time,open,high,low,close,Volume,Volume MA,RSI,RSI-based MA,Upper Bollinger Band,Lower Bollinger Band,CCI,Smoothing Line,Histogram,MACD,Signal,OnBalanceVolume,Smoothing Line,RSI,RSI-based MA,Upper Bollinger Band,Lower Bollinger Band,True Strength Index,Signal
1998-12-22T09:30:00-05:00,32.40625,32.5,31.78101,32.047,300500,NaN,NaN,NaN,NaN,NaN,NaN,NaN,NaN,NaN,NaN,NaN,NaN,NaN,NaN,NaN,NaN,NaN,NaN
1998-12-23T09:30:00-05:00,32.75,32.8125,32.15625,32.8125,338300,NaN,NaN,NaN,NaN,NaN,NaN,NaN,NaN,NaN,NaN,338300,NaN,NaN,NaN,NaN,NaN,NaN,NaN
1998-12-24T09:30:00-05:00,32.8125,32.8125,32.5625,32.6875,243700,NaN,NaN,NaN,NaN,NaN,NaN,NaN,NaN,NaN,NaN,94600,NaN,NaN,NaN,NaN,NaN,NaN,NaN
1998-12-28T09:30:00-05:00,33.1875,33.1875,32.59375,32.78125,309300,NaN,NaN,NaN,NaN,NaN,NaN,NaN,NaN,NaN,NaN,403900,NaN,NaN,NaN,NaN,NaN,NaN,NaN
1998-12-29T09:30:00-05:00,32.9375,33.01562,32.5,32.875,123800,NaN,NaN,NaN,NaN,NaN,NaN,NaN,NaN,NaN,NaN,527700,NaN,NaN,NaN,NaN,NaN,NaN,NaN
1998-12-30T09:30:00-05:00,32.6875,33.14062,32.57812,32.75,95600,NaN,NaN,NaN,NaN,NaN,NaN,NaN,NaN,NaN,NaN,432100,359320,NaN,NaN,NaN,NaN,NaN,NaN
1998-12-31T09:30:00-05:00,32.75,32.90625,32.34375,32.625,77200,NaN,NaN,NaN,NaN,NaN,NaN,NaN,NaN,NaN,NaN,354900,362640,NaN,NaN,NaN,NaN,NaN,NaN
1999-01-04T09:30:00-05:00,32.65625,33.5625,32.59375,33,650600,NaN,NaN,NaN,NaN,NaN,NaN,NaN,NaN,NaN,NaN,1005500,544820,NaN,NaN,NaN,NaN,NaN,NaN
1999-01-05T09:30:00-05:00,33.0625,34.03125,33.0625,33.84375,295200,NaN,NaN,NaN,NaN,NaN,NaN,NaN,NaN,NaN,NaN,1300700,724180,NaN,NaN,NaN,NaN,NaN,NaN
1999-01-06T09:30:00-05:00,34.6875,34.9375,34.40625,34.84375,624700,NaN,NaN,NaN,NaN,NaN,NaN,NaN,NaN,NaN,NaN,1925400,1003720,NaN,NaN,NaN,NaN,NaN,NaN
1999-01-07T09:30:00-05:00,34.5,35.03125,34.28125,34.73437,534600,NaN,NaN,NaN,NaN,NaN,NaN,NaN,NaN,NaN,NaN,1390800,1195460,NaN,NaN,NaN,NaN,NaN,NaN
1999-01-08T09:30:00-05:00,35.5,35.5625,34.48437,34.875,532800,NaN,NaN,NaN,NaN,NaN,NaN,NaN,NaN,NaN,NaN,1923600,1509200,NaN,NaN,NaN,NaN,NaN,NaN
1999-01-11T09:30:00-05:00,35.875,35.875,34.84375,35.21875,497900,NaN,NaN,NaN,NaN,NaN,NaN,NaN,NaN,NaN,NaN,2421500,1792400,NaN,NaN,NaN,NaN,NaN,NaN
1999-01-12T09:30:00-05:00,35.5,35.5625,34.26562,34.26562,486000,NaN,NaN,NaN,NaN,NaN,NaN,NaN,NaN,NaN,NaN,1935500,1919360,NaN,NaN,NaN,NaN,NaN,NaN
1999-01-13T09:30:00-05:00,32,35.15625,32,34.25,548200,NaN,71.55889502589416,NaN,NaN,NaN,NaN,NaN,NaN,NaN,NaN,1387300,1811740,NaN,NaN,NaN,NaN,NaN,NaN
1999-01-14T09:30:00-05:00,34.34375,34.625,33.5625,33.78125,366300,NaN,65.12443740230586,NaN,NaN,NaN,NaN,NaN,NaN,NaN,NaN,1021000,1737780,NaN,NaN,NaN,NaN,NaN,NaN
1999-01-15T09:30:00-05:00,34,34.79687,33.84375,34.78125,653900,NaN,71.09556334373605,NaN,NaN,NaN,NaN,NaN,NaN,NaN,NaN,1674900,1688040,NaN,NaN,NaN,NaN,NaN,NaN
1999-01-19T09:30:00-05:00,35.625,36,35.01562,35.98437,437300,NaN,76.3434064942947,NaN,NaN,NaN,NaN,NaN,NaN,NaN,NaN,2112200,1626180,NaN,NaN,NaN,NaN,NaN,NaN
1999-01-20T09:30:00-05:00,36.875,37.48437,36.25,36.3125,1132200,NaN,77.54104972972632,NaN,NaN,NaN,NaN,NaN,NaN,NaN,NaN,3244400,1887960,NaN,NaN,NaN,NaN,NaN,NaN
1999-01-21T09:30:00-05:00,36.25,36.3125,35.125,35.375,1492900,487050,67.0903506771863,NaN,NaN,NaN,98.61110797151397,NaN,NaN,NaN,NaN,1751500,1960800,86.59956852420652,NaN,NaN,NaN,NaN,NaN
1999-01-22T09:30:00-05:00,34.75,35.40625,34.39062,34.75,1291000,536575,61.17126592987347,NaN,NaN,NaN,46.26938361806451,NaN,NaN,NaN,NaN,460500,1848700,82.07096522245605,NaN,NaN,NaN,NaN,NaN
1999-01-25T09:30:00-05:00,35.1875,35.375,34.59375,35.35937,946600,566990,64.4632514834785,NaN,NaN,NaN,57.10216971475543,NaN,NaN,NaN,NaN,1407100,1795140,79.92052913088227,NaN,NaN,NaN,NaN,NaN
1999-01-26T09:30:00-05:00,35.75,36.8125,35.75,36.78125,713900,590500,70.7045081434644,NaN,NaN,NaN,134.629616102042,NaN,NaN,NaN,NaN,2121000,1796900,79.93913044112101,NaN,NaN,NaN,NaN,NaN
1999-01-27T09:30:00-05:00,37.25,37.48437,36,36,1366900,643380,64.04848278092399,NaN,NaN,NaN,127.66410984869182,92.85527745101356,NaN,NaN,NaN,754100,1298840,62.33935090277925,NaN,NaN,NaN,NaN,NaN
1999-01-28T09:30:00-05:00,36.75,37.28125,36.60937,37.26562,903600,682370,69.12005248058756,NaN,NaN,NaN,150.2249433101964,103.17804451875004,NaN,NaN,NaN,1657700,1280080,61.787547192567274,NaN,NaN,NaN,NaN,NaN
1999-01-29T09:30:00-05:00,37.375,37.84375,36.9375,37.8125,933600,724270,71.0222813234779,NaN,NaN,NaN,159.8356457560001,125.89129694633716,NaN,1.3736171868916855,NaN,2591300,1706240,68.5893469099303,NaN,NaN,NaN,NaN,NaN
1999-02-01T09:30:00-05:00,38.15625,38.375,37.5625,37.84375,913000,766060,71.13171471560932,NaN,NaN,NaN,161.17491896422038,146.70584679623016,NaN,1.4265361732607502,NaN,3504300,2125680,73.57493923720763,NaN,NaN,NaN,NaN,NaN
1999-02-02T09:30:00-05:00,38,38,36.625,37.20312,1259200,796490,65.6576149728431,69.00520532167154,NaN,NaN,107.14572014299931,141.2090676044216,NaN,1.400635707615308,NaN,2245100,2150500,73.83954645225339,NaN,NaN,NaN,NaN,NaN
1999-02-03T09:30:00-05:00,37.0625,38.0625,36.8125,37.46875,1334100,848435,66.79855025213982,68.66518069497481,NaN,NaN,104.045937976355,136.48543322995425,NaN,1.3855715170655714,NaN,3579200,2715520,78.99584093835944,NaN,NaN,NaN,NaN,NaN
1999-02-04T09:30:00-05:00,37.75,37.75,35.875,36.1875,1945900,914495,56.96751465617931,68.08254335596577,NaN,NaN,46.91902833555466,115.8242502350259,NaN,1.25577112256574,NaN,1633300,2710640,78.85128301774593,NaN,NaN,NaN,NaN,NaN
1999-02-05T09:30:00-05:00,36,36.21875,34.75,35.3125,1832400,979385,51.40355184900978,66.67597110634246,NaN,NaN,-27.638426716732653,78.32943574047934,NaN,1.06996430496541,NaN,-199100,2152560,64.34887976558213,NaN,NaN,NaN,NaN,NaN
1999-02-08T09:30:00-05:00,35.75,36.5,35.125,35.90625,1314600,1018475,54.640985027572334,65.12579814443372,NaN,NaN,-4.435125065073884,45.20742693462049,NaN,0.9595605099228095,NaN,1115500,1674800,55.01962690870866,NaN,NaN,NaN,NaN,NaN
1999-02-09T09:30:00-05:00,36,36.03125,34.3125,34.5,2085500,1097855,46.704962238164136,62.923220466465,NaN,NaN,-60.515110927088244,11.675260720602981,NaN,0.7499471604173777,NaN,-970000,1031780,45.46556875998882,70.81015167169919,NaN,NaN,NaN,NaN
1999-02-10T09:30:00-05:00,34.65625,35.40625,34.25,34.75,1401800,1143645,48.146818445731476,61.57011102136108,NaN,NaN,-70.49603565610511,-23.233134005889035,-0.5382965951955194,0.5971167907431223,1.1354133859386417,431800,402300,38.43022524689005,67.369484294748,NaN,NaN,NaN,NaN
1999-02-11T09:30:00-05:00,35.375,36.28125,35.03125,36.21875,2666700,1249570,55.72531729607411,61.18111469037541,NaN,NaN,-11.091465646375779,-34.83523280227512,-0.4381399971214144,0.5877383895368737,1.0258783866582881,3098500,695340,42.862754702904134,64.56889782906573,NaN,NaN,NaN,NaN
1999-02-12T09:30:00-05:00,35.375,35.78125,34.59375,34.78125,2917400,1377125,48.28688183822226,60.02565971571425,NaN,NaN,-74.42646623432388,-44.19284070579337,-0.4534863883293013,0.45902040124666144,0.9125067895759628,181100,771380,43.98957031585668,62.00240077084961,NaN,NaN,NaN,NaN
1999-02-16T09:30:00-05:00,35.75,35.8125,34.5,34.625,1726400,1430750,47.543996831330645,58.37133747913327,NaN,NaN,-83.84179956614994,-60.07417560600859,-0.4576233633923198,0.34047758533556305,0.7981009487278828,-1545300,239220,38.29728857428652,59.02798349464715,NaN,NaN,NaN,NaN
1999-02-17T09:30:00-05:00,33.75,34.96875,33.5625,33.84375,2783500,1548060,43.90670640064413,56.93263916625614,NaN,NaN,-132.5464043690142,-74.48043429439377,-0.4933606501825616,0.18140013599968086,0.6747607861822424,-4328800,-432540,32.568183359597,56.90147152727699,NaN,NaN,5.825978841313726,NaN
1999-02-18T09:30:00-05:00,34.3125,34.40625,33.34375,34.03125,2075600,1595230,44.99434732184078,55.20937451205994,NaN,NaN,-130.9398115317756,-86.56918946952787,-0.48408316199531964,0.06965683368809295,0.5537399956834126,-2253200,-969540,28.852436695454927,54.548963634626105,NaN,NaN,2.7468821221121758,NaN
1999-02-19T09:30:00-05:00,34.625,34.875,34.15625,34.34375,1673600,1604265,46.84428869406433,53.48237503853039,NaN,NaN,-86.50632783000562,-101.65216190625384,-0.4379970947710413,0.006243627219610914,0.44424072199065223,-579600,-1705160,24.695820315660356,51.4137117350354,NaN,NaN,0.8748434756709637,NaN
1999-02-22T09:30:00-05:00,34.59375,35.65625,34.34375,35.5625,2368000,1658115,53.42340639913474,52.217495873067925,NaN,NaN,-41.507495080348136,-95.06836767545869,-0.31242298929309936,0.053711985374278015,0.3661349746673774,1788400,-1383700,29.477116056094175,48.263867222098725,NaN,NaN,1.4942195642419005,NaN
1999-02-23T09:30:00-05:00,36,36.46875,35.5625,36.03125,2065500,1714060,55.69475702158227,51.50586316226357,NaN,NaN,10.095761413794541,-76.28085547946979,-0.1907612961614651,0.12768335446554602,0.3184446506270111,3853900,-303860,42.64990714930986,46.036035843317045,NaN,NaN,2.7629629677939067,NaN
1999-02-24T09:30:00-05:00,36.375,36.4375,35.03125,35.03125,2500500,1803390,50.08356542182805,50.31193567438417,NaN,NaN,-21.892115655678463,-54.14999773680264,-0.17122694443404196,0.10441097008445865,0.2756379145185006,1353400,832580,52.66970073778424,44.15559725756167,NaN,NaN,2.0141054317009335,NaN
1999-02-25T09:30:00-05:00,34.375,35.125,34.125,35.125,2566200,1863355,50.58619156262307,49.856126881987294,NaN,NaN,-63.59966102517269,-40.68196763548205,-0.1465372241173462,0.09246638437181787,0.23900360848916408,3919600,2067140,60.70208585307861,42.85922603151401,NaN,NaN,1.583314879465152,NaN
1999-02-26T09:30:00-05:00,35.0625,35.125,33.75,34.0625,2342600,1935305,45.049687270434816,49.40227941208908,NaN,NaN,-88.57245549305638,-41.09519316809221,-0.19336568039578936,-0.0027034920055726275,0.19066218839021673,1577000,2498460,63.06074652040376,42.76721651400128,NaN,NaN,-0.5651626847029945,NaN
1999-03-01T09:30:00-05:00,33.625,34.1875,33.4375,33.90625,1092100,1943230,44.28213496833901,48.66236155071528,NaN,NaN,-114.57473899383392,-55.708641950789364,-0.22429004183403253,-0.08970036390232394,0.1345896779317086,484900,2237760,60.68971576772427,43.17222286107381,NaN,NaN,-2.5202979418515423,NaN
1999-03-02T09:30:00-05:00,34.1875,34.5,33,33,2480200,2021590,40.022848327937695,48.18506769998482,NaN,NaN,-134.36997592142765,-84.60178941783381,-0.2909769641019817,-0.22913152719576857,0.06184543690621315,-1995300,1067920,51.35809456860007,43.593117561688906,NaN,NaN,-5.552468725950684,NaN
1999-03-03T09:30:00-05:00,33.5,33.71875,32.875,33.5625,1607800,2039020,43.64604499578669,47.86358388213163,NaN,NaN,-135.78624616732387,-107.38061552016288,-0.2821879389098759,-0.2908894867311318,-0.008701547821255845,-387500,719740,48.94585755618477,44.34423415520995,NaN,NaN,-6.950552382809584,NaN
1999-03-04T09:30:00-05:00,34.375,34.46875,33.125,33.90625,3199100,2132270,45.800828214707956,47.154691804891186,NaN,NaN,-91.11913357400714,-112.88451002992979,-0.23986973785223242,-0.3085387201365464,-0.06866898228431395,2811600,498140,47.419287576827436,44.669700789061615,NaN,NaN,-7.442137008698511,NaN
1999-03-05T09:30:00-05:00,34.875,35,34.26562,34.6875,1876900,2128820,50.43904318095124,47.308417615086114,NaN,NaN,-7.285402409588365,-96.62709941323617,-0.15028754938364922,-0.25652841901387546,-0.10624086963022625,4688500,1120440,51.951357731999565,45.23839989021468,NaN,NaN,-6.414041454696444,-0.9340271474162307
1999-03-08T09:30:00-05:00,35.5,35.75,35.03125,35.6875,1659400,2120170,55.6685939304637,47.88874597930991,NaN,NaN,78.6124357256027,-57.98966446934885,-0.021474605923356843,-0.1330841270344223,-0.11160952111106545,6347900,2293040,59.1042699526209,46.724612845809986,NaN,NaN,-3.8100950288092967,-1.3448939876152401
1999-03-09T09:30:00-05:00,35.5,36.1875,35.1875,35.3125,936000,2101240,53.39335072131472,48.566363430786375,NaN,NaN,89.29472854029642,-13.256723577004035,0.037474484611717054,-0.06476641534641914,-0.10224089995813619,5411900,3774480,65.99233776682698,49.112052446326416,NaN,NaN,-2.3644091063613804,-1.4905390045789744
1999-03-10T09:30:00-05:00,35.3125,35.53125,34.89062,35.3125,442000,2019065,53.39335072131472,49.16629224503452,NaN,NaN,53.31392713613693,24.563311083688127,0.07339026888728567,-0.010503063849029104,-0.08389333273631477,5411900,4934360,70.22134308669914,52.06697433141529,NaN,NaN,-1.205209309384616,-1.4497776195512089
1999-03-11T09:30:00-05:00,35.5,35.96875,34.90625,35.25,1216200,2009785,52.974841188787025,49.60418885180042,NaN,NaN,61.307426352540965,55.04862306899774,0.08883058301222921,0.027144896028971743,-0.061685686983257465,4195700,5211180,71.1436427431484,55.38467593337872,NaN,NaN,-0.36591288124051496,-1.2949397997925383
1999-03-12T09:30:00-05:00,35.5625,35.5625,34.5625,34.9375,836000,1918250,50.82953634011446,49.41891241901326,NaN,NaN,32.16065652125841,62.937834855167104,0.07447098352052198,0.031403042417395,-0.04306794110312697,3359700,4945420,68.93619178897552,58.203181342870245,NaN,NaN,-0.22773752981283363,-1.1424823326525804
1999-03-15T09:30:00-05:00,35.1875,35.5,34.64062,35.5,432100,1793985,54.40852393031133,49.32703862677962,NaN,NaN,50.87216633524418,57.389780977095405,0.09785685083270598,0.07925312243775551,-0.01860372839495047,3791800,4434200,64.7727706471687,59.78338587843159,NaN,NaN,0.9075186153317952,-0.8496250543690982
1999-03-16T09:30:00-05:00,35.53125,36.25,35.40625,36.10937,758800,1745605,57.97702559626761,49.89085721066816,NaN,NaN,111.82622084628028,61.89607943829217,0.14644301802422335,0.1644500441353287,0.018007026111105367,4550600,4261940,63.38364491825807,60.54866760560829,NaN,NaN,2.946271841081287,-0.3073540693047575
1999-03-17T09:30:00-05:00,36.09375,36.125,35.5625,35.875,425400,1627700,56.156454819470504,50.28873315758583,NaN,NaN,95.33750682346107,70.300795375757,0.15409798887018394,0.2106295121988353,0.056531523328651356,4125200,4004600,61.26965904135,60.58920854762768,NaN,NaN,4.162045284527875,0.3311315526713329
1999-03-18T09:30:00-05:00,35.75,36.40625,35.625,36.375,321400,1539990,59.106689564939,51.292804750050415,NaN,NaN,112.34443095605067,80.50819629645893,0.1822113498851364,0.28429571068507187,0.10208436079993546,4446600,4054780,61.53903146380944,60.4805146150138,NaN,NaN,6.071103157729494,1.1511274962510702
1999-03-19T09:30:00-05:00,36.6875,36.875,35.5,35.5,636500,1488135,52.4546117816973,51.876553093861716,NaN,NaN,87.67223096603709,91.61051118541468,0.13350930040035666,0.2689709863003813,0.13546168590002464,3810100,4144860,62.04930604763826,60.57762820643622,NaN,NaN,5.8373918147756525,1.8205938274688678
1999-03-22T09:30:00-05:00,35.5,35.84375,35.1875,35.5,773500,1408410,52.4546117816973,52.764536197701695,NaN,NaN,42.576083326943426,89.95129458375453,0.09475004282514979,0.25389923943146187,0.15914919660631208,3810100,4148520,62.07132460128927,61.34285892305688,NaN,NaN,5.647838559215484,2.3673430748612416
1999-03-23T09:30:00-05:00,35.25,35.25,34.21875,34.46875,1498600,1380065,45.461231368571895,52.89419236718634,NaN,NaN,-32.837736125176775,61.01850318946312,-0.0017733614018234922,0.1569324948540327,0.1587058562558562,2311500,3700700,57.66300172197452,61.965512077756145,NaN,NaN,3.3577180635736106,2.508825216105866
1999-03-24T09:30:00-05:00,34.6875,35.29687,34.09375,35.14062,616700,1285875,50.12652591557805,53.20317077439135,NaN,NaN,-10.900715145618257,39.77085879564725,-0.02074911587521297,0.13276946141183998,0.15351857728705295,2928200,3461300,55.3979334795879,62.53541535652475,NaN,NaN,2.8101735935618732,2.551874984313867
1999-03-25T09:30:00-05:00,35.84375,36.09375,35.5625,35.96875,595100,1187320,55.2120201455328,53.544097700432886,NaN,NaN,81.84461461132538,33.67089552670219,0.01989467415509616,0.17838691998092315,0.158492245825827,3523300,3276640,53.64741689823077,62.65656243982698,NaN,NaN,3.952457806378249,2.7519582446087787
1999-03-26T09:30:00-05:00,35.8125,36.375,35.59375,35.78125,483500,1094365,53.87259370585828,53.415811970103924,NaN,NaN,78.94871230822865,31.926191795140504,0.03091574713393408,0.1971369297432446,0.1662211826093105,3039800,3122580,52.16638254629464,62.160999053660824,NaN,NaN,4.473378346324742,2.9978754019967733
1999-03-29T09:30:00-05:00,36.25,37.1875,36.15625,37.125,949700,1087245,61.147199248537966,53.96965829347702,NaN,NaN,155.14427289140374,54.439829708032576,0.12044246657475988,0.31677426582776036,0.19633179925300048,3989500,3158460,52.49530992907849,61.196925636678785,NaN,NaN,7.373004274923275,3.622893812414845
1999-03-30T09:30:00-05:00,36.9375,37.5,36.75,37.0625,842500,1005360,60.66795600316914,54.489272956466614,NaN,NaN,171.5829988987155,95.32397671281102,0.1644637632539528,0.40191150332044145,0.23744774006648867,3147000,3325560,54.0790586763444,60.04390532165345,NaN,NaN,9.50994845868948,4.463901619025507
1999-03-31T09:30:00-05:00,37.5,37.8125,36.53125,36.59375,774700,963705,57.05612320896253,54.78079310076487,NaN,NaN,148.84659288386612,127.27343831870789,0.15135470130904083,0.4266411167027897,0.2752864153937489,2372300,3214380,52.817343710690594,58.73488396219217,NaN,NaN,10.206296465921536,5.284243740010654
1999-04-01T09:30:00-05:00,37.5,37.53125,36.5,37.17187,318500,819675,60.203001786789486,55.45032634695594,NaN,NaN,144.40114303934428,139.78474400431168,0.16958846580697173,0.48727199765246354,0.3176835318454918,2690800,3047880,50.902031838376594,57.446729680006534,NaN,NaN,11.770272798559581,6.210819319803358
1999-04-05T09:30:00-04:00,37.625,38.5,37.59375,38.45312,1003500,776005,66.12720955161205,56.28737531990599,NaN,NaN,223.6047669720017,168.71595493706627,0.2509970501852969,0.6314298445771129,0.38043279439181604,3694300,3178780,52.364556669352034,56.56042868159106,NaN,NaN,15.167559208254735,7.490353589582126
1999-04-06T09:30:00-04:00,38.6875,39.125,38.3125,38.78125,540100,720040,67.4630469254377,56.96494827198957,NaN,NaN,211.09275149258403,179.90565065730235,0.30633685046383846,0.7633538574716141,0.45701700700777564,4234400,3227760,52.92956102332872,55.813708403381824,NaN,NaN,18.339696070579496,9.040259658296035
1999-04-07T09:30:00-04:00,39.5,39.5625,37.9375,38.6875,931700,719825,66.65424817808622,57.714790654747844,NaN,NaN,167.73124690398012,179.13530025835524,0.3148146384704451,0.850535305095832,0.5357206666253869,3302700,3258900,53.30873778083957,55.24507117048821,NaN,NaN,20.63535590212412,10.696701978842905
1999-04-08T09:30:00-04:00,38.6875,39.1875,37.875,39.0625,606900,728070,68.2917846867746,58.37086887773609,NaN,NaN,139.44149108238963,177.25427989805996,0.32267280906986606,0.9390616779627194,0.6163888688928534,3909600,3566360,56.992505988333264,54.92031935081134,NaN,NaN,23.05159682598423,12.46168695700595
1999-04-09T09:30:00-04:00,38.98437,39.35937,38.6875,39,278800,681200,67.6951051037109,59.4594755435942,NaN,NaN,135.33938460235316,175.44192821066173,0.301075012672517,0.9927326347334997,0.6916576220609827,3630800,3754360,59.116524970745665,54.71083498817616,NaN,NaN,24.85807420844981,14.23259942149793
1999-04-12T09:30:00-04:00,37.625,38.60937,37.4375,38.40625,1037500,691275,62.140469963284104,60.15132255656469,NaN,NaN,78.01287713110032,146.32355024248147,0.22755763423608977,0.9761046648560949,0.7485470306200052,2593300,3534160,55.6497802816253,54.2521532510573,NaN,NaN,24.850970107005335,15.749509519427559
1999-04-13T09:30:00-04:00,38.5625,38.75,37.5,37.8125,800600,709700,57.09521982244079,60.98232173184105,NaN,NaN,63.85464881463457,116.87592970689157,0.12483332020775983,0.904588680879705,0.7797553606719452,1792700,3045820,48.813186322869186,53.62002357969264,NaN,NaN,23.35470549235906,16.835966086989202
1999-04-14T09:30:00-04:00,38.375,38.48437,36.75,36.875,475700,695545,50.169004478646464,60.985355914917356,NaN,NaN,22.961363989276972,87.92195312395096,-0.013034199257211165,0.7634626116004313,0.7764968108576424,1317000,2648680,44.07142744333248,52.810987434245824,NaN,NaN,19.837760178769766,17.264793814386426
1999-04-15T09:30:00-04:00,37.3125,37.375,36.09375,37.1875,1699200,759235,52.248448144896116,60.77367220058617,NaN,NaN,-9.150292774375586,58.20359635259791,-0.08589976851848058,0.6691221002095418,0.7550218687280223,3016200,2470000,42.090348308235846,51.98548253496047,NaN,NaN,17.55124252398497,17.30571505861479
1999-04-16T09:30:00-04:00,37.1875,37.25,36,36.1875,272100,756770,45.67939730806738,60.18844388645825,NaN,NaN,-35.96553141293338,23.94261314954059,-0.19776854195628757,0.5078111912826628,0.7055797332389504,2744100,2292660,40.16077096198986,51.12793885036727,NaN,NaN,13.387972637361734,16.746037569864352
1999-04-19T09:30:00-04:00,36.5625,36.59375,34.125,34.4375,1208300,785360,36.929134639543435,58.45858212867292,NaN,NaN,-117.93661175256966,-15.24728462719342,-0.3756319155479799,0.2360398388039755,0.6116717543519554,1535800,2081160,37.92759313791789,50.08738765099866,NaN,NaN,6.33686829758904,15.259013388110736
1999-04-20T09:30:00-04:00,34.8125,35.375,34.125,35.3125,1029400,798155,42.826403461125054,57.184185518526924,NaN,NaN,-119.98190209573967,-52.014594809268274,-0.4171580253998819,0.09022422260210305,0.507382248001985,2565200,2235660,40.529120636870054,49.11953493389335,NaN,NaN,2.6165248880792564,13.452943602391953
1999-04-21T09:30:00-04:00,35.3125,36.375,35.0625,36.25,507800,748615,48.394028743685006,56.56546448529281,NaN,NaN,-71.20952032801246,-70.84877167272616,-0.36611432082343354,0.049739346972693,0.41585366779612654,3073000,2586860,46.06297274893444,48.637079865196476,NaN,NaN,1.5159372810115737,11.747656985051899
1999-04-22T09:30:00-04:00,37.8125,37.98437,37.1875,37.92187,1032300,769395,56.524803831089656,56.30273605988567,NaN,NaN,34.492488040885206,-62.120215509674,-0.21202521890598858,0.15082214416364081,0.3628473630696294,4105300,2804680,49.21907952190689,48.51686898544864,NaN,NaN,3.6167718124370363,10.586101960392632
1999-04-23T09:30:00-04:00,37.71875,38.34375,37.25,38,244500,751865,56.86681752655893,55.6412794866676,NaN,NaN,40.23706267509733,-46.87969669206785,-0.10265237876956484,0.23453188960767335,0.3371842683772382,4349800,3125820,53.5358959486334,48.60053607682588,NaN,NaN,5.308243241799401,9.832122143450743
1999-04-26T09:30:00-04:00,38.4375,39,38.21875,38.96875,265100,740945,60.96707918345283,55.17728179081154,NaN,NaN,90.59095253964347,-5.17418383362523,0.030030923055407166,0.37472292219649717,0.34469199914109,4614900,3741640,60.47466783053337,49.139472277340495,NaN,NaN,8.140930238352125,9.590523299865225
1999-04-27T09:30:00-04:00,39.4375,39.46875,37.96875,38,413000,714110,55.305316818642886,54.366643836565586,NaN,NaN,66.51921510537939,32.12603960659858,0.04665412254265172,0.40300965231940467,0.35635552977675294,4201900,4068980,63.587432691244814,49.87366477094088,NaN,NaN,8.549453797714754,9.4417990852723
1999-04-28T09:30:00-04:00,38,38.40625,37.3125,37.5,894300,716700,52.59070216293327,53.24513794200549,NaN,NaN,14.090393812049102,49.18602243461089,0.01946987848887427,0.3806928778878458,0.3612229993989715,3307600,4115900,64.02477143922243,50.37596944600438,NaN,NaN,7.976197232742717,9.232427392053788
1999-04-29T09:30:00-04:00,37.5,37.5625,36.59375,37.10937,484000,702165,50.50498311301554,52.01727208552726,NaN,NaN,-31.607700284955033,35.96598476944284,-0.026811617391759968,0.3277084776592716,0.35452009505103155,2823600,3859560,59.799021495327175,50.424719197760204,NaN,NaN,6.850149517844094,8.892101981452402
1999-04-30T09:30:00-04:00,37.75,37.75,35.9375,36.8125,760000,724240,48.91719060810193,51.07275213158567,NaN,NaN,-47.88754256670754,18.341063721081873,-0.07659209499259606,0.2587799763102865,0.33537207130288255,2063600,3402320,53.07047508223039,50.24048311208914,NaN,NaN,5.451584681955335,8.40059951009568
1999-05-03T09:30:00-04:00,37,37.25,36.59375,37.125,201600,684145,50.675090764038714,50.614171484556955,NaN,NaN,-33.03445360661926,-6.384017508170674,-0.08689295297690286,0.22675588008175396,0.3136488330586568,2265200,2932380,47.193037981918756,50.12475823059268,NaN,NaN,4.818720452173293,7.888902501821053
1999-05-04T09:30:00-04:00,36.96875,37.4375,36.3125,36.5625,1434900,728885,47.50606563131888,50.42396156689069,NaN,NaN,-42.55159455190428,-28.198179439627403,-0.12755117145998118,0.15420986873368037,0.28176104019366155,830300,2258060,40.296777681969765,49.85514039049535,NaN,NaN,3.3440471195101664,7.239637447205212
1999-05-05T09:30:00-04:00,36.75,37.3125,35.75,37.3125,443100,704455,51.83139000250346,50.39417169957693,NaN,NaN,-35.69914917144923,-38.15608803632707,-0.10105402570508515,0.1554435080623051,0.25649753376739026,1273400,1851220,36.80251539084615,49.47743803925322,NaN,NaN,3.3584742630486435,6.685185563754273
1999-05-06T09:30:00-04:00,37,37.59375,36.25,36.375,343400,691280,46.65633601531599,50.46395303580897,NaN,NaN,-34.35917109262347,-38.70638219786076,-0.1413162079529652,0.07985227382618376,0.22116848177914897,930000,1472500,33.859172865572646,49.027323889509134,NaN,NaN,1.7754620169224122,5.983796485635436
1999-05-07T09:30:00-04:00,36.9375,37.1875,36.28125,37,369700,695825,50.224394811967834,51.41361447669643,NaN,NaN,-21.579644861358325,-33.44480265679092,-0.12127404558798702,0.06957592479416519,0.1908499703821522,1299700,1319720,32.72222872800289,48.655512145943774,NaN,NaN,1.5346189727116724,5.3481996980748985
1999-05-10T09:30:00-04:00,37.375,37.75,37.0625,37.3125,243200,656110,51.95482324701248,52.06564446140268,NaN,NaN,32.51799147453792,-20.334313640559486,-0.08415154344014492,0.08566054108197108,0.169812084522116,1542900,1175260,31.64037103451159,48.02060146006103,NaN,NaN,1.8521331013829756,4.848761612833195
1999-05-11T09:30:00-04:00,37.53125,38.25,37.53125,37.875,465600,639360,54.98816275921926,52.53665403394084,NaN,NaN,81.85930004856434,4.547865279534234,-0.02212322377817072,0.14215805479940258,0.1642812785775733,2008500,1410900,35.39265128923246,47.2584356415109,NaN,NaN,3.0255484085121487,4.588302583644475
1999-05-12T09:30:00-04:00,38.46875,38.84375,37.5,38.625,294700,630310,58.729559401660104,52.69413657469588,NaN,NaN,110.55628749696709,33.7989526132175,0.06428018805004504,0.24463151364012958,0.18035132559008454,2303200,1616860,38.56673044635065,46.49755356468545,NaN,NaN,5.178106217707674,4.672560245653503
1999-05-13T09:30:00-04:00,38.875,39.28125,38.46875,38.51562,615500,576125,57.97274013500613,52.77313104672782,NaN,NaN,126.60945510994453,65.99267785373111,0.10644189431841658,0.31340369348810526,0.20696179916968868,1687700,1768400,40.86861209085406,45.59274757484407,NaN,NaN,6.7131826712030165,4.964077735017719
1999-05-14T09:30:00-04:00,37.875,38.125,37.34375,37.5,407800,582910,51.355182631995326,52.086567007338,NaN,NaN,34.966532991598655,77.30191342432249,0.06058684806838646,0.28269535925517175,0.2221085111867853,1279900,1764440,40.8255629856405,44.189240085923146,NaN,NaN,6.1078509703790305,5.127473911497907
1999-05-17T09:30:00-04:00,37.28125,38.1875,37.10937,38.03125,225600,533775,54.294171004335006,52.014342306316,NaN,NaN,37.967552789942154,78.39182568740334,0.060547943751399574,0.29779344087603477,0.2372454971246352,1505500,1756960,40.73827229256844,42.5571572003034,NaN,NaN,6.475210128774739,5.320007656823169
1999-05-18T09:30:00-04:00,38.4375,38.6875,38.0625,38.375,410100,502810,56.140680832643056,52.267912211295275,NaN,NaN,87.29557735605064,79.4790811489006,0.07712393604324264,0.3336504171786885,0.25652648113544585,1915600,1738380,40.50659138090873,40.87728719613814,NaN,NaN,7.322629778829719,5.606096531395533
1999-05-19T09:30:00-04:00,38.5625,38.59375,37.95312,38.5,318700,493355,56.82376898278763,52.71925405913614,NaN,NaN,80.02860803829533,73.37354525716626,0.08910898772808151,0.36791271579554774,0.2788037280674662,2234300,1724600,40.32343025358048,39.486173536013375,NaN,NaN,8.21240168840871,5.9784258395402725
1999-05-20T09:30:00-04:00,38.71875,38.73437,38,38,276000,455540,53.25113589203577,53.02882157941713,NaN,NaN,62.328522973238066,60.51735882982496,0.05749911327409868,0.3506776196600896,0.2931785063859909,1958300,1778720,41.443325161221594,38.655662827369895,NaN,NaN,7.97886826825441,6.264203329356578
1999-05-21T09:30:00-04:00,37.75,38.04687,37.46875,37.5625,277300,457180,50.272731915313926,53.00008166165107,NaN,NaN,2.4427255239153056,54.01259733628829,0.004079377420664221,0.2982777281618212,0.29419835074115697,1681000,1858940,43.14642744502162,38.36661921759153,NaN,NaN,6.937352063134246,6.360367434181959
1999-05-24T09:30:00-04:00,37.5625,37.75,36.64062,36.75,704800,479165,45.21488004840858,52.83642554858606,NaN,NaN,-61.81523586766695,34.05603960476647,-0.08415092786328432,0.18900969091205155,0.2731606187753359,976200,1753080,41.43383746932061,38.44783777383088,NaN,NaN,4.514364739835342,6.096652763561013
1999-05-25T09:30:00-04:00,37,37.25,35.92187,35.98437,356300,476330,41.026217676462025,52.06462752529738,NaN,NaN,-122.32419773873931,-7.867915414191515,-0.1863917143871164,0.040170975791440355,0.22656269017855676,619900,1493940,37.50892135274793,38.49829534253814,NaN,NaN,1.113014154787223,5.384704390879043
1999-05-26T09:30:00-04:00,36.4375,36.75,35.375,36.73437,676900,465460,46.27652883206313,52.03749844077932,NaN,NaN,-117.46768453320432,-47.36717392849145,-0.19490557791729327,-0.01706928221805981,0.17783629569923345,1296800,1306440,34.93062364872867,38.574827541335004,NaN,NaN,-0.2364575353437567,4.581681258561501
1999-05-27T09:30:00-04:00,36.73437,36.79687,36.03125,36.46875,380700,460295,44.756789246860635,51.646955186128814,NaN,NaN,-94.40505228316863,-78.71388897977279,-0.20859717760162388,-0.0829101763027964,0.12568700129882748,916100,1098000,32.274645808277356,38.54285733278318,NaN,NaN,-1.798489541048244,3.67022828718868
1999-05-28T09:30:00-04:00,36.46875,36.9375,36.15625,36.9375,132900,428940,48.00212185965359,51.36461937274604,NaN,NaN,-68.36542599742515,-92.87551928404088,-0.1774751327777996,-0.09615691467342202,0.08131821810437759,1049000,971600,30.747841307543737,38.479105209428326,NaN,NaN,-2.1686131685308543,2.8361080792287465
1999-06-01T09:30:00-04:00,36.98437,36.98437,36.0625,36.10937,318800,434800,43.17633639241403,50.520917489402805,NaN,NaN,-90.17019202675867,-98.54651051585923,-0.20225558290196582,-0.17150126052307968,0.03075432237888614,730200,922400,30.149964827956595,38.104627605051476,NaN,NaN,-3.966467491067429,1.8643115691864358
1999-06-02T09:30:00-04:00,35.9375,36.6875,35.46875,36.5,323000,379205,45.937278132223135,49.60718311301445,NaN,NaN,-99.43089628884202,-93.96785022587976,-0.18253620436501872,-0.19741593307738725,-0.014879728712368541,1053200,1009060,32.634651684352775,37.6809076934802,NaN,NaN,-4.6417091005977476,0.9348800449315525
1999-06-03T09:30:00-04:00,36.46875,36.8125,36.20312,36.25,456100,379855,44.44878443921011,48.641186277600454,NaN,NaN,-77.30376059257355,-85.93506543775361,-0.17642639077434746,-0.23541271718030288,-0.058986326405955414,597100,869120,30.73346638197056,36.95696871427424,NaN,NaN,-5.633285723920374,-0.0034293506187226264
1999-06-04T09:30:00-04:00,36.25,37.4375,36.25,37.32812,250000,375185,51.714963286225625,48.66688489575976,NaN,NaN,-27.16575796651263,-72.4872065744224,-0.09400744825385501,-0.17649563672327417,-0.08248818846941916,847100,855320,30.544493150523394,36.222606583194455,NaN,NaN,-4.282660032707118,-0.6147480194884932
1999-06-07T09:30:00-04:00,37.60937,38.25,37.60937,38,501800,381790,55.61161141436473,48.76098778219045,NaN,NaN,53.227236480094106,-48.16867407891855,0.006209015009630892,-0.07472691970738055,-0.08093593471701144,1348900,915300,32.48754635958585,35.63326901655284,NaN,NaN,-1.9028089323331012,-0.7987567213234372
1999-06-08T09:30:00-04:00,38,38.10937,37.01562,37.125,254200,382340,49.95731307909596,48.31931865693708,NaN,NaN,4.7030659751799515,-29.194022478530833,0.013594687467985894,-0.06394257538202908,-0.07753726285001497,1094700,988200,34.8723316757669,35.230821894757,NaN,NaN,-1.6373214338725808,-0.9185516802590291
1999-06-09T09:30:00-04:00,37.375,37.78125,37.21875,37.6875,281900,373155,53.24818423923613,48.063919746683396,NaN,NaN,19.64236292640703,-5.3793706354810125,0.054115556221682876,-0.009892817572911383,-0.06400837379459426,1376600,1052880,36.998716956241154,34.99334237351847,NaN,NaN,-0.3704058061877692,-0.8402451268202777
1999-06-10T09:30:00-04:00,37.3125,37.4375,36.82812,37.125,251400,370990,49.726557386816346,47.81216413916773,NaN,NaN,-15.307162463525463,7.019948990328599,0.041362541086284586,-0.012305197436738524,-0.05366773852302311,1125200,1158500,40.419618256122405,34.920220451725676,NaN,NaN,-0.4116940658428623,-0.779023546680647
1999-06-11T09:30:00-04:00,37.25,37.48437,36.5,36.625,105400,345485,46.76582409915677,47.561670723727936,NaN,NaN,-34.45892519466064,5.5613155446989975,-0.00021864786670702796,-0.053941048356406895,-0.05372240048969987,1019800,1193040,41.5375846718777,34.805303110786824,NaN,NaN,-1.362702979824851,-0.8624063228441047
1999-06-14T09:30:00-04:00,36.9375,36.9375,36.3125,36.45312,170600,333625,45.7572431345118,47.600410944163876,NaN,NaN,-61.017607302632534,-17.28765321184633,-0.03674867284489436,-0.09965824154581782,-0.06290956870092346,849200,1093100,39.24307345872475,34.648819967172834,NaN,NaN,-2.4345350100424166,-1.0869961353010065
1999-06-15T09:30:00-04:00,36.375,37.09375,36.375,36.78125,415400,343115,48.06020975753665,48.102838949954915,NaN,NaN,-37.51786920535919,-25.731840247954164,-0.03620453408424326,-0.10816523630622754,-0.07196070222198428,1264600,1127080,40.447601501190356,34.858725692061576,NaN,NaN,-2.6666046646636463,-1.3126544966385265
1999-06-16T09:30:00-04:00,37.6875,38.46875,37.625,38.29687,359500,340585,57.116755725829925,48.87714087093826,NaN,NaN,119.71956394873722,-5.716400043488124,0.06341380267245847,0.0073065511185888,-0.05610725155386966,1624100,1176580,42.24392799652393,35.38110457404695,NaN,NaN,0.044032640113312455,-1.118842048531121
1999-06-17T09:30:00-04:00,37.9375,38.84375,37.90625,38.71875,341100,341705,59.246887548234724,49.912147892464986,NaN,NaN,157.48047412182862,28.841127273582693,0.14996330501512142,0.13134687971503212,-0.018616425300089307,1965200,1344580,47.97917372722275,36.502856568257336,NaN,NaN,2.942186913889961,-0.538695053899538
1999-06-18T09:30:00-04:00,38.71875,39.0625,38.42187,39.0625,204900,338150,60.94900454488296,50.83692522712423,NaN,NaN,183.18761362031395,72.37043503657762,0.21845657642272243,0.25445429522831375,0.035997718805591314,2170100,1574640,54.62417985820963,38.20830932187632,NaN,NaN,5.84851026176715,0.3737628483385603
1999-06-21T09:30:00-04:00,39.23437,40.07812,39.1875,40.04687,757000,362135,65.40497788833659,52.42468533397584,NaN,NaN,222.52468715308765,129.07889392772165,0.3124269866885795,0.4265314521663157,0.1141044654777362,2927100,1990220,63.65556342356077,40.60156636441949,NaN,NaN,9.846626489932877,1.727029082852034
1999-06-22T09:30:00-04:00,39.9375,40.1875,39.125,39.20312,526400,353215,59.1723734538543,53.37004928552092,NaN,NaN,161.17962422308395,168.81839261341028,0.30006145795322353,0.48918128791926563,0.1891198299660421,2400700,2217440,67.46811421826337,43.0896708311274,NaN,NaN,11.268136103815925,3.090044371561161
1999-06-23T09:30:00-04:00,39,39.51562,38.625,39.5,457700,358285,60.59522456345956,54.523366437253024,NaN,NaN,120.01442211825163,168.87736424731315,0.2938032852922307,0.5563739365813305,0.2625706512890998,2858400,2464300,71.02441702762002,45.967595877245216,NaN,NaN,12.860853208250875,4.485874205373977
1999-06-24T09:30:00-04:00,39.375,39.40625,38.48437,38.6875,266800,337780,54.95095579530544,54.75450875933016,NaN,NaN,84.21126574558456,154.22352257206435,0.22023347184800984,0.5378624910991121,0.31762901925110226,2591600,2589580,72.65797969221691,48.97570205879475,NaN,NaN,12.448500857228746,5.623392298496087
1999-06-25T09:30:00-04:00,38.75,39.34375,38.5625,38.73437,273200,332405,55.21013805830706,54.725832091040324,NaN,NaN,76.06912893833517,132.79982563566858,0.1626717063171369,0.5209686521475234,0.3582969458303865,2864800,2728520,74.38288056813174,51.968225930833746,NaN,NaN,12.196883137680043,6.56246241837951
1999-06-28T09:30:00-04:00,39.125,39.4375,38.89062,39.375,218500,336685,58.70710873922284,55.35081749533509,NaN,NaN,89.09720644652667,106.11432949435638,0.1556825723009433,0.5529001612065656,0.3972175889056223,3083300,2759760,74.76831299006409,54.81793888185497,NaN,NaN,13.026698345144897,7.485924693631707
1999-06-29T09:30:00-04:00,39.375,39.9375,39.375,39.875,107800,326135,61.250019782459255,55.92237717699389,NaN,NaN,109.23845772668895,95.72609619507739,0.171428255781288,0.6115029086322323,0.4400746528509443,3191100,2917840,76.68032668433254,57.652339576718646,NaN,NaN,14.490377187648695,8.486560764205564
1999-06-30T09:30:00-04:00,39.85937,40.625,39.45312,40.48437,315100,325740,64.1478122919901,56.95246681307772,NaN,NaN,125.0476360353455,96.73273897849617,0.20718728589575452,0.6990587602206375,0.491871474324883,3506200,3047400,78.14226346317133,60.34681423436499,NaN,NaN,16.622309877359843,9.648810637513318
1999-07-01T09:30:00-04:00,40.65625,41.125,40.09375,40.9375,473400,326605,66.17352993205218,58.3387315154274,NaN,NaN,143.450046707541,108.58049517088746,0.24317265298083024,0.7958372905509208,0.5526646375700905,3979600,3325000,80.90455281374938,63.15874053021297,NaN,NaN,19.027682469207537,10.988649470612492
1999-07-02T09:30:00-04:00,40.875,41.46875,40.875,41.46875,222000,325205,68.42597402660647,59.957926579148435,NaN,NaN,158.2816429595274,125.02299797512592,0.28184466752112947,0.9049704719715024,0.6231258044503729,4201600,3592360,83.1174610118181,66.29262535543391,NaN,NaN,21.75676702481333,12.526951978355468
1999-07-06T09:30:00-04:00,41.6875,42.125,41.1875,41.23437,327900,316510,66.32752968887752,61.26273514567278,NaN,NaN,152.31210764823174,137.66597821546694,0.2706702707753621,0.9614636429195755,0.6907933721442134,3873700,3750440,84.27761881108373,69.42334087756916,NaN,NaN,23.412811048923757,14.082074702722366
1999-07-07T09:30:00-04:00,40.875,41.8125,40.875,41.71875,555600,331580,68.47896026435585,62.074321184138924,NaN,NaN,132.29992829390105,142.27827232890934,0.27409156121070166,1.0334078236575905,0.7593162624468889,4429300,3998080,85.91100159599208,72.54241756324545,NaN,NaN,25.461062356549153,15.707644367554764
1999-07-08T09:30:00-04:00,41.5,42.48437,41.4375,42.28125,379200,336445,70.81128163252416,62.900349333016734,NaN,NaN,145.1851641918453,146.3057779602093,0.29084252169408153,1.1228694145644909,0.8320268928704093,4808500,4258540,87.39433977088089,75.3577865663639,NaN,NaN,27.922099274911105,17.4525664971771
1999-07-09T09:30:00-04:00,42.4375,42.73437,42.15625,42.73437,123200,330035,72.57187615654078,63.73055444813515,NaN,NaN,148.76428342370403,147.3686253034419,0.3074268830900566,1.21631049673298,0.9088836136429235,4931700,4448960,88.35927116102219,77.76743594513621,NaN,NaN,30.540508853865454,19.322272548132577
1999-07-12T09:30:00-04:00,42.875,43.03125,42.375,42.79687,234400,336485,72.81544293432712,64.25987337999162,NaN,NaN,139.4608674374753,143.60447019903148,0.2974082998837879,1.2806439884976584,0.9832356886138705,5166100,4641860,89.25645757970914,79.59607124200396,NaN,NaN,32.75404485998803,21.241097164111927
1999-07-13T09:30:00-04:00,42.5,42.6875,42.14062,42.60937,200100,337960,70.78464394326421,65.08932127209233,NaN,NaN,113.1085385425442,135.763756377894,0.25460842744275003,1.301496222917308,1.046887795474558,4966000,4860320,90.17957546535227,81.21831847393888,NaN,NaN,34.070866007651716,23.07392128461761
1999-07-14T09:30:00-04:00,42.9375,43.15625,42.40625,43.14062,301900,332285,73.07586774831258,65.98079578529612,NaN,NaN,119.05521675206306,133.11481406952637,0.23879415978606966,1.345380495207145,1.1065863354210754,5267900,5028040,90.83095117005028,82.6330709126839,NaN,NaN,35.874900041779085,24.90263253564068
1999-07-15T09:30:00-04:00,43.4375,43.6875,43.03125,43.45312,386000,333610,74.35018154980827,67.3664547677606,NaN,NaN,126.90776660966574,129.45933455309049,0.22621858229923264,1.3893595632951161,1.1631409809958835,5653900,5197120,91.44686332388284,83.97513402923146,NaN,NaN,37.77498942991336,26.74154066339392
1999-07-16T09:30:00-04:00,43.75,44,43.375,43.84375,100400,321575,75.88654633391403,68.8433410731611,NaN,NaN,127.41567504202878,125.18961287675543,0.22080266178471142,1.4391443082267728,1.2183416464420613,5754300,5361640,92.00932035880572,85.23416544285104,NaN,NaN,39.85319540558183,28.614634197992192
1999-07-19T09:30:00-04:00,43.90625,43.96875,43.25,43.3125,222700,322465,69.76623690617265,69.63327879937181,NaN,NaN,106.32651778268804,118.56274294579798,0.16082270520737008,1.419370027951274,1.258547322743904,5531600,5434740,92.25308792837617,86.48307793844477,NaN,NaN,39.942098878248274,30.232843438028777
1999-07-20T09:30:00-04:00,43.10937,43.125,41.25,41.51562,808300,325030,53.92459199505271,69.11003395741419,NaN,NaN,31.66958962395613,102.27495316208037,-0.011348780990956708,1.2443613465052081,1.2557101274961648,4723300,5386200,90.2835341775256,87.45473561652997,NaN,NaN,34.65772121557462,30.86496883482104
1999-07-21T09:30:00-04:00,41.5,42.125,41.3125,41.875,397700,318595,56.07294940065066,68.53325803660424,NaN,NaN,18.31363887120427,82.12663758590858,-0.10718088868721298,1.1217340166371486,1.2289149053243615,5121000,5356820,89.04436649936115,88.2334572619721,NaN,NaN,31.08038749761749,30.895742929506245
1999-07-22T09:30:00-04:00,41.875,41.875,40.39062,40.57812,517300,321575,47.4710098552325,67.19736374540284,NaN,NaN,-30.017021678495098,50.74167992827641,-0.2555956323862765,0.909420364841516,1.1650159972277925,4603700,5146780,80.53422270185547,88.20700511112254,NaN,NaN,24.841676361349567,30.030876276912434
1999-07-23T09:30:00-04:00,40.8125,40.96875,40.29687,40.6875,401400,328305,48.192873713120406,65.75214229443955,NaN,NaN,-55.367773802042244,14.184990159462206,-0.3388612254603873,0.7414394654023084,1.0803006908626958,5005100,4996940,75.02551329202865,87.6290088454233,NaN,NaN,20.235481185898674,28.631534121053324
1999-07-26T09:30:00-04:00,40.125,40.4375,39.71875,39.76562,359900,332640,42.84832266298658,64.07505607830447,NaN,NaN,-103.78845555584628,-27.83800450824466,-0.44196794380396476,0.5278407611077398,0.9698087049117046,4645200,4819660,69.01095050001017,86.53853253748947,NaN,NaN,14.455083595203607,26.606326903074795
1999-07-27T09:30:00-04:00,40.375,40.96875,40.25,40.75,416900,342560,49.3123559385571,62.706012912176,NaN,NaN,-70.38574132261209,-48.24907069755831,-0.42944527635470275,0.43300210946832607,0.8624473858230288,5062100,4887420,70.00087486822807,85.40209491407776,NaN,NaN,11.700052835062335,24.476859179073013
1999-07-28T09:30:00-04:00,40.9375,41.4375,40.5625,41.125,475600,360950,51.560021611109335,61.33092291064637,NaN,NaN,-52.46027896777704,-62.403854265354575,-0.3830152242489169,0.3836783555118828,0.7666935797607997,5537700,4970760,71.21865699805065,84.24668900173275,NaN,NaN,10.234620619867945,22.442253670615145
1999-07-29T09:30:00-04:00,40.3125,40.9375,40.03125,40.4375,466600,368525,47.409338122998186,59.53359876539333,NaN,NaN,-95.65803556943051,-75.53205704354163,-0.3846999190232241,0.28581868098176955,0.6705186000049936,5071100,5064240,72.56399606781673,83.11845506650378,NaN,NaN,7.64838961719436,20.328844520126463
1999-07-30T09:30:00-04:00,40.8125,40.95312,40,40.01562,300900,359900,45.01458527648235,57.54782321840441,NaN,NaN,-102.79180378630636,-85.01686304039444,-0.3986256337250417,0.17223655784869152,0.5708621915737332,4770200,5017260,70.77351208932127,81.79824467433322,NaN,NaN,4.773944279074352,18.106715914261876
1999-08-02T09:30:00-04:00,39.8125,40.73437,39.78125,39.9375,319400,364770,44.56567937172775,55.67504003472323,NaN,NaN,-104.77190025133204,-85.2135519794916,-0.3966472650267366,0.07505311029031247,0.47170037531704906,4450800,4978380,69.2506141308466,80.30331886472568,NaN,NaN,2.348117040778745,15.855487503764287
1999-08-03T09:30:00-04:00,40.375,40.40625,39.26562,39.78125,470200,371885,43.62851668823842,53.57165781614651,NaN,NaN,-111.87206007532988,-93.51081573003515,-0.38888626904638407,-0.014407460990931042,0.374478808055453,3980600,4762080,61.342442797054794,78.19699683808312,NaN,NaN,0.08843371086961248,13.603051247636477
1999-08-04T09:30:00-04:00,39.75,40.1875,39.14062,39.29687,487600,368485,40.76652105270392,51.172824923496194,NaN,NaN,-112.89212867120916,-105.59718567072159,-0.3979618181052014,-0.12297346457604874,0.2749883535291527,3493000,4353140,49.77037195315865,75.22010459731712,NaN,NaN,-2.689174518505224,11.27559042390195
1999-08-05T09:30:00-04:00,39.14062,39.60937,38.53125,39.60937,879800,393515,43.34853262772415,48.84868108733978,NaN,NaN,-114.30642803281778,-109.32686416339902,-0.36535237671232007,-0.18170211736124742,0.18365025935107265,4372800,4213480,46.54124484290947,71.97238491761024,NaN,NaN,-4.303938171723013,9.049943481669812
1999-08-06T09:30:00-04:00,39.5625,40.3125,39.25,39.625,477200,411215,43.48123456121757,46.971180919842986,NaN,NaN,-81.39849259909492,-105.04820192595676,-0.32643786956697085,-0.22439707760764094,0.10204079195932993,4850000,4229440,46.964716822518334,68.73750126719182,NaN,NaN,-5.5943156902449305,6.957906457110564
1999-08-09T09:30:00-04:00,39.78125,39.89062,39.125,39.17187,210000,409995,40.51802175395416,46.01356875976451,NaN,NaN,-92.6232072254954,-102.61846332078942,-0.31478258227996114,-0.29143743589062154,0.023345146389339627,4640000,4267280,48.016139382347596,65.71840163896482,NaN,NaN,-7.542841857374491,4.886370983612699
1999-08-10T09:30:00-04:00,39.07812,39.25,37.9375,38.51562,699900,434985,36.62513805168472,44.624439377695516,NaN,NaN,-127.4114428687633,-105.72633987947611,-0.33306902601601174,-0.39299113613067505,-0.05992211011466331,3940100,4259180,47.79769647869548,62.772210923202984,NaN,NaN,-10.406449308050487,2.7016823705179585
1999-08-11T09:30:00-04:00,39.125,39.8125,38.75,39.75,636400,451710,46.94977262649797,44.58720814707162,NaN,NaN,-75.12092870670064,-98.1720998865744,-0.2477490396652109,-0.3696084096961769,-0.12185937003096603,4576500,4475880,53.84704726663009,60.86598410640118,NaN,NaN,-9.848697839614589,0.9087709119275944
1999-08-12T09:30:00-04:00,39.92187,39.9375,39.23437,39.25,417100,453265,43.83461068693757,44.27590364520142,NaN,NaN,-68.96964418753386,-89.10474311751761,-0.21208257439137873,-0.38696258802018946,-0.17488001362881073,4159400,4433200,52.55527604248556,59.26096716000524,NaN,NaN,-10.34806832983294,-0.6993489797524819
1999-08-13T09:30:00-04:00,39.98437,40.59375,39.90625,40.5,341600,465325,52.3471762090606,44.9543931842067,NaN,NaN,-1.3746726533162983,-73.0999791283619,-0.09724337845788483,-0.29643423670116675,-0.19919085824328192,4501000,4363400,50.42476734874996,57.93338264920094,NaN,NaN,-7.91596632358537,-1.7302943145857517
1999-08-16T09:30:00-04:00,40.6875,40.98437,40.28125,40.625,552000,481790,53.11247961047546,45.22583058934374,NaN,NaN,42.03456113959255,-46.1684254553443,-0.010373543656256284,-0.21215778781360228,-0.201784244157346,5053000,4446000,52.860135526078324,56.70904412476167,NaN,NaN,-5.759840698300845,-2.3059437979736224
1999-08-17T09:30:00-04:00,41.1875,41.25,40.1875,40.8125,348200,458785,54.298125389306804,45.42140943064355,NaN,NaN,65.81327762189177,-7.523481357213288,0.058424024551539694,-0.12875421346792137,-0.18717823801946107,5401200,4738220,60.29192317349565,55.92856313729346,NaN,NaN,-3.6526187639212533,-2.498325935966141
1999-08-18T09:30:00-04:00,40.85937,40.92187,40.32812,40.34375,184200,448110,50.837112172643245,45.66625043418962,NaN,NaN,53.62885592794376,18.22647556971559,0.07027426191800551,-0.09933541062195417,-0.16960967253995968,5217000,4866320,63.042545063940146,55.24845949415941,NaN,NaN,-2.8984291622988203,-2.5554835397279523
1999-08-19T09:30:00-04:00,39.9375,40.1875,39.67187,39.9375,268700,435680,47.98255610209548,45.878248350304844,NaN,NaN,-12.866679765324099,29.447068454157538,0.04963824127259256,-0.10756187094921899,-0.15720011222181154,4948300,5024100,66.15257901377515,54.91839284590613,NaN,NaN,-3.108482726682168,-2.6344834235785544
1999-08-20T09:30:00-04:00,40.1875,40.1875,39.78125,40.0625,208600,426040,48.93272693697438,46.19018031925104,NaN,NaN,1.314345887255984,29.98487216227199,0.043512236080860356,-0.10280981712073611,-0.14632205320159647,5156900,5155280,68.52417422552475,54.86650428124028,NaN,NaN,-3.0088425900111244,-2.687963304497493
1999-08-23T09:30:00-04:00,40.5,41.10937,40.39062,40.98437,292500,422670,55.40274078540838,47.03119632619174,NaN,NaN,99.09509634413888,41.39697920318126,0.09755717136341313,-0.024375588997330055,-0.12193276036074319,5449400,5234560,69.89696987213586,55.477541929460365,NaN,NaN,-0.9424016515933111,-2.4385973540826096
1999-08-24T09:30:00-04:00,41.1875,42,41,41.625,538600,428755,59.26509031920118,48.352522702370116,NaN,NaN,169.4129955034931,62.11692277950152,0.16831252931848492,0.08845790128736297,-0.07985462803112195,5988000,5351920,71.85395397079142,57.05494064500556,NaN,NaN,2.0468586877930925,-1.7978179195289379
1999-08-25T09:30:00-04:00,41.875,42.67187,41.5625,42.5,391800,424565,63.86789110909926,49.81819116532548,NaN,NaN,221.08731466227377,95.60861452636752,0.2604058712568137,0.24565271103989517,-0.014753160216918512,6379800,5584480,75.282993951233,59.10792272417153,NaN,NaN,6.1697450253538575,-0.6595946416885385
1999-08-26T09:30:00-04:00,42.6875,42.6875,41.9375,41.98437,226600,412565,59.594465412663965,50.969136226143085,NaN,NaN,180.42082924879077,134.2661163291905,0.2717054875189311,0.3248786991817454,0.053173211662814274,6153200,5825460,78.24115406497233,61.34195395577539,NaN,NaN,8.258741692408664,0.6144534060396334
1999-08-27T09:30:00-04:00,42.0625,42.34375,41.625,41.75,172100,406125,57.70450870993051,52.19674243728425,NaN,NaN,130.34916902225183,160.07308095618967,0.24910290156449993,0.3645518386184392,0.11544893705393926,5981100,5990300,80.00407785865293,63.62680670408291,NaN,NaN,9.38048930234481,1.8667442483689443
1999-08-30T09:30:00-04:00,41.9375,42.03125,40.90625,41.0625,431500,411730,52.44983868187845,53.327078196583805,NaN,NaN,74.34296259939467,155.12265420724083,0.17695048305357788,0.3366370408709116,0.15968655781733374,5549600,6010340,80.21396041754639,65.94225412828654,NaN,NaN,8.71765815956608,2.8454462356828207
1999-08-31T09:30:00-04:00,41.09375,41.625,40.5,41.42187,451300,410785,54.76846534159368,53.88555624766207,NaN,NaN,56.53554549066358,132.5471642046749,0.14392903021709788,0.3395978455887061,0.1956688153716082,6000900,6012920,80.24271247355199,67.82765878592382,NaN,NaN,8.87071778611949,3.7061993143166307
1999-09-01T09:30:00-04:00,41.71875,41.92187,41.375,41.64062,594400,416125,56.16949156566049,54.76661916757086,NaN,NaN,83.27402287968386,104.98450584815694,0.127863064435874,0.3554976459164507,0.22763458148057672,6595300,6056020,80.7460644672006,69.84128653054631,NaN,NaN,9.408117747328225,4.520759090461144
1999-09-02T09:30:00-04:00,41,41.67187,40.75,41.48437,289000,386585,54.86231069360995,54.94627163075295,NaN,NaN,51.541172519424656,79.20857450228371,0.09904362421300661,0.35143911174683495,0.25239548753382834,6306300,6086640,81.11418729616139,72.03338795536142,NaN,NaN,9.481874739922718,5.229489897527083
1999-09-03T09:30:00-04:00,42.5,43.10937,42.48437,43,450600,385255,63.68954628132206,55.70177639295628,NaN,NaN,152.59595695507338,83.65793208884801,0.1702110512937537,0.4651593016510205,0.2949482503572668,6756900,6241800,82.8984841610092,74.1789842864279,NaN,NaN,12.410420551802801,6.255337133852185
1999-09-07T09:30:00-04:00,43.1875,43.5625,43,43.01562,410700,395290,63.76818709160794,56.37820937169209,NaN,NaN,154.82155102566207,99.75364977410152,0.20420251628752795,0.5502013957166767,0.34599887942914875,7167600,6565400,85.8921634842648,76.00757288005427,NaN,NaN,14.741221261754198,7.467606294981044
1999-09-08T09:30:00-04:00,42.9375,43.35937,42.375,42.71875,200900,370340,61.061406379663936,57.10851610076499,NaN,NaN,119.61297056879097,112.36913478972697,0.19270311909313387,0.5868777782955661,0.3941746592024322,6966700,6758560,87.31912795017413,77.74161451478528,NaN,NaN,15.884581258868788,8.67003128982215
1999-09-09T09:30:00-04:00,43,43.28125,42.5,43.09375,186200,347830,63.18709076091899,58.194554290680955,NaN,NaN,117.68151961145774,119.25063413608174,0.1957317125873505,0.6388392999366204,0.44310758734926986,7152900,6870080,88.0694268269075,79.30710364429474,NaN,NaN,17.476556794982663,9.928106361987938
1999-09-10T09:30:00-04:00,43.6875,43.9375,43.21875,43.5625,168500,335400,65.70718268241517,59.392729701069584,NaN,NaN,145.2625826239518,137.9949161569872,0.2132441991332294,0.7096628362658066,0.4964186371325772,7321400,7073100,89.30951695656043,80.79177098222586,NaN,NaN,19.58921834411569,11.308265216577617
1999-09-13T09:30:00-04:00,43.5625,43.70312,42.96875,42.96875,403700,338505,60.09535682825447,59.72791656127287,NaN,NaN,105.26312296782345,128.5283493595372,0.17062458129054858,0.7096993637457629,0.5390747824552143,6917700,7105260,89.49577618889796,82.19168571913744,NaN,NaN,19.748600546929417,12.514027406627873
1999-09-14T09:30:00-04:00,43.125,43.54687,42.8125,43.4375,397400,330775,62.79678922238855,59.98018076864339,NaN,NaN,97.3662463195955,117.0372884183239,0.15996689603415626,0.7390334024979097,0.5790665064637535,7315100,7134760,89.67350751137567,83.46451097203631,NaN,NaN,20.692030036424836,13.682313496598868
1999-09-15T09:30:00-04:00,43.92187,43.92187,42.42187,42.53125,386300,332680,55.03908371631057,59.34955166915849,NaN,NaN,68.70495204688699,106.85568471394308,0.08178713972612872,0.6813004311214144,0.5995132913952856,6928800,7127180,89.25561228289128,84.46255513858333,NaN,NaN,19.077005241585443,14.452983745882664
1999-09-16T09:30:00-04:00,42.4375,42.78125,41.54687,42.34375,923900,369665,53.56469359963609,58.91885368251365,NaN,NaN,12.349309026756824,85.78924259700291,0.011066705848092107,0.6133466737054007,0.6022799678573086,6004900,6897580,77.47772304835718,84.40802435168224,NaN,NaN,17.318444337308943,14.862335258943562
1999-09-17T09:30:00-04:00,42.98437,43.35937,42.67187,43.1875,603700,386415,58.90022692631416,59.00426212654105,NaN,NaN,71.33930675056835,71.00458742232621,0.014515655312719145,0.6204245369982075,0.6059088816854884,6608600,6755020,71.19574443009887,83.7788576782141,NaN,NaN,17.432786215103842,15.22954253839503
1999-09-20T09:30:00-04:00,43.375,43.57812,42.90625,43.375,233000,387635,60.00014443211606,59.54356968012945,NaN,NaN,81.6432075117376,66.28060433110906,0.022358311731720537,0.6338567713501391,0.6114984596184185,6841600,6739800,70.53816921218423,83.08772973497393,NaN,NaN,17.857654420294857,15.604987092952149
1999-09-21T09:30:00-04:00,42.89062,43.0625,42.25,42.48437,655900,405805,52.775246856127005,59.40119693116755,NaN,NaN,13.020632337126576,49.41148153461526,-0.03631096346617935,0.5661097552856944,0.6024207187518738,6185700,6513920,61.4648527670615,81.7464540416532,NaN,NaN,15.937581384821842,15.652500563219247
1999-09-22T09:30:00-04:00,42.40625,42.90625,41.98437,42.5625,533600,405555,53.30642683308054,59.196692307411844,NaN,NaN,-3.488313979368638,34.972828329364134,-0.07168632846836631,0.5128128081664158,0.5844991366347821,6719300,6472020,59.92502887643487,80.25923721374136,NaN,NaN,14.561808286752095,15.496687380866797
1999-09-23T09:30:00-04:00,43,43,40.64062,41,936600,432795,42.91128528887286,58.3430476356449,NaN,NaN,-95.73730387407261,13.355505749198244,-0.1951448728954115,0.3405680455155178,0.5357129184109293,5782700,6427580,58.25799489901133,78.62665204251637,NaN,NaN,9.69618008280183,14.668043481143231
1999-09-24T09:30:00-04:00,40.65625,41.125,40.0625,41.09375,635800,453255,43.621678674405324,56.909628520865134,NaN,NaN,-149.0793198465282,-30.728219570221075,-0.2611975664896814,0.2092159602988275,0.4704135267885089,6418500,6389560,56.80212185657501,76.7626261636282,NaN,NaN,6.118054520764531,13.446616486803418
1999-09-27T09:30:00-04:00,41.875,42.09375,41.4375,41.51562,1041800,496740,46.828115907610105,55.69962343629386,NaN,NaN,-63.563631245012616,-59.76958732157111,-0.26627161963228074,0.13757400224815797,0.4038456218804387,7460300,6513300,60.28107176031738,74.93326246906052,NaN,NaN,4.142217369719868,12.117416612934338
1999-09-28T09:30:00-04:00,41.46875,41.875,40.5,41.70312,468000,498565,48.237196094048926,54.78360841589279,NaN,NaN,-92.54365777645395,-80.88244534428722,-0.24720951102873662,0.09483373309451792,0.34204324412325454,7928300,6861820,68.07878774693282,73.55895245454329,NaN,NaN,2.9542598378549143,10.80839421649442
1999-09-29T09:30:00-04:00,41.5625,41.8125,40.9375,40.9375,199800,485990,43.20264579225723,53.35614806098838,NaN,NaN,-104.73052568064955,-101.13088768454341,-0.27428104232641404,-0.0008080587847629772,0.27347298354165106,7728500,7063660,71.56095134820136,72.3797756346357,NaN,NaN,0.3473272836833904,9.313956083235702
1999-09-30T09:30:00-04:00,41.25,41.59375,40.75,41.25,385800,475560,45.6940680239336,51.92663987109684,NaN,NaN,-101.85424489226796,-102.35427588818247,-0.2594208692609352,-0.05080310303451796,0.20861776622641726,8114300,7529980,77.63194199831132,71.54566313761792,NaN,NaN,-1.0609473921368269,7.831827015325341
1999-10-01T09:30:00-04:00,41.0625,41.21875,40.35937,41,952500,508735,44.03010518376531,50.77912189649047,NaN,NaN,-124.84271555927657,-97.50695503073214,-0.2543638743410437,-0.10933707669988735,0.14502679764115634,7161800,7678640,79.15933514943299,70.80734592051327,NaN,NaN,-2.7169678168048303,6.324856325021031
1999-10-04T09:30:00-04:00,41.25,42,41.125,42,243200,498365,51.619374325172615,49.9807351181179,NaN,NaN,-48.48864475232594,-94.4919577321948,-0.1753645910994507,-0.07417894123315705,0.10118564986629366,7405000,7667580,78.72860941411021,70.02556748499431,NaN,NaN,-1.8479200429810878,5.157316843877871
1999-10-05T09:30:00-04:00,42.25,42.71875,41.5,42.25,613100,508485,53.32337439417184,49.858184452250846,NaN,NaN,-7.8601587424429225,-77.55525792539261,-0.10162454349315794,-0.02584502950015377,0.07577951399300417,8018100,7685540,78.92911082579235,69.28796023805867,NaN,NaN,-0.6174460827181231,4.332350711507015
1999-10-06T09:30:00-04:00,42.4375,42.89062,42.28125,42.76562,482800,522580,56.709949048417336,50.082845555735226,NaN,NaN,35.371225966741946,-49.534907595914305,-0.017863587285522953,0.05345002988610048,0.07131361717162343,8500900,7840020,80.62111327911788,69.51248811168445,NaN,NaN,1.4707378955010544,3.9235488806490206
1999-10-07T09:30:00-04:00,42.98437,43,42.26562,42.54687,948300,560685,54.89041289269099,49.79643026761928,NaN,NaN,34.063128275397304,-22.35143296238126,0.020962329514431582,0.0975165290646629,0.07655419955023132,7552600,7727680,75.85102494737026,69.8450081486324,NaN,NaN,2.661511903940535,3.74325788397638
1999-10-08T09:30:00-04:00,42.53125,42.65625,41.625,42.51562,532300,578875,54.6207966166536,49.412191137943395,NaN,NaN,10.58640227987516,4.734390605449088,0.04150655001119993,0.12843738706423125,0.08693083705303131,7020300,7699380,74.65274005895607,70.13890606625897,NaN,NaN,3.5571842056437446,3.7166759299288605
1999-10-11T09:30:00-04:00,42.73437,43.20312,42.625,42.9375,619100,589645,57.64543483007965,49.76006170751144,NaN,NaN,76.65751814210822,29.763623184335916,0.07833829163658998,0.1848537015987688,0.10651540996217881,7639400,7746260,75.34751661330048,71.13052491241889,NaN,NaN,5.195181276667045,3.927890979462887
1999-10-12T09:30:00-04:00,42.9375,43.125,42.0625,42.17187,235900,581570,51.00165103921525,49.595434865092486,NaN,NaN,36.3475428801604,38.60516350885658,0.047485292433156426,0.16587202550362434,0.11838673307046792,7403500,7623340,69.93466332171288,71.84549880136731,NaN,NaN,4.714621290114765,4.040281023841727
1999-10-13T09:30:00-04:00,41.8125,42.0625,40.75,41.0625,529300,588720,43.227501894089436,49.618021765465095,NaN,NaN,-74.1923134794456,16.692455619619096,-0.04621873819747466,0.0606133103236246,0.10683204852109926,6874200,7298000,58.04835879075191,71.8305247936345,NaN,NaN,1.7554271586505596,3.7138733288144175
1999-10-14T09:30:00-04:00,41.125,41.3125,40.3125,40.82812,700500,577550,41.77856017411349,49.486370444015684,NaN,NaN,-107.28520877632604,-11.57721179072557,-0.11845929805836615,-0.041242074051858424,0.07721722400650773,6173700,7022220,50.25159769634496,71.36263021076093,NaN,NaN,-1.0912888542324723,3.0274215883791475
1999-10-15T09:30:00-04:00,40.01562,40.5,39.53125,39.85937,1048800,599805,36.35449668587626,48.73825478532041,NaN,NaN,-167.14299459056346,-47.123091164813296,-0.22005578581318808,-0.19785250825997736,0.022203277553210707,5124900,6643140,41.91727820836242,70.05093067133558,NaN,NaN,-5.416623832297727,1.8211293854253083
1999-10-18T09:30:00-04:00,39.76562,39.96875,38.46875,39.5,1505900,663450,34.561895670983304,47.7614476122443,NaN,NaN,-200.27444268923026,-102.50948333108099,-0.29533538505896845,-0.3469659537704999,-0.05163056871153142,3619000,5839060,30.40005639500815,67.35959271762667,NaN,NaN,-9.521348780626308,0.20077536170364896
1999-10-19T09:30:00-04:00,39.9375,40,38.67187,38.875,1473900,704350,31.639875875704448,46.93553547534766,NaN,NaN,-181.05475098019124,-145.98994210315132,-0.3664525444011638,-0.5096962492129862,-0.14324370481182236,2145100,4787380,21.917669629876784,63.81364402346063,NaN,NaN,-13.95084599281667,-1.8208848317992539
1999-10-20T09:30:00-04:00,39.875,40.45312,39.5625,40.4375,398400,697590,44.314911891809075,46.83702432305305,NaN,NaN,-92.84749876091595,-149.72097915944536,-0.2907963289678384,-0.5067391160216204,-0.21594278705378195,2543500,3921240,17.569614209296006,59.523477752816675,NaN,NaN,-13.586766027341291,-3.501725002590973
1999-10-21T09:30:00-04:00,39.125,39.84375,38.875,39.78125,680900,684805,40.8860099670176,46.61244609328536,NaN,NaN,-124.99994418958819,-153.26392624209782,-0.26804408746666747,-0.5509978963871163,-0.2829538089204488,1862600,3059020,14.488318615540038,54.90411942896718,NaN,NaN,-14.478036464109106,-5.069769497093564
1999-10-22T09:30:00-04:00,40.25,40.4375,39.85937,39.875,199700,663000,41.58142294430474,45.8954495660805,NaN,NaN,-77.94228070175338,-135.4237834643358,-0.23116956744333172,-0.5719157682246134,-0.3407462007812817,2062300,2446500,12.77437105906671,50.19310240360693,NaN,NaN,-14.941114702090404,-6.479961669235969
1999-10-25T09:30:00-04:00,39.625,40.23437,39.57812,39.98437,162500,619035,42.432254054035475,45.11751239892791,NaN,NaN,-76.94410727126478,-110.7577163807427,-0.18585278599435417,-0.5730621832742244,-0.38720939727987025,2224800,2167660,12.074118874948468,45.41774583568951,NaN,NaN,-15.048362020972863,-7.70401886234124
1999-10-26T09:30:00-04:00,40.6875,40.76562,39.96875,40,491200,620195,42.56100329619391,44.106873416626236,NaN,NaN,-50.84458412423358,-84.71568300955119,-0.14317881091638862,-0.566182910925356,-0.4230041000089674,2716000,2281840,14.149404626783095,40.66976664623702,NaN,NaN,-15.09725554284983,-8.760195530985325
1999-10-27T09:30:00-04:00,39.98437,40,39.32812,39.95312,649300,642670,42.255747057336436,43.20439728552948,NaN,NaN,-74.3161253309289,-81.00940832355377,-0.10806124465415767,-0.5580806558266644,-0.45001941117250677,2066700,2186480,13.855276034214029,36.24149886672587,NaN,NaN,-15.220673609843255,-9.683120970822172
1999-10-28T09:30:00-04:00,40.6875,40.98437,40.125,40.98437,340200,640390,50.642054965012555,42.92020145326942,NaN,NaN,-14.314724114681889,-58.8723643085725,-0.010470778571310402,-0.46310788438664474,-0.45263710581533434,2406900,2295340,16.00189681197044,32.052152920512604,NaN,NaN,-12.815281304652082,-10.130572447083587
1999-10-29T09:30:00-04:00,41.6875,42.75,41.6875,42.5,816800,633605,59.86723816155522,43.07890169123196,NaN,NaN,77.02652435848057,-27.878603296525718,0.1520965023476264,-0.26251647788080135,-0.41461298022842774,3223700,2527620,20.55117301499456,28.138128377776475,NaN,NaN,-7.390781919498787,-9.739173800285759
1999-11-01T09:30:00-05:00,42.625,42.96875,42.40625,42.4375,230800,632985,59.374417622060655,43.67695644714949,NaN,NaN,87.70241966150827,5.050702090028895,0.24580871800489595,-0.10735208272230778,-0.35316080072720374,2992900,2681240,23.50199860925136,24.821509469743514,NaN,NaN,-3.3062819219652315,-8.82018924623997
1999-11-02T09:30:00-05:00,42.4375,42.9375,42.125,42.25,156300,610145,57.83624318469895,44.72043796790731,NaN,NaN,76.5463847876763,30.528895872410875,0.28291390773605457,0.0004815839428644608,-0.2824323237931901,2836600,2705360,23.97941954493392,22.38801380932794,NaN,NaN,-0.4487659779902371,-7.6242716364900085
1999-11-03T09:30:00-05:00,42.875,43.125,42.625,42.875,209200,596465,61.423726784349235,46.12366415435272,NaN,NaN,99.14357954055846,65.22083684670835,0.33380082874644657,0.13481871213986807,-0.19898211660657847,3045800,2901180,27.912868694720558,20.792390309211914,NaN,NaN,3.1288495366545046,-6.088111468897935
1999-11-04T09:30:00-05:00,43.4375,43.46875,42.90625,43.20312,409100,569505,63.194257933328906,48.0407899577422,NaN,NaN,111.98611649859023,90.48100496936277,0.37095130779628593,0.26470701813877895,-0.10624428965750697,3454900,3110780,31.970376303807498,20.081897316029423,NaN,NaN,6.6421285345688545,-4.269505754116965
1999-11-05T09:30:00-05:00,44.25,44.25,43.46875,43.67187,898000,587790,65.62176310554119,50.25935191735346,NaN,NaN,131.3294645221819,101.34159300210304,0.4056737666407826,0.40084791864347125,-0.004825847997311325,4352900,3336620,36.14115304088699,20.49197564787791,NaN,NaN,10.370465774430683,-2.17808125003873
1999-11-08T09:30:00-05:00,43.1875,44.29687,43.1875,44.10937,377100,575690,67.75910101375254,52.83929657007119,NaN,NaN,127.3965566564771,109.2804204010968,0.4341352662225187,0.5378432347808371,0.10370796855831836,4730000,3684040,42.029145068388765,21.928509607771623,NaN,NaN,14.18281721793255,0.159189959671453
1999-11-09T09:30:00-05:00,44.48437,44.5,43.5,43.625,981500,612970,63.082980896131396,54.17987292752279,NaN,NaN,117.79317307998868,117.52977805955928,0.3973594471629778,0.6004072775120406,0.20304783034906282,3748500,3866420,44.90121645438838,23.88076691099251,NaN,NaN,16.05999770768297,2.4307339236730985
1999-11-10T09:30:00-05:00,43.5,44.73437,43.5,44.39062,583900,615700,66.96384339516169,56.04257531524736,NaN,NaN,113.86125782564139,120.47331371657587,0.40048776887803206,0.7036575414466029,0.3031697725685708,4332400,4123740,48.75855624619829,26.328641027468098,NaN,NaN,18.916420536540894,4.78583201122564
1999-11-11T09:30:00-05:00,44.71875,45.25,44.67187,45,295500,595450,69.69459000589376,58.05065867678944,NaN,NaN,125.52195202626575,123.18048082211097,0.4175795767348309,0.8251442434871095,0.40756466675227854,4627900,4358340,52.0541669442027,29.134340733549234,NaN,NaN,22.214803500122006,7.275685081067978
1999-11-12T09:30:00-05:00,45.60937,45.625,44.03125,45.25,439300,564975,70.76234335976754,60.074236484341725,NaN,NaN,112.2693038088413,119.36844867944285,0.41864090603103854,0.9308657992910767,0.5122248932600382,5067200,4501200,53.99456576445102,32.128658368513705,NaN,NaN,25.240518448582627,9.842089847855785
1999-11-15T09:30:00-05:00,45.34375,45.34375,44.85937,45.04687,187300,499045,68.6460064777394,61.93745099730926,NaN,NaN,107.5411326607453,115.39736388029648,0.37972713997907737,0.9868838182338848,0.6071566782548075,4879900,4531180,54.41153191280572,35.004524603229605,NaN,NaN,27.120746632085968,12.310469388460097
1999-11-16T09:30:00-05:00,45.40625,46,45.03125,46,255600,438130,72.76237776681053,64.11649604798598,NaN,NaN,120.6088906855161,115.96050740140197,0.39072201953046837,1.0955592026678929,0.7048371831374245,5135500,4808580,58.18773122429776,38.171128545378444,NaN,NaN,30.10756948483635,14.85291225937099
1999-11-17T09:30:00-05:00,46.1875,46.375,45.5,45.5625,515600,443990,68.32801631611542,65.3797790016362,NaN,NaN,114.36694461088044,116.06164475844977,0.3427850091484318,1.1333184445729643,0.7905334354245325,4619900,4866080,58.9468203687869,41.23862308515105,NaN,NaN,31.247789747469817,17.19503761481368
1999-11-18T09:30:00-05:00,46.25,47.10937,45.90625,47.10937,752800,447585,74.29329863826588,66.4102118928298,NaN,NaN,135.66324327548168,118.08990300829296,0.3862801503286699,1.27338362333537,0.8871034730067,5372700,5015040,60.92590548331423,44.122532547173876,NaN,NaN,34.35953216969107,19.647108265510447
1999-11-19T09:30:00-05:00,47.15625,47.625,46.75,47.54687,445300,459865,75.68801252421444,67.57546867155507,NaN,NaN,143.6437918171595,124.36480060995659,0.413125293291583,1.4035100896211787,0.9903847963295958,5818000,5165200,62.86912615699597,46.934470229155636,NaN,NaN,37.325350032980545,22.172571375149033
1999-11-22T09:30:00-05:00,47.4375,48,47.375,47.84375,436200,473550,76.61518448201348,68.91682162136325,NaN,NaN,147.55443867056644,132.36746181192083,0.4182116371862299,1.5131493428123832,1.0949377056261533,6254200,5440060,66.18421129640558,49.949098211403616,NaN,NaN,40.00218981745613,24.719659724050047
1999-11-23T09:30:00-05:00,48.23437,48.23437,46.78125,47.42187,585000,478240,72.39031800114424,69.70014956542003,NaN,NaN,123.49233523107156,132.94415072103192,0.36257057984888474,1.5481509304372594,1.1855803505883746,5669200,5546800,67.40140241015948,52.7697077625064,NaN,NaN,40.89179813669004,27.029965211570044
1999-11-24T09:30:00-05:00,47.28125,48.32812,47.01562,48.15625,626700,477110,74.97705969648486,70.54177826278833,NaN,NaN,124.99221666074872,135.0692051310056,0.3447470003465578,1.616514101021572,1.2717671006750142,6295900,5882000,70.93902085471855,55.55318237328576,NaN,NaN,42.470262957381436,29.235722032400243
1999-11-26T09:30:00-05:00,48.39062,49,48.39062,48.53125,425900,481395,76.20310646437781,71.29758850270522,NaN,NaN,142.9398112765576,136.52451873122078,0.32784048462277116,1.6815677064534782,1.353727221830707,6721800,6151820,73.43781605966387,58.21722973176981,NaN,NaN,44.14620229291751,31.365790641045567
1999-11-29T09:30:00-05:00,48.375,48.8125,48.07812,48.10937,353200,458215,71.9329951749549,71.59572379993396,NaN,NaN,114.86170933598883,130.76810223498666,0.26079279947703826,1.679718221177005,1.4189254216999667,6368600,6261940,74.40509276538461,60.52979742441238,NaN,NaN,44.23743771309962,33.204597365624714
1999-11-30T09:30:00-05:00,47.875,48.10937,46.46875,46.67187,436200,468485,59.6646212227754,71.3515552518371,NaN,NaN,59.54272538056854,113.16575957698709,0.10042345591043644,1.5444547415880123,1.4440312856775759,5932400,6197580,72.73791348475734,62.518132926581586,NaN,NaN,40.17315907114147,34.20010618069853
1999-12-01T09:30:00-05:00,46.5,47.46875,46.5,47.125,900500,505695,61.87212333359137,70.98786096172493,NaN,NaN,51.12940042081316,98.69317261493539,0.010395435148119692,1.4570255796127256,1.446630144464606,6832900,6430320,74.92590014954075,64.38722891967748,NaN,NaN,37.58280423269774,34.683348759555564
1999-12-02T09:30:00-05:00,47.625,48.53125,47.625,48.25,208600,505665,66.73914018015337,70.77675740274347,NaN,NaN,88.55495124912821,91.40571953261129,0.012028890883954535,1.461666258069549,1.4496373671855944,7041500,6579440,76.24158705978205,66.114901785076,NaN,NaN,36.95388844142041,35.00771157125054
1999-12-03T09:30:00-05:00,49.625,50.125,49.34375,49.625,623100,516365,71.52366848965639,70.8311377691641,NaN,NaN,141.74652555802737,91.16706238890524,0.08695535554100542,1.5583315616118512,1.4713762060708457,7664600,6768000,77.82600416523991,67.81714738513236,NaN,NaN,38.10552817881393,35.45025680090245
1999-12-06T09:30:00-05:00,49.46875,50.34375,49.3125,49.96875,347400,488835,72.5853942471095,71.11252260983339,NaN,NaN,137.84762195625893,95.76424491295927,0.13788253452440058,1.6437293742263464,1.5058468397019458,8012000,7096680,80.29306355345405,69.66582821660724,NaN,NaN,39.363379461653366,36.00927432386687
1999-12-07T09:30:00-05:00,50.3125,50.3125,49.53125,50.09375,204500,480205,72.9799124576525,71.1280608020364,NaN,NaN,132.5744913655223,110.37059810995001,0.15682336316842194,1.7018760436624731,1.5450526804940512,8216500,7553500,83.10635941495806,71.44573023022583,NaN,NaN,40.471878921506956,36.64678926638688
1999-12-08T09:30:00-05:00,49.5625,50.125,49.5,49.5625,407900,451525,68.47008885942542,71.13820884084426,NaN,NaN,112.60100587290393,122.66491920036817,0.1124850835154414,1.685659034888353,1.5731739513729115,7808600,7748640,84.14743375561575,73.24577404357073,NaN,NaN,39.982036461826894,37.12325315144974
1999-12-09T09:30:00-05:00,50.0625,50.25,48.59375,49.4375,1187500,481705,67.41447489658103,70.64686428786676,NaN,NaN,90.53171126697181,123.06027120393689,0.05647852025408917,1.643772101690523,1.5872935814364337,6621100,7664560,81.80813300850582,74.73736172394158,NaN,NaN,39.27339541477111,37.43041633192422
1999-12-10T09:30:00-05:00,49.8125,50,48.8125,49.6875,226600,478260,68.46174002433348,70.1307019664467,NaN,NaN,86.20921360284456,111.95280881290034,0.019897357431386986,1.6121652782256675,1.5922679207942805,6847700,7501180,77.31059275652046,75.76889505247904,NaN,NaN,38.984165125422706,37.652380445281146
1999-12-13T09:30:00-05:00,49.67187,50.4375,49.3125,50.01562,377000,475145,69.83215949231449,69.64620018146819,NaN,NaN,97.94938495675073,103.9731614129987,0.0023493900687845404,1.5952046583802613,1.5928552683114767,7224700,7343720,73.13734828823853,76.26554769475283,NaN,NaN,39.12524548399334,37.86278973652575
1999-12-14T09:30:00-05:00,50.1875,50.1875,48.8125,49.0625,716100,501585,61.47575887542772,68.86658881534558,NaN,NaN,61.4989750278883,89.7580581454719,-0.08412014399285295,1.4877050883204106,1.5718252323132635,6508600,7002140,64.94702648200995,76.09023512845643,NaN,NaN,36.740327231081125,37.70243795003366
1999-12-15T09:30:00-05:00,48.9375,50.0625,48.125,50.0625,1248400,551225,66.06414237969888,68.22995186414659,NaN,NaN,58.362847192341135,78.91042640935935,-0.08442022258970305,1.4662999540761348,1.5507201766658378,7757000,6991820,64.71124296364351,75.6453938505225,NaN,NaN,36.04075221717616,37.465054273911164
1999-12-16T09:30:00-05:00,50.4375,51.125,50.3125,51,419400,546415,69.70686271440483,67.76593445343424,NaN,NaN,131.46927981881956,87.0979401197289,-0.03449141848995252,1.5076059035533973,1.5420973220433498,8176400,7302880,68.43137988419127,75.28779126656015,NaN,NaN,36.60863576488405,37.34270877262158
1999-12-17T09:30:00-05:00,51.75,51.84375,51.1875,51.5625,397700,528660,71.67168670232223,67.7472695625319,NaN,NaN,158.55547583770684,101.56719256670135,0.020449514762529875,1.567659215496512,1.5472097007339822,8574100,7648160,71.96438733116803,75.1134551641161,NaN,NaN,37.70726905297626,37.394788812672246
1999-12-20T09:30:00-05:00,51.75,52.25,51.375,52.0625,289200,520855,73.32772946512218,68.72320586555666,NaN,NaN,163.80193696983588,114.73770296931839,0.07161664639092269,1.6367305087226356,1.565113862331713,8863300,7975880,74.84229098136045,75.26376784244489,NaN,NaN,39.13826229562428,37.64385645309397
1999-12-21T09:30:00-05:00,52.1875,53.21875,51.8125,53.0625,381800,518135,76.31050951224059,69.75451916403162,NaN,NaN,190.7357835774207,140.58506467922487,0.14948176976754501,1.7519660745411443,1.6024843047735993,9245100,8523180,78.7630147802615,75.53784745892496,NaN,NaN,41.35947210966745,38.174658689747325
1999-12-22T09:30:00-05:00,53.5,53.6875,52.35937,53.0625,307700,504270,76.31050951224059,70.43818840203785,NaN,NaN,182.34153840624347,165.38080292200533,0.17584049570446436,1.8222849244041797,1.6464444286997153,9245100,8820800,80.53915856664487,75.8448168522723,NaN,NaN,43.10323533962573,38.87874106830138
1999-12-23T09:30:00-05:00,53.5625,54,53.28125,53.34375,359200,490895,77.14422726387275,70.83965688591044,NaN,NaN,174.191744727801,173.9252959038016,0.18608218349169858,1.8790471580643384,1.6929649745726398,9604300,9106380,82.08725417886015,76.14919185324517,NaN,NaN,44.79161954285406,39.723437993237475
1999-12-27T09:30:00-05:00,53.9375,53.9375,52.625,53.75,626000,500900,78.33053417496993,71.25002402361477,NaN,NaN,139.20455052759735,170.0551108417797,0.19323822684871717,1.9345127581335362,1.741274531284819,10230300,9437620,83.70628783140859,76.39299358738478,NaN,NaN,46.567659767942175,40.70118396105243
1999-12-28T09:30:00-05:00,53.625,53.9375,53.125,53.25,700400,518260,73.28858132383641,71.27207179977076,NaN,NaN,119.0790500712792,161.1105334620684,0.1398099295963422,1.9160369432802469,1.7762270136839047,9529900,9570940,84.32056086252052,76.47972226221067,NaN,NaN,46.62865863552928,41.54796605740626
1999-12-29T09:30:00-05:00,53.375,54.25,53.375,54.10937,583500,525625,76.13222101416315,71.8193669536806,NaN,NaN,121.71048014773515,147.30547277613127,0.13764250354538743,1.948280143115639,1.8106376395702515,10113400,9744600,85.10811472417072,76.54834233139317,NaN,NaN,47.5385293660967,42.40376081579061
1999-12-30T09:30:00-05:00,55,55,53.9375,54.0625,1689800,565090,75.6591368148849,72.40827137641658,NaN,NaN,122.29217383891438,135.29559986266545,0.10957018376456729,1.9476003692759605,1.8380301855113932,8423600,9580300,80.96461379643628,76.48809095910248,NaN,NaN,48.137791232720744,43.2229080182092
1999-12-31T09:30:00-05:00,54.15625,54.4375,53.8125,53.875,755300,592425,73.68649230270123,72.78146796772856,NaN,NaN,100.05593452563156,120.46843782223156,0.05750836517001945,1.9099156419739174,1.852407276803898,7668300,9193100,72.06076444014467,76.1131032222185,NaN,NaN,48.089093695039395,43.91807740061352
2000-01-03T09:30:00-05:00,55.625,55.625,53.5,55.4375,938100,608175,78.67601732356532,73.41317209853219,NaN,NaN,116.62527663112022,115.95258304293614,0.10468939851560077,1.9832690249483989,1.878579626432798,8606400,8868320,65.54915608296892,75.57108949327066,NaN,NaN,49.61004279293032,44.731215313801634
2000-01-04T09:30:00-05:00,54,54.75,52.3125,52.625,545500,618080,57.529877576351105,73.13132343431243,NaN,NaN,50.53396118375864,102.24356526543201,-0.06784026644521268,1.7937792933762822,1.8616195598214949,8060900,8574520,60.24565867132632,75.23527750679328,NaN,NaN,43.02618952531802,44.48764020116112
2000-01-05T09:30:00-05:00,51.75,53.0625,50.125,51.84375,1906000,703155,53.24854779922272,72.21592382142127,NaN,NaN,-12.518915166700655,75.39768620254486,-0.23925179915237593,1.562554810881025,1.801806610033401,6154900,7782820,48.79000968940538,74.09804655863341,NaN,NaN,36.26514975039319,43.31299870819427
2000-01-06T09:30:00-05:00,51.25,52.09375,49.625,50.125,1670000,766260,45.26720013133195,70.47023363691606,NaN,NaN,-58.4499793034038,39.24925557408124,-0.46026058901926925,1.2264808737593142,1.6867414627785835,4484900,6995080,40.5316284014795,72.10520716701113,NaN,NaN,27.413676976243508,41.0416670322013
2000-01-07T09:30:00-05:00,49.625,51,49.125,51,685900,741180,49.42341496761724,68.88107137015143,NaN,NaN,-72.39073305127874,4.7599220586991295,-0.5341942403402176,1.0189986623533116,1.5531929026935292,5170800,6495580,36.33217557220519,69.56004918422808,NaN,NaN,22.028217132099297,38.325459903615304
2000-01-10T09:30:00-05:00,53,53.4375,52.0625,52.9375,1020500,780875,57.177653039291336,67.72749448259208,NaN,NaN,25.803169842470155,-13.404499299030878,-0.4430445154312943,0.9993872584044112,1.4424317738357055,6191300,6012560,32.793794300763096,66.55658513561399,NaN,NaN,20.45966915526502,35.7732040824224
2000-01-11T09:30:00-05:00,53,53.46875,51.1875,51.4375,1411300,832590,50.69716737472916,65.8979700441984,NaN,NaN,-15.890206589425024,-26.689332853667604,-0.47156537899931394,0.8529750500865632,1.324540429085877,4780000,5356380,28.70402688423364,62.98094314304057,NaN,NaN,16.68969739750423,33.04698884171981
2000-01-12T09:30:00-05:00,52.375,52.375,50.625,51.21875,1983200,895945,49.810534325089876,64.00511467368764,NaN,NaN,-56.679475858576936,-35.52144499204287,-0.490757163570406,0.7110939746228695,1.2018511381932755,2796800,4684760,25.23508496681916,59.030652171624446,NaN,NaN,13.57206005943555,30.264856158536343
2000-01-13T09:30:00-05:00,51.875,52,50.875,51.6875,1193000,893175,51.75754151592288,62.19177997740551,NaN,NaN,-61.99021044970609,-36.22949122130333,-0.45810241837999,0.6292231152182879,1.0873255335982779,3989800,4585740,24.75998117640576,54.93584695716341,NaN,NaN,11.788124321070471,27.62532303889836
2000-01-14T09:30:00-05:00,53.25,53.71875,52.78125,52.875,1383900,941400,56.37465816837376,60.62350311979149,NaN,NaN,28.94614715077599,-15.962115180892383,-0.3477500345265152,0.6526379904401338,1.000388024966649,5373700,4626320,25.380011182652154,50.76968433939509,NaN,NaN,11.862692122135982,25.373518622218022
2000-01-18T09:30:00-05:00,52.75,53.71875,52.60937,53.15625,550800,949055,57.41421834610324,59.48962004995341,NaN,NaN,27.407081669660872,-15.64133281545424,-0.2515252954861771,0.6859814056089277,0.9375067010951048,5924500,4572960,25.08725543824484,46.538733951946824,NaN,NaN,12.255979282495028,23.499584430829024
2000-01-19T09:30:00-05:00,52.9375,53.46875,52.5625,53.25,790400,974115,57.77541161231439,58.17841937839278,NaN,NaN,19.63285287696774,-8.536720922175686,-0.18059228528014892,0.7117663444949187,0.8923586297750676,6714900,4959940,31.278312599117882,42.693748085871626,NaN,NaN,12.677205507242606,21.953530298888108
2000-01-20T09:30:00-05:00,54.25,54.4375,53.125,53.5625,1095600,1009805,59.023020313939085,56.990125342610945,NaN,NaN,58.18492574180084,14.436159397899871,-0.11485834602316358,0.7487856972461131,0.8636440432692767,7810500,5962680,44.15677704487291,40.06461688933138,NaN,NaN,13.388846053417247,20.730003978106556
2000-01-21T09:30:00-05:00,53.875,53.875,53.14062,53.625,1434700,1066155,59.282147224525026,55.96124355131264,NaN,NaN,44.42312639271839,35.718826766384765,-0.07152159598071095,0.774242048293388,0.845763644274099,9245200,7013760,53.9074227617766,38.76794962659081,NaN,NaN,14.042667765884136,19.774670233503354
2000-01-24T09:30:00-05:00,53.9375,54.34375,51.59375,51.875,568900,1076640,49.78829363871397,53.89783471668041,NaN,NaN,-16.580981491625778,26.613401037904413,-0.16000125776502494,0.6457620720678179,0.8057633298328428,8676300,7674280,58.778465493701944,38.2843288702146,NaN,NaN,11.781854422477503,18.632839403356805
2000-01-25T09:30:00-05:00,51.76562,53.03125,51.0625,52.98437,2982400,1194460,54.73693124543869,53.698338550186655,NaN,NaN,-29.597273399582942,15.21253002405565,-0.1436196540759569,0.6262387622378967,0.7698584163138535,11658700,8821120,65.57995358797852,38.66534993568977,NaN,NaN,11.36076467560985,17.59397158510724
2000-01-26T09:30:00-05:00,52.6875,52.75,50.9375,51.25,839300,1201405,46.946924458427794,53.248222597272736,NaN,NaN,-69.82945737253468,-2.6799320258448347,-0.24352529648510435,0.4654517957074731,0.7089770921925774,10819400,9642020,69.46383838856944,40.142051985630054,NaN,NaN,8.390748411898402,16.279225417505977
2000-01-27T09:30:00-05:00,51.875,52.125,49.71875,50.75,1238100,1234135,44.960371196479855,53.2263062447833,NaN,NaN,-107.46153681916259,-35.80922453803752,-0.33175065993155595,0.29428876727813247,0.6260394272096884,9581300,9996180,70.98498683063158,42.31729187342663,NaN,NaN,5.362844915789126,14.719742488689285
2000-01-28T09:30:00-05:00,50.125,51.125,48.125,48.9375,2457000,1272495,38.586274961913084,52.45222481580443,NaN,NaN,-173.08066942797853,-79.30998370217691,-0.4910346883718645,0.012246066744857842,0.5032807551167223,7124300,9572000,66.69936159352274,44.48637658923503,NaN,NaN,0.49494119668530817,12.687628018403002
2000-01-31T09:30:00-05:00,48.9375,50.5625,47.875,50.5625,1312300,1300345,45.98059970344233,51.652435291815216,NaN,NaN,-138.3858861726903,-103.67096463838982,-0.4660145926658822,-0.07923748571563038,0.3867771069502518,8436600,9524060,66.21281741797543,46.87344966903591,NaN,NaN,-1.087469316309596,10.719756970586916
2000-02-01T09:30:00-05:00,50.51562,51.75,50.03125,51.625,474900,1277185,50.202436407674746,51.61709736559705,NaN,NaN,-47.62368552735331,-107.27624706394388,-0.3616231316455726,-0.0652518076067139,0.2963713240388587,8911500,8974620,60.74379793906077,49.1620047443807,NaN,NaN,-0.9194047154535624,9.057019586866847
2000-02-02T09:30:00-05:00,51.4375,52.65625,51.4375,52,534700,1276645,51.63902923958885,51.74770414520412,NaN,NaN,12.720563614359564,-90.76624286656504,-0.25600604101929897,-0.02363622723526504,0.23236981378403393,9446200,8699980,58.157940253246515,51.5136372648398,NaN,NaN,-0.31713722013420004,7.71785432872384
2000-02-03T09:30:00-05:00,52.25,53.5,51.76562,53.5,1244600,1243575,56.98460172911797,52.12106558900377,NaN,NaN,64.91134296519456,-56.2916669096936,-0.0827790105679424,0.1288960505741059,0.21167506114204832,10690800,8921880,59.652447641514534,54.005956298061854,NaN,NaN,1.9986367695766987,6.900823248845677
2000-02-04T09:30:00-05:00,53.75,54.625,53.625,54.125,691700,1194660,59.01730135636483,52.309825816717414,NaN,NaN,127.71559883324511,3.867586742551123,0.06809198743232306,0.29679004543245213,0.22869805800012907,11382500,9773520,64.842652971228,56.82471642581727,NaN,NaN,4.529598699129704,6.562076884600538
2000-02-07T09:30:00-05:00,54.25,54.875,53.8125,54.75,655300,1193130,61.00192044188562,52.566090252130444,NaN,NaN,135.1659316588555,58.57795030886028,0.19688655496993707,0.4748062517125504,0.27791969674261335,12037800,10493760,68.52966519908874,59.92774569444898,NaN,NaN,7.228282575903072,6.657249126215186
2000-02-08T09:30:00-05:00,55.1875,55.75,55.07812,55.25,886000,1186405,62.56378446184976,52.90811688424011,NaN,NaN,163.44222107145822,100.7911316286226,0.29666646726980256,0.6487527808298665,0.352086313560064,12923800,11296220,72.04702904360278,62.83979686905504,NaN,NaN,9.9213311768891,7.123546562025745
2000-02-09T09:30:00-05:00,55.75,56.125,54.25,54.5625,1623300,1197005,59.061192151161976,52.91084344404175,NaN,NaN,124.4057942734255,123.12817776043578,0.296570289220842,0.7227991750861165,0.42622888586527446,11300500,11667080,73.5200353839129,64.93717246470077,NaN,NaN,11.141246277571515,7.697503664246569
2000-02-10T09:30:00-05:00,54.6875,55.875,54.5,55.85937,1157600,1155725,63.24171191331043,53.193669493240705,NaN,NaN,130.25641949099636,136.19719306559614,0.3598406683456148,0.876029721297293,0.5161890529516782,12458100,12020540,74.87876366395544,66.43512538628497,NaN,NaN,13.51213670062123,8.528165526585806
2000-02-11T09:30:00-05:00,55.85937,55.875,53.875,54.375,1002100,1146180,56.171368599302845,53.64960341899706,NaN,NaN,87.68446727415495,128.19096675377813,0.2811988510819299,0.8676876168040906,0.5864887657221607,11456000,12035240,74.93636347292353,67.58926095622937,NaN,NaN,13.333689860939336,9.214669002922024
2000-02-14T09:30:00-05:00,54.75,54.75,53.75,54.40625,351500,1094560,56.282180884291314,53.75997839320082,NaN,NaN,62.52456738522297,113.6626938990516,0.21381417100150046,0.8537564794740362,0.6399423084725357,11807500,11989180,74.3610338507982,68.2164809750022,NaN,NaN,13.225982670544928,9.787713812582439
2000-02-15T09:30:00-05:00,54.32812,54.9375,52.96875,54.5625,300600,1082050,56.869359987234326,54.468723788115575,NaN,NaN,51.67545831797595,91.30934134835516,0.16450754492961317,0.8455767396345522,0.681069194704939,12108100,11826040,72.2453289026775,68.41515886886705,NaN,NaN,13.305810789846253,10.290299095048699
2000-02-16T09:30:00-05:00,54.375,55,54.1875,54.28125,172100,1051135,55.42629742865691,55.21628994755679,NaN,NaN,61.08290997883793,78.64476448943763,0.10082145380260976,0.8070960119582011,0.7062745581555914,11936000,11953140,72.89242695876027,68.55140459230482,NaN,NaN,12.97278798679084,10.673511793869004
2000-02-17T09:30:00-05:00,54.98437,55.625,54.1875,55.5,231200,1007915,60.145717098248824,56.7562501001522,NaN,NaN,81.5716617746906,68.90781294617649,0.1269578259279458,0.8649718405655236,0.7380140146375778,12167200,11894960,72.0641678215712,68.93460503716543,NaN,NaN,14.039990736095827,11.154437357044264
2000-02-18T09:30:00-05:00,55.5625,55.5625,53.5,53.625,362700,954315,51.169516887163965,57.12688704184661,NaN,NaN,42.51937647966818,59.87479478727912,0.010297806052335767,0.7508862722029974,0.7405884661506617,11804500,11964660,72.46778415744825,69.3813883756992,NaN,NaN,12.204326568790485,11.304421530150867
2000-02-22T09:30:00-05:00,53.375,54,52,53.5,1233900,987565,50.62706157153337,57.15721741069365,NaN,NaN,-2.5190155540590937,46.86607819942271,-0.07809127399233362,0.6429743736602447,0.7210656476525783,10570600,11717280,68.67529666610496,69.9479239990595,NaN,NaN,10.573899621009817,11.200061257416431
2000-02-23T09:30:00-05:00,53.625,55.5,53.48437,55.125,183300,847610,57.00779253148768,57.54070050297214,NaN,NaN,56.91849534239029,47.91468560430558,-0.032268277527536915,0.6807303007431571,0.712998578270694,10753900,11446440,64.68404382311306,70.41407425404996,NaN,NaN,11.108329578403373,11.186956731843138
2000-02-24T09:30:00-05:00,55.48437,56.0625,54.5,55.8125,319900,821640,59.39850581807772,57.71312222361212,NaN,NaN,82.44065341649004,52.186234291836016,0.035518617282422005,0.7573968498737216,0.7218782325912996,11073800,11274000,62.205221327341484,70.59641523160903,NaN,NaN,12.294584253631683,11.345189234955788
2000-02-25T09:30:00-05:00,55.875,56.5,54.875,55.28125,937200,806595,56.77139588241905,57.552700404044565,NaN,NaN,83.16939250024633,52.505780436947155,0.035659825133997236,0.7664530140087962,0.7307931888747989,10136600,10867880,56.69471056044482,70.01441934512452,NaN,NaN,12.484182662048324,11.507902581683293
2000-02-28T09:30:00-05:00,54.75,55.625,53.25,54.625,1508300,759160,53.6166974968078,57.02518447939615,NaN,NaN,28.34110511628036,49.6701261642696,-0.014663859366061294,0.7124633646672223,0.7271272240332836,8628300,10232640,49.33311878790888,68.64323745861167,NaN,NaN,11.702289677217099,11.535672166759552
2000-02-29T09:30:00-05:00,55.75,56,55.375,55.875,474100,717250,58.362780907670285,56.72511279695476,NaN,NaN,110.77301517656016,72.32853231039344,0.027705933526867677,0.7617596409418681,0.7340537074150004,9102400,9939000,46.33790617660094,66.80687153954011,NaN,NaN,12.475113471635217,11.669878067456075
2000-03-01T09:30:00-05:00,56,57.25,56,56.4375,963500,741680,60.32991526854636,56.81573587676793,NaN,NaN,172.33660115298267,95.41215347251192,0.0820153164209445,0.8365728529411811,0.7545575365202366,10065900,9801400,44.960358153934656,64.76689459454165,NaN,NaN,13.712114927078947,11.961626190259343
2000-03-02T09:30:00-05:00,56.875,57.3125,56.09375,57,1097600,769825,62.25056196215933,56.74493945168571,NaN,NaN,176.06278726429724,114.13658024207336,0.1407742859300255,0.9305253939327685,0.789751108002743,11163500,9819340,45.18914214369512,62.646207343094495,NaN,NaN,15.319647469987954,12.441343515934859
2000-03-03T09:30:00-05:00,58,58.8125,57.375,58.57812,401600,727675,67.0678887602095,57.52326232032188,NaN,NaN,252.6416546695068,148.03103267592547,0.26373557050345986,1.1194205711320677,0.8556850006286079,11565100,10105040,48.8365343811994,60.78193383654277,NaN,NaN,18.29271506420269,13.277253737115977
2000-03-06T09:30:00-05:00,58.57812,59.40625,58,58.48437,667500,726465,66.52476983681481,58.25487581693069,NaN,NaN,224.2393496867452,187.21068159001842,0.31319584431223846,1.2471798060189059,0.9339839617066674,10897600,10558900,54.06588298693023,59.332280203409354,NaN,NaN,20.509570180390433,14.310441800440898
2000-03-07T09:30:00-05:00,59.15625,59.5,56.875,56.875,1304700,758935,57.86223814875074,58.32579568561044,NaN,NaN,138.6788610063525,192.7918507559769,0.2165571549251284,1.204680405363078,0.9881232504379496,9592900,10657000,55.133322637145,58.1099940415856,NaN,NaN,19.797637422454315,15.094326889299959
2000-03-08T09:30:00-05:00,57.5625,58.125,56.5,57.875,1089600,769115,61.2396063970813,58.74103204049789,NaN,NaN,105.12058289729585,179.34864710483953,0.1994427454744494,1.2374266822810114,1.037983936806562,10682500,10780320,56.50177195105684,56.939232969606785,NaN,NaN,20.25589327640197,15.831693516028817
2000-03-09T09:30:00-05:00,57.9375,59.75,57.375,59.625,285900,702245,66.32614679640466,59.18249130465189,NaN,NaN,150.30935443765148,174.19796053951035,0.2804784571734271,1.388582008273346,1.1081035510999189,10968400,10741300,55.92058620390327,55.78611999691621,NaN,NaN,22.353018185455042,16.763311325946848
2000-03-10T09:30:00-05:00,60,60.65625,59.5,59.75,265000,657615,66.66267519103218,60.289145469213906,NaN,NaN,162.4506759313991,156.15976479188882,0.31444176657018685,1.5011557593126525,1.1867139927424657,11233400,10674960,54.8868865543847,54.53034159669739,NaN,NaN,24.104282845907594,17.812021543084096
2000-03-13T09:30:00-05:00,58.5,60.25,58,58.875,2011200,708070,61.99232398399037,61.10094992724654,NaN,NaN,108.20414594819736,132.95272404417923,0.25258625313890914,1.502446809166102,1.249860556027193,9222200,10339880,49.872251296547915,53.187266927443325,NaN,NaN,24.134399250270988,18.71521835839651
2000-03-14T09:30:00-05:00,59.625,60.125,57.3125,57.53125,464200,713705,55.555269717165,60.99719829765206,NaN,NaN,72.36005921243255,119.68896368539527,0.10342570102516313,1.3791426823086468,1.2757169812834837,8758000,10172900,47.54125272042549,51.962781848679924,NaN,NaN,22.09961823158328,19.198704054566047
2000-03-15T09:30:00-05:00,58,58.1875,56.25,56.53125,619300,729640,51.28726401834818,60.41782388338567,NaN,NaN,16.5311331456922,101.97107373507453,-0.07093512149333758,1.1870480794168117,1.2579832009101493,8138700,9664140,41.21973429352658,50.463818489121714,NaN,NaN,19.01589608929487,19.17258863095588
2000-03-16T09:30:00-05:00,57.25,58.5,55.875,58.5,2726600,857365,58.11036178561704,60.51346430504267,NaN,NaN,37.64793243232541,79.43878933400931,-0.062330337907879896,1.1800702785252994,1.2424006164331793,10865300,9643520,40.981884326375386,49.341473758116756,NaN,NaN,18.555345213506005,19.08441099989161
2000-03-17T09:30:00-05:00,58.75,60,58.6875,59.875,441000,867855,62.10283993586204,61.119617336403685,NaN,NaN,107.03490284758955,68.3556347172474,0.02275299153291188,1.2708418558493193,1.2480888643164074,11306300,9658100,41.2400703455485,48.76339886937673,NaN,NaN,19.52547322889758,19.147419889749607
2000-03-20T09:30:00-05:00,60.125,60.625,59.125,59.625,395400,869490,60.96510972028611,61.305497965876235,NaN,NaN,108.48130975354212,68.41106747831634,0.04755582078349829,1.3075336402957802,1.259977819512282,10910900,9995840,47.02175748928972,48.81224539171165,NaN,NaN,19.922575051934118,19.258156341490253
2000-03-21T09:30:00-05:00,59.46875,61.625,58.64062,61.1875,649200,840255,65.2500670637666,61.656937379820555,NaN,NaN,131.07516647284535,80.1540889303989,0.14883692138256865,1.4460239712404928,1.297187049857924,11560100,10556260,54.94390119338571,49.52535560881529,NaN,NaN,21.67611878046694,19.603579547058352
2000-03-22T09:30:00-05:00,61.5625,62.75,61.25,62.25,668500,864515,67.83566896934113,62.05587359461926,NaN,NaN,179.43472153625757,112.73480660851199,0.26049573682077565,1.6228067208838937,1.362310984063118,12228600,11374240,63.518784389937416,50.83461576926117,NaN,NaN,23.980382980580156,20.22883718041861
2000-03-23T09:30:00-05:00,62.3125,64,62.125,63.4375,484100,872725,70.47942772839892,62.29955494948994,NaN,NaN,196.53512556016142,144.5122452340792,0.3801892487578158,1.8375475450103878,1.457358296252572,12712700,11743720,66.60996535448444,52.10414655306725,NaN,NaN,26.781229979718606,21.164893294604322
2000-03-24T09:30:00-05:00,64.0625,65.4375,63,63.98437,1103100,881020,71.63568573659369,62.6646203709027,NaN,NaN,197.9626977756751,162.69780421969628,0.45689418294869033,2.028476024938435,1.5715818419897445,13815800,12245620,70.29238938576444,53.263182724412545,NaN,NaN,29.412639750066834,22.343142788241824
2000-03-27T09:30:00-05:00,64.25,64.9375,64.0625,64.5,783100,844760,72.72061955064466,63.72593332818084,NaN,NaN,179.48029475973962,176.89760122093577,0.4995986919554434,2.196080206934049,1.6964815149786054,14598900,12983220,74.70711478558088,54.66131073501511,NaN,NaN,31.899481476405178,23.708334029408018
2000-03-28T09:30:00-05:00,64.5,64.5,62.9375,62.9375,625600,852335,64.6506749730244,63.96958108360535,NaN,NaN,124.79806262439159,175.64218045124503,0.3849936640396965,2.177723595028226,1.7927299309885296,13973300,13465860,77.10467674650442,56.13294679183279,NaN,NaN,31.55115885805416,24.828737576357465
2000-03-29T09:30:00-05:00,63,63.0625,60.40625,61.09375,3382700,973295,56.66043896404874,63.27917338129421,NaN,NaN,53.350752696840736,150.42538668336167,0.15897165452699857,1.9914444991472777,1.8324728446202792,10590600,13138260,72.10822673967765,57.28920683010239,NaN,NaN,28.599668586441783,25.36744200636951
2000-03-30T09:30:00-05:00,60.6875,61.84375,57.75,59.4375,4635801,1150205.05,50.60944574352432,62.13251413504365,NaN,NaN,-13.798921436868376,108.35857728395573,-0.1134324299142424,1.6906823072274761,1.8041147371417185,5954799,11786679.8,55.98836760955756,57.36788404832902,NaN,NaN,24.024283284767883,25.17556218899785
2000-03-31T09:30:00-05:00,60.25,61.1875,58.625,60.5625,319600,1146105.05,54.18822693954796,61.57507863186919,NaN,NaN,-1.341832157913313,68.49767129723804,-0.22287661517209045,1.5255189681766055,1.748395583348696,6274399,10278399.6,44.13192958719362,56.95786106908942,NaN,NaN,21.43586578811104,24.64131984601402
2000-04-03T09:30:00-04:00,59.8125,59.8125,57.25,58,2645000,1244980.05,46.01031405975493,60.893296084911334,NaN,NaN,-65.20504537997402,19.560603269295296,-0.4592631020788587,1.1743167057501225,1.6335798078289812,3629399,8084499.4,33.13896380896135,55.92912614684199,NaN,NaN,16.23779895981424,23.440816862271195
2000-04-04T09:30:00-04:00,57.71875,58.75,52.28125,57.4375,2211500,1290320.05,44.42537708329397,60.40316130383603,NaN,NaN,-137.59435173560945,-32.91787960270492,-0.6341407129799688,0.8409039166040202,1.475044629583989,1417899,5573419.2,25.354270903154926,54.795878761815445,NaN,NaN,11.634792700126226,21.75424198196477
2000-04-05T09:30:00-04:00,56.625,59.1875,56.125,57.8125,587900,1265235.05,45.7666484947979,59.521467497348944,NaN,NaN,-83.7381350248701,-60.33565714704707,-0.70002398390328,0.6000146497048888,1.3000386336081688,2005799,3856459,21.615328843861732,53.41255337020733,NaN,NaN,8.410129250065411,19.847940163122004
2000-04-06T09:30:00-04:00,58.75,59.4375,57.75,58.5625,173000,1259590.05,48.44651318454926,58.54601558654088,NaN,NaN,-51.87093434876406,-67.95005972942621,-0.6686108839797906,0.4642750286334305,1.1328859126132211,2178799,3101259,20.204020692266795,51.909978394972924,NaN,NaN,6.574327624803409,17.95170980050506
2000-04-07T09:30:00-04:00,59.3125,60.625,58.875,60.5625,233000,1257990.05,54.85311366336766,58.10944443961814,NaN,NaN,-1.536429778493828,-67.98897925354233,-0.49656505113638527,0.5121795986927395,1.0087446498291248,2411799,2328739,18.848316314665624,49.897589739642626,NaN,NaN,7.017239067181558,16.389642552887416
2000-04-10T09:30:00-04:00,60.5625,60.75,58.375,58.375,665100,1190685.05,47.84911215436092,56.866519088946305,NaN,NaN,-31.836851954596884,-61.315340568466866,-0.5114969676976265,0.3693734402070916,0.8808704079047182,1746699,1952199,18.207029430283498,47.27352747084961,NaN,NaN,5.047600639266645,14.769350850941592
2000-04-11T09:30:00-04:00,57.48437,58.125,56,56.9375,1479200,1241435.05,43.88366377971127,55.15566157540132,NaN,NaN,-102.20879091271684,-54.23822840388834,-0.5938111065669506,0.13860652469602996,0.7324176312629805,267499,1722119,17.808321191329668,44.00849438523477,NaN,NaN,2.081628091127231,12.956819028110969
2000-04-12T09:30:00-04:00,56.8125,56.8125,53.125,53.25,1338100,1277375.05,35.708462921313426,52.67202123203807,NaN,NaN,-177.03970209764975,-72.89854181844427,-0.856280401753444,-0.3379328709288245,0.5183475308246195,-1070601,1106839,16.751850353377634,40.44720045658428,NaN,NaN,-3.650363592924319,10.58436436796307
2000-04-13T09:30:00-04:00,54,55.25,52.21875,52.23437,2182100,1250150.05,33.838655713335896,49.97223337323394,NaN,NaN,-188.0459654640485,-100.13354804150114,-1.0454442469027465,-0.7884577778038135,0.25698646909893286,-3252701,20539,15.05382889725233,36.50158899311913,NaN,NaN,-8.785834270257466,7.817193133931566
2000-04-14T09:30:00-04:00,50.75,52.03125,47.25,49.5,1908000,1323500.05,29.378395559666373,46.8763602310212,NaN,NaN,-225.8808305582687,-145.00242819745614,-1.2860485673897921,-1.3505742401383074,-0.06452567274851523,-5160701,-1493961,13.065411067958038,32.098610156146066,NaN,NaN,-14.790073220658966,4.587583654704347
2000-04-17T09:30:00-04:00,48.75,52.1875,48.625,52.1875,905400,1349000.05,38.02489356813853,44.97451870210079,NaN,NaN,-158.67204853842682,-170.36946751422212,-1.1973396634421598,-1.561200252051215,-0.3638605886090552,-4255301,-2694361,11.741590853248823,27.429818306627812,NaN,NaN,-16.601835221805995,1.56052381520287
2000-04-18T09:30:00-04:00,52.625,54.78125,52.125,54.78125,572200,1345150.05,45.021106020087224,44.14313777753211,NaN,NaN,-87.72812146234394,-167.47333362414753,-0.9101278042986751,-1.5015203439823992,-0.5913925396837241,-3683101,-3484481,10.954795212065207,23.061716054655495,NaN,NaN,-15.476309621218242,-0.8733095328572889
2000-04-19T09:30:00-04:00,54.25,55.125,53.25,53.34375,355300,1329490.05,42.17920762128597,43.54097791165794,NaN,NaN,-77.79633029800172,-147.62465926421794,-0.7687448506301566,-1.5523236029714198,-0.7835787523412632,-4038401,-4078041,10.391458857207766,19.804794000916225,NaN,NaN,-15.601204616638087,-2.977294544825974
2000-04-20T09:30:00-04:00,53.5,53.875,52.25,52.875,241400,1317355.05,41.26449013494282,42.617853854186144,NaN,NaN,-85.06928609518059,-127.02932339044438,-0.6626006709544813,-1.6118295910343647,-0.9492289200798835,-4279801,-4283461,10.196043814838447,17.380802160033713,NaN,NaN,-16.000741685534198,-4.837786993498577
2000-04-24T09:30:00-04:00,50.625,51.375,49.375,51.25,611100,1292755.05,38.17383120302575,42.05810507870548,NaN,NaN,-115.67357087576028,-104.98787145394267,-0.6563866982522986,-1.7697122928952567,-1.113325594642958,-4890901,-4229501,10.671254941793421,15.775965812378862,NaN,NaN,-17.34519769267399,-6.624559950523636
2000-04-25T09:30:00-04:00,52.75,54.21875,52.26562,54.21875,357900,1271495.05,46.11441040910877,42.17875031626369,NaN,NaN,-54.061167432294,-84.06569523271608,-0.4184743588073392,-1.636418543152132,-1.217944184344793,-4533001,-4285041,10.609027018896114,14.722734106360381,NaN,NaN,-15.779960934835424,-7.932474376853891
2000-04-26T09:30:00-04:00,54.375,55.1875,53.1875,53.1875,1462000,1313315.05,44.00037971235201,42.05258826037469,NaN,NaN,-41.778679365462494,-74.8758068133398,-0.3021265973547784,-1.595602431038266,-1.2934758336834875,-5995001,-4747421,10.081929105251092,13.898919839316763,NaN,NaN,-15.223341461159027,-8.97402681746891
2000-04-27T09:30:00-04:00,52.375,55,52.375,54.84375,481700,1168265.05,48.114414535665794,42.02886692831159,NaN,NaN,-31.35922247487062,-65.58838524871359,-0.09587372106225311,-1.4133179850113038,-1.3174442639490507,-5513301,-5042401,9.749146548211542,13.15214311474139,NaN,NaN,-13.413732649927876,-9.608270507820192
2000-04-28T09:30:00-04:00,55.4375,55.6875,54.5,55,646500,968800,48.498810622753844,41.574988139696316,NaN,NaN,-2.7609383083906023,-49.1267156913556,0.060409842745555054,-1.2419319605171069,-1.302341803262662,-4866801,-5159801,9.613145381357612,12.492488048076533,NaN,NaN,-11.871342603242393,-9.931566521451936
2000-05-01T09:30:00-04:00,55.8125,56.25,55.25,55.78125,195800,962610,50.474487437393684,41.76251494562723,NaN,NaN,23.183998267094907,-21.35520186278456,0.21692932052800273,-1.0311801526026585,-1.2481094731306612,-4671001,-5115821,10.11898844460545,11.914770834813817,NaN,NaN,-10.008403608400137,-9.942543248158822
2000-05-02T09:30:00-04:00,55.3125,55.4375,53.5,54.75,682600,864490,47.864315526365814,42.046847213245414,NaN,NaN,-6.2016958274156755,-11.783307541808895,0.2492277134865275,-0.9365748312725017,-1.1858025447590292,-5353601,-5279941,9.89641197080239,11.34963446191901,NaN,NaN,-9.195340690897902,-9.835800025692976
2000-05-03T09:30:00-04:00,52.8125,53.3125,51,52.375,766600,792245,42.42323322925674,42.526473663812794,NaN,NaN,-72.88237960780361,-18.00404759027712,0.11565057578268467,-1.0412393250306735,-1.1568899008133582,-6120201,-5304981,9.860774188465044,10.85741473585382,NaN,NaN,-10.128165922692602,-9.877566582407209
2000-05-04T09:30:00-04:00,52.28125,53,51.6875,52,178600,771780,41.61875396821658,43.08219496773284,NaN,NaN,-67.90503617791283,-25.31321033088557,0.012479939866321788,-1.141289975980456,-1.1537699158467778,-6298801,-5462081,9.626550854567583,10.469752018519198,NaN,NaN,-11.121128958334324,-10.055218350396796
2000-05-05T09:30:00-04:00,52.5625,53.625,52.375,53.42187,300000,778130,45.81448464561227,44.25620133101469,NaN,NaN,-32.695563019533004,-31.30013527311405,0.04841948669130525,-1.0932455574826463,-1.1416650441739515,-5998801,-5688481,9.284293395436862,10.199672184767687,NaN,NaN,-10.742827038620105,-10.153448163000126
2000-05-08T09:30:00-04:00,52.1875,52.625,51.40625,51.53125,155400,774250,41.539589349026436,44.50725102964954,NaN,NaN,-75.10715392747596,-50.958365712028225,-0.04183914040916914,-1.193963969685413,-1.1521248292762438,-6154201,-5985121,8.840776083146764,9.992471129760398,NaN,NaN,-11.6995967056557,-10.374326526236636
2000-05-09T09:30:00-04:00,51.875,51.9375,50,50.57812,1236200,802805,39.536705655101265,44.11550814643625,NaN,NaN,-110.62607657479948,-71.84324186150499,-0.14654105016669727,-1.3353011419846155,-1.1887600918179182,-7390401,-6392481,8.257412827124142,9.799800959407463,NaN,NaN,-13.094384578950777,-10.762906248052943
2000-05-10T09:30:00-04:00,49.625,49.8125,47.75,48.125,1019800,779835,34.875811969780614,43.59383702847158,NaN,NaN,-184.63682435977057,-94.19413081189836,-0.35019894341390967,-1.6265087710853052,-1.2763098276713956,-8410201,-6850481,7.646494909027993,9.60373210596605,NaN,NaN,-15.796514100768055,-11.481993084155102
2000-05-11T09:30:00-04:00,48.4375,49.625,47.8125,49.48437,431200,734490,39.15625044160985,43.4432484789478,NaN,NaN,-142.00847520877923,-109.01481861807164,-0.3611020673655405,-1.7276874118783212,-1.3665853445127807,-7979001,-7186521,7.2241789051372365,9.391456040987391,NaN,NaN,-16.74931588071152,-12.234467769377448
2000-05-12T09:30:00-04:00,50.5,51.40625,50.125,50.125,221500,636460,41.12035846180731,43.65371471171791,NaN,NaN,-70.47039676277184,-116.5697853667194,-0.29566395946637636,-1.736165293845751,-1.4405013343793747,-7757501,-7538261,6.800780369162553,9.114993571513759,NaN,NaN,-16.944254941809085,-12.907294508296253
2000-05-15T09:30:00-04:00,50.5,51.1875,49.125,51.0625,157600,548940,43.9708023095889,43.50059984746649,NaN,NaN,-77.75009049398129,-117.09837268002047,-0.16618759233813485,-1.6482358248020432,-1.4820482324639084,-7599901,-7827401,6.465334124701201,8.819015507642694,NaN,NaN,-16.270469691160915,-13.387748105848347
2000-05-16T09:30:00-04:00,52.25,52.75,51.28125,52.59375,408000,524070,48.36753162498895,43.8125392697977,NaN,NaN,-10.809633074935592,-97.13508398004771,0.034909862964199956,-1.4384109037586583,-1.4733207667228583,-7191901,-7787701,7.142582232506371,8.6090621595895,NaN,NaN,-14.374141576212907,-13.52866145875757
2000-05-17T09:30:00-04:00,52.0625,52.34375,51.125,51.84375,368600,513890,46.445082272319375,43.69330125098724,NaN,NaN,-25.240077721527072,-65.25573465239901,0.12469255567498405,-1.3174550721291283,-1.4421476278041123,-7560501,-7617761,10.141898281515736,8.637115854825513,NaN,NaN,-13.34389217580937,-13.502265846907827
2000-05-18T09:30:00-04:00,51.875,51.875,50.375,50.53125,206800,506465,43.20845664221366,43.31541882380579,NaN,NaN,-55.978246376811725,-48.049688886005505,0.10381711915340563,-1.3123762288623553,-1.416193348015761,-7767301,-7575421,10.913965617601292,8.73003158598578,NaN,NaN,-13.395834079548582,-13.487061308713649
2000-05-19T09:30:00-04:00,50.125,50.1875,48.28125,48.5625,777500,533270,38.83656413087094,42.484138587625594,NaN,NaN,-121.13384482939622,-58.18237849933039,-0.02743932618425271,-1.4504925057460767,-1.423053179561824,-8544801,-7732881,10.550894827645791,8.760882041917231,NaN,NaN,-14.76400545891456,-13.669481901599493
2000-05-22T09:30:00-04:00,48.125,48.4375,46,48.34375,452600,525345,38.37198767993381,41.80611517002331,NaN,NaN,-157.42554005763662,-74.11746841206146,-0.10925631820105819,-1.5596235773131468,-1.4503672591120886,-8997401,-8012381,9.920055064252821,8.762570834306546,NaN,NaN,-16.00879988666343,-14.003670185180056
2000-05-23T09:30:00-04:00,48.5,48.5,45.9375,46,334300,524165,33.71799176249398,41.18431220811169,NaN,NaN,-157.16474508217917,-103.38849081351016,-0.2911601551231082,-1.814317453015974,-1.5231572978928658,-9331701,-8440341,9.02980094298097,8.703215602486257,NaN,NaN,-18.558827797252462,-14.654406986904686
2000-05-24T09:30:00-04:00,46.5,48,44.6875,47.8125,713600,486745,39.79888845425444,41.05432181425725,NaN,NaN,-136.68839164837973,-125.67815359888068,-0.26035500958272983,-1.848601059871278,-1.5882460502885483,-8618101,-8651861,8.61813390914439,8.631185820670314,NaN,NaN,-18.88504490766218,-15.258783832727184
2000-05-25T09:30:00-04:00,48.6875,49.15625,46.6875,47.03125,606100,492965,38.17323622039079,40.50851835531286,NaN,NaN,-101.22184262298354,-134.72687284811505,-0.26277651512082656,-1.9167166941895815,-1.653940179068755,-9224201,-8943241,8.07218499746861,8.544606649386868,NaN,NaN,-19.643808955688513,-15.885215993150231
2000-05-26T09:30:00-04:00,47.5625,47.71875,46.25,47.1875,143500,467815,38.71242865894136,40.30657830602107,NaN,NaN,-107.17629623423565,-131.93536312908296,-0.22546892186480827,-1.9357763313997651,-1.7103074095349569,-9080701,-9050421,7.874576919790087,8.475592423432818,NaN,NaN,-20.104249094293056,-16.487935007599205
2000-05-30T09:30:00-04:00,48.375,50.25,48.125,50.25,821100,499080,48.24037225389015,40.92826877736314,NaN,NaN,-20.68644292737596,-104.58754370303082,0.020768349899146887,-1.6843469721610234,-1.7051153220601702,-8259601,-8902861,11.101205927799143,8.678720502052462,NaN,NaN,-17.54200273617564,-16.638516111681554
2000-05-31T09:30:00-04:00,50,50.6875,49.21875,49.28125,252300,477565,45.81406447877949,41.709572528005914,NaN,NaN,-6.49644025968591,-74.45388273853216,0.12773823930233208,-1.5454425229322553,-1.6731807622345873,-8511901,-8738901,14.67713514885321,9.180909090611406,NaN,NaN,-16.157607117669304,-16.56981482682266
2000-06-01T09:30:00-04:00,50.25,51.5,49.9375,51.5,540200,466245,51.79425936777319,42.612287451303295,NaN,NaN,45.93197659480048,-37.92980908989612,0.34493815527010874,-1.2420080681469514,-1.5869462234170602,-7971701,-8609621,17.49519619938542,9.914553183057706,NaN,NaN,-13.027793000109874,-16.063811708720834
2000-06-02T09:30:00-04:00,53.75,54.21875,53.125,53.84375,858100,500220,57.17138727080482,43.758789509088835,NaN,NaN,146.66268350563365,11.647096135827315,0.6270331620247376,-0.8031547708861382,-1.4301879329108758,-7113601,-8187501,26.08010310669526,11.291647664310043,NaN,NaN,-8.52578346247127,-14.986950530685183
2000-06-05T09:30:00-04:00,53.5,54.75,53.5,54,391900,504815,57.51165040135676,44.725992944215115,NaN,NaN,154.26402492211884,63.935160367098206,0.7939849930506,-0.43770669159762576,-1.2316916846482258,-6721701,-7715701,34.30777587621158,13.280393503703639,NaN,NaN,-4.875432262503241,-13.542447920944905
2000-06-06T09:30:00-04:00,54,54.75,53.25,53.25,447200,519405,55.24291727868701,45.217091919479266,NaN,NaN,131.281203919394,94.3286897364522,0.8203710111259113,-0.20622792074083662,-1.0265989318667479,-7168901,-7497561,37.75735231037621,15.467162794980057,NaN,NaN,-2.5333591022399333,-11.969720946844195
2000-06-07T09:30:00-04:00,53.5625,54.34375,52.78125,54.25,238300,469510,57.64221552830965,46.016887152049996,NaN,NaN,118.2242769209711,119.27283317258359,0.8670810223903663,0.057252346121209996,-0.8098286762691563,-6930601,-7181301,42.4737609797204,17.776581559137533,NaN,NaN,0.15443804309560838,-10.237698233995651
2000-06-08T09:30:00-04:00,54.6875,54.98437,53.5625,54,277100,432375,56.822119726388536,46.989291658062484,NaN,NaN,116.5723184911853,133.40090155186056,0.8423327700549241,0.24308728629949883,-0.5992454837554253,-7207701,-7028501,44.65578425670371,20.186711461930567,NaN,NaN,2.1272477250577553,-8.471277382702308
2000-06-09T09:30:00-04:00,54.6875,54.6875,53.8125,54.125,130900,417360,57.15038544518224,48.29742175194186,NaN,NaN,104.04502926811419,124.87737070435666,0.7961049839159162,0.39588574613947003,-0.4002192377764462,-7076801,-7021141,44.764464626877654,22.630537876161412,NaN,NaN,3.8473174591131634,-6.711478119585812
2000-06-12T09:30:00-04:00,54.03125,54.15625,53,53.15625,318200,422195,53.740407614824306,49.39516603300547,NaN,NaN,72.93749379350132,108.61206447863317,0.6672225249593671,0.4338089184227627,-0.2334136065366044,-7395001,-7155801,43.09694543710766,25.00031575993676,NaN,NaN,4.424104348055038,-5.120680624208548
2000-06-13T09:30:00-04:00,53.1875,54.125,52.375,54.125,362200,432425,56.53341809218811,51.02483934226934,NaN,NaN,68.62430357158335,96.08068440907104,0.6154159383816561,0.5358563164404657,-0.07955962194119037,-7032801,-7128581,43.55466523015556,27.466377494734946,NaN,NaN,5.691551661902033,-3.5760760119070367
2000-06-14T09:30:00-04:00,54.25,54.5625,53.125,53.125,221000,423075,52.97762704082361,51.966177812738565,NaN,NaN,66.5138774126931,85.73860450741543,0.4875911192275031,0.5299292770931885,0.0423381578656854,-7253801,-7193221,42.676748457590676,29.89913567676682,NaN,NaN,5.812328451599736,-2.234875374263212
2000-06-15T09:30:00-04:00,53.5,54.625,53.25,54.1875,125800,410935,56.13457180659695,53.24913035461043,NaN,NaN,71.41196067376099,76.70653294393057,0.4493329456865641,0.6040043399738906,0.15467139428732646,-7128001,-7177281,42.98196115314682,32.392691116458124,NaN,NaN,6.7979292723124765,-0.9444747104666853
2000-06-16T09:30:00-04:00,54.375,54.78125,53.84375,54.375,470500,424120,56.68720336846901,54.5330428338624,NaN,NaN,71.64726923416701,70.22698093714114,0.41235439058298223,0.6701143825160543,0.25775999193307203,-6657501,-7093421,44.65162064554703,35.019622811155045,NaN,NaN,7.767435929696774,0.3000839524138088
2000-06-19T09:30:00-04:00,54.4375,56.3125,54.25,56.09375,511000,410795,61.47810326700742,55.478595049085065,NaN,NaN,92.58211070539403,74.15590431951969,0.4748973111422335,0.8513816308608639,0.37648431971863044,-6146501,-6843721,49.40269061094741,37.75544314566564,NaN,NaN,10.019826661896227,1.6886186251970112
2000-06-20T09:30:00-04:00,56.34375,56.98437,55.84375,56.25,200500,398190,61.89079216896923,56.62693274124147,NaN,NaN,105.54549049531352,81.54014170426572,0.49574227460354714,0.9961621629730644,0.5004198883695172,-5946001,-6626361,53.17100493831801,40.50500527348455,NaN,NaN,11.996321685541783,3.161147633817693
2000-06-21T09:30:00-04:00,55.75,56.90625,55.6875,56.75,339500,398450,63.24765167898034,57.44503219204198,NaN,NaN,105.42026248518917,89.32141871876493,0.510166463965365,1.1381279683262235,0.6279615043608585,-5606501,-6296901,58.2469369031052,43.41584389517882,NaN,NaN,14.052701575586685,4.717083911213264
2000-06-22T09:30:00-04:00,56.3125,56.53125,54.8125,54.9375,620800,393810,55.52937346288298,57.327745491476136,NaN,NaN,76.95316678887374,90.42965994178749,0.37106897652572246,1.0917977250180115,0.7207287484922891,-6227301,-6116761,60.75195642699104,45.892404846628516,NaN,NaN,13.729080722624692,6.004512027129182
2000-06-23T09:30:00-04:00,55,55.15625,53.5625,53.82812,113900,369200,51.395227402886675,56.89085813444255,NaN,NaN,32.11394710170693,82.52299551529548,0.1870645309417588,0.9545594121694876,0.7674948812277288,-6341201,-6053501,61.62272083093487,47.84347234339447,NaN,NaN,12.228826929792334,6.893699870366775
2000-06-26T09:30:00-04:00,54.3125,54.75,53.75,54.3125,190400,371545,53.039179919764806,56.73344832309097,NaN,NaN,29.047806938253217,69.8161347618673,0.0858427730564908,0.8747983475483423,0.7889555744918515,-6150801,-6054361,61.60271132209671,49.54671227280307,NaN,NaN,11.436064222342724,7.542609063506196
2000-06-27T09:30:00-04:00,54.25,54.78125,53.5625,53.65625,146400,337810,50.54484361448753,56.22649318638939,NaN,NaN,1.3269226150515208,48.97242118581491,-0.031174183061381533,0.7499878456651246,0.7811620287265061,-6297201,-6124601,59.89215938445342,50.790883587426855,NaN,NaN,10.049774353409584,7.900775533492395
2000-06-28T09:30:00-04:00,53.5,54.90625,53.5,54.10937,158100,333100,52.21582234721343,55.897471945019745,NaN,NaN,-2.952760440992234,27.297816600578635,-0.08108858724806423,0.6798012946664258,0.76088988191449,-6139101,-6231121,57.293936299306765,51.69360873332708,NaN,NaN,9.333977495681433,8.105518670947971
2000-06-29T09:30:00-04:00,53.5,53.875,52.8125,53.125,461500,329165,48.39065316386007,55.271776782068166,NaN,NaN,-106.95382848025497,-9.483582453247113,-0.17788025259801787,0.5385395661669676,0.7164198187649855,-6600601,-6305781,55.47731901506947,52.45881261819792,NaN,NaN,7.618698054407563,8.035972868585056
2000-06-30T09:30:00-04:00,53.125,54.1875,53.125,54.1875,262200,299370,52.440521142354434,55.17892774832031,NaN,NaN,-50.24692884795053,-25.955757643178593,-0.16794781142774773,0.5064850544803008,0.6744328659080485,-6338401,-6305221,55.48871913965842,53.34393931123726,NaN,NaN,7.263625039584339,7.925637464442096
2000-07-03T09:30:00-04:00,54.0625,54.5625,53.875,54.5625,38000,281675,53.81796091891199,54.98496652165773,NaN,NaN,-0.269434667672021,-31.81920596436364,-0.13513529969889915,0.5055137412844246,0.6406490409833238,-6300401,-6335141,54.683081926405556,54.138826218112264,NaN,NaN,7.349880806085346,7.843386513248275
2000-07-05T09:30:00-04:00,53.6875,53.8125,52.46875,52.8125,146100,266620,46.979815885837574,54.55655143915873,NaN,NaN,-127.13319962173831,-57.51123041172161,-0.2250066240189572,0.3593907609596272,0.5843973849785844,-6446501,-6365001,53.84289462014076,54.93640808686583,NaN,NaN,5.376768258132098,7.491012476803107
2000-07-06T09:30:00-04:00,52.625,53.6875,51.96875,53.60937,125900,261000,50.089640378111554,54.12477062283834,NaN,NaN,-114.1479089277648,-79.75026010907612,-0.2240144676098319,0.30437930046629447,0.5283937680761264,-6320601,-6401301,52.78118974157165,55.636352986039036,NaN,NaN,4.620713359827146,7.080969745806541
2000-07-07T09:30:00-04:00,53.8125,54.96875,53.8125,54.5,190100,256650,53.380835708641264,53.88860150427922,NaN,NaN,14.407954992083175,-55.4779034146085,-0.15962873383152054,0.3288578507867257,0.48848658461824623,-6130501,-6307281,55.242893133498505,56.39287244946415,NaN,NaN,4.950943877392036,6.77668033603304
2000-07-10T09:30:00-04:00,54.25,54.5625,53.6875,53.75,102000,255205,50.36871444107232,53.095073730998145,NaN,NaN,-25.332704321498746,-50.49505850931814,-0.16322168806813336,0.2844594745330795,0.4476811626012129,-6232501,-6286101,55.80189686520237,56.84995861048236,NaN,NaN,4.340854809363843,6.428705260794583
2000-07-11T09:30:00-04:00,53.65625,54.40625,53,53.46875,93700,243980,49.246493552363084,52.191909544097705,NaN,NaN,-62.46872763918294,-62.93491710362032,-0.1789474732303114,0.22399682106332364,0.40294429429363504,-6326201,-6291261,55.619637737848954,57.024860953305996,NaN,NaN,3.5158768104382663,6.012586910743681
2000-07-12T09:30:00-04:00,54.125,55.15625,53.875,54.875,345700,243155,54.683149929102136,51.5801594191064,NaN,NaN,29.567882478872747,-31.59470068349811,-0.09335334493966524,0.2862526131190535,0.3796059580587187,-5980501,-6198061,58.27077111848834,57.02656339726194,NaN,NaN,4.390465598861081,5.780855294760452
2000-07-13T09:30:00-04:00,55.21875,56.375,55.09375,55.90625,196700,241940,58.21777613781241,51.77218818160137,NaN,NaN,118.98214240151984,15.031309582358816,0.027540303792659093,0.4140313377995426,0.3864910340068835,-5783801,-6090701,61.14979534761851,57.054980463021046,NaN,NaN,6.215617340081655,5.842964158377767
2000-07-14T09:30:00-04:00,56.625,57.17187,56.14062,56.90625,134200,242360,61.364717109953645,52.484294589249,NaN,NaN,161.68438652018378,44.486595887978936,0.1621644913211614,0.5891966481583353,0.4270321568371739,-5649601,-5994521,63.57438792775432,57.19438525565101,NaN,NaN,8.744934720411143,6.257531381525392
2000-07-17T09:30:00-04:00,56.875,57.75,56.75,57.34375,111300,224400,62.68875238918496,53.17354976563615,NaN,NaN,161.86291126539663,81.92571900535802,0.2620704506205393,0.754620220112848,0.4925497694923087,-5538301,-5855681,66.79584540936483,57.56532340474159,NaN,NaN,11.23106425181604,6.968036077281199
2000-07-18T09:30:00-04:00,56.875,57.03125,56.03125,56.125,182600,207980,56.8445463310767,53.62352853110681,NaN,NaN,98.05768745642898,114.0310020244804,0.2286831443301407,0.7784036999049846,0.5497205555748439,-5720901,-5734621,69.3418665412221,58.24030248736792,NaN,NaN,11.651079954960405,7.637042345521086
2000-07-19T09:30:00-04:00,56,56.03125,54.875,55.28125,133400,204625,53.15030315444174,53.69027716019455,NaN,NaN,43.24910478226708,116.76724648515926,0.13691082804124322,0.7208590906263979,0.5839482625851546,-5854301,-5709381,69.86075652562873,59.137932503533776,NaN,NaN,10.88942514165888,8.101668459255055
2000-07-20T09:30:00-04:00,55.375,56.34375,55.34375,56.15625,269500,201125,56.32054801086459,54.25669822069487,NaN,NaN,82.60727372550765,109.49227274995683,0.12272933727261814,0.7373599341759274,0.6146305969033092,-5584801,-5669581,70.7027992155553,60.22546680356847,NaN,NaN,11.193169529062907,8.543311469227605
2000-07-21T09:30:00-04:00,55.46875,55.5625,54.78125,54.9375,227200,181445,51.130652484567904,54.16313617371012,NaN,NaN,28.102458611441076,82.77588716820829,0.024025731332433353,0.6446627610688509,0.6206370297364175,-5812001,-5702061,69.008378631748,61.19115676728916,NaN,NaN,9.85041625794695,8.73004072475894
2000-07-24T09:30:00-04:00,54.875,55.34375,53.39062,53.59375,203000,185900,46.08790477931107,53.61098930659576,NaN,NaN,-37.74054769212566,42.85519537670383,-0.1305124602872605,0.4574964543773419,0.5880089146646024,-6015001,-5797401,64.14860919451553,61.867265857868446,NaN,NaN,7.075589500275095,8.493690549832676
2000-07-25T09:30:00-04:00,54.28125,54.5625,53.53125,54.5,221300,187445,49.691542567839655,53.80468406959591,NaN,NaN,-31.47724518208567,16.9482088490009,-0.16805833326154995,0.37793599808766487,0.5459943313492148,-5793701,-5811961,63.41414455649622,62.55092656760811,NaN,NaN,5.874083441257349,8.119460962893344
2000-07-26T09:30:00-04:00,54.03125,54.0625,52.875,53.78125,272700,193760,47.007808680656595,53.584553234063414,NaN,NaN,-70.7941574618092,-5.86044359981436,-0.23362813549131384,0.2539591619850725,0.48758729747638635,-6066401,-5854381,61.21508947735973,63.153347977307256,NaN,NaN,4.043901650692675,7.537238204007534
2000-07-27T09:30:00-04:00,53,53.25,51.875,52.23437,474600,209585,41.778189799582464,52.75579281198778,NaN,NaN,-130.22851994852005,-48.427602334619905,-0.3656423524412661,0.030534356924803774,0.39617670936606986,-6541001,-6045621,52.39396433671659,62.9498530632514,NaN,NaN,0.7518206643554155,6.567892841200089
2000-07-28T09:30:00-04:00,52.3125,52.6875,49.84375,50.28125,372800,205150,36.28873900272808,51.75008028067748,NaN,NaN,-199.40473821369355,-93.92904169964683,-0.5574741527661696,-0.30066598159164215,0.2568081711745275,-6913801,-6265981,44.446295292961096,62.138738665234165,NaN,NaN,-4.020937937386234,5.055202729973471
2000-07-31T09:30:00-04:00,50.5625,51.65625,49.9375,51.46875,560500,220065,41.33583479554074,51.18503322661875,NaN,NaN,-168.32896177342946,-120.04672451590758,-0.5750446878326622,-0.4619976886163002,0.11304699921636194,-6353301,-6333641,42.323426057666815,61.18900925950687,NaN,NaN,-6.299628043776035,3.4330840480092566
2000-08-01T09:30:00-04:00,51.25,51.34375,50.5,50.59375,166000,226465,38.891084439607994,50.05702854879774,NaN,NaN,-151.10079727869223,-143.9714349352289,-0.6127838498155683,-0.6529328130530985,-0.04014896323753017,-6519301,-6478761,38.11810692067309,59.74953324537721,NaN,NaN,-8.960072408697956,1.6626331256225122
2000-08-02T09:30:00-04:00,50.25,51.71875,50.25,50.5,142000,226260,38.62748038103576,48.65772170902797,NaN,NaN,-134.58846911237012,-156.7302972653411,-0.609931758981586,-0.8025636619645127,-0.19263190298292668,-6661301,-6597741,35.043712195387144,57.88481302021783,NaN,NaN,-11.139447224925183,-0.1662354958843013
2000-08-03T09:30:00-04:00,48.9375,51.46875,48.84375,51.46875,902300,265080,42.93195505090034,47.34109584766702,NaN,NaN,-127.1045236301456,-156.10549800166618,-0.5125909429181017,-0.8333705816305539,-0.32077963871245213,-5759001,-6441341,41.70016827992192,56.32236875965837,NaN,NaN,-11.67753060053168,-1.810706225119641
2000-08-04T09:30:00-04:00,51.75,52.25,50.9375,51.46875,232300,267190,42.93195505090034,45.92989603778954,NaN,NaN,-79.81379932040929,-132.18731022300935,-0.42178425423566035,-0.8480099565070276,-0.42622570227136725,-5759001,-6210381,49.869857214925894,55.11336960291273,NaN,NaN,-12.109076834556996,-3.2819020264678347
2000-08-07T09:30:00-04:00,51.6875,52.70312,51.5,52.5,237800,273980,47.47968953275534,45.260977695052304,NaN,NaN,-50.09379467188185,-108.54027680269982,-0.27305996923468545,-0.767550663814724,-0.4944906945800386,-5521201,-6043961,54.786409340772074,54.07369408859488,NaN,NaN,-11.151340140790492,-4.4061074713710715
2000-08-08T09:30:00-04:00,52.42187,52.9375,52.20312,52.625,168400,277715,48.02040122858728,44.89455612891984,NaN,NaN,-34.88251851851877,-85.29662105066514,-0.15304282861705343,-0.6857942303513553,-0.5327514017343019,-5352801,-5810661,60.61760641151759,53.41346908044408,NaN,NaN,-10.213767981232216,-5.235773258494092
2000-08-09T09:30:00-04:00,53.4375,53.67187,52.53125,52.71875,157600,268310,48.44906910334058,44.33230763552526,NaN,NaN,-19.092706837455708,-62.19746859568225,-0.05895575320969337,-0.6064460932464186,-0.5474903400367253,-5195201,-5517441,66.47059986767981,53.111169127024404,NaN,NaN,-9.31945892999835,-5.819156925851843
2000-08-10T09:30:00-04:00,52.29687,52.5625,51.5625,51.5625,85300,262740,43.66610002763327,43.799125317172795,NaN,NaN,-51.012877600898435,-46.979139389832824,-0.06569104797666125,-0.6296041500075518,-0.5639131020308905,-5280501,-5421741,68.13512800275724,53.048794082096485,NaN,NaN,-9.837568255760738,-6.393215687267399
2000-08-11T09:30:00-04:00,51.25,51.9375,50.65625,51.875,266800,269370,45.239582275918046,43.73853085264472,NaN,NaN,-60.331938432278825,-43.08276721220674,-0.04138485891530563,-0.6156441756750226,-0.574259316759717,-5013701,-5272681,70.584607803216,53.50850826843224,NaN,NaN,-9.843684393719657,-6.88613978818915
2000-08-14T09:30:00-04:00,51.6875,52.9375,51.46875,52.9375,105100,269060,50.320401119134615,43.783449320594364,NaN,NaN,-16.75879290486128,-36.41576685880263,0.04906093256951338,-0.5129331510478252,-0.5619940836173386,-4908601,-5150161,72.45864231429273,54.15454382256056,NaN,NaN,-8.4018111675155,-7.102664270950058
2000-08-15T09:30:00-04:00,53.0625,53.4375,52.6875,53.0625,100700,264965,50.89761307734386,44.06129249178632,NaN,NaN,20.51794953519213,-25.335673248060452,0.11627954805371943,-0.41664464855018934,-0.5329241966039088,-4807901,-5041181,74.04275487733047,55.070805636844185,NaN,NaN,-7.047619185731055,-7.094800687347343
2000-08-16T09:30:00-04:00,53.3125,53.9375,52.78125,53.01562,69800,261785,50.65988323787588,44.69569916595013,NaN,NaN,39.046259270155296,-13.707880026538248,0.15418210404081456,-0.34019656655289054,-0.4943786705937051,-4877701,-4977681,74.94697158761832,56.68173472619431,NaN,NaN,-5.978931452793805,-6.935390796696837
2000-08-17T09:30:00-04:00,53.1875,54.25,52.9375,53.98437,184700,257545,55.30555600908058,46.05404323783245,NaN,NaN,80.56267129290525,12.60722975222249,0.2361867289659137,-0.199145259386313,-0.4353319883522267,-4693001,-4860181,76.57317962323737,58.976512178356906,NaN,NaN,-3.725932732746954,-6.47689678756114
2000-08-18T09:30:00-04:00,54.4375,54.8125,54,54.0625,250600,258715,55.668095751459525,47.07777616325522,NaN,NaN,122.92251563617198,49.258120565912655,0.28415925327724545,-0.08013292175566988,-0.36429217503291533,-4442401,-4745921,78.06428617971108,61.52943075850292,NaN,NaN,-1.7450445468112439,-5.800917896025441
2000-08-21T09:30:00-04:00,54.375,54.90625,53.875,54.3125,71900,252160,56.8735552083278,48.36223836102092,NaN,NaN,125.42918809351602,77.69571676558812,0.31860700270258935,0.03396657834532135,-0.284640424357268,-4370501,-4638301,79.39461648840867,64.47775287048403,NaN,NaN,0.2717246294963613,-4.933397535236612
2000-08-22T09:30:00-04:00,54.5625,54.9375,54.21875,54.42187,146100,248400,57.41905477067753,49.70449367456677,NaN,NaN,132.8643961053914,100.16500607962797,0.3330710294313441,0.13169836243191213,-0.20137266699943196,-4224401,-4521601,80.75742094547657,67.7430177812047,NaN,NaN,2.130919007979891,-3.9242094576342543
2000-08-23T09:30:00-04:00,54,54.98437,53.5625,54.85937,159700,242750,59.61938663829863,50.89645307366664,NaN,NaN,121.17604197562993,116.59096262072289,0.35443277152019104,0.24166829740080686,-0.11276447411938419,-4064701,-4359001,82.49465336966392,70.65690957332914,NaN,NaN,4.346574125484765,-2.7426689457601086
2000-08-24T09:30:00-04:00,54.9375,55.46875,54.8125,55.375,103800,224210,62.1048175555891,52.26594325257298,NaN,NaN,140.59653426854555,128.59773521585095,0.3831763002402938,0.36620590118098306,-0.016970399059310734,-3960901,-4212581,83.90387866146962,73.08791110522512,NaN,NaN,6.97601727309069,-1.3542852002099945
2000-08-25T09:30:00-04:00,55.375,55.6875,55.125,55.15625,108200,210980,60.40616476935962,53.18926291233043,NaN,NaN,128.9896807851321,129.81116824564296,0.3673000542887053,0.44215466880157095,0.07485461451286561,-4069101,-4137921,84.5853019958939,75.21640343773382,NaN,NaN,8.814561158082117,0.09840713668887857
2000-08-28T09:30:00-04:00,55.1875,56.09375,55.15625,55.59375,101000,188005,62.60889975246566,54.231298521178886,NaN,NaN,128.76105368684955,130.47754136430967,0.3653324478080663,0.5315201742729485,0.1661877264648822,-3968101,-4057441,85.30737296407837,76.97995819148817,NaN,NaN,11.020081434054033,1.6586463220267575
2000-08-29T09:30:00-04:00,55.75,55.98437,55.4375,55.6875,111900,185300,63.08285861115273,55.27656920030832,NaN,NaN,118.57948876445802,127.620559896123,0.3494156637907009,0.6029573062032583,0.2535416424125574,-3856201,-3983801,85.95564481342728,78.37174711618441,NaN,NaN,13.023463535452832,3.2821916382304823
2000-08-30T09:30:00-04:00,55.625,55.71875,55.15625,55.4375,103900,183395,60.86716901314659,56.50521698498785,NaN,NaN,95.26612258932242,122.4385760188615,0.30285647873859584,0.6321122408358022,0.32925576209720636,-3960101,-3962881,86.14269964177986,79.65800223325745,NaN,NaN,14.222893955826626,4.8451491121727885
2000-08-31T09:30:00-04:00,55.6875,56.65625,55.6875,56.51562,183000,147430,66.35531654506835,58.01348371849857,NaN,NaN,126.26096610621907,119.5714623863962,0.323599184268612,0.7337547424329713,0.41015555816435934,-3777101,-3926121,86.48336977270704,80.7936280882211,NaN,NaN,16.89260078352784,6.566213636652082
2000-09-01T09:30:00-04:00,57.03125,57.1875,56.3125,56.46875,337000,152665,65.92247340570697,59.127917453253744,NaN,NaN,131.86319053782248,120.14616433693429,0.312906262445065,0.8012883862206905,0.48838212377562557,-4114101,-3935121,85.92639731435735,81.75561058822572,NaN,NaN,19.00492090400284,8.34317181770219
2000-09-05T09:30:00-04:00,56.125,56.125,55.10937,55.25,125700,147060,55.74053819560822,59.47384067598692,NaN,NaN,66.89999444351893,107.77395248826815,0.20757081849563142,0.7478456468951649,0.5402748283995334,-4239801,-3989461,82.4727849905295,82.35775559631135,NaN,NaN,18.02680562838514,9.726548076371182
2000-09-06T09:30:00-04:00,54.9375,55.0625,53.75,53.75,306200,153950,46.26849766988051,59.160170278272965,NaN,NaN,-7.669348661713823,82.5241850030338,0.03001531940710056,0.5777939776584091,0.5477786582513086,-4546001,-4127421,74.30705074683803,82.31204696482705,NaN,NaN,13.972677037284795,10.33313792793027
2000-09-07T09:30:00-04:00,54.09375,54.90625,54.0625,54.73437,130200,152580,52.0295044760376,58.92616659734132,NaN,NaN,10.247040720034832,65.52036862917626,-0.02502027997458489,0.5165033082830774,0.5415235882576623,-4415801,-4218561,69.41723584758228,81.80090812370884,NaN,NaN,12.386014559468036,10.62640601814995
2000-09-08T09:30:00-04:00,54.25,54.25,52.9375,52.9375,251100,160870,42.97218282167782,58.01931567378548,NaN,NaN,-72.65681158021633,25.736813091889182,-0.17781293580040475,0.3192574185071564,0.49707035430756114,-4666901,-4396521,60.97918621586903,80.58054384057725,NaN,NaN,7.618704862590129,10.196734424498548
2000-09-11T09:30:00-04:00,52.625,53.3125,51.5,51.625,280100,161535,37.796485632467515,56.65666784693832,NaN,NaN,-161.32012978091993,-32.899850971859294,-0.35255154376831765,0.05638092459716404,0.4089324683654817,-4947001,-4563101,54.322751697208474,78.78969635549153,NaN,NaN,1.6935461407834613,8.981993241110679
2000-09-12T09:30:00-04:00,52,52.4375,50.75,50.875,204800,166520,35.188367836000154,55.06876163731851,NaN,NaN,-200.11944689779796,-86.30373924012267,-0.4951843906240783,-0.2100480199146162,0.28513637070946213,-5151801,-4745501,48.12773953151591,76.4590048259229,NaN,NaN,-3.9522474562745957,7.13424457005564
2000-09-13T09:30:00-04:00,50.1875,51.625,50.1875,51.375,170000,169985,38.24767121680312,53.54221053578311,NaN,NaN,-191.82762491606246,-123.1353944909924,-0.5293162137210994,-0.3765088964419121,0.15280731727918728,-4981801,-4832661,45.45986375682656,73.81366271072024,NaN,NaN,-7.357703210714547,5.063966315659899
2000-09-14T09:30:00-04:00,52.0625,52.54687,51.28125,51.5625,201200,176555,39.4028200736184,51.92063928707092,NaN,NaN,-134.4331183834417,-152.0714263116877,-0.5123890517956597,-0.48767899746538745,0.02471005433027232,-4780601,-4905621,43.29628333231626,70.91312018720929,NaN,NaN,-9.6530783839029,2.9615313585794993
2000-09-15T09:30:00-04:00,51.25,51.4375,50.28125,50.76562,271500,180895,36.295317146244585,50.19843588541984,NaN,NaN,-154.7319340546423,-168.4864508065729,-0.525999450648136,-0.6327892589798978,-0.10678980833176172,-5052101,-4982661,41.07337557141308,67.80512544260351,NaN,NaN,-12.587693757370296,0.740213484872386
2000-09-18T09:30:00-04:00,51,51.4375,49.28125,49.625,674000,202065,32.36124596230094,48.037889186122364,NaN,NaN,-151.1953887230666,-166.46150259500223,-0.5787745460012955,-0.8302579908333811,-0.2514834448320856,-5726101,-5138481,36.94210129187904,64.35046318030356,NaN,NaN,-16.42790039840847,-1.7123742127391646
2000-09-19T09:30:00-04:00,49.90625,51.625,49.78125,51.5625,268200,211880,43.55342450720846,46.6429296072692,NaN,NaN,-100.32278722541207,-146.50217066052505,-0.45557318505488287,-0.8209499261506892,-0.3653767410958063,-5457901,-5199701,35.43410621363529,60.741781851746985,NaN,NaN,-15.894297570410817,-3.7383632638351147
2000-09-20T09:30:00-04:00,51.3125,51.875,50.34375,51.48437,185200,213835,43.242687836845406,45.384038094676264,NaN,NaN,-80.90258853767165,-124.31716338484689,-0.3561260637308707,-0.8105343207593947,-0.454408257028524,-5643101,-5331961,32.36072489413124,56.900212226914945,NaN,NaN,-15.588817166485116,-5.4312852499279725
2000-09-21T09:30:00-04:00,50.9375,51.40625,50.21875,50.71875,408300,226265,40.2148229641085,43.51685998175056,NaN,NaN,-85.84554921981383,-114.59964955212133,-0.3198431443963341,-0.8542121875239417,-0.5343690431276076,-6051401,-5586121,27.43602739253997,52.68254491404587,NaN,NaN,-16.316002459862904,-6.986244851347248
2000-09-22T09:30:00-04:00,48.5,49.3125,48,49.25,435700,242860,35.132603281092585,41.3175835442781,NaN,NaN,-129.89179050170122,-109.63162084153308,-0.3691954604974772,-0.995863368749454,-0.6266679082519768,-6487101,-5873121,23.15152575066685,48.1986255166394,NaN,NaN,-18.671039933038195,-8.655501291588811
2000-09-25T09:30:00-04:00,49.875,50.0625,47.9375,48.21875,321100,253505,32.06822123571405,39.62670376142852,NaN,NaN,-119.30669334741398,-103.25388176640256,-0.44087345412337786,-1.1777597259061992,-0.7368862717828213,-6808201,-6089541,20.545940478407687,43.775279480059275,NaN,NaN,-21.66736478418217,-10.514338933387862
2000-09-26T09:30:00-04:00,48.3125,48.9375,47.1875,47.20312,778700,287390,29.352793444956802,38.418439173933976,NaN,NaN,-134.575511761734,-110.10442667366695,-0.5207855993431003,-1.3878682709616967,-0.8670826716185964,-7586901,-6515341,16.589887771589773,39.65262498182726,NaN,NaN,-25.071662706272363,-12.593956615228505
2000-09-27T09:30:00-04:00,47.9375,48,46.3125,46.90625,548500,309220,28.59070781987822,36.744239412779734,NaN,NaN,-143.19549613619202,-122.56300819337102,-0.5546130647882483,-1.5603490026039069,-1.0057359378156585,-8135401,-7013801,13.3494195588938,35.64778096120666,NaN,NaN,-28.007430955277435,-14.79588152094978
2000-09-28T09:30:00-04:00,47.25,48.625,46.625,48.46875,635300,335790,37.75129016392997,36.37131850865489,NaN,NaN,-110.6512065176751,-127.52413965294329,-0.4378575291894429,-1.553057849302462,-1.1152003201130192,-7500101,-7303541,11.894994379117762,32.14176725858156,NaN,NaN,-27.52524588346355,-16.614362144166034
2000-09-29T09:30:00-04:00,47.625,47.75,46.375,46.375,260700,339675,31.85435157084727,35.9468803613963,NaN,NaN,-134.98554121949226,-128.5428897965015,-0.46517537137410114,-1.6966695343306455,-1.2314941629565443,-7760801,-7558281,10.782676426209406,29.03176188208163,NaN,NaN,-29.1848639678596,-18.4101481189794
2000-10-02T09:30:00-04:00,47.0625,47.4375,45.875,46.03125,395000,342575,30.99823224554568,35.64758496207812,NaN,NaN,-131.86995803053333,-131.05554273312538,-0.4686224287127909,-1.817272198847533,-1.3486497701347422,-8155801,-7827801,9.744431646642838,26.29009703316212,NaN,NaN,-30.756161561308133,-20.17386432502636
2000-10-03T09:30:00-04:00,46.9375,47.15625,44.75,44.8125,827900,377685,28.113309965212608,34.92370201553594,NaN,NaN,-140.123005140251,-132.16504140882876,-0.5116994106551427,-1.9882740334536706,-1.476574622798528,-8983701,-8107161,8.798736023458957,23.6714450522073,NaN,NaN,-33.04246191371434,-22.012235409124646
2000-10-04T09:30:00-04:00,44.8125,46.39062,44.0625,46.01562,515900,388170,34.58548585236743,34.57960671401801,NaN,NaN,-125.23787131331045,-128.57351644425245,-0.42163314307197397,-2.0036160516384953,-1.5819829085665214,-8467801,-8173641,8.585206906570491,21.192082450368314,NaN,NaN,-32.76354094889847,-23.548136200520908
2000-10-05T09:30:00-04:00,45.75,46.34375,45.125,45.35937,246600,393990,32.848248742430044,34.33338754231698,NaN,NaN,-110.33740449337965,-128.51075603939336,-0.3705363510257216,-2.0451533473486734,-1.6746169963229518,-8714401,-8416501,7.8369770185802,18.81805398230883,NaN,NaN,-33.10040097667295,-24.912745454256914
2000-10-06T09:30:00-04:00,46,46,43.75,44.42187,478300,405350,30.49191621653972,34.19986398904832,NaN,NaN,-125.3856928866596,-126.59078637282683,-0.3636476402072515,-2.1291765465820163,-1.7655289063747648,-9192701,-8702881,7.056038887332747,16.68333523912695,NaN,NaN,-34.136487529014985,-26.230422893508067
2000-10-09T09:30:00-04:00,44.0625,45.125,43,44.17187,340200,408355,29.876446464600377,33.22293698600489,NaN,NaN,-128.5989217459703,-125.93657911591421,-0.3401253454486355,-2.190685588185559,-1.8505602427369237,-9532901,-8978301,6.395938748324525,14.609180420176184,NaN,NaN,-35.151700326436455,-27.504891098212124
2000-10-10T09:30:00-04:00,43.84375,44.4375,42.625,42.875,263800,411305,26.84890754908791,32.05195267973649,NaN,NaN,-136.3106841949674,-125.17411492685748,-0.3734441033406326,-2.3173653719127145,-1.943921268572082,-9796701,-9140901,6.036875598978966,12.728905470522447,NaN,NaN,-36.98546324076621,-28.85925854714842
2000-10-11T09:30:00-04:00,41.6875,42.5625,40.375,41.5,525100,429060,24.064524301781717,30.89835991814172,NaN,NaN,-165.46450156651503,-133.21944097749838,-0.4447780269171018,-2.499893802218459,-2.055115775301357,-10321801,-9511701,5.30541673033656,11.14814756607935,NaN,NaN,-39.47039334904428,-30.37513494741926
2000-10-12T09:30:00-04:00,41.5,42.5,40.0625,40.0625,577800,447890,21.548528823573307,29.928068885461773,NaN,NaN,-162.12561557037225,-143.5770831928969,-0.5391745426167711,-2.729083953572321,-2.1899094109555497,-10899601,-9948741,4.598229412314154,9.822912113339873,NaN,NaN,-42.43487161918825,-32.097954471957685
2000-10-13T09:30:00-04:00,40.875,43.5,40.875,43.4375,460300,457330,37.9512594577349,30.3482859013204,NaN,NaN,-104.39150294105801,-139.37824520377657,-0.3347264279578561,-2.6083174459028697,-2.2735910179450136,-10439301,-10198061,4.25017852300266,8.658929116525233,NaN,NaN,-39.109536770890486,-33.09960908609094
2000-10-16T09:30:00-04:00,43.1875,43.78125,42.3125,42.75,296700,438465,36.28689483656822,30.84357885786407,NaN,NaN,-85.9884995427965,-130.85616076314184,-0.21218214659942491,-2.5388187011942946,-2.3266365545948697,-10736001,-10438681,3.9402012820956003,7.7553800815613645,NaN,NaN,-37.11982736048154,-33.67392598243246
2000-10-17T09:30:00-04:00,42.875,43,41,41.625,388100,444460,33.6837005432247,31.20736405238882,NaN,NaN,-105.51870620896372,-124.69776516594109,-0.1748341968245315,-2.5451793006255343,-2.370345103801003,-11124101,-10704161,3.625981855104314,7.060848817004975,NaN,NaN,-36.399084271839186,-34.06323430949056
2000-10-18T09:30:00-04:00,39.5,42.04687,39.5,40.96875,410200,455710,32.23114102930823,30.813067685630127,NaN,NaN,-121.06796689108674,-115.81845823085544,-0.16253048598631858,-2.573508211283901,-2.4109777252975824,-11534301,-10946661,3.3622237279403606,6.451365199063732,NaN,NaN,-36.301106032347015,-34.38293026989862
2000-10-19T09:30:00-04:00,43.375,44.75,43,44.60937,772000,473895,46.11404803868219,31.831617433332617,NaN,NaN,-22.691323578795455,-87.93159983254007,0.10801764520315782,-2.2759556687936353,-2.383973313996793,-10762301,-10919201,4.211922817096465,5.982025655555667,NaN,NaN,-31.061052049037695,-33.90837623834706
2000-10-20T09:30:00-04:00,44.6875,46.125,44.34375,45.28125,466800,475450,48.22216720280435,33.06189850170824,NaN,NaN,19.08641655955867,-63.23601593241674,0.3365415506012672,-1.9632963757452089,-2.299837926346476,-10295501,-10890441,5.152548694247628,5.654034016098867,NaN,NaN,-26.27960146099978,-32.81855127015459
2000-10-23T09:30:00-04:00,45.4375,46,44.5,45,287200,473755,47.38645013239691,34.43855137079283,NaN,NaN,24.221806221190665,-41.19395477961929,0.46515230849537303,-1.7183975407272598,-2.183549849222633,-10582701,-10859781,6.20992675232246,5.4691190681605475,NaN,NaN,-22.843610621727255,-31.393559748950686
2000-10-24T09:30:00-04:00,45.46875,45.8125,43.6875,44.125,230700,446355,44.78596321673101,35.1671568968188,NaN,NaN,8.026208439906902,-18.484971849845174,0.48544553863183904,-1.5767429259328338,-2.062188464564673,-10813401,-10797641,8.437870870102188,5.458595065555668,NaN,NaN,-20.848215644203098,-29.88708201970103
2000-10-25T09:30:00-04:00,42.0625,43.15625,41,41.01562,541600,446010,37.01272482494604,35.46461947414137,NaN,NaN,-92.52191805113168,-12.77576208185418,0.29308429591333374,-1.6958330946730058,-1.9889173905863395,-11355001,-10761781,9.76992676252398,5.596662904408796,NaN,NaN,-21.7093453269065,-28.718833920730383
2000-10-26T09:30:00-04:00,41.46875,42.21875,39.625,42,1057400,467115,40.53172335157434,36.18174855521527,NaN,NaN,-98.02698801344256,-27.842894968783604,0.23810544465121852,-1.6912855847723165,-1.929391029423535,-10297601,-10668841,13.290787700791,6.0420021053701,NaN,NaN,-21.219338260934606,-27.647477397902414
2000-10-27T09:30:00-04:00,43.25,43.25,41.6875,42.35937,427900,475475,41.80986604684991,37.0341356682331,NaN,NaN,-45.801153853728124,-40.82040905144096,0.23168792851136044,-1.6397811187843345,-1.871469047295695,-9869701,-10583681,16.505720873358413,6.764129400015378,NaN,NaN,-20.428457619452086,-26.616188858123795
2000-10-30T09:30:00-05:00,42.125,42.625,40.84375,41.78125,257800,468615,40.30895022798073,37.995567288154014,NaN,NaN,-68.02883809079651,-59.270537913838396,0.19568764793006976,-1.6268594873831077,-1.8225471353131775,-10127501,-10492641,19.923870440710772,7.75605760299622,NaN,NaN,-20.242540620752983,-25.705667681356537
2000-10-31T09:30:00-05:00,42.8125,44,42.40625,43.71875,394300,446935,47.15569515244626,39.644936634630064,NaN,NaN,9.57722171881233,-58.960335258057306,0.3031276376258103,-1.4436375882809145,-1.7467652259067248,-9733201,-10276601,27.508083535619505,9.341962374802145,NaN,NaN,-17.9045916961891,-24.591228254904046
2000-11-01T09:30:00-05:00,43.25,43.875,42.3125,42.875,388700,440575,44.74850593488404,41.30207785686654,NaN,NaN,-1.5948333641916357,-40.7749183206693,0.3166572613399101,-1.3509436492318372,-1.6676009105717473,-10121901,-10029981,35.068437287036915,11.518405794425197,NaN,NaN,-16.722611727259665,-23.467140179526275
2000-11-02T09:30:00-05:00,43.8125,44.1875,43.25,43.98437,263800,441435,48.472927732119935,42.05362559075119,NaN,NaN,47.78286740727747,-11.61294723652529,0.39453827137489084,-1.1744280713531339,-1.5689663427280247,-9858101,-9942081,37.56767357966091,13.898226869900787,NaN,NaN,-14.577731467095381,-22.197224649179006
2000-11-03T09:30:00-05:00,43.96875,44.46875,43.625,44.3125,315000,433270,49.55605156227419,43.001422499730175,NaN,NaN,69.61579864604012,11.470443263428361,0.4579146882157086,-0.9965729824583889,-1.4544876706740975,-9543101,-9876761,39.433311152682606,16.433449003514145,NaN,NaN,-12.516847383420313,-20.81431361121348
2000-11-06T09:30:00-05:00,44.3125,44.65625,43.5,43.625,161800,424350,47.312036667452574,43.97487508003217,NaN,NaN,58.45560755327606,36.76733239224287,0.44301879644353304,-0.9007141751196812,-1.3437329715632143,-9704901,-9792241,41.85451713549126,19.164058666398926,NaN,NaN,-11.43183908583585,-19.473960107588102
2000-11-07T09:30:00-05:00,43.375,44.21875,43.14062,43.9375,287700,425545,48.45460173311441,45.13369370173261,NaN,NaN,46.89960646180383,44.231809340841174,0.44265213964741945,-0.7904177970039399,-1.2330699366513593,-9417201,-9729041,43.66792675556912,22.043037454086694,NaN,NaN,-10.213560382872005,-18.15104586120009
2000-11-08T09:30:00-05:00,43.9375,44.0625,41.5,41.625,279100,413245,41.31472380008563,44.79088482754714,NaN,NaN,-35.48934512176117,37.45290698932727,0.2828810853244177,-0.8794685799958373,-1.162349665320255,-9696301,-9643921,46.10585404149634,25.035461112972403,NaN,NaN,-11.246047681695421,-17.16461754984228
2000-11-09T09:30:00-05:00,40.1875,41.53125,39.625,41.01562,761900,422450,39.65643353656622,44.17904670853013,NaN,NaN,-133.718565875523,1.1526203327671638,0.13961830187141566,-0.9878267879809854,-1.127445089852401,-10458201,-9763941,43.26279255133321,27.757621388478515,NaN,NaN,-12.596918269333859,-16.51208908119822
2000-11-10T09:30:00-05:00,40.0625,40.125,38.625,38.75,501900,424530,34.165708617011845,43.23470802885977,NaN,NaN,-185.20498036987146,-49.81153547041515,-0.09180293125270378,-1.2421987539182808,-1.150395822665577,-10960101,-10047341,37.3985041508659,29.985376916945903,NaN,NaN,-15.586040176704884,-16.379796380556314
2000-11-13T09:30:00-05:00,37.5,39.75,37.0625,38.625,1331600,476275,33.88693227574707,42.45620581878949,NaN,NaN,-179.99426171688026,-97.50150932444642,-0.22953008430036093,-1.4373084280410282,-1.2077783437406673,-12291701,-10564701,29.529288606938792,31.491906755291375,NaN,NaN,-18.050932288607356,-16.618530081706464
2000-11-14T09:30:00-05:00,40.0625,41,39.6875,40.71875,400400,476890,42.36933021779327,42.838820489707146,NaN,NaN,-85.81081873107655,-124.04359436302249,-0.15919313107924316,-1.4067697575897213,-1.2475766265104782,-11891301,-11059521,24.269412119204745,32.52758428076857,NaN,NaN,-17.604582499063053,-16.759394712757405
2000-11-15T09:30:00-05:00,41.0625,41.5625,40.1875,41,400300,476395,43.41947860313648,43.04508872196159,NaN,NaN,-67.38795715846923,-130.42331677036412,-0.07743948855691762,-1.3443759872066252,-1.2669364986497076,-11491001,-11418461,21.304851291302583,33.10001739437654,NaN,NaN,-16.930150902516182,-16.783788454151516
2000-11-16T09:30:00-05:00,40.78125,41.28125,39.51562,39.6875,152200,445405,39.77681956882775,42.899871116388574,NaN,NaN,-88.74789482328416,-121.42918255991633,-0.09434864884170646,-1.3848723097018407,-1.2905236608601343,-11643201,-11655461,19.602231079017884,33.32119669478079,NaN,NaN,-17.45597074325739,-16.879814495452354
2000-11-17T09:30:00-05:00,39.34375,40.45312,38.75,40,268200,435475,41.0450254614839,42.952447918781665,NaN,NaN,-95.94605883356418,-103.57739825265487,-0.06829259302750534,-1.3758894021445158,-1.3075968091170105,-11375001,-11738441,19.028826634561923,33.25726499434158,NaN,NaN,-17.515485154972936,-16.97062458966958
2000-11-20T09:30:00-05:00,38.8125,39.46875,38.125,38.375,510700,446650,36.715292614122454,42.20670488032996,NaN,NaN,-128.43033980490176,-93.26461387025918,-0.14016374465141834,-1.4828014899312834,-1.342637745279865,-11885701,-11657241,21.450233291064606,32.824561405444804,NaN,NaN,-18.88378756952535,-17.243933586791833
2000-11-21T09:30:00-05:00,39.0625,39.0625,38.03125,38.5625,337400,451985,37.534089599514,41.691389427803536,NaN,NaN,-118.93435076184896,-99.88932027641366,-0.1536571910069151,-1.534709234038509,-1.3810520430315938,-11548301,-11588641,23.530776544598652,32.000442780984926,NaN,NaN,-19.758682538751636,-17.603183437071806
2000-11-22T09:30:00-05:00,38.5625,38.78125,37.125,37.15625,273200,438565,33.98282609341268,40.65638216789587,NaN,NaN,-133.33331447096896,-113.0783917389136,-0.23121245979888339,-1.670067617780198,-1.4388551579813147,-11821501,-11654741,22.901336026472435,30.952847241471467,NaN,NaN,-21.59301741121042,-18.173159719091608
2000-11-24T09:30:00-05:00,38.25,38.84375,37.90625,38.625,132600,392325,40.33267785631523,39.99756976032738,NaN,NaN,-92.58491561296826,-113.8457958968504,-0.16085209902507858,-1.639920281762663,-1.4790681827375844,-11688901,-11663881,22.81047405269736,29.76550173432966,NaN,NaN,-21.263190489974317,-18.614592686360567
2000-11-27T09:30:00-05:00,40,40.1875,38.40625,38.40625,294700,385665,39.719904714974454,39.45527462086466,NaN,NaN,-67.29915808083017,-108.1164157463036,-0.108795186839723,-1.6150621662872382,-1.5062669794475152,-11983601,-11785601,21.582408131595344,28.3174939483371,NaN,NaN,-21.173871437592776,-18.980203936536597
2000-11-28T09:30:00-05:00,38.5,38.875,36.75,36.85937,587600,402155,35.600860913889406,38.5371502766343,NaN,NaN,-107.79392368717895,-103.98913252275904,-0.1554496185979546,-1.7005790026949583,-1.5451293840970037,-12571201,-11922701,20.259366745256656,26.64545394760049,NaN,NaN,-22.340095192090985,-19.460188401615795
2000-11-29T09:30:00-05:00,36.875,37.3125,35.75,36.6875,445100,404695,35.16452485789746,38.09785035219228,NaN,NaN,-126.09318577338301,-105.42089952506585,-0.17342447892701118,-1.7619099827557676,-1.5884855038287564,-13016301,-12216301,17.749944173864876,24.620031814198246,NaN,NaN,-23.413323251055846,-20.024921951535802
2000-11-30T09:30:00-05:00,34.75,35.51562,33.76562,34.75,1683300,469425,30.609934528861572,37.451671851641954,NaN,NaN,-168.29911125215332,-112.41405888130275,-0.2847643799181303,-1.9444409787264192,-1.6596765988082889,-14699601,-12791921,14.070233008767872,22.53484898972929,NaN,NaN,-25.796944190404847,-20.84949655708852
2000-12-01T09:30:00-05:00,35.75,36.6875,34.625,35.20312,890600,500765,32.8020175777601,37.35426534883826,NaN,NaN,-130.65160154152684,-120.02739606701448,-0.29557423892487167,-2.0291443974643784,-1.7335701585395067,-13809001,-13215941,12.0830869501238,20.726604903962,NaN,NaN,-27.106540900600802,-21.743360034733133
2000-12-04T09:30:00-05:00,35.4375,35.8125,34.28125,35,709500,520490,32.30928509384272,37.241576264416516,NaN,NaN,-137.0889846645417,-133.9853613837568,-0.28401317475945165,-2.088586626988821,-1.8045734522293695,-14518501,-13722921,10.223859432450354,19.347645677212824,NaN,NaN,-28.319815621515826,-22.6828536899878
2000-12-05T09:30:00-05:00,36.625,38.46875,36.0625,38.3125,996600,562230,46.43935520267833,37.532292334765444,NaN,NaN,-43.26792302132493,-121.08016125058597,-0.034030520687946764,-1.847111603089303,-1.8130810824013561,-13521901,-13913061,9.625651564864498,18.301662780474235,NaN,NaN,-24.87789177715172,-22.99643055958265
2000-12-06T09:30:00-05:00,38,38.625,36.75,37.25,1838600,639775,43.316000543654134,37.52490104480243,NaN,NaN,-38.98428129678343,-103.65838035526606,0.07316094637779047,-1.721629899429118,-1.7947908458069084,-15360501,-14381901,8.331213266792133,17.37497435015206,NaN,NaN,-23.032866416070693,-23.001635681938083
2000-12-07T09:30:00-05:00,36,36.75,35.64062,36.01562,1571200,704380,39.95398409481148,37.537555653801256,NaN,NaN,-89.25344301080513,-87.84924670699641,0.07409878127150504,-1.702167369217527,-1.776266150489032,-16931701,-14828321,7.321588077195486,16.497785564307602,NaN,NaN,-22.56626796419083,-22.939440293688474
2000-12-08T09:30:00-05:00,37.5,38.5,37.07812,37.6875,1386200,735595,46.06057346911522,37.89580908291778,NaN,NaN,-10.920124162944088,-63.90295123127985,0.193691572675456,-1.534151684644712,-1.727843257320168,-15545501,-15175621,6.64673940030427,15.613350761860627,NaN,NaN,-20.14945008300054,-22.540870263590197
2000-12-11T09:30:00-05:00,37.5625,39.375,37.5625,39.10937,1309100,775955,50.656605197698745,38.89161712460181,NaN,NaN,35.71789890021,-29.341574518329516,0.364989223943446,-1.2716067273908607,-1.6365959513343067,-14236401,-15119201,8.128220851262654,14.661778444731913,NaN,NaN,-16.596903950928482,-21.691732218924237
2000-12-12T09:30:00-05:00,38.875,39.07812,38.125,38.3125,1062100,762480,48.17892055970952,39.6519621931872,NaN,NaN,26.90998056351364,-15.305993801361797,0.41728808605930645,-1.1149858437601736,-1.53227392981948,-15298501,-15474521,7.338382320688083,13.505178857309732,NaN,NaN,-14.497626086481723,-20.66400277143245
2000-12-13T09:30:00-05:00,38.875,38.875,36.6875,36.6875,1046200,794770,43.505793279526266,40.33217413505246,NaN,NaN,-20.873914387795455,-11.683920419564199,0.33845881385822585,-1.1092004124966977,-1.4476592263549235,-16344701,-15671361,6.936270160096186,12.36481700971143,NaN,NaN,-14.217026276024637,-19.743006129231333
2000-12-14T09:30:00-05:00,37,37.4375,36.125,36.125,628700,806190,41.987605479633054,40.450383251003736,NaN,NaN,-60.263676785251604,-5.8859671744535,0.24860817985568362,-1.136899001535319,-1.3855071813910027,-16973401,-15679701,6.918970970478412,11.229709646695792,NaN,NaN,-14.465543359167283,-18.98908287636504
2000-12-15T09:30:00-05:00,35,35.4375,34,34.6875,751900,836175,38.308489773451576,40.34956789803782,NaN,NaN,-144.78910414459824,-32.65976317078433,0.10015260433017703,-1.2603164259782815,-1.3604690303084586,-17725301,-16115661,6.067147522709178,10.121476746061067,NaN,NaN,-15.845443132919169,-18.5399914844442
2000-12-18T09:30:00-05:00,35.375,35.5625,33.625,34,728000,859165,36.654258199714754,40.424810561311055,NaN,NaN,-138.28914136312122,-67.46117122345058,-0.02961814677608987,-1.397491713778571,-1.367873567002481,-18453301,-16959041,4.82864999017724,9.019282692126824,NaN,NaN,-17.489304523324943,-18.38989334714145
2000-12-19T09:30:00-05:00,34.0625,35.48437,32.84375,33,799200,873590,34.33199071301115,40.365343836676324,NaN,NaN,-145.62670452579144,-101.96850824131158,-0.16075032890797347,-1.568811478137448,-1.4080611492294746,-19252501,-17749841,4.003428209849815,8.037388694697174,NaN,NaN,-19.58859314255431,-18.561136175057573
2000-12-20T09:30:00-05:00,31.1875,31.8125,30.125,30.53125,2044900,958965,29.38271619008495,40.27768538390656,NaN,NaN,-228.97208086856784,-143.58814153746607,-0.3792274751745599,-1.8820954931976743,-1.5028680180231144,-21297401,-18740381,3.253407213188595,7.264758280727228,NaN,NaN,-23.127059556640855,-19.213410943855184
2000-12-21T09:30:00-05:00,30.4375,31.625,29.625,30.625,6158699,1253239.95,29.796601053190855,40.06301277500876,NaN,NaN,-191.11400966183498,-169.75820811278274,-0.47660072012545274,-2.0986189181799304,-1.6220181980544777,-15138702,-18373441.2,9.981336562552059,7.1146332530435314,NaN,NaN,-25.786918054768766,-20.15248338827141
2000-12-22T09:30:00-05:00,31.5625,32.73437,31.5625,32.73437,2028500,1348034.95,38.52673639775295,40.50711643957378,NaN,NaN,-114.15496568099773,-163.63138042006264,-0.36324549051039323,-2.076075061192469,-1.712829570682076,-13110202,-17450421.4,24.25127089973722,8.116591214992594,NaN,NaN,-25.362849688174617,-20.896821431114724
2000-12-26T09:30:00-05:00,33.1875,33.21875,31.5,32.1875,1123000,1389449.95,37.23397533747849,39.84958930634521,NaN,NaN,-103.373314681235,-156.64821508368541,-0.2924391253625678,-2.078378477385286,-1.785939352022718,-14233202,-16606401.6,34.47934662772771,9.891855148054253,NaN,NaN,-25.4166725121745,-21.542514442694692
2000-12-27T09:30:00-05:00,32.3125,32.92187,31.6875,32.5,1294800,1424809.95,38.50383199603426,39.50586298151522,NaN,NaN,-90.43773198653172,-145.61042057583344,-0.1965038371412997,-2.0315691484493428,-1.835065311308043,-12938402,-15343581.8,46.187207316374035,12.595854723024388,NaN,NaN,-25.085836138650645,-22.048703256402685
2000-12-28T09:30:00-05:00,32.8125,32.84375,31.76562,32.34375,1484800,1476794.95,38.088894073664626,39.37264226571902,NaN,NaN,-82.89329765534545,-116.39466393318897,-0.11931397102088637,-1.9842077750841511,-1.8648938040632648,-14423202,-13968742,55.50842238904429,16.037771459585016,NaN,NaN,-24.93134792717817,-22.46050963794204
2000-12-29T09:30:00-05:00,32.4375,32.5,31.0625,31.3125,3387700,1562014.95,35.378994022534286,38.60967230524894,NaN,NaN,-93.16834251504966,-96.80553050383192,-0.11348830781211605,-2.0067541888284097,-1.8932658810162937,-17810902,-14503182,51.75545595970782,19.259822642399552,NaN,NaN,-25.56540646641033,-22.904066327723225
2001-01-02T09:30:00-05:00,31.4375,31.60937,29.14062,29.5,1905800,1612774.95,31.180132059298288,37.21849565250606,NaN,NaN,-120.30154835943313,-98.034847039519,-0.2022966223735838,-2.1461366589832735,-1.9438400366096897,-19716702,-15824482,43.86008673526361,21.81209877697105,NaN,NaN,-27.40541404236786,-23.547116001243886
2001-01-03T09:30:00-05:00,29.5625,34.625,29.3125,34.25,2574900,1706044.95,48.44779733378819,37.23770113636882,NaN,NaN,-44.648492792185834,-86.28988266170914,0.07350029148767345,-1.851964672250098,-1.9254649637377714,-17141802,-16406202,40.90170024317397,24.209478628577187,NaN,NaN,-23.045740701998817,-23.47549095849459
2001-01-04T09:30:00-05:00,34.65625,35.6875,34.25,34.59375,927400,1702584.95,49.43655580190202,37.66132703082423,NaN,NaN,15.889037513437337,-65.02452876171533,0.2820028657613629,-1.572961381536068,-1.8549642472974308,-16214402,-17061402,37.80842485669751,26.414632535477278,NaN,NaN,-19.365718862358445,-22.888380659046568
2001-01-05T09:30:00-05:00,34.125,34.1875,32.14062,32.5,1062900,1663799.95,43.91204921930224,37.79878729794346,NaN,NaN,-32.60641267299167,-54.967151765244566,0.28119830508202837,-1.5034663659448952,-1.7846646710269236,-17277302,-17632222,35.30344473490197,28.44209494722182,NaN,NaN,-18.1149757966517,-22.206465678704443
2001-01-08T09:30:00-05:00,31.875,32.46875,31.14062,32.40625,610900,1615784.95,43.67669273392834,38.18223036654894,NaN,NaN,-55.25504182693523,-47.384491627621685,0.2762406833849407,-1.4393638167957477,-1.7156045001806883,-17888202,-17647682,35.23535379521874,30.525538252401077,NaN,NaN,-17.223502490247363,-21.494613794639147
2001-01-09T09:30:00-05:00,33,33.75,32.75,33.125,630700,1578009.95,46.063495474041396,38.85431874328656,NaN,NaN,-13.508785495977314,-26.025939054930525,0.3201621336782121,-1.3154018330829231,-1.6355639667611352,-17257502,-17155842,39.2497423666069,32.984187707860336,NaN,NaN,-15.7568196384272,-20.674928915180296
2001-01-10T09:30:00-05:00,33.0625,34.3125,32.3125,34.125,1145300,1569819.95,49.28369519722945,39.92229763501644,NaN,NaN,8.862660325752081,-15.323708431342942,0.40963660803284574,-1.1235182067200782,-1.533154814752924,-16112202,-16949922,40.901392383550814,35.619756577410406,NaN,NaN,-13.541520461872775,-19.655870564707794
2001-01-11T09:30:00-05:00,34.28125,36,33.8125,35.5625,1082200,1570824.95,53.57459387061923,41.65028889791174,NaN,NaN,86.5152428471425,-1.198467364601902,0.5499590187947301,-0.8457060412595112,-1.3956650600542413,-15030002,-16713042,42.82703275623403,38.446444116199366,NaN,NaN,-10.303725871913715,-18.31984989430864
2001-01-12T09:30:00-05:00,35.375,36.10937,34.75,35.03125,715500,1554289.95,51.829365279270554,43.22405777120315,NaN,NaN,107.32315939702238,26.787447049400907,0.5879015048744063,-0.6607881789612335,-1.2486896838356398,-15745502,-16406682,45.309033361586415,40.96985103041611,NaN,NaN,-8.167943788923564,-16.869577593539343
2001-01-16T09:30:00-05:00,34.8125,35,34.0625,34.625,663100,1556009.95,50.47526400983841,44.07752402920925,NaN,NaN,83.22355625047534,54.483166664883015,0.5663224913020801,-0.5407865697080396,-1.1071090610101197,-16408602,-16110762,47.672076201961396,42.64276569486069,NaN,NaN,-6.7950573314055225,-15.430360413234512
2001-01-17T09:30:00-05:00,36,36.57812,35.40625,35.6875,615400,1549184.95,53.869803079033744,45.265797439320345,NaN,NaN,142.76290078225946,85.73750392053037,0.6010091926392922,-0.35584757021100444,-0.9568567628502966,-15793202,-15817902,49.97567912169561,43.749646587286975,NaN,NaN,-4.624121700863277,-13.886612025752907
2001-01-18T09:30:00-05:00,35.625,37.6875,35.5625,37.5625,1122400,1568904.95,59.18625733072853,46.74311353465565,NaN,NaN,170.90413376416257,118.14579860821247,0.719625850162785,-0.05732445014681531,-0.7769503003096003,-14670802,-15529622,52.206094623003,44.179567109189044,NaN,NaN,-1.0487540414718797,-12.05263231371276
2001-01-19T09:30:00-05:00,38.5,38.75,37.5,38.07812,1035900,1580739.95,60.533298200777686,48.34628525802087,NaN,NaN,182.4390394513784,137.33055792905967,0.7962374683199469,0.2183465350903333,-0.5778909332296136,-13634902,-15250602,54.32862616791255,44.09529595053677,NaN,NaN,2.297706619277461,-10.002583894714157
2001-01-22T09:30:00-05:00,37.6875,38.0625,36.90625,37.375,562500,1506619.95,57.7349759835705,49.943141112380594,NaN,NaN,134.62082239165628,142.79009052798642,0.7629131081029208,0.37575045189903733,-0.3871626562038834,-14197402,-14940982,56.630313221504096,44.44350004066508,NaN,NaN,4.3074643474962375,-7.9582912886841
2001-01-23T09:30:00-05:00,37.625,38.35937,37.0625,38,468100,1222090,59.52605272395869,51.96784973128491,NaN,NaN,128.6561926777559,151.87661781344255,0.7454486068579393,0.5446481023685408,-0.20080050448939854,-13729302,-14405122,60.35427786352919,45.62165654982691,NaN,NaN,6.5136160135177565,-5.89087595979812
2001-01-24T09:30:00-05:00,38.46875,39.0625,38.125,38.46875,570800,1149205,60.86553932507488,52.8548313020911,NaN,NaN,134.12160932857523,150.1483595227057,0.7271697378388109,0.7081616678091152,-0.01900807002969579,-13158502,-13878182,63.65883049513221,47.247165853538206,NaN,NaN,8.744157418627312,-3.8001569057373445
2001-01-25T09:30:00-05:00,38.25,38.40625,37.01562,37.125,457300,1115920,55.223352526275846,53.26817392526066,NaN,NaN,90.83258430453725,134.13404963078065,0.592011764800785,0.7210066359712854,0.12899487117050046,-13615802,-13667182,64.91974335481929,49.18368860340405,NaN,NaN,9.10752641011929,-1.956202146329254
2001-01-26T09:30:00-05:00,36.375,37.5,35.54687,37.375,731400,1087750,56.039825121072354,54.13444363252995,NaN,NaN,62.1247958104702,110.071200902599,0.491041525118599,0.7427967775687492,0.2517552524501502,-12884402,-13517082,65.8280629689354,51.36401847726358,NaN,NaN,9.633693806327496,-0.3005027245211469
2001-01-29T09:30:00-05:00,37,38.25,36.75,38.16,345000,1030760,58.59298656222443,55.19989319169396,NaN,NaN,83.15092862458806,99.77722214918533,0.4498157883661652,0.8140249879078567,0.3642091995416915,-12539402,-13185482,67.81096991542005,53.6908482001351,NaN,NaN,10.79585545452739,1.2846913010572154
2001-01-30T09:30:00-05:00,38.14999,38.47,37.75,38.25,706100,896680,58.887799894803045,56.11591493603407,NaN,NaN,88.43399004321047,91.73278162227625,0.4028193723262624,0.8677334149495195,0.4649140426232571,-11833302,-12806282,69.9578243935357,55.88428263063002,NaN,NaN,11.83937050266989,2.7925026155733117
2001-01-31T09:30:00-05:00,38.3,39,37.22,37.3,951700,848975,54.47855170309179,56.48697611502424,NaN,NaN,71.994635568028,79.30738687016682,0.2873811588904339,0.8241404912362995,0.5367593323458656,-12785002,-12731582,70.376966415383,57.98968077576088,NaN,NaN,11.557994054203826,4.044715678234814
2001-02-01T09:30:00-05:00,37.42,37.64999,36.75,37.28,1437100,792085,54.386226723762825,56.54494989024879,NaN,NaN,44.351178307212294,70.01110567070182,0.19379184224378665,0.7789991351505989,0.5852072929068123,-14222102,-12852842,68.7013419629295,59.83784571909627,NaN,NaN,11.299630801634898,5.081132124434826
2001-02-02T09:30:00-05:00,37.5,37.60001,35.61,35.64,1214300,806430,47.30654927742479,56.22189160440265,NaN,NaN,5.320422313995796,58.65023097140695,0.014976791255614241,0.6039282819763301,0.5889514907207158,-15436402,-13363242,62.00899255534182,61.030699947221656,NaN,NaN,9.033244143989803,5.645719555799823
2001-02-05T09:30:00-05:00,35.39999,35.67,34.78,35.42,782700,792420,46.43334070729143,55.93318279707787,NaN,NaN,-42.95119797779212,33.429805650930916,-0.11729537098600995,0.44233227698820343,0.5596276479742134,-16219102,-14099182,53.861756080087396,61.47281993851637,NaN,NaN,6.899039477329054,5.824765258875427
2001-02-06T09:30:00-05:00,35.39999,36.39999,35.39999,35.63,322500,778000,47.430832015578865,55.47325629254538,NaN,NaN,-33.06274151335284,9.130459339618259,-0.18575249161430318,0.32743703345633435,0.5131895250706375,-15896602,-14911842,46.58333202465348,61.23050943158479,NaN,NaN,5.360740503574559,5.75847600811816
2001-02-07T09:30:00-05:00,34.85001,35.32001,33.92999,34.71001,704900,781710,43.60035323371342,54.35997742847287,NaN,NaN,-101.90758624906594,-25.649985023800532,-0.28231289951386973,0.16029840067830037,0.4426113001921701,-16601502,-15675142,40.98166253745914,60.42876428261739,NaN,NaN,2.9199879499527777,5.352977714094534
2001-02-08T09:30:00-05:00,35.14999,35.39999,34.10001,34.2,776300,763260,41.59489941884869,53.007234658335086,NaN,NaN,-114.31466724915924,-57.383154135074825,-0.3646186332673274,-0.013161991391989147,0.35145664187533826,-17377802,-16306282,37.017848830167296,59.19228018706415,NaN,NaN,0.25966719072519706,4.625361925041771
2001-02-09T09:30:00-05:00,33.7,33.83,32.35001,32.62,837300,751015,36.061085722031734,51.45909963965374,NaN,NaN,-182.134813151409,-94.87420122815578,-0.5011284333460827,-0.27495389980726515,0.22617453353881758,-18215102,-16862022,33.90788722721176,57.569249758900405,NaN,NaN,-3.87572128540652,3.4109214664063012
2001-02-12T09:30:00-05:00,32.60001,33.24001,32.07001,32.89999,1242900,777385,37.64426812267941,49.89611502527664,NaN,NaN,-167.45695572353605,-119.77535277730458,-0.544613833206717,-0.45459275796957854,0.09002107523713837,-16972202,-17012642,33.09632962069908,55.62225345584112,NaN,NaN,-6.860224092626972,1.9436149579729765
2001-02-13T09:30:00-05:00,33.45,33.85001,32.33,32.34,644100,776435,35.73827338513691,48.101310315281076,NaN,NaN,-148.57193289222292,-142.87719105307858,-0.5798780408394684,-0.6348264758121971,-0.05494843497272875,-17616302,-17356582,31.256635670478857,53.30781096836587,NaN,NaN,-9.962018808963178,0.24281013412495467
2001-02-14T09:30:00-05:00,32.25,33.24001,31.64999,33.10001,713300,781330,40.16613096973113,47.0257944898136,NaN,NaN,-132.50004881284602,-148.99568356583458,-0.5225797808276302,-0.7081731610072666,-0.18559338017963634,-16903002,-17416882,30.93200235286804,50.88011518251221,NaN,NaN,-11.406627089565633,-1.4213951835451293
2001-02-15T09:30:00-05:00,34,34.85001,33.8,34.10001,689600,759690,45.48838589260922,46.27212025920909,NaN,NaN,-63.70132593023178,-138.8730153020491,-0.3937621626327397,-0.677796083470561,-0.28403392083782125,-16213402,-17184002,33.7919698019266,48.59182281344016,NaN,NaN,-11.118209789619556,-2.806654412984333
2001-02-16T09:30:00-05:00,32.25,35.2,31.50999,31.99001,609400,738365,37.840043063480785,44.78976715215597,NaN,NaN,-101.08301541796865,-122.66265575536104,-0.4244458995501189,-0.8145912952754699,-0.390145395725351,-16822802,-16905542,37.14354829946538,46.40129269801482,NaN,NaN,-13.322177897772235,-4.308872053668319
2001-02-20T09:30:00-05:00,32,32.00999,30.23,30.27,637200,742100,32.97306549065226,42.93871469471662,NaN,NaN,-150.90824739539366,-119.35291408973255,-0.5276378548315426,-1.0496927142647792,-0.5220548594332366,-17460002,-17003102,36.44740444955272,44.00769127344461,NaN,NaN,-16.916460198030133,-6.109956074291435
2001-02-21T09:30:00-05:00,30.13,30.89,29.3,29.5,924500,764920,31.047831868185398,41.26509184936617,NaN,NaN,-157.70930843593644,-121.18038919847527,-0.6090370516487125,-1.2833511739941272,-0.6743141223454148,-18384502,-17156742,35.32458516751558,41.50394975573978,NaN,NaN,-20.475593117284095,-8.1621899375761
2001-02-22T09:30:00-05:00,29.39999,30.17,28.25999,29.55,935300,783145,31.3282243419159,39.61809167923424,NaN,NaN,-155.52177125948913,-125.78473368780388,-0.618791286286705,-1.447803230203796,-0.829011943917091,-17449202,-17265982,34.5105242792753,39.06174849262163,NaN,NaN,-23.17903231177544,-10.307453133890291
2001-02-23T09:30:00-05:00,29.14999,29.62,28,29.33,1080900,814325,30.735977417916274,38.434479403555066,NaN,NaN,-143.7929972314986,-141.80306794805725,-0.5989489322472428,-1.5776981092261444,-0.9787491769789016,-18530102,-17729322,31.223765156234776,36.86280367839969,NaN,NaN,-25.549862657476,-12.48494020868825
2001-02-26T09:30:00-05:00,29.75,30.05,28.89999,29.8,856500,820580,33.62296389965124,37.51945248872362,NaN,NaN,-112.47209360219001,-144.08088358490153,-0.5161968649869464,-1.6239952582125845,-1.1077983932256381,-17673602,-17899482,30.090357772885625,35.16484665645671,NaN,NaN,-26.707069800410416,-14.516673007505702
2001-02-27T09:30:00-05:00,29.7,29.97,28.58,28.66,466700,826665,30.32168614714668,36.29737064097847,NaN,NaN,-115.14879553546648,-136.92899321291605,-0.4999221300258465,-1.7327010557579463,-1.2327789257320998,-18140302,-18035542,29.1783079929138,33.92163065418959,NaN,NaN,-28.715739739809788,-16.545111112120573
2001-02-28T09:30:00-05:00,28.64999,29.23,27.59,28.00999,1662300,874475,28.597537974099268,35.22574097957746,NaN,NaN,-126.59532766497873,-130.7061970587245,-0.4937578068171282,-1.84997618425351,-1.3562183774363819,-19802602,-18319162,27.319417941984625,32.94575604022713,NaN,NaN,-30.927083202821105,-18.59967855364922
2001-03-01T09:30:00-05:00,27.64999,28.8,26.85001,28.8,995200,876650,33.54355468903725,34.65064492744806,NaN,NaN,-113.8248864345005,-122.3668200937268,-0.40122955166285346,-1.8577553170149486,-1.456525765352095,-18807402,-18590802,25.634932254169314,32.13269057051299,NaN,NaN,-31.349070899882246,-20.421020317396795
2001-03-02T09:30:00-05:00,27.8,29.03999,27.2,27.8,815500,845570,30.649432121610772,34.264098241703714,NaN,NaN,-104.30718825607602,-114.46965829864227,-0.372740314245009,-1.9224511581583563,-1.5497108439133473,-19622902,-18809362,24.334806321758208,31.448899077266304,NaN,NaN,-32.58587134980013,-22.1588561791687
2001-03-05T09:30:00-05:00,28.2,28.58,27.96001,28.39999,544700,812090,34.31149589638676,34.02604308268281,NaN,NaN,-86.90915879219553,-109.35707133664337,-0.282925770898693,-1.9033680575367136,-1.6204422866380206,-19078202,-19090282,22.738515502126646,30.709055211653983,NaN,NaN,-32.52446254596588,-23.639657088711157
2001-03-06T09:30:00-05:00,29.5,30.21001,29.39999,29.60001,898100,817860,41.01977969619569,34.40329353347272,NaN,NaN,-42.18829450281273,-94.76497113011263,-0.12044458275633763,-1.7709980150834426,-1.650553432327105,-18180102,-19098242,22.693090718994796,30.097373429405117,NaN,NaN,-30.380659907584505,-24.60265749140735
2001-03-07T09:30:00-05:00,30.09,30.09,29.3,29.64,965300,850000,41.235150726368126,34.47965208751822,NaN,NaN,-38.6662657297833,-77.17915874307353,0.0053092311966032035,-1.643916893331351,-1.6492261245279543,-17214802,-18580682,32.179925493567424,30.186510796597933,NaN,NaN,-28.598480538572502,-25.173489355288087
2001-03-08T09:30:00-05:00,29.64999,29.64999,28.85001,29.05,464400,837975,38.97394265163864,34.01433471316317,NaN,NaN,-49.722089323212515,-64.35859932081593,0.061234224969019646,-1.5726833433166796,-1.6339175682856992,-17679202,-18355042,35.87457586635966,30.335268372628867,NaN,NaN,-27.724802780545506,-25.537962701753433
2001-03-09T09:30:00-05:00,28.00999,28.16,26.95,27.14999,730100,835665,32.746299378589114,33.650495878528055,NaN,NaN,-107.51094289592602,-64.99935024878593,-0.013281156486775414,-1.6505190138941686,-1.6372378574073931,-18409302,-18112322,39.681215966941195,30.516530348877147,NaN,NaN,-28.867531139369074,-26.013615335698525
2001-03-12T09:30:00-05:00,26.10001,26.53,25.35001,25.7,1025600,845080,28.945118611149113,33.36278538713497,NaN,NaN,-158.598619843644,-79.33724245907561,-0.13689832314550676,-1.8083607613392765,-1.6714624381937697,-19434902,-18183662,38.94936248029627,30.695241636787394,NaN,NaN,-31.11821736695304,-26.74284419730631
2001-03-13T09:30:00-05:00,25.85001,26.99001,25.50999,26.98,1169000,841385,36.00697060430059,33.71700958257177,NaN,NaN,-126.60372313772895,-96.22032818605886,-0.11027771835013422,-1.8093095861314374,-1.6990318677813032,-18265902,-18200822,38.764163558698826,30.9409258075862,NaN,NaN,-30.665826070890496,-27.30327017924691
2001-03-14T09:30:00-05:00,25.60001,27.14999,25.60001,26.32001,797200,849040,34.12378157836068,33.91669224231783,NaN,NaN,-123.43135576521605,-113.17334619314542,-0.11444076949108628,-1.842082829645161,-1.7276420601540747,-19063102,-18570482,34.91297473107059,30.969672268428717,NaN,NaN,-30.906306759310326,-27.817989690684538
2001-03-15T09:30:00-05:00,26.91,27.25,26.00999,26.00999,375100,832130,33.24423130890317,34.09585323453118,NaN,NaN,-110.7747927846503,-125.38388688543299,-0.11508508430555953,-1.8714984155360241,-1.7564133312304646,-19438202,-18922282,31.686577824562704,31.002730316166424,NaN,NaN,-31.370155678524732,-28.325441974661707
2001-03-16T09:30:00-05:00,25.8,26.10001,25.10001,25.44,469300,821115,31.630003020505953,33.9534988860208,NaN,NaN,-139.05718004952007,-131.69313431615188,-0.12981852318882048,-1.9186864852164902,-1.7888679620276697,-19907502,-19221922,29.21053008764794,30.93988548150659,NaN,NaN,-32.24280060473134,-28.88506463610023
2001-03-19T09:30:00-05:00,25.5,26.42,25.16,26.23,2079500,894620,36.25031438694708,34.37697233172083,NaN,NaN,-112.10114283109017,-122.39363891364113,-0.06552313358527329,-1.8707718790092613,-1.805248745423988,-17828002,-18900542,35.07092191050529,31.36078647562027,NaN,NaN,-31.584931646426384,-29.270759923289678
2001-03-20T09:30:00-05:00,26.55,26.75,24.97,24.97,1591500,942335,32.48021564830816,34.654306451307185,NaN,NaN,-114.71789919280647,-120.01647412465661,-0.0857413462459391,-1.912425428231412,-1.8266840819854728,-19419502,-19131262,32.96125992430447,31.763775188643113,NaN,NaN,-32.177156534518275,-29.685959439179477
2001-03-21T09:30:00-05:00,25,25.89999,24.8,25.09,1064000,949310,33.192837861091206,34.629255249311036,NaN,NaN,-113.53500768546333,-118.03720450870608,-0.06960737744841206,-1.9136933037959878,-1.8440859263475757,-18355502,-18989742,35.52329908198445,32.47008710491563,NaN,NaN,-32.4415474262198,-30.079614865899522
2001-03-22T09:30:00-05:00,25.28,26.39,24.64999,26.24001,1589600,982025,39.755101034365715,35.279660171650676,NaN,NaN,-80.87907089110331,-112.05806012999668,0.03435714632600306,-1.801139493440072,-1.835496639766075,-16765902,-18455282,44.19691521416494,33.88880916865896,NaN,NaN,-30.66840278339541,-30.163727425541794
2001-03-23T09:30:00-05:00,26.89999,27.10001,25.97,26.8,734300,964695,42.70631510467546,35.87929011509987,NaN,NaN,-35.71270397199467,-91.38916491449159,0.15019016337792346,-1.6477589355436706,-1.797949098921594,-16031602,-17680102,53.886358849828426,36.113655122066234,NaN,NaN,-28.297573460669646,-29.89713400198863
2001-03-26T09:30:00-05:00,27,27.09,26.2,26.45,1718700,1007805,41.34312571696543,35.90238625944056,NaN,NaN,-32.60544699974092,-75.49002574822174,0.20897421426629315,-1.5367313310887276,-1.7457055453550208,-17750302,-17664562,54.05857672146775,38.35404697938573,NaN,NaN,-26.724263605618802,-29.443866802507227
2001-03-27T09:30:00-05:00,26.60001,27.45,26.25,27.3,814900,1025215,45.86268775028423,36.23292461829171,NaN,NaN,-6.097458831429983,-53.76593767594644,0.30502442337762403,-1.3644250161329907,-1.6694494395106148,-16935402,-17167742,59.2928056365089,40.29068127531012,NaN,NaN,-24.018912710758254,-28.6688733608288
2001-03-28T09:30:00-05:00,26.25,26.53999,25.13,25.28,458300,965015,38.30847188676825,36.18539099222954,NaN,NaN,-75.81402921919171,-46.221741982692116,0.23554532030291853,-1.3750177891319666,-1.6105631094348851,-17393702,-16975382,61.138939935928576,42.095278708850756,NaN,NaN,-23.909602889471174,-27.98897757920628
2001-03-29T09:30:00-05:00,25.05,25.74001,24.42999,24.95,469600,938735,37.22961053662907,36.50562750351811,NaN,NaN,-102.50808286587679,-50.547544377646815,0.17327285699859662,-1.3939720381866394,-1.567244895185236,-17863302,-17194862,57.91175598888791,43.39746013898981,NaN,NaN,-24.155580318547454,-27.441349399112163
2001-03-30T09:30:00-05:00,24.89999,25.2,24.3,24.8,799200,937920,36.723348820609075,37.061215375622396,NaN,NaN,-110.97434242749306,-65.59987206874649,0.12987405690990328,-1.4049023240478569,-1.5347763809577601,-18662502,-17721042,50.96612790621105,44.25580052655515,NaN,NaN,-24.503183013227652,-27.021611343985803
2001-04-02T09:30:00-04:00,24.95,25.14999,23.8,24.2,1107700,966070,34.69122173979795,36.96723331387221,NaN,NaN,-125.95906231052227,-84.27059513090276,0.07156598213044107,-1.4453189032947087,-1.5168848854251498,-19770202,-18125022,46.368073993065074,44.79893698615273,NaN,NaN,-25.3923548060007,-26.788860409987933
2001-04-03T09:30:00-04:00,23.55,23.74001,22.41,22.58,1083900,975360,29.883031088193405,36.66432256457455,NaN,NaN,-200.8618379518259,-123.22347095498193,-0.058287461998676404,-1.5897442129234953,-1.531456750924819,-20854102,-18908762,39.01426023278687,45.09188595056104,NaN,NaN,-27.7208538720397,-26.922002333138185
2001-04-04T09:30:00-04:00,22.89999,23.2,21.85001,22.14999,1223200,988255,28.744196920651476,36.34289153684228,NaN,NaN,-217.37441740030965,-151.53554859120555,-0.15010179477551633,-1.7190839943942144,-1.5689821996186981,-22077302,-19845482,32.40025591126526,45.14286295675408,NaN,NaN,-29.980557911361405,-27.35893884431293
2001-04-05T09:30:00-04:00,23.35001,24.59,23.25,24.49001,1690900,1049580,41.752945192133495,37.065958834815675,NaN,NaN,-96.25694647868458,-150.2853213137671,-0.0361419347990366,-1.614159618117494,-1.5780176833184574,-20386402,-20350102,29.498989641689235,45.16346721061417,NaN,NaN,-27.72569489829101,-27.4113325663098
2001-04-06T09:30:00-04:00,23.8,23.89,23.00999,23.35001,485500,1037350,38.10332162212753,37.19831649447143,NaN,NaN,-124.05519796993202,-152.90149242225488,-0.0211851331416395,-1.6044990997455066,-1.5833139666038671,-20871902,-20791982,27.201973090489275,44.60139943775589,NaN,NaN,-27.07328675763378,-27.36304030792751
2001-04-09T09:30:00-04:00,23.64999,23.99001,22.89999,23.41,1459000,1059020,38.40842076740724,37.62175971726422,NaN,NaN,-106.00463431171521,-148.91060682249346,0.007563252919802865,-1.5738599004541136,-1.5814231533739165,-19412902,-20720522,28.17599771148997,44.25959499398342,NaN,NaN,-26.469886755689053,-27.235446943322014
2001-04-10T09:30:00-04:00,24.10001,25.44,24.10001,24.98,848800,1043010,45.92128414975872,38.53093445216904,NaN,NaN,-16.360185297531594,-112.01027629163461,0.13979697135453173,-1.4066769391807519,-1.5464739105352836,-18564102,-20262522,34.248185807753686,44.16851547439551,NaN,NaN,-23.467229373372525,-26.697130147614946
2001-04-11T09:30:00-04:00,26.3,26.64999,25.50999,25.89,1524700,1079385,49.74749001895279,39.24467652249668,NaN,NaN,59.56161041487581,-56.6230707285975,0.28752309755518324,-1.1870700385913047,-1.474593136146488,-17039402,-19254942,45.22037763875428,44.24161993329475,NaN,NaN,-19.7259260631513,-25.701243849834423
2001-04-12T09:30:00-04:00,25.8,26.67,25.16,26.53999,466200,1083940,52.34127714006563,39.93288809645312,NaN,NaN,68.20600930130017,-23.730479572600544,0.41996696309591597,-0.9496344322765928,-1.3696013953725088,-16573202,-18492302,51.77945151843605,44.09112655248101,NaN,NaN,-15.834014630534474,-24.291639675648717
2001-04-16T09:30:00-04:00,26.2,26.45,25.49001,25.89999,421500,1081550,49.62523128956811,40.524467065924746,NaN,NaN,54.541771839013805,11.988914389188633,0.4526079396292171,-0.8038414708359873,-1.2564494104652044,-16994702,-17716862,57.3688359744773,44.327573641981694,NaN,NaN,-13.450388297324519,-22.742889478745262
2001-04-17T09:30:00-04:00,25.5,26.5,25.5,26.17,417000,998425,50.78553089515017,40.87609871912946,NaN,NaN,60.83597790661448,45.357036832854575,0.47802643211251405,-0.6589163703245617,-1.1369428024370758,-16577702,-17149822,60.93476321424927,44.444856326106,NaN,NaN,-11.167302347926123,-21.08923417434253
2001-04-18T09:30:00-04:00,27.25,32,27.13,28.55,4498801,1143790.05,59.61540652541652,42.39802262189004,NaN,NaN,215.63395157008947,91.75586420637875,0.6311506456830382,-0.34800449533327793,-0.9791551410163162,-12078901,-15852781.8,67.60890387661033,44.90699660758327,NaN,NaN,-6.077730970670334,-18.944733716675074
2001-04-19T09:30:00-04:00,29,30.35001,28.66,30.35001,1139200,1147550.05,64.76443885205936,44.364796072992206,NaN,NaN,200.64292691795703,119.97212750699501,0.8178391800311848,0.04314383402266486,-0.77469534600852,-10939701,-14632841.6,72.38731321448262,45.94096498084003,NaN,NaN,0.13513072976664198,-16.21903879575483
2001-04-20T09:30:00-04:00,29.89,30.63,29.56,30,1066900,1121415.05,63.08023965604169,46.247431132665966,NaN,NaN,178.3891170590351,142.00874905854198,0.8767053844506869,0.3211863845548386,-0.5555189998958483,-12006601,-13719521.4,75.3224536513311,47.68070253406289,NaN,NaN,4.4716698101897485,-13.26322328061989
2001-04-23T09:30:00-04:00,28.75,29.11,28.13,28.34,1482600,1158830.05,55.68417111914686,47.74692751690518,NaN,NaN,105.21996933707685,152.1443885581546,0.766770474758564,0.4029440935523567,-0.36382638120620725,-13489201,-13018421.2,77.3158111088626,49.89125518519128,NaN,NaN,5.753664542423692,-10.546525020185094
2001-04-24T09:30:00-04:00,29,29.11,27.77,27.89999,822800,1114035.05,53.88081743983907,49.4610551134513,NaN,NaN,87.35006582695738,157.44720614222317,0.6329065532543934,0.42730681036178453,-0.20559974289260888,-14312001,-12565281,78.52331263562024,52.71333035682223,NaN,NaN,6.195749314359992,-8.15477154382151
2001-04-25T09:30:00-04:00,27.89999,28.53,27.60001,28.39,472200,1096900.05,55.60510335189613,51.37969128711163,NaN,NaN,79.35058258846476,130.19053234589825,0.5489709403383186,0.4806139325302894,-0.06835700780802922,-13839801,-12917461,75.17405030991412,55.76860138529715,NaN,NaN,7.083071479146281,-5.977936826254684
2001-04-26T09:30:00-04:00,28.7,28.87,27.83,27.99001,625700,1105270.05,53.83569971728022,52.24274518176497,NaN,NaN,72.54990238846374,104.57192743999956,0.4426805308831182,0.4849936557958685,0.04231312491275033,-14465501,-13622621,68.84243610082513,58.57884756094972,NaN,NaN,7.282116133014076,-4.083643546359147
2001-04-27T09:30:00-04:00,28.60001,28.66,28.00999,28.37,426700,1103125.05,55.29120226949853,53.470450942291464,NaN,NaN,67.80424752181706,82.45495353255595,0.3767180298913374,0.5132106622769221,0.1364926323855847,-14038801,-14029061,65.42213257171493,61.30885895246583,NaN,NaN,7.863529044510316,-2.3769046048063665
2001-04-30T09:30:00-04:00,28.89999,29.60001,28.62,28.81,690100,1097670.05,56.982488786949986,54.79717008654452,NaN,NaN,79.13754040161675,77.23846774546394,0.34246122535621853,0.5645691640808579,0.22210793872463935,-13348701,-14000961,65.54957018337481,63.978399843314754,NaN,NaN,8.827424244875811,-0.7762861977089126
2001-05-01T09:30:00-04:00,28.8,29.57001,28.39999,29.5,836900,1084130.05,59.56567375018264,55.77176934371766,NaN,NaN,75.20290813227739,74.80903620652796,0.34504661296818806,0.6534162049348744,0.30836959196668634,-12511801,-13640921,67.21674304786785,66.33329678903719,NaN,NaN,10.386910352982325,0.8184561666755499
2001-05-02T09:30:00-04:00,30,30.36,29.59,30.09,1270500,1093460.05,61.68439357940321,56.62440531232125,NaN,NaN,93.11147342653447,77.5612143741419,0.3634202451668343,0.7626448984252292,0.3992246532583949,-11241301,-13121221,69.51037985408898,68.06829694727539,NaN,NaN,12.318862475128636,2.4613713535974195
2001-05-03T09:30:00-04:00,29.14999,29.46001,28.67999,29.13,380500,1051325.05,56.49696267066051,56.92123999307803,NaN,NaN,59.02038852541067,74.85531160153127,0.2909807798739751,0.7629506281008638,0.4719698482268887,-11621801,-12552481,71.83290463161806,69.50068645535981,NaN,NaN,12.525603464597776,3.8991187980260418
2001-05-04T09:30:00-04:00,28.14999,29.7,28.14999,29.55,496400,991600.05,58.15495973294012,57.53050631046175,NaN,NaN,56.26567674079303,72.54759744532647,0.2528239928983699,0.7879998393498511,0.5351758464514812,-11125401,-11969801,74.01666164212881,70.68981686019207,NaN,NaN,13.164808230242858,5.222788716914159
2001-05-07T09:30:00-04:00,29.7,30,29.3,29.52,854400,1010045.05,57.98496470405566,58.04475158252642,NaN,NaN,72.12073161571523,71.14423568814615,0.20886098061173963,0.7962520722161557,0.587391091604416,-11979801,-11696021,74.99750985196842,71.69429876288629,NaN,NaN,13.645259966728023,6.425998895458997
2001-05-08T09:30:00-04:00,29.8,29.99001,29.33,29.64999,332700,953730.05,58.55034896336009,57.968676042379535,NaN,NaN,74.56654683044043,71.01696342777878,0.17329750414607248,0.8040129717870066,0.6307154676409341,-11647101,-11523081,75.62348471742163,72.26676882294424,NaN,NaN,14.196485942378054,7.536068473590291
2001-05-09T09:30:00-04:00,29.25,29.67,28.8,29.24001,1006800,961630.05,55.99119661600105,57.34201588266109,NaN,NaN,46.910823872628406,61.776833516997556,0.11000838621107101,0.7682259504047728,0.6582175641937018,-12653901,-11805601,72.43305726680055,72.27003625525266,NaN,NaN,14.00801932864735,8.460632881455584
2001-05-10T09:30:00-04:00,29.89999,29.89999,28.75999,28.81,324000,901595.05,53.35693967816326,56.64749445566978,NaN,NaN,36.422969184713345,57.25734964885809,0.031130094309637202,0.6971301820807483,0.6660000877711111,-12977901,-12076821,69.40582792470886,71.8474201319225,NaN,NaN,13.150711319646078,9.130644086911369
2001-05-11T09:30:00-04:00,29.10001,29.10001,28.28,28.5,1990800,977825.05,51.476684587407945,56.34695970340271,NaN,NaN,-11.607191720347734,43.68277595662993,-0.04579645336694782,0.6087545210624263,0.6545509744293742,-14968701,-12845481,61.55414000844758,70.72158648189286,NaN,NaN,11.91680700013909,9.528667360229615
2001-05-14T09:30:00-04:00,28.45,28.45,27.81,28.10001,753500,994425.05,49.07372214062941,56.00359575345916,NaN,NaN,-75.56443486946017,14.145742659594855,-0.12310564101672206,0.5006689231584716,0.6237745641751936,-15722201,-13593961,55.02632013047995,69.04322987438283,NaN,NaN,10.204219228276283,9.625174769950569
2001-05-15T09:30:00-04:00,28.25,28.8,27.85001,28.05,625200,1004835.05,48.76720365342268,55.51517434642534,NaN,NaN,-93.4677960510447,-19.461125916702166,-0.17398649598425275,0.4062914441948777,0.5802779401791305,-16347401,-14534021,48.123477756667775,67.11104612057953,NaN,NaN,8.674203753403917,9.48932176758676
2001-05-16T09:30:00-04:00,27.85001,29.28,27.64999,29.19,314400,795615,55.578551640513616,55.63966376951344,NaN,NaN,-30.941080927207473,-35.03150687666935,-0.1292951169965567,0.41865904393343456,0.5479541609299913,-16033001,-15209841,43.86337852536412,65.32682772233231,NaN,NaN,9.059696250035106,9.42794669365081
2001-05-17T09:30:00-04:00,29.3,29.75,29.17,29.36,853200,781315,56.50715777984184,55.72651773453797,NaN,NaN,62.268765588397784,-29.862347595932455,-0.0886521534209076,0.43713896915385675,0.5257911225747643,-15179801,-15650221,41.29788039298186,63.60366685242281,NaN,NaN,9.632659370278553,9.457191361740488
2001-05-18T09:30:00-04:00,29.35001,29.58,29.06,29.49001,251800,740560,57.24328968248704,55.74514636993347,NaN,NaN,64.05868117665757,-14.729173016531394,-0.05502724169057127,0.4570070704615503,0.5120343121521216,-14928001,-15642081,41.36614562464501,61.87627938394211,NaN,NaN,10.310016851160457,9.57902357451477
2001-05-21T09:30:00-04:00,29.60001,30.85001,29.36,30.8,1915100,762185,63.87752994330593,56.0531360980137,NaN,NaN,170.00340132779328,34.3843942229193,0.047865202836191556,0.5718658156973611,0.5240006128611695,-13012901,-15100221,45.87811430424269,60.352091616540314,NaN,NaN,12.87904014918306,10.050454513753097
2001-05-22T09:30:00-04:00,31.05,31.19,30.52,30.74001,970600,769575,63.3924425780717,56.175139597918594,NaN,NaN,202.8504699966015,93.64804743244854,0.10124138546452977,0.6505523446918318,0.549310959227302,-13983501,-14627441,49.52757343185584,58.924748300666515,NaN,NaN,14.86155857565208,10.737755094024381
2001-05-23T09:30:00-04:00,30.5,30.5,29.91,29.99001,995900,795760,57.512154893244706,56.24765332810318,NaN,NaN,108.3156512374156,121.49939386537315,0.07651809092367345,0.6449585728818938,0.5684404819582204,-14979401,-14416721,51.10994141390428,57.44453664225839,NaN,NaN,14.959762432556973,11.340898999529037
2001-05-24T09:30:00-04:00,29.85001,30.22,29.50999,30.22,722600,800605,58.77501139750841,56.2919427327152,NaN,NaN,80.71695076255035,125.18903090020368,0.06650586524204938,0.6515728135107821,0.5850669482687327,-14256801,-14232121,52.51445313609622,55.90866460611321,NaN,NaN,15.392785857464991,11.919739979234173
2001-05-25T09:30:00-04:00,30.2,30.2,29.60001,29.64999,378900,798215,54.45499654458226,56.03980214989567,NaN,NaN,54.14932443166089,123.20715955120431,0.01503339856150454,0.6038586964706134,0.5888252979091089,-14635701,-14173661,52.9751802252359,54.3356410613466,NaN,NaN,14.542364677080569,12.294400650355087
2001-05-29T09:30:00-04:00,29.3,29.49001,28.46001,28.53999,361600,781790,47.182280468645104,55.227797257416036,NaN,NaN,-66.54371240552845,75.89773680453997,-0.09422243664237295,0.4710472521061426,0.5652696887485156,-14997301,-14570541,49.46623758063132,52.467266265861575,NaN,NaN,11.520864456126697,12.183895479751031
2001-05-30T09:30:00-04:00,27.89999,27.99001,27.17,27.38,841900,782040,41.01717397217707,54.15822421142861,NaN,NaN,-189.2790585873999,-2.52816891226031,-0.23694388939059985,0.26908982701026574,0.5060337164008656,-15839201,-14941681,46.37287330692665,50.60582455444201,NaN,NaN,6.78362579944976,11.412428382565135
2001-05-31T09:30:00-04:00,27.47,28.17,27.47,27.63,901400,763585,42.75330508498171,53.40082174048707,NaN,NaN,-143.29885810522453,-52.85107078078833,-0.3026369376307893,0.12773754436237894,0.43037448199316825,-14937801,-14933361,46.45371246809041,48.96638773611212,NaN,NaN,3.4890314149781907,10.280514530052715
2001-06-01T09:30:00-04:00,27.89999,28.32001,27.3,28.10001,600700,774595,45.97303391328634,53.00770383519267,NaN,NaN,-111.35577744325933,-91.26561642195027,-0.3018760410576069,0.053029430671159616,0.3549054717287665,-14337101,-14949421,46.308599636621146,47.877420566695946,NaN,NaN,1.704205903773422,9.055327583441388
2001-06-04T09:30:00-04:00,28.35001,28.44701,27.89999,28.03999,168400,758195,45.62017636342517,52.7610219939638,NaN,NaN,-80.3600544310698,-118.16749219449642,-0.29264022655040645,-0.010894811459241538,0.2817454150911649,-14505501,-14923381,46.59987768953298,47.27553182091402,NaN,NaN,0.15831316655058322,7.784325523885559
2001-06-05T09:30:00-04:00,28.3,29.47,28.3,29.14999,222300,726590,52.83070787008564,53.051272295154014,NaN,NaN,-5.586631854949909,-105.97607608438071,-0.2032417250352488,0.027693258797103937,0.23093498383235272,-14283201,-14780561,48.25786095397172,47.28513062072144,NaN,NaN,0.9708202444044683,6.810967626816832
2001-06-06T09:30:00-04:00,29.14999,29.5,28.78,28.87,253800,722645,50.99394814809358,52.72380061712401,NaN,NaN,3.9941320221642544,-67.32143796246785,-0.15652790701325672,0.03527510006578183,0.19180300707903855,-14537001,-14520121,51.23145081965401,47.811421498885004,NaN,NaN,1.0913373113815124,5.993877581754644
2001-06-07T09:30:00-04:00,28.89999,29.69,28.89999,29.69,174200,681015,55.83661191576688,52.6759044839758,NaN,NaN,37.18290188495044,-31.225085964432868,-0.06846128641146312,0.10622639906470965,0.17468768547617278,-14362801,-14405121,52.528755961376305,48.613626896627466,NaN,NaN,2.697209417269713,5.522924986828225
2001-06-08T09:30:00-04:00,29.60001,29.60001,28.75999,29.03,306900,680160,51.43129807668846,52.26076222641876,NaN,NaN,10.464810616728066,-6.860968352435394,-0.05338623339481824,0.10795489373264999,0.16134112712746823,-14669701,-14471641,51.67250532805444,49.349795446871,NaN,NaN,2.706386529493932,5.120562350066184
2001-06-11T09:30:00-04:00,28.89999,28.89999,28.22,28.55,654800,613360,48.4381556755955,51.157949778725154,NaN,NaN,-41.02218310653713,1.006605912471143,-0.07324228253636167,0.06978827395701614,0.14303055649337781,-15324501,-14635441,49.531434490054195,49.61074688871468,NaN,NaN,1.7956211976132102,4.645570756858616
2001-06-12T09:30:00-04:00,27.85001,28.67999,27.53,28.33,681700,609770,47.0856030934385,49.993175529822786,NaN,NaN,-75.6005669526655,-12.996181107071981,-0.09719205630630282,0.0215404861104993,0.11873254241680212,-16006201,-14980041,45.28063978296656,49.30739448522258,NaN,NaN,0.6480145316972219,4.074491296121274
2001-06-13T09:30:00-04:00,28.39999,28.61,27.66,27.69,197600,588390,43.29790448995596,48.97787192958787,NaN,NaN,-90.48792411239715,-31.89259233398426,-0.14903410909571832,-0.06756009395284579,0.08147401514287253,-16203801,-15313401,41.564479249492116,48.62557575919315,NaN,NaN,-1.4875113329303846,3.2799194919710373
2001-06-14T09:30:00-04:00,27.14999,27.39999,26.5,26.7,272600,586300,38.181341099663065,47.50689547974178,NaN,NaN,-160.95700419412185,-71.5205735497987,-0.23763735939420108,-0.21557268409987884,0.022064675294322246,-16476401,-15736121,37.375632646498836,47.544231438507616,NaN,NaN,-5.0140379655904335,2.095068426605113
2001-06-15T09:30:00-04:00,26.05,26.67999,25.8,26.45,485700,567925,36.992524266778155,46.25957603132719,NaN,NaN,-170.0752537056499,-107.62858641427428,-0.2968703924818201,-0.34902331530795294,-0.0521529228261328,-16962101,-16194601,33.43938286443536,46.14881734130758,NaN,NaN,-8.252473300667088,0.6168481798519414
2001-06-18T09:30:00-04:00,26.35001,26.56,25.73,25.78999,353200,572995,33.98412769926276,45.316850833514174,NaN,NaN,-160.50568107952452,-131.52528600887177,-0.3600789016116398,-0.5022515498406825,-0.14217264822904274,-17315301,-16592761,30.44107642106775,44.78987725848161,NaN,NaN,-11.971460645656704,-1.1814816523635792
2001-06-19T09:30:00-04:00,26.78999,26.87,25.64999,25.89,498800,502180,34.848740238469915,44.87624842396366,NaN,NaN,-136.33742597737873,-143.67265781381442,-0.3731422741033012,-0.6086004908581693,-0.23545821675486805,-16816501,-16754821,29.289908523995805,43.569665488272264,NaN,NaN,-14.73436809164589,-3.1176082865467665
2001-06-20T09:30:00-04:00,25.64999,26.23,25.48,26.16,397600,473530,37.23859146225632,44.4823403080547,NaN,NaN,-135.05081740431154,-152.58523647219732,-0.34239201145672077,-0.663448231075769,-0.32105621961904823,-16418901,-16797841,28.97664771857484,42.32130372044973,NaN,NaN,-16.37437486391994,-5.011432083314363
2001-06-21T09:30:00-04:00,26.25,26.89,26.02,26.64999,285600,438015,41.43695312540769,44.158334537491946,NaN,NaN,-90.26802639402577,-138.44744091217808,-0.2709725621808449,-0.6597719223451044,-0.3887993601642595,-16133301,-16729221,30.257938832893075,41.17482794875486,NaN,NaN,-16.589138823556016,-6.66539018906317
2001-06-22T09:30:00-04:00,26.60001,27.05,26.31,26.39999,237400,413755,39.967904992715425,43.75460086815553,NaN,NaN,-76.88292052339837,-119.80897427572776,-0.2244132119319946,-0.6693158750792527,-0.4449026631472581,-16370701,-16610941,32.51779700971501,40.16896504305358,NaN,NaN,-17.179742657079792,-8.167440541636973
2001-06-25T09:30:00-04:00,26.60001,26.92,26.44,26.78,137500,401685,43.26075152683906,43.07103255792363,NaN,NaN,-60.8412313679037,-99.87608433340361,-0.15515915872297426,-0.6388516115509759,-0.48369245282800166,-16233201,-16394521,36.56790165660353,39.33396795038443,NaN,NaN,-16.760250847726084,-9.394984871078274
2001-06-26T09:30:00-04:00,26.45,26.95,26.24001,26.92999,447600,405985,44.553500167394525,42.61100055930227,NaN,NaN,-54.992553044445394,-83.60710974681695,-0.08963661719722649,-0.5957382243245348,-0.5061016071273083,-15785601,-16188341,40.247232519434995,38.5493809289402,NaN,NaN,-16.052834436854006,-10.346106237617663
2001-06-27T09:30:00-04:00,26.8,27.16,26.63,26.99001,301900,378985,45.09261298383142,41.843572064164015,NaN,NaN,-37.06681617156266,-64.01030950026717,-0.03542509003226635,-0.5503829696676412,-0.5149578796353749,-15483701,-16001301,43.451672709965855,37.90101783955374,NaN,NaN,-15.316961124568747,-11.05622836432496
2001-06-28T09:30:00-04:00,27.25,28.49001,27.25,27.52,1088900,388360,49.73976033845861,41.722747940004744,NaN,NaN,17.121669966024257,-42.53237022825716,0.03892818303815759,-0.46629765083767793,-0.5052258338758355,-14394801,-15653601,48.934181344086355,37.705423269270305,NaN,NaN,-13.37626222043477,-11.387661772340648
2001-06-29T09:30:00-04:00,27.7,28.5,27.5,28.17,401000,378375,54.79322839846917,42.17668170592429,NaN,NaN,36.24454084543173,-19.906877954491147,0.1295782234256011,-0.34325305459383415,-0.47283127801943525,-13993801,-15178221,55.31327511874938,38.118411885605674,NaN,NaN,-10.158134919144038,-11.212015079026846
2001-07-02T09:30:00-04:00,27.89999,28.50999,27.87,28.14999,213800,380645,54.61118915636264,42.714223567561724,NaN,NaN,43.79497998485356,1.020364316060305,0.1826369290206692,-0.24453511674359873,-0.4271720457642679,-14207601,-14773101,59.90946536511205,39.16332799861607,NaN,NaN,-7.55733567050227,-10.689918020666193
2001-07-03T09:30:00-04:00,28.10001,28.2,27.84,28.05,140800,376570,53.651969735586974,43.45379965653537,NaN,NaN,39.133734909496894,19.845621906848756,0.2038322859533781,-0.1723816883225453,-0.3762139742759234,-14348401,-14485661,62.83061029481348,40.682337358996165,NaN,NaN,-5.610026999877659,-9.964219303410689
2001-07-05T09:30:00-04:00,27.77,27.95,27.14999,27.14999,285100,378135,45.84620939196982,44.001290248843,NaN,NaN,3.2284412497883097,27.904673391118944,0.1524252351879536,-0.18568243029098142,-0.338107665478935,-14633501,-14315621,64.4794539072922,42.61832459190998,NaN,NaN,-6.000713748069733,-9.398004224076267
2001-07-06T09:30:00-04:00,26.75,26.85001,25.83,25.89999,1040800,421465,37.65265240166732,44.04844225847794,NaN,NaN,-80.96902144555963,8.286535108802171,0.03552429226397036,-0.29370230014897203,-0.3292265924129424,-15674301,-14571521,60.154643568150114,44.52655749931818,NaN,NaN,-9.041764596125839,-9.347112848654778
2001-07-09T09:30:00-04:00,26.05,26.44,25.95,26.23,776000,444920,40.667487450008146,44.52582509781689,NaN,NaN,-74.98606016333048,-13.959585092950267,-0.015547232879084771,-0.3486606335117983,-0.33311340063271355,-14898301,-14752421,57.23224489880729,46.440212390585295,NaN,NaN,-10.584434810547835,-9.523873128925214
2001-07-10T09:30:00-04:00,26.49001,26.53,25.34,25.42999,606300,442495,36.10906272335015,44.615848132451184,NaN,NaN,-108.53630998612152,-44.42584308714528,-0.09476070172373607,-0.4515642777873836,-0.35680357606364754,-15504601,-15011821,53.238227267145206,48.15080658652454,NaN,NaN,-13.427336446707214,-10.081510745751213
2001-07-11T09:30:00-04:00,25.42999,25.73,25.11,25.56,221600,419490,37.33829978804125,44.62297015572154,NaN,NaN,-128.0226461532266,-77.85711929968997,-0.12789281223855664,-0.5166695913618433,-0.3887767791232867,-15283001,-15198741,50.50321841806331,49.68841877934515,NaN,NaN,-15.315107223194039,-10.829167385385903
2001-07-12T09:30:00-04:00,26.49001,27.42,26.47,27.25999,237500,421485,50.69602763247955,45.28433262051239,NaN,NaN,32.29752501316509,-72.04330254701463,-0.02992123068549979,-0.42617831748016144,-0.39625708679466165,-15045501,-15281141,49.30082805603102,51.04862515242643,NaN,NaN,-12.398495838976276,-11.053357164470242
2001-07-13T09:30:00-04:00,27.2,27.7,26.92,27.34,339900,424850,51.22304831477691,46.088271429231064,NaN,NaN,55.94277816537163,-44.66094262482837,0.041772630465580884,-0.3440412987126855,-0.3858139291782664,-14705601,-15087401,52.183410862683864,52.453311856209915,NaN,NaN,-9.983489045042164,-10.900518861694803
2001-07-16T09:30:00-04:00,27.25,27.45,26.56,26.67999,223500,411740,46.78078608652285,46.339702469208476,NaN,NaN,10.443316230977548,-27.575067345966765,0.045916259029798456,-0.3284186053910183,-0.37433486442081676,-14929101,-15093561,52.082016265377945,53.56146289969381,NaN,NaN,-9.411637833685448,-10.68782157197918
2001-07-17T09:30:00-04:00,26.5,27.03,26.17,27,381500,413155,49.086317271160304,46.66347511947747,NaN,NaN,-10.549752991491113,-7.977755947040687,0.06994142907004453,-0.28690807808326113,-0.35684950715330566,-14547601,-14902161,55.00731465006677,54.61575448045322,NaN,NaN,-8.211965347580952,-10.334127825636577
2001-07-18T09:30:00-04:00,26.50999,26.67999,25.75,25.97,383600,407395,42.67773112388227,46.49098355805252,NaN,NaN,-75.54724002504739,2.517325278595152,0.018854630029746855,-0.3332812196161221,-0.35213584964586897,-14931201,-14831801,56.06903695248522,55.51699478349031,NaN,NaN,-9.292385446633759,-10.185307485779031
2001-07-19T09:30:00-04:00,26.5,26.95,26.12,26.45,2790100,527020,46.20266698277657,46.23833403264666,NaN,NaN,-39.66716487911588,-11.875612699861037,0.019688857201981658,-0.32752477814339187,-0.34721363534537353,-12141101,-14250921,63.687544753473716,56.57080645558941,NaN,NaN,-9.022220700298291,-10.019152230710354
2001-07-20T09:30:00-04:00,26.09,26.36,25.91,26.3,193100,522395,45.26589548524422,45.55781025313059,NaN,NaN,-71.75298199658603,-37.41476473225257,0.012772443066598416,-0.3312480815121255,-0.3440205245787239,-12334201,-13776641,68.49208589236014,57.5121500822759,NaN,NaN,-9.097402104526509,-9.88747364125552
2001-07-23T09:30:00-04:00,26.39999,26.58,25.64999,25.66,205300,520790,41.40821275074545,44.61474050987222,NaN,NaN,-89.15347040354847,-57.334122059157764,-0.029939119279720317,-0.3814444236783743,-0.35150530439865396,-12539501,-13298721,72.44806097910123,58.4077640547037,NaN,NaN,-10.372145810823834,-9.956712522622421
2001-07-24T09:30:00-04:00,25.55,25.86,25.05,25.32001,215400,524685,39.48317896451213,43.602684026224026,NaN,NaN,-128.62533844541605,-80.94923914994277,-0.07363320175085397,-0.44354680658722145,-0.3699136048363675,-12754901,-12940181,74.98548514477956,59.27596940112984,NaN,NaN,-12.015652200283975,-10.250846762288358
2001-07-25T09:30:00-04:00,25.42,25.86,25.23,25.86,219500,513280,43.940798849200306,43.46658327316906,NaN,NaN,-93.44086064882418,-84.52796327469812,-0.059326500029935836,-0.4440717298737873,-0.38474522984385146,-12535401,-12461021,77.91303661779494,60.23551102330861,NaN,NaN,-12.052258318922512,-10.508191270378951
2001-07-26T09:30:00-04:00,25.61,26.39,25.39,26.35001,646900,530530,47.70514698817848,44.184618600777,NaN,NaN,-53.05639247777443,-87.20580879442983,-0.012470401127788244,-0.4003332312535868,-0.38786283012579853,-11888501,-12410501,78.20269277835594,61.52465739546618,NaN,NaN,-10.930814543566783,-10.568566023691499
2001-07-27T09:30:00-04:00,26.25,26.57001,26.13,26.31,367600,494465,47.425120181042615,44.66730665299375,NaN,NaN,-22.72118035447281,-77.39944846600719,0.018534539600492672,-0.36469465562518266,-0.38322919522567533,-12256101,-12394881,78.29746033602653,63.029315640981835,NaN,NaN,-10.108024868863115,-10.502774430144587
2001-07-30T09:30:00-04:00,26.35001,26.55,26.11,26.23,221600,485495,46.83315803870834,45.43331346123362,NaN,NaN,-20.665669703820438,-63.70188832606158,0.03538463890617549,-0.33899839659295594,-0.37438303549913143,-12477701,-12382521,78.3775697348382,64.82498296010276,NaN,NaN,-9.592742080459898,-10.37276980876106
2001-07-31T09:30:00-04:00,26.35001,26.75,25.2,26.22,266000,488105,46.75459748929882,46.105906154180595,NaN,NaN,-41.32404012808613,-46.2416286625956,0.046866035501542225,-0.31580049112220365,-0.3626665266237459,-12743701,-12380281,78.39313580154463,66.8171199160657,NaN,NaN,-9.186697833375662,-10.203330955134575
2001-08-01T09:30:00-04:00,26.7,27.11,26.5,26.92,348500,498490,52.73185969317547,46.25132272994458,NaN,NaN,76.74516583658433,-12.204423365513895,0.09958428360111038,-0.23818617212235793,-0.3377704557234683,-12395201,-12352241,78.6008118225269,68.90997589938685,NaN,NaN,-7.131591001220299,-9.76451096171825
2001-08-02T09:30:00-04:00,27.45,27.5,26.91,27.28999,290600,498765,55.57085563680297,46.561880395803584,NaN,NaN,139.12416285418303,26.231687700877597,0.1540979736921625,-0.14514798860826517,-0.29924596230042766,-12104601,-12395461,77.36646052732314,70.70876516114679,NaN,NaN,-4.546510741856222,-9.019082358880818
2001-08-03T09:30:00-04:00,27.35001,27.35001,26.67999,26.89999,198600,456655,52.02387928120981,46.93638705256694,NaN,NaN,87.79823090507267,48.33556995278669,0.1580273075481663,-0.10171182786521982,-0.2597391354133861,-12303201,-12404881,77.08233032233204,72.49450187950066,NaN,NaN,-3.301582214521158,-8.202296623972295
2001-08-06T09:30:00-04:00,26.64999,26.83,26.42,26.57001,694500,452580,49.1645076842643,46.941972082074365,NaN,NaN,32.31089662059311,58.930883217669404,0.1335155247070184,-0.09284472952961309,-0.2263602542366315,-12997701,-12508881,73.85736104258865,73.8409337646808,NaN,NaN,-3.038315992799213,-7.464585105233283
2001-08-07T09:30:00-04:00,26.45,26.67999,26.14999,26.42,389100,441720,47.876242702445445,47.313294337686024,NaN,NaN,1.4991795137371002,67.49552714603405,0.10364330514546799,-0.0968061228047965,-0.2004494279502645,-13386801,-12637501,69.95906691114072,74.83307876172762,NaN,NaN,-3.172084109697358,-6.851370677299579
2001-08-08T09:30:00-04:00,26.27,26.56,25.42999,25.57001,476900,454485,41.276399694377965,46.9614181028004,NaN,NaN,-88.05996718986896,34.534500540743394,0.027069906431003737,-0.16661204491150983,-0.19368195134251356,-13863701,-12931201,61.92186349169089,74.70695867160028,NaN,NaN,-5.270864660059682,-6.6255841034081655
2001-08-09T09:30:00-04:00,25.45,25.61,25.22,25.58,557500,470485,41.37868316840317,46.6837600801689,NaN,NaN,-132.49738792243923,-19.78980961458106,-0.019940565794685727,-0.21860765858587072,-0.198667092791185,-13306201,-13171521,56.229461897952234,73.83105695771401,NaN,NaN,-6.943074514126116,-6.670939876367873
2001-08-10T09:30:00-04:00,25.53999,25.62,24.77,25.53999,406100,473795,41.07014649357975,46.659612490371345,NaN,NaN,-142.40862540579906,-65.83118087675541,-0.04910263639895182,-0.2600453882898748,-0.21094275189092296,-13712301,-13453341,50.38047859772972,72.25480107333033,NaN,NaN,-8.412247286166762,-6.919698077767714
2001-08-13T09:30:00-04:00,25.5,25.8,25.35001,25.64,179200,471580,42.22970920737417,46.85579322200436,NaN,NaN,-90.08681824870489,-90.310723850615,-0.0565012865902525,-0.28156936012873857,-0.22506807353848607,-13533101,-13560421,48.32365310086195,70.35038449876478,NaN,NaN,-9.354423963163102,-7.267516061395627
2001-08-14T09:30:00-04:00,25.81,25.92,25.25,25.31,366900,470850,39.46989380318749,46.53644286157487,NaN,NaN,-96.01236607213605,-109.81303296778962,-0.07718465278256709,-0.3215488895166949,-0.24436423673412783,-13900001,-13663061,46.36949158278258,68.09727413912104,NaN,NaN,-10.931582806896168,-7.790954167895704
2001-08-15T09:30:00-04:00,25.31,25.47,24.67,24.74001,262400,464790,35.191878156033056,45.642637944993055,NaN,NaN,-150.9621235707823,-122.39346424397232,-0.12025004706621628,-0.39467679556689816,-0.2744267485006819,-14162401,-13722801,45.22319963066273,65.74159605714296,NaN,NaN,-13.596359469286515,-8.620297782380105
2001-08-16T09:30:00-04:00,24.5,24.95,24.16,24.87,303100,340440,36.87232053990522,44.888866542054664,NaN,NaN,-164.05443932357767,-128.70487452419997,-0.13014134131459942,-0.4371034251439312,-0.30696208382933177,-13859301,-13833421,43.098590257171566,63.22739105151046,NaN,NaN,-15.376674397763612,-9.585494441720606
2001-08-17T09:30:00-04:00,24.46001,24.60001,23.92,24.13,203100,340940,31.814878448634403,43.81613228562081,NaN,NaN,-181.34932530991819,-136.4930145050238,-0.17394534526389238,-0.5243937654091972,-0.35044842014530486,-14062401,-13903441,41.7611828214353,60.61193484341025,NaN,NaN,-18.5546778743418,-10.86680636066649
2001-08-20T09:30:00-04:00,24.00999,24.33,23.92,24.28999,213600,341355,33.92502800980233,42.89973446565678,NaN,NaN,-155.57761038464903,-149.59117293221266,-0.17887718449900414,-0.57404490076906,-0.39516771627005587,-13848801,-13966581,40.53953346733921,57.90810610525272,NaN,NaN,-20.58673288275978,-12.255367292394103
2001-08-21T09:30:00-04:00,24.37,24.49001,23.58,23.58,258600,343515,29.553996710431704,41.24417282403222,NaN,NaN,-159.26799572942394,-162.24229886367021,-0.21429856268954073,-0.6630409196319818,-0.448742356942441,-14107401,-14008061,39.71752774670786,55.13072867126565,NaN,NaN,-23.793762273786417,-13.903709432593004
2001-08-22T09:30:00-04:00,23.89999,24.02,23.41,23.82001,384400,351760,32.710267747513356,39.611273689082964,NaN,NaN,-144.59771438023034,-160.96941702555984,-0.20585813564171795,-0.7060650264945885,-0.5002068908528705,-13723001,-13920181,42.383050173568776,52.63191364599748,NaN,NaN,-25.50970561581782,-15.561708887339407
2001-08-23T09:30:00-04:00,23.89999,24.25999,23.75,23.8,346300,336730,32.57921053618189,38.222368778723826,NaN,NaN,-113.83116536450565,-150.9247622337454,-0.18649311656178225,-0.7333232865550983,-0.546830169993316,-14069301,-13962181,41.43995719896455,50.08602985147123,NaN,NaN,-26.93635711931825,-17.186658634764957
2001-08-24T09:30:00-04:00,23.97,24.96001,23.95,24.96001,293700,333035,46.06923487600958,38.001277863848486,NaN,NaN,-57.325152033250575,-126.11992757841192,-0.0855647459455392,-0.65378610242524,-0.5682213564797008,-13775601,-13904821,43.29572087880235,47.90305555405793,NaN,NaN,-23.91121744766138,-18.14730989375016
2001-08-27T09:30:00-04:00,24.75999,25.22,24.66,24.89999,369400,340425,45.56127002432985,37.83592267255451,NaN,NaN,-31.160489498212062,-101.23650340112451,-0.016469323718456108,-0.5888080111277709,-0.5723386874093148,-14145001,-13964061,41.82166746712132,45.89324130805654,NaN,NaN,-21.669701794034957,-18.650508736647986
2001-08-28T09:30:00-04:00,24.89999,24.98,24.21001,24.21001,1566000,405425,40.08893833746152,37.75110400420334,NaN,NaN,-58.87487409152958,-81.15787907354564,-0.011113311621339994,-0.5862303269359899,-0.5751170153146499,-15711001,-14284781,34.894962925788604,43.96274841049209,NaN,NaN,-21.42411784901169,-19.0467386098428
2001-08-29T09:30:00-04:00,24.41,24.47,23.64999,23.75,202900,398145,36.90626449417441,37.43164552747272,NaN,NaN,-88.33103714247297,-69.90454362599415,-0.031287220327308574,-0.6142260407237856,-0.582938820396477,-15913901,-14722961,28.057620298300236,41.95047401051694,NaN,NaN,-22.23866335214552,-19.50272785874319
2001-08-30T09:30:00-04:00,23.31,23.48,22.57001,22.83,422200,404725,31.517125140322037,36.74928685938288,NaN,NaN,-153.3215406605379,-77.80261868520061,-0.09568941644133233,-0.7025505909481424,-0.6068611745068101,-16336101,-15176321,23.029701614614666,39.996847083151586,NaN,NaN,-24.81496486623388,-20.261618859813286
2001-08-31T09:30:00-04:00,22.7,23.23,22.62,23.02,248300,407210,33.67125346424589,36.13796859201658,NaN,NaN,-142.0736203168087,-94.75231234191223,-0.11338127434487233,-0.7485877674379005,-0.6352064930930281,-16087801,-15638761,19.24193631721542,37.919581598605404,NaN,NaN,-26.15136146191277,-21.103010660113213
2001-09-04T09:30:00-04:00,22.50999,23.5,22.5,22.52,453200,395145,30.915345097763378,35.526929398772,NaN,NaN,-138.81912761202645,-116.28403996467509,-0.14464432993728005,-0.8160119055146282,-0.6713675755773482,-16541001,-16117961,16.257893070909176,35.768753133471584,NaN,NaN,-28.17251410830397,-22.112939724140464
2001-09-05T09:30:00-04:00,22.44,22.69,21.61,22.33,501400,400760,29.913409770904693,35.1498959426914,NaN,NaN,-170.2084239441536,-138.55074993519992,-0.16266153881943335,-0.8746944991016399,-0.7120329602822065,-17042401,-16384241,14.877238347460207,33.60118447038569,NaN,NaN,-30.114478708435694,-23.256016721896927
2001-09-06T09:30:00-04:00,21.8,22.2,21.27,21.27,439200,398875,25.03808409549643,34.30459333951934,NaN,NaN,-190.4707621395848,-158.97869493462227,-0.2265826447080186,-0.9952612661672298,-0.7686786214592112,-17481601,-16697781,13.430914660354617,31.482064784898764,NaN,NaN,-33.5541756455983,-24.727182282425694
2001-09-07T09:30:00-04:00,21.2,21.81,20.92,21.02,901200,416060,24.04281206298114,33.74944574054411,NaN,NaN,-181.80681478397835,-164.67574975931035,-0.2637158385661149,-1.0983234196668548,-0.8346075811007398,-18382801,-17107121,11.815869147670355,29.34311380820127,NaN,NaN,-36.62669398849604,-26.42711252615003
2001-09-10T09:30:00-04:00,20.91,21.5,20.8,21.47,578600,424685,29.476930523999286,33.43172449155818,NaN,NaN,-150.70513186290268,-166.40205206852914,-0.23683887833717654,-1.1306561790222105,-0.893817300685034,-17804201,-17450401,10.658374115692837,27.208745283083676,NaN,NaN,-37.43558413542079,-27.999751327474424
2001-09-17T09:30:00-04:00,20.25,20.89999,19.94,20.10001,2716900,551570,23.876510015200196,33.02618972761307,NaN,NaN,-172.6289654957879,-173.16401964528146,-0.28685823453671344,-1.2523900938559258,-0.9655318593192124,-20521101,-18246421,8.56347288786769,24.98345565030937,NaN,NaN,-40.18207775178501,-29.74008367380451
2001-09-18T09:30:00-04:00,20.3,20.58,19.81,19.92,1799300,623190,23.25140708103963,32.35055682286495,NaN,NaN,-157.6073998502477,-170.6438148265003,-0.3058570633076565,-1.347853188453783,-1.0419961251461265,-22320401,-19302021,6.686589337685902,22.43370844774631,NaN,NaN,-42.517076453655065,-31.565368356640302
2001-09-19T09:30:00-04:00,20.25,20.25,18.55,19.74001,1563200,688230,22.613889188001735,31.638748155137794,NaN,NaN,-160.66014463162836,-164.681691324909,-0.30371848998651463,-1.4216442376292697,-1.117925747642755,-23883601,-20582421,5.1983204144953135,19.845020105998508,NaN,NaN,-44.571911509893745,-33.42344594996222
2001-09-20T09:30:00-04:00,19.3,19.92999,18.8,18.88,879400,717045,19.817871274869248,29.763650755056343,NaN,NaN,-147.11870749428678,-157.74406986697068,-0.33114856195557474,-1.5318614500872236,-1.200712888131649,-24763001,-21858461,4.195983286104578,17.052181706520095,NaN,NaN,-47.302058341882244,-35.40610486309365
2001-09-21T09:30:00-04:00,18.10001,18.84,17.62,18.34,1467100,780245,18.288809381289198,27.81561785198201,NaN,NaN,-157.7476843954379,-159.15258037347775,-0.354496713098563,-1.6438337795048525,-1.2893370664062895,-26230101,-23543641,3.292951890600719,14.300130593911485,NaN,NaN,-50.0717439740247,-37.501196164655234
2001-09-24T09:30:00-04:00,19.25,19.66,18.8,19.37,1743200,856725,29.467378932781628,27.05693503736202,NaN,NaN,-104.32535618253989,-145.4918585108281,-0.27306074477361664,-1.6306629973733102,-1.3576022525996936,-24486901,-24336801,2.9690686132319115,12.019709571586006,NaN,NaN,-48.622816997538074,-39.08999914078135
2001-09-25T09:30:00-04:00,19.7,19.98,19.10001,19.55,1098800,898735,31.237791466203447,26.652044106792665,NaN,NaN,-84.55691056835968,-130.8817606544505,-0.18383978197121875,-1.5874019800637171,-1.4035621980924984,-23388101,-24550341,2.8867467958573343,10.22179003569723,NaN,NaN,-46.90752170329133,-40.20678807828278
2001-09-26T09:30:00-04:00,19.7,19.94,18.56,18.89,853300,922180,28.420851144860407,26.430881678545404,NaN,NaN,-90.37638383999942,-116.8250084961247,-0.14760427530827336,-1.58806754222784,-1.4404632669195667,-24241401,-24621901,2.85814751372115,8.780964742776264,NaN,NaN,-46.37080791815665,-41.0873623411219
2001-09-27T09:30:00-04:00,18.99001,19,18.08,18.74001,1024700,956100,27.807150105068672,26.01201715288989,NaN,NaN,-99.48749383474008,-107.29876576421536,-0.11359448446592779,-1.5824563725019765,-1.4688618880360487,-25266101,-24722521,2.8159037207248616,7.6076767001697965,NaN,NaN,-46.133038637102224,-41.80817324054766
2001-09-28T09:30:00-04:00,19.05,19.61,18.69,19.25,862600,984545,33.09706842237864,26.16785453321955,NaN,NaN,-71.60729794315456,-90.0706884737587,-0.04038529204084407,-1.5193435030871036,-1.4789582110462596,-24403501,-24357201,8.125333266226008,7.026779571263854,NaN,NaN,-44.28065269019179,-42.16138459049682
2001-10-01T09:30:00-04:00,19.14999,19.14999,18.67,19,609100,996530,31.86446206766088,26.307215411559277,NaN,NaN,-74.36345124717332,-84.07830748668539,0.005146838963194567,-1.4725246623422663,-1.4776715013054609,-25012601,-24462341,7.9900385783613075,6.534836730613934,NaN,NaN,-43.1261688560664,-42.29921091414962
2001-10-02T09:30:00-04:00,19,19.25,18.67999,18.98,466100,941535,31.76255016519464,26.78753441653772,NaN,NaN,-68.19713213814371,-80.8063518006422,0.04561098650776407,-1.4206577681707557,-1.4662687546785198,-25478701,-24880461,7.4581869652539865,6.108213323821033,NaN,NaN,-42.22321669482316,-42.28835459710298
2001-10-03T09:30:00-04:00,18.7,20.56,18.7,20.25,1533000,1008040,44.00864698421469,28.213665482340122,NaN,NaN,-23.623803198634644,-67.45583567236925,0.1629982523853526,-1.262520939196829,-1.4255191915821817,-23945701,-24821321,8.387075099917226,5.863299463267239,NaN,NaN,-37.4302804271734,-41.59434400139875
2001-10-04T09:30:00-04:00,20.7,21.23,20.22,20.67999,1698000,1071830,47.44745530491294,29.497274395262526,NaN,NaN,30.09546553002257,-41.53924379941671,0.2684668223632478,-1.0899356636281219,-1.3584024859913697,-22247701,-24217641,17.491155184879858,6.351355253923454,NaN,NaN,-32.35495575808811,-40.274431395211515
2001-10-05T09:30:00-04:00,20.45,20.81,19.83,20.67,1046700,1111750,47.37465639173542,31.175713422157894,NaN,NaN,24.781173406828735,-22.26154952942005,0.3322457620180246,-0.9430952834688391,-1.2753410454868637,-23294401,-23995821,20.612972311159453,7.21203378415858,NaN,NaN,-28.342951695672014,-38.5699342952773
2001-10-08T09:30:00-04:00,20.14999,21.00999,20.14999,20.81,541900,1116185,48.56565811131657,32.98387421003482,NaN,NaN,52.55424624706095,3.121989969426802,0.3753658077401798,-0.8061337858116389,-1.1814995935518187,-22752501,-23543801,26.699317810339707,8.641514389348137,NaN,NaN,-24.68908252215131,-36.586955470545014
2001-10-09T09:30:00-04:00,20.66,20.84,20.21001,20.33,738100,1128020,44.82032595207492,34.57004826461148,NaN,NaN,49.78428306917335,26.718273010890215,0.3628543487539153,-0.7279316576094246,-1.0907860063633399,-23490601,-23146181,31.662512600788716,10.531813831226236,NaN,NaN,-22.5640384104892,-34.58368160482276
2001-10-10T09:30:00-04:00,20.14999,20.97,20.02,20.96001,558600,1133990,50.24404310879802,36.74334625274925,NaN,NaN,73.99559855103352,46.24215336082384,0.38614123828756863,-0.6081094585038791,-0.9942506967914477,-22932001,-22943441,34.1122192885676,12.668687831402167,NaN,NaN,-19.055790319914646,-32.365411421264454
2001-10-11T09:30:00-04:00,21.60001,21.97,21.39999,21.97,1443700,1161115,57.462497323997184,39.54146682008553,NaN,NaN,165.86419451186188,73.3958991571917,0.4540144438221695,-0.42673264201373584,-0.8807470858359053,-21488301,-22791561,35.96414732887223,15.00234464842156,NaN,NaN,-13.510396845848804,-29.67183791049079
2001-10-12T09:30:00-04:00,21.56,22.07001,21.22,21.92,1205600,1192465,57.021460276326124,41.509615487481575,NaN,NaN,154.8546101755617,99.4105865109383,0.47759458663116905,-0.2837538525469441,-0.7613484391781131,-22693901,-22671461,37.46106128429453,17.46605841064032,NaN,NaN,-9.246158496058776,-26.753883708429075
2001-10-15T09:30:00-04:00,21.60001,21.84,21.34,21.77,618800,1087560,55.641720873496034,43.252753302288184,NaN,NaN,130.25893948817364,114.95152515916084,0.46470628472044573,-0.1804655832775559,-0.6451718679980016,-23312701,-22783501,36.601479782881945,19.87425362399922,NaN,NaN,-6.14601120654273,-23.809901922445313
2001-10-16T09:30:00-04:00,21.7,22.06,21.56,22,921400,1043665,57.34599634758586,45.31883510248286,NaN,NaN,126.47743524907574,130.29015559514133,0.45282744688107057,-0.07913755939666345,-0.531965006277734,-22391301,-22563641,39.53358152532609,22.493927481971003,NaN,NaN,-3.0544552639297557,-20.84483811408595
2001-10-17T09:30:00-04:00,22.45,22.45,21,21,2154600,1073235,48.60257800989884,46.80422280997073,NaN,NaN,88.78040364583327,133.24711661410126,0.3626762180286879,-0.07861973374187414,-0.441295951770562,-24545901,-22886421,36.839800661356556,24.924205834873266,NaN,NaN,-2.8766078622814195,-18.277948078113873
2001-10-18T09:30:00-04:00,20.61,21.23,20.61,20.95,764200,1067475,48.20680950302328,47.88349003001677,NaN,NaN,47.785642808023425,109.63140627333357,0.2879914154258777,-0.08130668248821493,-0.3692980979140926,-25310101,-23650781,31.385905522102874,26.585675281721613,NaN,NaN,-2.8510204810856563,-16.074101278538414
2001-10-19T09:30:00-04:00,20.89999,21.39999,20.57001,21.23,1903000,1089270,50.631224662207664,49.223973072484405,NaN,NaN,51.764612617623534,89.01340676174596,0.2473192082944558,-0.060149087546022884,-0.3074682958404787,-23407101,-23793421,30.47908873322146,28.192036007068765,NaN,NaN,-2.134513896900175,-14.082731652590095
2001-10-22T09:30:00-04:00,20.89999,21.73,20.89999,21.73,1610800,1082650,54.708307475319444,50.86295573749332,NaN,NaN,74.02856584477018,77.76733203306526,0.2435737369131426,-0.0030011246990504503,-0.24657486161219305,-21796301,-23490141,34.79295365613561,30.144519342131737,NaN,NaN,-0.31337257433666155,-12.115680355696748
2001-10-23T09:30:00-04:00,21.7,22.23,21.53,21.75,774800,1066450,54.86886037504442,51.63868526540973,NaN,NaN,93.9408206917927,71.26000912160865,0.2319819394603464,0.043402562713239945,-0.18857937674710645,-21021501,-23216181,38.50504491301586,32.29580290021021,NaN,NaN,1.21291568897428,-10.21159520645803
2001-10-24T09:30:00-04:00,21.5,22.17999,21.5,22.02,631800,1055375,57.080782586596285,52.32678007124425,NaN,NaN,92.06037237989001,71.91600286842,0.23150556020081528,0.10080257350391264,-0.13070298669690264,-20389701,-22384941,48.149936826146245,34.48571587458638,NaN,NaN,3.135407647089846,-8.304880513094048
2001-10-25T09:30:00-04:00,21.50999,22.66,21.25,22.55,794000,1043840,61.11006371659104,53.30788059444823,NaN,NaN,104.0453305295265,83.16794041272061,0.2540860269034904,0.1869045469324604,-0.06718147997103004,-19595701,-21242061,57.92173672954066,37.15062761875647,NaN,NaN,6.012153316459015,-6.259589966015039
2001-10-26T09:30:00-04:00,22.45,22.87,22.41,22.58,940800,1047750,61.331355248509134,54.219716104247695,NaN,NaN,131.47695321497395,99.11040853219066,0.25744642723246636,0.2546265540695529,-0.002819873162913447,-18654901,-20291621,63.99828822194951,39.814839791014315,NaN,NaN,8.435337484297163,-4.160314615970439
2001-10-29T09:30:00-05:00,22.3,22.72,21.5,21.5,924900,1063540,50.246697872489165,54.607314098562995,NaN,NaN,65.53424471800201,97.41154430683703,0.17715952525360326,0.21862953340409064,0.04147000815048737,-19579801,-19848321,66.43311529363729,42.298454269074924,NaN,NaN,7.344783248933183,-2.5167292066984928
2001-10-30T09:30:00-05:00,21.14999,21.42999,20.89,21.06,1023200,1091395,46.555051221881634,54.343814678068966,NaN,NaN,-20.927052960345886,74.4379695764093,0.08909240922483506,0.1528355196815312,0.06374311045669613,-20603001,-19764621,66.88845634826832,44.63961405905355,NaN,NaN,5.258162584815662,-1.4060303793393278
2001-10-31T09:30:00-05:00,21.3,21.85001,21.2,21.35001,1345500,1082020,49.204078457333274,53.753927616164404,NaN,NaN,9.350550205652219,57.89600514156175,0.047149902644985336,0.12268048876292781,0.07553058611794247,-19257501,-19538181,68.14733513694752,46.938413188201785,NaN,NaN,4.320484238794,-0.5879568624631383
2001-11-01T09:30:00-05:00,21.5,22.2,21.12,22.09,571900,1025715,55.2931538671787,53.63047715836816,NaN,NaN,48.941296855462056,46.87519840674886,0.06492531138626119,0.15668722535076895,0.09176191396450777,-18685601,-19356161,69.16226856588071,49.20278513688651,NaN,NaN,5.412004129529519,0.26918042210724136
2001-11-02T09:30:00-05:00,22.08,22.28,21.84,22.12,586800,1002720,55.52591454984302,53.62220527810723,NaN,NaN,81.38533330122378,36.85687442399883,0.07374105517226598,0.18393823292984024,0.11019717775757426,-18098801,-19244941,69.7955706025989,51.573791624009154,NaN,NaN,6.34836034013998,1.1376346961119181
2001-11-05T09:30:00-05:00,22.71001,22.99001,22.67999,22.8,651200,1008185,60.54075071026133,53.85040201829833,NaN,NaN,175.9605315019949,58.94213178079741,0.11779232938573264,0.25743758948974005,0.1396452601040074,-17447601,-18818501,72.15664541561073,53.9040104733152,NaN,NaN,8.741957517699255,2.223966527767252
2001-11-06T09:30:00-05:00,22.64999,23.60001,22.64999,23.60001,3800400,1161300,65.47334518178724,55.055456816290395,NaN,NaN,224.12090915861228,107.95172420458903,0.18900959614907156,0.37590725529034685,0.1868976591412753,-13647201,-17427341,78.15568116516644,56.8551447950159,NaN,NaN,12.479468274861183,3.6890382059235276
2001-11-07T09:30:00-05:00,23.3,23.99001,23.3,23.5,1077100,1187225,64.38972800927263,56.211379566736774,NaN,NaN,223.0618355696619,150.69398127739098,0.21565268905374185,0.4564635204584526,0.24081083140471077,-14724301,-16520701,81.02503067226075,60.40079659145575,NaN,NaN,15.111987928419959,5.32088816628016
2001-11-08T09:30:00-05:00,23.8,24.35001,23.36,23.62,2088400,1219460,65.13535075966335,57.24738857369789,NaN,NaN,189.984712232079,178.90266435271437,0.22650988648948195,0.5239481895165632,0.29743830302708124,-12635901,-15310761,84.03829871631007,64.22645444739065,NaN,NaN,17.471264329995403,7.056656189668052
2001-11-09T09:30:00-05:00,23.55,23.77,23.28,23.53,903100,1204335,64.05211428156625,57.91480334557266,NaN,NaN,135.03931820927622,189.63346133432486,0.2129856669873995,0.5636703867613306,0.3506847197739311,-13539001,-14398801,85.8608383513362,67.87416049704784,NaN,NaN,19.102669376668754,8.777515216382438
2001-11-12T09:30:00-05:00,23.14999,23.89999,22.89999,23.71001,653900,1206090,65.29529339051285,58.659548560963266,NaN,NaN,112.56918127408737,176.95519128874335,0.20163457961901604,0.6027279442977012,0.4010933646786851,-12885101,-13486301,87.40990014972475,71.36736444252705,NaN,NaN,20.824336128844063,10.498489632448385
2001-11-13T09:30:00-05:00,24.39999,24.60001,23.34,24.55,1575100,1238775,70.43360958436594,59.613321917946806,NaN,NaN,140.97659375696233,160.32632820841337,0.23389942790104912,0.6934676495549965,0.4595682216539474,-11310001,-13018861,88.1274728988391,74.22290273343367,NaN,NaN,23.99309848433438,12.426290897003526
2001-11-14T09:30:00-05:00,24.94,25,24.19,24.67999,2779700,1270030,71.14558537705105,60.330144893693955,NaN,NaN,149.03456836827817,145.5208747681366,0.24596687758587898,0.7670268186362961,0.5210599410504171,-8530301,-11780061,89.7885315568914,76.49910236395873,NaN,NaN,26.799810131002772,14.479650787574846
2001-11-15T09:30:00-05:00,24.56,24.94,24.33,24.53,1513300,1307485,69.07855338043586,60.88351618883157,NaN,NaN,130.17504664816474,133.5589416513538,0.22631411568195026,0.8039525856528549,0.5776384699709046,-10043601,-11261601,90.39425134335761,78.38452830120217,NaN,NaN,28.555478789326717,16.490483359253684
2001-11-16T09:30:00-05:00,24.7,24.73,24.24001,24.45,572900,1240980,67.94467356593542,62.14765730979202,NaN,NaN,108.90360671790667,128.33179935307987,0.1917607525727807,0.8173394106868805,0.6255786581140999,-10616501,-10677101,91.03955909818629,80.14213143009852,NaN,NaN,29.7076333568306,18.378647644621815
2001-11-19T09:30:00-05:00,24.60001,24.99001,24.53999,24.96001,2834000,1302140,71.19122286269604,63.907383855564476,NaN,NaN,117.80153739816863,129.3782705778961,0.18689532397642183,0.8591978130846272,0.6723024891082053,-7782501,-9656581,92.04446776843703,81.93898938868199,NaN,NaN,31.66811851740219,20.27714348359044
2001-11-20T09:30:00-05:00,24.75,24.85001,24.14,24.25999,4446398,1485719.9,61.92125946897145,64.81575392782435,NaN,NaN,82.85695938652816,117.75434370380928,0.12324551139091922,0.8263593783468544,0.7031138669559351,-12228899,-9840360.6,90.08512347410365,83.50597426990744,NaN,NaN,30.62405895701974,21.755274265508913
2001-11-21T09:30:00-05:00,24.00999,24.19,23.67,24.02,4002800,1654269.9,59.08094528619788,65.0863104577543,NaN,NaN,48.64372944057483,97.67617591826861,0.055164552551425716,0.7720695576452172,0.7169050050937915,-16231699,-11380640.2,75.56639131204437,83.96341160891913,NaN,NaN,28.89560144409139,22.77532100530641
2001-11-23T09:30:00-05:00,24.03999,24.42999,23.91,24.39,234600,1626299.9,61.97674892904061,65.54708434198268,NaN,NaN,62.5242769225322,84.1460219731421,0.02667755902454394,0.7502519538744714,0.7235743948499275,-15997099,-12571339.8,66.62690465764305,83.73707832713656,NaN,NaN,28.26905314039892,23.560139881748196
2001-11-26T09:30:00-05:00,24.49001,24.85001,24.42,24.81,2208000,1689659.9,65.00429342007203,65.86590882125488,NaN,NaN,86.48685437947904,79.66267150545659,0.02763071080378743,0.7581127833546617,0.7304820725508743,-13789099,-13205859.4,62.39111704301869,83.03954058623712,NaN,NaN,28.637314421700005,24.28545053031274
2001-11-27T09:30:00-05:00,24.66,25.14999,24.19,24.73,2156900,1751259.9,63.959638942242584,65.75778694700169,NaN,NaN,81.3950364891735,72.38137132365758,0.015014601631369695,0.7492503245900863,0.7342357229587166,-15945999,-14838559,53.04602995572583,81.24599407127708,NaN,NaN,28.633015573631678,24.906531250786873
2001-11-28T09:30:00-05:00,24.45,24.66,23.95,23.95,640100,1732104.9,54.72525875304862,65.06746771441426,NaN,NaN,38.37068224138087,63.48411589462812,-0.05015168612195409,0.6715461153062741,0.7216978014282281,-16586099,-15709999,48.84107191826903,78.94713987456339,NaN,NaN,25.715811422424668,25.022142703877986
2001-11-29T09:30:00-05:00,24.14999,24.59,23.97,24.59,3821500,1855904.9,59.84775485278691,64.68978229249451,NaN,NaN,50.029958028771446,63.76136161226744,-0.054103894799041985,0.6540679329294257,0.7081718277284677,-12764599,-15016579,52.09517702229731,76.66548832499106,NaN,NaN,24.804228794557,24.99101214540356
2001-11-30T09:30:00-05:00,24.39999,24.73,24.27,24.53999,3255300,1990074.9,59.28331238140872,64.34915358534042,NaN,NaN,58.96327422429722,63.04916107262045,-0.06339263580584353,0.6289310329711633,0.6923236687770068,-16019899,-15021139,52.07172041328324,74.2519799008444,NaN,NaN,23.909016362060843,24.836441319211744
2001-12-03T09:30:00-05:00,24.25,24.44,24.09,24.19,538900,1987679.9,55.34903192224906,63.63870633760728,NaN,NaN,17.16626820419407,49.185043837563455,-0.09453881889061766,0.5741501451637347,0.6686889640543524,-16558799,-15575079,49.175075164487964,71.52092097332749,NaN,NaN,21.945702923360148,24.423478691232944
2001-12-04T09:30:00-05:00,24.32001,24.96001,24.25,24.94501,1764900,2043364.9,61.31352770014082,62.987271917305485,NaN,NaN,87.8855806290312,50.483152665534995,-0.06701809722690522,0.5849163425207209,0.6519344397476261,-14793899,-15344659,50.41080233123788,68.8268730756417,NaN,NaN,22.088949743266284,24.089974555809135
2001-12-05T09:30:00-05:00,25.2,26.3,25.2,26.14999,3631800,2034934.9,68.53711894357146,62.800952886342664,NaN,NaN,257.7532581466382,94.35966784658645,0.024700004048876734,0.6828094448087221,0.6581094407598453,-11162099,-14259859,55.85285410095484,66.40289611450336,NaN,NaN,24.80482957628607,24.192096701591556
2001-12-06T09:30:00-05:00,26.14999,26.3,25.91,26.08,4324898,2197324.8,67.74586180093068,62.705760630663725,NaN,NaN,247.59218895007294,133.87211403084675,0.07042586158660158,0.7461417677430973,0.6757159061564957,-15486997,-14804338.6,52.72525625106172,63.7122536079108,NaN,NaN,26.621282202136488,24.539123201669405
2001-12-07T09:30:00-05:00,25.99001,26,25.3,25.60001,3469500,2266379.8,62.42331479886606,62.31137786158734,NaN,NaN,152.6677519634612,152.61300957867954,0.058601889807126106,0.7489682684154033,0.6903663786082772,-18956497,-15391658.2,49.50498793344477,60.74549852471499,NaN,NaN,26.377646083474325,24.801769327641537
2001-12-10T09:30:00-05:00,25.25999,25.75,25,25.03999,757300,2259089.8,56.81472505008467,61.28448516068652,NaN,NaN,88.7819262337593,166.9361411845926,0.006085738879827551,0.6979735522080617,0.6918878133282341,-19713797,-16022657.8,46.23754929472764,57.47357577659288,NaN,NaN,24.305872393215466,24.730926908437812
2001-12-11T09:30:00-05:00,25.39999,25.69,25.08,25.22,1548400,2303814.8,58.11734821224651,61.012777213777596,NaN,NaN,85.33088790431138,166.4252026396486,-0.02196938306332019,0.6644260844990839,0.6863954675624041,-18165397,-16696957.4,42.97342315913215,54.10845432552349,NaN,NaN,23.059454445475176,24.492145128014577
2001-12-12T09:30:00-05:00,25.23,25.50999,24.92,25.32001,1993800,2324749.8,58.85982137258395,60.996982648519456,NaN,NaN,63.945166099439,127.66358423020878,-0.03827745051439291,0.638548654419413,0.6768261049338059,-16171597,-17698857,38.61179983870865,51.46884064885665,NaN,NaN,22.278839667164387,24.175958633607408
2001-12-13T09:30:00-05:00,24.94,25.03,24.35001,24.42,4562500,2413889.8,50.23005849288829,60.15793333165143,NaN,NaN,-28.495291589466138,72.44608812230098,-0.11009949406299602,0.5392017373550608,0.6493012314180568,-20734097,-18748277,34.64534172362559,49.18444329642682,NaN,NaN,18.76474870335582,23.402928643571467
2001-12-14T09:30:00-05:00,24.39999,24.78,24.25999,24.52,1620200,2419234.8,51.08814564533994,59.16392277631343,NaN,NaN,-39.077509452482985,34.09703583911214,-0.14888235112986714,0.463198292505723,0.6120806436355901,-19113897,-18779757,34.53074851254216,47.19441697282135,NaN,NaN,16.222561083551977,22.37716184928297
2001-12-17T09:30:00-05:00,24.52,25.17999,24.52,24.99001,1436600,2462419.8,55.0139937317206,58.524948118419005,NaN,NaN,11.376686764282901,18.615987945216848,-0.1409713179491151,0.43586649619919626,0.5768378141483114,-17677297,-18372457,37.415098665630374,46.077921880671674,NaN,NaN,15.248526122345668,21.358785316863354
2001-12-18T09:30:00-05:00,25.14999,25.38,24.89999,25.09,3061000,2473769.8,55.82629538734544,58.603593592297344,NaN,NaN,40.28315929446065,9.606442223246699,-0.1275006782204703,0.4174619663727235,0.5449626445931938,-14616297,-17662637,42.19475180958281,45.603184730051225,NaN,NaN,14.697445284558174,20.407165312248328
2001-12-19T09:30:00-05:00,24.55,25.08,24.53,24.73,2215100,2362204.9,52.173538195255354,58.055435259616516,NaN,NaN,-10.018500681356683,-5.186291132912439,-0.1403164253519228,0.36956711290329025,0.509883538255213,-16831397,-17794597,41.55931272391088,44.850622994452195,NaN,NaN,13.149560015848158,19.37036455561973
2001-12-20T09:30:00-05:00,24.8,24.8,23.85001,23.88,1601900,2242159.9,44.731431377778684,57.01601518792865,NaN,NaN,-99.44986374100246,-19.37720556321971,-0.19988699362787932,0.2600247962203639,0.4599117898482432,-18433297,-17334437,44.68748139988439,44.32317735063799,NaN,NaN,9.362953100604203,17.94073434776037
2001-12-21T09:30:00-05:00,24.25,24.37,24.03999,24.2,1308500,2295854.9,47.75293582195666,56.473436895050625,NaN,NaN,-94.95423201571528,-30.55255007586617,-0.21051754082295526,0.19676486381954916,0.4072824046425044,-17124797,-16936617,47.31314771831935,44.19018253305452,NaN,NaN,7.1600907670302405,16.400642407656065
2001-12-24T09:30:00-05:00,24.25,24.35001,24.06,24.11,999100,2235409.9,46.975096462102194,55.44926323519071,NaN,NaN,-91.40305226162674,-51.1084978810481,-0.21560159018657404,0.13778041690928688,0.35338200709586093,-18123897,-17025937,46.776253999809796,43.93057193795251,NaN,NaN,5.15036218960898,14.793459519363624
2001-12-26T09:30:00-05:00,24.24001,24.71001,24.21001,24.3,1775000,2216314.9,48.86863017193136,54.044371180073576,NaN,NaN,-55.79919434967374,-70.32496860987497,-0.19858234238962302,0.10515407910883212,0.30373642149845514,-16348897,-17372457,44.65896840802219,43.1310086741716,NaN,NaN,4.017983172110149,13.25410575547027
2001-12-27T09:30:00-05:00,24.49001,24.64,24.3,24.50999,1348300,2251724.9,50.95327864151463,52.844900954401,NaN,NaN,-48.60204575467666,-78.04167762453898,-0.16687302880984206,0.09514513548615255,0.2620181642959946,-15000597,-17006297,47.36988169601508,42.748481920239705,NaN,NaN,3.6516541801079874,11.882326958989944
2001-12-28T09:30:00-05:00,24.75,24.89999,24.50999,24.56,3130600,2217179.9,51.46083078539631,52.061866382010294,NaN,NaN,-27.07305089191169,-63.566315054720825,-0.1374477336762053,0.09020849720073798,0.22765623087694328,-11869997,-15693637,55.74023055063105,43.19385639289586,NaN,NaN,3.486322604236424,10.682897765453728
2001-12-31T09:30:00-05:00,24.41,24.74001,24,24,2013000,2155064.9,45.75142201091836,51.271630450641275,NaN,NaN,-81.51741301817333,-60.87895125521243,-0.14961268156727198,0.040640378917853326,0.1902530604851253,-13882997,-15045277,59.19244988554741,44.11920643509728,NaN,NaN,1.7046740929160955,9.400294383662636
2002-01-02T09:30:00-05:00,24.39999,24.69,24.10001,24.60001,3182000,2287219.9,51.90803698548752,50.828108220158484,NaN,NaN,-54.00330374050619,-53.39900155098832,-0.11283775560929049,0.049205865973512175,0.16204362158280267,-10700997,-13560697,65.77513463585913,45.74790011200635,NaN,NaN,1.9536392099063544,8.336486501697454
2002-01-03T09:30:00-05:00,24.91,25.75,24.91,25.67999,2751100,2336529.9,60.57991401420956,50.950971980274595,NaN,NaN,75.50922810625964,-27.137317059801642,-0.016428323059712785,0.1415082177581617,0.15793654081787448,-7949897,-11880897,71.39734981864163,48.08972511057299,NaN,NaN,5.118554019921531,7.87678186144375
2002-01-04T09:30:00-05:00,26.06,26.14999,25.53,25.84,4569000,2383389.9,61.682355396557,51.768993187679506,NaN,NaN,128.98225419149043,8.379542929431775,0.053632028434839774,0.2249765763614242,0.17134454792658443,-3380897,-9556957,77.02131792690135,51.116580553664114,NaN,NaN,7.988849460447798,7.892791518444328
2002-01-07T09:30:00-05:00,26,26.14999,25.50999,25.56,1551500,2244720,58.59427421787629,52.305145228574965,NaN,NaN,122.800351961861,38.35422350018632,0.07530195849818927,0.26547199604932104,0.19017003755113177,-4932397,-8169437,79.60035828686998,54.33583839468753,NaN,NaN,9.399778327808676,8.108075348353522
2002-01-08T09:30:00-05:00,25.45,25.92999,25.38,25.75,616500,2102070,60.05565475439726,52.66526387305186,NaN,NaN,114.26855244202403,77.5114165922258,0.09532840994379116,0.30933054998087073,0.21400214003707957,-4315897,-6256017,82.51482296717694,57.55724727336942,NaN,NaN,10.999563310902502,8.52114505728909
2002-01-09T09:30:00-05:00,26.14999,26.32001,25.39999,25.55,2242000,2176305,57.745289941144584,52.80233491260895,NaN,NaN,114.11452881297495,111.13498310292202,0.0881687795362367,0.32421311445737544,0.23604433492113874,-6557897,-5427397,83.60707413403736,60.51527029654475,NaN,NaN,11.656227575561715,8.969013988470893
2002-01-10T09:30:00-05:00,25.45,25.62,25.23,25.34,861600,2141965,55.33802286361296,53.028369531777344,NaN,NaN,65.85302140315706,109.2037417623015,0.06350562824029338,0.31542637022150544,0.25192074198121206,-7419497,-5321317,83.7470481794831,63.528679971942765,NaN,NaN,11.517900214398844,9.333140592174885
2002-01-11T09:30:00-05:00,25.46001,25.59,25.02,25.10001,1731800,2128865,52.63741932003342,53.593082956224116,NaN,NaN,45.11338234599563,92.42996739320253,0.027105858385394754,0.2858030649629555,0.25869720657756073,-9151297,-6475397,76.13084092421448,65.77463422368062,NaN,NaN,10.631474831052724,9.518616912014577
2002-01-14T09:30:00-05:00,24.95,25.08,24.53,24.71001,1294400,1965460,48.495560226134224,53.64612755652251,NaN,NaN,-16.852002020353005,64.49949659675974,-0.024377128006104476,0.22822579656993014,0.2526029245760346,-10445697,-7578057,69.6164816748679,67.36772950629123,NaN,NaN,8.651032764913829,9.394676319571614
2002-01-15T09:30:00-05:00,24.77,25.10001,24.58,24.87,1220400,1945470,50.22584483008882,53.87832386852155,NaN,NaN,-9.107417237044688,39.824302660945996,-0.047460521765253644,0.19327727236946757,0.2407377941347212,-9225297,-8559937,64.33720138325202,68.62208289082282,NaN,NaN,7.476828461535616,9.1206980541379
2002-01-16T09:30:00-05:00,24.60001,24.71001,24.25,24.25999,2038000,1975540,44.13737478278899,53.54037705501138,NaN,NaN,-63.63577798232662,4.274241301885683,-0.10056496041984914,0.11503159360990978,0.2155965540297589,-11263297,-9501017,59.666859805715845,69.69407513351521,NaN,NaN,4.573571682816161,8.471108572520508
2002-01-17T09:30:00-05:00,24.7,24.89,24.42999,24.86,795000,1862240,50.49423830617719,53.507588459630135,NaN,NaN,-19.4611584173259,-12.788594662210908,-0.09225232852577983,0.10028114337253413,0.19253347189831396,-10468297,-10110777,56.79027285651897,70.36696021640836,NaN,NaN,3.9748695880238936,7.8287887175924205
2002-01-18T09:30:00-05:00,24.25,24.39,23.86,24.03,1600100,1831490,43.17511106889236,52.91575133702271,NaN,NaN,-94.61823584945068,-40.73491830130018,-0.13693006427650306,0.021370891552685123,0.15830095582918818,-12068397,-10694197,54.10264056381973,70.2499895030647,NaN,NaN,0.9844445154760095,6.851025260147219
2002-01-22T09:30:00-05:00,24.2,24.25999,23.13,23.17,1891800,1845985,37.1641166046684,52.302372379433436,NaN,NaN,-155.4969808613749,-68.46391406950457,-0.21408149373840027,-0.10930091134381215,0.10478058239458812,-13960197,-11397097,50.9727383153034,69.66286724804726,NaN,NaN,-3.759123417738154,5.335289734735023
2002-01-23T09:30:00-05:00,23.25,23.67999,23.00999,23.52,1468200,1853970,40.777812371010654,51.50735633554223,NaN,NaN,-155.51571958126962,-97.74557453834954,-0.22983509163154187,-0.1825132821448392,0.047321809486702664,-12491997,-12050437,48.18255628309131,68.40625450856385,NaN,NaN,-6.329186814521136,3.6689359419841434
2002-01-24T09:30:00-05:00,23.60001,24.14999,23.60001,23.87,4121000,2010065,44.231758020523934,50.33963090742183,NaN,NaN,-97.8739390890326,-104.59320675969074,-0.20575604787321916,-0.2098732503548213,-0.0041172024816021335,-8370997,-11471977,50.75291574763151,66.93165207492027,NaN,NaN,-7.270008811770758,2.106229548590586
2002-01-25T09:30:00-05:00,23.64999,24.02,23.62,23.78,1119300,1977280,43.52874025409966,49.04294411153201,NaN,NaN,-97.4576711111116,-120.19250929844789,-0.18558375170330801,-0.23609689211073714,-0.05051314040742914,-9490297,-11276377,51.62669917418662,65.11775073544064,NaN,NaN,-8.231929884377127,0.6293496295951986
2002-01-28T09:30:00-05:00,23,24.14999,23,23.95,1093000,1964515,45.297348211415944,48.09316368249914,NaN,NaN,-98.48622333751662,-120.96610679606108,-0.1519020188314408,-0.24039066394673014,-0.08848864511528934,-8397297,-10542157,54.86403710370165,63.35087065092862,NaN,NaN,-8.486212007498928,-0.6728734614182479
2002-01-29T09:30:00-05:00,24.06,24.13,23.00999,23.10001,1163100,1866140,38.76082652653716,46.57210452336627,NaN,NaN,-110.66237295198506,-111.9991852141831,-0.17626564833947905,-0.30882070553963814,-0.1325550572001591,-9560397,-9662197,58.45280540733422,61.632155110939856,NaN,NaN,-10.816438626141135,-2.121954199235803
2002-01-30T09:30:00-05:00,23.00999,23.39999,22.44,23.39999,2932800,1912130,41.94486102619172,45.4435024580125,NaN,NaN,-125.80049721031692,-106.05614073999257,-0.1619436608160656,-0.3349846332202411,-0.17304097240417549,-6627597,-8489317,62.7088293178234,60.13942333835315,NaN,NaN,-11.72956033432735,-3.4944693613917384
2002-01-31T09:30:00-05:00,23.75,24,23.25,23.74001,1377400,1821900,45.40953282271986,44.734324597948714,NaN,NaN,-69.3070590243638,-100.3427647270588,-0.12120069863412777,-0.3245418456968352,-0.20334114706270742,-5250197,-7865157,64.77668226445276,58.78439720156526,NaN,NaN,-11.413645653386368,-4.6257802602481135
2002-02-01T09:30:00-05:00,23.55,23.81,23.19501,23.3,2049900,1786840,41.922831056276706,43.968996864823225,NaN,NaN,-79.83537563807056,-96.8183056324506,-0.11553684619682186,-0.34776220480873477,-0.2322253586119129,-7300097,-7427117,66.19350745255235,58.074587667875115,NaN,NaN,-12.22328932429465,-5.711138697969047
2002-02-04T09:30:00-05:00,23.3,23.32001,22.5,22.64,1297500,1623265,37.29682968208512,43.16908754024829,NaN,NaN,-118.51103440347629,-100.82326784564253,-0.14593272467606105,-0.41464126445698923,-0.2687085397809282,-8597597,-7467177,65.93231166436573,57.81143266712496,NaN,NaN,-14.416625434699265,-6.954779660359078
2002-02-05T09:30:00-05:00,22.35001,22.84,22.2,22.28999,3453000,1718340,35.0857369458776,42.08765126280463,NaN,NaN,-138.42136656096125,-106.37506656743776,-0.17722129391849495,-0.49023515717904687,-0.3130138632605519,-12050597,-7965217,62.623832667473955,57.68904918742653,NaN,NaN,-16.930161225157303,-8.379834169615966
2002-02-06T09:30:00-05:00,22.56,22.56,21.99001,22.16,1205700,1747800,34.27308896003629,41.3830594183223,NaN,NaN,-145.13897522610117,-110.2427621705946,-0.19298410036522196,-0.5542439887170794,-0.3612598883518574,-13256297,-9290957,54.74830635692822,57.337723941084555,NaN,NaN,-19.20522437408878,-9.926318484540653
2002-02-07T09:30:00-05:00,22.16,22.47,21.8,21.83,1710700,1721235,32.23206249396982,40.07861828887891,NaN,NaN,-153.15790620427708,-127.01293160657727,-0.21051366825363899,-0.6244019736689062,-0.41388830541526717,-14966997,-11234317,45.67966135141459,56.544108833577106,NaN,NaN,-21.739869671017196,-11.613968654037302
2002-02-08T09:30:00-05:00,21.95,22.27,21.66,22.25,1143900,1735350,37.346095892620745,39.66226006200237,NaN,NaN,-137.89564041655527,-138.6249845622742,-0.17988862797516503,-0.6387490903842235,-0.4588604624090584,-13823097,-12538917,40.79446772379146,55.59352505928937,NaN,NaN,-22.376568544024398,-13.15148292403546
2002-02-11T09:30:00-05:00,22.35001,22.75,22.21001,22.75,632500,1680385,42.873048472323134,40.070040909692,NaN,NaN,-83.86185673687332,-131.6951490289536,-0.11517121174805267,-0.6028244770941242,-0.48765326534607156,-13190597,-13457517,37.73440607904437,54.64792989955658,NaN,NaN,-21.224047851332998,-14.304706485077965
2002-02-12T09:30:00-05:00,22.36,22.7,22.25999,22.38,1007400,1666035,40.05704666105515,40.01855764469517,NaN,NaN,-84.73397203130229,-120.95767012302183,-0.08773681768755115,-0.5973242874555105,-0.5095874697679593,-14197997,-13886997,36.361100725901075,53.80354021690014,NaN,NaN,-21.1017107817471,-15.27570709888784
2002-02-13T09:30:00-05:00,22.60001,22.82001,22.5,22.74001,556300,1632830,43.916960673325136,39.99607211989525,NaN,NaN,-53.8694474858279,-102.70376457496718,-0.03832135318037477,-0.5574891612434278,-0.5191678080630531,-13641697,-13964077,36.10711702185758,52.75741173648771,NaN,NaN,-19.819379578908766,-15.924803167462258
2002-02-14T09:30:00-05:00,22.94,22.95,22.44,22.5,794300,1570645,41.97632776449098,39.88518551349464,NaN,NaN,-53.01132692234696,-82.67444871858115,-0.015923552394334628,-0.5390722485559714,-0.5231486961616367,-14435997,-13857877,36.762523688608375,51.69568491608926,NaN,NaN,-19.322775361438772,-16.41022776660176
2002-02-15T09:30:00-05:00,22.38,22.53999,21.75,21.85001,1198400,1590815,37.18416881282398,39.305672699309504,NaN,NaN,-105.58117327457784,-76.21155529018566,-0.03776170235245002,-0.5703508241021993,-0.5325891217497493,-15634397,-14220137,35.42752827825903,50.30736285712907,NaN,NaN,-20.35982741947512,-16.974456288440813
2002-02-19T09:30:00-05:00,21.5,21.63,21.05,21.08,1801800,1600900,32.45692009842986,38.8553936687304,NaN,NaN,-172.610465077511,-93.96127695831319,-0.09375462679091584,-0.649782405238394,-0.5560277784474782,-17436197,-15069257,32.45272032948715,48.450213922997136,NaN,NaN,-22.824519658040394,-17.810179626955037
2002-02-20T09:30:00-05:00,21.11,21.36,20.62,21.34,1621700,1587395,35.441383484887425,38.39085955863724,NaN,NaN,-165.11453094041048,-110.03738874013484,-0.10227334289483925,-0.6838694570660273,-0.5815961141711881,-15814497,-15392557,31.37255727573708,46.21190877713383,NaN,NaN,-23.885103321696572,-18.67802586906097
2002-02-21T09:30:00-05:00,21.00999,21.16,20.32001,20.35001,1015900,1564780,30.00488252487861,37.290527394505716,NaN,NaN,-185.12937886027348,-136.28937501502395,-0.1601279197274602,-0.7817560138305133,-0.6216280941030531,-16830397,-16030297,29.300793526903846,43.67791672445177,NaN,NaN,-26.688624861058972,-19.822397153632114
2002-02-22T09:30:00-05:00,20.25,20.84,20.07001,20.48,1214400,1419450,31.490889843889434,36.54538873647805,NaN,NaN,-172.27923159984147,-160.14295595052286,-0.17403295471054503,-0.8391692874912344,-0.6651363327806894,-15615997,-16266297,28.54944572750908,40.98905517266296,NaN,NaN,-28.4172827970862,-21.05023795983984
2002-02-25T09:30:00-05:00,20.78,21.38,20.61,21.17,1308400,1428905,38.90536031468061,36.660283781663445,NaN,NaN,-106.51694325562059,-160.3301099467314,-0.12352715717409324,-0.819545279248306,-0.6960181220742128,-14307597,-16000937,30.70121353141475,38.47254816316646,NaN,NaN,-27.470921445224583,-21.967478457751948
2002-02-26T09:30:00-05:00,21.35001,21.46001,20.84,21.03999,447000,1396605,38.06933494962077,36.873397924787966,NaN,NaN,-90.65450348860165,-143.93891762894955,-0.08734707415227216,-0.805201964764553,-0.7178548906122808,-14754597,-15464617,34.964214307019674,36.49686113741972,NaN,NaN,-26.976347373078553,-22.683031159941464
2002-02-27T09:30:00-05:00,21.28999,21.44,20.64999,20.89,1599600,1418430,37.079386050160416,37.07384771693968,NaN,NaN,-90.72050346166199,-129.06011213319985,-0.06311868646235086,-0.7967532486902194,-0.7336345622278685,-16354197,-15572557,34.50416497098776,35.05085103842397,NaN,NaN,-26.867360119909318,-23.28079243993687
2002-02-28T09:30:00-05:00,20.85001,21.2,20.61,20.65601,414600,1292520,35.52728777365573,37.30922095120297,NaN,NaN,-92.09871235348228,-110.4539788318416,-0.052868305488506184,-0.7997199440885012,-0.746851638599995,-16768797,-15560237,34.6099210824044,34.260155304923245,NaN,NaN,-27.226598963339093,-23.844479086137188
2002-03-01T09:30:00-05:00,20.92,21.72,20.89999,21.69,1573500,1302325,46.236919797862015,37.94427980157734,NaN,NaN,-33.60988198038047,-82.72010890794942,0.029123608695976744,-0.7104471277300242,-0.7395707364260009,-15195297,-15476097,35.37737598036621,33.87322018039287,NaN,NaN,-24.106877206698403,-23.881964531931647
2002-03-04T09:30:00-05:00,21.8,22.48,21.45,22.48,1674200,1283540,52.70151420568236,38.64631306824585,NaN,NaN,37.64679874966222,-53.887360506892854,0.13614632401547433,-0.569387831406658,-0.7055341554221324,-13521097,-15318797,36.869118109594595,33.81141389686075,NaN,NaN,-19.20331377159415,-23.213585851883433
2002-03-05T09:30:00-05:00,22.45,22.85001,22.39999,22.55,919500,1264640,53.238058164402766,39.58781388991354,NaN,NaN,84.82376307102584,-18.791707194967337,0.20698853001477757,-0.44679849290366036,-0.6537870229184379,-12601597,-14888197,40.89155021216889,34.135017431594164,NaN,NaN,-15.187777873235769,-22.067041854933766
2002-03-06T09:30:00-05:00,22.39999,22.92,22.2,22.77,508300,1117405,54.9670685980391,40.377107313107395,NaN,NaN,85.79265899517901,16.51092529640087,0.26054070904871884,-0.3281111366075393,-0.5886518456562582,-12093297,-14036017,47.95859543811363,34.981551604183885,NaN,NaN,-11.368907667462734,-20.53873697100933
2002-03-07T09:30:00-05:00,23.03,23.11,22.42,22.69,479900,1081115,54.182526382944395,41.248978642996924,NaN,NaN,91.02696072418229,53.136059911933785,0.2807094163053334,-0.23776507527459145,-0.5184744915799249,-12573197,-13196897,53.81422931240328,36.199530577312096,NaN,NaN,-8.488005146664763,-18.81720385324582
2002-03-08T09:30:00-05:00,23.32001,23.48,23,23.28999,1976700,1094415,58.91839701486055,42.80142351457096,NaN,NaN,124.20211964250475,84.69846023651084,0.3216523129135753,-0.11640910043795571,-0.43806141335153104,-10596497,-12277137,59.2293448221166,37.89966033044477,NaN,NaN,-4.491460106009273,-16.77066903221203
2002-03-11T09:30:00-05:00,23.10001,23.56,22.92999,23.36,959600,1085200,59.445156267958346,44.72915466953729,NaN,NaN,113.05009358010403,99.77911920259919,0.3389145784945676,-0.014418190233321582,-0.35333276872788916,-9636897,-11500297,63.158331572434925,40.09291827636961,NaN,NaN,-1.083279083167856,-14.52961332520572
2002-03-12T09:30:00-05:00,22.85001,22.86,22.56,22.86,915900,1099370,54.10899585686376,46.06255555324988,NaN,NaN,68.97591343160104,96.60954927471423,0.3032802053989775,0.02576748802083273,-0.27751271737814476,-10552797,-11090537,65.07042387869268,42.4999087480093,NaN,NaN,0.3654805692095532,-12.40174276886068
2002-03-13T09:30:00-05:00,22.60001,22.60001,22.17999,22.25999,581800,1078090,48.484443239996516,47.3825241757583,NaN,NaN,36.29143861288727,86.70930519825588,0.2292856151859813,0.00909430160433189,-0.22019131358164942,-11134597,-10898797,65.96068662581604,45.11847254078874,NaN,NaN,-0.06809712527004293,-10.639793391204876
2002-03-14T09:30:00-05:00,22.35001,22.38,21.97,22,359100,1068230,46.24142622119536,48.436133916994436,NaN,NaN,20.619395842219813,72.62779222186339,0.15630319648848717,-0.024812317971040443,-0.18111551445952762,-11493697,-10682897,66.98118193172726,47.86359655537575,NaN,NaN,-1.1036785749727773,-9.27749127460029
2002-03-15T09:30:00-05:00,22.00999,22.27,21.94,22.16,406800,1048855,47.84065396560017,49.074369177774415,NaN,NaN,23.978956972343443,52.58315968783113,0.11422758029884225,-0.038331039085974794,-0.15255861938481705,-11086897,-10780977,66.01296657079298,50.38586462961705,NaN,NaN,-1.502170764992504,-8.166731201799179
2002-03-18T09:30:00-05:00,22.60001,22.60001,22.11,22.23,642500,1021060,48.56161639079485,49.82381785214398,NaN,NaN,38.58013055926602,37.68916708366353,0.08772548497921154,-0.04290176316080263,-0.13062724814001417,-10444397,-10942477,64.36315909638003,52.48578925742851,NaN,NaN,-1.632476321144313,-7.233266218848484
2002-03-19T09:30:00-05:00,22.31,22.46001,22.14999,22.32001,577400,959840,49.527691881026726,50.71298255434873,NaN,NaN,34.62230964500354,30.81844632634403,0.07345090178864828,-0.038813620904203816,-0.1122645226928521,-9866997,-10805317,65.15955199858413,54.67545975939968,NaN,NaN,-1.4838605918297323,-6.411922557845805
2002-03-20T09:30:00-05:00,21.96001,22.03,21.60001,21.64,1082400,932875,42.96282659421448,51.24409247010292,NaN,NaN,-17.046754811195946,20.150807641527386,0.018280296597144613,-0.08941415194642133,-0.10769444854356594,-10949397,-10768277,65.38452307541885,56.87364561604357,NaN,NaN,-3.2574293878311495,-5.961280676415139
2002-03-21T09:30:00-05:00,21.7,22.10001,21.5,22.07001,1566100,960385,47.68509940623473,51.347533870700964,NaN,NaN,-11.972439303891845,13.632440612305057,0.011166210089510756,-0.0937366859316775,-0.10490289602118825,-9383297,-10346197,67.92609971549336,59.19855445426693,NaN,NaN,-3.4207210728488784,-5.598343590191388
2002-03-22T09:30:00-05:00,22.05,22.09,21.73,21.75,882300,943780,44.717916510525654,50.77727689247549,NaN,NaN,-25.791789380537196,3.678291341728928,-0.013344023614358963,-0.12158292553913697,-0.108238901924778,-10265597,-10181937,68.88361080707264,61.48530393265822,NaN,NaN,-4.439402814040916,-5.432780622169892
2002-03-25T09:30:00-05:00,21.85001,21.99001,21.25999,21.25999,1153600,936040,40.55643930754734,49.87144697412867,NaN,NaN,-73.27462136228388,-18.692659042581056,-0.058291547529421825,-0.1811033363365553,-0.12281178880713346,-11419197,-10376897,66.35173329087206,63.30388843827988,NaN,NaN,-6.602842088374586,-5.599932260199134
2002-03-26T09:30:00-05:00,21.22,21.74001,21.17999,21.42,2001400,1013760,42.44014275561304,48.976666556812525,NaN,NaN,-85.43926900777122,-42.70497477313601,-0.072076929474122,-0.21290795064978596,-0.14083102117566396,-9417797,-10287057,66.95449832005667,64.66073864413295,NaN,NaN,-7.839296405802125,-5.919841423856704
2002-03-27T09:30:00-05:00,21.36,21.47,21.17999,21.41,812700,974415,42.349820069534914,48.13147324871185,NaN,NaN,-103.36539575388758,-59.96870296167433,-0.07629319516571254,-0.23619751513280463,-0.1599043199670921,-10230497,-10143277,67.9442023914326,65.67002243549219,NaN,NaN,-8.87130948584255,-6.341479718426111
2002-03-28T09:30:00-05:00,21.60001,21.84,21.58,21.67,1339900,1020680,45.59202598730057,47.17958960388614,NaN,NaN,-69.14059562979412,-71.40233422685478,-0.05688604370476033,-0.2310118745980425,-0.17412583089328218,-8890597,-10044737,68.63747304537591,66.34203159429642,NaN,NaN,-8.865065735778261,-6.7019920066192755
2002-04-01T09:30:00-05:00,21.52,22.05,21.35001,21.91,356300,959820,48.47273628192205,46.39584531916926,NaN,NaN,-63.03557045568968,-78.85109044188529,-0.0248362454585071,-0.20517113771641604,-0.18033489225790894,-8534297,-9698477,71.01003908387489,66.90286784511356,NaN,NaN,-8.058856717031144,-6.8958298223923995
2002-04-02T09:30:00-05:00,21.58,21.67999,21.22,21.27,454000,898810,42.07515042149039,45.53628493092831,NaN,NaN,-105.98839912161164,-85.39384599375083,-0.04264532185213005,-0.2336415445730715,-0.19099622272094147,-8988297,-9212297,73.98579476945196,67.53968005159638,NaN,NaN,-9.220215228801084,-7.227884880450783
2002-04-03T09:30:00-05:00,21.2,21.44,20.731,20.94,741900,889930,39.20207953362357,44.87325895190167,NaN,NaN,-136.48349311819496,-95.60269081583559,-0.07089072063222016,-0.27960962351121665,-0.2087189028789965,-9730197,-9274777,72.94945936609247,68.03887810447326,NaN,NaN,-11.07837422409471,-7.77795478668563
2002-04-04T09:30:00-05:00,21,21.23,20.75999,21.03,1401200,934575,40.397439844315784,44.45583135355313,NaN,NaN,-125.40279729096255,-100.01017112325057,-0.07723174052616114,-0.3052585785366979,-0.22802683801053678,-8328997,-8894477,75.22428529944604,68.62767120216746,NaN,NaN,-12.261396268332,-8.418446426920825
2002-04-05T09:30:00-05:00,21.25,21.25,20.66,20.7,811300,951145,37.48707288418645,43.716289847737855,NaN,NaN,-130.71861104655412,-112.32577420660259,-0.0961385053961113,-0.3481999697556759,-0.2520614643595646,-9140297,-8944417,74.34018255144537,69.22247234364264,NaN,NaN,-14.13841160268007,-9.235584309172147
2002-04-08T09:30:00-04:00,20.14999,20.67,19.98,20.60001,828800,893750,36.62605656637153,42.86374986027904,NaN,NaN,-174.31626512689732,-134.5819131408441,-0.10703229196633884,-0.3858518293174882,-0.27881953735114934,-9969097,-9231377,69.30011740954292,69.57511222315426,NaN,NaN,-15.941439622965303,-10.193563639714027
2002-04-09T09:30:00-04:00,20.7,20.82001,20.02,20.08,917600,891650,32.45155035329843,41.64402546544131,NaN,NaN,-167.82439337587348,-146.9491119916965,-0.13889337559524323,-0.4524362568452034,-0.31354288124996016,-10886697,-9611057,63.19522734635705,69.43480331942375,NaN,NaN,-18.82322160092572,-11.426371919887126
2002-04-10T09:30:00-04:00,20.14999,20.34,19.7,20.14,1225300,907120,33.394844275833094,40.960598156985505,NaN,NaN,-174.49037193727946,-154.5504877555134,-0.14489469487560735,-0.49466124984446935,-0.349766554968862,-9661397,-9597297,63.32133539022115,69.28743277048106,NaN,NaN,-20.919686740059962,-12.782559751340388
2002-04-11T09:30:00-04:00,19.95,20,19.39,19.47,704600,913260,28.593080099028356,39.596882492185046,NaN,NaN,-188.8892557077808,-167.24777943887702,-0.18062966604389086,-0.5755536375237256,-0.3949239714798347,-10365997,-10004697,57.084760948346904,68.5130514299706,NaN,NaN,-24.354637959485373,-14.435713781075385
2002-04-12T09:30:00-04:00,19.7,19.89999,19.53999,19.8,913700,940990,33.65324761766843,38.80654899983811,NaN,NaN,-146.40363466392822,-170.38478416235185,-0.16889847257688118,-0.6060470622009362,-0.437148589624055,-9452297,-10067097,56.17219204479728,67.60509294695093,NaN,NaN,-25.720562841215962,-16.047835075381183
2002-04-15T09:30:00-04:00,20.10001,20.10001,19.74001,19.85001,650400,953170,34.41178675286747,38.3676452459324,NaN,NaN,-114.94403938897236,-158.51033901476686,-0.14551472914396585,-0.6190420010540123,-0.47352727191004645,-8801897,-9833657,58.82413156223179,67.06740710919091,NaN,NaN,-26.60310419146973,-17.55573066339383
2002-04-16T09:30:00-04:00,20.5,20.78999,20.35001,20.75,1652300,1003660,46.30855334947235,38.64396028835092,NaN,NaN,-39.61842993673886,-132.86914632693993,-0.06147781221632215,-0.5503745371804492,-0.488896724964127,-7149597,-9086237,65.93193563160006,66.9943669171583,NaN,NaN,-23.539033169185405,-18.4104881642212
2002-04-17T09:30:00-04:00,21,21.06,20.66,20.83,1085200,1029050,47.22491948667837,38.992181675289736,NaN,NaN,-11.310130042491759,-100.23309794798239,0.003980258976689688,-0.4839214012432649,-0.48790166021995457,-6064397,-8366837,71.1025545889027,67.21996350269187,NaN,NaN,-20.816017471591806,-18.754135208131284
2002-04-18T09:30:00-04:00,20.7,20.87,20.25999,20.61,1156100,1032735,44.95276571035424,38.946520226936435,NaN,NaN,-35.227723527512296,-69.5007915119287,0.03520767837838468,-0.44389206224697375,-0.47909974062535843,-7220497,-7737737,74.71638798808306,67.65417171288523,NaN,NaN,-19.231726385256746,-18.82236251914921
2002-04-19T09:30:00-04:00,20.85001,20.85001,20.50999,20.55,226000,965730,44.32637975702495,38.65035190372949,NaN,NaN,-23.413336361364777,-44.902731851416,0.05347357625933025,-0.4122577703011956,-0.46573134656052584,-7446497,-7336577,76.7160133557511,68.06174130373354,NaN,NaN,-18.121319296241296,-18.722213487305222
2002-04-22T09:30:00-04:00,20.10001,20.24001,19.84,20.03999,498000,946515,39.31194229257009,38.4529798945209,NaN,NaN,-85.2689817349324,-38.96772032060802,0.0338174510161095,-0.42345953279038895,-0.45727698380649845,-7944497,-7165097,77.5339447513553,68.3151805881552,NaN,NaN,-18.6333491285213,-18.70951857890752
2002-04-23T09:30:00-04:00,20.03,20.14999,19.56,19.63,348500,906260,35.80533630713613,38.210355378343216,NaN,NaN,-106.06874206033817,-52.25778274532787,-0.002271091160593597,-0.46011584775724046,-0.45784475659664686,-8292997,-7393777,73.81023748873267,68.37666473977235,NaN,NaN,-20.161129889408883,-18.916891623264856
2002-04-24T09:30:00-04:00,19.67999,19.87,19.31,19.33,749200,843650,33.45385610445143,37.71438511121005,NaN,NaN,-124.2793194177006,-74.85162062036963,-0.039742851788548306,-0.5075233213323322,-0.46778046954378394,-9042197,-7989337,65.0482738094034,67.64980677619788,NaN,NaN,-22.176397970070074,-19.382535387094173
2002-04-25T09:30:00-04:00,19.3,19.57001,19.14,19.46001,711400,838585,35.43285406260924,37.567655195383104,NaN,NaN,-122.01765290640648,-92.20960649614847,-0.048584439716468864,-0.52851101918937,-0.4799265794729012,-8330797,-8211397,62.08871473380836,66.77470193208094,NaN,NaN,-23.24548167803752,-19.934384857228938
2002-04-26T09:30:00-04:00,19.60001,19.69,18.8,18.8,1957100,869445,30.4776418988817,37.128482719133835,NaN,NaN,-140.14188792435584,-115.5553168087467,-0.0893241964089081,-0.5915818249840363,-0.5022576285751282,-10287897,-8779677,55.17077121774504,65.76546291838109,NaN,NaN,-25.79975781818814,-20.77229528022311
2002-04-29T09:30:00-04:00,18.75999,19.06,18.55,18.67999,960800,899670,29.665267932922262,36.929462546249816,NaN,NaN,-159.82497289158036,-130.46651504007627,-0.11325633557407133,-0.6438280480427174,-0.5305717124686461,-11248697,-9440517,48.41516410509945,64.70974411543413,NaN,NaN,-28.11533091480059,-21.821300370877033
2002-04-30T09:30:00-04:00,18.8,19.28999,18.64999,19.05,1531200,953530,35.38394755612558,37.071541351985,NaN,NaN,-122.76934911569414,-133.80663645114748,-0.09386915768766912,-0.6479081595782326,-0.5540390018905634,-9717497,-9725417,45.81078686740536,63.45899064951872,NaN,NaN,-28.350801403506654,-22.754086232681264
2002-05-01T09:30:00-04:00,18.95,19.10001,18.38,18.89,454300,939150,34.09307517216361,37.46439814292323,NaN,NaN,-130.81226486079893,-135.11322553976714,-0.08195663221043092,-0.6564847921536021,-0.5745281599431712,-10171797,-9951337,43.798771358215,62.50999139308072,NaN,NaN,-28.928104082648826,-23.63608878267663
2002-05-02T09:30:00-04:00,18.88,19.17999,18.35001,18.41,463900,892285,30.498397265347222,37.239051689186,NaN,NaN,-132.10610018329714,-137.13091499514528,-0.09558840500392829,-0.6940136661980816,-0.5984252611941533,-10635697,-10412317,39.94376856637787,61.350818287479335,NaN,NaN,-30.54661026654842,-24.623306137515456
2002-05-03T09:30:00-04:00,18.34,19.08,17.82001,17.97,830000,893220,27.623222365762757,36.75415423296423,NaN,NaN,-151.30701625091345,-139.3639406604568,-0.12174567715969853,-0.7506073576437764,-0.6288616804840779,-11465697,-10647877,38.098438367420854,59.87041163070712,NaN,NaN,-32.85469749324911,-25.79921918833455
2002-05-06T09:30:00-04:00,17.75,18.08,17.44,17.46001,672700,885415,24.714916578830298,35.2117516064898,NaN,NaN,-182.894913923756,-143.97792886689194,-0.15857159749298033,-0.8270761773503033,-0.6685045798573229,-12138397,-10825817,36.71847850889785,57.78373612194268,NaN,NaN,-35.802623808079986,-27.228276991155326
2002-05-07T09:30:00-04:00,17.64,17.75,17.27,17.46001,748700,876970,24.714916578830284,33.60389425592923,NaN,NaN,-167.4437029495814,-152.9127996336694,-0.16724615710525126,-0.877562276238887,-0.7103161191336358,-12138397,-11309997,33.19515939046994,55.076065036340346,NaN,NaN,-38.12029954987964,-28.78428021383023
2002-05-08T09:30:00-04:00,18.5,19.3,18.39,19.27,3023900,966900,47.47652915752309,33.78416307358414,NaN,NaN,-33.58830766752121,-133.46800819501385,-0.041930733295382994,-0.7627295357528645,-0.7207988024574815,-9114497,-11098537,36.079925713435706,52.31631773100838,NaN,NaN,-31.85172818098867,-29.222487066281435
2002-05-09T09:30:00-04:00,19.2,19.24001,18.61,18.64,1937900,1028565,42.64373413441118,33.6639741005403,NaN,NaN,-43.0391920514401,-115.65462656864244,0.005178881800544377,-0.714325200206801,-0.7195040820073454,-11052397,-11181877,35.430558059718265,49.367356638434615,NaN,NaN,-28.63808625033769,-29.13900123543233
2002-05-10T09:30:00-04:00,18.64999,18.71001,17.89,18,847700,1025265,38.37063907501636,33.59673815642932,NaN,NaN,-87.42559139261003,-102.87834159698177,0.000151066867202454,-0.7193152484233423,-0.7194663152905447,-11900097,-11268757,34.72883423488007,46.30984874440067,NaN,NaN,-27.650024425150583,-28.926290262534938
2002-05-13T09:30:00-04:00,18.05,18.75,18,18.71001,1016800,1043585,44.959886599822084,34.25063460590689,NaN,NaN,-58.35061915904635,-77.96948264403984,0.04886222724679945,-0.6583885312320454,-0.7072507584788449,-10883297,-11017737,38.51771900011697,43.78895456664241,NaN,NaN,-24.368509540731527,-28.275178730848737
2002-05-14T09:30:00-04:00,19.53999,19.67,19.25,19.61,2082800,1065110,51.96990989252137,35.57320987648331,NaN,NaN,35.12866303587296,-37.45500944694897,0.14071512960948285,-0.5313568464669913,-0.6720719760764742,-8800497,-10350157,47.28221344641009,42.519950255000026,NaN,NaN,-18.964935738808638,-26.94514401770015
2002-05-15T09:30:00-04:00,19.25,20.10001,19.2,19.55,2931800,1157440,51.499000673659474,36.720791777272616,NaN,NaN,55.99697438437399,-19.537953036569924,0.19320832179871594,-0.43056157382807925,-0.6237698956267952,-11732297,-10873717,42.20120856216682,41.09941409988277,NaN,NaN,-15.110759403079616,-25.254517644182933
2002-05-16T09:30:00-04:00,19.55,19.85001,19.45,19.84,735900,1136430,53.68350229677911,38.37835323426528,NaN,NaN,75.69523857560834,4.208933088839764,0.24017565178886147,-0.3235503308907184,-0.5637259826795799,-10996397,-10862517,42.34394438670401,40.18321218337984,NaN,NaN,-11.321921448158069,-23.264146759036525
2002-05-17T09:30:00-04:00,20.05,20.13,19.69,19.94,929300,1171595,54.44544131490011,40.148365618692274,NaN,NaN,109.06831505167192,43.50771437769615,0.2685446083401172,-0.22804522225443336,-0.49658983059455053,-10067097,-10495917,46.96103494841008,40.07934581504488,NaN,NaN,-8.099208751003635,-21.097727043603253
2002-05-20T09:30:00-04:00,19.64999,19.77,19.34,19.42,1072500,1200320,49.852804298070396,41.18185538597405,NaN,NaN,67.1031670944769,68.5984716284008,0.2435902981000047,-0.19210195796954466,-0.43569225606954937,-11139597,-10547177,46.401501155773936,40.1215396927855,NaN,NaN,-6.800820253000636,-19.05531178780288
2002-05-21T09:30:00-04:00,19.7,19.7,18.91,18.94,2520500,1308920,45.99587185463666,42.03205514900784,NaN,NaN,32.53895172099342,68.0805293654249,0.18851965844632612,-0.20004268301164174,-0.38856234145796786,-13660097,-11519097,37.32152609711014,39.65887931699229,NaN,NaN,-6.92557767769795,-17.32249262921646
2002-05-22T09:30:00-04:00,18.89999,19.17,18.73,19.17,931400,1318030,48.06911135790212,43.28710615561891,NaN,NaN,15.77103126423814,60.035340741397725,0.16234044777237522,-0.18563678174249887,-0.3479772295148741,-12728697,-11718377,35.77570679407802,39.36116061897087,NaN,NaN,-6.3968580153558445,-15.761687684379229
2002-05-23T09:30:00-04:00,19.24001,19.44,18.86,19.32001,389500,1301935,49.432657090430794,44.84492292166662,NaN,NaN,42.197909555514315,53.33587493737891,0.1501674008982058,-0.16026797839211682,-0.3104353792903226,-12339197,-11986937,33.74709906590212,39.050350668862386,NaN,NaN,-5.565297880126193,-14.305060569485939
2002-05-24T09:30:00-04:00,19.00999,19.14,18.8,18.89999,453100,1226735,45.8060443234262,46.351432046280614,NaN,NaN,7.991704358518818,33.12055279874831,0.11069103259303353,-0.1720715885490307,-0.28276262114206424,-12792297,-12531977,30.025940292265844,38.572312224817246,NaN,NaN,-5.9232888175064575,-13.107664604917442
2002-05-28T09:30:00-04:00,18.94,19.00999,18.52,18.73,953100,1226350,44.38673036913533,47.756561602730976,NaN,NaN,-18.559302556026648,15.98805886864759,0.07187493105686704,-0.1929189573209804,-0.26479388837784745,-13745397,-13053137,26.964273898283793,38.12724897537537,NaN,NaN,-6.629686987585711,-12.18223923101291
2002-05-29T09:30:00-04:00,18.53,18.63,18.37,18.38,1000100,1199795,41.533212714652194,47.332038999668775,NaN,NaN,-53.475709716693075,-1.214873418889691,0.023855840952611118,-0.23497408718708357,-0.2588299281396947,-14745497,-13270217,25.78487763822679,37.391888398574736,NaN,NaN,-8.065297968072006,-11.594104764878495
2002-05-30T09:30:00-04:00,18.24001,18.58,18.13,18.47,498500,1202005,42.5558748516302,47.32576333661299,NaN,NaN,-57.43905980471623,-15.856891632680567,0.0006111357491429548,-0.258066008453266,-0.25867714420240895,-14246997,-13573877,24.190923152397204,36.58905733376609,NaN,NaN,-8.972587513991355,-11.219602300466047
2002-05-31T09:30:00-04:00,18.62,18.77,18.25999,18.25999,813400,1219480,40.76410190861413,47.496724967584264,NaN,NaN,-50.304368164168544,-34.35734717661713,-0.02503426932521491,-0.28996998085892756,-0.26493571153371265,-15060397,-14118117,21.612238971319286,35.65215767208318,NaN,NaN,-10.24212941300368,-11.079963316542852
2002-06-03T09:30:00-04:00,18.27,18.42,17.64,17.72,704200,1213190,36.507737561458526,46.893000036272575,NaN,NaN,-107.19510769560883,-57.39470958744266,-0.07184150660118904,-0.35473759478519895,-0.2828960881840099,-15764597,-14712577,19.20422322610274,34.27262225965359,NaN,NaN,-12.624412752333761,-11.300598950227267
2002-06-04T09:30:00-04:00,17.55,18.14999,17.55,17.97,1539500,1256530,39.64955103737275,46.01297440376196,NaN,NaN,-115.68027838791676,-76.81890475382069,-0.07887980004011902,-0.38149583823415867,-0.30261603819403965,-14225097,-14808517,18.83939513014596,32.240992379920435,NaN,NaN,-13.765519585467198,-11.652730469547256
2002-06-05T09:30:00-04:00,17.89999,18.19,17.75,18.19,687300,1253460,42.35291370612698,45.35968247750964,NaN,NaN,-105.6081073208158,-87.24538427464523,-0.06235747785665552,-0.38056288551485906,-0.31820540765820354,-13537797,-14566977,22.814958708095688,30.856260247486784,NaN,NaN,-13.979669600701348,-11.985150345426412
2002-06-06T09:30:00-04:00,17.95,18.03,17.59,17.75,814500,1142990,38.62624351051004,44.284163992776136,NaN,NaN,-120.46486199910593,-99.85054471352318,-0.07391147849075808,-0.41059475577165117,-0.3366832772808931,-14352297,-14588037,22.71050252304879,29.45387154293999,NaN,NaN,-15.247881835541971,-12.451254844014349
2002-06-07T09:30:00-04:00,17.14999,17.57001,16.89,17.36,1571800,1124685,35.633352100043766,42.9404433345721,NaN,NaN,-153.7759753288933,-120.54486614646812,-0.09909815213170897,-0.4605559674455293,-0.3614578153138203,-15924097,-14760777,21.827742754700765,27.658636386246467,NaN,NaN,-17.23485186728292,-13.13462584733843
2002-06-10T09:30:00-04:00,17.25999,17.52,17.14,17.2,691500,1116875,34.4538826016135,41.840520356253755,NaN,NaN,-137.42843201769227,-126.59153101088482,-0.1166052666410588,-0.5072143986151438,-0.39060913197408503,-16615597,-14930977,20.963126938108687,25.841609656413233,NaN,NaN,-19.23270863512957,-14.005780531308593
2002-06-11T09:30:00-04:00,17.39999,17.53999,16.82001,16.82001,948800,1113475,31.764749273647595,40.82401160046883,NaN,NaN,-138.17301048639766,-131.090077430581,-0.14215471126654183,-0.5683025210572623,-0.4261478097907205,-17564397,-15598837,17.957288286562246,24.458449812802666,NaN,NaN,-21.76715605647921,-15.114548463475824
2002-06-12T09:30:00-04:00,16.67999,17.2,16.56,17.16,1031600,1060915,36.53751276430905,40.00032598664075,NaN,NaN,-130.54217304455392,-136.0768905753286,-0.12513414755990737,-0.5825654942406047,-0.4574313466806973,-16532797,-16197837,15.772823197821836,23.02967241307008,NaN,NaN,-22.564664352673482,-16.178850733361205
2002-06-13T09:30:00-04:00,17.38,17.38,16.81,16.87,676400,948145,34.331679366907565,38.92168472067481,NaN,NaN,-112.86134076340502,-134.55618632818843,-0.12224305741762498,-0.6102351684527285,-0.48799211103510354,-17209197,-16769217,14.020727591032369,21.620645879150818,NaN,NaN,-23.89042922326804,-17.280504803347895
2002-06-14T09:30:00-04:00,16.5,16.91,16.11,16.84,882800,955490,34.10231521982408,38.08570407041751,NaN,NaN,-130.92209708447822,-129.9854106793054,-0.11148839404697353,-0.6273526035938204,-0.5158642095468469,-18091997,-17202797,12.853886496922556,20.394070608054868,NaN,NaN,-25.039130679863376,-18.388879928564393
2002-06-17T09:30:00-04:00,16.95,17.47,16.95,17.41,403900,929220,42.027201424975196,37.91716628869178,NaN,NaN,-69.71876708980265,-116.4434776937275,-0.05782406965222242,-0.5881442966121249,-0.5303202269599024,-17688097,-17417297,12.308157598804385,19.347205158092056,NaN,NaN,-23.748170888112934,-19.154492922785614
2002-06-18T09:30:00-04:00,17.2,17.60001,17.2,17.22,348300,893010,40.287953422455374,37.82821919639201,NaN,NaN,-58.13023614155624,-100.4349228247592,-0.02844760533678725,-0.5658797336308865,-0.5374321282940993,-18036397,-17511697,12.065377662775248,18.367240874131227,NaN,NaN,-23.164421710979518,-19.7273398925276
2002-06-19T09:30:00-04:00,17,17.08,16.46001,16.53999,581500,796060,34.74578684890405,37.27035576762586,NaN,NaN,-109.36455577031273,-96.19939936991096,-0.047040719587119306,-0.5962330277779984,-0.549192308190879,-18617897,-17928717,11.03029192692182,17.427195786597274,NaN,NaN,-24.34357285427969,-20.38680174420647
2002-06-20T09:30:00-04:00,16.60001,16.67999,16.02,16.16,476500,773315,32.08930851204032,36.650727667870584,NaN,NaN,-132.9372664660808,-100.21458451044613,-0.07547176377076403,-0.643532012904334,-0.56806024913357,-19094397,-18305757,10.179945154427728,16.610603371105018,NaN,NaN,-26.17632307583379,-21.213876220153228
2002-06-21T09:30:00-04:00,15.8,16.24001,15.58,15.7,701800,788930,29.180791901228886,36.12737440642561,NaN,NaN,-159.61185031732845,-105.95253515701617,-0.11351266539410554,-0.709951080876202,-0.5964384154820964,-19796197,-18646597,9.469266587821508,15.9152493255135,NaN,NaN,-28.67717240853081,-22.280061389921453
2002-06-24T09:30:00-04:00,15.5,16.19,15.27,15.97,902600,811405,33.018372428827064,35.65371879152949,NaN,NaN,-151.3524820147946,-122.27927814201458,-0.10873705965148683,-0.732359740046455,-0.6236226803949682,-18893597,-18887697,8.99110761232788,15.211800217097922,NaN,NaN,-29.558169283348825,-23.319791088982505
2002-06-25T09:30:00-04:00,16.17999,16.2,15.39,15.42,638300,795665,29.510335248664347,34.736391758853586,NaN,NaN,-149.00254089395537,-140.45373909249437,-0.12945789230610805,-0.7854450457776032,-0.6559871534714952,-19531897,-19186797,8.422882286662258,14.183794758424108,NaN,NaN,-31.44928249134725,-24.48114700360604
2002-06-26T09:30:00-04:00,14.6,15.63,14.5,15.43,1229800,807150,29.656672007216955,34.09570808004693,NaN,NaN,-170.12717859300741,-152.60626365703334,-0.12904022585162345,-0.8172874357860245,-0.688247209934401,-18302097,-19123637,9.72038266105541,13.255929053996011,NaN,NaN,-32.900862149693154,-25.683963453047056
2002-06-27T09:30:00-04:00,15.62,15.84,15.14,15.84,564600,810455,35.56317787587673,34.090695635463575,NaN,NaN,-115.12806830309692,-149.04442402443655,-0.08957407813810081,-0.800214807607027,-0.7106407294689262,-17737497,-18852257,15.274980237530997,12.787874588483882,NaN,NaN,-32.357497363145576,-26.637325440203988
2002-06-28T09:30:00-04:00,15.95,16.17,15.72,15.82,454000,792485,35.40699707483205,34.158775240693465,NaN,NaN,-78.97419432722174,-132.91689282641522,-0.054939417542611335,-0.7793150013971903,-0.724375583854579,-18191497,-18531317,21.431588974080015,12.821336162481833,NaN,NaN,-31.964160392802704,-27.398301862003805
2002-07-01T09:30:00-04:00,15.78,15.88,15.13,15.15,584500,786500,30.564456657397784,34.07304005381848,NaN,NaN,-111.79810712129374,-125.00601784771504,-0.06650490904652462,-0.8075067201627348,-0.7410018111162102,-18775997,-18507797,21.879603881098873,13.101501562091594,NaN,NaN,-33.08792217490458,-28.211104763846773
2002-07-02T09:30:00-04:00,14.9,15.15,14.61,14.7,1413700,780210,27.813047773094652,33.44986398301745,NaN,NaN,-140.59981393833078,-123.32547245659012,-0.09223001448479473,-0.8562893292222036,-0.7640593147374088,-20189697,-18639357,21.15301620465452,13.485801062579641,NaN,NaN,-34.92015729202117,-29.169540839300257
2002-07-03T09:30:00-04:00,14.52,15.24,14.52,15.24,518700,771780,35.33566866883166,33.52157750458346,NaN,NaN,-113.09596110781348,-111.9192289595513,-0.062091841045307405,-0.8416741160440431,-0.7795822749987357,-19670997,-18913137,19.687779319169962,13.890590471732326,NaN,NaN,-34.08106012964144,-29.871186452206143
2002-07-05T09:30:00-04:00,15.45,16.10001,15.45,16.06,2239700,843040,44.75107520225426,34.28220321761419,NaN,NaN,-34.034290884417025,-95.70047347581534,0.01949092622511117,-0.7552186172173467,-0.7747095434424579,-17431297,-18851897,21.00587960630628,14.472875693831162,NaN,NaN,-30.082186617190054,-29.90132933291813
2002-07-08T09:30:00-04:00,16.17,16.2,15.47,15.58,1090100,818955,40.98879208364154,34.208031121804645,NaN,NaN,-39.84825139795612,-87.87528488996222,0.046034078065469775,-0.7171669458606207,-0.7632010239260905,-18521397,-18917877,20.61334575042028,15.066103418946582,NaN,NaN,-28.050183526896426,-29.636879932057887
2002-07-09T09:30:00-04:00,15.56,15.76,15.31,15.35,397600,804260,39.284513220703275,34.13635682167949,NaN,NaN,-60.88622132886889,-77.69290773147723,0.05253752434762937,-0.6975291184915537,-0.7500666428391831,-18918997,-18946477,20.435086883273016,15.66393979183928,NaN,NaN,-26.981780948286787,-29.257580077233445
2002-07-10T09:30:00-04:00,15.45,15.56,14.94,14.94,907900,802215,36.3805847355326,34.253128099295814,NaN,NaN,-88.23071123605463,-67.21908719102203,0.034532626886559115,-0.7069008592309842,-0.7414334861175433,-19826897,-18873917,22.271617649313484,16.466891629152972,NaN,NaN,-27.03062800680142,-28.939444067171728
2002-07-11T09:30:00-04:00,14.85,15.49,14.68,15.49,1277900,814530,42.51895028047786,34.99810251132707,NaN,NaN,-76.80079551648792,-59.96005407275692,0.06329647127239324,-0.6623128970270518,-0.725609368299445,-18548997,-18649517,27.820443401493947,17.72692721822913,NaN,NaN,-25.050564284585512,-28.383889812516554
2002-07-12T09:30:00-04:00,15.85,15.85,15.29,15.42,1111100,836265,41.96399254486995,35.91118827158714,NaN,NaN,-38.13506962155424,-60.78020982018436,0.08015499170552576,-0.6254156286675379,-0.7055706203730636,-19660097,-19095277,24.134691229799245,18.774457549798967,NaN,NaN,-23.657525502653307,-27.708694911107518
2002-07-15T09:30:00-04:00,15.1,15.72,14.76,15.72,548700,819560,45.26144542846633,36.7856934858471,NaN,NaN,-48.58300159721117,-62.527159860035376,0.11209758040381868,-0.5654486448682903,-0.677546225272109,-19111397,-19213277,23.256338376780306,19.793402604402708,NaN,NaN,-21.48384469795076,-26.81943059494227
2002-07-16T09:30:00-04:00,15.5,16.03999,15.41,15.54,1004900,849610,43.65861720575784,37.79628505421091,NaN,NaN,-2.6286923407485547,-50.87565406241131,0.1209321158883363,-0.5263810804116886,-0.6473131963000249,-20116297,-19452737,21.54290511931336,20.730547092449218,NaN,NaN,-20.160875302864984,-25.8682084103598
2002-07-17T09:30:00-04:00,16.3,16.3,15.45,15.65,1817000,923045,44.94179106841071,38.888079272867614,NaN,NaN,40.327790812333305,-25.163953652733717,0.13305134410032426,-0.4809990161746196,-0.6140503602749439,-18299297,-19147217,28.755153278412635,22.090173565117592,NaN,NaN,-18.703243529701517,-24.844641998837186
2002-07-18T09:30:00-04:00,15.51,15.82,15.3,15.32,369300,912435,41.861586077306626,39.33796557296974,NaN,NaN,-14.770459081840338,-12.757886365804199,0.118211021103378,-0.4662865838957213,-0.5844976049990993,-18668597,-19171137,28.53399296248746,23.03724590261448,NaN,NaN,-18.32058660479946,-23.912634085403226
2002-07-19T09:30:00-04:00,15.07,15.36,14.64,14.84,1419600,959590,37.80306135433704,39.50911302150582,NaN,NaN,-130.75776930700968,-31.28242630289529,0.07740885155456478,-0.4877365405558933,-0.5651453921104581,-20088197,-19256757,27.712385899070526,23.485874254399516,NaN,NaN,-19.188894521160307,-23.237814147654237
2002-07-22T09:30:00-04:00,14.51,14.88,13.95,14.06,1157600,982380,32.31958104979972,39.63447904953453,NaN,NaN,-231.02483385799883,-67.77079275505282,0.003151487125534702,-0.5612060332035398,-0.5643575203290745,-21245797,-19683637,24.001665282203305,23.637450068764117,NaN,NaN,-21.752636122757814,-23.02564585838332
2002-07-23T09:30:00-04:00,14.18,14.21,13.35,13.36,1009300,987715,28.345782171417696,39.672531506557604,NaN,NaN,-271.08334703271856,-121.46172369344681,-0.08308402134296444,-0.66821254700778,-0.5851285256648155,-22255097,-20111397,20.971338061717503,23.624473058554333,NaN,NaN,-25.341047283499467,-23.35641749054277
2002-07-24T09:30:00-04:00,12.9,14.05,12.9,14.05,894300,1000515,36.618334812508564,39.76415051682024,NaN,NaN,-211.08953913003634,-171.74518968192075,-0.08341067259148804,-0.6893918664041756,-0.6059811938126876,-21360797,-20723697,17.55475689027182,23.472114313633035,NaN,NaN,-25.594500483996256,-23.676143632464697
2002-07-25T09:30:00-04:00,13.85,13.9,12.95,13.21,1236900,1000870,31.804403270105908,38.839388235952505,NaN,NaN,-195.16335114667845,-207.82376809488838,-0.12732510871340064,-0.7651375797044384,-0.6378124709910378,-22597697,-21509517,14.328433987991005,22.995153912324803,NaN,NaN,-27.52750873693955,-24.226338647389674
2002-07-26T09:30:00-04:00,13.35,13.5,13.05,13.39,1156000,1030440,33.81236793105248,38.32678651076757,NaN,NaN,-162.6669915133823,-214.20561253616287,-0.13087323987956323,-0.8014040208404918,-0.6705307809609286,-21441697,-21780217,13.413864343202874,22.480905240380704,NaN,NaN,-28.358686523224367,-24.816674058223203
2002-07-29T09:30:00-04:00,13.8,14.25,13.66,14.18,1010900,1058285,41.89826325885385,38.51348294206404,NaN,NaN,-80.62080996300041,-184.1248077571632,-0.06970749271060772,-0.7576651468491882,-0.6879576541385805,-20430797,-21617217,16.855277203219245,22.22520454894829,NaN,NaN,-26.27516203622209,-25.025029483651615
2002-07-30T09:30:00-04:00,14.03,14.53,13.96,14.4,766800,1067400,43.95175774497907,39.05428101416736,NaN,NaN,-49.38611800006271,-139.78536195063205,-0.007403940755368543,-0.6972125800827911,-0.6898086393274225,-19663997,-21098997,26.814485162687845,22.549695085617888,NaN,NaN,-23.95211651046599,-24.871756201767955
2002-07-31T09:30:00-04:00,14.22,14.38,14.03,14.32,359200,1014675,43.35174155995941,39.113766105558895,NaN,NaN,-49.28692501022993,-107.42483912667076,0.033218285985084806,-0.6482857818460666,-0.6815040678311514,-20023197,-20831477,31.383725626535536,22.80421524454943,NaN,NaN,-22.30153189045776,-24.504581300152214
2002-08-01T09:30:00-04:00,14.17,14.35,13.64,13.69,1067300,1042105,38.85341333363698,38.891581876185114,NaN,NaN,-71.24100133724266,-82.6403691647836,0.022946167574355525,-0.652821358363207,-0.6757675259375625,-21090497,-20530037,36.21608643152552,23.667172044672732,NaN,NaN,-22.28913495081989,-24.18808896453331
2002-08-02T09:30:00-04:00,13.55,13.7,13.2,13.4,942300,977235,36.95263223898119,38.29809521979331,NaN,NaN,-98.15195718383924,-69.737362298875,0.0029586477717103987,-0.6720692162229245,-0.6750278639946349,-22032797,-20648257,35.169972454022115,24.518145907332865,NaN,NaN,-22.86879649233971,-23.999618611362795
2002-08-05T09:30:00-04:00,13.27,13.36,12.76,12.82,443200,944890,33.430097771477875,37.56748668877332,NaN,NaN,-122.13258124785358,-78.03971655584563,-0.040584384452787337,-0.725758344560619,-0.6851739601078317,-22475997,-21057297,31.752429687062147,25.247397662172066,NaN,NaN,-24.487200286639197,-24.06927313640228
2002-08-06T09:30:00-04:00,13.15,13.78,13.15,13.36,434700,946745,39.237671468588694,37.16004957450031,NaN,NaN,-79.06106969233244,-83.97470689429957,-0.025040674319206202,-0.7164748030068395,-0.6914341286876333,-22041297,-21532757,28.30894253905477,25.215525466503646,NaN,NaN,-24.015918080766806,-24.06165098559721
2002-08-07T09:30:00-04:00,13.92,14,13.11,13.6,681100,935405,41.67316718672322,37.14659108231579,NaN,NaN,-62.60106082485342,-86.63753405722426,0.00763440787071179,-0.6818911188492436,-0.6895255267199554,-21360197,-21800157,26.564128390213497,25.07482085419836,NaN,NaN,-22.879001699344798,-23.892701087561154
2002-08-08T09:30:00-04:00,13.59,14.18,13.37,14.1,397100,891365,46.485624288539555,37.76677414904454,NaN,NaN,-32.01522699650921,-78.79237918907758,0.06590941260707905,-0.6071387609611065,-0.6730481735681856,-20963097,-21774677,27.02567790713647,25.02577028334593,NaN,NaN,-20.403645588540737,-23.394264587701095
2002-08-09T09:30:00-04:00,13.88,14.21,13.79,14.05,196600,845640,46.07621288398927,38.749390708629505,NaN,NaN,-14.739550865594053,-62.10989792542854,0.10192514481633619,-0.5456417425477653,-0.6475668873641015,-21159697,-21600057,30.26062613307603,25.472838915551126,NaN,NaN,-18.53895545081536,-22.70064899671742
2002-08-12T09:30:00-04:00,13.8,14.09,13.73,13.92,188900,827650,44.967303284111274,39.93664221667905,NaN,NaN,-19.64814956616894,-41.61301158909161,0.11676347091599681,-0.5016125487191054,-0.6183760196351022,-21348597,-21374577,34.31006478873161,26.425605110337848,NaN,NaN,-17.310045706841,-21.93056281244936
2002-08-13T09:30:00-04:00,13.95,14.3,13.6,13.61,698500,812330,42.349876511990516,40.346038052356334,NaN,NaN,-21.500457456544055,-30.10088914193393,0.10579705251116156,-0.4861297039961503,-0.5919267565073119,-22047097,-21375737,34.29903078123152,27.62162467397783,NaN,NaN,-16.99303122480421,-21.22520115707148
2002-08-14T09:30:00-04:00,13.74,14.52,13.62,14.45,896400,766300,50.72030983119558,41.69717423529131,NaN,NaN,44.40506872851862,-8.699663231259525,0.1523807784529133,-0.40145078344117024,-0.5538315618940836,-21150697,-21333837,35.110785774789804,29.106078373034887,NaN,NaN,-14.12335084869534,-20.210651113017747
2002-08-15T09:30:00-04:00,14.72,14.8,14.3,14.65,357900,765730,52.48910013261761,43.03122653540311,NaN,NaN,128.73374899497588,23.45013196703749,0.19140321258884652,-0.31457754615802536,-0.5059807587468719,-20792797,-21299777,35.80512049806583,30.705453812667958,NaN,NaN,-11.2305571033069,-18.927780540201912
2002-08-16T09:30:00-04:00,14.35,15.14,14.35,15,1860500,787775,55.49931702167662,44.002730375604735,NaN,NaN,177.24012681995603,61.846067504147506,0.23277715796280862,-0.2150093112933611,-0.4477864692561697,-18932297,-20854297,44.21318757030955,32.65959026746012,NaN,NaN,-7.867734482582417,-17.347773960541986
2002-08-19T09:30:00-04:00,15.04,15.62,15,15.55,1219300,790860,59.808707369739906,45.13536963451622,NaN,NaN,233.28025477706447,112.43174837279419,0.28568908097527485,-0.09067511803707617,-0.376364199012351,-17712997,-20127177,54.653277614996234,34.64807544262501,NaN,NaN,-3.59045770752041,-15.38244306725319
2002-08-20T09:30:00-04:00,15.4,15.42,15.05,15.11,667200,773755,55.20309624181154,45.98189496893423,NaN,NaN,166.90028969254826,150.11189780261265,0.27922842402267267,-0.027328668984010207,-0.3065570930066829,-18380197,-19393797,62.31386325352732,36.857370987410135,NaN,NaN,-1.3464305533161742,-13.377298422405046
2002-08-21T09:30:00-04:00,15.36,15.64,15.11,15.58,640100,761045,58.84844407841647,47.4101114507042,NaN,NaN,165.5238561691323,174.3356552907354,0.293330518512792,0.06010605513430711,-0.23322446337848488,-17740097,-18711677,67.76793240025731,39.11107427089102,NaN,NaN,1.706388293438128,-11.22248603442745
2002-08-22T09:30:00-04:00,15.7,15.84,15.43,15.76,783000,738350,60.184731725821656,49.06954712833566,NaN,NaN,163.34927165572876,181.25875982288596,0.30040601005125966,0.14228304918558976,-0.15812296086566993,-16957097,-17944537,72.57503724732871,41.78286461327006,NaN,NaN,4.606932370040103,-8.961140548074942
2002-08-23T09:30:00-04:00,15.51,15.56,15.05,15.19,951000,728100,54.184403293149906,50.5519975227408,NaN,NaN,102.60789127263325,166.3323127134214,0.2541585201033681,0.1595751892635402,-0.09458333083982791,-17908097,-17739697,73.7028299157269,44.77932177246039,NaN,NaN,5.301432748590904,-6.923630077122679
2002-08-26T09:30:00-04:00,15.15,15.36,14.88,15.29,642400,709675,55.03145008981199,51.680124567113886,NaN,NaN,81.49779735682571,135.97582122937365,0.21909214432060176,0.1792818495609243,-0.03981029475967747,-17265697,-17650237,74.20179653705702,48.057382772317695,NaN,NaN,6.112553928383063,-5.0613180763361445
2002-08-27T09:30:00-04:00,15.32,15.37,14.72,14.78,1136800,728175,49.95852420559691,52.27193578274773,NaN,NaN,53.76910911966022,113.34958511479606,0.1534439814018656,0.15199468199265453,-0.001449299409211069,-18402497,-17654697,74.12628290665802,51.45467952349231,NaN,NaN,5.284038210774913,-3.5834100353202794
2002-08-28T09:30:00-04:00,14.6,14.65,14.29,14.37,1118900,766160,46.26612183015034,52.25625703571993,NaN,NaN,3.027375201286452,80.85028892122688,0.07810116846224405,0.09617716116859398,0.018075992706349943,-19521397,-18010957,68.15932342684741,54.39279706061451,NaN,NaN,3.4433813085079827,-2.579582700487671
2002-08-29T09:30:00-04:00,14.1,14.69,14.06,14.57,666300,746110,48.27445302986459,52.41327418899674,NaN,NaN,0.7369443606986351,48.32782346222085,0.0393822980261125,0.06730386523899057,0.02792156721287807,-18855097,-18390557,62.395897384045874,56.68817357854093,NaN,NaN,2.5050181628499133,-1.8532111485823015
2002-08-30T09:30:00-04:00,14.35,14.49,14.19,14.2,1605200,779255,44.92888976023601,52.41053036586278,NaN,NaN,-19.4935941982525,23.907526368043683,-0.010817516203831791,0.014399671958088334,0.025217188161920125,-20460297,-18900997,55.589023858745335,58.20809922639906,NaN,NaN,0.6991475224102743,-1.4885884812976478
2002-09-03T09:30:00-04:00,13.85,13.96,13.5,13.5,1459900,830090,39.36988516468708,52.1976738410554,NaN,NaN,-96.19058321159862,-11.630149745641164,-0.0866169801199453,-0.0830540369880115,0.0035629431319337997,-21920197,-19831897,45.78028538154781,59.02818884070736,NaN,NaN,-2.685576913361613,-1.659586828735357
2002-09-04T09:30:00-04:00,13.52,13.94,13.5,13.92,919200,854315,43.85829856428837,51.70753017913346,NaN,NaN,-85.5253659804253,-39.489044765658264,-0.10281507426627018,-0.12495589970090393,-0.02214082543463375,-21000997,-20351597,41.38944106366061,59.47666421848385,NaN,NaN,-4.157329730786552,-2.016407243314099
2002-09-05T09:30:00-04:00,13.55,13.63,13.36,13.45,392900,839905,40.265971333655955,50.834449550636194,NaN,NaN,-119.58557938601743,-64.01163568311904,-0.1373704380961876,-0.19385387305486823,-0.05648343495868065,-21393897,-20726097,38.52219873538217,59.67074123543501,NaN,NaN,-6.550449036779169,-2.664127499523395
2002-09-06T09:30:00-04:00,13.67,14.02,13.62,13.9,2943900,967245,44.91790881723285,50.07863467889022,NaN,NaN,-77.10269239933496,-79.57956303512576,-0.12259498792451783,-0.20972716986432793,-0.08713218193981011,-18449997,-20645077,39.49868193170028,59.33399083267721,NaN,NaN,-7.1158619496644855,-3.300089563829265
2002-09-09T09:30:00-04:00,13.68,14.11,13.57,14.05,699200,992375,46.41590730117168,49.12200610256391,NaN,NaN,-68.68388962935859,-89.41762212134697,-0.09654037311601174,-0.2078076483348248,-0.11126727521881305,-17750797,-20103177,45.70992448112365,58.69517989454345,NaN,NaN,-7.121877812184192,-3.8460593135942545
2002-09-10T09:30:00-04:00,14.17,14.33,14.04,14.29,290000,997430,48.814479227725585,48.665676315843484,NaN,NaN,-36.10667441072822,-77.4008403611729,-0.058818397606307665,-0.18479027222669764,-0.12597187462038997,-17460797,-19211297,54.067913303896816,58.10618346956984,NaN,NaN,-6.416878841439446,-4.213319246143567
2002-09-11T09:30:00-04:00,14.7,14.7,14.31,14.37,718500,998430,49.6239559298322,48.00678430523032,NaN,NaN,-12.45725451881124,-62.78721806885007,-0.025837761917202495,-0.15826907701689308,-0.13243131509969058,-16742297,-18359557,60.34632867172161,57.57606891753158,NaN,NaN,-5.608676255865163,-4.412655961818081
2002-09-12T09:30:00-04:00,14.15,14.25,13.84,13.84,340400,970630,44.59254225388096,46.893056485805985,NaN,NaN,-68.89382034827034,-52.64886626130067,-0.03642769103629334,-0.17796592889505725,-0.1415382378587639,-17082697,-17497317,65.4890870772759,57.069929619670674,NaN,NaN,-6.3668817781367775,-4.691831078435038
2002-09-13T09:30:00-04:00,13.75,14.04,13.72,13.9,246800,965075,45.269079113406555,46.256247615824314,NaN,NaN,-72.30645531817379,-51.68961884506844,-0.03603621676274468,-0.18658350881219476,-0.15054729204945008,-16835897,-17174497,67.20403180337179,56.605729754502455,NaN,NaN,-6.79785699372154,-4.992691923475967
2002-09-16T09:30:00-04:00,13.8,13.87,13.56,13.67,200800,882090,43.096733780553755,45.40376787944872,NaN,NaN,-86.04220938573839,-55.161282796344395,-0.04720732199586794,-0.20955644454428501,-0.16234912254841707,-17036697,-17031677,67.96254811566166,56.1600691529742,NaN,NaN,-7.774883891395811,-5.390147918893088
2002-09-17T09:30:00-04:00,13.87,14.02,13.46,13.5,378600,840055,41.51111995246618,44.80038186136796,NaN,NaN,-83.5358770876675,-64.64712333173225,-0.06110336539874159,-0.23872832929684407,-0.17762496389810248,-17415297,-17022577,68.01331152660964,55.723428340113614,NaN,NaN,-9.042760618255256,-5.911949733087683
2002-09-18T09:30:00-04:00,13.27,13.55,13.14,13.36,605500,836970,40.19941371288948,44.3670455672779,NaN,NaN,-110.41926110419521,-84.23952464880904,-0.07392509685407303,-0.27003133496569376,-0.19610623811162073,-18020797,-17278277,64.90144326803886,55.490722614484426,NaN,NaN,-10.476741420158962,-6.564062831240722
2002-09-19T09:30:00-04:00,13.05,13.12,12.76,12.76,1149700,862450,35.08288586265782,43.424790769620266,NaN,NaN,-152.86076000040268,-101.0329125792355,-0.11458896915065592,-0.33934244954994064,-0.22475348039928472,-19170497,-17695837,60.068137276330546,55.32445403536191,NaN,NaN,-13.30218908862234,-7.526652296580953
2002-09-20T09:30:00-04:00,13,13,12.73,12.83,1491300,897865,36.10466318607356,42.794488871465816,NaN,NaN,-149.75220857574016,-116.52206323074878,-0.12755308235748958,-0.3841948333461467,-0.2566417509886571,-17679197,-17864497,58.18333231054618,55.50976178191911,NaN,NaN,-15.354860331188172,-8.644967730096269
2002-09-23T09:30:00-04:00,12.54,12.63,12.3,12.43,898500,895240,32.91638757635887,42.3335247580138,NaN,NaN,-187.27432848965614,-136.76848705153233,-0.1521795056821681,-0.44686613309136725,-0.29468662740919915,-18577697,-18172697,54.799534949563416,56.15399389392023,NaN,NaN,-18.10279376078411,-9.996085734480246
2002-09-24T09:30:00-04:00,12.26,12.56,12.16,12.23,1327800,929510,31.422269908095842,41.44523699685719,NaN,NaN,-180.7547814207696,-156.21226791815275,-0.16971430060857218,-0.5068295031699144,-0.3371152025613422,-19905497,-18670737,49.763034412555676,56.75210770455559,NaN,NaN,-20.865078387163496,-11.548798970577852
2002-09-25T09:30:00-04:00,12.51,12.88,12.31,12.7,1345100,939925,38.488408386903096,41.318268214946265,NaN,NaN,-123.05442390055943,-158.73930047742562,-0.13874034933909807,-0.5105406392352148,-0.3718002898961167,-18560397,-18778657,48.718157195688896,57.48039045172036,NaN,NaN,-21.258381477835155,-12.935882185900324
2002-09-26T09:30:00-04:00,12.9,12.95,12.47,12.55,1616900,964825,37.17199294261064,40.76498850961611,NaN,NaN,-103.81203548310258,-148.9295555739656,-0.11823649567872369,-0.5195959094945213,-0.4013594138157976,-20177297,-18980017,46.7459247031577,57.9980506496816,NaN,NaN,-21.963748001745433,-14.225577302449626
2002-09-27T09:30:00-04:00,12.45,12.72,12.23,12.24,1092800,986150,34.54250060963379,39.91688803164912,NaN,NaN,-117.13000038134952,-142.40511393508746,-0.11531128357051534,-0.5454985182789418,-0.43018723470842646,-21270097,-19698197,40.45537904064911,57.622725975361995,NaN,NaN,-23.337812698843653,-15.5273252162202
2002-09-30T09:30:00-04:00,12.14,12.14,11.72,11.83,1585300,985155,31.380759146103813,38.67162231153327,NaN,NaN,-148.0544131603969,-134.5611308692356,-0.12967631652615424,-0.5922826303661193,-0.46260631383996503,-22855397,-20553737,34.499462668943806,56.22497950143678,NaN,NaN,-25.492681024460506,-16.950947474540243
2002-10-01T09:30:00-04:00,11.94,12.5,11.79,12.47,1078400,966080,40.53120982919507,38.02214044720205,NaN,NaN,-96.67952649454654,-117.746079883991,-0.08682139579074549,-0.5711330585783969,-0.4843116627876514,-21776997,-20928037,32.26165310926726,54.21893124697574,NaN,NaN,-24.531636509102732,-18.033903050906314
2002-10-02T09:30:00-04:00,12.38,12.65,12.1,12.19,2538900,1047065,38.13521687333447,37.560902920020155,NaN,NaN,-81.27809890816006,-109.39081488551115,-0.06886300956493363,-0.5703904247438185,-0.5015274151788849,-24315897,-22079137,26.556583947478856,51.43803816627595,NaN,NaN,-24.47724145475617,-18.954379965742007
2002-10-03T09:30:00-04:00,12.2,12.47,12.11,12.16,522200,1053530,37.87686128510148,37.03288736085551,NaN,NaN,-79.10763112105688,-104.44993401310198,-0.05133932844172584,-0.5657015757310422,-0.5143622472893163,-24838097,-23011297,23.008281922436282,48.28119888906628,NaN,NaN,-24.50958748583594,-19.74798104004114
2002-10-04T09:30:00-04:00,12.34,12.34,11.8,11.9,1139100,963290,35.62430907509163,36.49914273903678,NaN,NaN,-92.54586798741771,-99.53310753431563,-0.04956778233984804,-0.5763219752141264,-0.5267541928742784,-25977197,-23952717,20.08895133901912,44.861656262163244,NaN,NaN,-25.196187697091815,-20.526296276762665
2002-10-07T09:30:00-04:00,11.86,12.04,11.62,11.69,687400,962700,33.87214714540626,35.95350182424679,NaN,NaN,-106.52132338879517,-91.22648957999529,-0.05445837848040491,-0.5948271659747846,-0.5403687874943797,-26664597,-24714557,18.08875429647253,41.2956164600106,NaN,NaN,-26.284491690299173,-21.348895621553595
2002-10-08T09:30:00-04:00,11.81,11.91,11.42,11.69,1186100,1007505,33.87214714540626,35.5015542122837,NaN,NaN,-110.66263033972652,-94.02311034903128,-0.04974247211830107,-0.602546877642256,-0.5528044055239549,-26664597,-25692077,15.90105327089519,37.79558860307177,NaN,NaN,-27.172292189597364,-22.18080941698842
2002-10-09T09:30:00-04:00,11.5,11.82,11.4,11.58,982500,1020705,32.88943360182998,35.344879050796,NaN,NaN,-115.06358187216702,-100.78020694183267,-0.04615918156469334,-0.6105033824798216,-0.5643442009151283,-27647097,-26358317,14.60459494202523,34.54819272204996,NaN,NaN,-28.19012081725671,-23.039282474169603
2002-10-10T09:30:00-04:00,11.61,12.27,11.46,12.19,1492300,1078300,42.80007003237801,35.823122396960606,NaN,NaN,-68.30803406146192,-98.62028752991367,0.002580289391183044,-0.5611188391761495,-0.5636991285673325,-26154797,-26621657,14.114730331324623,31.40043543781985,NaN,NaN,-26.221526439962368,-23.49388875499714
2002-10-11T09:30:00-04:00,12.5,13.05,12.48,12.96,2498300,1190875,52.3631768160685,37.212178771225574,NaN,NaN,49.77628635346236,-70.15585666173766,0.08727272100631178,-0.4546082273094427,-0.5418809483157545,-23656497,-26157517,19.255368721857124,28.861566421555118,NaN,NaN,-21.223342098132427,-23.16952494687361
2002-10-14T09:30:00-04:00,12.66,13,12.66,12.98,738000,1217735,52.58491678336236,38.72379640517318,NaN,NaN,69.36147102179616,-34.97929777961939,0.14199789457731726,-0.364383580094108,-0.5063814746714252,-22918497,-25408297,26.865080482829967,27.225998283717566,NaN,NaN,-17.213956489461648,-22.318729452957616
2002-10-15T09:30:00-04:00,13.55,13.84,13.44,13.8,2732000,1335405,60.668597639600755,40.308095637508735,NaN,NaN,194.47878038730295,26.0489843657865,0.22580187647004396,-0.22412912908387028,-0.44993100555391424,-20186497,-24112677,37.78464031417747,26.44503279218103,NaN,NaN,-10.726940466630385,-20.662759597768012
2002-10-16T09:30:00-04:00,13.2,13.37,12.98,13.05,1105300,1360395,51.94546674377587,41.36334376616339,NaN,NaN,112.73984030508278,71.60966880123645,0.2227303685131305,-0.1715180449125011,-0.3942484134256316,-21291797,-22841617,46.26156712536281,26.410435822338545,NaN,NaN,-8.090367096277015,-18.866703526126443
2002-10-17T09:30:00-04:00,13.8,13.85,13.45,13.6,1575100,1381665,56.845718902722346,42.956430787098284,NaN,NaN,169.1689524084427,119.10506609521738,0.24782331549831504,-0.08446926905273777,-0.3322925845510528,-19716697,-21553997,53.215760136541384,27.321891614902274,NaN,NaN,-4.155012546072947,-16.7650333861188
2002-10-18T09:30:00-04:00,13.6,13.81,13.3,13.78,623600,1338280,58.342877576966025,44.882296389302724,NaN,NaN,148.1335781099685,138.77652444651864,0.2650764083818893,-0.000947074073691212,-0.2660234824555805,-19093097,-20641317,57.42172207853841,28.959195858444748,NaN,NaN,-0.5728878442552763,-14.451869737281156
2002-10-21T09:30:00-04:00,13.56,14.17,13.52,14.06,1472300,1366970,60.630946627385796,46.317991874887774,NaN,NaN,153.28140899450776,155.56051204106092,0.2822888005870684,0.08683751827825503,-0.19545128230881337,-17620797,-19581777,61.72379831263193,31.063634801542218,NaN,NaN,3.0844024849309353,-11.946687991250856
2002-10-22T09:30:00-04:00,13.79,14.25,13.63,14,2701300,1435645,59.87205126275628,47.87062290270362,NaN,NaN,135.18508921939085,143.7017738074785,0.2762319813783097,0.14983869441407371,-0.12639328696423596,-20322097,-19608897,61.55236635873503,33.56333354520337,NaN,NaN,5.746161811999624,-9.41913801935793
2002-10-23T09:30:00-04:00,13.96,14.38,13.78,14.38,751400,1405960,63.028318611403115,49.66715556886802,NaN,NaN,132.8924506494561,147.73229587635316,0.28335816324439966,0.22780441709126364,-0.05555374615313603,-19570697,-19264677,62.95860043477206,36.41692772465593,NaN,NaN,8.997350954369452,-6.788211023111161
2002-10-24T09:30:00-04:00,14.5,14.63,14.08,14.15,1502500,1400240,59.95450474656013,51.40502668825864,NaN,NaN,122.71779908294832,138.4420652112543,0.25879902305788294,0.26794503266921765,0.009146009611334702,-21073197,-19535977,61.06292499672323,39.34364012877764,NaN,NaN,10.767745181543097,-4.280217279589125
2002-10-25T09:30:00-04:00,14.096,14.54,14.096,14.53,686700,1379935,63.151907186106,53.496438119737185,NaN,NaN,114.37969341525144,131.69128827231089,0.25400648717168683,0.3266541185759433,0.07264763140425642,-20386497,-19794657,59.231621675834496,42.282416370160654,NaN,NaN,13.263977640179766,-1.7739037196221403
2002-10-28T09:30:00-05:00,14.75,14.85,14.42,14.5,610100,1331175,62.726098759351245,55.5574346635904,NaN,NaN,115.14245865710014,124.06349820482937,0.23511033423887712,0.3665355492028528,0.1314252149639757,-20996597,-20469817,54.62675933197479,45.048538231666335,NaN,NaN,15.151677618328296,0.6440364715136364
2002-10-29T09:30:00-05:00,14.44,14.6,13.91,14.26,1158800,1335195,59.282376957746735,57.44264490329874,NaN,NaN,81.63982358505348,113.35444507796187,0.19442730152349977,0.3744593418683504,0.18003204034485062,-22155397,-20836477,52.251017243036536,47.73756839602429,NaN,NaN,15.770221771302944,2.804920085769252
2002-10-30T09:30:00-05:00,14.26,14.82,14.2,14.75,854300,1250965,63.6680658658034,58.93321603425769,NaN,NaN,95.81985520640549,105.93992598935176,0.18836510188099365,0.4154884176960927,0.22712331581509904,-21301097,-21182557,50.03894332099303,50.30358360957202,NaN,NaN,17.63114639060483,4.922952415031477
2002-10-31T09:30:00-05:00,14.82,15.05,14.64,14.76,2117200,1330715,63.75386949515256,59.74683693990655,NaN,NaN,102.77729702703569,101.95182557816923,0.1732585594121347,0.4436965150802674,0.2704379556681327,-19183897,-20804697,52.40801295051095,52.67162962590445,NaN,NaN,19.158544317294,6.95660840106898
2002-11-01T09:30:00-05:00,14.6,15.23,14.44,15.2,641100,1305815,67.40181181199344,60.80518658480884,NaN,NaN,106.25963198029643,100.32781329117822,0.18032181213444126,0.4958402208361843,0.315518408701743,-18542797,-20435957,54.66710377056173,54.65748843217101,NaN,NaN,21.59454600748055,9.04774234484206
2002-11-04T09:30:00-05:00,15.85,16.14999,15.64,15.79,3035900,1423240,71.53829483828976,61.58159352757234,NaN,NaN,163.482466625918,109.99581488494182,0.21007205529053335,0.5781084778149097,0.36803642252437635,-15506897,-19338017,60.65569620593735,56.29113528158242,NaN,NaN,25.08819278339449,11.339235264635263
2002-11-05T09:30:00-05:00,15.55,15.82,15.41,15.69,1427900,1435330,69.91885520188262,62.86540698886568,NaN,NaN,138.53936591402177,121.37572335073548,0.20796952288288684,0.6279983261279849,0.42002880324509806,-16934797,-18293897,65.34428975431295,57.65418689793599,NaN,NaN,27.43567860689949,13.63872717067301
2002-11-06T09:30:00-05:00,15.85,15.98,15.5,15.94,809600,1426685,71.6468865924132,63.922633252415025,NaN,NaN,143.1550911107589,130.84277053160616,0.20787468379140056,0.6798721579843487,0.4719974741929482,-16125197,-17258717,69.25603640513062,58.799920917120936,NaN,NaN,29.933794551165605,15.966593939314809
2002-11-07T09:30:00-05:00,15.69,15.69,15.26,15.31,724600,1388300,61.98370726189712,64.18269251562438,NaN,NaN,102.13307821333999,130.71392676886703,0.1524098669842614,0.662509807923275,0.5100999409390136,-16849797,-16791897,70.85374280007507,59.75935096865927,NaN,NaN,29.13851265032078,17.84829661231566
2002-11-08T09:30:00-05:00,15.39,15.6,15.11,15.2,1447000,1335735,60.450642654042696,64.16981366038559,NaN,NaN,82.02140265814877,125.86628090443749,0.09798559045694943,0.6325819290102004,0.534596338553251,-18296797,-16742697,71.02465226121095,60.42369767927206,NaN,NaN,28.027279501590613,19.302437025069224
2002-11-11T09:30:00-05:00,15.16,15.16,14.6,14.67,861100,1341890,53.575004768613496,63.72002462508967,NaN,NaN,27.93626641225856,98.7570408617056,0.02003976714131772,0.5596460474798981,0.5396062803385804,-19157897,-17472897,64.93844668923643,60.665560560022165,NaN,NaN,24.851479607320623,20.095157393962282
2002-11-12T09:30:00-05:00,14.78,15.32,14.78,15.08,330800,1221830,57.59327785761217,63.33180742839033,NaN,NaN,48.445433138885335,80.73825430667833,-0.008619927849914055,0.5288313705261878,0.5374512983761018,-18827097,-17851357,61.97422001782243,60.595247673097184,NaN,NaN,23.40249965926891,20.56763486043466
2002-11-13T09:30:00-05:00,15,15.3,14.8,15.15,1646600,1248895,58.257577618305795,63.21059834780073,NaN,NaN,44.02193167969158,60.91162242046486,-0.026564003007851777,0.5042462946162871,0.5308102976241389,-17180497,-18062417,60.320562649217294,60.54222179113248,NaN,NaN,22.440295924266657,20.835157869553516
2002-11-14T09:30:00-05:00,15.5,15.76,15.35,15.76,1539500,1247115,63.6076103977052,63.24314857720068,NaN,NaN,99.04414534526344,60.29383584684956,-0.0023289939816389937,0.5278990551470901,0.5302280491287291,-15640997,-17820657,61.585003322383045,60.71032048017167,NaN,NaN,23.26822114538714,21.18273833752975
2002-11-15T09:30:00-05:00,15.54,15.84,15.4,15.79,918800,1261875,63.852983725180565,63.3236403604742,NaN,NaN,95.96293964066962,63.08214324335372,0.010063671881088698,0.54280763898009,0.5327439670990013,-14722197,-17105737,65.12427484373208,61.46014301672575,NaN,NaN,23.99951629543278,21.585135188658754
2002-11-18T09:30:00-05:00,15.99,16.02,15.6,15.61,1166100,1246565,61.18726834445238,63.459704030953176,NaN,NaN,95.13662186508073,76.52221433391814,0.0009594959052240393,0.5339433369805313,0.5329838410753073,-15888297,-16451817,68.02603451434942,62.586929964676685,NaN,NaN,23.82721392448548,21.905432150919715
2002-11-19T09:30:00-05:00,15.55,15.63,15.25,15.36,850900,1154045,57.59109899590666,63.0256349688177,NaN,NaN,46.784797992706025,76.1900873046823,-0.02561065147593833,0.5009705267303843,0.5265811782063227,-16739197,-16034237,69.75652658893203,63.995328769529465,NaN,NaN,22.626147938376835,22.008391549127875
2002-11-20T09:30:00-05:00,15.32,16.10001,15.32,16,1290200,1180985,63.50456686198002,63.007827637876794,NaN,NaN,91.67536313636545,85.72077359601705,-0.0048791876780994725,0.5204821936086983,0.5253613812867978,-15448997,-15687937,71.15097281332227,65.33411161687313,NaN,NaN,23.36348501361106,22.201976329768332
2002-11-21T09:30:00-05:00,16.45,16.85001,16.31,16.83,3673400,1289530,69.45338985813575,63.15436892688696,NaN,NaN,187.79932535240644,103.47180959744564,0.05654970881387844,0.5960485173041459,0.5394988084902674,-11775597,-14914857,74.02971903538072,66.7171555643602,NaN,NaN,26.065542015332333,22.753914284848904
2002-11-22T09:30:00-05:00,16.55,16.88,16.5,16.77,1297600,1320075,68.58309296522462,62.943283078810886,NaN,NaN,174.55552210767337,119.19032609084641,0.08334015439476394,0.6436740014837223,0.5603338470889584,-13073197,-14585057,75.16811361014211,67.75375680751769,NaN,NaN,27.895551050882357,23.488433822853683
2002-11-25T09:30:00-05:00,16.8,17.12,16.75999,17.02,1887600,1383950,70.25554416810097,62.967332290683615,NaN,NaN,179.86370187358006,136.13574209254628,0.10660901729005345,0.6935951187015252,0.5869861014114718,-11185597,-13644517,78.11446558832674,68.66591222423295,NaN,NaN,29.92898869534406,24.408513090352308
2002-11-26T09:30:00-05:00,16.85001,16.99001,16.53,16.53,1734200,1412720,63.1587191533315,62.36103461646349,NaN,NaN,133.67274835576504,153.5133321651581,0.07898277339919768,0.6857145681604688,0.6067317947612711,-12919797,-12880637,80.17216856348742,69.44563594982988,NaN,NaN,29.422858782484624,25.124848189228352
2002-11-27T09:30:00-05:00,16.95,17.25999,16.78999,17.2,1231800,1431595,67.92914777252061,62.78570893865088,NaN,NaN,159.8386320701816,167.14598595192132,0.09475314824315917,0.72517323006522,0.6304200818220609,-11687997,-12128437,81.96986885290886,70.23964495360372,NaN,NaN,30.565287555703197,25.902053813010472
2002-11-29T09:30:00-05:00,17.3,17.3,17.05,17.10001,434800,1347475,66.54430639030994,63.22097063409854,NaN,NaN,141.3027116768054,157.84666321680112,0.08754204931485976,0.7398476434656356,0.6523055941507758,-12122797,-12197877,81.23761727940945,70.9691424549036,NaN,NaN,31.02838913756803,26.63438743080441
2002-12-02T09:30:00-05:00,17.60001,17.8,16.95,17.14999,1781600,1404500,66.9074665927054,64.17328933581939,NaN,NaN,131.67724289542892,149.27100737435222,0.07567583457724614,0.7469003873723334,0.6712245527950873,-10341197,-11651477,82.55796660765347,72.2276795919334,NaN,NaN,31.50650522281057,27.330404258233862
2002-12-03T09:30:00-05:00,16.85001,16.89999,16.53,16.55,3024700,1403940,58.67360723969561,64.25045572025392,NaN,NaN,60.12965081387899,125.32419716241199,0.019861882533256825,0.6960519059616583,0.6761900234284015,-13365897,-12087537,77.84952623067272,73.36163003570842,NaN,NaN,29.338001275349562,27.617203832107535
2002-12-04T09:30:00-05:00,16.13,16.49001,16.02,16.3,1771100,1421100,55.60311060080508,64.06085093328959,NaN,NaN,19.994562463338784,102.58855998392673,-0.038281525339279865,0.6283381167543016,0.6666196420935815,-15136997,-12530977,73.2730059187358,74.28680455495974,NaN,NaN,26.587311199318076,27.47007631313761
2002-12-05T09:30:00-05:00,16.53999,16.53999,15.93,15.94,975900,1429415,51.42938099822441,63.19097740475525,NaN,NaN,5.664820305440699,71.75379763097855,-0.10176970915812455,0.5394075056459258,0.6411772148040503,-16112897,-13415957,65.05370753265856,74.534569141408,NaN,NaN,22.94545924841924,26.823702446749273
2002-12-06T09:30:00-05:00,15.8,16.24001,15.6,16.09,993800,1442875,53.012032601608965,62.41662375307156,NaN,NaN,-13.163803550396379,40.860494585538206,-0.13250077718949127,0.47555124331718623,0.6080520205066775,-15119097,-14015217,60.134648517191245,74.1781672609408,NaN,NaN,20.426061837371563,25.909753788266745
2002-12-09T09:30:00-05:00,15.8,15.86,15.29,15.33,1130100,1427030,45.0095713913583,61.2610739707077,NaN,NaN,-64.12574208163366,1.6998975901256856,-0.1988614242898773,0.35947524014433085,0.5583366644342082,-16249197,-15196817,51.81499373725737,73.02023577686279,NaN,NaN,15.502440670400173,24.422994771428662
2002-12-10T09:30:00-05:00,15.35,15.72,15.35,15.58,3302900,1549120,47.80097485709734,60.561779389364176,NaN,NaN,-65.6914116425123,-23.464314901152573,-0.21916618064697269,0.28437893862549224,0.5035451192724649,-12946297,-15112897,52.319539595557764,71.77473670590749,NaN,NaN,12.335172470816822,22.6961630141984
2002-12-11T09:30:00-05:00,15.49,15.88,15.35,15.7,734100,1569285,49.13564807206797,59.535428047227605,NaN,NaN,-61.330635696217314,-39.72935453306379,-0.21733636029463116,0.23187466890417596,0.4492110291988071,-12212197,-14527937,55.79420736457099,70.67782488813953,NaN,NaN,10.168426492719652,20.906486368272866
2002-12-12T09:30:00-05:00,15.85,15.89,15.54,15.63,663500,1520130,48.35888194043289,58.0286774816774,NaN,NaN,-62.7406875448126,-53.41045610311445,-0.2133589408829495,0.18251235309512026,0.39587129397806975,-12875697,-13880497,59.327141809526786,69.62764080057853,NaN,NaN,8.177088222187523,19.0880009188321
2002-12-13T09:30:00-05:00,15.51,15.54,15.25,15.28,533800,1469845,44.56533505081484,56.31312334493384,NaN,NaN,-98.43288534974953,-70.46427246298508,-0.225626608569314,0.11383803326642727,0.33946464183574127,-13409497,-13538577,61.09548308724788,68.62245290608608,NaN,NaN,5.328367229571481,17.12233896322344
2002-12-16T09:30:00-05:00,15.31,15.86,15.31,15.8,1592600,1503535,50.74720758319979,54.91967073172662,NaN,NaN,-63.152199133843695,-70.26956387342709,-0.19139767451574968,0.10021754869105415,0.29161522320680383,-11816897,-12652117,65.30686182415012,67.70762406578775,NaN,NaN,4.6657215031849155,15.342822183217939
2002-12-17T09:30:00-05:00,15.83,16.00999,15.67,15.72,2565900,1573525,49.82660697018739,53.967377004359186,NaN,NaN,-46.96635359170523,-66.52455226326568,-0.16767427283879316,0.08202238215831237,0.24969665499710553,-14382797,-12939417,62.929265600093686,66.47598813983106,NaN,NaN,3.8588138784985118,13.70224956825802
2002-12-18T09:30:00-05:00,15.48,15.57,15.2,15.29,805300,1571245,45.09162678687345,52.33612550538438,NaN,NaN,-98.5047468418302,-73.95937449238825,-0.17373317399784294,0.032530187499801855,0.2062633614976448,-15188097,-13534597,58.20195390689205,64.7782799294013,NaN,NaN,1.7275097557412196,11.991572452184192
2002-12-19T09:30:00-05:00,15.37,15.61,15.07,15.23,2437500,1628610,44.45678950104943,50.75844572758006,NaN,NaN,-97.53585435278866,-80.91840785398345,-0.17413291932611424,-0.011402787659998026,0.16273013166611622,-17625597,-14484577,51.54603997414293,62.657452979025116,NaN,NaN,-0.1922640158633376,10.25102438532026
2002-12-20T09:30:00-05:00,15.4,15.48,15.25,15.35,1769300,1533405,46.091491222423834,49.27159034398852,NaN,NaN,-83.02783227563367,-77.8373972391603,-0.159080596471273,-0.03612061392297505,0.12295998254829796,-15856297,-14973937,48.470999764001384,60.22266963304997,NaN,NaN,-1.3449139493157816,8.59446176608654
2002-12-23T09:30:00-05:00,15.3,15.63,15.26,15.54,1070900,1522070,48.667554540175175,48.556872294022774,NaN,NaN,-64.39437733168282,-78.08583287872811,-0.13030247094710698,-0.039918106135585774,0.0903843648115212,-14785397,-15567637,44.966187013968536,57.87385968899967,NaN,NaN,-1.6184268196079008,7.135477682415907
2002-12-24T09:30:00-05:00,15.38,15.56,15.35,15.38,525300,1453955,46.64609268378325,47.91708529994979,NaN,NaN,-65.13059165424333,-81.71868049123573,-0.11646907176378496,-0.05520197489320999,0.061267096870574966,-15310697,-15753217,43.89768999579486,55.77562283736103,NaN,NaN,-2.403005407348282,5.772837241021023
2002-12-26T09:30:00-05:00,15.49,15.67,15.2,15.3,788900,1406690,45.62564732780652,47.502532894919945,NaN,NaN,-65.25072456577018,-75.06787603602372,-0.10735703748800515,-0.07292919998943148,0.03442783749857367,-16099597,-15935517,42.82125737768561,54.18759068343439,NaN,NaN,-3.3366344752213775,4.47148413870068
2002-12-27T09:30:00-05:00,15.29,15.34,15,15.03,1253800,1407790,42.26506539283279,46.73489238000736,NaN,NaN,-97.67437378487111,-75.09557992244022,-0.113562598882718,-0.10752541110482383,0.006037187777894169,-17353397,-15881077,43.26864551662383,52.982876183393856,NaN,NaN,-5.081019564319346,3.1068407525549615
2002-12-30T09:30:00-05:00,15.18,15.18,14.75,14.88,3716800,1571890,40.48116488624384,46.411434772499184,NaN,NaN,-127.2972321468993,-83.94945989669336,-0.12112667491771593,-0.14537115586925076,-0.02424448095153482,-21070197,-16923857,37.25552613723792,51.9429142119639,NaN,NaN,-7.064403574955983,1.6538058486248266
2002-12-31T09:30:00-05:00,14.97,14.98,14.72,14.8,2171100,1591365,39.52303845746713,45.820153601097026,NaN,NaN,-151.23905120837713,-101.31839467203221,-0.12440241158486257,-0.17974749543261304,-0.05534508384775047,-23241297,-18615037,29.978981143324503,50.34716003680438,NaN,NaN,-9.00250891818116,0.13147516765254275
2003-01-02T09:30:00-05:00,14.9,15.6,14.88,15.6,2072200,1543740,51.80700035268535,46.01096447828398,NaN,NaN,-36.726696681682526,-95.63761567752006,-0.06837549826662477,-0.14081445668103143,-0.07243895841440666,-21169097,-19786717,26.16591521724098,48.23085345485224,NaN,NaN,-7.168106454499655,-0.9113222069406282
2003-01-03T09:30:00-05:00,15.55,15.7,15.4,15.66,1581200,1534245,52.58487804280024,46.31282134273879,NaN,NaN,33.33340643279174,-75.92078947780767,-0.025185085830600557,-0.10392031570265736,-0.0787352298720568,-19587897,-20484377,24.192755369524846,45.72125442342353,NaN,NaN,-5.448216615325065,-1.5594499795669763
2003-01-06T09:30:00-05:00,15.76,16.46001,15.76,16.35001,1287800,1549840,60.48415662749773,47.44988002678757,NaN,NaN,206.55259168699558,-15.075396383434327,0.04795871203492322,-0.01878683982840279,-0.06674555186332601,-18300097,-20673717,23.671047898258635,43.04808048135287,NaN,NaN,-1.240198078491335,-1.5138425651275988
2003-01-07T09:30:00-05:00,16.42,16.67,16.3,16.52,1797200,1590010,62.156828510713204,48.26485295018138,NaN,NaN,255.27889223645087,61.43982849323571,0.10274662370140694,0.061687727763432676,-0.041058895937974266,-16502897,-19760257,31.361332480147126,40.62339981392408,NaN,NaN,2.7229942961540674,-0.9085801563730751
2003-01-08T09:30:00-05:00,16.25,16.35001,15.98,15.98,1516800,1609345,54.29451229136002,48.583989044550854,NaN,NaN,130.17533945346813,117.72270662560477,0.09761326517582788,0.0809576855318106,-0.01665557964401729,-18019697,-18715937,38.93605477303169,38.90959904056251,NaN,NaN,3.6745194512866335,-0.25385164099311686
2003-01-09T09:30:00-05:00,16.28999,16.59,16.23,16.45,871800,1487790,59.13911542502138,49.58738109013285,NaN,NaN,165.89191167528003,158.2464282969973,0.11942487457753329,0.1326255135778993,0.01320063900036603,-17147897,-17911697,44.056246574380545,37.899191373954544,NaN,NaN,6.123067014406971,0.6571367383497528
2003-01-10T09:30:00-05:00,16.14999,16.7,16.14999,16.53999,791900,1490680,60.013070271279574,50.69854400229214,NaN,NaN,145.2034750800091,180.62044202644074,0.13245812338478996,0.1787732932313535,0.04631516984656353,-16355997,-17265317,47.84164973646116,37.63459207126299,NaN,NaN,8.337222902948467,1.7542919047209977
2003-01-13T09:30:00-05:00,16.85001,16.89999,16.39999,16.45,1338700,1524440,58.661863633205286,51.5964277459194,NaN,NaN,138.7292459233682,167.05577287371528,0.12751823940703405,0.20571296910535608,0.07819472969832204,-17694697,-17144237,48.54401914231511,37.63980774114254,NaN,NaN,9.71665970230227,2.8917730186611794
2003-01-14T09:30:00-05:00,16.49001,16.73,16.45,16.67999,947400,1545120,61.07406919966322,52.48260736445426,NaN,NaN,122.23563565210735,140.44712155684655,0.13170183708443875,0.2428220260538705,0.11112018896943174,-16747297,-17193117,48.26147532924346,37.8751854779479,NaN,NaN,11.607070301202702,4.136815487595682
2003-01-15T09:30:00-05:00,16.75,16.78,16.3,16.35001,908000,1510890,56.02289530762602,53.152378980443025,NaN,NaN,90.01307830335386,132.4146693268237,0.10534839287353609,0.24280568006135184,0.13745728718781575,-17655297,-17120237,48.74053104282201,38.2211026955927,NaN,NaN,11.709639904857019,5.218647547204444
2003-01-16T09:30:00-05:00,16.32001,16.45,15.95,16,1295200,1447355,51.18704306180162,53.54962153287125,NaN,NaN,42.952261438035116,107.82673927937473,0.05971803539697507,0.21210483143403458,0.1523867960370595,-18950497,-17480757,46.44936056245787,38.48025292307643,NaN,NaN,10.300834488720323,5.944674253135284
2003-01-17T09:30:00-05:00,15.55,15.64,15.2,15.22,2839300,1549055,42.402858678829375,53.55946391044244,NaN,NaN,-52.4518620199151,68.2956718593899,-0.023179765866461283,0.1234120887039829,0.14659185457044419,-21789797,-18567517,40.299616671004344,38.26817943410361,NaN,NaN,5.990186529252283,5.951176006866284
2003-01-21T09:30:00-05:00,15.36,15.4,15.12,15.12,1436900,1499025,41.42143480112395,53.62662604721958,NaN,NaN,-68.51616039411637,26.846590595892984,-0.08164159640958998,0.0445398590584567,0.12618145546804668,-23226697,-19673917,35.19132060523988,38.12073618181803,NaN,NaN,2.275301837357947,5.42605112550795
2003-01-22T09:30:00-05:00,15.1,15.38,15.02,15.02,1363900,1478755,40.41408814019641,53.69027245312882,NaN,NaN,-74.73663751052904,-12.5478640366343,-0.12153669043537325,-0.02573940757616988,0.09579728285920337,-24590597,-21242577,29.48476388938353,38.08543494939368,NaN,NaN,-1.0257915386789378,4.504359316338395
2003-01-23T09:30:00-05:00,15.4,15.4,14.95,15.28,527400,1451580,44.21288235092067,53.14783545300276,NaN,NaN,-63.4364671473418,-43.237773126773426,-0.12445178128098858,-0.059767443742032356,0.06468433753895622,-24063197,-22524157,25.803338113538615,38.05953658484351,NaN,NaN,-2.6688268774640886,3.4796184315094685
2003-01-24T09:30:00-05:00,15.2,15.23,14.61,14.68,1335900,1492110,38.1658811247904,52.11790710171635,NaN,NaN,-98.60635794317737,-71.54949700301593,-0.158635248775546,-0.13360972343047628,0.025025525345069716,-25399097,-23813877,22.727868134583446,37.9549017823477,NaN,NaN,-6.114748036125402,2.108994650418773
2003-01-27T09:30:00-05:00,14.45,14.83,14.43,14.52,1685200,1536925,36.723472264583975,50.42071536150822,NaN,NaN,-114.79494955121967,-84.01811450927684,-0.1821838412326313,-0.2027042761957194,-0.020520434963088113,-27084297,-24872777,20.56103815859622,37.732758229514666,NaN,NaN,-9.36231483853047,0.47023615199745294
2003-01-28T09:30:00-05:00,14.75,14.83,14.47,14.72,596600,1504065,39.78684047215257,48.8228590730396,NaN,NaN,-100.78449498022789,-90.47178142649913,-0.174442651118661,-0.23857374886141436,-0.06413109774275336,-26487697,-25524977,19.338137159575155,36.87395856375952,NaN,NaN,-11.123664403546634,-1.1860353559374166
2003-01-29T09:30:00-05:00,14.7,15,14.47,14.93,996700,1368060,42.91202170081144,48.009824030857565,NaN,NaN,-86.35614201065215,-92.79568232652376,-0.14645967072426258,-0.24720568614808158,-0.100746015423819,-25490997,-25705057,19.002077246409172,35.45010302614363,NaN,NaN,-11.661562052056235,-2.6825391696686762
2003-01-30T09:30:00-05:00,15.09,15.09,14.44,14.47,879900,1303500,38.231172706017475,46.516399550928725,NaN,NaN,-97.87369690321175,-99.68312827769776,-0.14968046594520149,-0.28784659785532085,-0.13816613191011937,-26370897,-26166597,18.132346866988982,33.598395904187086,NaN,NaN,-13.590315318854945,-4.240792905266715
2003-01-31T09:30:00-05:00,14.29,14.54,14.13,14.45,838100,1241795,38.036901856865,44.946673235613396,NaN,NaN,-114.62384105808536,-102.88662490067934,-0.14386941965774505,-0.3180029064823007,-0.17413348682455562,-27208997,-26528577,17.45746964585912,31.42809732628694,NaN,NaN,-15.190073791619362,-5.804975889031379
2003-02-03T09:30:00-05:00,14.43,14.7,14.42,14.58,1079100,1216690,40.165244655374146,43.625486165768315,NaN,NaN,-86.1785818072683,-97.16335135188908,-0.12280145765551789,-0.327635308893953,-0.2048338512384351,-26129897,-26337697,19.166010234262927,29.32966811856893,NaN,NaN,-15.917607222145518,-7.249637508047685
2003-02-04T09:30:00-05:00,14.31,14.4,14.18,14.33,688600,1186730,37.49779905532203,41.94146686974394,NaN,NaN,-99.59529312150882,-96.92551098014526,-0.1172459967286969,-0.3513913471493062,-0.2341453504206093,-26818497,-26403857,19.019064686724263,27.24092450124613,NaN,NaN,-17.31104491356527,-8.686981423121626
2003-02-05T09:30:00-05:00,14.6,14.74,14.25,14.28,735000,1133620,36.968991757647366,40.580473759031186,NaN,NaN,-83.61216377395479,-96.37671533280579,-0.10867393728409558,-0.36998777202572875,-0.26131383474163317,-27553497,-26816357,18.087901006840056,25.051450927247423,NaN,NaN,-18.608834134852465,-10.104388953368888
2003-02-06T09:30:00-05:00,14.16,14.42,14.11,14.2,422100,1078885,36.0919768046895,39.50225474066604,NaN,NaN,-92.79222254518808,-95.36042046120106,-0.10032733387950143,-0.38672300209100996,-0.2863956682115085,-27975597,-27137297,17.37513080704649,22.974720230432325,NaN,NaN,-19.93898286858153,-11.509330941256408
2003-02-07T09:30:00-05:00,14.35,14.42,13.94,14.04,558200,1063205,34.33748035128944,38.926156288698905,NaN,NaN,-96.89889963313641,-91.81543217621126,-0.09743633151291925,-0.4081910826026576,-0.3107547510897383,-28533797,-27402257,16.786997810782182,21.295247454702174,NaN,NaN,-21.563992887099086,-12.945711219233933
2003-02-10T09:30:00-05:00,14.03,14.25,13.88,14.19,569500,1052085,37.40938009508173,38.63958095255303,NaN,NaN,-93.25055748447882,-93.22982731165338,-0.07811079241328034,-0.4083932416063387,-0.3302824491930584,-27964297,-27769137,15.980388551683959,19.92303802230532,NaN,NaN,-22.150124484426982,-14.260627399975798
2003-02-11T09:30:00-05:00,14.24,14.4,14.02,14.14,319500,1001125,36.79150529967748,38.38082503537311,NaN,NaN,-81.93892241831611,-89.69855317101484,-0.06208298324022499,-0.4078861782433396,-0.3458031950031146,-28283797,-28062197,15.34607403654121,18.913131604245155,NaN,NaN,-22.806061088446057,-15.481403641185835
2003-02-12T09:30:00-05:00,14.11,14.25,13.95,13.95,287400,968125,34.46217572594634,37.68434599073208,NaN,NaN,-97.1216423484981,-92.40044888592351,-0.057755304796628715,-0.4179973259989005,-0.3602420212022718,-28571197,-28265737,14.903601368579032,18.134578979605184,NaN,NaN,-24.00099579332102,-16.698488234348005
2003-02-13T09:30:00-05:00,14.04,14.06,13.75,13.99,628500,954150,35.38959669115829,37.48603995975835,NaN,NaN,-113.15869430243889,-96.47374323737367,-0.04617820697982866,-0.4179647799270576,-0.37178657294722894,-27942697,-28259157,14.988936019930136,17.581798114272804,NaN,NaN,-24.77577543949764,-17.852386406512238
2003-02-14T09:30:00-05:00,14.12,14.44,14.01,14.43,1283800,953580,44.665537231092536,38.05333031450897,NaN,NaN,-49.80187034395959,-87.0543373795383,-0.005031889140638068,-0.3780764343730265,-0.37304454523238845,-26658897,-27884177,19.917482424341486,17.535829847540324,NaN,NaN,-22.881772437719462,-18.57087012525613
2003-02-18T09:30:00-05:00,14.55,14.95,14.55,14.9,1037700,863500,52.50882708029339,38.96204364366188,NaN,NaN,56.272586473922026,-57.14970858785813,0.054416883593131016,-0.30502344074097465,-0.35944032433410567,-25621197,-27415557,25.713759982496327,17.99123147774898,NaN,NaN,-18.68475548203497,-18.58713946193882
2003-02-19T09:30:00-05:00,14.85,14.92,14.57,14.8,532200,818265,50.85709007224409,39.52954852733564,NaN,NaN,57.34369219385191,-29.293185665424527,0.08572078211502554,-0.25228934669032377,-0.3380101288053493,-26153397,-26989477,30.6300537609102,18.821801228784768,NaN,NaN,-15.711621714386565,-18.176351212288495
2003-02-20T09:30:00-05:00,14.8,14.89,14.55,14.57,480400,774090,47.18098351665504,40.16882072809547,NaN,NaN,45.39434075857222,-0.7899890440104699,0.08925134535171264,-0.22644594711570853,-0.3156972924674212,-26633797,-26601997,34.852553877837224,20.016101729559644,NaN,NaN,-14.235453738320114,-17.61336585886444
2003-02-21T09:30:00-05:00,14.65,14.86,14.35,14.75,458300,770635,50.2139894731083,41.038612700684276,NaN,NaN,53.458277554655226,32.53340532740835,0.10115086242719834,-0.18925871443342324,-0.2904095768606216,-26175497,-26248557,38.528133245323545,21.521149129521383,NaN,NaN,-12.078416998322968,-16.822658878787088
2003-02-24T09:30:00-05:00,14.7,14.72,14.43,14.5,691800,738430,46.2423060545788,41.47268851491318,NaN,NaN,31.509121061350417,48.79560360847036,0.08999994656936516,-0.17790964364891515,-0.2679095902182803,-26867297,-26290237,38.25403744373393,22.8845796444836,NaN,NaN,-11.394510068082111,-16.047209048686376
2003-02-25T09:30:00-05:00,14.25,14.59,14.08,14.54,441400,676240,46.965102973354966,42.148924509058396,NaN,NaN,-7.712207741503926,35.99864476538517,0.08328800976907713,-0.1637995780069339,-0.24708758777601103,-26425897,-26451177,37.154876696593284,24.17999478804567,NaN,NaN,-10.628514925484028,-15.273109888228898
2003-02-26T09:30:00-05:00,14.45,14.57,14.12,14.16,707500,681785,41.28591935233496,42.45727648010751,NaN,NaN,-38.40234148311783,16.849438029991223,0.05271694083764905,-0.1811914117289497,-0.23390835256659875,-27133397,-26647177,35.80556818635796,25.445542443725518,NaN,NaN,-11.654081554050022,-14.75610584048906
2003-02-27T09:30:00-05:00,14.21,14.49,14.15,14.3,958600,679880,43.97392367493334,43.02027268512493,NaN,NaN,-23.878139151925012,2.994942047891776,0.04185904867778106,-0.18158454171937244,-0.2234435903971535,-26174797,-26555377,36.96029930802905,26.844483050938557,NaN,NaN,-11.71293083869909,-14.321366554519065
2003-02-28T09:30:00-05:00,14.35,14.57,14.35,14.52,926600,682215,48.0024818664565,43.99634422192258,NaN,NaN,35.90944574549913,-0.5148243139394466,0.04893619032572655,-0.1622733524899953,-0.21120954281572185,-25248197,-26369917,39.33450064884508,28.45501896794305,NaN,NaN,-10.556808635519273,-13.783572566090523
2003-03-03T09:30:00-05:00,14.55,14.7,14.2,14.27,694400,675030,44.12010261107663,44.47568154449363,NaN,NaN,4.382929642433355,-5.940062597722862,0.03677783077462951,-0.16523725434743497,-0.20201508512206448,-25942597,-26184977,41.69275793228824,30.291616780843356,NaN,NaN,-10.732150314406724,-13.347655101564266
2003-03-04T09:30:00-05:00,14.23,14.29,14.07,14.11,356100,638880,41.79052720414171,44.83275453766965,NaN,NaN,-69.4360130662375,-18.284823662669574,0.01886015865182683,-0.17843988680728096,-0.1973000454591078,-26298697,-26159537,42.026606156178154,32.19736907510314,NaN,NaN,-11.577836912878482,-13.09482393175201
2003-03-05T09:30:00-05:00,14.05,14.27,14.05,14.25,388000,623850,44.54944580023371,45.55327382869018,NaN,NaN,-54.46199769086669,-21.496754904219344,0.01737424799444437,-0.17558223546605234,-0.1929564834604967,-25910697,-25914997,45.27049225449653,34.36643270981153,NaN,NaN,-11.478174235774341,-12.863873975183772
2003-03-06T09:30:00-05:00,14.06,14.22,14.01,14.07,509800,612590,41.805901564073224,46.011581319612674,NaN,NaN,-77.17569786536087,-32.156266646906516,0.005804089132199097,-0.18570137204524784,-0.19150546117744693,-26420497,-25964137,44.72887218734042,36.49071386462655,NaN,NaN,-12.199209076655658,-12.768921846822613
2003-03-07T09:30:00-05:00,13.71,14.15,13.71,14,808400,631905,40.7547670540878,45.732240592683766,NaN,NaN,-114.06233820027511,-62.150623436061366,-0.00447343996739899,-0.19709726113669568,-0.1926238211692967,-27228897,-26360277,40.520162789041244,37.962333890676526,NaN,NaN,-13.097021287121393,-12.815793195436724
2003-03-10T09:30:00-05:00,13.91,13.98,13.67,13.71,383900,623190,36.644124682726876,44.59904756428616,NaN,NaN,-150.04720749510366,-93.03665086356878,-0.027431698881271838,-0.22691344477088649,-0.19948174588961465,-27612797,-26694317,37.330401967952845,38.79209403249485,NaN,NaN,-15.120045654113563,-13.144972118104844
2003-03-11T09:30:00-05:00,13.71,13.88,13.61,13.64,348600,612145,35.7078995210685,43.51696252491648,NaN,NaN,-153.9149888143255,-109.93244601318638,-0.04303207527668523,-0.2532718399854712,-0.21023976470878597,-27961397,-27026857,34.425094009871074,39.06316833599205,NaN,NaN,-17.06573168451015,-13.705080627591316
2003-03-12T09:30:00-05:00,13.62,13.85,13.42,13.82,442000,618270,39.95609081527068,43.000898760531875,NaN,NaN,-136.14256019051905,-126.26855851311684,-0.03715038118788719,-0.25667774119364495,-0.21952736000575776,-27519397,-27348597,31.84290495309068,38.84819341279587,NaN,NaN,-17.53344394843727,-14.251989673426452
2003-03-13T09:30:00-05:00,14.15,14.59,13.95,14.56,1448600,676330,53.54592516565447,43.23889416714231,NaN,NaN,22.965551672484807,-106.24030860554771,0.017710095351746585,-0.19738974081607452,-0.2150998361678211,-26070797,-27278657,33.01907281978092,38.454689096685684,NaN,NaN,-13.38887773719151,-14.128687968250032
2003-03-14T09:30:00-05:00,14.7,14.8,14.43,14.61,1418300,715820,54.298583427818386,43.81434255094514,NaN,NaN,77.8800272665241,-67.85183551218788,0.05631909409813962,-0.14470096854514658,-0.2010200626432862,-24652497,-26763377,41.085525460504954,38.65693824074076,NaN,NaN,-9.893101403889212,-13.523604173341344
2003-03-17T09:30:00-05:00,14.5,15.29,14.4,15.28,2986700,800965,62.95911993207978,44.95677233371119,NaN,NaN,148.5438566258785,-8.133622687991425,0.1221566228538637,-0.04832428407595657,-0.17048090692982026,-21665797,-25573977,54.659019878866644,39.90723418233171,NaN,NaN,-3.521998237439595,-12.094803325355379
2003-03-18T09:30:00-05:00,15.38,15.39,15.11,15.35,1443700,821265,63.732408815855926,46.56009300967698,NaN,NaN,195.65527065526396,61.780429205926474,0.16304013672259338,0.03331926397342144,-0.12972087274917193,-20222097,-24026117,65.7258795922728,42.044399282754185,NaN,NaN,1.6722760015881133,-10.128077707220594
2003-03-19T09:30:00-05:00,15.23,15.39,15.03,15.32,1483300,868820,63.12418398612021,47.92796874619033,NaN,NaN,169.43329534379848,122.89560031278998,0.17938640831296948,0.09451213764203992,-0.08487427067092956,-21705397,-22863317,71.3777837497363,44.50279102859042,NaN,NaN,5.568323508439139,-7.885734676412062
2003-03-20T09:30:00-05:00,15.17,15.47,15,15.3,640200,876810,62.69462034658739,48.97740720905683,NaN,NaN,150.37796976241108,148.37808393077523,0.17972563196844166,0.13978276928962252,-0.03994286267881914,-22345597,-22118277,74.30186434120199,47.00045986375877,NaN,NaN,8.568550822076428,-5.535122462342278
2003-03-21T09:30:00-05:00,15.6,15.61,15.33,15.53,1645300,936160,65.59426697643264,50.51127609229654,NaN,NaN,162.78332540814063,165.35874355909854,0.1855589503062093,0.1920058252039425,0.006446874897733185,-20700297,-21327837,76.98792526146062,49.521543244413934,NaN,NaN,12.034903653311549,-3.0251187315345884
2003-03-24T09:30:00-05:00,15.08,15.2,14.86,14.9,923700,947755,53.359796610909925,51.33765247849427,NaN,NaN,74.79723267627396,150.60941876917764,0.13922395130051807,0.18047681402338078,0.04125286272286271,-21623997,-21319477,77.01528899418688,52.02073487570028,NaN,NaN,11.264783287405738,-0.9837041574002563
2003-03-25T09:30:00-05:00,14.85,15.2,14.81,15.11,652000,958285,56.286623727595405,52.17602233044868,NaN,NaN,73.09124767224843,126.09661417257453,0.11590933692474814,0.1861395338787979,0.07023019695404975,-20971997,-21469457,75.28569650064154,54.16467803613921,NaN,NaN,11.582220534013643,0.8114279413731578
2003-03-26T09:30:00-05:00,15.15,15.15,14.93,15.06,1335600,989690,55.395280855213805,53.14669227981586,NaN,NaN,66.10885222397322,105.43172554860948,0.09138887084971277,0.1844662855161907,0.09307741466647794,-22307597,-21589897,73.85137175917194,56.24485657698431,NaN,NaN,11.557877968021183,2.3466350880371616
2003-03-27T09:30:00-05:00,14.9,15.08,14.77,14.89,510700,967295,52.35931321042691,53.97558843384008,NaN,NaN,43.639986715373404,84.08412893920193,0.05953159025975495,0.16749190249117163,0.10796031223141668,-22818297,-21684437,72.6808365831373,58.542047562276885,NaN,NaN,10.60977224841877,3.527083253805962
2003-03-28T09:30:00-05:00,14.95,14.99,14.69,14.7,422700,942100,49.119166172262304,54.86666282594975,NaN,NaN,25.433881799492685,56.61424021747233,0.02333370994718774,0.13712744966540136,0.11379373971821362,-23240997,-22192577,66.57314053179701,60.630814602551474,NaN,NaN,8.822159753252791,4.283522753726937
2003-03-31T09:30:00-05:00,14.41,14.55,14.3,14.3,1219600,968360,43.07560115709712,55.39292722852324,NaN,NaN,-28.578646193727348,35.93906444347207,-0.02714211312657576,0.07986609830999392,0.10700821143656968,-24460597,-22759897,60.46395334040219,62.49073312616084,NaN,NaN,5.2838109992375415,4.426421074514167
2003-04-01T09:30:00-05:00,14.35,14.6,14.34,14.47,652600,983185,46.110339644565684,55.83251643061573,NaN,NaN,-19.888623707243184,17.34309016757373,-0.04748311731830314,0.047654314788690755,0.0951374321069939,-23807997,-23327097,55.0270292886306,64.14674200727083,NaN,NaN,3.2910807071672497,4.2642295934646075
2003-04-02T09:30:00-05:00,14.75,15.17,14.75,15.09,1559500,1041760,55.440526152549296,55.9678450725368,NaN,NaN,47.88696742719431,13.69871320821795,-0.01904371944441499,0.07133278280147515,0.09037650224589014,-22248497,-23315277,55.117602280641194,65.72520839733228,NaN,NaN,4.614405354759148,4.31425470222097
2003-04-03T09:30:00-05:00,15.3,15.31,15.04,15.05,1381300,1085335,54.781546278997695,56.002342419049604,NaN,NaN,60.496110794913044,17.06993802412588,-0.0035968044505522573,0.08588049668269981,0.08947730113325207,-23629797,-23477577,53.52363833889291,66.61364503150284,NaN,NaN,5.4344497295275165,4.4742825632647625
2003-04-04T09:30:00-05:00,15.12,15.15,14.76,14.88,399100,1064870,51.95506376531935,55.216338407138146,NaN,NaN,26.995396738703008,17.38224101196795,-0.005391177279858481,0.08273832953342897,0.08812950681328745,-24028897,-23635157,51.95268448189371,66.4203353602905,NaN,NaN,5.228808670744049,4.582072007190375
2003-04-07T09:30:00-04:00,15.5,15.5,14.92,14.92,777200,1084535,52.57509594596006,54.419387487859865,NaN,NaN,51.83199285075613,33.46436882086464,-0.0044839943234498,0.0825245139089752,0.087008508232425,-23251697,-23393377,54.17509036997746,65.5952789872694,NaN,NaN,5.246056108260768,4.67692687877186
2003-04-08T09:30:00-04:00,15,15,14.71,14.77,1112600,1122735,49.970751394723145,53.47985658847437,NaN,NaN,-11.650485436898656,35.11199647493355,-0.01404622076328578,0.06945073227831777,0.08349695304160355,-24364297,-23504637,52.961101716335904,64.27980169916938,NaN,NaN,4.50027658741053,4.651691122863098
2003-04-09T09:30:00-04:00,14.7,14.93,14.41,14.45,1274100,1164340,44.864896806871634,52.206304907066105,NaN,NaN,-89.84910836763623,7.564781315967457,-0.04048619114634164,0.03288921410867651,0.07337540525501815,-25638397,-24182617,46.171402158693894,62.270482971847365,NaN,NaN,2.288494645749334,4.31409162613256
2003-04-10T09:30:00-04:00,14.45,14.58,14.33,14.54,533700,1118595,46.51998557901572,50.84385623582203,NaN,NaN,-126.17702448211773,-29.7698457394387,-0.04986125913493333,0.011048831336351483,0.06091009047128482,-25104697,-24477597,43.55507139166457,59.88242198114765,NaN,NaN,0.9452003116697628,3.832821438352161
2003-04-11T09:30:00-04:00,14.79,14.85,14.36,14.41,643800,1079870,44.44460532240133,50.207056858071425,NaN,NaN,-107.13625439083972,-56.59617596534724,-0.061975162493666414,-0.0165588626457982,0.04541629984786821,-25748497,-24821517,40.66200799659423,57.285759052748176,NaN,NaN,-0.7874568823784244,3.172781678247792
2003-04-14T09:30:00-04:00,14.4,14.79,14.4,14.76,673600,964215,50.80765106785882,49.81570166809024,NaN,NaN,-68.29953472040239,-80.62248147957895,-0.04439695140691775,-0.010079889410778975,0.03431706199613878,-25074897,-25186157,37.795514006931434,54.60788887462603,NaN,NaN,-0.4344628764820507,2.6574610275721
2003-04-15T09:30:00-04:00,14.74,14.88,14.65,14.79,353200,909690,51.322294929366464,49.52477410195828,NaN,NaN,-30.218089833876974,-84.33600235897462,-0.029450239878186724,-0.002495737851594626,0.0269545020265921,-24721697,-25257637,37.241281806946546,51.99288244946706,NaN,NaN,0.00008167080735230679,2.277835405177136
2003-04-16T09:30:00-04:00,15.08,15.2,14.85,14.9,562300,863640,53.25344046012505,49.58864033407958,NaN,NaN,32.38478489986691,-59.88922370547399,-0.01176389644914292,0.012249631465163446,0.024013527914306367,-24159397,-24961837,41.09102095317243,49.73646704732672,NaN,NaN,0.9128402693891748,2.08283610006457
2003-04-17T09:30:00-04:00,14.9,15.25,14.8,15.21,1211800,892220,58.27702657715961,50.24277322014367,NaN,NaN,66.73106933193876,-21.307604942662685,0.019502792894811955,0.04839201903282131,0.028889226138009354,-22947597,-24530417,46.26800680046647,48.286100352231685,NaN,NaN,3.2253222999581617,2.246048414335083
2003-04-21T09:30:00-04:00,15.25,15.32,15.04,15.15,1518800,885895,57.00024916029143,51.23739093465756,NaN,NaN,102.86137801423284,20.691921538351828,0.03398534201949543,0.07137090366237864,0.03738556164288321,-24466397,-24273997,49.12953165508595,47.47649880328053,NaN,NaN,4.772801181924345,2.6070130954192634
2003-04-22T09:30:00-04:00,15,15.48,14.99,15.48,829900,881205,61.939284449420526,52.368029849290046,NaN,NaN,134.67813705131294,61.2874558926949,0.062000147481073936,0.11488574599422563,0.052885598513151694,-23636497,-23986317,52.20485518240225,47.274914938549934,NaN,NaN,7.661192499596884,3.3290387245874946
2003-04-23T09:30:00-04:00,15.49,15.75,15.43,15.74,981300,897670,65.31922509876132,53.0736512025909,NaN,NaN,197.91666666666043,106.91440719280237,0.092419579311995,0.16841007265314545,0.07599049334115045,-22655197,-23573017,56.292915809666255,47.35886590490886,NaN,NaN,11.216112414954287,4.455763537497036
2003-04-24T09:30:00-04:00,15.58,15.73,15.41,15.6,391200,850450,62.12029320866341,53.59784741185274,NaN,NaN,159.38882187373576,132.31521458757615,0.0970138390406857,0.19725779214200756,0.10024395310132186,-23046397,-23350417,58.35877846561586,47.70423305681765,NaN,NaN,13.228140214176964,5.708960205594169
2003-04-25T09:30:00-04:00,15.53,15.53,15.26,15.31,790700,864450,56.002103299281856,53.88692166427863,NaN,NaN,95.21674140507497,138.0123490022034,0.075386778790084,0.19447742658892686,0.11909064779884286,-23837097,-23528317,56.07752309180177,47.99886438609679,NaN,NaN,13.102893796489273,6.7652364328648975
2003-04-28T09:30:00-04:00,15.3,15.72,15.29,15.63,498900,868260,60.61198912679713,54.460985462909846,NaN,NaN,119.48161416077859,141.33639623151254,0.07721538261394234,0.2156098760662708,0.13839449345232846,-23338197,-23302677,58.30384785531254,48.29377563504929,NaN,NaN,14.455434644674709,7.863836177409156
2003-04-29T09:30:00-04:00,15.75,15.94,15.61,15.79,590500,836805,62.715483969246485,55.37132350394723,NaN,NaN,150.38600102932998,144.47796902711596,0.08326286814700498,0.2424730786360847,0.1592102104890797,-22747697,-23124917,60.023000814258054,48.79819699918659,NaN,NaN,16.22924536935563,9.05889463340151
2003-04-30T09:30:00-04:00,15.74,15.79,15.61,15.61,509000,829625,58.904286033653655,56.374137020145945,NaN,NaN,115.98551474391493,128.09173864256687,0.0697498692005756,0.2463975469897992,0.1766476777892236,-23256697,-23245217,58.27196717693348,49.66252307191799,NaN,NaN,16.54028688833419,10.12766495553475
2003-05-01T09:30:00-04:00,15.57,15.84,15.46,15.76,484900,775895,61.029608961968826,57.41053869035688,NaN,NaN,104.51352131651703,117.1166785311231,0.06558596626487748,0.25863013562032044,0.19304416935544297,-22771797,-23190297,58.86199112216802,50.755874481239665,NaN,NaN,17.44081650259216,11.172400890828666
2003-05-02T09:30:00-04:00,15.74,16.09,15.74,16.09,583800,736020,65.28337203778747,58.89902202717014,NaN,NaN,135.02471357960607,125.07827296602932,0.07883787006241436,0.2915915069334609,0.21275363687104656,-22187997,-22860477,62.30876822134835,52.302071640150665,NaN,NaN,19.5700517212126,12.372065295169227
2003-05-05T09:30:00-04:00,16.14,16.28999,16.03999,16.05,929300,762530,64.3662492782284,59.86749332791083,NaN,NaN,138.82016974149698,128.945984082173,0.07851875435962882,0.3109020798205826,0.23238332546095378,-23117297,-22816297,62.75888583149674,54.08516962761962,NaN,NaN,21.008030354581074,13.605774589370919
2003-05-06T09:30:00-04:00,16.09,16.5,16.09,16.34,1164100,781875,67.88841162929393,61.05078737790565,NaN,NaN,144.41104640645213,127.75099315759743,0.0905911840567647,0.34562230553190965,0.25503112147514495,-21953197,-22657397,64.40535357212372,56.02546046798942,NaN,NaN,23.35246879083332,14.998159475294118
2003-05-07T09:30:00-04:00,16.25,16.37,16.03999,16.14,1036100,778050,63.2454628821979,61.76450326519656,NaN,NaN,113.34937858742818,127.22376592630008,0.07832040672914387,0.3529316298865748,0.2746112231574309,-22989297,-22603917,64.96674176647424,57.73086909751098,NaN,NaN,23.917251896536282,16.27231553547157
2003-05-08T09:30:00-04:00,16.03999,16.10001,15.88,15.88,614300,745060,57.71902533688089,61.724646033748094,NaN,NaN,74.26793276881486,121.17464821675965,0.04742746539012155,0.3338955548950828,0.2864680895049613,-23603597,-22770277,61.706486483286824,58.83361764628386,NaN,NaN,22.678502611414128,17.187485117749077
2003-05-09T09:30:00-04:00,16.08,16.32001,16.07001,16.32001,369900,736870,63.5274216254849,62.19087263840476,NaN,NaN,108.69045378452628,115.90779625774368,0.051046877514968725,0.35027668639867215,0.29922980888370343,-23233697,-22979417,57.78078870716387,59.45156457857514,NaN,NaN,23.469079461013916,18.08485573821548
2003-05-12T09:30:00-04:00,16.34,16.63,16.24001,16.57001,502500,729805,66.35547616500457,62.50631490380363,NaN,NaN,136.9900706032228,115.54177643008885,0.06386588814961991,0.3790621690707283,0.3151962809211084,-22731197,-22902197,58.82244391048565,59.924249487723955,NaN,NaN,25.05384796906454,19.080426056908205
2003-05-13T09:30:00-04:00,16.39999,16.63,16.39999,16.53999,712200,731735,65.69672649999481,62.53327928960602,NaN,NaN,130.9647835988713,112.85252386857269,0.06376324968444358,0.3949003430266629,0.3311370933422193,-23443397,-23200237,53.351183677617165,59.71412576400616,NaN,NaN,26.10063159259103,20.08331256200575
2003-05-14T09:30:00-04:00,16.60001,16.69,16.34,16.48,541400,741145,64.32249661883148,62.69057953318946,NaN,NaN,115.17019882191896,113.21668791547083,0.05350900764675687,0.3980233529006654,0.3445143452539085,-23984797,-23399337,50.00507689898906,59.11743279496138,NaN,NaN,26.546581794010876,21.006636738006485
2003-05-15T09:30:00-04:00,16.59,16.75,16.45,16.64999,677200,746890,66.46324623478003,63.437804028582185,NaN,NaN,120.57268843874323,122.4776390494565,0.05198430994361358,0.4094947326834255,0.35751042273981193,-23307597,-23340137,50.9893626913666,58.75399276635887,NaN,NaN,27.551801784678588,21.9416603161025
2003-05-16T09:30:00-04:00,16.57001,16.64999,16.39999,16.5,1131900,742895,62.87819708523662,63.599676025613576,NaN,NaN,95.81809132546536,119.90316655764431,0.03547218985694134,0.4018506600609886,0.36637847020404724,-24439497,-23581297,46.93553456115614,57.94197038820484,NaN,NaN,27.3612299033528,22.715884542852542
2003-05-19T09:30:00-04:00,16.33,16.39999,15.9,15.9,960600,714985,51.02201635681258,62.764428339011154,NaN,NaN,11.88286497130535,94.88172543126083,-0.018367598795732853,0.3434189717093812,0.36178657050511404,-25400097,-24115077,39.45794075281437,56.47303752667316,NaN,NaN,23.262957616682492,22.794037839113965
2003-05-20T09:30:00-04:00,15.95,16.12,15.8,15.93,1818800,764430,51.51429739882032,62.23657200795162,NaN,NaN,-17.7661760160488,65.13553350827681,-0.05253428458309084,0.2961187147762505,0.34865299935934135,-23581297,-24142657,39.11122136455273,55.10441282578881,NaN,NaN,20.180137298054767,22.420623476105508
2003-05-21T09:30:00-04:00,16,16,15.78,15.95,940500,762390,51.861670867764175,61.58171928693701,NaN,NaN,-30.151817114478238,36.07113032099736,-0.07309761687608318,0.25728097826423735,0.33037859514032053,-22640797,-23873857,44.25269132744823,54.060891411880256,NaN,NaN,17.801039869258457,21.760682960841642
2003-05-22T09:30:00-04:00,15.97,16.17999,15.88,16.12,2750100,880335,54.82439067140758,60.83464918933844,NaN,NaN,-3.0526317601735573,11.346066281214007,-0.07431741305382494,0.23748182882303936,0.3117992418768643,-19890697,-23190477,54.72076566635461,53.5188912293807,NaN,NaN,16.617282198589244,21.025911423377014
2003-05-23T09:30:00-04:00,16.00999,16.2,16.00999,16.14,297900,855695,55.17392995482138,60.17805495195223,NaN,NaN,1.6383199877902686,-7.489887986321014,-0.07275237696527503,0.2208587706702705,0.2936111476355455,-19592797,-22221137,64.81365664305834,53.66566057306367,NaN,NaN,15.743587422980843,20.271293709034705
2003-05-27T09:30:00-04:00,16,16.63,16,16.56,699600,865730,61.849602401195426,59.74671143565947,NaN,NaN,67.97798162577993,3.7291353445739226,-0.043831020830777334,0.23882237159707387,0.2826533924278512,-18893197,-20919757,73.38958034178333,54.30739105661079,NaN,NaN,16.941029132963696,19.795541626738846
2003-05-28T09:30:00-04:00,16.63,16.78,16.5,16.67,941300,883270,63.3874809611552,59.75685558415642,NaN,NaN,122.65858500892482,31.814087549568647,-0.018962934571215784,0.25894972421383144,0.27791265878504723,-17951897,-19793877,78.31403538115782,55.26076917194532,NaN,NaN,18.393169876971907,19.59520280534357
2003-05-29T09:30:00-04:00,16.66,17.02,16.64999,16.71001,730000,894320,63.956607947720876,60.20239719921642,NaN,NaN,143.26127112606264,66.49670519767683,-0.002362363445569282,0.2749597044780856,0.2773220679236549,-17221897,-18710097,81.80464106481185,56.69635164205425,NaN,NaN,19.747339667890824,19.61693664285032
2003-05-30T09:30:00-04:00,16.83,17.03,16.83,16.95,1418700,941010,67.24557020591335,60.4679792406756,NaN,NaN,160.58431251844206,99.22409405339995,0.02095370070737851,0.30351419380787803,0.2825604931004995,-15803197,-17892597,83.9086425467523,58.56262691631057,NaN,NaN,21.914449096172,19.94515270761056
2003-06-02T09:30:00-04:00,17,17.25999,16.85001,16.86,693100,946475,64.85548176839495,60.36083678377491,NaN,NaN,151.456604848262,129.1877510254943,0.02614969057265576,0.3152476063163192,0.28909791574366345,-16496297,-17273297,85.29579724959883,60.45358072624722,NaN,NaN,23.051997010918157,20.388987608083074
2003-06-03T09:30:00-04:00,16.73,17.03,16.73,17.00999,860400,943030,66.96292716170876,60.45127968818305,NaN,NaN,119.99965990259254,139.59208668085682,0.03497198724913386,0.3328128998050808,0.2978409125559469,-15635897,-16621837,86.60401003178976,62.82878260868812,NaN,NaN,24.635416136689276,20.995620255026818
2003-06-04T09:30:00-04:00,17.08,17.44,17.00999,17.37,2524500,1011050,71.39650891464179,60.95656628074094,NaN,NaN,170.02132103614733,149.06463388630132,0.058927980933641266,0.37150088872299847,0.3125729077893572,-13111397,-15653737,88.27363005883588,65.56225069153432,NaN,NaN,27.456874481186937,21.91865657304969
2003-06-05T09:30:00-04:00,17.25,17.39,17.10001,17.37,505600,984525,71.39650891464179,61.30894218644534,NaN,NaN,151.63476257737463,150.73933217656372,0.06800436400055404,0.39757836279004977,0.3295739987894957,-13111397,-14831637,89.47345477457071,68.31111441176319,NaN,NaN,29.71917702983581,23.03301663830485
2003-06-06T09:30:00-04:00,17.78,17.85001,17.16,17.2,845100,996065,66.5084785301726,61.568248003940774,NaN,NaN,150.55799111745424,148.73406789636616,0.056274697849513944,0.39991737110138814,0.3436426732518742,-13956497,-14462297,89.96998117062857,71.38500345529692,NaN,NaN,30.26166269835165,24.065680361168678
2003-06-09T09:30:00-04:00,17.17999,17.25999,16.84,16.95,1167000,1035920,60.00264311275624,62.20972134365103,NaN,NaN,71.59592545238297,132.76193201719033,0.026885417085793895,0.3772494446091166,0.3503640275233227,-15123497,-14187737,90.3349503366408,75.01907556842738,NaN,NaN,28.78483449594692,24.739845237565568
2003-06-10T09:30:00-04:00,16.97,17.24001,16.96001,17.19,568800,1039235,63.67609616036139,63.078421255189674,NaN,NaN,82.04042570912065,125.170085178496,0.019177444634306373,0.3743358333162057,0.3551583886818993,-14554697,-13971497,90.62431202011933,78.698582043825,NaN,NaN,28.614318595147274,25.293341431505812
2003-06-11T09:30:00-04:00,17.05,17.42999,16.97,17.3,459200,1026585,65.25133860776788,64.03482609376137,NaN,NaN,88.56309022552465,108.87843901637143,0.017122955277097507,0.3765620827782712,0.3594391275011737,-14095497,-14168317,88.04063641944995,81.82629240753941,NaN,NaN,28.9426412880817,25.814669982445224
2003-06-12T09:30:00-04:00,17.49001,17.52,17.23,17.38,983900,1048710,66.39282027899354,64.86114249430322,NaN,NaN,99.71874765518746,98.495236031934,0.016766102730976562,0.3803967559148944,0.36363065318391785,-13111597,-14168357,88.0400870693955,84.20624393632805,NaN,NaN,29.545986735226705,26.347715232842578
2003-06-13T09:30:00-04:00,17.39,17.46001,16.97,17,1468400,1088270,56.841287644131555,64.9802394721111,NaN,NaN,58.24798250317423,80.03323430907801,-0.011902335846189938,0.3487527333761804,0.36065506922237034,-14579997,-14293057,86.23360487337462,85.7362402384935,NaN,NaN,27.09690859464309,26.454742855956937
2003-06-16T09:30:00-04:00,17.19,17.45,17.05,17.42,2064100,1134880,63.15122910413784,65.07321280803555,NaN,NaN,76.316898371222,80.9774288928458,-0.005731822253362995,0.35349029140566657,0.35922211365902956,-12515897,-13771537,87.39820008483139,86.7368559344255,NaN,NaN,26.989858973016062,26.531188015536813
2003-06-17T09:30:00-04:00,17.62,17.62,17.34,17.5,1133600,1143530,64.22416076605327,65.13297565124256,NaN,NaN,97.84105517575149,84.13755478617198,0.0002666613824630626,0.3595554403871084,0.35928877900464534,-11382297,-13137057,88.65558573305185,87.47553810241793,NaN,NaN,27.24675386531822,26.63341170836273
2003-06-18T09:30:00-04:00,17.35001,17.82001,17.34,17.67,437200,1074450,66.45910803322631,65.3117256573501,NaN,NaN,114.4857203934668,89.32208081976042,0.01158585151815833,0.37377109340234327,0.36218524188418494,-10945097,-12506977,89.74940924689228,88.04302154399511,NaN,NaN,28.164080193205738,26.852078634768873
2003-06-19T09:30:00-04:00,17.75,17.89999,17.53,17.53999,398600,1047355,63.207069905498955,65.02326135017765,NaN,NaN,118.49632729616678,93.07759674795628,0.006474242936646779,0.37027804555499344,0.36380380261834666,-11343697,-12153397,90.31381891220413,88.50053414152738,NaN,NaN,27.921879945325106,27.004907393419764
2003-06-20T09:30:00-04:00,17.60001,17.7,17.44,17.52,389300,929315,62.69904759697195,64.86923033793315,NaN,NaN,94.7498601046703,100.37797226825549,-0.001661449731003628,0.3617269904545921,0.36338844018559574,-11732997,-11583997,91.15813290092399,88.91927240233632,NaN,NaN,27.578667622458326,27.086873140425272
2003-06-23T09:30:00-04:00,17.42999,17.48,17.00999,17.17,1706800,999760,54.44750670651532,63.97527173399076,NaN,NaN,13.276623756687929,87.76991734534866,-0.032322773720821873,0.3229849730345684,0.3553077467553903,-13439797,-11768777,88.46327061956724,89.05207673003471,NaN,NaN,24.696249458591755,26.745355471591914
2003-06-24T09:30:00-04:00,17.12,17.25,16.99001,17.10001,603200,994940,52.94689865838048,62.657442429972086,NaN,NaN,-28.475756694080907,62.50655497138219,-0.0575521555752776,0.2833675522862933,0.3409197078615709,-14042997,-12300917,81.03371983143964,88.5349402852207,NaN,NaN,21.893241227312295,26.05219629383768
2003-06-25T09:30:00-04:00,17.05,17.32001,16.84,16.92999,597000,977725,49.38613602176316,61.08527293762362,NaN,NaN,-66.55264180913368,26.29888253086208,-0.08430684335463157,0.2355361536682814,0.31984299702291297,-14639997,-13039897,71.99155201302285,87.28623294511013,NaN,NaN,18.425891615480932,24.962724196929575
2003-06-26T09:30:00-04:00,16.92999,17.3,16.89999,17.25,1613700,1021910,55.45798029697308,60.29595163525222,NaN,NaN,-34.548754537490645,-4.3101338358694035,-0.07915031624410701,0.22090510171777922,0.30005541796188623,-13026297,-13376417,68.25636115330968,85.73526008673022,NaN,NaN,17.213751413643816,23.855728085031608
2003-06-27T09:30:00-04:00,17.28999,17.42,17.02,17.12,500800,976015,52.69253719350929,59.773801212448866,NaN,NaN,-27.195883866226758,-28.69928263004882,-0.08280095884886429,0.19655421940080586,0.27935517824967016,-13527097,-13735237,64.41847451168121,83.88408324209024,NaN,NaN,15.359869288241654,22.642033971204473
2003-06-30T09:30:00-04:00,17.22,17.34,17.02,17.07001,558200,969270,51.62643873788527,58.913111396557724,NaN,NaN,-49.70418425225693,-41.295444231837784,-0.08648562067401444,0.17124815240715208,0.2577337730811665,-14085297,-13864337,63.0449587113911,81.91412943432394,NaN,NaN,13.53702557406086,21.341318485898242
2003-07-01T09:30:00-04:00,16.91,17.31,16.77,17.31,604100,956455,56.207275928335704,58.26710691945542,NaN,NaN,-63.29844227710272,-48.25998134844214,-0.07129548464834512,0.16861441727073512,0.23990990191908024,-13481197,-13751977,63.769016972231455,80.18044233095118,NaN,NaN,13.314475928207697,20.19462669194245
2003-07-02T09:30:00-04:00,17.34,17.67999,17.34,17.67,803600,870410,62.0177494674526,57.95460186148822,NaN,NaN,110.93161985196437,-12.763129016222537,-0.037250028360497456,0.1933473664684584,0.23059739482895586,-12677597,-13359497,66.25607491196963,78.62444146256361,NaN,NaN,14.985547529496632,19.450472525878762
2003-07-03T09:30:00-04:00,17.48,17.74001,17.45,17.46001,764300,883345,57.246427206464475,57.98354040165485,NaN,NaN,92.26836357478813,12.600294606233216,-0.029461671546517604,0.19377030539580886,0.22323197694232647,-13441897,-13442617,65.23476493558749,77.12452432415024,NaN,NaN,14.869843695031088,18.79609697861481
2003-07-07T09:30:00-04:00,17.67,18.10001,17.67,18.06,735200,877850,65.43014108562429,58.14631982890387,NaN,NaN,193.52063238713214,56.74359785690499,0.013219145915922936,0.23975590933723012,0.22653676342130719,-12706697,-13278537,66.33784880166999,75.62021351821015,NaN,NaN,17.693631163188403,18.638601862125324
2003-07-08T09:30:00-04:00,18.06,18.28,17.91,18.2,780900,858545,67.01664643546347,58.3457830910046,NaN,NaN,204.92776050007575,107.66998680737154,0.0461468664684451,0.28422034650686356,0.23807348003841847,-11925797,-12846637,69.11572574318663,74.22450923321979,NaN,NaN,20.4637119816744,18.899331879203764
2003-07-09T09:30:00-04:00,18.2,18.41,18.07001,18.17999,1183300,889270,66.54656477125928,58.3520300008641,NaN,NaN,187.86995664866836,157.90366659252575,0.06091876687417919,0.31422193863114245,0.25330317175696326,-13109097,-12772217,69.58152597980997,72.7839461427139,NaN,NaN,22.465985655865712,19.408853847298328
2003-07-10T09:30:00-04:00,17.98,18.07001,17.69,17.75999,1011200,916870,57.43932387511309,57.94004814155081,NaN,NaN,86.28807625805837,152.97495787374456,0.03787130997718424,0.3006423092284436,0.26277099925125935,-14120297,-13060757,65.45927401248699,71.00862150701981,NaN,NaN,21.204254047359765,19.665339590164248
2003-07-11T09:30:00-04:00,17.83,18.10001,17.83,18.00999,345400,884945,60.87193754345295,57.80954028058517,NaN,NaN,104.7618530301572,155.47365576481837,0.03499911676202022,0.30651989520378464,0.2715207784417644,-13774897,-13127357,64.50929121670765,69.10513281529009,NaN,NaN,21.297523606329865,19.898508735330765
2003-07-14T09:30:00-04:00,18.36,18.45,18.03999,18.09,494800,836265,61.930182361312994,58.34401711307072,NaN,NaN,134.5184480084935,143.67321888909063,0.03399481833816986,0.3140143013644767,0.28001948302630686,-13280097,-13242037,62.81872641836648,67.27337965806146,NaN,NaN,21.706632594544498,20.15681214378987
2003-07-15T09:30:00-04:00,18.35001,18.35001,17.95,18.12,707400,768430,62.34144862433022,59.01505639635285,NaN,NaN,107.91718897742236,124.27110458455995,0.030944924730324452,0.3187006389392124,0.28775571420888796,-12572697,-13371417,60.88029497725265,65.83384931133382,NaN,NaN,22.15640063446698,20.44246764245803
2003-07-16T09:30:00-04:00,18.35001,18.35001,17.89,18.06,489200,736210,60.923878630533224,59.83918086840786,NaN,NaN,88.4120695403105,104.3795271628884,0.020958652666982602,0.31395403004261624,0.29299537737563364,-13061897,-13361977,60.97491753393475,65.04694684854181,NaN,NaN,22.119552566437594,20.68205120302654
2003-07-17T09:30:00-04:00,17.71001,17.8,17.35001,17.50999,634600,746080,49.75502520945639,59.431826933585235,NaN,NaN,-12.230518804665664,84.67580815034358,-0.02417077260540834,0.2627819116188732,0.28695268422428155,-13696497,-13277217,61.866796727796306,64.59054938957655,NaN,NaN,18.471004840979365,20.3661874370198
2003-07-18T09:30:00-04:00,17.62,17.64999,17.32001,17.55,211600,736730,50.46640826487618,59.27281772439716,NaN,NaN,-19.310543624313897,59.86132881944936,-0.05125269834188623,0.22288681129692378,0.27413950963881,-13484897,-13219217,62.498384779597224,64.45340012299913,NaN,NaN,15.783729924109894,19.71155064946124
2003-07-21T09:30:00-04:00,17.42,17.55,17.10001,17.16,468200,740675,43.93636909034231,58.72352703528695,NaN,NaN,-58.16451022096129,21.3247371735584,-0.09292854006091517,0.15797883456266604,0.2509073746235812,-13953097,-13353817,60.01418631522188,64.23691638041562,NaN,NaN,11.258843568295129,18.50402106643751
2003-07-22T09:30:00-04:00,17.47,17.60001,17.3,17.53,419800,676325,50.4826226742172,58.31462323142133,NaN,NaN,-24.477271241936457,-5.154154870313361,-0.09285362165596028,0.13484034755363083,0.22769396920959112,-13533297,-13545937,56.55855049157326,63.7218830603686,NaN,NaN,9.494457433603195,17.216940547461178
2003-07-23T09:30:00-04:00,17.64999,17.64999,17.32001,17.63,247200,658525,52.11018534033867,57.60694007948463,NaN,NaN,-18.844060351413525,-26.605380848658164,-0.08363320004317099,0.12315246915562739,0.20678566919879837,-13286097,-13590777,55.75166923050995,62.97156836883577,NaN,NaN,8.602588084860871,15.986318767089706
2003-07-24T09:30:00-04:00,17.7,17.85001,17.3,17.38,549800,656165,47.873735282914566,56.93746208494535,NaN,NaN,-29.506411818813618,-30.060559451487755,-0.09130946929054229,0.09264883258562051,0.1839583018761628,-13835897,-13618657,55.22413321374819,62.25652324584724,NaN,NaN,6.497021778793021,14.630704911618752
2003-07-25T09:30:00-04:00,17.39999,17.75999,17.19,17.75,346700,592815,53.85326283433121,56.11054220985299,NaN,NaN,-23.450627267189322,-30.88857618006284,-0.06939878998991772,0.09720981438876564,0.16660860437868336,-13489197,-13619517,55.20678011555886,61.461446911125016,NaN,NaN,6.637353988183696,13.488797636842316
2003-07-28T09:30:00-04:00,17.7,17.85001,17.64999,17.78,954600,615505,54.31090604718947,55.20298932497627,NaN,NaN,12.286319788563157,-16.798410178157955,-0.05163201036615361,0.10206859142099134,0.15370060178714495,-12534597,-13335817,59.705038789976335,60.78925498589572,NaN,NaN,6.889915901149031,12.54610024602899
2003-07-29T09:30:00-04:00,17.78,17.81,17.46001,17.61,848600,630025,51.21158480840262,54.10763361334365,NaN,NaN,-25.06332993997363,-16.91562191776539,-0.05003976369308827,0.09115089717078462,0.14119066086387289,-13383197,-13305797,60.160946764248855,60.116356470498495,NaN,NaN,6.159482396225072,11.633726267485573
2003-07-30T09:30:00-04:00,17.72,17.72,17.46001,17.48,200400,609840,48.9128866260783,53.49860238126974,NaN,NaN,-51.65037733194011,-23.476885313870703,-0.05600211182624193,0.07118802108107047,0.1271901329073124,-13583597,-13365297,58.74231887310826,59.63657396054287,NaN,NaN,4.867610002283497,10.667138229599562
2003-07-31T09:30:00-04:00,17.8,17.95,17.59,17.60001,1230900,631205,51.09523307771952,52.80026634800306,NaN,NaN,-12.08819088532597,-19.99324112717317,-0.05030428321369129,0.06430977889019829,0.11461406210388958,-12352697,-13068657,63.37875581121799,59.555821431579325,NaN,NaN,4.42360293330917,9.775204615843792
2003-08-01T09:30:00-04:00,17.57001,17.67,17.46001,17.50999,1211200,653550,49.39085805854378,51.904600326376695,NaN,NaN,-56.782735262070986,-26.65966272614951,-0.05088574159784684,0.051006885106581024,0.10189262670442786,-13563897,-13083597,62.994792471840206,59.56839757825602,NaN,NaN,3.569438559095891,8.88866660773695
2003-08-04T09:30:00-04:00,17.60001,17.75,17.33,17.66,338900,633735,52.24930638601244,51.18373302363972,NaN,NaN,-43.65656360053105,-37.84823940396835,-0.039938321667842724,0.05196972461962446,0.09190804628746718,-13224997,-13221677,59.41228448706264,59.463539686099594,NaN,NaN,3.6469080522774506,8.139843956957021
2003-08-05T09:30:00-04:00,17.7,17.7,17.14999,17.22,333300,611355,44.33882828417885,49.99908657032869,NaN,NaN,-98.36496385083744,-52.50856618614112,-0.059900738319782126,0.017032123387739517,0.07693286170752164,-13558297,-13256697,58.50355458647056,59.28701376128072,NaN,NaN,1.2777341017093102,7.159542549064491
2003-08-06T09:30:00-04:00,17.03,17.35001,16.94,17.06,643200,584350,41.85715881091462,49.43495325614713,NaN,NaN,-160.19900060998924,-74.21829084175093,-0.08018490708276367,-0.02329827214593294,0.05688663493683073,-14201497,-13380277,55.28974679156472,58.81722448012133,NaN,NaN,-1.4620193514343507,5.927890848993227
2003-08-07T09:30:00-04:00,16.99001,17.12,16.92,17.00999,451400,556360,41.08315155263911,48.76472063384449,NaN,NaN,-172.1540377577939,-106.23146021624453,-0.09240535172473306,-0.0586200547190856,0.03378529700564746,-14652897,-13840317,45.311049381958696,57.58955766600429,NaN,NaN,-3.919051048710074,4.521184863607042
2003-08-08T09:30:00-04:00,17.08,17.19,16.89999,16.99001,325000,555340,40.75887111745349,48.537756492923855,NaN,NaN,-159.26395558223325,-126.72770428027698,-0.0968039394737821,-0.08721962733658017,0.009584312137201931,-14977897,-14123117,40.47506090797196,56.19390585120073,NaN,NaN,-6.021737944093915,3.0150530339354766
2003-08-11T09:30:00-04:00,16.98,17.21001,16.96001,17.07001,437700,552485,42.70882313830213,47.982485097501346,NaN,NaN,-129.64141972104625,-143.92467550438002,-0.08946823183079736,-0.10225097765129476,-0.012782745820497408,-14540197,-14386157,36.565892429625094,54.76585884677586,NaN,NaN,-7.2755961985298985,1.544960286440423
2003-08-12T09:30:00-04:00,17.12,17.37,17.06,17.33,224100,528320,48.62698690380094,47.733685209177224,NaN,NaN,-65.34317702643071,-137.32031813949868,-0.0634717875750461,-0.09212248028930503,-0.028650692714258935,-14316097,-14537717,34.49840275445024,53.24776838420017,NaN,NaN,-6.719170652542404,0.3643701523000191
2003-08-13T09:30:00-04:00,17.49001,17.5,17.23,17.3,264600,517090,48.010694916521324,47.74346804014914,NaN,NaN,-26.829115943097168,-110.64634120612027,-0.04550375098150654,-0.08553038144114211,-0.04002663045963557,-14580697,-14613557,33.47833405456413,51.69449701568702,NaN,NaN,-6.426089073300162,-0.6056954513571495
2003-08-14T09:30:00-04:00,17.28,17.52,17.23,17.45,229400,496830,51.33198982100396,47.56337711062576,NaN,NaN,-4.280494362829163,-77.07163252712732,-0.021918787203418458,-0.06742511446390864,-0.045506327260490184,-14351297,-14553237,35.12149077601751,50.259833491434065,NaN,NaN,-5.243602419376335,-1.2682535896456044
2003-08-15T09:30:00-04:00,17.37,17.55,17.37,17.37,274600,499980,49.5151568721915,47.220823598125904,NaN,NaN,8.108672042693422,-43.597107002141975,-0.010677710385880446,-0.05885346524284074,-0.048175754856960296,-14625897,-14482837,37.075085677654,48.643408269125324,NaN,NaN,-4.726804718286246,-1.7623323223085532
2003-08-18T09:30:00-04:00,17.61,17.91,17.52,17.88,327100,492925,59.384414547964795,47.80459715095178,NaN,NaN,119.90698463816071,6.3125738696994205,0.029913939718111272,-0.010783330209321207,-0.04069726992743248,-14298797,-14434557,38.44402177063627,47.092199341010144,NaN,NaN,-1.101522472769599,-1.6679309152315598
2003-08-19T09:30:00-04:00,17.99001,18.12,17.86,18.12,501000,496985,63.04555131963522,48.814073200491556,NaN,NaN,179.67797318766642,55.316803912518836,0.06947513001962687,0.046146642597101106,-0.023328487422525763,-13797797,-14330897,41.392140875063134,45.852900912578356,NaN,NaN,3.192611580335907,-0.9735677015790646
2003-08-20T09:30:00-04:00,18,18.14,17.87,18.02,544900,511870,60.59462215839904,49.492600991968665,NaN,NaN,149.75265473465893,90.63315804807007,0.08446023154021211,0.08224680200273937,-0.002213429537472736,-14342697,-14283297,42.7480955022759,44.37928231908249,NaN,NaN,5.9564059399764435,0.016428532928865036
2003-08-21T09:30:00-04:00,18.2,18.33,18.02,18.19,307100,499735,63.21284225230193,50.4798855772371,NaN,NaN,167.1189530422616,124.91304752908823,0.10029424022599134,0.12315437074501645,0.0228601305190251,-14035597,-14220157,44.5797358418709,43.06392113122753,NaN,NaN,9.104279867612814,1.3146930093122862
2003-08-22T09:30:00-04:00,18.45,18.64,18.12,18.16,334200,499110,62.424593315102115,51.20669178645779,NaN,NaN,167.9234403823175,156.87600119701304,0.10283815895263573,0.15140782920981977,0.04856967025718403,-14369797,-14168937,46.08657488643306,42.11208473118256,NaN,NaN,11.425988094742355,2.7591637358022956
2003-08-25T09:30:00-04:00,18.05,18.16,17.96001,18.05,366600,469710,59.49508150322243,52.28928130210377,NaN,NaN,103.10780621573865,153.51616551252863,0.09157894826975872,0.16304335559438243,0.07146440732462371,-14736397,-14256457,43.89062484599819,41.068304035434544,NaN,NaN,12.554815254904517,4.15854252424547
2003-08-26T09:30:00-04:00,17.95,18.21001,17.78,18.14999,378800,446220,61.27413585313029,53.6762082336906,NaN,NaN,89.64505869237192,135.50958261346972,0.08545077419045613,0.17827787506269388,0.09282710087223775,-14357597,-14368417,41.18698821447211,40.060964137070776,NaN,NaN,14.016509174271244,5.566823474249151
2003-08-27T09:30:00-04:00,18.17,18.33,18.07001,18.27,204500,446425,63.35453760159398,55.26702152290166,NaN,NaN,107.33260399445523,127.025572465429,0.08394275349147381,0.19775554273658003,0.11381278924510621,-14153097,-14330497,42.47936850432714,39.858701217239954,NaN,NaN,15.8605520281079,7.037356124800401
2003-08-28T09:30:00-04:00,18.35001,18.45,18.12,18.38,543200,412040,65.19991957109247,57.01281069816158,NaN,NaN,108.93520230346039,115.38882231766874,0.08457947103106542,0.219537128033938,0.13495765700287257,-13609897,-14245357,45.38143393976514,40.209156433796615,NaN,NaN,17.96160474146945,8.597963070038837
2003-08-29T09:30:00-04:00,18.32001,18.53999,18.28,18.44,291000,366030,66.19975643548105,58.69073450510293,NaN,NaN,109.84217776845891,103.77256979489702,0.08314343424852877,0.23888694981353353,0.15574351556500476,-13318897,-14035177,51.841001271207226,41.300235636766764,NaN,NaN,20.00966583532459,10.228206322222515
2003-09-02T09:30:00-04:00,18.64999,18.87,18.42999,18.84,440600,371115,71.97960627271172,60.358778745739414,NaN,NaN,133.89177828451923,109.92936420865313,0.10199201962704932,0.2832335400988164,0.1812415204717671,-12878297,-13663557,60.692734922554074,43.171259363059896,NaN,NaN,23.76562272441569,12.162122951107253
2003-09-03T09:30:00-04:00,19.03,19.2,18.91,19.03999,694200,389160,74.34200108608925,62.23958632927998,NaN,NaN,157.58496469094393,123.5173454083675,0.11956990782256718,0.33070390524997606,0.21113399742740888,-12184097,-13228857,68.08283668870007,45.64300955121246,NaN,NaN,27.737051344507435,14.387112721592993
2003-09-04T09:30:00-04:00,19.09,19.3,18.98,19.22,388700,376435,76.28046389431925,64.02162019165965,NaN,NaN,156.4657660438872,133.3439778182539,0.1338822847664755,0.37848685338550325,0.24460456861902774,-11795397,-12757317,73.83044876952674,48.4079351221774,NaN,NaN,31.72151808648089,16.863456345148407
2003-09-05T09:30:00-04:00,19.11,19.39999,19.05,19.12,531600,380445,72.98180548245371,65.69780937810695,NaN,NaN,148.47377290176976,141.25169193791578,0.12722289521768776,0.4036331876411374,0.27641029242344967,-12326997,-12500737,76.32837797537621,51.21174171487184,NaN,NaN,34.01382134746214,19.313508488336083
2003-09-08T09:30:00-04:00,19.2,19.48,19.2,19.47,468700,387630,76.76845298137721,66.93952640906498,NaN,NaN,153.85296927510575,150.05385023924515,0.13619588693138068,0.4466551510876755,0.3104592641562948,-11858297,-12208617,78.80847788690645,54.094917151748284,NaN,NaN,37.31759296600114,21.885520556573947
2003-09-09T09:30:00-04:00,19.39999,19.42,19.19,19.25999,485400,390015,70.39335542156431,67.46436955920277,NaN,NaN,126.57164625857452,148.5898238340562,0.11844762542760495,0.458518795940801,0.3400711705131961,-12343697,-12101697,79.64892586561162,56.827544651073175,NaN,NaN,38.024688194151906,24.1911159333708
2003-09-10T09:30:00-04:00,19.17999,19.17999,18.67999,18.69,560600,406840,56.64431674019632,67.182204886474,NaN,NaN,63.05326094750048,129.68348308536753,0.061638344560536795,0.4171191012138671,0.3554807566533303,-12904297,-12245737,75.31540070559991,59.153780737024896,NaN,NaN,33.66138629478685,25.544011699287378
2003-09-11T09:30:00-04:00,18.87,19.03,18.64,18.91,314500,409335,59.89988227469155,66.94556488807326,NaN,NaN,56.410856868399875,109.67250125027003,0.03359923985409946,0.3974798064709546,0.36388056661685514,-12589797,-12404617,70.74328291326259,61.022605527838586,NaN,NaN,31.297558880133757,26.36594701083686
2003-09-12T09:30:00-04:00,18.7,18.99001,18.63,18.92999,292800,412505,60.192379280523404,66.7861210284605,NaN,NaN,47.718757098828746,89.52149808968184,0.012221829991120758,0.3791578541057561,0.36693602411463533,-12296997,-12398617,70.81533640205052,62.788945636096976,NaN,NaN,29.5829619937288,26.825520579821422
2003-09-15T09:30:00-04:00,19.07001,19.07001,18.78999,18.82001,271000,412325,57.698772579825096,66.65781324821783,NaN,NaN,46.95505255671579,68.14191474600383,-0.012181757242097135,0.35170882756201394,0.3638905848041111,-12567997,-12540557,66.63446716074506,64.41350580143605,NaN,NaN,27.401055191241756,26.907739810024328
2003-09-16T09:30:00-04:00,18.82001,19.35001,18.82001,19.3,212200,406580,64.5929087024889,66.89486845174345,NaN,NaN,79.40794919256592,58.709175332802126,0.0004754543549803647,0.3644849027478365,0.36400944839285615,-12355797,-12542977,66.5623127450328,66.22602898219039,NaN,NaN,27.75006017859721,27.028071291249024
2003-09-17T09:30:00-04:00,19.28999,19.42999,19.19,19.27,312100,397135,63.89202288478909,66.93326025768594,NaN,NaN,93.89717924747445,64.8779589927969,0.003150690697907743,0.36794781176524083,0.3647971210673331,-12667897,-12495697,67.30715362405327,67.99944220502796,NaN,NaN,27.796712577098067,27.13787718922746
2003-09-18T09:30:00-04:00,19.2,19.60001,19.14,19.53999,444200,392100,67.32799281040732,67.08526548906559,NaN,NaN,106.9430169674651,74.98439101260996,0.018566657932061248,0.3880054434824096,0.36943878555034837,-12223697,-12422477,68.47820293086585,69.64921141867801,NaN,NaN,28.948711302163986,27.39656777678982
2003-09-19T09:30:00-04:00,19.58,19.62,19.17,19.56,257500,389620,67.57426767093898,67.18344486302688,NaN,NaN,104.41228600678637,86.32309679420148,0.025164681213549478,0.40089463706728523,0.37572995585373575,-11966197,-12356317,69.53990852634051,70.91341907975895,NaN,NaN,29.933705262469278,27.75901598902974
2003-09-22T09:30:00-04:00,19.27,19.33,19.05,19.19,411600,393490,58.75507254649627,66.23883531115435,NaN,NaN,53.975918733919755,87.72727002964227,0.0009430263100367875,0.3769087387412817,0.37596571243124494,-12377797,-12318277,70.16219407759027,71.5898090194044,NaN,NaN,27.975716481193746,27.789973202196027
2003-09-23T09:30:00-04:00,19.2,19.33,19.05,19.3,288600,389590,60.409377530679514,65.24364791433936,NaN,NaN,54.62335216386439,82.77035062390198,-0.01069573734426077,0.362596040750919,0.37329177809517977,-12089197,-12264957,71.0548191818925,71.80209348320388,NaN,NaN,26.89287113871285,27.661815764555573
2003-09-24T09:30:00-04:00,19.41,19.41,18.63,18.64,608300,401065,47.97563887487707,63.22187469866492,NaN,NaN,-22.67246322246009,59.456422129915055,-0.06295288870242388,0.29460066721714995,0.35755355591957383,-12697497,-12270877,70.80156227282872,71.58574444772545,NaN,NaN,21.443823816471188,26.77353120054352
2003-09-25T09:30:00-04:00,18.75999,18.89,18.5,18.5,682700,424975,45.821207394929395,61.281831978127464,NaN,NaN,-94.9306567460618,19.081687387209723,-0.10460078478679202,0.2268025749360838,0.3314033597228758,-13380197,-12502177,61.56814538265696,70.53144211967407,NaN,NaN,16.40624626180947,25.292490495010085
2003-09-26T09:30:00-04:00,18.53,18.64999,18.38,18.39999,393600,417495,44.29107770451714,58.96201945835175,NaN,NaN,-139.52403421459042,-29.70557665706563,-0.13462527894519277,0.16312176104138487,0.29774703998657764,-13773797,-12863697,50.485830460461685,68.50839587492801,NaN,NaN,11.901794749980414,23.379533960005848
2003-09-29T09:30:00-04:00,18.55,18.7,18.36,18.7,302300,418060,49.71571809212659,57.48504536339192,NaN,NaN,-117.59446204156164,-64.01965281216191,-0.12995533623924505,0.13530286968752137,0.2652582059267664,-13471497,-13082437,45.18603386370396,66.04676073193461,NaN,NaN,9.812266648630178,21.44135291552361
2003-09-30T09:30:00-04:00,18.58,18.75999,18.21001,18.28,436900,417875,43.351455096256544,56.53555524596764,NaN,NaN,-149.14161806816898,-104.77264685856858,-0.14943756038983044,0.07846125543947835,0.2278988158293088,-13908397,-13446277,38.03401308446363,63.38380447328202,NaN,NaN,5.815141444756294,19.20903699112828
2003-10-01T09:30:00-04:00,18.42,18.7,18.3,18.67999,622700,414300,49.92580620102737,55.823121240705916,NaN,NaN,-99.46028257281279,-120.13021072863913,-0.1303661598559551,0.06494111600936492,0.19530727586532,-13285697,-13563917,36.0473373328593,60.905522646110356,NaN,NaN,4.7027825594309025,17.136714929457227
2003-10-02T09:30:00-04:00,18.64,18.74001,18.50999,18.64,296700,409700,49.309660950518605,55.04578421713414,NaN,NaN,-75.35677342393575,-116.21543406421392,-0.11591121348549113,0.05041825900845609,0.16632947249394722,-13582397,-13604357,35.36350295227069,58.373248828268935,NaN,NaN,3.6442986930652017,15.209226895686939
2003-10-03T09:30:00-04:00,18.87,19.38,18.87,19.21001,907800,428510,57.38305400617792,55.02323289044506,NaN,NaN,43.847407149122795,-79.54114579147128,-0.06591456329274334,0.08393626837801804,0.14985083167076138,-12674597,-13384517,41.82448091683251,56.60110695370376,NaN,NaN,5.518884221884549,13.824892228000884
2003-10-06T09:30:00-04:00,19.32001,19.35001,19.14999,19.31,670200,438585,58.627848848858996,54.59715718661435,NaN,NaN,73.29753212687172,-41.3627469577846,-0.02610731444475503,0.1172166886148176,0.14332400305957263,-12004397,-13091097,49.1329244895747,55.35615064974247,NaN,NaN,7.399197844612479,12.906935887516827
2003-10-07T09:30:00-04:00,19.24001,19.45,19.13,19.44,273200,427975,60.253350620573805,54.337252024884684,NaN,NaN,88.17343750018011,6.100264155885213,0.007201325220634103,0.15232565958536526,0.14512433436473116,-11731197,-12655657,57.63810120241986,54.66550404819723,NaN,NaN,9.433323859995753,12.41070559787096
2003-10-08T09:30:00-04:00,19.47,19.52,19.21001,19.3,211700,410530,57.62745099460033,53.64435618089847,NaN,NaN,79.43544459151222,41.87940958875022,0.017443486110542056,0.16692869200290872,0.14948520589236666,-11942897,-12387097,61.87241956699273,54.19366237934914,NaN,NaN,10.299077248472864,12.109044405099803
2003-10-09T09:30:00-04:00,19.55,19.73,19.34,19.38,500100,419810,58.7341619843162,53.012920060425415,NaN,NaN,98.26661705909416,76.60408768535619,0.026691242784302405,0.18284925937274465,0.15615801658844225,-11442797,-11959177,67.45459751249999,54.04471159264625,NaN,NaN,11.33377235576183,11.99829125519438
2003-10-10T09:30:00-04:00,19.5,19.56,19.36,19.53999,325200,421430,60.931821126926394,53.168402101884716,NaN,NaN,89.74012122297067,85.78263050012576,0.03987488366155101,0.206001621165381,0.16612673750383,-11117597,-11647777,70.80442312099035,54.09058509574625,NaN,NaN,12.854041535618563,12.120541295254977
2003-10-13T09:30:00-04:00,19.61,19.75,19.48,19.60001,259800,420870,61.75469937091088,53.2644965190441,NaN,NaN,104.39740008669011,92.00260409208946,0.048363617489500216,0.22658125936570528,0.17821764187620506,-10857797,-11418457,73.0077533529242,54.23008039367709,NaN,NaN,14.343622441168643,12.438124316099787
2003-10-14T09:30:00-04:00,19.55,19.59,19.42,19.55,220300,421275,60.609195712601256,54.1668934360244,NaN,NaN,80.0227247865257,90.37246154935858,0.04633259306311047,0.23613338320509314,0.18980079014198267,-11078097,-11287837,74.20201831853834,54.472970111227774,NaN,NaN,15.277307082897984,12.843721854213815
2003-10-15T09:30:00-04:00,19.95,19.95,19.59,19.67,1151200,463230,62.41095526195711,55.35187542652638,NaN,NaN,112.13878640011166,96.91312991107846,0.04855849729495765,0.25049891176067973,0.20194041446572208,-9926897,-10884637,77.50989073959617,55.61166620815201,NaN,NaN,16.571138814972375,13.376209991465037
2003-10-16T09:30:00-04:00,19.64999,19.75,19.5,19.74001,243200,453180,63.46103373531594,56.72115800015486,NaN,NaN,94.47449486914579,96.15470547308878,0.050034956709457845,0.2644841103525444,0.21444915364308653,-9683697,-10532817,79.92831026485507,57.7147004798944,NaN,NaN,17.952073597839515,14.029904792375676
2003-10-17T09:30:00-04:00,19.67999,19.8,19.37,19.42,344500,457530,55.789206620750406,57.15497860934227,NaN,NaN,69.47374815294454,92.10143085908355,0.025960075159822293,0.2468992475928644,0.22093917243304212,-10028197,-10314937,81.27146315408552,60.292231143493076,NaN,NaN,17.06873256661362,14.464023045838239
2003-10-20T09:30:00-04:00,19.42,19.67,19.38,19.64999,445500,459225,59.571931412964524,58.313584060535696,NaN,NaN,70.12235605645402,85.24642205303634,0.02217270001553079,0.2486550474524556,0.2264823474369248,-9582697,-10059917,82.72832240568636,63.48468180929469,NaN,NaN,17.38359537317513,14.881104806886366
2003-10-21T09:30:00-04:00,19.74001,19.81,19.61,19.75999,225200,456055,61.278399430903676,59.124483576955434,NaN,NaN,88.64096005106231,86.97006910594367,0.02359166376531019,0.25597192714356254,0.23238026337825235,-9357497,-9715797,84.48243575904786,66.94433169687959,NaN,NaN,18.13641196185062,15.346148686166973
2003-10-22T09:30:00-04:00,19.5,19.64,19.41,19.47,474600,449370,54.72083056370869,59.5109956921833,NaN,NaN,48.77914540302175,74.29814090652567,0.0026192779216026862,0.2356543607802557,0.23303508285865301,-9832097,-9696837,84.57538600404419,70.4594662005777,NaN,NaN,16.856177756613754,15.561867124802228
2003-10-23T09:30:00-04:00,19.25,19.41,19.14999,19.32001,552200,442845,51.64255741133448,59.100960221123046,NaN,NaN,8.836125194476816,57.170466971591885,-0.02235966186335686,0.20508550552945692,0.22744516739281379,-10384297,-9836957,80.72688452321975,73.23820931531965,NaN,NaN,14.85761110801043,15.4612591224034
2003-10-24T09:30:00-04:00,19.00999,19.08,18.75,19.03,368800,441605,46.22764322581392,58.2152312480484,NaN,NaN,-63.48727236140551,30.57826286872188,-0.057425181835044775,0.15566369009900782,0.2130888719340526,-10753097,-9981937,76.83124989236595,75.21666112980473,NaN,NaN,11.41443748490043,14.88314174561726
2003-10-27T09:30:00-05:00,19.2,19.28,19.06,19.13,244300,438705,48.24287807989267,57.35734035228546,NaN,NaN,-31.83944469594112,10.185902718242845,-0.07195417168745283,0.12314615732473655,0.19510032901218938,-10508797,-10167157,72.04775880320648,76.24592238700379,NaN,NaN,9.166937548695774,14.066541146057048
2003-10-28T09:30:00-05:00,19.22,19.60001,19.21001,19.59,351400,434430,56.34727131804088,57.26589894681694,NaN,NaN,31.81258799889938,-1.1797716921897403,-0.04971127157725258,0.13296123954062367,0.18267251111787625,-10157397,-10327137,68.10372667303255,76.6910157517209,NaN,NaN,9.70642071181479,13.443666798308154
2003-10-29T09:30:00-05:00,19.60001,19.67999,19.39999,19.62,205600,413575,56.82212494429354,57.1293248725296,NaN,NaN,53.8465709699977,-0.1662865787945563,-0.03291476620492309,0.1415290533617224,0.17444381956664548,-9951797,-10351077,67.50817496727804,76.69484271277648,NaN,NaN,10.279717128447786,12.9916739883281
2003-10-30T09:30:00-05:00,19.8,19.86,19.57001,19.60001,491100,423295,56.38201098111852,56.80433843354332,NaN,NaN,90.16521332050013,16.099531046410114,-0.023527681710704684,0.1450342174282646,0.1685618991389693,-10442897,-10362797,67.19836495386241,76.43726712941019,NaN,NaN,10.615627832521591,12.652238823212885
2003-10-31T09:30:00-05:00,19.73,19.77,19.58,19.62,706600,413235,56.742830858550946,56.44634782551761,NaN,NaN,78.49180851675685,44.49534722204258,-0.01667171061394962,0.14772226087153228,0.1643939714854819,-9736297,-10159437,69.78911291920458,76.20736424128737,NaN,NaN,10.99149481933569,12.414989679801858
2003-11-03T09:30:00-05:00,19.78,20.09,19.78,20.08,613554,410402.7,64.10194382443412,56.69582983350568,NaN,NaN,197.06530420370754,90.27629700197232,0.016356814764480226,0.1848399899410822,0.16848317517660197,-9122743,-9882226.2,72.92802343631817,76.11636460684306,NaN,NaN,13.631031588089233,12.588709952414339
2003-11-04T09:30:00-05:00,20,20.05,19.83,19.91,443183,418901.85,60.036933528684,56.526256852557594,NaN,NaN,152.87940680369903,114.48966076293225,0.02381597154801962,0.1982531396116265,0.17443716806360687,-9565926,-9763932,74.16174356482655,75.87721123721667,NaN,NaN,14.617905793615757,12.87859507258597
2003-11-05T09:30:00-05:00,19.89999,20,19.7,19.97,190300,417831.85,60.977506469234406,56.348862047837486,NaN,NaN,122.41186715735047,128.20272000040282,0.029481503394434505,0.21128904730665,0.18180754391221549,-9375626,-9648697.8,75.34065413060497,75.54952151334166,NaN,NaN,15.701514891114929,13.281869332375821
2003-11-06T09:30:00-05:00,20.10001,20.16,19.87,20.13,418100,413731.85,63.44807734070212,56.89592424211975,NaN,NaN,156.24211236205988,141.41809980871477,0.040040401409349835,0.23185804567390278,0.19181764426455294,-8957526,-9351623.6,78.11314001694043,75.32392700354558,NaN,NaN,17.357531885554934,13.864106839972838
2003-11-07T09:30:00-05:00,20.21001,20.28999,19.99001,20.05,194300,407186.85,61.35638991419004,57.02338556363586,NaN,NaN,150.40425413063946,155.8005889314913,0.037705352166335804,0.23894933447247269,0.20124398230613688,-9151826,-9234729.4,79.10847801149889,75.06536668967506,NaN,NaN,18.14376816498543,14.475487029260352
2003-11-10T09:30:00-05:00,20.08,20.08,19.75,19.78999,333500,410871.85,55.00897851275594,56.57556978376816,NaN,NaN,68.95065267077945,130.17765862490563,0.015837277930712768,0.22104057971952784,0.20520330178881507,-9485326,-9307246,76.77587385552064,74.51489798228025,NaN,NaN,16.957673340632027,14.83008507374202
2003-11-11T09:30:00-05:00,19.85001,19.87,19.69,19.74001,166000,408156.85,53.85563446296128,56.5137700622862,NaN,NaN,33.69741650063198,106.34126056429224,-0.003759829794317493,0.2005035145459182,0.2042633443402357,-9651326,-9324326,76.20591720364072,73.91707878225142,NaN,NaN,15.64996206326047,14.94721035795894
2003-11-12T09:30:00-05:00,19.85001,20.2,19.82001,20.16,303600,365776.85,61.214659621284525,57.19749164871121,NaN,NaN,109.9794621663665,103.85477956609543,0.009094729940211599,0.21563175676550017,0.20653702682528857,-9347726,-9318746,76.26790186172404,73.59858002071601,NaN,NaN,16.724571840668773,15.201119141203202
2003-11-13T09:30:00-05:00,19.95,20.10001,19.86,19.99001,446000,375916.85,57.23597254999244,57.983800886152515,NaN,NaN,78.83792215994517,88.37394152567248,0.003943634854331218,0.2114665703932026,0.20752293553887138,-9793726,-9485986,70.35248535099328,73.13581112490368,NaN,NaN,16.385534303387196,15.370321307229487
2003-11-14T09:30:00-05:00,20,20.10001,19.67,19.72,352100,376296.85,51.509195582565845,58.217109279200606,NaN,NaN,34.2863944930672,65.15036959815802,-0.018615058005888696,0.1842541130315105,0.2028691710373992,-10145826,-9684786,63.99812705920958,72.56083742890391,NaN,NaN,14.25697356174278,15.211271629302814
2003-11-17T09:30:00-05:00,19.46001,19.64,19.25999,19.45,658900,386966.85,46.4990131743196,57.513662268934794,NaN,NaN,-64.6580361820493,38.42863182759228,-0.05085886629437947,0.1392955881694249,0.19015445446380436,-10804726,-9948666,56.68004582637461,71.74486022557119,NaN,NaN,10.791763246704672,14.579913288931651
2003-11-18T09:30:00-05:00,19.64,19.66,19.2,19.21001,396800,395546.85,42.538387001083564,56.49339527299122,NaN,NaN,-79.43107338142032,15.80293385118182,-0.08545175785544878,0.08333975714449338,0.16879151499994216,-11201526,-10258706,49.5158112608856,70.4596913894003,NaN,NaN,6.56593922103562,13.43505985066079
2003-11-19T09:30:00-05:00,19.14999,19.44,19.14999,19.42,627000,403166.85,46.80770948036873,55.80951659436624,NaN,NaN,-79.5610736588734,-22.105173313866167,-0.09079215855885553,0.055301316801372735,0.14609347536022826,-10574526,-10504066,44.70051663519319,68.85270222378107,NaN,NaN,4.419229823365514,12.14708413247575
2003-11-20T09:30:00-05:00,19.2,19.53999,19.12,19.12,352300,393171.85,42.0059611095233,54.75688304086426,NaN,NaN,-96.84361736797257,-57.24148121944971,-0.1098571487537812,0.008772039418001754,0.11862918817178296,-10926826,-10730686,40.758021090706066,66.77905280745975,NaN,NaN,0.9864761434827198,10.552711562619603
2003-11-21T09:30:00-05:00,19.22,19.34,19.11,19.28,181300,383796.85,45.232860869262794,53.40909140120916,NaN,NaN,-110.27400642643128,-86.15356140334941,-0.10691851544313419,-0.015018956132134775,0.09189955931099941,-10745526,-10850626,38.807182772835446,64.34184990292526,NaN,NaN,-0.7785721637753746,8.933956744563178
2003-11-24T09:30:00-05:00,19.53999,19.78999,19.48,19.77,515900,397376.85,53.72487156995966,52.95822983272886,NaN,NaN,-7.986183892116521,-74.81919094536285,-0.06903896723031297,0.005600850273108193,0.07463981750342116,-10229626,-10735606,41.68954539330973,62.02240717638835,NaN,NaN,0.577426334905867,7.740166686040705
2003-11-25T09:30:00-05:00,19.84,19.92,19.73,19.75,278600,393736.85,53.361178946486724,52.41420643824687,NaN,NaN,21.6298165949208,-54.60701295009462,-0.04363449376066082,0.02009670030259514,0.06373119406325596,-10508226,-10596946,45.04985670849086,59.858778789094494,NaN,NaN,1.5074707088889472,6.849781546447597
2003-11-26T09:30:00-05:00,19.83,19.94,19.64,19.83,177200,392316.85,54.6826814371944,51.78810673085347,NaN,NaN,19.715718055353623,-34.75165460724922,-0.020899681716452588,0.037606591917690224,0.05850627363414281,-10331026,-10548246,46.22205144541366,57.58084389112829,NaN,NaN,2.66584740499498,6.252076669097223
2003-11-28T09:30:00-05:00,19.81,19.97,19.78999,19.89999,97100,372616.85,55.861028758625515,51.39558093402742,NaN,NaN,41.176997305521475,-7.147531672550381,-0.0016211383612403998,0.056479850682592314,0.058100989043832714,-10233926,-10409666,49.52187295658153,55.46751495863419,NaN,NaN,3.9623580022837994,5.9249740024095905
2003-12-01T09:30:00-05:00,20,20.19,19.89999,20.10001,506900,362631.85,59.13156687168649,51.69005153109389,NaN,NaN,86.25373493185992,32.15801659910786,0.0227823753682546,0.08657895825415096,0.06379658288589636,-9727026,-10205966,53.99082617256409,53.840011552708724,NaN,NaN,6.060255822322885,5.9442999766829185
2003-12-02T09:30:00-05:00,20.07001,20.2,20.00999,20.00999,365400,350224.15,57.08161561987434,51.920478756587684,NaN,NaN,86.66237090973084,51.08772755947733,0.03055724787104136,0.10199314272469806,0.0714358948536567,-10092426,-10178526,54.57424772090354,52.29489230394178,NaN,NaN,7.2159976375479555,6.125971071092209
2003-12-03T09:30:00-05:00,20.19,20.27,19.91,19.94,265500,341340,55.4714327645463,51.510248266820675,NaN,NaN,74.24203665353686,61.610171571200546,0.02871066019655219,0.10732422009934695,0.07861355990279476,-10357926,-10148466,55.24379437442553,50.79317034056332,NaN,NaN,7.73032647812318,6.3551647006680625
2003-12-04T09:30:00-05:00,19.89999,20.19,19.85001,20.19,243400,343995,59.830232881156064,51.695552576189506,NaN,NaN,79.77294774630431,73.62161750939069,0.041285905701699016,0.13022094202991852,0.0889350363282195,-10114526,-10105166,56.24424914570025,49.785439183042385,NaN,NaN,9.465222097287784,6.79945861447088
2003-12-05T09:30:00-05:00,19.99001,20.08,19.81,19.83,373200,341750,51.944926946605,51.72667624504944,NaN,NaN,35.680779739418526,72.5223739961701,0.023218387838369575,0.11795802112618148,0.0947396332878119,-10487726,-10155926,54.70057893785855,49.12132860294589,NaN,NaN,8.60177534224857,7.056932432724836
2003-12-08T09:30:00-05:00,19.75,19.92999,19.67,19.88,322200,348145,52.87391767373519,52.18202656643627,NaN,NaN,17.878122639152625,58.84725153762863,0.013004031448966363,0.11099467259901985,0.09799064115005349,-10165526,-10243626,52.04291143054905,48.79010471752978,NaN,NaN,8.177755707537099,7.217050043412303
2003-12-09T09:30:00-05:00,19.98,20.05,19.42,19.45,362600,349600,44.8448072066935,52.346770866836984,NaN,NaN,-32.912707700811794,34.93223581552011,-0.022414779479835695,0.06997216680025886,0.09238694628009456,-10528126,-10330766,49.47096594131478,48.786901480417576,NaN,NaN,5.196621059060269,6.928417331362012
2003-12-10T09:30:00-05:00,19.56,19.64999,19.38,19.56,516200,367110,47.05954602015288,52.364759191107275,NaN,NaN,-57.96759606575037,8.490309271662662,-0.037261915348791044,0.045809552094105754,0.0830714674428968,-10011926,-10261566,51.51994039103002,49.27400317726306,NaN,NaN,3.4544618941311103,6.432137983186169
2003-12-11T09:30:00-05:00,19.59,20,19.53,19.92999,366300,370245,53.78201898117218,53.20590618193933,NaN,NaN,25.480002697731397,-2.368279738051927,-0.021759930575485656,0.05587155422353973,0.07763148479902539,-9645626,-10167786,54.2287420843256,50.236197533950175,NaN,NaN,4.09947763305973,6.098900790310964
2003-12-12T09:30:00-05:00,19.98,19.99001,19.78,19.95,202900,358090,54.1213269326225,53.84079661503646,NaN,NaN,51.87758577631902,0.8710814693281733,-0.010333655300957839,0.0647144156728281,0.07504807097378594,-9442726,-9958786,59.64096396643981,51.72432476206477,NaN,NaN,4.712213701038692,5.900802634700639
2003-12-15T09:30:00-05:00,20.3,20.3,19.67999,19.7,892600,385115,49.255920649713865,53.521585835018904,NaN,NaN,46.61485049946948,6.61842704139155,-0.019268794928260197,0.050962077313460696,0.07023087224172089,-10335326,-9992746,58.431928492479315,52.92020926914831,NaN,NaN,3.7291577603973702,5.590567652657315
2003-12-16T09:30:00-05:00,19.73,19.86,19.62,19.8,787500,391545,51.147741454699414,53.36348315703409,NaN,NaN,4.558550236804853,14.112678628914878,-0.018117580348486068,0.0475838968061133,0.06570147715459937,-9547826,-9796686,63.08465305905716,54.208409008474476,NaN,NaN,3.4919195339139257,5.290760778551117
2003-12-17T09:30:00-05:00,19.82001,19.82001,19.63,19.77,276600,385535,50.539007860577975,53.067506472990054,NaN,NaN,-8.426974400290936,24.020802962006766,-0.018959785593308867,0.04200174516296329,0.060961530756272156,-9824426,-9759186,63.9165742421499,55.472303493955636,NaN,NaN,3.1245105368113446,4.981296458302578
2003-12-18T09:30:00-05:00,19.73,20.17,19.73,20.10001,679200,388145,56.65084747174269,53.123922095355574,NaN,NaN,78.07397488976338,34.539597400413165,0.0020109323629195486,0.06347519620992159,0.06146426384700204,-9145226,-9659106,66.11154011771725,56.65727971975105,NaN,NaN,4.653068112311662,4.9344066945895895
2003-12-19T09:30:00-05:00,20.03,20.10001,19.77,19.89,1028300,421945,52.2279237948397,52.63080473272366,NaN,NaN,40.822711920841655,32.32862262931769,0.0010868501708457753,0.06282282656055926,0.06173597638971349,-10173526,-9805266,60.33879280079126,57.11070590748157,NaN,NaN,4.61122763024584,4.888238256826197
2003-12-22T09:30:00-05:00,19.84,19.99001,19.8,19.92,380300,431895,52.79489108136295,52.32461012282999,NaN,NaN,22.670069505533185,27.539666430530428,0.0018023736755560169,0.06398894348415851,0.062186569808602495,-9793226,-9696846,62.924936924736464,57.70718370775535,NaN,NaN,4.742669775267709,4.867442759460698
2003-12-23T09:30:00-05:00,19.97,20.10001,19.95,20.08,526500,432425,55.8073253739709,52.3486024520746,NaN,NaN,95.09965051144808,45.647886485459075,0.011800249664213502,0.07693688188886938,0.06513663222465588,-9266726,-9640626,64.22750997357758,58.34887767912335,NaN,NaN,5.735291687145826,4.991421177701431
2003-12-24T09:30:00-05:00,20.08,20.13,20,20.03999,947600,465875,54.864453056859944,51.993903893196304,NaN,NaN,93.96595124709101,66.12647161493547,0.014300953084624049,0.08301282358043593,0.06871187049581189,-10214326,-9718606,61.024897988491986,58.690352596465615,NaN,NaN,6.291129450222398,5.177093788061569
2003-12-26T09:30:00-05:00,20.13,20.16,20.05,20.08,305600,472295,55.671008470778375,52.260052573494406,NaN,NaN,105.26278362772908,71.5642333625286,0.017045577671935735,0.09001884258573156,0.07297326491379583,-9908726,-9871306,55.218481449073664,58.72734563298098,NaN,NaN,6.97470640552081,5.433895590555746
2003-12-29T09:30:00-05:00,20.12,20.45,20.10001,20.44,616900,498285,62.213854836203176,52.92719094224211,NaN,NaN,190.11412041940974,101.42251506224223,0.04018137349051412,0.12319998177693847,0.08301860828642435,-9291826,-9694966,59.956820784652756,59.29262487255981,NaN,NaN,9.569304985578581,6.024668361273294
2003-12-30T09:30:00-05:00,20.45,20.49001,20.35001,20.41,380000,491940,61.40054775404123,54.10974383848123,NaN,NaN,195.8012216760546,136.0487454963465,0.04990467338038693,0.14539945001190802,0.09549477663152109,-9671826,-9670686,60.575374540684095,60.08579691537191,NaN,NaN,11.46371029357375,6.80167435160193
2003-12-31T09:30:00-05:00,20.53,20.53,20.32001,20.38,352000,491270,60.54812927594832,55.073214071038045,NaN,NaN,166.588373667823,150.3464901276215,0.05059782637284031,0.15874205959757148,0.10814423322473117,-10023826,-9822106,54.881663685709775,60.325920007849035,NaN,NaN,12.80617750333847,7.659460516135721
2004-01-02T09:30:00-05:00,20.46001,20.64999,20.38,20.48,274300,491710,62.42092383073302,55.69027870314954,NaN,NaN,168.7147275181784,165.29624538183896,0.0537756956228692,0.17536385275331767,0.12158815713044847,-9749526,-9729146,57.52143722549299,60.561112517932415,NaN,NaN,14.476781601411522,8.633363528317979
2004-01-05T09:30:00-05:00,20.60001,21.03,20.60001,20.98,670600,513070,70.07105150448905,56.82954474399715,NaN,NaN,224.59519150598447,189.16272695749004,0.08374884756796472,0.22627421659040436,0.14252536902243965,-9078926,-9563186,61.81660496675238,60.71651544652617,NaN,NaN,18.568050589753483,10.05260453709448
2004-01-06T09:30:00-05:00,21.03,21.2,20.91,21.17,462900,517555,72.37265258529932,58.48073988225326,NaN,NaN,215.92140697684167,194.32418426897644,0.10897116509445978,0.2787393253905144,0.1697681602960546,-8616026,-9428026,64.92698105820597,61.180447772649494,NaN,NaN,22.76829689647061,11.869132017005356
2004-01-07T09:30:00-05:00,21.25,21.32001,21.00999,21.27,510800,526985,73.52658314385485,60.07922857433579,NaN,NaN,186.642318467139,192.49240362719328,0.12390159901224568,0.3246451590613617,0.20074356004911603,-8105226,-9114706,70.85406382744412,61.73540568467714,NaN,NaN,26.576093806867444,13.970126558414226
2004-01-08T09:30:00-05:00,21.55,21.71001,21.35001,21.69,1877600,602735,77.73319437782237,62.02167046842467,NaN,NaN,202.54456089419253,199.6836410724672,0.15173785726845748,0.3904158816346879,0.2386780243662304,-6227626,-8355466,79.77388233254858,62.868070548277046,NaN,NaN,31.49347593304724,16.4734621833618
2004-01-09T09:30:00-05:00,21.31,21.71001,21.31,21.39999,523200,603085,69.51884292203559,62.94081300058844,NaN,NaN,157.78584687647995,197.4978649441275,0.14054699278029237,0.41436176534159586,0.2738147725613035,-6750826,-7755726,83.95189981802025,64.14238195544155,NaN,NaN,32.89512822824897,18.81941447548854
2004-01-12T09:30:00-05:00,21.5,21.74001,21.25,21.73,438800,606710,73.01355394677091,64.42550086858354,NaN,NaN,144.74662352848748,181.5281513486281,0.14472922033941,0.45472629798556596,0.30999707764615597,-6312026,-7202346,86.684939800266,66.02424959826116,NaN,NaN,35.29646996412977,21.173279545294427
2004-01-13T09:30:00-05:00,21.75,21.78999,21.28999,21.42,1135200,653325,65.42525358694556,65.3276696189823,NaN,NaN,115.52328670312579,161.44852729388495,0.11715395469922163,0.45643952102018304,0.3392855663209614,-7447226,-6968586,87.64233285887333,67.78977787927094,NaN,NaN,34.63393905449889,23.096230903752208
2004-01-14T09:30:00-05:00,21.52,21.7,21.45,21.67999,1012800,659335,68.39223262759077,66.22659156566942,NaN,NaN,110.47005841156567,146.21407528277027,0.10722766119627253,0.4733201428163021,0.36609248162002955,-6434426,-6634426,88.87390243306857,69.5502344835203,NaN,NaN,35.112249096410885,24.812804931274876
2004-01-15T09:30:00-05:00,21.63,21.91,21.53999,21.77,347000,637310,69.37215290861758,67.26285584079497,NaN,NaN,109.45979649239943,127.59712240241167,0.09779163419386783,0.48833202436236434,0.3905403901684965,-6087426,-6606386,88.97320942222473,71.54654244307265,NaN,NaN,35.80805104751044,26.383554376451386
2004-01-16T09:30:00-05:00,21.84,22.06,21.8,22.05,516300,649295,72.25386971926379,68.4473459299725,NaN,NaN,119.10661030231812,119.86127508757929,0.101059379896901,0.5168646150396228,0.4158052351427218,-5571126,-6370446,89.79832833521456,74.01653150636842,NaN,NaN,37.34747044517269,27.94982810055443
2004-01-20T09:30:00-05:00,22.21001,22.24001,21.96001,22.10001,715100,651090,72.74707917123925,69.19971909676079,NaN,NaN,118.38948685003696,114.5898477518892,0.09721054431885973,0.5373184155412964,0.4401078712224367,-4856026,-6079246,90.72118530396399,76.21398611489066,NaN,NaN,38.71723795045093,29.4880295076825
2004-01-21T09:30:00-05:00,21.92,22.05,21.75,21.92999,635700,631460,68.30189688028794,69.69267260577841,NaN,NaN,90.77366387946863,109.63992318715778,0.07483957272185998,0.5336573371247617,0.45881776440290173,-5491726,-5688146,91.79476700533377,78.4439427195085,NaN,NaN,38.484454908693145,30.773233136398307
2004-01-22T09:30:00-05:00,21.89999,22.07001,21.67999,21.72,479700,636430,63.16792035264377,69.8798005398281,NaN,NaN,75.94482402751237,102.73487631034709,0.03931064185145483,0.5079560667172203,0.46864542486576544,-5971426,-5595546,92.0299003409891,81.0973881948856,NaN,NaN,36.68707757672121,31.618068056444436
2004-01-23T09:30:00-05:00,21.71001,21.89999,21.52,21.64999,660500,643130,61.507956765157296,69.81458860657268,NaN,NaN,56.57594742509184,92.15810649688557,0.006240641962205529,0.4764462273185224,0.47020558535631685,-6631926,-5704446,88.80681963114665,83.332058366718,NaN,NaN,34.72524281689166,32.06195016507975
2004-01-26T09:30:00-05:00,21.75,22.08,21.64999,22.05,3832100,787355,66.86562927723273,69.58562987605437,NaN,NaN,78.3609780295426,84.00898004233048,0.006426791076507787,0.47823907420195155,0.47181228312544377,-2799826,-5150186,90.6094392618734,85.38868938779808,NaN,NaN,34.62209901681702,32.42768571532793
2004-01-27T09:30:00-05:00,21.97,22.11,21.67,21.71001,479600,796055,59.30934474202286,68.65253645867747,NaN,NaN,62.55958639382722,72.84299995108852,-0.019792227318540412,0.44707199897726824,0.46686422629580865,-3279426,-4834866,91.45277127022655,87.2833886886567,NaN,NaN,32.03785271025622,32.371995286031975
2004-01-28T09:30:00-05:00,21.75,21.89999,21.28,21.35001,3897500,960085,52.53903553590537,67.15342591525251,NaN,NaN,11.847034275349959,57.057674030264785,-0.06241892984958547,0.3888405639838268,0.4512594938334123,-7176926,-5171906,82.8844681029455,88.14270327976394,NaN,NaN,27.50526142164857,31.67674759112006
2004-01-29T09:30:00-05:00,21.37,21.5,20.98,21.24001,649500,973560,50.63695953296904,65.21798056919155,NaN,NaN,-44.60228508331615,32.94825220809908,-0.09699840742184773,0.33001148455610263,0.42700989197795036,-7826426,-5542906,74.59915355634364,87.77307979574928,NaN,NaN,23.273844897557264,30.47633292061109
2004-01-30T09:30:00-05:00,21.23,21.39,21.17,21.25,360900,974005,50.81112823610259,63.88171523448206,NaN,NaN,-55.234364362567696,10.586189850567163,-0.11684276646362923,0.28095643389841385,0.3977992003620431,-7465526,-5709626,71.15683586098186,86.85914665596083,NaN,NaN,19.989337780737205,28.978190757771962
2004-02-02T09:30:00-05:00,21.35001,21.5,21.12,21.25,2084100,1064495,50.811128236102576,62.29582768372004,NaN,NaN,-69.41143995313432,-18.968293745968214,-0.1267823947468732,0.2393212069284516,0.3661036016753248,-7465526,-6642766,55.67224952987741,84.64395449379023,NaN,NaN,17.348078437166915,27.31674614054267
2004-02-03T09:30:00-05:00,21.17999,21.36,21.17999,21.28,533100,1057620,51.40824047760028,61.29461246162395,NaN,NaN,-85.99522455983276,-48.679255936700216,-0.12778938530052908,0.20636687004966348,0.33415625535019255,-6932426,-7373366,47.04094294076869,81.7438552139256,NaN,NaN,15.32370603782729,25.603454697297614
2004-02-04T09:30:00-05:00,20.89999,21.03999,20.69,20.75999,687400,1068845,41.91109224405151,59.40310243422829,NaN,NaN,-195.18640288965105,-90.0859433697004,-0.15795387888854712,0.13671390673950867,0.2946677856280558,-7619826,-7461946,46.10757949458732,78.68911786117694,NaN,NaN,10.38949410419523,23.430031755425844
2004-02-05T09:30:00-05:00,20.75999,20.91,20.67999,20.78999,298800,1058245,42.57025341940645,57.48868104214177,NaN,NaN,-183.23360634767184,-117.81220762257153,-0.16935209578833388,0.08297766589263844,0.2523297616809723,-7321026,-7360866,47.39036573547081,75.71891474069453,NaN,NaN,6.608827035754122,21.027002509758454
2004-02-06T09:30:00-05:00,20.78,21.23,20.78,21.23,648900,996810,51.29917688711408,55.99191726841679,NaN,NaN,-99.58607782954304,-126.6825503159666,-0.14183859263399387,0.07503152088847997,0.21687011352247385,-6672126,-7202186,49.42553052786987,72.83514346874134,NaN,NaN,5.879500744241444,18.863073686113168
2004-02-09T09:30:00-05:00,21.14999,21.25999,21.06,21.07001,417700,991535,48.4175260586446,54.2540920460886,NaN,NaN,-79.66764836873796,-128.73379199908734,-0.12934559994126474,0.05518811359589293,0.18453371353715767,-7089826,-7127046,50.40392786833888,69.95533936619668,NaN,NaN,4.377449198207076,16.79369875926944
2004-02-10T09:30:00-05:00,21.05,21.3,21.05,21.24001,225500,980870,51.53295781320221,53.05631068415391,NaN,NaN,-58.96063332050961,-123.3268737512227,-0.10556807986149103,0.0525736137102939,0.15814169357178492,-6864326,-7113426,50.59051635542634,67.01217860548901,NaN,NaN,4.08649936822945,14.978384560549442
2004-02-11T09:30:00-05:00,21.2,21.48,21.2,21.41,673200,957770,54.492715337863174,52.43665318309815,NaN,NaN,-23.180955085656198,-88.92578419042374,-0.07572412069461865,0.06348654270351162,0.13921066339813026,-6191126,-6827686,54.46128281360344,64.32870592496145,NaN,NaN,4.752224766136617,13.517504589919039
2004-02-12T09:30:00-05:00,21.28,21.48,21.21001,21.21001,337600,924010,50.579332800560486,51.65603718562694,NaN,NaN,-32.69796790436864,-58.8186565017631,-0.06708097335952257,0.055359446698727055,0.12244042005824962,-6528726,-6669226,56.496649467128485,62.02083662753159,NaN,NaN,4.1278235377230565,12.17612158246247
2004-02-13T09:30:00-05:00,21.32001,21.46001,21.00999,21.08,1156600,964490,48.15810100625844,50.31978516627164,NaN,NaN,-51.31591318033676,-49.16462357192184,-0.0675603209967015,0.03799001881237274,0.10555033980907425,-7685326,-6871866,53.22073226356024,59.35021469908065,NaN,NaN,2.8835405780393466,10.848610010402023
2004-02-17T09:30:00-05:00,21.33,21.44,21.23,21.39,357200,956535,53.8330745821134,49.9286230119924,NaN,NaN,-11.571944638360257,-35.54548282584629,-0.045497949661171336,0.04867790273261008,0.09417585239378141,-7328126,-6919526,52.450409639691834,56.56433172547104,NaN,NaN,3.5557472911519783,9.806772479080589
2004-02-18T09:30:00-05:00,21.33,21.42999,21.25999,21.28999,737400,957650,51.86070727934355,49.88017099366656,NaN,NaN,-10.51649665621739,-25.85665549298786,-0.03652559285227654,0.04851886132843575,0.08504445418071228,-8065526,-7159766,48.629493402068796,54.117547818265564,NaN,NaN,3.515555867378666,8.908027248837458
2004-02-19T09:30:00-05:00,21.55,21.56,20.96001,20.97,854800,968605,46.04742250710389,49.55234692039047,NaN,NaN,-50.19102289175705,-31.25866905420802,-0.05018350979512559,0.022315066936805295,0.07249857673193089,-8920326,-7705606,41.27273341430538,51.7370892366914,NaN,NaN,1.6601379061769568,7.872614485600243
2004-02-20T09:30:00-05:00,21.10001,21.10001,20.72,20.87,558600,972550,44.37342654493657,49.09251108530719,NaN,NaN,-125.48020808456707,-49.81511709024771,-0.06315604709637612,-0.006446482138539267,0.056709564957836855,-9478926,-8295646,35.09253566412255,49.1610677940586,NaN,NaN,-0.36645841998311396,6.695604070516906
2004-02-23T09:30:00-05:00,20.91,21,20.45,20.59,1140700,996560,39.989731965609984,48.31955420884343,NaN,NaN,-172.46125908879438,-74.04418627193924,-0.08636219395554168,-0.05124317748659024,0.035119016468951436,-10619626,-8882506,30.24202228642112,47.344622990954576,NaN,NaN,-3.5049534603975014,5.238381566100562
2004-02-24T09:30:00-05:00,20.45,20.74001,20.42,20.61,1091300,859520,40.442328970993835,47.536274815514396,NaN,NaN,-177.74212610696807,-107.2782225656608,-0.09542392840834638,-0.08416089404148153,0.011263034366864842,-9528326,-9322546,27.20552814088113,45.927807648105464,NaN,NaN,-5.886390779972901,3.6491283738043534
2004-02-25T09:30:00-05:00,20.64999,20.82001,20.63,20.77,554200,863250,44.0761052820189,47.69091860394064,NaN,NaN,-114.165656217052,-128.00805447782773,-0.08599322472423579,-0.09622849653842991,-0.010235271814194112,-8974126,-9504266,26.04262989986556,44.49459696276819,NaN,NaN,-6.853717832549616,2.1487217728966437
2004-02-26T09:30:00-05:00,20.74001,20.94,20.62,20.82001,435000,690125,45.20151481948887,47.87886584680367,NaN,NaN,-85.27736205858974,-135.02532231119426,-0.07228950103410761,-0.10059714810682863,-0.028307647072721015,-8539126,-9428026,27.443904655116356,43.069849742742875,NaN,NaN,-7.333717617875704,0.7940875742148796
2004-02-27T09:30:00-05:00,20.91,20.95,20.62,20.71001,356800,675490,43.14485388710467,47.29641420394586,NaN,NaN,-83.45212470754261,-126.61970563578936,-0.06667260501847176,-0.11164840334581072,-0.04497579832733896,-8895926,-9311426,29.639592172379494,41.65656843163642,NaN,NaN,-8.314406782949964,-0.507125905380098
2004-03-01T09:30:00-05:00,20.74001,21.03,20.72,20.96001,572300,686060,48.84197539775733,47.32673201388248,NaN,NaN,-37.32018089425623,-99.59148999688173,-0.04329250356426003,-0.099091427782664,-0.05579892421840397,-8323626,-8852226,37.64291683244471,40.74506764335826,NaN,NaN,-7.531954532900093,-1.5106728521686685
2004-03-02T09:30:00-05:00,21,21.22,20.75999,20.88,520700,607890,47.21147025512872,47.01805433116294,NaN,NaN,-18.711877636227452,-67.78544030273362,-0.030966187487314542,-0.09450665857754714,-0.0635404710902326,-8844326,-8715426,39.838401238879804,39.97705942074781,NaN,NaN,-7.335372913896511,-2.3427728609869316
2004-03-03T09:30:00-05:00,20.8,20.89999,20.69,20.78,413300,601900,45.18131956039394,46.35295463277229,NaN,NaN,-61.72184659664453,-57.29667837865212,-0.02741947268907173,-0.09781481195157227,-0.07039533926250054,-9257626,-8772126,39.22201056133876,38.88853997415747,NaN,NaN,-7.7324952906870195,-3.112733208086944
2004-03-04T09:30:00-05:00,20.78999,20.99001,20.77,20.96001,399500,587505,49.39942577428148,46.268675559466644,NaN,NaN,-27.566182993633102,-45.754442565660796,-0.011629487963338458,-0.08493219921667361,-0.07330271125333515,-8858126,-8835926,38.50017354260848,37.60307740812032,NaN,NaN,-6.873537470622386,-3.6499909598777216
2004-03-05T09:30:00-05:00,20.78,21.07001,20.7,20.8,386400,591885,46.01036185766286,46.11526562028125,NaN,NaN,-44.72462449464528,-38.00894252308132,-0.010666172025453724,-0.0866354262851523,-0.07596925425969858,-9244526,-8905646,37.68399050058762,36.493310139336565,NaN,NaN,-7.0961737757409615,-4.142302790715327
2004-03-08T09:30:00-05:00,20.81,20.92999,20.35001,20.35001,592600,589070,38.095068149904286,44.99112230369487,NaN,NaN,-127.16557365185366,-55.97802107460082,-0.03752795924701058,-0.1228792033184618,-0.08535124407145123,-9837126,-9208346,34.285578080512934,35.19582217082379,NaN,NaN,-9.835719192727584,-4.955647991002792
2004-03-09T09:30:00-05:00,20.41,20.42999,20.16,20.35001,470600,591715,38.095068149904286,44.007862365877784,NaN,NaN,-171.8646789803886,-86.60858134343303,-0.051618998442361175,-0.1498749921244027,-0.09825599368204152,-9837126,-9406906,32.23218110600044,34.02458557824748,NaN,NaN,-11.999478756845141,-5.96190952898027
2004-03-10T09:30:00-05:00,20.3,20.42,19.92999,19.99001,2590700,709975,32.85140964565797,43.06529001863165,NaN,NaN,-196.81985405525919,-113.62818283515597,-0.07982361346189179,-0.19803551050940627,-0.11821189704751447,-12427826,-10040946,26.727529519294592,32.985642442889564,NaN,NaN,-15.647762447313054,-7.34560280302781
2004-03-11T09:30:00-05:00,19.78,20.19,19.73,19.77,1214800,737055,30.122545482981323,42.047369942777706,NaN,NaN,-214.93807547915486,-151.1025613322603,-0.1062800429378069,-0.2510619507197731,-0.1447819077819662,-13642626,-10997846,20.92057589854096,31.97335960249088,NaN,NaN,-19.618821719359985,-9.098919791075264
2004-03-12T09:30:00-05:00,20.03,20.17,19.92,20.16,284300,734390,39.68672442270778,42.02572654685612,NaN,NaN,-147.4936084334882,-171.65635812002887,-0.0910822070111485,-0.25863466654590184,-0.16755245953475334,-13358326,-11820606,17.416713478463237,31.05726611620818,NaN,NaN,-19.89805076266605,-10.641652787016804
2004-03-15T09:30:00-05:00,20.07001,20.10001,19.73,19.78,706800,711900,34.702726153821146,41.61575491705808,NaN,NaN,-161.65630151399372,-178.5545036924569,-0.09950498654567688,-0.29193369271684944,-0.19242870617117255,-14065126,-12666206,14.69300552140075,30.16351450053101,NaN,NaN,-21.876744504474292,-12.24666588951073
2004-03-16T09:30:00-05:00,19.88,19.99001,19.67,19.89999,881900,738135,37.377039917630476,41.13725024817318,NaN,NaN,-140.5323268605297,-172.28803326848512,-0.0901561884984049,-0.3051239417941787,-0.21496775329577378,-13183226,-13335426,12.964963667838774,29.22939548395767,NaN,NaN,-22.542145293833443,-13.717448661556832
2004-03-17T09:30:00-05:00,20.10001,20.21001,19.95,20.14999,1122600,757395,42.64750859679366,40.95482123226638,NaN,NaN,-82.09329274065422,-149.34272100556413,-0.061656170694081525,-0.29203796666337567,-0.23038179596929415,-12060626,-13261986,14.15810353921249,28.280409689964536,NaN,NaN,-21.32920016703026,-14.80484173376732
2004-03-18T09:30:00-05:00,19.98,20.08,19.81,20.02,385500,733930,40.72811275556175,40.782196865727606,NaN,NaN,-93.47367212728206,-125.04984033518959,-0.046756104583473734,-0.2888269266986363,-0.24207082211516256,-12446126,-13022686,18.098014333187763,27.456011272879408,NaN,NaN,-20.962901917272546,-15.68456461712521
2004-03-19T09:30:00-05:00,19.92999,20.05,19.72,19.75,460100,729005,37.002946224214305,39.936551924760245,NaN,NaN,-102.92315689345271,-116.13575002718248,-0.04998985529732425,-0.3045581412368179,-0.25456828593949365,-12906226,-12932266,19.599605660847672,26.167203332051052,NaN,NaN,-21.855507544392196,-16.566127892449064
2004-03-22T09:30:00-05:00,19.47,19.52,19.25999,19.42999,628400,703390,33.13466165508245,38.93106559618551,NaN,NaN,-152.69574033932346,-114.34363779224843,-0.067497596905788,-0.33894028207172866,-0.27144268516594067,-13534626,-12826166,21.420161552505206,24.8516147830243,NaN,NaN,-23.90198624424758,-17.61410765699171
2004-03-23T09:30:00-05:00,19.47,19.66,19.28,19.39999,406900,669170,32.788604816058694,38.04587168587585,NaN,NaN,-127.74087283086536,-111.78534698631556,-0.07437261336808071,-0.36440845187604154,-0.29003583850796083,-13941526,-12977826,20.698674207930083,23.528519329209395,NaN,NaN,-25.616632914176407,-18.757325550875237
2004-03-24T09:30:00-05:00,19.39999,19.69,19.33,19.5,626100,672765,35.21761149200276,37.03288495142738,NaN,NaN,-106.7743882674305,-116.72156609167082,-0.06575639927265553,-0.37223133759878024,-0.3064749383261247,-13315426,-13228786,19.526611116293083,22.173264870186866,NaN,NaN,-26.291622639203005,-19.83365370635063
2004-03-25T09:30:00-05:00,19.77,20.13,19.71001,20.12,732400,687635,47.80995155119094,37.16142707239367,NaN,NaN,-33.18085645410489,-104.6630029570354,-0.014547839015521369,-0.3246597370955264,-0.31011189808000506,-12583026,-13256166,19.397557809364415,20.86709110652807,NaN,NaN,-22.642198143983908,-20.23487434029824
2004-03-26T09:30:00-05:00,20.02,20.19,20,20,871100,713350,45.94832151109544,37.722373741050184,NaN,NaN,-17.47572333797055,-87.57351624593898,0.013480427560863706,-0.2932613636289254,-0.3067417911897891,-13454126,-13365746,18.86031123932149,19.76528633215725,NaN,NaN,-20.33097231136739,-20.24860262187955
2004-03-29T09:30:00-05:00,20.28,20.36,20.13,20.25999,403300,704900,50.450041244753756,38.60487181925372,NaN,NaN,20.542627519475502,-52.92584267417917,0.04972979653947446,-0.24457954551544603,-0.2943093420549205,-13050826,-13268986,20.942494499182672,18.95888014595598,NaN,NaN,-16.90996116057321,-19.771653841692928
2004-03-30T09:30:00-05:00,20.17999,20.32001,20.06,20.28999,673900,712560,50.95760457393572,39.89817145698783,NaN,NaN,25.55791676440249,-22.26608475512561,0.07444097264643756,-0.20125812624687356,-0.2756990988933111,-12376926,-12956066,27.42845263974624,19.008946083131097,NaN,NaN,-14.048344998335525,-18.95403829264187
2004-03-31T09:30:00-05:00,20.21001,20.35001,20.16,20.16,448300,714310,48.63298832765025,41.22034594589276,NaN,NaN,34.756416503989996,6.04007619915851,0.08024497823987131,-0.17539287609347198,-0.2556378543333433,-12825226,-12858026,29.38321356500616,19.613420202164328,NaN,NaN,-12.357928140591055,-18.011736842348895
2004-04-01T09:30:00-05:00,20.28,20.49001,20.24001,20.37,452400,716955,52.41002962292944,42.1291534601943,NaN,NaN,81.13363158005716,28.902973805990918,0.09540855306838658,-0.13637716299786007,-0.23178571606624665,-12372826,-12815986,30.250795721853763,20.53014036240651,NaN,NaN,-9.766925643128255,-16.833906671031663
2004-04-02T09:30:00-05:00,20.91,20.91,20.64,20.88,1479000,771585,60.085925285988345,43.94223911249197,NaN,NaN,195.32852935345332,71.46382434427571,0.13457146867302044,-0.06357138022497111,-0.19814284889799155,-10893826,-12303926,39.93121824372846,22.33286984257277,NaN,NaN,-4.8258684018888856,-15.118472632582694
2004-04-05T09:30:00-04:00,20.84,21.10001,20.84,21.06,442900,764100,62.39153727810651,45.72898892395454,NaN,NaN,220.3738358926197,111.43006601890454,0.165357176724047,0.008553622007067219,-0.1568035547169798,-10450926,-11783946,47.8468577466837,24.82443370534741,NaN,NaN,-0.026054087189182985,-12.962412840383621
2004-04-06T09:30:00-04:00,20.75,20.95,20.75,20.84,259000,753520,57.98298887075951,46.82438037209496,NaN,NaN,162.0532699394131,138.72913665390666,0.16337442770580696,0.04741447991527892,-0.11595994779052804,-10709926,-11450546,52.19656406470708,27.541466600025593,NaN,NaN,2.588047209196342,-10.740918547586483
2004-04-07T09:30:00-04:00,20.85001,20.85001,20.53999,20.71001,716200,659795,55.48815210407299,47.87866889698862,NaN,NaN,111.89670800014648,154.15719495313795,0.14632884815916544,0.06695111240842877,-0.07937773575073667,-11426126,-11170726,55.547552817151924,30.216433634594466,NaN,NaN,3.9579347274345817,-8.641082365440617
2004-04-08T09:30:00-04:00,21,21,20.63,20.75,342700,616190,56.113751241942765,49.243726398254935,NaN,NaN,112.53819822158124,160.4381082814428,0.13124994915065774,0.08468470068758549,-0.04656524846307224,-11083426,-10912846,58.439050884873694,32.99067972202489,NaN,NaN,5.247289311506152,-6.657029268733936
2004-04-12T09:30:00-04:00,20.83,20.85001,20.75,20.8,269400,615445,56.92885006822025,50.94331128490764,NaN,NaN,99.9026072428649,141.35292385932507,0.11853385783680655,0.10160207383293596,-0.016931784003870593,-10814026,-10896886,58.61845559282925,35.647700724905185,NaN,NaN,6.53903241696517,-4.7718775993483495
2004-04-13T09:30:00-04:00,20.85001,20.88,20.50999,20.53999,501400,605175,51.565392317888445,52.2845103921812,NaN,NaN,66.36541321574798,110.55123932395074,0.08791105053073048,0.09295702915954251,0.00504597862881203,-11315426,-11069786,55.80790820006856,38.155503152915074,NaN,NaN,6.123431039532711,-3.215404936651055
2004-04-14T09:30:00-04:00,20.47,20.64,20.39,20.52,264500,574305,51.166272166793135,53.42370044038051,NaN,NaN,40.286219358088545,86.19782920768583,0.0627871073150222,0.08352986277258978,0.02074275545756758,-11579926,-11243786,53.05120064444069,40.55011669063991,NaN,NaN,5.671656685494909,-1.9458247049159172
2004-04-15T09:30:00-04:00,20.5,20.61,20.09,20.28,702400,553295,46.51159375553523,53.33096059783367,NaN,NaN,6.900393816941249,65.19856637104479,0.02824315546454651,0.05604669978825072,0.02780354432370421,-12282326,-11415026,50.41201660045182,42.76543517571758,NaN,NaN,3.923958586844446,-1.1072842346644367
2004-04-16T09:30:00-04:00,20.14,20.22,19.98,20.09,308400,549440,43.16384346719167,53.1320693089834,NaN,NaN,-33.57659887662959,35.97560695140261,-0.007267712938554875,0.018718903150510613,0.025986616089065488,-12590726,-11716486,46.06716356073211,44.70878177010405,NaN,NaN,1.4244455928038968,-0.7456085450261034
2004-04-19T09:30:00-04:00,20.06,20.33,20.03999,20.32001,261400,539505,48.03960112569037,52.95989501476459,NaN,NaN,-14.767929246693324,13.041499653490968,-0.014702465935984226,0.0076085336690852046,0.02231099960506943,-12329326,-12019546,42.13552953811517,46.22256998717065,NaN,NaN,0.6673453566079837,-0.5437579876498053
2004-04-20T09:30:00-04:00,20.42,20.48,19.88,19.88,259500,521060,40.824551193376564,52.23610548758179,NaN,NaN,-52.566463659193815,-10.744875721497388,-0.04687551290164826,-0.03628339152199089,0.010592121379657364,-12588826,-12274226,39.11440101295617,47.05728058525708,NaN,NaN,-2.361761408588777,-0.8034727620696585
2004-04-21T09:30:00-04:00,20.02,20.17999,19.92999,20.17999,524200,526925,46.70188932735101,52.09816984470327,NaN,NaN,-60.77842248103944,-30.957804089322984,-0.04553556897991341,-0.046327339845234405,-0.0007917708653209909,-12064626,-12371166,37.99761506303157,47.67259497797318,NaN,NaN,-3.0457945803060453,-1.1238044503891422
2004-04-22T09:30:00-04:00,19.98,20.58,19.98,20.49001,785200,534880,52.00689202701883,52.06937430213823,NaN,NaN,-17.01762057944344,-35.741406968599925,-0.02251669775831601,-0.028937643063216,-0.006420945304899993,-11279426,-12170586,41.70633399194121,48.49084771155086,NaN,NaN,-1.8657220756860209,-1.2297926825744105
2004-04-23T09:30:00-04:00,20.7,20.8,20.56,20.75999,504900,523505,56.10441330456762,51.784980589179604,NaN,NaN,61.59627876478131,-16.706831440317746,0.010379478687497458,0.006553403054471829,-0.0038260756330256284,-10774526,-11807346,47.796207900990055,49.05263268706955,NaN,NaN,0.4878609145879643,-0.9844135972654998
2004-04-26T09:30:00-04:00,20.73,20.81,20.47,20.50999,213200,490610,51.702448629876685,51.02147425716318,NaN,NaN,29.356606075612785,-7.881924375856525,0.01453452100161342,0.014342075618991146,-0.00019244538262227313,-10987726,-11539026,51.80175820297716,49.33512557680479,NaN,NaN,0.9928219685602067,-0.7019513735761131
2004-04-27T09:30:00-04:00,20.53,20.7,20.39999,20.45,268000,483845,50.674984453659924,50.49947394165606,NaN,NaN,5.527370971961354,3.736842550374509,0.012550230254892873,0.01549534243599382,0.0029451121811009456,-11255726,-11272406,55.45892832370216,49.568151595304435,NaN,NaN,1.072107355487113,-0.44851441228136657
2004-04-28T09:30:00-04:00,20.38,20.38,20.05,20.10001,738400,487070,45.05010935224311,49.7538994593825,NaN,NaN,-84.65047837141775,-1.037568627701146,-0.011713782736415105,-0.011697116239417937,0.000016666496997168496,-11994126,-11258306,55.65058015865379,49.575510691126,NaN,NaN,-0.6792386051036227,-0.4814750112559746
2004-04-29T09:30:00-04:00,20.03999,20.16,19.61,19.8,472000,488255,40.86300015423464,48.66456009597478,NaN,NaN,-152.82688761168,-28.199422034148462,-0.04545402942737873,-0.056800870287226246,-0.011346840859847517,-12466126,-11495646,51.62396446811474,49.08871880421464,NaN,NaN,-3.545257219821682,-0.9191581839082186
2004-04-30T09:30:00-04:00,19.75999,19.86,19.39,19.39,524400,491855,35.94598411518359,47.16578395647216,NaN,NaN,-187.87137747621782,-78.09295328234829,-0.09028078224731047,-0.1241978186689856,-0.03391703642167514,-12990526,-11938846,45.06647538943092,48.120720218257624,NaN,NaN,-7.710330100712882,-1.889325600594599
2004-05-03T09:30:00-04:00,19.52,19.72,19.35001,19.5,387000,437255,38.098115390508625,46.20383560451646,NaN,NaN,-165.1546547908217,-116.99520545563519,-0.10631549652219838,-0.1668114070744231,-0.060495910552224724,-12603526,-12262006,40.979043138716484,47.0615155710182,NaN,NaN,-10.330848660427382,-3.0952574662849965
2004-05-04T09:30:00-04:00,19.59,19.91,19.50999,19.69,599000,445060,41.739307849916145,45.53048101045382,NaN,NaN,-116.73503004297783,-141.44768565862302,-0.09811562498573101,-0.18314044178438849,-0.08502481679865748,-12004526,-12411766,39.20446385230898,46.07246294300878,NaN,NaN,-11.346908875764901,-4.274064810496411
2004-05-05T09:30:00-04:00,19.72,19.88,19.62,19.78999,734100,468815,43.61888884358578,45.323859231028855,NaN,NaN,-94.58760966830899,-143.43511191800127,-0.08067643794437371,-0.18587036422912462,-0.10519392628475091,-11270426,-12267026,41.82648575400884,45.45921073969142,NaN,NaN,-11.601423991932496,-5.320830407844423
2004-05-06T09:30:00-04:00,19.61,19.74001,19.46001,19.7,475400,456775,42.2963434249933,45.2618949423004,NaN,NaN,-107.47133822434142,-134.36400204053356,-0.07030061979227546,-0.19306970102509524,-0.12276908123281978,-11745826,-12122966,44.39690018880932,45.33990621312551,NaN,NaN,-12.19811099358362,-6.303299062950023
2004-05-07T09:30:00-04:00,19.64,19.92,19.60001,19.60001,417500,460515,40.81550336619815,44.74588795947953,NaN,NaN,-84.94443520768259,-113.77861358682651,-0.06537384925784812,-0.20448639280512992,-0.1391125435472818,-12163326,-11957526,47.27795734227842,45.70722248485146,NaN,NaN,-13.119468550093224,-7.277037561113337
2004-05-10T09:30:00-04:00,19.41,19.60001,19.36,19.52,425300,468310,39.620156619480305,44.65985977562979,NaN,NaN,-114.7180109648744,-103.69128482163705,-0.06269662850779051,-0.21748332918201996,-0.15478670067422945,-12588626,-11954546,47.33089554955526,46.29411495175139,NaN,NaN,-14.224222434899511,-8.26949254308279
2004-05-11T09:30:00-04:00,19.66,19.83,19.66,19.78,381400,462310,45.23321729472724,44.554954630442374,NaN,NaN,-55.636629577810396,-91.47160472860355,-0.0397281841439337,-0.20444693085414656,-0.16471874671021286,-12207226,-11995086,46.64472557871198,46.91176570287142,NaN,NaN,-13.593741503259938,-9.030099537393811
2004-05-12T09:30:00-04:00,19.77,19.77,19.25999,19.72,407400,469455,44.21178774717553,43.99816146759643,NaN,NaN,-81.45999506806051,-88.84608180855386,-0.025576741586187918,-0.19668967369294776,-0.17111293210675985,-12614626,-12263926,42.26850960878003,46.95192110407419,NaN,NaN,-13.352135975555399,-9.647533314274037
2004-05-13T09:30:00-04:00,19.58,19.87,19.57001,19.72,372500,452960,44.21178774717553,43.148688213496996,NaN,NaN,-48.75322424259838,-77.10245901220524,-0.013806112553049033,-0.18837057279807112,-0.1745644602450221,-12614626,-12437686,39.677432316190135,46.37200856230277,NaN,NaN,-13.1527664240471,-10.148280901384474
2004-05-14T09:30:00-04:00,19.78,19.78,19.42,19.45,672800,471180,39.55070274500402,42.28070636457752,NaN,NaN,-76.26638370732992,-75.36684871213473,-0.021344069444643787,-0.20124454705082684,-0.17990047760618305,-13287426,-12662506,36.55508605928409,45.28296055203897,NaN,NaN,-14.269125830623668,-10.73697303413293
2004-05-17T09:30:00-04:00,19.23,19.38,19.08,19.24001,675200,491870,36.34167535546137,41.25689857184905,NaN,NaN,-128.02475016440223,-78.02819655204027,-0.036710776310822923,-0.22578894799471172,-0.1890781716838888,-13962626,-12937306,33.123891638106244,43.68760078878212,NaN,NaN,-16.17484377528717,-11.51381171144068
2004-05-18T09:30:00-04:00,19.48,19.53999,19.39999,19.42999,331600,495475,41.00532568410659,40.96798545269644,NaN,NaN,-77.73531371971978,-82.44793338042214,-0.03057002154459093,-0.22729069861462747,-0.19672067707003654,-13631026,-13222066,29.98321872730503,41.85421782940007,NaN,NaN,-16.484354158597363,-12.223889203891634
2004-05-19T09:30:00-04:00,19.60001,19.88,19.50999,19.52,438200,491175,43.13108117293117,41.12999123974619,NaN,NaN,-38.73179372897868,-73.90229311260578,-0.01758089159696677,-0.218696791566245,-0.20111589996927823,-13192826,-13337706,28.789428077788813,40.22317951580536,NaN,NaN,-16.14052469207681,-12.78340855934666
2004-05-20T09:30:00-04:00,19.49001,19.62,19.39,19.50999,151300,459480,42.94574990752292,41.62997451062757,NaN,NaN,-62.80820379754631,-76.71328902359537,-0.007323216742940397,-0.2102699208979537,-0.2029467041550133,-13344126,-13483606,27.311906509088317,38.95499602435232,NaN,NaN,-15.906956434096767,-13.22962968431096
2004-05-21T09:30:00-04:00,19.64,19.66,19.45,19.57001,179700,443220,44.486055975731595,42.08625598100064,NaN,NaN,-47.893002191774414,-71.03861272048427,0.005170552799088346,-0.19648351315615287,-0.2016540659552412,-13164426,-13459006,27.98302647141881,38.026709119545345,NaN,NaN,-15.298842612694392,-13.525231531222879
2004-05-24T09:30:00-04:00,19.8,19.8,19.53,19.60001,219400,443530,45.2812356195043,42.33925082168552,NaN,NaN,-13.15676197114233,-48.06501508183228,0.01648332812330469,-0.18104990580111036,-0.19753323392441505,-12945026,-13255486,33.45692118862527,37.61617035785365,NaN,NaN,-14.577730200014125,-13.675588483907342
2004-05-25T09:30:00-04:00,19.5,19.9785,19.46001,19.97,277900,444025,54.02736643433787,43.08271350673924,NaN,NaN,79.35918575850154,-16.646115186188016,0.04812264345782549,-0.1373799296021332,-0.18550257305995868,-12667126,-13062706,38.24512252358637,37.36035869853776,NaN,NaN,-11.34732275911054,-13.342979094650657
2004-05-26T09:30:00-04:00,19.94,20,19.78,19.92999,336200,423915,53.040071215442964,43.850122634628505,NaN,NaN,151.47907910826092,21.39605938125991,0.06456873168506727,-0.10479165845362459,-0.16936039013869186,-13003326,-13024806,39.171816368037284,36.98713842562546,NaN,NaN,-8.934439205227692,-12.713187681875947
2004-05-27T09:30:00-04:00,19.95,20.14,19.89,20.05,952500,447940,55.657568882831384,44.910270171530875,NaN,NaN,201.30485554468677,74.21867124970652,0.08069480574612814,-0.0684918829560317,-0.14918668870215984,-12050826,-12766146,45.21419339582009,36.83972671516415,NaN,NaN,-6.109360425814138,-11.769783788152832
2004-05-28T09:30:00-04:00,20,20.14999,19.98,20.14999,282300,435835,57.76963507103681,46.2066614894992,NaN,NaN,191.35985090795222,122.06924186965185,0.09431339626336901,-0.03129494337294858,-0.1256083396363176,-11768526,-12486966,50.885140440027385,37.09360135019788,NaN,NaN,-3.0893735627459495,-10.529725184523278
2004-06-01T09:30:00-04:00,19.91,20.10001,19.83,20.00999,249600,428965,53.898645294735545,46.82562063235694,NaN,NaN,123.37766880589707,149.37612802505973,0.09011587520747828,-0.012963495626969745,-0.10307937083444803,-12018126,-12301586,54.27008227230942,37.63826968545484,NaN,NaN,-1.5180555589945806,-9.24234380944775
2004-06-02T09:30:00-04:00,20.00999,20.10001,19.88,20.00999,940200,446025,53.898645294735545,47.51753902861122,NaN,NaN,113.668323920774,156.23795565751422,0.0837006821891246,0.0015464819019577192,-0.08215420028716688,-12018126,-12171786,56.52916820789403,38.65688815682012,NaN,NaN,-0.22038773482573565,-7.953492941644605
2004-06-03T09:30:00-04:00,19.92999,19.92999,19.74001,19.75,476900,433165,47.101109371021536,47.72391914460021,NaN,NaN,38.97274255351797,133.73668834656564,0.05944906516519344,-0.007842868830675087,-0.06729193399586852,-12495026,-12070126,58.2680155848152,39.984786961721916,NaN,NaN,-0.9586238517661081,-6.95422592880482
2004-06-04T09:30:00-04:00,19.95,20.14,19.92999,19.94,521600,435475,51.877536475132565,48.60440726818082,NaN,NaN,100.33915791631198,113.54354882089066,0.05387104705830579,0.00004687482701370982,-0.05382417223129208,-11973426,-12054646,58.539971584313015,41.55513592779541,NaN,NaN,-0.20916128915524282,-5.990645265997737
2004-06-07T09:30:00-04:00,20.05,20.42999,20.05,20.39999,1159100,472555,61.04756478686507,50.36911365613823,NaN,NaN,168.56206533597728,108.98399170649566,0.07739703595218622,0.04292212270894069,-0.034474913243245524,-10814326,-11863806,61.841423018154615,43.606388169227436,NaN,NaN,3.5700138292561863,-4.6248368238186055
2004-06-08T09:30:00-04:00,20.28,20.52,20.28,20.50999,558600,479220,62.869698639475395,51.93085458152172,NaN,NaN,180.91109082657965,120.49067611063217,0.09541963372287632,0.08479962891034987,-0.010620004812526444,-10255726,-11511326,67.05892726054512,46.25465306445887,NaN,NaN,7.222410327370639,-2.932372945077285
2004-06-09T09:30:00-04:00,20.5,20.5,20.25999,20.28,354600,477880,56.878736753125395,52.91282998010702,NaN,NaN,131.76733212766877,124.11047775201112,0.08713319003185216,0.09829648272728875,0.011163292695436595,-10610326,-11229766,70.52577090483322,49.235820409247765,NaN,NaN,8.383698871063961,-1.3157912570571069
2004-06-10T09:30:00-04:00,20.41,20.42,20.3,20.39,856800,500350,58.89619971407069,54.052147823431866,NaN,NaN,120.87953922013779,140.4918370853351,0.08428991127049626,0.11652568178355693,0.03223577051306067,-9753526,-10681466,75.8549126404118,52.70317799005658,NaN,NaN,9.968718095373449,0.2962815075758296
2004-06-14T09:30:00-04:00,20.22,20.32001,20.03999,20.11,414400,502445,52.20128131791175,54.6032353478733,NaN,NaN,63.118343593582736,133.04767422078925,0.05992634955961818,0.10714370746258339,0.04721735790296521,-10167926,-10320366,78.59925133259789,56.31862262299795,NaN,NaN,9.146048961800698,1.5605340010365252
2004-06-15T09:30:00-04:00,20.28999,20.53,20.27,20.41,592000,498405,57.7436781018387,55.4934098108972,NaN,NaN,110.22835134906914,121.38093142340763,0.06022913031865232,0.12250377080128061,0.06227464048262829,-9575926,-10072686,80.25682928815188,59.661473201535564,NaN,NaN,10.30123589318745,2.8092056999152284
2004-06-16T09:30:00-04:00,20.3,20.39,20.24001,20.32001,713900,500340,55.658836043722815,55.609943354424686,NaN,NaN,84.97612293963552,102.19393784601878,0.05095089932030342,0.12596326463300755,0.07501236531270414,-10289826,-10079506,80.07291783788824,62.64917286684284,NaN,NaN,10.54577949212109,3.9144305273732085
2004-06-17T09:30:00-04:00,20.3,20.3,20.05,20.09,225600,495040,50.62740491761296,55.43761004743683,NaN,NaN,35.13812961048754,82.86809734258254,0.027101979274347016,0.1088898394056379,0.08178786013129088,-10515426,-10060526,80.20884132525482,65.58038893521552,NaN,NaN,9.10193943733501,4.655503228796323
2004-06-18T09:30:00-04:00,20,20.28999,20,20.13,335000,489880,51.44936417429403,55.13702399682702,NaN,NaN,27.822875571067758,64.25676461276855,0.01254026992625798,0.09746319753911337,0.08492292761285539,-10180426,-10145906,77.64318337673825,67.89674536242396,NaN,NaN,8.206024116955762,5.162720498533385
2004-06-21T09:30:00-04:00,20.14999,20.28999,20.00999,20.03999,402900,502460,49.454180867748626,54.54306298230643,NaN,NaN,12.301465865879216,54.09338906722784,-0.0037625630981955177,0.08021972374011099,0.08398228683830651,-10583326,-10228986,75.12500748133745,69.62816443680325,NaN,NaN,6.865243062280305,5.4059380076400885
2004-06-22T09:30:00-04:00,20.00999,20.28,19.99001,20.25,335300,510240,53.94206042170082,54.54616406280395,NaN,NaN,25.573589491585174,37.16243669573105,-0.001146926124564962,0.08254862918260031,0.08369555530716527,-10248026,-10363406,71.10668096306605,70.83077862900015,NaN,NaN,7.061774059110235,5.642486014992967
2004-06-23T09:30:00-04:00,20.31,20.56,20.23,20.53,429600,520750,59.14983852404062,54.9212492934686,NaN,NaN,121.17404943718384,44.4020219952407,0.017658537687137918,0.10576872741608767,0.08811018972894975,-9818426,-10269126,72.22869266401392,71.95217323300871,NaN,NaN,8.888372115985572,6.106184029420482
2004-06-24T09:30:00-04:00,20.53,20.61,20.38,20.42999,498900,531800,56.68446843248682,55.605774940716124,NaN,NaN,119.41628659527247,61.25765339219769,0.021334060017617812,0.11477776475097201,0.0934437047333542,-10317326,-10229506,72.70832637811382,72.98362400395861,NaN,NaN,9.62521139776679,6.608902224898526
2004-06-25T09:30:00-04:00,20.47,20.61,20.39999,20.50999,220500,526015,58.18582328875506,56.05636685597487,NaN,NaN,116.83115384973759,79.05930904793165,0.02677294421486838,0.12690988500193967,0.10013694078707129,-10096826,-10212786,72.92087315317504,74.01083125887733,NaN,NaN,10.678541783527006,7.190279304702594
2004-06-28T09:30:00-04:00,20.64,20.64,20.3,20.35001,425200,499650,54.14423287810924,55.56327171963517,NaN,NaN,77.75783869959633,92.15058361467509,0.01765597025282309,0.12220690360310016,0.10455093335027707,-10522026,-10200526,73.08638734168727,74.81404299627252,NaN,NaN,10.371250854775345,7.644703811855845
2004-06-29T09:30:00-04:00,20.37,20.58,20.3,20.56,640800,517575,58.24410676327638,55.23287229990666,NaN,NaN,87.9012996795952,104.61612565227708,0.023463972785522216,0.13388089933217984,0.11041692654665762,-9881226,-10127166,74.10626664765616,75.31742438106616,NaN,NaN,11.35057782097801,8.174114384587583
2004-06-30T09:30:00-04:00,20.53999,20.77,20.50999,20.7,342100,522200,60.76287287564229,55.51031059437215,NaN,NaN,143.7499856376965,109.13131289237963,0.03380211891940045,0.15266957519590818,0.11886745627650773,-9539126,-10071306,74.88664952474464,75.62891571105983,NaN,NaN,12.938640606984892,8.854760987787198
2004-07-01T09:30:00-04:00,20.64999,20.64999,20.14,20.32001,486700,499525,51.6551019030335,54.99308932215521,NaN,NaN,27.894490348443032,90.82695364301374,0.013176139720687458,0.13533763092736706,0.1221614912066796,-10025826,-10013006,75.70946499286552,75.61852659337796,NaN,NaN,11.41655875839606,9.220732097874178
2004-07-02T09:30:00-04:00,20.34,20.34,20.05,20.10001,352600,493310,47.24020308737669,54.63872659140271,NaN,NaN,-76.03463556333134,52.25379576039995,-0.015596148502786344,0.10266630557819667,0.11826245408098301,-10378426,-10069326,73.21389321258253,75.233858156234,NaN,NaN,8.677813588193631,9.143172310776958
2004-07-06T09:30:00-04:00,19.87,19.97,19.57001,19.67,846800,509570,40.03722549415234,53.373979976567966,NaN,NaN,-247.36318373486097,-12.770408726491514,-0.06133289531125205,0.041596334941917945,0.10292923025317,-11225226,-10209966,67.25235564944867,74.30496718204093,NaN,NaN,3.687449512054936,8.363783339530954
2004-07-07T09:30:00-04:00,19.62,19.89,19.62,19.8,207200,461975,42.873121384250034,52.46071464374848,NaN,NaN,-184.05271660365543,-67.16121198314164,-0.0794267202712114,0.0036458299141557404,0.08307255018536715,-11018026,-10437326,58.90234120673306,72.79278313695842,NaN,NaN,0.6679349522360414,7.264376427060252
2004-07-08T09:30:00-04:00,19.59,19.75999,19.46001,19.47,275900,447840,37.96468031001329,51.55623431463422,NaN,NaN,-206.4463059815519,-137.20047030699135,-0.10842108494013877,-0.05245380598980631,0.05596727895033246,-11293926,-10788286,48.824918094718676,70.55107433477725,NaN,NaN,-3.614351143597297,5.710272488394889
2004-07-09T09:30:00-04:00,19.62,19.72,19.58,19.63,218700,441045,41.46391352356135,50.84298783958189,NaN,NaN,-154.02606102317324,-173.58458058131458,-0.11120999535867673,-0.08304521524801345,0.028164780110663278,-11075226,-10998166,43.97915744888909,68.1465010542166,NaN,NaN,-5.901308975144269,4.0514751364607235
2004-07-12T09:30:00-04:00,19.5,19.64,19.39999,19.60001,1238600,460135,40.997116219898395,50.23891179330686,NaN,NaN,-155.40064054578588,-189.4577815778055,-0.10929888331831333,-0.1084588240372284,0.0008400592810849407,-12313826,-11385246,36.737410620125566,65.40452984984432,NaN,NaN,-7.842198125744836,2.3523789561456434
2004-07-13T09:30:00-04:00,19.69,19.7,19.49001,19.50999,314900,455160,39.557540361968606,49.21144607475457,NaN,NaN,-126.29084825552235,-165.24331448193774,-0.1081239320013991,-0.13431485572066393,-0.026190923719264833,-12628726,-11665946,32.55146710513206,62.65058600284904,NaN,NaN,-9.86580725158114,0.6069237836132457
2004-07-14T09:30:00-04:00,19.3,19.45,19.13,19.2,837100,467415,34.99988741293673,47.48644956681858,NaN,NaN,-158.0224934285755,-160.0372698469218,-0.12126352005140394,-0.17777032378351976,-0.05650680373211582,-13465826,-12155506,26.81319014236486,59.40662153701697,NaN,NaN,-13.100092196645384,-1.3512213564237012
2004-07-15T09:30:00-04:00,19.2,19.34,19.10001,19.10001,251000,444270,33.65300587182864,45.84134509820014,NaN,NaN,-144.0636651557785,-147.5607416817671,-0.12900829164716496,-0.217767168291072,-0.08875887664390705,-13716826,-12640086,22.57169186759691,55.82543335769433,NaN,NaN,-16.160148419074794,-3.4667823653738568
2004-07-16T09:30:00-04:00,19.25999,19.28,18.86,18.89999,457600,455870,31.07669033901024,43.90497845893265,NaN,NaN,-144.53289446682575,-145.6621083704976,-0.13905534799901395,-0.2625780616426745,-0.12352271364366055,-14174426,-13259926,18.533193866470953,51.940599122929754,NaN,NaN,-19.569193045871245,-5.767126748302055
2004-07-19T09:30:00-04:00,18.87,19.09,18.82001,18.96001,689800,473610,32.74062126491863,42.37614905799047,NaN,NaN,-131.70788776570552,-140.9235578144815,-0.13310666797213633,-0.28990604860883096,-0.15679938063669463,-13484626,-13494086,17.275691008550638,47.95412081342,NaN,NaN,-21.864555924789883,-8.066759487800317
2004-07-20T09:30:00-04:00,19.00999,19.27,18.96001,19.27,502600,478595,40.70292624108301,41.12320759211951,NaN,NaN,-91.74701114626197,-134.01479039262944,-0.10118813146319522,-0.28328454496568867,-0.18209641350249345,-12982026,-13564746,16.902983882475397,43.86817204447851,NaN,NaN,-21.46259415270109,-9.980450154214713
2004-07-21T09:30:00-04:00,19.57001,19.58,18.95,18.98,638200,493740,36.36569260478475,39.38055185848683,NaN,NaN,-83.23523863867281,-119.05733943464891,-0.09272474635180478,-0.29800234644224943,-0.20527760009044466,-13620226,-13595626,16.73308263544483,39.71434583809996,NaN,NaN,-22.482401472310723,-11.766443199657001
2004-07-22T09:30:00-04:00,18.92999,19.28,18.88,19.17999,781600,511340,41.03225094966274,38.62177679038892,NaN,NaN,-84.27763726344834,-107.10013385618285,-0.0679249048199885,-0.2901837311154303,-0.22225882629544177,-12838626,-13419986,21.56242681163424,35.8467002537263,NaN,NaN,-21.851526133560892,-13.207169333071842
2004-07-23T09:30:00-04:00,19.10001,19.10001,18.83,18.85001,268200,499805,36.30184802967277,37.840465714838636,NaN,NaN,-101.43560019647528,-98.48067500211276,-0.06785237026205604,-0.3070742891230118,-0.23922191886095578,-13106826,-13206466,27.097909164640754,32.55270139315903,NaN,NaN,-22.84484843105362,-14.583980632783526
2004-07-26T09:30:00-04:00,18.92999,19.03999,18.78999,18.96001,457900,511675,38.83334422363191,37.75447419551575,NaN,NaN,-94.6514590785825,-91.06938926468816,-0.0550490900457562,-0.308033281418151,-0.2529841913723948,-12648926,-13039326,31.191459978366993,29.976923130938903,NaN,NaN,-22.84350237498517,-15.763912310240903
2004-07-27T09:30:00-04:00,19.00999,19.23,18.94,19.14,582600,519545,42.83656153157355,37.75186277746743,NaN,NaN,-63.389857976028175,-85.3979586306414,-0.030345527889574064,-0.2909161012343624,-0.26057057334478834,-12066326,-12856186,35.467356188418975,28.30299562963076,NaN,NaN,-21.58272164331136,-16.595170786393826
2004-07-28T09:30:00-04:00,19.07001,19.25999,18.86,19.13,956800,535345,42.66947247409921,38.087919360616425,NaN,NaN,-60.40497356361357,-80.83190561562955,-0.011533655461566428,-0.27498764267174636,-0.26345398721017993,-13023126,-12736766,38.16567330551891,27.541621001830777,NaN,NaN,-20.626387547031587,-17.171058895056362
2004-07-29T09:30:00-04:00,19.25,19.48,19.25,19.39999,513300,543905,48.509234104456496,38.591156544966076,NaN,NaN,-1.0769433372586177,-64.1917668303916,0.02049386577412482,-0.23783665499252393,-0.25833052076664875,-12509826,-12671006,39.66182329573588,27.233239990891256,NaN,NaN,-17.9906420410362,-17.28814220162491
2004-07-30T09:30:00-04:00,19.38,19.53,19.31,19.44,169300,528035,49.332880781253884,39.186568299348615,NaN,NaN,22.02356370547698,-39.49993405000115,0.04440226807629441,-0.20282768567128073,-0.24722995374757514,-12340526,-12517746,43.11632074914599,27.688876428678434,NaN,NaN,-15.60730623433528,-17.04802277772639
2004-08-02T09:30:00-04:00,19.31,19.55,19.24001,19.49001,423000,531555,50.40085020131449,39.961090430730465,NaN,NaN,36.12367915625819,-13.344906403033008,0.06250542085653671,-0.16909817767690427,-0.23160359853344098,-11917526,-12371466,46.27777911130981,28.66932728626256,NaN,NaN,-13.330844930310914,-16.51699737095275
2004-08-03T09:30:00-04:00,19.42,19.48,19.13,19.17,429600,510695,44.00850012366855,40.60456276721131,NaN,NaN,-4.441174500585261,-1.555169707944428,0.052264684056536975,-0.16627274346276977,-0.21853742751930674,-12347126,-12427626,45.23825992416918,29.985403699248582,NaN,NaN,-13.135913555249305,-16.03398539728083
2004-08-04T09:30:00-04:00,19.05,19.31,19.05,19.2,786200,539645,44.716383192413694,41.39480400439596,NaN,NaN,-20.852219270379237,6.355381150702438,0.047013081450900635,-0.15977107570568094,-0.20678415715658158,-11560926,-12135186,51.36467205728562,32.0420451413692,NaN,NaN,-12.774928817918344,-15.568405885943331
2004-08-05T09:30:00-04:00,19.28999,19.28999,18.89,18.91,351100,543405,39.515592790913054,41.997582750960454,NaN,NaN,-71.3398628812644,-7.697202758098714,0.024635064445102522,-0.17599032660020342,-0.20062539104530594,-11912026,-12015626,53.64781446225284,34.550232326782194,NaN,NaN,-14.010381354257289,-15.345830952845326
2004-08-06T09:30:00-04:00,18.7,18.78,18.34,18.34,481900,556565,31.7092128511176,41.92391072140323,NaN,NaN,-249.4053494292551,-61.982985385045126,-0.025229458847548625,-0.23216221460474173,-0.2069327557571931,-12393926,-12026306,53.4066316419988,37.13101380059992,NaN,NaN,-17.87113679705044,-15.706588930588913
2004-08-09T09:30:00-04:00,18.59,18.59,18.39999,18.46001,309400,510105,34.63700595999937,41.490630701325834,NaN,NaN,-213.04167359805965,-111.81605593590871,-0.04561568181952738,-0.26395235803160233,-0.21833667621207495,-12084526,-12059706,52.61006327342531,39.68151947138205,NaN,NaN,-20.003901191274643,-16.320490682115445
2004-08-10T09:30:00-04:00,18.50999,18.78,18.50999,18.78,781000,533410,41.80162023153995,41.87891124609406,NaN,NaN,-125.0429081001156,-135.9364026558148,-0.03359057396903656,-0.26032489367337064,-0.22673431970433408,-11303526,-11850986,56.93296284779834,42.55293948655016,NaN,NaN,-19.436788557535365,-16.76567609288972
2004-08-11T09:30:00-04:00,18.53,18.53,18.17,18.31,406600,511885,35.62486685662313,41.49266952516267,NaN,NaN,-195.98825107638,-170.96360901701496,-0.05221980442148075,-0.292009075231185,-0.23978927080970427,-11710126,-11880826,56.14443834118784,45.02308316723256,NaN,NaN,-21.12288529574961,-17.388134550441134
2004-08-12T09:30:00-04:00,18.06,18.14999,17.86,17.95,2643000,631485,31.754423590672303,41.16785349380549,NaN,NaN,-225.9727131663198,-201.89017907402604,-0.0819470426881233,-0.3422230741698584,-0.2602760314817351,-14353126,-12369046,45.13090067171741,46.311153989166606,NaN,NaN,-23.916972922323307,-18.3208257464243
2004-08-13T09:30:00-04:00,18.07001,18.11,17.95,18.05,427900,630000,33.90261950776305,40.81565887124343,NaN,NaN,-169.368865516659,-185.88288229150683,-0.0875290470541007,-0.369687340299361,-0.2821582932452603,-13925226,-12675306,39.85000191188342,46.92962127013207,NaN,NaN,-25.362225594151326,-19.326740010385304
2004-08-16T09:30:00-04:00,18.13,18.32001,18.05,18.21001,425600,616790,37.30337458535679,40.42043123222794,NaN,NaN,-116.33917325089025,-166.54238222207294,-0.0736554742801272,-0.3742276360954193,-0.3005721618152921,-13499626,-12958326,35.69344407445597,46.94577040484899,NaN,NaN,-25.4179058686323,-20.196906561563445
2004-08-17T09:30:00-04:00,18.36,18.44,18.27,18.33,354600,609390,39.804512580957606,40.21579123986068,NaN,NaN,-78.973183662478,-157.3284373345454,-0.050700905462926826,-0.36394829364395065,-0.3132473881810238,-13145026,-13326626,31.14134118501093,46.44403239624129,NaN,NaN,-24.67446227787816,-20.836557378179833
2004-08-18T09:30:00-04:00,18.17999,18.67999,18.17999,18.63,848500,619905,45.643115371215394,40.01106847320061,NaN,NaN,-48.58616167748558,-127.84801945476654,-0.011654485398877035,-0.32781549492962014,-0.3161610095307431,-12296526,-13443906,29.836440247984214,45.742219321401876,NaN,NaN,-22.15466046209872,-21.024857818739676
2004-08-19T09:30:00-04:00,18.62,18.69,18.46001,18.57001,430100,602330,44.70924916016823,39.68080907169449,NaN,NaN,-32.128078817735805,-89.07909258504975,0.012483959546788714,-0.3005560600972572,-0.31304001964404593,-12726626,-13118606,37.641571037001626,45.35116577053442,NaN,NaN,-20.41739670306601,-20.938077659357724
2004-08-20T09:30:00-04:00,18.55,18.75,18.55,18.66,236600,600750,46.478296219379914,39.40062664441344,NaN,NaN,-16.892971112623282,-58.58391370424262,0.035555917083101796,-0.26859512329016866,-0.30415104037327045,-12490026,-12831566,43.60321403823213,45.16012540817173,NaN,NaN,-18.46414576847478,-20.584658817803017
2004-08-23T09:30:00-04:00,18.74001,18.84,18.67999,18.75,151500,585430,48.26123288005198,39.704393269869406,NaN,NaN,1.6958455177503224,-34.9769099505145,0.05666954988325895,-0.23331410301919675,-0.2899836529024557,-12338526,-12599346,47.93952860597034,45.35307317115753,NaN,NaN,-16.32369044093831,-19.97594904967949
2004-08-24T09:30:00-04:00,18.85001,18.85001,18.58,18.64999,283500,570475,46.411056874295426,39.82544139000381,NaN,NaN,-5.856766882022018,-20.353626594423297,0.06319377548858729,-0.21099143354172156,-0.27418520903030885,-12622026,-12494746,49.81145088578065,45.242128801764316,NaN,NaN,-15.032461276273965,-19.269736510621556
2004-08-25T09:30:00-04:00,18.55,18.89999,18.55,18.86,390300,542150,50.68632386766618,40.62335075262904,NaN,NaN,11.175256771512023,-8.401342904623752,0.07987235336060661,-0.17434476732955062,-0.25421712069015723,-12231726,-12481786,50.05109330990324,44.98522014802506,NaN,NaN,-12.667257970098579,-18.326525290546844
2004-08-26T09:30:00-04:00,18.77,18.88,18.75,18.75999,287500,530860,48.69403658255487,41.836552447731705,NaN,NaN,23.831123637431954,2.7904975864098,0.08207436651222233,-0.15162416254987932,-0.23369852906210165,-12519226,-12440306,50.859842826126005,44.803306661177,NaN,NaN,-11.22644127346843,-17.312227573821357
2004-08-27T09:30:00-04:00,18.8,18.92,18.77,18.84,320500,538420,50.37458431860151,42.960665187631854,NaN,NaN,43.443818048355155,14.857855418605487,0.08638870794393264,-0.12571264413218586,-0.2121013520761185,-12198726,-12382046,52.03455888576425,44.7621992049155,NaN,NaN,-9.545366120193679,-16.202675937588833
2004-08-30T09:30:00-04:00,18.83,18.83,18.64,18.64999,222600,528400,46.48078693391105,43.29489138065837,NaN,NaN,23.099657001086584,19.138617715272737,0.07437190798795285,-0.11913646709117742,-0.19350837507913027,-12421326,-12398606,51.65655493468337,44.385312925407284,NaN,NaN,-9.151862424711735,-15.195416864320675
2004-08-31T09:30:00-04:00,18.67,18.67,18.39999,18.58,914600,552650,45.097974953162016,43.97154195898257,NaN,NaN,-8.86723211363357,18.536524668950427,0.0602388928966692,-0.11820975895829378,-0.17844865185496298,-13335926,-12541386,48.39238178240789,43.831594599780146,NaN,NaN,-9.200358811859417,-14.338979999683353
2004-09-01T09:30:00-04:00,18.57001,18.8,18.50999,18.72,522300,539455,48.40454576112441,45.16083639972915,NaN,NaN,38.86335366141518,24.07414404693106,0.058784125764346606,-0.10496849464952973,-0.16375262041387634,-12813626,-12657766,45.8492123922573,43.88290257981872,NaN,NaN,-8.331469484485082,-13.480764211797887
2004-09-02T09:30:00-04:00,18.64,18.94,18.64,18.94,162100,530005,53.176862932824854,46.53756807294785,NaN,NaN,98.05611768649368,38.919142856743406,0.07032353232317728,-0.07584820500990475,-0.14617173733308203,-12651526,-12684226,45.26674220685521,44.26981260088813,NaN,NaN,-6.186923813795179,-12.438787012083214
2004-09-03T09:30:00-04:00,18.72,18.75999,18.50999,18.53,169300,514375,44.85089340863343,47.076676560324756,NaN,NaN,16.31172705584109,33.49272465824059,0.049037110692584596,-0.08487534896735127,-0.13391245965993587,-12820826,-12808646,42.53066093795057,44.75818523399489,NaN,NaN,-6.782086481572561,-11.630686936295978
2004-09-07T09:30:00-04:00,18.55,18.75,18.53,18.61,286300,513220,46.60753393337818,47.56260665692623,NaN,NaN,24.1431927988315,33.70143181778957,0.039450855067053994,-0.08459889082611838,-0.12404974589317237,-12534526,-12831286,42.03279894610038,45.53614650264414,NaN,NaN,-6.7386083506755705,-10.931818566921635
2004-09-08T09:30:00-04:00,18.60001,18.75999,18.58,18.63,223900,485365,47.0615179805653,47.66392112902265,NaN,NaN,33.95551090249263,42.26598042101481,0.03378158787619011,-0.08182276104793473,-0.11560434892412484,-12310626,-12626226,47.97329087882712,46.83163583341862,NaN,NaN,-6.573468576075908,-10.30919713965796
2004-09-09T09:30:00-04:00,18.72,18.98,18.64999,18.91,268400,478455,53.076860884065646,48.261607680729604,NaN,NaN,92.85952486956712,53.065214662645204,0.04738020302617539,-0.0563790951414056,-0.10375929816758099,-12042226,-12471946,51.96205080962323,47.85452724574874,NaN,NaN,-4.613662185408086,-9.495549289050835
2004-09-10T09:30:00-04:00,18.92999,19.25999,18.85001,19.23,292700,360940,58.83397070926627,49.14415585857863,NaN,NaN,187.6332004081745,70.98063120698137,0.07478740915566923,-0.010275036722994457,-0.08506244587866368,-11749526,-12291546,56.19147957311836,48.75368906966919,NaN,NaN,-1.0268675829893472,-8.285737616756338
2004-09-13T09:30:00-04:00,19.32001,19.49001,19.25999,19.32001,546600,366875,60.30911238861201,50.00471868061863,NaN,NaN,257.8327447896377,119.28483475374068,0.09456496142585506,0.03314375590365515,-0.061421205522199915,-11202926,-11967966,62.55905224929592,49.79794075847816,NaN,NaN,2.3534829953461274,-6.7658489578845575
2004-09-14T09:30:00-04:00,19.28,19.41,19.25,19.39999,180300,354610,61.62499902435923,51.091428834194616,NaN,NaN,216.71460465991788,157.79911712595793,0.10766799865342203,0.07316379279457763,-0.0345042058588444,-11022626,-11665586,67.33686635237626,51.04975614894922,NaN,NaN,5.52992274011119,-5.009310143885165
2004-09-15T09:30:00-04:00,19.23,19.25,19.05,19.09,157800,344770,54.13386346756208,51.337681662758605,NaN,NaN,116.98939696048441,174.4058943375563,0.09076832478900743,0.07895620012741489,-0.011812124661592545,-11180426,-11439546,70.37976720070684,52.50180428400662,NaN,NaN,6.051190623138808,-3.4292386057388833
2004-09-16T09:30:00-04:00,19.14999,19.25,19.11,19.13,138700,309280,54.89577568828676,51.78066302745374,NaN,NaN,111.35646798420441,178.10528296048378,0.07807810647740646,0.08578550843516553,0.007707401957759069,-11041726,-11239446,72.79584884569057,54.06866185683266,NaN,NaN,6.697110461561443,-1.9826173104102653
2004-09-17T09:30:00-04:00,19.14999,19.28,19.09,19.22,256600,300605,56.64103084517679,52.228266350780544,NaN,NaN,104.10097954320224,161.39883878748932,0.07170446296173083,0.09733798065992261,0.025633517698191777,-10785126,-11046566,74.91950425034608,55.70330081144566,NaN,NaN,7.7405804781633405,-0.5935890548997504
2004-09-20T09:30:00-04:00,19.10001,19.46001,19.10001,19.33,531100,315330,58.74229953439877,53.10408867938681,NaN,NaN,114.41184483400207,132.71465879636222,0.07073696738173477,0.11405472692536023,0.04331775954362547,-10254026,-10856786,76.83560262611432,57.50180421797644,NaN,NaN,9.22660580407185,0.8092959249533354
2004-09-21T09:30:00-04:00,19.33,19.5,19.33,19.39999,239600,319735,60.06831405329287,54.17339861511044,NaN,NaN,124.21998737804981,114.21573533998858,0.07049408972372426,0.1314353716982808,0.06094128197455653,-10014426,-10655146,78.69776594667299,59.66647451542395,NaN,NaN,10.845744497571904,2.243074292470274
2004-09-22T09:30:00-04:00,19.21001,19.3,19.06,19.08,194200,315270,51.86151896834619,54.42032527276915,NaN,NaN,49.75772249581911,100.7694004470555,0.04566983776361774,0.11802857917907872,0.07235874141546098,-10208626,-10460786,80.33846548737662,62.12999259364676,NaN,NaN,9.867295275545555,3.3322487186238856
2004-09-23T09:30:00-04:00,19.12,19.21001,19.03999,19.13,236000,307555,52.94336947964759,54.40364716897077,NaN,NaN,40.069153310198864,86.51193751225438,0.03024759155676901,0.11016823086142224,0.07992063930465323,-9972626,-10246966,81.98254725898272,64.75255009737016,NaN,NaN,9.375243113019446,4.195533632108965
2004-09-24T09:30:00-04:00,19.10001,19.22,18.97,18.97,334000,309880,49.13775456268264,54.70985153711713,NaN,NaN,18.16871808833411,69.32548522128074,0.008056150257834793,0.08999082712694673,0.08193467686911193,-10306626,-10151266,82.68059830975058,67.62040276678444,NaN,NaN,7.826755817033354,4.714279658526735
2004-09-27T09:30:00-04:00,18.88,18.96001,18.78,18.8,1260800,356895,45.40340229726313,54.62384213453748,NaN,NaN,-36.716251688642615,39.099865916751824,-0.017871317595416963,0.059595529874840736,0.0774668474702577,-11567426,-10413946,74.1847248192896,69.91696890058367,NaN,NaN,5.366545188653375,4.807460448544826
2004-09-28T09:30:00-04:00,18.89,18.89,18.67,18.85001,1030100,397270,46.68699071612361,54.59709018707736,NaN,NaN,-50.57162133894574,4.141544173352711,-0.030700037241754005,0.03909180091806519,0.0697918381598192,-10537326,-10518526,71.0543150054705,71.5656134810582,NaN,NaN,3.697053406118933,4.648830871055413
2004-09-29T09:30:00-04:00,18.82001,19.07001,18.82001,19.05,1183600,410720,51.58865402983117,54.490789697489184,NaN,NaN,-9.398925794194552,-7.689785484650024,-0.0250048677803789,0.038535753434345565,0.06354062121472447,-9353726,-10347546,73.05614759744809,73.07233468018855,NaN,NaN,3.6513012134324034,4.506326634252126
2004-09-30T09:30:00-04:00,19.00999,19.17999,19.00999,19.12,143100,391760,53.210223984899585,54.089093502891565,NaN,NaN,22.889605586609772,-11.125695029367844,-0.01623650065566603,0.04324499539514193,0.05948149605080796,-9210626,-10195146,74.73346027983092,74.39676187352516,NaN,NaN,4.077051646096738,4.445001635944213
2004-10-01T09:30:00-04:00,19.23,19.66,19.23,19.60001,933000,430305,62.48888714134274,54.24479169951519,NaN,NaN,136.40303701360025,12.521168755685427,0.02020132154415777,0.08473314798100517,0.0645318264368474,-8277626,-9789346,78.56063296475729,75.53973192462955,NaN,NaN,7.537167362521459,4.88673959688382
2004-10-04T09:30:00-04:00,19.88,19.94,19.75999,19.75999,1671200,505400,64.98137806177921,54.4845330593309,NaN,NaN,219.616287968751,63.78767668716415,0.05160208143860609,0.12903442823510503,0.07743234679649894,-6606426,-8797146,84.67352206736342,76.77806447570005,NaN,NaN,11.2137486905114,5.790598038830617
2004-10-05T09:30:00-04:00,19.8,19.94,19.72,19.89999,347500,508460,67.04505295663074,55.406760879978656,NaN,NaN,194.4680348828753,112.79560793152837,0.07680694003848891,0.17344102184461008,0.09663408180612117,-6258926,-7941466,87.88236971326555,78.02825036945424,NaN,NaN,14.91234379491322,7.093704575413846
2004-10-06T09:30:00-04:00,19.81,20.03,19.75999,20.03,734400,533985,68.87916904261238,56.40557469100192,NaN,NaN,182.63401302337647,151.20219569504258,0.09599445039030291,0.2166271447939998,0.1206326944036969,-5524526,-7175626,89.91708710307391,79.25119595926733,NaN,NaN,18.55524725391019,8.731067815199038
2004-10-07T09:30:00-04:00,19.91,20.03999,19.82001,19.82001,581400,549635,62.799640548290505,56.84547538408146,NaN,NaN,146.01544376601137,175.82736333092288,0.08848776596901115,0.2312424018649608,0.14275463589594967,-6105926,-6554686,91.20637683656264,80.41454400113994,NaN,NaN,19.765157384235966,10.307366325061457
2004-10-08T09:30:00-04:00,19.73,19.85001,19.48,19.53999,372900,553645,55.73507137562584,56.63067337274054,NaN,NaN,70.43235758679761,162.63322744556234,0.05997235770296752,0.21772008302465906,0.15774772532169154,-6478826,-6194926,91.85612287736056,81.4874383048004,NaN,NaN,18.504723043315572,11.478417284812044
2004-10-11T09:30:00-04:00,19.50999,19.64,19.5,19.60001,203500,536490,56.85540292103264,56.40117972043623,NaN,NaN,54.93443145616126,129.69685614304439,0.04134778242862727,0.20943245335747562,0.16808467092884835,-6275326,-6128706,91.97368114696333,82.43571796196399,NaN,NaN,17.840952551013388,12.38735089426938
2004-10-12T09:30:00-04:00,19.36,19.57001,19.32001,19.55,286900,541820,55.59284519268072,56.667703022174415,NaN,NaN,29.796355408628177,96.76252024819499,0.022782823157931287,0.19656319987626247,0.1737803767183312,-6562226,-6189366,90.68233526735426,83.17456580339096,NaN,NaN,16.924456980560993,13.035508906596753
2004-10-13T09:30:00-04:00,19.82001,19.82001,19.44,19.48,196100,543735,53.79221391127757,56.728334767290846,NaN,NaN,47.05507522290491,69.64673268810068,0.0039007941232958587,0.178656369372451,0.17475557524915514,-6758326,-6436126,85.42778903441,83.42065450163578,NaN,NaN,15.639936076590608,13.40756993088159
2004-10-14T09:30:00-04:00,19.57001,19.57001,19.32001,19.33,189500,546275,50.051128162923405,56.79357573873661,NaN,NaN,5.7434204850816215,41.592328031914725,-0.01930444473791862,0.15062501932675687,0.1699294640646755,-6947826,-6604506,81.938777315897,83.36766728778909,NaN,NaN,13.431699420176832,13.411017000780909
2004-10-15T09:30:00-04:00,19.42999,19.60001,19.35001,19.45,248800,545885,52.87475030326795,57.32724345345124,NaN,NaN,16.94904582990756,30.895665680536716,-0.02672816283277879,0.136519260523702,0.1632474233564808,-6699026,-6648546,81.00688298096205,83.85496429933713,NaN,NaN,12.355342027537388,13.260206290317548
2004-10-18T09:30:00-04:00,19.33,19.67,19.33,19.64999,240300,531345,57.215630038077435,58.07928911930509,NaN,NaN,33.84078584197891,26.676936557700238,-0.018705472062089334,0.1398655832788691,0.15857105534095844,-6458726,-6685226,80.1888741194698,84.50743280747994,NaN,NaN,12.691395120249243,13.178947551736362
2004-10-19T09:30:00-04:00,19.75,19.92999,19.63,19.64999,2635200,651125,57.215630038077435,58.48121597703697,NaN,NaN,71.11260119748017,34.940185715470626,-0.014142095200541632,0.1408934363402814,0.15503553154082303,-6458726,-6664526,80.30971497504574,85.02554476302262,NaN,NaN,12.963241691012655,13.148132428775833
2004-10-20T09:30:00-04:00,19.50999,19.72,19.47,19.67999,212800,652055,57.8904486386658,58.81551773802027,NaN,NaN,41.45138863745034,33.81944839837971,-0.010039406424756231,0.14248627350987775,0.15252567993463398,-6245926,-6562046,80.92988587027845,85.46814659091173,NaN,NaN,13.372683862407841,13.180211205008977
2004-10-21T09:30:00-04:00,19.82001,19.92999,19.64,19.85001,379600,659235,61.58814017897982,58.751178669280065,NaN,NaN,79.61282653183835,48.593329607731064,0.00251809338463696,0.15567329666543017,0.1531552032807932,-5866326,-6345746,82.20393300685566,85.72838230820447,NaN,NaN,14.776242735052502,13.40821570930091
2004-10-22T09:30:00-04:00,19.87,19.87,19.41,19.42,651600,675115,49.70097714004859,57.659721460585025,NaN,NaN,15.819642912998523,48.367449024349256,-0.018581632001999693,0.1299281632782936,0.1485097952802933,-6517926,-6309526,82.41578463595656,85.56711534881829,NaN,NaN,12.346964896827949,13.2566084503762
2004-10-25T09:30:00-04:00,19.39,19.50999,19.35001,19.39,439400,634045,48.99054793049135,56.37011395871792,NaN,NaN,-37.326399177872,34.134012020379075,-0.03410091662057607,0.10588364950457319,0.13998456612514926,-6957326,-6409246,79.60600592369987,84.97594650670645,NaN,NaN,10.188517233619027,12.818309705125175
2004-10-26T09:30:00-04:00,19.38,19.5,19.3,19.42999,316900,598385,50.01619982493838,55.02275901459836,NaN,NaN,-58.35064415500025,8.241362949882989,-0.040764621355244446,0.08902878943109371,0.12979341078633816,-6640426,-6445586,78.55495766848547,84.16436583280729,NaN,NaN,8.718405922259933,12.232609164715855
2004-10-27T09:30:00-04:00,19.5,19.96001,19.41,19.89999,916300,585020,60.15626056586988,54.83394615871117,NaN,NaN,62.836361651190465,12.518357552631015,-0.013993353330193192,0.11230171912359665,0.12629507245378985,-5724126,-6341226,79.39626859905745,83.32078667298548,NaN,NaN,10.644640297692657,12.005756469426826
2004-10-28T09:30:00-04:00,19.75,20.06,19.75,19.95,979200,626825,61.06144035322115,55.21440108568226,NaN,NaN,117.2534986480077,20.04649197586489,0.0055600268263159836,0.13324510598668482,0.12768507916036884,-4744926,-6116946,81.11130281250371,82.5532995254957,NaN,NaN,12.460569657534919,12.070729782013697
2004-10-29T09:30:00-04:00,20.05,20.09,19.85001,19.96001,814500,620900,61.25119611148486,55.528386313571716,NaN,NaN,118.86754813648598,40.65607302056238,0.016998975223793622,0.14893379819011088,0.13193482296631726,-3930426,-5599446,84.348612474028,82.00865176314316,NaN,NaN,13.96491852892816,12.341328174430048
2004-11-01T09:30:00-05:00,20.05,20.16,19.95,20.12,390200,556850,64.24991403654292,56.14674837384761,NaN,NaN,145.44162772835153,77.20967840180708,0.03228493553671491,0.1722909923872109,0.140006056850496,-3540226,-4916026,87.4159677161332,81.7753397951988,NaN,NaN,16.16764352619725,12.887944653253934
2004-11-02T09:30:00-05:00,20.17,20.36,20.07001,20.14999,891200,584035,64.79982259345658,56.93300613686039,NaN,NaN,165.1338655592245,121.90658034465203,0.040810932895820023,0.19101972297027103,0.150208790074451,-2649026,-4117746,89.90472081292205,82.09512063652109,NaN,NaN,18.126809121559205,13.636353863011829
2004-11-03T09:30:00-05:00,20.5,20.56,20.17,20.25999,958700,595250,66.81606250181994,58.13050144678157,NaN,NaN,184.47149625397773,146.23360726520949,0.04966600447838826,0.21229129567243632,0.16262529119404806,-1690326,-3310986,91.69281253557196,82.79183743792645,NaN,NaN,20.38838902080276,14.600930314124819
2004-11-04T09:30:00-05:00,20.25,20.50999,20.17,20.49001,571400,594750,70.60740394255228,59.39711956387332,NaN,NaN,173.0974953445328,157.4024066045145,0.0658093330651146,0.24488695752544132,0.1790776244603267,-1118926,-2585786,92.9087049186018,83.64196757632928,NaN,NaN,23.5788297051918,15.88348736999153
2004-11-05T09:30:00-05:00,20.7,20.75,20.53999,20.67,4918898,822049.9,73.1887677524883,60.53805797204552,NaN,NaN,192.38184666765167,172.10526631074762,0.08233174948223604,0.28199231131312175,0.1996605618308857,3799972,-1039706.4,94.69233063587852,84.67792875607277,NaN,NaN,27.146601947107303,17.492503738150926
2004-11-08T09:30:00-05:00,20.67999,20.73,20.60001,20.7,464400,835094.9,73.60486299719418,61.70871746912529,NaN,NaN,161.83633539032147,175.3842078431416,0.08846597632962686,0.31024303224291927,0.22177705591329241,4264372,521213.2,95.83212441431589,85.78667228744919,NaN,NaN,30.16506278741538,19.302869316617276
2004-11-09T09:30:00-05:00,20.62,20.78999,20.61,20.69,633600,852429.9,73.19707621891648,62.80204801057176,NaN,NaN,141.4226343190619,170.6419615951091,0.08501318249212819,0.32804353402845265,0.24303035153632446,3630772,1777172.8,96.48601126638764,86.89782410145699,NaN,NaN,32.520259675518595,21.191067939317463
2004-11-10T09:30:00-05:00,20.66,20.66,20.47,20.50999,685800,876914.9,66.0980822639433,63.12418673092629,NaN,NaN,100.51161328753471,153.8499850018205,0.06468902771429025,0.32389163617918726,0.259202608464897,2944972,2704232.4,96.87565166194535,87.94580400539198,NaN,NaN,32.5829922347843,22.818485695812726
2004-11-11T09:30:00-05:00,20.47,20.78999,20.47,20.77,531500,894014.9,70.54216379738006,64.61284292073569,NaN,NaN,108.05275016583397,140.84103596608074,0.06278926558279585,0.33768919044339185,0.274899924860596,3476472,3623312,97.2063729783999,89.00227460128077,NaN,NaN,33.997692323462516,24.41551521404841
2004-11-12T09:30:00-05:00,21,21.06,20.72,21.06,394300,901289.9,74.54942762627151,66.43847718471999,NaN,NaN,133.69025277584646,129.1027171877197,0.07430792679303594,0.36778483335189094,0.293476906558855,3870772,3637472,97.21127081049302,90.259793521766,NaN,NaN,36.5770818107736,26.152881870723437
2004-11-15T09:30:00-05:00,21.28,21.36,21.05,21.17999,2578800,1018214.9,76.00394426643919,68.29474464482719,NaN,NaN,150.27064899505436,126.78957990866627,0.08261416471973726,0.39674461245852655,0.3141304477387893,6449572,4074512,97.36483364647368,91.60335609162232,NaN,NaN,39.16128231270275,28.011224791006196
2004-11-16T09:30:00-05:00,20.03,21.07001,20.03,21.02,603000,916604.9,70.2397750632888,69.0149956803571,NaN,NaN,70.28815210493032,112.56268346583995,0.07041552734157885,0.4021498569157629,0.33173432957418403,5846572,4517672,97.51430295557462,92.89750140280209,NaN,NaN,39.48799884118113,29.650763941031187
2004-11-17T09:30:00-05:00,21.25,21.42,21.17,21.25999,702900,941109.9,73.48787990570874,69.90259850553478,NaN,NaN,138.4094319253331,120.14224719339964,0.07136960203982162,0.42094633212396104,0.3495767300841394,6549472,5238572,97.73897475186524,94.08519225561363,NaN,NaN,40.8293956925617,31.247711334106974
2004-11-18T09:30:00-05:00,21.17999,21.37,21.17,21.34,774100,960834.9,74.48760560777411,70.84805632669831,NaN,NaN,125.35538997644268,123.60277515552139,0.07014531206777286,0.4372583701688555,0.36711305810108263,7323572,6007992,97.95176568910503,95.05684605669057,NaN,NaN,42.225203193021194,32.81592445680901
2004-11-19T09:30:00-05:00,21.2,21.36,20.97,21.00999,336200,945064.9,63.801176700468595,70.81600365983586,NaN,NaN,92.26749903848105,115.31822440804831,0.04129345075204488,0.4187298715411387,0.37743642078909384,6987372,6631312,98.10717943743192,95.82050403678333,NaN,NaN,39.86655351963908,33.823157180070446
2004-11-22T09:30:00-05:00,20.89999,21.10001,20.83,21.03999,361900,941189.9,64.30255388975328,70.78048446671419,NaN,NaN,69.81410247436267,99.22691510390997,0.019518506222634235,0.4018345535673866,0.3823160473447524,7349272,6811252,98.15080036876581,96.40950971934362,NaN,NaN,38.17275331639082,34.444528056687645
2004-11-23T09:30:00-05:00,21,21.12,20.86,20.95,490500,949869.9,61.54866486637448,70.40424177846809,NaN,NaN,63.0592933982471,97.78114336257332,-0.004381253499500526,0.37683948047037674,0.38122073396987727,6858772,7013692,98.20103030555947,96.87438241719985,NaN,NaN,35.930948091454454,34.65687377594005
2004-11-24T09:30:00-05:00,20.97,21.12,20.97,21.12,259500,917029.9,64.63035042358698,69.97730938425627,NaN,NaN,74.97990743293207,85.09523846409311,-0.011758001143898578,0.3665232325400041,0.37828123368390265,7118272,7127452,98.23012404867094,97.25448378363338,NaN,NaN,34.951631035280606,34.698981955845845
2004-11-26T09:30:00-05:00,21.2,21.2,21.06,21.09,215500,878844.9,63.66072169791993,69.29673466607282,NaN,NaN,75.50386721310677,75.12493391142593,-0.02112847752141167,0.35187063678213804,0.3729991143035497,6902772,7043292,96.98055220146932,97.41792818117558,NaN,NaN,33.873652274499136,34.58107771565346
2004-11-29T09:30:00-05:00,21.14999,21.27,20.97,21.10001,761000,876169.9,63.85557500843122,68.60035695258975,NaN,NaN,67.38981542624344,70.1493971889784,-0.028655867784746547,0.3371792795726165,0.36583514735736306,7663772,7178572,97.0456096411994,97.50460569738155,NaN,NaN,33.04865712252275,34.36216048806335
2004-11-30T09:30:00-05:00,21.12,21.12,20.98,20.98,294900,871404.9,59.72103803335306,67.63778279647808,NaN,NaN,42.42913023991774,64.67240274208942,-0.042865709272604635,0.3122530107666073,0.3551187200392119,7368872,7182492,97.04759474201691,97.54471880278363,NaN,NaN,31.162314349622573,33.90503961114324
2004-12-01T09:30:00-05:00,21.10001,21.42999,21.05,21.41,1171300,885409.9,67.77273191713421,67.75740062884886,NaN,NaN,101.86320617521581,72.43318529748316,-0.02532102545732795,0.323467438217552,0.3487884636748799,8540172,7518772,97.22015280978552,97.56932602762936,NaN,NaN,31.886689139733203,33.616703829513234
2004-12-02T09:30:00-05:00,21.64999,21.67,21.33,21.47,822900,878619.9,68.71255595645489,67.62671435449705,NaN,NaN,145.7413808997029,86.58547999083733,-0.01234776555984729,0.33335375672507084,0.34570152228491813,9363072,7967732,97.43564372060234,97.58570250921525,NaN,NaN,32.76131323313293,33.49450517288748
2004-12-03T09:30:00-05:00,21.71001,21.82001,21.59,21.62,791100,889604.9,70.99023224998842,67.37248611333398,NaN,NaN,182.1423094904146,107.9131684462989,0.002851867467033309,0.34926635661870975,0.34641448915167644,10154172,8618012,97.71226817961785,97.6214880355813,NaN,NaN,34.20956611269624,33.5966567357173
2004-12-06T09:30:00-05:00,21.5,21.78999,21.5,21.71001,351300,661225,72.29365512199549,67.10746546015943,NaN,NaN,159.0993417337869,126.25507370780758,0.014815236524683195,0.36493353480753044,0.35011829828284724,10505472,9186352,97.92313708981337,97.66136685296271,NaN,NaN,35.80474344966119,33.91209769485214
2004-12-07T09:30:00-05:00,21.78999,21.88,21.39,21.42,929900,684500,62.543138021860095,66.55770567148595,NaN,NaN,118.16744453417539,141.40273656665912,-0.00016271707610238106,0.34991490193771924,0.3500776190138216,9575572,9627692,98.0717703323618,97.70118595130465,NaN,NaN,34.11692441664976,33.94135865510894
2004-12-08T09:30:00-05:00,21.38,21.49001,21.31,21.39999,427200,674180,61.92256173174985,65.73161151620317,NaN,NaN,66.009041042362,134.23190354008835,-0.014010660605496661,0.3325642932569508,0.34657495386244747,9148372,9749332,98.11187787079243,97.72782188837087,NaN,NaN,32.58672254131314,33.74783921028097
2004-12-09T09:30:00-05:00,21.27,21.45,21.03999,21.39,746500,677215,61.59396987951982,64.81063753561358,NaN,NaN,29.690245469027396,111.02167645395325,-0.025753017510581566,0.3143836819742205,0.3401366994848021,8401872,9557092,94.75734418462646,97.49964892376525,NaN,NaN,31.255866224426953,33.39184306944468
2004-12-10T09:30:00-05:00,21.23,21.41,21.23,21.28,520700,676675,57.947643529749506,64.39252802341936,NaN,NaN,26.68897013671363,79.93100858321306,-0.041883787981453424,0.2877819645079853,0.32966575248943875,7881172,9102492,87.16745729430335,96.71824019925607,NaN,NaN,29.06435133246641,32.77362996416207
2004-12-13T09:30:00-05:00,21.5,21.55,21.37,21.53,590300,686475,63.26963945612454,64.3187484210173,NaN,NaN,77.95016536304657,63.701173309064984,-0.0368497088153551,0.2836036164702449,0.3204533252856,8471472,8695692,80.92118578288698,95.48755344312187,NaN,NaN,28.671680882054453,32.18763723814669
2004-12-14T09:30:00-05:00,21.2,21.66,21.2,21.57001,1698400,642455,64.05370357201079,64.4976797571342,NaN,NaN,69.00648167514268,53.86898073725844,-0.03213088996113678,0.28028971283417903,0.3124206027953158,10169872,8814552,81.34188690151103,94.28332891426125,NaN,NaN,28.579539762530214,31.67219474163005
2004-12-15T09:30:00-05:00,21.60001,21.71001,21.47,21.57001,498700,637240,64.05370357201079,64.45649069630731,NaN,NaN,98.03386203160571,60.273944935107195,-0.03033715037632767,0.2744991648249062,0.3048363152012339,10169872,9018852,82.07358683183391,93.12929054163003,NaN,NaN,28.50454016258004,31.21967265890862
2004-12-16T09:30:00-05:00,21.5,21.67,21.36,21.48,657900,634990,60.67442766411475,64.24318397960694,NaN,NaN,62.14257600756099,66.7644110428139,-0.03614590802037726,0.2596539301757623,0.2957998381961396,9511972,9240872,82.86023159673209,92.12069621272023,NaN,NaN,27.50772760838179,30.689394794547646
2004-12-17T09:30:00-05:00,20.89999,21.11,20.89999,20.96001,482200,620395,45.68092218946307,62.944994492537795,NaN,NaN,-101.45932080608583,41.13475285425402,-0.07377319422078643,0.20358334542015655,0.277356539640943,9029772,9470592,83.65923570657615,91.16452664596144,NaN,NaN,21.43942112836625,29.36796998509316
2004-12-20T09:30:00-05:00,21.2,21.2,20.81,20.84,332600,620215,43.037585293114525,61.753319296806474,NaN,NaN,-107.44709509337044,4.05530076297062,-0.10367729996801972,0.14775991468091831,0.25143721464893803,8697172,9515732,83.81886059031913,90.21961706369731,NaN,NaN,15.616660151971212,27.403497151790027
2004-12-21T09:30:00-05:00,20.98,21.10001,20.89999,21.07001,1964900,700365,49.115031592812265,60.42062641649776,NaN,NaN,-86.02374940864921,-26.95074545378776,-0.10459928296476179,0.12068811094298582,0.2252873939077476,10662072,9614172,84.18175580201053,89.28830299171338,NaN,NaN,12.634157243616897,25.293591450622436
2004-12-22T09:30:00-05:00,21.12,21.22,21.02,21.11,633500,707515,50.111632776505765,59.091989046501396,NaN,NaN,-61.18955720417658,-58.795429300944214,-0.09919573058081893,0.10129273068172395,0.20048846126254288,11295572,9839312,85.00978516083825,88.40074166601595,NaN,NaN,10.590392722032597,23.193134489395316
2004-12-23T09:30:00-05:00,21.14999,21.2,21.07001,21.16,1485900,768835,51.393461120189386,57.692219680087184,NaN,NaN,-54.675913338474686,-82.15912717015135,-0.089245816361121,0.08893119081114165,0.17817700717226265,12781472,10493212,87.11883132490338,87.6440676049649,NaN,NaN,9.320596120484682,21.211343293836656
2004-12-27T09:30:00-05:00,21.22,21.22,20.99001,21.03,238100,769965,47.94421026381577,55.952973618788626,NaN,NaN,-74.1330696217992,-76.69387693329402,-0.08825169178440437,0.06786239244175718,0.15611408422616155,12543372,11195932,88.92256744925054,87.00116977349613,NaN,NaN,7.202906413058561,19.21013802515407
2004-12-28T09:30:00-05:00,21.10001,21.16,21.00999,21.14,488200,756325,50.94434011803595,55.12448805422976,NaN,NaN,-66.28037580671564,-68.46053307596306,-0.07740561353315972,0.05935706730971191,0.13676268084287163,13031572,12062812,90.66006075437048,86.47176194649674,NaN,NaN,6.3098181260828365,17.367235182429607
2004-12-29T09:30:00-05:00,21.09,21.2,21.08,21.14,384900,760825,50.94434011803595,54.34032936753591,NaN,NaN,-57.69762214997989,-62.79530762422919,-0.06779661089616176,0.052016917222669434,0.1198135281188312,13031572,12536712,91.44961521848418,85.99588604276043,NaN,NaN,5.588179834972156,15.684512989935685
2004-12-30T09:30:00-05:00,21.16,21.21001,21.13,21.14999,542800,729400,51.24032801859921,53.6007835203273,NaN,NaN,-46.38719613649813,-59.83483541069351,-0.058674642432775787,0.04647022507786147,0.10514486751063726,13574372,12992472,92.1379621103161,85.80878732316684,NaN,NaN,5.071558275140315,14.168376602107775
2004-12-31T09:30:00-05:00,21.14999,21.22,21.09,21.11,489300,712720,49.94130944514973,53.02890251428446,NaN,NaN,-48.79524874472359,-58.65870249194329,-0.053392001673019635,0.03840486541936272,0.09179686709238236,13085072,13053192,92.22773588509831,86.1702357939379,NaN,NaN,4.291652493266633,12.75741601513047
2005-01-03T09:30:00-05:00,21.27,21.3,20.89999,20.92999,1323900,739360,44.47550310485622,51.68646420347958,NaN,NaN,-73.55722146891816,-58.543532861367076,-0.059606760011384124,0.017288417078152207,0.07689517708953633,11761172,12896752,89.39549166475507,86.77554335692848,NaN,NaN,2.0535939692712923,11.228298580007731
2005-01-04T09:30:00-05:00,20.98,21.07001,20.46001,20.53999,764700,760030,35.4285829831439,49.641812732846226,NaN,NaN,-179.25599044821556,-81.13865578966707,-0.08596729282311347,-0.030563938939355495,0.055403353883757965,10996472,12489732,82.31293788798925,86.84490414167693,NaN,NaN,-3.083340427805479,9.183778721748702
2005-01-05T09:30:00-05:00,20.55,20.74001,20.47,20.47,813500,754210,34.08846391176404,47.50143847140003,NaN,NaN,-206.65181662520072,-110.92949468471124,-0.10295471664950641,-0.07329004192812505,0.02966467472138136,10182972,11920012,73.53127504195149,86.23473901382819,NaN,NaN,-7.678306178835145,6.7749094502367235
2005-01-06T09:30:00-05:00,20.50999,20.62,20.39999,20.41,481700,756935,32.93822069547271,45.52028083078273,NaN,NaN,-201.79687412713656,-142.01143028283892,-0.11230455543743575,-0.11071601957541333,0.0015885358620224242,9701272,11145392,63.59658393249053,84.85876418066808,NaN,NaN,-11.793895421949067,4.122223039924467
2005-01-07T09:30:00-05:00,20.39999,20.62,20.34,20.45,395600,739390,34.52441027372919,44.72338712251603,NaN,NaN,-169.10024727081642,-166.0724299880575,-0.10973943870824826,-0.1355857625232879,-0.025846323815039644,10096872,10547752,57.177898454337964,82.96724009122248,NaN,NaN,-14.721617039693186,1.430245885693374
2005-01-10T09:30:00-05:00,20.64999,20.64999,20.39,20.45,493800,738045,34.52441027372919,44.11530319255993,NaN,NaN,-137.35653298506352,-178.83229229128656,-0.10214331452345574,-0.15352546696935931,-0.05138215244590358,10096872,10214892,53.91411438772843,80.83118679103742,NaN,NaN,-17.112948852189422,-1.2187819340041681
2005-01-11T09:30:00-05:00,20.12,20.42,20.12,20.25,733900,745225,30.360272783954358,42.77567756335579,NaN,NaN,-163.28092707952152,-175.63727961754776,-0.1043227812023358,-0.18178562894882333,-0.07746284774648753,9362972,9888192,50.84632855632879,78.4500848449173,NaN,NaN,-20.52265965964457,-3.976478751952797
2005-01-12T09:30:00-05:00,20.25,20.39,20.14,20.36301,2789400,799775,35.1220336575375,41.70499191200092,NaN,NaN,-130.8843358919764,-160.4837834709029,-0.0923018079329419,-0.1928401076626649,-0.100538299729723,12152372,10282072,54.22793125399814,76.25138099442871,NaN,NaN,-22.06151913694699,-6.56005594980911
2005-01-13T09:30:00-05:00,20.35001,20.37,20.10001,20.16,1184600,834070,31.018845853987372,40.24966225012935,NaN,NaN,-128.66563118509868,-145.85753488249532,-0.0919677169233474,-0.21549794588390725,-0.12353022896055985,10967772,10535372,56.309586100589094,74.05072062126341,NaN,NaN,-24.695736567459022,-9.15086746661624
2005-01-14T09:30:00-05:00,20.14,20.3,20.14,20.22,4103500,1006350,33.49190636313466,39.21735482865212,NaN,NaN,-112.03622042345945,-134.4447295130239,-0.08198195411373324,-0.2260076716027264,-0.14402571748899315,15071272,11530252,63.35821976857408,72.22469578692939,NaN,NaN,-26.123439385375907,-11.575520597867621
2005-01-18T09:30:00-05:00,20.19,20.44,20.14,20.44,525300,1008505,41.73962231520279,38.559874985592614,NaN,NaN,-78.76804971787173,-122.72703285958555,-0.056072500923497526,-0.21411634364336507,-0.15804384271986754,15596572,12630192,69.26253808506617,70.69630131055054,NaN,NaN,-24.785787006728125,-13.462701513419121
2005-01-19T09:30:00-05:00,20.44,20.44,20.00999,20.00999,1012500,1042500,33.099479543581126,37.28524208741727,NaN,NaN,-102.60885424636476,-110.59261829295421,-0.06289492253162252,-0.2366624958843957,-0.17376757335277318,14584072,13674412,73.6100386454714,69.42204584104964,NaN,NaN,-26.555717434010607,-15.333132359217904
2005-01-20T09:30:00-05:00,19.98,20.03999,19.79601,19.87,1006300,994570,30.85988284564199,35.82949600363461,NaN,NaN,-132.51061012358298,-110.91787313927553,-0.0712236574161749,-0.2627971451229918,-0.1915734877068169,13577772,13959492,74.66363760197811,68.17387980473977,NaN,NaN,-28.748546319954656,-17.249620067894583
2005-01-21T09:30:00-05:00,20,20,19.72,19.73,1519200,1038855,28.76379021251003,34.316816058446065,NaN,NaN,-134.19259785219802,-112.02326647269538,-0.07989821928934354,-0.2914462618184963,-0.21154804252915277,12058572,14177652,75.47071381218474,66.97694965667452,NaN,NaN,-31.233537606168337,-19.24732257336226
2005-01-24T09:30:00-05:00,19.75,19.8,19.53,19.57001,983100,1013715,26.54484830448729,33.03605500127686,NaN,NaN,-152.19023568965267,-120.05406952593403,-0.08942841484797232,-0.32333356108911815,-0.23390514624114583,11075472,13378492,67.04546065105862,65.38051886998191,NaN,NaN,-34.02183814171436,-21.357967654555416
2005-01-25T09:30:00-05:00,19.59,19.8,19.59,19.60001,1060700,1054845,27.67158354159905,32.48198361259508,NaN,NaN,-132.89620622144798,-130.8797008266493,-0.08666677302952308,-0.34223861252804966,-0.2555718394985266,12136172,12686412,60.72327911930312,63.83840038650434,NaN,NaN,-35.85397087371454,-23.428825257292434
2005-01-26T09:30:00-05:00,19.75,19.85001,19.64999,19.8,363600,1048615,34.846384331365996,32.53612078542379,NaN,NaN,-105.44569150802448,-131.44706827898122,-0.06529971972411691,-0.33719648915367273,-0.2718967694295558,12499772,12269552,57.223120481926344,62.673532203645394,NaN,NaN,-35.107645875977646,-25.097228202818894
2005-01-27T09:30:00-05:00,19.71001,19.84,19.67,19.78,721000,1065420,34.4780434678386,32.64610812630708,NaN,NaN,-98.69421785083765,-124.68378982443214,-0.047281667780277314,-0.3309988541549025,-0.2837171863746252,11778772,11909752,54.31312113765784,62.0104277183002,NaN,NaN,-34.62539052410341,-26.458394248716683
2005-01-28T09:30:00-05:00,19.85001,19.92,19.62,19.78,343200,1055440,34.4780434678386,32.6427962116006,NaN,NaN,-89.3296061759912,-115.71119148919078,-0.030923123303922828,-0.3223710905045287,-0.2914479672006059,11778772,11853792,53.85440521213898,61.77303534385741,NaN,NaN,-34.23806564033424,-27.56977587609062
2005-01-31T09:30:00-05:00,19.8,20,19.8,19.92,1314200,1096685,39.65638741329487,33.00936600728386,NaN,NaN,-55.82905569770902,-96.43895549080204,-0.007457314903261403,-0.3007696108296827,-0.2933122959264213,13092972,12257292,56.69449875177009,61.97163422700323,NaN,NaN,-32.381994659289745,-28.257235702261923
2005-02-01T09:30:00-05:00,20,20.08,19.92999,20.03999,702800,1065630,43.75898470362147,33.96641685868865,NaN,NaN,-24.430120620650474,-74.74573837064256,0.0179730776589323,-0.2708459488527559,-0.2888190265116882,13795772,12589212,58.93355043869171,62.5492929328863,NaN,NaN,-29.569850014426706,-28.444752032571177
2005-02-02T09:30:00-05:00,20,20.14,19.96001,20.05,464400,1050615,44.10042110943133,34.60773024810964,NaN,NaN,-10.003220636714213,-55.65724419638051,0.036242099367179814,-0.24351640230271343,-0.27975850166989324,14260172,12941292,61.22378060277741,63.048996457799106,NaN,NaN,-27.175814187760217,-28.263475197598183
2005-02-03T09:30:00-05:00,20.03,20.03999,19.82001,19.92,987000,1059290,40.64898134170512,35.29559706866092,NaN,NaN,-36.113887378386615,-43.141178101890304,0.04004710607032169,-0.2296996190819911,-0.2697467251523128,13273172,13240172,63.10483606174823,63.534371455024754,NaN,NaN,-26.030164959075787,-27.944430877809268
2005-02-04T09:30:00-05:00,19.95,20.3,19.88,20.25999,847500,1077580,51.36865001714353,36.57250732966155,NaN,NaN,31.509090453537677,-18.97343877598453,0.0644892720061761,-0.18913513514459268,-0.2536244071507688,14120672,13708552,65.89684536689037,63.71570185490449,NaN,NaN,-21.479314568474223,-27.02084283361855
2005-02-07T09:30:00-05:00,20.25999,20.34,20.17999,20.2,931700,1104385,49.66416296242777,37.13854594732048,NaN,NaN,66.11145018924275,5.414662401405826,0.07491233754422971,-0.15998398522048163,-0.23489632276471134,13188972,13727752,66.0103937932393,63.48340583405972,NaN,NaN,-18.301451114221308,-25.775215445133227
2005-02-08T09:30:00-05:00,20.14999,20.39,20.14,20.3,485800,1103985,52.49392875198721,38.52386374792091,NaN,NaN,85.49694064995579,27.400074655527078,0.08604155589296131,-0.12734437789850972,-0.21338593379147103,13674772,13703552,65.71340547951709,62.91936060792012,NaN,NaN,-14.770715623352663,-24.20314404202172
2005-02-09T09:30:00-05:00,20.28,20.31,19.95,19.95,1166200,1125600,43.315484033464344,39.41354954705108,NaN,NaN,21.237523457627827,33.64822347439549,0.06811591029872344,-0.12824104591806673,-0.19635695621679017,12508572,13353232,61.40640463891167,61.97241539627252,NaN,NaN,-14.51447581034741,-22.81904858035396
2005-02-10T09:30:00-05:00,19.95,20.06,19.86,19.99001,412400,1006750,44.50991377565211,40.53827265870409,NaN,NaN,-8.242617886892218,39.22247737269437,0.05765320796158821,-0.1242904462648049,-0.1819436542263931,12920972,13282792,60.54708776534582,60.90644210721259,NaN,NaN,-13.93410334594092,-21.549770689723527
2005-02-11T09:30:00-05:00,19.83,20.23,19.83,20.17999,567300,975885,49.90742483032943,42.20702812483567,NaN,NaN,36.19409040407845,40.15947736280252,0.06185593774182124,-0.10462373204911657,-0.1664796697909378,13488272,13156312,58.951854010540146,60.32832734717556,NaN,NaN,-11.692880305306755,-20.1416434919497
2005-02-14T09:30:00-05:00,20.08,20.27,20.08,20.22,963400,818880,50.988659768866555,43.87253356964049,NaN,NaN,79.71159505780885,42.879506336515746,0.06531864497980541,-0.08483136356618104,-0.15015000854598645,14451672,13408852,61.15267727259664,60.35899864383938,NaN,NaN,-9.564723458420305,-18.630654915731217
2005-02-15T09:30:00-05:00,20.14,20.45,20.14,20.32001,1042600,844745,53.68003642236485,45.21779443328326,NaN,NaN,125.67306838770962,50.91473188406651,0.07181618501420625,-0.06037977727822863,-0.13219596229243488,15494272,13772752,64.13654971414533,60.85281501756931,NaN,NaN,-6.965409383657771,-16.964191268292154
2005-02-16T09:30:00-05:00,20.17,20.32001,20.17,20.25,540100,821125,51.546130329630714,46.436943494839845,NaN,NaN,98.94075475233369,66.45537814300768,0.06886132485079732,-0.04611930622893823,-0.11498063107973555,14954172,14261872,67.72497416797003,61.810804519734475,NaN,NaN,-5.430509985422034,-15.316522513596423
2005-02-17T09:30:00-05:00,20.19,20.27,19.92,19.92,459500,793785,42.891106010769555,47.037876533620626,NaN,NaN,16.558762072432042,71.41565413487254,0.04338787871475658,-0.06074578268628983,-0.1041336614010464,14494672,14576612,69.8177582994648,62.95104402597203,NaN,NaN,-6.801220593743539,-14.100050810760298
2005-02-18T09:30:00-05:00,19.89999,20.02,19.88,19.88,347800,735215,41.971177428622326,47.203218677572586,NaN,NaN,-29.113463353369106,58.35414338338302,0.023543812042970208,-0.07470389634733365,-0.09824770839030386,14146872,14708332,70.67476420161441,63.94963441524663,NaN,NaN,-8.18233244867862,-13.254662473320058
2005-02-22T09:30:00-05:00,19.64999,20.03999,19.64999,19.77,987400,735430,39.46443270899646,46.896464963670795,NaN,NaN,-80.5607867308122,26.299667025658813,0.0037474925485727895,-0.09356334270458788,-0.09731083525316067,13159472,14449892,66.67453383885837,64.50256180097281,NaN,NaN,-10.112708488194807,-12.805811904016451
2005-02-23T09:30:00-05:00,19.72,19.84,19.60001,19.71001,1036600,734225,38.12702823348686,46.469794043960476,NaN,NaN,-128.22487509299594,-24.4799216704823,-0.011798164086332344,-0.1120585403610761,-0.10026037627474375,12122872,13775612,57.526026516642375,64.23843650910602,NaN,NaN,-12.103331894367582,-12.705457616923756
2005-02-24T09:30:00-05:00,19.73,19.92,19.64999,19.88,877600,759925,43.925959415298685,46.70386390636002,NaN,NaN,-87.36903060920618,-61.74187874279028,-0.009160981853886752,-0.1117116035921022,-0.10255062173821544,13000472,13384872,52.988644557808634,63.51585140168178,NaN,NaN,-12.100014322247596,-12.618965717684304
2005-02-25T09:30:00-05:00,19.89999,20.06,19.85001,20.00999,577500,752750,47.943782765479526,46.45923053124117,NaN,NaN,-24.343458209735726,-69.92232279922383,0.0022027792481409403,-0.09979714767803927,-0.1019999269261802,13577972,13201532,50.957669640195306,62.448767421203556,NaN,NaN,-10.875984870674467,-12.369968453825756
2005-02-28T09:30:00-05:00,19.97,20.14999,19.88,19.95,844300,777805,46.295171417833686,46.21858827805587,NaN,NaN,-21.76304150805256,-68.45223843016052,0.006311383437441087,-0.09411069762937885,-0.10042208106681993,12733672,12918892,47.909068833627344,61.15581563837413,NaN,NaN,-10.349539790107738,-12.081335787580324
2005-03-01T09:30:00-05:00,20.10001,20.23,20.03999,20.19,596400,741915,53.22492155310572,46.27080204956434,NaN,NaN,55.03319001772377,-41.33344308045332,0.024787492057983945,-0.06943771599434001,-0.09422520805232396,13330072,12953012,48.31108957512598,59.912793073774765,NaN,NaN,-7.701207806208586,-11.455603218812932
2005-03-02T09:30:00-05:00,20.08,20.28999,20,20.14,451700,729360,51.727415901157116,46.87165432582811,NaN,NaN,45.460987764573005,-6.596270508939531,0.03273670775148958,-0.05330432336296198,-0.08604103111445156,12878372,13104112,50.1460472952103,59.108481834938964,NaN,NaN,-5.993716240610078,-10.675333650498239
2005-03-03T09:30:00-05:00,20.11,20.2,19.91,19.99001,402300,726255,47.41749744094774,47.07933887334923,NaN,NaN,-10.027598081925207,8.87201599651666,0.027215418091975835,-0.05202175849948176,-0.0792371765914576,12476072,12999232,48.84975199837996,58.27295785158425,NaN,NaN,-5.828953549509571,-9.982993636071287
2005-03-04T09:30:00-05:00,19.89999,20.22,19.89999,20.12,744800,714145,51.211503557960185,47.172487353894276,NaN,NaN,10.133029053400648,15.767313449143932,0.03134615184441618,-0.04005448678593737,-0.07140063863035355,13220872,12927812,47.94091621172452,57.486462294526,NaN,NaN,-4.531381764957513,-9.20419194019789
2005-03-07T09:30:00-05:00,20,20.44,20,20.27,540900,698815,55.226149232122935,47.475165172698304,NaN,NaN,87.77378371227111,37.674678493208674,0.042515594223950556,-0.01825614585041535,-0.06077174007436591,13761772,13133432,50.78010290030038,56.745564125076264,NaN,NaN,-2.175049412865269,-8.200028722007517
2005-03-08T09:30:00-05:00,20.2,20.39,20.10001,20.10001,738600,689160,50.186150050843494,47.22560186044678,NaN,NaN,69.43527066266883,40.55509462219768,0.03699332629806572,-0.014530082201783756,-0.051523408499849474,13023172,13072052,49.90514142181252,55.7290349613382,NaN,NaN,-1.7232526277531923,-7.274774994256899
2005-03-09T09:30:00-05:00,19.89999,20.24001,19.89999,20.06,946400,712190,49.051484881807085,47.04741289988795,NaN,NaN,7.860752386287639,33.03504754654061,0.029509208804110884,-0.014636897494710865,-0.04414610629882175,12076772,12911732,47.59822623174831,54.29141010875094,NaN,NaN,-1.6990550062033334,-6.478243567392104
2005-03-10T09:30:00-05:00,20,20.17,19.92999,20.14999,572500,682505,51.69675793364144,47.676388037235945,NaN,NaN,16.756280485983737,38.39182326012239,0.02941681065451006,-0.0073750929806841725,-0.03679190363519423,12649272,12946372,48.15587500304152,52.74413273043499,NaN,NaN,-0.8981292824461884,-5.681084383828402
2005-03-11T09:30:00-05:00,20.00999,20.25,19.84,19.89,565700,690170,44.50699850338174,47.85751811400447,NaN,NaN,-34.54255378577108,29.456706692288055,0.011560289807437119,-0.022341541375897833,-0.03390183118333495,12083572,12718912,44.78560249535173,50.89490689427337,NaN,NaN,-2.4515024583076217,-5.219715537325434
2005-03-14T09:30:00-05:00,19.89,19.99001,19.8,19.97,648700,694240,46.95177915805231,48.39232857465132,NaN,NaN,-68.28430267788191,-1.7549105857425502,0.005176648613626746,-0.02743102041630152,-0.03260766902992827,12732272,12513012,41.925201669576815,49.1270974536104,NaN,NaN,-2.977462112296529,-4.899393619464162
2005-03-15T09:30:00-05:00,19.97,20.08,19.77,19.77,328800,662510,41.97327131632001,48.66706022342511,NaN,NaN,-84.40608076714868,-32.52318087170605,-0.011562117358545725,-0.047060315728110425,-0.0354981983695647,12403472,12389072,40.25839673466256,47.893695326326124,NaN,NaN,-5.028014317044175,-4.917768004832735
2005-03-16T09:30:00-05:00,19.75,19.8,19.50999,19.57001,566800,638720,37.67171599004853,48.22032855019296,NaN,NaN,-188.61978768578385,-71.81928888612035,-0.03388681057705733,-0.07785671159088636,-0.043969901013829034,11836672,12341052,39.60147098920353,46.93746864285434,NaN,NaN,-8.208572501487337,-5.387882932926249
2005-03-17T09:30:00-05:00,19.53999,19.66,19.5,19.56,336800,628555,37.46475614756691,47.471826648913485,NaN,NaN,-181.48692842408298,-111.46793066813368,-0.04634104279987987,-0.10189620451367887,-0.055555161713799,11499872,12111172,36.528520220991545,45.90681511291121,NaN,NaN,-10.77936846627496,-6.158095151976065
2005-03-18T09:30:00-05:00,19.5,19.62,19.3792,19.45,1347300,672945,35.17767731831155,46.67771992751904,NaN,NaN,-181.3694789851161,-140.8333157080027,-0.05823129745520447,-0.12834428353280458,-0.07011298607760011,10152572,11724972,32.0315682348446,44.772707927283875,NaN,NaN,-13.64655946425908,-7.227875768016496
2005-03-21T09:30:00-05:00,19.46001,19.56,19.35001,19.45,849100,698010,35.17767731831155,45.38863105360518,NaN,NaN,-158.24841331531945,-158.82613783549021,-0.06199209117471287,-0.1476031000459912,-0.08561100887127833,10152572,11209032,27.211904650636782,43.26562328982036,NaN,NaN,-15.95342343718173,-8.474382577897243
2005-03-22T09:30:00-05:00,19.45,19.55,19.23,19.28,1544600,725870,31.708262194902773,43.95869150315844,NaN,NaN,-161.32536282782783,-174.20999424762604,-0.07116805958579325,-0.1745710833535199,-0.10340302376772664,8607972,10449932,21.973274092197812,41.253282346748044,NaN,NaN,-19.041142749762642,-9.983919745306586
2005-03-23T09:30:00-05:00,19.10001,19.46001,19.10001,19.36,662300,707155,34.959143458039904,43.068809075807884,NaN,NaN,-151.9424330603951,-166.8745233225483,-0.06714051279947379,-0.1873286647670689,-0.1201881519675951,9270272,9936652,19.271689037791518,39.140563563848865,NaN,NaN,-20.7031946749858,-11.51524473526076
2005-03-24T09:30:00-05:00,19.3,19.56,19.3,19.37,450500,685800,35.37327640081908,41.93750713601209,NaN,NaN,-106.98621223619396,-151.9743800849705,-0.05936259879720576,-0.1943914004641023,-0.13502880166689654,9720772,9580832,17.65149830505959,36.9770337133728,NaN,NaN,-21.949660897150018,-13.005875615530654
2005-03-28T09:30:00-05:00,19.39,19.61,19.39,19.39,645000,689175,36.247585191669195,40.58189541883683,NaN,NaN,-82.27504935347004,-132.1554941586413,-0.04886828237640234,-0.19611415463739945,-0.1472458722609971,10365772,9623472,18.535365472880883,34.67383818284283,NaN,NaN,-22.758427711476077,-14.399097343522858
2005-03-29T09:30:00-05:00,19.25,19.48,19.2,19.24001,735800,683750,32.67720398266961,39.33125641396726,NaN,NaN,-103.00898204634814,-121.10760790484701,-0.047958490924726815,-0.20719398591690563,-0.15923549499217882,9629972,9518952,18.024665994426456,32.39666136660097,NaN,NaN,-24.48873606529261,-15.840474303775679
2005-03-30T09:30:00-05:00,19.27,19.58,19.27,19.53,929500,700405,44.134553969099045,38.980047063059544,NaN,NaN,-63.143134691314515,-101.47116227754437,-0.02491598398353484,-0.19038047497159738,-0.16546449098806254,10559472,9909252,26.201677083927763,30.868336427470933,NaN,NaN,-22.57099269672132,-16.801976931339343
2005-03-31T09:30:00-05:00,19.53,19.64999,19.48,19.56,545600,705100,45.174069453237315,38.51414074303068,NaN,NaN,-36.148949207071205,-78.31246550687958,-0.00574421189373181,-0.17264475585522732,-0.1669005439614955,11105072,10276212,32.97147795698518,29.783736638466905,NaN,NaN,-20.70785117569244,-17.35995896624693
2005-04-01T09:30:00-05:00,19.5,19.7,19.35001,19.39,2045300,787250,40.56749367809169,38.23274754122424,NaN,NaN,-50.14509565565822,-66.94424219077243,-0.002753997935676683,-0.17034304138109135,-0.16758904344541467,9059772,10144012,31.838354002612547,28.85893317469982,NaN,NaN,-20.466874144358947,-17.803803991691503
2005-04-04T09:30:00-04:00,19.35001,19.52,19.28999,19.46001,963600,798190,43.139066511098754,37.96041092358471,NaN,NaN,-58.806514363333804,-62.250535192745176,0.005260331328751172,-0.1610136292844757,-0.16627396061322688,10023372,10075532,31.239447092035675,28.095664990589743,NaN,NaN,-19.49317219017841,-18.04514230576106
2005-04-05T09:30:00-04:00,19.53,19.58,19.48,19.5,545500,798420,44.61326697269128,38.14898204189694,NaN,NaN,-30.375338563477996,-47.72380649617115,0.014075758723872622,-0.14867926220838612,-0.16275502093225874,10568872,10263312,34.85804061031601,27.709925267422136,NaN,NaN,-18.262069216008545,-18.076131864367845
2005-04-06T09:30:00-04:00,19.59,19.66,19.46001,19.47,453200,784150,43.697977580558266,38.57942929836192,NaN,NaN,-21.53336211839762,-39.40185198158777,0.01843249984464665,-0.13971439612645042,-0.15814689597109707,10115672,10174552,33.94859875847658,27.30614867951307,NaN,NaN,-17.493726654981074,-17.992931120169736
2005-04-07T09:30:00-04:00,19.49001,19.74001,19.49001,19.73,658600,769760,52.7462813035251,39.67096680950179,NaN,NaN,31.05463685299958,-25.961134769573608,0.03823134633050268,-0.11035771305796871,-0.1485890593884714,10774272,10108392,33.25220432417581,27.072126115454804,NaN,NaN,-13.96068796433104,-17.41689638362135
2005-04-08T09:30:00-04:00,19.75999,19.78,19.56,19.59,426800,762475,48.249750075705,40.60468629217275,NaN,NaN,42.600297744009865,-7.412056089639998,0.04105691454831023,-0.09726791620308362,-0.13832483075139385,10347472,10365932,38.53759244708109,27.536842130614552,NaN,NaN,-12.31847415069544,-16.68855035034622
2005-04-11T09:30:00-04:00,19.67999,19.67999,19.46001,19.48,717000,770040,45.00350405562604,41.30653105912379,NaN,NaN,6.227842644753456,5.594815311977454,0.03491679272105447,-0.09467883985007575,-0.12959563257113021,9630472,10287352,37.56030771334653,28.276013777950965,NaN,NaN,-11.940746389283074,-16.01029264162291
2005-04-12T09:30:00-04:00,19.46001,19.62,19.261,19.60001,635100,769360,49.032433777531566,42.543971886454415,NaN,NaN,-9.91325898390183,9.68723122789269,0.03807814382123413,-0.08199795279458755,-0.12007609661582168,10265572,10226692,36.78481070724839,29.33398067902601,NaN,NaN,-10.3677122126263,-15.204209723194824
2005-04-13T09:30:00-04:00,19.52,19.561,19.25,19.32001,788000,792320,41.41012567117381,43.00475633024969,NaN,NaN,-88.73353880835322,-3.7528041100984324,0.021289263208413123,-0.09346451760530528,-0.1147537808137184,9477572,10099072,35.14094824667551,30.46749919394629,NaN,NaN,-11.488144076488636,-14.673343202236797
2005-04-14T09:30:00-04:00,19.24001,19.28999,19.03,19.05,663600,797160,35.65414215187957,43.02481816961116,NaN,NaN,-245.30016562347234,-59.02376460539282,-0.00653491935355785,-0.12292243000566572,-0.11638751065210787,8813972,9707012,30.61463581018377,31.393437587169448,NaN,NaN,-14.508554362722784,-14.64980193944908
2005-04-15T09:30:00-04:00,18.81,18.84,18.46001,18.47,1393900,850015,26.97907452296289,42.362781693275,NaN,NaN,-391.2147945359781,-145.7867830613904,-0.05958516896449939,-0.1908689718577321,-0.13128380289323272,7420072,9121532,25.361183636479453,31.880996027426484,NaN,NaN,-20.937457938979097,-15.548038510810512
2005-04-18T09:30:00-04:00,18.55,18.64999,18.47,18.49001,2042500,884775,27.63326711515691,42.002500488452654,NaN,NaN,-281.7278456570231,-203.37792072174574,-0.08723860382547449,-0.24033205767507582,-0.15309345384960132,9462572,9087952,25.095197128430712,32.386033965569645,NaN,NaN,-25.35183581874032,-16.94858098337191
2005-04-19T09:30:00-04:00,18.72,18.75999,18.60001,18.72,706700,877655,34.8571634101168,41.339829734239636,NaN,NaN,-176.21883347500554,-236.63903561996648,-0.08392490099557953,-0.25799958009407575,-0.17407467909849622,10169272,9068692,24.933673289422472,32.29546226596212,NaN,NaN,-26.30748092541709,-18.285566689378367
2005-04-20T09:30:00-04:00,18.95,18.95,18.48,18.55,795200,840185,32.29124973430626,40.41962832574456,NaN,NaN,-147.57346578221998,-248.4070210147398,-0.08671045149697493,-0.2824627434697149,-0.19575229197273997,9374072,9047992,24.749295921420853,31.708163549136106,NaN,NaN,-27.982276155691693,-19.6708108988517
2005-04-21T09:30:00-04:00,18.64999,19.06,18.64999,19.05,1466300,880385,45.093337765631794,40.742902903426,NaN,NaN,-75.30659625393874,-214.40830714083307,-0.05021740724754262,-0.25852405103216825,-0.20830664378462563,10840372,9453272,34.899508226734696,31.926817422287687,NaN,NaN,-24.506833203014153,-20.361671228017762
2005-04-22T09:30:00-04:00,18.89999,18.99001,18.69,18.82001,650400,890380,41.231542661118816,40.606651199856,NaN,NaN,-81.59217498031224,-152.48378322969992,-0.03749012722378092,-0.2551693028143518,-0.21767917559057087,10189972,10007252,45.68433671113368,32.958595252223255,NaN,NaN,-23.22216339575801,-20.77031296626637
2005-04-25T09:30:00-04:00,18.92,19.05,18.88,18.95,787600,897510,44.143189214017625,40.573074217093605,NaN,NaN,-49.979916137727585,-106.1341973258408,-0.01726742264248249,-0.23926345389367398,-0.2219960312511915,10977572,10310252,50.51326747733085,34.07682574272432,NaN,NaN,-21.18685984544622,-20.829819663292064
2005-04-26T09:30:00-04:00,18.88,19.10001,18.8,18.82001,538500,887645,41.90720983611314,40.445162235347524,NaN,NaN,-54.44549280619292,-81.77952919207827,-0.009958799039886834,-0.23444453005105004,-0.2244857310111632,10439072,10364212,51.342900638189306,35.319275876989515,NaN,NaN,-20.342989252700598,-20.760272461778996
2005-04-27T09:30:00-04:00,18.7,18.98,18.7,18.89,426700,862505,43.564754497978306,39.78933889209418,NaN,NaN,-57.58387061353567,-63.781610158341394,0.0016573531941297404,-0.22241403951850103,-0.22407139271263077,10865772,10662552,55.75907072505457,36.926909191338,NaN,NaN,-19.141135323011138,-20.528967156240732
2005-04-28T09:30:00-04:00,18.81,18.92,18.7,18.7,360500,853250,40.210580150907845,39.21511246889438,NaN,NaN,-66.55915937984531,-62.032122783522745,-0.0012312888303938618,-0.22561050375062308,-0.22437921492022922,10505272,10595532,54.56106191415408,38.071442724700354,NaN,NaN,-19.21320528400444,-20.34100117449269
2005-04-29T09:30:00-04:00,18.89,18.9276,18.63,18.87,423700,772170,44.33986304007048,39.167709539211835,NaN,NaN,-54.29200143314829,-56.57208807408996,0.009917337827237693,-0.2119825426361821,-0.2218998804634198,10928972,10743332,56.7671026155584,39.44335664628692,NaN,NaN,-17.95597894986038,-20.00028371383093
2005-05-02T09:30:00-04:00,18.96001,19.03,18.8,18.85001,316200,739800,43.95543817813768,38.80506699639799,NaN,NaN,-34.238431508436356,-53.4237911482317,0.017132501548438317,-0.20048425352787191,-0.21761675507631023,10612772,10670372,55.338832290407254,40.768643902226835,NaN,NaN,-17.072351209970257,-19.582007641850836
2005-05-03T09:30:00-04:00,18.84,19.05,18.84,18.98,285000,726775,47.16343220748099,39.216017463277076,NaN,NaN,-17.392409549791232,-46.01317449695137,0.031036340882960062,-0.17882132897261016,-0.20985766985557022,10897772,10762112,56.81030566715254,42.31645514654663,NaN,NaN,-15.372320164947434,-18.980623716578922
2005-05-04T09:30:00-04:00,19.03,19.19,18.95,19.11,415500,724890,50.23155167139804,40.25726100038554,NaN,NaN,16.185873046358196,-31.259225764972598,0.04833355035556838,-0.14944073191110974,-0.19777428226667812,11313272,10851612,58.25532096238801,44.290789800275505,NaN,NaN,-13.024031311990228,-18.129681944494823
2005-05-05T09:30:00-04:00,19.11,19.22,19.00999,19.08,719600,727940,49.516966038659675,41.86711039436388,NaN,NaN,31.46979707293806,-11.653434474415922,0.056529922038433045,-0.1271118797186368,-0.18364180175706984,10593672,10869292,58.55034482471856,46.66144417086401,NaN,NaN,-11.300549479709543,-17.154091592382642
2005-05-06T09:30:00-04:00,19.14999,19.2,19.10001,19.13,350800,724140,50.773883316139276,43.5200115515769,NaN,NaN,56.67252549835558,10.539470911884852,0.0635689675379926,-0.1041805923345791,-0.1677495598725717,10944472,10872392,58.60558586835656,49.055043366572995,NaN,NaN,-9.511260307790405,-16.062258551726607
2005-05-09T09:30:00-04:00,19.17999,19.24001,19.05,19.21001,271600,701870,52.79909544406503,44.801578125430346,NaN,NaN,77.66721646976708,32.92060050752554,0.07128390656590089,-0.07864467666519559,-0.14992858323109648,11216072,10993052,60.7956723933729,51.616614731140885,NaN,NaN,-7.427748544363618,-14.828757122103323
2005-05-10T09:30:00-04:00,19.16,19.17,18.95,19.00999,345700,687400,47.53414306339719,45.89035622036541,NaN,NaN,48.82771972236163,46.16462636195611,0.06098472186979659,-0.07369768089385076,-0.13468240276364735,10870372,10987572,60.63875476773525,54.180147505877635,NaN,NaN,-7.02564516447326,-13.714026842441886
2005-05-11T09:30:00-04:00,19.00999,19.16,18.85001,19.10001,1855500,740775,49.952926157572485,46.23746967693261,NaN,NaN,58.986270855537555,54.72470592379197,0.05830521239200785,-0.06180088727363753,-0.12010609966564538,12725872,11270092,65.57231271894503,56.37106211246408,NaN,NaN,-6.007346884356265,-12.613072562715368
2005-05-12T09:30:00-04:00,19.14,19.3,19.05,19.12,301200,722655,50.49867826060166,46.89940793403853,NaN,NaN,110.66645228810329,70.56403696682503,0.0559399916677997,-0.05018111008089576,-0.10612110174869546,13027072,11756772,72.06736069228887,58.25556382540374,NaN,NaN,-5.014584280992168,-11.527574236754912
2005-05-13T09:30:00-04:00,19.24001,19.46001,19.16,19.36,1858000,745860,56.61560654467922,47.790294886228644,NaN,NaN,165.34890401906966,92.29931267096784,0.06780877548427558,-0.021360132393350995,-0.08916890787762657,14885072,12544892,78.98235825539058,60.289070309550866,NaN,NaN,-2.332974270721684,-10.214059955893022
2005-05-16T09:30:00-04:00,19.39,19.55,19.31,19.53999,716200,679545,60.5525349104941,49.12210382011299,NaN,NaN,196.19466174372562,116.00480172575953,0.0839927284071296,0.015822002631285415,-0.06817072577584418,15601272,13421932,83.79121855041177,62.60680730328104,NaN,NaN,1.2033359297635593,-8.583003400799225
2005-05-17T09:30:00-04:00,19.49001,19.66,19.37,19.61,420700,665245,61.99709996918666,50.438699925199295,NaN,NaN,195.78376880360122,145.39601154200744,0.09482285308752766,0.050357840583565405,-0.04446501250396226,16021972,14452252,87.42983686878172,64.86900488497584,NaN,NaN,4.574760428558268,-6.703322853748155
2005-05-18T09:30:00-04:00,19.62,19.95,19.62,19.89,1383800,694675,67.174502785448,52.36469439909502,NaN,NaN,242.20274748053168,182.03930686700627,0.11491451967695754,0.09917813709223466,-0.015736382584722874,17405772,15388232,89.69334900460285,67.37845396286504,NaN,NaN,9.284397115714295,-4.419362858110662
2005-05-19T09:30:00-04:00,19.96001,20.03999,19.89,20,861300,664425,68.96341287092159,54.12351938701296,NaN,NaN,225.96763515107457,205.09954343960052,0.12864698666239702,0.1450723507432734,0.01642536408087638,18267072,16436232,91.5320099439849,69.86166162918121,NaN,NaN,13.766750336329656,-1.821346687476331
2005-05-20T09:30:00-04:00,19.91,20.09,19.91,20.03,470400,655425,69.45236688770873,55.94472858055376,NaN,NaN,183.52266588098414,208.73429581198343,0.13227512631239696,0.1817692719713726,0.04949414565897563,18737472,17206712,92.5800329727983,72.52174739220915,NaN,NaN,17.553227053924413,0.946449561295204
2005-05-23T09:30:00-04:00,20.08,20.17999,20.03999,20.10001,1019200,667005,70.61577427499117,57.61989587109019,NaN,NaN,164.27812859978732,202.3509891831958,0.13163173922619653,0.2140338196917213,0.08240208046552476,19756672,18037792,93.51268871509679,75.14334618134801,NaN,NaN,21.06854760552283,3.821034996184865
2005-05-24T09:30:00-04:00,20.06,20.21001,20.00999,20.2,842300,682195,72.24179757245,59.19205629259391,NaN,NaN,142.70728775909723,191.73569297429498,0.12995800755036788,0.2448495899034846,0.11489158235311672,20598972,18953192,94.35443222908538,77.72185412896927,NaN,NaN,24.549029159778563,6.782177019555393
2005-05-25T09:30:00-04:00,20.14999,20.14999,20,20.11,1085600,715140,68.56406862879233,60.55256362046053,NaN,NaN,114.67230762234286,166.2296050026572,0.11530529709128262,0.25902320371722,0.14371790662593736,19513372,19374712,94.69572938921598,80.30366731214765,NaN,NaN,26.492561526838802,9.597946234881594
2005-05-26T09:30:00-04:00,20.21001,20.37,20.21001,20.34,780700,736150,72.42722010774736,62.09923053414683,NaN,NaN,130.53695575285818,147.14346912301394,0.11344458179589209,0.2855236338708025,0.1720790520749104,20294072,19780112,95.0082834921524,82.90385999956163,NaN,NaN,29.416938173785223,12.429230797582111
2005-05-27T09:30:00-04:00,20.39999,20.39999,20.24001,20.31,447500,737340,71.19819016985406,63.4134515859889,NaN,NaN,115.87568395133026,133.61407273708318,0.10284802727546444,0.30063908616924095,0.19779105889377652,19846572,20001932,95.17578839404965,85.35958257103856,NaN,NaN,31.456891788544166,15.147468082005261
2005-05-31T09:30:00-04:00,20.33,20.33,20.17999,20.17999,471700,745115,65.97339057792209,64.73054069416925,NaN,NaN,91.47593657943726,119.05363433301315,0.08071469085146893,0.29868442245811266,0.21796973160664374,19374872,19925572,94.00633044418926,87.7429808336424,NaN,NaN,31.70715042608519,17.513136988302392
2005-06-01T09:30:00-04:00,20.2,20.45,20.16,20.3792,838400,772785,69.64872364743124,66.1373833720163,NaN,NaN,95.1256489843092,109.53730657805554,0.07333667527857135,0.3096405757048579,0.23630390042628657,20213272,19848432,92.76625938910003,89.68540559579635,NaN,NaN,33.02704967796796,19.729410229683186
2005-06-02T09:30:00-04:00,20.36,20.47,20.17,20.47,459400,774980,71.1769154921499,67.6144003171269,NaN,NaN,91.80508094358983,104.96386124230494,0.06850815467307941,0.32193909376763585,0.25343093909455644,20672672,20080292,93.06248610034717,91.18505741065766,NaN,NaN,34.58407751467074,21.851505556109977
2005-06-03T09:30:00-04:00,20.42999,20.44,20.21001,20.25,584900,768245,62.91170548144591,68.06412166975308,NaN,NaN,75.5494099425145,93.96635208023619,0.04554005329332267,0.3103560057112098,0.26481595241788713,20087772,20039032,92.33783484694823,92.13902002434034,NaN,NaN,33.376092923291594,23.497875179993066
2005-06-06T09:30:00-04:00,20.3,20.3,20.1208,20.22,1739000,837655,61.85686713988353,68.1572882575666,NaN,NaN,57.88156019342189,82.36752732865452,0.024428001065740612,0.29535095375006293,0.2709229526843223,18348772,19739472,87.03868730424263,92.3709820781854,NaN,NaN,32.08392503053672,24.72445373007073
2005-06-07T09:30:00-04:00,20.25999,20.42999,20.13,20.142,1030200,875585,59.083064891458754,67.94914289487177,NaN,NaN,56.80856095355441,75.43405220347793,0.002467088933924,0.2740068138517273,0.2715397249178033,17318572,19328212,80.23119848044811,91.85679362187587,NaN,NaN,30.18020960708104,25.50384742678649
2005-06-08T09:30:00-04:00,20.28,20.28999,20.12,20.17999,598700,888235,60.023336862361205,67.43834532893699,NaN,NaN,46.72109576025263,65.75314155866663,-0.011478057006592102,0.25719215365956316,0.26867021066615526,17917272,18869012,73.33432883414197,90.68829218112866,NaN,NaN,28.86121698614027,25.983471649551316
2005-06-09T09:30:00-04:00,20.25,20.33,20.09,20.28,1752700,883095,62.468485696474524,66.97442195933363,NaN,NaN,50.72570894629599,57.537267159207865,-0.015683916072473214,0.24906531557556377,0.264749231648037,19669972,18668472,70.48470560222127,89.1849132995741,NaN,NaN,28.400648269684158,26.32878259528458
2005-06-10T09:30:00-04:00,20.28999,20.28999,20.05,20.17,452500,890660,58.2484414047217,66.1741415676917,NaN,NaN,29.684139376931657,48.364213046091294,-0.02693150148567236,0.23108485479094654,0.2580163562766189,19217472,18494412,68.0143288592487,87.43022014860628,NaN,NaN,26.78669456580578,26.394198591073323
2005-06-13T09:30:00-04:00,20.10001,20.36,20.10001,20.25,734700,834495,60.346508850988606,65.44062260883437,NaN,NaN,45.52951631983015,45.893804271372964,-0.029816349074427595,0.2207459199335844,0.250562269008012,19952172,18815092,70.09395318073932,85.75745332472361,NaN,NaN,25.994288875295307,26.337068631676463
2005-06-14T09:30:00-04:00,20.24001,20.3,20.11,20.13,540200,825695,55.815667860463385,64.26732762940676,NaN,NaN,14.55763494242185,37.44361906914646,-0.040003941403154775,0.20055734225406852,0.2405612836572233,19411972,19233772,72.59886793061813,84.20348444626165,NaN,NaN,23.98727723454298,26.00138414637168
2005-06-15T09:30:00-04:00,20.28,20.28999,19.98,20.25,499200,829620,59.12097542992753,63.59282097234499,NaN,NaN,-5.634481381963945,26.972503640703138,-0.03882728584248252,0.19202717635412014,0.23085446219660266,19911172,19632552,74.76678362707027,82.7799883203941,NaN,NaN,23.19400190228686,25.60032954007385
2005-06-16T09:30:00-04:00,20.25,20.34,20.19,20.28999,593100,790085,60.18976729832519,62.718717200243404,NaN,NaN,57.76748666002464,28.38085918344887,-0.03560697813929253,0.186345739522487,0.22195271766177954,20504272,19799412,75.63541682492853,81.39621212987812,NaN,NaN,22.834180535819424,25.205165396608933
2005-06-17T09:30:00-04:00,20.42999,20.42999,20.25,20.3,575600,775800,60.46838234030893,61.95230235527589,NaN,NaN,97.4093988713944,41.925911082341415,-0.0331066607719214,0.1805693916968778,0.2136760524687992,21079872,20171892,77.49762239997253,80.13348598744403,NaN,NaN,22.61150348354789,24.83464226617164
2005-06-20T09:30:00-04:00,20.24001,20.39999,20.13,20.27,698800,787220,59.13268126444196,61.46368026145588,NaN,NaN,34.79618299467365,39.779244417310125,-0.03366657811914184,0.1715928298198719,0.20525940793901373,20381072,20257672,77.91623237400604,78.98419326814523,NaN,NaN,22.069213642665066,24.43958103424213
2005-06-21T09:30:00-04:00,20.32001,20.39,20.25,20.36,712900,771905,61.854915226374665,60.906979659951844,NaN,NaN,95.5503144482167,55.97778031846908,-0.028380386906610322,0.16978392430575084,0.19816431121236117,21093972,20594072,79.52488455295739,78.03838077984935,NaN,NaN,22.315535284917004,24.136145927195685
2005-06-22T09:30:00-04:00,20.37,20.48,20.31,20.39999,744900,767035,63.03321176141713,60.32528653632807,NaN,NaN,145.3619390044077,86.17706439574343,-0.02283391571014462,0.1696219165746804,0.19245583228482502,21838872,20979612,81.21386478309338,77.19205068575978,NaN,NaN,22.837745452261917,23.95066014506229
2005-06-23T09:30:00-04:00,20.39999,20.60001,20.24001,20.24001,867800,756145,55.62994169241173,59.805160551397066,NaN,NaN,99.13124783800424,94.44981663133933,-0.03012463636833057,0.1548000368244118,0.18492467319274236,20971072,21072972,81.60947581918549,76.42573932663387,NaN,NaN,21.22956249235656,23.561931908961473
2005-06-24T09:30:00-04:00,20.28,20.28,19.95,19.99001,773200,755770,46.448959491240466,58.704595719351126,NaN,NaN,-187.52893192709465,37.46215047164153,-0.05075547451602297,0.12148033004771364,0.1722358045637366,20197872,20896572,78.25617887120494,75.79841729570262,NaN,NaN,16.801345841439154,22.596133899315426
2005-06-27T09:30:00-04:00,19.91,20.00999,19.8,19.83,1537700,810280,41.704808802415556,57.463291712990895,NaN,NaN,-296.6071541478002,-28.818516956853237,-0.07280750367841865,0.0812264249657133,0.15403392864413196,18660172,20552392,72.03666083510927,75.21309317817841,NaN,NaN,11.40967750751512,20.99806870048681
2005-06-28T09:30:00-04:00,19.92,20.11,19.89999,20.08,558200,814605,50.253885566706685,56.765473763301294,NaN,NaN,-145.052509758597,-76.93908179821598,-0.0682624806576396,0.06870582782208245,0.13696830847972205,19218372,20177272,65.89016021422579,74.6813668481844,NaN,NaN,9.49056931775539,19.354140217239465
2005-06-29T09:30:00-04:00,20.10001,20.19,20.05,20.11,588700,802120,51.1791330288661,55.959091429900695,NaN,NaN,-72.76695673724669,-120.56486094654686,-0.061169500254398795,0.06050643316172355,0.12167593341612234,19807072,19770912,59.925178608248004,73.92711492004344,NaN,NaN,8.285616139952245,17.77292249191272
2005-06-30T09:30:00-04:00,20.16,20.17,19.88,19.92,825400,820420,45.41757771613754,55.042601166430394,NaN,NaN,-141.89730524835426,-168.77057156381858,-0.06675180365479141,0.038236178847633084,0.1049879825024245,18981672,19373032,54.70328747975017,72.97632625007925,NaN,NaN,5.3254985238970844,15.994719067910486
2005-07-01T09:30:00-04:00,20.03999,20.08,19.92,19.97,980000,840175,47.105145870972244,54.09678952500065,NaN,NaN,-122.98168967692551,-155.86112311378474,-0.06451771563441097,0.024340837959410777,0.08885855359382175,19961672,19325792,54.10050275278626,71.83393693379689,NaN,NaN,3.491879678940553,14.208599155200496
2005-07-05T09:30:00-04:00,19.84,20.16,19.84,20.10001,636300,785040,51.319713965345784,53.77564996106368,NaN,NaN,-84.47375517177434,-113.43444331857957,-0.05224847927926121,0.023547954494745227,0.07579643377400644,20597972,19713352,58.17264514415296,70.80349244904939,NaN,NaN,3.279807456868264,12.647343198295891
2005-07-06T09:30:00-04:00,20.07001,20.24001,20.05,20.05,540400,760550,49.679934492770535,53.1012898941239,NaN,NaN,-32.85621224367328,-90.99518381559483,-0.045701950992100365,0.018668995033880975,0.06437094602598134,20057572,19881192,59.83455997404629,69.73690504526195,NaN,NaN,2.6083087830964633,11.213195424695973
2005-07-07T09:30:00-04:00,20.28,20.28,19.82001,20.09,1149300,788080,51.02777611859972,52.44686195271493,NaN,NaN,-56.31500940835647,-87.70479434981678,-0.0372370931740164,0.01782457955846084,0.05506167273247724,21206872,20161152,62.51030925643857,68.79939736179838,NaN,NaN,2.4552956134391835,9.962066880230719
2005-07-08T09:30:00-04:00,20.12,20.46001,20.07001,20.45,1272200,764055,61.12118522860256,52.4934907304502,NaN,NaN,88.1580265578325,-41.69372798857941,-0.007507082115224627,0.04567782008844645,0.05318490220367108,22479072,20860632,68.2088440893219,68.1359131967519,NaN,NaN,5.733090914095444,9.357927456497109
2005-07-11T09:30:00-04:00,20.5,20.66,20.46001,20.66,793600,781110,65.57800947749001,52.95387131709648,NaN,NaN,189.99720121046752,20.902050188899196,0.024437479300167313,0.08373175132888022,0.05929427202871291,23272672,21522832,72.47449408396697,67.74721760460625,NaN,NaN,10.095597070426669,9.463308829915617
2005-07-12T09:30:00-04:00,20.85001,20.85001,20.60001,20.77,721100,780430,67.66871800583311,53.369142944200654,NaN,NaN,206.70877608610607,79.13855644047528,0.049658026940542,0.1213668057043904,0.0717087787638484,23993772,22201992,76.02724280810133,67.49738605140224,NaN,NaN,14.331005743377782,10.158694103267354
2005-07-13T09:30:00-04:00,20.83,20.92,20.77,20.86,688600,787850,69.31109700156979,53.81756331849728,NaN,NaN,200.9983877364674,125.90947643650343,0.067952456265707,0.15664934909598216,0.08869689283027515,24682372,23126952,79.84307300687695,67.39947235310107,NaN,NaN,18.298731765060015,11.321556626380591
2005-07-14T09:30:00-04:00,21.05,21.11,20.96001,21.03999,1471900,836485,72.33753565298065,55.01096288710935,NaN,NaN,211.3440409741983,179.4412865130144,0.08653477877052111,0.19686536629342655,0.11033058752290544,26154272,24116432,82.96657500610688,67.49640800930975,NaN,NaN,22.69487748856294,12.946316749549498
2005-07-15T09:30:00-04:00,21.07001,21.09,20.95,21.03,1455300,879595,71.91363552312903,56.829868317958535,NaN,NaN,170.87963189102382,195.98560757965265,0.09200212105430466,0.22533323884078627,0.1333311177864816,24698972,24560412,84.15316599007177,67.91762137494308,NaN,NaN,26.01086239884521,14.812680413734599
2005-07-18T09:30:00-04:00,21.07001,21.10001,20.87,20.91,1406200,921125,66.84632175756256,58.6256906718976,NaN,NaN,129.72959500320232,183.93208633819958,0.08173236805748546,0.23549657785833844,0.15376420980085298,23292772,24564432,84.16392306006298,68.7838543910112,NaN,NaN,27.261380094257824,16.591066082380774
2005-07-19T09:30:00-04:00,21.14999,21.25999,21.03,21.22,1899900,981180,72.280324202764,60.19900771733027,NaN,NaN,144.03822389908066,171.3979759007945,0.08939257688107455,0.2655049309021962,0.17611235402112163,25192672,24804212,84.8255833576724,70.13638461554311,NaN,NaN,30.239863210358852,18.540894243520498
2005-07-20T09:30:00-04:00,20.96001,21.23,20.88,21.14999,1376300,1014350,69.5094609141049,61.50831685199018,NaN,NaN,109.50695931665044,153.0996902168311,0.08343428341586043,0.28040520829094717,0.19697092487508674,23816372,24631012,82.15538738930998,71.72425667133324,NaN,NaN,31.73115417857199,20.425217091384997
2005-07-21T09:30:00-04:00,21.14999,21.17999,20.97,21.00999,1616000,1057905,64.20866269094577,62.85053720733362,NaN,NaN,90.94974780351376,129.0208315826942,0.0645957582397943,0.27771562267482963,0.21311986443503533,22200372,23840232,71.1438904175013,72.89858545260118,NaN,NaN,31.27768538366506,21.975569704567864
2005-07-22T09:30:00-04:00,21.06,21.08,20.89999,20.96001,1023300,1065680,62.37974628306333,63.94158009391156,NaN,NaN,71.27300729453835,109.09950666339712,0.04426933927529508,0.2684565385291542,0.2241871992538591,21177072,23135852,63.03885933357209,73.53703949408589,NaN,NaN,30.34779868653731,23.171602416277786
2005-07-25T09:30:00-04:00,20.96001,21.08,20.85001,20.85001,747900,1064415,58.43469945359931,64.44979334307253,NaN,NaN,57.477855643335836,94.64915879142382,0.02014464681812403,0.24936800777651413,0.2292233609583901,20429172,22563132,57.32079190125703,73.47619283387904,NaN,NaN,28.35472467915427,23.91204845383157
2005-07-26T09:30:00-04:00,21.05,21.06,20.92999,21.00999,800700,1027565,62.180793388290546,65.34271183560968,NaN,NaN,63.117721328846436,78.46505827737697,0.012087505515850278,0.24433274285320294,0.23224523733735267,21229872,21770572,50.49485125483084,72.8090707825065,NaN,NaN,27.780819757735465,24.464730068674985
2005-07-27T09:30:00-04:00,21.09,21.27,20.94,21.14999,911800,1045245,65.14155081086652,66.350838599343,NaN,NaN,76.07701303225726,71.77906902049833,0.013220935864933059,0.24877140716851898,0.23555047130358592,22141672,21435632,47.898906339136325,71.76539914555634,NaN,NaN,28.21057512015151,24.99985079031449
2005-07-28T09:30:00-04:00,21.14999,21.19,21.06,21.16,1949800,1113300,65.35042226223702,66.65292695888833,NaN,NaN,73.79262603710775,68.34764466721714,0.011729630875510433,0.25021250989797394,0.2384828790224635,24091472,21813852,50.964543527644516,70.53366339115081,NaN,NaN,28.615556682318644,25.516380203457942
2005-07-29T09:30:00-04:00,21.23,21.25,21.02,21.05,1808200,1162440,61.023199174331765,66.3275833658056,NaN,NaN,65.01227105043799,67.09549741839706,0.0009858772611121558,0.23971522559885372,0.23872934833774156,22283272,22035092,52.717138301644546,69.12242369241349,NaN,NaN,27.687764641329405,25.826577980296722
2005-08-01T09:30:00-04:00,21.13,21.14,21,21.06,966400,1161760,61.27424487068138,65.87083528472333,NaN,NaN,54.13318170164958,66.4265626300598,-0.0073380539396109,0.22955678091322795,0.23689483485283885,23249672,22599192,56.94279541460538,67.75924887859236,NaN,NaN,27.000948166574858,25.994345149765028
2005-08-02T09:30:00-04:00,21.07001,21.33,21.06,21.27,1080800,1183985,66.1979655641154,65.64846875347659,NaN,NaN,88.01844195353435,71.40670675499739,-0.0009286754302067768,0.23573399056508038,0.23666266599528715,24330472,23219312,61.062472647099575,66.41777742432255,NaN,NaN,27.833202986770345,26.257039126480073
2005-08-03T09:30:00-04:00,21.27,21.4261,21.17999,21.41,1320700,1223000,69.02540060735353,65.41188767878894,NaN,NaN,124.24890005893607,81.04108416033316,0.009914146133325474,0.249055348661944,0.23914120252861853,25651172,23921212,65.12935432480437,65.14369023280094,NaN,NaN,29.41327636552769,26.707930160629733
2005-08-04T09:30:00-04:00,21.32001,21.37,21.16,21.21001,1051200,1218095,61.15580506711801,64.64347121764531,NaN,NaN,102.06768962553673,86.69609687801895,0.0012474014240149989,0.2407004543086373,0.2394530528846223,24599972,24022912,65.6885485173552,63.82478898474976,NaN,NaN,28.32410376567215,26.93881210420722
2005-08-05T09:30:00-04:00,21.2,21.25,21.08,21.16,1063900,1207680,59.33408768178478,64.10688306937547,NaN,NaN,64.84344341445686,86.66233135082273,-0.009624706244021397,0.22742217007959553,0.23704687632361693,23536072,24273472,67.08884889766904,62.605140830293045,NaN,NaN,26.884319173594335,26.93102739983395
2005-08-08T09:30:00-04:00,21.10001,21.21001,20.98,20.99001,1150900,1225545,53.50029859239978,62.76545266863517,NaN,NaN,-2.805555372693579,75.2745839359541,-0.028944065492776838,0.20086679445764588,0.22981085995042272,22385172,24100572,65.11404168042591,61.19717356763258,NaN,NaN,23.79916976454266,26.483619166220908
2005-08-09T09:30:00-04:00,21.08,21.25,21.08,21.14999,642200,1221600,57.71405563015773,61.92292371978179,NaN,NaN,55.601293390744466,68.79115422339613,-0.03142136173636931,0.19053415777996108,0.22195551951633039,23027372,23839952,62.144597437284524,59.76783142820219,NaN,NaN,22.47155908242054,25.910467725678
2005-08-10T09:30:00-04:00,21.19,21.28999,20.87,20.91,1001700,1237255,50.34387541386519,60.932581771418896,NaN,NaN,-57.63988413407863,32.413397384793186,-0.04866605056854395,0.16112295630565043,0.20978900687419438,22025672,23114852,54.673986625128244,58.59140972874697,NaN,NaN,18.842967211363725,24.900824795061673
2005-08-11T09:30:00-04:00,20.92999,21.09,20.89,21.07001,826100,1204965,54.514562020968185,60.37078289555496,NaN,NaN,-61.58213383715341,-0.31656730774484176,-0.04862467459878564,0.14900816362571234,0.19763283822449798,22851772,22765212,51.461487916969986,57.76445462756111,NaN,NaN,17.186708029126237,23.798808114213752
2005-08-12T09:30:00-04:00,20.36,20.88,20.24001,20.78999,1530100,1208705,47.06457544467456,59.558631180631764,NaN,NaN,-287.6437817332057,-70.81401233727735,-0.06572175823512058,0.11548064043059725,0.18120239866571783,21321672,22322332,47.64284094532054,57.07317241642278,NaN,NaN,13.136429613907872,22.275611185598628
2005-08-15T09:30:00-04:00,20.77,20.99001,20.75,20.89999,938000,1185295,49.95770888590611,58.68555371617573,NaN,NaN,-120.07549009984747,-94.26799928270813,-0.06762468052628187,0.09667154800786548,0.16429622853414735,22259672,22297232,47.42804074003173,56.85411452250856,NaN,NaN,10.862114669018746,20.645111683230073
2005-08-16T09:30:00-04:00,20.89999,20.89999,20.66,20.7,548300,1117715,45.128527615908126,57.256052059392985,NaN,NaN,-167.84161649766818,-138.95658126039066,-0.07953314979603118,0.06487979128910837,0.14441294108513955,21711372,22034032,45.13029454144773,56.65635653695938,NaN,NaN,7.3100001765932925,18.740095753710534
2005-08-17T09:30:00-04:00,20.75,20.98,20.75,20.88,1477800,1122790,49.829308317589096,56.147401063346706,NaN,NaN,-89.22620931734058,-145.27384629704306,-0.07265729422500439,0.05359132330388405,0.12624861752888844,23189172,22266732,47.54970731778161,56.412439664826316,NaN,NaN,5.946286793249095,16.9124087593589
2005-08-18T09:30:00-04:00,20.83,20.89999,20.74001,20.74001,1591000,1121540,46.49332998086104,55.10955326381308,NaN,NaN,-112.75341504282656,-155.50810253817767,-0.07462364504188881,0.03296906122652743,0.10759270626841624,21598172,22016012,45.235339030975055,55.87802543120706,NaN,NaN,3.726993604733623,15.028778022983861
2005-08-19T09:30:00-04:00,20.83,20.88,20.75999,20.75999,497500,1095250,47.03831344283125,54.09270101896664,NaN,NaN,-98.10048279156364,-117.59944274984927,-0.07165004609887807,0.018030148644818667,0.08968019474369673,22095672,22170812,46.95213694115551,55.16440696881779,NaN,NaN,2.152787275245931,13.189350773307014
2005-08-22T09:30:00-04:00,20.75,20.98,20.72,20.8,929300,1104320,48.176619097334864,52.80546198562518,NaN,NaN,-77.86269986300991,-109.15688470248176,-0.06429449056468324,0.009312081537842687,0.07360657210252593,23024972,22323872,48.665706727010466,54.278923688811425,NaN,NaN,1.2139590904367439,11.478580532896975
2005-08-23T09:30:00-04:00,20.8,20.89999,20.73,20.78999,1508000,1139685,47.899238610503346,51.29645041442159,NaN,NaN,-79.26905635581052,-91.44237267411023,-0.057623619302048346,0.0015770479749654953,0.05920066727701384,21516972,22284992,48.23943615114102,53.07250096212118,NaN,NaN,0.37332874247078657,9.89211599140752
2005-08-24T09:30:00-04:00,20.77,20.972,20.64999,20.66,1050000,1146595,44.329830491132746,50.0945950875655,NaN,NaN,-86.48694565760972,-90.89451994216407,-0.05925710039136267,-0.014870708212189498,0.04438639217917317,20466972,21740552,42.61094555310268,51.42410075038886,NaN,NaN,-1.3782031058090176,8.282070406090872
2005-08-25T09:30:00-04:00,20.71001,20.75,20.67,20.67,772800,1087745,44.67141010141331,49.047260974681826,NaN,NaN,-98.92242291198585,-88.1283215159959,-0.05694106519883011,-0.026789939319364464,0.030151125879465647,21239772,21668872,41.91749154576283,49.62614665382414,NaN,NaN,-2.7259837469795785,6.709491241366522
2005-08-26T09:30:00-04:00,21,21,20.56,20.60001,1604000,1077535,42.696782422922055,48.275581248290564,NaN,NaN,-81.66741780238053,-84.8417085181593,-0.05724595483073827,-0.04140631765895719,0.01583963717178108,19635772,21176892,37.416633316558126,47.64776034211929,NaN,NaN,-4.419392820801728,5.119650661056772
2005-08-29T09:30:00-04:00,20.58,20.8,20.5,20.74001,461400,1052285,47.67884948830885,47.55878080958707,NaN,NaN,-87.7940459271808,-86.82797773099348,-0.0456460602127388,-0.041217938094142426,0.004428122118596377,20097172,20591332,32.8900252567134,45.55814804350707,NaN,NaN,-4.542920312778141,3.739283379080356
2005-08-30T09:30:00-04:00,20.63,20.74001,20.56,20.74001,887800,1042635,47.67884948830885,47.36842181490448,NaN,NaN,-82.89042097064923,-87.55225065396124,-0.036022999434694766,-0.040600627174772086,-0.004577627740077316,20097172,20307372,30.935523339856047,43.862543523130476,NaN,NaN,-4.64475081009329,2.5415642091984063
2005-08-31T09:30:00-04:00,20.67,20.89999,20.64999,20.85001,855700,1019385,51.519720253103,47.15450454577125,NaN,NaN,-31.35735514767312,-76.52633255197391,-0.021041389834876682,-0.030879365033673167,-0.009837975198796487,20952872,20404552,32.41572859097438,42.50213214270222,NaN,NaN,-3.683645210847966,1.6522485777632103
2005-09-01T09:30:00-04:00,20.86,20.89999,20.75,20.8,466500,990150,49.73224782638115,47.34505257303601,NaN,NaN,-16.588492484540478,-60.059546466484846,-0.013650013180863844,-0.026900491674876292,-0.013250478494012449,20486372,20253872,31.29573441820071,41.33448167647937,NaN,NaN,-3.3364210920942377,0.9395814820692893
2005-09-02T09:30:00-04:00,20.83,20.89,20.71001,20.74001,494000,961655,47.598863363537426,47.176563607152524,NaN,NaN,-30.858466456735442,-49.89775619735583,-0.012009304811655276,-0.028262109508581545,-0.01625280469692627,19992372,20325192,32.48478959328635,40.26710659456899,NaN,NaN,-3.600765114530847,0.2909605396978413
2005-09-06T09:30:00-04:00,20.81,21.02,20.78999,20.98,679700,938095,55.772612306790606,47.93685537078699,NaN,NaN,75.07001984350599,-17.324943043218468,0.00511238186865956,-0.00986232736110182,-0.01497470922976138,20672072,20440172,34.45429949376954,39.50453551973483,NaN,NaN,-1.4288162428694895,0.045278142188222625
2005-09-07T09:30:00-04:00,20.75,21.00999,20.75,20.98,2278000,1019885,55.772612306790606,48.36137708430139,NaN,NaN,85.7409039606777,16.401321943046916,0.015712445437946854,0.004665847567672188,-0.011046597870274667,20672072,20555152,36.45071928065788,38.71175065994028,NaN,NaN,0.3334633368542871,0.08644745571194612
2005-09-08T09:30:00-04:00,21,21.10001,20.944,21.03,490100,994305,57.37900028186879,49.138924962944785,NaN,NaN,177.48035905903424,58.16886478438839,0.02482428048743527,0.019983752739019423,-0.004840527748415848,21162172,20597012,37.20065556987707,38.137844698433284,NaN,NaN,2.278002280717083,0.3995267164269657
2005-09-09T09:30:00-04:00,21.06,21.13,20.99001,21.05,1391000,1022550,58.03557641658512,49.92444374678435,NaN,NaN,196.4022726987294,100.76701782104237,0.030554555811405166,0.03335266701584061,0.0027981112044354432,22553172,21010372,44.202928633112855,37.941472676430244,NaN,NaN,4.088190403322272,0.9264786716977237
2005-09-12T09:30:00-04:00,21.06,21.17999,21.05,21.10001,584200,975255,59.70705942526639,50.74804662735089,NaN,NaN,195.3033043429375,145.99937198097695,0.03571047258772839,0.04743620193909592,0.011725729351367538,23137372,21639372,52.82317238539072,38.23843450917169,NaN,NaN,6.100736421047363,1.6656583501762436
2005-09-13T09:30:00-04:00,21.16,21.23,21.03999,21.12,1055200,981115,60.386274036635285,51.639977729217456,NaN,NaN,171.00220536013563,165.1858090843029,0.03823891321807584,0.05952437087396234,0.0212854576558865,24192572,22343472,60.22999824546486,39.09490323019482,NaN,NaN,7.990259605688245,2.5691728152493867
2005-09-14T09:30:00-04:00,21.12,21.16,20.89999,20.89999,1594700,1033435,50.33034356495234,52.068585805918865,NaN,NaN,74.02131304309991,162.84189090078732,0.02358456413250762,0.05076616282152102,0.027181598689013403,22597872,22728632,63.59692017062851,40.59390141716095,NaN,NaN,6.94610735641885,3.1944491782735955
2005-09-15T09:30:00-04:00,20.94,20.99001,20.8,20.85001,1109400,1015015,48.36014439647621,52.33206682699478,NaN,NaN,11.617973639263449,129.66941381683316,0.009725743919777742,0.03933877858873558,0.029613034668957837,21488472,22793892,64.15071451289171,42.181988771955865,NaN,NaN,5.5026140305080435,3.524187014307088
2005-09-16T09:30:00-04:00,20.95,21.00999,20.845,20.98,1109000,990915,53.46261580985692,53.10105492606156,NaN,NaN,44.19825367255115,99.22861001159752,0.00855514606830992,0.04030696725434524,0.03175182118603532,22597472,22802752,64.23027497992067,44.09724889076748,NaN,NaN,5.711792049755702,3.8367020193711756
2005-09-19T09:30:00-04:00,20.97,20.97,20.75999,20.81,1189200,1025500,46.93154920878497,53.047676334667,NaN,NaN,-13.46852785189764,57.4742435726305,-0.0037655150222184533,0.027044927408262254,0.030810442430480707,21408272,22456932,58.74972981307692,45.94437064479344,NaN,NaN,3.8641386600800174,3.840621539472439
2005-09-20T09:30:00-04:00,20.86,21.03999,20.7,20.73,937000,1025885,44.19541809764278,52.79885980676228,NaN,NaN,-26.627467584311646,17.94830898374104,-0.01667677821106271,0.00996446966665232,0.02664124787771503,20471272,21712672,49.04957838311734,47.238231719312104,NaN,NaN,1.4703042093949492,3.5020047780327976
2005-09-21T09:30:00-04:00,20.67999,20.69,20.46001,20.48,770700,989020,36.94640470754043,51.75790869636495,NaN,NaN,-164.1365186877702,-29.683257362432983,-0.040092382700153875,-0.023474230497477322,0.016618152202676557,19700572,21133212,43.084970390501255,48.00032041927831,NaN,NaN,-3.1961461285977766,2.545126077085573
2005-09-22T09:30:00-04:00,20.42,20.60001,20.36,20.56,1084300,990735,40.31979523754592,51.08559065430529,NaN,NaN,-161.75622609734455,-64.35809730975458,-0.04771321242370311,-0.043023363326952335,0.004689849096750779,20784872,20992492,41.75698644769437,48.74755270709928,NaN,NaN,-5.889438818215891,1.3401882348996497
2005-09-23T09:30:00-04:00,20.49001,20.63,20.42,20.57001,667800,985485,40.74696073967466,50.5961690383151,NaN,NaN,-134.40172324375374,-100.07809269301556,-0.04939253706100833,-0.057050822229509635,-0.007658285168501304,21452672,20763532,39.61734563737724,49.257020995962925,NaN,NaN,-7.885783323331235,0.02219229800952327
2005-09-26T09:30:00-04:00,20.67,20.75,20.47,20.53999,818200,946195,39.82630518354126,49.457147100940134,NaN,NaN,-105.36884905817158,-118.45815693427035,-0.04970185394347349,-0.06978560259784317,-0.020083748654369675,20634472,20608772,38.19279796421998,49.524056600995095,NaN,NaN,-9.78777984553816,-1.37923229392586
2005-09-27T09:30:00-04:00,20.57001,20.58,20.41,20.47,930100,969630,37.68825461945993,48.165407266130806,NaN,NaN,-135.73368206940634,-140.27939983128925,-0.05157377304856717,-0.08455096496507863,-0.03297719191651147,19704372,20455392,36.78119630701613,49.54766210287782,NaN,NaN,-12.027145463642652,-2.9003627467425446
2005-09-28T09:30:00-04:00,20.53,20.64999,20.47,20.60001,977900,974135,43.73110434600975,47.19055755642659,NaN,NaN,-94.64034325672338,-126.3801647450799,-0.04144589203687048,-0.08478455696259957,-0.04333866492572909,20682272,20651732,39.846115966534676,49.73662355978194,NaN,NaN,-12.192919251786401,-4.227870818891667
2005-09-29T09:30:00-04:00,20.57001,20.82001,20.47,20.75999,927300,977715,50.13888297072334,46.626508024579316,NaN,NaN,-47.14009256063203,-103.4569380377374,-0.022320610088682656,-0.07123942753658241,-0.048918817447899755,21609572,20816672,42.37364336000338,49.605960325988406,NaN,NaN,-10.317496979060287,-5.0978174132014695
2005-09-30T09:30:00-04:00,20.78,20.91,20.75,20.89999,671000,987940,54.97141191344658,46.28824748802076,NaN,NaN,16.23611900814503,-73.32936958735766,0.00021728583743201718,-0.04864721015110973,-0.04886449598854175,22280572,20982252,44.877600455112706,49.03841947382569,NaN,NaN,-7.134029979618862,-5.388704922689668
2005-10-03T09:30:00-04:00,20.85001,21.03999,20.85001,20.87,1056300,1016055,53.769205087420175,45.815599705933955,NaN,NaN,38.178406562354176,-44.61991846325252,0.012863808434297345,-0.032784735445670066,-0.04564854387996741,21224272,21100212,46.655895103428804,48.06884067796597,NaN,NaN,-4.937657251247125,-5.32426954105502
2005-10-04T09:30:00-04:00,20.92,20.97,20.66,20.67999,785100,1021325,46.78756555669071,45.56254413391527,NaN,NaN,-14.586324123105557,-20.390446873992353,0.008406236458615088,-0.035140748306698555,-0.04354698476531364,20439172,21247172,48.86903398192096,47.016848807344005,NaN,NaN,-5.203491369700037,-5.307015516575737
2005-10-05T09:30:00-04:00,20.69,20.69,20.37,20.39,1824600,998655,38.55873950948437,44.86244378484442,NaN,NaN,-105.93800927465244,-22.64998007757816,-0.012937826886798266,-0.059719268373811474,-0.04678144148701321,18614572,20833632,43.41112443421818,45.53544951601018,NaN,NaN,-8.35727178184144,-5.742766411613695
2005-10-06T09:30:00-04:00,20.36,20.46001,20.03,20.16,1252200,1036760,33.5228331504138,43.43817359488421,NaN,NaN,-168.08596638585206,-46.839154842622165,-0.03988921523014722,-0.09664296052469723,-0.05675374529455001,17362372,19984192,34.8109331168675,43.43406795436352,NaN,NaN,-12.889276165423471,-6.763696376443662
2005-10-07T09:30:00-04:00,20.2,20.32001,20.17,20.21001,976400,1016030,35.49552109572396,42.62131444395128,NaN,NaN,-142.82748099908883,-78.65187484406894,-0.050981830302396336,-0.12048103317254544,-0.0694992028701491,18338772,19195832,29.05733621125981,41.31318269709087,NaN,NaN,-15.709153849758483,-8.041618872631494
2005-10-10T09:30:00-04:00,20.17999,20.28,20.05,20.07001,942500,1033945,32.580760003235525,41.79169600863647,NaN,NaN,-153.98788277931817,-117.08513271240341,-0.06356277671022106,-0.14895267375792542,-0.08538989704770436,17396272,18430232,24.774842811165755,39.57927301338004,NaN,NaN,-19.028577847865144,-9.611184440522015
2005-10-11T09:30:00-04:00,20.05,20.14,19.88,19.92,857400,1024055,29.76075303079459,41.2784351745832,NaN,NaN,-178.65225972941528,-149.89831983366534,-0.0769110087549538,-0.1815286579913966,-0.10461764923644282,16538872,17650172,21.326084249074952,38.02506686042102,NaN,NaN,-22.744213542862024,-11.487331455142016
2005-10-12T09:30:00-04:00,19.5,19.98,19.5,19.78999,2051000,1046870,27.536240540021893,40.36532412476006,NaN,NaN,-207.71495395337635,-170.25370876941014,-0.08858877516860753,-0.21535361819720222,-0.1267648430285947,14487872,16824832,18.40654841656496,36.35717842962607,NaN,NaN,-26.548238032047163,-13.638889537557036
2005-10-13T09:30:00-04:00,19.75,19.994,19.74001,19.92999,2764800,1129640,33.31647485357031,39.834575132895466,NaN,NaN,-146.64587599430448,-165.96569069110063,-0.08117403912932089,-0.2282323919402458,-0.1470583528109249,17252672,16802892,18.334692137515034,34.83698889392163,NaN,NaN,-27.785948108239733,-15.659897904797422
2005-10-14T09:30:00-04:00,19.98,20.03999,19.85001,20.00999,975100,1122945,36.436643298741394,39.59245642683833,NaN,NaN,-108.62750682984961,-159.12569585725277,-0.06582523292528172,-0.22933989396752708,-0.16351466104224535,18227772,16780692,18.257027473030007,33.413005287408055,NaN,NaN,-27.78201520683114,-17.391628947945097
2005-10-17T09:30:00-04:00,20.03,20.05,19.89,19.99001,1425300,1134750,35.98379099022155,39.47070902474987,NaN,NaN,-92.66826182131085,-146.8617716656513,-0.05253857604195156,-0.2291878810946848,-0.17664930505273324,16802472,16661932,17.822106079809174,32.058784556893265,NaN,NaN,-27.914784472283205,-18.8949368799934
2005-10-18T09:30:00-04:00,20.02,20.03999,19.92999,19.95,1428300,1159315,35.04450908401368,38.85023793460731,NaN,NaN,-82.91058833025355,-127.71343738581895,-0.04239946467535943,-0.22964863589693252,-0.18724917122157309,15374172,16428992,16.96826563730258,30.424652390519544,NaN,NaN,-28.295123225655583,-20.237820643659425
2005-10-19T09:30:00-04:00,19.72,20.2,19.72,20.2,2156200,1228590,44.7492388540632,38.465263354845874,NaN,NaN,-61.63716781060949,-98.4978801572656,-0.01616028519221141,-0.20744952771183733,-0.19128924251962592,17530372,17037492,26.82997292341561,29.314390216477562,NaN,NaN,-25.565933519543393,-20.998979625928563
2005-10-20T09:30:00-04:00,20.21001,20.3299,19.98,20.05,1510000,1249875,40.80952192717954,37.453699784398225,NaN,NaN,-40.469453782097226,-77.26259571482414,-0.006695629038669215,-0.19965877881796246,-0.19296314977929324,16020372,16791032,25.508484970340376,27.930881967565252,NaN,NaN,-24.481657825277114,-21.496505082978356
2005-10-21T09:30:00-04:00,20.03999,20.28999,20.03999,20.17,451800,1239075,44.98257846549788,36.826083597118064,NaN,NaN,-27.193818545784577,-60.975858058011134,0.009004957876954878,-0.18170695243309964,-0.19071191031005452,16472172,16439912,23.716296602690974,26.292339217512552,NaN,NaN,-22.242691706479967,-21.603103172050016
2005-10-24T09:30:00-04:00,20.37,20.42999,20.14999,20.42999,991400,1247735,52.754416163833916,37.25228721191401,NaN,NaN,13.58532281422071,-39.72514113090483,0.03670436531140897,-0.1448314536707933,-0.18153581898220228,17463572,16572132,25.82957174152996,24.646663343198906,NaN,NaN,-17.602908071787297,-21.03164672915534
2005-10-25T09:30:00-04:00,20.5,20.5,20.10001,20.28999,999700,1251215,48.76008542397763,37.980954777234956,NaN,NaN,6.80498909498985,-21.78202564585615,0.04486226825896508,-0.12545798365849592,-0.170320251917461,16463872,16790072,29.305985017244225,23.63915338484362,NaN,NaN,-15.093344501013028,-20.183317839420724
2005-10-26T09:30:00-04:00,20.28,20.48,20.24001,20.24001,988100,1251725,47.38084214401234,38.97081256249199,NaN,NaN,16.370906689642972,-6.1804107458056645,0.045986899935986675,-0.11283662699747765,-0.15882352693346433,15475772,16379152,26.75927245376144,23.064034766050334,NaN,NaN,-13.530552286728081,-19.232922760464632
2005-10-27T09:30:00-04:00,20.27,20.28,20.02,20.02,982500,1254485,41.77860821378715,39.419604499496515,NaN,NaN,-33.42328234863493,-4.771176459113205,0.031688527560797625,-0.11921286748246729,-0.1509013950432649,14493272,16073732,25.01899555859613,22.775581862288643,NaN,NaN,-13.999864213518254,-18.48534296804372
2005-10-28T09:30:00-04:00,20.10001,20.23,19.96001,20.21001,1120300,1276950,47.54691344599387,40.48861545969354,NaN,NaN,-18.722809560474822,-3.076974662051254,0.03456715330005264,-0.10769245341819911,-0.14225960671825175,15613572,15902012,24.07112605546847,22.725316379738835,NaN,NaN,-12.475506910340032,-17.626794959800336
2005-10-31T09:30:00-05:00,20.25999,20.53999,20.24001,20.42,981500,1273210,53.07957867097251,42.15424586256339,NaN,NaN,90.11635530418296,12.229231835941192,0.0492573777542219,-0.08068788452547437,-0.12994526227969627,16595072,15728312,23.117067472270676,22.853243752824245,NaN,NaN,-9.296787748742577,-16.436793929649227
2005-11-01T09:30:00-05:00,20.38,20.42999,20.3206,20.38,1507700,1309340,51.95538794927488,43.89847067751004,NaN,NaN,101.3868724620327,31.145608509349763,0.05451475230845118,-0.0618018218941323,-0.11631657420258348,15087372,15453012,21.65228401270045,23.085082009691064,NaN,NaN,-7.15732817881858,-15.11115596524485
2005-11-02T09:30:00-05:00,20.3,20.66,20.28,20.61,678200,1252020,57.52583337994015,45.62771057225074,NaN,NaN,159.9277433005693,59.85697583153503,0.07069071811159369,-0.027953176563091375,-0.09864389467468507,15765572,15510972,22.76191615050564,23.401312296333252,NaN,NaN,-3.445950727431446,-13.444698074128649
2005-11-03T09:30:00-05:00,20.75,20.85001,20.69,20.8,1339200,1256370,61.49726642992568,47.41775508162105,NaN,NaN,216.86634471054347,109.9149012433707,0.09014844952583127,0.014041667232604027,-0.07610678229322725,17104772,16033272,32.09510589018599,24.38974646898725,NaN,NaN,1.0150656941817406,-11.379017535798592
2005-11-04T09:30:00-05:00,20.8,20.89999,20.7,20.89,967500,1255925,63.250144111743296,49.36535173315832,NaN,NaN,187.9176815281871,151.2429994611031,0.1040558886802333,0.05396307855706439,-0.050092810123168914,18072272,16525012,39.50661558226245,25.93864000487677,NaN,NaN,5.181462833870819,-9.013234625845818
2005-11-07T09:30:00-05:00,20.95,21,20.82001,20.92999,1085700,1263085,64.03366364312981,51.43600563023798,NaN,NaN,174.00834543085438,168.02139748643737,0.1103267754456092,0.0878156591838426,-0.022511116261766613,19157972,17037592,46.10943127320372,28.020151836012566,NaN,NaN,8.758887989895578,-6.474359966454191
2005-11-08T09:30:00-05:00,20.8,21.00999,20.8,20.94,888300,1264630,64.23919064295605,52.82814504373032,NaN,NaN,150.00113863136397,177.74425072030363,0.10931777827244851,0.11413610657879403,0.004818328306345515,20046272,18029372,56.095015758201875,30.1105120384973,NaN,NaN,11.696747415419233,-3.878487483329416
2005-11-09T09:30:00-05:00,20.88,21.00999,20.85001,20.92,943800,1209270,63.45891877159338,54.4459591040456,NaN,NaN,134.17143144911293,172.59298835001238,0.10163445875994655,0.1318614017562787,0.030226942996332152,19102472,18696752,61.292554754973956,32.66651702311399,NaN,NaN,13.901839638393405,-1.3384407516547272
2005-11-10T09:30:00-05:00,20.96001,21.10001,20.814,21.10001,1139300,1127995,67.30785429432018,56.040621663247194,NaN,NaN,130.82403570965388,155.38452654983445,0.10270310106330408,0.15860581932546225,0.055902718262158174,20241772,19324152,65.43516801686951,35.64643640984103,NaN,NaN,17.008604899189205,1.2825657698944055
2005-11-11T09:30:00-05:00,21.14999,21.2,21.10001,21.14999,888800,1123680,68.30605939590083,57.151453322680545,NaN,NaN,137.41772328485882,145.28453490116877,0.10066899151553817,0.18173895765658088,0.08106996614104271,21130572,19935812,68.92671073870288,38.72480348106766,NaN,NaN,19.886535563547874,3.9402757404163298
2005-11-14T09:30:00-05:00,21.2,21.25999,21.09,21.17,3792100,1242020,68.71787998671509,58.577010077161795,NaN,NaN,123.49232550016,135.1813309150299,0.0946547082219619,0.1993883514184951,0.1047336431965332,24922672,21088752,74.21415283360737,41.93252975366503,NaN,NaN,22.389339430616513,6.575856267587785
2005-11-15T09:30:00-05:00,21.42,21.42,21.03,21.10001,2801200,1310665,65.51144397171866,59.8720530648551,NaN,NaN,110.2792456950453,127.23695232776615,0.08050168083136573,0.20536074423574036,0.12485906340437462,22121472,21503792,75.80989968666717,45.436145984586865,NaN,NaN,23.689272987767374,9.020630084756297
2005-11-16T09:30:00-05:00,21,21.17999,21,21.17999,1178300,1261770,67.38432131107407,61.70103257180417,NaN,NaN,88.77753955271399,118.15817394848636,0.07137662682531906,0.21407984693602344,0.14270322011070438,23299772,22343252,78.68330680255721,49.26931107344122,NaN,NaN,25.324427760774675,11.349744038473208
2005-11-17T09:30:00-05:00,21.2,21.45,21.2,21.42999,4782000,1425370,72.42504044742503,63.47804164333497,NaN,NaN,120.30762065909688,116.05489093837495,0.07656895696984767,0.23841441632301397,0.1618454593531663,28081772,23911252,82.79442084503995,53.4638321298392,NaN,NaN,28.37714641227535,13.782230091873513
2005-11-18T09:30:00-05:00,21.60001,21.64999,21.45,21.55,1239900,1464775,74.46518485104046,65.00558494191127,NaN,NaN,141.61223978784278,116.89379423897178,0.08199278133913906,0.2643364360270901,0.18234365468795105,29321672,25549472,85.86224805917597,57.94563074318957,NaN,NaN,31.613325000686764,16.32952936456112
2005-11-21T09:30:00-05:00,21.55,21.57001,21.05,21.53999,1245300,1477470,73.97357119877908,66.57831231687584,NaN,NaN,103.0869385170027,112.8127168423403,0.07879292518415776,0.28083481116814824,0.20204188598399048,28076372,26180212,86.8355073528448,62.6015752674856,NaN,NaN,34.09643024574287,18.8676580618728
2005-11-22T09:30:00-05:00,21.5,21.74001,21.49001,21.67999,1307800,1492875,76.32750052771935,67.92128854171722,NaN,NaN,136.42085555486722,118.0410388143047,0.07974935762679897,0.30172858301748917,0.2219792253906902,29384172,27632752,88.75531571469644,67.31538952207066,NaN,NaN,36.97993019757319,21.455125509829998
2005-11-23T09:30:00-05:00,21.74001,21.92,21.69,21.8,2272700,1557105,78.15169320594106,69.11089045428974,NaN,NaN,150.00084102198537,130.28569910815898,0.08180325345528278,0.3242332922097937,0.2424300387545109,31656872,29304172,90.47638300646986,71.48548074466235,NaN,NaN,40.018040835373775,24.10697055633625
2005-11-25T09:30:00-05:00,21.89999,22,21.8,21.86,601000,1538030,79.02207080678056,70.23745664679241,NaN,NaN,149.30894645492916,136.08596426732544,0.08042120529196273,0.3429565453694643,0.26253534007750157,32257872,30139392,91.20111618192304,75.17794507320954,NaN,NaN,42.81022896693232,26.77886461499283
2005-11-28T09:30:00-05:00,21.92,21.94,21.78,21.78,1094900,1536760,74.74640595559654,71.00265252625431,NaN,NaN,129.29039059728277,133.62159442921342,0.0678402541194546,0.34733565772681985,0.27949540360736524,31162972,30507652,91.50796628766285,78.42069757424234,NaN,NaN,43.954609980476064,29.23254252434758
2005-11-29T09:30:00-05:00,21.8,21.96001,21.75999,21.78,1905400,1582955,74.74640595559654,71.75316790572863,NaN,NaN,115.05921463930909,136.01604965367468,0.05385035319269338,0.346808345098232,0.2929579919055386,31162972,31124972,92.01092863776994,80.98611992278292,NaN,NaN,44.88972008899079,31.469282176439467
2005-11-30T09:30:00-05:00,21.74001,21.88,21.7,21.71001,1398700,1577505,70.8564047579084,72.28155976189399,NaN,NaN,91.13330794490264,126.95854013168177,0.03512138944132337,0.33685972870719283,0.30173833926586946,29764272,31200992,92.0731908247757,83.1847367849116,NaN,NaN,44.62985432364443,33.34936391175446
2005-12-01T09:30:00-05:00,21.89999,22.09,21.85001,22.03999,2128300,1650010,76.94770377882271,72.97012043935845,NaN,NaN,121.29697137728462,121.21776620274163,0.03984897839667206,0.3515495622617095,0.31170058386503746,31892572,31248132,92.11423187542094,85.09038420337957,NaN,NaN,46.267303274705206,35.194783820747425
2005-12-02T09:30:00-05:00,22.02,22.14,21.99001,22.02,2894400,1727770,75.91258442378528,73.51344365563591,NaN,NaN,117.20167166255803,114.79631124426741,0.0366057604459874,0.35745778442252174,0.32085202397653434,28998172,30596192,85.51962955556863,86.27559269029857,NaN,NaN,47.26383516025391,36.918934012105495
2005-12-05T09:30:00-05:00,22.03999,22.03999,21.83,21.91,2006600,1779725,70.30775296796371,73.62700601143938,NaN,NaN,85.15680388319689,105.96959390145025,0.02270895013806229,0.3492382116491122,0.3265292615110499,26991572,29761912,77.83978561599733,86.53456646046926,NaN,NaN,46.409280966978955,38.2746978628017
2005-12-06T09:30:00-05:00,22.02,22.14,21.94,21.94,1342100,1792545,70.93796693753268,74.01461479471182,NaN,NaN,91.55064331767838,101.2678796371241,0.011745882938292707,0.34121161518391574,0.32946573224562303,28333672,29196052,73.04821349732377,86.33730316123045,NaN,NaN,45.8892113981515,39.362485510708815
2005-12-07T09:30:00-05:00,22.00999,22.03,21.82001,21.89999,1510700,1823665,68.83944130835665,74.11855193737485,NaN,NaN,68.51055917404717,96.74332988295302,-0.001298314706150383,0.3278428388629351,0.32914115356908547,26822972,28607792,68.33857753042679,85.59839392750685,NaN,NaN,44.85724965766102,40.147451817416275
2005-12-08T09:30:00-05:00,21.92,21.92999,21.61,21.74001,1132100,1833080,61.06117955252176,73.30684758773891,NaN,NaN,31.723792400920804,78.82869408768026,-0.022616372206453517,0.3008706883110186,0.3234870605174721,25690872,27367452,59.61158640514748,83.94247718180024,NaN,NaN,41.58616859913404,40.3529827862331
2005-12-09T09:30:00-05:00,21.74001,21.87,21.6801,21.82001,1136100,1832920,63.29466626016436,72.50895340267633,NaN,NaN,33.1847805905402,62.02531587327669,-0.03263628672247315,0.28269170211438066,0.3153279888368538,26826972,26933212,56.87328846537056,81.87183721081415,NaN,NaN,39.455869257543334,40.22482371070599
2005-12-12T09:30:00-05:00,21.92999,21.95,21.8,21.88,946800,1835820,64.9196107966594,71.86224194538207,NaN,NaN,50.369536493242876,55.0678623952859,-0.036252090375206825,0.2700128758678453,0.3062649662430521,27773772,27089652,57.62842809152942,79.78561726357734,NaN,NaN,38.127644640917154,39.925226700736154
2005-12-13T09:30:00-05:00,21.84,21.92,21.75,21.81,1038600,1698145,61.49842082599283,70.80302196668731,NaN,NaN,32.00300591460972,43.15833491467215,-0.04387740727741496,0.2514182071462834,0.29529561442369834,26735172,26769952,55.4900924375361,77.4095298866373,NaN,NaN,36.00368446189697,39.36500638090198
2005-12-14T09:30:00-05:00,21.85001,21.89,21.71001,21.84,1290500,1622610,62.41264139489644,69.67880398018413,NaN,NaN,21.837276612033822,33.823678402269486,-0.047134305826524336,0.23637773214054292,0.28351203796706725,28025672,27010492,56.78924545801876,75.00330577603366,NaN,NaN,34.48417054298192,38.66774411834197
2005-12-15T09:30:00-05:00,21.87,21.87,21.7,21.75,986700,1613030,57.96581352542878,68.17478560294471,NaN,NaN,-8.235628951001479,25.831794131885022,-0.0550331234193745,0.2147206336928491,0.2697537571122236,27038972,27280112,58.25988663050039,72.6503608080749,NaN,NaN,31.88541522026242,37.698839990044895
2005-12-16T09:30:00-05:00,21.7,21.7,21.53999,21.57001,1079500,1427905,50.25427059481204,66.42534736288867,NaN,NaN,-115.01610207823866,-3.8083824018707504,-0.07104485681615269,0.1809476860920327,0.2519925429081854,25959472,27106612,56.917454320677635,70.17960995329022,NaN,NaN,27.123440574835016,36.188068645014916
2005-12-19T09:30:00-05:00,21.55,21.56,21.27,21.31,1949500,1463385,41.63691117912729,64.06038345028374,NaN,NaN,-220.1548395855038,-57.91325761762008,-0.0962470110018514,0.13168377915587115,0.22793079015772255,24009972,26353852,51.38519524489156,67.27777185379892,NaN,NaN,19.74663080958681,33.83929181138233
2005-12-20T09:30:00-05:00,21.28,21.33,21.17999,21.23,1185700,1460405,39.398374785652074,61.813381309408285,NaN,NaN,-268.59266225776094,-118.0323912520942,-0.11418122025234928,0.08520426484228594,0.19938548509463522,22824272,25571672,46.34450357113147,64.0114370499672,NaN,NaN,13.010304623041721,30.863722213047957
2005-12-21T09:30:00-05:00,21.3,21.39,21.2,21.25,983100,1444170,40.26305075003264,59.19304895020899,NaN,NaN,-206.5432404858712,-163.70849467167523,-0.11997787305795754,0.049413143772188306,0.16939101683014585,23807372,24728012,41.60391997063229,60.40355762819657,NaN,NaN,7.920972634766223,27.58618655900771
2005-12-22T09:30:00-05:00,21.42,21.42,21.25,21.35001,1049000,1382985,44.52551281545346,56.951115263899574,NaN,NaN,-143.99875319239433,-190.86111951995377,-0.11248356538509269,0.02878656009878,0.1412701254838727,24856372,24291492,39.360475702722816,57.10647521013617,NaN,NaN,4.898434581593482,24.34507913366282
2005-12-23T09:30:00-05:00,21.39,21.47,21.34,21.39,741100,1389990,46.179225622472785,55.227649024935936,NaN,NaN,-103.0751601953461,-188.47293114337526,-0.10062556854871763,0.015488164797975656,0.11611373334669328,25597472,24219092,38.98498643937246,54.331132411805825,NaN,NaN,2.9083607893123595,21.282690798755613
2005-12-27T09:30:00-05:00,21.45,21.5,21.19,21.21001,1483200,1409405,40.34904851701873,53.042726280613515,NaN,NaN,-113.80611807646,-167.2031868415665,-0.10046337533336444,-0.009465485820012276,0.09099788951335216,24114272,24239952,39.16506030513897,51.910907183792624,NaN,NaN,-0.7118468840652693,18.14061398692406
2005-12-28T09:30:00-05:00,21.25999,21.27,21.13,21.16,907200,1359495,38.88026601401098,50.902785188160244,NaN,NaN,-123.85905725554782,-138.25646584112388,-0.09911639138159856,-0.03289759971364603,0.06621879166795253,23207072,24316512,39.8665198333931,49.87718877686165,NaN,NaN,-4.123754143158386,14.959989968340853
2005-12-29T09:30:00-05:00,21.2,21.24001,21.03,21.03999,1643700,1371745,35.53714574706247,49.079639916341726,NaN,NaN,-124.28021911632284,-121.80386156721423,-0.10133874483609509,-0.06045463937716633,0.04088410545892875,21563372,23867712,37.161453983314146,48.27360788958784,NaN,NaN,-8.102172140029507,11.665395381430802
2005-12-30T09:30:00-05:00,20.99001,20.99001,20.87,20.89999,1029900,1316825,32.07255735128494,46.8494892799932,NaN,NaN,-144.67115591190287,-121.93834211111592,-0.1067265339884414,-0.092524062026623,0.0142024719618184,20533472,23003132,32.57579680661425,46.53807277110524,NaN,NaN,-12.650946521047441,8.19163225250534
2006-01-03T09:30:00-05:00,21,21.35001,20.84,21.31,2708300,1307520,48.04714392797276,45.64431307508702,NaN,NaN,-81.33191960509546,-117.5896939930658,-0.07847231546538347,-0.08388792236991094,-0.005415606904527467,23241772,22531992,30.37606433446979,44.5914753598867,NaN,NaN,-11.20975228397154,5.4200058901515
2006-01-04T09:30:00-05:00,21.35001,21.56,21.31,21.56,2729600,1343670,54.996726383501255,45.17990632919476,NaN,NaN,-7.562694797183568,-96.34100933721051,-0.04064568121544046,-0.05622270842382804,-0.015577027208387582,25971372,22903412,34.151118705480755,43.06726295045417,NaN,NaN,-7.335536986263113,3.5977854792351267
2006-01-05T09:30:00-05:00,21.47,21.69,21.47,21.66,1282200,1340675,57.44865195242759,44.82533565473269,NaN,NaN,30.675340441423568,-65.43412979781624,-0.008282186752711172,-0.025929760649276545,-0.017647573896565374,27253572,23712712,41.58351717272311,41.98113950150448,NaN,NaN,-3.4376339445243156,2.5927255615552065
2006-01-06T09:30:00-05:00,21.8,22.02,21.74001,22,4508699,1490574.95,64.52554332252059,45.2938877830964,NaN,NaN,111.77963609084787,-18.222158756382093,0.034295685767288316,0.025222033312545022,-0.009073652454743293,31762271,25752491.8,55.283181123121274,41.76851767954883,NaN,NaN,2.713859521127085,2.6100304129226175
2006-01-09T09:30:00-05:00,22.02,22.091,21.92,22.07001,2458300,1556884.95,65.78731901811244,46.40339124190357,NaN,NaN,128.69576611112947,36.45122564822437,0.0637354322748037,0.07059563788876133,0.006860205613957632,34220571,28489911.6,66.60271361902326,42.460321915144945,NaN,NaN,7.838804614315556,3.3569981559787516
2006-01-10T09:30:00-05:00,21.96001,22.07001,21.92,22.05,2422400,1621199.95,65.07487386780718,48.077531433952124,NaN,NaN,117.31409921000403,76.18042941124428,0.07750704372731423,0.10374401027310043,0.026236966545786194,31798171,30201191.4,71.46556666421111,43.89463415938206,NaN,NaN,11.51902576737729,4.523002100464257
2006-01-11T09:30:00-05:00,22.10001,22.31,22.07001,22.25999,2342500,1690984.95,68.8832488319019,50.18359386582711,NaN,NaN,150.46287149210298,107.78554266910157,0.0952376494880655,0.14528402840586807,0.05004637891780257,34140671,31835051.2,75.18124718168451,45.95440156013585,NaN,NaN,15.96699865769523,6.157858751497253
2006-01-12T09:30:00-05:00,22.28,22.31,22.11,22.14,1625400,1720324.95,64.5517251357365,51.91849917909168,NaN,NaN,131.9994852118759,128.05037162319204,0.09324458995600894,0.16660211636281375,0.0733575264068048,32515271,32887391,77.2372327533555,48.499638187473224,NaN,NaN,18.16333065719535,7.872926166596981
2006-01-13T09:30:00-05:00,22.16,22.2,22.03,22.13,1451100,1728354.95,64.18945677754587,53.32306660495543,NaN,NaN,109.33975254107759,127.562394913238,0.0858003801647109,0.18060800161269341,0.09480762144798252,31064171,32747771,76.33372293945891,51.14058441866866,NaN,NaN,19.771449950870576,9.572715278636066
2006-01-17T09:30:00-05:00,22.62,22.62,21.83009,21.91,2381000,1798069.95,56.656282899107524,54.07142783900077,NaN,NaN,100.30782439925324,121.88480657086275,0.06173246695174847,0.17197320513766812,0.11024073818591965,28683171,31640291,69.3989534224196,53.31301063174345,NaN,NaN,18.770816246071803,10.886729702555456
2006-01-18T09:30:00-05:00,21.48,21.72,21.47,21.64999,4361102,1962150.05,49.29329340685063,54.710302473988754,NaN,NaN,5.998210842801091,99.62162889742216,0.025812772760982455,0.14250670413714772,0.11669393137616527,24322069,30145070.6,61.301627882025954,54.89419403009252,NaN,NaN,15.399847542599462,11.531460822561742
2006-01-19T09:30:00-05:00,21.78,21.94,21.67,21.84,3861700,2057760.05,53.99820995099612,55.79015561234485,NaN,NaN,39.50184494175416,77.4294235873524,0.013007974125159166,0.13295389903261423,0.11994592490745506,28183769,28953690.2,55.722699957349406,56.02677832466083,NaN,NaN,14.158689451353807,11.906779198103466
2006-01-20T09:30:00-05:00,21.73,21.8,21.23,21.27,3268600,2161905.05,41.54484436135621,56.21927694193725,NaN,NaN,-33.86682272153755,44.25616200066971,-0.03316931756568808,0.07848427795034496,0.11165359551603304,24915169,27433669.8,49.529357604825506,56.91020001191164,NaN,NaN,8.127792183347578,11.366923910281196
2006-01-23T09:30:00-05:00,21.34,21.36,21.17,21.19,1826200,2204060.05,40.14543941334047,56.79591137494122,NaN,NaN,-69.74044541354023,8.440122409746156,-0.06649689658115507,0.0285324747895892,0.09502937137074427,23088969,25838629.4,44.00251168425459,57.7263939317431,NaN,NaN,3.0787468561714335,10.182898616836944
2006-01-24T09:30:00-05:00,21.28999,21.42999,21.24001,21.25999,2283400,2265780.05,41.98657373628502,56.363013504106384,NaN,NaN,-56.0569972591036,-22.832841921925212,-0.08029986659453392,-0.0053454618724231295,0.07495440472211079,25372369,25176469,41.91164854608622,58.550364232572846,NaN,NaN,-0.20361347190120602,8.699111175588637
2006-01-25T09:30:00-05:00,21.35001,21.36,21.1701,21.33,1854400,2321445.05,43.84723842007171,55.566621506718555,NaN,NaN,-58.46686074272734,-35.7258562390309,-0.0809573194512729,-0.026242244591980324,0.05471507485929257,27226769,25757409,44.407491031367876,59.2829622558505,NaN,NaN,-2.2066706411636674,7.141142344624022
2006-01-26T09:30:00-05:00,21.44,21.53999,21.35001,21.47,2130200,2353795.05,47.47515287104277,54.85422871519107,NaN,NaN,-29.682155700902015,-49.56265636756213,-0.06868983566246577,-0.031147219718789643,0.037542615943676125,29356969,25992049,45.42739264439789,59.55752478954155,NaN,NaN,-2.7164419027506894,5.732916023570492
2006-01-27T09:30:00-05:00,21.7,21.83,21.59,21.71001,2380100,2427440.05,53.07269667349726,54.036168240260835,NaN,NaN,14.362671309340364,-39.91675756138655,-0.04242537116472346,-0.015489098012228197,0.02693627315249526,31737069,27356429,51.05087009767966,59.25521685915287,NaN,NaN,-1.3273237595778755,4.724310340263582
2006-01-30T09:30:00-05:00,21.71001,21.83,21.67999,21.78,3770400,2533775.05,54.592378931408426,53.23652966263911,NaN,NaN,19.52406737391996,-22.06385500389451,-0.01951828015376541,0.0025384229602885,0.02205670311405391,35507469,29840129,59.27736136298236,58.7319774122928,NaN,NaN,0.2662708803082381,4.087447560269961
2006-01-31T09:30:00-05:00,21.78,21.78999,21.60001,21.60001,1103400,2537450.05,50.09918728771334,52.16683776406098,NaN,NaN,-10.326485440398633,-12.917752640153514,-0.015825006856687703,0.0022754445431942827,0.018100451399881985,34404069,31646469,64.01417379517778,58.19973506450471,NaN,NaN,0.22097288759610534,3.5350940356022673
2006-02-01T09:30:00-05:00,21.48,21.78,21.48,21.73,3081900,2556130.05,53.10131938681862,51.03955708941218,NaN,NaN,-17.61202669908615,-4.746785831425278,-0.004549921936342523,0.012413048979453833,0.016962970915796356,37485969,33698309,68.4968099248239,57.72227526044323,NaN,NaN,1.1145581090638634,3.189303188953924
2006-02-02T09:30:00-05:00,21.67999,21.73,21.42,21.42999,2418200,2540560.05,46.19387987591157,49.72828242799611,NaN,NaN,-53.850551690075044,-9.580465029259885,-0.01654498820650279,-0.0037182643423321338,0.012826723864170657,35067769,34840469,70.68582064100573,57.254317252418254,NaN,NaN,-0.33545450273596816,2.685766375855368
2006-02-03T09:30:00-05:00,21.33,21.39999,21.25,21.28,1533900,2553145.05,43.17038681595384,48.2269202878824,NaN,NaN,-100.94143618392283,-32.64128652791253,-0.03288489792958117,-0.028279398547805812,0.004605499381775362,33533869,35199829,71.36011889672368,56.89905982079431,NaN,NaN,-2.50701843811869,1.943939973859074
2006-02-06T09:30:00-05:00,21.27,21.32001,21.12,21.22,1481600,2401790.1,41.98650622200706,47.17907909666093,NaN,NaN,-110.21767573652474,-58.589635150001456,-0.04527360338597691,-0.05198650485069578,-0.006712901464718866,32052269,34508789,68.11539526303294,56.80737709512383,NaN,NaN,-4.6189973752026265,1.0063774954216882
2006-02-07T09:30:00-05:00,21.14999,21.28999,21.12,21.16,3525500,2455150.1,40.78209127286297,46.57113608709038,NaN,NaN,-106.13634387550758,-77.75160683702326,-0.0544331464441465,-0.07475433451990199,-0.02032118807575549,28526769,33333329,62.878057140821014,56.919979185037775,NaN,NaN,-6.704036945616644,-0.09511028186950199
2006-02-08T09:30:00-05:00,21.25,21.60001,21.24001,21.57001,1935700,2430815.1,51.104149144155855,46.36441745803036,NaN,NaN,-35.69721103156262,-81.36864370351854,-0.030969550365466215,-0.05903312603258826,-0.028063575667122042,30462469,31928629,57.21636790349543,57.026669752619625,NaN,NaN,-5.295423956597988,-0.8380122354021428
2006-02-09T09:30:00-05:00,21.62,21.74001,21.46001,21.47,1304200,2378900.1,48.8666668756593,46.88740478048057,NaN,NaN,-7.183434511209921,-72.03522026774553,-0.02076610219974126,-0.05402120341679861,-0.03325510121705735,29158269,30746729,52.90031273852172,57.26745226216936,NaN,NaN,-4.8574899725175005,-1.4122233407043367
2006-02-10T09:30:00-05:00,21.47,21.64999,21.34,21.64,2023000,2398780.1,52.66081591240929,47.78136024469978,NaN,NaN,-2.30782924637732,-52.30849888023643,-0.002130001912477364,-0.03591760360765406,-0.033787601695176694,31181269,30276209,51.243078292588585,57.78463559133608,NaN,NaN,-3.2870943382678335,-1.680062054641979
2006-02-13T09:30:00-05:00,21.5,21.58,21.36,21.44,1872800,2419865.1,48.135570238533354,48.22057428057466,NaN,NaN,-21.27786853753558,-34.5205374404386,-0.002793094722131337,-0.03727897009784087,-0.03448587537570953,29308469,29727449,49.30313390495002,58.312598831254924,NaN,NaN,-3.3829872357337156,-1.9233370805122272
2006-02-14T09:30:00-05:00,21.49001,21.8,21.45,21.73,1743300,2387980.1,54.271672406982724,48.96517670821117,NaN,NaN,70.20152585731479,0.747036506125869,0.015759233841874977,-0.014786833073365813,-0.03054606691524079,31051769,30232449,51.13643107215944,58.793237405597175,NaN,NaN,-1.435882028739552,-1.8537006445447022
2006-02-15T09:30:00-05:00,21.73,21.88,21.71001,21.85001,2045400,2272195,56.56199655218484,49.614236971149886,NaN,NaN,123.16655234205592,32.51978918084958,0.03449858938466702,0.012577169815592981,-0.021921419569074035,33097169,30759389,53.0444942426196,59.33731609118445,NaN,NaN,0.8841472020395459,-1.4625795236040955
2006-02-16T09:30:00-05:00,21.97,22.09,21.91,22.05,1585200,2158370,60.1444152773336,50.11935972856676,NaN,NaN,188.96260116099555,71.74899631529067,0.05739832932015541,0.04982649208112022,-0.007571837239035184,34682369,31864209,56.84912258978528,59.7514769834777,NaN,NaN,4.002079700585408,-0.6819139201484522
2006-02-17T09:30:00-05:00,22,22,21.88,21.92999,1155500,2052715,57.10111425045539,50.2985551084987,NaN,NaN,137.13191703230953,99.63694557102804,0.06115280056084289,0.06886916346201843,0.00771636290117554,33526869,32333329,58.390795475753386,59.68815084867564,NaN,NaN,5.613617445727347,0.2174477035480905
2006-02-21T09:30:00-05:00,21.87,21.91,21.62,21.69,2009100,2061860,51.49018897898983,50.397912372161294,NaN,NaN,62.020643991528665,116.29664807684087,0.044914349795455576,0.06385930014549501,0.018944950350039437,31517769,32775189,59.84597673419719,59.39042248717702,NaN,NaN,5.213757272029828,0.9312062133311958
2006-02-22T09:30:00-05:00,21.66,21.87,21.59,21.8,1679400,2031660,53.734245412125354,50.44312137396893,NaN,NaN,59.945694080651535,114.24548172150824,0.03922914453692987,0.06798138102120177,0.028752236484271904,33197169,33204269,61.262732312946305,58.87370265775719,NaN,NaN,5.581765288511575,1.5955717954998214
2006-02-23T09:30:00-05:00,21.72,21.85001,21.67,21.69,1677200,2022800,51.18432930779811,50.79958204767511,NaN,NaN,48.39824129058229,99.2918195112135,0.026327239770248784,0.06166128619708289,0.035334046426834104,31519969,32888829,59.597939152083654,58.081711122834186,NaN,NaN,5.112678860102137,2.098015661871581
2006-02-24T09:30:00-05:00,21.7,21.73,21.60001,21.7,1498000,1991190,51.41007163314069,51.38813096318846,NaN,NaN,22.19239652911799,65.937778584838,0.017176501283045223,0.05680467303064063,0.039628171747595406,33017969,32555949,57.81251499920649,57.114025130154396,NaN,NaN,4.799248265174864,2.4839060337720498
2006-02-27T09:30:00-05:00,21.67999,21.96001,21.67999,21.89999,2585700,2001470,55.811152719335,52.37560571299759,NaN,NaN,83.93781140794083,55.29895745996426,0.022942187207876566,0.06830590575744111,0.045363718549564544,35603669,32971309,59.445097640841055,56.49471815714069,NaN,NaN,5.816502776748775,2.959991282768725
2006-02-28T09:30:00-05:00,21.89,21.89999,21.63,21.64999,1507400,1888320,49.745428025637274,53.01584405248148,NaN,NaN,39.042707900742286,50.70337024180699,0.008985351764796881,0.05659540825556064,0.04761005649076376,34096269,33487009,61.4402798173437,56.39201977689231,NaN,NaN,4.862512755502364,3.231780064587816
2006-03-01T09:30:00-05:00,21.75999,22.16,21.756,22.08,1696700,1917985,58.16717398514017,53.520345826837506,NaN,NaN,127.64144134206225,64.24251969408913,0.026774632531974173,0.08107834715573148,0.054303714623757306,35792969,34006169,63.39279552824274,56.83319317865998,NaN,NaN,6.802459594338541,3.741877140266491
2006-03-02T09:30:00-05:00,21.99001,22.17999,21.98,22.13,1245400,1826160,59.02698036377196,54.24608250455983,NaN,NaN,141.50319805863643,82.86351104769994,0.03921684519121926,0.10332477111278138,0.06410792592156211,37038369,35109849,67.19572082948176,57.8542937565857,NaN,NaN,8.605326715079457,4.436655650954058
2006-03-03T09:30:00-05:00,21.88,22.22,21.88,22,1849800,1797740,55.81486336560295,54.471371608359384,NaN,NaN,108.36446505071757,100.09792475201986,0.03607881519283422,0.1092064449126049,0.07312762971977067,35188569,35543969,68.57842869700576,59.092533071186914,NaN,NaN,9.102181547681525,5.103159350486553
2006-03-06T09:30:00-05:00,22.13,22.17,21.85001,21.91,2797800,1860935,53.63864520830153,54.86444839191425,NaN,NaN,84.51559114442745,100.21348069931719,0.025810367288855426,0.10539058883083996,0.07958022154198453,32390769,34901389,64.26077331628277,60.16093588628212,NaN,NaN,8.855203265105335,5.639165624003522
2006-03-07T09:30:00-05:00,21.81,21.84,21.63,21.77,1317500,1852730,50.34996285677055,54.58432628118481,NaN,NaN,-0.8728623078823894,92.23036665759226,0.008361290348901373,0.09003183447811125,0.08167054412920988,31073269,34296789,60.40710701985952,60.82312702540355,NaN,NaN,7.659524513893282,5.927788322559202
2006-03-08T09:30:00-05:00,21.75999,21.87,21.61,21.75,1409300,1746920,49.879470464625086,54.107002989216255,NaN,NaN,-14.727931271820461,63.75649213481571,-0.005034693726380948,0.0753771769712337,0.08041187069761464,29663969,33070989,53.413298852093234,60.84947021179453,NaN,NaN,6.553365360821073,6.017156470882327
2006-03-09T09:30:00-05:00,21.87,21.94,21.62,21.62,1428600,1721565,46.81711143740406,53.15505271493557,NaN,NaN,-29.820834746772615,29.4916855737339,-0.022196506029028354,0.052666238161329204,0.07486274419035756,28235369,31310389,45.30075776678898,60.02458701015194,NaN,NaN,4.7225601078479995,5.832214133305994
2006-03-10T09:30:00-05:00,21.66,21.84,21.57001,21.72,2884000,1800555,49.39107680522748,52.60433575456215,NaN,NaN,-43.271396396399886,-0.8354867156895963,-0.026090362943718595,0.04224979051070932,0.06834015345442791,31119369,30496549,42.11640060141063,58.86213023341317,NaN,NaN,3.883725962248935,5.553858680297843
2006-03-13T09:30:00-05:00,21.83,21.91,21.73,21.8,1670900,1782950,51.41685133205038,52.59909735120933,NaN,NaN,1.4734864316150784,-17.44390765825207,-0.022680888112159195,0.03998904331422892,0.06266993142638812,32790269,30576449,42.543420883362245,57.62623338692496,NaN,NaN,3.7326604762999516,5.293687508298144
2006-03-14T09:30:00-05:00,21.77,22.07001,21.74001,22.05,1754800,1777050,57.18451095711944,52.84554489013749,NaN,NaN,66.90459811928433,-3.8884155728187126,-0.003971859554772562,0.057705106982922416,0.06167696653769498,34545069,31270809,46.254160038875696,56.55419251020563,NaN,NaN,5.295463768686756,5.2939412597822315
2006-03-15T09:30:00-05:00,22.02,22.23,22.02,22.17999,869000,1733335,59.85332414408013,53.46475880701478,NaN,NaN,147.8783856895862,28.63284781946262,0.015696169520761027,0.08129717843864626,0.06560100891788523,35414069,32420829,51.80579457007543,55.997610754347896,NaN,NaN,7.420300406444571,5.597706852162566
2006-03-16T09:30:00-05:00,22.23,22.3,22.00999,22.03999,1952100,1728670,55.8178623360564,53.779601000080184,NaN,NaN,115.21774812267974,57.64056439335309,0.01766834515864764,0.08768644036619477,0.07001809520754713,33461969,33466149,56.23134935717739,55.884670351345825,NaN,NaN,8.058086134210374,5.949189606740824
2006-03-17T09:30:00-05:00,22.06,22.17999,22.00999,22.11,922700,1695545,57.365890603325695,53.890653706079526,NaN,NaN,101.96504272523103,86.68785221767928,0.021807795827453944,0.09727783999186457,0.07547004416441062,34384669,34119209,58.778116489025514,55.83702884050185,NaN,NaN,9.035893362893553,6.3901472861912145
2006-03-20T09:30:00-05:00,22.14,22.17999,22.08,22.14999,444300,1659985,58.265397410756975,54.49922294787378,NaN,NaN,106.18106639381634,107.62936821011954,0.025123145008613332,0.10687397542517729,0.08175083041656396,34828969,34526949,60.330151584061575,55.75773396669599,NaN,NaN,10.099473527411554,6.920051034936977
2006-03-21T09:30:00-05:00,22.14,22.39999,22.02,22.06,1918600,1655460,55.43120637124777,54.30379668973861,NaN,NaN,103.12489053095014,114.8734266924527,0.019395886587997416,0.10599568865156073,0.08659980206356331,32910369,34200009,58.43046281545205,55.40328163006808,NaN,NaN,10.23267996687402,7.393283739499411
2006-03-22T09:30:00-05:00,21.89999,22.10001,21.84,22.07001,1213200,1632150,55.689402970811635,54.06539830452716,NaN,NaN,34.34478908035777,92.166707370607,0.014638688490112198,0.10489816267620355,0.09025947418609136,34123569,33941909,56.90704611790966,54.66837629352722,NaN,NaN,10.411678123115726,7.824482937158884
2006-03-23T09:30:00-05:00,22.03999,22.10001,21.92,22.02,914900,1594035,54.00607133450045,53.93619887373412,NaN,NaN,34.355233697636955,75.99420448559844,0.006875184879998747,0.0988534552860898,0.09197827040609105,33208669,33891249,56.59514250370871,53.81242727972028,NaN,NaN,10.12616530251881,8.153294703638874
2006-03-24T09:30:00-05:00,22.03,22.14999,21.96001,22.09,1603000,1599285,56.01041795478557,54.1056112127687,NaN,NaN,53.72873320787878,66.346942582128,0.005277450802177272,0.09857508390881264,0.09329763310663537,34811669,33976649,57.022774417292915,53.29542735836386,NaN,NaN,10.39696749586537,8.47381938824266
2006-03-27T09:30:00-05:00,22,22.2,22,22.12,740200,1507010,56.87774263782107,54.57188119712946,NaN,NaN,67.67051187544642,58.644831678454025,0.0050633225462731885,0.09962678628947685,0.09456346374320367,35551869,34121229,57.781130898552604,53.10785763541337,NaN,NaN,10.849406138042484,8.81318892392835
2006-03-28T09:30:00-05:00,22,22.19,21.85001,21.87,727000,1467990,48.32664352098189,54.46096498686922,NaN,NaN,-5.949219155201995,36.830009741223584,-0.012152849633580487,0.07937240170122806,0.09152525133480854,34824869,34504129,59.8040528304198,53.5643400624367,NaN,NaN,8.869583516586848,8.821245294308135
2006-03-29T09:30:00-05:00,21.95,22.3,21.91,22.2,1094900,1437900,57.42551630773181,55.21870819189264,NaN,NaN,78.753854662122,45.71182285757642,-0.002081129549768468,0.08892383939759796,0.09100496894736643,35919769,34863369,61.66017540769466,54.73286989392995,NaN,NaN,9.829801853495765,8.96532480276351
2006-03-30T09:30:00-05:00,22.28999,22.42999,22.17999,22.27,2129800,1482120,59.071827962001166,55.91019041737648,NaN,NaN,147.17973542901694,68.27672320385243,0.007978287263688516,0.10097782802697708,0.09299954076328856,38049569,35831549,66.19132720475235,56.45250750845436,NaN,NaN,11.122223454922349,9.273453181643344
2006-03-31T09:30:00-05:00,22.33,22.34,22.14,22.14,1623500,1470805,54.831288491695126,56.15407878592253,NaN,NaN,94.65552801920514,76.4620821661177,0.004720944479833095,0.09890072136307992,0.09417977688324683,36426069,36154429,67.56791246308782,58.239971192720475,NaN,NaN,10.92195684530443,9.5089537050235
2006-04-03T09:30:00-04:00,22.28999,22.45,22.2101,22.27,3303800,1496105,58.072617622302936,56.217514976292776,NaN,NaN,125.51130751709587,88.03024129444759,0.009869502665294252,0.10651665521486464,0.09664715254957039,39729869,36990029,70.87320334883586,59.99847428628906,NaN,NaN,11.74658073007197,9.828614708601853
2006-04-04T09:30:00-04:00,22.25,22.39,22.21001,22.35001,1993600,1529910,59.9762739599385,56.22629710599695,NaN,NaN,119.73850882429531,113.16778689034705,0.016804081194071202,0.1176522540421594,0.1008481728480882,41723469,38369749,75.34181924538454,61.679618905953994,NaN,NaN,13.005461427960524,10.28244995422452
2006-04-05T09:30:00-04:00,22.39999,22.55,22.36,22.53999,2736800,1596285,64.13971855621041,56.82071540743652,NaN,NaN,181.60863627467336,133.73874321285732,0.031474309197620204,0.14019105934511344,0.10871675014749324,44460269,40077849,79.52903736179512,63.343739477712404,NaN,NaN,15.413710404343615,11.01548716138439
2006-04-06T09:30:00-04:00,22.47,22.62,22.39999,22.52,1651400,1607425,63.392474326252966,57.2511856733599,NaN,NaN,180.63780565439836,140.43035725793362,0.036752523645120425,0.15465740470389377,0.11790488105877335,42808869,41029709,81.4222608373836,64.96117835973799,NaN,NaN,17.134185058670386,11.889586860996676
2006-04-07T09:30:00-04:00,22.50999,22.62,22.25999,22.25999,1673200,1546885,54.498744043005715,56.98213900423481,NaN,NaN,106.08341295914798,142.71593424592217,0.02046603112088151,0.14348741995987524,0.12302138883899373,41135669,41971629,83.08896817423425,66.58680811617889,NaN,NaN,15.895339805100964,12.461837281583003
2006-04-10T09:30:00-04:00,22.25999,22.34,22.17999,22.23,1170600,1521870,53.56527337734303,56.84885807609876,NaN,NaN,34.64090407935529,124.54185355837406,0.006149655701388729,0.13070845846572965,0.12455880276434092,39965069,42018669,83.17017342372587,68.35393030248416,NaN,NaN,14.616579102391219,12.769657541698463
2006-04-11T09:30:00-04:00,22.28999,22.33,21.9808,22.03,2471200,1557690,47.69780463486563,56.27802962353119,NaN,NaN,-42.121474778048395,92.16985683790531,-0.017045057763110244,0.10325248056045311,0.12029753832356335,37493869,41172749,76.09381205543633,69.72441358373607,NaN,NaN,11.637692930020794,12.607948311458795
2006-04-12T09:30:00-04:00,22.06,22.13,22.00999,22.07001,2617000,1645090,48.90362004729488,55.91356881730223,NaN,NaN,-62.356890333564216,43.376751516257805,-0.029232909677595106,0.08375640122656947,0.11298931090416457,40110869,40302869,69.54140881244615,70.64914689150302,NaN,NaN,9.57814967058394,12.175119934190958
2006-04-13T09:30:00-04:00,22.33,22.33,22.02,22.10001,897300,1592350,49.83747133005837,55.472644058393136,NaN,NaN,-20.952669962667677,3.0586563928446067,-0.03445515377449565,0.06992036868604501,0.10437552246054066,41008169,39942729,66.97024435175464,71.35968045825028,NaN,NaN,8.154990090993804,11.600815670877079
2006-04-17T09:30:00-04:00,22.09,22.17,21.78999,21.86,2600900,1676260,43.05748239117798,54.48548261220434,NaN,NaN,-123.10304535972398,-42.77863527092977,-0.05219060831506747,0.03913726206670631,0.09132787038177378,38407269,39397049,63.159776382812694,71.74386942141173,NaN,NaN,4.74647286001415,10.621623840753804
2006-04-18T09:30:00-04:00,22,22.32001,21.91,22.3,851500,1696620,55.1133441671502,54.97024694407351,NaN,NaN,-3.2809386333752735,-50.36300381347589,-0.03332377638102339,0.04967314990549454,0.08299692628651793,39258769,39255789,62.17356938140146,71.9131206036247,NaN,NaN,5.684215527581785,9.916279796014944
2006-04-19T09:30:00-04:00,22.25,22.34,22.12,22.28,1174200,1659400,54.548013510173504,54.7647110299622,NaN,NaN,30.098262696579614,-35.91905631855031,-0.02178454462380633,0.055766245506760015,0.07755079013056634,38084569,39373929,62.69815961986954,71.98726233306576,NaN,NaN,6.22053984835665,9.388316946349473
2006-04-20T09:30:00-04:00,22.27,22.47,22.22,22.3,2016000,1699540,55.04461970468551,54.4770532972968,NaN,NaN,65.11926026928448,-10.42382619798057,-0.012840658358141271,0.06149996718288975,0.07434062554103102,40100569,39371869,62.68183581151356,71.73658437640584,NaN,NaN,6.797773165110341,9.018239263315312
2006-04-21T09:30:00-04:00,22.33,22.37,22.0005,22.06,1391600,1723375,48.234112111170894,54.00582641297364,NaN,NaN,-36.09780798491014,-13.452853802429065,-0.02255566379830129,0.0461460457931544,0.06870170959145569,38708969,38912029,58.98978461833391,71.12386095892342,NaN,NaN,5.114785013862738,8.460602941964945
2006-04-24T09:30:00-04:00,22.00999,22.08,21.91,22.03,591700,1672810,47.44390715432848,53.24663280811832,NaN,NaN,-106.21099833105689,-10.074444396695645,-0.030003306116359575,0.031197576946006222,0.0612008830623658,38117269,38854029,58.521566858651056,70.2416012096245,NaN,NaN,3.530126633125277,7.756249183559278
2006-04-25T09:30:00-04:00,22.03,22.10001,21.88,22.02,2114500,1741525,47.16652229907217,52.33165054662787,NaN,NaN,-102.61033560731798,-29.940323791484182,-0.03429465455861587,0.018332564864095957,0.05262721942271183,36002769,38202829,53.396980103527454,68.67411269949186,NaN,NaN,2.172884562610444,6.958625666280874
2006-04-26T09:30:00-04:00,22.10001,22.14999,22,22.10001,2450300,1827690,49.70045629091982,51.30027467053568,NaN,NaN,-65.93665643420752,-49.14730761764161,-0.030560347195567474,0.014426785428252487,0.04498713262381996,38453069,38276529,53.88911497772513,66.84268967205828,NaN,NaN,1.741613978999649,6.213338282383556
2006-04-27T09:30:00-04:00,21.96001,22.38989,21.96001,22.32001,2647400,1905315,55.95563277803318,50.7690717028057,NaN,NaN,6.214805807673003,-60.9281985099639,-0.012987984848353777,0.028752151563377737,0.041740136411731514,41100469,38476509,55.26943018167436,64.97463033950763,NaN,NaN,3.248815271791662,5.789834995156142
2006-04-28T09:30:00-04:00,22.10001,22.10001,21.81,21.85001,2910000,1944325,43.50760475649486,49.98399032519777,NaN,NaN,-137.12854389206166,-81.1343456913942,-0.03166795578544774,0.002155191679921842,0.03382314746536958,38190469,38372809,54.36069634183841,62.92261092290793,NaN,NaN,0.36098936713561086,5.014285619724638
2006-05-01T09:30:00-04:00,21.96001,21.96001,21.67,21.67,3851400,2055720,39.850989147338666,49.00439859448317,NaN,NaN,-177.64161904709835,-95.4204698346025,-0.053512289949543365,-0.03306721497155962,0.020445074977983743,34339069,37617169,48.14837117137988,60.42105361916892,NaN,NaN,-3.2814044105489693,3.8291870439712654
2006-05-02T09:30:00-04:00,21.78,21.87,21.73,21.77,876300,1934345,42.73054329111579,48.649594212786745,NaN,NaN,-146.33964287909413,-104.16633128895774,-0.058203320208686446,-0.05230907528287432,0.00589424492581213,35215369,37459689,46.944313440221045,58.33894657522497,NaN,NaN,-5.219993731636937,2.536446933170094
2006-05-03T09:30:00-04:00,21.74001,21.81,21.62,21.72,815400,1875435,41.65671108513484,48.13195785834675,NaN,NaN,-152.2587567437654,-121.43075135086931,-0.06133707276975392,-0.07077709603638027,-0.00944002326662635,34399969,36649069,41.22894162246777,56.31662749022653,NaN,NaN,-7.098099163365326,1.1600832050936054
2006-05-04T09:30:00-04:00,21.75999,21.88,21.58,21.8,1683200,1822755,44.0782071245012,47.7205818436641,NaN,NaN,-124.31081696968792,-147.5358759063415,-0.05489438145926413,-0.07805800009070651,-0.02316361863144238,36083169,35645609,35.47174017679929,54.06673433487257,NaN,NaN,-7.8927446932996785,-0.13317792324829214
2006-05-05T09:30:00-04:00,21.89,21.95,21.83,21.92,1126200,1796495,47.591925894124195,48.04447066530311,NaN,NaN,-60.21348214851495,-132.15286355763214,-0.04010927522912265,-0.0733002126678457,-0.03319093743872305,37209369,35449389,34.45845218781618,52.01663974951567,NaN,NaN,-7.488992196487299,-1.1840085337110073
2006-05-08T09:30:00-04:00,21.94,22,21.90401,21.95,765200,1751095,48.463739231905556,47.56949888421421,NaN,NaN,-32.97886094062145,-103.22031193633677,-0.026522537238666898,-0.06634410898705667,-0.039821571748389774,37974569,36176489,41.165314533185374,50.516050117500235,NaN,NaN,-6.905977546364123,-2.001432678375738
2006-05-09T09:30:00-04:00,22.03,22.03,21.78999,21.86,1570200,1771075,45.99194117397936,46.95835086020035,NaN,NaN,-52.76706188666336,-84.5057957378506,-0.021996821931865244,-0.06731759916322133,-0.04532077723135609,36404369,36414289,43.21204801863316,49.124185003126215,NaN,NaN,-7.1179610478464275,-2.7323653025858365
2006-05-10T09:30:00-04:00,21.89999,21.95,21.57001,21.63,2613900,1778210,40.33081224240516,45.907364612894604,NaN,NaN,-117.77017602868439,-77.60807959483441,-0.03227196330456427,-0.08566073136206143,-0.053388768057497156,33790469,36292389,42.39781653927345,47.67532648368048,NaN,NaN,-9.032570839603247,-3.632394665016895
2006-05-11T09:30:00-04:00,21.52,21.57001,21.10001,21.17999,2625500,1778635,32.024888428237006,44.74956292125648,NaN,NaN,-244.61623473301455,-101.66916314749975,-0.06525232489831118,-0.13495417418038613,-0.06970184928207496,31164969,35308749,36.43231495453299,46.06407865055184,NaN,NaN,-13.776172064041342,-5.081505722020387
2006-05-12T09:30:00-04:00,21.10001,21.17,20.96001,20.98,4707301,1969135.05,29.151570211873548,43.44296742536683,NaN,NaN,-260.4097778747219,-141.70842229274112,-0.09463057804586952,-0.18799007183941185,-0.09335949379354233,26457668,33158408.8,27.3669459790343,43.83874858772207,NaN,NaN,-18.695893810139143,-7.026418306037352
2006-05-15T09:30:00-04:00,20.92,21.07001,20.78,21,2884600,1983320.05,29.829611871471343,42.2046166805382,NaN,NaN,-217.46466887518332,-178.6055838796535,-0.1059561127361236,-0.22580463471369683,-0.11984852197757323,29342268,31431948.6,22.52153347283162,41.63335954267237,NaN,NaN,-22.28006702445202,-9.20551098009659
2006-05-16T09:30:00-04:00,21,21.00999,20.75,20.8,1557000,2018595.05,27.042480978923578,40.58618987253847,NaN,NaN,-195.79500675575522,-207.21117285347185,-0.11917124061983494,-0.2688125727523669,-0.14964133213253197,27785268,29708128.4,18.91959469139924,39.13553666507766,NaN,NaN,-26.243724619533843,-11.639541500016199
2006-05-17T09:30:00-04:00,20.7,20.77,20.5,20.52,1651500,2042460.05,23.703358383439223,38.28245598721033,NaN,NaN,-194.938793850125,-222.64489641775998,-0.1377117678112541,-0.3217810418965996,-0.1840692740853455,26133768,28176788.2,16.408958488096204,36.35978868696493,NaN,NaN,-30.829962751392344,-14.38103025021279
2006-05-18T09:30:00-04:00,20.75,20.75,20.44,20.45,4040900,2143705.05,22.94072185534226,36.81339292284229,NaN,NaN,-161.59198385403818,-206.04004624196472,-0.1449026446696934,-0.36519757992246227,-0.22029493525276886,22092868,26362368,14.032838546197482,33.479227415847724,NaN,NaN,-34.715639582921554,-17.285974440599755
2006-05-19T09:30:00-04:00,20.48,20.64,20.34,20.60001,2057400,2176995.05,28.267111043958536,35.98597305831514,NaN,NaN,-136.2944325664275,-181.21697718030583,-0.13023203627688934,-0.3830849805988805,-0.2528529443219912,24150268,25900888,13.497485939456226,31.004164184996032,NaN,NaN,-36.252366670540674,-19.99545904487703
2006-05-22T09:30:00-04:00,20.39999,20.56,20.31,20.42,1608400,2227830.05,25.949218262106868,34.7873069848145,NaN,NaN,-126.67256119570585,-163.05855564441035,-0.12339241024913217,-0.4070934571334064,-0.2837010468842742,22541868,24540808,12.039662407031528,28.510974825482496,NaN,NaN,-38.28711174740468,-22.608552288095265
2006-05-23T09:30:00-04:00,20.64999,20.67999,20.27,20.27,1025200,2173365.05,24.17061559178815,33.538300163861166,NaN,NaN,-112.84046566907104,-146.46764742707353,-0.11962323240092643,-0.4332300873854322,-0.3136068549845058,21516668,23287088,10.873783276037628,26.342749229308914,NaN,NaN,-40.54548027756936,-25.170970572305848
2006-05-24T09:30:00-04:00,20.37,20.53,20.2,20.47,2090600,2155380.05,30.964961483911196,32.60163976096189,NaN,NaN,-101.48566427508594,-127.77702151206572,-0.09536731063815623,-0.4328159932822011,-0.3374486826440449,23607268,22781788,10.435179301905109,24.554423452530756,NaN,NaN,-40.28465207302049,-27.330067929550797
2006-05-25T09:30:00-04:00,20.64999,20.66,20.47,20.66,1261200,2086070.05,36.761882022269084,31.82806519868652,NaN,NaN,-71.09234587512886,-109.67709391628384,-0.05996304543014308,-0.41240248943172375,-0.35243944400158067,24868468,23336908,14.514668157719058,23.129867450380964,NaN,NaN,-38.182705917286796,-28.880444784941655
2006-05-26T09:30:00-04:00,20.73,20.78999,20.64999,20.75999,2022800,2041710.05,39.63466640771025,31.197417139815432,NaN,NaN,-49.6777256870211,-92.35375254040257,-0.025034724625349836,-0.38373284978326794,-0.3586981251579181,26891268,23885108,18.464268069309043,21.508364131532655,NaN,NaN,-35.55952357400258,-29.834598897664645
2006-05-30T09:30:00-04:00,20.62,20.69,20.35001,20.35001,982600,1898270.05,33.01258629220908,30.27032036254613,NaN,NaN,-75.97500195745916,-82.21424069275324,-0.02472375166048557,-0.3896028147335251,-0.3648790630730395,25908668,24558468,23.160392612727904,20.076103031110854,NaN,NaN,-35.37110033100999,-30.625527673856837
2006-05-31T09:30:00-04:00,20.50999,20.55,20.33,20.42999,1353000,1922105.05,35.28419231378135,29.909847510501567,NaN,NaN,-73.80672238703188,-74.40749203634542,-0.014802110393660584,-0.38338170106511527,-0.3685795906714547,27261668,25707468,30.514702889172426,19.227309198960775,NaN,NaN,-34.48148472734169,-31.17637868149753
2006-06-01T09:30:00-04:00,20.42,20.8,20.42,20.78,671400,1914905.05,44.201717916458975,30.77962104537456,NaN,NaN,-40.03965863407184,-62.11829090814258,0.017889623509739272,-0.3462175612842806,-0.3641071847940199,27933068,26572628,35.51907031634235,19.16207743909002,NaN,NaN,-30.628497066458387,-31.098109879349078
2006-06-02T09:30:00-04:00,20.87,20.92999,20.62,20.71001,1533700,1907430.05,42.92788147273622,31.763643278293326,NaN,NaN,-23.389282063292615,-52.57767814577534,0.03629526276190592,-0.31873810634163746,-0.3550333691035434,26399368,26878808,37.24170225566181,19.86741717313484,NaN,NaN,-27.998536283636312,-30.655313651390113
2006-06-05T09:30:00-04:00,20.69,20.69,20.38,20.39999,732300,1887735.05,37.73973982706227,32.3286524179784,NaN,NaN,-60.34582579163,-54.7112981666971,0.029380922539080534,-0.3183072159296927,-0.3476881384687732,25667068,26633968,36.404168054417966,20.859033928962436,NaN,NaN,-27.437498739989746,-30.195625806904346
2006-06-06T09:30:00-04:00,20.42,20.46001,20.22,20.39999,3650900,2032020.05,37.73973982706227,33.09274233570258,NaN,NaN,-82.93270933929026,-56.10283964306332,0.02667675792187163,-0.3143421910664337,-0.3410189489883053,25667068,26585648,36.23099412324296,22.095562459808416,NaN,NaN,-27.002609478772747,-29.73948061717126
2006-06-07T09:30:00-04:00,20.3,20.46001,20.12,20.12,1539800,2030500.05,33.49913211030075,33.792440459049836,NaN,NaN,-112.61530720081555,-63.864556605820056,0.00882409716749527,-0.3299888275289362,-0.3388129246964315,24127268,25958768,33.9730747393957,23.350142192044096,NaN,NaN,-27.985318598763907,-29.488886043113066
2006-06-08T09:30:00-04:00,20.62,20.62,19.67,20.02,5917000,2195655.05,32.111323535388394,34.44748343619598,NaN,NaN,-153.36487224549893,-86.52959932810548,-0.006121052105483804,-0.3464642398282862,-0.3403431877228024,18210268,24014208,28.119095865864182,24.356303429163145,NaN,NaN,-29.21783179098039,-29.450164007094113
2006-06-09T09:30:00-04:00,20.12,20.2,19.91,19.94,821900,2105475.05,31.00470415193338,34.64302580105133,NaN,NaN,-174.30713668828088,-116.71317025310313,-0.01717007569694079,-0.3618057823439784,-0.34463570664703763,17388368,22212008,23.992774171160548,25.10596687428488,NaN,NaN,-30.560134653505123,-29.608731242295686
2006-06-12T09:30:00-04:00,19.95,19.99001,19.57001,19.57001,801300,1910175,26.462598455718847,34.67969581488076,NaN,NaN,-241.94576802063696,-153.03315869890451,-0.04366522537223039,-0.3992172383623256,-0.3555520129900952,16587068,20396008,20.69693959706926,25.724343816430434,NaN,NaN,-33.261733784035115,-30.13058874825846
2006-06-13T09:30:00-04:00,19.57001,19.81,19.53999,19.59,1637400,1847815,27.084124356094122,34.887803583759755,NaN,NaN,-215.95291202731036,-179.63719923650854,-0.053465653691737,-0.42238408010476647,-0.36891842641302947,18224468,18907488,18.458686259972254,26.266122600997193,NaN,NaN,-35.21030457178767,-30.856262437334063
2006-06-14T09:30:00-04:00,19.52,19.8,19.52,19.72,1230800,1831505,31.15899117508087,34.901662847414734,NaN,NaN,-166.05909757639935,-190.3259573116253,-0.04514595921265163,-0.425350875428844,-0.38020491621619235,19455268,17973088,17.201142137115937,26.749405660655107,NaN,NaN,-35.62788781596504,-31.537923205709916
2006-06-15T09:30:00-04:00,19.81,20.27,19.81,20.22,1814400,1839650,44.098701517770685,35.4257213828077,NaN,NaN,-52.79331906686388,-170.2116466758983,-0.0021896225550942505,-0.38294194441006013,-0.3807523218549659,21269668,18584968,20.99678481667827,27.212413993437906,NaN,NaN,-31.660068854298,-31.55537258407964
2006-06-16T09:30:00-04:00,20.24001,20.28,20.08,20.19,2260600,1750635,43.56953038896932,35.70678309575478,NaN,NaN,-28.01096252824574,-140.95241184389127,0.026406077016453977,-0.3477447255843984,-0.3741508026008524,19009068,18909108,23.010253675635767,27.537127251032675,NaN,NaN,-28.720723130041847,-31.15042266207424
2006-06-19T09:30:00-04:00,20.23,20.28,20.02,20.10001,1165900,1706060,41.943629644514445,36.344714763776594,NaN,NaN,-35.67451193408693,-99.69816062658126,0.040613167207223966,-0.32338434359182244,-0.3639975107990464,17843168,19160328,24.613860593446162,27.64094639251255,NaN,NaN,-26.807934031509674,-30.530067143422162
2006-06-20T09:30:00-04:00,20.11,20.23,19.99001,20.07001,1023600,1676820,41.389120093549856,36.78078103376005,NaN,NaN,-40.426406085174015,-64.59285943815397,0.048792852677062626,-0.3030064449527181,-0.35179929762978074,16819568,18879348,24.011454466361457,27.17642864802605,NaN,NaN,-25.41666799527827,-29.799581550830176
2006-06-21T09:30:00-04:00,20,20.46001,20,20.33,1515200,1701320,47.826551794049394,37.039697739302234,NaN,NaN,2.5355430614741765,-30.87393131057927,0.07116116055889188,-0.2628478469311659,-0.3340090074900578,18334768,18655248,23.517093222421877,26.319144569888874,NaN,NaN,-22.21766628611784,-28.716450798728413
2006-06-22T09:30:00-04:00,20.39999,20.39999,20.05,20.09,669500,1630265,43.11853824994758,37.05331608053161,NaN,NaN,-16.09330998570244,-23.533929494346978,0.06917965401668863,-0.247534439969197,-0.3167140939858856,17665268,17934368,21.951442722713878,25.22698317467831,NaN,NaN,-20.87617147190017,-27.596410894895808
2006-06-23T09:30:00-04:00,20.03999,20.2,19.98,20.03,483900,1591400,42.00527678559685,37.357997291855504,NaN,NaN,-39.63109817193621,-25.85795662308508,0.06336953443709681,-0.23750217593951461,-0.3008717103766114,17181368,17568828,21.181386936864897,24.13964166628166,NaN,NaN,-20.115849290767663,-26.527759237163217
2006-06-26T09:30:00-04:00,20.05,20.2,20.00999,20.07001,961700,1538345,43.06098781658543,37.738086433964305,NaN,NaN,-27.54183528260888,-24.231421292789467,0.06170226301844062,-0.22374388160356062,-0.28544614462200124,18143068,17628808,21.666966391045676,23.099353971124714,NaN,NaN,-19.191221213522873,-25.47968237664317
2006-06-27T09:30:00-04:00,20.14999,20.14999,19.8,19.8,1326600,1555545,38.02973787950948,38.061701131764934,NaN,NaN,-74.19001702196044,-30.984143480146752,0.0427936656143042,-0.231954062604121,-0.2747477282184252,16816468,17628188,21.665480558892952,22.2202401010888,NaN,NaN,-19.869455051405005,-24.678221330180573
2006-06-28T09:30:00-04:00,19.75,19.92999,19.72,19.92999,870000,1531395,41.569286419119244,38.73726990917428,NaN,NaN,-84.51220038723389,-48.39369216988837,0.039499289130213444,-0.22537361680565837,-0.2648729059358718,17686468,17498528,21.33595975607051,21.73573037896068,NaN,NaN,-19.390018976155098,-23.922763851034077
2006-06-29T09:30:00-04:00,20,20.44,20,20.44,1085900,1552120,52.92908457856931,40.30329708250541,NaN,NaN,64.36567973804667,-32.30189422513855,0.07032626221425828,-0.17696507816804896,-0.24729134038230724,18772368,17719948,23.476411066244296,21.698847300038093,NaN,NaN,-15.096945053428499,-22.66193259423328
2006-06-30T09:30:00-04:00,20.41,20.41479,20.27,20.33,1788800,1564875,50.64221803729478,42.030412766903694,NaN,NaN,96.90311566251867,-4.995051458247568,0.08119595777827679,-0.14579639315946125,-0.22699235093773804,16983568,17680388,23.354141847173423,21.888647460759817,NaN,NaN,-12.389333025612212,-21.194418370144557
2006-07-03T09:30:00-04:00,20.28999,20.5,20.28999,20.48,411000,1548810,53.58710323928039,43.92348268713129,NaN,NaN,132.99399043143924,27.112113684562058,0.09539454160723684,-0.10774917392869199,-0.20314371553592883,17394568,17530688,22.86876577784517,22.203653140607884,NaN,NaN,-9.215460379478527,-19.483138657192267
2006-07-05T09:30:00-04:00,20.41,20.41,20.16,20.16,931300,1412830,47.127176953359886,45.06406738557979,NaN,NaN,66.10801935903501,55.17172096076115,0.08072356943206016,-0.10223925374585363,-0.1829628231779138,16463268,17460048,22.629760235035548,22.591411576173574,NaN,NaN,-8.568560338281001,-17.923913183062087
2006-07-06T09:30:00-04:00,20.2,20.3,20.13,20.17999,794500,1375565,47.552520067019664,45.31076871052614,NaN,NaN,50.91890595519883,82.25794222924769,0.07024017763172069,-0.09516260113826291,-0.1654027787699836,17257768,17374308,22.324781239103004,22.686268463489622,NaN,NaN,-7.929545817383672,-16.4961464165366
2006-07-07T09:30:00-04:00,20.17999,20.17999,19.9026,19.98,833800,1121405,43.75970665353503,45.324352729423694,NaN,NaN,-21.08542956705635,65.1677203682271,0.04873233554501133,-0.10448735933871944,-0.15321969488373077,16423968,16904628,20.680576518284767,22.519862952250264,NaN,NaN,-8.570115196984348,-15.36385624231485
2006-07-10T09:30:00-04:00,20.05,20.08,19.67,19.75,1966700,1178645,39.82553093175018,45.17305996422625,NaN,NaN,-86.38492633998145,28.510111967727067,0.01941581927869987,-0.12894992078535594,-0.1483657400640558,14457268,16399368,19.05476633271411,22.1227847907694,NaN,NaN,-10.372472042835279,-14.650801356674911
2006-07-11T09:30:00-04:00,19.75,19.86,19.55,19.83,2244100,1250785,41.78597219657254,45.20140654301358,NaN,NaN,-121.0800787381862,-22.304701866198023,0.006481020745617211,-0.1402644641320343,-0.14674548487765152,16701368,16260728,18.62215737639815,21.737834998629165,NaN,NaN,-11.246753302421851,-14.164508777495902
2006-07-12T09:30:00-04:00,19.72,19.7701,19.42149,19.47,1032300,1220530,36.088212411302166,44.36295372996021,NaN,NaN,-185.98570120254098,-72.72344597851323,-0.023602514603070168,-0.17624862813148923,-0.15264611352841906,15669068,16101888,18.114723337443664,21.351951435416435,NaN,NaN,-13.891770971483226,-14.125546233779806
2006-07-13T09:30:00-04:00,18.85001,19.49001,18.85001,19.14999,1903300,1254155,31.921422588989245,43.56315975417748,NaN,NaN,-269.7843446955768,-136.86409610866835,-0.06025165404672661,-0.22796068108682732,-0.1677090270401007,13765768,15403488,16.044552238357113,20.930030686533808,NaN,NaN,-17.592831612766222,-14.620872716492151
2006-07-14T09:30:00-04:00,18.89,19.17,18.89,19.10001,920600,1209465,31.313311932464856,42.79944797895376,NaN,NaN,-224.9022488846741,-177.6274599721919,-0.08172476902284381,-0.26986498831865546,-0.18814021929581165,12845168,14687728,14.247498616113589,20.434752949337287,NaN,NaN,-20.707590405193553,-15.490403814878066
2006-07-17T09:30:00-04:00,19.07001,19.23,19.07001,19.16,988000,1145835,32.96403987912743,42.07823741199247,NaN,NaN,-163.4780957075916,-193.04609384571393,-0.08535589393161361,-0.29483508671032865,-0.20947919277871505,13833168,14562908,13.953981775976757,19.883825476832364,NaN,NaN,-22.732976500810302,-16.52505705572553
2006-07-18T09:30:00-04:00,19.14999,19.263,18.92999,19.2,2252500,1200165,34.10126338851343,41.79763209120704,NaN,NaN,-140.6096805607376,-196.9520142102242,-0.0786948273068167,-0.30784772691223594,-0.22915289960541924,16085668,14439768,13.655107068513601,19.31165594180527,NaN,NaN,-24.06075396193083,-17.601585185183428
2006-07-19T09:30:00-04:00,19.22,19.53,19.17999,19.48,2077600,1252865,41.573194517809235,41.79791124111347,NaN,NaN,-80.1772522569878,-175.79032442111355,-0.05043639779502579,-0.29219839684920146,-0.24176199905417567,18163268,14938608,21.033794086320412,19.290072679680264,NaN,NaN,-23.002953899980614,-18.37320928729731
2006-07-20T09:30:00-04:00,19.45,19.56,19.2,19.2,709900,1212600,37.049225809005705,40.663635614716064,NaN,NaN,-82.43542569014099,-138.3205406200264,-0.04574545019104981,-0.2989438117929879,-0.2531983616019381,17453368,15676128,30.491342042551295,19.791139177987905,NaN,NaN,-23.479799726731027,-19.102722207216413
2006-07-21T09:30:00-04:00,19.13,19.2,18.92999,19,1337200,1245985,34.18748682917821,39.48829767127917,NaN,NaN,-112.9724287447018,-115.93457659203193,-0.05086237465396898,-0.3167763299193993,-0.2659139552654303,16116168,16330328,37.62731419808446,20.810651488767263,NaN,NaN,-24.78265462389525,-19.914141123884818
2006-07-24T09:30:00-04:00,19.14,19.35001,19.06,19.28999,1793500,1311465,41.27089071915129,38.60856820555567,NaN,NaN,-73.17353389541405,-97.87366422959641,-0.030472502948440394,-0.30400458395098084,-0.27353208100254045,17909668,17145628,45.18066403634984,22.404358507231883,NaN,NaN,-23.62530964059784,-20.44430805484382
2006-07-25T09:30:00-04:00,19.33,19.55,19.3,19.5,1551400,1340950,45.81891586581789,38.51512098501695,NaN,NaN,-34.81964707638881,-76.71565753272667,-0.0001990200747191695,-0.2737808560959394,-0.2735818360212202,19461068,17820708,50.52344188869298,24.396764339635983,NaN,NaN,-21.181513955516476,-20.549623183511343
2006-07-26T09:30:00-04:00,19.35001,19.67,19.35001,19.55,738700,1311555,46.873771773753916,38.466638964069396,NaN,NaN,-20.36777561318046,-64.75376220396518,0.02447132202459973,-0.24299268349047054,-0.26746400551507027,20199768,18228008,53.46996962931462,26.621420653222525,NaN,NaN,-18.90357124445155,-20.3144729065028
2006-07-27T09:30:00-04:00,19.64999,19.77,19.49001,19.49001,911700,1313640,45.723556853753315,38.606913978370706,NaN,NaN,-8.628940572934397,-49.992465180523865,0.03726138400250867,-0.22088727551193443,-0.2581486595144431,19288068,18594948,56.01161194201988,29.145066040632177,NaN,NaN,-17.377596629650473,-19.894919152666752
2006-07-28T09:30:00-04:00,19.64,19.89,19.61,19.83,800700,1299380,52.79359827820959,39.53320450311781,NaN,NaN,30.03686847519804,-21.390605736543897,0.06737550331857545,-0.1739292803662238,-0.24130478368479924,20088768,19389468,60.98149512245632,32.139832382756616,NaN,NaN,-13.775392989065303,-19.020701129295116
2006-07-31T09:30:00-04:00,19.7,19.91,19.7,19.8,3630600,1391470,52.148109139352336,40.27335714188779,NaN,NaN,43.38332716407488,1.9207664753538907,0.08300391441904581,-0.137549890660992,-0.2205538050800378,16458168,19099168,58.38586539264346,34.98009724105986,NaN,NaN,-11.07053562284997,-17.884963199802954
2006-08-01T09:30:00-04:00,19.72,19.72,19.41,19.52,1302500,1436045,46.44083006433735,41.012829831390306,NaN,NaN,2.4810189508305496,9.380899680797764,0.07259009844482364,-0.12981618202400824,-0.20240628046883188,15155668,18238088,51.39761031387323,37.35744631080483,NaN,NaN,-10.416856972722396,-16.818090881648587
2006-08-02T09:30:00-04:00,19.63,19.83,19.60001,19.75999,1035900,1441275,51.354983333834085,42.400941313164935,NaN,NaN,53.93280068009252,24.24101493945232,0.07941852799407617,-0.10313312047623668,-0.18255164847031286,16191568,17436448,45.8907196263034,39.48931540994385,NaN,NaN,-8.311759747393156,-15.602900719612096
2006-08-03T09:30:00-04:00,19.64999,19.89,19.50999,19.82001,644400,1433770,52.52809419591995,43.916282903411734,NaN,NaN,67.44680161932666,39.45616337790453,0.08502982959193778,-0.07626436148039062,-0.1612941910723284,16835968,16946028,42.86492743145027,41.53341746818218,NaN,NaN,-6.253532908843712,-14.267276746645184
2006-08-04T09:30:00-04:00,19.94,20.08,19.62,19.75999,992500,1441705,51.198429845340705,45.218739329569814,NaN,NaN,95.25467678697485,52.49972504025989,0.08172963272147835,-0.05913215017048046,-0.1408617828919588,15843468,16096968,38.17228676685692,43.26329639610219,NaN,NaN,-4.942859963432849,-12.935217206186278
2006-08-07T09:30:00-04:00,19.64999,19.75,19.60001,19.69,1869800,1436860,49.62103335249785,46.327294326997276,NaN,NaN,59.89286582404232,55.80163277225338,0.07219434255531947,-0.05061885469780947,-0.12281319725312893,13973668,15600068,35.70850533534221,44.8385391294471,NaN,NaN,-4.289812683234808,-11.70015941719321
2006-08-08T09:30:00-04:00,19.67999,19.78,19.53,19.62,1080100,1378660,48.02728767738513,46.788300981252696,NaN,NaN,51.84056351782101,65.67354168565147,0.05908568868533924,-0.04895608639645488,-0.10804177508179412,12893568,15147648,33.58314373256478,45.73492124703598,NaN,NaN,-4.17749435477352,-10.625492979704683
2006-08-09T09:30:00-04:00,20,20.10001,19.7,19.74001,1684200,1411255,50.93675549989539,47.780267387744814,NaN,NaN,101.53260639154576,75.19350282794213,0.05641582303592524,-0.03752199628688757,-0.09393781932281281,14577768,14824888,32.11460198604263,45.85086838585679,NaN,NaN,-3.2814303186252993,-9.576341170979056
2006-08-10T09:30:00-04:00,19.64,19.85001,19.64,19.82001,769300,1354555,52.832325705418604,49.112041593190554,NaN,NaN,74.09078651460871,76.52229980699853,0.05774681857752326,-0.021754296100908732,-0.07950111467843199,15347068,14527108,30.777398917863835,45.36158872298389,NaN,NaN,-2.000871283970899,-8.494131187120749
2006-08-11T09:30:00-04:00,19.7,19.77,19.63,19.71001,1022700,1359660,49.9733562895323,49.7336462767892,NaN,NaN,50.10957321734814,67.4932790930732,0.0492587306125581,-0.017927701412734365,-0.06718643202529247,14324368,14223288,29.430906309015484,44.236606028174286,NaN,NaN,-1.6669161369731154,-7.5188147513853725
2006-08-14T09:30:00-04:00,19.87,20.06,19.83,19.88,841500,1352335,54.106463561268306,50.32561396932137,NaN,NaN,112.22458396760919,77.95962272178656,0.05281722801118255,-0.001164897011314281,-0.05398212502249683,15165868,14461728,31.947223284714426,42.90973327074725,NaN,NaN,-0.214543836943909,-6.4753474778937345
2006-08-15T09:30:00-04:00,20.10001,20.36,20.07001,20.34,1497700,1314595,63.0119209255576,51.478338908735914,NaN,NaN,203.8996469166677,108.3714394015559,0.08212712895808641,0.048676786175111175,-0.03345034278297523,16663568,15215728,39.3160987449547,41.89874249329297,NaN,NaN,4.065078440152604,-4.969572346744258
2006-08-16T09:30:00-04:00,20.55,20.69,20.39,20.66,4193898,1420409.9,67.7064999278979,53.048549128317674,NaN,NaN,259.6050834552756,139.98593481430186,0.11691938004753244,0.11269888227644032,-0.004220497771092117,20857466,16471667.6,49.18615287988941,41.4112097031408,NaN,NaN,9.416944577763415,-2.914355643243162
2006-08-17T09:30:00-04:00,20.64999,20.87,20.63,20.75,1840600,1476944.9,68.9019865911109,54.19914829352491,NaN,NaN,251.77765201727274,175.52330791483467,0.1383794491064223,0.16875381361193575,0.03037436450551346,22698066,17941867.2,57.83222670726547,41.186261959198596,NaN,NaN,14.089987174310718,-0.4851638121640365
2006-08-18T09:30:00-04:00,20.60001,20.88,20.58,20.83,764200,1448294.9,69.96630256403205,55.471876395287744,NaN,NaN,202.11693888151717,205.92478104766846,0.14940462108072444,0.21713014085641902,0.06772551977569458,23462266,19769446.8,65.65535686451904,41.70551135004685,NaN,NaN,18.21158453422957,2.185800237320764
2006-08-21T09:30:00-04:00,20.77,20.77,20.63,20.69,1590800,1438159.9,65.72690773303471,56.84945337162327,NaN,NaN,150.46160471716618,213.5721851975799,0.13893103459405523,0.2413893130182636,0.10245827842420838,21871466,21110566.4,70.0469035484798,43.03760372394732,NaN,NaN,20.381427151278874,4.785175510743351
2006-08-22T09:30:00-04:00,20.64,20.87,20.61,20.7,1022800,1411729.9,65.88591075231338,57.88737675865751,NaN,NaN,128.20505648186722,198.43326711061977,0.12478748315657537,0.2584426323699276,0.13365514921335223,22894266,22356706,73.444673784077,45.005743306645435,NaN,NaN,22.17395802296188,7.269287298203141
2006-08-23T09:30:00-04:00,20.46001,20.85001,20.46001,20.60001,2497700,1499679.9,62.75107698153411,58.61758981477281,NaN,NaN,96.33222868357282,165.7786961562792,0.10178137636509754,0.26088186966972415,0.1591004933046266,20396566,22264526,72.78692456339107,47.14302881606977,NaN,NaN,22.799661881456398,9.487912238667892
2006-08-24T09:30:00-04:00,20.88,20.88,20.56,20.67999,1137200,1510954.9,64.21763912136605,59.547533334488904,NaN,NaN,93.79314316645183,134.18179438611506,0.08567969432003322,0.26620011120466813,0.1805204168846349,21533766,22031666,71.05574504130988,49.49184726424499,NaN,NaN,23.735643550238304,11.523302426035094
2006-08-25T09:30:00-04:00,20.67999,20.84,20.63499,20.74001,961900,1519014.9,65.321086201034,60.66896568081291,NaN,NaN,87.1484870610795,111.18810402202753,0.07328056680027678,0.2721211253849809,0.19884055858470412,22495666,21838346,69.5762406035181,51.91097121197184,NaN,NaN,24.826025516757237,13.4236914389954
2006-08-28T09:30:00-04:00,20.8,20.95,20.71001,20.92999,1381000,1406534.9,68.61973239611882,62.13985458929388,NaN,NaN,94.08734139061211,99.91325135671671,0.07197883383463072,0.28881410087799253,0.2168352670433618,23876666,22239386,70.92855979237663,54.578500930529835,NaN,NaN,26.737721220616688,15.325695693512726
2006-08-29T09:30:00-04:00,20.97,21.12,20.81,21.12,1767000,1429759.9,71.53595167375212,63.611225744569374,NaN,NaN,104.94152687883931,95.26054543611113,0.0775388319840967,0.3137588070234827,0.236219975039386,25643666,22789266,72.71912268881577,57.47882383787077,NaN,NaN,29.28634338776138,17.320073935548248
2006-08-30T09:30:00-04:00,21.14,21.3,21.09,21.27,2012100,1478569.9,73.62013353099903,65.09606916068226,NaN,NaN,120.18067354853629,100.03023440910383,0.0843780945603046,0.34169259323976675,0.25731449867946216,27655766,24241106,76.7847846554532,60.76506567627001,NaN,NaN,32.103076026321084,19.431931377087224
2006-08-31T09:30:00-04:00,21.35001,21.35001,21.17,21.19,1108400,1501769.9,70.64895927817516,66.57289794558532,NaN,NaN,112.46911486531607,103.76542874887669,0.07679027242663572,0.3533023392127568,0.27651206678612106,26547366,25243826,79.1013126197389,64.31295184132169,NaN,NaN,33.59752323110373,21.45558735623244
2006-09-01T09:30:00-04:00,21.32001,21.35001,21.17999,21.28,4026600,1653474.9,72.01719214433247,67.85223570151848,NaN,NaN,109.33104499865816,108.20194033639241,0.07123158155548659,0.36555154373047927,0.2943199621749927,30573966,26859486,82.18581898420533,67.9014229627139,NaN,NaN,35.25208104973474,23.42651502673277
2006-09-05T09:30:00-04:00,21.28,21.41,21.14999,21.39,2460500,1683009.9,73.63490245995784,68.61102009683279,NaN,NaN,112.15778785764078,111.81602962979814,0.0683501087029662,0.37975759805370046,0.31140748935073426,33034466,28691046,84.9056235518044,71.15781759177459,NaN,NaN,37.13192056046031,25.38443010297956
2006-09-06T09:30:00-04:00,21.13,21.27,21.02,21.03999,1333500,1695679.9,61.459789863461936,68.16482652080164,NaN,NaN,77.91802349698983,106.41132895342825,0.0377851685502299,0.35863895003852164,0.32085378148829174,31700966,29902506,86.38617841368584,73.81496227276004,NaN,NaN,35.03887384219501,26.76363635143891
2006-09-07T09:30:00-04:00,20.92999,21.08,20.83,20.92,1839100,1703424.9,57.92391825794314,67.38067878271823,NaN,NaN,45.234393996722,91.4220730430654,0.006064251069634485,0.32843409532533485,0.32236984425570037,29861866,30343726,86.89052090307392,75.89055471531779,NaN,NaN,32.18248025933982,27.53775690971047
2006-09-08T09:30:00-04:00,20.91,21.11,20.91,21.09,1894800,1759699.9,61.319297720066515,66.76303557957785,NaN,NaN,57.42688440979746,80.41362695196167,-0.006225685018771021,0.3145877379822366,0.3208134230010076,31756666,31385586,88.01919928036699,77.4879720307355,NaN,NaN,30.79223151899258,28.00268185389363
2006-09-11T09:30:00-04:00,20.95,21.33,20.95,21.27,3203900,1868759.9,64.57861633031476,66.68101476509784,NaN,NaN,82.33376151032832,75.01417025429569,-0.005040033419648038,0.31451338122644756,0.3195534146460956,34960566,32262906,88.88686920527941,78.83368386336404,NaN,NaN,30.624591724301798,28.377240406809083
2006-09-12T09:30:00-04:00,21.2,21.67,21.2,21.64,1423600,1897864.9,70.14705617111986,66.9853822950126,NaN,NaN,149.94060551117775,82.57073378500309,0.01666654504149573,0.3403865959479653,0.32372005090646955,36384166,32932846,89.51152885027953,79.9813163680928,NaN,NaN,32.360707694091126,28.94630716213509
2006-09-13T09:30:00-04:00,21.63,21.6799,21.5099,21.64,1699800,1907969.9,70.14705617111986,67.51366652284015,NaN,NaN,160.71371673671877,99.12987243294887,0.026446826152002556,0.35677858359647274,0.3303317574444702,36384166,33869486,90.32991590383627,81.2343871781246,NaN,NaN,33.7007345421156,29.625511073560876
2006-09-14T09:30:00-04:00,21.5,21.75819,21.5,21.69,1479300,1772240,70.86488741566527,67.98846997243297,NaN,NaN,150.53987170760632,120.19096797512574,0.03136984216138128,0.3695440601461968,0.3381742179848155,37863466,35469806,91.54395497737252,82.6978307449862,NaN,NaN,35.00052560044238,30.393370291686804
2006-09-15T09:30:00-04:00,21.87,21.89999,21.67,21.7,6910000,2025710,71.01500208926578,68.3951782501638,NaN,NaN,153.04632402080307,139.31485589732688,0.030366141103666422,0.37613189436439853,0.3457657532607321,44773466,38073166,93.0685042157512,84.37584957443144,NaN,NaN,36.09429112536719,31.207787553641143
2006-09-18T09:30:00-04:00,21.60001,21.85001,21.55,21.69,1173100,2046155,70.6231356010158,68.53827847908501,NaN,NaN,123.06033222774076,147.46017004080937,0.024354740421503596,0.3762091787876116,0.351854438366108,43600366,39801126,93.85980318708164,86.01379553119607,NaN,NaN,36.88761929041131,32.019192087465456
2006-09-19T09:30:00-04:00,21.72,21.73,21.38,21.59,3532900,2143260,66.66173023149486,68.19011980463807,NaN,NaN,85.78042681417547,134.62813430140892,0.009720639063660885,0.3640052371956841,0.35428459813202323,40067466,40537786,94.16559663508428,87.54568652735813,NaN,NaN,36.49217530726674,32.65818969029421
2006-09-20T09:30:00-04:00,21.77,21.95,21.60001,21.94,2559300,2220085,72.48010609508425,68.1086892735013,NaN,NaN,130.17106116225628,128.5196031865164,0.019144933161895916,0.3782157645843931,0.3590708314224972,42626766,41786306,94.65174731784295,88.82189814610024,NaN,NaN,37.87812990222465,33.4038954348557
2006-09-21T09:30:00-04:00,21.94,22,21.69,21.73,1954400,2192920,65.13483289599836,67.71482310334581,NaN,NaN,111.59685026527757,120.73099889805067,0.007372999460704133,0.36828708074837735,0.3609140812876732,40672366,42348086,94.85931093883,89.94746945460676,NaN,NaN,36.7589510320597,33.88318909159913
2006-09-22T09:30:00-04:00,21.64999,21.7,21.56,21.60001,3341500,2303135,61.01303143366054,66.92881162401211,NaN,NaN,62.34568894260946,102.59087188241195,-0.011977968244308468,0.34594162098228765,0.3579195892265961,37330866,40859566,85.40174948150657,90.17717877584255,NaN,NaN,34.5258561907886,33.974998677197625
2006-09-25T09:30:00-04:00,21.73,22.03999,21.6888,21.99001,1670300,2338555,67.63122387442417,66.49997743933106,NaN,NaN,115.76704188559131,101.13221381398203,-0.0018530707085054332,0.35560325084096434,0.35745632154946977,39001166,39939726,80.08790958723985,89.83305634980222,NaN,NaN,34.70487485062607,34.07926670197312
2006-09-26T09:30:00-04:00,22.10001,22.14,21.9182,22.13,2522500,2395630,69.62446978012987,67.08316886195021,NaN,NaN,138.34212414907478,111.6445532809619,0.010265133650339153,0.3702877386123937,0.36002260496205457,41523666,40230966,80.50158939570582,89.41272856280365,NaN,NaN,35.51307632994468,34.2840966488262
2006-09-27T09:30:00-04:00,22.2,22.25999,21.89,21.96001,5312102,2572885.1,64.43561381499424,67.54828997316814,NaN,NaN,121.61527283017101,109.93339561454484,0.0031918520660126903,0.36401242004457046,0.36082056797855777,36211564,38947925.6,73.27887784869375,88.44046834463363,NaN,NaN,34.4645514425632,34.30987590507434
2006-09-28T09:30:00-04:00,22,22.08,21.89,22.07001,2266700,2585615.1,66.19147405679422,67.8963025686487,NaN,NaN,106.12293434415173,108.83861243031967,0.0023215448178711684,0.3637224990008967,0.36140095418302554,38478264,38509105.2,70.93472531398845,87.2201487756066,NaN,NaN,34.170870913339975,34.29001804911229
2006-09-29T09:30:00-04:00,22.08,22.14999,21.96001,22,1186700,2589530.1,64.02488999266177,67.85675068738776,NaN,NaN,102.59832648045575,116.88913993788893,-0.006108344277930555,0.3537655238356123,0.3598738681135429,37291564,38501244.8,70.89097909187436,85.93472805322052,NaN,NaN,33.26460381299779,34.143530301095936
2006-10-02T09:30:00-04:00,21.95,22.07001,21.84,21.84,4174199,2596910.05,59.25159651690766,67.07850356922975,NaN,NaN,68.7054766610001,107.47682689297069,-0.024563553521020298,0.3291694262122675,0.3537329797332878,33117365,37324484.6,64.47986118610648,84.14675179149388,NaN,NaN,31.015076922100665,33.6966083898109
2006-10-03T09:30:00-04:00,21.75,22.02,21.69,21.96001,2061400,2576955.05,61.56614046233715,66.46558101860242,NaN,NaN,56.97093928489174,91.20258992013409,-0.030409417292645846,0.3157212081174805,0.34613062541012635,35178765,36055504.4,58.35147422325306,81.86257738573795,NaN,NaN,29.829106887465883,33.14410817519018
2006-10-04T09:30:00-04:00,21.92,22.35001,21.91,22.3,6255199,2823040,67.24282393826743,66.20686219878829,NaN,NaN,121.37743136285181,91.15502162667025,-0.013937618867817358,0.32870860182535466,0.342646220693172,41433964,37099984.4,61.58758695629459,79.7228368128038,NaN,NaN,30.59819920575325,32.78040689384205
2006-10-05T09:30:00-04:00,22.33,22.35001,22.21001,22.28999,1707800,2816475,66.92938702228682,65.91503255114694,NaN,NaN,140.3058007046656,97.99159489877302,-0.006645436718494269,0.3343394247950542,0.34098486151354845,39726164,37349564.4,62.34058171203699,77.52798520539565,NaN,NaN,31.106927259288288,32.54133837462008
2006-10-06T09:30:00-04:00,22.2,22.32001,21.10001,22.3,1649100,2804190,67.09456665632482,65.66299191224043,NaN,NaN,27.654164473493523,83.00276249738059,-0.004196352525824842,0.3357394208562674,0.33993577338209224,41375264,38166304.4,64.77413445511624,75.4504374388267,NaN,NaN,31.56396484314564,32.40171358440945
2006-10-09T09:30:00-04:00,22.23,22.41,22.2,22.36,525100,2670250,68.12235191167224,65.76732203225312,NaN,NaN,157.0613012781996,100.67392742082048,-0.0017114039957938365,0.3377965183873499,0.33950792238314376,41900364,39922904.2,69.36007610636014,73.67861454391782,NaN,NaN,32.23578211852348,32.378009089282884
2006-10-10T09:30:00-04:00,22.38,22.41,22.25,22.38,1590200,2678580,68.47581338777447,65.48130112458813,NaN,NaN,148.02953554562086,118.8856466729663,-0.0018830474188621382,0.3371541131095661,0.33903716052842825,43490564,41585264,72.94916641886515,72.12843019399085,NaN,NaN,32.88919005460027,32.45103494147108
2006-10-11T09:30:00-04:00,22.34,22.5,22.25,22.37,1479500,2667565,68.06940519135357,65.69091343139921,NaN,NaN,136.34537005514298,121.87923441142452,-0.005621031448090119,0.33201087121831563,0.33763190266640575,42011064,41700684,73.18403818220249,70.5801964256603,NaN,NaN,33.33072728793332,32.576705276679974
2006-10-12T09:30:00-04:00,22.39,22.73,22.39,22.7,2433600,2715280,73.6311924443048,66.59221064644522,NaN,NaN,182.44224633753774,130.30652353799897,0.010312439787472205,0.350522452400746,0.34021001261327377,44444664,42644384,75.08856246279049,69.84354021003774,NaN,NaN,35.40080395310176,32.98014794474023
2006-10-13T09:30:00-04:00,22.74001,22.88,22.6828,22.81,2931700,2516365,75.1829401784291,67.13161895387415,NaN,NaN,195.4094740584828,163.8575854549968,0.02367694901645273,0.3698061988838397,0.34612924986738697,47376364,43844604,77.29701321614878,69.64419046924552,NaN,NaN,37.62437664873914,33.64360918816865
2006-10-16T09:30:00-04:00,22.89,22.96001,22.8,22.8,1901300,2552775,74.75226781845191,67.49789024232572,NaN,NaN,173.77821514092406,167.2009682275417,0.02701860875689993,0.3799025108135119,0.35288390205661196,45475064,44559544,78.51865484365076,69.50255228695586,NaN,NaN,39.32182734421588,34.45478321046111
2006-10-17T09:30:00-04:00,22.7,22.7,22.46001,22.61,7454102,2748835.1,66.90975207008523,67.67461440340365,NaN,NaN,99.06135347039724,157.40733181249698,0.012354204925531298,0.36832665821352606,0.35597245328799476,38020962,43465623.6,72.12367090060661,69.42003750494965,NaN,NaN,38.570839711268526,35.04279128200503
2006-10-18T09:30:00-04:00,22.71001,22.86,22.468,22.55,3755700,2808655.1,64.60471674085865,67.56127459512254,NaN,NaN,95.43372858949415,149.22500351936722,-0.004559179872337615,0.35027347844757273,0.35483265831991034,34265262,41916463.2,64.15489269336287,68.93576374633354,NaN,NaN,37.28299826169546,35.36282085053223
2006-10-19T09:30:00-04:00,22.5,22.66,22.41,22.62,1981700,2810020.1,66.07317905436344,67.70758095667266,NaN,NaN,73.0410629913358,127.34476685012683,-0.01368886720140644,0.3377215743181523,0.35141044151955875,36246962,40276922.8,56.97953968817721,67.94208950321232,NaN,NaN,36.59668186832196,35.53908671021648
2006-10-20T09:30:00-04:00,22.64,22.75999,22.56,22.75999,1739500,2729920.1,68.85594233925409,68.39360565826884,NaN,NaN,94.79865707734551,107.22260345389937,-0.01296349246850681,0.33520607593392526,0.3481695684024321,37986462,38398942.4,50.071459703354535,66.91291796873003,NaN,NaN,36.784088991847824,35.716944179020956
2006-10-23T09:30:00-04:00,22.75,22.97,22.47,22.89999,1301500,2711480.1,71.38384358817076,69.09487016725696,NaN,NaN,104.41833527714864,93.35062748114427,-0.006068996503349577,0.3405833227732451,0.3466523192765947,39287962,37161522,46.1050479319587,66.03817323363758,NaN,NaN,37.68729798776623,35.998423294556
2006-10-24T09:30:00-04:00,22.87,22.94,22.64999,22.74001,2198500,2695280.1,64.90109371372755,68.92760372264696,NaN,NaN,92.43614874436646,92.02558653593812,-0.014799426058017318,0.32815303670407303,0.34295246276209035,37089462,36975222,45.52040071156753,64.89051707329995,NaN,NaN,36.53239284395553,36.074704658755934
2006-10-25T09:30:00-04:00,22.8,22.96001,22.75999,22.94,1331000,2496225,68.72481709443423,69.05584872780035,NaN,NaN,105.14244279048154,93.9673293761356,-0.009859417349748878,0.33062819107490427,0.34048760842465314,38420462,37806262,48.64857992546484,63.91251694568765,NaN,NaN,36.697005524341456,36.16360478241101
2006-10-26T09:30:00-04:00,22.92,23.08,22.84,23.06,2169900,2491385,70.78168189005262,69.31921410163805,NaN,NaN,116.91958723989258,102.74303422584694,-0.0016923095204168792,0.33837222152413204,0.3400645310445489,40590362,38674942,51.76625791040222,62.98338290677951,NaN,NaN,37.473114882993755,36.35067765392283
2006-10-27T09:30:00-04:00,23,23,22.66,22.75999,2352500,2549675,60.13379002745448,68.74860253847964,NaN,NaN,69.45114181690514,97.67353117375887,-0.01873085163356214,0.3166509665025963,0.3353818181361584,38237862,38725222,51.94810629004401,61.73967077704264,NaN,NaN,34.6213452045763,36.10363016115904
2006-10-30T09:30:00-05:00,22.62,22.92,22.53999,22.84,2476500,2464790.05,61.784881693008245,68.27067884599634,NaN,NaN,55.95887257806892,87.98163863394294,-0.026379938279918247,0.30240689528626064,0.3287868335661789,40714362,39010502,53.03013438305016,60.31688277448443,NaN,NaN,32.85080510819449,35.63894086787839
2006-10-31T09:30:00-05:00,22.95,22.99001,22.78,22.89,2823100,2502875.05,62.82115090273553,67.89580353966649,NaN,NaN,84.61491434608467,86.41739175428657,-0.029597961257864902,0.29178938199384774,0.32138734325171264,43537462,40300102,57.67037818444276,59.20876420321587,NaN,NaN,31.738817304069926,35.08178035876289
2006-11-01T09:30:00-05:00,23,23,22.64999,22.77,3312000,2355715.1,58.70661947475804,66.82976261327028,NaN,NaN,55.71669672020334,76.53224254023092,-0.040651528398630676,0.2705729327534243,0.311224461152055,40225462,40661102,58.894592080373386,58.05205203304322,NaN,NaN,29.538812631985216,34.28992782636608
2006-11-02T09:30:00-05:00,22.62,22.74001,22.60001,22.63,2804100,2410530.1,54.24297620605961,65.33405090095818,NaN,NaN,1.7730490157845356,53.50293489540932,-0.057220516786438635,0.2396988151690067,0.29691933195544534,37421362,40027302,55.8411013360535,56.519486898750706,NaN,NaN,26.28119753185942,33.14582349857942
2006-11-03T09:30:00-05:00,22.7,22.8,22.50999,22.63,1916900,2423920.1,54.24297620605961,63.86910150007301,NaN,NaN,-19.11427202972086,35.78985212608412,-0.0673130005434317,0.21277808127615572,0.2800910818195874,37421362,39864002,55.049164480515074,54.8430947299553,NaN,NaN,23.672104583491382,31.79243508213827
2006-11-06T09:30:00-05:00,22.74001,22.96001,22.67,22.89999,1514500,2473390.1,60.89329731205424,63.43935473164223,NaN,NaN,64.51471631592025,37.50102087365438,-0.05543352099460552,0.2107991805763305,0.26623270157093604,38935862,39508302,53.27678405421137,53.49688852664134,NaN,NaN,23.323838746075808,30.58263560555792
2006-11-07T09:30:00-05:00,23.05,23.14,22.67999,23.02,3286500,2558205.1,63.437080832012256,63.355952166724634,NaN,NaN,112.07911939452788,42.99386188334302,-0.0398502114731919,0.2164199372294462,0.2562701487026381,42222362,39245282,51.9449828231603,52.624752107341166,NaN,NaN,23.82299667049329,29.616972900548685
2006-11-08T09:30:00-05:00,23.02,23.13,22.82001,23.03999,2987400,2633600.1,63.85878869211333,63.19778142656391,NaN,NaN,139.21712766500147,59.693948072302646,-0.029054531957610846,0.21995198375562452,0.24900651571323537,45209762,40242142,56.39412696488836,52.58293691282053,NaN,NaN,24.349929746969707,28.86453816432312
2006-11-09T09:30:00-05:00,23.28999,23.28999,23.02,23.03,3104600,2667150.1,63.46483843368063,62.812702576165805,NaN,NaN,185.54994154826892,96.44932657879954,-0.023672605942896108,0.21941575828461524,0.24308836422751134,42105162,41178902,60.12976969967339,53.3013876268433,NaN,NaN,24.670437817840554,28.265380971968465
2006-11-10T09:30:00-05:00,22.78,23.11,22.78,23.09,1608900,2601010.1,64.86671543898026,62.34719342265218,NaN,NaN,100.15851801883217,120.30388458851014,-0.017445492247572414,0.22128149891804583,0.23872699116561824,43714062,42437442,64.52666152062612,54.61721716889098,NaN,NaN,25.33095064767272,27.846176639926217
2006-11-13T09:30:00-05:00,23.14999,23.31,23.09,23.28999,2047400,2608315.1,69.1199435781853,62.64853984154202,NaN,NaN,187.8882039867499,144.97858212267607,-0.0020414703142460355,0.2361751532728107,0.23821662358705673,45761462,43802562,68.5748678417874,56.26396482104955,NaN,NaN,27.193963576841888,27.753003345199883
2006-11-14T09:30:00-05:00,23.33,23.52,23.17,23.46001,2433400,2357280,72.20103743926228,62.89684129474402,NaN,NaN,213.73282138330367,165.3093225204312,0.016398993171893333,0.2587153650519234,0.24231637188003005,48194862,44997062,71.62612768772735,57.90521823263972,NaN,NaN,29.788006224167347,28.043718042195234
2006-11-15T09:30:00-05:00,23.28,23.59,23.28,23.50999,1718700,2255430,73.05223528083883,63.059023679800184,NaN,NaN,200.4011814886715,177.54613328516524,0.02807791084303768,0.27741376043382715,0.24933584959078947,49913562,45937822,73.785010835802,59.47798629873971,NaN,NaN,32.18077059224603,28.634725549345347
2006-11-16T09:30:00-05:00,23.57001,23.66,23.45,23.60001,1622900,2237490,74.5629948151976,64.08968116463898,NaN,NaN,198.22999100066252,180.08214317564392,0.037397858448306676,0.2960831726511728,0.2586853142028661,51536462,47824082,77.48419095409324,61.301992346171794,NaN,NaN,34.66463933594199,29.49614180457344
2006-11-17T09:30:00-05:00,23.5,23.64,23.4799,23.64,1521100,2226570,75.22741229632925,65.04986192201905,NaN,NaN,167.84069817745578,193.61857920736867,0.04147264725816491,0.3105261232755723,0.26905347601740737,53057562,49692782,80.43038171987322,63.25915287023059,NaN,NaN,36.92185218258519,30.556957572860835
2006-11-20T09:30:00-05:00,23.60001,23.72,23.52,23.64,1402000,2231595,75.22741229632923,65.93602345013288,NaN,NaN,146.57625140061603,185.3561886901419,0.03939967205977046,0.31830306609212045,0.27890339403235,53057562,51152002,82.37030267600372,65.02343319105637,NaN,NaN,38.77919572742932,31.731563023513477
2006-11-21T09:30:00-05:00,23.7,23.7,23.58,23.63,1431600,2193250,74.66183535333845,67.07568172717434,NaN,NaN,126.4714873893007,167.90392189134133,0.032854089807777265,0.31997100629207154,0.28711691648429427,51625962,51838222,83.21305623833442,66.76046634519643,NaN,NaN,40.19397453461179,32.94047895367038
2006-11-22T09:30:00-05:00,23.77,23.81,23.64,23.81,1068100,2180105,77.88485240874702,68.76438717022344,NaN,NaN,130.1962843395391,153.86294246151482,0.03589876935008052,0.3319903781718949,0.2960916088218144,52694062,52394322,83.88533773114187,68.76362608770276,NaN,NaN,42.43136904353892,34.29632039508017
2006-11-24T09:30:00-05:00,23.67,23.83,23.55,23.75999,423500,2092785,75.0293174693613,70.24912583188784,NaN,NaN,105.70125274573887,135.35719481053007,0.030034310646476936,0.33363449712991056,0.3036001864834336,52270562,52541142,84.06676414375478,70.83631177793416,NaN,NaN,43.55026349140092,35.618312265983135
2006-11-27T09:30:00-05:00,23.60001,23.69,23.14999,23.2,3231700,2136745,52.02700849454421,69.61581948777999,NaN,NaN,29.774384834005872,107.7439321418401,-0.013720985158182375,0.28644895503570567,0.30016994019388804,49038862,51737402,78.83426264561064,72.66184596303411,NaN,NaN,36.55013705956732,35.75143009363802
2006-11-28T09:30:00-05:00,23.13,23.33,23.05,23.32001,2940100,2159925,55.19707690331382,69.02724777858724,NaN,NaN,2.543090621263803,78.93729998596964,-0.03550451438534491,0.2557892972122069,0.2912938115975518,51978962,51521682,77.44105514353241,74.48299398591782,NaN,NaN,32.022646388065766,35.2187467071277
2006-11-29T09:30:00-05:00,23.47,23.55,23.36,23.47,3165400,2177040,58.85642257981773,68.66993591342329,NaN,NaN,46.09259463665206,62.86152143543994,-0.04038046185656613,0.24081823427684412,0.28119869613341025,55144362,52225362,78.75970879157214,76.08053554496666,NaN,NaN,29.551889932813047,34.409195739368464
2006-11-30T09:30:00-05:00,23.46001,23.62,23.37,23.52,1715200,2097200,60.028457043677285,68.4244800998516,NaN,NaN,50.10589458703237,46.84344348493859,-0.040692552378315816,0.2303330056605155,0.2710255580388313,56859562,53058462,80.23290760485935,77.51647396676567,NaN,NaN,27.98453865800894,33.49138758488853
2006-12-01T09:30:00-05:00,23.39999,23.52,23.11,23.32001,2899400,2101965,53.46771563151285,67.61026582788966,NaN,NaN,-0.34824024048796065,25.633544887693212,-0.05398877669953661,0.20353958716441056,0.2575283638639472,53960162,53396382,80.81418390509751,78.67986842279934,NaN,NaN,24.438105822200104,32.198061618790184
2006-12-04T09:30:00-05:00,23.36,23.7,23.36,23.62,1417000,2076970,60.450380937391856,66.99101135354726,NaN,NaN,58.09626304772584,31.297920530437203,-0.042695587593444995,0.20415887937214094,0.24685446696558594,55377162,54664042,82.85142083527757,79.69962220804862,NaN,NaN,23.765220190997066,30.99336998624831
2006-12-05T09:30:00-05:00,23.55,23.72,23.55,23.63,1159100,2059200,60.662292087756434,66.16681525701114,NaN,NaN,74.18267623415322,45.62583765301508,-0.03499141061119446,0.20311520370159286,0.23810661431278732,56536262,55575502,84.15426691343423,80.59448929559913,NaN,NaN,23.320633681314266,29.897264799829163
2006-12-06T09:30:00-05:00,23.64,23.71001,23.46001,23.48,974500,1943600,55.829980571413834,64.93665420633792,NaN,NaN,41.96963625423313,44.8012459765313,-0.040071696293415365,0.18801699394601812,0.22808869023943348,55561762,55658982,84.27212638447205,81.34356897764698,NaN,NaN,21.372088080117976,28.67938241129899
2006-12-07T09:30:00-05:00,23.53999,23.64999,23.35001,23.39,1563100,1872385,53.0969671967596,63.40336651930663,NaN,NaN,2.8135911310998947,35.3427852853448,-0.04897832719670864,0.16686578124354767,0.2158441084402563,53998662,55086802,79.88622399952405,81.51514276660633,NaN,NaN,18.914452900631684,27.28439248120366
2006-12-08T09:30:00-05:00,23.36,23.53,23.25,23.39,815200,1757915,53.0969671967596,61.82262044076594,NaN,NaN,-37.572657232127504,27.897901887016893,-0.053961115587917025,0.14839271395536002,0.20235382954327705,53998662,55094502,79.90138346571011,81.47735717702325,NaN,NaN,16.968680451890318,25.810719334158897
2006-12-11T09:30:00-05:00,23.38,23.64,23.25,23.53,962100,1725575,56.90302968217009,60.513735968325996,NaN,NaN,-11.874093023963058,13.903830672679115,-0.04716584827676787,0.14339651919731722,0.1905623674740851,54960762,55011222,79.20606555744615,81.25134023998342,NaN,NaN,16.426253921175864,24.470081418018463
2006-12-12T09:30:00-05:00,23.49001,23.57001,23.3,23.45,2998500,1773130,54.19661829671795,59.05193474999596,NaN,NaN,-39.93654376964348,-8.920013328080225,-0.047276928502329174,0.1314662068461736,0.17874313534850278,51962262,54096422,71.81334338422148,80.43707503611822,NaN,NaN,15.174613072300009,23.142157368630112
2006-12-13T09:30:00-05:00,23.64,23.64,23.33,23.49001,1397700,1721345,55.34063974553731,57.441633845480986,NaN,NaN,-15.083335820950484,-20.33060774311695,-0.043944439038783256,0.1238125865500237,0.16775702558880695,53359962,53656062,68.49900680990751,79.33805139888717,NaN,NaN,14.465768458685845,21.902673238638073
2006-12-14T09:30:00-05:00,23.49001,23.74001,23.39999,23.69,1324500,1701635,60.63347220200513,56.41335918352697,NaN,NaN,57.890757782122265,-9.315174412912452,-0.028318573288329263,0.13235880897839536,0.16067738226672462,54684462,53793222,68.97923566770848,78.26037079345531,NaN,NaN,15.422782499390895,20.976974561602763
2006-12-15T09:30:00-05:00,23.67999,23.7,23.55,23.56,1845800,1712780,55.98839020071078,56.69631501968173,NaN,NaN,51.85342938448418,8.570042910409887,-0.026801238273081618,0.1271758344253726,0.15397707269845423,52838662,53561222,67.1154677973725,77.42331401858114,NaN,NaN,14.841583219952376,20.100490084224138
2006-12-18T09:30:00-05:00,23.61,23.72861,23.36,23.47,2075100,1740480,52.96329015003188,56.53675882301873,NaN,NaN,2.2674942409984937,11.398360363402196,-0.03159260620771645,0.11448631493880868,0.14607892114652513,50763562,52721782,60.722407732530186,76.22912491779527,NaN,NaN,13.448809303625604,19.15024997271006
2006-12-19T09:30:00-05:00,23.27,23.44,23.17999,23.32001,1489200,1744840,48.28135207894473,55.78139664438494,NaN,NaN,-115.44332948991591,-3.7029967806522928,-0.04384339121930031,0.09127468212239975,0.13511807334170006,49274362,52184202,56.97922662708617,74.67337619176055,NaN,NaN,10.807560915607477,17.958437250266833
2006-12-20T09:30:00-05:00,23.42,23.52,23.31,23.33,1274900,1737005,48.607219310986245,54.96559394919273,NaN,NaN,-63.859133506075565,-13.458156317677311,-0.04981791013328159,0.07284568567509808,0.12266359580837967,50549262,51622062,53.28054790959743,72.74820764209899,NaN,NaN,8.77258978043491,16.64617332600513
2006-12-21T09:30:00-05:00,23.34,23.37,23.14999,23.22,1823300,1774765,45.228025958876366,54.37704468686155,NaN,NaN,-139.82671164848324,-53.00165020379842,-0.05908932928202827,0.04880193420584433,0.1078912634878726,48725962,50430362,46.40369472688424,70.2903155579409,NaN,NaN,6.027533289036119,15.129224749295272
2006-12-22T09:30:00-05:00,23.23,23.24001,23.02,23.03999,1405400,1823860,40.29157183331964,52.93712975085639,NaN,NaN,-197.30327301847723,-102.8329906843907,-0.07427435662418189,0.015048317707645253,0.08932267433182714,47320562,49326742,41.11165239878734,67.30890352676303,NaN,NaN,2.069125144906483,13.263496234382588
2006-12-26T09:30:00-05:00,22.98,23.17,22.98,23.17,894100,1706980,44.9637670720049,51.81580653544557,NaN,NaN,-165.01021133880488,-136.28853180035136,-0.0724158563713347,-0.0011971461323412314,0.07121871023899347,48214662,48816962,38.90456646783954,64.07678206636342,NaN,NaN,0.10208339834520126,11.383294400662962
2006-12-27T09:30:00-05:00,23.19,23.37,23.17999,23.34,906900,1605320,50.42629384652915,51.42982891223952,NaN,NaN,-68.62157629597891,-126.92418116156398,-0.05725511010326058,-0.00035017739008225135,0.05690493271317833,49121562,48786402,38.77019485384621,60.826644099890146,NaN,NaN,0.11148154040465362,9.77303542062606
2006-12-28T09:30:00-05:00,23.34,23.37,23.25,23.33,1005800,1497340,50.111217648414595,51.216561087357725,NaN,NaN,-52.08650192362284,-124.56965484507343,-0.04590820862122574,-0.00048032806335385203,0.04542788055787189,48115762,48299702,36.60197105734683,57.73491174687749,NaN,NaN,0.026291007939475156,8.380643361670835
2006-12-29T09:30:00-05:00,23.32001,23.49001,23.25,23.25999,1065100,1464835,47.85673759853519,50.842258973198845,NaN,NaN,-38.94230473970382,-104.39277346331755,-0.04127163840215773,-0.0061616674448252695,0.03510997095733246,47050662,47964642,35.14479167608859,54.538012333333086,NaN,NaN,-0.6968933881205696,7.08385239741492
2007-01-03T09:30:00-05:00,23.36,23.66,23.10001,23.33,4745102,1557120.1,50.26634612710851,50.3682101478373,NaN,NaN,-24.83413016994958,-69.89894489361203,-0.03205421479038638,-0.0049577975306505095,0.027096417259735866,51795764,48859682.4,41.80928277509934,51.86681356316546,NaN,NaN,-0.6148295157915812,5.984040695528277
2007-01-04T09:30:00-05:00,23.32001,23.75,23.27,23.69,2883000,1630420.1,60.40008393947188,50.81131483660543,NaN,NaN,85.38563641558324,-19.819775342734385,-0.001869251224855959,0.024759853228665918,0.026629104453521877,54678764,50152502.8,49.82893753591008,50.29649885971464,NaN,NaN,2.8342957584779045,5.534077133092509
2007-01-05T09:30:00-05:00,23.52,23.53999,23.35001,23.5,1649100,1654920.1,54.131038226765675,50.724914728121746,NaN,NaN,35.35884157320515,0.9763082311024235,0.0047799598084859105,0.03260405421412926,0.027824094405643353,53029664,50934123.2,53.960156149431576,49.25800952682351,NaN,NaN,3.687891560277897,5.270336336976136
2007-01-08T09:30:00-05:00,23.5,23.64999,23.42,23.57001,1779300,1695160.1,55.94549000081612,50.39005885660824,NaN,NaN,83.33888200087773,28.06138501600255,0.012911190762220155,0.043963082858418545,0.03105189209619839,54808964,52272763.6,60.03041539859693,48.618808079029826,NaN,NaN,4.9603852544077665,5.226057610894941
2007-01-09T09:30:00-05:00,23.53,23.67,23.41,23.60001,3469000,1790455.1,56.735270440235816,50.443407445145745,NaN,NaN,84.69499608511947,52.7888451809672,0.018962298582987827,0.054754765324933174,0.03579246674194535,58277964,54518224,67.7190019398762,48.66191766063724,NaN,NaN,6.220045250790123,5.3680558451656815
2007-01-10T09:30:00-05:00,23.52,23.75999,23.46001,23.72,2659300,1882660.1,59.836646617728555,50.93436147855265,NaN,NaN,115.87929916271847,80.93153104750083,0.029092149104548083,0.07215765312263045,0.043065504018082366,60937264,56346524,72.37805696662382,49.49446403450107,NaN,NaN,8.246939716904157,5.77932496969975
2007-01-11T09:30:00-05:00,23.86,24,23.78,23.96001,3620200,2015565.1,65.20891170608346,52.14347288049113,NaN,NaN,208.735309026173,105.60146556961877,0.04884054214831395,0.10411618170347481,0.055275639555160856,64557464,58322264,76.35036050861031,50.87811645460994,NaN,NaN,11.82783589722553,6.64339795934629
2007-01-12T09:30:00-05:00,23.98,24.06,23.84,24.02,3149500,2023115.1,66.4180274563144,53.41567346230028,NaN,NaN,192.42160823067235,137.01401890111222,0.06198263459139776,0.13275393279440806,0.0707712982030103,67706964,61257724,80.77423576471186,52.841951301403824,NaN,NaN,15.103940563305828,7.8520469027690805
2007-01-16T09:30:00-05:00,23.89999,24.05,23.89,23.97,1556800,2031070.1,64.40883681633233,54.785731380689995,NaN,NaN,159.89209475324284,152.32466145158523,0.0631345197958063,0.14968944794776817,0.08655492815196188,66150164,63525964,83.36381709510904,55.481960041991314,NaN,NaN,17.18074484963922,9.184718038036243
2007-01-17T09:30:00-05:00,23.87,23.92,23.62,23.66,1513000,2040495.1,53.5855485266402,55.7353011444986,NaN,NaN,76.30676754829389,150.64701574422014,0.0399743027321052,0.13652280656709337,0.09654850383498817,64637164,64797804,84.6151353519595,58.58935168150361,NaN,NaN,15.560753909703658,10.095580305417302
2007-01-18T09:30:00-05:00,23.53,23.62,23.32001,23.39,4830398,2189725,46.28956820886175,55.830001225702674,NaN,NaN,-15.43581967249079,124.38399197717827,0.005251424850175185,0.10311278489770714,0.09786136004753196,59806766,64571704.4,83.4139643086944,61.76859438442182,NaN,NaN,11.598663640845396,10.310306496192744
2007-01-19T09:30:00-05:00,23.25,23.39999,23.23,23.38,2370700,2204505,46.03954065374998,55.51666171193273,NaN,NaN,-46.59020678234188,73.31888881547528,-0.018317850658141815,0.07496404672485468,0.0932818973829965,57436066,63147424.8,76.08664098580518,64.43405482241887,NaN,NaN,8.464076454032542,10.046559347312716
2007-01-22T09:30:00-05:00,23.35001,23.39,23.09,23.21001,3399900,2300040,41.89674870409396,54.92991393019554,NaN,NaN,-78.40846978479368,19.152873212382076,-0.0438291618585559,0.038495445059801625,0.08232460691835752,54036166,60413265.2,64.39279974951201,66.41911401471638,NaN,NaN,4.4465131431740375,9.246552746721475
2007-01-23T09:30:00-05:00,23.14999,23.36,23.12,23.21001,1470800,2309835,41.89674870409396,54.50420043773545,NaN,NaN,-73.71896107058618,-27.56933795238374,-0.05827209812076033,0.009484484267407112,0.06775658238816744,54036166,57990465.6,56.15658294617279,67.91995624829384,NaN,NaN,1.2899926716189083,8.109901307421108
2007-01-24T09:30:00-05:00,23.3,23.63,23.28,23.63,4381500,2437745,53.80705075827936,54.75710791139051,NaN,NaN,9.90868576782053,-40.84895430847841,-0.03808487429142836,0.020150489523881987,0.058235363815310345,58417666,56746566,52.44749021990617,68.67982820863719,NaN,NaN,2.3295032059083525,7.284130150062143
2007-01-25T09:30:00-05:00,23.72,23.82001,23.34,23.34,1451400,2440045,46.690143866274376,53.777826477590686,NaN,NaN,-0.8154047061777224,-37.9248713152158,-0.04247348464696773,0.005143508006600683,0.04761699265356841,56966266,56178466,50.79730816358452,68.74899753918535,NaN,NaN,0.6871754382108164,6.341708048369097
2007-01-26T09:30:00-05:00,23.42999,23.50999,23.25999,23.35001,4290301,2609855.05,46.95096952317832,53.26496442733445,NaN,NaN,-53.07130022026423,-39.22109000280026,-0.042792950564932104,-0.005874195552596717,0.03691875501233539,61256567,56942566.2,52.94193351848452,68.67626735126056,NaN,NaN,-0.4761802286806289,5.367724008790565
2007-01-29T09:30:00-05:00,23.39,23.53999,23.35001,23.45,2340500,2681535.05,49.60344178718766,52.81196098350385,NaN,NaN,-29.514210390953057,-29.442238124032134,-0.03470536146976576,-0.006462946824871807,0.028242414644893948,63597067,58854746.4,57.88873056783753,68.52328986334918,NaN,NaN,-0.5744552682209927,4.518841254931771
2007-01-30T09:30:00-05:00,23.42999,23.59,23.42999,23.59,2498100,2756150.05,53.136601963471506,52.554913235163546,NaN,NaN,1.0130914469198289,-14.495827620530932,-0.019139912680259993,0.004317523794568956,0.02345743647482895,66095167,61266546.6,63.15036210600395,68.19695844664402,NaN,NaN,0.46712389861671094,3.940024489743905
2007-01-31T09:30:00-05:00,23.55,23.78999,23.41,23.73,1723400,2789065.05,56.42640942107131,52.311324863973745,NaN,NaN,38.719665999578076,-8.73363157417942,0.0003401708818155068,0.023882650077098333,0.023542479195282826,67818567,63146726.8,66.64881623170893,67.78772696557867,NaN,NaN,2.3831493550778693,3.7176137562201856
2007-02-01T09:30:00-05:00,23.75999,23.81,23.56,23.63,1507200,2627169.95,53.535495381051554,51.477509412185746,NaN,NaN,42.48359196259945,-0.07383224042398809,0.0059356788761353516,0.030962077790452014,0.025026398914316662,66311367,65015747,69.72573332688782,67.31453930974136,NaN,NaN,3.081865157692545,3.6267925278590942
2007-02-02T09:30:00-05:00,23.71001,23.75,23.63,23.75,1521600,2559099.95,56.420839097405974,50.76342452940657,NaN,NaN,54.762803164693956,21.49298843656765,0.016561635545378213,0.04572844334603943,0.029166807800661214,67832967,66331027,71.70414330268208,66.6666755624535,NaN,NaN,4.55364576834377,3.7592001336426195
2007-02-05T09:30:00-05:00,23.60001,23.75,23.60001,23.69,1034500,2528369.95,54.59532013200729,50.06245905195478,NaN,NaN,38.33644496078171,35.0631195069146,0.018258622976249812,0.05199008652097348,0.033731463544723665,66798467,66971307,72.64143000991048,65.90079077065361,NaN,NaN,5.228047611566261,3.9690354876317113
2007-02-06T09:30:00-05:00,23.67999,23.74001,23.48,23.66,1695700,2524189.95,53.66044043304815,50.06780847384106,NaN,NaN,15.718140144067585,38.00412924634416,0.016143061405553466,0.0539102903016655,0.03776722889611203,65102767,66772827,71.84693829158473,64.98877669491256,NaN,NaN,5.51826061667947,4.1903533632099625
2007-02-07T09:30:00-05:00,23.8,23.86,23.67999,23.77,1570600,2429269.95,56.59533709127667,50.803934822584985,NaN,NaN,65.29883793938669,43.319963634305886,0.020646448847480348,0.06357528995546247,0.04292884110798212,66673367,66543787,70.88348794737168,64.09374266910379,NaN,NaN,6.604497168440194,4.535231049671424
2007-02-08T09:30:00-05:00,23.64999,23.83,23.64999,23.8,1370100,2364809.95,57.3879956040402,51.614538747605714,NaN,NaN,57.711677361154294,46.36558071401685,0.023909919750287487,0.07281624079584148,0.048906321045553994,68043467,66890207,71.50586399335177,63.76654431249998,NaN,NaN,7.726485517454656,4.991124545069028
2007-02-09T09:30:00-05:00,23.83,23.86,23.42,23.53999,1887400,2278169.95,49.03060874971815,52.12410017943602,NaN,NaN,7.6159186151589156,36.936203804109844,0.007662902222841196,0.05848494882410549,0.05082204660126429,66156067,66554827,69.9470236165399,64.16327458871626,NaN,NaN,6.288316461032258,5.176437675920918
2007-02-12T09:30:00-05:00,23.45,23.52,23.38,23.44,2596064,2250498.15,46.2416991717355,52.43445378426755,NaN,NaN,-49.08904673149056,19.451105465655385,-0.009766578706111036,0.0386138232186255,0.048380401924736534,63560003,65907134.2,66.9132130177076,64.9316053081116,NaN,NaN,4.24075743513318,5.042769070094098
2007-02-13T09:30:00-05:00,23.52,23.57001,23.45,23.53999,1531734,2249244.85,49.344665207027035,52.11571195917811,NaN,NaN,-9.22717326278236,14.462042784285398,-0.01423900617715615,0.030581644203291347,0.044820650380447496,65091737,65904928.2,66.90256955003372,65.96411097454929,NaN,NaN,3.411554777765774,4.809738456904338
2007-02-14T09:30:00-05:00,23.63,23.88,23.61,23.86,1018215,2224505.6,57.74991686945626,52.905695745119665,NaN,NaN,117.31512293836246,24.86529978408055,0.0037178644462417393,0.04946798093824967,0.04575011649200793,66109952,65792245.2,66.32224882472596,67.07303530748796,NaN,NaN,5.358779638797765,4.888172911460542
2007-02-15T09:30:00-05:00,23.89999,23.96001,23.82001,23.95,3063300,2136150.7,59.771639211997986,53.82145786574964,NaN,NaN,152.37339213523632,43.797642738896954,0.02010448113730453,0.07088071791363859,0.05077623677633406,69173252,66018202.2,66.94149114002082,68.07300370902627,NaN,NaN,7.591085341834261,5.274303258656787
2007-02-16T09:30:00-05:00,23.77,23.89999,23.74001,23.89999,2046300,2119930.7,58.107740223988436,54.428907754092556,NaN,NaN,113.06779677194058,64.88801837025328,0.02566694626956296,0.08285991961328776,0.0571929733437248,67126952,66212379.2,67.49462393350484,68.75913894943108,NaN,NaN,8.902835360219703,5.79266498745149
2007-02-20T09:30:00-05:00,23.78999,23.96001,23.71001,23.91,1321200,2015995.7,58.357618931910864,54.80183753755251,NaN,NaN,111.96136053520556,97.09809982359249,0.027925285309555348,0.09209957998066898,0.06417429467111363,68448152,67190009,70.19826493446004,69.26256058003509,NaN,NaN,10.035216145957074,6.398743724380859
2007-02-21T09:30:00-05:00,23.83,23.92,23.77,23.87,1164700,2000690.7,56.89713606203178,54.83546086904969,NaN,NaN,101.86073505548366,119.31568148724571,0.024739107520819953,0.09509817907213858,0.07035907155131862,67283452,67628352,71.3489556620589,69.59828482506008,NaN,NaN,10.57755498730922,6.995716761942053
2007-02-22T09:30:00-05:00,24.02,24.08,23.85001,24,3578600,1960545.7,60.36855372889317,55.32353646532409,NaN,NaN,144.1124304644801,124.67514299246923,0.029100054185011603,0.10673413928258313,0.07763408509757153,70862052,68578772,73.71844268362776,69.88347835054151,NaN,NaN,12.042968968695375,7.716752791478242
2007-02-23T09:30:00-05:00,23.94,23.9895,23.87,23.98,1007900,1938370.7,59.57362878750211,55.54873572890239,NaN,NaN,115.3797609008851,117.276416745599,0.028323809731469307,0.11303884726190816,0.08471503753043885,69854152,68714952,74.04960453704254,70.05101129585297,NaN,NaN,13.042379035893367,8.477556540680402
2007-02-26T09:30:00-05:00,23.89999,24.03999,23.78,23.92,987547,1773233,57.14264732652447,55.7306876713679,NaN,NaN,91.68461331071632,112.99978005335413,0.021751103181791714,0.1119039165076785,0.09015281332588679,68866605,69062882.6,74.91915608727005,70.21370601566437,NaN,NaN,13.245221998255365,9.158651606048254
2007-02-27T09:30:00-05:00,23.52,23.75,22.78,23,4721500,1892283,34.13890673793138,54.336292407431,NaN,NaN,-237.25948461412042,43.15561102348894,-0.04304292742252784,0.036349154047726984,0.07939208147025482,64145105,68202273.2,68.77996117162053,69.99463622138121,NaN,NaN,4.338009421653052,8.46998843684894
2007-02-28T09:30:00-05:00,23,23.27,22.87,23.05,3617700,1948263,35.65497903440155,52.84055254622564,NaN,NaN,-236.35435416858687,-24.487406821325163,-0.07893110841705914,-0.019271804051069097,0.05965930436599004,67762805,68298143.8,69.08388690699756,69.86609328992593,NaN,NaN,-1.7108506829914734,7.015582848300309
2007-03-01T09:30:00-05:00,22.73,23.2,22.39,23.07001,3683536,2046269.8,36.28707106447848,51.33334365054265,NaN,NaN,-228.8181007605229,-99.07351306632577,-0.09655433690109017,-0.061033616760372666,0.0355207201407175,71446341,68415001.6,69.4739737074694,69.72095826950576,NaN,NaN,-6.08753368747065,5.143709057475887
2007-03-02T09:30:00-05:00,22.89999,23.03,22.64,22.64,2612900,2101554.8,29.565551056076288,49.94298238671109,NaN,NaN,-201.14150883312564,-162.3777670131279,-0.13030476645082328,-0.1273602379228116,0.002944528528011678,68833441,68210859.4,67.86306979168018,69.57210442487292,NaN,NaN,-12.579514488746712,2.611819979444087
2007-03-05T09:30:00-05:00,22.46001,22.92,22.46001,22.69,1406800,2095814.8,31.162233261510167,48.865877678837855,NaN,NaN,-173.19667520939353,-215.35402471714988,-0.14146405217599622,-0.1738855366919836,-0.03242148451598738,70240241,68485586.6,68.90791253427595,69.71458296177066,NaN,NaN,-16.98262184842729,-0.1873859959661095
2007-03-06T09:30:00-05:00,22.87,23.03999,22.75,23.03999,2177000,2152939.8,41.20876700680224,48.28474209310751,NaN,NaN,-104.99184817694719,-188.90049742971524,-0.11841157225875792,-0.18043594983943478,-0.06202437758067686,72417241,70140013.8,74.32213541809637,70.24455195234655,NaN,NaN,-17.19649646464206,-2.6172589200626737
2007-03-07T09:30:00-05:00,22.91,22.96001,22.75,22.75,1541900,2145249.8,36.46060609600743,46.76407703786117,NaN,NaN,-108.9647471456896,-163.42257602513578,-0.11569641408322595,-0.2066448951847093,-0.09094848110148335,70875341,70762521,76.01458189584582,70.93686145742655,NaN,NaN,-19.10027886246188,-4.971976054691131
2007-03-08T09:30:00-05:00,22.94,23.07001,22.85001,22.94,2775000,2205469.8,41.237965290683775,45.440243186338726,NaN,NaN,-76.89761100319491,-133.03847807367018,-0.09497509226763282,-0.20966734643602436,-0.11469225416839154,73650341,71203321,77.1624385556653,71.66692912997259,NaN,NaN,-18.91419498471333,-6.963721616122874
2007-03-09T09:30:00-05:00,23.09,23.11,22.81,23,1132300,2193579.8,42.703036610426814,44.339907213941466,NaN,NaN,-65.74083467122671,-105.95834324129041,-0.07213393069927279,-0.20485966754248253,-0.13272573684320974,74782641,72393161,79.95147649218262,72.55670431273528,NaN,NaN,-18.27863523394261,-8.580137847239978
2007-03-12T09:30:00-04:00,22.91,23.17,22.91,23.14,1593400,2178879.8,46.08107539620126,43.46301124710506,NaN,NaN,-45.482136590162774,-80.41543551744425,-0.043891645149974706,-0.1875902932806781,-0.1436986481307034,76376041,73620321,82.34612632786703,73.42440869797863,NaN,NaN,-16.65418271499987,-9.733572828348533
2007-03-13T09:30:00-04:00,23.03999,23.10001,22.7,22.77,1657100,2131931.6,39.45973961136622,42.21748292920038,NaN,NaN,-71.05719909366532,-73.62850570078787,-0.046191517612585664,-0.20143804514643548,-0.15524652753384982,74718941,74080661,83.15876192706659,74.26796628833632,NaN,NaN,-17.479220695937943,-10.840093952289877
2007-03-14T09:30:00-04:00,22.77,22.99001,22.59,22.98,2899700,2200329.9,44.347500329393355,41.07312197209325,NaN,NaN,-65.3947023662214,-64.91449674489422,-0.03039453507581813,-0.19323969637862248,-0.16284516130280435,77618641,75429321,85.29448317478086,75.0948263234187,NaN,NaN,-16.48520019772698,-11.646537701638033
2007-03-15T09:30:00-04:00,22.98,23.02,22.85001,22.99001,2243700,2261604.15,44.57719642293544,40.00194823176706,NaN,NaN,-46.89681585540213,-58.91433771533567,-0.016776517640909455,-0.18381580835394118,-0.16703929071303172,79862341,76671721,86.93783102122337,76.01541392943162,NaN,NaN,-15.643820143481706,-12.217578050472843
2007-03-16T09:30:00-04:00,22.88,23.05251,22.85001,22.95,2905225,2253700.4,43.799065041156524,39.04883521138363,NaN,NaN,-43.57074834813162,-54.48032045071666,-0.008392034761839973,-0.17752933416533168,-0.1691372994034917,76957116,77106616,87.46585258741666,76.91160653658494,NaN,NaN,-15.200688369318893,-12.64373666745085
2007-03-19T09:30:00-04:00,23.07001,23.34,23.03,23.10001,870500,2194910.4,47.499398015069055,40.00315601689346,NaN,NaN,-4.9310068349258005,-46.370094499669264,0.008418401224213529,-0.15861429787322479,-0.16703269909743831,77827616,77396931,87.81981725381675,78.27159625674183,NaN,NaN,-13.712175041102407,-12.796370720829644
2007-03-20T09:30:00-04:00,23.14999,23.28999,23.09,23.25,1291300,2193415.4,50.97508675138164,41.09744942524919,NaN,NaN,12.37684004041711,-29.683286672852766,0.029608366955032633,-0.13002224040364752,-0.15963060735868015,79118916,78276926,88.84787639811393,79.68330979182156,NaN,NaN,-11.399377654441821,-12.596800282774241
2007-03-21T09:30:00-04:00,23.28999,23.72,23.19,23.72,858350,2178097.9,59.92755300511681,42.78605527815193,NaN,NaN,91.40114970203409,1.6758837407983236,0.07278733120675829,-0.06864644335023229,-0.14143377455699058,79977266,78748651,89.36602383089023,81.10417051492304,NaN,NaN,-6.193665867358744,-11.682066794857741
2007-03-22T09:30:00-04:00,23.61,23.64999,23.42,23.63,1724200,2085377.9,57.75271169147778,44.79942389496632,NaN,NaN,111.18720481760118,33.29268787539898,0.09158127228869004,-0.026957184196128026,-0.11853845648481806,78253066,78426796,86.41586558909022,82.42937021473804,NaN,NaN,-2.717094256495595,-10.401356432234577
2007-03-23T09:30:00-04:00,23.55,23.67999,23.50999,23.57001,1370100,2103487.9,56.286402498243945,46.59400741187587,NaN,NaN,131.93634735159807,68.39410701534493,0.09581237966380421,0.0012270180949371934,-0.09458536156886702,76882966,78411966,86.27453990308146,83.66984359822415,NaN,NaN,-0.3610495919932663,-8.967026883628675
2007-03-26T09:30:00-04:00,23.57001,23.64,23.09,23.60001,958600,2102040.55,56.87605847029375,47.71309965926813,NaN,NaN,113.68495007956494,92.11729839824307,0.09621855913312294,0.025687837347536657,-0.07053072178558628,77841566,78414756,86.27908620620862,84.52391151166073,NaN,NaN,1.7195864753839853,-7.440367832341152
2007-03-27T09:30:00-04:00,23.53999,23.61,23.5,23.61,1764865,1954208.8,57.08366152097283,49.186175046765655,NaN,NaN,131.87285713166193,116.01650181649204,0.09270976228102841,0.04535648106569923,-0.04735328121532918,79606431,78512259,86.44802620599819,85.26915753381448,NaN,NaN,3.478165503861366,-5.880577355740792
2007-03-28T09:30:00-04:00,23.41,23.48,23.27,23.34,1987300,1872688.8,50.068143704006616,49.81690207628872,NaN,NaN,65.97448194180261,110.93116826444574,0.06885145905156073,0.038711042599121726,-0.030140416452439,77619131,78040632,81.23761518044623,85.56024157844169,NaN,NaN,3.039233419682231,-4.606318673537503
2007-03-29T09:30:00-04:00,23.39999,23.45779,23.12,23.37,2854000,1831212,50.79179214697203,50.394670328899096,NaN,NaN,47.88673220520897,98.2710737419673,0.052477543882377346,0.035456513400532685,-0.01702103048184466,80473131,78484645,82.31812080192908,85.72928760056644,NaN,NaN,2.881234801765282,-3.5366681770656765
2007-03-30T09:30:00-04:00,23.38,23.44,23.14999,23.32001,3817100,1891422,49.504314965360955,50.63918744098193,NaN,NaN,39.19262561282145,79.72232939421198,0.03642866397606949,0.028514799488242204,-0.007913864487827287,76656031,78439258,81.79954724600381,85.6902462375762,NaN,NaN,2.395667343947799,-2.6891916740637516
2007-04-02T09:30:00-04:00,23.39,23.49001,23.25,23.44,1573300,1899747,52.60947591116747,51.57845431953916,NaN,NaN,56.42845150819291,68.27102967993757,0.03218951688152025,0.03232303161407302,0.00013351473255277316,78229331,78516811,82.00811320992938,85.60805704349498,NaN,NaN,2.822515148562517,-1.901804985117142
2007-04-03T09:30:00-04:00,23.49001,23.73,23.39999,23.63,1990848,1890439.4,57.10733746607012,52.489871257873226,NaN,NaN,99.23257977046885,61.74297420769894,0.03996921284002661,0.050095030782586036,0.010125817942559427,80220179,78639560.6,82.3528144641468,85.39793784987826,NaN,NaN,4.49032197756324,-0.988643990448516
2007-04-04T09:30:00-04:00,23.61,23.77,23.60001,23.77,2291000,1927894.4,60.111486939111224,53.59946343760006,NaN,NaN,121.75317754894081,72.8987133291266,0.05159228115113519,0.07461616938147841,0.023023888230343223,82511179,79617970.2,84.84513319149693,85.24845943346922,NaN,NaN,6.80791632629464,0.1251503405147918
2007-04-05T09:30:00-04:00,23.8,23.87,23.52,23.86,659700,1822129.4,61.95617065417271,54.89639955281551,NaN,NaN,120.46504211729027,87.41437531154284,0.0617065279116059,0.1001570481198506,0.0384505202082447,83170879,80157519.8,86.01786068550287,85.14503144047538,NaN,NaN,9.301559720312712,1.4360659662002089
2007-04-09T09:30:00-04:00,23.86,23.94,23.8,23.86,767735,1803901.15,61.9561706541727,55.929026169894335,NaN,NaN,136.77912350524625,106.93167489002781,0.06446063762403956,0.11902631723829415,0.0545656796142546,83170879,81460489.4,88.36032700084216,85.18363927954863,NaN,NaN,11.3456683105648,2.851723443966579
2007-04-10T09:30:00-04:00,23.84,23.89999,23.75999,23.84,1942124,1821337.35,61.226427816225424,56.661264817383184,NaN,NaN,115.38614629474108,118.72321384733743,0.06103390893369058,0.13085806578136783,0.06982415684767725,81228755,82060374.2,89.25302436366783,85.21257841994533,NaN,NaN,12.873504562071195,4.283406460838667
2007-04-11T09:30:00-04:00,23.89999,23.89999,23.5901,23.62,2096043,1843284.5,53.72961948670219,56.21855528035356,NaN,NaN,75.00815933106576,113.8783297594568,0.04101014386768001,0.12108683668227727,0.08007669281459726,79132712,81842880.8,86.65803711639653,85.0191507974815,NaN,NaN,12.19447415702487,5.413558988865267
2007-04-12T09:30:00-04:00,23.64999,23.87,23.53999,23.87,770777,1736838.35,59.75942946851872,56.36189226442792,NaN,NaN,84.55992721780387,106.43967969322944,0.04153418837282426,0.13199442828062757,0.09046023990780332,79903489,81321342.8,80.60596588149255,84.60415796122452,NaN,NaN,13.370062413429618,6.550202335231603
2007-04-13T09:30:00-04:00,23.72,23.89,23.59,23.89,1113179,1680312.3,60.206206224769154,56.641878244894016,NaN,NaN,88.6227879010273,100.07122884997683,0.040137003066177235,0.14063149374052486,0.10049449067434763,81016668,80890500.6,75.89075605073884,83.8624591146286,NaN,NaN,14.4543036033137,7.679359659243331
2007-04-16T09:30:00-04:00,23.91,24.09,23.89999,24.09,1321636,1601132.85,64.45608363555282,57.183308613841085,NaN,NaN,160.95226574062963,104.90585729705349,0.04900457003472743,0.1617502032177569,0.11274563318302948,82338304,80723985.6,74.08692759933763,82.99159064270926,NaN,NaN,16.696700201704942,8.967551165309276
2007-04-17T09:30:00-04:00,24.03999,24.14,23.9716,24.14,1372838,1626249.75,65.44951951538326,57.780869899156116,NaN,NaN,159.07147707216632,113.64292345253855,0.054156691454263106,0.18044149750085836,0.12628480604659525,83711142,81220463,75.92437426599179,82.23990121842307,NaN,NaN,18.83788554207374,10.377598933418485
2007-04-18T09:30:00-04:00,23.89999,24.14999,23.89999,24.08,1066392,1615004.35,63.16793189971124,58.71656905599216,NaN,NaN,130.43737258062987,124.72876610245137,0.04956658379098511,0.18824303578532664,0.13867645199434153,82644750,81922870.6,78.27181036132339,82.02805801705715,NaN,NaN,19.991959736832268,11.751079048191881
2007-04-19T09:30:00-04:00,23.89,24.14999,23.86,24.09,1779516,1661062.65,63.396956073066626,59.61693790785606,NaN,NaN,112.75004150766678,130.36678896042395,0.04346512090193447,0.1930078531217596,0.14954273221982514,84424266,82827026,80.85895338143939,81.92383177273645,NaN,NaN,21.007562297775344,13.073433798132376
2007-04-20T09:30:00-04:00,24.25999,24.33,24.14,24.23,986578,1624181.55,66.53433779092077,60.83336810968176,NaN,NaN,154.18062478280024,143.47835633677855,0.044933449097691924,0.20570954359194005,0.16077609449424812,85410844,83705861.2,82.9802400880844,82.00816697574221,NaN,NaN,22.78963190041674,14.461462098458714
2007-04-23T09:30:00-04:00,24.2,24.27,24.11,24.17999,1606800,1636016.55,64.41050479604354,61.67629874431576,NaN,NaN,123.5370225981228,135.99530770827718,0.038840996782270404,0.20932734047208612,0.17048634368981572,83804044,83999009.2,83.63186411117671,82.12414918297418,NaN,NaN,23.71854682497793,15.783902773675745
2007-04-24T09:30:00-04:00,24.37,24.39999,24.14999,24.31,2851905,1730681.8,67.33012638445692,62.406497952771964,NaN,NaN,133.80734905269242,130.9424821043824,0.03972889948884195,0.22014746805086816,0.1804185685620262,86655949,84587970.6,84.8840363645748,82.30495074729046,NaN,NaN,25.36176097273919,17.152168230684808
2007-04-25T09:30:00-04:00,24.33,24.52,24.28,24.49001,1713371,1728107.1,70.8908540493138,63.17645274635786,NaN,NaN,148.2981003393409,134.51462765612462,0.04804574115679766,0.24047574500802327,0.1924300038512256,88369320,85732884.6,86.9707174245138,82.45677819250594,NaN,NaN,27.896682948372657,18.687098904640216
2007-04-26T09:30:00-04:00,24.47,24.67,24.41,24.63,719138,1664699,73.32568927022857,63.98856121893328,NaN,NaN,158.64645649752416,143.6939106540961,0.057919426391387197,0.2648292868404596,0.2069098604490724,89088458,86665723,88.37839900865761,82.62538807273128,NaN,NaN,30.836664287334937,20.422751102168032
2007-04-27T09:30:00-04:00,24.50999,24.7,24.50999,24.61,904856,1567241.8,72.3940227543512,64.73412208323174,NaN,NaN,148.63963521834356,142.58571274120476,0.05790911799415216,0.2792962579417626,0.22138713994761045,88183602,87220274.6,89.13023694212856,82.68038163996603,NaN,NaN,32.96701173494233,22.214788335421503
2007-04-30T09:30:00-04:00,24.59,24.71001,24.42,24.42,925705,1422672.05,64.06602837271718,64.93695069440972,NaN,NaN,118.5319575566157,141.58469973290332,0.04072326481376537,0.27229122096481717,0.2315679561510518,87257897,87911045.2,89.99822163409183,82.73361001642489,NaN,NaN,32.370099692791804,23.66554710076012
2007-05-01T09:30:00-04:00,24.49001,24.53999,24.34,24.53999,3100036,1499008.85,66.6734107068653,65.86150721013566,NaN,NaN,97.88607908302518,134.4004457389699,0.033363044779743195,0.2732717621257308,0.2399087173459876,90357933,88651442,90.84231958008496,83.03248733525977,NaN,NaN,32.6393879575595,24.947524366017173
2007-05-02T09:30:00-04:00,24.58,24.78,24.56,24.67,1329993,1465966.1,69.27482902889633,66.54117860730548,NaN,NaN,128.22095649658667,130.38501697041903,0.03311058800783481,0.2812969523557811,0.2481863643479463,91687926,89315163.2,91.53222677713083,83.81293454209107,NaN,NaN,33.65907023169139,26.192030918256346
2007-05-03T09:30:00-04:00,24.8,24.92999,24.7,24.91,1068515,1404841.85,73.4022880525409,67.48375588071775,NaN,NaN,148.6676189764088,128.38924946619596,0.0442702128651673,0.3035241304294054,0.2592539175642381,92756441,90048759.8,92.22906913346895,84.97995690514323,NaN,NaN,35.90984389240236,27.58028991456292
2007-05-04T09:30:00-04:00,25,25.03,24.87,25.00999,2949700,1519341.85,74.91426543572925,68.23076886644465,NaN,NaN,153.05478137700675,129.27227869792858,0.052961691542341094,0.32545603199216444,0.27249434044982335,95706141,91553267.6,93.4242472075787,86.36119402001759,NaN,NaN,38.243865898798745,29.103657912310894
2007-05-07T09:30:00-04:00,24.95,25.03999,24.92999,24.98,635257,1512717.95,73.56353652102496,68.81034150970477,NaN,NaN,135.7015203310656,132.70619125281857,0.05123483198438922,0.33653788043030985,0.28530304844592064,95070884,93115865,94.38941923653785,87.68012580362802,NaN,NaN,39.70999405835352,30.618848790316985
2007-05-08T09:30:00-04:00,24.89999,25.09,24.88,25.08,1927600,1511991.75,75.17110430066631,69.66771096691583,NaN,NaN,125.93809341190183,138.3165941185939,0.05124736826277093,0.3493622587743843,0.2981148905116134,96998484,94443975.2,95.0539154136339,88.87884759307879,NaN,NaN,41.43089929669379,32.1634274340851
2007-05-09T09:30:00-04:00,24.95,25.17999,24.89999,25.05,5624801,1688429.65,73.7227546196736,70.40526800595919,NaN,NaN,120.0946513120753,136.69133308169165,0.043936367566393686,0.3530353499696055,0.3090989824032118,91373683,94381126.6,94.48363632504967,89.85203923190808,NaN,NaN,42.423563975011206,33.62916122564597
2007-05-10T09:30:00-04:00,25.03999,25.16,24.83,24.92,2383200,1769050.8,67.64086631579394,70.48430575773584,NaN,NaN,97.07649079324202,126.37310744505828,0.02593646426122259,0.34151956272974004,0.31558309846851745,88990483,93627935,87.69348709074313,90.188699732098,NaN,NaN,41.4982550111093,34.75331748071216
2007-05-11T09:30:00-04:00,24.87,25.19,24.87,25.19,2538199,1840301.8,72.6816341750944,71.07510071338234,NaN,NaN,109.55246211337372,117.67264359233168,0.02764849963260868,0.3501437230092783,0.32249522337666964,91528682,92792443.2,80.76016575137389,89.98357842068351,NaN,NaN,42.228022209668076,35.82113244199158
2007-05-14T09:30:00-04:00,25.25999,25.25999,24.98,25.07001,704000,1809420,67.63894057766007,71.0971588700397,NaN,NaN,102.68617703788334,111.06957493369524,0.01667458132394617,0.34333845003160235,0.3266638687076562,90824682,91943202.8,74.32742274985537,89.22953459106068,NaN,NaN,41.226473217297446,36.59332398132099
2007-05-15T09:30:00-04:00,25.10001,25.25999,24.97,25.03,3432100,1912383.1,65.99473776800392,70.74743627851758,NaN,NaN,89.46798748696179,103.77555374870721,0.003390755956052316,0.3309023136527216,0.3275115576966693,87392582,90022022.4,62.24799055761272,87.4636255291392,NaN,NaN,39.91477835545119,37.067817463339594
2007-05-16T09:30:00-04:00,25.07001,25.25,24.9599,25.25,591300,1888628.5,70.27369832338279,70.52943692517144,NaN,NaN,93.89649427089341,98.53592234047085,0.005940988220559551,0.3349377929723687,0.32899680475180915,87983882,89344062.2,58.62709061504553,85.33853207245261,NaN,NaN,40.093357959819244,37.50003753426526
2007-05-17T09:30:00-04:00,25.25,25.28999,25.12,25.17999,510400,1825172.7,67.36852996243002,70.17047315431994,NaN,NaN,95.51617620448592,98.22385942271963,-0.00023928773462877917,0.3286976950835232,0.328936982818152,87473482,89040662,57.02834880837938,83.04554006289911,NaN,NaN,39.33531779349128,37.76222042844041
2007-05-18T09:30:00-04:00,25.27,25.32001,25.12,25.31,1413200,1846503.8,69.86035737030548,70.58435379700481,NaN,NaN,100.52696099163198,96.41875919837128,0.0011976576760736601,0.33043405491324407,0.3292363972371704,88886682,88512262,54.25349966993676,80.49234563688802,NaN,NaN,39.45823786262345,38.0045086333237
2007-05-21T09:30:00-04:00,25.37,25.55,25.28999,25.42,2847648,1908546.2,71.8210382644493,70.95204147968938,NaN,NaN,133.84179036519174,102.64988186383296,0.006053881658855231,0.3368037493107394,0.3307498676518842,91734330,88694191.6,55.06421090374529,77.93676644572089,NaN,NaN,40.16379617352809,38.31297828192433
2007-05-22T09:30:00-04:00,25.14999,25.55,25.14999,25.39,1934751,1862688.5,70.47451406974575,71.03773326832149,NaN,NaN,115.8127958986846,107.91884354617753,0.0038504009671253003,0.3355628688607908,0.3317124678936655,89799579,89175591,57.22439772317486,75.48620722758119,NaN,NaN,40.338945868267714,38.60240222283053
2007-05-23T09:30:00-04:00,25.46001,25.52,25.28,25.3,3864146,1970227.25,66.44956348616383,70.54111008500884,NaN,NaN,113.0437144674253,111.7482875854839,-0.006500291418159665,0.3235871036209659,0.33008739503912554,85935433,88765901.2,54.80955151243399,72.81338454036441,NaN,NaN,39.306057819965794,38.70292445099271
2007-05-24T09:30:00-04:00,25.24001,25.39,24.89,24.98,4835230,2176031.85,54.52559029698247,69.08477614652693,NaN,NaN,24.873687921673767,97.61978992892148,-0.036078145055748134,0.2849897137194404,0.3210678587751885,81100203,87491245.4,48.01983873299047,69.57021250646525,NaN,NaN,34.39531811999494,38.08755211799303
2007-05-25T09:30:00-04:00,25.03,25.21001,24.98,25.19,1972800,2229429.05,59.64353904232056,68.09049061233375,NaN,NaN,32.66105926098236,84.04660958279155,-0.04225109969770069,0.2682539841530627,0.31050508385076336,83073003,86328509.6,42.810118671546896,65.88597675182304,NaN,NaN,31.864019926952775,37.19847609070156
2007-05-29T09:30:00-04:00,25.17,25.39,25.14999,25.34,2370800,2301683.8,62.85897180160303,67.21105257668638,NaN,NaN,89.33962217791951,75.1461759453371,-0.03716348162110111,0.264050731824387,0.3012142134454881,85443803,85070404.2,38.00548152005697,61.81108861656754,NaN,NaN,30.8348886824222,36.28939217523308
2007-05-30T09:30:00-04:00,25.14999,25.56,25.07001,25.53,2252800,2259322,66.49995574837465,66.69513837159361,NaN,NaN,120.63161167492524,76.10993910058524,-0.02264724641980631,0.27290515542073024,0.29555240184053655,87696603,84649809,36.529470795661815,57.67150536446841,NaN,NaN,31.194867698793594,35.56160296431315
2007-05-31T09:30:00-04:00,25.63,25.7,25.56,25.64999,2170783,2301361.5,68.59385421910352,66.76320893611572,NaN,NaN,199.7846172254841,93.458119652197,-0.007398558691831092,0.2863042034757477,0.2937027621675788,89867386,85436199.6,41.1328324762697,54.34574432057745,NaN,NaN,32.181469057357695,35.07872669189094
2007-06-01T09:30:00-04:00,25.77,25.83,25.59,25.64999,2067900,2351330.75,68.59385421910352,66.47122465354494,NaN,NaN,185.96037982018353,125.67545803189896,-0.00013076398770572872,0.29353930718294663,0.29367007117065236,89867386,87189636.2,49.86428726198203,52.138895857049455,NaN,NaN,32.951649143450666,34.77485847068519
2007-06-04T09:30:00-04:00,25.57001,25.75,25.56,25.74001,1417534,2274722.45,70.21375819661105,66.65514019775573,NaN,NaN,155.8060755512744,150.30446128995737,0.007498935911257665,0.3030437410597244,0.29554480514846676,91284920,88832019.6,56.389225851505,50.85759607859586,NaN,NaN,34.084764574870604,34.67627362842596
2007-06-05T09:30:00-04:00,25.61,25.69,25.49001,25.64999,1376101,2311764.65,66.51884683354274,66.69257655957993,NaN,NaN,113.68190094717893,155.17291704380926,0.003448685713334343,0.2998556622901347,0.2964069765768004,89908819,89725022.8,59.477320096051635,50.65969104562721,NaN,NaN,33.94060557359443,34.571178192021456
2007-06-06T09:30:00-04:00,25.53999,25.57001,25.35001,25.35001,2049000,2317834.65,55.95220499659413,65.66961275052361,NaN,NaN,43.93140545549067,139.83287579992233,-0.021117027066480443,0.2700106927436998,0.29112771981018026,87859819,89757666,59.589964695199484,50.72846776563822,NaN,NaN,30.370518055160005,33.97108388675554
2007-06-07T09:30:00-04:00,25.31,25.46001,24.92999,24.99001,2473755,2160282.35,46.42184044942308,64.17342064245169,NaN,NaN,-63.32701543048719,87.21054926872809,-0.061035865291344416,0.21483288819599977,0.2758687534873442,85386064,88861401.6,55.06402972357929,50.588159259581076,NaN,NaN,23.72402260844727,32.507217989854354
2007-06-08T09:30:00-04:00,24.95,25.42999,24.95,25.34,1676700,2124957.35,54.530519607701386,63.0784322308371,NaN,NaN,-29.364862369183438,44.14550083085469,-0.06303611742601423,0.19707360670482643,0.26010972413084066,87062764,88300477.2,52.38254900422419,50.45451992631588,NaN,NaN,20.95338221700797,30.856670022304872
2007-06-11T09:30:00-04:00,25.32001,25.47,25.27,25.39,1122600,2054177.4,55.565149683974816,61.91729733223178,NaN,NaN,18.489027978370274,16.682091316273862,-0.060165866788430916,0.184902390645302,0.24506825743373292,88185364,87680566,49.512861865837884,50.057994995036786,NaN,NaN,19.204338920684968,29.19205129350203
2007-06-12T09:30:00-04:00,25.21001,25.39,25.07001,25.09,1436046,2090779.7,48.44270010619779,60.34359633483549,NaN,NaN,-62.929368790713795,-18.640162631304683,-0.0765923948072669,0.1493277639246493,0.2259201587319162,86749318,87048665.8,46.70415060934896,49.30654877262065,NaN,NaN,15.164455640770738,27.188109057397558
2007-06-13T09:30:00-04:00,25.2,25.41,25.10001,25.41,1553600,1996854.7,55.05990109084523,59.53004902088417,NaN,NaN,-17.518141965760062,-30.93007211555483,-0.06451114297716123,0.14528123001046467,0.2097923729876259,88302918,87137285.6,47.15688597808688,48.75992980588156,NaN,NaN,14.17085759629828,25.328501705811945
2007-06-14T09:30:00-04:00,25.39,25.67,25.39,25.64999,849620,2009770.7,59.28085545854349,59.86971081813853,NaN,NaN,90.58651992140199,-0.1473650451769913,-0.04015410354740895,0.1595997435533647,0.19975384710077365,89152538,87890580.4,50.96960918719479,48.9706276954676,NaN,NaN,14.902460152339724,23.839067198173055
2007-06-15T09:30:00-04:00,25.78,25.88,25.73,25.78,867800,2027640.7,61.396171702112596,59.99489886526653,NaN,NaN,161.02851369488167,37.93131016763603,-0.016306821869074506,0.17937031976443052,0.19567714163350503,90020338,88482095.2,53.789136394415564,49.75484324710107,NaN,NaN,16.215492694618355,22.74998512623667
2007-06-18T09:30:00-04:00,25.94,25.94,25.72,25.85001,658171,1989889.25,62.525147403756264,59.97105426542033,NaN,NaN,148.7199919258135,63.97750295712467,0.0021789463314872692,0.19840082454786412,0.19622187821637685,90678509,88980724.2,56.08185885785992,51.04601305694414,NaN,NaN,17.617550201507864,22.0167801369897
2007-06-19T09:30:00-04:00,25.7,25.89,25.69,25.84,1308351,1912924.4,62.24485176537845,59.66711826663489,NaN,NaN,116.54324461508918,99.87202563828528,0.011223511520467327,0.210251267616961,0.19902775609649367,89370158,89504892.2,58.4174467126533,52.60943990815782,NaN,NaN,18.63199304554107,21.533239123925608
2007-06-20T09:30:00-04:00,25.95,25.95,25.549,25.69,1111897,1871781.7,58.045592139149505,58.9136709752096,NaN,NaN,81.1020476284658,119.59606355713045,0.004916967104768799,0.20517396497745466,0.20025699787268586,88258261,89495960.8,58.360495241642845,53.83998724854161,NaN,NaN,18.216111655057734,21.059363771230196
2007-06-21T09:30:00-04:00,25.53,25.83,25.48,25.82001,1572815,1757215.15,60.53098884230138,58.33775201972373,NaN,NaN,67.56250857367422,114.99126128758489,0.007177621351564356,0.20922902456214132,0.20205140321057696,89831076,89631668.4,59.01432366208823,54.49356127712063,NaN,NaN,18.61637774218257,20.710365767080535
2007-06-22T09:30:00-04:00,25.55,25.78999,25.4301,25.53,1897000,1610303.65,52.98992944280245,57.107478537308836,NaN,NaN,24.74659492645655,87.73487753389986,-0.012131531893014413,0.18688698834430895,0.19901852023732336,87934076,89214416,56.09768559557739,54.4727369731258,NaN,NaN,16.584488780084953,20.120954768938308
2007-06-25T09:30:00-04:00,25.53999,25.713,25.31,25.44,1461618,1584744.55,50.871830809067916,55.98983453556063,NaN,NaN,-12.766600962880448,55.43755895616107,-0.03115618372131851,0.1600732905856752,0.19122947430699372,86472458,88373205.8,50.661508541682394,53.84303614781371,NaN,NaN,14.27286654423144,19.285513593980184
2007-06-26T09:30:00-04:00,25.59,25.59,25.28,25.35001,2082952,1570352.15,48.7725769177317,55.477003958499026,NaN,NaN,-44.80561417635456,23.167787197872332,-0.04893356246643932,0.13006252122394457,0.1789960836903839,84389506,87377075.4,45.089401312663036,52.807281620489675,NaN,NaN,11.732110498112062,18.206456008856165
2007-06-27T09:30:00-04:00,25.28,25.67,25.22,25.60001,4079695,1661696.9,54.40199935691592,56.04701530903423,NaN,NaN,-14.469812943938255,4.053415083391524,-0.04318835802869908,0.12501063615451002,0.1681989941832091,88469201,87419263.4,45.36348410578344,52.114385504932834,NaN,NaN,11.225896992415633,17.209233292221803
2007-06-28T09:30:00-04:00,25.61,25.83,25.61,25.69,1701800,1638247.75,56.26506740647781,56.1709115803754,NaN,NaN,63.4210039239477,3.2251141534462264,-0.03311385665364397,0.12680667336615414,0.1599205300197981,90171001,87487248.4,45.832698836785475,51.646539064401495,NaN,NaN,11.372697953515342,16.375442529549453
2007-06-29T09:30:00-04:00,25.78,25.85001,25.4301,25.60001,1402363,1604970.9,53.893664669113406,56.05151979359959,NaN,NaN,34.29659871110556,5.135114910376034,-0.0322643877964465,0.11959004527424,0.1518544330706865,88768638,87654160.8,47.03533715352238,51.46957301352181,NaN,NaN,10.798376028510681,15.578718743686771
2007-07-02T09:30:00-04:00,25.67999,25.86,25.67999,25.82001,1677920,1617990.2,58.49877941096659,56.769811172511645,NaN,NaN,90.16261511912353,25.72095812677684,-0.01738514649100112,0.1301229999569351,0.14750814644793622,90446558,88448980.8,52.44934869138029,51.87994430509548,NaN,NaN,11.696246955618525,15.024079916819879
2007-07-03T09:30:00-04:00,25.89999,26.06,25.89,26,1556446,1627007.45,61.85554947733636,57.255214628689586,NaN,NaN,142.2700144852714,63.13608385910203,0.0029939695032996927,0.15125060832706083,0.14825663882376114,92003004,89971680.4,60.73093694795998,52.84951937437212,NaN,NaN,13.505415109668132,14.807127801512486
2007-07-05T09:30:00-04:00,26.03999,26.83,25.97,26.10001,3360135,1692564.2,63.616491408313706,57.56490291081603,NaN,NaN,206.06159629494226,107.24236570687813,0.020641032852727503,0.1740579298896705,0.153416897036943,95363139,91350468,66.43193946730008,53.95397153723679,NaN,NaN,15.541748804683722,14.912073659108376
2007-07-06T09:30:00-04:00,26.14,26.25,26.07001,26.14999,2729711,1705362,64.49854967591875,57.786501337516434,NaN,NaN,147.4646611534594,124.05109715278047,0.03241076750191882,0.19393035641434153,0.1615195889124227,98092850,92934837.8,71.5442238002659,55.22219206622611,NaN,NaN,17.472210219927305,15.27780745351108
2007-07-09T09:30:00-04:00,26.2,26.31,26.12,26.3,1010476,1672050.8,67.07833259762948,58.111728851364525,NaN,NaN,155.66356086165584,148.32448958289052,0.04618952766222176,0.2192564984901999,0.17306697082797814,99103326,95001775.4,76.55965467778783,56.684891767649525,NaN,NaN,19.905293584013634,15.938876900725731
2007-07-10T09:30:00-04:00,26.05,26.23,25.95,26,2134192,1722630.4,58.000999497295815,57.80859654650148,NaN,NaN,92.28356408261183,148.7486793755882,0.03168133854436539,0.21266864400843488,0.1809873054640695,96969134,96306290.6,79.0673175995673,58.159882545286244,NaN,NaN,19.305695602256353,16.41985100094439
2007-07-11T09:30:00-04:00,25.96001,26.2,25.88,26.14999,1091362,1705396.2,60.853309959432494,58.00914781937883,NaN,NaN,88.38867069398484,137.9724106173309,0.02884908323772964,0.21704865951123153,0.1881995762735019,98060496,97517789,81.09053595875775,59.783456882223014,NaN,NaN,19.685265086626007,16.886338727470335
2007-07-12T09:30:00-04:00,26.21001,26.66,26.19,26.59,1287825,1692107.45,67.7687512231131,58.526130846579676,NaN,NaN,176.86830278962668,132.13375191626776,0.051926194510919926,0.2531073194121518,0.20118112490123188,99348321,98314825.4,82.30244790540654,61.446894328174324,NaN,NaN,22.412473421350615,17.675786540881802
2007-07-13T09:30:00-04:00,26.63,26.99001,26.5428,26.64999,1678500,1733551.45,68.58360959820821,59.63996514339437,NaN,NaN,195.20364257811096,141.68154820119807,0.06566271559757747,0.2832595193982037,0.21759680380062624,101026821,98901619.6,83.15824635910425,63.3797915255691,NaN,NaN,24.821510323151102,18.69660422406313
2007-07-16T09:30:00-04:00,26.62,26.78999,26.55,26.73,1393520,1759837.45,69.68444066825006,60.98372299047882,NaN,NaN,154.58042177358467,141.46492038358386,0.07395261559731678,0.3100375732972722,0.23608495769995544,102420341,99565022.6,84.09468000820678,65.76787520174942,NaN,NaN,27.114164876031694,19.899112888630068
2007-07-17T09:30:00-04:00,26.72,26.92999,26.7,26.82001,1313600,1792608.9,70.91898074279318,62.565608977983196,NaN,NaN,152.12119522864768,153.432446612791,0.07886373243011302,0.3346646232375967,0.2558008908074837,103733941,100917984,85.82563569509105,68.6776062290657,NaN,NaN,29.37771091162677,21.25319832048674
2007-07-18T09:30:00-04:00,26.62,26.7,26.38,26.67999,1534900,1803936.35,66.3897481605439,63.421876749670915,NaN,NaN,96.933610029928,155.14143447997967,0.06653992096548922,0.33897579201434525,0.272435871048856,102199041,101745693,86.77394664212038,71.63549641023262,NaN,NaN,29.939859434406728,22.494149908189595
2007-07-19T09:30:00-04:00,26.92,27.02,26.81,26.89999,3010331,1898858.05,69.66757877317211,64.37919899014908,NaN,NaN,133.55505897117186,146.47878571628868,0.06688360228931167,0.3560403739104956,0.2891567716211839,105209372,102917903.2,87.99854475333579,74.64734254712907,NaN,NaN,31.441230162757872,23.772304230270777
2007-07-20T09:30:00-04:00,26.82001,26.86,26.56,26.8,1573220,1898878.3,66.49353624574297,65.27918981705119,NaN,NaN,94.32048093589766,126.30215338784603,0.05457555083612187,0.35737621016633625,0.3028006593302144,103636152,103439769.4,88.50866454588179,77.60972307515475,NaN,NaN,31.729111559500573,24.90899099158932
2007-07-23T09:30:00-04:00,26.83,26.94,26.75,26.84,1102699,1859163.25,67.13853234227255,65.89631502643019,NaN,NaN,99.3619647694071,115.25846198701052,0.04379229281633917,0.35754102535063836,0.3137487325342992,104738851,103903471.4,88.95778113620233,80.2174682497849,NaN,NaN,32.14985233791479,25.9433997553501
2007-07-24T09:30:00-04:00,26.55,26.8499,26.39,26.57001,1737919,1872978.3,58.89723191498862,65.68500662911963,NaN,NaN,55.796148405998785,95.99345262248073,0.014647372883912047,0.33205794863918925,0.3174105757552772,103000932,103756869.6,87.78958276232032,82.15022866509635,NaN,NaN,30.00621456304912,26.523801870735674
2007-07-25T09:30:00-04:00,26.57001,26.8,26.05,26.60001,4027579,1970209.65,59.49223665590332,65.39041700394746,NaN,NaN,29.976788803193617,82.60208837713387,-0.005367179505306463,0.3107016013736441,0.3160687808789506,107028511,104722763.6,88.83033565591042,83.75011410713994,NaN,NaN,28.43933080658894,26.797448861571855
2007-07-26T09:30:00-04:00,26.60001,26.60001,25.75,26.2,2972350,1914842.4,49.25400049254753,64.30152063370666,NaN,NaN,-32.97582668067328,49.29591124676482,-0.0460397992248035,0.2585190318479462,0.3045588310727497,104056161,104492121.4,86.92506733908479,84.84874578848417,NaN,NaN,23.62577831264238,26.344353068867644
2007-07-27T09:30:00-04:00,26.09,26.21001,25.64,25.64,2058420,1932673.4,39.10730556825548,62.303590131608516,NaN,NaN,-105.79089949110576,9.273635161364126,-0.10763362341849597,0.17001680179962975,0.2776504252181257,101997741,104164439.2,84.16311976895878,85.3918504378535,NaN,NaN,15.330369436608656,24.77092683568779
2007-07-30T09:30:00-04:00,25.75,25.91,25.57001,25.73,1605540,1942832.25,41.20369654124744,61.103782777605055,NaN,NaN,-127.77183411282391,-36.15312461508207,-0.1373848029410302,0.10591942154183798,0.24330422448286818,103603281,103937325.2,82.21332743255249,85.61656542592388,NaN,NaN,9.628329815569582,22.607698689956617
2007-07-31T09:30:00-04:00,26.10001,26.10001,25.42999,25.55,2736200,1995746.25,38.35928597627095,59.49706677880781,NaN,NaN,-133.7611517381918,-74.06458464392021,-0.1625356651609381,0.04013464303169556,0.20267030819263365,100867081,103510555,78.53164689128239,85.43378763538992,NaN,NaN,4.017451825844541,19.951949137940606
2007-08-01T09:30:00-04:00,25.57001,26.27,25.25999,25.8,9571055,2396476.7,44.12828291600225,57.808461899728464,NaN,NaN,-111.4100245188695,-102.34194730833283,-0.15567264076103707,0.008079507241337325,0.1637521480023744,110438136,104192480,80.06764177592687,85.27415862614137,NaN,NaN,1.258286458916704,17.281425898080048
2007-08-02T09:30:00-04:00,25.78,26.05,25.72,25.85001,5042898,2480614.85,45.2325065594548,56.140525968388935,NaN,NaN,-83.1545736684312,-112.37769670588443,-0.14151178866880293,-0.013137587833629283,0.12837420083517365,115481034,106477454.6,84.15776908822846,85.34555310679309,NaN,NaN,-0.5583391098406298,14.732888039805665
2007-08-03T09:30:00-04:00,25.91,25.96001,25.35001,25.35001,2657945,2477026.55,37.29606429236799,53.82707051296878,NaN,NaN,-125.9681710821334,-116.41315102408994,-0.15829695411289202,-0.06949699180594138,0.08879996230695064,112823089,108642524.2,86.9006296613435,85.54597808201713,NaN,NaN,-4.999200541244441,11.914018242512793
2007-08-06T09:30:00-04:00,25.52,25.75999,25.28999,25.75,2508222,2551913.85,45.52981756768519,52.01355885760393,NaN,NaN,-104.06425483518511,-111.67163516856219,-0.13580252767814915,-0.0809531972907358,0.05484933038741335,115331311,110988130.2,89.10203783081064,85.7800068059971,NaN,NaN,-5.820385650541215,9.380531972076506
2007-08-07T09:30:00-04:00,25.67999,25.95,25.38,25.8,3117366,2601072.55,46.4759620739568,50.591145565704856,NaN,NaN,-80.73222502944574,-101.06584982681298,-0.11189363175882719,-0.08501770931112063,0.026875922447706556,118448677,114504449.4,91.42777918237493,86.11242341601529,NaN,NaN,-6.129564385370723,7.164803921012616
2007-08-08T09:30:00-04:00,25.98,26.2,25.86,26.2,5285699,2810789.4,53.44314129586068,49.43225717446832,NaN,NaN,-24.07084919840419,-83.59801476271993,-0.06576030704435311,-0.05532446135773483,0.010435845686618275,123734376,117163697.4,92.69708830312753,86.44803366957184,NaN,NaN,-3.951277913335507,5.576792230391456
2007-08-09T09:30:00-04:00,25.84,26.39999,25.41,25.60001,3686684,2930732.35,44.1580407203277,47.836864636938664,NaN,NaN,-60.74123610926414,-79.11534725088651,-0.07178267063237877,-0.07929249260385518,-0.0075098219714764165,120047692,118077029,93.07628749504076,86.77429245165463,NaN,NaN,-5.480547046611763,3.997172333676711
2007-08-10T09:30:00-04:00,25.23,25.53999,24.92999,25.24001,4870391,3090326.9,39.701067805521035,45.877045741456406,NaN,NaN,-130.14735623093816,-79.95118428064748,-0.09470029860793688,-0.12588519523139752,-0.031184896623460637,115177301,118547871.4,93.2702865830406,87.08232855500022,NaN,NaN,-8.374255795528846,2.229825458075917
2007-08-13T09:30:00-04:00,25.60001,25.67999,25.42999,25.59,2660900,3153695.9,45.46409347749667,44.91753585306412,NaN,NaN,-75.98776058484023,-74.33588543057849,-0.08148042678754223,-0.13303543010788843,-0.051555003320346196,117838201,119049249.4,93.47979258331267,87.48877211364254,NaN,NaN,-8.580632441031085,0.6854743296320598
2007-08-14T09:30:00-04:00,25.61,25.64999,24.95,25.07001,1520700,3164050.9,39.433858375295415,43.484794547306414,NaN,NaN,-117.42849302307138,-81.67513902930362,-0.10163765851403002,-0.17860207646288373,-0.07696441794885371,116317501,118623014.2,90.88930566600615,87.63584140007795,NaN,NaN,-11.022480753836646,-0.9870906822920409
2007-08-15T09:30:00-04:00,25.05,25.25,24.63,24.75,3073550,3240983.4,36.247483892965896,42.55575764733629,NaN,NaN,-156.32518727475835,-108.12600664457446,-0.12866442753321283,-0.23779495236536974,-0.1091305248321569,113243951,116524929.2,79.2477959390372,87.08746487150312,NaN,NaN,-14.125390518014916,-2.86399065882388
2007-08-16T09:30:00-04:00,24.57001,24.67,23.89999,24.59,4039400,3292436.85,34.736183618846226,42.24353465094992,NaN,NaN,-215.93264798018805,-139.16428901875923,-0.1480753849068491,-0.2942247559657183,-0.1461493710588692,109204551,114356301,69.35894752918458,86.03002399723353,NaN,NaN,-17.052679003748395,-4.890946136670239
2007-08-17T09:30:00-04:00,25.22,25.23,24.57001,24.83,4007347,3414143.2,38.854443418627675,42.07573085647708,NaN,NaN,-128.36801159558624,-138.80842009168887,-0.13583078534139695,-0.31593785273561537,-0.18010706739421842,113211898,113963220.4,67.70968232611828,84.99404934677393,NaN,NaN,-18.020315385931198,-6.76657031513609
2007-08-20T09:30:00-04:00,25.03,25.08,24.78999,24.92,2193200,3468668.25,40.37391820200725,42.21963315831539,NaN,NaN,-107.52208839778827,-145.11528565427847,-0.11365004183614594,-0.32216961968940083,-0.2085195778532549,115405098,113476599.8,65.62913200130626,84.07244114034708,NaN,NaN,-18.297364373765298,-8.413826609225977
2007-08-21T09:30:00-04:00,24.84,25.21001,24.84,25,2856320,3524588.3,41.75935566350404,42.05042406885123,NaN,NaN,-82.02447004860294,-138.03448105938477,-0.08678341223480363,-0.3169988431467594,-0.2302154309119558,118261418,113865383.2,66.51442517281373,83.1043542401247,NaN,NaN,-18.097906482510744,-9.797266591123801
2007-08-22T09:30:00-04:00,25.33,25.39,25.19,25.33,1995200,3422969.35,47.20844292661133,42.19156238079098,NaN,NaN,-27.63847596933992,-112.2971387983011,-0.04223594022245894,-0.28301035619002946,-0.24077441596757052,120256618,115267916.6,69.5603963536013,82.06168475907991,NaN,NaN,-16.22755024825414,-10.715878542142422
2007-08-23T09:30:00-04:00,25.45,25.5,25.25999,25.39999,1906300,3369666.85,48.31299375818534,42.978485914063654,NaN,NaN,-6.841964208841542,-70.47900204403179,-0.005438677333837322,-0.24757276263486716,-0.24213408530102984,122162918,117859590,74.22594320401231,81.15635001212767,NaN,NaN,-14.383713379256486,-11.239854947444432
2007-08-24T09:30:00-04:00,25.39999,25.81,25.34,25.75999,2567400,3395115.85,53.68120590082749,43.56072793785953,NaN,NaN,42.642141214354815,-36.276971482043585,0.043092087826853365,-0.18826897551746313,-0.2313610633443165,124730318,120163274,77.5236806370897,80.32932449829048,NaN,NaN,-11.09745845501303,-11.219512591382802
2007-08-27T09:30:00-04:00,25.63,25.78,25.62,25.62,1468800,3388278.85,51.44372223921028,43.91556794966335,NaN,NaN,50.67411705571115,-4.637730391343695,0.0644267126759675,-0.15082767249935713,-0.21525438517532464,123261518,121734558,79.45460090155566,79.47409747823194,NaN,NaN,-9.03892942940588,-10.908000711100385
2007-08-28T09:30:00-04:00,25.52,25.53999,25.06,25.16,2799600,3391448.85,44.83124870842171,43.30043276484628,NaN,NaN,-26.542732898646,6.4586170386476836,0.04702779525753181,-0.15646964110340988,-0.2034974363609417,120461918,122174658,79.97354967230018,78.56527329031572,NaN,NaN,-9.258783064926087,-10.672398190218342
2007-08-29T09:30:00-04:00,25.25,25.78999,25.25,25.75999,3272200,3076506.1,53.26868370211718,43.95119297783125,NaN,NaN,44.32714781499097,20.851741795513867,0.07380242355257355,-0.11124440692022475,-0.1850468304727983,123734118,122870158,80.79895126886284,77.68832070273156,NaN,NaN,-6.59241125672883,-10.089542914005554
2007-08-30T09:30:00-04:00,25.60001,26.05,25.42,25.87,4312602,3039991.3,54.6385465376008,45.01815574440837,NaN,NaN,82.52715100367277,38.72556483801673,0.09542301468948328,-0.06576806211094421,-0.1611910768004275,128046720,124046918.4,82.14021203102898,76.89331537758787,NaN,NaN,-4.040856241758455,-9.225444817970255
2007-08-31T09:30:00-04:00,26.14999,26.14999,25.88,26.03999,4653602,3139774.15,56.74837612986908,45.82417593386354,NaN,NaN,119.18556474065254,54.03424954327627,0.11629006319545251,-0.01582849780611184,-0.13211856100156436,132700322,125640919.2,83.79182250050113,76.2013175145299,NaN,NaN,-1.2926822244530998,-8.092193018896376
2007-09-04T09:30:00-04:00,26.08,26.61011,26.03999,26.44,4444398,3236582.95,61.308795914365,47.38667147236851,NaN,NaN,159.36326359579195,75.77207885129243,0.1500052110693068,0.05538795283506914,-0.09461725823423765,137144720,128417559.6,86.18792806048413,75.86550482842118,NaN,NaN,2.5696071490949888,-6.569078709183324
2007-09-05T09:30:00-04:00,26.34,26.37,26.06,26.16,2463000,3203864.65,56.794591222993525,48.854321995941916,NaN,NaN,119.03960358256528,104.88854614753468,0.14626735316310024,0.08821693321963764,-0.05805041994346259,134681720,131261520,88.12441803992775,76.49954926419908,NaN,NaN,4.368608245745088,-5.0065520013364075
2007-09-06T09:30:00-04:00,26.25999,26.31,26.06799,26.28999,2288800,3054019.7,58.32861806828244,50.539495885187364,NaN,NaN,120.16220916465527,120.05555841746755,0.1450818526111133,0.12330189582042905,-0.021779956790684257,136970520,133908800.4,89.58780682355918,77.94446778522583,NaN,NaN,6.3016429842404795,-3.3910955748254237
2007-09-07T09:30:00-04:00,25.88,25.95,25.60001,25.75,4738000,3106585.5,50.33369782318224,51.359442628369834,NaN,NaN,48.07785522404951,113.16569926154288,0.10247103680555354,0.10630883921625767,0.0038378024107041282,132232520,134745960.4,90.00716651103366,79.5371452270055,NaN,NaN,5.431654738674076,-2.130702672896924
2007-09-10T09:30:00-04:00,25.92,26,25.56,25.7,3500300,3038080.95,49.65501857869006,52.022378369561466,NaN,NaN,41.78310150742651,97.6852066148977,0.06716583018971378,0.08779509014784637,0.020629259958132577,128732220,133952340,86.4524041353248,81.02452180800684,NaN,NaN,4.53358439516212,-1.1786616631742033
2007-09-11T09:30:00-04:00,25.86,26.16,25.85001,26.07001,2481200,3029095.95,54.5400039192717,52.93528181640202,NaN,NaN,77.91274296495381,81.39510248873006,0.06494136761751737,0.10180596948002929,0.03686460186251192,131213420,132766080,81.28474029952822,82.07954431705787,NaN,NaN,5.283530665341039,-0.2554913305291687
2007-09-12T09:30:00-04:00,26,26.22,25.94009,26,2787900,3092455.95,53.482576182984815,53.38343419185726,NaN,NaN,74.96431842139425,72.58004545649585,0.05533882158900909,0.10603812884877328,0.050699307259764195,128425520,131514840,76.11651439738893,82.5478384630427,NaN,NaN,5.5713221383673925,0.5769105935989114
2007-09-13T09:30:00-04:00,26.14,26.14999,25.97099,26,1835400,3030548.45,53.482576182984815,53.75269007934294,NaN,NaN,68.20183183065087,62.18796998969499,0.04595696339316783,0.10814551150122398,0.06218854810805615,128425520,129805840,69.60668587441856,82.21789151092885,NaN,NaN,5.803351022722827,1.3235449406166135
2007-09-14T09:30:00-04:00,25.78,25.99001,25.78,25.87,2896300,2973393.45,51.33901584175748,53.58539078940937,NaN,NaN,36.08746423344333,59.789891791573744,0.02880419905280969,0.09819379692406827,0.06938959787125858,125529220,128465180,64.91632906471298,81.31736639861622,NaN,NaN,5.404831210270397,1.9065858362814398
2007-09-17T09:30:00-04:00,25.86,25.98,25.75999,25.86,929250,2819488.6,51.16912392841737,53.56577662435273,NaN,NaN,27.44763803866823,56.922799097822086,0.015272426600849681,0.08848013112232067,0.07320770452147099,124599970,127638730,62.1367068521471,80.08037396651561,NaN,NaN,5.0298549021992445,2.3527671314125547
2007-09-18T09:30:00-04:00,26.08,26.38,25.64999,26.37,3394000,2879528.6,58.6792645742837,54.55492061477145,NaN,NaN,79.13137518593959,57.166525542019244,0.037869955822058515,0.12054514929904414,0.08267519347698563,127993970,126994840,59.98178758268018,78.65239096011419,NaN,NaN,6.863388641498523,2.997141632853407
2007-09-19T09:30:00-04:00,26.52,26.62,26.37,26.47,2072300,2840327.6,59.97900301865723,55.034229137381445,NaN,NaN,151.5113251508493,72.47592688791026,0.05567647611383533,0.15227078861927978,0.09659431250544445,130066270,127322990,60.7292635425575,77.21884183680666,NaN,NaN,8.763029440154085,3.8208398910392183
2007-09-20T09:30:00-04:00,26.42999,26.66,26.42999,26.57001,1853400,2833237.6,61.29040156860397,55.509361639595966,NaN,NaN,149.85960344914326,88.80748121160873,0.06942037783371743,0.18336978479759125,0.11394940696387382,131919670,128021820,62.34241742167773,75.80471365042443,NaN,NaN,10.728478740245384,4.807645440925813
2007-09-21T09:30:00-04:00,26.62,26.77,26.60001,26.72,3527000,2914272.6,63.2360847007439,55.97276939465845,NaN,NaN,166.22073080965566,114.8341345268512,0.08292881465408627,0.21761042528148167,0.1346816106273954,135446670,130005310,66.54323527869063,74.57267170600937,NaN,NaN,12.960762322272371,5.972376423975321
2007-09-24T09:30:00-04:00,26.77,26.97,26.64999,26.64999,6265500,3099177.6,61.677737105204784,55.9991223368613,NaN,NaN,157.79826001844998,140.90425892280754,0.08135263447413832,0.2363724037200683,0.15501976924592997,129181170,130921550,68.30226646909802,73.29512444948179,NaN,NaN,14.424846057521304,7.179872085910461
2007-09-25T09:30:00-04:00,26.66,27,26.60001,26.92,2966940,3174084.6,65.23596675235211,56.602077731815484,NaN,NaN,150.293475953876,155.13667907639484,0.09191819750690397,0.26991751612955994,0.17799931862265597,132148110,131752378,69.85022809045626,71.98982516737668,NaN,NaN,16.74325313493242,8.546069378627884
2007-09-26T09:30:00-04:00,27.36,27.36,26.95,27.09,3881800,3228194.6,67.29494370336904,57.24252956289309,NaN,NaN,182.19550282345483,161.27351461091592,0.10294820096413637,0.30668456982782644,0.20373636886369006,136029910,132945106,71.96673927916262,70.73117748563408,NaN,NaN,19.331051191786532,10.086781066221976
2007-09-27T09:30:00-04:00,27.17999,27.17999,27.02,27.07001,2703800,3199774.6,66.79397891702749,58.418263926739186,NaN,NaN,147.17532313551268,160.73665854818984,0.10133173795127909,0.3304010413027889,0.22906930335150982,133326110,133226394,72.45779382586166,69.47765086526465,NaN,NaN,21.3400478037337,11.694390600152222
2007-09-28T09:30:00-04:00,27.37,27.37,26.91,26.97,2653600,3116824.5,64.2182591528209,59.45849539631996,NaN,NaN,126.66671405805616,152.8258551978699,0.08653580743316974,0.337239062642972,0.25070325520980224,130672510,132271562,68.09719826778928,68.16656473186926,NaN,NaN,22.383490591149712,13.221404884580434
2007-10-01T09:30:00-04:00,27.17,27.37,27.02,27.25999,10141602,3391224.5,68.06388996892872,60.424487257009744,NaN,NaN,128.82804348786127,147.03181189175217,0.08894652541771186,0.36188641198194205,0.2729398865642302,140814112,134598150.4,72.44818874223735,67.53538247777705,NaN,NaN,24.418460041706236,14.820984192741262
2007-10-02T09:30:00-04:00,27.47,27.47,27.23,27.36,3556200,3346814.6,69.28973284209663,61.55356987551773,NaN,NaN,128.84852424874566,142.7428215507261,0.08968885661972825,0.3850509573388905,0.29536210071916225,144370312,137042590.8,76.13143087625804,67.53644794055342,NaN,NaN,26.487362194008973,16.487609621493792
2007-10-03T09:30:00-04:00,27.22,27.3,27,27.03999,2053700,3326349.6,61.19547710827948,62.10449137018164,NaN,NaN,84.66248983810371,123.23621895365588,0.06233744687710435,0.3732839093155427,0.3109464624384383,142316612,138299931.2,77.77708739517854,68.12004804917913,NaN,NaN,25.997589054064303,17.846178111861008
2007-10-04T09:30:00-04:00,27.17,27.17,26.97,27.11,5076500,3465734.6,62.234871135619976,62.88276674831468,NaN,NaN,72.90806448241962,108.38276722303726,0.043559316262521575,0.3653956077665903,0.32183629150406873,147393112,141113331.6,80.9431986696013,69.26482444952829,NaN,NaN,25.883035091357655,18.994300537503385
2007-10-05T09:30:00-04:00,27.23,27.47,27.21001,27.39999,1930700,3325369.6,66.265557729645,63.96108344840236,NaN,NaN,101.08976888839447,103.26737818910492,0.0450784607432847,0.37818436743317463,0.33310590668988993,149323812,144843592,84.16461040835428,70.83824613211452,NaN,NaN,26.968670609033325,20.13349626200766
2007-10-08T09:30:00-04:00,27.38,27.56,27.36,27.45,865100,3193609.6,66.92124348859721,64.5497962279962,NaN,NaN,106.56684359373558,98.8151382102798,0.043822202072866745,0.38788365928097335,0.3440614572081066,150188912,146718552,85.49212016259112,72.66041274496531,NaN,NaN,28.04828626599405,21.26418054829143
2007-10-09T09:30:00-04:00,27.64,27.71001,27.49001,27.64999,2707500,3204924.6,69.47627281496722,65.22817264201834,NaN,NaN,118.44279232715732,96.73399182596211,0.05036372318768606,0.4070161111927142,0.35665238800502813,152896412,148423772,86.59293851979338,74.50781810048215,NaN,NaN,29.732029757783373,22.473873292504567
2007-10-10T09:30:00-04:00,27.98,27.98,27.63,27.74001,1793671,3155213.15,70.5779028075601,65.89156558765805,NaN,NaN,130.16677635952286,105.83484913024594,0.05431700665489492,0.42454864632364675,0.37023163966875183,154690083,150898466.2,88.0142894116377,76.34152324262216,NaN,NaN,31.459181154024723,23.757488701293163
2007-10-11T09:30:00-04:00,27.86,28.00999,27.2606,27.44,4907000,3308793.15,62.48415785841581,65.83785652749177,NaN,NaN,93.07202168156576,109.86764057007515,0.03142619239106664,0.4095143801575851,0.3780881877665185,149783083,151376460.4,88.2728987190502,77.89364205979068,NaN,NaN,30.592809750987616,24.733963136963798
2007-10-12T09:30:00-04:00,27.50999,27.74001,27.47,27.71001,2187500,3273353.15,66.23692455495706,66.16351277390264,NaN,NaN,100.76947444609202,109.80358168161467,0.02921571011502544,0.4146078254103003,0.38539211529527484,151970583,151905814.6,88.56710041579832,79.3411301988407,NaN,NaN,30.977770008561727,25.625935547192075
2007-10-15T09:30:00-04:00,27.42,27.78,27.36,27.50999,5073500,3480565.65,61.341717614343665,65.88535212118775,NaN,NaN,82.63818499480585,105.01784996182873,0.01002033138057945,0.3979175295209991,0.3878971981404197,146897083,151247448.8,85.68785072013614,80.47238895810356,NaN,NaN,29.781261667033306,26.21955356431225
2007-10-16T09:30:00-04:00,27.44,27.60001,27.37151,27.50999,5602199,3590975.6,61.341717614343665,65.46012168625737,NaN,NaN,64.46724080836341,94.22273965806994,-0.0060726271750591865,0.3803064141715957,0.3863790413466549,146897083,150047583,80.54843103161731,81.08536694042175,NaN,NaN,28.82496226421666,26.591754807155738
2007-10-17T09:30:00-04:00,27.89999,27.89999,27.41,27.74001,6580801,3816400.65,64.81027084279307,65.31842825238348,NaN,NaN,96.42641319930043,87.47466702602546,-0.004684249609616942,0.38052372933463374,0.3852079789442507,153477884,149805143.2,79.51071997057105,81.58914737932956,NaN,NaN,29.009341849727242,26.937124384665953
2007-10-18T09:30:00-04:00,27.69,27.84,27.59,27.81,2397060,3843583.65,65.81533147076003,65.432504846522,NaN,NaN,102.90933049137537,89.44212878798737,-0.0026137546677569845,0.38194078560955447,0.38455454027731145,155874944,151023515.4,80.84619326794582,82.49978987934074,NaN,NaN,29.45079816871517,27.296220639530127
2007-10-19T09:30:00-04:00,27.81,27.82001,27.09,27.14999,3045900,3819528.65,51.01758880014376,64.2149119058945,NaN,NaN,1.9382504831978047,69.67588399540853,-0.046805197846649826,0.32604804296899914,0.37285324081564897,152829044,151195207.6,81.03379815473586,83.11304769451921,NaN,NaN,24.852239970802344,26.947080543997586
2007-10-22T09:30:00-04:00,26.95,27.35001,26.92,27.32001,3357100,3674108.65,53.89343306147178,63.11517620727843,NaN,NaN,-51.350860625151,42.878074871417205,-0.0645988851104346,0.2921046344276057,0.3567035195380403,156186144,153053019.8,82.97677174134922,83.6020006134543,NaN,NaN,22.056363274668165,26.2484066483791
2007-10-23T09:30:00-04:00,27.60001,27.72,27.38,27.62,6429898,3847256.55,58.52092543397844,62.924136801971216,NaN,NaN,54.37789952170428,40.860206614085385,-0.0564725801945426,0.286112794294862,0.3425853744894046,162616042,156196811.6,85.65487602497453,84.16469980129686,NaN,NaN,21.222642450038254,25.530440334330407
2007-10-24T09:30:00-04:00,27.75,27.75,26.862,27.34,5611301,3933731.6,53.15815999242831,62.27580029174324,NaN,NaN,-32.68055333852673,15.03881330651995,-0.06941101507001557,0.25582160565188516,0.32523262072190073,157004741,156902183,86.18021031436824,84.53877206163736,NaN,NaN,18.71010967910074,24.556107383583313
2007-10-25T09:30:00-04:00,27.52,27.59,27.13,27.57001,3138200,3955451.6,56.67078514061388,61.59045939252673,NaN,NaN,-0.39395742993384314,-5.6218442777418955,-0.06216831815156815,0.24752222303244054,0.3096905411840087,160142941,157755782.4,86.8097255046401,84.72770885422919,NaN,NaN,17.803170015614164,23.591402045302008
2007-10-26T09:30:00-04:00,27.75,28.21001,27.67999,27.94,2617101,3953626.65,61.65233758711645,61.21410897099239,NaN,NaN,168.19329302312428,27.6291642302434,-0.033581262185021776,0.26771396345273146,0.30129522563775324,162760042,159741982,88.16108292636052,84.9183490516413,NaN,NaN,18.73120493398712,22.897088172257025
2007-10-29T09:30:00-04:00,28.02,28.1075,27.91,28.02,2510700,3572081.55,62.652185097063324,60.72667413399925,NaN,NaN,167.82713300724365,71.46476295672232,-0.011544502028884351,0.28686459810164777,0.2984091001305321,165270742,161558901.6,89.24642529582731,85.10788382135802,NaN,NaN,19.786474877793346,22.4527148444765
2007-10-30T09:30:00-04:00,27.85001,28.17999,27.85001,28.07001,2733432,3530943.15,63.29643545505065,60.20656932310572,NaN,NaN,152.21733984017487,91.03265102041645,0.003343876749643926,0.302588946067587,0.2992450693179431,168004174,162636528,89.84128008332726,85.23838315505012,NaN,NaN,20.825939888799816,22.220318422236975
2007-10-31T09:30:00-04:00,28.45,28.52,28.11,28.39999,3877486,3622132.45,67.30415632448506,60.55085492782496,NaN,NaN,211.06853935119756,139.7824695583613,0.030830725117923896,0.33778347571534795,0.30695275059742405,171881660,165611911.8,91.27618750654582,85.45290378272838,NaN,NaN,23.015941666449326,22.33397888569588
2007-11-01T09:30:00-04:00,28.60001,28.60001,27.95,28.09,7202262,3728420.55,60.60885605771953,60.14885003516513,NaN,NaN,150.05799761320782,169.87286056698963,0.023861484368462305,0.33677960605800195,0.31291812168953964,164679398,166519203.2,91.66290015913006,85.67403233582351,NaN,NaN,22.73932310073657,22.391885202130265
2007-11-02T09:30:00-04:00,28.39,28.39,27.83,28.14999,5332820,3898526.55,61.40893131670613,60.153651013905304,NaN,NaN,108.89773236168931,158.01374843470265,0.01921804771129021,0.3369406813286524,0.3177226336173622,170012218,167969638.4,92.25404417185906,86.14304615380372,NaN,NaN,22.763564663460926,22.444982268034646
2007-11-05T09:30:00-05:00,28.03,28.23,26.75,28.11,4705078,4090525.45,60.526391604806136,60.09541344179548,NaN,NaN,-5.223634755133973,123.40359488222711,0.009851504776698605,0.3300370145882354,0.3201855098115368,165307140,167976918,92.25701160382057,86.97937333753251,NaN,NaN,22.525323280424328,22.456459555518887
2007-11-06T09:30:00-05:00,28.37,28.37,27.89,28.25999,3376997,4124000.3,62.69209587775523,59.944115230007064,NaN,NaN,106.9227751648843,114.34468194716901,0.010117246187244189,0.332832067545592,0.32271482135834784,168684137,168112910.6,92.31623215332753,87.89405277915797,NaN,NaN,22.949226719095613,22.526854864601276
2007-11-07T09:30:00-05:00,28.14999,28.16,27.5,27.5,5835383,4326085.9,48.24770477082665,58.68928475144039,NaN,NaN,-5.179390029771759,71.09509607097515,-0.04168947075825846,0.27060298291052476,0.3122924536687832,162848754,166306329.4,83.21136972321767,88.06299395453455,NaN,NaN,18.429143972262388,21.94146759426715
2007-11-08T09:30:00-05:00,26.71001,27.39999,26.27,26.52,14313320,4796401.9,36.55252883083212,57.656066182203844,NaN,NaN,-213.7668176666341,-1.6698669849932344,-0.1373639075611049,0.14058756921740212,0.277951476778507,148535434,163077536.6,69.93556698428716,87.27026315664534,NaN,NaN,9.407071313379934,20.150839554140404
2007-11-09T09:30:00-05:00,25.71001,26.40849,25.58,25.97,6401551,5007104.45,31.881710155435,56.08380026034407,NaN,NaN,-277.65944775442574,-78.98130300821626,-0.2277636936670652,-0.006753140305324479,0.22101055336174072,142133883,157501869.6,53.93344385527662,85.19573973621159,NaN,NaN,0.22432960061728055,17.304195275065673
2007-11-12T09:30:00-05:00,25.5,26.13,25.5,25.55,7263852,5116622.05,28.849968396777058,53.96444618625826,NaN,NaN,-241.46429141177805,-126.22943433954507,-0.30130310891092665,-0.1556183327769176,0.14568477613400904,134870031,151414447.8,42.499738093030494,82.11322988392988,NaN,NaN,-8.161417645264523,13.66625057216136
2007-11-13T09:30:00-05:00,26,26.55,25.88,26.42,4477969,5060410.55,41.30172400182129,53.1175579012149,NaN,NaN,-138.3457049435918,-175.28313036124027,-0.27740819561553376,-0.20107546838540813,0.0763327272301256,139348000,145547220.4,34.834543396578454,78.4456822469449,NaN,NaN,-10.178220089633172,10.259897620476426
2007-11-14T09:30:00-05:00,27,27,26.08,26.27,6078723,5035306.65,40.001876090178556,51.926921540469515,NaN,NaN,-102.80567141683267,-194.80838663865248,-0.2581576913500767,-0.24636438695747032,0.01179330439260641,133269277,139631325,29.12968384461506,74.32567927122882,NaN,NaN,-12.144584826267485,7.059257270941582
2007-11-15T09:30:00-05:00,25.99001,26.32001,25.85001,25.95,3870673,5108987.3,37.304572498705134,50.187795462725845,NaN,NaN,-125.07289957703921,-177.0696030207335,-0.2530879651814546,-0.30456665208421185,-0.05147868690275724,129398604,135803959,26.146299183935795,69.89605186105562,NaN,NaN,-14.659223361350271,3.9566171806141743
2007-11-16T09:30:00-05:00,25.89999,26.37,25.89999,26.32001,3484766,5130930.6,42.1610155045077,48.72414049182902,NaN,NaN,-94.89844524227208,-140.51740251830273,-0.21256057454178362,-0.31717940507998676,-0.10461883053820314,132883370,133953856.4,24.82285475601907,65.29436825106933,NaN,NaN,-14.947791119626942,1.2559874234368724
2007-11-19T09:30:00-05:00,26.31,26.32001,25.7719,25.8,4766160,5201383.6,37.73685341225224,46.89845606020056,NaN,NaN,-100.24243946684292,-112.27303212931572,-0.20824804813147524,-0.3649288907025472,-0.15668084257107195,128117210,132603292.2,23.872896120350447,60.582340825142424,NaN,NaN,-16.755695769286117,-1.3171101755235548
2007-11-20T09:30:00-05:00,26.28999,26.28999,25.5401,26.02,5255176,5142647.5,40.577808079925475,44.98943118558916,NaN,NaN,-89.16002725819759,-102.4358965922369,-0.17916001795451156,-0.3806308650142114,-0.20147084705969984,133372386,131408169.4,23.032888257601726,55.707819450217855,NaN,NaN,-17.207551603268648,-3.5871732366299964
2007-11-21T09:30:00-05:00,25.59,26.02,25.4328,25.53,6298703,5177017.6,36.57490954029092,43.272720720058544,NaN,NaN,-97.88310560231602,-101.45138342933356,-0.18097022399471954,-0.42768362705309926,-0.24671340305837972,127073683,130169050.6,22.16217391295558,50.743481861205396,NaN,NaN,-18.94911624527398,-5.781736523579137
2007-11-23T09:30:00-05:00,25.55,25.89999,25.55,25.78,882022,5064208.7,39.83591785489079,41.731791187071735,NaN,NaN,-82.78356559031027,-92.99351663198777,-0.15441441293362995,-0.43973141922541714,-0.2853170062917872,127955705,129880470.8,21.954022639747876,45.72205175176888,NaN,NaN,-19.266011122684116,-7.708061466308419
2007-11-26T09:30:00-05:00,26.08,26.08,25.19,25.24001,2815571,5074132.2,35.58057843175716,39.94994738899681,NaN,NaN,-91.04882447500883,-92.22359247853514,-0.16153480594914843,-0.4872355137282227,-0.3257007077790743,125140134,128331823.6,20.82371621386507,40.6196735096292,NaN,NaN,-20.96158785252978,-9.601422378625756
2007-11-27T09:30:00-05:00,25.60001,25.67,25.21001,25.52,3370423,5117118.35,39.20681207844677,38.27242711761763,NaN,NaN,-87.19324894992116,-89.61375437515078,-0.13669215002053614,-0.4965658953047445,-0.35987374528420835,128510557,128410493,21.046095192982307,35.52894944103311,NaN,NaN,-21.146444124490884,-11.25071119946363
2007-11-28T09:30:00-05:00,26.08,26.41,25.82001,26.27,4242262,5192559.85,47.699551545114474,38.23327331578105,NaN,NaN,-33.53365467779464,-78.48847985907018,-0.06281147808440413,-0.4383880928897135,-0.37557661480530935,132752819,128286579.6,20.946301501536283,31.08144456805587,NaN,NaN,-18.368342346738583,-12.267515649074337
2007-11-29T09:30:00-05:00,26.39,26.53,26.23,26.39999,4674688,5232419.95,49.02863577412897,39.12442381173082,NaN,NaN,-10.732820654254553,-61.0584228694579,-0.001492104323496446,-0.3774417452096799,-0.37594964088618343,137427507,130357344.4,27.16195797833332,28.026186781916312,NaN,NaN,-15.758205175680551,-12.766185581446653
2007-11-30T09:30:00-05:00,27.14,27.14,26.03,26.25999,3603738,5052493.75,47.62490447107736,40.248937691419556,NaN,NaN,5.658277535589765,-43.37005424427788,0.03151289794940332,-0.3365585184494293,-0.3680714163988326,133823769,131530957.2,30.49733560763731,26.35217904994207,NaN,NaN,-14.095931573685046,-12.956149294623566
2007-12-03T09:30:00-05:00,26.34,26.37,26.05,26.10001,2674627,4919584.1,46.00401914259566,41.4742270304066,NaN,NaN,-18.828037526731638,-28.925896854622444,0.0436939227649179,-0.31345401294268527,-0.35714793570760317,131149142,132732758.8,33.838403850993814,25.73351231836801,NaN,NaN,-13.21606517081829,-12.993280134079955
2007-12-04T09:30:00-05:00,26.09,26.22,25.8,26,1971400,4782900.2,44.97354357329741,41.73649985694061,NaN,NaN,-34.30771473720587,-18.348790012079384,0.04591189049939848,-0.2997580725833551,-0.34566996308275355,129177742,132866195.8,34.21652319077367,25.68936801795338,NaN,NaN,-12.788518074114569,-12.964028411227757
2007-12-05T09:30:00-05:00,26.44,26.64999,26.25819,26.60001,3866132,4807356.95,51.930387919556914,42.58853641618192,NaN,NaN,65.55351697019134,1.4686443175178128,0.0863379360784915,-0.23774754298463918,-0.3240854790631307,133043874,132924406.8,34.39267565269378,26.065296004244722,NaN,NaN,-10.270448390645607,-12.579231265430307
2007-12-06T09:30:00-05:00,26.78999,26.96001,26.55,26.87,2271902,4629182.9,54.7053769080371,43.8314510168485,NaN,NaN,149.00092919483697,33.41539428733612,0.12733497749319012,-0.164916757196643,-0.2922517346898331,135315776,132502060.6,33.68783139928486,26.603976876769654,NaN,NaN,-7.3123635526034,-11.82682159216932
2007-12-07T09:30:00-05:00,27.13,27.13,26.82001,26.89999,2797225,4053378.15,55.01602020892506,44.74966563859259,NaN,NaN,174.49782959056483,67.18330469833113,0.1509343138930933,-0.10358384232346651,-0.2545181562165598,138113001,133359907,36.532954778610836,27.44041259266906,NaN,NaN,-4.832015708706586,-10.827563608817501
2007-12-10T09:30:00-05:00,27.19,27.19,26.89,27.03,2524647,3859532.95,56.41165160768091,46.08357979540892,NaN,NaN,163.81978711705895,103.71286962708925,0.16843102253194867,-0.043979378051623996,-0.21241040058357266,140637648,135257608.2,42.41858765617279,28.765104845227803,NaN,NaN,-2.360140577300065,-9.617931747172154
2007-12-11T09:30:00-05:00,27.36,27.63,26.61,26.61,3667199,3679700.3,50.91594110731155,46.82201786879364,NaN,NaN,128.336254685215,136.24166351157342,0.14570127429214275,-0.03028380771839423,-0.17598508201053698,136970449,136816149.6,46.78341514760379,30.461571051656527,NaN,NaN,-1.725740824608773,-8.49047590109167
2007-12-12T09:30:00-05:00,27.3,27.35001,26.66,27.07001,3812719,3646437.8,55.97486759450385,48.207729158380275,NaN,NaN,121.99803624755396,147.53056736704596,0.15477799281835808,0.017487409012410637,-0.13729058380594744,140783168,138364008.4,50.77434382023794,32.50529747360527,NaN,NaN,0.35794461804135,-7.226415826929811
2007-12-13T09:30:00-05:00,27.05,27.10001,26.82001,26.92999,2518757,3468439.5,54.145553903066954,49.22984601896428,NaN,NaN,98.95689992311087,137.52176151270072,0.14466928876162916,0.04354602714608902,-0.10112326161554014,138264411,138953735.4,52.2438145840841,34.668854041057855,NaN,NaN,1.5510660043091986,-5.9724898510385245
2007-12-14T09:30:00-05:00,27.03,27.06,26.72,26.75999,2108398,3380325.75,51.92669678006119,50.39742590098599,NaN,NaN,74.69551025178588,117.56129764494494,0.12082246434987876,0.049904818821808306,-0.07091764552807045,136156013,138562337.8,51.152406082812654,36.83518903169697,NaN,NaN,1.922254880449635,-4.844669175111645
2007-12-17T09:30:00-05:00,26.53,26.7,26.17,26.25,1958315,3304003.2,45.85573352211213,50.87234886124781,NaN,NaN,4.008095610987608,85.59895934373067,0.06764219583440134,0.013635099264931227,-0.054007096569470114,134197698,137274347.8,47.62642897414173,38.733784301779785,NaN,NaN,0.42634301643480893,-4.091667433462152
2007-12-18T09:30:00-05:00,26.5,26.5,26.02,26.25,3387313,3235060.85,45.85573352211213,50.7406475738905,NaN,NaN,-16.098009778026647,56.712106451082335,0.03125629051321752,-0.014936733427948212,-0.046193023941165735,134197698,136719797.6,46.15136442568607,40.53414593921906,NaN,NaN,-0.7781146636246731,-3.6183027520567976
2007-12-19T09:30:00-05:00,26.46001,26.47,26.17,26.42,1908296,3067716.85,48.19714235970094,50.681255187145645,NaN,NaN,-4.520199940194415,31.408459213532666,0.018081939403550677,-0.023590599686727387,-0.041672539090278064,136105994,135784362.8,43.69307530663682,41.71494003409788,NaN,NaN,-1.1507300112953736,-3.2657923605194514
2007-12-20T09:30:00-05:00,26.78999,26.8,26.47,26.8,1928017,2849182.55,53.081304431634436,51.07099804147115,NaN,NaN,44.03468931227105,20.424017091364696,0.03350725905009404,0.00021153472233947923,-0.03329572432775456,138034011,135738282.8,43.569957977315525,42.64869877478918,NaN,NaN,-0.07154485600215148,-2.8094712884455513
2007-12-21T09:30:00-05:00,26.89999,27.05,26.85001,27.02,3048982,2957530.55,55.68624981280308,51.76258594648596,NaN,NaN,84.55880136396236,22.396675313799996,0.05576248148190967,0.03640737752463252,-0.01935510395727714,141082993,136723678.8,47.00865954236301,43.589431324172686,NaN,NaN,1.6020045529488487,-2.1792604539606373
2007-12-24T09:30:00-05:00,27.27,27.27,27.07001,27.22,837004,2858602.2,57.97077560803502,52.69095966325293,NaN,NaN,112.02836468041461,44.000729127685396,0.07972845187619813,0.08030546088797053,0.0005770090117723954,141919997,138268138.6,51.95085867973926,44.85616957338452,NaN,NaN,3.6839489760178554,-1.3416591068208525
2007-12-26T09:30:00-05:00,27.2,27.42999,27.08,27.37,2401210,2810141.55,59.65088485812213,53.242423730293304,NaN,NaN,124.83826875000041,72.18798483329081,0.10013774972059516,0.12574919616251634,0.025611446441921183,144321207,140292840.4,57.54135776364589,46.50964686702395,NaN,NaN,5.920216143504237,-0.3042483567744112
2007-12-27T09:30:00-05:00,27.21001,27.37,26.89,26.99001,1683677,2682212.3,53.7852511363384,53.17670046088626,NaN,NaN,76.16652450126549,88.32532972158279,0.08319694716302883,0.12960763039570722,0.04641068323267839,142637530,141599147.6,60.71704710206907,48.44030513150854,NaN,NaN,6.214023750042859,0.6269333727709131
2007-12-28T09:30:00-05:00,27.41,27.41,26.7901,26.86,1062664,2501611.1,51.904662969398416,52.954460658062935,NaN,NaN,57.85860482458674,91.09011282404592,0.05949740705816059,0.12078244205537914,0.061285034997218546,141574866,142307318.6,62.36063051524323,50.28513911269657,NaN,NaN,5.922890011889292,1.3834986069306816
2007-12-31T09:30:00-05:00,26.99001,26.99001,26.55,26.66,1786624,2410755.4,49.06269103882821,52.429534903144884,NaN,NaN,-5.938156759227539,72.99072119940794,0.028201785334707588,0.09653726666560303,0.06833548133089544,139788242,142048368.4,61.34983382724733,51.63737098205904,NaN,NaN,4.862622802837905,1.880516349203142
2008-01-02T09:30:00-05:00,26.64999,26.72,25.97099,26.12,7460508,2650049.45,42.32436116461974,51.81585062152404,NaN,NaN,-112.42874949630398,28.099298364064232,-0.027976628253831168,0.033364696013606476,0.061341324267437644,132327734,140129915.8,54.3244772152313,52.17601827260386,NaN,NaN,1.8063789384875777,1.86992529052949
2008-01-03T09:30:00-05:00,26.28999,26.28999,25.944,26.16,2010973,2652028.1,42.94940716349266,50.88546059073753,NaN,NaN,-149.2566860690368,-26.71969259974321,-0.05972811904375933,-0.01331882453726152,0.04640929450649781,134338707,138133415.8,48.14553763186539,51.98824640200582,NaN,NaN,-0.4865933086596803,1.5332797763596087
2008-01-04T09:30:00-05:00,25.71001,25.75,25,25.14,3892023,2653322.65,33.098910500578114,49.38212891913118,NaN,NaN,-261.6056501670611,-94.27412753340855,-0.1420154134192542,-0.13110997226756993,0.010905441151684264,130446684,135695246.6,41.88067847996704,51.248022394568885,NaN,NaN,-6.195087055724749,0.429227371776129
2008-01-07T09:30:00-05:00,24.96001,25.17999,24.64999,24.92,5599137,2819684.4,31.424812630108846,47.917708622706016,NaN,NaN,-240.14393451395432,-153.87463540111676,-0.20028612158842735,-0.23945221083384993,-0.03916608924542257,124847547,132349782.8,35.12656790078245,50.10331966728102,NaN,NaN,-11.345897385250039,-1.2529333077990377
2008-01-08T09:30:00-05:00,25.03,25.25,24.2,24.25999,5295332,2944589.75,27.010943798613823,46.571652213884704,NaN,NaN,-221.02742567297688,-196.89248918386662,-0.268072969663661,-0.3742573013249988,-0.10618433166133781,119552215,128302577.4,29.02768315593751,48.77483782312357,NaN,NaN,-17.441579851231364,-3.565597099717942
2008-01-09T09:30:00-05:00,24.12,24.64,24.05,24.60001,5319832,3084349,32.287540995158196,45.60249560481657,NaN,NaN,-192.34364966497023,-212.87546921759986,-0.27384028041415254,-0.4484846821790285,-0.17464440176487595,124872047,126811440,27.156825239455145,47.41808502410708,NaN,NaN,-20.601167901312813,-5.999250071374352
2008-01-10T09:30:00-05:00,24.36,24.92,24.17,24.64,6524266,3227202.35,32.90192216701159,44.509979876767325,NaN,NaN,-147.22753907211825,-212.4696398182162,-0.25895569101198845,-0.4983390155298615,-0.23938332451787306,131396313,126222961.2,26.432774461440488,46.185206392307336,NaN,NaN,-22.860399239828944,-8.407985666867864
2008-01-11T09:30:00-05:00,24.61,24.62,24.08,24.28,3284288,3200780.8,30.2417372422817,42.87858222038499,NaN,NaN,-139.08275960041104,-187.96506170488615,-0.25684338040927135,-0.5604375500294623,-0.3035941696201909,128112025,125756029.4,25.84398925120064,44.919065769013415,NaN,NaN,-25.619949201157592,-10.866837600337826
2008-01-14T09:30:00-05:00,24.60001,24.8495,24.55,24.77,4135492,3281617.55,37.63307657054712,41.589069845938134,NaN,NaN,-92.9309739716927,-158.5224695964338,-0.2080168052670695,-0.5636151762040278,-0.3555983709369583,132247517,127236023.4,31.083923891398086,43.78158465108735,NaN,NaN,-25.580460134056626,-12.968783676583369
2008-01-15T09:30:00-05:00,24.58,24.63,24.17,24.25,3663086,3359351.95,33.56819897794702,39.84602865807471,NaN,NaN,-103.58860373577629,-135.03470520899367,-0.1964519319474205,-0.6011632858712339,-0.4047113539238134,128584431,129042466.6,36.94093536626863,42.709447271553735,NaN,NaN,-26.89862363479973,-14.95876081347142
2008-01-16T09:30:00-05:00,23.99001,24.17,23.57001,23.72,6687355,3595803.95,30.01021444330989,37.72883791415955,NaN,NaN,-119.79632502011648,-120.52524028002294,-0.20903864416761608,-0.6660096591333335,-0.45697101496571746,121897076,128447472.4,35.85990529201615,41.160772095008745,NaN,NaN,-29.22615589624073,-16.99696011100989
2008-01-17T09:30:00-05:00,23.82001,24.0285,23.31,23.50999,5623500,3707613.3,28.71159436428526,35.93786243044146,NaN,NaN,-115.50388234255097,-114.1805089341095,-0.21520583045783848,-0.7259783030380156,-0.5107724725801771,116273576,125422925,30.908385151340028,39.03158195567096,NaN,NaN,-31.509983812566954,-19.07024921123233
2008-01-18T09:30:00-05:00,23.52,23.78,23.10001,23.10001,4556039,3840000.45,26.3173799310689,34.110199356275075,NaN,NaN,-117.12248906233445,-109.78845482649419,-0.22929720878025672,-0.797393983555498,-0.5680967747752412,111717537,122144027.4,26.61748361160447,36.47850003398248,NaN,NaN,-34.20886441553847,-21.23290852613321
2008-01-22T09:30:00-05:00,20.5,22.88,19.75999,22.67,8978742,4192536.7,24.051921583401935,32.32371582374463,NaN,NaN,-176.93415781080682,-126.58909159431701,-0.24837227690018204,-0.8785621209004688,-0.6301898440002868,102738795,116242283,20.973555027163428,33.59448011969077,NaN,NaN,-37.221481562243255,-23.516990388434643
2008-01-23T09:30:00-05:00,22,22.87,21.31,22.87,8362602,4458217.7,27.19122490765332,31.2427775196756,NaN,NaN,-134.3424590435274,-132.73986265586723,-0.22879922160280253,-0.91618887100379,-0.6873896494009875,111101397,112745676.2,18.474183327491048,31.033744841995034,NaN,NaN,-38.6635591680158,-25.680785928374807
2008-01-24T09:30:00-05:00,23.02,23.2,22.67,23.2,4136766,4623205.8,32.173038566170646,30.473036905581175,NaN,NaN,-93.80817095113348,-127.54223184207062,-0.17721054718400375,-0.9089028333809921,-0.7316922861969883,115238163,111413893.6,17.613250000799553,28.85286715406176,NaN,NaN,-38.303224847019465,-27.483991488181186
2008-01-25T09:30:00-05:00,23.75999,23.75999,22.7583,22.84,3913577,4698824.15,29.77922466431488,30.235916488705232,NaN,NaN,-83.53997351322948,-121.1494500762063,-0.15188975585593611,-0.9215544810169085,-0.7696647251609724,111324586,110424095.6,16.979909078833785,27.074240768266527,NaN,NaN,-38.74072168140763,-29.092095801499248
2008-01-28T09:30:00-05:00,22.75,22.99001,22.57001,22.94,2891295,4759205.05,31.30814801409788,30.227583301847307,NaN,NaN,-91.98202248319262,-116.12135676037796,-0.11465820964385742,-0.9129874872157941,-0.7983292775719367,114215881,110923764.4,18.571727821264133,25.89175219115808,NaN,NaN,-38.635098370064966,-30.45538188272292
2008-01-29T09:30:00-05:00,23.28,23.28,22.82001,23.14,4257578,4918950.75,34.38521182837452,30.754316732544503,NaN,NaN,-68.57933180127355,-94.4503915584713,-0.06526987656028294,-0.8799166232722904,-0.8146467467120074,118473459,114070697.2,27.94257905271121,25.81424475521334,NaN,NaN,-37.640044996559624,-31.481762327556737
2008-01-30T09:30:00-05:00,22.95,23.5,22.95,22.96001,5001047,5079671.9,32.95450978340865,30.80195736027668,NaN,NaN,-57.84590389840055,-79.15108052944593,-0.03495223383500279,-0.858337039005761,-0.8233848051707582,113472412,114544900.2,29.26359577270017,25.96472836473084,NaN,NaN,-37.20997947297076,-32.300079062615886
2008-01-31T09:30:00-05:00,22.60001,23.55,22.60001,23.25,6045246,5008908.8,37.46883983997434,31.12816576548831,NaN,NaN,-52.02440654383449,-70.79432764798614,0.011895657557227546,-0.8085152332242238,-0.8204108907814514,119517658,115400799.2,31.697530415992134,26.340782361484532,NaN,NaN,-35.526296104250996,-32.760967211420905
2008-02-01T09:30:00-05:00,23.58,23.6599,23.23,23.64999,3134877,5065104,43.15437772962982,32.05049722887031,NaN,NaN,-15.683542861465561,-57.223041517633376,0.07364137510063973,-0.7283591719056517,-0.8020005470062914,122652535,117666389,37.79864553825508,27.194686381988422,NaN,NaN,-32.34096213154483,-32.70096648572432
2008-02-04T09:30:00-05:00,23.69,23.69,23.16,23.16,1959905,4968498.1,38.532437539932545,32.114737298112125,NaN,NaN,-25.026709994749893,-43.831979019944825,0.08452366087875662,-0.6963459709078457,-0.7808696317866023,120692630,118961738.8,41.04137434513688,27.90593284296977,NaN,NaN,-30.92627766250352,-32.44743951097849
2008-02-05T09:30:00-05:00,22.92,22.99001,22.50999,22.58,4144418,4895762.15,33.9036112555699,32.138695317942336,NaN,NaN,-80.7473721602281,-46.26558709173573,0.05701839117144636,-0.7095966428222944,-0.7666150339937408,116548212,118576689.4,40.36768648700298,28.150700780165074,NaN,NaN,-31.157729059574507,-32.26319516077792
2008-02-06T09:30:00-05:00,22.61,22.78999,22.21001,22.33,6159441,4938967.6,32.11291928790352,32.28888852112759,NaN,NaN,-98.8916394832888,-54.47473420871338,0.02782428967747974,-0.7318346718968911,-0.7596589615743709,110388771,117959961.2,39.256192696270006,28.393292737611777,NaN,NaN,-31.91124357026921,-32.21291636213382
2008-02-07T09:30:00-05:00,22,22.52,21.86,22.47,4758391,4910895.55,34.20856094163926,32.68152899093859,NaN,NaN,-107.52940817622515,-65.57573453519151,0.023927535883459417,-0.7297495417200466,-0.753677077603506,115147162,117085862,37.672925805313476,28.876474212895598,NaN,NaN,-31.88992168501811,-32.166774265403
2008-02-08T09:30:00-05:00,22.33,22.53,22.17999,22.3,4781781,4823771.3,32.881217384881296,33.15037452335376,NaN,NaN,-95.94122067076776,-81.62727009705196,0.01625293233186975,-0.7333609121886688,-0.7496138445205386,110365381,114628431.2,33.57329138578643,29.373317625337165,NaN,NaN,-32.26225627090287,-32.18041455190298
2008-02-11T09:30:00-05:00,22.42,22.75,22.38,22.69,3191856,4819149.7,38.75255293196771,34.20041961967989,NaN,NaN,-58.51735516763533,-88.32539913162904,0.04231360915867666,-0.6967218330721927,-0.7390354422308694,113557237,113201352.6,31.434014911961242,30.120493331394155,NaN,NaN,-30.81889354812064,-31.985911551362644
2008-02-12T09:30:00-05:00,22.98,22.98,22.56,22.74001,4784047,4851577.45,39.483595852514505,35.07844611574141,NaN,NaN,-30.64096582083156,-78.30411786374974,0.06635895362738409,-0.6560867501966392,-0.7224457038240233,118341284,113559967,32.5963225750106,31.129217563359838,NaN,NaN,-29.434565832427644,-31.621433591514787
2008-02-13T09:30:00-05:00,22.97,23.35001,22.61011,23.25999,5757164,4956281.35,46.618093998310876,36.11023578946571,NaN,NaN,25.870032843811536,-53.35178339832968,0.11772177211344803,-0.5752934886822132,-0.6930152607956612,124098448,116301902.4,40.85223199553391,32.789144848698,NaN,NaN,-26.014557742162207,-30.82045132732156
2008-02-14T09:30:00-05:00,23.42,23.42,22.8,22.8,3644913,4804159.25,41.9108840325254,36.976782887195036,NaN,NaN,23.77871488739789,-27.09015878560507,0.12070642252539288,-0.5421322326389202,-0.6628386551643131,120453535,117363177,43.72532420512309,34.699531643432955,NaN,NaN,-24.470624371660403,-29.91333319079854
2008-02-15T09:30:00-05:00,22.56,22.82001,22.56,22.72,2312305,4638599.5,41.13298089858861,37.67855666465865,NaN,NaN,-24.10295976697638,-12.7225066048468,0.11718707384358873,-0.5163548128598272,-0.6335418867034159,118141230,118918346.8,47.73197952973952,36.78240676546692,NaN,NaN,-23.452026955691636,-28.990289442926123
2008-02-19T09:30:00-05:00,22.75999,22.99001,22.24001,22.50999,2312125,4526403.8,39.082230912591626,38.01405802781702,NaN,NaN,-41.3834543086846,-9.29572643305666,0.1012116070878365,-0.5070273778436203,-0.6082389849314568,115829105,119372720.4,48.87723732457699,38.27773949917161,NaN,NaN,-23.192046491141532,-28.16196902124261
2008-02-20T09:30:00-05:00,22.38,22.61,22.1199,22.55,5785094,4366721.4,39.69905301277335,38.49581111562878,NaN,NaN,-86.71535986114465,-20.510605241119272,0.09399135778612577,-0.4907497876987996,-0.5847411454849254,121614199,120027303.4,50.55797437811879,39.7987665424158,NaN,NaN,-22.806869517283797,-27.39695480639135
2008-02-21T09:30:00-05:00,22.77,22.82001,22.24001,22.50999,3446757,4120929.15,39.27082932075578,38.624524649970304,NaN,NaN,-69.37596317230528,-39.55980444434264,0.08731629179156841,-0.47559578074546494,-0.5629120725370333,118167442,118841102.2,47.5097526849351,40.928210990197435,NaN,NaN,-22.60131908317717,-26.711863988789325
2008-02-22T09:30:00-05:00,22.5,22.5,22.03,22.49001,3003577,4064269.7,39.044333509861474,38.330950062844,NaN,NaN,-99.21628136666928,-64.15880369515608,0.08241211043644392,-0.4598969344914785,-0.5423090449279224,115163865,117783168.2,44.909135216777514,41.43610311009189,NaN,NaN,-22.48748257600367,-26.108380929819948
2008-02-25T09:30:00-05:00,22.41,22.69,22.31,22.62,2478559,3992518.8,41.411881525423475,38.536624633236215,NaN,NaN,-50.94840678164403,-69.5278930980896,0.08825787172878297,-0.4319867052669437,-0.5202445769957267,117642424,117683407,44.660874104031926,41.69463880715583,NaN,NaN,-21.780934137464296,-25.49017424519771
2008-02-26T09:30:00-05:00,22.53,22.96001,22.3781,22.88,3099368,4002922.45,45.93510613192499,39.39601712440443,NaN,NaN,-5.272623747903756,-62.305726985933426,0.10863082127548368,-0.3844560504013721,-0.4930868716768558,120741792,118665944.4,47.7258902073003,42.22022478717707,NaN,NaN,-19.94349051568138,-24.697790855266806
2008-02-27T09:30:00-05:00,22.82001,23.05,22.55,22.89999,2521910,3916139.05,46.278514399156705,40.407845346636805,NaN,NaN,19.833040241272936,-40.99604696544988,0.12147667819334973,-0.34124102393516864,-0.46271770212851837,123263702,118995845,48.75223687747461,42.89851365726311,NaN,NaN,-18.30750989280813,-23.784893574915568
2008-02-28T09:30:00-05:00,22.88,23.03,22.61,22.61,2704926,3801333,42.100783337847574,40.97157551779454,NaN,NaN,4.942224403470307,-26.132409450294762,0.10887222887706394,-0.3266274160321885,-0.4354996449092524,120558776,119474111.8,50.27643527369659,43.79876433357619,NaN,NaN,-17.92492924214516,-22.947755813091224
2008-02-29T09:30:00-05:00,22.49001,22.64,22.14999,22.14999,4493422,3723741.8,36.47564750184644,41.2283205261492,NaN,NaN,-100.18215808342975,-26.325584793646858,0.06987834569412649,-0.3481517127915943,-0.4180300584857208,116065354,119654409.6,50.86966268294198,45.03421942623015,NaN,NaN,-19.200747654607035,-22.412468933307768
2008-03-03T09:30:00-05:00,22.17999,22.25,21.942,22.14,2919940,3712994.95,36.362022535334674,41.05756835496113,NaN,NaN,-146.67807149837006,-45.471517736992055,0.044948158589100506,-0.36184486024934515,-0.40679301883844565,113145414,118755007.6,47.80567833392862,46.20362395637068,NaN,NaN,-20.27721365965377,-22.107432465642912
2008-03-04T09:30:00-05:00,21.89999,22.22,21.73,22.17,4308840,3830441.7,36.99673100249406,40.87993515138823,NaN,NaN,-156.5790410460885,-75.73280119662901,0.032589327760433495,-0.3660563591379038,-0.3986456868983373,117454254,118097500,45.64137553581392,47.13541345357091,NaN,NaN,-21.009923404082105,-21.950645456848513
2008-03-05T09:30:00-05:00,22.35001,22.52,22.13,22.33,5299387,3888190.15,40.41032860839733,40.436523337822976,NaN,NaN,-62.98639932715717,-92.29668911031504,0.03697986845837409,-0.3524208513253697,-0.3894007197837438,122753641,117995487.8,45.298717859248306,47.45301958669337,NaN,NaN,-20.744794517460367,-21.77838103693592
2008-03-06T09:30:00-05:00,22.42999,22.42999,21.92999,22.02,3017269,3731081.55,36.30589883696761,40.03616725242599,NaN,NaN,-110.24815625589217,-115.33476524218752,0.02155984474674988,-0.3624509138503065,-0.38401075859705636,119736372,117831007,44.715795807663284,47.52376755830339,NaN,NaN,-21.655901135870685,-21.760883908212314
2008-03-07T09:30:00-05:00,21.73,22.25,21.69,22.02,4614328,3723878.4,36.30589883696759,39.69137567659592,NaN,NaN,-135.94824229600306,-122.48798208470218,0.014265622717157922,-0.366178730200609,-0.3804443529177669,119736372,118565210.6,47.936451672394,47.538372711350135,NaN,NaN,-22.407902021569924,-21.853315067263402
2008-03-10T09:30:00-04:00,21.96001,22.08,21.71001,21.78,9308930,3950235.85,33.271633952475,39.27633303658759,NaN,NaN,-148.32042909591806,-122.81645360421177,-0.0029018826252040775,-0.384071706199272,-0.3811698235740679,110427442,118021616.2,45.8086371035339,47.31918698127563,NaN,NaN,-23.926110703005378,-22.149428729512255
2008-03-11T09:30:00-04:00,22.14,22.55,21.86,22.55,5311898,4056237.95,48.22290580702518,39.885179664748435,NaN,NaN,-34.79397146347584,-98.45943968768925,0.03910463276061088,-0.33228903262330434,-0.3713936653839152,115739340,117678633.4,44.46744160077441,46.884148925751035,NaN,NaN,-20.594765866524526,-21.927334034799724
2008-03-12T09:30:00-04:00,22.60001,22.67,22.25999,22.32001,4402621,4037166.65,44.981005062103556,40.29304936055899,NaN,NaN,-8.380594201024367,-87.5382786624627,0.052092073989421395,-0.30627857289713845,-0.35837064688655984,111336719,115395249,36.75264193996434,46.115783872538834,NaN,NaN,-18.86874573894872,-21.490392849678152
2008-03-13T09:30:00-04:00,21.98,22.52,21.84,22.23,3913511,3944984,43.74161601617291,40.628569539581235,NaN,NaN,-57.158261346872855,-76.92029968065883,0.055024566806998076,-0.2895899383778122,-0.3446145051848103,107423208,112932616.2,30.58881454070429,45.09290382424789,NaN,NaN,-17.85831066517638,-20.971523966177898
2008-03-14T09:30:00-04:00,22.38,22.50999,21.71001,21.95,8236832,4174579.95,40.04519941576982,40.53094938889169,NaN,NaN,-88.57302902000056,-67.44525702545833,0.03925095657113137,-0.29555080947089607,-0.33480176604202744,99186376,108822617,23.50397544550006,43.5816967772099,NaN,NaN,-18.14524898261721,-20.5677703970978
2008-03-17T09:30:00-04:00,21.17999,22.11,21.11,21.85001,5715973,4344763.35,38.784736272283176,40.02020868463156,NaN,NaN,-171.46983288812552,-72.07513778389982,0.023977958846157832,-0.3048293174843302,-0.328807276330488,93470403,105431209.2,19.49208854522827,41.564996658490465,NaN,NaN,-18.761084356694795,-20.309672391325943
2008-03-18T09:30:00-04:00,22.37,22.83,22.02879,22.83,6112066,4534760.4,54.0502810905411,40.575334876873306,NaN,NaN,70.90994817698092,-50.93435385580847,0.07868652107406249,-0.23044912498790993,-0.3091356460619724,99582469,102199835,16.58695588998583,39.26747658795556,NaN,NaN,-13.885952251953585,-19.39199808570132
2008-03-19T09:30:00-04:00,22.75,22.78999,22.10001,22.14999,7411293,4616070.35,45.56012245302679,40.822430527957536,NaN,NaN,12.070808599374791,-46.844073295728634,0.06827359164321728,-0.2237936565079508,-0.2920672481511681,92171176,98366726.4,13.933990128167196,36.67158764898917,NaN,NaN,-12.883351992058456,-18.462191500895198
2008-03-20T09:30:00-04:00,22.03,22.53999,22.03,22.39,6987289,4793096.95,48.62736694205055,41.69041048797211,NaN,NaN,7.6869173328883535,-33.875037559776395,0.07614755356077701,-0.19688280620019682,-0.27303035976097384,99158465,96713777.8,12.970567500922868,33.96450942170209,NaN,NaN,-10.994551995972746,-17.395385857334848
2008-03-24T09:30:00-04:00,22.77,23.3,22.67,23.17999,4050956,4845465.9,57.17926167947171,43.177356141124754,NaN,NaN,184.42331703706543,20.724231651636803,0.12999550167354,-0.11053598266904885,-0.24053148434258884,103209421,97518386.8,16.01464108625528,31.693721046868284,NaN,NaN,-6.052023227641685,-15.774905481664396
2008-03-25T09:30:00-04:00,23.25999,23.27,22.97,23.2,3312373,4887156.6,57.37282685784925,44.63279155936442,NaN,NaN,175.95101179218636,90.20840058769917,0.16040164441972624,-0.040029428817931034,-0.20043107323765727,106521794,100128665,25.16016162706528,30.230777196243388,NaN,NaN,-2.332270687202561,-13.854529082455562
2008-03-26T09:30:00-04:00,23.16,23.16,22.7,22.75,6453844,5054880.4,51.711592874333405,45.44002472121699,NaN,NaN,109.53263552767389,97.93293805783777,0.14416044949436574,-0.02023051136970011,-0.16439096086406585,100067950,100225761.2,25.485209592291483,28.81552660574647,NaN,NaN,-1.234107348407692,-12.051611691877294
2008-03-27T09:30:00-04:00,22.73,22.88,22.44,22.57001,7106613,5284115.55,49.60327656820807,46.3898374163056,NaN,NaN,62.265874141316836,107.97195116622618,0.1164358338832224,-0.018846168510037842,-0.13528200239326024,92961337,100383793.4,26.04818765020974,27.482126023071213,NaN,NaN,-1.0760866642225815,-10.483679545069478
2008-03-28T09:30:00-04:00,22.72,22.7999,22.34,22.42999,4459250,5371831.75,47.9649581936236,47.22262737035245,NaN,NaN,42.71855609531054,114.97827891871061,0.08525241402497793,-0.028716484862037817,-0.11396889888701575,88502087,98252517.8,23.47253288506718,25.73470325254787,NaN,NaN,-1.475391043141568,-9.196781187651204
2008-03-31T09:30:00-04:00,22.52,22.69,22.36,22.39999,5812180,5437769.65,47.60218872924163,48.246238425835784,NaN,NaN,30.390143816971136,84.17164427469176,0.060362680946814934,-0.03851554770349708,-0.09887822865031201,82689907,94148615,19.478529391668616,23.853981273128927,NaN,NaN,-1.902010549522553,-8.154671096489968
2008-04-01T09:30:00-04:00,22.92,23.39,22.75,23.05,7669047,5675225,55.46213403793161,48.763326156614816,NaN,NaN,140.67925855419375,77.11729362709323,0.08398154056238097,0.006098697052664193,-0.07788284350971678,90358954,90916047,17.021642140745854,21.893567025984026,NaN,NaN,0.24033367255376775,-6.955384700912292
2008-04-02T09:30:00-04:00,23.37,23.53999,23.09,23.33,3689460,5644256,58.359759715051325,49.71895148896822,NaN,NaN,164.4391623455872,88.0985989906759,0.11296192195357035,0.06331955893224617,-0.04964236302132419,94048414,89712139.8,16.20199382691345,20.425663589337535,NaN,NaN,2.942449678603525,-5.541408360981461
2008-04-03T09:30:00-04:00,23.19,23.39999,23.02,23.32001,6509145,5704743.9,58.214235850677184,50.75271004857567,NaN,NaN,128.5485182648815,101.35512781538883,0.12501965444298593,0.10663220503240822,-0.018387449410577704,87539269,88627726.2,15.47896654816904,19.346388732727867,NaN,NaN,5.035885383434027,-4.030366397493534
2008-04-04T09:30:00-04:00,23.36,23.45,23.07001,23.24001,4081301,5757945.5,56.98872034327562,51.96296154339751,NaN,NaN,113.1440099342743,115.44021858318156,0.12108569246017772,0.13296966616464445,0.01188397370446673,83457968,87618902.4,14.816539509127566,18.725857594415544,NaN,NaN,6.402569585707295,-2.5399469713219873
2008-04-07T09:30:00-04:00,23.33,23.52,23.21001,23.25999,1985263,5626492.25,57.230884608921755,53.280543567443125,NaN,NaN,110.27356911427421,131.41690364264218,0.11343918222274334,0.1536829514828959,0.040243769260152565,85443231,88169567.2,16.90688376851149,18.541200110364343,NaN,NaN,7.5905992867767145,-1.092726077307887
2008-04-08T09:30:00-04:00,23.09,23.17999,22.98,23.12,2200478,5271069.65,54.898632812599686,53.34114011901873,NaN,NaN,64.46028891266329,116.17310971433608,0.09339909884164269,0.15699264281220593,0.06359354397056324,83242753,86746327,15.82592947087933,18.48684108042816,NaN,NaN,7.977844903957647,0.20306977715861763
2008-04-09T09:30:00-04:00,23.14,23.14,22.77,23.02,1916048,5101277.15,53.229894441590716,53.88898097534473,NaN,NaN,40.6798920479732,91.42125565481328,0.06898069114011955,0.1498194078957127,0.08083871675559313,81326705,84201985.2,14.091406545183347,18.498085110215033,NaN,NaN,7.863364202504116,1.2973975522079746
2008-04-10T09:30:00-04:00,22.97,23.36,22.97,23.21001,2213143,4991803.25,55.96862977718371,54.41335689213996,NaN,NaN,67.26946757752606,79.1654455173422,0.0614486275933078,0.15764950124722787,0.09620087365392008,83539848,83402101,13.587235085967393,18.542132794861068,NaN,NaN,8.490960339772414,2.3250493790028948
2008-04-11T09:30:00-04:00,22.99001,23.02,22.55,22.59,7223879,5157321.65,46.41721483237498,53.64463926020447,NaN,NaN,-12.814123469730355,53.973818836541284,0.013061802739440756,0.11252812707822102,0.09946632433878026,76315969,81973701.2,12.71252699046984,18.306267502304966,NaN,NaN,6.213389458186211,2.88052653317194
2008-04-14T09:30:00-04:00,22.59,22.74001,22.47,22.5,2192901,4855125.1,45.211078489477,52.775942948177885,NaN,NaN,-47.08159329737406,22.50278635421163,-0.024601248189735914,0.06871476410161037,0.09331601229134628,74123068,79709668.6,11.453884381346768,17.327247699039358,NaN,NaN,3.984275405273437,3.038204943472154
2008-04-15T09:30:00-04:00,22.57001,22.62,22.31,22.5,4505602,4794606.55,45.211078489477,52.31162049211671,NaN,NaN,-82.29280723566109,-6.8478328754532525,-0.047768825047458524,0.033604980982023136,0.08137380602948166,74123068,77885731.6,10.547846830708082,16.260293216069115,NaN,NaN,2.1665642955392963,2.9136848509103173
2008-04-16T09:30:00-04:00,22.83,23.42,22.77499,23.42,4649020,4721454.25,58.114291715955346,52.919550145527225,NaN,NaN,68.2988543995555,-1.3240404051367989,-0.0018153113925302167,0.07910466678881889,0.0809199781813491,78772088,77374808.2,10.302010517133695,15.135566277992254,NaN,NaN,4.514982332345677,3.1424416339725116
2008-04-17T09:30:00-04:00,23.19,23.42,23,23.41,2927682,4497273.7,57.95452389175349,53.6330905525365,NaN,NaN,78.12370600592334,0.8468072805426573,0.025706713688742777,0.11305337029227758,0.0873466566035348,75844406,75835719.8,9.577837809211559,14.143088058288283,NaN,NaN,6.30697718412552,3.594518141137227
2008-04-18T09:30:00-04:00,23.81,23.95,23.63,23.82001,2763614,4286089.95,62.50595338313712,54.69764517067189,NaN,NaN,185.5311316563339,40.51585830575551,0.06697895495619655,0.17107035029878048,0.10409139534258394,78608020,76294130,11.571662705184863,13.578311866396588,NaN,NaN,9.329860079984988,4.413852703829765
2008-04-21T09:30:00-04:00,23.75999,24.00999,23.7,23.97,5296078,4348346.05,64.0395332688973,55.3103165443123,NaN,NaN,176.55666035718193,85.24350903666671,0.09795947872414246,0.226540743747762,0.12858126502361955,83904098,78250336,19.708007758788526,13.770195124828206,NaN,NaN,12.27903581438511,5.5374502910519565
2008-04-22T09:30:00-04:00,23.92999,23.94,23.60001,23.85001,5080984,4436776.6,61.85971913537357,55.56031364576389,NaN,NaN,137.22486121874937,129.1470427275488,0.10341254075362655,0.25784694096565275,0.1544344002120262,78823114,79190345.2,23.357318063893487,14.281289713183924,NaN,NaN,14.058086430839186,6.754684025307275
2008-04-23T09:30:00-04:00,23.87,24.16,23.839,24,3719806,4300074.7,63.53080740142019,55.940068756531254,NaN,NaN,152.88109994373028,146.06349183638378,0.10957342057112326,0.2914011759259303,0.18182775535480702,82542920,79944511.6,26.253332474084146,15.050887279320719,NaN,NaN,16.0374339150733,8.080791152416706
2008-04-24T09:30:00-04:00,24.21001,24.57001,23.95,24.28999,3314904,4110489.25,66.57963001222969,56.62513373288511,NaN,NaN,176.6753715037251,165.7738249359441,0.12453971630959823,0.3375024007418048,0.2129626844322066,85857824,81947195.2,33.445163740770795,16.38150329586666,NaN,NaN,18.672958151680156,9.593957866597199
2008-04-25T09:30:00-04:00,24.31,24.39,23.82001,24,5657738,4170413.65,61.0805082768094,56.90010685201995,NaN,NaN,125.93067575429978,153.85373375553726,0.10694369833861647,0.3466423073554772,0.23969860901686071,80200086,82265608.4,34.53823433194496,17.640885478969057,NaN,NaN,19.29697958670052,10.980103826611959
2008-04-28T09:30:00-04:00,24.45,24.45,23.97,24,10221871,4390898.2,61.0805082768094,57.34166938517779,NaN,NaN,117.71337085547387,142.08507585519567,0.08812340331895568,0.3498528631655553,0.2617294598465996,80200086,81524806,33.1731746898693,18.879974423182624,NaN,NaN,19.799348649571208,12.239995944177565
2008-04-29T09:30:00-04:00,24.06,24.31,24.0101,24.23,2908900,4152890.85,63.82860136102905,58.09871987942338,NaN,NaN,106.9687436244381,136.0338523363334,0.08399955774373152,0.36672890702626404,0.2827293492825325,83108986,82381980.4,36.309889210341645,20.46700889926536,NaN,NaN,21.02224384877035,13.49460278769082
2008-04-30T09:30:00-04:00,24.3,24.48,23.8,23.8,3281730,4132504.35,55.88392062529123,58.09266922571677,NaN,NaN,74.98528529523968,120.4546894066353,0.04699223065900704,0.34146963760629134,0.2944774069472843,79827256,81838847.6,35.18300670251493,22.009564014733037,NaN,NaN,19.700246709823862,14.38112334799554
2008-05-01T09:30:00-04:00,24.17,24.85001,24.14,24.8,7593492,4186721.7,66.36799527214737,59.5177249714148,NaN,NaN,131.37556315502098,111.3947277368945,0.082466314120557,0.39756029959798056,0.31509398547742357,87420748,82151432.4,36.40625500911863,23.70197315892224,NaN,NaN,22.128327282648385,15.487866767231662
2008-05-02T09:30:00-04:00,25.00999,25.00999,24.578,24.78999,6491066,4307209.95,66.1984055669746,61.01681976266463,NaN,NaN,135.96434634823484,113.40146185568149,0.09686629539746555,0.4361768547242555,0.33931055932678994,80929682,82297351.6,37.00393461158234,25.52697674679621,NaN,NaN,23.912510918434737,16.691387360260673
2008-05-05T09:30:00-04:00,24.84,24.89,24.5825,24.67999,1536488,4284771.2,64.25531460769486,62.377122342537334,NaN,NaN,113.95379343520212,112.64954637162714,0.09070066079849293,0.4526863853249061,0.3619857245264132,79393194,82135973.2,36.59431074396461,27.38743845488596,NaN,NaN,24.72459325862014,17.838988202883453
2008-05-06T09:30:00-04:00,24.60001,25.02,24.4599,24.98,3498386,4349666.6,67.09238275787679,63.01841455981743,NaN,NaN,115.58069637320276,114.37193692138007,0.0979272645336775,0.4843948051935101,0.3864675406598326,82891580,82092492,36.47714544819155,29.25709094996152,NaN,NaN,26.306586915597286,19.048645161842572
2008-05-07T09:30:00-04:00,24.86,25.03999,24.42999,24.53999,4704777,4489103.05,59.618430380910205,63.137265023328624,NaN,NaN,92.17002387375796,117.80888463708372,0.06571948967387337,0.46861690275217427,0.4028974130783009,78186803,81764401.4,35.55217357035502,31.112400647186053,NaN,NaN,25.23675934537259,19.932661473775433
2008-05-08T09:30:00-04:00,24.64,24.75999,24.47,24.58,7467016,4751796.7,60.05418210705421,62.962138503608415,NaN,NaN,78.4096227531241,107.21569655670437,0.04096736203568041,0.45410661562290144,0.41313925358722103,85653819,81411015.6,34.536336763549045,32.75273450849778,NaN,NaN,24.523603078079073,20.588510274390238
2008-05-09T09:30:00-04:00,24.48,24.63,24.28999,24.5,2924805,4536843,58.69044873171081,62.58006103666652,NaN,NaN,58.97982683539646,91.81879265413667,0.014433706328162987,0.43118138649742477,0.4167476801692618,82729014,81770882,36.52533808523441,33.9539723889582,NaN,NaN,23.538873089474755,21.00999067654517
2008-05-12T09:30:00-04:00,24.60001,24.89999,24.52,24.89999,1651064,4509751.15,63.191169432086895,62.67516462928891,NaN,NaN,92.97209029581745,87.62245202625975,0.018773304537186064,0.44021431084074436,0.4214410063035583,84380078,82768258.8,41.80296039426072,35.27151826969872,NaN,NaN,24.03040553343571,21.44147851324382
2008-05-13T09:30:00-04:00,24.78,24.92,24.67999,24.89999,5496969,4559319.5,63.191169432086895,62.65090477433653,NaN,NaN,95.80799065648783,83.66791088291676,0.016666955768890546,0.4422747010146715,0.42560774524578093,84380078,83065958.4,43.31787348421144,36.49041405613638,NaN,NaN,24.42405547074273,21.867560935743665
2008-05-14T09:30:00-04:00,25.02,25.31,24.94,24.95,4225902,4538163.6,63.76364009749293,62.44976263756962,NaN,NaN,122.76705774734342,89.78731765763385,0.013784364600917365,0.4428382009969276,0.42905383639601025,88605980,85149793.8,52.615873592198774,37.85975047409552,NaN,NaN,24.90753831621486,22.30184341866812
2008-05-15T09:30:00-04:00,24.97,25.48,24.94,25.42999,2792967,4531427.85,68.78204487298663,62.99987239443942,NaN,NaN,148.4643431515577,103.79826173732059,0.03797525166052196,0.4765229009716627,0.43854764931114076,91398947,86298819.4,56.82177575463441,39.45143200428762,NaN,NaN,26.857448277438927,22.952644112778234
2008-05-16T09:30:00-04:00,25.5,25.5,25.14999,25.37,3631623,4574828.3,67.5233898422033,63.46007822053899,NaN,NaN,144.13362124186366,120.82902061861401,0.043320328711131784,0.49269806020005547,0.4493777314889237,87767324,87306481.4,60.16141851999493,41.379163706439456,NaN,NaN,28.093937189705976,23.68711455233934
2008-05-19T09:30:00-04:00,25.48,25.69,25.25999,25.5,4212145,4520631.65,68.85350718932143,63.819000065417015,NaN,NaN,154.8247126576049,133.1995450909715,0.04859900153758412,0.5101264834109038,0.4615274818733197,91979469,88826359.6,64.60793337099622,43.400452575057635,NaN,NaN,29.51511984813404,24.51968673745287
2008-05-20T09:30:00-04:00,25.25,25.25,24.84,25.10001,3115175,4422341.2,60.625993746048835,64.15771957404256,NaN,NaN,75.0517484120996,129.04829664209385,0.019625846128848323,0.4860597895343801,0.4664339434055318,88864294,89723202.8,66.95191698295152,45.669660452231675,NaN,NaN,28.34800225308751,25.066588953972104
2008-05-21T09:30:00-04:00,24.95,25.10001,24.42999,24.44,4220453,4447373.55,50.007483320312396,62.989111577482916,NaN,NaN,-7.507636581009395,102.99335777642327,-0.04593547118622465,0.40901460442275095,0.4549500756089756,84643841,88930775,62.982760625989684,47.56798228200818,NaN,NaN,23.700256337670332,24.87139858021471
2008-05-22T09:30:00-04:00,24.52,24.765,24.5,24.53,2749847,4419120.7,51.26107851644841,61.92215964530247,NaN,NaN,-24.100706697200714,68.48034780667159,-0.08302412469459625,0.3511699197407303,0.43419404443532655,87393688,88129723.2,59.16436453919595,49.15087013398058,NaN,NaN,20.390600373740092,24.231284550718335
2008-05-23T09:30:00-04:00,24.5,24.60001,24.31261,24.48,3024230,4287445.3,50.50339975794591,60.93988001317755,NaN,NaN,-61.10443328393774,27.432736901511323,-0.10906765979332556,0.2978594696936696,0.40692712948699516,84369458,87450150,56.05932270072595,50.541228130892115,NaN,NaN,17.502361539214753,23.270009834789253
2008-05-27T09:30:00-04:00,24.44,24.92,24.44,24.88,2569189,3904811.2,56.09442795966044,60.15431181330496,NaN,NaN,-3.3003193227297936,-4.192269494555621,-0.09785654753088141,0.2846064450733934,0.3824629926042748,86938647,86441985.6,51.72254707626677,51.630185390040346,NaN,NaN,16.662358721675467,22.326059675773
2008-05-28T09:30:00-04:00,25.02,25.05,24.75999,25.02,5004035,4009567.95,57.887430011956994,60.0306689298083,NaN,NaN,39.60979957764964,-11.2806592614456,-0.08025220680161466,0.28214773410225646,0.3623999409038711,91942682,87057663.2,54.05986634815306,52.95216344559734,NaN,NaN,16.512454896949645,21.495544707369664
2008-05-29T09:30:00-04:00,25.03,25.34,24.92,25.2,2510874,3971025.15,60.14122420409888,60.03688622245435,NaN,NaN,84.72643760397904,7.166155575552092,-0.05682794539222369,0.29136500916359154,0.3481929545558152,94453556,89019606.2,60.60518083535755,54.81422373644081,NaN,NaN,17.060180251735087,20.861921213707582
2008-05-30T09:30:00-04:00,25.32001,25.4501,25.25,25.35001,2739439,3728322.5,61.96799524249446,60.27099668751032,NaN,NaN,119.83018616051885,35.95233414709601,-0.03276817829620199,0.30723273168556275,0.34000090998176474,97192995,90979467.6,65.84081634155643,56.908186469035236,NaN,NaN,18.05710246530983,20.46123282107933
2008-06-02T09:30:00-04:00,25.28,25.28999,24.78,24.99001,3548850,3581211.7,55.40535122375883,59.71486681548688,NaN,NaN,30.27527208929874,54.228275221743296,-0.042044302712631265,0.28744553159097563,0.3294898343036069,93644145,92834405,69.9160600679741,58.91626501715762,NaN,NaN,16.946902643319657,19.959185652827948
2008-06-03T09:30:00-04:00,25.03,25.24001,24.66,24.85001,5067500,3757762.3,53.052328769696466,58.990663911030424,NaN,NaN,0.9943336766400203,55.08720582161726,-0.05759273482509186,0.25749891577224204,0.3150916505973339,88576645,93162004.6,70.58353562351598,60.86381231282223,NaN,NaN,15.32221272786024,19.29676094926113
2008-06-04T09:30:00-04:00,24.75999,25.12,24.73,24.89999,4943727,3830029.35,53.80656521632077,58.27944427666098,NaN,NaN,-0.3084275999917735,47.10356038608898,-0.06400210811817064,0.23508901544962058,0.2990911235677912,93520372,93477542.6,71.24529865603371,62.19448553166758,NaN,NaN,14.20471005648497,18.569325107435965
2008-06-05T09:30:00-04:00,25.05,25.50999,25,25.41,3950700,3792325.5,60.73813376446954,57.70487919748119,NaN,NaN,94.45219415190253,49.048711695673674,-0.03484339282050819,0.255536882542156,0.2903802753626642,97471072,94081045.8,72.51869044835608,63.31569372407627,NaN,NaN,15.309781577135546,18.103676031678763
2008-06-06T09:30:00-04:00,25.28999,25.28999,24.72,24.72,6360461,3736997.75,49.841395026315254,56.4418795677749,NaN,NaN,-15.382845736907843,22.006105316188332,-0.06142225631844778,0.2136024549646045,0.2750247112830523,91110611,92864569,66.15879857859623,63.74407801397637,NaN,NaN,12.60458795764631,17.318092021102697
2008-06-09T09:30:00-04:00,24.89999,24.89999,24.41,24.67,4081212,3794818.1,49.15322975597415,55.03471689396438,NaN,NaN,-91.1780852014219,-2.284566141955791,-0.08055974785518183,0.174325026464075,0.2548847743192568,87029399,91541619.8,59.996410206024755,63.414683502192695,NaN,NaN,10.276482944600538,16.312147867316675
2008-06-10T09:30:00-04:00,24.33,24.75999,24.3,24.56,4283820,3926455.9,47.596251051207425,54.10402098718999,NaN,NaN,-117.24865376290784,-25.933163629865362,-0.0976753605485346,0.1327905736335886,0.2304659341821232,82745579,90375406.6,55.12216688605832,62.569701352414604,NaN,NaN,7.911265206976221,15.112021772982324
2008-06-11T09:30:00-04:00,24.44,24.47,23.92999,23.92999,5722211,3937718,39.816987981610616,53.37612846299701,NaN,NaN,-198.26207209717927,-65.52389252930286,-0.14558967151100632,0.04847884479336528,0.1940685163043716,77023368,87076005.8,44.18512584902562,61.22701315406003,NaN,NaN,3.105791473484491,13.396846015911205
2008-06-12T09:30:00-04:00,24.10001,24.35201,23.88,24.2,5025426,3977694.2,44.038537218088294,52.86023265597129,NaN,NaN,-157.19530264237852,-115.85339188815905,-0.1525272604230155,0.003409440775602235,0.15593670119861774,82048794,83991550.2,36.828400418824344,59.631587145462056,NaN,NaN,0.5452350680364885,11.560901594786245
2008-06-13T09:30:00-04:00,24.25999,24.60001,24.14999,24.46001,3231388,3999615.25,47.83331268631655,52.66951215085491,NaN,NaN,-90.10088449071745,-130.796999638921,-0.13370829008881188,-0.011198661412397115,0.12250962867641477,85280182,82825464.4,34.49040622781365,58.090950254539756,NaN,NaN,-0.33022486629476083,9.862169243203244
2008-06-16T09:30:00-04:00,24.39999,24.67999,24.28,24.52,2463566,3941212.4,48.69769798797643,52.141174295734615,NaN,NaN,-64.17431053956669,-125.39624470654994,-0.11219218980563699,-0.01773060858063147,0.09446158122500552,87743748,82968334.2,35.034579787785475,56.89895259107681,NaN,NaN,-0.7590164833814552,8.344856996548287
2008-06-17T09:30:00-04:00,24.65491,24.67,24.36,24.42,4049930,3933101.65,47.29100765284331,51.38428698436935,NaN,NaN,-60.19718818903659,-113.98595159177572,-0.10006796959252473,-0.03062338076565041,0.06944458882687432,83693818,83157982,35.796974855152044,55.594460341576735,NaN,NaN,-1.525182687175537,6.934851327444884
2008-06-18T09:30:00-04:00,24.25999,24.28999,24.02,24.16,4428996,3998792.7,43.75226753971279,50.21364722262749,NaN,NaN,-121.4392452841931,-98.62138622917846,-0.10444872058072727,-0.06111631189903477,0.0433324086816925,79264822,83606272.8,37.65934452706305,53.95547203384142,NaN,NaN,-3.239895787292463,5.481316025339549
2008-06-19T09:30:00-04:00,24.02119,24.49001,23.83,24.25,6326762,4104108.15,45.278709435163535,49.02155537924671,NaN,NaN,-101.57236975710055,-87.49679965212287,-0.09637057945964791,-0.07713081564286739,0.019239763816780518,85591584,84314830.8,40.59260848194686,52.15202861529787,NaN,NaN,-4.2145130116214435,4.096197591487979
2008-06-20T09:30:00-04:00,24.14,24.14,23.57001,23.75,6458090,4289520.3,38.95401355572137,47.84645983152975,NaN,NaN,-152.91785508194195,-100.06019377036776,-0.11833968924744856,-0.1286848477425302,-0.010345158495081629,79133494,83085493.2,37.312316958546155,49.8231898217673,NaN,NaN,-7.072467275837288,2.500674039012941
2008-06-23T09:30:00-04:00,23.75,23.81,23.44,23.53,4179145,4347266.05,36.53576376923506,46.666705188639654,NaN,NaN,-166.81087228895083,-120.5875061202446,-0.13985151079724534,-0.18515954699163828,-0.045308036194392956,74954349,80527613.4,31.591819781710598,47.038067261638346,NaN,NaN,-10.217049271942246,0.6838564231622002
2008-06-24T09:30:00-04:00,23.44,23.75,23.2,23.5,5485891,4493101.15,36.20569149100596,45.40949992254574,NaN,NaN,-157.8346890755406,-140.1150062975454,-0.14750492169885288,-0.22968918831795904,-0.08218426661910617,69468458,77682541.4,26.69028030167611,43.85556595061281,NaN,NaN,-12.847280665656417,-1.249163160954745
2008-06-25T09:30:00-04:00,23.56,24.07001,23.56,23.7,5132273,4499513.05,40.09142719688113,43.934735167717996,NaN,NaN,-101.4534062708422,-136.11783849487523,-0.13105668861028547,-0.246005127381963,-0.11494843877167754,74600731,76749723.2,25.304047144099314,40.48309142888018,NaN,NaN,-13.97023933406823,-3.0664597571138144
2008-06-26T09:30:00-04:00,23.48,23.53,22.81,23.25,5348723,4641405.5,34.935306416076074,42.870014552700916,NaN,NaN,-160.40804727520208,-147.88497399849552,-0.14154703233113194,-0.2918822291855925,-0.15033519685446053,69252008,73481808,21.158143878080864,37.268758950271945,NaN,NaN,-16.57938091837153,-4.996877065864917
2008-06-27T09:30:00-04:00,22.99001,23.06,22.64,22.94,9404941,4974680.6,31.89237418962263,41.63709629796152,NaN,NaN,-177.36225951487077,-152.77385488508128,-0.15911494570366597,-0.349228878984043,-0.190113933280377,59847067,69624522.6,17.51111880100133,34.23409527848456,NaN,NaN,-19.774477712321993,-7.107962872501641
2008-06-30T09:30:00-04:00,22.8,23.05499,22.74001,22.91,4765590,5035517.6,31.605471748026247,40.49489777630572,NaN,NaN,-153.63417875948903,-150.1385161791889,-0.16196640255413022,-0.3925719364730398,-0.23060553391890956,55081477,65649948.2,14.699495390427302,31.346761600225204,NaN,NaN,-22.41792048731274,-9.295099674617513
2008-07-01T09:30:00-04:00,22.64,22.89999,22.41499,22.75,9249328,5244609,30.052677289936426,39.797447012614704,NaN,NaN,-151.35257920880875,-148.84209420584256,-0.16337153358423262,-0.43481995089920034,-0.2714484173149677,45832149,60922686.4,12.192087279787003,29.061544559565306,NaN,NaN,-25.10011876520113,-11.552959544700887
2008-07-02T09:30:00-04:00,22.89,22.98,22.39999,22.45,6501676,5322506.45,27.340352118819425,38.604719505524066,NaN,NaN,-138.20784239746447,-156.19298143116697,-0.17235859248242213,-0.4868966579179954,-0.3145380654355733,39330473,53868634.8,9.569047052721132,27.11444789055793,NaN,NaN,-28.265203474242952,-13.940422963206895
2008-07-03T09:30:00-04:00,22.55,22.62,22.23,22.35001,4289199,5339431.4,26.482451905614965,37.07965802118823,NaN,NaN,-142.4093922314405,-152.59325042241466,-0.17246972936712612,-0.530125227144481,-0.35765549777735484,35041274,47026488,7.813174959212404,25.20893137137213,NaN,NaN,-31.13526732756719,-16.39682930097265
2008-07-07T09:30:00-04:00,22.60001,22.89,22.23,22.60001,6852773,5364047,32.20997184903955,35.90196329697846,NaN,NaN,-109.77584880186207,-139.07596827981294,-0.1442831467500098,-0.5380094312148671,-0.3937262844648573,41894047,43435884,7.079066873877409,23.2121090203787,NaN,NaN,-31.944505717748306,-18.6179259319406
2008-07-08T09:30:00-04:00,22.55,22.85001,22.44,22.83,6674086,5493690.7,37.06738455868035,35.17170450453825,NaN,NaN,-86.23585731129572,-125.59630399017428,-0.10078582998005509,-0.5197085719399261,-0.41892274195987106,48568133,42133215.2,6.8283968537136275,21.142924877418814,NaN,NaN,-31.192512907956004,-20.414295499942803
2008-07-09T09:30:00-04:00,22.81,22.81,22.10001,22.14999,5942855,5576642.45,30.18135408223702,34.20235354328998,NaN,NaN,-108.55633115020507,-117.03705437845356,-0.10781660566297868,-0.5536934990385944,-0.44587689337561576,42625278,41491841,6.702553914042795,18.931725547917363,NaN,NaN,-32.731867463497935,-22.173948637593536
2008-07-10T09:30:00-04:00,22.24001,22.46001,22,22.42999,6520203,5616542.05,35.49505856074484,33.503521337974355,NaN,NaN,-101.48918066563111,-109.69332203208687,-0.0846375146294801,-0.5516737866624659,-0.4670362720329858,49145481,43454842.6,12.045282244334672,16.892630816659356,NaN,NaN,-32.246836478901656,-23.612932614923267
2008-07-11T09:30:00-04:00,22.21001,22.53999,21.92,22.22,13322629,6031402.2,33.43958399475427,33.10963351219099,NaN,NaN,-97.94206207230143,-100.79985600025904,-0.07481566173188331,-0.56055584919784,-0.48574018746595665,35822852,43611158.2,12.475106853461739,15.118544380581897,NaN,NaN,-32.504815185150086,-24.883201553527098
2008-07-14T09:30:00-04:00,22.42,22.55,21.92999,22.05,11833145,6461490.05,31.832459935823735,32.77368323837589,NaN,NaN,-94.89490232886487,-97.82366670565959,-0.07115815628108402,-0.5746878828173116,-0.5035297265362276,23989707,40030290.2,11.132922982034245,13.657194609176445,NaN,NaN,-33.2153134036657,-26.07350324640404
2008-07-15T09:30:00-04:00,21.78999,22.37,21.58,22,11118813,6894252.4,31.355147065309794,32.4272157793976,NaN,NaN,-106.7984958998218,-101.93619442336481,-0.06373577337606195,-0.583199443256305,-0.5194636698802431,12870894,32890842.4,9.043738733269606,12.396727354290269,NaN,NaN,-33.92779682383253,-27.195545186036682
2008-07-16T09:30:00-04:00,22.11,22.48,21.87,22.32001,6859309,7034721.35,37.785070292947275,32.262476000545185,NaN,NaN,-78.67853432396592,-95.96063505811699,-0.030584291288194843,-0.5576940339904866,-0.5271097427022917,19730203,28311827.4,8.006027024663496,11.16115448861628,NaN,NaN,-32.58069176478753,-27.964851840143947
2008-07-17T09:30:00-04:00,22.60001,22.82001,22.34,22.55,13009660,7463754.55,41.990650236240086,32.7664291305569,NaN,NaN,-33.77251369753295,-82.41730166449734,0.011280677930271432,-0.5130088952894525,-0.5242895732197239,32739863,25030703.8,7.354796735176535,10.175201121265973,NaN,NaN,-30.146323788625008,-28.276490689926955
2008-07-18T09:30:00-04:00,22.67999,22.8,22.17999,22.8,9669117,7630872.3,46.244389040573914,33.79157304848199,NaN,NaN,-24.235551508109555,-67.67599955165898,0.05766374171502542,-0.4522098960759422,-0.5098736377909676,42408980,26347929.4,10.502198349838153,9.674563946182888,NaN,NaN,-26.755831797838255,-28.059253705342854
2008-07-21T09:30:00-04:00,22.53,22.53999,22.1799,22.35001,4975066,7556721.1,40.48920044706735,34.4261250984135,NaN,NaN,-56.782248391674045,-60.0534687642208,0.059644028968642904,-0.435318601580164,-0.4949626305488069,37433914,29036770.8,16.72163597938767,9.819002559680056,NaN,NaN,-25.556951740726912,-27.701781996112004
2008-07-22T09:30:00-04:00,21.89999,22.23,21.75,22.23,7772707,7736399.2,39.091910092011325,35.071784584275996,NaN,NaN,-104.06441086839497,-59.50665175793544,0.05461231808695988,-0.4266972329401071,-0.48130955102706696,29661207,32394833.4,23.839906707135867,10.650989661633547,NaN,NaN,-25.013687050619186,-27.317768432470174
2008-07-23T09:30:00-04:00,22.39999,22.78,22.28999,22.63,8194621,7871835.7,45.80515757152208,36.39069925946904,NaN,NaN,2.0847572423118472,-43.35399344467989,0.0785107440599403,-0.38317112095214156,-0.46168186501208186,37855828,36019958.4,30.723960415200807,12.162054901810668,NaN,NaN,-22.382115436406874,-26.612675147318274
2008-07-24T09:30:00-04:00,22.72,22.73,22.05,22.05,6339965,7932220.3,39.07917484063146,37.29046518339879,NaN,NaN,-55.74278090121787,-47.748046885416876,0.056568971955644476,-0.3909706500675263,-0.44753962202317077,31515863,35775158.4,30.523318510625472,13.784208012625887,NaN,NaN,-22.302169017513442,-25.996888557346157
2008-07-25T09:30:00-04:00,22.36,22.42999,22.14,22.36,10109309,8170249.6,43.826925922705044,38.12024761723204,NaN,NaN,-39.80652754335314,-50.862242092465586,0.06371446438739603,-0.3678965415389257,-0.43161100592632173,41625172,35618396.8,30.386470759775975,15.449022575904356,NaN,NaN,-20.63204169205658,-25.23048186230479
2008-07-28T09:30:00-04:00,22.37,22.37,21.87,21.89,5131531,7956579.1,38.879657825072215,38.2496957076886,NaN,NaN,-115.18846141725392,-62.54348469758156,0.03879371626551975,-0.383118860594422,-0.42191257685994177,36493641,35430342.2,30.211483302322776,17.119243036519297,NaN,NaN,-20.911136761604965,-24.613432562204814
2008-07-29T09:30:00-04:00,22.00999,22.38,22,22.33,4322152,7934407.2,45.12477061946885,39.31708260320516,NaN,NaN,-46.72464194513134,-51.07553091292883,0.05306651193461953,-0.3555794369416674,-0.4086459488762869,40815793,37661259.4,34.994079821357985,19.14006631561324,NaN,NaN,-18.968712691214076,-23.807044009206138
2008-07-30T09:30:00-04:00,22.42,22.52,22.16,22.48,7561133,7849997.45,47.108857669888906,40.146639682429736,NaN,NaN,15.751028775139755,-48.34227660636326,0.07252878619105385,-0.3179849661374696,-0.3905137523285235,48376926,39765479,39.22465577003957,21.081450138877873,NaN,NaN,-16.77908503880366,-22.803049870577212
2008-07-31T09:30:00-04:00,22.3,22.64,22.2,22.35001,5926426,7821234.95,45.571136471608696,41.01317914506219,NaN,NaN,25.855551137699482,-32.022610198579784,0.07618986504561753,-0.29527642102150153,-0.37146628606711907,42450500,41952406.4,43.3510121000129,23.28687194220296,NaN,NaN,-15.509875735414969,-21.76116785126832
2008-08-01T09:30:00-04:00,22.48,22.48,21.9601,22.10001,8789598,8046254.9,42.68532242733448,41.78838360874153,NaN,NaN,-62.268339719395506,-36.514972633788304,0.061922730990287445,-0.29406287232925976,-0.3559856033195472,33660902,40359552.4,41.15906010806234,25.431596022633535,NaN,NaN,-15.34966332432544,-20.845238633133622
2008-08-04T09:30:00-04:00,22.17999,22.2693,22.00101,22.21001,4525539,7929893.2,44.35503499779481,42.71694703249047,NaN,NaN,-65.17720391862275,-26.512721134062076,0.059999671697492485,-0.2809860136976816,-0.3409856853951741,38186441,40698112.4,41.83228192623883,27.773634822131335,NaN,NaN,-14.718988539774166,-19.970060048367987
2008-08-05T09:30:00-04:00,22.27,22.71001,22.17,22.63,4869063,7839642.05,50.30750987854013,43.611407002889955,NaN,NaN,100.52933598402615,2.938074451769424,0.08556053548557174,-0.23403501603820942,-0.31959555152378116,43055504,41146054.6,42.76534006170332,30.256442896205613,NaN,NaN,-12.310787414670903,-18.87587824355412
2008-08-06T09:30:00-04:00,22.58,22.95,22.5,22.95,6127750,7848886.8,54.31727905373747,44.491880489854054,NaN,NaN,197.13116133682092,39.214100964105654,0.12043170911895673,-0.16905591512508522,-0.28948762424404195,49183254,41307320.2,43.11909103750454,32.811035346371895,NaN,NaN,-8.998522691246304,-17.464827450367288
2008-08-07T09:30:00-04:00,22.78,23.07001,22.62,22.91,8908949,7968324.1,53.73360646273033,45.02682459143666,NaN,NaN,180.39583182194707,70.12215710095516,0.1360615528486927,-0.11941068318317605,-0.25547223603186875,40274305,40872081.2,42.358158144894674,35.08646104601879,NaN,NaN,-6.514654438978128,-15.900517020168836
2008-08-08T09:30:00-04:00,22.85001,23.41,22.82001,23.35001,5890996,7596742.45,58.95811913798954,46.34603306935967,NaN,NaN,228.2592748829878,128.2276800214318,0.16913496653367438,-0.04405352786477579,-0.21318849439845017,46165301,43372961,48.03300402431702,37.32298733494231,NaN,NaN,-2.6794100868268456,-14.011787458262837
2008-08-11T09:30:00-04:00,23.41,23.78999,23.27,23.5,5607148,7285442.6,60.59174205973916,47.88173535276879,NaN,NaN,241.70221993396743,189.60356479194985,0.19251401727028558,0.027454027189406816,-0.16505999008087877,51772449,46090162.6,53.40093752666131,39.43448953633699,NaN,NaN,0.9770249787470903,-11.87052853868999
2008-08-12T09:30:00-04:00,23.56,23.67999,23.42999,23.55,4812688,6970136.35,61.14693285144825,48.977576444192096,NaN,NaN,202.15574217437322,209.92884603001926,0.20177135405815094,0.08715420249180994,-0.11461715156634102,56585137,48796089.2,58.048313157623674,41.38622901793862,NaN,NaN,4.1173080587732525,-9.586551881909527
2008-08-13T09:30:00-04:00,23.53,23.63,23.25,23.46001,4792852,6866813.5,59.5216137281067,50.43775065044032,NaN,NaN,149.41592972085706,200.3857997068265,0.192298476746676,0.125755944367004,-0.06654253237967202,51792285,49317895.4,58.89955896482814,43.41310333609596,NaN,NaN,6.292019395904612,-7.318184556507507
2008-08-14T09:30:00-04:00,23.42,23.75,23.28,23.64,6264074,6529534.2,61.71364525074022,51.7153734595857,NaN,NaN,137.84821834914098,191.8762770122653,0.18837365373514176,0.16892453478925518,-0.01944911894588658,58056359,52874306.2,64.22731644251824,45.830306599148976,NaN,NaN,8.777980187705888,-5.018732450191308
2008-08-15T09:30:00-04:00,23.67999,23.83,23.52,23.73,4686262,6280391.45,62.798478829084026,53.42386067415797,NaN,NaN,132.1073787422263,172.64589778411298,0.18195969615497973,0.2080005012478381,0.02604080509285836,62742621,56189770.2,68.34671516940985,48.554251732512334,NaN,NaN,11.173430579884636,-2.705566303037602
2008-08-18T09:30:00-04:00,23.75999,23.75999,23.24001,23.42999,4839250,6273600.65,57.00051157113086,54.27212788499097,NaN,NaN,90.76938703806029,142.45933120493157,0.14901757748493755,0.21231277694903028,0.06329519946409275,57903371,57415954.6,69.73481834535669,51.0357330556551,NaN,NaN,11.694866920483307,-0.6483615568203294
2008-08-19T09:30:00-04:00,23.25999,23.3214,22.97,23.02,5432371,6156583.85,50.181899992516996,54.49163090803582,NaN,NaN,38.02804211022473,109.63379119210188,0.0938166938056843,0.18056606672119813,0.08674937291551382,52471000,56593127.2,67.59271463764895,53.06202297477006,NaN,NaN,10.120856862201114,0.8900982173255911
2008-08-20T09:30:00-04:00,23.14999,23.32001,22.98,23.07001,5539664,6023836,50.95262812832719,54.87602316923001,NaN,NaN,36.714410369281865,87.09348732178684,0.05670046711397485,0.15762495680798239,0.10092448969400754,58010664,57836803,69.13593202444426,54.9038029693723,NaN,NaN,9.050196419212591,2.055826531880877
2008-08-21T09:30:00-04:00,22.97,23.12,22.82001,22.98,4061103,5909892.9,49.469196613306714,55.36058561108518,NaN,NaN,13.27442627740683,62.178728907440004,0.023800065877243204,0.13067457204056154,0.10687450616331834,53949561,57015443.4,66.87111129142139,56.74037805389794,NaN,NaN,7.735103294722874,2.867151783715448
2008-08-22T09:30:00-04:00,23.23,23.48,23.17,23.3,2932074,5551031.15,54.536823040967576,56.087856185597516,NaN,NaN,54.58008455485642,46.67327006996603,0.02137839093722707,0.13359749483485217,0.1122191038976251,56881635,55843246.2,63.66567335614423,58.2999060131769,NaN,NaN,8.005969698739172,3.601268628718837
2008-08-25T09:30:00-04:00,23.23,23.33,22.95,23,6686246,5628766.9,49.52255661213419,56.03178809513995,NaN,NaN,17.689185859787816,32.057229834311535,-0.0014285378733737558,0.1104334315559079,0.11186196942928166,50195389,54301649.8,59.61821410250626,59.503682730377115,NaN,NaN,6.742692061606689,4.050043404845673
2008-08-26T09:30:00-04:00,23,23.03,22.77,22.91,6112621,5718290.35,48.093945844838416,55.587264294504294,NaN,NaN,-18.443350415883643,20.762951329089855,-0.02241200665866122,0.08384696110595513,0.10625896776461635,44082768,52624003.4,55.48429790278177,60.38691179218262,NaN,NaN,5.280942757883159,4.225886169565314
2008-08-27T09:30:00-04:00,23,23.25999,22.89,23.13,3789799,5529723.65,51.75752278738248,55.44611546055088,NaN,NaN,8.454880755642181,15.111045406361914,-0.021318020638977184,0.07961144196589487,0.10092946260487205,47872567,50596384,50.891293248272326,60.99642144242388,NaN,NaN,5.072487997606307,4.346829287856885
2008-08-28T09:30:00-04:00,23.22,23.42999,23.22,23.27,5322637,5499534.2,53.983354355742456,55.0907751189618,NaN,NaN,43.57918599185748,21.171997349252052,-0.011500487237971091,0.08655385355740819,0.09805434079537928,53195204,50445512.6,50.555938750412565,61.17663106571643,NaN,NaN,5.532640966386347,4.516230956218236
2008-08-29T09:30:00-04:00,23.10001,23.17999,22.75,22.75,8922453,5506176.95,45.57273821520356,54.017989130066404,NaN,NaN,-54.07880563160102,-0.5597806880394358,-0.03882330084807424,0.04952521473528648,0.08834851558336072,44272751,47923735.8,45.19505957120777,60.59049692604117,NaN,NaN,3.3124095506543494,4.3442564697091095
2008-09-02T09:30:00-04:00,23.27,23.33,22.56,22.62,5718719,5565835.95,43.738091424148344,52.774500456687846,NaN,NaN,-83.62422827102682,-20.82246351420236,-0.06301528235372725,0.009579412641201657,0.0725946949949289,38554032,45595464.4,40.884495315197235,59.364509937296425,NaN,NaN,0.923779275682776,3.8556168705624905
2008-09-03T09:30:00-04:00,22.55,22.63,22.19031,22.32001,6659098,5655337.7,39.76027421858321,51.362976206007595,NaN,NaN,-194.99012143341994,-56.13181771770962,-0.09468147540192942,-0.045757149257482865,0.04892432614444655,31894934,43157897.6,36.91484859963066,57.79417348263946,NaN,NaN,-2.3953885409452824,2.962616097489952
2008-09-04T09:30:00-04:00,22.14999,22.17,21.48,21.52,8903559,5794128.15,31.525972033203374,49.20671383332639,NaN,NaN,-290.9293311625994,-116.00866010135795,-0.1610666753075453,-0.15240901798998507,0.00865765731756022,22991375,38181659.2,30.42107542174358,55.37944198115555,NaN,NaN,-8.529565229852192,1.3208759078696455
2008-09-05T09:30:00-04:00,21.36,21.67999,21.25,21.52,7204391,5708900.25,31.52597203320336,46.972963347906344,NaN,NaN,-255.72844344128825,-175.8701859879871,-0.19431118145282397,-0.23423131949846976,-0.03992013804564578,22991375,32140893.4,24.733181251878605,52.264189558474754,NaN,NaN,-13.201568585871183,-0.7537590198076154
2008-09-08T09:30:00-04:00,22.09,22.09,21.33,21.78,12667027,6047701.8,36.48398831768796,45.50749740123185,NaN,NaN,-171.50623245438842,-199.35567135254456,-0.1880055437647419,-0.27492706775157316,-0.08692152398683126,35658402,30418023.6,23.38994826419946,48.953841695534955,NaN,NaN,-15.502002544506228,-2.8606509519074166
2008-09-09T09:30:00-04:00,21.7,21.95,21.31,21.39999,8163113,6175500.05,32.751336653907956,44.26245716275978,NaN,NaN,-159.72278661815903,-214.575383021971,-0.19765663443879744,-0.33399231703532806,-0.13633568259653062,27495289,28206275,21.756419525576618,45.67982061610121,NaN,NaN,-18.708429691667526,-5.124619343301718
2008-09-10T09:30:00-04:00,21.58,21.58,21.3,21.3,7447570,6307244.15,31.828597635299587,42.89645498468638,NaN,NaN,-144.96366929229913,-204.57009259374686,-0.1984824455222996,-0.3844387394994051,-0.1859562939771055,20047719,25836832,20.134139643278047,42.17969258887506,NaN,NaN,-21.56248942211039,-7.472886497417242
2008-09-11T09:30:00-04:00,21.16,21.64999,20.96001,21.64999,9756262,6555414.65,38.37347190807977,42.103903220027306,NaN,NaN,-119.40694690250453,-170.26561574172788,-0.1645643979440488,-0.3916617914071665,-0.2270973934631177,29803981,27199353.2,23.65927908556,39.093133145599246,NaN,NaN,-21.926782482532584,-9.537728781005148
2008-09-12T09:30:00-04:00,21.38,21.75,21.17,21.75,7183926,6601407.25,40.14192799175258,41.07569643079766,NaN,NaN,-92.50413208073975,-137.62075346961817,-0.1262256770082424,-0.3848794897234207,-0.2586538127151783,36987907,29998659.6,30.451256979121226,36.72067483295474,NaN,NaN,-21.677126263365253,-11.271928421342306
2008-09-15T09:30:00-04:00,20.92,21.44,20.7,20.7,20197728,7376980.55,30.308215615644514,39.70324350247697,NaN,NaN,-129.7067012536798,-129.26084722947644,-0.1602292004740059,-0.4589403133076857,-0.2987111128336798,16790179,26225015,26.968010847426015,34.388517457591874,NaN,NaN,-24.979837666028317,-13.230201170583165
2008-09-16T09:30:00-04:00,20.45,21.09,20.28,21.09,27426640,8506350.05,36.52781894426031,38.8770915810071,NaN,NaN,-123.21170363975313,-121.95863063379527,-0.14553028968391246,-0.48062397493857034,-0.3350936852546579,44216819,29569321,34.156260058781825,32.865086183020445,NaN,NaN,-25.42076063769983,-14.971709665885545
2008-09-17T09:30:00-04:00,20.5,20.66,18.84,19.92,22131552,9341309.1,28.35288433746524,37.2053316917273,NaN,NaN,-176.25594490790138,-128.2170857569157,-0.20030004040522809,-0.585468735761193,-0.3851686953559649,22085267,29976830.6,34.99585071057618,31.729697430327867,NaN,NaN,-29.122226332128886,-16.99321204677745
2008-09-18T09:30:00-04:00,20.13,20.77,19.50999,20.77,22785968,10203624.3,39.02875610102712,36.13714610210478,NaN,NaN,-120.89144025723628,-128.51398442786206,-0.16637207627444195,-0.5931337906990173,-0.42676171442457533,44871235,32990281.4,40.98827252058114,31.046292699625628,NaN,NaN,-27.720562210456528,-18.52569064158875
2008-09-19T09:30:00-04:00,22.23,22.23,20.85001,20.85001,11215797,10561359,39.936010000941444,35.73452265822892,NaN,NaN,-45.135463760776815,-119.04025076386947,-0.12738843012520829,-0.5859972520810857,-0.4586088219558774,56087032,36810106.4,47.584357680401425,31.216956850282315,NaN,NaN,-26.36831040146392,-19.646064892999487
2008-09-22T09:30:00-04:00,21.05,21.14999,20.25,20.31,8853180,10857414.3,36.038293711906576,35.18453710735451,NaN,NaN,-96.68657174389664,-112.43622486191285,-0.1265574515001533,-0.616805636331069,-0.4902481848309157,47233852,42898841,56.02249800958414,32.29824275702424,NaN,NaN,-26.712990789726337,-20.655625735389037
2008-09-23T09:30:00-04:00,20.41,20.81,20.06,20.3,16727105,11359457.25,35.96828563125523,34.91368077968822,NaN,NaN,-104.33008801786129,-108.65990173753445,-0.11557093697999687,-0.6347118560559117,-0.5191409190759149,30506747,40156826.6,51.9652962136476,33.37327472945402,NaN,NaN,-26.994242554864844,-21.56114242388558
2008-09-24T09:30:00-04:00,20.34,20.49001,20.13,20.35001,7084250,11408038.7,36.631265774124785,35.27834461832546,NaN,NaN,-102.38055671165787,-93.88482409828575,-0.09470195300304829,-0.6375183603297252,-0.5428164073266769,37590997,43257972.6,55.85883986205898,35.19025790376226,NaN,NaN,-27.00380146784875,-22.33866514445175
2008-09-25T09:30:00-04:00,20.47,21.0172,20.36501,20.7,14856902,11961393.85,41.218290370789546,35.97065307101018,NaN,NaN,-63.35746308824478,-82.37802866448746,-0.049372947551113544,-0.6045325917655688,-0.5551596442144553,52447899,44773305.4,57.66461607373674,37.5425032481807,NaN,NaN,-25.56724391798938,-22.799890683528552
2008-09-26T09:30:00-04:00,20.17,20.92,20.14,20.8,16681250,12529324.5,42.49902829040129,36.400298783346855,NaN,NaN,-62.25924219484912,-85.80278435130194,-0.0069303427196250045,-0.5638225726139865,-0.5568922298943615,69129149,47381728.8,60.64884678592935,40.20385314258998,NaN,NaN,-24.022752392522744,-22.974585213384866
2008-09-29T09:30:00-04:00,20.32001,20.44,18.96001,19,20520704,13109237.05,29.879388706803198,36.19515964426794,NaN,NaN,-159.39135631660568,-98.34374126584376,-0.08975955495714438,-0.6690916735907919,-0.5793321186336475,48608445,47656647.4,60.961192931222904,43.00419410013614,NaN,NaN,-27.117101606511557,-23.56637326954582
2008-09-30T09:30:00-04:00,19.17999,19.92999,19.17999,19.85001,10347262,13340664.2,39.07903147891817,36.71304777595498,NaN,NaN,-130.8111194116006,-103.6399475445916,-0.07744264356516362,-0.676135423090102,-0.5986927795249384,58955707,53346439.4,66.82944056839789,46.3395727376447,NaN,NaN,-26.136603892832245,-23.933549072872452
2008-10-01T09:30:00-04:00,19.67999,19.77,19.28,19.67,13473695,13681394.05,37.94370114507494,36.68234986431178,NaN,NaN,-127.65288303274106,-108.69441280880827,-0.07169262065258708,-0.6883085553406723,-0.6166159346880852,45482012,54924642.4,68.2548525362148,49.524970841262906,NaN,NaN,-25.803348879597106,-24.200663330975974
2008-10-02T09:30:00-04:00,19.25999,19.3828,18.67,18.89999,10857871,13779109.65,33.464985337550104,36.2054253890116,NaN,NaN,-166.81961260724322,-129.38684271260792,-0.10784904158769515,-0.7514272366727042,-0.643578195085009,34624141,51359890.8,61.79541168181319,51.76383903431232,NaN,NaN,-27.147135382467845,-24.621587909760528
2008-10-03T09:30:00-04:00,19.06,19.52499,18.55,18.63,13053750,14071577.6,32.03706954937718,36.32891495570679,NaN,NaN,-150.80070977878256,-147.09513622939463,-0.13622031228923126,-0.8138535854465481,-0.6776332731573168,21570391,41848139.2,48.58348945585475,53.30780179205724,NaN,NaN,-28.685200985271326,-25.202104063404928
2008-10-06T09:30:00-04:00,18.14999,18.27,17.06,17.60001,20373360,14456894.25,27.25863095814104,35.66683009955541,NaN,NaN,-219.57404538641643,-159.13167404335678,-0.20641568361148654,-0.935652877671675,-0.7292371940601885,1197031,32365856.4,39.51374487270224,53.690479278765835,NaN,NaN,-31.76321974378559,-26.139406303459307
2008-10-07T09:30:00-04:00,18.05,18.07001,16.7,16.7,14864078,14791942.5,23.90360666595258,35.349024551590226,NaN,NaN,-206.24665704573795,-174.21878157018423,-0.29038035053870126,-1.092212632233565,-0.8018322816948638,-13667047,17841305.6,30.21042952395095,53.348663479721175,NaN,NaN,-35.5778101744354,-27.48774971359875
2008-10-08T09:30:00-04:00,16.3,17.35001,16.28999,16.55,24304048,15634766.4,23.386959559666224,34.231753370064446,NaN,NaN,-194.19519614009045,-187.52724419165412,-0.3300480570134938,-1.214392352961731,-0.8843442959482373,-37971095,1150684.2,23.394102494262142,52.091937049269816,NaN,NaN,-38.65446179082101,-29.082994296059073
2008-10-09T09:30:00-04:00,16.88,17.13,15.3,16,23145056,16304206.1,21.547916237994528,32.918318101282516,NaN,NaN,-190.13812345680157,-192.19094636156578,-0.3646466593735267,-1.3401526201651457,-0.975505960791619,-61116151,-17997374.2,18.294365391478152,49.999794742918155,NaN,NaN,-41.80347092175769,-30.900205242587447
2008-10-10T09:30:00-04:00,15.26,16.58,14.94,15.9,31530096,17521514.6,21.221170802070617,31.859952179151378,NaN,NaN,-169.77917145902438,-195.98663869761415,-0.36470527735700653,-1.4313875574878772,-1.0666822801308706,-92646247,-40840701.8,14.291733744815602,47.01902586686326,NaN,NaN,-44.36768079986343,-32.8241303221983
2008-10-13T09:30:00-04:00,16.78,17.75999,16.45,17.75999,16435102,17333383.3,39.57466019978258,32.11755036261762,NaN,NaN,-83.93498230401231,-168.85882608113332,-0.21719860942702884,-1.3381805419146566,-1.1209819324876278,-76211145,-56322337,12.323782066029182,44.18748914203337,NaN,NaN,-40.0959088427,-33.862955825127116
2008-10-14T09:30:00-04:00,18.39,18.45,16.92999,17.16,24416720,17182887.3,36.61156564340361,32.11614321042325,NaN,NaN,-66.57861726866696,-140.92521812571914,-0.1414285594497835,-1.2977676317998572,-1.1563390723500737,-100627865,-73714500.6,10.563928847459124,40.95213835527624,NaN,NaN,-37.752328206474736,-34.41858045103392
2008-10-15T09:30:00-04:00,17.02,17.054,15.84,15.87,17895920,16971105.7,31.202225735851727,31.400710022213406,NaN,NaN,-107.56602996020293,-123.59938488974163,-0.1583061049757375,-1.3542217035697455,-1.195915598594008,-118523785,-89825038.6,9.246702425140285,37.493715951805065,NaN,NaN,-37.75484303734127,-34.89518939193497
2008-10-16T09:30:00-04:00,15.91,16.7,15.15,16.7,19919328,16827773.7,37.59138322359577,31.050163946013008,NaN,NaN,-97.26621366704927,-105.02500293179116,-0.09671436072689343,-1.3168085495026247,-1.2200941887757313,-98604457,-97322699.8,8.702831322637138,33.78328627585562,NaN,NaN,-35.39568820209963,-34.96668922195849
2008-10-17T09:30:00-04:00,16.42,17.28999,16.12801,16.53999,15632402,17048603.95,36.88030492534636,31.550229390194662,NaN,NaN,-70.36286488097727,-85.14174161618173,-0.05212802062374999,-1.2852542145554189,-1.233126193931669,-114236859,-101640822.2,8.396520545206542,30.0286668197116,NaN,NaN,-33.848124160531704,-34.806894213183234
2008-10-20T09:30:00-04:00,16.8,17.2,16.38,17.2,18867456,17549317.75,41.77293199478672,31.742650855613842,NaN,NaN,-53.23286597245174,-79.00131834986963,0.031912942973824965,-1.1932350152143876,-1.2251479581882125,-95369403,-105472473.8,8.123302070489984,25.835371212718176,NaN,NaN,-30.923708707265174,-34.25215342662351
2008-10-21T09:30:00-04:00,16.92999,17.03999,16.2,16.3,10004918,17213208.4,37.503891871493025,31.711235907500846,NaN,NaN,-65.78769998891535,-78.84313489391931,0.03664880424718975,-1.1793369528792255,-1.2159857571264152,-105374321,-106421765,8.05338435025432,21.535266342292427,NaN,NaN,-29.90837163411072,-33.63161317055025
2008-10-22T09:30:00-04:00,16.14,16.14,15.05,15.45,11394859,17428738.85,33.972662250978686,31.747498544174313,NaN,NaN,-104.02051548610763,-78.13403199910024,-0.005463144741994608,-1.2228146880539086,-1.217351543311914,-116769180,-106070844,8.367362502932764,17.71897711522954,NaN,NaN,-30.268862159109066,-33.1512201689158
2008-10-23T09:30:00-04:00,15.53,15.88,14.8,15.8,18529744,17612380.95,36.61898384477445,32.0747781367027,NaN,NaN,-102.76711033224899,-79.23421133214019,0.001862832535016734,-1.215023002643143,-1.2168858351781597,-98239436,-105997839.8,8.43741198237737,14.8514001528383,NaN,NaN,-29.69127333015927,-32.65694204909344
2008-10-24T09:30:00-04:00,14.34,15.53,14.29,15.06,14136172,17485127.05,33.55669357230485,32.524639752000105,NaN,NaN,-126.12433670052215,-90.38650569604917,-0.029773994943992355,-1.2541033288581502,-1.2243293339141579,-112375608,-105625589.6,8.820170863188153,12.659002009301583,NaN,NaN,-30.20670924004028,-32.306908790657275
2008-10-27T09:30:00-04:00,14.9,15.5398,14.6,14.75,8752332,16896708.45,32.336719277658545,33.127004938550535,NaN,NaN,-118.24064663514967,-103.38806182858875,-0.05666404243654721,-1.295159386959842,-1.2384953445232947,-121127940,-110777297,8.302877642833806,11.09417687493607,NaN,NaN,-31.00478599576845,-32.1208912485303
2008-10-28T09:30:00-04:00,15.23,16.8,14.9609,16.8,12088910,16983790.85,46.25247607802341,34.76025611843319,NaN,NaN,-39.69392302987258,-98.1693064367802,0.07156955595360803,-1.1490333995812847,-1.2206029555348927,-109039030,-111510238.8,8.228933070157211,10.010950487500002,NaN,NaN,-26.82659169908555,-31.364562741466763
2008-10-29T09:30:00-04:00,16.55,16.87,16.12,16.14999,16558711,17138041.65,43.21744118121923,36.30807932866353,NaN,NaN,-18.699017936151478,-81.10500692678899,0.11783798123565759,-1.0733054789903207,-1.1911434602259783,-125597741,-113275951,8.043094461386431,9.278716849636305,NaN,NaN,-24.522325861375403,-30.38710033002514
2008-10-30T09:30:00-04:00,16.64999,16.91,16.27721,16.75,19154352,17552865.7,46.69458883684866,38.12760918829053,NaN,NaN,14.147621179266931,-57.7220606244858,0.18981153616454227,-0.9538790400203006,-1.1436905761848428,-106443389,-114916741.6,7.8653370654746055,8.81968851539766,NaN,NaN,-21.496013281988333,-29.116945037448456
2008-10-31T09:30:00-04:00,16.38,17.02,16.35001,16.64999,23454880,18072922.2,46.1869011612921,38.599912114112634,NaN,NaN,32.43374857025656,-26.010443570330057,0.22901733577342442,-0.8574189064680624,-1.0864362422414868,-129898269,-118421273.8,7.484842252589303,8.474049957294813,NaN,NaN,-19.288804109048655,-27.712924904819914
2008-11-03T09:30:00-05:00,16.69,16.84,16.52,16.64999,6774074,17392957.9,46.1869011612921,39.28386465110467,NaN,NaN,40.558610705157534,5.749407897731388,0.25149013608936777,-0.7720735721297771,-1.0235637082191449,-129898269,-120175339.6,7.294631412412102,8.240528711934314,NaN,NaN,-17.538030960219974,-26.259368627019924
2008-11-04T09:30:00-05:00,16.96001,17.45,16.84,17.35001,12224469,17260977.45,50.551271372026044,40.66593933940283,NaN,NaN,105.73550307345592,34.83529311839708,0.3063973994277305,-0.6405669589344818,-0.9469643583622123,-117673800,-121902293.6,7.103237328476851,8.087424062172639,NaN,NaN,-14.718763300647616,-24.610710723252453
2008-11-05T09:30:00-05:00,17.00999,17.14,16.2699,16.3,9040328,16497791.45,44.69572722884685,41.17339248263506,NaN,NaN,29.281716477439407,44.43144000111526,0.2663744584924814,-0.6139962852466105,-0.880370743739092,-126714128,-122125571,7.0773822126792965,7.971320554318505,NaN,NaN,-14.022210421883186,-23.098067823056844
2008-11-06T09:30:00-05:00,16.11,16.22,15.28,15.4,11912457,15936161.5,40.37837239896727,41.423254445036555,NaN,NaN,-78.32378677368003,25.93715841052587,0.17791533979718055,-0.6579765689926163,-0.8358919087897968,-138626585,-128562210.2,6.358817916841886,7.8257703665781735,NaN,NaN,-14.795912376019881,-21.912045616337277
2008-11-07T09:30:00-05:00,15.61,15.93,15.54,15.84,9216109,14820462.15,43.263778813531935,41.529743503518354,NaN,NaN,-61.96663848440288,7.057080999593985,0.14884470088804236,-0.6498360326797439,-0.7986807335677862,-129410476,-128464651.6,6.513746595163838,7.710802118340591,NaN,NaN,-14.543218029039592,-20.859355961009037
2008-11-10T09:30:00-05:00,16.22,16.22,15.48,15.668,6290137,14313213.9,42.399947509759905,41.87946176339456,NaN,NaN,-52.88798832023322,-11.632238805484166,0.11912588405347513,-0.6497733785009423,-0.7688992625544174,-135700613,-129625120.4,6.378558007597135,7.591171665293651,NaN,NaN,-14.594081373378556,-19.964316734204683
2008-11-11T09:30:00-05:00,15.58,15.63,15.13,15.33,15270383,13855897.05,40.68097558127205,42.35862700127266,NaN,NaN,-92.72367426249563,-51.32407427267448,0.07969346715884518,-0.669282428605861,-0.7489758957647061,-150970996,-136284559.6,5.653436831349609,7.397319831609141,NaN,NaN,-15.134438570311449,-19.274334139362793
2008-11-12T09:30:00-05:00,15.07,15.14,14.57,14.61,7418484,13332025.25,37.21940368788632,42.40151413292351,NaN,NaN,-138.66032959301862,-84.91248348676609,0.011679881272538828,-0.7343760441740326,-0.7460559254465714,-158389480,-142619630,5.06370454222855,7.156340728741368,NaN,NaN,-16.633747920519475,-18.89710753667089
2008-11-13T09:30:00-05:00,14.57,15.56,13.87,15.52,14719172,13072017.45,43.735803157536736,43.1285933890115,NaN,NaN,-101.55654504464464,-89.55903514095901,0.03331372814156197,-0.704413765269619,-0.7377274934111809,-143670308,-143628374.6,4.974717806889842,6.881665510434346,NaN,NaN,-15.978951755809318,-18.48022813940495
2008-11-14T09:30:00-05:00,15.17,15.57,14.7,14.81,11079945,12844394.6,40.227426944778756,43.69221536523437,NaN,NaN,-88.06271925283157,-94.77825129464475,0.006542222991405611,-0.7295497146719239,-0.7360919376633295,-154750253,-148696330,4.542785769342757,6.6130875194707,NaN,NaN,-16.49979283727776,-18.197308810529638
2008-11-17T09:30:00-05:00,14.56,14.88,14.33,14.39,9575648,12379804.2,38.27163911489115,43.122155582153496,NaN,NaN,-126.71651359772,-109.5439563501421,-0.0306732010415095,-0.7744334389652163,-0.7437602379237068,-164325901,-154421387.6,4.108783513547294,6.318791122569992,NaN,NaN,-17.525123771952885,-18.101282376447244
2008-11-18T09:30:00-05:00,14.45,14.67,14,14.59,8095902,12284353.4,39.77323952020702,42.87614117779548,NaN,NaN,-123.85598086885182,-115.77041767141334,-0.03284691507775406,-0.7848188817708994,-0.7519719666931454,-156229999,-155473188.2,4.032560027323925,6.032324377279813,NaN,NaN,-17.932279844681293,-18.077139157623538
2008-11-19T09:30:00-05:00,14.57,14.75,13.75,13.78,8251055,12127163.2,35.95813455179035,42.1092515860056,NaN,NaN,-135.25948892989527,-115.09024953878865,-0.07732419016927916,-0.8486272044047443,-0.7713030142354651,-164481054,-156691503,3.941352308243367,5.752039751763297,NaN,NaN,-19.436804252839448,-18.27137702836867
2008-11-20T09:30:00-05:00,13.57,14.24,13.08,13.19,19011680,12151260,33.44186214927352,41.198891656575704,NaN,NaN,-158.01446173212562,-126.38183287628485,-0.1317688220082166,-0.9360140417457359,-0.8042452197375193,-183492734,-164655988.2,3.399964996706757,5.460262804914543,NaN,NaN,-21.48322788135008,-18.73021286450887
2008-11-21T09:30:00-05:00,13.35,13.89,12.94,13.89,20149136,12451908.2,38.904477217713854,40.678718517748685,NaN,NaN,-135.88772993395065,-135.94683501250867,-0.10698160826592251,-0.9379722300699225,-0.830990621804,-163343598,-166374657.2,3.2947906417797697,5.174559892726521,NaN,NaN,-21.596473513497905,-19.139678671507305
2008-11-24T09:30:00-05:00,14.17,14.91,14.05,14.57,11938406,12611211.9,43.735401347286874,40.191870658838745,NaN,NaN,-64.39135381115156,-123.481803055195,-0.034865315943499064,-0.8745722667333737,-0.8397069507898747,-151405192,-163790515.4,7.9076250544917315,5.232016158870441,NaN,NaN,-20.212092291037646,-19.292880617154495
2008-11-25T09:30:00-05:00,14.89,15.06,14.29,14.77,12861660,12649849.4,45.11013560662566,40.221471257251515,NaN,NaN,-45.55051167217816,-107.82070921586026,0.03258245718134689,-0.7989788793131911,-0.831561336494538,-138543532,-160253222,13.95781295117763,5.723475497334607,NaN,NaN,-18.675966451358473,-19.204750022040777
2008-11-26T09:30:00-05:00,14.39,15.28,14.36,15.23,8758336,12259830.65,48.24248001926376,40.78319323012983,NaN,NaN,-23.51626903761493,-85.47206523740418,0.11008669977995589,-0.6939529617695932,-0.8040396615495491,-129785196,-153314050.4,24.44437686467171,7.015301136465309,NaN,NaN,-16.45066576727789,-18.811309414217508
2008-11-28T09:30:00-05:00,14.97,15.33,14.97,15.25,1859635,11395094.8,48.38040685565414,41.14866666170999,NaN,NaN,-1.1487804336358511,-54.09892897770622,0.16150056021500225,-0.6021639612807963,-0.7636645214957986,-127925561,-142200615.8,37.5680154462211,9.233463197255114,NaN,NaN,-14.59930915610778,-18.209595091630405
2008-12-01T09:30:00-05:00,14.97,14.98,14.14,14.15,6297941,10537247.85,41.784980266210866,41.10474043002792,NaN,NaN,-58.68541268719133,-38.65846552835437,0.12202239912252577,-0.6111365225926413,-0.7331589217151671,-134223502,-136376596.6,43.14167823588948,11.85940035641885,NaN,NaN,-14.84285105838263,-17.728631658309293
2008-12-02T09:30:00-05:00,14.41,14.71,14.15,14.65,8004504,10598769.35,45.426771326201575,41.44372584038002,NaN,NaN,-46.767522100046484,-35.13369918613335,0.12947453862477487,-0.5713157484341984,-0.7007902870589733,-126218998,-131339357.8,47.50675045338605,14.848922757992883,NaN,NaN,-13.966678570433244,-17.191209788612714
2008-12-03T09:30:00-05:00,14.34,15.1,14.3,15.07,9659816,10470536.7,48.34969093285919,42.238746357878085,NaN,NaN,-4.030195207529107,-26.829635893203545,0.16055051611305926,-0.5001021419176492,-0.6606526580307085,-116559182,-126942487.8,51.04000199049693,18.132944004297766,NaN,NaN,-12.364550859850002,-16.501687084503754
2008-12-04T09:30:00-05:00,14.76,15.06,14.25,14.46,10062441,10521642.35,44.6123910246682,42.301359776958904,NaN,NaN,-23.709036158754834,-26.868189317431522,0.1387062826561949,-0.4872698047104649,-0.6259760873666598,-126621623,-126309773.2,51.545424760169105,21.459423072389143,NaN,NaN,-12.090301188518852,-15.871489099363053
2008-12-05T09:30:00-05:00,14.31,15.07,14.02,15.03,10401660,10446102.5,48.60976307786459,42.900098072179325,NaN,NaN,-0.7764116753612001,-26.793715565776587,0.15982650065673343,-0.42619296154574293,-0.5860194622024764,-116219963,-123968653.6,53.45986358019611,24.953500058878667,NaN,NaN,-10.657815222782592,-15.126678545565845
2008-12-08T09:30:00-05:00,15.39,15.94,15.27,15.73,9407109,10455652.5,53.08749835606063,43.958373732262864,NaN,NaN,149.42528735631774,14.828424442925222,0.2147008671156575,-0.31764337830790446,-0.532344245423562,-106812854,-118486524,57.676786980886575,28.779786020831473,NaN,NaN,-8.044455141599327,-14.1149323449992
2008-12-09T09:30:00-05:00,15.49,16.08,15.45,15.63,8168270,10549559.15,52.385277558934575,44.85923359217197,NaN,NaN,162.82789507357242,56.747507877649,0.23631159717659883,-0.23695474895281343,-0.47326634612941226,-114981124,-116238949.2,59.304810500183024,32.72780391174998,NaN,NaN,-6.1290929280056545,-12.97409814257155
2008-12-10T09:30:00-05:00,15.7,15.88,15.41,15.5,6983195,10135199.75,51.43281102824542,45.96456762620448,NaN,NaN,137.31436124717501,85.01641916858982,0.2334873223417619,-0.18140719320220988,-0.4148945155439718,-121964319,-117319976.6,58.146270220681025,36.59958376263838,NaN,NaN,-4.810490623190571,-11.807868496945696
2008-12-11T09:30:00-05:00,15.38,15.68,15.07,15.17,17680880,10648319.55,48.99741863251398,47.075678803578796,NaN,NaN,82.42971156877883,106.24416871409656,0.20220001537591614,-0.16214449632407657,-0.3643445116999927,-139645199,-119924691.8,55.34098928991627,40.30965692643906,NaN,NaN,-4.355091371552293,-10.743186050460924
2008-12-12T09:30:00-05:00,14.73,15.55,14.71,15.35,7851078,10304914.85,50.37764186080999,47.89519056379994,NaN,NaN,64.09529211570637,119.21850947231007,0.18679891743299998,-0.13084586490874273,-0.3176447823417427,-131794121,-123039523.4,52.103696052930744,43.79600731294985,NaN,NaN,-3.597932766243312,-9.72243558128698
2008-12-15T09:30:00-05:00,15.49,15.49,14.95,15.18,5570133,10029424.25,49.028169623428305,48.27324544066719,NaN,NaN,61.98643612711548,101.73073922646964,0.1594004036873739,-0.11839427773252531,-0.2777946814198992,-137364254,-129149803.4,46.372951112710744,46.543530602822635,NaN,NaN,-3.311582439849745,-8.806599418224518
2008-12-16T09:30:00-05:00,15.31,15.97,15.26,15.97,9825570,10041920.35,55.053548774058235,48.983489238340944,NaN,NaN,117.6546391752537,92.69608804680588,0.18682006901118692,-0.04426959515591555,-0.23108966416710247,-127538684,-131661315.4,44.220066431610974,48.7051201371393,NaN,NaN,-1.3467518228172652,-7.740906904594911
2008-12-17T09:30:00-05:00,15.7,15.891,15.44,15.66,8562863,10065268.4,52.43423013762419,49.282899961080965,NaN,NaN,96.58434051497224,84.55008390036532,0.17653609187947122,-0.010419549317763455,-0.18695564119723468,-136101547,-134488761,41.863728257220416,49.94935952232135,NaN,NaN,-0.40079693024558727,-6.69231976540215
2008-12-18T09:30:00-05:00,15.71,15.74,15.15,15.22,8843098,10094870.55,48.879509167732664,49.31855012622945,NaN,NaN,54.55382465899441,78.97490651840846,0.13446064741300714,-0.018879831930975755,-0.1533404793439829,-144944645,-135548650.2,40.982144060390404,50.19322585190487,NaN,NaN,-0.5864098365725857,-5.820046918426498
2008-12-19T09:30:00-05:00,15.42,15.61,15.27,15.27,17321056,10010339.35,49.30013835577896,49.85534713262716,NaN,NaN,50.03604569596934,76.16305723446105,0.10562878370611178,-0.021304499711343183,-0.12693328341745497,-127623589,-134714543.8,42.01698208835952,50.11289041279559,NaN,NaN,-0.6263966173888242,-5.078096875421116
2008-12-22T09:30:00-05:00,15.29,15.35,14.8,15.06,7907977,9398281.4,47.531182546475186,50.005662219789556,NaN,NaN,-8.03977479141214,62.15781505075553,0.06977581182926466,-0.039713518630874134,-0.1094893304601388,-135531566,-134348006.2,42.494162542243146,49.75484841914253,NaN,NaN,-1.1372475923747076,-4.515118406414487
2008-12-23T09:30:00-05:00,15.19,15.27,14.84,14.85,5588738,9080798,45.762839602302655,49.8208871247498,NaN,NaN,-29.148271623250817,32.797232891054605,0.03124258421361613,-0.07043610019311863,-0.10167868440673476,-141120304,-137064330.2,39.87518223270526,48.957361293585976,NaN,NaN,-2.0498927883660567,-4.1629433181218545
2008-12-24T09:30:00-05:00,14.99,15.02,14.92,14.95,1663216,8520875.8,46.778251852672014,49.97559146960722,NaN,NaN,-37.5907490399658,5.962214980067,0.012761667305150035,-0.08572660027529722,-0.09848826758044725,-139457088,-137735438.4,39.231846949506526,48.077820021395794,NaN,NaN,-2.5663445675300456,-3.9348577823230246
2008-12-26T09:30:00-05:00,15.01,15.07,14.93,14.93,2123628,8189140.4,46.590382297152864,49.83134998527067,NaN,NaN,-35.2474171288983,-11.998033377511542,0.00013074439341166644,-0.09832483708868267,-0.09845558148209434,-141580716,-137062652.6,40.272198629116254,47.13584395346152,NaN,NaN,-3.0511974010006644,-3.808620584991259
2008-12-29T09:30:00-05:00,15.07,15.07,14.72,14.94,3008119,8246564.6,46.70563427992548,49.375502551261015,NaN,NaN,-44.43475029487095,-30.892192575679605,-0.006257149842138862,-0.10627701878476792,-0.10001986894262906,-138572597,-139252454.2,37.99231574954673,45.7298102940801,NaN,NaN,-3.437735146678209,-3.7556369509465375
2008-12-30T09:30:00-05:00,14.98,15.27,14.98,15.22,4272863,8145310.7,49.96156650547826,49.202380333156995,NaN,NaN,-4.163275640685746,-30.116892745534322,0.008847859861252166,-0.08896004411606384,-0.09780790397731601,-134299734,-139006087.8,38.41473664429778,44.23766216151687,NaN,NaN,-2.984332492788533,-3.645450599781108
2008-12-31T09:30:00-05:00,15.28,15.59,15.21,15.41,4138617,7952016.35,52.10006635063679,49.25004142761352,NaN,NaN,42.89662927070103,-15.707912566743953,0.030868619992381524,-0.059222128986839095,-0.09009074897922062,-130161117,-136814250.4,42.188100277204796,43.09779287983999,NaN,NaN,-2.050117004491331,-3.4175458004539974
2009-01-02T09:30:00-05:00,15.5,16.07001,15.38,15.99,4479938,7693022.45,58.00079523863388,49.893139756622084,NaN,NaN,123.39894131074533,16.49002550339827,0.08088820693745953,0.01101950969260379,-0.06986869724485574,-125681179,-134059068.6,46.61592282395666,42.47457384655717,NaN,NaN,0.4340988504611944,-2.8673108503232556
2009-01-05T09:30:00-05:00,15.89,16.035,15.72,15.94,6265938,7503197.3,57.34496306123126,50.39080555665218,NaN,NaN,130.63187586677662,49.665884102533255,0.1054453179102556,0.06193795014296377,-0.04350736776729184,-131947117,-132132348.8,49.52719868196085,42.29053832005932,NaN,NaN,2.358093503272698,-2.120824514095262
2009-01-06T09:30:00-05:00,16.12,16.45,16.03999,16.31,8426824,7404455.5,60.870903679306,51.23671513207201,NaN,NaN,187.74691086259722,96.10221633402689,0.13931880549236814,0.13064113909816832,-0.008677666394199805,-123520293,-129121888,53.76948029217507,42.8188618328782,NaN,NaN,5.056466324391126,-1.0954972514543497
2009-01-07T09:30:00-05:00,16.06,16.06,15.67,15.79,6210930,7244646.55,54.10219448660594,51.16876125439684,NaN,NaN,88.31552464946992,114.59797639205802,0.12014065671592172,0.14149815450070236,0.02135749778478063,-129731223,-128208185.8,55.00559001838165,43.589256374790395,NaN,NaN,5.596630509465756,-0.13947899989433465
2009-01-08T09:30:00-05:00,15.68,15.93,15.59,15.9,5710730,7121769.55,55.23615393738398,51.3688986686654,NaN,NaN,79.02310836738882,121.82327221139558,0.1086474236466827,0.157166777343134,0.0485193536964513,-124020493,-126980061,56.68214464650539,44.64771468831075,NaN,NaN,6.363631634792793,0.7895368050609693
2009-01-09T09:30:00-05:00,15.9,15.94,15.49,15.55,3942755,6969747.55,50.924971139821785,51.51500309524319,NaN,NaN,47.212718303851226,106.58602761001676,0.07296968631859013,0.13973146159468897,0.06676177527609883,-127963248,-127436474.8,55.849273862778965,45.7096525313385,NaN,NaN,5.808427302554709,1.5065211618457894
2009-01-12T09:30:00-05:00,15.6,15.6,15.15,15.27,5129570,6342182.05,47.716374563169275,51.40187711005678,NaN,NaN,-19.16470052569148,76.62671233152314,0.02830477999002748,0.10214275026363318,0.0738379702736057,-133092818,-127665615,55.409084511308656,46.66623127583487,NaN,NaN,4.400105982490599,1.9198904219379052
2009-01-13T09:30:00-05:00,15.32,15.41,15.08,15.2,8654102,6382333.25,46.920451302564715,51.358253449777465,NaN,NaN,-42.34671982502755,30.607986193998194,-0.006314504479988936,0.06594483967361953,0.07225934415360846,-141746920,-131310940.4,48.8171334736155,47.11787205664717,NaN,NaN,3.005429051210522,2.0749673689768504
2009-01-14T09:30:00-05:00,15.03,15.11,14.66,14.74,8513285,6529490.85,41.966507647001414,51.087086881541666,NaN,NaN,-114.88480421348449,-10.032079578592686,-0.05769708454341673,0.00013798847433754702,0.05783507301775428,-150260205,-135416736.8,42.660977782439616,47.31685745305678,NaN,NaN,0.28561886338568204,1.8193461538923978
2009-01-15T09:30:00-05:00,14.73,14.97,14.37,14.84,7652234,6420824.05,43.36638509504398,50.84338211313967,NaN,NaN,-123.21399852038417,-50.47950095614728,-0.08102361870869423,-0.04344445036811351,0.03757916834058072,-142607971,-139134232.4,37.98964992784753,47.22812909436684,NaN,NaN,-1.5934648988544853,1.3318017177857002
2009-01-16T09:30:00-05:00,15.12,15.16,14.63,14.94,7446367,6364999.25,44.80033003309993,50.71552123713588,NaN,NaN,-79.33792666509008,-75.78962994993553,-0.08535768215829699,-0.06911793435729052,0.01623974780100647,-135161604,-140573903.6,36.33052621951991,46.94658106510996,NaN,NaN,-2.7878551159984055,0.7432793129593994
2009-01-20T09:30:00-05:00,14.91,14.98,14.3,14.33,16858080,6765748.35,38.41134053476112,50.12307168390986,NaN,NaN,-130.0520121241106,-97.96709226961936,-0.12267642802770871,-0.13710578723362943,-0.01442935920592071,-152019684,-144359276.8,32.33219525638761,46.54228674417003,NaN,NaN,-5.8326143459023,-0.19613406687798618
2009-01-21T09:30:00-05:00,14.68,15.03,14.45,15.02,5863152,6192853.15,47.527048314584334,49.94917752741743,NaN,NaN,-71.49266705925727,-103.7962817164653,-0.09547045613626118,-0.1337674293762472,-0.03829697323998601,-146156532,-145241199.2,31.463396853856977,46.04576247342425,NaN,NaN,-5.709255283474026,-0.9837228121059918
2009-01-22T09:30:00-05:00,14.7,14.93,14.44,14.68,7492922,6172100.4,44.065999104481946,49.375315581263514,NaN,NaN,-89.96572477262782,-98.81246582829397,-0.09476242045707671,-0.1567499988113319,-0.06198757835425518,-153649454,-145919049,30.7788179064613,45.23081373265686,NaN,NaN,-6.717730939944517,-1.8028668303686382
2009-01-23T09:30:00-05:00,14.41,15.16,14.39,14.89,7437398,6264533.4,46.65019157325957,48.56455817659393,NaN,NaN,-66.39329033628427,-87.44832419147399,-0.07538419642127979,-0.15621782388085492,-0.08083362745957513,-146212056,-146639866,30.03054944421089,44.046144205532165,NaN,NaN,-6.738190374467572,-2.5079130509542003
2009-01-26T09:30:00-05:00,14.98,15.35,14.94,15.07,7342754,6548510.3,48.83233100798479,47.95651302993347,NaN,NaN,-19.090345700973472,-75.39880799865065,-0.04706241263239902,-0.1396616432500739,-0.09259923061767489,-138869302,-147381405.6,29.242922986423835,42.59726737013666,NaN,NaN,-6.0907666125271005,-3.019749274036043
2009-01-27T09:30:00-05:00,15.12,15.33,15.01,15.16,6140555,6749356.65,49.93498355346911,47.17537587808797,NaN,NaN,-13.327294188702046,-52.05386441156895,-0.020255978547023684,-0.11791920380145449,-0.0976632252544308,-132728747,-143523218.2,38.30887401295563,41.49293835019241,NaN,NaN,-5.237547246619041,-3.3365775558336144
2009-01-28T09:30:00-05:00,15.39,15.78,15.31,15.59,7137852,6955843.3,54.93211588363691,47.234655977875896,NaN,NaN,45.8776368714637,-28.57980362542478,0.025939599301585653,-0.06523872612744874,-0.0911783254290344,-125590895,-139410090.8,46.21999219441453,40.86539564848049,NaN,NaN,-2.964306111567264,-3.2833959209384216
2009-01-29T09:30:00-05:00,15.45,15.45,15.06,15.13,5074855,6995942.9,49.266907971453904,46.80828126602374,NaN,NaN,-11.476480087969593,-12.881954688493133,0.025009425913887842,-0.0599165430366746,-0.08492596895056244,-130665750,-134813350,53.4105889301324,40.63171309731098,NaN,NaN,-2.7236499318549687,-3.203432208212214
2009-01-30T09:30:00-05:00,15.21,15.21,14.68,14.68,5075426,7042783.35,44.43865720211017,46.34497312761577,NaN,NaN,-64.23261680487828,-12.449819982211938,-0.004828319047558816,-0.09096136776001096,-0.08613304871245214,-135741176,-132719174,56.27863194744929,40.66238153193029,NaN,NaN,-4.0591046812834195,-3.3256711329366717
2009-02-02T09:30:00-05:00,14.6,15.11,14.56,14.91,4930945,7065333.7,47.282398968191735,46.31397487083166,NaN,NaN,-58.81317049952538,-20.394384941922322,-0.007813609831499188,-0.09590006100182613,-0.08808645117032694,-130810231,-131107359.8,58.401219077830575,40.876105429539,NaN,NaN,-4.27563536661246,-3.46138030917607
2009-02-03T09:30:00-05:00,14.98,15.28,14.7872,15.21,6327211,7068397.35,50.81829210803566,46.59239207122244,NaN,NaN,-14.024244234445417,-20.533774951070995,0.010673236584961249,-0.07474490543912538,-0.08541814202408662,-124483020,-129458214.4,60.513488003344555,41.71155932451965,NaN,NaN,-3.3597699170955675,-3.4468645388788555
2009-02-04T09:30:00-05:00,15.25,15.64,15.17,15.2,5782922,6936202.25,50.6962295178728,47.215943633427536,NaN,NaN,46.91018408894824,-20.32726550757409,0.021841489328365896,-0.05811628036362926,-0.07995776969199515,-130265942,-130393223.8,58.693777180324886,42.85675928151145,NaN,NaN,-2.6622635203609972,-3.33477867909059
2009-02-05T09:30:00-05:00,15.03,15.63,14.99,15.44,8969445,7074128,53.57814307458907,47.94535491768075,NaN,NaN,60.67514939374385,-5.8969396112313985,0.04374176586090593,-0.025280562365862735,-0.06902232822676867,-121296497,-128519373.2,61.21122198931923,44.515443000188,NaN,NaN,-1.2249494902666331,-3.0333745092585964
2009-02-06T09:30:00-05:00,15.56,16.11,15.51,15.97,7666906,7171936.8,59.243726010837676,48.97702605894774,NaN,NaN,178.82626579560554,42.714836908865365,0.0896280444809732,0.043012727374447834,-0.04661531710652536,-113629591,-124097056.2,66.41365826073756,46.66423814598925,NaN,NaN,1.8292437520717015,-2.3387147576399823
2009-02-09T09:30:00-05:00,16.00999,16.14,15.89,16.00999,4606891,7205143.6,59.64393890926947,50.493640228555485,NaN,NaN,197.55362874176694,93.98819675712382,0.11666727608412393,0.09921877799862955,-0.01744849808549438,-109022700,-119739550,70.5981958885825,49.39752390543174,NaN,NaN,4.412728299561,-1.3742228923255562
2009-02-10T09:30:00-05:00,15.95,16.08,15.27,15.36,8825000,7389915.1,50.89575123044426,50.73426186540262,NaN,NaN,93.4501685922165,115.4830793224562,0.08617728254172748,0.09027310509166497,0.004095822549937494,-117847700,-118412486,71.75245681351115,52.2753139025499,NaN,NaN,4.0459793678542155,-0.599908283728446
2009-02-11T09:30:00-05:00,15.35,15.53,15.2,15.39,5678461,7241133.05,51.251149588080004,51.247486899945336,NaN,NaN,49.04926648361692,115.91089580138994,0.06442637880880786,0.08462879606094731,0.020202417252139455,-112169239,-114793145.4,74.67283359982042,55.41060073778983,NaN,NaN,3.85857088130565,0.037017311276424936
2009-02-12T09:30:00-05:00,15.25,15.495,15,15.46,5786043,7104770.95,52.12190203373908,51.638323361408155,NaN,NaN,33.311991206404464,110.43826416392207,0.05169905138279231,0.08482623148062984,0.033127180097837536,-106383196,-111810485.2,76.80136313649305,58.75137314438142,NaN,NaN,3.9524493147498756,0.5963647403440607
2009-02-13T09:30:00-05:00,15.44,15.7,15.39,15.39,3917162,6918017.35,51.13820694317126,51.803028785350044,NaN,NaN,63.202660839866745,87.31354317277432,0.03624240877458781,0.0784301910660723,0.04218778229148449,-110300358,-111144638.6,77.2607974191819,62.18122131814984,NaN,NaN,3.758862589163023,1.0481501473181982
2009-02-17T09:30:00-05:00,15,15.04,14.75,14.75,6237898,6857593.9,43.12453918293647,51.31656847316914,NaN,NaN,-73.92944772426435,33.01692787956806,-0.016573325124528034,0.02147112588582445,0.03804445101035248,-116538256,-112647749.8,73.71184777015866,64.71000515795006,NaN,NaN,1.1275395225143383,1.0594914866319325
2009-02-18T09:30:00-05:00,14.96,15,14.64,14.76,6663418,6347860.8,43.27411858705935,50.483854380556465,NaN,NaN,-90.40836390800878,-3.7547786204769977,-0.04851707019218639,-0.022601886729880505,0.025915183462305882,-109874838,-111053177.4,75.02261459786413,66.76733532962503,NaN,NaN,-0.950391198622182,0.7723653887384876
2009-02-19T09:30:00-05:00,14.91,14.91,14.39,14.4,6833371,6396371.75,39.27010019369135,49.76979668214485,NaN,NaN,-133.21535449215185,-40.207702815630746,-0.08920606851249296,-0.08559240217831032,0.0036136663341826414,-116708209,-111960971.4,72.79721555131034,68.15209437399488,NaN,NaN,-3.985671255928492,0.09264586807177622
2009-02-20T09:30:00-05:00,14.25,14.64,14.21,14.54,12284578,6635954.55,41.53562771554038,49.56243743310415,NaN,NaN,-147.62616080297948,-76.39533321750754,-0.10113128703701375,-0.12280044246208455,-0.021669155425070797,-104423631,-111569058.4,73.16727166257988,69.3584257822185,NaN,NaN,-5.874411425957835,-0.7597908882181682
2009-02-23T09:30:00-05:00,14.6,14.62,13.83,13.87,14199605,6974064.9,34.83760625740494,48.67352366804795,NaN,NaN,-191.58982313082865,-127.35383001164662,-0.14586459500440188,-0.20399989918057315,-0.05813530417617127,-118623236,-113233634,68.88125542018358,70.10699980667229,NaN,NaN,-9.794006618390563,-2.050393135385653
2009-02-24T09:30:00-05:00,13.99,14.4399,13.9,14.24,8190680,7016461.2,40.54006067879139,47.93936428024479,NaN,NaN,-146.5430568994115,-141.87655184667605,-0.14211355862656855,-0.23577725245938197,-0.09366369383281342,-110432556,-112012494,70.25769814604567,70.80301481686523,NaN,NaN,-11.311715468793546,-3.373439183015352
2009-02-25T09:30:00-05:00,14.3,14.63,14.01,14.37,18432128,7631039.85,42.44581967161991,47.35004929122672,NaN,NaN,-106.86528733950288,-145.16793653297486,-0.12316244380572336,-0.24761674858996763,-0.12445430478424427,-92000428,-108437612,73.89765723561499,71.88900624938596,NaN,NaN,-11.953753532452307,-4.59919837579206
2009-02-26T09:30:00-05:00,14.44,14.69,14.2,14.22,7070918,7627693.15,40.820083765092264,46.43875934054838,NaN,NaN,-91.23062675330745,-136.77099098520597,-0.11326589679170371,-0.2660366757738739,-0.1527707789821702,-99071346,-104910239.4,76.90151724214277,73.00974162458763,NaN,NaN,-12.969681701432108,-5.794981708026352
2009-02-27T09:30:00-05:00,14.05,14.41,14.03,14.12,6972445,7722572.65,39.72763467807428,45.04475281677957,NaN,NaN,-104.63369386791712,-128.1724975981935,-0.10611433172961104,-0.285413693644184,-0.17929936191457296,-106043791,-105234271.4,76.0358719357097,73.69704260137135,NaN,NaN,-14.124023410777745,-6.984844808419409
2009-03-02T09:30:00-05:00,13.94,14.18,13.67,13.78,7345195,7836061.1,36.18207808790306,43.368905615253404,NaN,NaN,-128.7359691912202,-115.60172681027181,-0.1161325483233088,-0.32446504731870895,-0.20833249899540016,-113388986,-104187421.4,76.93903023281695,74.14995934024525,NaN,NaN,-16.192108774894745,-8.3001682322016
2009-03-03T09:30:00-05:00,13.87,13.9499,13.58,13.65,7444746,7961751.15,34.899567735668384,42.22632107991227,NaN,NaN,-128.098180860016,-111.9127516023927,-0.12272088098621331,-0.3617336002281668,-0.2390127192419535,-120833732,-106267656.6,71.19686381768264,74.11027412625751,NaN,NaN,-18.288725606589885,-9.727104999971354
2009-03-04T09:30:00-05:00,13.92,14.27,13.84,14.01,6412934,7966037.3,41.123348771221025,41.50290673585091,NaN,NaN,-82.82523793430492,-107.10474172135312,-0.09526369658199224,-0.3580923399694438,-0.26282864338745154,-114420798,-110751730.6,60.68343793289958,73.1110315786203,NaN,NaN,-18.288532892226236,-10.950166127436336
2009-03-05T09:30:00-05:00,13.84,14.04,13.55,13.58,6954301,8024606.25,36.61996465549242,40.39562549454757,NaN,NaN,-105.6648741729104,-109.99159120527372,-0.09810562181026161,-0.38546067065027856,-0.28735504884001695,-121375099,-115212481.2,52.39466377877611,71.36769591021195,NaN,NaN,-19.67994827282653,-12.197277862492077
2009-03-06T09:30:00-05:00,13.81,13.86,13.17,13.65,23331568,8742712.4,37.81383876720118,39.443884910549706,NaN,NaN,-112.19375461104272,-111.50360335389882,-0.08765702908268996,-0.3969263351933794,-0.3092693061106894,-98043531,-113612429.2,54.78058399179969,69.76196637968465,NaN,NaN,-20.45326961461504,-13.3767052556525
2009-03-09T09:30:00-04:00,13.37,13.67,13.08,13.22,9427488,8830741.5,33.62388656504994,38.765266866414954,NaN,NaN,-129.55086453358777,-111.66658242237236,-0.10113497348513634,-0.43568802296710984,-0.3345530494819735,-107471019,-112428835.8,56.51668906360145,68.5337407577877,NaN,NaN,-22.43335435761599,-14.670512270218712
2009-03-10T09:30:00-04:00,13.35,14.04,13.31,13.98,24772864,9839040.15,45.184733485960344,38.9017393591936,NaN,NaN,-75.20763669433279,-101.08847358923572,-0.05272954470470825,-0.4004649803628588,-0.34773543565815057,-82698155,-104801720.4,65.66482796780772,67.86532742706939,NaN,NaN,-20.330096181816444,-15.479024257589817
2009-03-11T09:30:00-04:00,14.19,14.44,14.04,14.29,14230090,10109294.65,49.08051521972726,39.602483289624736,NaN,NaN,-8.516429018061405,-86.22671180598702,0.0033279235242581473,-0.3435755312528279,-0.34690345477708606,-68468065,-95611173.8,73.02832039771987,67.88183491609864,NaN,NaN,-17.288939060356856,-15.737583515127966
2009-03-12T09:30:00-04:00,14.37,14.75,14.19,14.7,8089141,10229828.65,53.76117155166187,40.47573642077627,NaN,NaN,42.40917664371058,-56.611901642662815,0.06761709809067584,-0.26238208216374126,-0.3299991802544171,-60378924,-83411938.8,79.35677983438697,68.32394264265629,NaN,NaN,-13.143760923160846,-15.367037430561235
2009-03-13T09:30:00-04:00,14.74,14.8,14.5,14.7,6735676,10277310.3,53.76117155166187,41.82741965608034,NaN,NaN,72.11342882187625,-19.750464956079025,0.10737624674183799,-0.19577887182711962,-0.3031551185689576,-60378924,-75879017.4,82.14299221993817,69.27120955692448,NaN,NaN,-9.929072732970837,-14.590185330905463
2009-03-16T09:30:00-04:00,14.82,14.9,14.52,14.57,4901133,10326508.85,52.00331807821627,42.646223756039255,NaN,NaN,87.92618188625165,23.74494432788886,0.12113518162111492,-0.15173614154256398,-0.2728713231636789,-65280057,-67440825,84.6433587842424,70.2987567453671,NaN,NaN,-7.825513852260274,-13.623803691099008
2009-03-17T09:30:00-04:00,14.61,15.11,14.53,15.1,5677523,10298490.1,58.0286877331006,43.75928576043073,NaN,NaN,133.61558746891572,65.50958916053857,0.15971998665170278,-0.07322133984905044,-0.23294132650075322,-59602534,-62821700.8,85.8143138795711,71.14994650564968,NaN,NaN,-4.012908154787297,-12.25081861448305
2009-03-18T09:30:00-04:00,15.01,15.56,14.9499,15.31,10645078,10497573.1,60.162670029948366,45.14089906506331,NaN,NaN,184.67527761697318,104.1479304875455,0.19105680031876865,0.005879673897707605,-0.18517712642106104,-48957456,-58919579,86.73453529550295,71.85230493803256,NaN,NaN,-0.1977107535364541,-10.52894606291925
2009-03-19T09:30:00-04:00,15.59,15.64,15.24,15.35,6230758,10467442.45,60.57386505190657,46.62991552033704,NaN,NaN,180.53163904763198,131.77242296832978,0.20492352591830457,0.07097728097681966,-0.1339462449414849,-42726698,-55389133.8,87.52314216091588,72.672824239833,NaN,NaN,2.9931824972436183,-8.597213411467411
2009-03-20T09:30:00-04:00,15.34,15.47,14.9491,15.04,5265914,10116509.25,55.769451487972255,48.029013620341985,NaN,NaN,123.23898283240761,141.99753377043606,0.18431017759583537,0.0964414770533093,-0.08786870054252607,-47992612,-52911871.4,88.05953922377813,73.46714631061595,NaN,NaN,4.336606165875006,-6.7495249004184945
2009-03-23T09:30:00-04:00,15.41,15.93,15.26,15.93,5424910,9677774.5,64.47992829527985,50.1418965174571,NaN,NaN,167.75369585692638,157.96303656457098,0.21932708911443835,0.18629016085052186,-0.03303692826391649,-42567702,-48369400.4,88.9939096295056,74.7383638686033,NaN,NaN,8.573933167247832,-4.560459462180448
2009-03-24T09:30:00-04:00,15.79,15.94,15.66,15.67,5979820,9567231.5,60.718044269010235,51.541517624442044,NaN,NaN,145.65185177468462,160.37028942572476,0.21348612120797555,0.23382072324605296,0.020334602038077396,-48547522,-46158398,89.42757460812945,76.79151648826257,NaN,NaN,10.780846295849312,-2.368844353890483
2009-03-25T09:30:00-04:00,15.83,16,15.34,15.76,9481305,9119690.35,61.55419327919623,53.3225339547066,NaN,NaN,120.3135550973689,147.4979449218039,0.20419202349808843,0.27557463141068794,0.07138260791259951,-39066217,-44180150.2,89.81428767240737,79.4643467663791,NaN,NaN,12.796412744415067,-0.20237905413254742
2009-03-26T09:30:00-04:00,15.98,16.21001,15.82,16.17,8387211,9185505,65.18939245936281,55.277930647003856,NaN,NaN,135.297102326359,138.4510375775493,0.21317704038167778,0.33785390838969676,0.12467686800801896,-30679006,-41770611.8,90.280614977195,82.0000632653359,NaN,NaN,15.687780512855042,2.067643741151394
2009-03-27T09:30:00-04:00,16.03,16.03999,15.79,15.82,6294434,9151604.45,59.97594275876184,57.16022037512614,NaN,NaN,104.35006863287124,134.67325473764203,0.1841607446373511,0.3548777988047078,0.17071705416735672,-36973440,-39566777.4,90.69999931628271,84.44172828338456,NaN,NaN,16.472707635361434,4.125510011752828
2009-03-30T09:30:00-04:00,15.57,15.5724,15.18,15.33,6392699,9103979.65,53.522421737051616,57.75576953591837,NaN,NaN,52.24680120031345,111.57187580631944,0.12349283199229424,0.3250830941577245,0.20159026216543027,-43366139,-39726464.8,90.39563253913734,86.20821432419382,NaN,NaN,15.029446870012064,5.683215277218434
2009-03-31T09:30:00-04:00,15.57,15.92,15.52,15.62,5039035,8983694.1,56.50534536150472,58.28611454604533,NaN,NaN,74.238851187754,97.28927568893333,0.09566292393104014,0.32116891707923045,0.2255059931481903,-38327104,-37682381.2,90.8202833197405,87.47906881862386,NaN,NaN,14.789601743981681,6.984127629613183
2009-04-01T09:30:00-04:00,15.44,16.08,15.4,16.06,6063352,8966215,60.63357615386334,58.77700058905972,NaN,NaN,81.26936967326499,89.48043860411255,0.09922874515075158,0.3495419245866298,0.2503131794358782,-32263752,-36321888.2,91.10226756344068,88.31803222784198,NaN,NaN,15.925048978644348,8.261402108046207
2009-04-02T09:30:00-04:00,16.35001,16.83,16.25999,16.48,7322898,8984644.85,64.13305789000576,59.51784961322714,NaN,NaN,132.8718858369884,88.99539530623844,0.12078335934838103,0.4012923786213545,0.28050901927297345,-24940854,-35174257.8,91.3438204526114,88.97523424446149,NaN,NaN,18.03038761701054,9.656971466469683
2009-04-03T09:30:00-04:00,16.53,16.78,16.44,16.71001,15089887,8572560.8,65.91980054690922,60.51188407527663,NaN,NaN,136.57140209744153,95.4396619991525,0.140083064333552,0.45561284968991345,0.31552978535636145,-9850967,-29749763.2,92.39478126894664,89.52890727908323,NaN,NaN,20.31466599169606,11.179499255787736
2009-04-06T09:30:00-04:00,16.55,16.63,16.25999,16.53999,15326965,8867534.65,63.40541439218935,60.89593597949726,NaN,NaN,115.3140925295099,108.0531202649918,0.13110945578614341,0.4794166050890407,0.3483071493028973,-25177932,-26112121.8,93.00785924703236,90.0427319481876,NaN,NaN,21.40201730926065,12.639858977712437
2009-04-07T09:30:00-04:00,16.34,16.39999,16.07001,16.08,6284242,7943103.55,57.06366842526365,60.67457872201978,NaN,NaN,77.3720252610975,108.67975507966051,0.0860810605021996,0.4559084749306468,0.3698274144284472,-31462174,-24739135.8,93.2297007409887,90.50667233715087,NaN,NaN,20.339114144162934,13.73975257291965
2009-04-08T09:30:00-04:00,16.34,16.519,16.21001,16.32001,5336355,7498416.8,59.34835311067905,60.58704215478924,NaN,NaN,92.03526194251819,110.83293353351114,0.06529085479884089,0.4514409829269983,0.3861501281281574,-26125819,-23511549.2,93.43039842665846,90.92861921327533,NaN,NaN,20.15957402328572,14.656869922971946
2009-04-09T09:30:00-04:00,16.71001,16.92999,16.62,16.73,15105781,7849248.8,62.972868996533435,61.10157197682933,NaN,NaN,135.10611334894668,111.27977903590276,0.07148144912064269,0.4755019395289608,0.4040204904083181,-11020038,-20727386,93.87394823328859,91.3439341425261,NaN,NaN,21.136515454722726,15.582533570364914
2009-04-13T09:30:00-04:00,16.78,16.89,16.59,16.73,5776324,7801281.2,62.972868996533435,60.99392488406172,NaN,NaN,119.24620564936548,107.81473974628754,0.06793104033907393,0.48893429083216056,0.4210032504930866,-11020038,-20961200.2,93.30422288790872,91.65181366098345,NaN,NaN,21.912229458930373,16.48677584015998
2009-04-14T09:30:00-04:00,16.7,16.72,16.46001,16.55,5434559,7827952.5,60.238153680456385,60.959646984879306,NaN,NaN,87.66094488177364,102.28411021674029,0.04681926975285783,0.4795273376841589,0.43270806793130107,-16454597,-19216533.2,93.61558646810117,91.95095736526716,NaN,NaN,21.77378763743195,17.24206323977026
2009-04-15T09:30:00-04:00,16.42,16.53999,16.27,16.5,5673328,7827742.75,59.46563869367705,60.81046451448508,NaN,NaN,60.92732824536548,98.99517081359389,0.023996677417246093,0.46270391470285865,0.43870723728561256,-22127925,-17349683.4,93.9402993433001,92.24567248461663,NaN,NaN,21.445208223154218,17.842512523110827
2009-04-16T09:30:00-04:00,16.72,17.07001,16.59,16.99001,14776340,8034305.85,64.2978826996453,60.74678524593383,NaN,NaN,115.02268172138338,103.59265476936693,0.0357056565123286,0.4833393079260233,0.4476336514136947,-7351585,-13594836.6,94.54162457931392,92.5500303133394,NaN,NaN,22.55377885789745,18.51555057093749
2009-04-17T09:30:00-04:00,17,17.045,16.78999,16.96001,8981582,8171847.05,63.796438111472135,61.01967777112742,NaN,NaN,111.21318871913401,98.8140698434044,0.03517734778460058,0.49160533614444546,0.4564279883598449,-16333167,-14657462.4,91.76629679845469,92.62619441920882,NaN,NaN,23.31923499856957,19.201791203456356
2009-04-20T09:30:00-04:00,16.69,16.7,16.38,16.42,5375523,8177327.5,55.41834706579083,61.15510100889451,NaN,NaN,40.94674115764334,83.15417694505996,-0.0056211840732001694,0.4494015082683447,0.45502269234154485,-21708690,-16795192.8,86.27905780058141,92.33215336645483,NaN,NaN,21.507435251149996,19.53116892455545
2009-04-21T09:30:00-04:00,16.36,16.73,16.31,16.7,7309023,8271533.15,58.464220947184046,61.2950206935859,NaN,NaN,49.26574648895781,75.4751372664968,-0.017177650846029235,0.4335506287840083,0.45072827963003753,-14399667,-16384206.8,86.44684920870262,92.01976521566642,NaN,NaN,20.86663656628936,19.72195001623172
2009-04-22T09:30:00-04:00,16.64,17.11,16.60001,16.78,9122719,8428678.1,59.31940517722585,61.20115133811179,NaN,NaN,86.72534864775042,80.63474134697378,-0.022524330074721932,0.4225728670366351,0.44509719711135703,-5276948,-13014011.4,87.76784517088447,91.78159218762669,NaN,NaN,20.58621477611129,19.84541641050023
2009-04-23T09:30:00-04:00,16.89999,16.92,16.50999,16.86,6821270,8295676.35,60.20184469560084,60.920350395654296,NaN,NaN,70.44681931576274,71.71956886584967,-0.0236472155097473,0.4155381777241729,0.4391853932339202,1544322,-11234830,88.41007668700703,91.57203906151209,NaN,NaN,20.59754709904412,19.952863651720786
2009-04-24T09:30:00-04:00,17,17.25,16.86,17.10001,5195680,8136099.8,62.80839779083822,60.69810734164923,NaN,NaN,120.97458292828276,73.67184770767942,-0.01179848413844975,0.424437288060858,0.43623577219930776,6740002,-6620196.2,89.89238645180112,91.39329657457311,NaN,NaN,21.3375324170155,20.150673475334315
2009-04-27T09:30:00-04:00,16.97,17.27,16.94,17.02,4374523,8040104.25,61.36552610150001,60.55240103517142,NaN,NaN,116.23347134045945,88.72919374424264,-0.012836562375500737,0.42019006922993185,0.4330266316054326,2365479,-1805362.4,91.1624335861559,91.2614804559391,NaN,NaN,21.564887508051793,20.352704051436813
2009-04-28T09:30:00-04:00,16.92999,17.13499,16.8,17.00999,7075730,8074255.8,61.176175447097535,60.846151536730986,NaN,NaN,94.21614700079992,97.71927384661106,-0.01740093185008773,0.4112754667928229,0.4286763986429106,-4710251,132520.8,91.61889440299464,91.14642286036808,NaN,NaN,21.704738837923134,20.545851878077716
2009-04-29T09:30:00-04:00,17.14,17.45,17.06,17.2,5524641,8098536.1,63.47975440010445,61.1412516288328,NaN,NaN,146.78222624667498,109.73064936639598,-0.011131771206283225,0.4147616846350566,0.4258934558413398,814390,1350788.4,91.9020629352066,91.03725603955009,NaN,NaN,22.43594523519457,20.815865214808696
2009-04-30T09:30:00-04:00,17.48,17.67,17.188,17.25,12714199,8431078.45,64.08366825089358,61.22059443271566,NaN,NaN,169.89130188121499,129.61954587948642,-0.007310743077678483,0.4167550269942417,0.4240657700719202,13528589,3747641.8,92.44303466257868,90.93504792735652,NaN,NaN,23.212861344576854,21.158293233347003
2009-05-01T09:30:00-04:00,17.31,17.48,17.11,17.48,3511126,8240489.85,66.80311841883318,61.49418367716565,NaN,NaN,143.1773408771901,134.06009746926787,0.006279380559621073,0.43191499577144654,0.42563561521182547,17039715,5807584.4,92.88307347486298,90.90496582642469,NaN,NaN,24.634177342649284,21.65484810610447
2009-05-04T09:30:00-04:00,17.60001,17.83,17.495,17.8,4554313,7713711.15,70.18550619855371,62.204708857029736,NaN,NaN,189.65502799957972,148.74440880109196,0.03100944503036568,0.4643974214997826,0.4333879764694169,21594028,9653294.2,93.62894031646516,90.9059196727364,NaN,NaN,26.880887632577593,22.401425181314917
2009-05-05T09:30:00-04:00,17.7,17.75,17.55,17.69,4544051,7174565.45,67.63444188158601,62.78819479902324,NaN,NaN,154.4084008613316,160.7828595731983,0.0339131455155568,0.4757794083638629,0.4418662628483061,17049977,14005339.8,94.35051205660531,90.93522058082964,NaN,NaN,28.0945097857774,23.214722981952413
2009-05-06T09:30:00-04:00,17.89,17.89,17.52,17.78999,7248824,7222794.55,68.74648445509905,63.10595206726994,NaN,NaN,148.20879863794593,161.06817405145247,0.03630806343049198,0.4872513421364211,0.4509432787059291,24298801,18702222,95.00767304869221,90.96850975721381,NaN,NaN,29.43140684520067,24.102820676702162
2009-05-07T09:30:00-04:00,17.83,17.88,17.03,17.11,18326544,7872304,54.92539841780037,62.47230637486481,NaN,NaN,63.02441912459504,139.69479750012846,-0.011600714112797283,0.43644238606493246,0.44804310017772975,5972257,17190955.6,91.32658707535938,90.93710191984987,NaN,NaN,26.433054027105683,24.435711155331237
2009-05-08T09:30:00-04:00,17.33,17.37,16.94,17.09,6863023,7460166.1,54.57784607409154,62.412270589743436,NaN,NaN,18.131216822134174,114.6855726891173,-0.04638195582338822,0.39006565539849447,0.4364476112218827,-890766,13604859.4,83.09889343560913,90.70994732235184,NaN,NaN,23.92746371101483,24.36310437757175
2009-05-11T09:30:00-04:00,16.92999,17.32001,16.89999,17.14,5695906,7456145.2,55.338703052688224,62.18901931156516,NaN,NaN,11.933906175171026,79.14134832423557,-0.06653887190626584,0.3532740213390504,0.41981289324531623,4805140,10247081.8,76.17854103648533,89.97649673862205,NaN,NaN,22.077563085232416,24.036598478666132
2009-05-12T09:30:00-04:00,17.25999,17.28999,16.96001,17.05,5802988,7474566.65,53.59832456537064,61.78037069643265,NaN,NaN,2.1686633000341993,48.69340081197607,-0.08525570254313808,0.31324326506639366,0.39849896760953174,-997848,6637516.8,69.47999747161508,88.67022190295994,NaN,NaN,20.030591799432056,23.464311810204123
2009-05-13T09:30:00-04:00,16.95,16.99001,16.62,16.62,13210293,7851414.9,46.133172175913245,60.77546551645496,NaN,NaN,-89.34231099413986,1.1831788855589083,-0.12359243903791939,0.24400841881213253,0.3676008578500519,-14208141,-1063871.6,57.80152871972269,86.48389704815392,NaN,NaN,15.859073673174763,22.377849219199927
2009-05-14T09:30:00-04:00,16.74001,17,16.69,16.8,6752629,7450229.35,49.315544448934666,59.811690277747566,NaN,NaN,-66.74683371982287,-24.771071683324664,-0.13300641025066834,0.2013428450367165,0.33434925528738485,-7455512,-3749425.4,54.369648301403345,83.9465586088398,NaN,NaN,13.259703366124665,21.075256954474888
2009-05-15T09:30:00-04:00,16.95,17.06,16.8,16.8,7018328,7352066.65,49.315544448934666,58.95097730256432,NaN,NaN,-51.976792917506074,-38.79267363125272,-0.13498268755867804,0.16562089583903727,0.3006035833977153,-7455512,-5062374.6,52.7215624033047,81.20078209577898,NaN,NaN,11.155008745322762,19.658078638881726
2009-05-18T09:30:00-04:00,17,17.25999,16.89999,17.25999,4340246,7300302.8,56.86779653988705,58.64323595204929,NaN,NaN,1.8412957380243027,-40.81119571868206,-0.10253042266852119,0.1724405550620638,0.274970977730585,-3115266,-6646455.8,50.72377581048752,78.2797021963142,NaN,NaN,11.497476626040287,18.49227835133295
2009-05-19T09:30:00-04:00,17.17999,17.5,17.14999,17.36,7119496,7290826.45,58.32188064363614,58.27481639801584,NaN,NaN,46.480265926101694,-31.94887519346856,-0.07293961091867152,0.1837964640822456,0.2567360750009171,4004230,-5646040.2,51.961816998466816,75.42682748654707,NaN,NaN,12.214980372078701,17.595521497153772
2009-05-20T09:30:00-04:00,17.48,17.56,17.16,17.17999,8700750,7269728,54.74449141516282,57.60773233832078,NaN,NaN,30.666960265724654,-7.947020941495654,-0.0643974799048049,0.17623922511991097,0.24063670502471587,-4696520,-3743716,54.3124472829075,72.70321410228485,NaN,NaN,11.769288899836008,16.763202554679808
2009-05-21T09:30:00-04:00,17.05,17.11,16.72,16.88,6453664,7251347.7,49.31556992506297,56.35862173162291,NaN,NaN,-89.08251918520976,-12.414158034573031,-0.07700611524036247,0.14437906097426279,0.22138517621462525,-11150184,-4482650.4,53.22300756890215,69.87035225185907,NaN,NaN,9.714471356466673,15.756240954935073
2009-05-22T09:30:00-04:00,16.95,17.03999,16.7,16.94,5434660,7263296.7,50.37555070790274,54.94362491086213,NaN,NaN,-86.3548928678582,-19.289778024643457,-0.07906144235513785,0.12255837327070296,0.2016198156258408,-5715524,-4134652.8,53.69408827495031,67.01786282032229,NaN,NaN,8.347459136631645,14.697843552320299
2009-05-26T09:30:00-04:00,16.75999,17.42,16.7,17.38,5743316,7331736.35,57.40982026377919,54.21329479530449,NaN,NaN,-8.94670107284855,-21.447377386818026,-0.04996350741473718,0.13916543135741932,0.1891289387721565,27792,-3506041.2,54.58383079785136,64.17738558755416,NaN,NaN,9.314353929564481,13.928773606212324
2009-05-27T09:30:00-04:00,17.39,17.60001,17.2,17.21001,7714816,7363690.65,54.21255573978464,53.17515702992489,NaN,NaN,36.37437013209277,-23.468556545619816,-0.04167893300092043,0.13703027252100597,0.1787092055219264,-7687024,-5844292,50.68277904648776,61.01132173025384,NaN,NaN,9.129840791659847,13.24321177556197
2009-05-28T09:30:00-04:00,17.41901,17.53999,17.11,17.46001,6177867,7396351.95,57.92388380353579,53.38933455747742,NaN,NaN,43.05095379159414,-20.991757840445917,-0.0199762854778813,0.15373884867457477,0.17371513415245607,-1509157,-5206819.4,51.6963468149761,58.18059028308362,NaN,NaN,10.137821753145854,12.799584629502526
2009-05-29T09:30:00-04:00,17.50999,17.67999,17.34,17.64999,5396988,7030491.4,60.54133101869098,53.81529776780595,NaN,NaN,90.76818762335004,14.978383521266043,0.005214055486714941,0.18023270351084975,0.1750186480241348,3887831,-2199216.4,56.263464894649665,56.26377395872936,NaN,NaN,11.799337979517526,12.65669225093324
2009-06-01T09:30:00-04:00,17.89,18.2,17.83,18.14999,7937086,7251789.4,66.45569315579597,54.60936848945651,NaN,NaN,192.87336342140952,70.82403477911959,0.05104276408380359,0.2388221031288893,0.1877793390450857,11824917,1308871.8,60.906495482429534,55.17291356201109,NaN,NaN,15.299278903603614,13.034204629886151
2009-06-02T09:30:00-04:00,18.03,18.3,17.97,18.11,6871984,7367672.95,65.60867478422992,55.46725064794646,NaN,NaN,189.54137859745944,110.52165071318117,0.07282754797916802,0.2788137740190457,0.2059862260398777,4952933,2293900,62.12240812505631,54.647371465828314,NaN,NaN,17.79103177051558,13.713751364261784
2009-06-03T09:30:00-04:00,18.05,18.05,17.78,17.91,5743836,7427662.2,61.39412918947634,56.5573190060581,NaN,NaN,132.9366177242033,129.8341002316033,0.06802261820946995,0.29101449880171515,0.2229918805922452,-790903,3673124.2,63.8192681006837,55.07720999303982,NaN,NaN,18.581647936121303,14.409165160241715
2009-06-04T09:30:00-04:00,18.03999,18.21001,18.00999,18.16,9371754,7533808.7,64.4668161036054,57.639552695677445,NaN,NaN,163.4202738232232,153.9079642379291,0.07536656481265253,0.31720008660806087,0.24183352179540835,8580851,5691125.8,66.20482441814562,55.922579715664256,NaN,NaN,20.217048798882157,15.238862822904634
2009-06-05T09:30:00-04:00,18.33,18.41,18.1499,18.34,9653902,7100176.6,66.53223814648538,58.86931653121678,NaN,NaN,160.1456872925084,167.78346417176076,0.08530119783374207,0.34846001908758595,0.2631588212538439,18234753,8560510.2,69.30399896492025,57.10703947006537,NaN,NaN,22.222499348119715,16.236525183649647
2009-06-08T09:30:00-04:00,18.16,18.33,17.92,18.23,6718883,7092969.6,64.0808732161976,59.38453629381039,NaN,NaN,114.5936570925982,152.12752290599852,0.07763729184082596,0.3602054360548763,0.28256814421405035,11515870,8498700.8,69.15687711349703,58.423689563137465,NaN,NaN,23.146359490218718,17.22364437030237
2009-06-09T09:30:00-04:00,18.35001,18.45,18.19,18.31,6112695,7113809.05,65.08833455167658,59.86785443009899,NaN,NaN,118.07604176187795,137.8344555388822,0.0712931221832801,0.37168454694315045,0.30039142475987035,17628565,11033827.2,71.80100407667157,59.840774354437805,NaN,NaN,24.201186351858343,18.220436081953224
2009-06-10T09:30:00-04:00,18.42,18.48,18.10001,18.36,5349953,7091157.3,65.7352022880344,60.652905206732676,NaN,NaN,102.7864690796369,131.8044258099689,0.06403168818879895,0.38043103499586906,0.3163993468070701,22978518,15787711.4,75.96247915812489,61.38720520266761,NaN,NaN,25.25593271229217,19.225507029144502
2009-06-11T09:30:00-04:00,18.37,18.63,18.31,18.42999,6167742,6739029.75,66.66626633559862,61.89224066462807,NaN,NaN,107.67455720833367,120.65528248699101,0.05770576097727986,0.38853154802866996,0.3308257870513901,29146260,19900793.2,78.86819816790666,63.21900453116793,NaN,NaN,26.3996861968769,20.250389767391987
2009-06-12T09:30:00-04:00,18.38,18.44,18.19,18.38,5705520,6686674.3,65.30141360158314,62.95837372846239,NaN,NaN,83.0620402185872,105.23855307220678,0.04450944044428562,0.3864625876067471,0.3419531471624615,23440740,20941990.6,79.54236860080725,65.06531026872915,NaN,NaN,27.00770849626194,21.215721014373408
2009-06-15T09:30:00-04:00,18.24001,18.33,18.00999,18.19,6774656,6674490.7,60.25237191092611,63.161413131830024,NaN,NaN,56.339667826239484,93.58775521893503,0.01866210627803644,0.3652807800100071,0.34661867373197064,16666084,21972033.4,80.2148486858771,66.89609726073098,NaN,NaN,26.17940959319145,21.924819382775986
2009-06-16T09:30:00-04:00,18.24001,18.28,17.92,17.96001,6800711,6797513.95,54.73547001228206,63.19876415129413,NaN,NaN,35.10506564157,76.99355999487344,-0.016354281266214077,0.32617582214920304,0.3425301034154171,9865373,20419395,76.15133847852995,68.71528007730544,NaN,NaN,23.869731923828887,22.20266403149783
2009-06-17T09:30:00-04:00,18.00999,18.19991,17.88,18.06,7721086,6827593.45,56.596190996977064,63.10392895082565,NaN,NaN,30.49920872510577,62.53610792396722,-0.034186209515121746,0.29979734152151494,0.3339835510366367,17586459,19340983.2,73.37117056986986,70.26348177408356,NaN,NaN,22.413783650798713,22.23282397711224
2009-06-18T09:30:00-04:00,18.06,18.13,17.94,17.98,6771340,6731122.95,54.66016028149135,62.683845326739956,NaN,NaN,22.182777469473063,45.4377519761951,-0.051721096475232264,0.2693321804425963,0.3210532769178286,10815119,15674755,64.72041002926036,70.86754928369861,NaN,NaN,20.643503054227764,22.005778130985885
2009-06-19T09:30:00-04:00,18.06,18.17,17.96001,18.12,11448281,6980853.8,57.40612482674227,62.0374475889504,NaN,NaN,27.955905450162145,34.41652502251009,-0.05399282707983727,0.253562243068032,0.30755507014786926,22263400,15439287,64.19688209054445,71.10257689856395,NaN,NaN,19.845755223196416,21.697203429873102
2009-06-22T09:30:00-04:00,17.95,18,17.61,17.67,7682375,7093239.55,47.45700932796626,60.74090005636015,NaN,NaN,-53.29960369220683,12.488670718820831,-0.08410818018302185,0.20241984491909193,0.2865280251021138,14581025,15022275.2,63.22152266055462,71.18108507967098,NaN,NaN,15.988252490995661,20.881639010033467
2009-06-23T09:30:00-04:00,17.7,17.74001,17.53,17.67999,5780672,7095107.35,47.673821130876455,59.76087805217444,NaN,NaN,-96.96630467851463,-13.925603345196095,-0.10054949313931938,0.16084115867796456,0.26139065181728394,20361697,17121540,66.0203327802941,71.33830398535738,NaN,NaN,12.953753153222767,19.74908388763194
2009-06-24T09:30:00-04:00,17.84,18.07001,17.78999,17.92999,6681648,7043448.95,52.910450875619674,58.9354233930326,NaN,NaN,-34.72573758691084,-26.97059260759942,-0.0920122517217612,0.14637533716508244,0.23838758888684364,27043345,19012917.2,68.35677997731428,71.49201509672658,NaN,NaN,11.832883420001874,18.618198106541932
2009-06-25T09:30:00-04:00,17.84,18.25,17.75,18.19,8693250,7169218.1,57.656717140941,58.301457606922284,NaN,NaN,-3.5841894073431906,-32.12398598296268,-0.06741794329126308,0.1541151597727648,0.22153310306402788,35736595,23997212.4,73.52342817792871,71.79340289765575,NaN,NaN,12.328036999463947,17.71960366267365
2009-06-26T09:30:00-04:00,18.13,18.25,18.08,18.16,8955180,7347127.7,56.943555405763064,57.79164919189124,NaN,NaN,27.894316998409487,-32.1363036733132,-0.05240275217597798,0.1560296628440554,0.20843241502003337,26781415,24900815.4,74.34136609666136,72.16372353931035,NaN,NaN,12.517297500925665,16.976417068138222
2009-06-29T09:30:00-04:00,18.2,18.41,18.17,18.35001,5331422,7216844.5,60.29351416721836,57.4491620215728,NaN,NaN,85.46538409883475,-4.383306115104884,-0.030018726656500905,0.17090900669940723,0.20092773335590813,32112837,28407177.8,77.27512196211993,72.55473195969952,NaN,NaN,13.687552960485272,16.506579338473514
2009-06-30T09:30:00-04:00,18.39,18.42999,18.0775,18.21001,7748918,7260691.2,56.78767761136614,56.81005311609649,NaN,NaN,50.252007163921725,25.060356253382388,-0.025181514582351794,0.1694508401279684,0.1946323547103202,24363919,29207622.2,77.89643688121174,72.69287179706286,NaN,NaN,13.643574007466173,16.097578576901036
2009-07-01T09:30:00-04:00,18.33,18.47,18.25,18.28999,11035672,7525283,58.2801352307674,56.211043751465695,NaN,NaN,83.87406394542343,48.78031655984924,-0.01749987643547546,0.17275750916597588,0.19025738560145133,35399591,30878871.4,79.17657577581964,72.71489876905665,NaN,NaN,14.039354196482694,15.803546522555559
2009-07-02T09:30:00-04:00,18.11,18.12,17.83,17.83,9273848,7520387.7,48.00996848435386,54.97594052880646,NaN,NaN,-82.56339724983737,32.98447499135041,-0.04285782947022998,0.13668509876366386,0.17954292823389384,26125743,28956701,73.87701928705177,72.31023096093125,NaN,NaN,11.105388463158514,15.132381085498839
2009-07-06T09:30:00-04:00,17.75,17.88,17.63,17.78,5862277,7330806.45,47.03962150125086,54.03217264240108,NaN,NaN,-129.61854405013182,1.4819027816421453,-0.06133276672305571,0.10287696983007422,0.16420973655312993,20263466,27653111.2,70.4338529142961,71.61158840581832,NaN,NaN,8.45562350037542,14.17855857333835
2009-07-07T09:30:00-04:00,17.81,17.85001,17.34,17.34,4491223,7219423.45,39.47795320470178,52.942350013288205,NaN,NaN,-186.95463152340395,-53.00210034280559,-0.0992741753979493,0.04011701730569328,0.13939119270364259,15772243,24384992.4,62.56161582129761,70.64089393030173,NaN,NaN,3.4731848702851043,12.649219472902171
2009-07-08T09:30:00-04:00,17.41,17.45,17.14999,17.35001,8610813,7344329.35,39.7153781950319,51.73657767029213,NaN,NaN,-203.946342089136,-103.84177019341715,-0.1184829870726087,-0.00871254113711828,0.10977044593549042,24383056,24388819.8,62.566892532202985,69.86915978475409,NaN,NaN,-0.34517344940768496,10.792877626857907
2009-07-09T09:30:00-04:00,17.44,17.545,17.37,17.46001,14031172,7778390.3,42.38995060719623,50.86013412212818,NaN,NaN,-137.75485812257915,-148.16755460701765,-0.11829243730988279,-0.03809510070186306,0.08019733660801973,38414228,24991747.2,63.441042329849864,69.77777637765335,NaN,NaN,-2.695964908328218,8.865900121831318
2009-07-10T09:30:00-04:00,17.39999,17.57001,17.33,17.53,10027637,7971385.05,44.0896344398955,49.908956237353415,NaN,NaN,-117.08434200185937,-155.07174355742205,-0.10823646489633061,-0.055098244512393535,0.053138220383937076,48441865,29454971.6,69.17886356523506,70.13363219727411,NaN,NaN,-4.1352242198824145,7.008596644443642
2009-07-13T09:30:00-04:00,17.50999,17.86,17.31,17.86,8236828,8097950.45,51.37413623404861,50.1887510163593,NaN,NaN,-57.3525750202001,-140.61854975143572,-0.07568426381415178,-0.04146710938375264,0.03421715443039913,56678693,36738017,75.84181309067975,71.03508151371162,NaN,NaN,-3.1647971039006544,5.555254680394457
2009-07-14T09:30:00-04:00,17.83,17.89,17.702,17.88,6954020,8106918.65,51.78414967345545,50.4823459122578,NaN,NaN,-15.079037648675824,-106.24343097649009,-0.05034927863442964,-0.028719443862637917,0.02162983477179172,63632713,46310111,81.50190518454335,72.14090811401515,NaN,NaN,-2.264113758524612,4.438202046263162
2009-07-15T09:30:00-04:00,18.19,18.56,18.14999,18.55,8306234,8182194.8,63.03034558084851,51.205195534059854,NaN,NaN,131.10194881987923,-39.23377279468704,0.010730231323241208,0.03504262392584323,0.024312392602602022,71938947,55821289.2,85.20992184371322,73.34470396161507,NaN,NaN,2.593314830572396,4.174646729735909
2009-07-16T09:30:00-04:00,18.5,18.84,18.44,18.82001,8516719,8221976.45,66.4287357612177,51.83176829265104,NaN,NaN,173.65340890618663,23.047880611066127,0.06546094436601002,0.10613857306011454,0.040677628694104524,80455666,64229576.8,87.58014448249355,74.34875512622683,NaN,NaN,7.815660474169081,4.694791550369219
2009-07-17T09:30:00-04:00,18.82001,19,18.7375,19,18447744,8805796.65,68.50697454335261,52.65772680247887,NaN,NaN,181.27321336315686,82.71939168406938,0.10744921525277168,0.17498914776006913,0.06753993250729745,98903410,74321885.8,89.71142886228809,75.44661675234305,NaN,NaN,12.743468693393044,5.844602570801194
2009-07-20T09:30:00-04:00,19.10001,19.19,19,19.17,20703040,9268534.6,70.37252749343088,53.37765632577976,NaN,NaN,181.37840934728283,130.46558855756595,0.1383672387582242,0.2404989809550777,0.1021317421968535,119606450,86907437.2,91.63841957571779,76.47256658188574,NaN,NaN,17.37481134063541,7.491775252206082
2009-07-21T09:30:00-04:00,19.24001,19.28,19.03,19.28,15816480,9675239.85,71.54701779607065,54.43189491040151,NaN,NaN,162.47632980230765,165.97666204776266,0.15658144503462648,0.2978585484901366,0.14127710345551012,135422930,101265480.6,93.202565554038,77.56586148708763,NaN,NaN,21.490916341533513,9.49165255068143
2009-07-22T09:30:00-04:00,19.27,19.45,19.23,19.39,7262238,9749318.15,72.71197923921798,55.46274091100513,NaN,NaN,158.55278244107862,171.46682877200254,0.16552144520874307,0.34817890996643897,0.1826574647576959,142685168,115414724.8,94.32849222445067,78.64814123341841,NaN,NaN,25.224096731018818,11.739144576443913
2009-07-23T09:30:00-04:00,19.38,19.87,19.34,19.77,13414637,10085967.6,76.31907748362516,57.4848201252388,NaN,NaN,166.22279151572909,169.98070529391103,0.18503341546298507,0.41394923408642725,0.22891581862344218,156099805,130543552.6,95.23695385376278,80.17385084532634,NaN,NaN,29.754648341797047,14.31278797149436
2009-07-24T09:30:00-04:00,19.5,19.67999,19.36,19.65199,10708605,10186735.35,73.08796767824354,59.34541628073827,NaN,NaN,131.81406154956193,160.08887493119204,0.1779452786875449,0.4513474169828733,0.2734021382953284,145391200,139841110.6,95.69349631904437,81.97811108852264,NaN,NaN,32.426274379086536,16.90042888686467
2009-07-27T09:30:00-04:00,19.67999,19.67999,19.42999,19.64999,5741723,10026062.5,73.03153574779004,61.74210074810172,NaN,NaN,115.33159002542719,146.87951106682092,0.1615541958926937,0.4753448831611955,0.3137906872685018,139649477,143849716,95.87698949843383,84.35778063688952,NaN,NaN,34.5335576937512,19.41944728784846
2009-07-28T09:30:00-04:00,19.50999,19.72,19.39,19.69,5887484,10053865.6,73.47279492931973,64.15334480055085,NaN,NaN,101.29669483695109,134.6435840737496,0.14250421977146094,0.491920961982828,0.34941674221136704,145536961,145872522.2,95.97029641900538,86.74373805737541,NaN,NaN,36.39048520207563,21.843881275595198
2009-07-29T09:30:00-04:00,19.59,19.67,19.45,19.67,5928410,9962840.2,72.83128755263594,66.3277260109394,NaN,NaN,89.54044832587752,120.84111725070936,0.11863183810324973,0.49770653984042923,0.3790747017371795,139608551,145257198.8,95.26404025632601,89.016809337838,NaN,NaN,37.75466281210101,24.1168500665246
2009-07-30T09:30:00-04:00,19.87,20.05991,19.73,19.77,11482863,9985199.75,74.05124935856745,68.4678413622731,NaN,NaN,99.04740300400104,107.40603954836374,0.10037602946032831,0.5045447385625899,0.40416870910226155,151091414,144255520.6,94.05066051799861,90.7933662630354,NaN,NaN,39.259080684838125,26.280025869140815
2009-07-31T09:30:00-04:00,19.78,19.89,19.67,19.7,6733789,9858196.8,71.62667940892946,69.91445158905032,NaN,NaN,83.11972463670425,97.66717216579221,0.07551979950978599,0.49856845848949405,0.42304865897970806,144357625,144048805.6,93.78518136844272,92.07503542573274,NaN,NaN,39.905802139822,28.226565336380983
2009-08-03T09:30:00-04:00,19.95,19.97,19.78,19.97,7821168,9956141.35,75.02358059738842,71.57441094075982,NaN,NaN,87.8447769923256,92.16980955917191,0.06935543880085909,0.5097429574807819,0.4403875186799228,152178793,146554668.8,94.00605867855847,92.96818924673381,NaN,NaN,41.457018310552016,30.116630046976844
2009-08-04T09:30:00-04:00,19.85001,19.94,19.81,19.91,5823609,10022760.65,72.93392598274372,72.28180954089518,NaN,NaN,81.03353119138778,88.11717683005924,0.054012021451356806,0.5079025454941188,0.45389052404276203,146355184,146718313.4,94.021003129913,93.5975521957481,NaN,NaN,42.183865258027545,31.840520791412658
2009-08-05T09:30:00-04:00,20,20,19.64999,19.73,5012578,9842848.9,66.91262001346294,72.31637270176985,NaN,NaN,69.14866719135587,84.0388206031549,0.02593845253815663,0.4863135897154578,0.46037513717730116,141342606,147065124.4,94.05483354880688,94.06002998619905,NaN,NaN,41.116634313629326,33.16567986601504
2009-08-06T09:30:00-04:00,19.78999,19.828,19.5201,19.59,10208199,9651700.25,62.58479071688968,71.89335957130821,NaN,NaN,51.26903254922114,74.48314651219891,-0.0061488783067799035,0.4526890392938263,0.4588379176006062,131134407,143073723,87.89113557405153,93.9300090370393,NaN,NaN,38.94626362209156,33.99147754545454
2009-08-07T09:30:00-04:00,19.87,19.91,19.7,19.78999,11741445,9737390.65,65.97073341666686,71.57894570868221,NaN,NaN,65.0589182325898,70.87098523137603,-0.017358504407532505,0.4371397870911906,0.4544982914987231,142875852,142777368.4,87.43298683437156,93.629620984086,NaN,NaN,38.00074763675035,34.564230415639656
2009-08-10T09:30:00-04:00,19.69,19.7599,19.53999,19.7,12463664,9948732.45,63.19923948236932,70.9826758291321,NaN,NaN,43.409708965418545,61.98397162599461,-0.03336104513078919,0.41279698508523666,0.44615803021602585,130412188,138424047.4,80.77232043483747,92.74174633271453,NaN,NaN,36.40124331102767,34.826660829266515
2009-08-11T09:30:00-04:00,19.61,19.63,19.41,19.42,4821793,9842121.1,55.40049442065807,69.74614119923498,NaN,NaN,2.4111456263422455,46.25949451298551,-0.06357876998947926,0.3666845677291768,0.43026333771865605,125590395,134271089.6,74.90957283041166,91.35468066171175,NaN,NaN,32.54375783542625,34.50053183014648
2009-08-12T09:30:00-04:00,19.45,19.9496,19.42,19.81,5338453,9693732.05,62.36643128696811,68.74952361375946,NaN,NaN,50.15602914941374,42.46096690459709,-0.05821949016556355,0.3574889750117016,0.4157084651772652,130928848,132188338,72.08377678131707,89.7008822993942,NaN,NaN,31.27656086544681,34.039964549475094
2009-08-13T09:30:00-04:00,19.88,19.94,19.7,19.89999,6075844,9571688.3,63.772486406530355,68.08413209435138,NaN,NaN,84.43430372172621,49.0940211390981,-0.04985541867912463,0.3533891918283594,0.403244610507484,137004692,133362395,72.70875267623151,88.05911489633614,NaN,NaN,30.702056453190686,33.56312053572018
2009-08-14T09:30:00-04:00,19.88,19.91,19.57001,19.71001,3455921,8822097.15,58.77959789925005,67.06613653374139,NaN,NaN,37.91516228097664,43.66526994877547,-0.05779986119454067,0.33099478401430815,0.3887946452088488,133548771,131496978.8,70.02625859039469,86.21263411719049,NaN,NaN,28.621626589235653,32.85719282907954
2009-08-17T09:30:00-04:00,19.39999,19.455,19.2,19.24001,5061609,8040025.6,48.63485970354796,65.29199830332911,NaN,NaN,-155.50006110078994,3.8833159355337785,-0.09328818818052437,0.2721844099831934,0.36547259816371774,128487162,131111973.6,69.45669563932509,84.31880549007046,NaN,NaN,23.14936358439102,31.47036007983832
2009-08-18T09:30:00-04:00,19.33,19.53999,19.3,19.53,3716788,7435041,53.9193453281328,63.941145287293175,NaN,NaN,-100.35348083968601,-16.669609357671877,-0.09546672262074873,0.2461391948877818,0.34160591750853053,132203950,132434684.6,70.34898043570658,82.53915836002622,NaN,NaN,20.425424377304775,29.892512122333528
2009-08-19T09:30:00-04:00,19.27,19.66,19.24001,19.58,5720281,7357943.15,54.78313177825299,62.56485117441356,NaN,NaN,-90.16176595200204,-44.73316837795503,-0.09175113520381017,0.2269169985037678,0.31866813370757796,137924231,133833761.2,71.30391015082088,80.91439047665638,NaN,NaN,18.597846875922038,28.278988515703315
2009-08-20T09:30:00-04:00,19.60001,19.83,19.53999,19.8,3911170,6882769.8,58.471789232746296,61.62521616182905,NaN,NaN,26.713602741641203,-56.27730857397203,-0.07347788138155442,0.22682078198063493,0.30029866336218936,141835401,134799903,71.97512193210268,79.35652908834638,NaN,NaN,18.27825014220716,26.850311605203864
2009-08-21T09:30:00-04:00,19.92,20.12,19.8,20.09,6633574,6679018.25,62.78184320763768,60.75080634827543,NaN,NaN,147.56083551040268,-34.34817392808682,-0.042403371023838676,0.247294449582391,0.2896978206062297,148468975,137783943.8,73.9980970809452,77.92738897423114,NaN,NaN,19.452550919916682,25.79348865016284
2009-08-24T09:30:00-04:00,20.14999,20.27,20.03,20.03,4240773,6603970.75,61.36284160004897,59.924300320940084,NaN,NaN,173.0643861926615,31.364715530603462,-0.02717379472869169,0.25573057719536507,0.28290437192405676,144228202,140932151.8,75.96898645888437,76.63795921201482,NaN,NaN,19.93460497855524,24.95650526850461
2009-08-25T09:30:00-04:00,20.14,20.27,20.07001,20.08,4613426,6540267.85,62.13097454402216,59.58275421598004,NaN,NaN,160.74929372192312,83.58527044292529,-0.015591998096831039,0.26341437430301795,0.279006372399849,148841628,144259687.4,77.87766202982417,75.48244696065889,NaN,NaN,20.55487581864779,24.327701061382207
2009-08-26T09:30:00-04:00,20.07001,20.22501,20.03999,20.17,5684797,6528087.2,63.53621345636129,59.65071298308515,NaN,NaN,141.4377597755331,129.90517558843231,-0.0043154521358306774,0.27361205723006066,0.27792750936589133,154526425,147580126.2,79.61737497359908,74.89146406062657,NaN,NaN,21.483194814591613,23.921343026126408
2009-08-27T09:30:00-04:00,20.12,20.22,19.87,20.21001,9414637,6424675.9,64.17270232938185,59.52228219113628,NaN,NaN,111.75472803677879,146.9134006474598,0.002998224219578849,0.2816752896403649,0.2786770654207861,163941062,152001258.4,81.6828809012982,74.4807422082642,NaN,NaN,22.42819304768681,23.70803588634932
2009-08-28T09:30:00-04:00,20.46001,20.57001,20.14,20.28,11048605,6640416.7,65.31332969840184,59.6732886351386,NaN,NaN,160.74066296670188,149.54936613871968,0.009351075681696241,0.29036591002290635,0.2810148343412101,174989667,157305396.8,83.80346056867108,74.69725221782373,NaN,NaN,23.541605207585107,23.684260075097292
2009-08-31T09:30:00-04:00,20.05,20.08,19.92,20.02,9825156,6740616.1,57.93447663979015,59.854287365076594,NaN,NaN,56.90516993026366,126.31752288624008,-0.006311830132460616,0.2731250466756343,0.2794368768080949,165164511,161492658.6,85.25473625603468,75.4361924625111,NaN,NaN,22.421456278207717,23.503859532684494
2009-09-01T09:30:00-04:00,19.94,20.2395,19.59,19.61,13649883,7131929.8,48.60849773973109,58.87157782598824,NaN,NaN,-0.8099068135634266,94.0056827791428,-0.0445109743218125,0.22379815890582933,0.2683091332276418,151514628,162027258.6,85.434187276196,76.3897932121453,NaN,NaN,18.385288203819496,22.77263505713235
2009-09-02T09:30:00-04:00,19.58,19.74001,19.53,19.64999,4948055,7128703.65,49.46301124736672,57.84947245747655,NaN,NaN,-50.44582032321092,55.62896675939398,-0.06601417381031577,0.18579141596474713,0.2518055897750629,156462683,162414510.2,85.57117239190603,77.30853747755063,NaN,NaN,15.408551997258924,21.720623191436147
2009-09-03T09:30:00-04:00,19.75999,19.75999,19.50999,19.74001,5338313,6885209.35,51.421165924180045,57.32387017354297,NaN,NaN,-42.00840986334434,24.876339179369374,-0.07258218798878269,0.16107785478908454,0.23366004277786723,161800996,161986497,84.62388826351268,78.35122531134478,NaN,NaN,13.509929439800269,20.54766694120245
2009-09-04T09:30:00-04:00,19.74001,20.09,19.71001,20.09,10254816,6810877.9,58.202152182154656,58.00724820772917,NaN,NaN,42.504311607315486,1.2290689074920835,-0.05268870365020195,0.1677991632151148,0.22048786686531674,172055812,161399726,83.26306620460144,79.33739463743595,NaN,NaN,13.912726093935184,19.599818248735698
2009-09-08T09:30:00-04:00,20.19,20.24001,20.08,20.24001,3124598,6343924.6,60.732215743972645,58.49388180886059,NaN,NaN,95.45616165098633,8.939267251636606,-0.029894682203812556,0.18311951411055105,0.2130141963143636,175180410,163402905.8,84.19734074464,80.3265632309312,NaN,NaN,15.041759106003083,18.94866694263104
2009-09-09T09:30:00-04:00,20.2,20.44,20.15601,20.39,7057676,6455718.75,63.13501947564339,59.09044521581705,NaN,NaN,120.18301612691631,33.13785183973255,-0.006410700886006565,0.2050008202068554,0.21141152109286196,182238086,169547597.4,86.65767911144378,81.42326101383283,NaN,NaN,16.734295839670683,18.632328213636704
2009-09-10T09:30:00-04:00,20.39999,20.67,20.34,20.67,15727500,6975171.1,67.17324247840102,59.711977590506685,NaN,NaN,157.7610140937907,74.77921872313286,0.02458621056334584,0.24214428429704427,0.21755807373369843,197965586,177848178,89.1215814579152,82.64800812281943,NaN,NaN,19.520520520654337,18.759212828924937
2009-09-11T09:30:00-04:00,20.66,20.73,20.5105,20.69,11761680,7259462.9,67.44753678547997,60.04524141749541,NaN,NaN,154.6546162039739,114.11182393659651,0.04201854221161924,0.2700812514982225,0.22806270928660324,209727266,187433432,91.15326082910761,83.87337696197389,NaN,NaN,21.820476984426445,19.196536279710866
2009-09-14T09:30:00-04:00,20.50999,20.67,20.5,20.62,4524277,7312880.7,65.38813775745649,60.33276257159595,NaN,NaN,128.72161223233363,131.35528406160014,0.04419566789882551,0.2833072941601351,0.2391116262613096,205202989,194062867.4,92.23361449871648,85.03513610767618,NaN,NaN,23.12615182401147,19.757909928896666
2009-09-15T09:30:00-04:00,20.67999,20.82001,20.60001,20.75999,4572488,7288424.65,67.5237571090909,60.717961326243724,NaN,NaN,144.89521753134684,141.24309523767224,0.04999733786409821,0.30160829859143234,0.25161096072733413,209775477,200981880.8,93.17095050622426,86.12751385599049,NaN,NaN,24.869511661648282,20.488138747861182
2009-09-16T09:30:00-04:00,20.85001,20.99001,20.71001,20.92,10838547,7644512.6,69.8162444736659,61.16653497033691,NaN,NaN,158.872249167968,148.98094184588257,0.058930344420601966,0.3252738912530866,0.2663435468324846,220614024,208657068.4,94.0314917093331,87.15709362282861,NaN,NaN,27.05213496600227,21.425852493309907
2009-09-17T09:30:00-04:00,20.86,20.99001,20.78,20.84,5726410,7644819.05,67.25986849027981,61.38704683897248,NaN,NaN,136.95389134642718,144.81951729640986,0.05390653745544077,0.3337267186517856,0.27982018119634483,214887614,212041474,94.36848023288012,88.06320786079876,NaN,NaN,28.15194428864332,22.38672274978611
2009-09-18T09:30:00-04:00,20.85001,20.92999,20.73,20.89,6549395,7776730.3,68.04734904945103,61.582333935476,NaN,NaN,116.35399972242988,137.15939400010106,0.048571658819131724,0.3405347547202595,0.2919630959011278,221437009,214383422.6,94.5958618694705,88.8340936679987,NaN,NaN,29.289124842463465,23.372780191597162
2009-09-21T09:30:00-04:00,20.75,20.89,20.67,20.8,6007852,7745444.2,65.0159939317906,62.08815659919032,NaN,NaN,92.21446484661088,129.85796452295654,0.03427629206943561,0.3348084609879223,0.30053216891848666,215429157,216428656.2,94.79356803621003,89.51543879515408,NaN,NaN,29.432621999724322,24.23847187847247
2009-09-22T09:30:00-04:00,20.96001,20.97,20.78999,20.91,5691344,7817972.75,66.95368063899373,63.39852680628051,NaN,NaN,99.08646914021772,120.6962148447307,0.027799461871285402,0.3352814962575934,0.307482034386308,221120501,218697661,95.0116058000709,90.19954011828801,NaN,NaN,30.088761921674262,25.07422759892987
2009-09-23T09:30:00-04:00,21,21.24001,20.84,20.91,6525918,7913597.35,66.95368063899373,64.64786033425386,NaN,NaN,104.74274032068622,109.87031307527437,0.019479361438066667,0.3318312361838913,0.31235187474582465,221120501,218798956.4,95.02162926210188,90.87457275187343,NaN,NaN,30.632534767009247,25.868271480084065
2009-09-24T09:30:00-04:00,21,21.03,20.63,20.71001,5581922,7908453.6,59.95199480018672,65.25720525396862,NaN,NaN,62.286688741093876,94.93687255420771,-0.0023672036472781044,0.309392870186727,0.3117600738340051,215538579,218929149.4,95.03543693880091,91.6182548001083,NaN,NaN,29.187755300468943,26.342483454424762
2009-09-25T09:30:00-04:00,20.64,20.78,20.55,20.58,9222582,7898850.85,55.86221893480451,65.09006716487218,NaN,NaN,31.988139124736392,78.06370043466902,-0.027075306233984908,0.27791594104152395,0.30499124727550886,206315997,215904947,88.86956724419662,92.0187191600794,NaN,NaN,26.765498245854264,26.402914138914692
2009-09-28T09:30:00-04:00,20.7,21.08,20.7,20.92,5062938,7599567.5,62.97552672094979,65.2503036632277,NaN,NaN,72.62163723211873,74.1451349117706,-0.0222250752529356,0.27720990320933936,0.29943497846227496,211378935,215094902.6,87.23692227107024,92.23583212625297,NaN,NaN,26.653363567021472,26.438692628644233
2009-09-29T09:30:00-04:00,20.92,21.02229,20.765,20.81,11108156,7663717.5,59.62737414687124,64.99975756831539,NaN,NaN,62.73598920051243,66.87503892382954,-0.02776980383012989,0.2647227236746126,0.29249252750474247,200270779,210924958.2,79.17341146495414,91.70124158007515,NaN,NaN,25.536011944610127,26.309738245210788
2009-09-30T09:30:00-04:00,20.86,20.9899,20.55,20.87,14908063,7726626.5,60.85004060003566,64.54810029128929,NaN,NaN,47.8774597833238,55.50198281635706,-0.028626931991164783,0.2567088625157865,0.2853357945069513,215178842,209736626.4,76.98943913849139,90.83465998583058,NaN,NaN,24.975280261451214,26.119101390387993
2009-10-01T09:30:00-04:00,20.77,20.77,20.25,20.25,16202309,8289339.2,45.511942953112175,62.98127216040589,NaN,NaN,-49.973614039930226,33.04992226015223,-0.06983179577809617,0.19804604978433105,0.2678778455624272,198976533,206424217.2,71.10182340221648,89.40241445533836,NaN,NaN,18.932734413367417,25.09247753652791
2009-10-02T09:30:00-04:00,20.09,20.36,20.09,20.25,7154996,8380173.35,45.51194295311218,61.561543960095584,NaN,NaN,-122.67297556455216,2.117699322294514,-0.09443969918723355,0.14982822157838527,0.24426792076561882,198976533,204956324.4,68.59827196510767,87.71417570293774,NaN,NaN,14.33523270683215,23.5557282751428
2009-10-05T09:30:00-04:00,20.3,20.46001,20.16,20.42,6221289,8178497,49.55539201156146,60.27808931027205,NaN,NaN,-104.51483468795251,-33.30959506171974,-0.09629071238214784,0.12390453028793402,0.22019524267008186,205197822,203720101.8,66.47540019004984,85.80735068035385,NaN,NaN,11.804458387727177,21.876975434083427
2009-10-06T09:30:00-04:00,20.52,20.81,20.5,20.78999,8246691,8434601.65,57.02931588797996,59.36473726843734,NaN,NaN,3.3848736320389694,-45.17981817541443,-0.07079875389666068,0.131696800299256,0.2024955541959167,213444513,206354848.6,68.69870870637538,83.9978661801426,NaN,NaN,12.127337082911625,20.484169955344598
2009-10-07T09:30:00-04:00,20.74001,20.81,20.64999,20.75,5191137,8341274.7,56.06248095668242,58.564923873180376,NaN,NaN,10.828598936483134,-52.589590344782565,-0.055507682201280856,0.13311095144431562,0.18861863364559647,208253376,204969755.4,66.21270233627978,81.98673918752829,NaN,NaN,12.06690521289767,19.281703563566467
2009-10-08T09:30:00-04:00,20.92,20.98,20.75999,20.88,4999238,7804861.6,58.52413091674343,57.88469400655841,NaN,NaN,64.53994571105426,-29.686878394585666,-0.036437034059338264,0.14307234107142364,0.1795093751307619,213252614,207824971.6,68.72513157954437,80.13882988110497,NaN,NaN,12.800352281319466,18.35579623753118
2009-10-09T09:30:00-04:00,20.8,21.02,20.77,21.02,9212773,7677416.25,61.054683528144665,57.601743263440845,NaN,NaN,84.67727335005398,11.783171388335564,-0.015275911502355993,0.16041448575281692,0.1756903972551729,222465387,212522742.4,72.3661234060858,78.53686955038181,NaN,NaN,14.207196601542849,17.763139146675705
2009-10-12T09:30:00-04:00,21.10001,21.14999,20.92,21.03,3998760,7651140.4,61.23661099112372,57.19338114573585,NaN,NaN,116.60563508155062,56.00726534223619,-0.002175300496764121,0.17297127163421777,0.1751465721309819,226464147,216776007.4,75.18312217394616,77.12054929137291,NaN,NaN,15.385141054375318,17.423425133489935
2009-10-13T09:30:00-04:00,21.03999,21.157,20.95,21.11,4807926,7662912.3,62.7363081745837,56.89214025542084,NaN,NaN,120.76835644055777,79.48396190393996,0.009658576766914395,0.1872197930896249,0.1775612163227105,231272073,220341519.4,77.27454381075287,75.85290033056228,NaN,NaN,16.806420205410287,17.3352815723357
2009-10-14T09:30:00-04:00,21.41,21.41,21.24001,21.36,9181137,7580041.8,67.02916572655755,57.39765246444733,NaN,NaN,199.47649002245288,117.21354012113389,0.030905127459980447,0.21619262564768604,0.1852874981877056,240453210,226781486.2,80.47512675480215,74.81287817456236,NaN,NaN,19.397845891007815,17.62993361786029
2009-10-15T09:30:00-04:00,21.25999,21.33,21.17,21.32001,5721445,7579793.55,65.72483954608276,58.102125365252924,NaN,NaN,152.63889316094065,134.8333296111112,0.03836065684177428,0.23323831923992344,0.19487766239814916,234731765,231077316.4,82.26902293961724,74.34141072423526,NaN,NaN,21.14068160694023,18.131469044871707
2009-10-16T09:30:00-04:00,21.23,21.24001,21,21.12,7215582,7613102.9,59.48966117427004,57.85313496906151,NaN,NaN,90.33993226637236,135.96586139437485,0.026481875811665778,0.22798000716273137,0.2014981313510656,227516183,232087475.6,82.67218557129792,74.01535810282296,NaN,NaN,20.825754043693937,18.51636690184631
2009-10-19T09:30:00-04:00,21.17999,21.36,21.10001,21.35001,9162156,7770818.1,63.748796754968545,58.14752229821132,NaN,NaN,122.26361891658746,137.09745816138224,0.030489943156732424,0.23961056029698113,0.2091206171402487,236678339,234130314,83.48976459738782,74.32366904085394,NaN,NaN,21.8643717813692,18.994653313206722
2009-10-20T09:30:00-04:00,21.49001,21.5,21.17999,21.28,7084746,7840488.2,61.62501128883519,58.20287734741129,NaN,NaN,120.02672190658849,136.94913125458837,0.025029401524203326,0.24040736904550286,0.21537796752129953,229593593,233794618,82.7984037921456,74.73859508754353,NaN,NaN,22.08265622156418,19.435796585829216
2009-10-21T09:30:00-04:00,21.28999,21.63,21.2301,21.28999,9058492,7967116.9,61.82047192248993,59.36777227379541,NaN,NaN,122.24690122385287,121.50321349486835,0.01896873587386036,0.239088887363625,0.22012015148976463,238652085,233434393,82.0135844843934,75.51800659341332,NaN,NaN,22.31503472000935,19.847116319283522
2009-10-22T09:30:00-04:00,21.3,21.45,21.14,21.39,10329613,8204501.45,63.807882761774614,60.6746251172713,NaN,NaN,95.34126252878717,110.04368736843767,0.018551266734480765,0.2433092349078656,0.22475796817338484,248981698,236284379.6,83.35763733859866,76.57224697723412,NaN,NaN,23.074227281450845,20.30813217102171
2009-10-23T09:30:00-04:00,21.67,21.7,21.24001,21.33,16498969,8568320.8,61.73173579389775,61.54436395886675,NaN,NaN,105.55928507769242,113.08755793070168,0.011438981786526303,0.23905669540654273,0.22761771362001643,232482729,237277688.8,83.81168322229662,77.81055290810887,NaN,NaN,23.144131035308583,20.713274865919836
2009-10-26T09:30:00-04:00,21.38,21.59,21.14,21.19,10610004,8845674.1,57.06597499886375,61.546982466787014,NaN,NaN,70.91575893548529,102.81798593448124,-0.0046281311394179014,0.22183254969574406,0.22646068083516196,221872725,234316566,77.06202443502906,78.40793260301271,NaN,NaN,21.892064276950236,20.881673353209894
2009-10-27T09:30:00-04:00,21.2,21.32001,21,21.08,9355883,8758060.45,53.635786644370626,61.37364715876475,NaN,NaN,29.36554505812444,84.68575056478844,-0.02354061378732558,0.197034913601005,0.22057552738833058,212516842,230901215.8,70.05432134810177,78.682333961,NaN,NaN,19.83561402978439,20.73223630700625
2009-10-28T09:30:00-04:00,20.94,21.12,20.75999,20.77,13055844,8665449.5,45.36067394981924,60.43340023255587,NaN,NaN,-28.15167794400401,54.606034731217065,-0.05595497440411923,0.15063180938318155,0.20658678378730078,199460998,223062998.4,57.19881814501119,77.85902585853334,NaN,NaN,15.320450549917341,19.95912405599355
2009-10-29T09:30:00-04:00,20.97,21.2,20.86,21.17,10726391,8391653.6,55.006730363374395,60.00140357792942,NaN,NaN,9.693261301466595,37.47643448575295,-0.049694762195511,0.144468331042912,0.194163093238423,210187389,215304136.6,47.84018549478625,76.10717315058336,NaN,NaN,14.380259964494726,19.162143471493717
2009-10-30T09:30:00-04:00,21.14999,21.14999,20.59,20.61,11335371,8600672.35,43.44344087765812,58.730462855539024,NaN,NaN,-84.32534222635276,-0.5004909750560899,-0.08067394050910665,0.09332066760203972,0.17399460811114636,198852018,208577994.4,41.50096000993614,73.70130442458266,NaN,NaN,9.06217428689057,17.719290730836125
2009-11-02T09:30:00-05:00,20.63,20.88,20.46049,20.73,16750715,9127143.65,46.06013710334738,57.539307779022145,NaN,NaN,-127.82773067419681,-40.24918889699251,-0.08979018401218081,0.06175687809592034,0.15154706210810115,215602733,207323996,40.42545151446571,71.06922640341928,NaN,NaN,5.934950870940651,16.035813607993916
2009-11-03T09:30:00-05:00,20.56,20.64999,20.46001,20.64999,15033207,9466469.45,44.579154808029166,55.935735570555835,NaN,NaN,-155.29986185170915,-77.18227027895924,-0.09728479593126482,0.02994106719402012,0.12722586312528494,200569526,204934532.8,38.38420123565295,68.06273172348006,NaN,NaN,3.007054471051158,14.17456230271638
2009-11-04T09:30:00-05:00,20.74001,21.02,20.74001,20.77,7939566,9603890.9,47.31546687019061,54.62078037942068,NaN,NaN,-77.87275069475832,-87.12648482911008,-0.0903835798032409,0.01424638837123382,0.10462996817447472,208509092,206744151.6,40.8213275165741,65.10218205040555,NaN,NaN,1.5515166302314736,12.371270063789964
2009-11-05T09:30:00-05:00,21.06,21.27,21.00999,21.22,6739699,9690913.95,56.073369838578714,54.37675956972844,NaN,NaN,23.033929311391045,-84.4583512271252,-0.05355591735769551,0.037685071477355336,0.09124098883505084,215248791,207756432,42.19860882398356,62.211212282740235,NaN,NaN,3.356050825514159,11.083381601179136
2009-11-06T09:30:00-05:00,21.11,21.3,21.07001,21.25,4962047,9478377.65,56.59143671963415,53.86551956720456,NaN,NaN,32.854339924743044,-61.022414796906034,-0.02658285908667085,0.05801241497671228,0.08459527406338313,220210838,212028196,47.72731315511743,59.65675146543521,NaN,NaN,4.9122607452758285,10.201792907478664
2009-11-09T09:30:00-05:00,21.42,21.81,21.36,21.74001,7437367,9650308,64.04957373999369,54.03870259943017,NaN,NaN,157.9168338202903,-3.873501898008624,0.022216903163520874,0.11236640301778422,0.09014949985426335,227648205,214437290.4,50.59721945034968,57.35666686959264,NaN,NaN,9.016947138500619,10.032529226196086
2009-11-10T09:30:00-05:00,21.69,21.8,21.6209,21.73,5367594,9678291.4,63.8083908160238,54.18069680611115,NaN,NaN,158.41167036361173,58.86880454505556,0.050178311360957475,0.1528723890554602,0.10269407769450271,222280611,218779507.4,55.35503665628184,55.45248488187038,NaN,NaN,12.055668748872634,10.321549158007022
2009-11-11T09:30:00-05:00,21.86,21.92,21.72,21.86,5211555,9479812.3,65.61907151167725,54.310067431104194,NaN,NaN,168.62709026631686,108.16877273727059,0.0724336043118727,0.1932360830843436,0.12080247877247088,227492166,222576122.2,59.066968282070484,53.71743709211837,NaN,NaN,15.112173501683069,11.005924064246457
2009-11-12T09:30:00-05:00,21.86,21.955,21.67999,21.7,6361316,9511805.85,61.53831315084694,54.29625152802914,NaN,NaN,134.1901435740309,130.40001558979856,0.07127354219731855,0.20989440651911906,0.1386208643218005,221130850,223752534,60.17197219979306,52.02888630479669,NaN,NaN,16.373135292667843,11.772668525449513
2009-11-13T09:30:00-05:00,21.8,21.96001,21.64999,21.89999,5436160,9422834.75,64.5092849449027,54.82791652417478,NaN,NaN,129.3822100564406,149.70558961613807,0.07830927550939235,0.23650745870854095,0.1581981831991486,226567010,225023768.4,61.38507078625365,50.90910390131273,NaN,NaN,18.378938439677473,12.716421370339221
2009-11-16T09:30:00-05:00,22,22.17999,21.94,22.14,8003547,9364904.3,67.73082680622298,55.83470510716423,NaN,NaN,156.91035052941402,149.50429295796283,0.09248865007647439,0.2738089957947416,0.18132034571826722,234570557,226408238.8,62.71693995972863,50.38500523071466,NaN,NaN,21.12927549202323,13.918257673436937
2009-11-17T09:30:00-05:00,22.05,22.24001,22.03,22.24001,5001820,9260758,68.99380618778463,57.522785981304615,NaN,NaN,145.99650295507237,147.02125947625495,0.1012569410652294,0.30789152204980397,0.20663458098457457,239572377,229866592,65.88252216582922,51.005269803630235,NaN,NaN,23.762503802264696,15.324578548983759
2009-11-18T09:30:00-05:00,22.21001,22.21001,21.99001,22.12,4210660,9018366.4,65.67219607668886,58.28460496082708,NaN,NaN,116.1768636561794,136.53121415422748,0.0919020739506286,0.3215121734228603,0.2296100994722317,235361717,231440502.2,67.24555879932846,52.39136789681181,NaN,NaN,24.950834782325778,16.699758010889763
2009-11-19T09:30:00-05:00,21.97,21.98,21.67,21.8,10573480,9030559.75,57.69590869215536,59.30263837614831,NaN,NaN,63.021232529252124,122.29743194527173,0.058706002029785986,0.3029926020094642,0.24428659997967822,224788237,232171979.6,67.88766685273171,54.27613267129721,NaN,NaN,23.4827697115118,17.668759682407195
2009-11-20T09:30:00-05:00,21.66,21.74001,21.61,21.69,5551281,8483175.35,55.21339804307459,59.95644272898597,NaN,NaN,39.03673159477709,104.22833625293902,0.02557482430936414,0.2762551303663834,0.25068030605701924,219236956,230705968.8,65.13183827958864,56.04087458309171,NaN,NaN,21.511929931951997,18.21778400377074
2009-11-23T09:30:00-05:00,21.91,22.11,21.89,22.07001,7236020,8314476.15,61.3934744477086,61.15746556039164,NaN,NaN,80.84830190197128,89.01592652745049,0.025434115348774045,0.2824729502429868,0.25703883489421275,226472976,229086452.6,62.13126444487352,57.73709338375032,NaN,NaN,21.743909917214303,18.721516277119818
2009-11-24T09:30:00-05:00,22.06,22.065,21.89999,22.03,7012512,8197307.6,60.4477082650372,62.09548280288068,NaN,NaN,70.77687497636292,73.97200093170859,0.019115904621114954,0.28093371567060643,0.2618178110494915,219460464,225064070,55.31513649175132,58.77236545340583,NaN,NaN,21.635967284277235,19.137866420999448
2009-11-25T09:30:00-05:00,22.07001,22.1091,22.00999,22.07001,3507571,7719893.95,61.09317233722819,62.454040124212796,NaN,NaN,74.73866865576994,65.68436193162668,0.014320086955951994,0.2797179197444315,0.2653978327884795,222968035,222585333.6,51.56123796521122,59.441124677779236,NaN,NaN,21.73753740478511,19.509247990111685
2009-11-27T09:30:00-05:00,21.53999,21.85899,21.46001,21.71001,5257430,7446445.9,52.75148771604554,62.1797580525279,NaN,NaN,14.38569370126785,55.95725416602985,-0.014830461623105418,0.24685975575959773,0.26169021738270315,217710605,221169807.2,49.49549389309058,59.56742330192018,NaN,NaN,19.20738112878604,19.46612415277945
2009-11-30T09:30:00-05:00,21.7,21.8,21.56,21.75,6983148,7228834.75,53.51084528417239,61.42699173425494,NaN,NaN,13.171628138127165,50.78423347469986,-0.03215773481157064,0.22149304886823984,0.2536507836798105,224693753,222261166.6,51.121439777828854,59.60486761102583,NaN,NaN,17.396938036569225,19.17052613617799
2009-12-01T09:30:00-05:00,21.92,22.14951,21.91,22.10001,8527055,6817651.75,59.62681016499034,61.12830740203826,NaN,NaN,76.19325555837166,49.85322420597994,-0.021308037628393478,0.22701573664431862,0.2483237742727121,233220808,223610733,53.130874738719356,59.44599890262851,NaN,NaN,17.68672023799505,18.958553865008998
2009-12-02T09:30:00-05:00,22.10001,22.27,22.03,22.07001,5212133,6326598.05,58.91142757669426,60.649189978110904,NaN,NaN,89.83272584578596,53.664394379864554,-0.017569105448938666,0.22636239246153878,0.24393149791047744,228008675,225320375.2,55.61995522871251,59.19978368453152,NaN,NaN,17.70453892468208,18.779408873533725
2009-12-03T09:30:00-05:00,22.17,22.27,22.03,22.08,6448227,6252031.1,59.08745575471997,60.47412873553041,NaN,NaN,87.22447584110239,56.161555816931035,-0.01589095209729427,0.2240678077888596,0.23995875988615387,234456902,227618148.6,58.787804406961754,59.10091455647214,NaN,NaN,17.768788513626852,18.635034536404174
2009-12-04T09:30:00-05:00,22.31,22.45,22,22.22,11021195,6466105.9,61.572050613584935,60.26432628329342,NaN,NaN,107.70690388742217,74.82579785416189,-0.0072592733955390565,0.23088466814173003,0.2381439415372691,245478097,233171647,65.24492788570042,59.37661863500404,NaN,NaN,18.529360773802576,18.619938284603947
2009-12-07T09:30:00-05:00,22.24001,22.31,22.13,22.181,6636500,6549828.55,60.470351893546614,59.745720932387954,NaN,NaN,97.3137495957081,91.65422214567809,-0.006128563048118402,0.2304832377271211,0.2366118007752395,238841597,236001215.8,67.99631451990354,59.75371681787369,NaN,NaN,18.861679776958486,18.65447278351174
2009-12-08T09:30:00-05:00,22.08,22.17,21.89999,21.98,8826262,6619273.3,55.007524691493025,58.74670082550999,NaN,NaN,22.03172057308335,80.82191514862043,-0.020083081355707327,0.21150794908060533,0.23159103043631266,230015335,235360121.2,66.70777882618567,59.812663722184865,NaN,NaN,17.61273594544916,18.505653235217085
2009-12-09T09:30:00-05:00,22.02,22.19,21.88,22.19,7479508,6724869,59.15879866259664,58.28145815307482,NaN,NaN,46.00889689960694,72.0571493593846,-0.016486376592516006,0.21098305969566766,0.22746943628818367,237494843,237257354.8,68.60391674543904,59.90968928976418,NaN,NaN,17.712672068246682,18.39237021136417
2009-12-10T09:30:00-05:00,22.27,22.39,22.25,22.28999,10928363,7010709.4,61.00375566539488,58.51773293687766,NaN,NaN,132.2876776412238,81.06978971940887,-0.009060455848693166,0.2161438664773172,0.22520432232601037,248423206,240050615.6,71.2042604298017,60.14658883098347,NaN,NaN,18.328334567234833,18.383222262202835
2009-12-11T09:30:00-05:00,22.37,22.39999,22.17,22.24001,4097984,6897542.8,59.5555366350881,58.82788569345005,NaN,NaN,108.6194417038546,81.25229728269537,-0.009173820179708053,0.2137370471013753,0.22291086728108336,244325222,239820040.6,70.68383227727746,60.54315983081839,NaN,NaN,18.438671826735323,18.39114362856462
2009-12-14T09:30:00-05:00,22.41,22.45,22.3,22.42,11716500,7211559.8,62.965293359123294,58.940158472836806,NaN,NaN,149.7278585627766,91.73511907610906,0.0006903375501591813,0.22377378921878233,0.22308345166862315,256041722,243260065.6,73.76471173822824,61.374120351772284,NaN,NaN,19.512446690630377,18.5513297802883
2009-12-15T09:30:00-05:00,22.37,22.46001,22.2,22.28,5083781,7065571.5,58.81198213421882,58.82332089206407,NaN,NaN,103.55053426558706,108.0388818146098,-0.004131470300812484,0.21791911379260753,0.22205058409342002,250957941,247448586.8,76.94210499194824,62.918903816072074,NaN,NaN,19.24871926667043,18.65095684977146
2009-12-16T09:30:00-05:00,22.39,22.46001,22.31,22.35001,4482949,7039627.95,60.224913615241675,58.761302411922166,NaN,NaN,117.75758158247693,122.3886187511838,-0.00449362569334244,0.21643355197674197,0.2209271776700844,255440890,251037796.2,79.26010985285296,64.89739466518934,NaN,NaN,19.42374307807473,18.761354882386215
2009-12-17T09:30:00-05:00,22.27,22.27,22.06,22.08,5126059,7085397.9,52.71418363493653,58.758637834700096,NaN,NaN,22.591425037881216,100.44936823051528,-0.023730612707996007,0.1912639117850894,0.2149945244930854,250314831,251416121.2,79.4941143180512,67.04015326697224,NaN,NaN,17.33156591670951,18.55709931586097
2009-12-18T09:30:00-05:00,22.22,22.36,22.12,22.33,7314840,6922465.9,57.94391785962355,59.07528587580375,NaN,NaN,69.07740449834137,92.54096078941262,-0.02054963364182577,0.1893074824408032,0.20985711608262897,257629671,254077011,81.108580033776,69.18209185668276,NaN,NaN,17.09984405359765,18.348919992680496
2009-12-21T09:30:00-05:00,22.47,22.62,22.41,22.53,6207656,6955284.65,61.602604116702615,59.216414015211775,NaN,NaN,158.65831446978933,94.32705197081518,-0.006628306342387924,0.20157173315464405,0.20820003949703197,263837327,255636132,82.00269896793681,71.24436501591258,NaN,NaN,18.058348742106585,18.307409814027082
2009-12-22T09:30:00-05:00,22.60001,22.71001,22.58,22.71001,3804425,6783704.9,64.58860994792502,59.62192704172826,NaN,NaN,183.65226316250858,110.34739775019948,0.012034476324806365,0.22324313490303993,0.21120865857823357,267641752,258972894.2,83.77282330599331,73.25528416428976,NaN,NaN,19.819071636673268,18.523361502976538
2009-12-23T09:30:00-05:00,22.75999,22.82001,22.67,22.8,5491605,6707659.55,66.01160012588824,60.116508782526,NaN,NaN,187.24420761305254,124.2447229563146,0.02691848235032185,0.2448567615161359,0.21793827916581404,273133357,262511387.6,85.41147140895103,75.15697466443187,NaN,NaN,21.70068902695569,18.97726543497356
2009-12-24T09:30:00-05:00,22.87,23.02,22.82001,23.00999,1666549,6615608.45,69.1290401401059,60.65629374870606,NaN,NaN,205.95535791458158,160.91750953165467,0.04625054718518712,0.2757514631472979,0.2295009159621108,274799906,267408402.6,87.31985121243895,76.73375490205605,NaN,NaN,24.310034832297394,19.739089634591252
2009-12-28T09:30:00-05:00,23.05,23.11,22.95,23.08,9133723,6809423.1,70.11325990180202,61.34507289215288,NaN,NaN,198.323885936448,186.766805819276,0.058318539391406826,0.30239909020136935,0.24408055080996252,283933629,272669194.2,88.98662977706914,78.23306313471073,NaN,NaN,26.740900099307847,20.73934827240791
2009-12-29T09:30:00-05:00,23.12,23.12,23.00999,23.05,3849384,6652734.9,69.0966719964035,62.35144055678934,NaN,NaN,168.18482937177922,188.67210879967396,0.05868560320330318,0.3174375548140915,0.25875195161078834,280084245,275918577.8,89.8721629441873,79.88766200028228,NaN,NaN,28.43179747465828,21.838269587015105
2009-12-30T09:30:00-05:00,23.00999,23.14,22.98,23.13,5683445,6510554.4,70.33201140888426,63.149527181524164,NaN,NaN,143.25264302507836,180.59218477218795,0.05858569635008609,0.331984072048396,0.2733983756983099,285767690,279543765.4,90.76436934578165,81.47055147173532,NaN,NaN,30.210710330033265,23.034332550303414
2009-12-31T09:30:00-05:00,23.14999,23.17999,22.87,22.92999,5763691,6538132.3,63.49783236791806,63.32767551741868,NaN,NaN,106.09532403614861,164.36240805680714,0.04019522591480623,0.32364240809181766,0.2834471821770114,280003999,280917893.8,91.08496183911119,82.89060157240029,NaN,NaN,29.799718971797766,24.000816324802607
2010-01-04T09:30:00-05:00,23.14,23.28999,23.10001,23.27,8449676,6638204.75,69.01061572130824,64.00303830929155,NaN,NaN,131.4527205678967,149.46188058747018,0.04567584518671208,0.34054198866040153,0.29486614347368945,288453675,283648647.6,91.70145552504822,84.39186037581248,NaN,NaN,31.161949418197338,25.02383533814471
2010-01-05T09:30:00-05:00,23.3,23.3,23.10001,23.24001,19988208,7086555.4,68.03461162778788,64.36513247133902,NaN,NaN,113.15041814480936,132.42718702914243,0.04211445780571044,0.3475092157308275,0.30539475792511706,268465467,280555015.2,84.56675214849021,85.1634346908312,NaN,NaN,31.958448083990376,26.014494301836947
2010-01-06T09:30:00-05:00,23.24001,23.25,22.96001,22.98,10024016,7255931.2,60.09866350892968,64.45703828381836,NaN,NaN,77.03477061351958,114.19717527749053,0.018297083239313117,0.3282661119742585,0.30996902873494536,258441451,276226456.4,75.69286440073806,85.07420322003045,NaN,NaN,30.16150168193576,26.60692392756535
2010-01-07T09:30:00-05:00,23,23,22.81,22.89,7293125,7179274.35,57.59436527102312,64.26914197351704,NaN,NaN,41.87819468195075,93.92228560886501,-0.006159867268275998,0.30226919464960034,0.30842906191787633,251148326,269302583.6,64.10515316557604,83.9917063137964,NaN,NaN,27.91390973247992,26.79363618541029
2010-01-08T09:30:00-05:00,22.86,23.06,22.78011,23.03999,11886660,7399631.95,60.54507782179,64.8284915582923,NaN,NaN,47.787478424902595,82.2607164866158,-0.014405977103230938,0.29042159053883765,0.3048275676420686,263034986,265908781,59.312141263011874,82.55013680986501,NaN,NaN,26.897645339657767,26.808494636017073
2010-01-11T09:30:00-05:00,23.14,23.14999,22.84,22.95,15241332,7615280.4,57.940127689337814,64.82822083184331,NaN,NaN,47.151100179900745,65.4003924090166,-0.027341300184273165,0.27065094241172716,0.2979922425960003,247793654,257776776.8,49.71950344336293,80.3080599105498,NaN,NaN,25.273018912122165,26.589140961174945
2010-01-12T09:30:00-05:00,22.82001,22.85001,22.61,22.7,9742883,7897525.35,51.33252879587424,64.09464402321271,NaN,NaN,-14.172736100867379,39.93576155988125,-0.05268678830605705,0.232133757213429,0.28482054551948605,238050771,251693837.6,43.98845922250141,77.59275707159013,NaN,NaN,21.753741208794423,25.898369567977728
2010-01-13T09:30:00-05:00,22.8,22.95,22.60001,22.92,10053633,7814382,56.07932498936259,63.48683795474397,NaN,NaN,5.139259247734007,25.556659286724134,-0.05436768923945767,0.21686093397016393,0.2712286232096216,248104404,249626428.2,42.20773479514773,74.6238221779583,NaN,NaN,20.210970404988444,25.085883973264973
2010-01-14T09:30:00-05:00,22.89999,23.058,22.87,22.98,7508602,7935623.05,57.30246962218606,62.864757204479524,NaN,NaN,36.95749784547304,24.5725199194286,-0.0512148810275293,0.20721002192521,0.2584249029527393,255613006,250519364.2,43.27581715768506,71.61413258858217,NaN,NaN,19.335310199430435,24.264373434145753
2010-01-15T09:30:00-05:00,23.02,23.03999,22.59,22.66,13533258,8388138.5,49.40068496634147,61.455588977782064,NaN,NaN,-28.1042464258173,9.394174949284622,-0.06933165616119602,0.17176033275124425,0.24109198891244027,242079748,246328316.6,39.57854208300138,68.20403907933662,NaN,NaN,15.970856943051423,23.07958536398942
2010-01-19T09:30:00-05:00,22.71001,23.05,22.71001,23.05,7482746,8505972.85,57.15511896139336,60.53000748203859,NaN,NaN,15.920219898157189,3.1479988929359157,-0.05436152060723845,0.1731400881533922,0.22750160876063066,249562494,246682084.6,40.04418013981757,64.70814981953293,NaN,NaN,15.642078703467337,22.017084412486266
2010-01-20T09:30:00-05:00,22.87,22.87,22.47,22.67999,14698953,8875178.5,49.41730843287945,59.124338656072595,NaN,NaN,-108.09031433631357,-15.63551675415332,-0.06781607145336549,0.14273151944392382,0.2105475908972893,234863541,246044638.6,39.45416967693058,61.10686458615745,NaN,NaN,12.561982162157731,20.66635551958219
2010-01-21T09:30:00-05:00,22.75,22.86,22.37,22.44,12805469,9205069.15,45.14792535838483,57.325475366751206,NaN,NaN,-163.4326421719002,-49.349897038080165,-0.08992921607523735,0.0981360708032426,0.18806528687847995,222058072,240835372.2,34.9254063471909,57.118367229115265,NaN,NaN,8.536197806756478,18.933475846321375
2010-01-22T09:30:00-05:00,22.39999,22.39999,21.63,21.66,33702080,10699951.9,34.66535420299975,55.26601264068562,NaN,NaN,-335.0675798830126,-123.75491258377731,-0.15056740171352484,-0.0001439652634260824,0.15042343645009876,188355992,227383969.4,26.474693396668442,52.50334805465507,NaN,NaN,0.5040185488000133,16.300696232389754
2010-01-25T09:30:00-05:00,21.86,21.98,21.72,21.84,33340304,12092386.85,38.22964169841216,53.06737163905017,NaN,NaN,-257.8520769016969,-169.70447867895322,-0.17056545198570175,-0.06278337853202842,0.10778207345367333,221696296,223307279,24.53694573671835,47.705883069774366,NaN,NaN,-4.176499876396542,13.375382502563141
2010-01-26T09:30:00-05:00,21.8,22.05,21.67999,21.78,16125258,12815322.3,37.49534766473463,50.885995641689235,NaN,NaN,-199.25539840396578,-212.73960233937783,-0.17897020804950306,-0.11593068660820549,0.06303952144129757,205571038,214508987.8,20.969694691849412,43.16323610858574,NaN,NaN,-7.944019863917207,10.329753593065949
2010-01-27T09:30:00-05:00,21.78999,22.00999,21.63,21.96001,17684928,13242882.55,41.147625649669536,49.532350080313506,NaN,NaN,-156.2835028716868,-222.37824004645245,-0.16394313390288498,-0.14188939593730865,0.022053737965576324,223255966,212187472.8,20.137772982331015,39.195015292985246,NaN,NaN,-9.715382075159756,7.46616278331942
2010-01-28T09:30:00-05:00,21.85001,21.88,21.24001,21.33,23143472,14207586.95,33.721057625209625,47.82711381989826,NaN,NaN,-177.1941468977977,-225.13054099163196,-0.1863371110693251,-0.21086765087108006,-0.024530539801754958,200112494,207798357.2,18.63270387776157,35.9469832009985,NaN,NaN,-14.054145215745828,4.391833069167241
2010-01-29T09:30:00-05:00,21.53,21.56,20.86,20.959,26897584,15268293.9,30.257749323815247,45.663733212900055,NaN,NaN,-181.69167553651405,-194.45536012233225,-0.21405783587153793,-0.29210283464117737,-0.07804499876963944,173214910,204770140.8,17.65243718603891,32.97129005264328,NaN,NaN,-18.86142314308992,1.0699393245590754
2010-02-01T09:30:00-05:00,21.06,21.25,21.05,21.2,19215152,15940866.95,34.932735507406306,44.020348057047805,NaN,NaN,-144.3418737209445,-171.75331948618177,-0.20411980533132965,-0.3331947554338015,-0.12907495010247186,192430062,198916894,15.910086692142656,30.556331713270403,NaN,NaN,-20.994191691340422,-2.0820793919979956
2010-02-02T09:30:00-05:00,21.27,21.47,21.14999,21.41,13695574,16203161.85,38.78344031925957,43.12398459443248,NaN,NaN,-107.46472249818183,-153.395184305025,-0.17261208174936554,-0.3448400522891788,-0.17222797053981326,206125636,199027813.6,16.07912960565008,28.562808169209596,NaN,NaN,-21.363847841823162,-4.8366177419730185
2010-02-03T09:30:00-05:00,21.33,21.50999,21.3084,21.46001,14784027,15942952.8,39.69866318535923,41.95393732271795,NaN,NaN,-87.44767601786012,-139.62801893425964,-0.13905334956148044,-0.3460446574916638,-0.20699130793018336,220909663,198558553,15.933198953318737,26.686055609078952,NaN,NaN,-21.35590741894807,-7.196516267255168
2010-02-04T09:30:00-05:00,21.33,21.37,20.84,20.86,16489074,16266205.7,33.27153330704263,40.237441871636285,NaN,NaN,-114.73072178929215,-127.13533391255854,-0.14713411623201414,-0.390908953220201,-0.2437748369881869,204420589,199420172,17.41527193498129,24.83887380745725,NaN,NaN,-23.558203589229077,-9.533900170394299
2010-02-05T09:30:00-05:00,20.89,21.11,20.71001,21.07001,23253680,17064233.45,37.10942678389919,39.35949485860469,NaN,NaN,-108.79094682119525,-112.5551881694948,-0.1288611744955066,-0.40485130510757017,-0.27599013061206357,227674269,210312043.8,33.39958392703112,24.39751965345937,NaN,NaN,-24.03496421668333,-11.605480748435589
2010-02-08T09:30:00-05:00,21.10001,21.22,20.95,20.98,22944928,17617146.85,36.14975527272059,37.8591117379852,NaN,NaN,-92.6023695864299,-102.20728734259187,-0.11388101150203767,-0.41834139498961065,-0.304460383487573,204729341,212771899.6,36.39381533675692,24.136779310383613,NaN,NaN,-24.71475930605187,-13.478234828095058
2010-02-09T09:30:00-05:00,21.21001,21.36,21.02,21.16,15891508,17649655.65,39.5182004819589,37.15203259863374,NaN,NaN,-74.60143172479424,-95.63462918791434,-0.08425901806226077,-0.409784156065399,-0.3255251380031382,220620849,215670942.2,39.8273182366977,24.16343277893841,NaN,NaN,-24.225822975531507,-15.013604563443122
2010-02-10T09:30:00-05:00,21.21001,21.24001,20.97,21.10001,10423313,17683677.15,38.78384087971107,36.69745513587133,NaN,NaN,-75.68754074040112,-93.28260213242257,-0.06213620059586333,-0.40319538874796734,-0.341059188152104,210197536,213528516.8,38.186778009270085,24.396387897658354,NaN,NaN,-24.045856166972946,-16.30392622109024
2010-02-11T09:30:00-05:00,21.10001,21.39999,20.95,21.32001,15175828,17939786.9,42.96935133676245,37.290597788282945,NaN,NaN,-56.798665772909985,-81.69619092914613,-0.02786350733187898,-0.3758885723169527,-0.34802506498507374,225373364,217719071.8,43.12193688695602,25.58547671839318,NaN,NaN,-22.645716512853667,-17.20989626277073
2010-02-12T09:30:00-05:00,21.17,21.3985,21.03999,21.36,15143551,18321534.35,43.7225853086873,37.6829509033026,NaN,NaN,-46.737839247880245,-69.28556941448312,0.0008035503915811426,-0.3470206269955973,-0.34782417738717847,240516915,220287601,45.9693943076103,27.116365902028317,NaN,NaN,-21.28736289929312,-17.79239149655964
2010-02-16T09:30:00-05:00,21.49001,21.67999,21.42999,21.67999,10233484,18156545.65,49.47318571048372,38.53851076371325,NaN,NaN,2.6748891292408183,-50.23011767134897,0.04232144423658368,-0.2949223720914489,-0.3372438163280326,250750399,229491812.6,54.717763098914524,29.526942216818686,NaN,NaN,-18.366284946190596,-17.87437627507835
2010-02-17T09:30:00-05:00,21.78,21.78,21.63,21.74001,8903297,18227573.2,50.49500095247636,39.206180428199445,NaN,NaN,34.51233477199055,-28.407364371992013,0.07303041940523575,-0.24595579207148788,-0.3189862114767236,259653696,237298382,60.55184189710277,32.41366142501666,NaN,NaN,-15.667890533246592,-17.55916402624524
2010-02-18T09:30:00-05:00,21.73,21.92,21.67999,21.88,5764039,17780827.5,52.88813204637344,40.575257172568286,NaN,NaN,69.94899179798762,0.7199421356857243,0.10029180600572596,-0.1936214539695662,-0.29391325997529216,265417735,248342421.8,67.02456928952309,35.87022324014249,NaN,NaN,-12.685878007257886,-16.86298030924705
2010-02-19T09:30:00-05:00,21.75999,21.92999,21.73,21.82001,6767797,17478943.9,51.73398824107905,42.10927423808713,NaN,NaN,87.71386404351995,29.62244809897171,0.110972382226593,-0.15519778219205094,-0.26617016441864394,258649938,254997736.6,70.19801518558508,39.62347881153864,NaN,NaN,-10.498526134478773,-15.953772569994438
2010-02-22T09:30:00-05:00,21.92999,21.94,21.74001,21.78,7037285,16145704.15,50.93563011094469,43.25233813833988,NaN,NaN,88.33663292581318,56.637342533710395,0.11172268268744939,-0.1265168110593322,-0.2382394937467816,251612653,257216884.2,71.19349722250612,43.57229384942175,NaN,NaN,-8.867093543476352,-14.941389851920427
2010-02-23T09:30:00-05:00,21.75999,21.77,21.42,21.50999,10485730,15002975.45,45.79904811864292,43.753452981152975,NaN,NaN,35.27963037322767,63.15829078250776,0.09127684542229084,-0.12414343696891805,-0.2154202823912089,241126923,255292189,69.03949425346242,47.3551770385512,NaN,NaN,-8.788427714552196,-14.062395260867822
2010-02-24T09:30:00-05:00,21.61,21.78999,21.588,21.72,7538969,14573661,50.020745733157526,44.49074459170999,NaN,NaN,70.7415079092186,70.40412540995338,0.089043200834105,-0.10411628134857764,-0.19315948218268264,248665892,253094628.2,66.56319157487991,50.97160508294843,NaN,NaN,-7.527211302533714,-13.128797552534378
2010-02-25T09:30:00-05:00,21.44,21.7,21.3,21.66,11657637,14272296.45,48.85005751512831,45.60349632085897,NaN,NaN,40.83635514846823,64.5815980800495,0.08090734225358168,-0.09202530436570555,-0.17293264661928723,237008255,247412732.2,60.519041601286936,54.050445773398835,NaN,NaN,-6.79070348052351,-12.223355542247111
2010-02-26T09:30:00-05:00,21.66,21.75,21.56,21.69,9701918,13600218.75,49.48663615750617,46.487582704688045,NaN,NaN,65.85137823171829,60.20910091768917,0.0750577709829286,-0.07911043289062647,-0.15416820387355507,246710173,245024779.2,58.13002703692679,55.816905995534235,NaN,NaN,-6.005314026430427,-11.335063897130443
2010-03-01T09:30:00-05:00,21.8,21.99001,21.75999,21.97,6422504,12576464.75,55.102890366075655,47.84137806849912,NaN,NaN,112.9789673951139,65.13756781154932,0.08673118860904078,-0.04575421811225411,-0.13248540672129488,253132677,245328784,58.355411864227285,57.38559146178212,NaN,NaN,-3.7036654294664877,-10.244864116035592
2010-03-02T09:30:00-05:00,22.07001,22.11,21.87,21.94,7011813,11966297.8,54.404936557424655,48.90471635960382,NaN,NaN,115.88262798578482,81.25816733406074,0.08879458265134095,-0.0214921784071187,-0.11028676105845965,246120864,246327572.2,59.1337431744125,58.76462181447604,NaN,NaN,-1.9752327760766502,-9.063488210327172
2010-03-03T09:30:00-05:00,22,22.06,21.88989,21.95,8331797,11698108.95,54.61131452695816,50.03525019155004,NaN,NaN,102.96699010655819,87.70326377352868,0.08707675930065083,-0.0014408119326461133,-0.08851757123329694,254452661,247484926,60.06514160396143,60.327362071239705,NaN,NaN,-0.4757758081782273,-7.836672152877323
2010-03-04T09:30:00-05:00,21.98,22.05991,21.8219,22.03999,3624507,11140132.95,56.51865159749672,51.00305735303106,NaN,NaN,95.08397128700578,98.55278700123617,0.087985302661514,0.021464057093595557,-0.06652124556791844,258077168,251698708.6,63.34111634002058,61.77158917503003,NaN,NaN,1.327739444936022,-6.5274704960468455
2010-03-05T09:30:00-05:00,22.2,22.34,22.12,22.31,7047809,10668069.7,61.71690204510986,52.288365691346954,NaN,NaN,146.4449985733541,114.67151106956335,0.10178029398982083,0.06070412191935759,-0.041076172070463234,265124977,255381669.4,65.96881253823811,63.20011904864625,NaN,NaN,4.46332680491921,-4.957356595908838
2010-03-08T09:30:00-05:00,22.35001,22.47,22.32001,22.42999,5861348,9798453.1,63.788703611447154,53.31090268427291,NaN,NaN,167.0236905814066,125.48045570682189,0.11312320120759561,0.10032782943903129,-0.012795371768564327,270986325,258952399,68.33840295652794,64.17302189561863,NaN,NaN,7.755602846124071,-3.1412195327612795
2010-03-09T09:30:00-05:00,22.39999,22.67,22.36,22.53,12001891,9251301.25,65.46622547406605,54.38027586438647,NaN,NaN,173.30423594324233,136.9647772983134,0.12080166808893815,0.13820671334260837,0.017405045253670214,282988216,266325869.4,72.58367124617817,65.03243827769545,NaN,NaN,11.051169786313501,-1.1137353443220253
2010-03-10T09:30:00-05:00,22.53999,22.72,22.52,22.67999,16908608,9302156.25,67.87023006546232,55.45042572289281,NaN,NaN,178.47581975316558,152.0665432276349,0.12869509223778908,0.17827391055090658,0.04957881831311749,299896824,275414702,76.72615900771085,65.72540897185172,NaN,NaN,14.624069498365577,1.1345224903476319
2010-03-11T09:30:00-05:00,22.62,22.77,22.58,22.77,5454762,9053728.7,69.25347906481738,56.701817924588404,NaN,NaN,166.88981146958193,166.4277112641501,0.13218835547701932,0.21481426265939163,0.08262590718237231,305351586,284869585.6,80.09544033220664,66.43236791089612,NaN,NaN,18.064838323239353,3.553139037903592
2010-03-12T09:30:00-05:00,22.83,22.96271,22.69,22.75,7459203,8667897.45,68.54731258437964,57.95979524411947,NaN,NaN,158.9628518458603,168.93128191865134,0.12541869527436783,0.23939927627533208,0.11398058100096427,297892383,291423066.8,82.0365880921942,67.20687440158812,NaN,NaN,20.750055597137926,6.0098414035084975
2010-03-15T09:30:00-04:00,22.67,22.75999,22.56,22.73,8781980,8349818.9,67.80275629644285,59.5314886853909,NaN,NaN,115.43476327367897,158.6134964571058,0.11228545568224757,0.25433740060377374,0.14205194492152617,289110403,295047882.4,83.02280083096807,68.2056820142671,NaN,NaN,22.826731580438466,8.412254285927064
2010-03-16T09:30:00-04:00,22.73,22.905,22.71001,22.89999,6614727,8168881.05,70.71440647127277,61.009607309541984,NaN,NaN,122.82017385961721,148.51668404038077,0.10772091061510033,0.2767030831904016,0.16898217257530126,295725130,297595265.2,83.70006878736469,69.42974467230172,NaN,NaN,25.502003426912122,10.8536470203535
2010-03-17T09:30:00-04:00,22.92999,23.10001,22.88,22.97,9810480,8214240.2,71.84372657915739,62.652012242686915,NaN,NaN,127.1222542332254,138.24597093639275,0.1021403304944983,0.29665758569342415,0.19451725519892585,305535610,298723022.4,84.00430003177534,71.10726313162232,NaN,NaN,28.108591737375612,13.318639122785232
2010-03-18T09:30:00-04:00,22.96001,23.05,22.92999,23,4502605,8151168.5,72.33601946687077,64.28411105049868,NaN,NaN,113.29531071478773,127.52707078543392,0.09342931931424975,0.31130390434173805,0.2178745850274883,310038215,299660348.2,84.26713640483732,72.9741995150445,NaN,NaN,30.450314771760073,15.766021358353067
2010-03-19T09:30:00-04:00,23.02,23.03,22.69,22.78999,9042992,8264928.25,63.911745710154285,64.91331500364716,NaN,NaN,80.80961173891991,111.89642276404584,0.0676830383822701,0.3024783830053259,0.23479534462305582,300995223,300280916.2,84.44932241403005,74.83805026860183,NaN,NaN,30.27960555538238,17.839390529357253
2010-03-22T09:30:00-04:00,22.67999,23.06,22.66,22.96001,8430793,8334603.65,67.23826105019151,65.82998103884479,NaN,NaN,81.01356231981205,105.01218257327245,0.05670740643337216,0.305679602664771,0.24897219623139885,309426016,304344038.8,85.62320474629075,76.73015466659315,NaN,NaN,31.0674272776667,19.72911006483003
2010-03-23T09:30:00-04:00,23.03999,23.2,22.94,23.17999,5978387,8109236.5,70.96716328467497,66.99825595011028,NaN,NaN,104.48578230146506,101.34530426164201,0.058624174709519083,0.3222524146182977,0.2636282399087786,315404403,308279893.4,86.6727016728679,78.63069467151503,NaN,NaN,32.892742857921256,21.609629035271634
2010-03-24T09:30:00-04:00,23.07001,23.14,23,23.07001,5877094,8026142.75,66.86931276363501,67.73758889054872,NaN,NaN,92.10419621287069,94.34169265757107,0.04733027681319102,0.3227910859252674,0.2754608091120764,309527309,309078233.2,86.88188351554555,80.31217804119538,NaN,NaN,33.1966223555353,23.2649137953093
2010-03-25T09:30:00-04:00,23.22,23.38,23.06,23.11,8332094,7859865.6,67.6018690427584,68.15794367609506,NaN,NaN,105.00292535844682,92.6832155863029,0.03781109385104697,0.3227246764258851,0.2849135825748381,317859403,310642470.8,87.30241884370908,81.83600706301475,NaN,NaN,33.65512491921793,24.74922967015339
2010-03-26T09:30:00-04:00,23.17,23.2,22.95,23,8580551,7803797.25,63.44618942217983,68.13347837686167,NaN,NaN,78.81097549756461,92.28348833803183,0.020245088600986727,0.3102199433260715,0.2899748547250848,309278852,312299196.6,87.7503261297283,83.22257300395763,NaN,NaN,32.83657672754611,25.904564964066637
2010-03-29T09:30:00-04:00,23.10001,23.2,23.03999,23.07001,7747289,7870036.5,64.92408725421998,68.09475421830125,NaN,NaN,84.85756231322003,93.05228833671343,0.009998005067109017,0.302472361058971,0.292474355991862,317026141,313819221.6,88.16289587452495,84.33537476312526,NaN,NaN,32.557539959533585,26.854989963419058
2010-03-30T09:30:00-04:00,23.13,23.25,23.03,23.17,5314770,7785184.35,66.97761851897867,68.03099625069527,NaN,NaN,89.72749893271666,90.10063166296375,0.006765915010522927,0.3009317497550157,0.29416583474449276,322340911,315206523.2,88.54219269637758,85.17937716945859,NaN,NaN,32.892662011027035,27.717514541648768
2010-03-31T09:30:00-04:00,23.10001,23.17999,23,23.10001,4678199,7602504.45,64.14667879583578,67.66622480291088,NaN,NaN,73.54096836743562,86.38798609387673,-0.002763028920602373,0.2907120485937398,0.29347507751434215,317662712,316833603.8,88.98787730917509,85.81455123924205,NaN,NaN,32.376999965553495,28.3831553164923
2010-04-01T09:30:00-04:00,23.16,23.28999,22.89999,23.06,9107594,7876658.8,62.51987103500822,67.23569326367006,NaN,NaN,66.45584133919583,78.67856929002654,-0.01381964482018938,0.27620052148910545,0.29002016630929484,308555118,314972746.8,84.91949152321376,86.02047291288632,NaN,NaN,31.493552025974676,28.82749770356121
2010-04-05T09:30:00-04:00,23.14,23.34,22.92731,23.33,4849586,7766747.65,68.35269294824559,67.27497445308454,NaN,NaN,97.52497499660191,82.421369189834,-0.005438558111948599,0.2832219686693591,0.2886605267813077,313404704,315797917.2,85.24170433976498,86.17896602065751,NaN,NaN,32.387791894320515,29.336111159383968
2010-04-06T09:30:00-04:00,23.25,23.41,23.16,23.35001,5071828,7727271.65,68.74095182863299,67.1340134071817,NaN,NaN,129.24495831008255,91.29884838920653,-0.0012550285980673648,0.2870917410337235,0.28834676963179084,318476532,316087995.4,85.36012306631716,86.29754132629697,NaN,NaN,33.227607178670496,29.892039162139188
2010-04-07T09:30:00-04:00,23.28,23.37801,23.14,23.25999,5710207,7412687.45,64.88438020907722,66.63691723789024,NaN,NaN,107.40746892365577,94.83484238739433,-0.006940751229300379,0.2796708305951654,0.2866115818244658,312766325,314173078.2,80.7536761247164,86.06535390436419,NaN,NaN,32.83661103769941,30.31269228721922
2010-04-08T09:30:00-04:00,23.17999,23.33,23.07001,23.3,8455145,6990014.3,65.80269579934287,66.17025126163826,NaN,NaN,91.31748329725583,98.39014537335838,-0.010200244728132968,0.27386127591429954,0.2840615206424325,321221470,314884829.8,81.16062574701866,85.84346028594857,NaN,NaN,32.762182367824124,30.66261944159135
2010-04-09T09:30:00-04:00,23.35001,23.49001,23.27,23.48,5489648,6991758.6,69.64828973460624,66.58000440624197,NaN,NaN,162.4773501215978,117.59444712983877,-0.0028110735965135025,0.28054767864679064,0.28335875224330415,326711118,318516029.8,83.1214327098524,85.74861102136445,NaN,NaN,33.815406573797205,31.11301760333504
2010-04-12T09:30:00-04:00,23.5,23.61,23.48,23.53,4160426,6826819.75,70.63608665740199,66.82270623532843,NaN,NaN,197.07186960479962,137.5038260514783,0.0025752323748645667,0.2865777927118849,0.2840025603370203,330871544,322009397.8,84.76432440750543,85.68726242573692,NaN,NaN,34.97710136894738,31.66502956985109
2010-04-13T09:30:00-04:00,23.5,23.64,23.42,23.60001,5939816,6684711.55,72.00970696543668,66.89717364109713,NaN,NaN,177.22480167674388,147.09979472481058,0.007694944183775587,0.29362124056673977,0.2859262963829642,336811360,325676363.4,86.27456661417095,85.65882420725858,NaN,NaN,36.35529501059951,32.33506748995801
2010-04-14T09:30:00-04:00,23.78999,23.95,23.75,23.94,14981242,7103037.3,77.51149753585494,67.65732969625569,NaN,NaN,251.38266174597865,175.89483328927514,0.029591130726660808,0.3229152097912902,0.2933240790646294,351792602,333481618.8,88.81584875259853,85.79696458133378,NaN,NaN,39.48653285116047,33.356705398701216
2010-04-15T09:30:00-04:00,23.96001,24.06,23.89,24.05,9493238,7087175.2,78.95294609341533,68.46812091415975,NaN,NaN,225.92585476676607,202.81650758317718,0.04610978366414664,0.3509613086448127,0.30485152498066603,361285840,341494492.8,90.71621667885007,86.04080728384385,NaN,NaN,42.54891484933266,34.669878177362854
2010-04-16T09:30:00-04:00,23.91,24.02,23.61,23.73,15204422,7622266.05,65.74986087503201,68.63266887507777,NaN,NaN,134.81763448463263,197.28456445578416,0.030845278669528575,0.34340812331757675,0.3125628446480482,346081418,345368552.8,91.47079755670963,86.30655524291394,NaN,NaN,40.740255305970415,35.537074910021076
2010-04-19T09:30:00-04:00,23.69,23.82001,23.52,23.78,8766746,7608453.75,66.68725497644877,68.75860942666554,NaN,NaN,97.71305967646902,177.41280247011804,0.02000212958346098,0.3375655066273744,0.3175633770439134,354848164,350163876.8,92.30457424575465,86.6023894122875,NaN,NaN,39.62604601264582,36.12121363896747
2010-04-20T09:30:00-04:00,23.86,23.96001,23.72,23.91,6944129,7534120.55,69.05841297300191,68.90723760195291,NaN,NaN,119.09824272308462,165.7874906793862,0.017558440723599356,0.3395114279484126,0.32195298722481325,361792293,355160063.4,93.06521518038083,86.92546244685916,NaN,NaN,39.46395877236192,36.598748658023815
2010-04-21T09:30:00-04:00,24.05,24.08,23.8407,23.96001,9400836,7705243,69.94468995561206,69.32138125622265,NaN,NaN,123.10233867590932,140.13142606537232,0.01536267885008602,0.3411563357874208,0.32579365693733475,371193129,359040168.8,93.59472540450196,87.25452302509679,NaN,NaN,39.606954918579575,37.02849240953178
2010-04-22T09:30:00-04:00,23.73,24.03999,23.56,24.02,10011055,7911941.05,71.01713462617658,69.92832865559183,NaN,NaN,91.23368436147051,113.1929919843132,0.01403930390645558,0.3433427868204042,0.3293034829139486,381204184,363023837.6,94.09338524192391,87.90980114786181,NaN,NaN,40.044803889277794,37.459394049495494
2010-04-23T09:30:00-04:00,24.00999,24.11,23.87,24.08,12870168,8138844.75,72.0898224573306,70.19526647766932,NaN,NaN,109.39788857565503,108.10904280251768,0.013300737454029599,0.3459294047314856,0.332628667277456,394074352,372622424.4,95.0860567001674,88.61296917360484,NaN,NaN,40.72112362685335,37.925355417689474
2010-04-26T09:30:00-04:00,24.13,24.16,24.02,24.05,9812813,8200457.85,70.68121263028921,70.33385653493049,NaN,NaN,109.65331029116236,110.49709292545636,0.007193529693414358,0.34162057939422397,0.3344270497008096,384261539,378505099.4,95.57669964821258,89.34272464374023,NaN,NaN,40.88228563428117,38.34777402005972
2010-04-27T09:30:00-04:00,23.95,24.06,23.535,23.58,28248992,9225543,53.15700020239367,69.49618653445309,NaN,NaN,30.541882398184544,92.78582086047633,-0.030054656097856847,0.2968587295784886,0.3269133856763454,356012547,377349150.2,93.59902288110918,90.260249412054,NaN,NaN,35.04763630024237,37.87632577437152
2010-04-28T09:30:00-04:00,23.73,23.73,23.44,23.64999,12760621,9597835.55,54.94830096330582,68.7208726175933,NaN,NaN,-0.560129443688811,68.05332723655671,-0.05033939124328135,0.2639891466222437,0.31432853786552506,368773168,376865158,92.73380465916865,91.08690504863613,NaN,NaN,30.971890670330936,36.88997790236572
2010-04-29T09:30:00-04:00,23.75999,23.92999,23.71001,23.89,9053559,9816603.55,60.52327618182018,68.06908593525144,NaN,NaN,50.012654612417116,59.80912128674605,-0.04796339196774457,0.2543742979058443,0.3023376898735889,377826727,376189666.6,91.46303713969982,91.68273393648238,NaN,NaN,29.28813630783944,35.80400053171911
2010-04-30T09:30:00-04:00,23.87,23.91,23.38,23.38901,10547578,9888602.75,47.351367846390296,66.40589173446489,NaN,NaN,-31.240501072645454,31.681443357085953,-0.07868820779330282,0.20397743013196035,0.28266563792526317,367279149,370830626,81.87694569492747,91.47649259986966,NaN,NaN,22.629418295615057,33.92191735513282
2010-05-03T09:30:00-04:00,23.46001,23.8018,23.46001,23.71001,6884402,9990343.55,54.22539901230579,65.13558402352696,NaN,NaN,-11.36715628269279,7.47735004231493,-0.07591249981491666,0.18777501315661738,0.26368751297153403,374163551,368811028.4,78.53631143132979,90.92376008680958,NaN,NaN,19.818171407175335,31.907096505424608
2010-05-04T09:30:00-04:00,23.42999,23.46001,22.89,23.03,14841297,10478817,41.78046443091682,62.58336737317425,NaN,NaN,-168.3061158359125,-32.29224960450448,-0.11599391944360304,0.11869511366703023,0.23468903311063327,359322254,369472969.8,78.8410315786677,90.21127314581453,NaN,NaN,11.880706410621315,29.046183634738423
2010-05-05T09:30:00-04:00,22.8,23.08501,22.78,22.92999,13465027,10866558,40.31501935633151,59.82351546338254,NaN,NaN,-205.45825902193928,-73.27187552015457,-0.14355760350771582,0.05524202872598849,0.1987996322337043,345857227,364889781.6,71.29389854326215,88.82396470755825,NaN,NaN,5.6064579534913355,25.697651394560268
2010-05-06T09:30:00-04:00,22.77,22.99001,20.64,22.24001,25524432,11720022.35,31.980823790214785,57.41144138589559,NaN,NaN,-348.99714578927046,-153.0738356004921,-0.19915378986871674,-0.050142605102191595,0.14901118476652514,320332795,353390995.2,56.64351748350907,86.33630184518677,NaN,NaN,-3.4434732627265854,21.534633586376433
2010-05-07T09:30:00-04:00,22.14,22.30811,21.25,21.75,25222272,12706653.55,27.614750146123598,54.62054818372951,NaN,NaN,-271.51376397195713,-201.12848818035442,-0.25619023162680016,-0.17122660476697504,0.0849636268598251,295110523,338957270,44.32948372376556,82.9095096650447,NaN,NaN,-12.421941306038205,16.683694316031485
2010-05-10T09:30:00-04:00,22.69,22.85001,22.53,22.75,23388144,13668039.45,44.320810777192385,52.85357659831455,NaN,NaN,-104.65110355240293,-219.78527763429648,-0.21546658641539446,-0.184369606159418,0.031096980255976472,318498667,327824293.2,37.548928881582526,78.94406064370196,NaN,NaN,-12.305811548916838,12.542336335324581
2010-05-11T09:30:00-04:00,22.50999,23,22.49001,22.60001,12864984,14014297.85,42.72793160474255,50.90952243039529,NaN,NaN,-90.88866550446878,-204.3017875680077,-0.18850219667256654,-0.2045307655847317,-0.016028568912165163,305633683,317086579,32.40116718214399,74.57309219924784,NaN,NaN,-12.89011556809074,8.909128920550964
2010-05-12T09:30:00-04:00,22.75999,23.19,22.75999,23.19,11812387,13855855.1,50.29522055090416,49.42938571073298,NaN,NaN,-42.070011057746,-171.62413797516905,-0.12392193005514163,-0.1709309814810922,-0.04700905142595057,317446070,311404347.6,30.0531431373729,69.9987891917799,NaN,NaN,-10.168033766330037,6.18381996528225
2010-05-13T09:30:00-04:00,23.11,23.27,22.8,22.85001,11439727,13953179.55,46.48365093265598,47.600373458970516,NaN,NaN,-44.62457244531557,-110.74962330637808,-0.09821687269499516,-0.1697801422946945,-0.07156326959969936,306006343,308539057.2,28.915245536347427,65.27230268007847,NaN,NaN,-9.62437768403451,3.925506015379856
2010-05-14T09:30:00-04:00,22.64999,22.7,22.17,22.41,16497504,14017833.65,42.04295109387655,45.554783349226746,NaN,NaN,-96.83441667809826,-75.8137538476063,-0.104384731556707,-0.2020441840455831,-0.09765945248887611,289508839,307418720.4,28.46147599528544,60.47835813344083,NaN,NaN,-10.91257335553175,1.8057803909639123
2010-05-17T09:30:00-04:00,22.47,22.55,22.07001,22.52,14988156,14328904.15,43.49621194248174,44.86472704494732,NaN,NaN,-90.96792486169583,-73.07711810946488,-0.09486832027741395,-0.21624485283564354,-0.1213765325582296,304496995,304618386,27.3079088508363,55.74327855984991,NaN,NaN,-11.352976760388463,-0.07404205922928409
2010-05-18T09:30:00-04:00,22.67,22.7,22.08,22.17999,22520080,15107701.7,40.14535205103976,43.80737355121404,NaN,NaN,-88.48642049192343,-72.59666910695582,-0.1045225411357198,-0.25202970897787935,-0.14750716784215956,281976915,299887032.4,25.432344168999208,50.93603138198067,NaN,NaN,-12.876141215552373,-1.9029133672754395
2010-05-19T09:30:00-04:00,22.12,22.3,21.83,22.00999,26722576,15973788.7,38.5464172125188,42.23759791054966,NaN,NaN,-107.17682755586974,-85.61803240658057,-0.11459858357114658,-0.2907553973060928,-0.1761568137349462,255254339,287448686.2,21.292115468544253,45.923822691183844,NaN,NaN,-14.605529896096886,-3.7175728713927887
2010-05-20T09:30:00-04:00,21.66,21.7135,21.24001,21.31,19833760,16464923.95,32.7604841656118,41.19539193335119,NaN,NaN,-153.06204705410087,-107.30552732833762,-0.1579723430985912,-0.3736222426081852,-0.215649899509594,235420579,273331533.4,17.75854010593001,41.34393657768403,NaN,NaN,-18.173649429264163,-5.782726665374414
2010-05-21T09:30:00-04:00,20.94,21.60001,20.86,21.47,21021952,16872513.15,35.15638817149912,39.83331973043643,NaN,NaN,-145.00226503584554,-116.93909699988708,-0.16470013883817308,-0.42152507305731035,-0.25682493421913727,256442531,266718271.8,16.386592664691364,36.90467095149557,NaN,NaN,-20.163779948672396,-7.837162848702697
2010-05-24T09:30:00-04:00,21.48,21.66,21.34,21.37,12961645,17029954.75,34.33296914111057,39.30135578116455,NaN,NaN,-117.74135866866696,-122.29378376128129,-0.16432347991676177,-0.46222928411508946,-0.2979058041983277,243480886,254515050,14.205691090459538,32.28786091662356,NaN,NaN,-21.995141375032752,-9.85973120960699
2010-05-25T09:30:00-04:00,20.82001,21.35001,20.67,21.31,18288336,16531921.95,33.82112163798,38.837505944139444,NaN,NaN,-134.47812980746187,-131.492125624389,-0.15658639853040046,-0.4936388023613283,-0.3370524038309278,225192550,243158177,12.533830119008314,28.090713172034004,NaN,NaN,-23.61302011984509,-11.824486768212433
2010-05-26T09:30:00-04:00,21.50999,21.72,21.03999,21.10001,24322976,17110039.7,32.021807019617626,38.84043331766823,NaN,NaN,-106.82120782230902,-131.42100167767686,-0.1538566568488675,-0.5293732248920122,-0.3755165680431447,200869574,232281224,11.177081531742786,24.8431106040507,NaN,NaN,-25.503391878012078,-13.778616069612381
2010-05-27T09:30:00-04:00,21.58,21.84,21.50999,21.82001,19124368,17613580.15,43.18311491268346,39.9524593724225,NaN,NaN,-57.97862226288435,-112.40431671943354,-0.09470805663891146,-0.49390163884178406,-0.3991935822028726,219993942,229195896.6,10.819319532589589,22.449527447538124,NaN,NaN,-23.659600024047904,-15.190185205960313
2010-05-28T09:30:00-04:00,21.83,21.84,21.49001,21.64,12116293,17692015.9,41.35492410963525,39.740610324739855,NaN,NaN,-57.84128470301658,-94.97212065286776,-0.0605185530736807,-0.4748417735449735,-0.4143232204712928,207877649,219482920.2,9.760166361409276,20.46461583895432,NaN,NaN,-22.727510438346908,-16.26694595344411
2010-06-01T09:30:00-04:00,21.53999,21.88,21.39999,21.42999,13233422,18009466.9,39.26632158166561,39.49335246594864,NaN,NaN,-60.999193522234535,-83.62368762358128,-0.04554179391010643,-0.4712504628589258,-0.42570866894881937,194644227,209715588.4,8.824624258137433,18.780577058668136,NaN,NaN,-22.58903584247759,-17.170101651877467
2010-06-02T09:30:00-04:00,21.55,21.91,21.39999,21.91,10379910,17786397.55,45.981617296714504,39.18523794779224,NaN,NaN,-36.105428541674975,-63.94914737042391,0.0007469461598910154,-0.4247749862489556,-0.4255219324088466,205024137,205681905.8,8.463810959751257,17.238481903123734,NaN,NaN,-20.334466015338396,-17.622153703800457
2010-06-03T09:30:00-04:00,21.98,22.17,21.8535,22.13,12585211,17742406.75,48.7770999308586,39.34905573337814,NaN,NaN,9.509442955144417,-40.683017214933216,0.04763996379454749,-0.36597197766566225,-0.41361194146020974,217609348,209029860.6,11.69121092792173,16.008193716807614,NaN,NaN,-17.603539351647267,-17.619494510635715
2010-06-04T09:30:00-04:00,21.66,21.95,21.34,21.42,18494464,17390908.35,41.34141600834293,39.29894608441145,NaN,NaN,-52.62411919802417,-39.61211660196117,0.032994512964003075,-0.3723688002552059,-0.405363313219209,199114884,204854049,11.162559111827477,14.772556796560613,NaN,NaN,-17.57658449267165,-17.61336450806942
2010-06-07T09:30:00-04:00,21.53,21.595,21.07001,21.11,10543180,16656953.75,38.57629888709826,38.94752372331262,NaN,NaN,-86.89962816910365,-45.42378529517858,0.00599754538862729,-0.3978663814834249,-0.4038639268720522,188571704,200992860,10.681596573271221,13.584963062448825,NaN,NaN,-18.458396218789286,-17.734083323886544
2010-06-08T09:30:00-04:00,21.14,21.21001,20.83,21.14999,13325332,16153813.15,39.141784797772026,38.875840348079215,NaN,NaN,-103.56972505548906,-53.937891601829485,-0.005004013402663154,-0.41011894362538115,-0.405114930222718,201897036,202443421.8,12.211918832580594,12.640646966990355,NaN,NaN,-18.979426166790173,-17.911989444301348
2010-06-09T09:30:00-04:00,21.31,21.5,20.9426,21.03999,13313488,16176238.35,38.10266149508142,38.8441435111194,NaN,NaN,-85.89265295547528,-63.89533648458954,-0.014963846196856201,-0.42381973796878825,-0.40885589177193205,188583548,199155304,11.721658426206517,11.957042892537658,NaN,NaN,-19.71082985297382,-18.168966645540273
2010-06-10T09:30:00-04:00,21.27,21.57001,21.23,21.55,14212707,16296254.35,45.34718292766123,39.743193422694354,NaN,NaN,-40.731557930612006,-73.94353666174082,0.0158530609512072,-0.3890395655829231,-0.4048926265341303,202796255,196192685.4,11.282168861406205,11.494444946500247,NaN,NaN,-18.12686956677415,-18.16295277714511
2010-06-11T09:30:00-04:00,21.33,21.78,21.33,21.74001,10725582,16260547.1,47.798519778203826,40.64620282317326,NaN,NaN,-2.879265815196855,-63.994565985175356,0.05015478076881452,-0.3421991505731121,-0.39235393134192664,213521837,199074076,14.634544984728024,11.369298683645722,NaN,NaN,-16.074220359113745,-17.86456243171206
2010-06-14T09:30:00-04:00,21.97,22.03999,21.67,21.7,13023777,16086860.75,47.317252058152086,41.573651602961945,NaN,NaN,46.162564563982386,-37.382127438558165,0.07004890889992943,-0.30479279521701486,-0.3748417041169443,200498060,201459347.2,17.416532951024735,11.59864453082895,NaN,NaN,-14.54710178012013,-17.39063948148464
2010-06-15T09:30:00-04:00,21.83,22.28999,21.8,22.27,11526777,15913791.8,54.36655998946347,43.04118291378219,NaN,NaN,127.09517220864325,8.750852014268295,0.11863951208585916,-0.22654231400962033,-0.3451818260954795,212024837,203484907.4,19.806566353188586,12.118125690413255,NaN,NaN,-10.975049494829317,-16.474126626248164
2010-06-16T09:30:00-04:00,22.17999,22.39999,22.125,22.33,7753727,15175474.15,55.04840280352642,44.68593975548997,NaN,NaN,167.99436549714014,59.52825570479138,0.14985189818850925,-0.1578669533598429,-0.30771885154835216,219778564,209723910.6,26.830725524253523,13.236243118449734,NaN,NaN,-7.882464436287319,-15.246746313396615
2010-06-17T09:30:00-04:00,22.42999,22.45,22.17999,22.41,9918781,14335284.4,55.99257335957101,45.60090107312478,NaN,NaN,169.1469898763417,101.50396526618212,0.1694705601283068,-0.09588065138796864,-0.26535121151627544,229697345,215104128.6,32.33486975300811,14.773068134193917,NaN,NaN,-5.058137804943639,-13.791230812189047
2010-06-18T09:30:00-04:00,22.35001,22.448,22.25999,22.33,7119273,13699560.05,54.754044269697616,46.55798108455781,NaN,NaN,143.2747087715215,130.7347601835258,0.17019697379567728,-0.05260499427167886,-0.22280196806735614,222578072,216915375.6,34.13126891304458,16.51386117359644,NaN,NaN,-3.0283915491315794,-12.25368234603798
2010-06-21T09:30:00-04:00,22.58,22.62,22.06,22.17,8742141,13085569.5,52.264076400710564,47.486392143061025,NaN,NaN,113.88153648663916,144.27855456805713,0.1535506860087747,-0.030863610556387755,-0.18441429656516245,213835931,219582949.8,36.79277908059064,18.51158651805738,NaN,NaN,-1.9501513291191628,-10.781749343621007
2010-06-22T09:30:00-04:00,22.24001,22.395,21.95,21.98,10183309,12946652.7,49.3916470825772,47.72996569919407,NaN,NaN,71.79488532910985,133.21849719215047,0.124623648439908,-0.02863473601527744,-0.15325838445518544,203652622,217908506.8,35.81453617552195,20.46520974775529,NaN,NaN,-1.7911736648248306,-9.497381389507268
2010-06-23T09:30:00-04:00,22.05,22.11,21.77,21.94,9409707,12502721.25,48.78377451578006,47.73044245525989,NaN,NaN,33.90185545087318,106.39999518289707,0.09880428500347332,-0.0297530282008438,-0.12855731320431713,194242915,212801377,32.937983491952764,21.982836359471786,NaN,NaN,-1.8175921880720802,-8.400268646445099
2010-06-24T09:30:00-04:00,21.84,21.89999,21.46001,21.5,15267367,12049940.8,42.57643253068345,47.81865792114136,NaN,NaN,-34.37139507860288,65.69631819190815,0.05053398472476736,-0.06538983229835793,-0.11592381702312529,178975548,202657017.6,28.108667013009196,23.193272638127628,NaN,NaN,-3.606527781915405,-7.715448522940857
2010-06-25T09:30:00-04:00,21.63,21.64999,21.31,21.47501,15665484,11876996.6,42.24763320349859,48.080896086598514,NaN,NaN,-59.19328480427994,25.202719476747863,0.017092072571556233,-0.09455872630868001,-0.11165079888023624,163310064,190803416,23.730384196649126,24.125328896940335,NaN,NaN,-5.175483099447975,-7.352596319584731
2010-06-28T09:30:00-04:00,21.45,21.62,21.34,21.52,10263590,11784361.45,43.09957820110567,48.363595615408066,NaN,NaN,-53.365484699649926,-8.246684760509945,-0.0008756090597994703,-0.11274531020498557,-0.1118697011451861,173573654,182750960.6,21.302857031912936,24.774681625464073,NaN,NaN,-6.275844645614242,-7.198774651874661
2010-06-29T09:30:00-04:00,21.16,21.19,20.57001,20.72,19834720,12114426.35,33.6062158147772,48.04242092395776,NaN,NaN,-160.5424033300752,-54.714142492346944,-0.06212573928354373,-0.18952687524961576,-0.12740113596607203,153738934,172768223,18.74305842247196,25.276210196625893,NaN,NaN,-10.384179743942791,-7.6538325221701085
2010-06-30T09:30:00-04:00,20.63,20.8,20.34,20.39999,12499984,12220430.05,30.69378429628729,46.99574959314534,NaN,NaN,-179.52353994012125,-97.39922157054585,-0.11652019914483774,-0.2730513848971192,-0.15653118575228148,141238950,162167430,16.4786124287032,25.647384737147103,NaN,NaN,-14.840765013835828,-8.68053716383664
2010-07-01T09:30:00-04:00,20.41,20.53999,20.00999,20.32001,22905328,12736435.9,29.994143526449506,45.724008432305745,NaN,NaN,-183.47219374777637,-127.21938130438055,-0.148182483221226,-0.341759289778814,-0.19357680655758797,118333622,150039044.8,14.34347771094636,25.626594217591272,NaN,NaN,-18.660004983478363,-10.106175423785457
2010-07-02T09:30:00-04:00,20.41,20.48,20.14999,20.28999,8510941,12237259.75,29.720306651567014,44.46708376040681,NaN,NaN,-151.6493138861824,-145.71058712076103,-0.1604108223225119,-0.39409033446072783,-0.23367951213821594,109822681,139341568.2,12.771618556032834,25.294814617948994,NaN,NaN,-21.841636217970468,-11.782669822954745
2010-07-06T09:30:00-04:00,20.61,20.75999,20.28,20.49001,15336113,12476906.4,34.04121944018583,43.0152737211727,NaN,NaN,-113.15011927747508,-157.66751403632605,-0.14477108737295685,-0.414643371354412,-0.26987228398145513,125158794,129658596.2,11.538972684488272,24.70427221304183,NaN,NaN,-23.35259686296942,-13.43551654295684
2010-07-07T09:30:00-04:00,20.52,21.17999,20.49001,21.14999,12890223,12455150.95,45.86744603033757,42.35949109451634,NaN,NaN,-61.375270418174,-137.83408745394584,-0.08280050901026464,-0.3733729202442859,-0.2905724112340213,138049017,126520612.8,11.162963427170581,23.585146348964475,NaN,NaN,-20.997171888071918,-14.515753020830422
2010-07-08T09:30:00-04:00,21.36,21.36,21.03999,21.28,8666395,12222796.3,47.85102731551112,41.777952091369215,NaN,NaN,-28.875863713066998,-107.70455220853498,-0.02867198387769948,-0.3264123910811456,-0.29774040720344613,146715412,127615905.2,12.237948110567146,22.14965194593298,NaN,NaN,-18.462602964678254,-15.079588727094398
2010-07-09T09:30:00-04:00,21.265,21.39,21.23,21.39,7858125,11905067.2,49.53592829799393,41.4052295219618,NaN,NaN,-15.256926441500838,-74.06149874727987,0.01649214528345405,-0.27712522559912856,-0.2936173708825826,154573537,134863888.2,19.205227867654585,21.083506156976547,NaN,NaN,-15.875539594424238,-15.193295993855804
2010-07-12T09:30:00-04:00,21.34,21.58,21.34,21.49001,8713516,11804463.9,51.0833917069342,41.32089490097777,NaN,NaN,0.9033312080471895,-43.550969728433955,0.05299485904146761,-0.22737379708074812,-0.28036865612221573,163287053,145556762.6,28.254490404065166,20.473628394367584,NaN,NaN,-13.279816841870511,-14.919941829286476
2010-07-13T09:30:00-04:00,21.71001,21.87,21.56,21.8,10290941,11667822.1,55.625528729594215,41.76617216147899,NaN,NaN,33.09235256345334,-14.302475360248257,0.09543487989614219,-0.161075056252038,-0.2565099361481802,173577994,155240602.6,35.31991598045619,20.438298380434315,NaN,NaN,-9.622220005731593,-14.163124425921492
2010-07-14T09:30:00-04:00,21.88,22.07001,21.81,21.92999,12383430,11710654.75,57.41137652029603,42.38242944751585,NaN,NaN,57.41389421167341,9.455357565721231,0.12766681890928702,-0.09692641251157141,-0.22459323142085844,185961424,164823084,41.46303418665029,21.047230572912714,NaN,NaN,-6.038463512276775,-13.002458581115103
2010-07-15T09:30:00-04:00,21.88,22.02,21.64999,22,12419477,11943942.25,58.382822574751756,43.51145730780643,NaN,NaN,55.797977757815204,26.390125859897672,0.14769211650332495,-0.039978085791702256,-0.1876702022950272,198380901,175156181.8,47.27800296678732,22.416468855325434,NaN,NaN,-2.7880191968064443,-11.543252954785295
2010-07-16T09:30:00-04:00,21.81,21.86,21.35001,21.3725,15108102,12203408.3,47.84800029908999,43.9114835289201,NaN,NaN,17.834058226830614,33.00832279356396,0.11416668964968119,-0.04496184023292571,-0.1591285298826069,183272799,180896034.2,50.235290299005094,24.309676434065143,NaN,NaN,-2.970114895426343,-10.318518946305446
2010-07-19T09:30:00-04:00,21.46001,21.63,21.35001,21.58,7352297,12215059.5,50.99687211771855,44.475575951535305,NaN,NaN,23.713951058616008,37.57044676367773,0.10186170474446415,-0.031801398952026716,-0.13366310369649087,190625096,186363642.8,52.94303055466883,26.569688828547708,NaN,NaN,-2.141046154669259,-9.150308547500277
2010-07-20T09:30:00-04:00,21.2,21.75,21.11,21.72,15610539,12558479.4,53.05634253415968,45.86487071720548,NaN,NaN,31.65895451440225,37.28376715386751,0.09896247364869101,-0.009960011635627097,-0.10892248528431811,206235635,192895171,56.021454709908575,29.23243142050747,NaN,NaN,-0.8326063222179596,-7.962065372459946
2010-07-21T09:30:00-04:00,21.89,21.91,21.39,21.46001,16655016,12882064.75,48.942643887629075,47.1683606880156,NaN,NaN,46.09628785207205,35.020245881947226,0.07635858645981049,-0.013474252209555004,-0.08983283866936549,189580619,193619010,56.36216056708424,32.081256287534686,NaN,NaN,-0.9708875314643088,-6.963325680889141
2010-07-22T09:30:00-04:00,21.73,22.11,21.72,22.03999,11719238,12997541.3,56.95964691931503,49.094468073220284,NaN,NaN,102.20588763933594,44.30182785825137,0.09602002210462152,0.030192188961411404,-0.06582783314321011,201299857,194202801.2,56.653829200303505,35.1034242510602,NaN,NaN,1.5576659584547534,-5.7460411609828705
2010-07-23T09:30:00-04:00,21.98,22.19,21.9099,22.19,10386266,12753486.25,58.76320648661306,51.16896091858071,NaN,NaN,115.48042888717603,63.83110199032046,0.11348332837582124,0.07602632732656645,-0.0374570010492548,211686123,199885466,59.49204848464881,38.440597817389914,NaN,NaN,4.17599265122746,-4.328607759238538
2010-07-26T09:30:00-04:00,22.19,22.34,22.10001,22.32001,6576234,12299023.75,60.31530382967145,53.0456812321154,NaN,NaN,125.01549811885171,84.09141140236758,0.12711842963196607,0.12144103599070277,-0.005677393641263281,218262357,205412918.2,62.09210348329129,42.05153573159013,NaN,NaN,6.789015099853994,-2.740375922225319
2010-07-27T09:30:00-04:00,22.39999,22.45,22.27,22.39,7794180,12175553.25,61.162777375640474,54.13820489963704,NaN,NaN,125.92504092622792,102.94462868473275,0.133519246813662,0.16122166487581424,0.027702418062152227,226056537,209377098.6,63.88259351639291,45.81722359510601,NaN,NaN,9.16516376645944,-1.0395845381274964
2010-07-28T09:30:00-04:00,22.35001,22.42999,22.13,22.21001,13176699,11842652.2,57.74744532274421,54.84509190015369,NaN,NaN,103.42323700333131,114.41001851498459,0.1187927565025599,0.1761933636903521,0.057400607187792205,212879838,214036942.4,65.92029552771407,49.65167698204505,NaN,NaN,10.183834363643497,0.5637610192683595
2010-07-29T09:30:00-04:00,22.28999,22.32001,21.83,22.00999,10647668,11750036.4,54.1300662352852,55.17324460996021,NaN,NaN,72.14703493313105,108.39824797374361,0.09004704558777142,0.16995941417250648,0.07991236858473506,202232170,214223405,66.00295076959299,52.99437147504066,NaN,NaN,9.994044865211594,1.9109444258316788
2010-07-30T09:30:00-04:00,21.77,22.035,21.7,21.92,8956340,11052587,52.53558172359376,55.276972468293025,NaN,NaN,41.672817114464664,93.63672561920133,0.060837878580538074,0.15595971681040766,0.09512183822986958,193275830,210541346.4,62.7656698121231,55.459455718473365,NaN,NaN,9.38007670144239,2.9779633223474944
2010-08-02T09:30:00-04:00,22.17999,22.44,22.11,22.38,15710246,11412552.25,59.15826771626779,55.52931096734114,NaN,NaN,102.6289262014339,89.15941123571777,0.06782983416512897,0.1799091309362808,0.11207929677115183,208986076,208686090.2,61.13851160317662,57.30364112009625,NaN,NaN,10.827026817918814,4.099258107429112
2010-08-03T09:30:00-04:00,22.35001,22.36,22.21001,22.25999,5403500,10915921.6,56.926619759857275,55.49468548445265,NaN,NaN,91.99005106500108,82.3724132634724,0.059975941089070756,0.18704922313249028,0.12707328204341953,203582576,204191298,57.265146795438376,58.4323634492954,NaN,NaN,11.357093249599663,5.136091699167761
2010-08-04T09:30:00-04:00,22.32001,22.45,22.17,22.44,14681570,11005488.95,59.40058660577012,55.56738291523969,NaN,NaN,102.28933550122011,82.14563296305016,0.06223854993433767,0.2048714694613416,0.14263291952700394,218264146,205268159.6,57.9524512814162,59.194824043197464,NaN,NaN,12.5350016728213,6.193078838261124
2010-08-05T09:30:00-04:00,22.28999,22.38,22.2,22.34,5073770,10825857.7,57.427294720853645,56.251618231079945,NaN,NaN,85.67456379130792,84.85113873468552,0.0527119382097814,0.20852284228923068,0.15581090407944928,213190376,207459800.8,59.38416630720913,59.84831518664061,NaN,NaN,12.948062057829734,7.1580764410566395
2010-08-06T09:30:00-04:00,22.13,22.31,21.98,22.28,15617070,11213804.95,56.220505898217034,56.62473492968699,NaN,NaN,52.737805527547806,87.06413641730217,0.038728037538793836,0.20422095100294158,0.16549291346414774,197573306,208319296,59.959962852940535,60.34952463651717,NaN,NaN,12.95538361009334,7.986263179490454
2010-08-09T09:30:00-04:00,22.34,22.47,22.25,22.42999,13552707,11455764.5,58.564626322603,57.018183771718654,NaN,NaN,92.24862360642106,84.9880758982996,0.03599625588233951,0.21048823331707212,0.1744919774347326,211126013,208747283.4,60.26206318952168,60.65242524220382,NaN,NaN,13.60798130489336,8.789365768833726
2010-08-10T09:30:00-04:00,22.22,22.32001,22.03999,22.2,11289266,11505680.75,53.80711109471205,57.36564571508172,NaN,NaN,37.97315255763638,74.18469619682666,0.016128810297022733,0.19465299030601102,0.1785241800089883,199836747,207998117.6,59.416980974977974,60.87062669991052,NaN,NaN,12.828762218232043,9.366422404462057
2010-08-11T09:30:00-04:00,21.86,21.87,21.59,21.67,18062704,11789644.45,44.77945141267139,56.49563175032146,NaN,NaN,-80.89922705793855,37.546983684994935,-0.03262015128207718,0.1377489909063918,0.170369142188469,181774043,200700097,51.79673217175831,60.52369119787157,NaN,NaN,9.214559507939553,9.344727704958842
2010-08-12T09:30:00-04:00,21.24001,21.46001,21.14,21.37,15165766,11926958.9,40.62460717821126,55.20001751400704,NaN,NaN,-151.5210032630976,-9.892129725886168,-0.08216357583710518,0.06766467239208751,0.1498282482291927,166608277,191383677.2,44.03307676490033,59.419478932175245,NaN,NaN,4.760861188843401,8.689889631228064
2010-08-13T09:30:00-04:00,21.28,21.39999,21.24001,21.27,6078711,11475489.35,39.315126531313645,53.70000484983863,NaN,NaN,-146.87961031170906,-49.81561289373754,-0.11665700603949006,0.004006990679830125,0.12066399671932018,160529566,183974929.2,39.02381148842332,57.771743789684685,NaN,NaN,0.7416531109489186,7.554427271188187
2010-08-16T09:30:00-04:00,21.14,21.42,21.08,21.31,10268539,11621301.45,40.14621301279764,52.198821681064146,NaN,NaN,-144.3950708084793,-97.14435177671761,-0.13070883089105598,-0.042722041894499796,0.08798678899655618,170798105,175909347.6,34.43154521356169,55.66809748233959,NaN,NaN,-2.269588437384106,6.150996455677859
2010-08-17T09:30:00-04:00,21.50999,21.73,21.42999,21.53999,17100592,11695804.1,44.8250842278292,51.27579588857021,NaN,NaN,-85.08478153299518,-121.75593859484393,-0.11878900383617877,-0.060499465798667273,0.05828953803751149,187898697,173521737.6,33.18653843707166,53.329971975865135,NaN,NaN,-3.5034514662167338,4.7717896096929175
2010-08-18T09:30:00-04:00,21.53999,21.78,21.47,21.66,12616086,11493857.6,47.146824882019764,50.77699293476553,NaN,NaN,-71.91583696758751,-119.95926057677373,-0.09796342805002906,-0.06416474702502484,0.03379868102500422,200514783,177269885.6,37.03554520294013,51.26087157824707,NaN,NaN,-3.8631311282942713,3.5382295042661767
2010-08-19T09:30:00-04:00,21.58,21.64999,21.27,21.39999,13811008,11598446.1,42.93172681464007,50.09100329841169,NaN,NaN,-97.83772861798211,-109.22260564775063,-0.0966763227229818,-0.08704672237872302,0.00962960034425877,186703775,181288985.2,40.96295343169154,49.70353469393053,NaN,NaN,-5.434994735983245,2.256340327087688
2010-08-20T09:30:00-04:00,21.33,21.42,21.23,21.35001,9316320,11544948.8,42.15160886183295,48.87624195166635,NaN,NaN,-102.58015303478388,-100.36271419236559,-0.09407905551799206,-0.10796921905323131,-0.01389016353523925,177387455,184660563,44.112268975849325,48.4873745062643,NaN,NaN,-6.9486629756714,0.941339855264961
2010-08-23T09:30:00-04:00,21.46001,21.50999,21.16,21.16,8183770,11625325.6,39.2328597201888,47.61240194883289,NaN,NaN,-99.5450814353017,-91.39271631773008,-0.09951871953525235,-0.1382885629543047,-0.03876984341905234,169203685,184341679,43.87388237167874,47.5308556188529,NaN,NaN,-9.106876324127153,-0.4941195989339122
2010-08-24T09:30:00-04:00,20.92999,21.07899,20.77,20.87,10593895,11765311.35,35.22394488060361,45.88549896846386,NaN,NaN,-141.00499630589462,-102.57675927230996,-0.11586492507772295,-0.18360099976620603,-0.06773607468848308,158609790,178483897.6,39.63645409361274,46.222570105438365,NaN,NaN,-12.23740510705244,-2.171731814379416
2010-08-25T09:30:00-04:00,20.74001,21.09,20.69,21,11073012,11660127,38.26910061133057,44.517056532069354,NaN,NaN,-123.18344923066634,-112.83028172492573,-0.11112274604327857,-0.2066395072425813,-0.09551676119930272,169682802,172317501.4,35.72489250562219,44.53262197675359,NaN,NaN,-13.96955156880712,-3.8571346364405166
2010-08-26T09:30:00-04:00,21.10001,21.1295,20.75999,20.78999,10154934,11635490.3,35.37586756381178,43.028153793897545,NaN,NaN,-114.72940029559138,-116.20861606044757,-0.11485674162558432,-0.23908768823128312,-0.1242309466056988,159527868,166882320,32.66500533842712,42.58298215428834,NaN,NaN,-16.329476896358162,-5.638897816428751
2010-08-27T09:30:00-04:00,20.91,21.05,20.58,21.03999,14991926,11937269.6,41.08590660230461,41.77967381387623,NaN,NaN,-103.34083346184454,-116.36075214585972,-0.09408915174825602,-0.24184238629101884,-0.14775323454276282,174519794,166308787.8,32.3501297772533,40.589272624840596,NaN,NaN,-16.64895147427588,-7.211762624692627
2010-08-30T09:30:00-04:00,20.92999,21.09,20.75999,20.75999,7593563,11531435.45,37.12896286034755,40.588377511421626,NaN,NaN,-97.99416135919851,-116.05056813063906,-0.0926620277718534,-0.26358076925757956,-0.17091874148572617,166926231,165853297,32.08560102276944,38.63703119968284,NaN,NaN,-18.154807248662188,-8.775054713831135
2010-08-31T09:30:00-04:00,20.71001,20.84,20.58,20.69,15519965,12037258.7,36.19069556892013,39.97489495115367,NaN,NaN,-112.95182600368136,-110.43993407019641,-0.0898184022488766,-0.2831917442968219,-0.19337334204794532,151406266,164412592.2,31.216128276549995,37.16698806431082,NaN,NaN,-19.65987991310611,-10.330029742298988
2010-09-01T09:30:00-04:00,20.97,21.3,20.92999,21.22,14798047,12043082.55,47.093690005675356,40.43697229597253,NaN,NaN,-42.67376972832545,-94.33799816972822,-0.04774133412640502,-0.2530500097059516,-0.20530867557954657,166204313,163716894.4,30.78234007387826,36.22050687209495,NaN,NaN,-17.46227468072135,-11.348921876359325
2010-09-02T09:30:00-04:00,21.23,21.41,21.19,21.41,9306449,12254716.5,50.36776078647459,41.22644617134118,NaN,NaN,-5.2701185054928965,-72.44614181170853,-0.0048684472411522905,-0.21139423463098694,-0.20652578738983465,175510762,166913473.2,35.235662076383576,35.94992477123497,NaN,NaN,-14.583777586661936,-11.811044120688269
2010-09-03T09:30:00-04:00,21.60001,21.73,21.50999,21.73,10358910,11991808.5,55.37646747252809,42.31432148989335,NaN,NaN,66.09055614683116,-38.559863889973414,0.04456316832477569,-0.15082182698386504,-0.19538499530864073,185869672,169183448.8,38.27279803936344,36.224299973077954,NaN,NaN,-10.446587158870301,-11.616121697571417
2010-09-07T09:30:00-04:00,21.63,21.74001,21.53,21.55,7839344,11706140.35,52.186217174590446,42.8401167003763,NaN,NaN,72.98312766288096,-4.364406085557524,0.06350398061057741,-0.11600501954541897,-0.17950900015599638,178030328,171404268.2,41.17907431063709,36.79519539261834,NaN,NaN,-8.076692552332316,-11.11048896253726
2010-09-08T09:30:00-04:00,21.62,21.72,21.56,21.67,9290727,11606213.4,54.085303270721965,43.33572229956932,NaN,NaN,97.91987909801688,37.809934934782135,0.08134140015513716,-0.07783224996207494,-0.1591736501172121,187321055,178587226,49.46641462514307,37.683114637061415,NaN,NaN,-5.553238974583533,-10.3165961071153
2010-09-09T09:30:00-04:00,21.85001,21.89,21.69,21.73,6947590,11050457.7,55.04671121727209,44.20107832832874,NaN,NaN,127.07981869723476,71.76065261989417,0.09353771416460682,-0.04225150741145356,-0.13578922157606038,194268645,184200092.4,54.82276567445111,38.67310122582995,NaN,NaN,-3.2197462254176643,-9.302760409729924
2010-09-10T09:30:00-04:00,21.75,21.77,21.60001,21.74001,8150289,10699683.85,55.21519348528219,45.13419151571798,NaN,NaN,98.6127659969503,92.53722952038281,0.09815550519166635,-0.013094840086477433,-0.11125034527814379,202418934,189581726.8,59.27949486718838,39.75647450378274,NaN,NaN,-1.2782412805271353,-8.156400534129526
2010-09-13T09:30:00-04:00,21.95,22.17,21.92,22.13,11598656,10975681.1,61.30073856166563,46.71046857582347,NaN,NaN,158.67350695743528,111.05381968250363,0.12180687224384872,0.04100824502666711,-0.0807986272171816,214017590,195211310.4,63.35227014508642,41.147787916169,NaN,NaN,2.373296941540289,-6.6521580376052665
2010-09-14T09:30:00-04:00,22.13,22.39999,22.05,22.22,9427176,10933612.95,62.56495339361915,48.663397755324574,NaN,NaN,159.58874210875737,128.3749425716789,0.13672598879452713,0.0901088587759773,-0.04661713001854982,223444766,204294198,68.77812979201795,43.2293361803408,NaN,NaN,5.763776137798661,-4.8784531554047055
2010-09-15T09:30:00-04:00,22.2,22.41,22.15939,22.36,7381609,10447663.8,64.50730305817515,50.53755507295633,NaN,NaN,152.7988939778958,139.3507455476547,0.14826907216600754,0.1387192101889596,-0.009549861977047928,230826375,212995262,72.91509527124802,45.88577923502836,NaN,NaN,9.207915469731036,-2.866114780385314
2010-09-16T09:30:00-04:00,22.33,22.50999,22.28999,22.49001,7800609,10206889.95,66.25816207749207,52.74343325250493,NaN,NaN,150.571662429636,144.04911429413497,0.15611554217226895,0.18559456573828825,0.029479023566019315,238626984,221866929.8,76.35523149948219,49.006509675103715,NaN,NaN,12.63888604092852,-0.6511146630547664
2010-09-17T09:30:00-04:00,22.56,22.58009,22.42,22.53,14419656,10237322.35,66.80066353574637,54.580201604893624,NaN,NaN,138.08273484663275,151.94310806407145,0.15513303661670316,0.22339531933689827,0.0682622827201951,253046640,231992471,79.54809118622,52.37779263288706,NaN,NaN,15.633287261340623,1.6752284690017176
2010-09-20T09:30:00-04:00,22.61,22.89999,22.56,22.86,9552527,10249132.7,70.95122807065957,56.99607769134449,NaN,NaN,149.90465452103598,150.18933757679162,0.1668223859025257,0.27679026509835225,0.10996787919582654,262599167,241708786.4,82.05255843806688,55.94686101969402,NaN,NaN,19.62437979789141,4.239392944557388
2010-09-21T09:30:00-04:00,22.89,23.00999,22.74001,22.82001,18634576,10771673,69.81220822759241,59.39761430982109,NaN,NaN,139.92450388923982,146.2564899328881,0.16184931390494198,0.312279521577004,0.15043020767206203,243964591,245812751.4,82.99951394834339,59.64567428196498,NaN,NaN,22.582759392324057,6.859873865666913
2010-09-22T09:30:00-04:00,22.73,22.84,22.59,22.71001,8405750,10662265.75,66.64299232439573,60.79399304687254,NaN,NaN,108.79309502452764,137.45533014221445,0.14185649373437229,0.3277508248400274,0.1858943311056551,235558841,246759244.6,83.21941767464834,63.39117982487712,NaN,NaN,24.219943363768063,9.339883793967077
2010-09-23T09:30:00-04:00,22.56,22.92,22.53,22.67999,9931262,10605178.25,65.76554398962716,61.89383470424058,NaN,NaN,96.0775752383798,126.5565127039632,0.11827846016805882,0.3337424063157286,0.21546394614766978,225627579,244159363.6,80.15245333937122,66.59952205794767,NaN,NaN,25.34735684609713,11.626665658557085
2010-09-24T09:30:00-04:00,22.89999,23.14,22.89999,23.12,8166285,10505745.8,71.65617776063812,63.05667115339129,NaN,NaN,119.49719441171443,122.83940461697952,0.12341591977104147,0.3697338458614716,0.24631792609043016,233793864,240308808.4,75.70256401842153,69.27307677073753,NaN,NaN,28.211586948265616,13.995940128515446
2010-09-27T09:30:00-04:00,23.17,23.31,23.08,23.13,15320078,10522153.4,71.77504276778532,64.45587298147665,NaN,NaN,120.75636449426625,117.00974661162556,0.11855885659548188,0.3945164968347825,0.27595764023930064,249113942,237611763.4,72.65974729323213,71.52169626949431,NaN,NaN,30.558545955502915,16.36202667522794
2010-09-28T09:30:00-04:00,23.19,23.21001,22.83,23.16,14715926,10878271.55,72.15234568451478,65.74637601103328,NaN,NaN,100.7292394982998,109.17069373343756,0.10869816910618019,0.41183035162202586,0.30313218251584567,263829868,241584818.8,74.29861126354982,73.29542460080908,NaN,NaN,32.60541662579449,18.682510953880303
2010-09-29T09:30:00-04:00,23.11,23.21001,23.05,23.11,6133453,10408945.95,70.46173489981341,66.8474491312148,NaN,NaN,100.82500135127,107.57707499878605,0.09086506214534895,0.4167135101975319,0.32584844805218294,257696415,246012333.6,76.02344504480664,74.80975884154876,NaN,NaN,33.88121844793333,20.853754881602164
2010-09-30T09:30:00-04:00,23.23,23.37,22.89,23.02,13139332,10326010.2,67.40038651248489,67.71782006172927,NaN,NaN,90.0427957957909,106.37011911026825,0.06621003163644845,0.4086109875977435,0.34240095596129505,244557083,249798234.4,77.41894183018157,76.10543362461972,NaN,NaN,34.16554363944211,22.755438989865013
2010-10-01T09:30:00-04:00,23.17999,23.22,22.95,23.03,12167613,10469068.4,67.5689882690891,68.16555218368809,NaN,NaN,80.39250098379709,98.54918042468479,0.04480246937677956,0.3984040426822695,0.3536015733054899,256724696,254384400.8,79.01250036699676,77.22402149761331,NaN,NaN,34.447097037161704,24.42567585376454
2010-10-04T09:30:00-04:00,22.91,23.03,22.67999,22.84,8487910,10375518.4,61.10279064117968,68.06111198708527,NaN,NaN,45.59988868259872,83.51788526235129,0.013686930435929168,0.37071023635040135,0.3570233059144722,248236786,254208969.6,78.78346606817794,77.93868837448188,NaN,NaN,32.9461072373992,25.64288033714092
2010-10-05T09:30:00-04:00,23,23.35001,22.99001,23.28999,7713016,10369202,68.73420420969329,68.36303349790799,NaN,NaN,92.34085844293583,81.84020905127849,0.018929219136968878,0.3806848298356833,0.3617556106987144,255949802,252632956.4,76.63432099328449,78.20434735462734,NaN,NaN,33.78042438004752,26.80538662898472
2010-10-06T09:30:00-04:00,23.28999,23.36,22.99001,23.17999,7169902,10263160.75,65.3585092948646,68.29877258486317,NaN,NaN,83.73015127332171,78.42123903568883,0.010904683318944453,0.375386464847395,0.36448178152845057,248779900,250849653.4,74.16883752730607,78.04817635661477,NaN,NaN,33.43972746105448,27.753149604994686
2010-10-07T09:30:00-04:00,23.27,23.28,23.015,23.17999,4949629,10163262.7,65.3585092948646,68.19576156765733,NaN,NaN,76.54252687341175,75.72118525121299,0.0019805073818360275,0.3669574157557456,0.36497690837390956,248779900,251694216.8,74.58584728388777,77.69373036359103,NaN,NaN,33.16577950998363,28.526382448564537
2010-10-08T09:30:00-04:00,23.19,23.36,23.03,23.31,6670570,10089276.75,67.54348025790088,67.95235100960313,NaN,NaN,87.97619545851646,77.23792414615686,0.0012526949921339847,0.366542777114077,0.365290082121943,255450470,251439371.6,74.1966093052236,77.13259113981651,NaN,NaN,33.55061063489298,29.244129332325745
2010-10-11T09:30:00-04:00,23.36,23.4525,23.25999,23.35001,6041055,9811396.7,68.20805326254607,67.83776851209983,NaN,NaN,108.5865601310606,89.83525843584923,-0.00004608727675625701,0.3652324730259977,0.36527856030275396,261491525,254090319.4,75.62179020259033,76.60561087226272,NaN,NaN,34.05401665687396,29.93125609297549
2010-10-12T09:30:00-04:00,23.28,23.53999,23.145,23.49001,11007238,9890399.8,70.48536425317188,68.11222364986955,NaN,NaN,112.21681180104454,93.81044910747099,0.004746575155628485,0.37121177924728954,0.36646520409166106,272498763,257400111.6,77.3070555824396,76.18329929424782,NaN,NaN,35.134084423332354,30.67451728302647
2010-10-13T09:30:00-04:00,23.63,23.78999,23.56,23.67999,15479406,10295289.65,73.28222030925578,68.6491291012716,NaN,NaN,181.30668548580692,113.32575594996801,0.01628478626436991,0.3868211869221234,0.3705364006577535,287978169,265239765.4,80.70883257179575,76.22304066799242,NaN,NaN,36.91140158266999,31.565500754404116
2010-10-14T09:30:00-04:00,23.73,23.77071,23.5638,23.69,5514664,10180992.4,73.42511462891649,68.77548173472005,NaN,NaN,173.1168638256096,132.6406233404076,0.01992374322891105,0.3954410796938923,0.37551733646498126,293492833,274182352,83.70881446083042,76.79491569959305,NaN,NaN,38.40504621641032,32.54257867754786
2010-10-15T09:30:00-04:00,24.00999,24.10001,23.81,24.09,21346944,10527356.8,78.39716897054097,69.24849074920259,NaN,NaN,233.05413435713749,161.6562111201318,0.04326368106395029,0.42959693779491914,0.38633325673096885,314839777,286060213.4,86.67326197324874,77.79588103387995,NaN,NaN,41.429719527783575,33.81217022758153
2010-10-18T09:30:00-04:00,24.10001,24.25,24.00999,24.25,10752547,10587357.8,80.00839614788794,69.80963721087211,NaN,NaN,218.7429984433543,183.68749878259055,0.06231344793173621,0.4642250666456391,0.4019116187139029,325592324,298880373.2,88.99989449636521,78.84597269336676,NaN,NaN,44.49495736412399,35.33828267565902
2010-10-19T09:30:00-04:00,23.78999,24,23.64,23.82001,25204672,10915862.6,65.80403539785627,69.47694438930374,NaN,NaN,115.37543666411227,184.3192237552041,0.03988179006588022,0.45176385629625315,0.41188206623037293,300387652,304458151,89.8316698133819,79.83227446255071,NaN,NaN,42.37540070768327,36.34358525166249
2010-10-20T09:30:00-04:00,23.89999,24.16,23.85001,24.02,23627216,11676935.9,68.59656563012138,69.5623857548492,NaN,NaN,133.51678594797468,174.76124384763767,0.03273923656263922,0.45280611193367193,0.4200668753710327,324014868,311665490.8,90.79974182537217,80.7880458907786,NaN,NaN,41.58566455701232,37.09245372385532
2010-10-21T09:30:00-04:00,24.14999,24.2,23.791,24.03999,27648896,12562817.6,68.87021118399471,69.65533024877104,NaN,NaN,114.83734342613604,163.10533976774295,0.02399222310209137,0.4500571542486469,0.4260649311465555,351663764,323299677,92.10618536011255,81.72330910457258,NaN,NaN,41.060500082301395,37.659317489347615
2010-10-22T09:30:00-04:00,24.03999,24.13,23.99001,24.11,5762527,12442629.7,69.86075918378496,70.28089943038569,NaN,NaN,109.76477541135857,138.44746797858716,0.017835574537795718,0.4483593993188002,0.4305238247810045,357426291,331816979.8,92.90095508259387,82.73170117703089,NaN,NaN,40.93689782608651,38.127543251738885
2010-10-25T09:30:00-04:00,24.2,24.36,24.17999,24.17999,9499996,12151625.6,70.85906462431609,70.43267517428733,NaN,NaN,120.05780573369884,118.71042943665607,0.013583330962467888,0.4475029884840893,0.4339196575216214,366926287,340083772.4,93.57691042738269,83.94188613660933,NaN,NaN,41.129771733460395,38.55643303484196
2010-10-26T09:30:00-04:00,24.09,24.27,23.99001,24.24001,10317836,11931721.1,71.7240195631409,70.8873544791642,NaN,NaN,96.33018646058169,114.90137939594997,0.010080419907338822,0.44652018240579494,0.4364397624984561,377244123,355455066.6,94.60547063785114,85.4016456445054,NaN,NaN,41.53713653156716,38.98224782008842
2010-10-27T09:30:00-04:00,24.14,24.33,24.056,24.31,11837289,12216912.9,72.74012447155454,71.41461270607063,NaN,NaN,96.827261035674,107.56347441348983,0.007844091136913756,0.4462448764195983,0.43840078528268456,389081412,368468375.4,95.2927247112218,86.8807083178864,NaN,NaN,42.164751343651766,39.43689118059747
2010-10-28T09:30:00-04:00,24.41,24.42999,24.145,24.31,8548051,11987348.85,72.74012447155454,71.78580157847445,NaN,NaN,97.92928480674773,104.18186268961217,0.002034387093275025,0.44094376914927835,0.4389093820560033,389081412,375951905,95.63696073113601,88.41216199116585,NaN,NaN,42.68117791344533,39.90036071386145
2010-10-29T09:30:00-04:00,24.35001,24.45,24.31,24.35001,8338504,11795893.4,73.37446312361786,72.1548308542653,NaN,NaN,100.438781898488,102.31666398703805,-0.003161777108138475,0.43495716067083023,0.4381189377789687,397419916,383950630,95.97570754371016,89.86601322981728,NaN,NaN,43.28594345099748,40.384015390595174
2010-11-01T09:30:00-04:00,24.47,24.62,24.265,24.37,8468844,11794940.1,73.7037092885368,72.38471264250565,NaN,NaN,102.13942163265678,98.73298716682964,-0.008971418209030635,0.42690466501768043,0.43587608322671106,405888760,391743124.6,96.27882220550873,91.22113941717934,NaN,NaN,43.88284335417705,40.88384795682116
2010-11-02T09:30:00-04:00,24.59,24.67,24.53999,24.61,7486824,11783630.5,77.32852015600331,72.67373406013049,NaN,NaN,125.0104902410601,104.46904792292533,-0.0008000518656571254,0.43487601839463963,0.43567607026029675,413375584,398969416.8,96.53915186136337,92.35187650929132,NaN,NaN,45.4581282782798,41.537316574172394
2010-11-03T09:30:00-04:00,24.64999,24.75999,24.45,24.75,15116328,12180951.8,79.1352971049501,73.08160423699003,NaN,NaN,127.3327380471496,110.57014332522044,0.009326039658665297,0.4473336198336284,0.4380075801749631,428491912,406851516.8,96.80195967003428,93.28710116709159,NaN,NaN,47.36555030073031,42.369921392252095
2010-11-04T09:30:00-04:00,25.00999,25.14,24.955,25.12,13674816,12617211.15,82.99286952136478,73.40986856204886,NaN,NaN,190.59924732628158,129.1041358291272,0.034803295354025376,0.4815116993674948,0.44670840401346945,442166728,417468580,97.11928396094817,94.03324559478442,NaN,NaN,50.454545408979115,43.52486768035595
2010-11-05T09:30:00-04:00,25.13,25.13,24.99001,25.10001,8737609,12720563.1,82.10960336449038,73.55995479180618,NaN,NaN,174.11497052116064,143.83937355366174,0.04359922904525709,0.5012074403200408,0.45760821127478374,433429119,424670420.6,97.31397803265385,94.62710870451932,NaN,NaN,52.64438037249673,44.82765520780463
2010-11-08T09:30:00-05:00,25.05,25.1501,25,25.12,7502094,12793615.05,82.31232783422473,74.73911853726108,NaN,NaN,156.8903157285256,154.78955237283552,0.04393059463374216,0.5125214545669614,0.46859085993321925,440931213,431678911.2,97.49164510027528,95.17424979644026,NaN,NaN,54.481223536639824,46.20673639763823
2010-11-09T09:30:00-05:00,25.2,25.28,24.92999,25.05,9079938,12697250.05,78.93908041977959,75.47786959366522,NaN,NaN,136.04175401213018,156.99580512704952,0.03309608391129143,0.5099609648223336,0.4768648809110421,431851275,435374049.4,97.58244081733838,95.65872829586644,NaN,NaN,55.07568920190013,47.47372965538993
2010-11-10T09:30:00-05:00,25.08,25.105,24.84,25.07001,7053434,12275951.45,79.20147184987087,76.21581678408495,NaN,NaN,106.16988254420245,152.7632340264601,0.021499776441713914,0.5037396014631845,0.4822398250214706,438904709,437456608.8,97.6344125015153,96.05360166310949,NaN,NaN,55.63980642400781,48.64031205090677
2010-11-11T09:30:00-05:00,24.59,24.72,24.44,24.685,12127645,12606600.5,62.950447442869034,75.72222308830524,NaN,NaN,30.478285100571306,120.73904158131805,-0.01586254540986337,0.4624116432591414,0.4782741886690048,426777064,434378676,94.40422647698774,96.16097819128048,NaN,NaN,51.029023147830635,48.98155649332447
2010-11-12T09:30:00-05:00,24.56,24.67999,24.22,24.34,10785465,12078526.55,52.546002008036936,74.41414718714245,NaN,NaN,-11.241298620415293,83.66778775300284,-0.06482641257666166,0.39724117294817773,0.4620675855248394,415991599,430891172,90.74096212048673,95.95841045507362,NaN,NaN,43.1643383675967,48.15052533250621
2010-11-15T09:30:00-05:00,24.46001,24.48,24.25,24.27,8800094,11980903.9,50.714465432277514,72.91346474922362,NaN,NaN,-28.91712183665826,46.50630023996608,-0.10079752670476472,0.3360706771438835,0.4368682038486482,407191505,424143230.4,83.95278429662949,95.1975042878435,NaN,NaN,36.32466529230688,46.46111675533488
2010-11-16T09:30:00-05:00,24.10001,24.17999,23.74001,23.83,17919648,11616652.7,41.032866369129756,70.64866059905043,NaN,NaN,-113.68594167219888,-3.439238896899738,-0.15012216735756106,0.2492154946516969,0.39933766200925797,389271857,415627346.8,76.20501843193634,93.83409669646598,NaN,NaN,26.4084165177965,43.596445292829394
2010-11-17T09:30:00-05:00,23.86,24,23.74001,23.84,10412848,10955934.3,41.30710760696634,68.4034451087227,NaN,NaN,-121.34643020413992,-48.9425014465682,-0.17617075306316027,0.17912422068030764,0.3552949737434679,399684705,407783346,69.81391329165201,91.9895933079314,NaN,NaN,18.99714964742783,40.08226020062917
2010-11-18T09:30:00-05:00,24.10001,24.3425,24.09,24.24001,10805246,10113751.8,51.10330975394783,66.81264843946056,NaN,NaN,-53.13542838741468,-65.6652441441654,-0.16097379270660428,0.15407773286021254,0.3150515255668168,410489951,404525923.4,67.2900579934631,89.94061834005662,NaN,NaN,15.849494841302079,36.62043657786816
2010-11-19T09:30:00-05:00,24.24001,24.34,24.16,24.31,5119852,10081618.05,52.59422616351029,65.30482821624437,NaN,NaN,-46.934319836652655,-72.80384838741287,-0.14141578648885345,0.13828179245575,0.27969757894460345,415609803,404449564.2,67.22870310785787,87.86560983308155,NaN,NaN,13.918578119305996,33.37731394093071
2010-11-22T09:30:00-05:00,24.2,24.45,24.13499,24.45,9414125,10077324.5,55.51604919939803,63.74679457648686,NaN,NaN,-32.946471068625684,-73.60971823380635,-0.11535943439005825,0.13549828595703062,0.25085772034708886,425023928,408016048.8,68.66578252185182,85.8746548802593,NaN,NaN,13.319573704920012,30.51192247864347
2010-11-23T09:30:00-05:00,24.22,24.25999,23.96989,24.09,11009887,10111927.05,47.422066175056486,61.48156379578017,NaN,NaN,-81.62403875348792,-67.19733765006416,-0.11824186644304602,0.10305538729328134,0.22129725373632736,414014041,412964485.6,70.59266474737244,84.00256238578345,NaN,NaN,9.96581215279691,27.57676386066539
2010-11-24T09:30:00-05:00,24.28999,24.5,24.25999,24.49001,7216168,9880871,55.232261945743105,59.498663254664336,NaN,NaN,-19.547576829270294,-46.83756697509024,-0.0903399061041906,0.1083723711060891,0.1987122772102797,421230209,417273586.4,72.19607876340997,82.22233344310214,NaN,NaN,9.940360437691725,25.057277657383437
2010-11-26T09:30:00-05:00,24.28999,24.44,24.24001,24.35001,2490421,9577989.5,52.30383874223751,57.369680067360555,NaN,NaN,-35.88455952498179,-43.387393202603654,-0.0788618255919627,0.10013499522032632,0.17899682081228901,418739788,418923553.8,72.80746146835,80.4718679742233,NaN,NaN,8.895807483210914,22.74849620393022
2010-11-29T09:30:00-05:00,24.23,24.3,23.97,24.19,7172891,9519708.85,49.09961475393891,54.997343418768715,NaN,NaN,-72.2324630376084,-48.447021842794825,-0.07937686411907668,0.07977574066344317,0.15915260478251986,411566897,418114972.6,71.97223348008038,78.64905285849508,NaN,NaN,6.970270838237994,20.49446400883133
2010-11-30T09:30:00-05:00,23.97,24.08,23.87,23.95,10692996,9630916.45,44.678454613881904,52.550155861204594,NaN,NaN,-100.72357330862975,-62.002442290795635,-0.09230581714323027,0.043770333353482016,0.1360761504967123,400873901,413284967.2,67.02593106281589,76.46644501888633,NaN,NaN,3.8663213643687833,18.119015059622395
2010-12-01T09:30:00-05:00,24.3,24.53,24.24001,24.46001,10728422,9792996.35,54.13065343151416,50.75938311703625,NaN,NaN,-11.583030507185567,-47.994240641535164,-0.06426354452632896,0.055746719838801084,0.12001026436513004,411602323,412802623.6,66.53417013737712,74.24499913573361,NaN,NaN,4.569448655961166,16.18336271624222
2010-12-02T09:30:00-05:00,24.49001,24.77,24.47,24.75,9625578,9518458.85,58.47511533430646,50.439716537853215,NaN,NaN,39.092375289540676,-36.26625021777297,-0.025906016466403933,0.08762774378212512,0.11353376024852906,421227901,412802162,66.53366704633379,72.2542448906869,NaN,NaN,6.733829018202493,14.833429330807972
2010-12-03T09:30:00-05:00,24.62,24.82001,24.61,24.80499,9177723,9293604.2,59.26304487910739,50.919505314358254,NaN,NaN,62.72903282434776,-16.54353174790706,0.0019680429164199154,0.11599381389405394,0.11402577097763403,430405624,415135329.2,67.85666016892034,70.61965189414646,NaN,NaN,8.655033227469838,13.950801316045382
2010-12-06T09:30:00-05:00,24.78,24.87,24.75,24.81,6439016,9178674.55,59.33874532115951,51.53552530642124,NaN,NaN,84.07657812188445,14.718276483991511,0.018615970572914947,0.13729573419377772,0.11867976362086277,436844640,420190877.8,70.57138830627174,69.66383789483518,NaN,NaN,10.165983396694585,13.41011304185241
2010-12-07T09:30:00-05:00,25.10001,25.1035,24.82001,24.84,9910527,9299096.2,59.82023332764427,52.87748008917229,NaN,NaN,115.46707786586333,57.95640671889013,0.028907238328757467,0.15481381153180962,0.12590657320305215,446755167,429367131,74.74131041195085,69.55928732197908,NaN,NaN,11.520533154378919,13.140173057927626
2010-12-08T09:30:00-05:00,24.92999,25.05,24.81,25.05,9010816,9295640.1,63.112998606965064,54.435043732029335,NaN,NaN,131.85222797590544,86.64345841550832,0.046096083590257964,0.1835266776908746,0.13743059410061664,455765983,438199863,77.9762344773043,70.14231026381138,NaN,NaN,13.691478580202945,13.218930989681244
2010-12-09T09:30:00-05:00,25.14999,25.16,24.97,25.07001,6231250,9254530.9,63.42060991779171,55.31485088658961,NaN,NaN,152.25770775347502,109.27652490829522,0.05447734888469516,0.20552728020648559,0.15104993132179043,461997233,446353729.4,80.4636580439643,71.08328169599004,NaN,NaN,15.539019628262519,13.550372223764283
2010-12-10T09:30:00-05:00,25.12,25.21001,25.03999,25.185,5816918,8938994.55,65.21579290974628,56.21639136846361,NaN,NaN,146.5628033907127,126.0432790215682,0.06283607072249667,0.22959501972491125,0.16675894900241459,467814151,453835434.8,82.42508889696514,72.16873782378342,NaN,NaN,17.62527539042918,14.132501247573554
2010-12-13T09:30:00-05:00,25.28999,25.32001,25.12,25.14,6901043,8744773.45,63.89428012276683,56.81483643441852,NaN,NaN,130.76484377424921,135.38093215204114,0.06038908059775247,0.24224529974960518,0.1818562191518527,460913108,458649128.4,83.56817286727212,73.23319427702772,NaN,NaN,19.00791039220096,14.828988268234612
2010-12-14T09:30:00-05:00,25.14,25.27,25.12,25.17999,6291633,8619350.4,64.58115333563484,58.04048551731699,NaN,NaN,112.34250210969238,134.75601700080696,0.05658377913983459,0.25258594307664595,0.19600216393681136,467204741,462739043.2,84.49113827193557,74.2259423859251,NaN,NaN,20.355513365779544,15.618491853598174
2010-12-15T09:30:00-05:00,25.14999,25.28,25.00999,25.08,4598430,7953289.5,61.43412884102944,58.48347600983744,NaN,NaN,90.902888189143,126.56614904345447,0.04306443218395897,0.24983270416676007,0.2067682719828011,462606311,464107108.8,84.79871759565778,75.12613087394278,NaN,NaN,20.6990793600692,16.34429006880832
2010-12-16T09:30:00-05:00,25.11,25.23,25,25.12,5935102,7729402.2,62.22710960310074,59.19228107132766,NaN,NaN,82.56381536883998,112.62737056652745,0.03300089841523424,0.2480193950018439,0.21501849658660965,468541413,465415944.8,85.10311137795344,76.00439158177161,NaN,NaN,21.196481876226446,17.03746032701091
2010-12-17T09:30:00-05:00,25.09,25.13,25.02,25.08,5979008,7488090.3,60.87904100823359,60.033668660920135,NaN,NaN,68.6900479108338,97.05281947055167,0.020450319643048775,0.24058139614042062,0.22013107649737185,462562405,464365595.6,83.65539769727272,76.83890331157106,NaN,NaN,21.282189910396166,17.643850267494518
2010-12-20T09:30:00-05:00,25.14,25.17,24.95,25.10001,4770699,7470632.65,61.33035040888329,61.22308978913453,NaN,NaN,62.62089810587261,83.42403033687636,0.010781918913408017,0.23360847513913185,0.22282655622572384,467333104,465649594.8,84.01341875142991,78.0522952893292,NaN,NaN,21.466680910951457,18.18996893084551
2010-12-21T09:30:00-05:00,25.17999,25.2599,25.13989,25.25,5557617,7277807.25,64.6246669347378,61.97266218222193,NaN,NaN,82.6517398459538,77.48587788412864,0.01169729085514662,0.2374481697946571,0.22575087893951049,472890721,466786790.8,84.34058241908662,79.32418188087988,NaN,NaN,22.484745209186404,18.803508399179922
2010-12-22T09:30:00-05:00,25.22,25.25,25.17999,25.22,5407707,6997698.25,63.46016578014643,62.328737214067644,NaN,NaN,77.82991186958003,74.87128262021604,0.007685179353268734,0.2353573531310964,0.22767217377782767,467483014,467762131.4,84.63109047864225,80.61685498318762,NaN,NaN,23.064390532414695,19.41220584678489
2010-12-23T09:30:00-05:00,25.19,25.2399,25.13,25.21001,3228144,6798297.05,63.052715782527194,62.59942799288335,NaN,NaN,68.17679669118843,71.99387888468571,0.002054413579470893,0.23024019075216628,0.2281857771726954,464254870,466904822.8,83.17053639438383,81.71070328500643,NaN,NaN,23.46003097918944,19.99046657998554
2010-12-27T09:30:00-05:00,25.10001,25.295,25.05,25.25999,2991320,6823342,64.28809854913371,62.952953223452944,NaN,NaN,66.69808431618065,71.59548616575509,-0.00047325641212517255,0.22759420665753893,0.2280674630696641,467246190,467841579.8,83.50550278888325,82.63456860519297,NaN,NaN,24.109870122864287,20.578952800396788
2010-12-28T09:30:00-05:00,25.31,25.33,25.205,25.23,2907471,6610071,62.92843686629065,63.17496776192769,NaN,NaN,78.39849136631078,74.75100481784273,-0.0060258813750610485,0.2205351113508378,0.22656099272589886,464338719,467242702.8,82.37666756101059,83.17995125869723,NaN,NaN,24.349635580950586,21.117621769047332
2010-12-29T09:30:00-05:00,25.3,25.34,25.25,25.28,3734852,6262163.8,64.28466644021749,63.258658321445715,NaN,NaN,94.09003569955884,77.03866398856373,-0.008064902603744845,0.2164798644712178,0.22454476707496265,468073571,466279272.8,80.49157322133398,83.35961831184223,NaN,NaN,24.889488557281936,21.656459881652275
2010-12-30T09:30:00-05:00,25.25999,25.28999,25.19,25.22,5045910,5978038.2,61.382624436107875,63.11308792989688,NaN,NaN,72.99340560955018,76.07136273655776,-0.014796337695028083,0.20604934495617755,0.22084568265120563,463027661,465388202.2,78.69779774533848,83.23348543336895,NaN,NaN,24.66301238074743,22.085967381523012
2010-12-31T09:30:00-05:00,25.21001,25.24001,25.09,25.19,6352020,5814360.3,59.92593881424962,62.735241208789965,NaN,NaN,37.67275011073092,69.97055342046625,-0.022167760176447004,0.1931359824306469,0.2153037426070939,456675641,463872356.4,75.61084930313537,82.74675403380968,NaN,NaN,24.111455462772923,22.37532282170157
2011-01-03T09:30:00-05:00,25.38,25.61,25.38,25.47,7427559,5726852.1,67.6438342760921,63.003066505456054,NaN,NaN,220.31601828653643,100.6941402145374,-0.009719891615218967,0.20315387808807017,0.21287376970328914,464103200,463243758.4,74.30914684410105,82.08539503215461,NaN,NaN,25.716114967186293,22.8525788424851
2011-01-04T09:30:00-05:00,25.59,25.62,25.39999,25.57001,9191629,5864482.75,69.87548238624245,63.38123286621374,NaN,NaN,234.0561641089171,131.82567476305866,0.003033399057546099,0.21666551852522176,0.21363211946767566,473294829,465034980.4,75.59831206572102,81.45019316028215,NaN,NaN,27.759664335651774,23.553591055794627
2011-01-05T09:30:00-05:00,25.52,25.75,25.47,25.72,11837352,5960824,72.89490034525986,64.1998594022302,NaN,NaN,253.5242212454142,163.71251187222975,0.018492266929490353,0.2367474531295386,0.21825518620004825,485132181,468446702.4,77.8755644160394,80.95568221888082,NaN,NaN,30.491735880782745,24.544754602221502
2011-01-06T09:30:00-05:00,25.78,25.87,25.67,25.87,11044906,6062528.5,75.535777435111,65.15047853308808,NaN,NaN,249.29330183540364,198.97249111740044,0.034795049335430484,0.26174899786933636,0.22695394853390588,496177087,475076587.6,81.49051720346715,80.69763977784609,NaN,NaN,33.71574540445255,25.854896145397365
2011-01-07T09:30:00-05:00,25.85001,25.87,25.5305,25.75,8915520,6196742,69.68627282128115,65.77956651973433,NaN,NaN,164.51844205470368,224.34162950619498,0.03346208804262979,0.2687815585871931,0.23531947054456331,487261567,481193772.8,84.07585275421168,80.72767228191317,NaN,NaN,34.673331475160104,27.114672621077755
2011-01-10T09:30:00-05:00,25.72,25.815,25.6011,25.77251,10333223,6422557.25,70.1531935832144,66.40976960361512,NaN,NaN,137.2498869409143,207.72840323707055,0.030163648697493217,0.27302403141642984,0.24286038271893662,497594790,487892090.8,86.32780730443304,80.89298574998482,NaN,NaN,35.58712997296468,28.325023671347317
2011-01-11T09:30:00-05:00,25.86,25.88,25.64999,25.73,8391965,6497103.35,68.02233001022447,66.65245982329273,NaN,NaN,121.42726418509555,185.20262325230627,0.021588021869389185,0.2698454100556731,0.2482573881862839,489202825,491073690,87.25011155843472,81.10080925993826,NaN,NaN,35.73833656833013,29.384068370916292
2011-01-12T09:30:00-05:00,25.88,25.98,25.78999,25.96001,13580063,6861524.85,72.83097343292243,67.32180322706246,NaN,NaN,140.62845559907834,162.62347012303908,0.02749669096689178,0.2826282518948986,0.2551315609280068,502782888,494603831.4,88.2011681683224,81.35581480920112,NaN,NaN,37.36912085981281,30.524790155044368
2011-01-13T09:30:00-05:00,25.98,26.00999,25.86,25.94,13044684,7283837.55,71.81915841004982,67.94797770045693,NaN,NaN,127.43153007459354,138.25111577087705,0.026155731117006475,0.2878262248242649,0.2616704937072584,489738204,493316054.8,85.69007055562686,81.53578153500419,NaN,NaN,38.38553512392565,31.647753722027407
2011-01-14T09:30:00-05:00,25.96001,26.17,25.91,26.17,7853344,7379749.65,75.95427952007213,68.78127634123824,NaN,NaN,142.83335490270895,133.91409834047812,0.03623657955179049,0.30696621814699654,0.27072963859520605,497591548,495382051,86.36095377887372,81.73974232000351,NaN,NaN,40.64135311490345,32.93255363529541
2011-01-18T09:30:00-05:00,26.00999,26.23,25.98,26.19749,8633992,7512498.85,76.40001538730274,69.74353194988196,NaN,NaN,136.94476476024346,133.85307390434397,0.039941635815023524,0.32065668336398545,0.2807150475489619,506225540,497108201,86.9130095108961,82.06376674499533,NaN,NaN,42.588469312659946,34.3119701606332
2011-01-19T09:30:00-05:00,26.25999,26.25999,25.9301,26.00999,11215527,7834740.25,67.24403657476041,69.95491553092074,NaN,NaN,108.64952421471276,131.2975259102674,0.02564504928157091,0.3127713591509256,0.28712630986935467,495010013,498269638.6,87.28590439706902,82.5490761146907,NaN,NaN,41.39617796629397,35.323999847156166
2011-01-20T09:30:00-05:00,25.92,25.925,25.64999,25.87,15358848,8324801.8,61.33396427573249,69.95143980517965,NaN,NaN,47.39176613726889,112.65018801790552,0.0037883594362079775,0.29186175916461465,0.2880733997284067,479651165,493643294,77.77906535063892,82.48345237221217,NaN,NaN,38.460261050159,35.772037161870855
2011-01-21T09:30:00-05:00,26.02,26.03,25.71001,25.72,11631641,8635998.5,55.68633025608331,69.64861062245348,NaN,NaN,43.890721535797276,95.94202631014628,-0.022308542155632716,0.26018772203386575,0.28249626418949847,468019524,489299558,70.06308027699086,82.087183156059,NaN,NaN,34.09627786352893,35.53264297639344
2011-01-24T09:30:00-05:00,25.73,26.10001,25.72501,26.08,18491744,9399178.5,64.20519044868809,69.40299320621033,NaN,NaN,74.34415660121246,82.24418664984697,-0.01709722939195163,0.26112472744955895,0.2782219568415106,486511268,487083502,66.4417217077538,81.52522421774847,NaN,NaN,33.09082210507424,35.18381142334784
2011-01-25T09:30:00-05:00,26.02,26.21001,25.96001,26.2,11014410,9800333,66.5159023571055,69.16302320412912,NaN,NaN,108.30109427539922,76.51545255287812,-0.00781299130953339,0.26845571770459387,0.27626870901412726,497525678,485343529.6,63.65949937301523,80.6724518825552,NaN,NaN,33.09980005086532,34.886095512993194
2011-01-26T09:30:00-05:00,26.27,26.42999,26.2001,26.35001,8285477,10069233.3,69.19319619028924,68.89861576448837,NaN,NaN,150.23422812304517,84.8323933345446,0.005470357834003958,0.28310665630663223,0.2776362984726283,505811155,487503758,65.58624764975083,79.79464354210602,NaN,NaN,34.0341583323269,34.76439020146944
2011-01-27T09:30:00-05:00,26.36,26.52,26.28999,26.44,9052406,10335111,70.70637178257681,68.55365821787878,NaN,NaN,157.73571267796618,106.90118264268406,0.01672113296881783,0.29853771468365053,0.2818165817148327,514863561,494546237.2,70.98682211967466,79.04437960754942,NaN,NaN,35.28608597697701,34.83891816939909
2011-01-28T09:30:00-05:00,26.47,26.47,25.74001,25.83,16182133,10891922.15,52.04505064224427,67.29357091937614,NaN,NaN,41.58910063843814,106.44085846321222,-0.018601691471221815,0.2585644673758054,0.2771661588470272,498681428,500678618,74.70873876837196,78.37530003713229,NaN,NaN,29.09874743350499,34.01889377855708
2011-01-31T09:30:00-05:00,25.85001,25.99001,25.7,25.99001,13986492,11273645.75,55.37233538357806,66.23779533368784,NaN,NaN,-5.437416766316735,90.4845437897064,-0.03208162868503439,0.2370641229907342,0.2691457516757686,512667920,505909948.4,77.37513703279174,77.7358235891579,NaN,NaN,25.6003808933409,32.81624908066905
2011-02-01T09:30:00-05:00,26.17999,26.485,26.14999,26.42999,12372660,11520900.8,62.97872252506763,65.87753765617663,NaN,NaN,139.89930038191534,96.80418501100962,-0.013224074908958883,0.25261565803957,0.26583973294852886,525040580,511412928.8,79.78900109231742,77.20288712729239,NaN,NaN,25.647909175996997,31.79220052285876
2011-02-02T09:30:00-05:00,26.3701,26.53,26.3701,26.47749,8747688,11498703.75,63.6980872398436,65.22518864238529,NaN,NaN,154.11612420763194,97.58056422792697,-0.00010356874478012479,0.2657102720175537,0.26581384076233383,533788268,517008351.4,81.90321047729935,76.75303300650502,NaN,NaN,25.94714725005377,30.957192912458048
2011-02-03T09:30:00-05:00,26.47,26.58,26.25,26.52,11464441,11480058.2,64.36543373920654,64.69277973732505,NaN,NaN,132.59439182585254,92.55230005750425,0.008415054419273982,0.2763326587864263,0.26791760436715234,545252709,523086181,83.87621275783283,76.62347173523402,NaN,NaN,26.402325169644104,30.306497520627484
2011-02-04T09:30:00-05:00,26.57001,26.71001,26.47,26.69,7567598,11306192.8,66.97967531385956,64.05173657973843,NaN,NaN,160.6850999144897,116.37149991271455,0.021719680518427376,0.2950672050151866,0.2733475244967592,552820307,533913956.8,86.66542014432652,76.64521933276637,NaN,NaN,27.653437371431334,29.92748892788518
2011-02-07T09:30:00-05:00,26.75,26.95,26.7401,26.82249,9798320,11350332.8,68.89492065932087,63.51565838488259,NaN,NaN,185.81824007100028,154.62263128017796,0.034883325936903686,0.3169516819178888,0.2820683559809851,562618627,543904098.2,88.62122808048488,76.76723494487986,NaN,NaN,29.299188857017768,29.83773177490412
2011-02-08T09:30:00-05:00,26.88,26.95,26.77,26.9325,5188543,11093098.8,70.42864748154511,63.74313059251006,NaN,NaN,164.19619173882452,159.4820095515598,0.045754420112650074,0.3392613811217977,0.29350696100914764,567807170,552457416.2,89.97674052102404,76.95943752516234,NaN,NaN,31.129504923349938,30.022270796110668
2011-02-09T09:30:00-05:00,26.89,26.96001,26.8,26.88,5189094,10932955.25,68.68800560379641,64.26841925880035,NaN,NaN,140.80251713995546,156.8192881380245,0.04414341473761213,0.3486862294311628,0.30454281469355066,562618076,558223377.8,90.77458093083891,77.88768863803377,NaN,NaN,32.082221849047556,30.316549517958794
2011-02-10T09:30:00-05:00,26.67,26.83,26.57001,26.75999,7838559,10645880.05,64.74857794344709,64.91572266504062,NaN,NaN,93.94715768531285,149.08984130991655,0.030384380490605767,0.34252329030680784,0.31213890981620207,554779517,560128739.4,91.02870883439431,79.38523353499116,NaN,NaN,31.7088341571582,30.51544732355871
2011-02-11T09:30:00-05:00,26.77,26.94,26.7,26.9025,12749773,10631134.5,67.15738771608355,65.12659389842601,NaN,NaN,109.52211962432688,138.85724525188397,0.026416629360176025,0.3451596965164221,0.31874306715624606,567529290,563070536,91.42161747133055,81.16951180381807,NaN,NaN,32.10892154533358,30.743086498097977
2011-02-14T09:30:00-05:00,26.88,26.99001,26.86681,26.94,5941746,10535554.6,67.78127315419673,65.21697752678968,NaN,NaN,113.03698586359216,124.30099441040235,0.022032159149857677,0.3462832660935682,0.3242511069437105,573471036,565241017.8,91.71009652682245,83.17312588623288,NaN,NaN,32.615301250503606,31.01054574844164
2011-02-15T09:30:00-05:00,26.89,26.89,26.74001,26.84,6042371,10405973.55,64.27487053656186,64.86566855152343,NaN,NaN,82.10956647723283,107.883669358084,0.008791194144594283,0.33524009962445334,0.32644890547985905,567428665,565165316.8,91.59440329099186,85.03085128917867,NaN,NaN,32.05094442736932,31.159174131145594
2011-02-16T09:30:00-05:00,26.92,27.02,26.84,26.9875,6786531,10184523.75,66.98759640866169,64.60004173910092,NaN,NaN,96.8797587528958,99.09911768067205,0.006468097931049577,0.33453402789367104,0.32806592996262146,574215196,567484740.8,91.93030421152174,86.52681429573917,NaN,NaN,32.33849151968248,31.32764804379372
2011-02-17T09:30:00-05:00,26.86,27.07001,26.84,27.03999,6648887,9749025.7,67.92111004365024,65.73404598205849,NaN,NaN,93.76891302096293,99.06346874780208,0.005031832561276206,0.3343557206642167,0.3293238881029405,580864083,572701654,92.64248753346243,87.80779635038849,NaN,NaN,32.840181592718515,31.54372426506869
2011-02-18T09:30:00-05:00,27.07001,27.09,26.92999,27,6334004,9484143.85,66.38101707947644,66.52038038890836,NaN,NaN,90.96589004605592,95.35222283214789,-0.0016866191264962582,0.32721561419482015,0.3289022333213164,574530079,574101811.8,92.82549739410358,88.91139351905363,NaN,NaN,32.84242153719104,31.729252446800455
2011-02-22T09:30:00-05:00,26.66,26.78999,26.28999,26.34,22346800,9676896.65,47.313177411067315,65.40141288076549,NaN,NaN,-29.217608365606957,66.90130398630806,-0.050927396123675195,0.2652429881667224,0.3161703842903976,552183279,569844260.4,85.8339965109943,89.34317890610198,NaN,NaN,26.241206248020895,30.945245846974803
2011-02-23T09:30:00-05:00,26.25,26.3,25.87,26.03,12256297,9738991,41.31079593137636,63.802320644446404,NaN,NaN,-121.12029594447894,26.25533150196575,-0.1017868037602393,0.18893687959009853,0.2907236833503378,539926982,564343923.8,77.69263509583126,89.0424235217114,NaN,NaN,18.42758381979176,29.15700841452008
2011-02-24T09:30:00-05:00,26.05,26.2,25.825,26.12,11360512,9892742.75,43.54988717584508,62.31549588992059,NaN,NaN,-116.0429846691912,-16.32921718245165,-0.1252355452917967,0.13417925173559198,0.2594147970273887,551287494,559758383.4,71.59571283180387,88.16524495556648,NaN,NaN,13.065845195591264,26.858270811815963
2011-02-25T09:30:00-05:00,26.28999,26.48,26.24001,26.45,7803730,9830308.95,50.940682685607015,61.169853559331116,NaN,NaN,-41.42265982876459,-43.367531752397156,-0.11467291410678451,0.11607365439390804,0.23074656850069256,559091224,555403811.6,66.27669705877642,86.70890759231291,NaN,NaN,11.016378235824194,24.595143300959997
2011-02-28T09:30:00-05:00,26.53999,26.63,26.38,26.56,9253324,9483868.5,53.14292438209674,60.04471096810083,NaN,NaN,-19.950081546972996,-65.55072607100294,-0.09712484726614215,0.10934050941801488,0.20646535668415703,568344548,554166705.4,64.80373848546513,85.00765833552578,NaN,NaN,10.137082065880813,22.52970598166297
2011-03-01T09:30:00-05:00,26.61,26.66,26.0311,26.05,14553164,9512202.1,43.41270738078501,58.11500096090367,NaN,NaN,-96.40259512538582,-78.98772342295872,-0.11546392774121553,0.06213544700763762,0.17759937474885315,553791384,554488326.4,65.02138632789496,83.22513303601656,NaN,NaN,5.765587047513067,20.134831848212986
2011-03-02T09:30:00-05:00,26.09,26.4064,26.06,26.21001,9927223,9389930.25,46.709477658835915,56.54510610769221,NaN,NaN,-97.65169968214265,-74.29400417049146,-0.11231337342006073,0.03720765797377723,0.14952103139383796,563718607,559246651.4,68.15860179465817,81.6097059548608,NaN,NaN,3.4941029276213778,17.757584859557042
2011-03-03T09:30:00-05:00,26.46001,26.64,26.45,26.63,9558402,9430465.95,54.244575073580066,55.79482018841599,NaN,NaN,-12.945728203846972,-53.67455287742263,-0.07901138845959624,0.05075679581934267,0.1297681842789389,573277009,563644554.4,70.76819942814133,80.162526711557,NaN,NaN,4.320369421245494,15.837982654083964
2011-03-04T09:30:00-05:00,26.63,26.63,26.25999,26.41499,13935371,9554012.45,50.32174932868175,54.59227458931586,NaN,NaN,-47.79807152039977,-54.949635215749666,-0.06890094957279713,0.04364199731294249,0.11254294688573963,559341638,563694637.2,70.79755079530823,78.68937909184112,NaN,NaN,3.5841790872561905,14.087439287394282
2011-03-07T09:30:00-05:00,26.53,26.53,25.92,26.08,14859070,9918586.05,44.87648009295709,52.95621794208446,NaN,NaN,-99.21212730303806,-70.80204436696268,-0.08135633248675492,0.010847531277295985,0.0922038637640509,544482568,558922241.2,64.18403577040404,76.7232318949541,NaN,NaN,1.0202059597733693,12.220691669162724
2011-03-08T09:30:00-05:00,26.10001,26.40849,26,26.2975,10990797,9978209.9,48.75384782360913,51.84757346258784,NaN,NaN,-77.46178537821972,-67.01388241752946,-0.07185855495786406,0.0023806700667208247,0.07423922502458488,555473365,559258637.4,64.4362219563846,74.783361799625,NaN,NaN,0.3266982745131263,10.521549755641352
2011-03-09T09:30:00-05:00,26.22,26.2912,26.03,26.19,11913746,10314470.05,46.99438573452636,50.419486985863884,NaN,NaN,-83.97418898613228,-64.27838027832738,-0.06967581151768679,-0.012855539372523594,0.056820272145163185,543559619,555226839.8,59.06801391270044,72.43605534970918,NaN,NaN,-0.8002006487352396,8.90415684073041
2011-03-10T09:30:00-05:00,25.89,25.91,25.66,25.7,15018777,10805954.2,39.92214295747154,48.41956076542255,NaN,NaN,-158.1250781821485,-93.31425027398767,-0.09644386388834204,-0.06373455771526437,0.03270930617307767,528540842,546279606.4,49.26023858600664,69.33732328203378,NaN,NaN,-4.2863568731852375,7.019797738742461
2011-03-11T09:30:00-05:00,25.56,25.89999,25.56,25.8,11415684,10984810.45,41.84559946283606,46.667030935662524,NaN,NaN,-139.46587292766375,-111.64781055544047,-0.10208225193892063,-0.09489350875057312,0.007188743188347516,539956526,542402584,45.71783512016291,65.9724902624666,NaN,NaN,-6.368501914090759,5.10718350262343
2011-03-14T09:30:00-04:00,25.67,25.845,25.53,25.67999,9655340,10830088.8,40.18290891062113,46.15772604277351,NaN,NaN,-136.35677054807346,-119.07673920444753,-0.10798926023992693,-0.12779783211156115,-0.019808571871634217,530301186,539566307.6,43.26657737399104,62.931960324109205,NaN,NaN,-8.569836869103499,3.153323449519583
2011-03-15T09:30:00-04:00,24.92999,25.42999,24.87,25.3,14937469,11279874.95,35.38822646979514,45.73468536694628,NaN,NaN,-202.1208450367139,-144.0085511361464,-0.13010016624510684,-0.18243377967801777,-0.05233361343291093,515363717,531544378,37.19257992256978,60.03909924030482,NaN,NaN,-12.078956339566076,0.9772834796502035
2011-03-16T09:30:00-04:00,25.16,25.25,24.52,24.6825,21457056,12050609.2,29.27506553472901,44.715055249723704,NaN,NaN,-228.1750136923112,-172.8487160773822,-0.17606907991816717,-0.2724199633306199,-0.09635088341245274,493906661,521613786.4,31.329151185800825,57.16291626559031,NaN,NaN,-17.459331408304244,-1.656518647200432
2011-03-17T09:30:00-04:00,25.02,25.17999,24.89999,24.94,10960305,12259297.9,34.36668922207896,43.531198573757415,NaN,NaN,-164.86505484040921,-174.19671140903432,-0.17834021128756414,-0.3192761475219079,-0.14093593623434378,504866966,516879011.2,28.983041908350714,54.49908375484562,NaN,NaN,-19.98646834498082,-4.275082889740487
2011-03-18T09:30:00-04:00,25.19,25.2,24.87,24.89999,18482544,12850980.75,33.95761982770969,42.16081967701548,NaN,NaN,-141.2837638209946,-174.56028958770048,-0.1716832825628546,-0.355540039437912,-0.18385675687505743,486384422,506164590.4,24.510052515737158,51.620963328436474,NaN,NaN,-22.06428565692027,-6.81639757076617
2011-03-21T09:30:00-04:00,25.3,25.47,25.25999,25.32249,8929770,12980769.05,41.831519177774815,42.04787766251475,NaN,NaN,-78.95093332470007,-163.0791221430258,-0.12987177731900051,-0.3461964785238081,-0.21632470120480757,495314192,499167191.6,22.11012705910015,48.55587338066541,NaN,NaN,-21.206965464722686,-8.87219298418853
2011-03-22T09:30:00-04:00,25.36,25.38,25.25,25.28,9204184,12323638.25,41.29825362521585,41.661361660113315,NaN,NaN,-76.14578423734466,-137.88410998315194,-0.09759646421309517,-0.33832028147117654,-0.24072381725808137,486110008,493316449.8,20.31866478888122,45.13873502310991,NaN,NaN,-20.703290681743734,-10.562349798124988
2011-03-23T09:30:00-04:00,25.22,25.485,25.11,25.42,5835680,12002607.4,43.83866083368995,40.91808207154974,NaN,NaN,-64.20050105583506,-105.08920745585672,-0.061121649284190005,-0.3171258788633189,-0.2560042295791289,491945688,492924255.2,20.200509244343678,41.52675715283865,NaN,NaN,-19.508564913796967,-11.84038052893527
2011-03-24T09:30:00-04:00,25.62,25.85001,25.5,25.8175,10413266,11955245.1,50.401805307429925,40.92380035574604,NaN,NaN,-10.029497219813523,-74.12209593173756,-0.007354381005439614,-0.26519720583592843,-0.2578428248304888,502358954,492422652.8,20.040000261420815,37.90121782898955,NaN,NaN,-16.34359904036396,-12.48369745913937
2011-03-25T09:30:00-04:00,25.89999,26.02,25.85001,25.88,6250172,11877567.2,51.364210695055355,41.38720968446734,NaN,NaN,21.238637262792125,-41.617615714980204,0.03307073771616614,-0.21650440268528115,-0.2495751404014473,508609126,496867593.6,25.675833465625914,35.15063195007683,NaN,NaN,-13.51294671856327,-12.630733067628498
2011-03-28T09:30:00-04:00,25.98,26.03999,25.8,25.82001,8270766,11828439.3,50.35423321214587,41.50152292650568,NaN,NaN,23.124742076241194,-21.20248063479196,0.05512170351121051,-0.18067301101243416,-0.23579471452364467,500338360,497872427.2,26.929665307744486,32.47159218945968,NaN,NaN,-11.493403158836593,-12.46825736637251
2011-03-29T09:30:00-04:00,25.78999,26.00999,25.67,26,5157457,11358653.95,53.31999435609714,41.95335211376074,NaN,NaN,27.99790967894414,-0.37374185153420286,0.07968948760459588,-0.13618285501789984,-0.21587234262249572,505495817,501749589,31.716304824950456,30.51789868319182,NaN,NaN,-8.901881648835982,-11.958775121010149
2011-03-30T09:30:00-04:00,26.14999,26.17,26.05,26.11,6232309,11173908.25,55.08589274930361,43.0364770988916,NaN,NaN,65.05263986493009,25.47688633261882,0.09989865405762183,-0.09099902505046842,-0.19089767910809025,511728126,505706076.6,36.30190944589557,29.59230374461246,NaN,NaN,-6.219327029439879,-11.138853965071538
2011-03-31T09:30:00-04:00,26.07001,26.14999,26.02,26.0625,6217289,11006852.6,54.13356368774838,43.91418882924247,NaN,NaN,67.07450257639917,40.89768629186136,0.1060375542232975,-0.05835073632896837,-0.16438829055226586,505510837,506336453.2,37.027522899644055,28.97156715743255,NaN,NaN,-4.244469656622762,-10.153941921007428
2011-04-01T09:30:00-04:00,26.17999,26.24001,25.92999,26.00999,10984137,10859290.9,53.04187550482639,44.83268644311428,NaN,NaN,69.79219531979159,50.608397903261256,0.10247426524468489,-0.036295458996409735,-0.13876972424109463,494526700,503519968,35.103453088335556,28.388486851314294,NaN,NaN,-2.866082260342778,-9.11281911234105
2011-04-04T09:30:00-04:00,26.07001,26.08,25.82001,25.92,5871602,10409917.5,51.138532040619,45.957708269601696,NaN,NaN,51.46138825146518,56.275727138306046,0.0903911799505956,-0.025780749302850126,-0.11617192925344573,488655098,501183315.6,33.546023110924395,28.128018507625338,NaN,NaN,-2.174256462759751,-8.121595876686579
2011-04-05T09:30:00-04:00,25.91,26.07001,25.85001,25.88,9920371,10356396.2,50.27495633088051,47.4577004693268,NaN,NaN,54.61104812566527,61.59835482765028,0.07658569191019528,-0.020439814365701636,-0.09702550627589691,478734727,495831097.6,30.236849211401932,28.04999693802542,NaN,NaN,-1.8051812012870003,-7.219250923058068
2011-04-06T09:30:00-04:00,26.06,26.11,25.92,26.07001,10946566,10308037.2,54.22901886057406,48.87643830064788,NaN,NaN,75.92753078339115,63.773333011342494,0.07692848826360912,-0.0008648959463855022,-0.07779338420999463,489681293,491421731,27.80349651628444,27.96574369573497,NaN,NaN,-0.4286000911633458,-6.249157947073107
2011-04-07T09:30:00-04:00,26.03999,26.17,25.87,26.08,9169426,10015569.65,54.43417349196855,50.33904927666638,NaN,NaN,72.41110776206608,64.84065404847587,0.07445739379971131,0.015278358039644502,-0.0591790357600668,498850719,490089707.4,27.094140430409865,28.150321403925883,NaN,NaN,0.7818594709776565,-5.24472688735157
2011-04-08T09:30:00-04:00,26.17999,26.17999,25.84,25.92999,6369168,9763243.85,50.75532325846915,50.97646385385883,NaN,NaN,58.3402826122338,62.550271506964314,0.059971616268259365,0.015785484575257414,-0.04418613169300195,492481551,489680677.6,26.867457319012956,28.490130708205367,NaN,NaN,0.9127550632924584,-4.365086608688138
2011-04-11T09:30:00-04:00,25.97,26.03,25.81,25.89,5796922,9570322.95,49.789289550410984,51.58296641994419,NaN,NaN,41.96137075611077,60.65026800789343,0.045599168476700536,0.012812828902873719,-0.03278633957382682,486684629,489286583.8,26.63622644436761,28.941385112168685,NaN,NaN,0.778655428392578,-3.630266317676607
2011-04-12T09:30:00-04:00,25.74001,25.81,25.5901,25.67999,8064578,9226678.4,44.950683778452536,51.662396630284384,NaN,NaN,-1.3658956989726458,49.454879242965845,0.021096972102115964,-0.0064151244461818635,-0.027512096548297827,478620051,489263648.6,26.621866744193753,29.400053505015116,NaN,NaN,-0.6447813350173541,-3.2037684630109995
2011-04-13T09:30:00-04:00,25.81,25.94,25.7,25.84,7224883,8515069.75,49.01613625165544,51.56342026915764,NaN,NaN,17.745037936880063,37.81838067366361,0.015095818882367808,-0.008642322945338066,-0.023738141827705873,485844934,488496376.8,26.11465608376342,29.833957492325304,NaN,NaN,-0.8040147783620012,-2.8609465080611427
2011-04-14T09:30:00-04:00,25.71001,25.82001,25.5681,25.78999,5508043,8242456.65,47.82728611943711,51.31078279947062,NaN,NaN,-16.989623477679643,19.938234425714466,0.0075679592757232975,-0.014278192733051753,-0.02184615200877505,480336891,484793611.2,23.76182214730214,29.69724239815932,NaN,NaN,-1.25737190617022,-2.6318644220767253
2011-04-15T09:30:00-04:00,25.72,25.8,25.59,25.74001,10205914,7828625.15,46.610550154038485,51.04337686674866,NaN,NaN,-39.25572247073391,0.4190334091209252,-0.000537521857346495,-0.02251805433045817,-0.021980532473111675,470130977,480323496.4,21.270336112335272,29.293004598487233,NaN,NaN,-1.9642876574466654,-2.53649631284386
2011-04-18T09:30:00-04:00,25.47,25.52,25.2,25.50999,8842152,7824244.25,41.39156047809189,50.19134587546257,NaN,NaN,-147.69668396865777,-37.512577535832776,-0.02006864933080997,-0.04706634413662414,-0.026997694805814168,461288825,475244335.6,18.851617707176786,28.374098375789114,NaN,NaN,-4.080346814896842,-2.7570463845657143
2011-04-19T09:30:00-04:00,25.53999,25.58,25.42101,25.58,9971055,7862587.8,43.46641613146744,49.36138325990284,NaN,NaN,-118.64537100174877,-60.968472596388004,-0.02654434241655411,-0.06017812282650681,-0.0336337804099527,471259880,473772301.4,18.205481974713905,27.081496413561847,NaN,NaN,-5.31634791652614,-3.122660889131489
2011-04-20T09:30:00-04:00,25.96001,26.16,25.94,26.119,9284324,8035020,56.294851747608,49.51576097846424,NaN,NaN,88.61247809603177,-46.79498456455766,0.005492670457839931,-0.026767942337652784,-0.032260612795492714,480544204,472712155.4,17.734053710744462,25.703391471497593,NaN,NaN,-2.408863289731431,-3.0206898035029095
2011-04-21T09:30:00-04:00,26.36,26.37,26.22,26.35001,10249930,8026853.2,60.43835963617165,50.04408127356033,NaN,NaN,176.14339185193325,-8.168381498635085,0.0403215469731913,0.018141320920996407,-0.02218022605219489,490794134,474803604,22.023894518399416,24.76913728793073,NaN,NaN,1.4457706543104147,-2.382624023815292
2011-04-25T09:30:00-04:00,26.35001,26.39999,26.28999,26.37,6228762,8025782.7,60.784822313250345,50.73310200731971,NaN,NaN,163.91344292139252,32.4654515797902,0.06151581789181831,0.054714546312577994,-0.006801271579240315,497022896,480181987.8,31.863747308292858,24.648974730599907,NaN,NaN,4.591603170438193,-1.386305853207651
2011-04-26T09:30:00-04:00,26.42999,26.679,26.39,26.59,7188480,7971668.4,64.47241098742256,51.74720591135844,NaN,NaN,196.8910476076771,101.38299789505717,0.08567710741301798,0.10029511268703217,0.014618005274014184,504211376,488766498,44.00870456013755,25.632678684081018,NaN,NaN,8.488051569549453,0.02431663575764942
2011-04-27T09:30:00-04:00,26.64999,26.78999,26.53999,26.75,8029270,8115259.05,66.90951154156227,52.65295538857189,NaN,NaN,199.40789623119306,164.99365134164555,0.10640715670472108,0.14762695115491553,0.041219794450194455,512240646,496962651.2,52.680974162468736,27.409641373094185,NaN,NaN,12.53558300293809,1.8116404024977122
2011-04-28T09:30:00-04:00,26.69,26.78999,26.64,26.75999,8496277,8228457.45,67.0614411765711,53.55490308032922,NaN,NaN,177.36994736062408,182.74514519456403,0.11408405647271845,0.18382486504109252,0.06974080856837407,520736923,505001195,59.33369061674675,29.712466386403964,NaN,NaN,15.813634237494828,3.8119252360687286
2011-04-29T09:30:00-04:00,26.74001,26.78999,26.66,26.74001,7497707,8292478.35,66.40476203722957,54.67272013595497,NaN,NaN,147.84806309151404,177.08607944248018,0.11100442320332488,0.20849633757253017,0.09749191436920529,513239216,509490211.4,62.50403369423758,32.25793612749144,NaN,NaN,18.311063289154564,5.883230672223847
2011-05-02T09:30:00-04:00,26.86,26.89,26.61,26.64,6708078,8078675.4,63.07531294646465,55.62172180710166,NaN,NaN,120.46678684193043,168.39674822658776,0.0959839137099086,0.21747180650659104,0.12148789279668244,506531138,511391859.8,63.791814582939516,34.911906708818,NaN,NaN,19.523590659451855,7.831853527542134
2011-05-03T09:30:00-04:00,26.64,26.7,26.48,26.64999,8164375,8193314.05,63.27340205563284,56.930487398328815,NaN,NaN,87.5020882361356,146.51895635227945,0.0810676705253972,0.22282248095342894,0.14175481042803173,514695513,513488687.2,65.21061504227563,37.6682458729667,NaN,NaN,20.581235708324375,9.653193839082455
2011-05-04T09:30:00-04:00,26.66,26.71001,26.39,26.57001,10963988,8245494.9,60.476169056328864,57.7490611700912,NaN,NaN,69.3627316754621,120.50992344113327,0.06107226872588373,0.2180951463353864,0.15702287760950268,503731525,511786863,63.05115918597401,40.306567523124606,NaN,NaN,20.749419116723995,11.238368878745533
2011-05-05T09:30:00-04:00,26.5,26.7,26.34,26.42999,13436164,8369974.8,55.82334460465871,58.320208204749896,NaN,NaN,52.33621055890234,95.50317608078892,0.034970732119615044,0.2007362927590215,0.16576556063940645,490295361,505698550.6,55.91708713782968,42.60337216530514,NaN,NaN,19.6162774780891,12.435212964366041
2011-05-06T09:30:00-04:00,26.66,26.8,26.455,26.48,10697441,8446375.55,57.09307424608895,59.068959925610635,NaN,NaN,61.21409129684958,78.17638172185603,0.018457839474527976,0.18883785998256641,0.17038002050803844,500992802,503249267.8,53.304131853926535,44.891500432561664,NaN,NaN,18.98833927026107,13.371373865208188
2011-05-09T09:30:00-04:00,26.53999,26.67999,26.44,26.59,3981139,8326974.1,59.82809936612521,60.38585556047017,NaN,NaN,54.84777978743819,65.0525803109576,0.012606908722741506,0.18613865641146532,0.17353174768872381,504973941,502937828.4,52.96521165348179,47.328185714440586,NaN,NaN,19.17042043083845,14.199809088869655
2011-05-10T09:30:00-04:00,26.64999,26.86,26.61,26.83,13603945,8717325.25,65.06105389960214,61.9283296867655,NaN,NaN,80.86322181800016,63.72480702733047,0.022012967188567323,0.20104795667443298,0.17903498948586566,518577886,503714303,53.7546943525911,49.86741517000325,NaN,NaN,20.863504963477624,15.15176564238508
2011-05-11T09:30:00-04:00,26.82001,26.88,26.44,26.59,11849316,8906562.15,57.056867568507805,61.98275938825834,NaN,NaN,55.36187973512734,60.92463663926352,0.009806079153973496,0.19129258842833252,0.18148650927435903,506728570,504313712,54.39112845032373,52.48577765140176,NaN,NaN,19.907374286904776,15.831138305887894
2011-05-12T09:30:00-04:00,26.52,26.8201,26.3709,26.78999,10984078,9094521.9,61.32650715020673,62.046198496403704,NaN,NaN,55.64657049200861,61.586708625884775,0.012749304072143391,0.19742313936453826,0.18467383529239487,517712648,509797169.4,59.83656312328471,55.186682551750714,NaN,NaN,20.423206878552186,16.487148101982793
2011-05-13T09:30:00-04:00,26.6902,26.72,26.43291,26.46001,10207688,9329504.15,52.11872024245965,61.427191205632944,NaN,NaN,27.51686154950465,54.84726267641578,-0.008816467967356412,0.17365325033319934,0.18246971830055575,507504960,511099601,61.02680272279047,57.26975793850055,NaN,NaN,17.734643437413276,16.665361721330004
2011-05-16T09:30:00-04:00,26.34,26.46989,26.03,26.08,16969840,9667700.45,43.93723989224886,59.960393270263395,NaN,NaN,-58.784325380759455,32.120841642776256,-0.0477861942826078,0.122736975447296,0.1705231697299038,490535120,508211836.8,56.99385106784754,58.19726840333698,NaN,NaN,12.351900743778268,16.049153010251185
2011-05-17T09:30:00-04:00,25.92999,26.09,25.78999,26.08,55192592,11985222.45,43.937239892248876,58.31951672388387,NaN,NaN,-136.1700422804904,-11.285811176921854,-0.07126125968913447,0.08144659511848573,0.1527078548076202,490535120,502603283.6,50.07271569716144,58.0109642272436,NaN,NaN,8.29018732180891,14.940729340473718
2011-05-18T09:30:00-04:00,26.10001,26.31,26.05,26.27,11963563,12084847.85,48.6146496054419,57.001888754517495,NaN,NaN,-102.87927958237375,-42.934043040422075,-0.07150619514936277,0.06332511087091675,0.1348313060202795,502498683,501757306.2,49.10408207813329,57.28027790305692,NaN,NaN,6.440563006345154,13.726419864169637
2011-05-19T09:30:00-04:00,26.37,26.38,26.16,26.32001,8182188,12029741.05,49.8018034132009,55.81596313851545,NaN,NaN,-85.66984540593364,-71.19732622001052,-0.06594895295496743,0.05239511482657022,0.11834406778153765,510680871,500350950.8,47.460425701475636,56.205734475002494,NaN,NaN,5.344057213226185,12.528939485463429
2011-05-20T09:30:00-04:00,26.28999,26.36,26.11,26.16901,13458309,12190160,46.32196246722786,54.619295247141395,NaN,NaN,-108.10195511088388,-98.32108955208824,-0.06972401563235339,0.031189048241095918,0.10091306387344931,497222562,498294471.2,45.08397070249739,54.86945991211377,NaN,NaN,3.329085165027565,11.21467458254402
2011-05-23T09:30:00-04:00,25.81,25.89999,25.7,25.8,12608672,12509155.5,39.12688506155653,52.894544033278805,NaN,NaN,-208.08882340401647,-128.18198915673963,-0.09290446493658092,-0.015217517297276828,0.07768694763930409,484613890,497110225.2,43.72615308124582,53.33485548632593,NaN,NaN,-0.9472852325445502,9.477251751817082
2011-05-24T09:30:00-04:00,25.86,25.87,25.71001,25.72,8765691,12588016.05,37.75761349022902,51.27179006427167,NaN,NaN,-171.81184387749084,-135.31034947613972,-0.1083769860891268,-0.057784284972104416,0.05059270111702238,475848199,494172841,40.4703387355685,51.72193973986839,NaN,NaN,-4.8003845068316755,7.437589429152974
2011-05-25T09:30:00-04:00,25.67999,25.92999,25.64,25.8,12413047,12807204.9,40.018186772945114,50.142850219149274,NaN,NaN,-138.99314603494287,-142.53312276665355,-0.10774939279309892,-0.08409403987435127,0.023655352918747652,488261246,491325353.6,37.55136722975934,50.41010260357765,NaN,NaN,-7.226418312384156,5.342731180361955
2011-05-26T09:30:00-04:00,25.75999,26.02,25.75,25.97,11218895,12943335.8,44.620977777248044,49.251986185660634,NaN,NaN,-97.31712879595142,-144.86257944465711,-0.09107428674415372,-0.0901875055114445,0.0008867812327092196,499480141,489085207.6,35.38885428823758,49.13043992031415,NaN,NaN,-7.856684869837499,3.4571003160477476
2011-05-27T09:30:00-04:00,25.99001,26.10001,25.96001,26.10001,12554523,13196176.6,47.9128629158945,48.40089786778701,NaN,NaN,-59.43279845689483,-135.1287481138593,-0.06755953886120458,-0.08356264234379651,-0.016003103482591926,512034664,492047628,40.286220391206086,48.22479768729446,NaN,NaN,-7.368165241984534,1.9106338077574216
2011-05-31T09:30:00-04:00,26.32001,26.46001,26.19,26.46001,10672707,13394408.05,55.75560720043452,47.736223103560754,NaN,NaN,16.906570800865527,-90.12966927288288,-0.026159111566506167,-0.04870199294072464,-0.02254288137421847,522707371,499666324.2,50.646899442819056,48.00281233659645,NaN,NaN,-4.30720489573321,1.0223711358301886
2011-06-01T09:30:00-04:00,26.39,26.48,25.89,25.91,16627414,13817560,44.68539518061838,46.852546504425796,NaN,NaN,-44.24470384411774,-64.61624126620828,-0.03373365607347061,-0.06470995146605674,-0.030976295392586124,506079957,505712675.8,57.0203415451469,48.19061327194096,NaN,NaN,-5.52202489892767,0.08745741657906592
2011-06-02T09:30:00-04:00,25.94,26.03,25.81,25.92999,10404840,13789602.6,45.11194729983438,45.694363657970634,NaN,NaN,-78.13573673018269,-52.44475940525624,-0.03515473976157301,-0.07491972009455239,-0.03976498033297938,516484797,511357386,61.95935702408302,48.34224140771227,NaN,NaN,-6.291875208892253,-0.8238758156311224
2011-06-03T09:30:00-04:00,25.63,25.7885,25.50999,25.53999,10777246,13656656.7,38.82200392927051,44.74459820702855,NaN,NaN,-136.99080784362752,-60.37949521479145,-0.05872893709121438,-0.11317615169699735,-0.05444721460578297,505707551,512602868,62.97048457652572,48.48107582583622,NaN,NaN,-9.196702212076351,-2.0199938722661552
2011-06-06T09:30:00-04:00,25.52,25.60001,25.33,25.35001,8436723,13543620.8,36.17592516468929,44.19021858363144,NaN,NaN,-156.59447500037356,-79.8118305234872,-0.08205381425162599,-0.15701448242031546,-0.07496066816868947,497270828,509650100.8,58.96867946909396,48.622134997353825,NaN,NaN,-12.448233528423891,-3.509742394574403
2011-06-07T09:30:00-04:00,25.42999,25.49001,25.25999,25.27,8807789,13784953.3,35.09114089944627,43.55835436985983,NaN,NaN,-155.05857183272815,-114.20485905020594,-0.09679464802632912,-0.19595397820160088,-0.09915933017527176,488463039,502801234.4,50.89023851331754,48.68052948422212,NaN,NaN,-15.359649082013071,-5.202586207065641
2011-06-08T09:30:00-04:00,25.17,25.2354,25.03,25.10001,9993516,13604431.85,32.83811717153323,42.4314591960092,NaN,NaN,-177.48897551718156,-140.8537133848187,-0.11090412965080285,-0.23778949223877532,-0.12688536258797248,478469523,497279147.6,45.48022917367549,48.42168284818943,NaN,NaN,-18.48889942357727,-7.100630952281588
2011-06-09T09:30:00-04:00,25.11,25.22,25.03999,25.12,5333445,13278638.3,33.379804013967274,41.25845923892109,NaN,NaN,-156.10323761804244,-156.44721356239066,-0.1115013969201138,-0.26626210873811473,-0.15476071181800094,483802968,490742781.8,40.05257933893684,47.89255096515094,NaN,NaN,-20.804219021195212,-9.05828639069782
2011-06-10T09:30:00-04:00,25.03,25.06,24.75,24.77,10907102,13274789.5,28.973571679334142,40.01928846835725,NaN,NaN,-178.0467310513983,-164.6583982039448,-0.12695592346740522,-0.3134556161522575,-0.18649969268485225,472895866,484180444.8,35.47516276957758,47.20620754137095,NaN,NaN,-24.301412824558795,-11.235875881249388
2011-06-13T09:30:00-04:00,24.78999,24.91,24.7,24.78999,11664805,13347645.35,29.545604747604187,39.33491130307494,NaN,NaN,-160.49896031053436,-165.43929526597694,-0.12701128481217186,-0.34526379870006707,-0.2182525138878952,484560671,481638413.4,33.860824501973795,46.501541214280095,NaN,NaN,-26.90392283560091,-13.474168303299605
2011-06-14T09:30:00-04:00,25.00999,25.17,24.98,25.10001,9117660,12955036.35,37.89897156794549,39.34500830862612,NaN,NaN,-97.51706406504485,-153.93099371244028,-0.0986133241593608,-0.34151916908709623,-0.24290584492773543,493678331,482681471.8,35.164576227541076,46.12255817799242,NaN,NaN,-26.585255921100487,-15.347180820128301
2011-06-15T09:30:00-04:00,24.86,24.98,24.58,24.63,16561637,11023488.6,31.752410134888407,38.75459569162207,NaN,NaN,-131.77748352520513,-144.78869531404501,-0.10342497312825416,-0.3721870613380531,-0.26876208820979897,477116694,482410906,34.971998732990826,45.93831757108039,NaN,NaN,-28.377883611718946,-17.208709790355535
2011-06-16T09:30:00-04:00,24.61,24.745,24.39,24.57001,9227840,10886702.45,31.060001116553224,37.78595450157245,NaN,NaN,-134.41519894992283,-140.45108758042107,-0.10239728248815128,-0.3967586913199881,-0.2943614088318368,467888854,479228083.2,32.70310880541487,45.74647860802162,NaN,NaN,-30.005233284433714,-19.036784575223844
2011-06-17T09:30:00-04:00,24.73,24.75,24.38499,24.44501,19947904,11474988.25,29.6110438664125,36.47868171232373,NaN,NaN,-124.49963029440839,-129.7416674290231,-0.10167888235463024,-0.4214600117751246,-0.31978112942049436,447940950,474237100,29.473948371664378,44.974173463768636,NaN,NaN,-31.78687993211487,-20.85822676906542
2011-06-20T09:30:00-04:00,24.35001,24.61,24.34,24.5425,8727055,11238425.55,32.26504846150871,34.80078465954331,NaN,NaN,-115.26139027917814,-120.69415342275184,-0.08676146047757832,-0.4282329550174673,-0.34147149453988895,456668005,468658566.8,26.34294518998726,43.2381767314235,NaN,NaN,-32.443886332733136,-22.513320992446523
2011-06-21T09:30:00-04:00,24.67,25.03,24.56,24.98,14340840,11325033.95,42.70536717593167,34.65935408777998,NaN,NaN,-61.45252132801078,-113.48124487534503,-0.041829971963997126,-0.3937589594948854,-0.35192898753088825,471008845,464124669.6,24.101984098320358,40.88686548522161,NaN,NaN,-29.612641236561533,-23.52750959874867
2011-06-22T09:30:00-04:00,24.84,24.99001,24.78,24.8,11135258,11443512.3,39.9753090522668,34.29245135581086,NaN,NaN,-55.833317164590746,-98.29241160322216,-0.019753699265352476,-0.37662111161257883,-0.35686741234722635,459873587,460676048.2,22.53188843688109,38.0706177289929,NaN,NaN,-28.14556044304995,-24.187231147934565
2011-06-23T09:30:00-04:00,24.5,24.99001,24.44,24.97,12577914,11451755.65,43.63987451481732,34.6365849690642,NaN,NaN,-58.13154445521869,-83.03568070428132,0.009221297257996086,-0.34534079077473123,-0.3545620880327273,472451501,461588577.6,23.94375683471894,35.28299431886384,NaN,NaN,-25.763286386900592,-24.412381896358283
2011-06-24T09:30:00-04:00,24.89,24.89999,24.50999,24.53999,11760508,11478836.3,37.41718686813272,34.72524651931017,NaN,NaN,-73.57067967865312,-72.84989058113028,0.002689109358548991,-0.35120070133454107,-0.35388981069309006,460690993,464138586.2,27.898299095714876,33.06368143505105,NaN,NaN,-25.706226573195924,-24.597216850192233
2011-06-27T09:30:00-04:00,24.59,25,24.52,24.87,11981352,11450177.75,44.014991959152916,35.362664452146355,NaN,NaN,-48.48724812059581,-59.49506214941381,0.022740706065505323,-0.3254639281112084,-0.3482046341767137,472672345,467339454.2,32.63327312789818,31.759612478949666,NaN,NaN,-23.39448668160102,-24.4253982546792
2011-06-28T09:30:00-04:00,24.94,25.19,24.92,25.17999,8059332,11319509,49.410249782456745,36.54638821006946,NaN,NaN,11.171775703413777,-44.970202743128894,0.057073905818472714,-0.2768622519036228,-0.3339361577220955,480731677,469284020.6,35.40843055628251,31.04019829199303,NaN,NaN,-19.59853301851533,-23.735846078084364
2011-06-29T09:30:00-04:00,25.27,25.38,25.12,25.38,8282730,10902274.8,52.58524227785148,37.91820522891834,NaN,NaN,64.70021886828408,-20.863495536553952,0.09140998497318203,-0.21967367650561798,-0.3110836614788,489014407,475112184.6,42.98888716480068,31.24993456526902,NaN,NaN,-15.45417282251432,-22.552749898717217
2011-06-30T09:30:00-04:00,25.49001,25.73,25.46001,25.7,9098473,10836956.45,57.21208026228814,39.935241556272196,NaN,NaN,149.7086805925383,20.704549472997442,0.13139705450954248,-0.14683734334187193,-0.2782343978514144,498112880,480244460.4,48.698569071464,32.194463586832335,NaN,NaN,-10.386313591094245,-20.814687569056794
2011-07-01T09:30:00-04:00,25.73,26.16,25.64999,26.12,11451520,10870670.15,62.398418780246104,42.281871130032336,NaN,NaN,211.11480554592598,77.64164651791326,0.17891215299429253,-0.054594206608548745,-0.23350635960284127,509564400,490019141.8,57.44081476995485,33.87874860597384,NaN,NaN,-4.219331071102007,-18.443922355063254
2011-07-05T09:30:00-04:00,26.10001,26.2,26.03999,26.16,8155996,10856633.8,62.860135274677326,44.064811394798895,NaN,NaN,210.77937151152386,129.49497044433718,0.2039963649665987,0.0214890966054071,-0.1825072683611916,517720396,499028752,63.59829867691231,35.90972878092894,NaN,NaN,0.6948728691783614,-15.709808751600166
2011-07-06T09:30:00-04:00,26.14999,26.3288,26.05,26.28,6758555,10754172.1,64.27729737016207,46.38801762588987,NaN,NaN,192.10456847519848,165.68152899869415,0.21834684011554045,0.09042628178323397,-0.12792055833230648,524478951,507778206.8,68.38238264131355,38.29618477438056,NaN,NaN,5.119265454598968,-12.734226722143147
2011-07-07T09:30:00-04:00,26.45,26.66,26.42999,26.60001,13009129,10904952.75,67.80531229800381,49.0126827102792,NaN,NaN,191.9769777561663,191.13688077627057,0.23748385567481045,0.1689342612612066,-0.06854959441360386,537488080,517472941.4,72.66863766324663,41.15086540708283,NaN,NaN,10.07571819039647,-9.475663163208916
2011-07-08T09:30:00-04:00,26.35001,26.47,26.2,26.47,11954160,11235988.5,64.996802212402,51.540236877849885,NaN,NaN,136.51409878637028,188.49796441503696,0.22935728923818904,0.21814701713413243,-0.011210272104056604,525533920,522957149.4,74.75365671539859,44.385130288778136,NaN,NaN,13.259392594672043,-6.227798054940208
2011-07-11T09:30:00-04:00,26.17999,26.31,25.94,26.03,11690684,11275167.6,56.47162946270914,53.26927837793563,NaN,NaN,89.60960243127195,164.1969237921062,0.1842628565678025,0.21911829860569654,0.03485544203789403,513843236,523812916.6,75.07320870628962,47.86586339708545,NaN,NaN,13.32545983814099,-3.434475498785751
2011-07-12T09:30:00-04:00,25.95,26.03999,25.77,25.8,9430816,11163468.15,52.58866690704303,53.9752283587293,NaN,NaN,57.78299990113191,133.59764947002776,0.13134334328331693,0.19903462114204018,0.06769127785872325,504412420,521151321.4,72.01992769530948,51.28857365401324,NaN,NaN,12.12241108448467,-1.2120631297471194
2011-07-13T09:30:00-04:00,25.92999,26.13,25.78,25.86,5580512,10986610.75,53.48715816476709,54.9403604381936,NaN,NaN,57.03343008830851,106.58342179264977,0.09450111385839458,0.18581767018171647,0.09131655632332189,509992932,518254117.6,68.74253078461359,54.58933382170842,NaN,NaN,11.432525607997725,0.5943066899307152
2011-07-14T09:30:00-04:00,25.91,26.08,25.53999,25.64,10751711,10696114.45,49.76326933341853,55.37774578237941,NaN,NaN,34.81987911519979,75.1520020644565,0.051582812010211865,0.15579507133608672,0.10421225932587486,499241221,510604745.8,60.86684216192059,57.226697059365684,NaN,NaN,9.703896607359738,1.8956766781348613
2011-07-15T09:30:00-04:00,25.89,25.95,25.73,25.92,14237898,10946617.35,54.13955333305826,56.57220052987408,NaN,NaN,41.743655938825015,56.19791349494744,0.038897258228358655,0.15283383211132318,0.11393657388296452,513479119,508193785.6,58.5884726977291,59.41885231665241,NaN,NaN,9.55386317300354,2.9897033202589585
2011-07-18T09:30:00-04:00,25.78999,25.92999,25.60001,25.83,8380676,10368255.95,52.5547858141971,57.18218580523438,NaN,NaN,28.06449862616815,43.88889273392668,0.02212481258780094,0.1415925896177157,0.11946777702991476,505098443,506444827,56.92386487469711,61.153894584280906,NaN,NaN,8.95768561128886,3.8422722189775156
2011-07-19T09:30:00-04:00,26.08,26.46001,26.06,26.45,12320809,10547943.65,61.01981808370277,58.01144068389482,NaN,NaN,87.70364361696298,49.87302147709288,0.0489301360093603,0.18063044704161513,0.13170031103225482,517419252,509046193.4,58.798924109369885,62.824644123787145,NaN,NaN,11.18157094594392,4.8907434656870015
2011-07-20T09:30:00-04:00,26.64999,26.64999,26.32001,26.37,5926781,10127240.7,59.54358754603339,58.5084653459078,NaN,NaN,97.71255632150809,58.00884672373279,0.0568600951400382,0.20277542995730258,0.14591533481726437,511492471,509346101.2,59.02039514968606,63.96975183699324,NaN,NaN,12.48575778077978,5.975745510700255
2011-07-21T09:30:00-04:00,26.33,26.61501,26.2,26.49001,11217023,10131328.95,61.06529880733803,58.7836952419828,NaN,NaN,91.585658366418,69.36200257397644,0.06517821533022908,0.22738810398005072,0.16220988864982164,522709494,514039755.8,62.42463136983827,64.95018485830569,NaN,NaN,14.014587808335637,7.124151553219596
2011-07-22T09:30:00-04:00,26.48,26.7686,26.45,26.72,6314941,9818180.3,63.87001467985209,58.8888092348118,NaN,NaN,116.46532356709469,84.30633609963039,0.08017369007691386,0.26242700124596396,0.1822533111690501,529024435,517148819,64.52674445574691,65.45632269300513,NaN,NaN,16.170291340569495,8.416457237126725
2011-07-25T09:30:00-04:00,26.5,26.78999,26.4429,26.64999,5902938,9525301.8,62.396521224268305,58.85569394549687,NaN,NaN,107.4336457240238,100.1801655192015,0.07924028253022947,0.28130366433183696,0.2020633818016075,523121497,520753429.8,66.84277615743505,65.68807108447103,NaN,NaN,17.50293351550206,9.71452527689463
2011-07-26T09:30:00-04:00,26.67,26.88,26.6311,26.77,8329320,9342700.2,63.932581628747755,58.83107139253871,NaN,NaN,123.0585685069133,107.25115049719156,0.08031791876786126,0.3024607802614341,0.22214286149357282,531450817,523559742.8,68.56360847326854,65.70101578675353,NaN,NaN,19.06173503775652,11.049840957017757
2011-07-27T09:30:00-04:00,26.5,26.52,26.00999,26.06,13465633,9613015.25,50.729713729119794,57.61138578047557,NaN,NaN,10.712021355794425,89.85104350404883,0.0294471868880041,0.25895184510357794,0.22950465821557384,517985184,524858285.4,69.35612593120865,65.46440780589367,NaN,NaN,16.236018836635463,11.790723511248858
2011-07-28T09:30:00-04:00,26.02,26.31,25.92999,26.02,10704582,9734107.85,50.10196317378559,56.547468706288676,NaN,NaN,-24.15997624791087,66.70191658118306,-0.008626329233356128,0.21872174667387867,0.2273480759072348,507280602,521772507,65.15271469161698,64.77862623276641,NaN,NaN,13.811292615134146,12.079376240375328
2011-07-29T09:30:00-04:00,25.78,26.09,25.61,25.81,11477418,9853055.1,46.82588204850191,55.85848674813102,NaN,NaN,-90.94476531291905,25.219898805180307,-0.047512263511729796,0.16795774651757256,0.21547001002930236,495803184,515128256.8,57.12472017498315,63.4965913376731,NaN,NaN,10.751721007730605,11.889711207140367
2011-08-01T09:30:00-04:00,26.14,26.2099,25.49001,25.78999,11998871,9880422.65,46.51378185835762,55.42456638751063,NaN,NaN,-88.3265442708096,-13.932139193786378,-0.07263593281292541,0.12467509401314558,0.197311026826071,483804313,507264820,49.37119353610478,61.87882461201563,NaN,NaN,8.200811449273507,11.362725527445102
2011-08-02T09:30:00-04:00,25.64,25.78,25.21001,25.25,21124016,10528823.65,38.96603108886288,54.38734302494605,NaN,NaN,-160.63867295957897,-70.67158748708484,-0.12083501363443347,0.04626725978302915,0.16710227341746262,462680297,493510716,39.31860539723596,59.77711565577436,NaN,NaN,3.371695683234462,10.22114983541501
2011-08-03T09:30:00-04:00,25.27,25.58,24.92,25.50999,21536384,11267715.1,43.702760836057486,53.95444956084883,NaN,NaN,-151.39407442941143,-103.092806644126,-0.129642377750656,0.0050493012291426,0.1346916789797986,484216681,486757015.4,35.496648406147386,57.96495895893342,NaN,NaN,0.8038152633291844,8.875816325117036
2011-08-04T09:30:00-04:00,25.21001,25.25999,24.44,24.48,33695840,12302050.65,32.83189769604691,52.43247415820516,NaN,NaN,-224.81227810660386,-143.2232670158646,-0.19532610916858167,-0.10946595748092847,0.0858601516876532,450520841,475405063.2,30.185384972720854,55.936166978575685,NaN,NaN,-5.870782894288902,6.769159293773331
2011-08-05T09:30:00-04:00,24.64999,24.7601,23.61,24.33,32841776,13346431.45,31.599151940224957,50.935643167207154,NaN,NaN,-251.5242295948977,-175.33915987226032,-0.23661150229861666,-0.20990422618561766,0.026707276112999015,417679065,459780239.4,24.705892866584733,53.63488326371051,NaN,NaN,-11.413761878358496,4.171599126325928
2011-08-08T09:30:00-04:00,23.59,23.98,22.96001,22.96001,44960848,15009939.65,23.076735899949384,48.22542301122477,NaN,NaN,-281.1689382779329,-213.90763867368497,-0.33775786734099555,-0.39549005806324544,-0.057732190722249874,372718217,437563020.2,19.33209078475305,50.815823740523605,NaN,NaN,-20.41248489374727,0.6595871234583282
2011-08-09T09:30:00-04:00,23.22,24.02,22.62,24.00999,41803008,16628549.25,37.08250706378205,46.62106011963539,NaN,NaN,-190.47996272177383,-219.87589662612396,-0.3159150198764296,-0.4526259655677869,-0.13671094569135728,414521225,427931205.8,17.549882659511766,47.85364427693973,NaN,NaN,-21.708278077559175,-2.5358221909727434
2011-08-10T09:30:00-04:00,23.56,23.78999,23.00999,23.07001,34620528,18080550.05,31.545131999394073,44.51247677621082,NaN,NaN,-168.99773934317645,-223.39662960887694,-0.34440451892445323,-0.5672165943469238,-0.2228120754224706,379900697,407068009,14.443767724168083,44.426439730820434,NaN,NaN,-25.157229221010635,-5.767451766692442
2011-08-11T09:30:00-04:00,23.42,24.25999,23.29111,23.95,31596464,19122787.7,40.502445511835745,42.84336469278109,NaN,NaN,-109.15667870059679,-200.26550972767555,-0.2860166898674838,-0.5803329377568254,-0.2943162478893416,411497161,399263273,13.482435082925008,40.780417632761726,NaN,NaN,-23.90908549732519,-8.359113728211407
2011-08-12T09:30:00-04:00,24.25999,24.28999,23.88921,24.121,14585898,19140187.7,42.08822704298484,41.39277225126084,NaN,NaN,-79.86501924355348,-165.9336676574067,-0.22083081670697002,-0.5703547687730541,-0.3495239520660841,426083059,400944071.8,14.79762087960033,37.06290654148781,NaN,NaN,-22.395741892735654,-10.364346323143442
2011-08-15T09:30:00-04:00,24.31,24.58,24.19,24.55,34968096,20469558.7,45.97830506042906,40.110323924952354,NaN,NaN,-51.795460782424236,-120.05897215830495,-0.1378329370222603,-0.5218151233439094,-0.38398218632164915,461051155,418610659.4,27.306048618912797,34.115937980462405,NaN,NaN,-19.766192739987794,-11.707467239835491
2011-08-16T09:30:00-04:00,24.35001,24.547,24.03999,24.37,20233168,20865176.65,44.62386881590048,39.67419214543669,NaN,NaN,-52.84595119192246,-92.5321698523347,-0.0865725308454075,-0.49219784987840853,-0.40562531903300103,440817987,423870011.8,30.573725797654973,31.345766542351434,NaN,NaN,-18.23909097811849,-12.640556345304491
2011-08-17T09:30:00-04:00,24.35001,24.57001,24.00999,24.25999,21578224,21647748.8,43.77512361130597,39.22227503383101,NaN,NaN,-49.43035750279211,-68.61869348425786,-0.053227798801622206,-0.4721600675350288,-0.4189322687334066,419239763,431737825,35.26193552682079,29.21071088772313,NaN,NaN,-17.33237468406787,-13.310816107984973
2011-08-18T09:30:00-04:00,23.57001,23.58,22.85001,23.08,30947696,22634282.45,35.88991200637204,38.441134316536015,NaN,NaN,-108.27748669097289,-68.44285508233307,-0.10102255718473174,-0.5452104652143213,-0.4441879080295895,388292067,427096806.2,33.811521927561145,27.5454824414787,NaN,NaN,-19.312315606622775,-14.168173179218945
2011-08-19T09:30:00-04:00,22.78,23.2,22.47,22.52,37744640,24205767.4,32.864354184265736,37.46617519695803,NaN,NaN,-125.42414607087355,-77.5546804477971,-0.15737193178983172,-0.6409028227668792,-0.48353089097704743,350547427,411989679.8,29.550585755222684,26.129724742844264,NaN,NaN,-21.985477462735883,-15.284930934007079
2011-08-22T09:30:00-04:00,22.98,23.03,22.55,22.64,20322384,24926739.7,34.14549380855162,37.121851105507226,NaN,NaN,-116.53825527474632,-90.5032393462615,-0.1723745529210613,-0.698999082128374,-0.5266245292073127,370869811,393953411,25.430185898332326,25.13769477863686,NaN,NaN,-23.627345787164757,-16.476704484458175
2011-08-23T09:30:00-04:00,22.8,23.49001,22.72,23.47,18570144,25438780.9,42.34126676847996,37.02460152925168,NaN,NaN,-79.9999049430671,-95.93403009649042,-0.11497195001980587,-0.6703394667320701,-0.5553675167122643,389439955,383677804.6,23.42608990405772,24.2755120284876,NaN,NaN,-22.253782237732857,-17.30200130635456
2011-08-24T09:30:00-04:00,23.45,23.74001,23.28,23.67999,22498400,25890419.25,44.232271356523626,37.83891393357145,NaN,NaN,-49.724170701139826,-95.99279273615996,-0.05450184012772907,-0.6234948168719257,-0.5689929767441966,411938355,382217523,23.14691527812424,23.772764193159272,NaN,NaN,-20.55339860294472,-17.766486634438866
2011-08-25T09:30:00-04:00,23.67999,23.7861,23.25999,23.34,20437712,26377075.75,41.83968248044924,38.57038040073032,NaN,NaN,-51.74351803169117,-84.68599900430362,-0.030253237392149246,-0.6068095234843831,-0.5765562860922339,391500643,382859238.2,23.57792331551383,23.69219493951135,NaN,NaN,-19.911060267866233,-18.07285429635706
2011-08-26T09:30:00-04:00,23.25,23.86501,23,23.8,23166592,26961534.45,46.088668187651265,40.21408984985188,NaN,NaN,-37.66511783450075,-67.13419335702906,0.02114372068573922,-0.5501266352350598,-0.571270355920799,414667235,395683199.8,31.80830737501185,24.583353267386975,NaN,NaN,-18.031038221948197,-18.06688057144151
2011-08-29T09:30:00-04:00,24.03999,24.41,24.03,24.39999,19925904,27357886.1,51.106126886384835,41.2157769800378,NaN,NaN,43.05275897647352,-35.21599050678509,0.09574807241070593,-0.4515852654074166,-0.5473333378181225,434593139,408427865.4,38.85598657798564,26.105217832992253,NaN,NaN,-14.810490708258303,-17.601682019558194
2011-08-30T09:30:00-04:00,24.35001,24.63,24.172,24.5,12470172,26925193.9,51.909554300271175,42.670378572957596,NaN,NaN,70.83937623325969,-5.048134271519709,0.1488617006960472,-0.36125621194806357,-0.5101179126441108,447063311,419952536.6,44.44719207971782,28.248319572674376,NaN,NaN,-11.994600102200796,-16.800670317078566
2011-08-31T09:30:00-04:00,24.63,24.8,24.241,24.44,12260258,26461387.6,51.36424162579813,43.44622115252634,NaN,NaN,89.36745292715436,22.770190454139133,0.17517030539812178,-0.29115503089645856,-0.46632533629458034,434803053,424525476.2,46.536305802035585,30.609310338325134,NaN,NaN,-9.870527387771217,-15.810649898606087
2011-09-01T09:30:00-04:00,24.49001,24.67999,24.16,24.17,11321535,25342672.35,48.87600766483598,43.93106262551571,NaN,NaN,74.75295470113748,48.06948500070486,0.1694979421253971,-0.254452908637834,-0.4239508507632311,423481518,430921651.2,49.40243172590869,33.081082541632874,NaN,NaN,-8.767676993783866,-14.804510912202913
2011-09-02T09:30:00-04:00,23.75999,23.88499,23.53,23.62,14339469,24417557,44.18087122399003,43.802674494341495,NaN,NaN,-8.356085954487718,53.93129137670748,0.1258226163913101,-0.26667258027409346,-0.39249519666540356,409142049,429816614,48.91454882271418,34.624546841904404,NaN,NaN,-9.161997986795301,-13.998437637144683
2011-09-06T09:30:00-04:00,23.11,23.56,23,23.50999,11431535,22741091.35,43.28520513468965,43.70705565996929,NaN,NaN,-53.11563207746129,34.69761316592051,0.08840966148028662,-0.2819831198150453,-0.37039278129533193,397710514,422440089,45.67206704569915,35.70299978819327,NaN,NaN,-9.740336516414587,-13.390137477040383
2011-09-07T09:30:00-04:00,23.85001,24.12,23.8,24.12,10757605,21188821.2,49.40967873100623,44.10952388280503,NaN,NaN,33.902986610584094,27.31033524138539,0.10263157899732861,-0.24210330754867115,-0.34473488654599976,408468119,414721050.6,42.49740180323949,36.219818807937465,NaN,NaN,-8.457530724994596,-12.685479369605272
2011-09-08T09:30:00-04:00,24.03,24.35001,23.94,24,9460605,19930825.05,48.30460834395639,44.99628790691819,NaN,NaN,40.718094355972816,17.580463527149078,0.10165024690942609,-0.21767207790921717,-0.31932232481864326,399007514,407561942.8,39.738482889909484,36.643173162390916,NaN,NaN,-7.713505014560706,-11.97519731888462
2011-09-09T09:30:00-04:00,23.82001,23.94859,23.37,23.49001,16506898,19176346.75,43.819148782391146,45.77877323535572,NaN,NaN,-26.269814638067082,-2.6240903406918377,0.06607132336796762,-0.2367331706086837,-0.3028044939766513,382500616,399365762.4,36.79348635105832,37.16052320495061,NaN,NaN,-8.368728675159998,-11.459987512638245
2011-09-12T09:30:00-04:00,23.25,23.78,23.22,23.77,11252547,19009679.2,46.74303416478228,46.67859754651505,NaN,NaN,-24.926471333199345,-5.938167416434164,0.06093649388544098,-0.22663387661985013,-0.2875703705052911,393753163,396287985.2,35.72287878445053,37.89571555395905,NaN,NaN,-8.078455647400991,-10.976911531890066
2011-09-13T09:30:00-04:00,23.88,24.12,23.72,24.05,16342105,18078379.65,49.56963408593375,47.19490949776175,NaN,NaN,32.28340805898137,11.14164061085437,0.07501436058620792,-0.1938024197725312,-0.2688167803587391,410095268,398764936,37.30399616646875,38.8869945727027,NaN,NaN,-7.018756086545955,-10.411460753983764
2011-09-14T09:30:00-04:00,24.23,24.675,23.94,24.41,16810976,17907270.05,53.0219613354473,47.8227444962563,NaN,NaN,87.74970836682589,21.910984962102727,0.10533082821165074,-0.1371532450941757,-0.24248407330582644,426906244,402452561,39.68282261831236,40.06813081128756,NaN,NaN,-5.100745026238661,-9.652787078591606
2011-09-15T09:30:00-04:00,24.64999,24.85001,24.46001,24.8,12576805,17457199.1,56.496453150750696,48.869656686992116,NaN,NaN,131.1540232129433,39.99817073349682,0.14591055662498748,-0.06009587752459211,-0.2060064341495796,439483049,410547668,44.64781088520374,41.573122780551124,NaN,NaN,-2.415925678708089,-8.618949735751103
2011-09-16T09:30:00-04:00,24.78999,24.98,24.73,24.98,15003539,16659991.25,58.038987872323176,49.723250950182965,NaN,NaN,138.39780605694887,72.93169487250002,0.17706157257459892,0.015320531568669082,-0.16174104100592984,454486588,424944862.4,52.186078322173714,43.02867784820554,NaN,NaN,0.2725248573754329,-7.348739079590169
2011-09-19T09:30:00-04:00,24.66,25.02,24.46001,24.92,11764348,15360976.65,57.30952943289177,50.16635113207632,NaN,NaN,116.28482423724371,101.17395398658863,0.18495006802975628,0.06944654403126549,-0.11550352399849077,442722240,434738677.8,56.52366707182597,44.290655026337,NaN,NaN,2.297112239119261,-5.970760319774536
2011-09-20T09:30:00-04:00,25.06,25.28999,24.83501,24.86,24735280,15581621.45,56.544191211531135,50.49739662573774,NaN,NaN,131.78020907614672,121.07331419002169,0.17742299972543346,0.10627522565830105,-0.07114777406713241,417986960,436317016.2,57.197566917932306,45.20139608620946,NaN,NaN,3.7919940614393353,-4.576081122458269
2011-09-21T09:30:00-04:00,24.96001,25.14999,24.48,24.49001,22080800,15757154.25,51.938065864949515,50.53838407139141,NaN,NaN,82.47132497836341,120.0176375123292,0.1404411155519742,0.10440362037283535,-0.03603749517913885,395906160,430116999.4,53.677794819759434,45.711502444618304,NaN,NaN,3.8765973685657866,-3.3685556237405465
2011-09-22T09:30:00-04:00,23.85001,24.0789,23.42,23.73,41230944,16693781.45,44.00774321143706,50.190650896148625,NaN,NaN,-61.162888018741704,81.5542552659922,0.061725915951562585,0.04111989976031438,-0.020606016191248206,354675216,413155432.8,45.439644804626596,45.4284462359553,NaN,NaN,1.5625282521978638,-2.6641150700350593
2011-09-23T09:30:00-04:00,23.66,24.075,23.56,24,26098896,16976840.65,47.09807897804489,50.399022878581114,NaN,NaN,-46.20748534466762,44.633196985668896,0.026571609644477658,0.012608495864348868,-0.01396311378012879,380774112,398412937.6,39.731905367116156,44.772543131984015,NaN,NaN,0.518513531117567,-2.20945384129897
2011-09-26T09:30:00-04:00,24.11,24.35001,23.71001,24.3,20508160,16843919.05,50.375385172938344,50.9054643098846,NaN,NaN,-13.677413941398374,18.64074934994047,0.022417242006525815,0.014058438728028477,-0.008358803278497338,401282272,390124944,36.92388834874657,44.14767322505883,NaN,NaN,0.5942414457294557,-1.808925943152052
2011-09-27T09:30:00-04:00,24.72,24.98,24.47,24.61,21943328,16944790.25,53.575861035294444,51.203048760190896,NaN,NaN,74.20715044314852,7.126137623340848,0.038497897383226114,0.0397635684505353,0.0012656710673091907,423225600,391172672,37.52499354128219,43.79250120634759,NaN,NaN,1.6045724969839175,-1.3212833088469136
2011-09-28T09:30:00-04:00,24.69,24.84,24.24001,24.25999,12328801,16937721.7,49.680008490792694,51.30129162782207,NaN,NaN,35.736916304912505,-2.2207441113493305,0.02421045784934618,0.03152874337899192,0.007318285529645737,410896799,394170799.8,39.30740333346639,43.7617098094588,NaN,NaN,1.3121473005295905,-0.9450789360788416
2011-09-29T09:30:00-04:00,24.62,24.71001,23.83,24.21001,19693120,17309364.8,49.13061184139433,51.680681846322294,NaN,NaN,6.520532418696508,11.315939976138313,0.010729889087019828,0.020730646888420523,0.010000757801400695,391203679,401476492.4,43.534845790570074,44.24323548370963,NaN,NaN,0.9168754806115882,-0.6790854479802089
2011-09-30T09:30:00-04:00,23.89,24.09,23.57001,23.60001,16734980,17580037.05,42.895624117693885,51.405866842958844,NaN,NaN,-67.9584749544254,6.965742054186751,-0.03730189869610619,-0.036626615568732035,0.0006752831273741482,374468699,400215409.8,42.97835422117519,44.76148372918997,NaN,NaN,-1.3428861404106973,-0.7739141183274215
2011-10-03T09:30:00-04:00,23.41,23.75999,23.03999,23.07001,23539312,18040029.2,38.34263976837488,50.60393867741892,NaN,NaN,-132.94500205088508,-16.88777556771059,-0.09928138383082721,-0.12342644666115987,-0.02414506283033266,350929387,390144832.8,38.72167239225353,44.862746316746026,NaN,NaN,-4.774512510325179,-1.3454281743271013
2011-10-04T09:30:00-04:00,22.82001,23.55,22.60001,23.53999,16976208,18317262.85,44.017126007427734,49.96073615398895,NaN,NaN,-139.3126902985176,-59.59174371604381,-0.102711278606028,-0.15253416108786766,-0.049822882481839664,367905595,379080831.8,34.66010370966019,44.50398068041373,NaN,NaN,-5.92555166757362,-1.9997315305051755
2011-10-05T09:30:00-04:00,23.494,24.07001,23.3,24.03,13240094,18441387.3,49.260360125890486,49.44387236649893,NaN,NaN,-50.793444967716454,-76.89781597056961,-0.06775125609961899,-0.1345119526063634,-0.0667606965067444,381145689,373130609.8,32.67509593034332,43.64878675506656,NaN,NaN,-5.215643180316869,-2.4591474804782747
2011-10-06T09:30:00-04:00,23.98,24.39999,23.84,24.39,10667305,18501722.3,52.760846621976945,49.066862277188484,NaN,NaN,8.768502006917057,-76.4482220529255,-0.018704354981485788,-0.09014114023360165,-0.07143678525211586,391812994,373252472.8,32.76003025617405,42.26121189320944,NaN,NaN,-3.4995200454132616,-2.6077721326118444
2011-10-07T09:30:00-04:00,24.42,24.55,24.15289,24.3,9772508,18165002.8,51.79873628075189,48.67323419489277,NaN,NaN,22.76773804258932,-58.30297945352255,0.007925491430067516,-0.06152992096453147,-0.06945541239459899,382040486,374766830.2,33.876392758389315,40.64354944224967,NaN,NaN,-2.415997683798961,-2.5803757827814326
2011-10-10T09:30:00-04:00,24.57001,25.07001,24.57001,25.05,8208293,18012790.1,58.57753184959929,48.81847281189765,NaN,NaN,100.25937749142025,-11.662103545061484,0.07269755549813157,0.02141653197806548,-0.051281023520066096,390248779,382630708.6,39.494211760705824,39.37902407387635,NaN,NaN,0.7762454230228699,-2.1008584676665323
2011-10-11T09:30:00-04:00,24.96001,25.22,24.89999,25.16,10772555,17734312.6,59.47766079018054,49.357015306557,NaN,NaN,116.11636056720238,39.423706628082506,0.11697196674905173,0.09493393491624857,-0.022038031832803163,401021334,389253856.4,43.82314573836565,38.6751205680625,NaN,NaN,3.60809875794057,-1.2852931497226605
2011-10-12T09:30:00-04:00,25.36,25.53999,25.27,25.27,9613234,17374425.5,60.40428079432977,50.52819656247791,NaN,NaN,133.693194721536,76.32103456593299,0.14581130574872522,0.16022610035310336,0.014414794604378143,410634568,395151632.2,47.43001490148282,38.8172898606951,NaN,NaN,6.189930633166383,-0.21740403788136864
2011-10-13T09:30:00-04:00,25.25,25.57001,25.19,25.55,9977293,17244449.9,62.73989580913633,51.64546919327016,NaN,NaN,129.51940217797812,100.4712146001452,0.17398110407185008,0.23189117469419074,0.05791007062234066,420611861,400911405.6,50.75533876359165,39.60467796044335,NaN,NaN,9.077993658565656,1.1105099187539207
2011-10-14T09:30:00-04:00,25.89999,26.03999,25.78,26,11503406,17069443.25,66.19147911243557,52.775190188948535,NaN,NaN,169.15147252715778,129.7479614970589,0.21070700461365907,0.3212938263894145,0.11058682177575543,432115267,410926361.8,55.97050481354674,40.96515056507194,NaN,NaN,12.661586541810948,2.7606637220477817
2011-10-17T09:30:00-04:00,25.95,25.96001,25.48,25.59,8901254,16926288.55,60.67641886025168,53.282372890731196,NaN,NaN,124.13341192735903,134.52276838424666,0.19550703710546535,0.3549706181575871,0.15946358105212177,423214013,417519408.6,59.04542072041674,42.50232393501012,NaN,NaN,14.073884083577923,4.376838059409231
2011-10-18T09:30:00-04:00,25.52,25.97,25.28149,25.82001,8711855,16125117.3,62.561021152342484,54.20244522369904,NaN,NaN,115.02052173837937,134.30360061848205,0.1889560918236703,0.39565869583170965,0.20670260400803936,431925868,423700315.4,61.742866264812925,44.104857001534874,NaN,NaN,15.815547799748684,6.010939450886295
2011-10-19T09:30:00-04:00,25.67,25.72,25.27,25.32001,12245293,15633341.95,56.25003247869411,54.71097526922045,NaN,NaN,81.46504527371522,123.85797072891789,0.14115139557188505,0.3831418484728957,0.24199045290101062,419680575,425509516.8,62.521005917362494,45.461011296305756,NaN,NaN,15.39082758764055,7.350923470422617
2011-10-20T09:30:00-04:00,25.31,25.34,24.89999,25.21001,8937664,14018677.95,54.93702832568457,55.57107556979121,NaN,NaN,48.953053796660896,107.74470105265445,0.09456282490750406,0.3601939840353907,0.26563115912788665,410742911,423535726.8,61.06181033524037,46.7526867330247,NaN,NaN,14.65369202991121,8.39417612177813
2011-10-21T09:30:00-04:00,25.49001,25.6599,25.34,25.53,9792633,13203364.8,58.0077527524483,56.975726497225025,NaN,NaN,75.2828815441779,88.97098285605848,0.07840417751812806,0.36363638102554674,0.2852322035074187,420535544,421219782.2,59.3125828565078,48.22346605190001,NaN,NaN,14.926794990959664,9.327407388804064
2011-10-24T09:30:00-04:00,25.62,26.00999,25.57001,25.92999,12653676,12810640.6,61.536103149567474,58.227082007377874,NaN,NaN,95.70200781878239,83.28470203434316,0.0870921936343087,0.39409744555030457,0.30700525191599587,433189220,423214823.6,60.365887933549956,50.05959349646356,NaN,NaN,16.225453922765144,10.312842607941361
2011-10-25T09:30:00-04:00,25.86,25.87,25.45,25.52,12034949,12315221.65,56.31309391829238,58.73084870683515,NaN,NaN,68.34807166171478,73.95021201901025,0.05900864484957247,0.3807660579779615,0.321757413128389,421154271,421060504.2,58.60169098165442,51.91149314298578,NaN,NaN,15.743188088081695,11.088606247961408
2011-10-26T09:30:00-04:00,25.7598,25.77,25.16,25.63,7495043,12073533.75,57.35883452852599,59.05927641444579,NaN,NaN,55.37802777985298,68.7328085202378,0.042399631972406204,0.3747569530938968,0.3323573211214906,428649314,422854252,59.658848581809664,53.832837309102615,NaN,NaN,15.655122643081759,11.740965732978601
2011-10-27T09:30:00-04:00,26.23,26.56,26.05,26.39,13942098,11785982.65,63.80532010563682,59.91688954479471,NaN,NaN,117.63589037049934,82.46937583500548,0.07523815194717093,0.42640501105545425,0.3511668591082833,442591412,429223952.2,63.24791436255533,55.930803137971616,NaN,NaN,17.62444831382071,12.581463244527475
2011-10-28T09:30:00-04:00,26.28,26.53999,26.25,26.48,9005789,11399523.1,64.48995460061107,60.33920545558127,NaN,NaN,120.26240641429962,91.4652808090298,0.09441866035023094,0.469190184546072,0.37477152419584103,451597201,435436283.6,66.38870297019857,57.85183822436396,NaN,NaN,19.412471875594488,13.557321620394191
2011-10-31T09:30:00-04:00,26.22,26.32001,25.99001,26.00999,6431113,10544113.15,58.28911147523946,60.25430907594262,NaN,NaN,88.25837912303861,89.97655506988106,0.06807938861462215,0.45987075996411875,0.3917913713494966,445166088,437831657.2,67.54056637725074,59.54593969857003,NaN,NaN,19.041540736737346,14.340781494157499
2011-11-01T09:30:00-04:00,25.39999,25.57001,25.24001,25.28999,16598211,10525213.3,50.308913066785735,59.53321138111805,NaN,NaN,-2.7399469063246666,75.75895135627317,-0.0015189957747240301,0.3898926266310916,0.3914116224058156,428567877,439314378.4,68.26553271892388,61.0341909712444,NaN,NaN,16.060008606605884,14.58638536736441
2011-11-02T09:30:00-04:00,25.61,25.715,25.41,25.60001,8999988,10313208,53.27521570445315,58.85716280221211,NaN,NaN,16.606176490633416,68.00458109842926,-0.02884595940748802,0.35535417314645557,0.3842001325539436,437567865,441098088.6,69.157953302359,62.348663438299205,NaN,NaN,14.56351888688757,14.583118727296291
2011-11-03T09:30:00-04:00,25.88,26.24001,25.58,26.21001,11639715,10361828.5,58.52185377431439,58.309332420917734,NaN,NaN,83.46299782040107,61.1700025884096,-0.00903572228578814,0.3729054796967084,0.38194120198249654,449207580,442421322.2,69.83564065368968,63.33903028402371,NaN,NaN,15.005776588100192,14.64349842169685
2011-11-04T09:30:00-04:00,26.00999,26.129,25.8,26.05,5703227,10158364.45,56.72260208138005,58.026916936712624,NaN,NaN,72.36663925074114,51.5908491556979,-0.009838931372713022,0.3696425377666053,0.3794814691393183,443504353,440802752.6,67.87114572310132,63.96943921278689,NaN,NaN,14.787506136008421,14.664070952312787
2011-11-07T09:30:00-05:00,26.03,26.24001,25.77,26.21001,6382434,10067071.5,58.10959142684199,57.70895767060544,NaN,NaN,79.80139163188623,49.89945165746743,-0.003074789957077384,0.3756379816929716,0.37871277165004896,449886787,441746892.4,68.42903909408875,64.44702298630659,NaN,NaN,15.031818393398892,14.716606301039374
2011-11-08T09:30:00-05:00,26.41,26.53999,26.14,26.50999,7238094,9890348.45,60.655406788240924,58.0236272641445,NaN,NaN,131.64603304752137,76.77664764823666,0.017017399152238932,0.3999845205903476,0.3829671214381087,457124881,447458293.2,71.63746505697438,65.09819863913602,NaN,NaN,16.006605314045178,14.900891874325916
2011-11-09T09:30:00-05:00,26,26.05,25.52,25.59,10394738,9929423.65,50.515918271302,57.70783368883146,NaN,NaN,-15.654080551775689,70.32459623975484,-0.03348433682768531,0.341111700403502,0.37459603723118734,446730143,449290748.8,72.59960137533616,65.92232657057143,NaN,NaN,13.54807825656829,14.707632786074827
2011-11-10T09:30:00-05:00,25.91,25.92,25.44901,25.67,5727039,9716910.95,51.2786250867608,57.22718171271092,NaN,NaN,-28.353238850743562,47.96134890552591,-0.061692249753879436,0.29748072503883805,0.3591729747927175,452457182,449940669.2,72.9500858998884,66.8964339308129,NaN,NaN,11.84486246304894,14.298665597071128
2011-11-11T09:30:00-05:00,25.91,26.235,25.89999,26.16,4938539,9388667.6,55.774889235003776,56.815666433099224,NaN,NaN,64.460263078004,46.38007367097847,-0.04814226960467122,0.2989951377868785,0.3471374073915497,457395721,452718942.8,74.45436425794367,67.9027536682696,NaN,NaN,11.801292918746274,13.94189807159615
2011-11-14T09:30:00-05:00,26.10001,26.21899,25.8911,25.96001,3260985,9106654.15,53.60068900224824,56.62192322481036,NaN,NaN,43.216680129899636,39.063131370581154,-0.05305338729726816,0.2808206732699645,0.3338740605672327,454134736,453568532.6,74.9137910451332,69.0679036728038,NaN,NaN,11.098098546564511,13.53564099659163
2011-11-15T09:30:00-05:00,25.92,26.39999,25.91,26.31,7742781,9058200.45,56.7762148763092,56.58030753536631,NaN,NaN,75.2320303971579,27.78033084050846,-0.034058756413838764,0.2913006150499342,0.325359371463773,461877517,454519059.8,75.44585562207175,70.19554703282252,NaN,NaN,11.472722532117974,13.240938358809679
2011-11-16T09:30:00-05:00,26.10001,26.34,25.87,25.92,8741484,8883010,52.467129644239634,55.770436788123654,NaN,NaN,35.59990375123043,38.03112770110968,-0.0482230016455053,0.2650806194068913,0.3133036210523966,453136033,455800237.8,76.17921194776787,71.11921114605197,NaN,NaN,10.467919023531394,12.844792739484209
2011-11-17T09:30:00-05:00,25.85001,25.87,25.21001,25.42,12498777,9061065.65,47.49070589427748,54.55620473767125,NaN,NaN,-95.86413654082791,24.528948163092814,-0.08933810793626701,0.20163098613206287,0.2909690940683299,440637256,453436252.6,71.91137522826216,71.51368773591366,NaN,NaN,8.02956078344437,12.156902460049947
2011-11-18T09:30:00-05:00,25.39999,25.44901,25.17999,25.21001,7296852,8936276.6,45.53722183168228,53.645355477417176,NaN,NaN,-139.40272400154404,-16.243649252816798,-0.12647878969968313,0.132870606943726,0.2593493966434091,433340404,448625189.2,64.04721134680798,71.26416237659632,NaN,NaN,5.4279019239582675,11.195616669179707
2011-11-21T09:30:00-05:00,24.92999,24.95,24.5401,24.77,9412996,8774242.6,41.669394697386295,53.028247022460064,NaN,NaN,-205.33231212953353,-65.95344770470344,-0.17357247154223293,0.042383807215617963,0.2159562787578509,423927408,442583723.6,55.795565919595305,70.37345046235856,NaN,NaN,1.9844993787175251,9.879742770542252
2011-11-22T09:30:00-05:00,24.72,24.86,24.53,24.73,7067707,8525880.5,41.32575490487661,52.17471410820459,NaN,NaN,-180.04441772598403,-117.00873732933182,-0.19851246191548175,-0.032184298636501296,0.16632816327898045,416859701,433580160.4,46.235284779328836,68.73611699642784,NaN,NaN,-0.8850109361928147,8.341920812437243
2011-11-23T09:30:00-05:00,24.53,24.58,24.14,24.14,12536777,8777967.2,36.53921023554947,50.6045252840071,NaN,NaN,-204.93240100694004,-165.1151982809659,-0.24290681720141324,-0.1373053582227861,0.10560145897862713,404322924,423817538.6,38.52677593133516,66.49976951625966,NaN,NaN,-4.938246222364904,6.444754093179793
2011-11-25T09:30:00-05:00,24.07001,24.36,24.00999,24.00999,7065855,8434155.05,35.56176144210582,49.09303666691609,NaN,NaN,-185.7917695491783,-183.100724882636,-0.2672584451077693,-0.22847159740608447,0.03878684770168481,397257069,415141501.2,33.22520958187732,64.02505979188652,NaN,NaN,-8.54565281644198,4.303267391805255
2011-11-28T09:30:00-05:00,24.62,24.83501,24.61,24.8,9796016,8473666.4,45.16152885445719,48.1681750546029,NaN,NaN,-95.15130578301059,-174.2504412389293,-0.21844846408800006,-0.23427373240831528,-0.015825268320315222,407053085,409884037.4,30.48741016603418,61.31494343988262,NaN,NaN,-8.817503400817124,2.428871564287772
2011-11-29T09:30:00-05:00,24.82001,24.98,24.6125,24.67,4765410,8390381.25,43.99990834989449,46.978496594721,NaN,NaN,-83.1710248937554,-149.8181837917737,-0.18455590448061057,-0.24652014892107843,-0.061964244440467865,402287675,405556090.8,28.41190180008944,58.22740320724798,NaN,NaN,-9.389093794820083,0.7405907987009357
2011-11-30T09:30:00-05:00,25.32001,25.64,25.25,25.62,13730492,8246995.3,53.42730788559104,47.186452995741654,NaN,NaN,3.4642572233358564,-113.1164488019097,-0.09244628243423253,-0.17752209748325853,-0.085075815049026,416018167,405387784,28.331127673908227,55.0653693714317,NaN,NaN,-6.749768133244224,-0.32946047729122996
2011-12-01T09:30:00-05:00,25.55,25.81,25.55,25.75999,7979672,8195979.5,54.63914024239617,47.426489792572745,NaN,NaN,26.415653824311583,-66.84683783565937,-0.020158114185941628,-0.11027345778145303,-0.0901153435955114,423997839,409322767,33.11856835019164,52.22026097502479,NaN,NaN,-4.2665783899456935,-0.8919058933847247
2011-12-02T09:30:00-05:00,25.95,26.02,25.7,25.74001,5542320,7891109.75,54.421487190650325,47.32981821797607,NaN,NaN,41.243470801389186,-21.439789765545868,0.025753918335855525,-0.057922945675692006,-0.08367686401154753,418455519,413562457,37.929549522560364,49.61134563678313,NaN,NaN,-2.359128138092639,-1.101509071200141
2011-12-05T09:30:00-05:00,26.10001,26.22501,25.89999,26.03,6083918,7910144.3,57.09302324857873,47.579270664142534,NaN,NaN,68.02565697401313,11.195602785858872,0.072449978228312,0.006885608773842478,-0.06556436945446953,424539437,417059727.4,41.65768387835873,47.23590941058495,NaN,NaN,0.056340243438015386,-0.9361020262518329
2011-12-06T09:30:00-05:00,26.03,26.155,25.91,26.02,5866602,7884352.7,56.969017653144704,47.593042291059355,NaN,NaN,65.72610304716402,40.97502837404276,0.09787977754225397,0.05678535247334793,-0.04109442506890604,418672835,420336759.4,44.99172417128018,45.060614306956985,NaN,NaN,1.982074467834445,-0.5192196699537932
2011-12-07T09:30:00-05:00,25.92,26.14999,25.7,26.05,5825219,7813708.95,57.26887075737481,47.936023799140436,NaN,NaN,62.65308836788172,52.81279460295193,0.11097684336137129,0.09762662913280806,-0.013350214228563216,424498054,422032736.8,46.689665378616795,42.95421812344619,NaN,NaN,3.6588841701433608,0.07765230720294303
2011-12-08T09:30:00-05:00,25.91,26.07001,25.60001,25.64,6816258,7634784.95,51.94176546482814,48.25395662560834,NaN,NaN,38.3718150560016,55.20402684928994,0.08732471016446965,0.09580567347702384,0.008480963312554199,417681796,420769528.2,45.56160251334475,41.072091500952084,NaN,NaN,3.696050802893782,0.59456637801592
2011-12-09T09:30:00-05:00,25.71001,26.09,25.69,26.03999,8280582,7762462.1,56.22030324074582,49.01703386911288,NaN,NaN,56.420873505265945,58.239507390065285,0.09337141371733503,0.12519523045922298,0.03182381674188796,425962378,422270900,47.19461176609316,39.868334388043884,NaN,NaN,4.959563400756576,1.218137381264585
2011-12-12T09:30:00-05:00,25.81,25.82001,25.52,25.71001,58170928,10424081.55,52.09947887057875,49.76203988148376,NaN,NaN,29.112902050555707,50.4569564053738,0.07091800219499164,0.1204713194856275,0.04955331729063587,367791450,410921302.6,37.93144323167084,38.592325624620706,NaN,NaN,4.861582891253945,1.7386295969773506
2011-12-13T09:30:00-05:00,25.89,25.97,25.39101,25.47,11729801,10847522.35,49.27065653194102,50.3295328548455,NaN,NaN,23.33766245563332,41.979268287067654,0.037358354358427506,0.09625126023867026,0.05889290588024275,356061649,398399065.4,30.75821794227413,37.48682085054538,NaN,NaN,3.9592354427268694,2.055859003512996
2011-12-14T09:30:00-05:00,25.42,25.44,24.99001,25.08,13896676,11155217.1,44.99541631808487,50.9335475750266,NaN,NaN,-26.186988478545505,24.21125291778221,-0.011060373684467162,0.0450674387746588,0.05612781245912596,342164973,381932449.2,24.260958851783386,36.467833916291674,NaN,NaN,1.896222057467401,2.0330537255064822
2011-12-15T09:30:00-05:00,25.33,25.35001,25,25.02,9473973,11191841.55,44.357721730248834,51.5618304527511,NaN,NaN,-27.141459255692254,11.10859805544344,-0.045169257711565214,-0.0003337596803305587,0.044835498031234655,332691000,364934290,19.64722578551148,35.497977930836974,NaN,NaN,0.02298953888272912,1.7459016988459461
2011-12-16T09:30:00-05:00,25.03999,25.28999,24.91,24.98,19699472,11551876.3,43.91092451060147,51.47250157104712,NaN,NaN,-32.363884529312266,-6.648353551472202,-0.06714166152287201,-0.03909157887235537,0.028050082650516648,312991528,342340120,15.443233396424432,34.423393875864846,NaN,NaN,-1.6511451295024075,1.2606092947961813
2011-12-19T09:30:00-05:00,25.06,25.12,24.66,24.74001,10153125,11694689.95,41.227751265613215,51.27449035074132,NaN,NaN,-56.127625864881004,-23.696459134559547,-0.09296519010107189,-0.08815640497582322,0.004808785125248672,302838403,329349510.6,13.636546485294147,33.368011353379465,NaN,NaN,-3.855942230124926,0.5296733626645946
2011-12-20T09:30:00-05:00,25.07001,25.47,25.07001,25.435,8962762,11672178.25,50.63504987463414,51.075043349958676,NaN,NaN,1.8653046698615632,-27.990930691713903,-0.05996869124564602,-0.07015207893180886,-0.010183387686162833,311801165,320497413.8,12.558394246459557,32.24138753713313,NaN,NaN,-3.1166703438296546,0.00876711887970194
2011-12-21T09:30:00-05:00,25.28,25.28,24.73,25.02,9106281,11774106.95,45.90952902528668,50.45149969159372,NaN,NaN,-43.7553970555202,-31.50461240710884,-0.06253495760544676,-0.08835208469297129,-0.025817127087524525,302694884,312603396,11.672131501019294,30.709499190763676,NaN,NaN,-3.935639673942008,-0.5547195658091137
2011-12-22T09:30:00-05:00,25.10001,25.31,25.10001,25.31,4686813,11381608.75,49.459101015425176,50.09704353622049,NaN,NaN,-20.560006654259748,-30.188321886822344,-0.042122765504410575,-0.07847058396803774,-0.03634781846362717,307381697,307541535.4,11.129743230597256,28.795227312766315,NaN,NaN,-3.529612614853657,-0.9797042871011914
2011-12-23T09:30:00-05:00,25.31,25.56,25.31,25.56,4745223,11265577.15,52.36139218912328,49.759069889116525,NaN,NaN,6.352719119079632,-22.44500115714396,-0.010834861895882543,-0.049891395833480345,-0.0390565339375978,312126920,307368613.8,11.11074876005712,26.61330337574477,NaN,NaN,-2.301179488880315,-1.1684864587839234
2011-12-27T09:30:00-05:00,25.50999,25.67999,25.49001,25.60001,2788962,10915224.45,52.82825915807395,49.463301425182905,NaN,NaN,21.18607789070342,-6.9822604060270645,0.01225318699688184,-0.0237400501914955,-0.03599323718837734,314915882,309784109.6,13.33571752107457,24.352160043587226,NaN,NaN,-1.1708654963673988,-1.1688263212958485
2011-12-28T09:30:00-05:00,25.60001,25.61,25.27499,25.34,4851234,10919515.65,49.43750125665627,48.90391788941729,NaN,NaN,-23.92644671597149,-12.140610683193675,0.009816909146933395,-0.023722100754710596,-0.03353900990164399,310064648,309436806.2,13.284230412743028,21.96605754602481,NaN,NaN,-1.1766390488514502,-1.1699424252323631
2011-12-29T09:30:00-05:00,25.39999,25.57001,25.355,25.53,5889297,10527455.9,51.868624571563174,48.89869353989837,NaN,NaN,-6.693501419154379,-4.7282315559205115,0.020206403666570914,-0.008281005318430346,-0.02848740898500126,315953945,312088618.4,15.952473917806742,19.851119789200663,NaN,NaN,-0.48385686677509165,-1.0719302025956101
2011-12-30T09:30:00-05:00,25.5,25.61,25.45,25.45,3751279,10316036.25,50.761905370751755,48.50880797775593,NaN,NaN,-0.4044616438906317,-0.6971225538466899,0.020813385648358922,-0.002470676924552606,-0.02328406257291153,312202666,313052812.2,16.953066394530595,17.691009405517626,NaN,NaN,-0.21242123024082568,-0.9491432065449267
2012-01-03T09:30:00-05:00,25.87,26.02,25.78999,25.81,26839840,11380912.25,55.376114679158924,48.742853392654524,NaN,NaN,82.78786334005548,14.58990629034848,0.04328939345547192,0.030827679246428374,-0.012461714209043547,339042506,318435929.4,22.500419780021858,16.588793444685557,NaN,NaN,1.3595100181464594,-0.6193356030175858
2012-01-04T09:30:00-05:00,25.8,25.92999,25.66,25.88,4744293,11313931,56.23493798845954,49.24030206812013,NaN,NaN,77.15872474628803,25.784435661465402,0.0596884657160228,0.06214886793598495,0.002460402219962153,343786799,324210112.8,28.052068352058996,16.395497045384474,NaN,NaN,2.9059153741850996,-0.11572832056005933
2012-01-05T09:30:00-05:00,25.85001,26.00999,25.73,25.96001,6756844,11358443.1,57.247744279310766,50.11546835106483,NaN,NaN,99.01392291108115,50.37250958687593,0.07192173876742432,0.09236257567924255,0.020440836911818232,350543643,332305911.8,35.07456165550454,17.16789724565027,NaN,NaN,4.484559447147873,0.5414556462553596
2012-01-06T09:30:00-05:00,25.98,26.034,25.85001,25.97,4989105,11316637.4,57.380365939347286,51.045657223143294,NaN,NaN,111.90524616625261,74.09225910395733,0.07627024418016118,0.11577864213701972,0.03950839795685853,355532748,340221672.4,41.12543862128266,18.70205530534821,NaN,NaN,5.8392682141855206,1.2982860131025253
2012-01-09T09:30:00-05:00,26.06,26.08,25.855,25.92999,4086508,11180149.9,56.62277577495693,51.95364659916868,NaN,NaN,106.95870427101838,95.56489228693913,0.07208405564576002,0.12961346751405856,0.05752941186829853,351446240,348070387.2,46.45412356975115,20.917118889157262,NaN,NaN,6.804903116957377,2.084945599367504
2012-01-10T09:30:00-05:00,26.17999,26.23,26.015,26.02,5733074,11052774.5,57.967289693328546,53.149327915434064,NaN,NaN,132.87698091117957,105.58271580116393,0.07090121171576394,0.14615592651300346,0.07525471479723952,357179314,351697748.8,48.76224899162002,23.42609763960911,NaN,NaN,7.984089031167778,2.9276803753389715
2012-01-11T09:30:00-05:00,25.97,26.17,25.95,26.10001,4154016,8351928.9,59.1785301689615,53.759576507886024,NaN,NaN,116.46014831067552,113.44300051404143,0.07086303779120426,0.16383351203624485,0.0929704742450406,361333330,355207055,50.96446243556237,26.169388224545024,NaN,NaN,9.314441278924827,3.840074790136951
2012-01-12T09:30:00-05:00,26.16,26.25,26.0061,26.23,4865453,8008711.5,61.13791368130283,54.84731826903003,NaN,NaN,118.03069391119361,117.24635471406393,0.0745724176306753,0.18618599628338472,0.11161357865270942,366198783,358338083,52.90917758336064,29.114891516140833,NaN,NaN,10.989657676388674,4.861443773887197
2012-01-13T09:30:00-05:00,26.07001,26.11,25.89,26.08,5971422,7612448.8,57.69642972242246,55.435698890958406,NaN,NaN,82.27656109102712,111.32061769901884,0.06239796643007664,0.1896110366903052,0.12721307026022857,360227361,359277005.6,53.50467769000515,32.14167254895568,NaN,NaN,11.613017227922176,5.825954267320766
2012-01-17T09:30:00-05:00,26.25999,26.38,26.14,26.2,5533086,7415404.45,59.65311000967938,55.95653587814099,NaN,NaN,109.65069124738072,111.8590150942913,0.0579945941472349,0.1997063129442722,0.1417117187970373,365760447,362139847,55.35837058743164,35.30221696519672,NaN,NaN,12.662415041906721,6.802591520833045
2012-01-18T09:30:00-05:00,26.27,26.61,26.25999,26.58,7209363,6790899,65.15017075583617,56.83667242083829,NaN,NaN,139.8215908723172,113.24793708651882,0.07515322681195155,0.23565325231197676,0.1605000255000252,372969810,365297946.2,57.37712915749699,38.44803208208403,NaN,NaN,15.202608462069515,8.002593941009684
2012-01-19T09:30:00-05:00,26.72,26.83,26.69,26.77,7425109,6654498.2,67.53210256998621,58.129143943219006,NaN,NaN,179.2226167141086,125.80043076720544,0.09263037704356722,0.27628799680448424,0.18365761976091702,380394919,369110264,59.74373450604681,41.7665680887486,NaN,NaN,18.105240974981843,9.445829231577134
2012-01-20T09:30:00-05:00,26.72,26.84,26.71001,26.8,13360246,6874372.4,67.90510950466674,59.274607152726404,NaN,NaN,164.33889720489637,135.062071425946,0.09896903724333689,0.3073689163150881,0.20839987907175123,393755165,374621540.4,62.94673770968561,45.12330121673995,NaN,NaN,20.62086333533541,11.042262674971173
2012-01-23T09:30:00-05:00,26.84,27.03,26.72,26.89,29022176,7870167.15,69.05373109093219,60.58116613273929,NaN,NaN,164.20296709067287,151.44735262587514,0.10159751401154807,0.3353967715861863,0.23379925757463824,422777341,387131536.4,68.98003650252619,48.839513367311056,NaN,NaN,23.089933332262945,12.763358483155711
2012-01-24T09:30:00-05:00,26.77,26.92,26.74001,26.87,5752148,7923433.9,68.46732749956756,61.51625276276848,NaN,NaN,139.11556977589188,157.34032833157738,0.09451122628207725,0.3519382904272348,0.25742706414515754,417025193,397384485.6,72.87791089234884,52.43790558962013,NaN,NaN,25.017769080903275,14.51398856854822
2012-01-25T09:30:00-05:00,27.12,27.16,26.84,27.08,17934176,8582881.55,71.22996466447222,62.58732609676939,NaN,NaN,145.89070809640197,158.55415177639435,0.09617003975974464,0.37763961384483835,0.2814695740850937,434959369,409782397.4,76.69188793818834,55.91217841720079,NaN,NaN,27.51724862740445,16.371597148384822
2012-01-26T09:30:00-05:00,27.17,27.2,26.78999,26.89999,8712805,8879073.7,65.90015697178741,63.205355574803434,NaN,NaN,116.80825480030518,146.07127939363366,0.07811443747038704,0.3791126209230775,0.30099818345269047,426246564,418952726.4,79.03974938944788,59.05254896962532,NaN,NaN,28.260872706025435,18.070065085190624
2012-01-27T09:30:00-05:00,26.8,26.97,26.8,26.89999,8260164,9049520.2,65.90015697178741,63.813912077120584,NaN,NaN,92.66182219608332,131.73586439187105,0.05995850487732979,0.3759463145493527,0.3159878096720229,426246564,425451006.2,80.53597215568735,61.86758707922565,NaN,NaN,28.877936069248022,19.61404665434168
2012-01-30T09:30:00-05:00,26.67,27.02,26.64999,26.98,7697879,9139949.3,67.16658881303889,64.56704157984073,NaN,NaN,81.51149400028909,115.19756977379427,0.04766084490250122,0.37556386580014944,0.3279030208976482,433944443,427684426.6,81.03700193934384,64.3377926770537,NaN,NaN,29.741308393784433,21.060798331404932
2012-01-31T09:30:00-05:00,27.16,27.17,26.87,27.03,8089285,9356849.6,67.9672235730255,65.28132257124766,NaN,NaN,93.39675904805114,106.05380762822612,0.03765590357047505,0.37497290036074205,0.337316996790267,442033728,432686133.6,82.14544240351083,66.72230649218876,NaN,NaN,30.687795260922822,22.436083607050346
2012-02-01T09:30:00-05:00,27.28999,27.42,27.19,27.3,8972371,8463476.15,71.94553574471672,66.19325154094444,NaN,NaN,123.24511193539288,101.52468839602429,0.043566530042065676,0.3917751593428491,0.34820862930078345,451006099,435895479.6,82.83861392192753,68.99903159835769,NaN,NaN,32.67641157895771,23.898987603037114
2012-02-02T09:30:00-05:00,27.39999,27.48,27.3,27.37,6020449,8527283.95,72.88573744508913,67.03238180978633,NaN,NaN,122.92368952095444,102.74777534015413,0.04628005157258752,0.4060586937665178,0.3597786421939303,457026548,442051476.4,84.11272572013338,71.22785646527004,NaN,NaN,34.62612406212019,25.43143566862041
2012-02-03T09:30:00-05:00,27.60001,27.77,27.55,27.715,7394395,8559161.5,76.98043559641178,68.40981080078556,NaN,NaN,153.43994576545415,114.90340005402831,0.06429181833258618,0.44014341510966304,0.37585159677707686,464420943,449686352.2,85.5460065844542,73.51652281487354,NaN,NaN,37.702228826650455,27.18440611976756
2012-02-06T09:30:00-05:00,27.64,27.75,27.57001,27.73,6702324,8644822.45,77.14206410038057,69.65902180726422,NaN,NaN,144.74088680291877,127.54927861455424,0.06974165913085933,0.463028670690651,0.3932870115597917,471123267,457122117,86.79544283281196,75.76202797525785,NaN,NaN,40.251029821530075,29.051066648590776
2012-02-07T09:30:00-05:00,27.72,27.87,27.59,27.8,7388148,8809904.45,77.92115592758148,70.57123503381747,NaN,NaN,145.45970472224204,137.9618677493924,0.07038325460271194,0.4812660798131816,0.41088282521046965,478511415,464417654.4,87.90055888342721,77.94227295568145,NaN,NaN,42.62190419567744,30.989757726746014
2012-02-08T09:30:00-05:00,27.86,28,27.77,27.97,11494816,9097991.55,79.72824114855788,71.44238778942973,NaN,NaN,151.67252915360697,143.64735119303523,0.07419885026779272,0.5036313880452106,0.42943253777741786,490006231,472217680.8,88.96401285881838,80.02943569516512,NaN,NaN,45.2355016679918,33.02486400406684
2012-02-09T09:30:00-05:00,28.10001,28.27901,28.00999,28.24001,9486461,9364613.8,82.21770449134304,72.46471600276375,NaN,NaN,164.59750389982568,151.9821140688095,0.08601711830341519,0.5369539356566868,0.4509368173532716,499492692,480710909.6,89.99516931773508,81.96146652431152,NaN,NaN,48.368283054194315,35.21678101122791
2012-02-10T09:30:00-05:00,28.05,28.09,27.92999,28.03,6369422,9439812.25,74.54933728998881,72.85725930269636,NaN,NaN,121.78969712243776,145.6520643402062,0.07140196780633101,0.5401892771111854,0.46878730930485435,493123270,486451375,90.63226813003574,83.50805449770506,NaN,NaN,48.69046414493798,37.14159288747221
2012-02-13T09:30:00-05:00,28.23,28.27,28.05,28.21001,8422316,9562356.95,76.5668212884175,73.43579457332851,NaN,NaN,127.11300376517424,142.1264877326573,0.06571243872721205,0.5509278577138694,0.4852154189866574,501545586,492535838.8,91.26704101082197,84.8215637918817,NaN,NaN,49.58472385719101,38.919183026003466
2012-02-14T09:30:00-05:00,28.17999,28.28,28.03,28.25999,6544078,9612906.55,77.10938747036744,73.85575334517816,NaN,NaN,115.43441981754201,136.12143075171727,0.05746758798434948,0.5570499039670942,0.4995823159827447,508089664,498451488.6,91.8455914248581,85.90397118378668,NaN,NaN,50.470629426142644,40.56938965459478
2012-02-15T09:30:00-05:00,28.39999,28.575,28.06,28.11,12213195,9863098.15,71.74104801716202,74.27295984841919,NaN,NaN,109.78489469715062,127.743903860426,0.03516072133624093,0.5435332176530459,0.5083724963168049,495876469,499625536.2,91.95944165887617,86.82680634588871,NaN,NaN,49.597896512196506,41.859176348537886
2012-02-16T09:30:00-05:00,28.11,28.55,28.07001,28.52,10047773,9994231.35,76.54753203573284,75.033486638701,NaN,NaN,113.3459941003209,117.49360190052505,0.04086653352033032,0.5594556632172178,0.5185891296968875,505924242,500911846.2,92.08975120354812,87.65207627787876,NaN,NaN,50.34172798201977,43.070969439035295
2012-02-17T09:30:00-05:00,28.61,28.61,28.424,28.52,9284902,9790464.15,76.54753203573284,75.70355401175058,NaN,NaN,118.76748855356054,116.88916018674959,0.037572656735986865,0.5655549506168711,0.5279822938808842,505924242,503472040.6,92.35531070196562,88.46052690378032,NaN,NaN,50.92258118766966,44.192628260268776
2012-02-21T09:30:00-05:00,28.56,28.77,28.47,28.64,9720371,8825373.9,77.82764983424954,76.40787017326659,NaN,NaN,121.79473391331031,115.82550621637681,0.03638310369633868,0.5734611735013075,0.5370780698049689,515644613,506291846,92.64806561794087,89.21071427623961,NaN,NaN,51.79223870590075,45.27828689535906
2012-02-22T09:30:00-05:00,28.60001,28.67,28.48,28.53999,8103121,8942922.55,74.19293135064902,76.56839843083318,NaN,NaN,103.50538308401094,113.4396988696706,0.02245140967892867,0.5651423319036297,0.5426909222247011,507541492,506182211.6,92.49974644696732,89.9007951708853,NaN,NaN,51.42697643486388,46.15667111528832
2012-02-23T09:30:00-05:00,28.50999,28.7,28.35001,28.64999,5507688,8321598.15,75.54570740967478,76.75839628544644,NaN,NaN,94.82776669346241,110.44827326893294,0.014614687248609481,0.5609592812854629,0.5463445940368534,513049180,509616753.8,92.884071927476,90.52731989998121,NaN,NaN,51.50983974804155,46.92140949139592
2012-02-24T09:30:00-05:00,28.75,28.8667,28.74001,28.82001,5496734,8160794.6,77.50818100226451,76.7960923858645,NaN,NaN,117.35562880889692,111.25020021064816,0.01480601522307512,0.5648521130656974,0.5500460978426223,518545914,512141088.2,93.16143640253387,91.07127917270118,NaN,NaN,52.160170978942645,47.66980398961688
2012-02-27T09:30:00-05:00,28.67999,28.95,28.532,28.87,8526441,8174108.45,78.0655505835158,76.86205570608844,NaN,NaN,107.16805230895658,108.93031296172735,0.012325359841826478,0.5654527976449053,0.5531274378030788,527072355,516370710.8,93.61080705420137,91.55809090280043,NaN,NaN,52.8554018117785,48.41060367849711
2012-02-28T09:30:00-05:00,28.89999,29.08,28.84,29.08,10110082,8294718.6,80.27670464486489,77.03030918589441,NaN,NaN,131.46771791389588,110.86490976184447,0.01848336951153029,0.5762316496924917,0.5577482801809615,537182437,520678275.6,94.04032127580471,91.99664535939883,NaN,NaN,54.128880126526425,49.22750031392987
2012-02-29T09:30:00-05:00,29.10001,29.2119,28.84,28.94501,10456480,8413078.35,75.04006766385237,76.69543965127257,NaN,NaN,123.35337338098202,114.83450782123869,0.007674530855531492,0.5673414437503759,0.5596669128948444,526725957,524515168.6,94.40135441909388,92.38502689941849,NaN,NaN,53.63966875886883,49.8578100917783
2012-03-01T09:30:00-05:00,29.10001,29.17,28.965,29.12,13978402,8663379.9,77.12336558745545,76.33155830099489,NaN,NaN,124.49887585905729,120.76872965435766,0.0065625251765395465,0.5678700693655188,0.5613075441889792,540704359,530046204.4,94.8826185347479,92.73413041491942,NaN,NaN,53.839036126727166,50.42655666819957
2012-03-02T09:30:00-05:00,29.095,29.19,29,29.08,8785391,8801627,75.57064766776696,76.40450904226475,NaN,NaN,115.37187547921518,120.37197898842132,-0.0021485171426389726,0.5586218977606805,0.5607704149033195,531918968,532720815.2,95.10188310322636,93.05338862729018,NaN,NaN,53.54687038804735,50.87231577103496
2012-03-05T09:30:00-05:00,29.05,29.10001,28.72,28.83,7246129,8794213.7,66.55216490048701,75.68917644312685,NaN,NaN,73.50545398667813,113.63945932396564,-0.028562653673935068,0.5250670978109007,0.5536297514848357,524672839,532240912,94.32096295507692,93.27152590902269,NaN,NaN,50.49094921038242,50.817834833798884
2012-03-06T09:30:00-05:00,28.55,28.605,28.39,28.545,14036859,9160940.45,58.047565176392155,74.32761770784292,NaN,NaN,-0.2677185308742275,87.29237203501161,-0.0668565921754618,0.47005901126550853,0.5369156034409703,510635980,526931620.6,85.91558823979098,92.84795425294647,NaN,NaN,44.96891891021509,49.982275416144056
2012-03-07T09:30:00-05:00,28.67,28.8,28.63,28.75999,10790918,9331078.95,61.99315219033264,73.63133943449796,NaN,NaN,37.7753063496403,70.17675862874333,-0.07852855543847548,0.43875490914287596,0.5172834645813514,521426898,525871808.8,84.30064733599964,92.30089751559812,NaN,NaN,41.542681746723645,48.77661917765543
2012-03-08T09:30:00-05:00,28.91,29.11,28.85001,29.05,7258824,9119279.35,66.56169876766788,72.91806562963617,NaN,NaN,90.76547187794102,63.43007783252008,-0.06793593317197044,0.43236354811638833,0.5002994812883588,528685722,523468081.4,80.60013722953407,91.48021080316856,NaN,NaN,40.11166032484794,47.538767912968645
2012-03-09T09:30:00-05:00,29.09,29.21001,29.08,29.17999,6365777,8963245.15,68.39547814062506,72.3357760656999,NaN,NaN,113.73424342808012,63.102551422293075,-0.054000845625322036,0.4327984242567062,0.48679926988202826,535051499,524094587.6,80.8362588869015,90.65742138780683,NaN,NaN,39.557858502963725,46.39863799725366
2012-03-12T09:30:00-04:00,29.16,29.25,29.08,29.22,5926793,8941113.7,68.95972828991015,71.70235309824709,NaN,NaN,111.23618946722908,70.64869851840326,-0.04432050045111924,0.43139864431812924,0.4757191447692485,540978292,527355678.2,82.06024330360466,89.90114836535425,NaN,NaN,39.29447972123562,45.383758243536796
2012-03-13T09:30:00-04:00,29.39,29.8,29.36,29.8,19012048,9470600.3,75.72549436262258,71.81182188481664,NaN,NaN,198.32579410525022,110.36740104562816,-0.003252489387402302,0.4716535330349956,0.4749060224223979,559990340,537226550.2,85.15162045404384,89.37628222300258,NaN,NaN,41.46870328012878,44.82446467733565
2012-03-14T09:30:00-04:00,29.82001,30.03999,29.72,29.91,12741773,9780485.05,76.76010057749738,71.89856425394682,NaN,NaN,216.08634220184325,146.02960821606877,0.0253489606610125,0.5065922232486635,0.481243262587651,572732113,547487593.2,87.55281458616243,88.99547812719446,NaN,NaN,43.53010830518931,44.63955662417189
2012-03-15T09:30:00-04:00,30.03,30.06,29.86,29.99001,12452090,9792429.8,77.51091522907092,71.89875955586156,NaN,NaN,200.26026747857676,167.92856733619587,0.042665609362461,0.5345752742907273,0.49190966492826627,585184203,558787289.4,89.55582147535677,88.73793420382466,NaN,NaN,45.40892427405767,44.74946628844128
2012-03-16T09:30:00-04:00,29.97,29.97,29.8295,29.88,9478852,9763983.75,73.97224671486083,71.60638070810049,NaN,NaN,158.91898674724564,176.965516000029,0.03977751983049038,0.5416315647163792,0.5018540448858888,575705351,566918059.8,90.71379626703171,88.53100486188397,NaN,NaN,45.83145529604755,44.90403614667075
2012-03-19T09:30:00-04:00,29.94,30.17,29.87,30.10001,8931895,9746333.4,76.30236008935725,71.32249895413567,NaN,NaN,156.52807004456034,186.02389211549524,0.045347334629496805,0.5585382131727599,0.5131908785432631,584637246,575649850.6,91.76920979953312,88.36878261357886,NaN,NaN,46.93458227220904,45.19411416460479
2012-03-20T09:30:00-04:00,29.92,30.11,29.842,30.07001,5716090,9546119.35,75.31228144682355,71.34194279577646,NaN,NaN,126.14599739116812,171.5879327726788,0.03986801123137673,0.563025892582484,0.5231578813511073,578921156,579436013.8,92.18401923270432,88.21040152883674,NaN,NaN,47.51833695686506,45.526145992070546
2012-03-21T09:30:00-04:00,30.12,30.25,30.05,30.06,8824926,9582209.6,74.96275922628112,71.1876137699783,NaN,NaN,120.78100372526853,152.52686507736388,0.028935385093009636,0.5593271127173693,0.5303917276243597,570096230,578908837.2,91.4926109279566,87.96825812835165,NaN,NaN,47.89095894555552,45.86397641399697
2012-03-22T09:30:00-04:00,29.92999,30.07001,29.88,29.99001,7502418,9681946.1,72.43157635295374,70.96339439034878,NaN,NaN,88.14480303439136,130.10377218852682,0.01126410770112829,0.54447186225077,0.5332077545496418,562593812,574390759,85.56911244395394,87.28734593840363,NaN,NaN,47.5005058742826,46.09776633689492
2012-03-23T09:30:00-04:00,30.03999,30.03999,29.83,29.985,9511543,9882686.55,72.2435306828209,71.36992051765834,NaN,NaN,74.86583978565534,113.29314279620876,-0.0055832695708761815,0.5262286675860466,0.5318119371569228,553082269,569866142.6,79.98428652270756,86.26329762180582,NaN,NaN,47.12747677406949,46.24486782791986
2012-03-26T09:30:00-04:00,30.19,30.44,30.12199,30.42999,12187734,10065751.2,77.76515359097505,72.77831969012854,NaN,NaN,111.94966497900147,104.37746178309696,0.007699599264908263,0.5414364362380581,0.5337368369731499,565270003,565992694,75.44464314270942,85.51537297201426,NaN,NaN,48.44343542363231,46.55894891302164
2012-03-27T09:30:00-04:00,30.46001,30.53999,30.39999,30.42,6437953,9882144.75,77.39293013986644,73.87830382938095,NaN,NaN,114.45408812024401,102.03907992891216,0.010117903079965407,0.5463842158231067,0.5362663127431413,558832050,561974872.8,70.94657540659,84.56151069134215,NaN,NaN,49.392794333661946,46.96378397311311
2012-03-28T09:30:00-04:00,30.42,30.53,30.16,30.31,6489445,9683793,73.23615879734166,74.35505097435767,NaN,NaN,91.12201653033866,96.10728248992618,-0.0008057287665794721,0.535259151784917,0.5360648805514965,552342605,558424147.8,67.13704935282655,83.59986155729162,NaN,NaN,49.00486387804619,47.25536681667498
2012-03-29T09:30:00-04:00,30.14999,30.28999,30.03,30.25,5737125,9271729.15,70.99623415619912,74.54081926118438,NaN,NaN,67.59763697559146,91.9978492781662,-0.016326472968003936,0.5156567893414916,0.5319832623094956,546605480,555226481.4,63.813858271699246,82.38397579906287,NaN,NaN,48.049944652472156,47.368877936074576
2012-03-30T09:30:00-04:00,30.35001,30.38,30.07001,30.16,8007211,9232820.15,67.65370372897681,74.44753179254629,NaN,NaN,64.48171455530982,89.9210242320971,-0.03579229365487624,0.48724289524090025,0.5230351888957765,538598269,552329681.4,60.874203072291024,80.87068721111189,NaN,NaN,46.29855236819807,47.21597428352079
2012-04-02T09:30:00-04:00,30.14999,30.52,30.09,30.48,16407977,9690912.55,72.59423967854487,74.22387074368359,NaN,NaN,82.70512097879553,84.0721154320559,-0.030463561325328903,0.48495573723911534,0.5154192985644442,555006246,550276930,58.806862958756874,78.98891881859139,NaN,NaN,46.1384599896229,47.0620436701068
2012-04-03T09:30:00-04:00,30.53,30.62,30.3,30.46001,6776379,9327888.55,71.85589456784504,73.87357031442271,NaN,NaN,99.95199060309052,81.17169592862521,-0.03150135937239207,0.4760425993489541,0.5075439587213462,548229867,548156493.4,56.666066736473574,76.78272254361362,NaN,NaN,45.79479050220333,46.88100750326345
2012-04-04T09:30:00-04:00,30.21001,30.23,29.91,30.10001,9209727,9248829,60.01711925085419,72.62401345883579,NaN,NaN,25.784832248558825,68.10425907226924,-0.05810201813538374,0.4349164360521165,0.49301845418750023,539020140,545492000.4,54.00558683842968,74.24342006954738,NaN,NaN,41.678372353304795,46.137773910412214
2012-04-05T09:30:00-04:00,30,30.2,29.97,30.17,5059844,9138880,61.35035830280468,71.72245000083178,NaN,NaN,25.31131372566183,59.646994422283306,-0.07175714875523409,0.4033220182434576,0.4750791669986917,544079984,544986901.2,53.49286764700322,71.58478231097392,NaN,NaN,38.740615220282095,45.08103695467934
2012-04-09T09:30:00-04:00,29.8,30.1084,29.78,29.96001,6889859,9165084.1,55.38330252866958,70.22823160363981,NaN,NaN,-35.30200705532198,39.69025010015696,-0.09428656907906996,0.35722095564985423,0.4515075247289242,537190125,544705272.4,53.189650964418654,68.82909953703718,NaN,NaN,34.2980424416344,43.54060916710149
2012-04-10T09:30:00-04:00,29.97,30.09,29.47,29.535,14372953,9587392.1,45.6959349362867,68.11277828145862,NaN,NaN,-142.33940118427682,-5.31865433245751,-0.1347043687352592,0.2831270638098502,0.4178314325451094,522817172,538267457.6,46.676362493273395,65.57855262707783,NaN,NaN,26.80503503133911,41.14981286199258
2012-04-11T09:30:00-04:00,29.78,29.856,29.64,29.71001,9306547,9102117.05,49.60491547087356,66.30150372750093,NaN,NaN,-132.92006385489782,-51.89306522405518,-0.14561659700812501,0.23581068628495316,0.3814272832930782,532123719,535046228,43.78709849181311,62.171016024496154,NaN,NaN,22.017175910108225,38.416579011723385
2012-04-12T09:30:00-04:00,29.78,30.11,29.75,30.075,9069410,8918498.9,56.61847887133644,65.17199676452826,NaN,NaN,-44.106953461281165,-65.87142236602317,-0.12500729826629986,0.22516816046020338,0.35017545872650324,541193129,535480825.8,44.28815680886309,59.222376336275374,NaN,NaN,20.34214266246463,35.834516676114994
2012-04-13T09:30:00-04:00,30,30,29.58,29.61,10530355,8822412.15,47.54081948039334,63.407517392926295,NaN,NaN,-127.17380690497201,-96.36844649214996,-0.13840439643331814,0.17716996318485556,0.3155743596181737,530662774,532797383.8,41.810037548771646,56.49564426670853,NaN,NaN,15.463694592999808,32.924399235669966
2012-04-16T09:30:00-04:00,29.78,29.78999,29.25,29.3,20488912,9372915.15,42.633340247534505,60.89810215410911,NaN,NaN,-197.85511923220676,-128.8790689275269,-0.1622065578383019,0.11281616232029634,0.27502272015859824,510173862,527394131.2,37.28598204316288,53.77002561674092,NaN,NaN,9.676444340255461,29.603262822039323
2012-04-17T09:30:00-04:00,29.39999,29.985,29.39,29.94,10269047,9439772.75,53.34171460963382,59.18015818766393,NaN,NaN,-82.79766032236611,-116.97072075514475,-0.13028618048610582,0.11216499455096596,0.24245117503707178,520442909,526919278.6,36.90801297133621,51.33869972850851,NaN,NaN,8.940367395878623,26.65142061830208
2012-04-18T09:30:00-04:00,29.77,29.8483,29.62,29.69,7106305,9509283.5,49.45801706501726,57.481719492497895,NaN,NaN,-88.47644423202078,-108.08199683056935,-0.12161408653081185,0.09043356687355697,0.21204765340436882,513336604,523161855.6,33.973307879872536,48.96986105186893,NaN,NaN,6.887986778386818,23.828072926885614
2012-04-19T09:30:00-04:00,29.62,29.89,29.22,29.39,19234816,10029778,45.20469828797373,55.63946693048179,NaN,NaN,-131.46105298440807,-125.55281673519474,-0.13088187179736782,0.04844531365765903,0.17932718545502685,494101788,513743587.4,27.969871422118587,46.409576276898875,NaN,NaN,3.6777210584533404,20.94945123139529
2012-04-20T09:30:00-04:00,29.50999,29.63,29.25,29.28,11625473,10235930.75,43.72003540201645,53.92991919284176,NaN,NaN,-138.42205720363796,-127.80246679492794,-0.1384845308031435,0.006221521951097486,0.14470605275424098,482476315,504106295.6,23.41105848529324,43.73363737782761,NaN,NaN,0.7100613206199672,18.058109815570244
2012-04-23T09:30:00-04:00,29.05,29.13,28.8,29.05,15530219,10536864.55,40.70939581296631,51.652430345300445,NaN,NaN,-186.72482351079978,-125.57640765064653,-0.1519874623795145,-0.04527827522015215,0.10670918715936234,466946096,495460742.4,20.2261498099477,40.97787215291266,NaN,NaN,-2.7125207411970917,15.090876878889196
2012-04-24T09:30:00-04:00,29.02,29.2,28.8801,28.99001,9625117,10408733.7,39.936913629602316,49.37250313542596,NaN,NaN,-156.01735412082854,-140.220346410339,-0.15728467331378382,-0.08989665448286743,0.06738801883091639,457320979,482836356.4,16.661666861762768,38.120415019004746,NaN,NaN,-5.633476954332584,12.130254902714656
2012-04-25T09:30:00-04:00,29.62,29.83501,29.62,29.80499,14355145,10804593.3,52.98820348323582,48.87043772345322,NaN,NaN,-13.856283429852422,-125.29631424990535,-0.10096398407396645,-0.05881696126154168,0.04214702281242477,471676124,474504260.4,14.806950019062256,35.32051238904993,NaN,NaN,-3.62726170909831,9.87918110102709
2012-04-26T09:30:00-04:00,29.8,30.10001,29.8,30.03999,9477547,10953998.4,55.95986939767611,48.48540280165832,NaN,NaN,38.0941591785611,-91.38527181731152,-0.045757663655961525,-0.01505005675752713,0.03070760689843439,481153671,471914637,14.275080899128852,32.519241907058905,NaN,NaN,-0.9832320148789656,8.327407798754797
2012-04-27T09:30:00-04:00,30.08,30.13,29.91,30.03,5570043,10945644.3,55.798397417847774,48.51505243659962,NaN,NaN,50.773510459331845,-53.546158284717556,-0.009674213054375401,0.018614840580465142,0.028289053634840543,475583628,470536099.6,13.987054653624696,29.71905645628791,NaN,NaN,0.9787744463108884,7.277603034119952
2012-04-30T09:30:00-04:00,29.99001,30.00999,29.78,29.82001,10061770,11048372.25,52.37718203726655,48.9922843723839,NaN,NaN,21.648166965775527,-11.87156018940249,-0.00020964416287154106,0.028026998431251116,0.028236642594122657,465521858,470251252,13.92453552768356,27.37964024446006,NaN,NaN,1.5121373142432724,6.453965074137569
2012-05-01T09:30:00-04:00,29.8,30.22,29.75999,29.92,11677980,10811872.4,53.8288653209876,49.29399507596348,NaN,NaN,53.191463479429615,29.970203330649134,0.011857254277089758,0.043058210440484856,0.031200956163395098,477199838,474227023.8,19.34353814121063,25.633671647988457,NaN,NaN,2.3894645929792473,5.873322148257809
2012-05-02T09:30:00-04:00,29.75999,29.95,29.69,29.94,6421242,10794115.55,54.13005708777945,49.11625066285226,NaN,NaN,37.4130999288924,40.2240800023981,0.019790875696947312,0.05593955078457924,0.03614867508763193,483621080,476616015,22.50083063970591,24.077434064477227,NaN,NaN,3.1823680753369006,5.488900137840536
2012-05-03T09:30:00-04:00,29.99001,30,29.61,29.69,9198980,10793578.2,49.76036530743001,49.27478965049773,NaN,NaN,15.944994328201854,35.794247032326254,0.007442068971203447,0.04545126130163624,0.03800919233043279,474422100,475269700.8,21.978682346307124,22.660908692872624,NaN,NaN,2.597880529827843,5.075897336695866
2012-05-04T09:30:00-04:00,29.42999,29.48,29.06,29.07001,12093879,11145279.95,40.93493676574459,49.15347511608417,NaN,NaN,-126.20800021450252,0.39794489755938117,-0.04060088534273067,-0.012741914347980554,0.02785897099475012,462328221,472618619.4,20.94783179010284,21.493897960511195,NaN,NaN,-0.8394618103725682,4.230846029971804
2012-05-07T09:30:00-04:00,28.89,29.13901,28.84,28.99001,8086684,11205121.2,39.950330478172255,48.196947678122626,NaN,NaN,-150.2676332069815,-33.98521513699202,-0.07394431088672528,-0.06457141761365648,0.009372893273068797,454241537,470362555.2,20.084518252344466,20.2922197662975,NaN,NaN,-3.888260016688515,3.0709737375917587
2012-05-08T09:30:00-04:00,28.84,28.97,28.52,28.88499,10174902,10995218.65,38.636518617442334,47.42398350329585,NaN,NaN,-160.03076551537734,-76.62966093595341,-0.09775462301731325,-0.11282038549857276,-0.015065762481259515,444066635,463735914.6,17.768193751515057,19.134711614271964,NaN,NaN,-6.776802614316881,1.6641485444619533
2012-05-09T09:30:00-04:00,28.59,29.03,28.48,28.89,10463508,11053066.7,38.74001854796442,46.96222066472376,NaN,NaN,-134.21416739853407,-110.9551144014387,-0.10709692833147585,-0.14893692289560434,-0.041839994564128485,454530143,457917727.2,16.021125121221218,18.281229735636437,NaN,NaN,-9.078352938867669,0.12950547541486435
2012-05-10T09:30:00-04:00,28.92999,28.95,28.61,28.67,8644340,11031813.2,35.87827165719962,46.40209468295113,NaN,NaN,-126.25867448690978,-139.39584816446103,-0.12099674515544041,-0.193085926008429,-0.07208918085298859,445885803,452210467.8,14.513594131811402,17.645696567530592,NaN,NaN,-11.90894341021404,-1.590272936817836
2012-05-11T09:30:00-04:00,28.61,29,28.57001,28.69,7161410,10863365.95,36.338675630239045,46.089900384184894,NaN,NaN,-108.7444593588367,-135.90313999332787,-0.1214324551602339,-0.22387974980328096,-0.10244729464304705,453047213,450354266.2,14.050522759639051,17.2045803496514,NaN,NaN,-14.110096453794654,-3.37881915352881
2012-05-14T09:30:00-04:00,28.49001,28.658,28.39999,28.44,14054438,10541642.25,33.13589465513549,45.60411331458012,NaN,NaN,-128.0858230800355,-131.46677796793867,-0.13036028331763594,-0.265397648790092,-0.13503736547245604,438992775,447304513.8,13.299697549723788,16.96443968450576,NaN,NaN,-16.980502659796013,-5.3219167972812675
2012-05-15T09:30:00-04:00,28.50999,28.7,28.3,28.36,8441598,10450269.8,32.15911436732489,44.116321234872196,NaN,NaN,-118.4296125900624,-123.14654738287568,-0.13299667480502278,-0.3012832089787345,-0.16828653417371173,430551177,444601422.2,12.654246207817238,16.810675126559683,NaN,NaN,-19.665003220134516,-7.37092914340316
2012-05-16T09:30:00-04:00,28.49001,28.50999,28.10001,28.13,12809977,10735453.4,29.469480309955458,42.22415058574929,NaN,NaN,-130.23045968884568,-122.349805840938,-0.14082103492313386,-0.34431282782762906,-0.2034917929044952,417741200,437243633.6,11.078221525418584,16.582328028437523,NaN,NaN,-22.810879458851076,-9.576636331324291
2012-05-17T09:30:00-04:00,28.17,28.21899,27.72,27.73,11276297,10337527.45,25.478498213438172,40.058443499720035,NaN,NaN,-153.7690203363453,-127.8518750108251,-0.16201499061003966,-0.4060105311670448,-0.24399554055700512,406464903,429359453.6,9.686121179899828,16.275118494600033,NaN,NaN,-26.931833247987864,-12.055950176561945
2012-05-18T09:30:00-04:00,27.84,27.92999,27.41,27.47,12598098,10386158.7,23.272299440830764,37.979523314260334,NaN,NaN,-163.5676639599754,-138.81651593105283,-0.18117398973856513,-0.47046302773021154,-0.2892890379916464,393866805,417523372,8.050572845342415,15.855549731575667,NaN,NaN,-31.173595415049014,-14.787042353488669
2012-05-21T09:30:00-04:00,27.53,28.16,27.47,28.14999,8553133,10037304.4,38.31607024658845,36.87146652323181,NaN,NaN,-112.87107029704097,-135.77356537445394,-0.13765227314458245,-0.46135437942237445,-0.323702106277792,402419938,410208804.6,7.237267731738612,14.990816130899093,NaN,NaN,-29.96426375612229,-16.955216839579187
2012-05-22T09:30:00-04:00,28.24001,28.315,27.89999,28.06,7814277,9946762.4,37.27449021131066,35.667497460626905,NaN,NaN,-85.59752673602792,-129.20714820364702,-0.10594956597470911,-0.4561390637461784,-0.3501894977714693,394605661,403019701.4,6.538147037780419,13.850624445047272,NaN,NaN,-29.35488899599562,-18.726598576210105
2012-05-23T09:30:00-04:00,27.85001,28.17,27.59,28.09,8718645,9664937.4,37.880737298187725,34.81895260282389,NaN,NaN,-91.63718398877045,-121.48849306363199,-0.07541773126195994,-0.4444616618489192,-0.3690439305869593,403324306,400136322.6,6.276273829957319,12.729023836736573,NaN,NaN,-28.68647955377897,-20.1494387158628
2012-05-24T09:30:00-04:00,28.17,28.17999,27.72,27.92999,8300324,9606076.25,35.888368487916196,34.45848344012186,NaN,NaN,-86.58899924758227,-108.05248884587938,-0.05917440798588325,-0.44301194056931337,-0.3838375325834301,395023982,397848138.4,6.0685458549111075,11.666217698508593,NaN,NaN,-28.723861657477144,-21.374356278950565
2012-05-25T09:30:00-04:00,27.91,27.98,27.80991,27.87,5005160,9577832.1,35.142099431338195,34.11503836534799,NaN,NaN,-84.33968460702724,-92.20689297528975,-0.04622043553020305,-0.4416130769961839,-0.39539264146598085,390018822,397078541.8,5.996657394510464,10.65994192294902,NaN,NaN,-28.968666233866465,-22.45925770108141
2012-05-29T09:30:00-04:00,28.16,28.36,28.03799,28.24001,7334133,9441450.25,43.013196992095175,34.42765824925177,NaN,NaN,-43.101762568113195,-78.25303142950419,-0.008460291921378704,-0.40596800636770425,-0.39750771444632554,397352955,396065145.2,5.897585655139238,9.81204134463646,NaN,NaN,-26.765475008035516,-23.074431602074853
2012-05-30T09:30:00-04:00,27.99001,28.14999,27.89999,28.06,5551496,9135126.05,40.44179104795797,34.549213427822735,NaN,NaN,-58.66013918602508,-72.86555391950363,0.0077867213308212,-0.38777431278279906,-0.39556103411362026,391801459,395504304.8,5.840080875570834,9.084823898518579,NaN,NaN,-25.681508541591587,-23.44687116486296
2012-05-31T09:30:00-04:00,28.00999,28.11,27.72501,27.92999,11922082,9410168.05,38.644883501419656,34.74682855955273,NaN,NaN,-68.2378824785035,-68.18569361745023,0.01287116165036728,-0.3794720820506612,-0.39234324370102847,379879377,390815319,5.368748715557814,8.431620654500463,NaN,NaN,-25.30635003355823,-23.712511003247997
2012-06-01T09:30:00-04:00,27.45,27.61,27.2,27.2,12014371,9550937.6,30.460927133517302,34.32698938121546,NaN,NaN,-149.97220982311484,-80.86233573255674,-0.027626075170780307,-0.4268758376645039,-0.39924976249372357,367865006,385383523.8,4.877650821196966,7.776415516040315,NaN,NaN,-27.722023629950293,-24.285298521348324
2012-06-04T09:30:00-04:00,27.28999,27.42,27.03999,27.36,7853246,9338905.95,33.77150599466903,34.37239019118215,NaN,NaN,-149.6732119959653,-93.92904121034435,-0.037710044052634006,-0.4463873175595161,-0.4086772735068821,375718252,382523409.8,4.637121455455457,7.157660080735433,NaN,NaN,-28.56780643536851,-24.89708536620835
2012-06-05T09:30:00-04:00,27.28999,27.56,27.25999,27.52499,7134098,9291276.65,37.09709130321416,34.725102829459956,NaN,NaN,-113.2944757989014,-107.96758385650199,-0.02779854852048791,-0.443425459157492,-0.4156269106370041,382852350,379623288.8,4.400177801042105,6.568083765965781,NaN,NaN,-28.19121196971149,-25.367674880994514
2012-06-06T09:30:00-04:00,27.72,28.19,27.71001,28.155,8870246,9226043.85,47.86285746296288,36.03891548324621,NaN,NaN,-6.577409117468097,-97.55103784279059,0.023865988299703045,-0.3857944252623753,-0.40966041356207833,391722596,379607516.2,4.398861337797001,6.0909866097070955,NaN,NaN,-24.070741443311043,-25.18239867561116
2012-06-07T09:30:00-04:00,28.42999,28.44,28,28.02,6681145,9036925.7,46.04432388938807,37.507903031528336,NaN,NaN,29.605993703150038,-77.9822626064599,0.050116635704622214,-0.3470146189313006,-0.3971312546359228,385041451,380639931,6.373434458589543,5.854366129613504,NaN,NaN,-21.418073896294008,-24.644637992851568
2012-06-08T09:30:00-04:00,28,28.345,27.922,28.33,7605172,8984967.3,50.67849074631736,39.46548812477738,NaN,NaN,50.27380123960031,-37.93306039391689,0.08734688170733296,-0.2879476525017566,-0.37529453420908954,392646623,385596254.4,15.406539210445843,6.379792298549461,NaN,NaN,-17.648604532376343,-23.645204641355107
2012-06-11T09:30:00-04:00,28.56,28.58,27.88,27.92999,13558691,9304831.35,45.274862024273965,39.962544680326346,NaN,NaN,46.34265693827775,1.2701133929317237,0.08399699568639385,-0.27029828960109725,-0.3542952852874911,379087932,386270190.4,16.585028560748057,7.047489500621566,NaN,NaN,-16.25459074400127,-22.589402656018844
2012-06-12T09:30:00-04:00,27.99001,28.24001,27.8299,28.21001,8009332,9002576.05,49.34654354194641,40.82483420394318,NaN,NaN,45.41932457143252,33.012873466998506,0.0985943554233864,-0.2310523410082581,-0.3296466964316445,387097264,387119173.2,18.13229954245024,7.8756432509551235,NaN,NaN,-13.74399347176461,-21.325772772553954
2012-06-13T09:30:00-04:00,28.17,28.31,27.96001,28.03999,11354438,9148218.05,47.057211595947564,41.48029665378317,NaN,NaN,57.09504594166583,45.7473644788253,0.09473026548301344,-0.21123386457787774,-0.3059641300608912,375742826,383923219.2,16.864142738656554,8.631919601576499,NaN,NaN,-12.45397070492146,-20.058372477177883
2012-06-14T09:30:00-04:00,28.06,28.28,27.88,28.17999,10581121,9036775.25,49.14921505777067,42.42749998020135,NaN,NaN,63.63522535920086,52.553210810035466,0.09906630122211901,-0.18213125353324244,-0.28119755475536146,386323947,384179718.4,17.363672373966182,9.438714352937577,NaN,NaN,-10.754567400157175,-18.729257466174925
2012-06-15T09:30:00-04:00,28.17999,28.44,28.14,28.37,14601695,9203045.15,51.9257383205782,43.62633132943278,NaN,NaN,116.42719591025333,65.78388974416607,0.1112804439438656,-0.14209699982552948,-0.2533774437693951,400925642,385835522.2,20.677111109410845,10.487318189716175,NaN,NaN,-8.488551391523329,-17.26629945551041
2012-06-18T09:30:00-04:00,28.28,28.6888,28.2375,28.58,8650477,9005664.1,54.85932689936041,44.47248346566601,NaN,NaN,159.07009843821317,88.32937804415316,0.12881423041189644,-0.09235965575452454,-0.22117388616642097,409576119,391933159.6,31.560240975554237,12.320364998317245,NaN,NaN,-5.687895835099692,-15.612241795451736
2012-06-19T09:30:00-04:00,28.73,28.9201,28.7,28.8,6555906,8905802.75,57.766881026647745,45.70998989271528,NaN,NaN,213.37669921844102,121.92085297355486,0.14910769941223984,-0.03478926190112119,-0.18389696131336103,416132025,397740111.8,40.00251891101256,14.760539143705941,NaN,NaN,-2.433712841202772,-13.729594801987599
2012-06-20T09:30:00-04:00,28.84,28.94,28.62,28.85001,9480910,8989134.4,58.42247844124217,47.12267524555974,NaN,NaN,179.8101393670884,146.46387165863936,0.15887885550082417,0.01470160806266918,-0.144177247438155,425612935,407714133.6,51.14886613623421,18.030547530897113,NaN,NaN,0.4069445008610854,-11.71008918729493
2012-06-21T09:30:00-04:00,28.83,28.87,28.13,28.16499,6173859,8861895.1,47.537012132671684,48.34239560264219,NaN,NaN,72.12136741794401,148.16110007038802,0.11427259507368934,-0.0013365035960433147,-0.11560909866973265,419439076,414337159.4,56.87777051952567,21.744841795063447,NaN,NaN,-0.38271848630984606,-10.091893372868489
2012-06-22T09:30:00-04:00,28.27,28.50999,28.21001,28.48,14264273,9160092.55,51.96896168919763,49.6422138665371,NaN,NaN,68.58079954415547,138.59182079716842,0.1014810853084979,0.011242257965889735,-0.09023882734260817,433703349,420892700.8,61.66936190500288,25.818573255745406,NaN,NaN,0.38746929388417833,-8.594841563332393
2012-06-25T09:30:00-04:00,28.22,28.22,27.85001,27.89999,5464387,9183053.9,44.51269400004988,50.17189977345394,NaN,NaN,-29.24098686767855,100.92960373599007,0.05195161559191076,-0.02529930785271972,-0.07725092344463048,428238962,424625269.4,64.11438454694434,30.08387373759559,NaN,NaN,-1.509855696573131,-7.582700725223927
2012-06-26T09:30:00-04:00,27.98,28.08,27.81149,28.00999,5620410,9097367.75,46.092375503917474,50.04543677637927,NaN,NaN,-31.47586372497269,51.95909114730735,0.02590833892661816,-0.04486549978635779,-0.07077383871297595,433859372,428170738.8,66.3125273004137,34.506278449211074,NaN,NaN,-2.4888972546111323,-6.855014515136385
2012-06-27T09:30:00-04:00,28.13,28.25999,28.06,28.17999,7437609,9191673.4,48.53109441900866,50.22306324278073,NaN,NaN,14.268897989402738,18.850842871770215,0.01972099414390592,-0.046122596033093544,-0.06584359017699946,441296981,431307548,68.17019697015633,38.92033291432298,NaN,NaN,-2.5190306872986663,-6.235588254016711
2012-06-28T09:30:00-04:00,27.99001,28.03,27.63,27.95,10552320,9123185.3,45.530166876415805,49.85532582350205,NaN,NaN,-55.015713664401105,-6.5765733446988035,0.0007319381442496831,-0.06492866749668735,-0.06566060564093704,430744661,433568665,69.4768175320652,42.782495651581506,NaN,NaN,-3.481429055129228,-5.842136939889928
2012-06-29T09:30:00-04:00,28.42999,28.77,28.36,28.72501,8999664,8972449.95,55.51295812194537,50.58661840190716,NaN,NaN,111.59475606324945,2.026217959119987,0.038849539159273604,-0.01709868169184503,-0.055948220851118634,439744325,434776860.2,70.18119352841616,46.610793149272084,NaN,NaN,-0.9427998070297334,-5.142231635195614
2012-07-02T09:30:00-04:00,28.81,28.89999,28.67,28.89,8471391,9003357.2,57.306821776507185,51.15520970437579,NaN,NaN,142.2854371736857,36.33150276739283,0.0717437015794964,0.03373140612325187,-0.03801229545624453,448215716,438772211,72.44566649320733,50.49031936004045,NaN,NaN,1.6638775329711208,-4.169930325457509
2012-07-03T09:30:00-04:00,28.87,29.12,28.85001,29.12,3426557,8817980.15,59.74375728854306,52.06139153956117,NaN,NaN,169.62365080810906,76.55140567400917,0.10362481545085417,0.09151872385732318,-0.012106091593530988,451642273,442328791.2,74.3155298348744,54.59398986691315,NaN,NaN,4.58294918156126,-2.9195189673119706
2012-07-05T09:30:00-04:00,29.05,29.2699,28.92999,29.12,7064598,8727697.75,59.743757288543065,52.81814455604492,NaN,NaN,158.27370675194214,105.35236742651705,0.11828546485399216,0.13575073947395921,0.017465274619967053,451642273,444397849.6,75.36297904978305,58.73679748661436,NaN,NaN,6.879914385747813,-1.5195999168748588
2012-07-06T09:30:00-04:00,28.92999,28.92999,28.49001,28.69,6902152,8738748.1,53.163955345407594,52.90658862924702,NaN,NaN,63.057931701080996,128.9670964996135,0.09367293333431395,0.13455644128785949,0.04088350795354554,444740121,447196941.6,76.74467920529422,62.74162377917746,NaN,NaN,6.860533993326849,-0.3224379297031863
2012-07-09T09:30:00-04:00,28.62,28.69,28.46001,28.63,7319695,8724474.25,52.29843660873112,52.72366789420206,NaN,NaN,35.403591174981564,113.7288635219599,0.06913399848208954,0.12730100605615746,0.058167007574067925,437420426,446732161.8,75.98267920452388,65.91465508124672,NaN,NaN,6.587256605708397,0.6646612896413255
2012-07-10T09:30:00-04:00,28.74001,28.84,28.21001,28.31,7290047,8411042.05,47.82635345913486,52.01363021080829,NaN,NaN,2.4422121426406243,85.76021851575089,0.029177401149333607,0.09463875901073493,0.06546135786140132,430130379,443115094.4,70.14553070452762,68.06772735221207,NaN,NaN,4.993179074581496,1.283020973204207
2012-07-11T09:30:00-04:00,28.28999,28.36,27.95,28.17999,7842004,8402675.65,46.10151730821189,51.13356155844899,NaN,NaN,-63.20952844491814,39.193582665145435,-0.00628988072961606,0.05759900694938125,0.06388888767899731,422288375,437244314.8,61.841482025896,68.83148563004507,NaN,NaN,3.1629291358428415,1.5515792821525833
2012-07-12T09:30:00-04:00,27.98,28.02,27.67,27.89999,9757820,8322844.75,42.54295794010515,50.77684340183709,NaN,NaN,-122.71440589566723,-17.004039864376438,-0.04664176861712828,0.005586676907586963,0.05222844552471524,412530555,429421971.2,52.86185893637922,68.54463480267746,NaN,NaN,0.5124736777075994,1.4031356243747286
2012-07-13T09:30:00-04:00,27.96001,28.34,27.95,28.27,6889625,8138269.95,48.22989186259242,50.50976698565101,NaN,NaN,-54.59534473657403,-40.53469515190746,-0.04635149459540738,-0.005710922719543987,0.040640571875863396,419420180,424357983,48.00246366793302,67.5684277857439,NaN,NaN,-0.09159084621941484,1.189603271432708
2012-07-16T09:30:00-04:00,28.27,28.3772,28.17999,28.24001,4710234,7643696.9,47.816784464027414,50.745773447363696,NaN,NaN,-36.52534673309453,-54.92048273352268,-0.04602413859731027,-0.016889601370774443,0.029134537226535827,414709946,419815887,44.087700031453814,66.13795032035172,NaN,NaN,-0.6987295755036482,0.9198414361560858
2012-07-17T09:30:00-04:00,28.42,28.44,28,28.35001,8381855,7630265.8,49.52454825874416,50.99092864413702,NaN,NaN,-34.021840431230764,-62.21329324829694,-0.036651967797749055,-0.016680422520650495,0.01997154527709856,423091801,418408171.4,42.9194404094658,64.46701554242686,NaN,NaN,-0.7263120769032744,0.6846766485761773
2012-07-18T09:30:00-04:00,28.35001,28.909,28.33,28.84,8130105,7708975.75,56.37353334813266,51.551102853360156,NaN,NaN,59.95573821609558,-37.5802399160942,0.002231624334717342,0.022761075695495236,0.020529451360777894,431221906,420194877.6,44.914616382463144,62.80590264330592,NaN,NaN,1.3278381601492895,0.7765568645151932
2012-07-19T09:30:00-04:00,29.02,29.19,28.98,29.09,9843449,7727102.7,59.40047749455098,52.541839326084094,NaN,NaN,135.5902763765977,14.08069653835879,0.042253374012865656,0.07334616887685996,0.031092794863994307,441065355,425901837.6,50.82692042121901,61.47376713538835,NaN,NaN,4.000302657455103,1.2370919777923233
2012-07-20T09:30:00-04:00,29.03999,29.07001,28.74001,28.755,15705211,8203670.3,53.994283439548596,52.43336256305576,NaN,NaN,78.17040544255786,40.63384657418517,0.043460855220246224,0.08541886388930209,0.041958008669055864,425360144,427089830.4,51.98227586965307,60.17384444547669,NaN,NaN,4.649592752715178,1.7245920884955883
2012-07-23T09:30:00-04:00,28.27,28.57851,28.05,28.48,6525137,7816713.5,49.97347129962441,51.90955181470698,NaN,NaN,-16.29528182871733,44.67985955506061,0.02400701049611484,0.07196677178919941,0.047959761293084574,418835007,427914842.6,52.81146940690067,58.77140179645479,NaN,NaN,3.9520897489743843,2.042806039992559
2012-07-24T09:30:00-04:00,28.49001,28.55499,28.00999,28.19,7876094,7937298.85,46.076762564051116,50.9333379058147,NaN,NaN,-43.25208650552028,42.8338103402027,-0.008389132149399646,0.037473346106335015,0.04586247825573466,410958913,425488265,50.07259012946248,57.03976324606822,NaN,NaN,2.138619953447943,2.056493741914757
2012-07-25T09:30:00-04:00,27.99001,28.25999,27.91499,28.08,8230543,8067805.5,44.65442620783042,49.85552854290666,NaN,NaN,-79.28645338166237,14.985372020651118,-0.0356926970521979,0.0012466069404872826,0.036939303992685184,402728370,419789557.8,44.26646580402107,54.818583728513794,NaN,NaN,0.2279968446954551,1.7952798994548567
2012-07-26T09:30:00-04:00,28.49001,28.63,28.35001,28.50999,7043914,8048120.75,51.01937650814187,49.70234434024483,NaN,NaN,1.6954417438826304,-11.793594905891895,-0.023830783734910894,0.007150824324046567,0.03098160805895746,409772284,413530943.6,38.9278008622116,52.117378132579326,NaN,NaN,0.5152014442883897,1.61241154871679
2012-07-27T09:30:00-04:00,28.67,29.17999,28.589,29.13,9139039,7977456.7,58.44104806902257,50.14110230169421,NaN,NaN,92.80306584898017,-8.867062824607437,0.024138419127590613,0.06115463196844573,0.037016212840855114,418911323,412241179.4,37.913041055942344,49.398118264823495,NaN,NaN,3.2801803885956895,1.8506642401280613
2012-07-30T09:30:00-04:00,29.17,29.36,29.08,29.14,8926453,7973796.15,58.55013845927687,50.9070869445615,NaN,NaN,124.53325205224343,19.29864395158471,0.053239917237879186,0.1035661093882041,0.05032619215032491,427837776,414041733.2,40.25451300994641,47.263045572353406,NaN,NaN,5.461991777478451,2.36656817403526
2012-07-31T09:30:00-04:00,29.22,29.42,29.2,29.25999,8740484,7987250.8,59.909978832295586,51.893405624853195,NaN,NaN,130.44963249288014,54.03898775126479,0.07588791522137028,0.14518608617703777,0.06929817095566748,436578260,419165602.6,46.44423868456193,46.16324247654383,NaN,NaN,7.656089533526515,3.122214082534011
2012-08-01T09:30:00-04:00,29.45,29.45,29.06,29.16,9120301,8271938,58.196579838302775,53.011521474724454,NaN,NaN,112.19992201104193,92.33626282980565,0.07909216527617798,0.16816337755088995,0.08907121227471197,427457959,424111520.4,51.6512126701115,46.076767743238996,NaN,NaN,8.966859241468061,3.957163390953161
2012-08-02T09:30:00-04:00,28.92,29.3,28.82001,28.97,6630352,8250225.7,54.978940074643866,53.49359634701384,NaN,NaN,78.68208726561474,107.73359193415209,0.06401698377103898,0.1690924419885107,0.10507545821747172,420827607,426322585,53.813119919485565,46.49181461834989,NaN,NaN,9.154232112738772,4.699601779779677
2012-08-03T09:30:00-04:00,29.47,29.63,29.34,29.53999,8188566,8314546.4,61.801996209222644,54.49254004309921,NaN,NaN,141.18519025937485,117.41001681623102,0.08662975329009054,0.2133626498300849,0.12673289653999437,429016173,428343555,55.760302774038365,47.32557195710593,NaN,NaN,11.472642573513928,5.667179036027427
2012-08-06T09:30:00-04:00,29.64999,29.88,29.6301,29.75,11320180,8514570.65,63.968704891341595,55.524265516856175,NaN,NaN,152.47733275895808,122.99883295757395,0.10850867227790989,0.2623687368873817,0.15386006460947182,440336353,430843270.4,58.112572820621274,48.41079570075989,NaN,NaN,14.074464663228007,6.868219839913224
2012-08-07T09:30:00-04:00,29.85001,30.07001,29.80499,29.95,7687324,8534434.5,65.94957973528153,56.20826883022395,NaN,NaN,152.48439917050746,127.40578629309941,0.12789457085528083,0.31372827817857285,0.18583370732329202,448023677,433132353.8,60.199554785858425,49.502577015288125,NaN,NaN,16.853903801691033,8.294746120167197
2012-08-08T09:30:00-04:00,29.89,30.03999,29.84,29.96001,8559199,8570294.25,66.05018098889559,56.683247651248564,NaN,NaN,136.15601115999132,132.1970041228893,0.13228543615399962,0.35119050251579154,0.2189050663617919,456582876,438957337.2,64.9809740968343,50.513580849260656,NaN,NaN,19.118277655931124,9.840964910990614
2012-08-09T09:30:00-04:00,30.0098,30.11,29.94,30.06,4393734,8302089.95,67.09595391701919,57.61908125678218,NaN,NaN,134.22306554372946,143.30519977851222,0.13248833680393096,0.3845154873667056,0.25202715056277464,460976610,446987137.8,70.28120561558276,51.8206472596842,NaN,NaN,21.3099032621303,11.47938467543914
2012-08-10T09:30:00-04:00,29.96001,30.14,29.89999,30.13,11433020,8529259.7,67.84275496992424,58.895458661803595,NaN,NaN,122.82676149765051,139.63351402616735,0.1278398065019133,0.41182690869016625,0.28398710218825296,472409630,455665829.2,74.7325078827603,53.3864357222456,NaN,NaN,23.35296918003367,13.17561103323836
2012-08-13T09:30:00-04:00,30.13,30.23,30.00999,30.22,5209164,8554206.2,68.82252840883315,60.52015622214516,NaN,NaN,120.3611283767414,133.21027314972403,0.12137915740481675,0.4357110489442739,0.3143318915394572,477618794,463122317.4,77.80801552993722,55.36753753656523,NaN,NaN,25.356058656186008,14.915674979373737
2012-08-14T09:30:00-04:00,30.31,30.32001,30.065,30.16,6332660,8451746.45,67.34928920279086,62.141217864642336,NaN,NaN,110.92954565260668,124.89930244614388,0.10427208803006877,0.4446720015770431,0.34039991354697435,471286134,467774808.8,79.48583219417591,57.88320656443343,NaN,NaN,26.677249498843565,16.59589991072657
2012-08-15T09:30:00-04:00,30.17,30.24001,30.12,30.17,5650770,8327779.7,67.47425848730508,63.3165665774397,NaN,NaN,97.65619859683292,117.19933993351219,0.08561840881198202,0.4474229245619519,0.36180451574996986,476936904,471845614.4,80.85008449070753,60.87765539504028,NaN,NaN,27.824441938711708,18.199977343295874
2012-08-16T09:30:00-04:00,30.33,30.63,30.28999,30.58,7173180,8194266.25,72.17637044731285,64.29766103303186,NaN,NaN,117.39004456594212,113.83273573795472,0.09230512504981919,0.47718592206224386,0.38488079701242467,484110084,476472309.2,82.2915262330864,64.04754719340771,NaN,NaN,30.227706937031364,19.91822442811523
2012-08-17T09:30:00-04:00,30.63,30.75999,30.60001,30.75,8135031,7815757.25,73.8635529302117,65.39147635238434,NaN,NaN,123.5729623077438,113.98197589997338,0.09899756015229016,0.5086277472027874,0.4096301870504972,492245115,480439406.2,83.44236674626869,67.1323938888593,NaN,NaN,32.7896787645696,21.757003619037285
2012-08-20T09:30:00-04:00,30.72,30.82001,30.6199,30.78,8096223,7894311.55,74.16131928705894,66.4094292420103,NaN,NaN,116.40826071622249,113.19140236786959,0.09618264282231803,0.5298584905783947,0.4336758477560767,500341338,484983915,84.6713258062983,69.86290011184046,NaN,NaN,35.00550619886161,23.649646844726472
2012-08-21T09:30:00-04:00,30.89999,30.96001,30.49001,30.58,10126352,8006824.45,68.55399981371966,67.14924495454008,NaN,NaN,103.62239055627133,111.72997134860252,0.0726589814167804,0.5244995745270522,0.4518405931102718,490214986,488769685.4,85.6282980975239,72.28983478522706,NaN,NaN,35.433345488849035,25.33303236531541
2012-08-22T09:30:00-04:00,30.50999,30.71001,30.39999,30.63,18549984,8522796.5,69.18135867104121,68.16370342571132,NaN,NaN,89.15413724071806,110.02955907737956,0.053177441059973074,0.5183123944352381,0.46513495337526506,508764970,495135298.6,87.08798420898836,74.66661080590585,NaN,NaN,35.959501590222345,26.851099397444973
2012-08-23T09:30:00-04:00,30.5,30.57001,30.31,30.38,7056855,8523443.55,62.47046932828955,68.21145150564466,NaN,NaN,65.66481262431691,99.68451268905451,0.017984177114667543,0.4876151747685995,0.46963099765393196,501708115,498654904.8,87.82433135457933,76.95689856165878,NaN,NaN,34.549554570038005,27.950878707815406
2012-08-24T09:30:00-04:00,30.28,30.62,30.21001,30.57001,6257406,8379361.9,65.23106917377868,68.3016203829616,NaN,NaN,67.16910617323644,88.40374146215304,0.002827418939825632,0.473165271328714,0.47033785238888837,507965521,501798986,88.45757381554954,79.12439863272508,NaN,NaN,34.081995256828385,28.826752500531544
2012-08-27T09:30:00-04:00,30.7,30.72,30.53999,30.60001,4823902,8174234.35,65.66055914317224,68.2809760549538,NaN,NaN,84.18725883180286,81.95954108526911,-0.009194211927985863,0.45884508747890607,0.46803929940689193,512789423,504288603,88.9477491041846,81.17784108403409,NaN,NaN,33.80964525168473,29.538594322124855
2012-08-28T09:30:00-04:00,30.57001,30.64,30.44,30.53,7866809,8130550.6,63.68353329795256,68.111929791315,NaN,NaN,65.39734105058191,74.31453118413124,-0.024982061071991246,0.43681172306690286,0.4617937841388941,504922614,507230128.6,89.51434651300305,82.93022482804612,NaN,NaN,33.04385629421393,30.039346032423293
2012-08-29T09:30:00-04:00,30.57001,30.67999,30.47,30.59,4791406,7914105.85,64.6654687946527,67.93832371114596,NaN,NaN,66.2247008653748,69.72864390906258,-0.0339490040839619,0.41935752903394174,0.45330653311790364,509714020,507419938.6,89.55156905817368,84.30667935965975,NaN,NaN,32.643725253776545,30.41140020690233
2012-08-30T09:30:00-04:00,30.45,30.49001,30.23,30.25,6021031,7883639.8,55.50669938564747,67.05717688369761,NaN,NaN,6.544492800270311,57.90457994425326,-0.06362036218500333,0.3737810803866495,0.4374014425716528,503692989,507816913.4,89.634445602046,85.37110348246588,NaN,NaN,29.60604028356615,30.296348789282874
2012-08-31T09:30:00-04:00,30.48,30.5899,30.17,30.49001,6610559,7804739.45,59.83167371371896,66.41497297690374,NaN,NaN,20.348402654125504,48.54043924043108,-0.06755353806606851,0.35295951998906716,0.42051305805513567,510303548,508284518.8,89.73770422882919,86.22322410381533,NaN,NaN,28.17574224512638,29.993404997260516
2012-09-04T09:30:00-04:00,30.46001,30.58,30.19,30.49001,6805879,7579024.4,59.83167371371896,65.87800044197003,NaN,NaN,14.159032688331049,34.53479401173671,-0.07031124569910518,0.3326240009312542,0.4029352466303594,510303548,507787343.8,88.72566459907955,86.883212132737,NaN,NaN,27.017056003712938,29.568212283896575
2012-09-05T09:30:00-04:00,30.47,30.61,30.39,30.46001,8789254,7634120.9,59.000284661135254,65.27271659724362,NaN,NaN,29.525051724542685,27.36033614652887,-0.07394190537893863,0.31050786490668614,0.38444977028562477,501514294,507105679.8,87.27239819365273,87.34194882580451,NaN,NaN,25.823878285628677,29.033307427001162
2012-09-06T09:30:00-04:00,30.67999,31.14999,30.64,31.14,7895336,7600927.75,69.38462097157867,65.07330592040546,NaN,NaN,185.0327120851267,51.12193839047925,-0.03245095761684319,0.34388607326457077,0.37633703088141396,509409630,507044801.8,87.13513188116157,87.68792065780988,NaN,NaN,28.000626791879927,28.885781621983842
2012-09-07T09:30:00-04:00,31.05,31.14999,30.9799,31.09,8003066,7781394.35,68.02038606458459,64.65593685857495,NaN,NaN,194.80133916416688,88.77330766325856,-0.011365978616869443,0.36212955761032717,0.3734955362271966,501406564,506587516.8,86.04041748703557,87.87349571072181,NaN,NaN,29.299080304551374,28.94482429092206
2012-09-10T09:30:00-04:00,31.03,31.12,30.75999,30.75999,6266125,7523049.6,59.67982514651534,63.6215444199647,NaN,NaN,116.13331903720956,107.93029093987539,-0.022020053629359326,0.34597046919049745,0.3679905228198568,495140439,503554895,78.95593251980772,87.46525333311534,NaN,NaN,27.701946657413128,28.76727034327793
2012-09-11T09:30:00-04:00,30.81,31,30.78999,30.84,5317156,7528449.2,60.93064359180457,63.077018975542195,NaN,NaN,103.88296335954672,125.87507707411851,-0.025792341917083128,0.33575009542350287,0.361542437340586,500457595,501585704.4,74.65728204457555,86.68160932933333,NaN,NaN,26.809241741440044,28.487551971586804
2012-09-12T09:30:00-04:00,30.97,31.0399,30.82001,31.00999,5191527,7471392.55,63.519992508359984,62.67263567820782,NaN,NaN,116.75915531050698,143.3218977913114,-0.019252410667835562,0.33747692400579155,0.3567293346736271,505649122,502412670,75.26628731607349,85.83720240841083,NaN,NaN,26.863668122719847,28.25556856460581
2012-09-13T09:30:00-04:00,31.03999,31.55,31.02,31.42999,8819418,7629824.95,68.98870210174044,63.13822373345432,NaN,NaN,206.6320052266434,147.64175641961472,0.009407120272811653,0.3684882350146417,0.35908111474183,514468540,503424452,76.02539520788977,84.99442125507585,NaN,NaN,28.746657589721213,28.325724139622295
2012-09-14T09:30:00-04:00,31.50999,31.72,31.48,31.58,10304070,7786369.45,70.67937197925986,63.527388219560116,NaN,NaN,223.52872860522888,153.3872343078271,0.03317683601853216,0.40055215976499525,0.3673753237464631,524772610,508097661.2,79.20063944093746,84.33321165688928,NaN,NaN,30.83189581986938,28.68374866537188
2012-09-17T09:30:00-04:00,31.60001,31.63,31.495,31.61,3815345,7570385.15,71.01964560691637,63.91018010982756,NaN,NaN,174.964378043242,165.1534461090336,0.04490128799952686,0.42350193374587164,0.3786006457463448,528587955,514787164.4,82.72720272192974,83.88888691529965,NaN,NaN,32.589658338365254,29.24173576151379
2012-09-18T09:30:00-04:00,31.53999,31.63,31.53,31.63,5308879,7431017.95,71.25911421836255,64.45129303271399,NaN,NaN,148.49596545651806,174.07604652842787,0.0477208711056229,0.4382517346283734,0.3905308635227505,533896834,521475012.2,85.39358561199833,83.59454685094218,NaN,NaN,34.07774891387936,29.9325947832803
2012-09-19T09:30:00-04:00,31.61,31.74001,31.55,31.66,17244848,7786942.75,71.63769827386204,64.94930942408608,NaN,NaN,135.98874643632524,177.9219647535915,0.04534065883133398,0.447206687061918,0.40186602823058404,551141682,530573524.2,88.08774099696642,83.48998770371308,NaN,NaN,35.410042677068745,30.715087339535792
2012-09-20T09:30:00-04:00,31.55,31.64,31.44,31.60001,7135137,7216200.4,69.66164704463759,65.96037711401395,NaN,NaN,105.46381926375668,157.68832756101418,0.03397979811002905,0.4443407758681204,0.4103609777580913,544006545,536481125.2,89.44860401184756,83.47671330441321,NaN,NaN,35.99964970648576,31.470024820528646
2012-09-21T09:30:00-04:00,31.61,31.7,31.45,31.50999,8968875,7311801.4,66.68891963215634,66.45018039390233,NaN,NaN,93.08474569917061,131.59953097980252,0.015591704740408052,0.42985060868360137,0.4142589039431933,535037670,538534137.2,89.88123040095913,83.48696517385106,NaN,NaN,35.70536283444115,32.075073108230434
2012-09-24T09:30:00-04:00,31.27,31.36,31.19,31.31,4681145,7232988.35,60.51090473766025,66.49869689561243,NaN,NaN,44.28765392543025,105.46418615624017,-0.013290552812751488,0.3976457129272539,0.4109362657400054,530356525,538887851.2,89.95762889464427,83.57496262353425,NaN,NaN,33.699606852414234,32.307149357399545
2012-09-25T09:30:00-04:00,31.38,31.41,30.86,30.87,5439750,7263780.75,49.61964734250204,65.82865137285292,NaN,NaN,1.777353326137166,76.120463730164,-0.06252287913841303,0.3327826668169891,0.3953055459554021,524916775,537091839.4,86.39092676498657,83.51200037862952,NaN,NaN,28.28590252316537,31.73268552393752
2012-09-26T09:30:00-04:00,30.811,30.83,30.48199,30.64999,7390973,7239988.95,45.23537983573855,64.10370557743576,NaN,NaN,-67.19744634780096,35.483225173338745,-0.1077476442739026,0.2606209906130239,0.3683686348869265,517525802,530368663.4,74.4853679018951,82.60844580868192,NaN,NaN,22.233625110716666,30.375676893477397
2012-09-27T09:30:00-04:00,30.69,31.11501,30.66,31.045,4848566,7242846.95,53.226278913899556,63.04698363810111,NaN,NaN,-21.735298705638385,10.04340157945973,-0.10859507249842232,0.2326247942638986,0.3412198667623209,522374368,526042228,67.99186506793708,81.31926349303203,NaN,NaN,19.504209461425113,28.822610117469928
2012-09-28T09:30:00-04:00,30.97,31.08009,30.78,30.825,8123348,7347962.8,48.942917736492134,62.28006168024232,NaN,NaN,-37.50928696989291,-16.07540495435297,-0.12058421337894293,0.19048960003864224,0.31107381341758517,514251020,521884898,62.36557692042061,80.13423809307581,NaN,NaN,15.795269757449276,26.961561494609835
2012-10-01T09:30:00-04:00,30.95,31.12,30.67999,30.75999,14927402,7763804.95,47.72081254468158,61.33650231973353,NaN,NaN,-52.47843322246638,-35.42862238393229,-0.12876233779625956,0.15012089117226068,0.27888322896852025,499323618,515678316.6,55.04261591406005,78.7331905123247,NaN,NaN,12.469997920756402,24.891338126916487
2012-10-02T09:30:00-04:00,30.89999,30.95,30.57001,30.8,7517691,7799395.55,48.57193487837893,60.268783917592025,NaN,NaN,-75.67719327279266,-50.919531703718256,-0.12712747366251956,0.1199738868903708,0.24710136055289036,506841309,512063223.4,51.2666469409992,77.01893048553367,NaN,NaN,10.065691569335769,22.77338861869067
2012-10-03T09:30:00-04:00,30.89999,31.03,30.75999,30.96001,5268637,7623364.7,51.9416651108341,59.05113841824157,NaN,NaN,-52.58929839512017,-47.99790211318209,-0.11147985180769587,0.10775154579327051,0.21923139760096638,512109946,510980052.2,50.15640396987729,75.1711453971042,NaN,NaN,9.041806323343243,20.81173400506961
2012-10-04T09:30:00-04:00,30.99001,31.11,30.85001,31.05,3962737,7426734.75,53.77606360836064,57.84375924889162,NaN,NaN,-33.451774488288684,-50.341197269712154,-0.0920840067678102,0.10412638914120365,0.19621039590901385,516072683,509719715.2,48.83128302239278,73.00190565292243,NaN,NaN,8.733017565799301,19.086203085173853
2012-10-05T09:30:00-04:00,31.19,31.22,30.8125,30.89,4578898,7255526.35,50.11346117273019,56.350460360735475,NaN,NaN,-38.41843199743249,-50.52302627522007,-0.08709950999745578,0.08733600841219413,0.1744355184096499,511493785,509168268.2,48.23086194871024,70.5378813119782,NaN,NaN,7.3907907605723855,17.41542989594507
2012-10-08T09:30:00-04:00,30.67,30.75999,30.52,30.57001,17581824,7821311.3,43.702692929815136,54.38214455441066,NaN,NaN,-111.43644995207755,-62.31462962114231,-0.10142073331791271,0.04765960176225903,0.14908033508017174,493911961,508085936.8,47.00911563978858,67.79613345682036,NaN,NaN,4.169856687458234,15.523205151875523
2012-10-09T09:30:00-04:00,30.50999,30.53,30.09,30.17999,15484656,8329686.3,37.419395724905876,51.93798008662806,NaN,NaN,-167.1955141093366,-80.6182937884511,-0.13132965841679473,-0.015081737940821682,0.11624792047597304,478427305,502403136,41.119455609300644,64.44125592912995,NaN,NaN,-0.8377922715485964,13.185919805672077
2012-10-10T09:30:00-04:00,30.19,30.24001,30,30.06,13485078,8744363.85,35.71798482360737,49.513432785125914,NaN,NaN,-174.06954705815252,-104.91434352105757,-0.15190876711311235,-0.07363803841541738,0.07827072869769496,464942227,492969592.2,33.594931668395986,60.45170790459769,NaN,NaN,-5.431449721189724,10.526295587548962
2012-10-11T09:30:00-04:00,30.28,30.28999,29.94,29.94,6899324,8648359.15,34.0505185910733,47.18211842504855,NaN,NaN,-160.25306345639913,-130.27460131467967,-0.16521574412206452,-0.12824895145488568,0.036966792667178824,458042903,481363636.2,27.03925984982068,55.96299572237351,NaN,NaN,-9.71434038027645,7.634776163573903
2012-10-12T09:30:00-04:00,29.95,30.10001,29.86,29.92,7138262,8490068.75,33.767572710012175,45.27188042307369,NaN,NaN,-157.01024189723543,-153.99296329464025,-0.16650878966809957,-0.17116919441794565,-0.004660404749846074,450904641,469245807.4,22.173907936506268,51.121301368220806,NaN,NaN,-13.22731282761089,4.654477736261791
2012-10-15T09:30:00-04:00,29.99001,30.10989,29.81,30.07001,5169102,8557756.6,37.933501027308786,44.437155686274174,NaN,NaN,-131.32273477995838,-157.97022026021642,-0.1489748038989684,-0.19087890962355658,-0.04190410572458818,456073743,461678163.8,19.780202363245422,46.36339248238215,NaN,NaN,-14.997192430912666,1.847096283808297
2012-10-16T09:30:00-04:00,30.11,30.50999,30.11,30.48,11225434,8853584.35,47.62899170662607,44.60812796276614,NaN,NaN,-65.02804501076555,-137.5367264405022,-0.10362870019734963,-0.17143998097127522,-0.06781128077392559,467299177,459452538.2,19.126266996679362,42.40917098915246,NaN,NaN,-13.503491783559102,-0.34584486867276
2012-10-17T09:30:00-04:00,30.23,30.41499,30.17,30.32001,10598426,8521263.25,44.69489309917696,43.99874326171452,NaN,NaN,-66.80484131343029,-116.08378529155777,-0.07936621872594156,-0.16701905418135254,-0.08765283545541099,456700751,457804243,18.63490799414285,38.88367405531001,NaN,NaN,-13.182346657470651,-2.17963083850103
2012-10-18T09:30:00-04:00,30.24001,30.35001,29.86,29.965,12251188,8777065.8,38.95966191759546,43.28565356036476,NaN,NaN,-96.5132187647154,-103.33581635322102,-0.08185525171248068,-0.18997190009601184,-0.10811664838353116,444449563,455085575,17.821660498905388,35.7019657394875,NaN,NaN,-14.786607431665827,-3.9806274946674294
2012-10-19T09:30:00-04:00,29.95,29.95,29.28999,29.28999,12846176,8970930.85,30.852960575330343,42.08080699112538,NaN,NaN,-163.9523809102423,-104.72424415582239,-0.12121622422160211,-0.2596369286605338,-0.13842070443893167,431603387,451225324.2,16.706770504213424,32.96369106735558,NaN,NaN,-19.309358052131163,-6.170446145733677
2012-10-22T09:30:00-04:00,29.28999,29.56,29.23,29.49001,6088883,9041317.75,35.158522090736156,41.12270607772233,NaN,NaN,-155.91604225466335,-109.6429056507634,-0.12550580021056165,-0.29530295470213375,-0.1697971544915721,437692270,447549029.6,15.699493408499492,30.42318010074846,NaN,NaN,-21.304304349341926,-8.332425889106283
2012-10-23T09:30:00-04:00,29.28999,29.45,29.13,29.17,10561957,9297428.1,31.752064498700264,39.6805917482842,NaN,NaN,-161.17712702642405,-128.87272205389507,-0.14048948425422078,-0.3454090098093481,-0.2049195255551273,427130313,439515256.8,13.74869712633837,27.82262961192426,NaN,NaN,-24.153843245615693,-10.592628368607627
2012-10-24T09:30:00-04:00,29.25999,29.34,28.95,29,6392203,9247489.6,30.084490585103282,37.98833653233725,NaN,NaN,-157.4662773443373,-147.0050092600765,-0.15149706686832437,-0.39429085914053275,-0.24279379227220838,420738110,432322728.6,12.27776598344046,25.211664109141946,NaN,NaN,-26.976483316227956,-12.933179075410532
2012-10-25T09:30:00-04:00,29.17999,29.22,28.83,28.94,5235871,9266854.85,29.495702675039425,36.51563949678791,NaN,NaN,-148.89108521308617,-157.48058254975064,-0.1520702349864288,-0.4328815860052444,-0.2808113510188156,415502239,426533263.8,11.23574997201429,22.569156110806517,NaN,NaN,-29.370944117924143,-15.281431224341048
2012-10-26T09:30:00-04:00,28.89999,29.12,28.72,28.99001,9692637,9345319.3,30.712894228117094,35.58779673238091,NaN,NaN,-138.5163743310157,-152.39338123390533,-0.13870608780401605,-0.45419396077383567,-0.3154878729698196,425194876,425251561.6,11.012911291959114,19.99799865739013,NaN,NaN,-30.908984499563825,-17.51393883508716
2012-10-31T09:30:00-04:00,28.98,29.02,28.78,28.8705,19434464,9570672.4,29.406371825747527,35.01543788244103,NaN,NaN,-126.2810894073906,-146.46639066445078,-0.1278091032193192,-0.4752492519939686,-0.3474401487746494,405760412,418865190,9.953606984363475,17.771866612751758,NaN,NaN,-32.57065417248622,-19.66489816900131
2012-11-01T09:30:00-04:00,29.02,29.37,28.96001,29.34,6269027,9508239.2,40.173623198129455,35.33369776633547,NaN,NaN,-76.91951182243822,-129.61486762365362,-0.08114918132773058,-0.4488766254343126,-0.36772744410658204,412029439,415845015.2,9.488779774767579,16.04999862034973,NaN,NaN,-30.617544860165502,-21.229561982024766
2012-11-02T09:30:00-04:00,29.42999,29.47,28.92999,28.96001,9134422,9701528.45,35.459573936545496,35.43434457672634,NaN,NaN,-78.87513025802535,-113.89663820639123,-0.0685472452202639,-0.45341150063191193,-0.38486425541164804,402895017,412276396.6,8.956543776416694,14.758376043678014,NaN,NaN,-30.471172271094105,-22.549792023320386
2012-11-05T09:30:00-05:00,28.98,29.19,28.91,29.12,6018148,9804299,38.72002045262919,35.78809084405612,NaN,NaN,-76.18059757226065,-99.35454067822613,-0.0433363139581201,-0.43903464785929813,-0.39569833390117803,408913165,410958581.8,8.761113382193656,13.800319289798539,NaN,NaN,-29.29251893789025,-23.513038725401795
2012-11-06T09:30:00-05:00,29.25,29.455,29.17999,29.25,6070332,9878870.7,41.31427692918776,36.029574837047484,NaN,NaN,-43.655710496386725,-80.38240791130032,-0.013359026998047419,-0.4123971176487373,-0.3990380906506899,414983497,408916306,8.453275972087894,12.991253119001575,NaN,NaN,-27.51719909683981,-24.085061635607225
2012-11-07T09:30:00-05:00,28.94,28.95,28.44,28.52,10098406,9504699.8,32.89324662212897,34.97702161672626,NaN,NaN,-121.8434904113191,-79.49488811208602,-0.036818482502145644,-0.44506119377837194,-0.4082427112762263,404885091,408741241.8,8.42594542198502,12.226944435094836,NaN,NaN,-28.773437325551548,-24.754829591313555
2012-11-08T09:30:00-05:00,28.61,28.7,28.10001,28.11,9463574,9203645.7,29.283078065300415,33.87617768573508,NaN,NaN,-153.07547009286867,-94.7260797661721,-0.07203570032772333,-0.49828733668588043,-0.4262516363581571,395421517,405419657.4,7.903799520381057,11.460436686968993,NaN,NaN,-31.109958362449802,-25.662705130047303
2012-11-09T09:30:00-05:00,28.09,28.52,28.07001,28.24001,14395398,9249161.7,31.83779027871995,33.36747256867255,NaN,NaN,-142.6856413298569,-107.48818198053841,-0.07814995046804174,-0.5239390744432093,-0.44578912397516757,409816915,406804037,10.396068317760154,10.930037245458621,NaN,NaN,-32.06637868318925,-26.57751563763901
2012-11-12T09:30:00-05:00,28.35001,28.39,28.10001,28.19501,5111992,9159795.1,31.414758686370902,33.40760100517544,NaN,NaN,-137.67641208058888,-119.78734488220407,-0.076693114985241,-0.5416555177067188,-0.4649624027214778,404704923,405962388.6,10.215078120339427,10.466344932324764,NaN,NaN,-32.9469945816446,-27.487441201068382
2012-11-13T09:30:00-05:00,27.99001,28.32001,27.91,28.06,10087906,9307277.3,30.12161653942026,33.0478220372243,NaN,NaN,-139.98873257429608,-139.05394929778595,-0.07613666823124099,-0.560133238010529,-0.48399656977928807,394617017,401889092.6,9.365296358799426,10.013902285917615,NaN,NaN,-34.062344350510564,-28.426713079560123
2012-11-14T09:30:00-05:00,28.19,28.25,27.72,27.77499,15250832,9811363.8,27.543999549932465,32.74724596945517,NaN,NaN,-146.49812847341815,-143.98487691020574,-0.08557285625224575,-0.5909626400945953,-0.5053897838423496,379366185,396785311.4,8.420116273230818,9.633289367838504,NaN,NaN,-35.81845291184637,-29.482675912743872
2012-11-15T09:30:00-05:00,27.8,27.91,27.53,27.62,8949480,9697566.1,26.22950592659278,32.471889922418704,NaN,NaN,-154.7482769979292,-144.31943829121786,-0.09228496309350809,-0.6207459877092347,-0.5284610246157266,370416705,391784349,7.6097022846498845,9.29985624649632,NaN,NaN,-37.67148200595868,-30.652505354631703
2012-11-16T09:30:00-05:00,27.64999,27.75999,27.21001,27.66,8672590,9601274.3,27.19518447321917,32.307567193717254,NaN,NaN,-148.5999845766846,-145.5023069405834,-0.08428366652766195,-0.6338156077753041,-0.5495319412476422,379089295,385638825,6.749939340251956,8.979441201370438,NaN,NaN,-38.896027031169425,-31.830151308422806
2012-11-19T09:30:00-05:00,28,28.44,27.98,28.41499,10976918,9537560.8,42.49597937562564,33.14921613282501,NaN,NaN,-52.307183261259524,-128.42846117671752,-0.021658643961883217,-0.5766052461999962,-0.554946602238113,390066213,382711083,6.380112875081878,8.648527028736352,NaN,NaN,-34.98940769256939,-32.281473649015176
2012-11-20T09:30:00-05:00,28.38,28.39,28.041,28.3,14619652,9626234.6,41.07990243932319,33.983039748080415,NaN,NaN,-50.36165107054376,-110.50304487596705,0.01644983791997423,-0.5343843048381451,-0.5508341427581194,375446561,378876991.8,5.922481150906464,8.360589469203706,NaN,NaN,-32.31358444419013,-32.28606090546874
2012-11-21T09:30:00-05:00,28.31,28.45,28.27,28.39,10099227,9826751.8,42.689582981521916,34.16275116117988,NaN,NaN,-28.293970868570636,-86.86221335499754,0.05023860787184398,-0.48803588291831446,-0.5382744907901584,385545788,380112912.4,8.208105786088979,8.269112755726665,NaN,NaN,-29.65826621753876,-31.910661664335883
2012-11-23T09:30:00-05:00,28.57001,28.87,28.53,28.85001,8285480,9712927.95,50.18125066197785,35.21429949871076,NaN,NaN,29.59968410405762,-49.992621134600164,0.10304727275816405,-0.40946539984245334,-0.5125126726006174,393831268,384795825,16.487190255285824,8.807016075645887,NaN,NaN,-24.844066338995237,-30.901148046430077
2012-11-26T09:30:00-05:00,28.8,28.98,28.69,28.97501,8069172,9796776.4,52.01678170067751,36.16406815928564,NaN,NaN,51.72968923665912,-9.926686371931423,0.14339450070278542,-0.3332695467221356,-0.476664047424921,401900440,389358054,23.706736246710264,9.874560565968503,NaN,NaN,-20.364126524360525,-29.395859257562996
2012-11-27T09:30:00-05:00,28.95,29.03999,28.78011,28.84869,10753313,10072648.5,50.011454765472166,36.78529514759167,NaN,NaN,54.38296387157452,11.41134305463538,0.15745059268752948,-0.2798508065655092,-0.4373013992530387,391147127,389574236.8,24.041825155102856,10.988028364755284,NaN,NaN,-17.2744315873426,-27.664226733245798
2012-11-28T09:30:00-05:00,28.66,29.03999,28.5,29.02,11266070,10151320.15,52.675972923124434,38.1983470262342,NaN,NaN,50.06282693261602,31.496238655267337,0.17292625596047156,-0.2211435793024492,-0.3940698352629208,402413197,394967564,32.059078479389626,12.676109297427043,NaN,NaN,-13.879097724266812,-25.694922589105943
2012-11-29T09:30:00-05:00,29.16,29.26199,29.03,29.16,13520355,9855614.7,54.796529989999584,40.020736449427,NaN,NaN,91.04512388931175,55.364057606843815,0.1860881542032521,-0.1614596425088557,-0.3475477967121078,415933552,401045116.8,39.77337404571418,14.95250747780798,NaN,NaN,-10.408381018327914,-23.511130936137654
2012-11-30T09:30:00-05:00,29.14999,29.2063,29.03,29.13,6301758,9857251.25,54.23569975302002,41.62058712616272,NaN,NaN,88.54032659092069,67.15218610421643,0.18583672550111696,-0.11525188983571155,-0.3010886153368285,409631794,404205222,43.373689780408085,17.30805186799712,NaN,NaN,-7.71553414741594,-21.25461710917741
2012-12-03T09:30:00-05:00,29.35001,29.3867,29.06,29.09,7906457,9795853,53.450190972229805,43.194546575152636,NaN,NaN,96.03158472870737,76.01256520262606,0.17612952751076838,-0.08092670594836804,-0.2570562334591364,401725337,404170201.4,43.3427672222036,19.674315375273128,NaN,NaN,-5.676216937871279,-19.029131370419393
2012-12-04T09:30:00-05:00,29.09,29.11,28.89,29.035,10661801,10028035.65,52.32794803037367,44.78071311022074,NaN,NaN,71.90892382484424,79.51775719328,0.15964580410049614,-0.05749897833351625,-0.2171447824340124,391063536,404153483.2,43.326886978965746,22.100143276713577,NaN,NaN,-4.2379094194696885,-16.916099663140862
2012-12-05T09:30:00-05:00,28.98,28.98,28.57001,28.75,12588203,10353929.2,46.83987137143462,46.15898966889946,NaN,NaN,41.370147354614524,77.77922127767972,0.1247368621007243,-0.061223704808107016,-0.1859605669088313,378475333,399365910.4,38.92826972523049,24.27929709471356,NaN,NaN,-4.431664033348305,-15.132608858884783
2012-12-06T09:30:00-05:00,28.67,28.99001,28.545,28.91499,9738871,10335952.45,50.10246512636776,47.86420104031196,NaN,NaN,46.93851450231863,68.9578994002811,0.10854234446968486,-0.05028263632172525,-0.1588249807914101,388214204,393822040.8,34.553698199450395,26.20386823148502,NaN,NaN,-3.7004493582822824,-13.499443215941568
2012-12-07T09:30:00-05:00,29.06,29.09,28.64999,28.77,23721344,11048840.95,47.35215398948371,49.303984577188,NaN,NaN,45.61890372411909,60.373614826920765,0.08489701945960504,-0.05270370646690381,-0.13760072592650885,364492860,384794254,28.865196299345598,27.783529442848852,NaN,NaN,-3.835310892127512,-12.118852883968131
2012-12-10T09:30:00-05:00,28.7,28.9801,28.67999,28.84,13726203,11015381.2,48.81307405832851,49.75520562595249,NaN,NaN,41.1912801650388,49.40555391418706,0.07134786180344985,-0.04841589867219653,-0.11976376047564638,378219063,380092999.2,26.425458874036167,29.215339871345588,NaN,NaN,-3.5556173409232166,-10.895533520676
2012-12-11T09:30:00-05:00,29.07001,29.39999,29.02,29.23,9920980,11255830.6,56.11897618278281,50.82942517905674,NaN,NaN,93.9107483908158,53.80591882738137,0.0850960916951469,-0.013393645856712766,-0.09848973755185966,388140043,379508300.6,26.12965409847439,30.65870936760044,NaN,NaN,-1.140523467967628,-9.501960656003376
2012-12-12T09:30:00-05:00,29.37,29.39,29.11,29.17999,6555039,11079187.25,55.03423858254962,51.71118629341587,NaN,NaN,90.56618905164528,63.64512716678752,0.08695872887220538,0.01020867353839705,-0.07675005533380833,381585004,380130234.8,27.064879761308717,32.00562179440185,NaN,NaN,0.5408056546987442,-8.067279754474502
2012-12-13T09:30:00-05:00,29.14,29.27,28.87,28.97,8780652,10755678.25,50.610569592935704,51.74185193134144,NaN,NaN,56.69293777508309,65.59601182134041,0.07086631788865036,0.01183284202700463,-0.05903347586164573,372804352,377048264.4,25.351998749192944,32.6388224011095,NaN,NaN,0.7324684886788728,-6.810172862595448
2012-12-14T09:30:00-05:00,28.78,28.87,28.61,28.69,9166035,10766506,45.37341678382342,51.26732586585185,NaN,NaN,-14.878895620328688,53.49645195245087,0.03973422802319193,-0.009365690832655815,-0.049099918855847746,363638317,376877355.8,25.256540143480223,32.749522679450216,NaN,NaN,-0.6866295931292943,-5.9353809669574265
2012-12-17T09:30:00-05:00,28.69,29.05,28.67999,29.03999,8813340,10773543.5,52.05230321675316,51.413100755229074,NaN,NaN,21.709486648298284,49.600093249102756,0.040921482081059946,0.0020519337454771858,-0.03886954833558276,372451657,375723874.6,24.583745959336483,32.78823130832404,NaN,NaN,0.14689150719809688,-5.0664848992209235
2012-12-18T09:30:00-05:00,29.17,29.5,29.07001,29.47,11042605,10776827.85,58.72888041681501,51.84545129049268,NaN,NaN,143.54350440139146,59.526644451217884,0.06731705808423065,0.045276774269705555,-0.022040283814525097,383494262,374794718.4,24.02848435780824,32.2146174424968,NaN,NaN,3.1343443376665494,-3.8949378653798563
2012-12-19T09:30:00-05:00,29.53999,29.56,29.31,29.32001,9210703,10506380.4,55.80967886311685,51.91781906714392,NaN,NaN,144.26412318827064,70.26623127854296,0.07096134799920065,0.06666140118447572,-0.004299946814724932,374283559,373334429.4,23.143739823462184,31.026786426621662,NaN,NaN,4.599378446668572,-2.6814641065157954
2012-12-20T09:30:00-05:00,29.34,29.42,29.17,29.37,7104785,10356658.3,56.584256786330634,52.085573140951816,NaN,NaN,109.160341796032,80.75971208273273,0.07275505400465579,0.0866438706910948,0.013888816686439015,381388344,375051227.8,26.567060576648018,29.82631291206737,NaN,NaN,6.00423814365751,-1.4406494993481804
2012-12-21T09:30:00-05:00,28.82001,28.99001,28.72,28.95,13549586,10619863.6,48.83869619733108,51.75618065703048,NaN,NaN,-49.52362399346018,73.83076640810643,0.04313533353205801,0.06780798360151152,0.024672650069453517,367838758,375891316,28.251181861695557,28.748342529173936,NaN,NaN,4.726672763691512,-0.5596034617710817
2012-12-24T09:30:00-05:00,28.87,28.92,28.81,28.87,2594205,10346115.25,47.5048057388158,51.41167049334776,NaN,NaN,-56.416328532305386,58.205603371985696,0.01697869216116432,0.04589601527090892,0.028917323109744597,365244553,374449895.2,27.102645573652623,27.589468143080143,NaN,NaN,3.283598184139817,-0.010574655212381878
2012-12-26T09:30:00-05:00,28.87,28.96001,28.59,28.71001,4224910,10019695.1,44.865692560301746,51.270657721123996,NaN,NaN,-92.44330412896207,11.008241665914994,-0.010779656759956069,0.015442752159799511,0.02622240891975558,361019643,369954971.4,23.8468617120308,26.512224713565878,NaN,NaN,1.2632591518264658,0.1714016029360249
2012-12-27T09:30:00-05:00,28.69,28.75999,28.31,28.67999,10745148,9993649,44.36762394896872,50.861026208452635,NaN,NaN,-138.26089434141073,-45.49676184002128,-0.029767835639744077,-0.010987385629924518,0.01878045000981956,350274495,365153158.6,20.95136088985562,25.540629191451966,NaN,NaN,-0.5158044555444871,0.07322930886738035
2012-12-28T09:30:00-05:00,28.45,28.64999,28.33,28.36,8253473,9730304.9,39.35274729485475,50.28964001597914,NaN,NaN,-158.81698877317413,-99.0922279538625,-0.06070101118907189,-0.057095813976520304,0.003605197212551585,342021022,357279694.2,17.252346940843893,24.711139951558987,NaN,NaN,-3.655936153580975,-0.4595086143395276
2012-12-31T09:30:00-05:00,28.28999,28.97,28.25,28.85001,15186273,10174530.65,48.88130304406153,50.294513514960066,NaN,NaN,-77.03662522548892,-104.59482820026827,-0.045668853485518295,-0.053480869644346285,-0.0078120161588279904,357207295,355153401.6,16.409754316428874,23.995732483158466,NaN,NaN,-3.4099171881869292,-0.8809955534605849
2013-01-02T09:30:00-05:00,29.62,29.83,29.48,29.81,15041711,10531293.35,61.607723361488794,50.68656688486764,NaN,NaN,196.10368515109838,-54.0908254635875,0.02748258825414603,0.026541219158854545,-0.0009413690952914831,372249006,356554292.2,19.20935706480911,23.501425552182376,NaN,NaN,1.7935289446912848,-0.4989206251531749
2013-01-03T09:30:00-05:00,29.78999,29.87,29.53,29.62,9789664,10487686.5,58.50331707797529,50.93435820596947,NaN,NaN,154.03776454745582,-4.79461172830392,0.05977503822552791,0.07377742868661841,0.014002390461090496,362459342,356842232,19.80389048254885,22.982783460842388,NaN,NaN,4.627397442691876,0.233410527396118
2013-01-04T09:30:00-05:00,29.59,29.62,29.395,29.5,6833738,10199963.25,56.564660397446815,51.359650406291685,NaN,NaN,100.89578051956444,43.03672324389112,0.06909603720239102,0.10037243696407927,0.03127639976168825,355625604,357912453.8,22.098546262106083,22.75039399747904,NaN,NaN,6.142125415332815,1.0775126542442175
2013-01-07T09:30:00-05:00,29.41,29.53,29.28999,29.4612,7687945,10097416.95,55.91942486699662,52.112936697946914,NaN,NaN,74.65100480882562,89.73032196029108,0.06855486401478184,0.11696997978016554,0.04841511576538371,347937659,359095781.2,24.665248087967868,22.708158850656726,NaN,NaN,7.108735081844911,1.9391158581871735
2013-01-08T09:30:00-05:00,29.46001,29.52,29.19,29.35001,5565313,9189615.4,54.01778383048117,52.253328170356056,NaN,NaN,53.419834229650235,115.8216138513189,0.05708463048317158,0.11977090386934819,0.0626862733861766,342372346,356128791.4,22.65014759359643,22.57004468167529,NaN,NaN,7.303912759752169,2.7055154155536014
2013-01-09T09:30:00-05:00,29.38,29.46001,29.33749,29.39999,11599230,9083266.75,54.76248121079729,51.970013941354786,NaN,NaN,57.19574879210035,88.0400265795193,0.0495209477120003,0.12458745802617699,0.07506651031417669,353971576,352473305.4,20.43501403352836,22.313368229941016,NaN,NaN,7.679750553929843,3.416120435321636
2013-01-10T09:30:00-05:00,29.61,29.62,29.3,29.55,9735270,9073981.25,57.0127688893919,52.05594894323157,NaN,NaN,70.5342784774586,71.33932936551984,0.05107312867905563,0.13890792116299622,0.08783479248394059,363706846,352722806.2,21.00288752814025,22.16045020884659,NaN,NaN,8.64791481719438,4.163519632732028
2013-01-11T09:30:00-05:00,29.53999,29.63,29.4801,29.59,5057867,8999122.65,57.61817030394948,52.12979990877578,NaN,NaN,78.86313951751366,66.9328011651097,0.05112060135457887,0.15173554417716417,0.1006149428225853,368764713,355350628,26.919079641345718,22.185594427753575,NaN,NaN,9.613766809894248,4.94212637232663
2013-01-14T09:30:00-05:00,29.39,29.47,29.285,29.39999,9731887,9046684.4,53.74602655633027,52.480323505847146,NaN,NaN,40.498433180229966,60.10228683939057,0.035427248382097265,0.14489900330020689,0.10947175491810962,359032826,357569661.4,31.578945605944753,22.423291838057086,NaN,NaN,9.369296414165012,5.574579235446398
2013-01-15T09:30:00-05:00,29.27,29.27,29.10001,29.21001,8084141,8992589.7,50.11931322562517,52.66707404061925,NaN,NaN,-0.4773327798973315,49.32285343748106,0.01061169100342299,0.12273636867238835,0.11212467766896536,350948685,359284929.2,35.02761079414019,22.989360782377624,NaN,NaN,8.123764174676928,5.938748512479331
2013-01-16T09:30:00-05:00,29.23,29.42999,29.19,29.31,8722336,8988039.5,51.95683235435613,53.173584025908845,NaN,NaN,20.533956046365386,41.990494888334055,-0.00013959306014565964,0.11195018634378329,0.11208977940392895,359671021,360424818.2,37.28972882095241,23.949565575872025,NaN,NaN,7.577551400842728,6.172863210816959
2013-01-17T09:30:00-05:00,29.46001,29.53999,29.39999,29.42999,6353082,8753563.35,54.14009394053179,53.87161759673478,NaN,NaN,50.41108135788899,37.965855464420144,-0.00023539156661475658,0.1117955399456605,0.11203093151227525,366024103,360888269.6,38.231359896423974,25.18385121919834,NaN,NaN,7.708462215794257,6.3922344972422875
2013-01-18T09:30:00-05:00,29.32001,29.39999,29.24001,29.39,7740480,8680052.2,53.27121794367306,54.86579407165037,NaN,NaN,26.952967077272902,27.58382097637199,-0.0038565295934994692,0.10721026952040091,0.11106679911390038,358283623,358792051.6,35.625673654614104,26.496231698753352,NaN,NaN,7.586203525545199,6.562801501285561
2013-01-22T09:30:00-05:00,29.41,29.47,29.25,29.47,6401184,8644872.15,54.832870970448035,55.29090606639227,NaN,NaN,37.26004877619754,26.936144095565503,-0.0018311848030669459,0.1087778181100667,0.11060900291313365,364684807,359922447.8,38.07663166962214,28.04386579541001,NaN,NaN,7.890503462455775,6.752473210024163
2013-01-23T09:30:00-05:00,29.74001,29.89,29.7,29.78,9488098,8441797.75,60.36101110815532,55.20185519115416,NaN,NaN,113.70414415855163,49.77243948325528,0.01830933042470753,0.13349566594401807,0.11518633551931054,374172905,364567291.8,47.00519529093537,30.029282811561888,NaN,NaN,9.734030220414319,7.178409925794185
2013-01-24T09:30:00-05:00,29.31,29.53999,29.23,29.27,13378445,8981009.75,49.60451283193554,54.56622631643704,NaN,NaN,13.3579800532074,48.33724428462369,-0.003623930553541016,0.11065642232738426,0.11428035288092528,360794460,364791979.6,47.40029199051507,32.000454347845185,NaN,NaN,8.102498572130504,7.310422589556516
2013-01-25T09:30:00-05:00,29.38,29.4901,29.255,29.3,16208457,9580187.1,50.16706990778855,54.10925556717574,NaN,NaN,7.789580419968014,39.8129440970395,-0.016308643437440623,0.0938945485841245,0.11020319202156512,377002917,366987742.4,51.22712144948487,34.08106686122939,NaN,NaN,6.965420736809405,7.261136610592643
2013-01-28T09:30:00-05:00,29.34,29.5,29.28,29.39999,7214336,9403646.5,52.0868422691544,53.83549966732986,NaN,NaN,11.584751327801092,36.73930094714513,-0.018027822952194558,0.08766841333132191,0.10569623628351647,384217253,372174468.4,58.84406614137782,36.522411007901525,NaN,NaN,6.57614356919398,7.163280461821405
2013-01-29T09:30:00-05:00,29.35001,29.5099,29.205,29.44,6791348,9330540.25,52.86925211843984,53.75346168789834,NaN,NaN,-11.350856770829704,27.01711983773968,-0.016570590778496222,0.0849829978103962,0.10155358858889242,391008601,377439227.2,64.84547841881985,39.536363209703204,NaN,NaN,6.473972968940295,7.0648079628383895
2013-01-30T09:30:00-05:00,29.42,29.55499,29.31,29.35001,5963289,8869391.05,50.85763171857909,53.47454386702561,NaN,NaN,-23.85700702949266,-0.49511039986917565,-0.02145736438233438,0.07473188311097445,0.09618924749330883,385045312,379613708.6,66.98674736427193,42.86148701904203,NaN,NaN,5.831106412913369,6.888564884277672
2013-01-31T09:30:00-05:00,29.45,29.62,29.37,29.39999,5417262,8388168.6,51.95111675832887,53.1129972862354,NaN,NaN,22.918410509048687,1.4169756912990839,-0.02108280107802793,0.06983574614577392,0.09091854722380185,390462574,385547331.4,71.99879968545443,46.5040521731359,NaN,NaN,5.581406987086182,6.701828041821745
2013-02-01T09:30:00-05:00,29.64999,29.795,29.53999,29.73,7322527,8264811.75,58.51503317569153,53.177058919931255,NaN,NaN,182.77221686392218,36.413502980089916,0.000488743411053455,0.09152947648761867,0.09104073307656521,397785101,389703768.2,74.8761896043865,49.92956002763881,NaN,NaN,7.257952532171251,6.78127439758596
2013-02-04T09:30:00-05:00,29.63,29.67,29.32001,29.34,10881777,8467213.7,49.84835337651863,52.89865369280186,NaN,NaN,10.52330790179147,36.201214294888,-0.011735141024875134,0.07637180679547129,0.08810694782034642,386903324,390240982.4,75.23047297578816,53.04752626834191,NaN,NaN,6.078197438298895,6.680834831973523
2013-02-05T09:30:00-05:00,29.45,29.78999,29.42,29.67999,9629621,8564297.5,55.970642851851196,53.31660580896086,NaN,NaN,125.40525889197026,63.55243742744799,0.0021124538068306997,0.09074751507888479,0.08863506127205409,396532945,391345851.2,75.98066786086775,55.97274463025102,NaN,NaN,7.055441624417071,6.734350088036887
2013-02-06T09:30:00-05:00,29.55,29.785,29.55,29.67,7437723,8657918,55.755266217853425,53.58792251349638,NaN,NaN,127.78334161412289,93.88050715617109,0.009235512259419945,0.10017945159632902,0.09094393933690907,389095222,392155833.2,76.54159216606337,58.776449154901805,NaN,NaN,7.755566518887004,6.880238149586904
2013-02-07T09:30:00-05:00,29.7,29.73,29.39,29.67,9934297,8574671.35,55.755266217853425,53.7032919618765,NaN,NaN,74.70296748357595,104.23741855107656,0.012386847952064406,0.10642749927698958,0.09404065132492517,389095222,391882362.8,75.89714339064895,61.46686226163216,NaN,NaN,8.315991266023518,7.085345737649278
2013-02-08T09:30:00-05:00,29.78999,30,29.78,29.92999,9132598,8544537.75,60.35931544518091,54.209584640555626,NaN,NaN,192.86895318340007,106.25676581497214,0.02944730882335808,0.13084978735412278,0.1014024785307647,398227820,391970906.6,75.9676969319257,64.3484353528687,NaN,NaN,10.203664953452328,7.530819911335428
2013-02-11T09:30:00-05:00,29.97,30.02,29.87,29.99001,6435574,8613423.1,61.358972575357356,54.675734755192,NaN,NaN,178.3725036115159,139.82660495691704,0.041502667735142634,0.153280813199693,0.11177814546455037,404663394,395522920.6,78.66563081186514,67.24764957731463,NaN,NaN,12.048761471401614,8.176240134202025
2013-02-12T09:30:00-05:00,29.96001,30.015,29.84,29.89,5368898,8395273.65,58.702539194132996,54.55727247561898,NaN,NaN,134.65751818337455,141.6770568151979,0.03948163015331933,0.16113018315619954,0.1216485530028802,399294496,396075230.8,79.0592899982544,69.53722777069456,NaN,NaN,12.852462541571619,8.844271906683396
2013-02-13T09:30:00-05:00,29.92999,30,29.78999,29.88,8999535,8441043.35,58.430144236157616,55.18767471877771,NaN,NaN,111.01506922881953,138.3234023381372,0.0343979673828565,0.1646460122314508,0.1302480448485943,390294961,396315178.6,79.23852269090362,71.8113871064366,NaN,NaN,13.439855662087988,9.500783871741195
2013-02-14T09:30:00-05:00,29.71001,29.84,29.66,29.802,6370176,8323435.35,56.238086451120935,55.62131875758716,NaN,NaN,61.94089710772058,135.7709882629661,0.023243203414589964,0.15930204911683177,0.1360588457022418,383924785,395281091.2,76.21112579460566,73.5959588453738,NaN,NaN,13.354048864166646,10.051250299230546
2013-02-15T09:30:00-05:00,29.82001,29.92599,29.69,29.78,5011695,8256366,55.604454041998025,55.8725767413617,NaN,NaN,65.83190277884748,110.3635781820556,0.012388755203493668,0.1515447897066089,0.13915603450311523,378913090,391418145.2,66.05790437207195,74.11123300470909,NaN,NaN,13.116600539145443,10.489157476361246
2013-02-19T09:30:00-05:00,29.83,29.98,29.83,29.97501,4618578,8100270.9,59.9156752259978,56.37589267761583,NaN,NaN,99.9585861882794,94.6807946974083,0.016112381948236693,0.1592965119384111,0.1431841299901744,383531668,387191800,57.09560989652541,73.55767096740234,NaN,NaN,14.070619750286717,11.000794944064884
2013-02-20T09:30:00-05:00,29.97,29.99001,29.56,29.57001,6662242,8113323.8,49.2245082192029,56.25924099908896,NaN,NaN,19.916052694819324,71.73250159969726,-0.009549894860802183,0.1312467614141717,0.14079665627497387,376869426,382706786,49.431194377115794,72.3037028968912,NaN,NaN,11.700507442319736,11.100753872387006
2013-02-21T09:30:00-05:00,29.47,29.49001,29.23,29.33,16631574,8470497.6,44.19197069606365,55.70501628035573,NaN,NaN,-96.36523101889634,30.256441550154072,-0.041734385267152174,0.08862867469103364,0.1303630599581858,360237852,376695364.2,41.40782438008723,70.11863323222211,NaN,NaN,8.019120643245563,10.660520553938229
2013-02-22T09:30:00-05:00,29.53,29.7,29.42,29.69,8672789,8235214.8,52.10204330352675,55.2469455752011,NaN,NaN,-14.370480697643297,14.99416598908129,-0.037933351057316725,0.08294637113653991,0.12087972219385663,368910641,373692535.4,38.08260418976336,67.49051998832046,NaN,NaN,7.3725439099915215,10.190809604802984
2013-02-25T09:30:00-05:00,29.85001,29.95,29.25,29.27,8079219,7828752.9,44.22623364006804,54.84536559402606,NaN,NaN,-61.27953899360782,-10.428122365409749,-0.06146786366530069,0.04404489261223077,0.10551275627753146,360831422,370076201.8,34.49041640937156,64.58051594786212,NaN,NaN,3.9727296800949303,9.302512472701833
2013-02-26T09:30:00-05:00,29.35001,29.5,29.21001,29.442,7609477,7848509.95,47.71206059227125,54.25546686119891,NaN,NaN,-101.60206916618381,-50.74025343630239,-0.0629818947262785,0.02678538786968332,0.08976728259596183,368440899,367058048,31.794868877729584,61.42438744906654,NaN,NaN,2.4637758575924638,8.32555009911478
2013-02-27T09:30:00-05:00,29.39999,29.84,29.37,29.69,8249684,7921426.75,52.3375736853767,54.011345966022006,NaN,NaN,-11.534621079109973,-57.03038819108825,-0.045620855623025786,0.032741213067179586,0.07836206869020537,376690583,367022279.4,31.763186491826602,58.22592990090676,NaN,NaN,2.8152516027189263,7.538364599629658
2013-02-28T09:30:00-05:00,29.7,29.88499,29.63,29.63,6665184,7956521.5,51.158448262257416,53.68300182633658,NaN,NaN,16.94026162504108,-34.369289662300766,-0.036891243866984905,0.032248013856474245,0.06913925772345915,370025399,368979788.8,35.5483239399144,55.34387136871145,NaN,NaN,2.707736888430198,6.848274926601164
2013-03-01T09:30:00-05:00,29.49001,29.745,29.35001,29.67999,5505168,7960916.8,52.12619329239078,53.09492167256586,NaN,NaN,-42.33181200976468,-39.96155592472504,-0.02692587677648165,0.03548191175285709,0.06240778852933874,375530567,370303774,38.051313157484216,52.635558241965626,NaN,NaN,2.920452848106727,6.287157486816245
2013-03-04T09:30:00-05:00,29.59,29.785,29.55,29.77,4998633,7844722.1,53.89747845241081,52.561957806641104,NaN,NaN,8.212381854742942,-26.06317175505489,-0.01409301076706744,0.044791525070504434,0.058884535837571875,380529200,374243329.6,44.90726675096331,50.22424652332978,NaN,NaN,3.625943525596007,5.906984063784782
2013-03-05T09:30:00-05:00,29.94,30.25,29.94,30.17999,12437184,7922492.45,60.97940744546551,52.72459125316486,NaN,NaN,175.1612244592031,29.289486970022494,0.02031692486115068,0.08428069191401022,0.06396376705285954,392966384,379148426.6,52.02634292825503,48.293321732615546,NaN,NaN,6.582962582495775,6.003552423600638
2013-03-06T09:30:00-05:00,30.28,30.28999,30.11011,30.16,7174828,7799752.8,60.491491072837086,52.87183031292768,NaN,NaN,166.89837456943513,64.97608609973152,0.03896049855400899,0.11266439024537078,0.0737038916913618,385791556,380968621.2,54.382043321119106,46.51785892048808,NaN,NaN,8.77459985657769,6.39941634259736
2013-03-07T09:30:00-05:00,30.17,30.28,30.13049,30.23,5326922,7694212.75,61.648701126680514,53.258302789753365,NaN,NaN,149.66157399935102,91.5203485745935,0.052398847800797135,0.1392024514423582,0.08680360364156108,391118478,385187237,59.36262136913974,45.31439431866908,NaN,NaN,10.91888429406625,7.04505462137863
2013-03-08T09:30:00-05:00,30.37,30.37,30.19501,30.28999,5990141,7497004.95,62.65814675553423,53.762137983577375,NaN,NaN,148.86507482624424,129.7597259417953,0.06111196034525955,0.16319355407313552,0.10208159372787597,397108619,389502847.4,63.725761534353246,45.147812687403466,NaN,NaN,12.986718551991656,7.893863754323347
2013-03-11T09:30:00-04:00,30.23,30.38,30.14,30.36,5368453,7308797.7,63.85386970170637,54.04343758898513,NaN,NaN,132.13483154552856,154.54421587995242,0.06690679678257955,0.1857150897061004,0.11880829292352085,402477072,393892421.8,67.54297978969547,45.89405339405847,NaN,NaN,15.062323625803748,8.917929450249119
2013-03-12T09:30:00-04:00,30.28,30.33,30.12,30.25,4852066,7229622.3,60.57198160754101,54.85397140243786,NaN,NaN,104.5881973407938,140.42961045627055,0.05892842760325201,0.19246882742758586,0.13354039982433386,397625006,394824146.2,68.30538165957668,47.24220962851995,NaN,NaN,15.94810153467375,9.922239748024065
2013-03-13T09:30:00-04:00,30.24001,30.35001,30.13,30.23,5485352,7235445,59.96847566580912,55.98086461456253,NaN,NaN,94.51623365702012,125.95318227378755,0.04834479920783946,0.19397139883413317,0.1456265996262937,392139654,396093765.8,69.36150247837031,49.23890092125446,NaN,NaN,16.526435017439358,10.865696215083393
2013-03-14T09:30:00-04:00,30.33,30.47,30.33,30.44501,5756477,7073292.1,64.10860111531606,56.838475886833194,NaN,NaN,119.46792318829965,119.91445211157728,0.05157065769439256,0.21008992174428442,0.15851926404989186,397896131,397449296.4,70.49204670272646,51.553861100751824,NaN,NaN,18.21196283191712,11.915162874631068
2013-03-15T09:30:00-04:00,30.33,30.35001,30.12,30.2,9855078,7247537.2,56.88846443698755,57.74292094375602,NaN,NaN,68.7177934236664,103.8849958310617,0.03380798852204339,0.2007792497024461,0.1669712611804027,388041053,395635783.2,66.93360086727927,53.8712314191738,NaN,NaN,17.613150201153797,12.729161064134315
2013-03-18T09:30:00-04:00,29.96001,30.34,29.92,30.21001,6172391,7305572,57.101038779783956,58.413562242864074,NaN,NaN,49.55551443506789,87.36913240896956,0.020018990680166243,0.1919949995306105,0.17197600885044426,394213444,393983057.6,63.77402503101294,56.15545685869404,NaN,NaN,17.18446849474455,13.36563355422149
2013-03-19T09:30:00-04:00,30.28999,30.35001,29.92,30.17,7275754,7438430.8,55.9142885789072,58.66904187811625,NaN,NaN,43.739025128973594,75.19929796660553,0.006205668224182059,0.17973309413067184,0.17352742590648979,386937690,391845594.4,59.83981610049841,58.16093040217059,NaN,NaN,16.501255799666446,13.813579589285055
2013-03-20T09:30:00-04:00,30.34,30.39,30.22501,30.32001,7306809,7470659.15,59.32742260371168,59.252540045362984,NaN,NaN,71.2005768351575,70.536166602233,0.005213705265375401,0.18004455748820902,0.17483085222283362,394244499,392266563.4,60.358496530471236,59.933085587210364,NaN,NaN,16.838300561542002,14.245682585321761
2013-03-21T09:30:00-04:00,30.02,30.10001,29.91,29.97501,5796734,6928917.15,49.78170055927893,59.085076278712144,NaN,NaN,-0.45532651653031536,46.551516661267,-0.019292342469478946,0.15071542413598493,0.17000776660546388,388447765,390376890.2,56.81149282558215,61.27309842064592,NaN,NaN,14.213332031808063,14.241061077676948
2013-03-22T09:30:00-04:00,30.06,30.21001,30.03,30.172,3409167,6665736.05,54.302881490958214,59.11403363860838,NaN,NaN,28.54418512228696,38.516795000991124,-0.02261940871838586,0.14173350570748156,0.1643529144258674,391856932,391140066,57.88784227517206,62.20028238666084,NaN,NaN,13.351908201683285,14.114039238249282
2013-03-25T09:30:00-04:00,30.3,30.35001,29.99001,30.10001,4575051,6490527.65,52.4446337277907,58.50440694448876,NaN,NaN,25.933253034938463,33.79234272096524,-0.029611610372246744,0.12733840146055897,0.1569500118328057,387281881,389753753.4,55.19680151453083,62.42674371425196,NaN,NaN,12.082657287197215,13.823841816670415
2013-03-26T09:30:00-04:00,30.25,30.3,30.17999,30.28999,4224746,6321291.1,56.65959953981841,58.230700406415984,NaN,NaN,55.98516428196186,36.241570551562894,-0.021748700887531447,0.1297641357233914,0.15151283661092285,391506627,390667540.8,56.628035645909556,62.58717173745128,NaN,NaN,12.276209279718804,13.602751454248756
2013-03-27T09:30:00-04:00,30.08,30.23,30.02499,30.21001,7230387,6270326.25,54.470749172256035,57.71798955252853,NaN,NaN,12.757625645221571,24.55298031357571,-0.02216572907609854,0.12380567526579966,0.1459714043418982,384276240,388673889,52.67445549752837,62.109445603764755,NaN,NaN,11.780569365735456,13.342439727318284
2013-03-28T09:30:00-04:00,30.14,30.3,30.09,30.27,7425559,6308345,55.84849846414562,57.23158610314363,NaN,NaN,37.51801461091944,32.14764853906566,-0.018767521897687933,0.12251200196978829,0.14127952386747622,391701799,389324695.8,53.80819031466528,61.40104765950133,NaN,NaN,11.769018889734877,13.117665321949227
2013-04-01T09:30:00-04:00,30.3,30.3,29.99001,30.07001,4629906,6264581.9,50.375638249065325,56.26885528509784,NaN,NaN,-42.002622873200515,18.038286939968167,-0.02970468000084575,0.10414867386641902,0.13385335386726477,387071893,388367688,51.84147590109244,60.27951166745826,NaN,NaN,10.11619673749121,12.688884095598082
2013-04-02T09:30:00-04:00,30.17999,30.32001,30.12,30.19,4217797,6225540.1,53.33062984823238,55.75161587371865,NaN,NaN,6.7526213216404,14.202160597308557,-0.028565544397010145,0.0981464233710021,0.12671196776801225,391289690,389169249.8,53.37851609602565,59.21330698434747,NaN,NaN,9.591431006736869,12.246390797189337
2013-04-03T09:30:00-04:00,30.22,30.27,29.89999,29.95,8473617,6027361.75,47.267772810656034,54.84442281263629,NaN,NaN,-149.8217752429162,-26.959227307667067,-0.04282555136883173,0.07318002855697259,0.11600557992580432,382816073,387431139,49.67610433951989,57.80720711728672,NaN,NaN,7.231748341569267,11.530013303529326
2013-04-04T09:30:00-04:00,29.95,30.02,29.8201,29.96001,5635992,5950419.95,47.5356725210611,53.660642198760925,NaN,NaN,-199.10656261045773,-69.33206495880293,-0.04993724722175703,0.05358402089860803,0.10352126812036506,388452065,388266304,51.41974706598255,56.44490000037644,NaN,NaN,5.420657433733187,10.657248179272734
2013-04-05T09:30:00-04:00,29.55,29.78,29.47,29.73,7012695,6034708.6,42.22702447360562,52.61339648709078,NaN,NaN,-303.0833702981622,-137.45234194061925,-0.0673994118848564,0.019272003264294568,0.08667141514915097,381439370,386213818.2,47.100561231209504,55.02825431208574,NaN,NaN,2.1651161468598517,9.444086460356608
2013-04-08T09:30:00-04:00,29.75,29.86,29.64,29.86,6322977,6051350.4,45.90415873751554,51.81361934121447,NaN,NaN,-182.52126674192698,-165.55607071436455,-0.06730504030559208,0.0025401147671608726,0.06984515507275295,387762347,386351909,47.42056649683931,53.86015013107334,NaN,NaN,0.5322933946725519,8.170973165258886
2013-04-09T09:30:00-04:00,29.92999,30.14999,29.8,30.07001,5970035,6081429.5,51.2970462195762,51.483816315547976,NaN,NaN,-58.08267413724639,-178.5231298061419,-0.050952065967050805,0.0061550726139394385,0.057107138580990244,393732382,386840447.4,48.60509301572225,53.05766991073218,NaN,NaN,0.798104284440022,7.1177061822847625
2013-04-10T09:30:00-04:00,30.14999,30.63,30.13,30.60001,10553688,6366510.6,61.67967340812696,51.65183423014907,NaN,NaN,156.84528635898212,-117.18971748576223,-0.004728620027408495,0.05119636354672963,0.055924983574138123,404286070,391134446.8,57.638441628480194,52.86338027487568,NaN,NaN,4.800980995219501,6.786745441275439
2013-04-11T09:30:00-04:00,30.44,30.54469,30.37,30.5,6243164,6404401.2,59.11856431396779,52.31875306976969,NaN,NaN,150.4383734669848,-47.28073027027372,0.017598960507600202,0.07792368420863838,0.060324723701038176,398042906,393052615,60.941060965764486,53.15834942774585,NaN,NaN,7.070208929499344,6.827240225307426
2013-04-12T09:30:00-04:00,30.36,30.45,30.17,30.36501,5749457,6404050.2,55.75344422120541,52.42236469335878,NaN,NaN,89.0990514993131,31.15575408922134,0.021506173409362422,0.0872074404627412,0.06570126705337878,392293449,395223430.8,64.33033434206186,53.61852743252372,NaN,NaN,7.796212754293556,6.965664872305444
2013-04-15T09:30:00-04:00,30.25999,30.32001,29.87,29.87,16423340,6732463.3,45.52088158471771,51.92781096885357,NaN,NaN,-49.195860954406236,57.82083524672548,-0.00936161806333298,0.05399924447421256,0.06336086253754554,375870109,392844983.2,58.35553268277621,53.844151087398394,NaN,NaN,4.740316216498697,6.647757921475909
2013-04-16T09:30:00-04:00,30.09,30.28,30.00999,30.24001,8319980,6839842.75,52.533554651352055,51.63309347682026,NaN,NaN,21.73800209941867,73.7849704940585,-0.0051826753617567264,0.05688251833534963,0.062065193697106356,384190089,390936524.6,54.02005878686919,53.65786702603837,NaN,NaN,4.781832944326505,6.381197210454566
2013-04-17T09:30:00-04:00,29.97,29.99001,29.49001,29.62,12046441,7078377.1,42.630968371478346,50.78739484819328,NaN,NaN,-158.46866169349204,10.722180883563663,-0.042425136896879295,0.009033772576007237,0.05145890947288653,372143648,384508040.2,42.552101107785,52.934841712485266,NaN,NaN,0.8337419326896656,5.588703599345295
2013-04-18T09:30:00-04:00,29.75,29.75999,29.231,29.31,15772820,7501677.65,38.70270292913693,49.56269516712123,NaN,NaN,-210.9409131655303,-61.553676442939356,-0.08379661133886455,-0.053286854700694164,0.03050975663817039,356370828,376173624.6,32.82321034642014,51.435914571896326,NaN,NaN,-3.783429377706786,4.2498274597664265
2013-04-19T09:30:00-04:00,29.25,29.46001,29.10001,29.35001,8609980,7642339.95,39.47784543013103,48.78428139434021,NaN,NaN,-202.97518974314667,-119.96852469143133,-0.10305950008486148,-0.09831461846790646,0.004744881616955018,364980808,370711096.4,28.262286374314684,49.75168674855506,NaN,NaN,-6.91481429454398,2.654878637722083
2013-04-22T09:30:00-04:00,29.45,29.66,29.31,29.575,7321301,7837946.65,43.782986098043835,48.10230684075531,NaN,NaN,-121.40807991604771,-134.4109684837596,-0.09541547827213387,-0.11452446622321233,-0.019108987951078453,372302109,369997496.4,27.720389142690152,47.918963394745376,NaN,NaN,-7.934911810425907,1.142051430843799
2013-04-23T09:30:00-04:00,29.72,30.00999,29.63,29.89999,12455199,8231954.05,49.38383281833634,48.25345398416105,NaN,NaN,-33.678117538046266,-145.49419241125258,-0.06470820089193122,-0.09999423906599247,-0.03528603817406126,384757308,370110940.2,27.956879133912423,46.367590165773414,NaN,NaN,-6.821938933408919,0.004338521664839279
2013-04-24T09:30:00-04:00,29.71001,30.03,29.67999,29.95,5547824,8298107.95,50.20595219827963,48.444188246819515,NaN,NaN,-19.626750233486387,-117.72581011925146,-0.03855614607081119,-0.08348122076257525,-0.04492507469176406,390305132,373743237,35.260701382670135,45.21337261696538,NaN,NaN,-5.691615904223395,-0.8093692534620514
2013-04-25T09:30:00-04:00,30.02,30.2099,29.98,30.05,6468883,8260032.75,51.88870568692327,49.13430833348506,NaN,NaN,31.212525253979578,-69.29512243534948,-0.013352028158096316,-0.061615109889384456,-0.04826308173128814,396774015,381823874.4,47.91221627412316,45.2713479771735,NaN,NaN,-4.253976461108249,-1.301455997411508
2013-04-26T09:30:00-04:00,30,30.13,29.92,30.03999,5367102,8157109.9,51.700360122569954,49.54832271813181,NaN,NaN,21.4312832003318,-24.413827846653785,0.0029465505326351643,-0.04457989356549419,-0.04752644409812935,391406913,387109095.4,54.21458632305573,45.756635107617534,NaN,NaN,-3.163238433919207,-1.567424916912608
2013-04-29T09:30:00-04:00,30.11,30.55,30.11,30.47,8256117,8338420.45,58.64486329993953,50.07316679530061,NaN,NaN,106.04640107551263,21.077068351658276,0.04088324398925708,0.0035776108884419955,-0.03730563310081508,399663030,392581279.6,59.65729704367501,46.546078252471304,NaN,NaN,0.0444649549297358,-1.3371549352208447
2013-04-30T09:30:00-04:00,30.50999,30.81,30.44,30.8,13395949,8797328.05,63.037078821837966,50.17012432485139,NaN,NaN,165.0655760502751,60.825807069322536,0.08391799868150032,0.06759186525106031,-0.016326133430440003,413058979,398241613.8,64.37479318245113,47.02724622061209,NaN,NaN,4.2631013018185175,-0.5371183299295073
2013-05-01T09:30:00-04:00,30.75999,30.8,30.5,30.53,8689188,8808106.6,57.64279583021929,50.06471229029794,NaN,NaN,128.81258495280488,90.5136741065808,0.08941030205338382,0.09543674413628978,0.006026442082905956,404369791,401054545.6,66.47297623805383,47.422383025775616,NaN,NaN,6.072215565266189,0.4070722265270208
2013-05-02T09:30:00-04:00,30.57001,30.96001,30.56,30.92,6413879,8847000.95,62.61875628167428,50.555091723188575,NaN,NaN,145.2689812114463,113.32496529807413,0.1129996825928911,0.14727604532401983,0.03427636273112873,410783670,403856476.6,68.46529001996066,47.71773700276839,NaN,NaN,9.318730068290337,1.6801662039217802
2013-05-03T09:30:00-04:00,31.17999,31.28,31.14,31.21001,10430859,9017909.15,65.83307256638432,52.00596250759334,NaN,NaN,183.77634564124202,145.79397778625616,0.14005668885568964,0.20934722380074078,0.06929053494505114,421214529,409817999.8,72.24446365818167,48.70980350101164,NaN,NaN,13.106317214627136,3.3124734911654024
2013-05-06T09:30:00-04:00,31.28999,31.395,31.25,31.36,7242391,9063879.85,67.39463016387998,53.06746790134533,NaN,NaN,171.5829501762251,158.90128760639865,0.15861379595268896,0.26755777988591234,0.10894398393322338,428456920,415576777.8,75.32119712881148,50.231313382578946,NaN,NaN,16.66205329701907,5.219556320573069
2013-05-07T09:30:00-04:00,31.38,31.42999,31.17999,31.34,6280461,9079401.15,66.95520110275777,54.80491309643673,NaN,NaN,143.95459445453866,154.67909128725137,0.15966065910717436,0.30851980781719135,0.148859148710017,422176459,417400273.8,76.22009335860062,52.63616997192292,NaN,NaN,19.336071942321915,7.236201409394333
2013-05-08T09:30:00-04:00,31.31,31.60001,31.25,31.59,8493320,8976382.75,69.62158844232101,57.01340491880702,NaN,NaN,144.03275753093047,157.7231258028765,0.1665444325845041,0.3570396894406471,0.19049525685614302,430669779,422660271.4,78.63726623554825,55.90860253543207,NaN,NaN,22.45165730134166,9.409837965386808
2013-05-09T09:30:00-04:00,31.53,31.69,31.41,31.5,10263965,9177422.8,67.50968814513278,59.015679398450004,NaN,NaN,129.6514165668032,154.59961287394788,0.1546482154435316,0.3838055261605575,0.2291573107170259,420405814,424584700.2,79.4598901197723,59.56557423153618,NaN,NaN,24.38545400729256,11.549211685659058
2013-05-10T09:30:00-04:00,31.56,31.64,31.4445,31.59,4696234,9124761.65,68.53748572935393,60.78385794354358,NaN,NaN,113.58535882404065,140.5614155105076,0.1427393882940452,0.4075815460845824,0.2648421577905372,425102048,425362204,79.79835727311774,63.2854290979953,NaN,NaN,26.286359808255494,13.654518560315692
2013-05-13T09:30:00-04:00,31.56,31.60001,31.46001,31.50999,4732863,8540237.8,66.52278483710974,62.00806880202739,NaN,NaN,97.48741927261516,125.7423093297856,0.12027196486832753,0.4151821138759466,0.2949101490076191,420369185,423744657,76.9571569654044,66.78544894310187,NaN,NaN,27.3168981847063,15.606287078085778
2013-05-14T09:30:00-04:00,31.48,31.71561,31.48,31.61,7373336,8492905.6,67.7970559219196,63.26457621085882,NaN,NaN,94.11260826729902,115.77391209233765,0.10357872901630666,0.4243835602780024,0.32080483126169573,427742521,424857869.4,77.54958830094105,69.80608372297836,NaN,NaN,28.54095158065636,17.45409629273872
2013-05-15T09:30:00-04:00,31.59,31.72,31.52,31.71001,6419730,8211570.05,69.06513240846571,64.49146383382613,NaN,NaN,89.84518319933066,104.9363972260177,0.0911436522032496,0.43473439651575774,0.34359074431250813,434162251,425556363.8,77.93295615582221,71.95042228595688,NaN,NaN,29.93023668228742,19.236402062674248
2013-05-16T09:30:00-04:00,31.78999,32.07001,31.78,31.88,9150828,7880470.45,71.1449995204184,65.88036664795817,NaN,NaN,104.65678795501428,99.9374715036599,0.08628759955022308,0.451450243750287,0.3651626442000639,443313079,430137816.8,80.30816871883995,73.81424959994146,NaN,NaN,31.721720913888884,21.020019041419197
2013-05-17T09:30:00-04:00,32,32.21001,31.92,32.2,17189504,8309446.65,74.60619686874038,67.02046190287251,NaN,NaN,114.3940304769991,100.09920583425159,0.09581311557065092,0.48492903866337755,0.38911592309272663,460502583,437217923.8,83.29976027055356,75.50299697328992,NaN,NaN,34.37678209487949,22.92812804905638
2013-05-20T09:30:00-04:00,32.12,32.31,32.09,32.2,8091059,8347934.55,74.60619686874038,67.84682747765126,NaN,NaN,116.30676999890312,103.86307597950918,0.09321334703531747,0.5056326068868735,0.41241925985155603,460502583,445244603.4,85.91267641528523,77.04141720420664,NaN,NaN,36.53565729964799,24.872060799140893
2013-05-21T09:30:00-04:00,32.13,32.2,31.98,32.10001,8384445,8144396.85,71.49822901695758,68.836501276704,NaN,NaN,100.58086483255796,105.15672729256099,0.07655638893062156,0.508114746014833,0.4315583570842114,452118138,450119726.8,87.22050500760672,78.523383544889,NaN,NaN,37.53353549907409,26.68084289913135
2013-05-22T09:30:00-04:00,32.14999,32.28999,31.62,31.75,14408352,8587423.25,61.79408777522761,68.77759638338638,NaN,NaN,73.82134739965277,101.95196013262539,0.035831662201200154,0.4763479348357116,0.44051627263451143,437709786,450829233.8,87.40378628905702,79.87613327839588,NaN,NaN,35.58408523659283,27.952734661625847
2013-05-23T09:30:00-04:00,31.48,31.85001,31.41,31.74001,17015344,9114746.3,61.537361444141204,68.47075987465472,NaN,NaN,41.09180040813736,89.23896262325002,0.0037741962826655095,0.44523401798784334,0.44145982170517784,420694442,446305506.4,79.56825121759196,80.3992609612109,NaN,NaN,33.9259126708761,28.806045805804455
2013-05-24T09:30:00-04:00,31.53,31.71001,31.465,31.69,5276605,9110221.45,60.189272239963366,67.95609145151782,NaN,NaN,28.036177375111603,71.96739200287251,-0.02373287819919845,0.41179372395617975,0.4355266021553782,415417837,437288557.2,66.7274822872042,79.78542418681037,NaN,NaN,32.164778672587985,29.28586478677353
2013-05-28T09:30:00-04:00,32.03999,32.1393,31.77,31.84,6305816,9012706.4,62.82018287778011,67.66073300687655,NaN,NaN,76.41887447783235,63.98981289865841,-0.03412762621641213,0.39286706938486304,0.4269946956012752,421723653,429532771.2,58.049816026083626,78.48754723448774,NaN,NaN,31.331408474128292,29.578085313538494
2013-05-29T09:30:00-04:00,31.67999,31.856,31.53,31.75999,8230926,8754455.25,60.522650634453996,67.0108088777432,NaN,NaN,29.27957302506366,49.729554537159544,-0.04785270675011355,0.36717881216363324,0.4150315189137468,413492727,421807689,50.94343621299999,76.50941651859144,NaN,NaN,29.99239181197598,29.63727195617242
2013-05-30T09:30:00-04:00,31.78999,32.09,31.75,31.96001,8837430,8761867.35,64.06130805671535,66.7644960142848,NaN,NaN,73.15103953565604,49.5954929643602,-0.04496575738753866,0.3588243221793235,0.40379007956686214,422330157,418731763.2,48.40261658155011,74.29103983728986,NaN,NaN,29.77504138652328,29.6569533033654
2013-05-31T09:30:00-04:00,31.84,32.12,31.64,31.66,6966426,8789494.7,55.95902085241666,65.86603423736072,NaN,NaN,30.713741515122315,47.51988118575719,-0.06362630855254409,0.324257193876182,0.3878835024287261,415363731,417665621,47.5179747220582,71.98529822649989,NaN,NaN,27.132131224673568,29.296264434980852
2013-06-03T09:30:00-04:00,31.7,31.83,31.47501,31.82001,10004570,8768180.25,58.9417149488986,65.32452924534564,NaN,NaN,-6.5695713052293145,40.59873144968901,-0.06531177973974239,0.3062437777540481,0.3715555574937905,425368301,419655713.8,49.377842929829626,70.01534722395884,NaN,NaN,25.76303087951395,28.791516784199867
2013-06-04T09:30:00-04:00,31.85001,32.02499,31.59,31.67999,9273586,8869740,55.405548962555265,64.43942160539105,NaN,NaN,5.393575165275558,26.393671587177653,-0.0752675993920277,0.27747105825375584,0.35273865764578355,416094715,418529926.2,48.33433642420785,67.9285435184779,NaN,NaN,23.540290591511923,28.041341613815874
2013-06-05T09:30:00-04:00,31.60001,31.67999,31.33,31.37,7927332,8952083.55,48.47217428686627,62.96849602527679,NaN,NaN,-109.49536849808123,-1.361316717451325,-0.10056075095657485,0.22703771895006497,0.3275984699066398,408167383,417464857.4,47.31557370786717,65.74158762933824,NaN,NaN,19.336027018155235,26.79772524300721
2013-06-06T09:30:00-04:00,31.38,31.49001,31.11,31.44,14728613,9263848.2,49.993944385727744,61.45770637279889,NaN,NaN,-144.03731082239466,-44.79898678906146,-0.10966186386341403,0.1905211400773723,0.30018300394078634,422895996,417578025.2,47.44233400444657,63.39402800688158,NaN,NaN,16.374106311320105,25.308636824194767
2013-06-07T09:30:00-04:00,31.60001,31.75999,31.44,31.73,6511305,9076215.2,55.81576963146471,60.11553299870777,NaN,NaN,-41.23857258939017,-59.18944960996396,-0.09384719764412236,0.18287400688563338,0.27672120452975574,429407301,420386739.2,50.61802869817679,61.05961860885467,NaN,NaN,15.578850319673036,23.918667323548807
2013-06-10T09:30:00-04:00,31.85001,31.92999,31.75011,31.8,6390977,9160952.35,57.11366657215938,58.866066548951984,NaN,NaN,21.75791142031013,-53.52395306485607,-0.07707082399625642,0.18038267453443524,0.25745349853069166,435798278,422472734.6,52.8945131088246,58.7011783726789,NaN,NaN,15.32838043171288,22.69148348185796
2013-06-11T09:30:00-04:00,31.50999,31.78999,31.42999,31.47,7307797,9289699.05,49.70153233503702,57.30915964310052,NaN,NaN,-79.59128420692075,-70.52092493929533,-0.08592252152114765,0.1500503466292571,0.23597286815040475,428490481,424951887.8,55.51900624386934,56.43678560384052,NaN,NaN,12.721199284859045,21.267157168000974
2013-06-12T09:30:00-04:00,31.64,31.7,31.1899,31.25999,8951297,9368597.1,45.64197755950467,56.15543748483459,NaN,NaN,-136.25766815739956,-75.873384871159,-0.10252006065951741,0.107822792326008,0.2103428529855254,419539184,427226248,57.839701863932675,54.32506528776021,NaN,NaN,9.205980877263224,19.544131983609866
2013-06-13T09:30:00-04:00,31.2,31.67999,31.14999,31.61501,7608535,9428037.35,52.67859282017553,55.52266829740847,NaN,NaN,-93.40575152015163,-65.7470730107104,-0.08680991428874649,0.10183046012459229,0.18864037441333878,427147719,428076592.6,58.707141072252924,52.83498599166457,NaN,NaN,8.485262963280999,17.964293552134315
2013-06-14T09:30:00-04:00,31.58,31.67999,31.351,31.38,5779227,9259457.3,48.22800231988986,54.668291874546085,NaN,NaN,-87.91220699234135,-75.08179989130062,-0.08912996720510183,0.0772279154069615,0.16635788261206333,421368492,426468830.8,56.34658455722418,52.093493296666,NaN,NaN,6.389561034814734,16.310760335374376
2013-06-17T09:30:00-04:00,31.58,31.86,31.5399,31.67,6588320,8729398.1,53.453923865664365,53.99927337368068,NaN,NaN,-7.173049270088935,-80.86799202938045,-0.06892132181872787,0.08020623033865348,0.14912755215738135,427956812,424900537.6,54.06301638651806,51.80872189383989,NaN,NaN,6.4050371332181495,14.895657020780629
2013-06-18T09:30:00-04:00,31.73,32,31.71001,31.92,6318766,8640783.45,57.442104333693685,53.779234352197804,NaN,NaN,76.58812129690978,-49.63211092861434,-0.03804711629290708,0.10156865679124749,0.13961577308415457,434275578,426057557,55.49600726347168,52.133905540302145,NaN,NaN,7.780218106068899,13.879165747250381
2013-06-19T09:30:00-04:00,31.95,31.96001,31.53,31.55,11224047,8782763.55,50.54011405708141,52.81343478079538,NaN,NaN,3.7301696533706505,-21.634543366460296,-0.04158665566156583,0.08763245350719728,0.1292191091687631,423051531,426760026.4,56.385582090722295,52.70411736238588,NaN,NaN,6.555272568400593,12.832895293128983
2013-06-20T09:30:00-04:00,31.22,31.36501,30.78,30.85001,15781500,8851420.95,40.60085562771314,51.71642297903084,NaN,NaN,-247.3553978000299,-52.42447262243595,-0.08747492160536101,0.01987545716206185,0.10735037876742286,407270031,422784488.8,50.26236613980708,52.90014532079651,NaN,NaN,1.613661832165007,11.230147655848416
2013-06-21T09:30:00-04:00,30.74001,30.78,30.3,30.50999,12111391,8606223.3,36.81360992107833,50.13584404847226,NaN,NaN,-297.4040084888766,-94.32283292174301,-0.13432919272260463,-0.06056111213583293,0.0737680805867717,395158640,417542518.4,43.547221912343446,52.48367239097606,NaN,NaN,-3.749897796580555,9.090141162644278
2013-06-24T09:30:00-04:00,30.24001,30.3484,29.94,30.14,11185773,8901681.7,33.18605398577276,48.54873726441637,NaN,NaN,-285.4799237826189,-149.984207824249,-0.18093921083535452,-0.15240593295742144,0.02853327787793307,383972867,408745729.4,35.07771691697427,51.53677099760223,NaN,NaN,-9.425551293655372,6.445042240315756
2013-06-25T09:30:00-04:00,30.45,30.50999,30.2,30.39,8264457,8999613.75,37.65631504237582,47.7761758898099,NaN,NaN,-187.21885883787795,-202.74560385120657,-0.18497405127593505,-0.20268428621698575,-0.0177102349410507,392237324,400338078.6,29.226911302693154,50.24472368294694,NaN,NaN,-12.279620187305431,3.7700904649413007
2013-06-26T09:30:00-04:00,30.69,30.7,30.48,30.57001,20470304,9611582.65,40.731229166566074,47.1145533741555,NaN,NaN,-123.45960196708336,-228.18355817529738,-0.16615708717803984,-0.22540659391360052,-0.05924950673556067,412707628,398269298,27.98980048088947,48.85525700269287,NaN,NaN,-13.463714660128481,1.3081183042170461
2013-06-27T09:30:00-04:00,30.75,30.88,30.7,30.72,6544215,9496921.9,43.243167810486064,46.216510386942744,NaN,NaN,-80.7698706699288,-194.86645274927713,-0.13554057171602724,-0.2286752213805947,-0.09313464966456747,419251843,400665660.4,31.60136884305993,47.49692415589881,NaN,NaN,-13.57588990362675,-0.818168582617782
2013-06-28T09:30:00-04:00,30.47,30.75,30.36,30.58501,9145555,9605878.35,41.53692277288675,45.10388582985184,NaN,NaN,-95.19359482619369,-154.42437001674054,-0.11701112784097281,-0.23939855946578348,-0.12238743162481067,410106288,403655190,35.91919198286544,46.284401218330295,NaN,NaN,-14.20186576469445,-2.730125322914449
2013-07-01T09:30:00-04:00,30.82001,30.99001,30.72,30.75,9576395,9584469.6,44.42332701207194,44.72687116392576,NaN,NaN,-52.3768058787551,-107.80374643596778,-0.08761825551622568,-0.23191025102009277,-0.1442919955038671,419682683,410797153.2,44.87252917484131,45.52393857054259,NaN,NaN,-13.824192856066658,-4.314992113364765
2013-07-02T09:30:00-04:00,30.73,31.00999,30.62,30.8,14495316,9845556.1,45.304625746227,44.702774605834506,NaN,NaN,-47.559573756591504,-79.8718894197105,-0.060095913070202095,-0.21941188684161972,-0.15931597377141762,434177999,419185288.2,53.15164233958044,45.189077175946,NaN,NaN,-13.25900488406796,-5.5927082234652215
2013-07-03T09:30:00-04:00,30.72,31.12,30.72,30.98,11597023,10029040.65,48.472423883694084,44.402333967514394,NaN,NaN,-26.024683248909195,-60.384905676075675,-0.026755482145170345,-0.19276032645288055,-0.1660048443077102,445775022,425798767,58.44994314007442,45.1707058950761,NaN,NaN,-11.848650207486019,-6.4864142211824785
2013-07-05T09:30:00-04:00,31.16,31.2,30.84801,31.17999,14204035,10002811.75,51.8118196089069,44.6583209167299,NaN,NaN,-5.009032606830069,-45.23273806345592,0.009820549697456632,-0.15372915718588942,-0.16354970688334605,459979057,433944209.8,63.86973711325808,45.70807393479281,NaN,NaN,-9.655629137895893,-6.939159209284395
2013-07-08T09:30:00-04:00,31.34,31.37,31.075,31.16,7829793,10068736.15,51.45287534297942,44.51538887939525,NaN,NaN,17.221876293061847,-22.749643839604822,0.032446224777150534,-0.12299192591190788,-0.15543815068905842,452149264,442352805,68.44552187515202,46.73539575540951,NaN,NaN,-7.962532329203241,-7.0853553692728015
2013-07-09T09:30:00-04:00,31.28999,31.33,31.13,31.28,12468828,10372628.7,53.53394727281816,44.23623480361844,NaN,NaN,30.612791278895337,-6.151724408074735,0.054001894474692336,-0.08793578259569301,-0.14193767707038535,464618092,451339886.8,72.46007453618309,47.94711484631747,NaN,NaN,-5.938926016224807,-6.921579747408802
2013-07-10T09:30:00-04:00,31.27,31.48,31.25999,31.38,8839465,10449212.1,55.25529520881198,44.57303345731348,NaN,NaN,54.160892420550006,14.192368827353572,0.07235748718623065,-0.051490818087597034,-0.12384830527382769,473457557,459195798.4,75.40567380096462,49.30569282562049,NaN,NaN,-3.7413253381293976,-6.4672576889403155
2013-07-11T09:30:00-04:00,31.7,31.94,31.67,31.91,10324980,10517896.25,63.064954293041474,46.17761193340836,NaN,NaN,121.55793189798565,43.70889185673254,0.11502178122950359,0.01992892126305179,-0.0950928599664518,483782537,466797301.4,77.87194949597702,51.27780592248977,NaN,NaN,0.7958617202636653,-5.429669201911175
2013-07-12T09:30:00-04:00,31.94,31.97,31.81,31.92999,7208902,10497914.6,63.32495985280327,48.071279785674434,NaN,NaN,121.63531859021661,69.03776209614189,0.13787596090696663,0.07725209116725651,-0.06062386973971014,490991439,472999777.8,79.66389501672208,53.857568287088235,NaN,NaN,4.532967492698113,-4.006435388395563
2013-07-15T09:30:00-04:00,31.95,32.05,31.83,32.02,4549965,10436451.5,64.53555738266977,50.310530028309934,NaN,NaN,120.03723303764492,89.6008334450585,0.1512697564383636,0.12846332580824438,-0.022806430630119237,495541404,481678205.8,81.87550340534227,57.20026732197167,NaN,NaN,8.013042578728756,-2.289367107377803
2013-07-16T09:30:00-04:00,32,32.07001,31.94,32.045,4974121,10355741.55,64.8822857357246,52.25524222069198,NaN,NaN,120.40986118409602,107.56024742609864,0.15353828087271781,0.16911642046077802,0.015578139588060216,500515525,488857692.4,83.47646336047254,61.07523532609876,NaN,NaN,10.994004612203758,-0.39174257600900875
2013-07-17T09:30:00-04:00,32.14,32.19,32.00999,32.07001,5480621,10313834.3,65.24832721261603,54.00646350969555,NaN,NaN,125.71026861702444,121.87012266539352,0.1483654744932818,0.20103498270466247,0.052669508211380674,505996146,495365410.2,84.7881123565421,65.1322576029311,NaN,NaN,13.594798912760506,1.6063347795294933
2013-07-18T09:30:00-04:00,32.09,32.14999,31.92,31.99001,4266715,9965967.7,62.986735837692656,55.41671836878174,NaN,NaN,110.01624209447711,119.5617847046918,0.13176010537524951,0.21736963993044256,0.08560953455519305,501729431,498954789,85.47307002361546,68.98023625868507,NaN,NaN,15.267097456006681,3.55787230474052
2013-07-19T09:30:00-04:00,31.66,31.69,31.37,31.44501,13599613,9856873.35,50.21688732153221,56.03671583654212,NaN,NaN,39.58683146274803,103.1520872791981,0.07888398669876136,0.18421451792864474,0.10533053122988338,488129818,498382464.8,84.81726852557772,72.47295601173595,NaN,NaN,13.115040342443418,4.9231820244123625
2013-07-22T09:30:00-04:00,31.50999,31.58,31.44,31.53999,5038672,9503237.4,52.0417100371333,56.580886052617934,NaN,NaN,36.885302110327515,86.5217010937346,0.04670815432263439,0.16371572413317637,0.11700756981054197,493168490,497907882,84.2400816489714,75.28492404560238,NaN,NaN,11.856107413126422,5.9135999370858
2013-07-23T09:30:00-04:00,31.58,31.63,31.39999,31.411,4584469,9173172.2,49.393705065044166,56.87296314681915,NaN,NaN,25.1093451830745,67.4615978935303,0.01479387117255511,0.13549990877623586,0.12070603760368075,488584021,495521581.2,81.24621016567826,77.29167889032365,NaN,NaN,10.014821636870003,6.499488751340686
2013-07-24T09:30:00-04:00,31.75999,31.78,31.56,31.62,5791406,9049519.65,53.52041903689334,57.23353422919053,NaN,NaN,44.0086630373817,51.12127677760175,0.006252535437725429,0.12852170690083753,0.1222691714631121,494375427,493197437.4,78.32646211640116,78.71143024577556,NaN,NaN,9.61414460809126,6.94443958801934
2013-07-25T09:30:00-04:00,31.59,31.67999,31.49001,31.64,4828766,8267442.75,53.9077623044968,57.38324442173267,NaN,NaN,30.747446398404758,35.267517638387275,0.0007328720120890336,0.1231852614782234,0.12245238946613436,499204193,492692389.8,77.67322984880464,79.69739401260031,NaN,NaN,9.395305642682384,7.294563310114061
2013-07-26T09:30:00-04:00,31.5,31.73,31.42371,31.73,6027078,8241585.9,55.6969845620602,57.686395080238434,NaN,NaN,29.974353106135133,33.34502196706471,0.0018620502315958853,0.12477995225562921,0.12291790202403333,505231271,496112680.4,78.9533687335629,80.44795450248681,NaN,NaN,9.702636451762292,7.638573758920951
2013-07-29T09:30:00-04:00,31.66,31.78,31.61,31.67999,3977667,7983191.5,54.4325561188682,57.750581426384876,NaN,NaN,35.34921491663127,33.03780452832545,-0.0018399549035805068,0.12061795839455769,0.1224579132981382,501253604,497729703.2,79.5503422330188,80.95440219511794,NaN,NaN,9.621129795966718,7.921796049927489
2013-07-30T09:30:00-04:00,31.8,31.97,31.765,31.84,5562168,7782480.15,57.7384079259888,57.92794662046894,NaN,NaN,64.0609696233802,40.82812941638661,0.005031192440955637,0.12874690384933274,0.1237157114083771,506815772,501376053.4,80.86816215280083,81.34457993453479,NaN,NaN,10.455034547582239,8.283687263878168
2013-07-31T09:30:00-04:00,31.89999,32.02,31.67999,31.73,6840891,7399758.9,54.795325223610334,57.33725882979528,NaN,NaN,47.59967124399117,41.54633105770851,0.0009263155132567119,0.124873605799948,0.12394729028669128,499974881,502495944.2,81.26743453089719,81.58711457988625,NaN,NaN,10.369263552662119,8.581626733704447
2013-08-01T09:30:00-04:00,31.94,32.10001,31.92999,32.07001,7747254,7207270.45,61.35283557732628,57.196392810118354,NaN,NaN,96.41250991306339,54.679343760640236,0.018873539278341844,0.1475392143846186,0.12866567510627674,507722135,504199532.6,81.88670961293096,81.74588705104402,NaN,NaN,12.24891816173114,9.10552550913683
2013-08-02T09:30:00-04:00,32.07001,32.23,32.00999,32.21001,4433367,6718737.05,63.688552596923444,57.13589246827933,NaN,NaN,117.03076290937616,72.09062572128843,0.036894581857421616,0.17478390242805375,0.13788932057063213,512155502,505584378.8,82.39617529446733,81.78307790026724,NaN,NaN,14.545331875179723,9.882640704285816
2013-08-05T09:30:00-04:00,32.14,32.32001,32.13,32.28,4369055,6545700.15,64.8328333959754,57.13236015829724,NaN,NaN,131.75378148620132,91.37153903520246,0.049465234949716275,0.19972086425777746,0.1502556293080612,516524557,508638569.4,83.49852556176509,81.78465377178814,NaN,NaN,16.785436467378293,10.868754384727598
2013-08-06T09:30:00-04:00,32.28,32.28,32.02,32.11,4686234,6156570.45,59.89562181324844,56.75002405834241,NaN,NaN,95.26610218860739,97.61256554824789,0.04253237268032567,0.2034210951584683,0.16088872247814262,511838323,509643079.6,83.85658158017793,81.71811585919069,NaN,NaN,17.290104334608554,11.786090091853449
2013-08-07T09:30:00-04:00,32.03999,32.12,31.89999,32.03,5249965,5977095.45,57.66994538517584,56.37025331173407,NaN,NaN,52.91613643334061,98.67585858611777,0.02938516678712405,0.1976201809620477,0.16823501417492365,506588358,510965775,84.33847656573003,81.63707346934174,NaN,NaN,17.073314661969366,12.541407887584294
2013-08-08T09:30:00-04:00,32.17999,32.205,31.94,32.13499,5058691,5713781,59.78211508168134,57.053483866030426,NaN,NaN,70.88674216380223,93.57070503626554,0.024770783850520617,0.19919849398807443,0.17442771013755382,511647049,511750757.8,84.6316794878404,81.62381710950335,NaN,NaN,17.485584288922777,13.24771880206122
2013-08-09T09:30:00-04:00,32.08,32.14999,31.87151,31.97,3669777,5536824.75,55.126918100578514,57.27385587056223,NaN,NaN,37.988782269590146,77.76230890830834,0.008460552108806446,0.18500340027356188,0.17654284816475543,507977272,510915111.8,82.85343412602336,81.52477085786423,NaN,NaN,16.49466303107764,13.711567977634994
2013-08-12T09:30:00-04:00,31.78999,32.21001,31.78999,32.17999,4983281,5558490.55,59.454408393182575,57.992477536857834,NaN,NaN,55.06911752010783,62.425376115089634,0.009585662490268265,0.18852492627759077,0.1789392637873225,512960553,510202311,81.28452736979702,81.52750780101555,NaN,NaN,16.903229566705882,14.16751963321655
2013-08-13T09:30:00-04:00,32.22,32.46001,32.065,32.39999,4715469,5545557.95,63.4331563595829,58.70053020276423,NaN,NaN,119.51931227212589,67.27601813179334,0.02219689454149848,0.2066853819641956,0.18448848742269713,517676022,511369850.8,81.88945893123724,81.78200757350385,NaN,NaN,18.486830189471313,14.784563998395802
2013-08-14T09:30:00-04:00,32.39,32.47,32.25999,32.37,5295672,5536310.5,62.5323202226826,59.31657005406321,NaN,NaN,125.59904662452824,81.81260017003086,0.025341934518576664,0.21616590557091797,0.1908239710523413,512380350,512528249.2,82.4940504567982,82.12635190264625,NaN,NaN,19.505305298548798,15.458955612703372
2013-08-15T09:30:00-04:00,32.05,32.05,31.795,31.85001,7036066,5674778.05,49.425824032720115,58.8686300162532,NaN,NaN,-1.1477735726695424,67.40569702273652,-0.008939534163905194,0.1796495533474598,0.188589087511365,505344284,511267696.2,79.38824205889097,82.15741428302682,NaN,NaN,16.062295906497468,15.545147083245386
2013-08-16T09:30:00-04:00,31.85001,31.97501,31.75,31.815,7235617,5356578.25,48.68593367453192,58.45815698451491,NaN,NaN,-22.03963892175668,55.40001278446714,-0.03391145656153277,0.14619976680944902,0.1801112233709818,498108667,509293975.2,74.64924143533094,81.80733565462056,NaN,NaN,13.123317828858896,15.199171475475888
2013-08-19T09:30:00-04:00,31.84,32.03999,31.72,31.72,4812078,5345248.55,46.64542393683537,57.66580098528966,NaN,NaN,-35.146938657481,37.35680154894938,-0.05549039685080248,0.11074822730747869,0.16623862415828117,493296589,505361182.4,66.17286031393456,80.75767123755868,NaN,NaN,10.078591453657491,14.467660043787545
2013-08-20T09:30:00-04:00,31.81,31.92,31.69,31.77,3317868,5281918.5,47.883483754309076,57.17209802319671,NaN,NaN,-55.24071678147198,2.4047957382298066,-0.06443144288752672,0.08569932054887275,0.15013076343639947,496614457,501148869.4,58.50955508266309,79.13210841982767,NaN,NaN,7.9570416903085155,13.537571707576255
2013-08-21T09:30:00-04:00,31.77,31.94,31.62,31.7,6068309,5295763.65,46.26490315223411,56.09438856426156,NaN,NaN,-72.96145180321119,-37.307303947318076,-0.07249386460247406,0.05951343268330689,0.13200729728578095,490546148,496782029,51.81088490451884,76.98383522636966,NaN,NaN,5.719280585065142,12.420672975788953
2013-08-22T09:30:00-04:00,31.78999,31.88,31.64,31.84,6049102,5356780.45,49.91160600944644,55.11032095087034,NaN,NaN,-67.59874214078017,-50.597497660940206,-0.06601599856234894,0.04948729908284477,0.11550329764519371,496595250,495032222.2,49.37168597311059,74.62494313198704,NaN,NaN,4.831760500507422,11.336542622177307
2013-08-23T09:30:00-04:00,32.11,32.14,31.98,32.07001,5072305,5309041.8,55.28113817688537,54.42805700664962,NaN,NaN,31.650959163486522,-39.85937804389157,-0.04486945055690758,0.059416484449059226,0.1042859350059668,501667555,495743999.8,50.39472677990866,72.26038607614014,NaN,NaN,5.6605295803577915,10.52568361620309
2013-08-26T09:30:00-04:00,32.05,32.2,31.91,31.92,6796844,5450000.65,51.41027811363603,53.82196102810587,NaN,NaN,3.391588964860384,-32.151672519423286,-0.039787115914670296,0.05455204011262893,0.09433915602729923,494870711,496058824.2,50.86763397510744,69.90403267577797,NaN,NaN,5.200788056727265,9.764984250563685
2013-08-27T09:30:00-04:00,31.62,31.72771,31.28999,31.36,6861402,5514962.35,40.1171741090403,52.56819165123905,NaN,NaN,-206.84541216297072,-62.47261159572304,-0.07111386447639345,0.005446825431807412,0.07656068990820086,488009309,494337794.6,48.16442810096884,67.32017207115216,NaN,NaN,0.7853036769813533,8.482172740051924
2013-08-28T09:30:00-04:00,31.32001,31.53999,31.3,31.38,4500605,5397948.05,40.6188676406205,51.199388262591846,NaN,NaN,-192.0945124592835,-86.2992237269375,-0.08644259320835941,-0.0314925516022484,0.054950041606111014,492509914,494730547.8,48.83268930994278,64.76310134415948,NaN,NaN,-2.4504442665839004,6.920370310532521
2013-08-29T09:30:00-04:00,31.44,31.71001,31.39999,31.55,4787699,5249970.3,44.84845054745708,50.46521200879745,NaN,NaN,-120.99494991780789,-96.97846528234304,-0.08117084602642045,-0.04651351592691455,0.034657330099505904,497297613,494871020.4,49.085512152060105,62.351106917447815,NaN,NaN,-3.7850407583354095,5.391025872122817
2013-08-30T09:30:00-04:00,31.62,31.62,31.32001,31.39999,7171563,5386880.1,42.00524313251163,49.21884306160667,NaN,NaN,-134.56914728250288,-130.2224865715409,-0.08350075915863028,-0.06971861884878194,0.013782140309848333,490126050,492562719.4,45.13860129707796,59.76925505511074,NaN,NaN,-5.795980838802336,3.7928820562763663
2013-09-03T09:30:00-04:00,31.53,31.66,31.31,31.431,7394969,5538175.8,42.812347335777545,47.74592813133486,NaN,NaN,-114.94509302415841,-153.8898229693447,-0.07873051918586371,-0.0846310086724813,-0.005900489486617595,497521019,493092781,46.20824295346885,57.22059677098442,NaN,NaN,-7.162888476338453,2.2277719801885354
2013-09-04T09:30:00-04:00,31.5,31.78,31.46001,31.735,7160586,5661893.4,50.138305161121274,46.860641341223335,NaN,NaN,-53.88892995660655,-123.29852652807185,-0.052159077837185465,-0.07109933678309943,-0.018940258945913967,504681605,496427240.2,52.48436930502686,55.07704811728646,NaN,NaN,-6.056558363036956,1.044296216870608
2013-09-05T09:30:00-04:00,31.77,31.86,31.7,31.75,3714011,5585095.7,50.475425731512566,46.935612891137076,NaN,NaN,-17.736685034453007,-88.42696104310576,-0.031640408442481976,-0.05849076949901644,-0.02685036105653446,508395616,499604380.6,57.5647723425804,53.51822885183571,NaN,NaN,-5.074820723360897,0.17013665398039302
2013-09-06T09:30:00-04:00,31.85001,31.91,31.50999,31.77,5142852,5589303.75,50.951600606164696,47.09744624339657,NaN,NaN,-25.591221746420292,-69.34621540882823,-0.015599918591892269,-0.0463502592963998,-0.03075034070450753,513538468,502852551.6,62.034103077350295,52.617147540551386,NaN,NaN,-4.139501893234964,-0.44552599562180084
2013-09-09T09:30:00-04:00,31.96001,32.22,31.92999,32.14999,5714574,5691543.6,59.01467960856709,47.98096450566312,NaN,NaN,88.59016848867869,-24.714352254591915,0.019802142261312366,-0.0059976628778670715,-0.025799805139179437,519253042,508677950,68.45158843397446,52.77991383483995,NaN,NaN,-0.697050684946566,-0.48145809409676726
2013-09-10T09:30:00-04:00,32.34,32.425,32.23,32.35001,6774789,5781119,62.50845772578652,49.0256055036258,NaN,NaN,146.89677608574416,27.65402156738859,0.05395342814889828,0.041641980046943416,-0.012311448101954866,526027831,514379312.4,73.22229097477714,53.83082354141953,NaN,NaN,3.3641231264448868,0.06791065169489757
2013-09-11T09:30:00-04:00,32.08,32.28,32.06,32.2,9332656,6011978.35,58.48202142371718,49.89825680873173,NaN,NaN,107.16447307716102,59.864702174142096,0.06306941803851543,0.06652532444618942,0.0034559064076739917,516695175,516782026.4,74.94201626795342,55.48304721023627,NaN,NaN,5.500997067427215,0.8440658539423713
2013-09-12T09:30:00-04:00,32.22,32.34,32.14,32.22501,6052633,6049826.4,58.95670308404829,50.54433517120329,NaN,NaN,129.8576921001658,89.38357760106585,0.06704151371744091,0.08725779855447513,0.02021628483703422,522747808,519652464.8,76.85444026407674,57.44610108816243,NaN,NaN,7.3567309975036,1.7744465887368326
2013-09-13T09:30:00-04:00,32.28999,32.325,32.14999,32.255,3991168,5897581.5,59.55386314909742,50.84952981207557,NaN,NaN,116.46428212720804,117.79467837579152,0.06774630313477362,0.10489916375550123,0.037152860620727625,526738976,522292566.4,78.4811644384425,59.452275206629125,NaN,NaN,9.046776250978654,2.81335082619995
2013-09-16T09:30:00-04:00,32.50999,32.50999,32.12,32.21001,8213484,5946474.85,58.18615822149182,51.333521248351,NaN,NaN,108.6874558539703,121.81413584884986,0.06142680609815285,0.11393636824341868,0.05250956214526584,518525492,522147056.4,78.1551321455499,61.40138221880359,NaN,NaN,10.085015213703858,3.852160024414794
2013-09-17T09:30:00-04:00,32.25999,32.44,32.25,32.37,6401363,6025939.1,61.566452241873066,52.86561254355333,NaN,NaN,109.70465213544783,114.37571105879059,0.06397724148525456,0.13248111400183404,0.06850387251657948,524926855,521926861.2,77.62957243521458,63.506035385535434,NaN,NaN,11.961010832870391,5.010567282765594
2013-09-18T09:30:00-04:00,32.47,32.82001,32.39,32.77901,8828082,6301449.8,68.56323019944742,54.861638440612396,NaN,NaN,153.0515069362895,123.55311783061629,0.08769953820827835,0.17812829527692742,0.09042875706864907,533754937,525338813.6,79.88656724417913,65.72416952369517,NaN,NaN,16.011235617859715,6.582091330636183
2013-09-19T09:30:00-04:00,32.83,32.91,32.785,32.80499,6649168,6330492.75,68.94990023642458,56.58317056125293,NaN,NaN,161.37776823134786,129.85713305685272,0.09880442069663341,0.21393428293944083,0.11512986224280743,540404105,528870073,81.9197316093084,68.06947091349862,NaN,NaN,19.366450173649742,8.408428308209547
2013-09-20T09:30:00-04:00,32.75999,32.78,32.38,32.41499,7779633,6417019.3,57.51364935659245,57.69091386297299,NaN,NaN,93.30571174251949,125.225418979915,0.07464674903692625,0.20843829853896523,0.13379154950203898,532624472,530047172.2,82.55284153696476,70.7419166449191,NaN,NaN,18.727500800060387,9.882581521331096
2013-09-23T09:30:00-04:00,32.62,32.7,32.34,32.50999,8043496,6565578.85,59.28517047612068,58.867544087283214,NaN,NaN,82.9762331640543,120.0831744419318,0.060435008564505205,0.2093353102076705,0.14890030164316528,540667968,534475667.4,84.7205888873332,73.49279849733797,NaN,NaN,18.770752123897196,11.152320178840538
2013-09-24T09:30:00-04:00,32.45,32.52,32.243,32.37,4747551,6463114.2,55.60578751695793,59.25807854127155,NaN,NaN,54.008619357609255,108.94396788636406,0.03806793156513322,0.1964852160995818,0.1584172845344486,535920417,536674379.8,85.67240732975432,75.86337264196138,NaN,NaN,17.647542286815362,12.08020905140837
2013-09-25T09:30:00-04:00,32.41,32.45,32.22,32.32001,4591285,6349608.35,54.30957523474011,59.53194636293066,NaN,NaN,41.74445751024501,86.68255800115517,0.017418591989151994,0.18019052452088857,0.16277193253173658,531329132,536189218.8,84.42269841237815,77.78179593266123,NaN,NaN,16.34650959737453,12.689680557974965
2013-09-26T09:30:00-04:00,32.45,32.595,32.338,32.44,5065266,6377841.4,56.90624699323997,59.95727824772175,NaN,NaN,60.784813786123884,66.56396711211038,0.009736395455197944,0.17494242685073402,0.16520603139553608,536394398,535387277.4,82.286038086607,79.2283627190367,NaN,NaN,16.011965104305233,13.164292636022147
2013-09-27T09:30:00-04:00,32.25,32.3,32.1301,32.24001,6199539,6448433.4,51.63862679571032,59.430417332517685,NaN,NaN,8.379203269906684,49.57866541758782,-0.009858100881872417,0.15288340529319555,0.16274150617506797,530194859,534901354.8,80.94914199472221,80.12104511623296,NaN,NaN,14.109077544661902,13.299261908684969
2013-09-30T09:30:00-04:00,31.9001,32.16,31.81,32.03999,7522105,6465960.5,46.95692267479458,58.31959340030398,NaN,NaN,-54.25151073117483,22.13311663854198,-0.035871266003494884,0.11790242367069936,0.15377368967419425,522672754,531302312,71.66232302209065,80.00961883389822,NaN,NaN,10.995931710078134,12.970214737455422
2013-10-01T09:30:00-04:00,32.07001,32.39,32.03999,32.32001,8177758,6505099.95,53.33540157249709,57.95197769664539,NaN,NaN,-1.0133284716263486,11.128727072694856,-0.03382708605833348,0.11148983210127739,0.14531691815961087,530850512,530288331,69.2517892627155,79.6031740478098,NaN,NaN,10.298177162376037,12.588495083872653
2013-10-02T09:30:00-04:00,32.14,32.37,32.09,32.33,8127977,6553469.5,53.5500042863217,57.56578492537921,NaN,NaN,-7.306618960645583,1.3185117785167428,-0.03145985006603602,0.10599210557706584,0.13745195564310186,538978489,531818202.4,70.84525028735355,79.17394619232957,NaN,NaN,9.812797796617293,12.19196689997903
2013-10-03T09:30:00-04:00,32.35001,32.36,31.88499,32.05,6492594,6692398.65,47.022718388023456,56.67070315673107,NaN,NaN,-79.40861173902645,-26.720173326513322,-0.04744900419292497,0.07814070040194565,0.12558970459487062,532485895,531036501.8,68.88102454928313,78.48822191453247,NaN,NaN,7.295596558848515,11.49248542267467
2013-10-04T09:30:00-04:00,32.0201,32.23,32,32.17999,5340809,6702296.5,50.06576181239738,56.09067484179576,NaN,NaN,-81.0859404879453,-44.61320207808372,-0.04783266027688278,0.06579887924876715,0.11363153952564993,537826704,532562870.8,70.59537676398429,77.94823938727778,NaN,NaN,6.157320437216807,10.73031899618069
2013-10-07T09:30:00-04:00,31.95,32.23,31.94,32.03999,4567738,6644954.7,46.938593024378434,55.045827754831855,NaN,NaN,-108.89459142935064,-55.54181821771888,-0.05553609137618963,0.04421142530541289,0.09974751668160252,533258966,534680113.2,72.83121656870013,77.60549968252676,NaN,NaN,4.2334581940429095,9.802196024446722
2013-10-08T09:30:00-04:00,32.02,32.06,31.5,31.53,8092660,6710848.25,37.700609668850376,52.841354859789206,NaN,NaN,-223.2958605657986,-99.99832463655333,-0.09090890850982827,-0.01388861895568283,0.07702028955414544,525166306,533543272,69.763824768891,76.8824466485776,NaN,NaN,-0.8331851130324806,8.282855861949693
2013-10-09T09:30:00-04:00,31.62,31.77,31.38,31.64999,10270414,6757736.15,40.65974347507364,50.82062937683556,NaN,NaN,-216.9302293883557,-141.92304672209536,-0.10135900759641762,-0.04967846994137659,0.051680537655041034,535436720,532834918.2,67.84642030854945,75.87721012709483,NaN,NaN,-3.8771233908828506,6.545715968687902
2013-10-10T09:30:00-04:00,31.92,32.22,31.89999,32.17999,8204820,6865345.5,51.59618220122907,50.39795315145248,NaN,NaN,-48.214076300143546,-135.68413963431877,-0.06924332035930222,-0.03487361279408674,0.03436970756521548,543641540,535066047.2,70.58838269910156,75.0226059243903,NaN,NaN,-2.6409275967782206,5.233338316478456
2013-10-11T09:30:00-04:00,32.12,32.45,32.09,32.45,8908566,7111215.4,56.04108373197735,50.16623266972795,NaN,NaN,23.449141161632525,-114.77712330440322,-0.02856591516680022,-0.0013376863932847982,0.027228228773515422,552550106,538010727.6,73.7679143511485,74.24027202894854,NaN,NaN,-0.016230833949779283,4.48339986641728
2013-10-14T09:30:00-04:00,32.25999,32.59,32.21001,32.56,7139906,7057536.5,57.74352942397336,50.31892852022906,NaN,NaN,57.371104292012724,-81.52398416013054,0.005199075287175482,0.033727072882484777,0.028527997595309294,559690012,543296936.8,78.30256216538339,73.71385451720776,NaN,NaN,2.612676469115776,4.2161536668027795
2013-10-15T09:30:00-04:00,32.48,32.64,32.35001,32.36,7250359,7099986.3,53.67340721935004,50.2734879477012,NaN,NaN,53.71477500646431,-26.121857045677963,0.01306615597744288,0.04486069256711289,0.03179453658967001,552439653,548751606.2,81.79892538043516,73.52644215778325,NaN,NaN,3.3922218579084764,4.098449122675022
2013-10-16T09:30:00-04:00,32.5,32.72,32.48,32.67,8192168,7068190.6,58.55028682839145,50.390919364497734,NaN,NaN,106.65880590195648,38.59595001238449,0.03680575131871971,0.07780172573806965,0.04099597441934994,560631821,553790626.4,84.31365951130226,73.67127225954721,NaN,NaN,5.725725197312036,4.3309171333374525
2013-10-17T09:30:00-04:00,32.46001,32.71001,32.39,32.67999,7421180,7106791.2,58.70116899484497,50.89538666443592,NaN,NaN,106.61292950121327,69.56135117265585,0.050019637451694125,0.1035205212339676,0.053500883782273474,568053001,558672918.6,86.29013159355767,74.0527715166069,NaN,NaN,7.575865253782546,4.794481150543895
2013-10-18T09:30:00-04:00,33.02,33.25999,32.91,33.24001,7934691,7114544.1,66.14170466356262,52.265728235062205,NaN,NaN,235.10812113544782,111.8931471674189,0.09093114398172321,0.1671648137594275,0.07623366977770428,575987692,563360435.8,87.87036284400139,75.21048864674336,NaN,NaN,11.905688848709906,5.810367964567611
2013-10-21T09:30:00-04:00,33.38,33.50999,33.35001,33.42,5401551,6982446.85,68.1291259682888,53.32242283476161,NaN,NaN,254.4590671117142,151.3107397313592,0.12259845635794263,0.22948174022513257,0.10688328386718994,581389243,567700282,89.12064144443973,76.62969237400937,NaN,NaN,16.0550410088778,7.273892685183352
2013-10-22T09:30:00-04:00,33.53999,33.57001,33.2301,33.41,16358137,7562976.15,67.89069021258722,54.34675754378058,NaN,NaN,195.2726839473276,179.62232151953185,0.13440748945597045,0.274892645687153,0.14048515623118255,565031106,570218572.6,89.779008661718,77.98210368646399,NaN,NaN,19.196687467734268,8.977149082690625
2013-10-23T09:30:00-04:00,33.25,33.32001,33.10001,33.25,5133328,7590078.3,64.02948201419453,55.56152637422137,NaN,NaN,135.2649796382267,185.3435562667859,0.12327169736376795,0.2945747779358925,0.17130308057212454,559897778,570071764,89.43920880444179,79.4505454189753,NaN,NaN,20.620938952774182,10.640547635559704
2013-10-24T09:30:00-04:00,33.28999,33.42999,33.2,33.33,3533554,7513492.7,65.09832510012633,56.63528089477343,NaN,NaN,127.72628905139132,189.5662281768215,0.11337356816260244,0.3130200407753776,0.19964647261277516,563431332,569147430.2,87.20134530940311,80.63668602936237,NaN,NaN,22.102599155294772,12.277983566950429
2013-10-25T09:30:00-04:00,33.57001,33.645,33.39999,33.5,3381301,7372580.8,67.32053853659994,58.0911341456464,NaN,NaN,131.64887384656305,168.87437871904456,0.11025524682126642,0.3374655311393582,0.22721028431809176,566812633,567312418.4,82.77350742176574,81.34684966172419,NaN,NaN,24.023177067509323,13.955868352744556
2013-10-28T09:30:00-04:00,33.59,33.64,33.445,33.61,5014028,7247176.95,68.70885784288176,60.30600901522007,NaN,NaN,119.52352615398063,141.88727052749783,0.10746949141835554,0.3615471485910362,0.25407765717268066,571826661,565399902,78.3103842558461,81.9573181965067,NaN,NaN,26.03491735531696,15.681446781683471
2013-10-29T09:30:00-04:00,33.8,33.905,33.67,33.825,4975004,7087039.25,71.27730218654133,62.49297749461062,NaN,NaN,126.078580335326,128.0484498050975,0.11149412579530255,0.39344531441680886,0.2819511886215063,576801665,567754013.8,79.75723566762815,82.80809072215517,NaN,NaN,28.549708178249816,17.519769838335804
2013-10-30T09:30:00-04:00,33.9,33.92,33.62,33.76,5574894,6959385.1,69.42203832619658,63.76625293210831,NaN,NaN,106.49414648015205,122.29428317348261,0.10145333902807957,0.4087678624066058,0.3073145233785262,571226771,570019812.4,81.06637183542927,83.55651851760716,NaN,NaN,30.10095474372596,19.317081967677254
2013-10-31T09:30:00-04:00,33.69,33.84,33.61,33.65,28712024,8070356.6,66.27799995568616,64.49746123380179,NaN,NaN,88.98677970626143,114.54638130445662,0.08001994586079769,0.40733945570452335,0.32731950984372565,542514747,565836495.4,71.82993187455932,83.41809119785079,NaN,NaN,30.532895686882593,20.919341070420874
2013-11-01T09:30:00-04:00,33.79,33.849,33.53,33.66,4635178,8035075.05,66.4268587347745,65.11769904171615,NaN,NaN,79.01373077870076,104.01935269088415,0.06004519961538218,0.40237600936295337,0.3423308097475712,547149925,561903953.8,64.40150082023204,82.42515824462569,NaN,NaN,30.928889505773828,22.349276561185583
2013-11-04T09:30:00-05:00,33.76,33.82,33.66,33.79,5976753,8105525.8,68.38092092032674,66.16823573464306,NaN,NaN,80.49127685635726,96.21290283135947,0.049553078709096754,0.4042721581339421,0.3547190794248454,553126678,558163957.2,58.23346560764625,80.74191111799792,NaN,NaN,31.800410671467745,23.699438576940178
2013-11-05T09:30:00-05:00,33.66,33.8,33.58,33.7,4512072,7926496.4,65.53700449028577,66.66728699620694,NaN,NaN,69.8515083044055,84.96748842517536,0.03140167044188702,0.3939711674772042,0.36256949703531716,548614606,552526545.4,50.398115767440764,78.31937227915067,NaN,NaN,31.785898469870293,24.85464713307305
2013-11-06T09:30:00-05:00,33.87,34.05,33.83,34.04,5250766,7675514,70.52431965892312,67.5117977579268,NaN,NaN,101.87540106825509,84.04373934279597,0.03677112073980837,0.4085333979600776,0.3717622772202692,553865372,549054265.6,46.26866440212314,75.46069605119105,NaN,NaN,33.22422748766943,26.050301469443962
2013-11-07T09:30:00-05:00,34.04,34.1,33.56,33.595,10535261,7792036.05,58.57617260702147,66.97140261103101,NaN,NaN,68.03957946293333,79.85429929413036,0.006420839135319878,0.37978832613941904,0.37336748700409916,543330111,549217338.4,46.490413137325525,72.50498535785707,NaN,NaN,30.690703117074612,26.713215990534056
2013-11-08T09:30:00-05:00,33.67,33.92,33.51,33.9,8947220,7793968.75,63.18047979001261,66.61792788401128,NaN,NaN,68.38976389826573,77.72950591804334,0.0031217469658345043,0.3772696707113923,0.3741479237455578,552277331,550242819.6,47.945284028610004,69.56388839958352,NaN,NaN,30.02536868293559,27.186380660877134
2013-11-11T09:30:00-05:00,33.89,33.97,33.8,33.94,7829879,7828467.4,63.74955832496765,66.3221327491813,NaN,NaN,87.1281104850967,79.05687264379124,0.000031964124112937586,0.37418787890069893,0.374155914776586,560107210,551638926,49.9407869737822,66.71830113615952,NaN,NaN,29.67903010865951,27.542473439131758
2013-11-12T09:30:00-05:00,33.7901,34.1,33.7901,34.03,4709771,7701438,65.05815878061878,66.39560966106875,NaN,NaN,99.03434621993684,84.8934402268975,0.0004261541744036146,0.37468860749459054,0.3742624533201869,564816981,554879401,54.31813391039559,64.20965292944194,NaN,NaN,29.7904869526593,27.86361822677855
2013-11-13T09:30:00-05:00,33.89,34.33,33.866,34.32,6750436,7629351.4,68.94793345852494,66.67058168666865,NaN,NaN,141.2686326485693,92.77208654296035,0.015745928315798796,0.3939448637149354,0.3781989353991366,571567417,558419810,58.57970362499026,62.16524995198388,NaN,NaN,31.11178110735854,28.327641495432832
2013-11-14T09:30:00-05:00,34.1,34.26,34.05,34.225,8478520,7682218.4,66.3424954005443,66.60072146266468,NaN,NaN,148.16717085473272,108.79760482132023,0.01501199280816401,0.39696392640934164,0.38195193360117763,563088897,562371567.2,62.75610608141928,60.73543557053056,NaN,NaN,31.39834673324964,28.766313672263806
2013-11-15T09:30:00-05:00,34.21,34.33,34.19,34.3,7706316,7670799.65,67.39017925649742,66.50653013506579,NaN,NaN,164.0452100144122,127.92869404454953,0.01506916469741243,0.40078838947294315,0.3857192247755307,570795213,566075143.6,66.1962007380466,59.8701367478306,NaN,NaN,31.94175356964418,29.219947943318147
2013-11-18T09:30:00-05:00,34.36,34.37,34.1,34.17,5240009,7662722.55,63.689487888427614,65.96454339948625,NaN,NaN,128.8759180461002,136.27825555675022,0.002502223574678053,0.3888470042438783,0.38634478066920025,565555204,567164742.4,67.15733421467604,58.97014378690545,NaN,NaN,31.320686031621797,29.520053384504383
2013-11-19T09:30:00-05:00,34.13,34.295,33.99,34.05,4449145,7067272.95,60.39268363971562,65.31958949330904,NaN,NaN,86.82273214887908,133.83593274253866,-0.01668601363021094,0.3654872636314366,0.3821732772616475,561106059,566422558,65.78526287322515,57.87863600389088,NaN,NaN,29.836212945966338,29.565219036141805
2013-11-20T09:30:00-05:00,34.08,34.25,33.86,33.94,4326136,7026913.35,57.4566448509665,64.68949270011477,NaN,NaN,50.63063680131887,115.70833357308857,-0.03834226440376742,0.33424544675693824,0.37258771116070566,556779923,563465059.2,60.48240782837561,57.06809857202062,NaN,NaN,27.730722819153208,29.303148148000577
2013-11-21T09:30:00-05:00,34.03,34.24,34.03,34.23,5391021,7119786.7,62.61660341798915,64.41733160605868,NaN,NaN,89.61762281217234,103.9984239645765,-0.034795706514501756,0.3290930780175785,0.36388878453208023,562170944,563281468.6,60.158227453502306,56.7650076172542,NaN,NaN,27.36652786570935,29.02648810767326
2013-11-22T09:30:00-05:00,34.23,34.23,34.1101,34.16,3110906,7106266.95,60.70275471303879,63.86889116268096,NaN,NaN,81.25843629944985,87.44106922158403,-0.03853348536064288,0.3157219278312766,0.3542554131919195,559060038,560934433.6,56.02407798813901,56.60719421586084,NaN,NaN,26.5047439892398,28.66623894789705
2013-11-25T09:30:00-05:00,34.22,34.25,34.08,34.16,9180400,7314585.55,60.70275471303879,63.52358760716333,NaN,NaN,73.46399080743186,76.35868377385036,-0.04208594273309629,0.3016479847755491,0.3437339275086454,559060038,559635400.4,53.819545338653334,56.851582042376016,NaN,NaN,25.80408883234357,28.25736035996084
2013-11-26T09:30:00-05:00,34.17,34.37,34.135,34.28,5315856,7331628.15,62.95394710257641,62.982846710281414,NaN,NaN,98.42506149787854,78.67914964365025,-0.03758197647577016,0.2967564569139327,0.33433843338970287,564375894,560289367.4,54.784157452614274,57.45983154598252,NaN,NaN,25.819678777999556,27.90912013396637
2013-11-27T09:30:00-05:00,34.35,34.57,34.35,34.55,6605419,7383154.4,67.46947726664962,63.61808275739771,NaN,NaN,157.39307991384825,100.03163826615614,-0.01860619882073089,0.31108068486378926,0.32968688368452015,570981313,563129645.4,58.80847360850749,58.3396930082098,NaN,NaN,27.17028291692818,27.80357196010377
2013-11-29T09:30:00-05:00,34.61,34.79,34.6001,34.69,4232979,6159202.15,69.54252658382366,64.07251467124135,NaN,NaN,196.5226206418001,121.41263783208169,0.00019159922661893258,0.32992638271779384,0.3297347834911749,575214292,565738315,62.14128152300473,59.353692829238,NaN,NaN,28.9412959100943,27.96610395295956
2013-12-02T09:30:00-05:00,34.72,34.79,34.5,34.58,4941628,6174524.65,65.9844948202024,64.23215299232956,NaN,NaN,160.08114997303534,137.17718056679877,0.0019375788205659994,0.3321567570168824,0.3302191781963164,570272664,567980840.2,64.77944402978247,60.41359690466658,NaN,NaN,29.4029154236124,28.171362734481395
2013-12-03T09:30:00-05:00,34.46,34.7,34.46,34.66,5727939,6162083.95,67.29504860470144,64.39193083690688,NaN,NaN,142.78347161737346,151.04107672878712,0.005025221812422487,0.3365007054618445,0.33147548364942203,576000603,571368953.2,68.36612884496232,61.417025114278495,NaN,NaN,30.16558189941343,28.456251186614544
2013-12-04T09:30:00-05:00,34.56,34.815,34.46,34.69,6573887,6265174.7,67.79612279882359,64.30965864692823,NaN,NaN,138.5378300582201,159.0636304408554,0.005589597394138945,0.3384624803920957,0.33287288299795675,582574490,575008672.4,71.70020127459348,62.35420351782158,NaN,NaN,30.936413161914132,28.810560040228772
2013-12-05T09:30:00-05:00,34.78,34.78,34.535,34.58,4268831,6216077.95,63.9285416077426,64.13723337601381,NaN,NaN,112.93649254717636,150.172312967521,-0.004404360411185748,0.3273674324839746,0.33177179289516034,578305659,576473541.6,72.93649695107108,63.08137429422528,NaN,NaN,30.539221542294392,29.057511683381005
2013-12-06T09:30:00-05:00,34.82,34.9,34.71,34.82,4398298,5909229.8,68.19210522704806,64.19451380248172,NaN,NaN,140.3374363573141,138.93527611062382,0.00185404351226498,0.33408934728549156,0.3322353037732266,582703957,577971474.6,74.1787074788914,63.65155334714276,NaN,NaN,31.42055588422283,29.395089426358407
2013-12-09T09:30:00-05:00,34.92,35.03,34.855,34.93,4001612,5661949.4,69.94551897022565,64.64137316546729,NaN,NaN,148.58024644395942,136.63509540480862,0.009670514995051838,0.34432344751704136,0.3346529325219895,586705569,581258055.6,76.70514121825043,64.33353956168379,NaN,NaN,32.68246911394627,29.864715096013814
2013-12-10T09:30:00-05:00,34.92,34.94,34.82,34.86,8124852,5676698.05,67.39930477363745,65.14184610360455,NaN,NaN,116.0709185093161,131.29258478319716,0.00654458014101994,0.34283365769826446,0.3362890775572445,578580717,581774078.4,77.08425807204074,65.14061064731348,NaN,NaN,33.01792058453536,30.315173022945462
2013-12-11T09:30:00-05:00,34.91,34.9794,34.49,34.54,7537687,5818093.85,57.156132149301875,65.12038091062851,NaN,NaN,59.23788551830624,115.43259587521439,-0.019245308721273724,0.31223244165565234,0.33147775037692606,571043030,579467786.4,71.48467081995575,65.92648657528349,NaN,NaN,30.138499367727917,30.289933929342954
2013-12-12T09:30:00-05:00,34.55,34.55,34.3,34.31,5504088,5755776.45,51.1401862576203,64.30063682774502,NaN,NaN,-15.786024952614486,89.68809237525622,-0.05210112259716737,0.2663513471304668,0.3184524697276342,565538942,576914443,65.78684708228809,66.32853083448246,NaN,NaN,25.681177355545465,29.63154013308617
2013-12-13T09:30:00-05:00,34.48,34.48,34.195,34.2,4852728,5574486.85,48.510371128371034,63.429752285983035,NaN,NaN,-43.319792524214144,52.95664659895063,-0.07988649667134584,0.21859434888845186,0.2984808455597977,560686214,572510894.4,57.30369989472962,66.41993239923895,NaN,NaN,21.17605548815972,28.423613755239533
2013-12-16T09:30:00-05:00,34.38,34.629,34.335,34.54,6014532,5489897.65,56.0358258764887,63.09640022622945,NaN,NaN,10.520325339111654,25.344662377981063,-0.0741372358831966,0.20580930070580195,0.27994653658899854,566700746,568509929.8,50.88359248838225,66.21022148136244,NaN,NaN,19.60914584738849,27.164404054117956
2013-12-17T09:30:00-05:00,34.51,34.638,34.48,34.53,5579567,5506875.55,55.77761253697191,62.58380490011484,NaN,NaN,20.186706548386972,6.167819985795238,-0.06983770996706984,0.19264939913016121,0.26248710909723105,561121179,565018022.2,46.03586038114333,65.58534311911451,NaN,NaN,18.30558775211772,25.898858868117923
2013-12-18T09:30:00-05:00,34.5,34.82,34.03,34.8,17110740,6139955.3,61.00272461308843,62.121893996289046,NaN,NaN,15.326962532603742,-2.6143646113452736,-0.048644117899182604,0.2016819617232528,0.2503260796224354,578231919,566455800,48.22316881474165,64.82924991955981,NaN,NaN,18.85750609819883,24.892951329558052
2013-12-19T09:30:00-05:00,34.79,34.9199,34.73,34.86,8661348,6356715.9,62.0751076873186,61.588506932252976,NaN,NaN,101.95788802965721,20.93441798510907,-0.031263495194084584,0.2112467106298297,0.24251020582391428,586893267,570726665,54.16609558079501,64.25959378083054,NaN,NaN,19.635495490106432,24.141886209636393
2013-12-20T09:30:00-05:00,34.78,35.04,34.74,34.96,8826908,6528510.25,63.85892425668167,61.43668046343006,NaN,NaN,118.95090113642041,53.38855671723597,-0.014559926396204514,0.22431029782865863,0.23887022422486315,595720175,577733457.2,61.893772318202394,64.05347437286053,NaN,NaN,20.825256101399034,23.668081908459627
2013-12-23T09:30:00-05:00,35.28,35.43,35.2,35.42,7285972,6737263.55,70.68866159812993,61.67908139153213,NaN,NaN,238.91153899630578,99.0667994486748,0.023851193443407137,0.26868421602912207,0.24483302258571493,603006147,584994537.4,67.92838733469564,64.0222071221272,NaN,NaN,24.299165252148054,23.758236671843687
2013-12-24T09:30:00-05:00,35.43,35.52,35.42,35.52,2614065,6408946.8,71.93049827319373,61.97439392541571,NaN,NaN,229.62008737049422,140.95347561309626,0.05082589068865778,0.3083653859465372,0.2575394952578794,605620212,593894344,73.47336489939109,64.14886166675561,NaN,NaN,27.48908722961843,24.291215322954365
2013-12-26T09:30:00-05:00,35.59,35.65,35.53,35.61,3580232,6322165.6,73.03766622384353,62.62504568370864,NaN,NaN,209.38781975535258,179.76564705764602,0.06846438248483733,0.3431199733639261,0.27465559087908875,609200444,600088049,76.5163462713541,64.40456518963296,NaN,NaN,30.42496567945918,25.167465373883623
2013-12-27T09:30:00-05:00,35.7,35.7,35.54,35.58,3824964,6183142.85,72.01794153347727,62.89831970559643,NaN,NaN,174.46494939280942,194.26705933027648,0.07151231885698345,0.3640459894503181,0.2925336705933346,605375480,603784491.6,78.12887128612641,64.6867197472926,NaN,NaN,32.48093703465828,26.212247039708576
2013-12-30T09:30:00-05:00,35.55,35.569,35.46,35.51,4638796,6203433.7,69.57696830085226,62.87199465778405,NaN,NaN,129.13962439844752,196.30480398268188,0.06253970230144551,0.37070829847014153,0.308168596168696,600736684,604787793.4,78.5592133670604,64.8191534722076,NaN,NaN,33.4851112941886,27.251227647491437
2013-12-31T09:30:00-05:00,35.59,35.76,35.55,35.74,6844744,6298589.5,72.8349410293879,63.26025439033765,NaN,NaN,136.4543778304565,175.81337174951202,0.06550595394729936,0.3900510386028202,0.32454508465552084,607581428,605702849.6,78.96572320795894,64.9535438390589,NaN,NaN,35.36669157821775,28.410579637595195
2014-01-02T09:30:00-05:00,35.62,35.62,35.33,35.39,8552475,6439816.3,61.96097249601404,63.603457272245656,NaN,NaN,81.7611529318239,146.24158486177797,0.03863621474091983,0.37284035308167063,0.3342041383407508,599028953,604384597.8,76.70933483119094,65.3267341255757,NaN,NaN,33.54913979703497,29.144659660372305
2014-01-03T09:30:00-05:00,35.48,35.48,35.195,35.22,5204778,6371360.85,57.472736011454295,64.05578225466238,NaN,NaN,50.17709203130221,114.39943931696789,0.005873530355371248,0.34154605128496485,0.3356725209295936,593824175,601309344,71.57147249902026,65.73992165534227,NaN,NaN,30.57518268541245,29.3490200925209
2014-01-06T09:30:00-05:00,35.18,35.29,35.03,35.16,4524621,6384150.35,55.932770998244656,64.58595367393906,NaN,NaN,23.20415786239439,84.14728101088488,-0.021858707793724508,0.308349136187438,0.3302078439811625,589299554,598094158.8,66.55256965534676,66.40055520967208,NaN,NaN,27.705391527606654,29.114216011818865
2014-01-07T09:30:00-05:00,35.32,35.53,35.25,35.48,7161785,6522324.7,61.81011069427054,64.99840258949492,NaN,NaN,60.68251858660326,70.45585984851604,-0.020683657281295065,0.3043532723795437,0.32503692966083875,596461339,597239089.8,65.24224893046751,67.42617352696388,NaN,NaN,27.03695080811004,28.817463839860462
2014-01-08T09:30:00-05:00,35.5,35.6,35.36,35.48,4696341,6557061.15,61.81011069427054,65.42929531501623,NaN,NaN,64.08820744831375,55.982625772087474,-0.021826186535439884,0.2977541964915389,0.3195803830269788,596461339,595015072,61.83228445722896,68.55448953239856,NaN,NaN,26.512971000480395,28.488250577091883
2014-01-09T09:30:00-05:00,35.63,35.63,35.16,35.25,6341897,6467913.4,55.6258353111428,65.04523179344869,NaN,NaN,39.06058168692523,47.44251152310775,-0.038989753000809535,0.27084319177596683,0.30983294477677636,590119442,593233169.8,59.164137432311335,69.3359872907964,NaN,NaN,24.119221561794994,27.86410357490661
2014-01-10T09:30:00-05:00,35.35,35.42,35.14,35.32,12960056,6739031.85,57.03480287418302,64.68521002108186,NaN,NaN,26.842329132123314,42.77555894327197,-0.04606108801634462,0.2522565847563456,0.2983176727726902,603079498,595084234.4,61.04468193057757,69.82731488720943,NaN,NaN,22.58661811437994,27.110177080545657
2014-01-13T09:30:00-05:00,35.29,35.46,34.83,34.94,6445233,6786089.1,48.105183980680074,63.55994285851032,NaN,NaN,-17.876897758662004,34.55934781906069,-0.0750490829929506,0.20450631903150196,0.27955540202445256,596634265,596551176.6,62.51781797681946,69.87188957711064,NaN,NaN,18.240089170691125,25.843021664852152
2014-01-14T09:30:00-05:00,35.08,35.55,35.04,35.53,6419361,6864420.75,58.87192880512708,62.715890516152974,NaN,NaN,33.370359334828336,29.096915968705694,-0.054180231295694214,0.21183011290483478,0.266010344200529,603053626,597869634,63.84132541891767,69.5799565831265,NaN,NaN,18.10230924932111,24.737205605490576
2014-01-15T09:30:00-05:00,35.73,36.05,35.68,35.96,9673963,7047392.3,64.6313638455432,62.19452377132079,NaN,NaN,150.0763803177573,46.294550542594436,-0.013243392185164238,0.2494561039690737,0.26269949615423793,612727589,601122884,66.94303100693077,69.11350416223648,NaN,NaN,20.19034301924019,24.087653807454807
2014-01-16T09:30:00-05:00,35.98,36.008,35.87,35.95,6931286,7114978.25,64.40548237483443,61.577939210677286,NaN,NaN,157.7926708902901,70.04096838326741,0.010076108193268318,0.27529463139582333,0.265218523202555,605796303,604258256.2,69.6455387508468,68.62273219648596,NaN,NaN,21.6590644862282,23.740712475851005
2014-01-17T09:30:00-05:00,35.89,35.9599,35.67,35.75,6338677,6576375.1,59.89674260528528,60.712139287235,NaN,NaN,111.97177378413818,87.06685731367038,0.00898263360139212,0.27644681520429515,0.26746418160290303,599457626,603533881.8,68.25715108122307,67.91760932470716,NaN,NaN,21.3241541778813,23.39548986185533
2014-01-21T09:30:00-05:00,36.03,36.03,35.63,35.93,6294177,6458016.55,62.44491207779025,60.202706699873424,NaN,NaN,123.10539971371922,115.26331680814663,0.016875140012763856,0.28855810661885783,0.271682966606094,605751803,605357389.4,69.88469913312224,67.29800116514014,NaN,NaN,21.897777358340402,23.18153093278177
2014-01-22T09:30:00-05:00,35.89,35.95,35.8,35.89,4215882,6227465.25,61.50958474993673,59.39375267991262,NaN,NaN,114.78458167317424,131.5461612758158,0.01590779910429707,0.2915677154864653,0.27565991638216825,601535921,605053848.4,69.24821008387121,66.60389308484817,NaN,NaN,22.058691348021505,23.021125277816015
2014-01-23T09:30:00-05:00,35.73,35.82,35.575,35.82,6417934,6184063.35,59.82092398130855,59.24089207171938,NaN,NaN,61.505551631934054,113.83199553865116,0.007487200141889083,0.2850189165595296,0.2775317164176405,595117987,601531928,62.17273409599536,65.56556446090562,NaN,NaN,21.685132925650326,22.83026922750663
2014-01-24T09:30:00-05:00,35.67,35.73,35.12,35.13,15496614,6828190.8,46.32143429910128,58.444370520837026,NaN,NaN,-64.553492083854,69.36276294382235,-0.044747551273712105,0.22159727732550039,0.2663448285992125,579621373,596296942,53.43336111975762,64.26998507667257,NaN,NaN,16.597186953425492,21.939828902637895
2014-01-27T09:30:00-05:00,35.18,35.2,34.63,34.8,8013962,7049877.3,41.49815356323128,57.41332641833606,NaN,NaN,-172.62693797846322,12.443020591302064,-0.09862958494754537,0.14305784741478078,0.24168743236232615,571607411,590726899,46.02088979667864,62.803436515339136,NaN,NaN,10.641008268371435,20.32571166917126
2014-01-28T09:30:00-05:00,34.49,34.65,34.39,34.59,13145418,7515900,38.734114287331174,55.76504096069754,NaN,NaN,-218.25958807082523,-55.82997696560683,-0.1428366015537165,0.06314168042018053,0.20597828197389703,558461993,581268937,36.70884676803538,60.7653363608797,NaN,NaN,4.892250342787217,18.120931479687826
2014-01-29T09:30:00-05:00,34.3,34.52,34.19,34.32,11219308,7844925.6,35.463521685547434,53.88314174578875,NaN,NaN,-214.32599477061245,-121.65209225436415,-0.1821656063602279,-0.021728725976387864,0.16043688038384005,547242685,570410289.8,29.362846239346098,58.446090773888066,NaN,NaN,-0.9754320719584977,15.392879543738351
2014-01-30T09:30:00-05:00,34.73,34.855,34.55,34.74,8329805,7919178.65,43.460969053120095,53.01422272735856,NaN,NaN,-121.50625697559188,-158.25445397586935,-0.1719260961540547,-0.0544707398087283,0.11745535634532638,555572490,562501190.4,25.379093984741047,56.032873384775904,NaN,NaN,-3.20212504543307,12.736450316713862
2014-01-31T09:30:00-05:00,34.46,34.99,34.45,34.82,10943492,8038729.5,44.86254999917506,52.144776093429414,NaN,NaN,-99.73830008287504,-165.29141557567357,-0.15246092443243964,-0.07312079919522319,0.07934012523721645,566515982,559880112.2,24.206973401924998,53.40160848987215,NaN,NaN,-4.470316923820912,10.27834071092318
2014-02-03T09:30:00-05:00,34.74,34.87,33.96,34.09,15975741,8577277.65,36.074578396325485,51.28544712311837,NaN,NaN,-148.05712997084117,-160.37745397414915,-0.17957850167587716,-0.14513300185763,0.034445499818247155,550540241,555666678.2,22.414830876714007,50.537109411293194,NaN,NaN,-8.859313065359975,7.5443901714541575
2014-02-04T09:30:00-05:00,34.15,34.31,34.05,34.22,5725628,8637328,38.38913173911029,49.822390189831445,NaN,NaN,-139.29817288668792,-144.5851709373217,-0.1791792086905162,-0.1895285110448981,-0.010349302354381897,556265869,555227453.4,22.230070755333657,47.56487693532291,NaN,NaN,-11.446856037474637,4.831354998750044
2014-02-05T09:30:00-05:00,34.15,34.35,33.92,34.25,9203061,8739391.8,38.93857533023957,47.9871910101669,NaN,NaN,-121.62231878013237,-126.04443573922568,-0.1675271868551386,-0.21975828592330515,-0.05223109906816655,565468930,558872702.4,27.566345696582076,44.75225655601229,NaN,NaN,-13.268766194724895,2.245623399682195
2014-02-06T09:30:00-05:00,34.28,34.635,34.28,34.63,9139616,8961555.55,45.561080484429496,46.64116230370941,NaN,NaN,-70.8849335876481,-115.92017106163694,-0.12671498013452223,-0.21062482423631934,-0.08390984410179711,574608546,562679913.6,32.756067196634845,42.11729430214001,NaN,NaN,-12.65394615960255,0.11711346264151734
2014-02-07T09:30:00-05:00,34.85,35.11,34.7,35.1,10464749,9167698.15,52.43275133541589,46.108020070147305,NaN,NaN,-13.423597762508638,-98.65723059756365,-0.06373277895464151,-0.163575817795099,-0.09984303884045749,585073295,566391376.2,37.460233981864654,39.91751450932868,NaN,NaN,-9.749710206397202,-1.2924327757925853
2014-02-10T09:30:00-05:00,35.1,35.23,35.01,35.17,6758633,8857627,53.37668370411985,45.460289472028,NaN,NaN,8.245568406504459,-67.39669092209452,-0.015538291442883018,-0.11926590314406127,-0.10372761170117825,591831928,574649713.6,46.43889102544692,38.24281393020902,NaN,NaN,-7.172673010611527,-2.132467095052434
2014-02-11T09:30:00-05:00,35.32,35.698,35.28,35.6,7041374,8887434.05,58.78699470715535,45.26581875468647,NaN,NaN,52.031263936533016,-29.130803557450342,0.04387088283797061,-0.048889008153715,-0.0927598909916856,598873302,583171200.2,53.808209923044764,37.13995677586428,NaN,NaN,-3.1178513424100043,-2.2732362732463725
2014-02-12T09:30:00-05:00,35.69,35.8,35.66,35.74,8047800,8968856,60.39829760553569,45.307059727845555,NaN,NaN,72.44830508227581,9.683321215031295,0.08858776531301855,0.017974815649587583,-0.07061294966343097,606921102,591461634.6,59.62796884642036,36.95818782946606,NaN,NaN,0.6581123853865013,-1.854472179155962
2014-02-13T09:30:00-05:00,35.54,36.03,35.492,36,6914277,8830871.7,63.270333627289496,46.51769539414471,NaN,NaN,85.69578037957783,40.99946400847648,0.1292078812722109,0.09089690192683264,-0.03831097934537825,613835379,599307001.2,64.22184030136,37.72879348529481,NaN,NaN,4.74497882782223,-0.9116934638733631
2014-02-14T09:30:00-05:00,35.97,36.14,35.88,36.07,12376258,9103120.3,64.02675709219245,48.1268813604991,NaN,NaN,106.52971258810031,64.99012607859827,0.15271100272383015,0.15257777405940942,-0.00013322866442071202,626211637,607534669.6,68.29618680165255,39.31988612850723,NaN,NaN,8.2613181532155,0.39873676713933137
2014-02-18T09:30:00-05:00,36.11,36.18,35.99,36.09,5946429,9083507.9,64.25327415293978,49.94967849375685,NaN,NaN,108.63183727405642,85.06737985210866,0.1607145087094779,0.20075990722242665,0.04004539851294876,632158066,615599897.2,71.69849760473323,41.81914690255707,NaN,NaN,11.16775395245934,1.9371677936136182
2014-02-19T09:30:00-05:00,36.02,36.18,35.89,35.97,8611677,9199382.9,61.74120070990177,51.82665556692501,NaN,NaN,98.22452117992319,94.3060313007867,0.14928282518055427,0.2266489299886416,0.07736610480808734,623546389,620534514.6,73.56754987305867,44.976625733536544,NaN,NaN,12.924222480790354,3.506747034638866
2014-02-20T09:30:00-05:00,35.97,36.17,35.81,36.09,6696968,9323437.2,63.28696080236272,53.24279783472806,NaN,NaN,97.28068601607256,99.27250748754605,0.14124480268747402,0.2539221081674299,0.11267730547995586,630243357,625198965.6,75.23258848334392,48.53758962629389,NaN,NaN,14.846270109967389,5.12667890254294
2014-02-21T09:30:00-05:00,36.2,36.26,35.94,35.95,6372503,9321165.65,60.22956306201959,54.34044162493124,NaN,NaN,95.78513210045399,101.29037783172127,0.1188407095380056,0.26122819240246287,0.14238748286445727,623870854,627206060.6,75.93505218636577,52.23245239661109,NaN,NaN,15.664059137783038,6.632018936148668
2014-02-24T09:30:00-05:00,35.91,36.27,35.91,36.09,7845199,8938594.9,62.196344841516414,56.206282085302014,NaN,NaN,89.90345937248492,97.9651271885982,0.1062047850549617,0.2751434641831594,0.16893867912819768,631716053,628306943.8,76.33157719742837,56.0836485623764,NaN,NaN,16.90638541657095,8.099785576208994
2014-02-25T09:30:00-05:00,36.15,36.16,35.9001,35.99,5611524,8818473,59.91703798292971,57.743989674146256,NaN,NaN,74.00159721835269,91.03907917745747,0.08479545398803218,0.2749329966132379,0.1901375426252057,626104529,627096236.4,74.87048063548626,59.84367783953015,NaN,NaN,17.35484126650664,9.421936389108657
2014-02-26T09:30:00-05:00,36.01,36.16,35.88,36.02,5820637,8452233.95,60.38605859327528,59.275952764363105,NaN,NaN,67.61086383531008,84.91634770853484,0.06711246445953195,0.27402812319962067,0.20691565874008871,631925166,628771991.8,75.56758405039841,63.27233772194561,NaN,NaN,17.85356271978126,10.6264544363476
2014-02-27T09:30:00-05:00,36.01,36.33,35.975,36.31,5449313,8163734.2,64.68757063777784,60.64213063245942,NaN,NaN,79.34910851874814,81.33003220906996,0.06913167485755448,0.2933302523120318,0.22419857745447733,637374479,630198216.2,76.17339498971,66.37357542145097,NaN,NaN,19.497759960925098,11.893783797001529
2014-02-28T09:30:00-05:00,36.29,36.4501,35.942,36.35,9700966,8232292.25,65.24809993890932,61.557512675566095,NaN,NaN,77.87776024295835,77.74855783757081,0.06728201110351162,0.30830109133386685,0.24101908023035523,647075445,634839134.4,78.07818837517121,69.27485787811572,NaN,NaN,21.02595941753046,13.198380314219946
2014-03-03T09:30:00-05:00,35.9,36.05,35.67,35.96,9027211,8136478.2,55.92673541947455,61.73965922666286,NaN,NaN,37.41992345983135,67.2518506550401,0.035509429659268316,0.2854058673044406,0.2498964376451723,638048234,636105570.6,78.58138891655415,71.57075058462338,NaN,NaN,19.753993494069384,14.134896482769866
2014-03-04T09:30:00-05:00,36.35,36.525,36.301,36.43,11604801,7917931.2,62.82018737992805,62.02774441757519,NaN,NaN,93.07133062850941,71.06579733707146,0.04144957204123112,0.3017084026967112,0.26025883065548006,649653035,640815271.8,80.38463795321702,73.46906687249283,NaN,NaN,20.747185939872832,15.079509262356003
2014-03-05T09:30:00-05:00,36.51,36.55,36.41,36.48,8930711,8078185.35,63.47469130834244,62.24748682491853,NaN,NaN,102.69734422717049,78.08309341544354,0.04381803625883035,0.315031375979018,0.27121333972018763,658583746,646146987.8,82.2105706192877,75.08210985626907,NaN,NaN,21.74171162512569,16.031252457037386
2014-03-06T09:30:00-05:00,36.53,36.6,36.45,36.53,8665334,8051299,64.15425068228399,62.310623757418135,NaN,NaN,116.87413681812097,85.58809907531811,0.04372381282180682,0.3258681057474462,0.28214429292563936,667249080,652121908,84.00721570555376,76.49535095656863,NaN,NaN,22.750707005586424,16.991174535401534
2014-03-07T09:30:00-05:00,36.63,36.65,36.2701,36.42,7197361,7954186.25,61.44572743924723,62.126264496493484,NaN,NaN,108.26250139069153,91.66504730486474,0.031780482196652304,0.32186989567145474,0.29008941347480244,660051719,654717162.8,84.72867141550317,77.66909985755797,NaN,NaN,22.83158941429581,17.825519518100716
2014-03-10T09:30:00-04:00,36.4,36.475,36.22,36.36,7557629,7808830.25,59.95875477939254,61.81951311266868,NaN,NaN,83.95277552572426,100.97161771804332,0.016154898911549143,0.3102830371142389,0.29412813820268974,652494090,657606334,85.51221908412447,78.65579424894305,NaN,NaN,22.487433323534688,18.491507204591283
2014-03-11T09:30:00-04:00,36.42,36.55,36.18,36.28,9456599,7943728.55,57.945250495223256,61.54837381162021,NaN,NaN,70.5263506808951,96.46262172852046,-0.0022727036666387312,0.2912872586193913,0.29355996228603004,643037491,656283225.2,83.40178917677372,79.35823991349413,NaN,NaN,21.64615097369669,18.94217060017777
2014-03-12T09:30:00-04:00,36.13,36.38,36.01,36.34,6356072,7909463.45,59.05580091383339,61.2461481052967,NaN,NaN,32.11499218186634,82.34615131945962,-0.012550899390428638,0.27787133804799424,0.2904222374384229,649393563,654445188.6,80.43207066666027,79.72963149801673,NaN,NaN,21.222652332015752,19.267953704726054
2014-03-13T09:30:00-04:00,36.44,36.45,35.72,35.85,9397387,7976942.8,47.92524024199734,60.367267903866534,NaN,NaN,-60.5153306493949,46.86825782595646,-0.05225351383559396,0.22510534514393044,0.2773588589795244,639996176,648994607.8,72.21969378902567,79.46424875534957,NaN,NaN,17.401146447656153,19.00126695371607
2014-03-14T09:30:00-04:00,35.78,35.9,35.6,35.63,8939771,8078217.5,43.92253880706865,59.061996044263125,NaN,NaN,-164.96117605962624,-7.776477664107094,-0.09096764167631977,0.1636493068841247,0.2546169485604445,631056405,643195545,64.65577812259346,78.63026310714709,NaN,NaN,12.855905793245903,18.123358216506045
2014-03-17T09:30:00-04:00,35.87,36.15,35.8,36.05,16444900,8281649.6,52.14056883376198,58.50653396217972,NaN,NaN,-57.62868893413496,-36.09277055607894,-0.0859821082105367,0.1471393132972736,0.2331214215078103,647501305,642196988,63.423966864791346,77.81265498066887,NaN,NaN,11.42074984472885,17.16584273482359
2014-03-18T09:30:00-04:00,36.07,36.56,36.07,36.52,6863904,8327523.35,59.32426619235566,58.43069164782832,NaN,NaN,73.44275469291564,-35.50948975367483,-0.05048096973554811,0.17002020933837514,0.22050117907392325,654365209,644462531.6,65.05085477541346,77.06146003245567,NaN,NaN,12.672428543964276,16.523926421843687
2014-03-19T09:30:00-04:00,36.45,36.62,36.14,36.37,7789329,8286405.95,56.41391868960234,57.83971650867293,NaN,NaN,64.6407335369296,-29.004341482662177,-0.03716616479367968,0.17404347308182366,0.21120963787550334,646575880,643898995,64.28489780297959,76.21228166197491,NaN,NaN,12.685641463639394,15.975599999243073
2014-03-20T09:30:00-04:00,36.33,36.75,36.2701,36.65,5895475,8246331.3,60.3265087599771,57.48817428160634,NaN,NaN,114.62482248143444,6.023689143503691,-0.010929003317293656,0.19754838372888628,0.20847738704617993,652471355,646394030.8,66.18343948771607,75.36265674144241,NaN,NaN,14.022985789847722,15.696655112186594
2014-03-21T09:30:00-04:00,36.66,36.74,36.24,36.31,9109667,8383189.5,53.988885027758265,57.349756396483755,NaN,NaN,65.85401079674507,52.18672651477796,-0.017509796629843533,0.18659014125887552,0.20409993788871905,643361688,648855087.4,67.99090941055657,74.60619391958544,NaN,NaN,12.980007467005859,15.308562591446488
2014-03-24T09:30:00-04:00,36.42,36.56,35.9801,36.28,10354186,8508638.85,53.45526056466223,56.68083305253619,NaN,NaN,9.684648631341128,65.64939402787317,-0.02449188800310234,0.17348507788484113,0.19797696588794347,633007502,645956326.8,63.67394158585553,73.41257275048818,NaN,NaN,11.999654797694637,14.835861478053367
2014-03-25T09:30:00-04:00,36.35,36.58,36.21,36.5,7626258,8609375.55,56.82538513416173,56.205882611523286,NaN,NaN,60.14947066057536,62.99073722140512,-0.01534925453786179,0.17879039771561622,0.194139652253478,640633760,643210037,59.80004376862894,71.81182083258399,NaN,NaN,12.249110479630321,14.46632562113579
2014-03-26T09:30:00-04:00,36.67,36.74,36.055,36.06,7513359,8694011.65,49.158962793805905,55.13479061948914,NaN,NaN,1.9836174333608045,50.45931400069135,-0.03866390194915134,0.14580977481703883,0.18447367676619017,633120401,640518941.2,56.192338814553764,69.82504391179828,NaN,NaN,9.897755431148298,13.813672736851862
2014-03-27T09:30:00-04:00,36.04,36.1,35.74,35.93,12927516,9067921.8,47.13559556877789,54.11263834302704,NaN,NaN,-124.29489202552239,2.6753710992999915,-0.06122835323197495,0.10793823522622148,0.16916658845819643,620192885,634063247.2,48.61527840645011,67.24551583972305,NaN,NaN,7.355843317082235,12.891125676884773
2014-03-28T09:30:00-04:00,36.04,36.3,35.92,36.07,6355831,8900665.05,49.54413109252521,53.368736651107945,NaN,NaN,-55.71412294439958,-21.63825564892894,-0.06476940925994645,0.08820482688326337,0.15297423614320982,626548716,630700652.8,45.19669228286731,64.36583535391898,NaN,NaN,6.029166529444571,11.91084579867903
2014-03-31T09:30:00-04:00,36.3,36.49,36.25,36.35,7283511,8813480.05,54.05294273702402,53.09071466837943,NaN,NaN,31.544751051475878,-17.266235164901985,-0.04711924615860533,0.09407517844495317,0.1411944246035585,633832227,630865597.8,45.39951639841125,61.65138729832166,NaN,NaN,6.320033840897018,11.112158376138742
2014-04-01T09:30:00-04:00,36.42,36.78,36.41,36.78,7024473,8584463.65,59.969113713504235,53.15595129692735,NaN,NaN,133.46588143259683,-2.602953010497689,-0.007432044298539886,0.13190436923038362,0.1393364135289235,640856700,630910185.8,45.45827956257292,59.15325936231542,NaN,NaN,8.552376559010488,10.746475259406134
2014-04-02T09:30:00-04:00,36.88,36.91,36.66,36.8,10504694,8663162.8,60.22564033116565,54.03455130329651,NaN,NaN,165.48803986443986,30.09793147571812,0.017838774792664713,0.1616348820197544,0.1437961072270897,651361394,634558384.4,50.18255586002396,57.57917808167245,NaN,NaN,10.37944716544901,10.694042674555117
2014-04-03T09:30:00-04:00,36.85,36.93,36.51,36.62,7762565,8618024.35,56.703747135932076,54.94749475535819,NaN,NaN,123.08851939614775,79.57461376005215,0.019944755421590632,0.16872705150407796,0.14878229608248733,643598829,639239573.2,55.507944361152965,56.9257613844267,NaN,NaN,10.834462047174942,10.714102584929378
2014-04-04T09:30:00-04:00,36.81,36.87,35.8199,35.92,10097119,8763012.25,45.54850295626237,54.47663290696536,NaN,NaN,-33.87399490180413,83.94263936857124,-0.025809578221873297,0.11652032330514572,0.14232990152701902,633501710,640630172,56.979169116690464,56.465418688133774,NaN,NaN,7.415084488149219,10.242814285389356
2014-04-07T09:30:00-04:00,35.77,35.97,35.5,35.64,11181270,8944194.3,41.99007145436543,53.23847613996605,NaN,NaN,-165.3809923508206,44.55749068811194,-0.07230106781494113,0.05195356675834262,0.12425463457328374,622320440,638327814.6,53.80676152640965,55.66226917034779,NaN,NaN,3.3931227353636717,9.264286921099972
2014-04-08T09:30:00-04:00,35.71,36.01,35.6,35.96,7329722,8837850.45,47.07860259234508,52.571667847304816,NaN,NaN,-104.74600926080129,-3.084887450567686,-0.07836204471897222,0.026302078674568463,0.10466412339354068,629650162,636086507,50.839295224722385,54.70186898618657,NaN,NaN,1.7805664715101164,8.195183999729993
2014-04-09T09:30:00-04:00,36.08,36.45,35.97,36.44,6656920,8852892.85,53.64679433517577,52.094545388390436,NaN,NaN,9.504830628873577,-34.28152929768094,-0.04837480395235641,0.044195618453095165,0.09257042240545157,636307082,633075644.6,47.08277988604142,53.337536157495514,NaN,NaN,2.7053514327235337,7.410922204443356
2014-04-10T09:30:00-04:00,36.44,36.5,35.54,35.6,8087001,8787373.55,43.47729130028695,51.343717264999626,NaN,NaN,-94.08475201738395,-77.71618358038727,-0.08149427970824966,-0.009297427229860489,0.07219685247838917,628220081,629999895,43.543207384794734,51.591271727083964,NaN,NaN,-0.3550108070326049,6.301503202803933
2014-04-11T09:30:00-04:00,35.36,35.6399,35.17,35.2,14254422,9053106.1,39.625230408828564,50.35585796815436,NaN,NaN,-211.17601893408502,-113.17658838684345,-0.12416613112589873,-0.08301081142898425,0.04115531969691448,613965659,626092684.8,39.482566573361346,49.86331636904866,NaN,NaN,-4.227852978114694,4.7973094626727
2014-04-14T09:30:00-04:00,35.43,35.68,35.3,35.55,4992335,8480477.85,44.27739243688369,49.45957277549165,NaN,NaN,-148.53443754016814,-109.80727742471295,-0.12244204999255602,-0.11189724279378055,0.010544807198775472,618957994,625420195.6,38.81169408818443,48.3641485347312,NaN,NaN,-5.600617762241519,3.311891287684955
2014-04-15T09:30:00-04:00,35.61,35.82,35.13,35.73,8589261,8566745.7,46.558103914650985,49.27379714126629,NaN,NaN,-117.16653165594587,-112.29138190374188,-0.10355177025989998,-0.1188949056260995,-0.015343135366199526,627547255,624999614.2,38.37255234369556,47.09130664395561,NaN,NaN,-5.879592426543609,1.9988221856523032
2014-04-16T09:30:00-04:00,35.93,36.09,35.68,36.08,13999716,8877265.05,50.776896122984766,49.533890037995356,NaN,NaN,-36.67982092092665,-121.52831221370191,-0.0638072912082252,-0.09510224937648104,-0.03129495816825583,641546971,626047592,40.18854137366807,46.48939685589975,NaN,NaN,-4.66783937596779,1.0464419625637185
2014-04-17T09:30:00-04:00,35.91,36.17,35.72,36.03,7881744,8976578.5,50.167616867868254,49.57842473623414,NaN,NaN,-27.495956180618755,-108.21055304634888,-0.03845691110640597,-0.0793660970512633,-0.040909185944857325,633665227,627136621.2,42.09797649139118,46.26806001365146,NaN,NaN,-3.917304041516826,0.3373353905522122
2014-04-21T09:30:00-04:00,36.06,36.21,35.96,36.17,3527540,8697472.15,51.907694225684494,49.425192699709896,NaN,NaN,4.107177196089427,-65.15391382031399,-0.01124437497597168,-0.05496465466482192,-0.04372027968885024,637192767,631782042.8,49.50344524915089,46.561197788704284,NaN,NaN,-2.7731665248379516,-0.10702202593209692
2014-04-22T09:30:00-04:00,36.19,36.4,36.12,36.32,5478515,8453688.6,53.770320349564365,48.98242174514276,NaN,NaN,39.251567569242276,-27.596712798431916,0.016372603209948947,-0.023254525676414062,-0.03962712888636301,642671282,636524700.4,55.728766345041024,47.294803987452006,NaN,NaN,-1.2724076777861864,-0.27350569048268114
2014-04-23T09:30:00-04:00,36.26,36.26,35.92,35.93,11426035,8643677.45,48.50970273629388,48.145569059794774,NaN,NaN,-8.380952380954463,-5.8395969434336354,0.008296495273410733,-0.029256509794599594,-0.03755300506801033,631245247,637264298.8,56.6267751540304,47.75510536559533,NaN,NaN,-1.5543136863467029,-0.4564782613203985
2014-04-24T09:30:00-04:00,36.52,36.53,35.97,36.21,5010664,8518542.7,52.1307085158749,47.818923444076404,NaN,NaN,36.65812441968324,8.827992124688347,0.02101094073537227,-0.011289329148794991,-0.03230026988416726,636255911,636206086.8,54.910542696115314,47.712433818092634,NaN,NaN,-0.6871236134581797,-0.4894275973400815
2014-04-25T09:30:00-04:00,35.99,36.08,35.67,35.75,6402045,8192269.15,46.36233229361356,47.87705411103006,NaN,NaN,-51.444566410539316,4.038270078704239,-0.0011829693622647658,-0.033778981586998214,-0.03259601222473345,629853866,635443814.6,53.64918150468458,47.474577560092214,NaN,NaN,-1.7458211180577343,-0.6689123860140319
2014-04-28T09:30:00-04:00,35.87,36.21,35.62,36.09,12069084,8477931.8,50.70419128490571,48.49949124178294,NaN,NaN,-19.18786207577299,-0.6207377756682384,0.006963508284192999,-0.0238916268694922,-0.0308551351536852,641922950,636389851.2,55.029853672198094,47.561941284791395,NaN,NaN,-1.2633516226950825,-0.7538322769684677
2014-04-29T09:30:00-04:00,36.18,36.42,36.11,36.34,5476110,8387561.75,53.673665401622685,48.97056715673135,NaN,NaN,51.20367337891718,1.7696833862667432,0.027940240370468487,0.004070165309400409,-0.02387007506106808,647399060,637335406.8,56.42691442842887,47.961056942199,NaN,NaN,0.06857544209054155,-0.6363454599600378
2014-04-30T09:30:00-04:00,36.29,36.54,36.19,36.45,9165648,8494620.5,54.95928413660243,49.06431642826182,NaN,NaN,80.76682970445654,19.599239803348944,0.04686093802391084,0.034706097468820474,-0.012154840555090368,656564708,642399299,63.04776476437257,49.101413004936944,NaN,NaN,1.5381842412381748,-0.3256983597888646
2014-05-01T09:30:00-04:00,36.44,36.67,36.4,36.49,4977653,8218268.45,55.44350915264353,49.919046274858715,NaN,NaN,119.15579930936333,36.098774781284966,0.05892705686691158,0.06150398052854911,0.002576923661637526,661542361,647456589,68.23835281451885,50.865351964202944,NaN,NaN,2.8709621733029467,0.13096743065282274
2014-05-02T09:30:00-04:00,36.58,36.59,36.36,36.39,6720106,8166145.5,53.88386553091563,50.93752021215066,NaN,NaN,108.98746547694735,68.1851811587823,0.05699555300193833,0.07382136491406044,0.01682581191212211,654822255,652450266.8,72.36603618780626,53.21417122237758,NaN,NaN,3.556365856976524,0.62031006298478
2014-05-05T09:30:00-04:00,36.3,36.58,36.17,36.58,4082236,7865401.35,56.39379348239469,51.802977429687154,NaN,NaN,100.46698882598534,92.11615133913396,0.06476908113968292,0.09778716333672577,0.033018082197042845,658904491,655846575,74.76779717075414,55.78246429970399,NaN,NaN,4.844853688338104,1.223816295178112
2014-05-06T09:30:00-04:00,36.51,36.51,36.16,36.17,4700159,7541345.8,50.061938500301856,52.05325132866222,NaN,NaN,54.522999650967954,92.7800165935441,0.03977981400094802,0.08274284969822787,0.04296303569727985,654204332,657207629.4,75.68002395021801,58.44728370016988,NaN,NaN,4.171084740407567,1.6448546444966055
2014-05-07T09:30:00-04:00,36.23,36.28,35.78,36.19,6827022,7516210.8,50.354763436225234,52.02309899389369,NaN,NaN,3.090801357099806,77.24481092407277,0.022916369378813986,0.07160849742079733,0.04869212804198335,661031354,658100958.6,76.28602413029616,61.02567532564332,NaN,NaN,3.701966167096976,1.9387277191538013
2014-05-08T09:30:00-04:00,36.1,36.61,36.0459,36.29,3787427,7372736.15,51.87428972135373,52.14500419771407,NaN,NaN,62.15135902977904,65.84392286815589,0.017083224583445987,0.07004615877129083,0.05296293418784485,664818781,658756242.6,76.74379812381751,63.50037687081663,NaN,NaN,3.7167504827579383,2.1927309710972493
2014-05-09T09:30:00-04:00,36.26,36.35,36.07,36.33,7438540,7340313.1,52.50056283964786,52.18735195585432,NaN,NaN,41.26132940656843,52.298695654080106,0.014601445162595511,0.07121474064108924,0.056613295478493725,672257321,662243255.8,79.06026759518727,65.61157846696207,NaN,NaN,3.893444836232841,2.435690094688048
2014-05-12T09:30:00-04:00,36.5,36.84,36.48,36.82,5593376,6907260.8,59.460232744060114,52.59377426974687,NaN,NaN,153.19435858420098,62.84416960572323,0.04303500468080157,0.11040705132949569,0.06737204664869412,677850697,666032497,81.24630677989259,67.43425992659432,NaN,NaN,6.072053502049559,2.955170581453978
2014-05-13T09:30:00-04:00,36.87,36.94,36.745,36.84,5744088,6944848.45,59.71965780561651,53.39448534612706,NaN,NaN,179.0255532461169,87.74468032475303,0.05926277806712958,0.1414505192326061,0.08218774116547652,683594785,671910587.6,84.03130514948012,69.39172635484074,NaN,NaN,7.932077066109376,3.666157222119035
2014-05-14T09:30:00-04:00,36.78,36.85,36.59,36.67,5111610,6770965.9,56.41498286580076,53.700504942550346,NaN,NaN,132.39240365503787,113.60500078434063,0.05472908649114196,0.15059909927940396,0.095870012788262,678483175,675400951.8,85.41623259042129,71.57070420443402,NaN,NaN,8.638072171106785,4.376430786260142
2014-05-15T09:30:00-04:00,36.73,36.76,36.3,36.45,7288321,6435396.15,52.37573926780903,54.13003401213573,NaN,NaN,61.578968629449825,113.49052270427481,0.034104552647624076,0.1385007035977921,0.10439615095016802,671194854,676676166.4,85.89746192567105,73.87415280593305,NaN,NaN,8.126624179835504,4.9121726996280515
2014-05-16T09:30:00-04:00,36.44,36.7,36.33,36.68,5803657,6331491.8,55.92840382474526,54.503192050695695,NaN,NaN,73.89453233460863,120.01716328988284,0.03311598029055554,0.14579112631336244,0.1126751460228069,676998511,677624404.4,86.26051619095102,76.1049144144154,NaN,NaN,8.686843143113325,5.451411334411662
2014-05-19T09:30:00-04:00,36.55,36.97,36.55,36.92,3298522,6320040.9,59.337129693293925,54.907725214386495,NaN,NaN,133.33791030657457,116.04587363435755,0.04504936939831812,0.16898685777070455,0.12393748837238643,680297033,678113671.6,86.45428753210311,78.24972677896358,NaN,NaN,10.165901914061248,6.1249099886473175
2014-05-20T09:30:00-04:00,36.96,36.99,36.59,36.71,4237099,6257970.1,55.30624646142979,54.93250823758844,NaN,NaN,104.56537767818428,101.15383852077103,0.03563580029286678,0.1684822387384699,0.13284643844560312,676059934,676606701.4,82.59067649892798,79.64564904571753,NaN,NaN,10.268243463568648,6.716814770778936
2014-05-21T09:30:00-04:00,36.74,36.97,36.74,36.96,4161445,5894740.6,58.88687727750926,55.17846310365029,NaN,NaN,127.66228976502762,100.20781574276899,0.04261075034525069,0.18610987637716647,0.14349912603191578,680221379,676954342.2,82.78183973206583,80.68446953982803,NaN,NaN,11.417516687525401,7.388343616028431
2014-05-22T09:30:00-04:00,36.96,37.15,36.91,37.03,3175015,5802958.15,59.85664798906011,55.60509042208918,NaN,NaN,144.75773469760705,116.84356895640042,0.04790777029359963,0.20338383889891531,0.15547606860531568,683396394,679394650.2,84.10154227752092,81.52271997480766,NaN,NaN,12.644505517731282,8.139223887700267
2014-05-23T09:30:00-04:00,37.12,37.36,37.06,37.34,3312147,5648463.25,63.91595712697229,56.142387825273296,NaN,NaN,179.79089061372008,138.0228406122227,0.06708246543803514,0.23932915040285963,0.17224668496482448,686708541,681336656.2,85.08149520303614,82.25941269139923,NaN,NaN,14.949095955147607,9.112062754478458
2014-05-27T09:30:00-04:00,37.43,37.67,37.42,37.66,5674511,5328734.6,67.56233026325737,57.392415808341546,NaN,NaN,219.47952002839577,155.25116255658693,0.09443553146603656,0.2902910992973702,0.19585556783133362,692383052,683753860,86.22002894757588,83.0122701912105,NaN,NaN,18.10800786688321,10.39719777053628
2014-05-28T09:30:00-04:00,37.68,37.71,37.532,37.56,6776905,5393774.35,65.3402417212603,58.462807114415476,NaN,NaN,188.0445277150008,171.94699256395023,0.09846209252052365,0.3189331834819882,0.22047109096146453,685606147,685663102.6,87.06004194948447,83.78184289258108,NaN,NaN,20.048906480995754,11.77601330060192
2014-05-29T09:30:00-04:00,37.69,37.79,37.6,37.78,4664031,5168693.5,67.84578557005814,59.60362824646579,NaN,NaN,176.98646672535307,181.81182795601532,0.10785421057902014,0.3552888541852397,0.24743464360621956,690270178,687672862.4,87.89644998143727,84.57846088241108,NaN,NaN,22.468643815191925,13.303531945543348
2014-05-30T09:30:00-04:00,37.79,37.8701,37.66,37.82,6219928,5230807.25,68.29456423116558,60.73177120300277,NaN,NaN,156.26220179828428,184.11272137615077,0.10838400442140106,0.3829146491329709,0.27453064471156985,696490106,690291604.8,88.90297632716062,85.28151150612346,NaN,NaN,24.57489633990171,14.913726859023114
2014-06-02T09:30:00-04:00,37.88,37.91,37.595,37.76,5461532,5167878.55,66.78874269119638,61.25523619922679,NaN,NaN,128.43219242179455,173.84098173776565,0.09670249701654116,0.3954087659822463,0.2987062689657051,691028574,691155611.4,89.22145580173544,85.85116500768366,NaN,NaN,25.91687684028392,16.485605427774658
2014-06-03T09:30:00-04:00,37.7,37.79,37.582,37.7,5669268,5247230.15,65.23962816140644,61.64951979606893,NaN,NaN,102.68545810549651,150.4821693531858,0.07775914193145811,0.39590519638002775,0.31814605444856964,685359306,689750862.2,84.9525387670408,85.91696740893799,NaN,NaN,26.631763214716305,17.935056540194893
2014-06-04T09:30:00-04:00,37.64,37.82,37.54,37.77,3499243,5187184.35,66.22391359815674,62.35015770552293,NaN,NaN,93.24280545174699,131.52182490053502,0.06337631086452622,0.3973664430292274,0.3339901321647012,688858549,690401342.6,85.30320279404137,85.90889385205371,NaN,NaN,27.50049490457324,19.301547735106084
2014-06-05T09:30:00-04:00,37.9,38.06,37.675,38.02,5667622,5129214.35,69.54115260087951,63.576258657885106,NaN,NaN,107.81607408933819,117.68774637333206,0.06394863172617937,0.4139259218224254,0.349977290096246,694526171,691252541.2,85.77050605003643,85.89982557522266,NaN,NaN,29.20611165641737,20.716485438150553
2014-06-06T09:30:00-04:00,38.22,38.22,38.09,38.19,4798969,5179791.45,71.5848253846673,64.69457448359383,NaN,NaN,125.79726970787186,111.59475995524959,0.06861338510935483,0.43574402148293956,0.36713063637358473,699325140,691819548,86.08783727220923,85.8874913667411,NaN,NaN,31.27135760000871,22.224324318416002
2014-06-09T09:30:00-04:00,38.24,38.37,38.17,38.31,6392010,5127464.95,72.9638129400669,65.66790900122047,NaN,NaN,127.43995710399136,111.39631289168895,0.07225139485833243,0.4574448799465003,0.38519348508816786,705717150,694757263.2,87.62737805621553,85.97128354703486,NaN,NaN,33.42879913943214,23.824963578561164
2014-06-10T09:30:00-04:00,38.31,38.375,38.25,38.33,3594667,5027529.5,73.19727824447335,66.94583984286643,NaN,NaN,118.65752422029482,114.5907261146486,0.06850870918055285,0.47082937156385896,0.4023206623833061,709311817,699547765.4,89.64058266370216,86.47484827309016,NaN,NaN,35.28727384935076,25.462436474388248
2014-06-11T09:30:00-04:00,38.17,38.34,38.14,38.24,4254852,4953067.7,70.25716067278687,67.75800294252913,NaN,NaN,99.4907456141465,115.8403141471285,0.053160056138788214,0.46877073255679136,0.41561067641800314,705056965,702787448.6,90.73814757148114,87.04315597590553,NaN,NaN,36.11199861007274,26.983802493771748
2014-06-12T09:30:00-04:00,38.26,38.38,37.79,37.91,4818001,4938387.25,60.639269862766085,67.8139045049367,NaN,NaN,67.48961552854169,107.7750224349692,0.015904207515764546,0.4354909358127088,0.41958672829694427,700238964,703930007.2,91.09642538047999,87.54279048325975,NaN,NaN,34.094158943437144,27.999567700866805
2014-06-13T09:30:00-04:00,38.14,38.2,37.97,38.13,7331675,4940554.95,64.16160905277471,67.83145107106542,NaN,NaN,74.36563044608769,97.48869458261237,0.0019338324562092613,0.42200401886720584,0.4200701864109966,707570639,705579107,91.60141375238823,88.00849895107062,NaN,NaN,33.342523460091265,28.762847095041728
2014-06-16T09:30:00-04:00,38.06,38.24,38,38.13,7065464,5003645.3,64.16160905277471,67.5885424131738,NaN,NaN,74.5614768609369,86.91299853400147,-0.010753602378009042,0.4066281834384853,0.4173817858164943,707570639,705949804.8,91.7151656260295,88.4010087138173,NaN,NaN,32.7329708108241,29.330007625867783
2014-06-17T09:30:00-04:00,38.1,38.29,38.06,38.22,7037598,5190599.1,65.62125408798195,67.60861472508249,NaN,NaN,80.65134188922384,79.31176206778728,-0.016203719456034826,0.3971271364964508,0.41333085595248564,714608237,707009088.8,92.04666208553633,88.75719586639244,NaN,NaN,32.61245989539899,29.798929378657956
2014-06-18T09:30:00-04:00,38.3,38.44,38.02,38.42,13035265,5630507.4,68.67454579470358,67.66781188398573,NaN,NaN,92.23445393196444,77.86050373135087,-0.009775047257242597,0.4011120468809324,0.410887094138175,727643502,711526396.2,93.28128227584155,89.14182674456417,NaN,NaN,33.3709841032078,30.309222910736505
2014-06-19T09:30:00-04:00,38.48,38.48,38.2,38.35,5918748,5718372.55,66.45007617532733,67.53606273714014,NaN,NaN,96.07434285297937,83.5774491962384,-0.013446471610438715,0.39407900462512657,0.4075254762355653,721724754,715823554.2,94.20313855995357,89.52040976119223,NaN,NaN,33.386123848651145,30.748780187581453
2014-06-20T09:30:00-04:00,38.15,38.22,38.01,38.09,5427718,5831007.7,58.82797710885747,66.96743662411595,NaN,NaN,37.1066783686608,76.12565878075303,-0.03535068757632509,0.3633371167651589,0.398687804341484,716297036,717568833.6,94.53132972666498,89.89968647011577,NaN,NaN,31.13428629518481,30.803852488667648
2014-06-23T09:30:00-04:00,38.05,38.2,38.015,38.2,3767121,5853756.4,60.8728277356115,66.65552230798774,NaN,NaN,39.18103958135575,69.0495713248368,-0.04384150192100772,0.34388592694022435,0.38772742886123207,720064157,720067537.2,94.97037010137237,90.61524585113945,NaN,NaN,29.81828716055357,30.66305744179421
2014-06-24T09:30:00-04:00,38.18,38.375,37.91,38,8471329,5993597.3,55.477721585204826,65.88793716420545,NaN,NaN,21.194803889757427,57.15826372494352,-0.06316350560430756,0.3087730468558476,0.37193655246015517,711592828,719464455.4,93.02909238852115,91.16709510788802,NaN,NaN,27.035755135185685,30.14487139799299
2014-06-25T09:30:00-04:00,37.92,38.21,37.88,38.15,5111856,5910344.85,58.45194227560381,65.09585071240005,NaN,NaN,9.671138055821652,40.645600549714956,-0.06578125282675801,0.28970998642670764,0.35549123925346565,716704684,717276691.8,86.14952280717536,91.19416773339792,NaN,NaN,25.53816914534038,29.486771076185473
2014-06-26T09:30:00-04:00,38.18,38.2,37.885,38.11,11352298,6244758.2,57.351682121508745,64.07919762217445,NaN,NaN,-2.7381053471946317,20.883110909680155,-0.06976729642373553,0.26828211872379626,0.3380494151475318,705352386,714002218.2,76.97434913664303,90.54320429514318,NaN,NaN,23.99058395532574,28.701601487491224
2014-06-27T09:30:00-04:00,38.08,38.34,38.06,38.34,10883328,6477928.2,61.80382268403831,63.282055461029536,NaN,NaN,71.62249109426264,27.78627345480057,-0.05701222367618014,0.2667841355523066,0.32379635922848676,716235714,713989953.8,76.94129617253236,89.77991273202296,NaN,NaN,23.932606890247822,28.02031654502788
2014-06-30T09:30:00-04:00,38.31,38.475,38.285,38.35,4490433,6429373.25,61.98961428833335,62.48150803559097,NaN,NaN,122.00756159374163,44.351577857277746,-0.048342729173127486,0.2633679477620774,0.3117106769352049,720726147,714122351.8,77.05583597426633,88.88100225420612,NaN,NaN,23.938329254474162,27.43717550352021
2014-07-01T09:30:00-04:00,38.49,38.86,38.46,38.74,7488882,6520353.95,68.43761759903128,62.351540673179834,NaN,NaN,244.3237219668386,88.97736147269397,-0.018327570081207833,0.2888012143336951,0.30712878441490293,728215029,717446792,79.7727735288203,88.09776125115893,NaN,NaN,25.984947027425378,27.22971429264952
2014-07-02T09:30:00-04:00,38.81,38.83,38.72,38.78,4970038,6593893.7,69.01812890899777,62.95003060505353,NaN,NaN,243.24774000331223,135.6926818621921,0.001198783706795159,0.3086272640483969,0.30742848034160175,733185067,720742868.6,82.04316461764381,87.45109976809921,NaN,NaN,27.81114281433142,27.312775510032647
2014-07-03T09:30:00-04:00,38.92,38.97,38.79,38.95,2193046,6420164.9,71.42371186345878,63.4687522343881,NaN,NaN,237.85085218271234,183.8104733681735,0.021420917826632357,0.3342046276248922,0.31278370979825987,735378113,726748014,85.28404928265847,86.9998594488328,NaN,NaN,30.120365183368534,27.71385974908063
2014-07-07T09:30:00-04:00,38.95,39.02,38.85,38.99,10482168,6704324.85,71.97509390184374,64.0268582950359,NaN,NaN,198.9163280191626,209.26924075315347,0.03267395699187492,0.35362615603810355,0.3209521990462286,745860281,732672927.4,87.6520041129458,86.70963362646968,NaN,NaN,32.16982300646713,28.350425928707274
2014-07-08T09:30:00-04:00,38.97,38.97,38.43,38.64,6923856,6730917.15,60.90195454647917,63.68976547064283,NaN,NaN,97.12493219178658,204.29271487276247,0.012752078845878034,0.3368922976035762,0.32414021875769816,738936425,736314983,88.84070131090546,86.48063642828176,NaN,NaN,30.570171290518005,28.66753240896595
2014-07-09T09:30:00-04:00,38.7,38.845,38.615,38.83,7118133,6907090.45,64.1282990294527,63.36503355883919,NaN,NaN,102.87241148963977,176.0024527773227,0.008767178153834654,0.33509919144999145,0.3263320132961568,746054558,739882888.8,89.86955749079834,86.23694180077868,NaN,NaN,30.234118619692747,28.89133043906978
2014-07-10T09:30:00-04:00,38.22,38.885,38.22,38.72,4421945,6915445.1,60.990386440763835,62.97505572065609,NaN,NaN,56.386768447829944,138.63025846622625,-0.004185120059353342,0.32110061322196515,0.3252857332813185,741632613,741572398,90.32446651638958,85.95989379766696,NaN,NaN,28.977227556756695,28.903601455882196
2014-07-11T09:30:00-04:00,38.81,38.92,38.71,38.92,3261418,6837615.95,64.40113186056456,63.37313820292088,NaN,NaN,100.11218134694607,111.08252429907301,-0.002286013917790153,0.32242821588408077,0.3247142298018709,744894031,743475581.6,90.82431616050812,85.69510711437003,NaN,NaN,28.96887548990265,28.91292631788512
2014-07-14T09:30:00-04:00,39.1,39.25,39.06,39.2,4209101,6681487.25,68.54731179318144,63.921315635604444,NaN,NaN,148.05778037093708,100.9108147694279,0.013932733865305469,0.34213014713350276,0.3281974132681973,749103132,744124151.8,90.99504504340447,85.41115532451519,NaN,NaN,30.31979988928632,29.11390825665672
2014-07-15T09:30:00-04:00,39.29,39.34,38.91,39.13,7417055,6699066.8,66.46321449942693,64.70599370090602,NaN,NaN,122.27280391164717,105.94038911340002,0.01590860419778617,0.34808316851543,0.3321745643176438,741686077,744674082.2,91.14548689297436,85.27661207483327,NaN,NaN,30.75265712808417,29.348015238289214
2014-07-16T09:30:00-04:00,39.5,39.59,39.405,39.49,8064843,6750429.05,71.2965868002488,65.62346830980923,NaN,NaN,170.41088601453757,119.44808401837956,0.036259073001459974,0.3774984055694688,0.3412393325680088,749750920,745413354.6,91.35458702674529,85.64840237623113,NaN,NaN,32.75931123692106,29.835343238093763
2014-07-17T09:30:00-04:00,39.45,39.5,38.86,38.98,5670951,6382213.35,58.44568445346227,65.7016113335202,NaN,NaN,89.6709598353617,126.1049222958859,0.011455569666315779,0.35555879465090356,0.3441032249845878,744079969,745902825.8,91.49775003928882,86.68578815499154,NaN,NaN,29.88732515556135,29.842769226303417
2014-07-18T09:30:00-04:00,39.16,39.48,39.11,39.4499,4770496,6324800.75,64.75007407176207,65.91205786121476,NaN,NaN,119.69308133720725,130.02110229393813,0.022159491217478067,0.37180258900643537,0.3496430977889573,748850465,746694112.6,91.73599680972333,87.74255248621945,NaN,NaN,29.82758339036079,29.840599821168755
2014-07-21T09:30:00-04:00,39.43,39.51,39.245,39.4,6181589,6362494.3,63.64580107344572,66.03035691729421,NaN,NaN,115.30023232008813,123.46959268376835,0.021334733923827176,0.3763115151937413,0.3549767812699141,742668876,745407261.4,87.44453812437946,88.48460263979896,NaN,NaN,29.393625357563412,29.77674632636799
2014-07-22T09:30:00-04:00,39.63,39.76,39.56,39.73,4789762,6413626.35,67.5831594495177,65.96932419232897,NaN,NaN,150.38921716764386,129.0928753349677,0.03752296352820195,0.40188048568016654,0.3643575221519646,747458638,746561773.6,87.98748097408946,89.07136745731819,NaN,NaN,30.431025642753873,29.870214800137404
2014-07-23T09:30:00-04:00,39.82,39.91,39.645,39.8,5473434,6263731.6,68.36582402278958,65.92273098617123,NaN,NaN,149.81419643840442,124.97353741974106,0.046847874961694735,0.422917365854083,0.3760694908923883,752932072,747198004,88.28805471226704,89.51743103550557,NaN,NaN,31.4955945231807,30.102411903429303
2014-07-24T09:30:00-04:00,39.92,39.92,39.69,39.77,11659600,6591118.8,67.61240038068249,65.65049445168722,NaN,NaN,134.29276039665697,133.89789753200012,0.04489362209906955,0.43218651851622525,0.3872928964171557,741272472,746636504.6,86.2372172523999,89.58551446191566,NaN,NaN,32.09570214659037,30.387167652452312
2014-07-25T09:30:00-04:00,39.65,39.77,39.53,39.72,4749496,6260978.7,66.30094552262307,65.24519813888574,NaN,NaN,103.93751697205309,130.7467846589693,0.034593577811502296,0.43053486868153357,0.39594129087003127,736522976,744171006.8,77.70223166643267,88.87481643002188,NaN,NaN,32.190767365267,30.644824754282983
2014-07-28T09:30:00-04:00,39.75,39.865,39.475,39.79,7762226,6104923.6,67.25844599968872,65.69923324268642,NaN,NaN,100.7180810505449,127.83035440506065,0.02718177238192787,0.4299185063474411,0.40273673396551324,744285202,744494272,78.00954492210845,88.10116240225067,NaN,NaN,32.54414583047212,30.916156336595716
2014-07-29T09:30:00-04:00,40.08,40.08,39.69,39.71,7312421,6246023,64.9858779111732,65.76048887709503,NaN,NaN,108.4797220366534,119.44845537886256,0.012334195871891052,0.41815447880537704,0.405820282933486,736972781,742397100.6,71.1577873996283,86.76460739573852,NaN,NaN,32.2032010804839,31.100019871436885
2014-07-30T09:30:00-04:00,39.89,39.89,39.56,39.75,7762585,6259708.15,65.61153667522956,66.09057103669973,NaN,NaN,82.72550931511701,106.03071795420507,0.0012343641293318663,0.40736323809515085,0.406128873965819,744735366,740757759.4,66.25867820476644,85.04562251633686,NaN,NaN,32.08744188357188,31.241080158884742
2014-07-31T09:30:00-04:00,39.5,39.54,38.94,39,17416663,6882039.4,48.215011178690474,64.934419559423,NaN,NaN,-24.026078645765917,74.3669501457205,-0.05735335005879805,0.33443718639232145,0.3917905364511195,727318703,737967005.6,58.8327508931695,82.76051071152696,NaN,NaN,26.102990303438865,30.507067322392473
2014-08-01T09:30:00-04:00,38.9,39.06,38.6,38.789,15507425,7547758.35,44.62981235961977,63.22602674274003,NaN,NaN,-86.65656045876871,36.248134659556136,-0.10810584349740193,0.2566582320793671,0.36476407557676904,711811278,733024666,48.47193365151193,79.72314561210608,NaN,NaN,19.959166851571705,29.000224397989506
2014-08-04T09:30:00-04:00,38.91,39.17,38.71,39.065,6333724,7340336.15,49.87976495615418,62.041494632506264,NaN,NaN,-56.483244049977834,4.807869639451589,-0.11996124542899061,0.21481251879053076,0.3347737642195214,718145002,727796626,40.372548926652726,76.09650718594024,NaN,NaN,16.523131242840503,27.217782518682505
2014-08-05T09:30:00-04:00,38.83,38.96,38.54,38.7,12293402,7608813.45,43.94555622392679,60.08784959134041,NaN,NaN,-103.98592009403629,-37.68525878668636,-0.14744893076961152,0.15046260075750695,0.29791153152711847,705851600,721572389.8,33.24932815664894,71.94613155236193,NaN,NaN,11.515555672586714,24.974607254954535
2014-08-06T09:30:00-04:00,38.44,38.765,38.39,38.58,9140902,7709951.9,42.169291113985594,58.92525006709207,NaN,NaN,-127.99260237619917,-79.82888112494959,-0.16732228504215396,0.08875867522442604,0.25608096026658,696710698,711967456.2,25.710635584864207,67.24705194847446,NaN,NaN,6.952579002634658,22.400031790337408
2014-08-07T09:30:00-04:00,38.74,38.81,38.29,38.42,6865031,7832106.2,39.85610239589552,57.14710923310161,NaN,NaN,-138.23764943800987,-102.67119528339838,-0.1835526752644797,0.02664011618598039,0.21019279145046008,689845667,704472849,21.596045421263824,62.23705542072735,NaN,NaN,2.4791915681981846,19.554197472888948
2014-08-08T09:30:00-04:00,38.4,38.7,38.276,38.67,6022790,7970174.8,44.93848795015443,55.81087258143794,NaN,NaN,-122.93946703970391,-109.92777659958543,-0.17006530648011456,-0.0023888416496831155,0.16767646483043144,695868457,701284284.8,20.120718621782615,57.428211170541864,NaN,NaN,0.3332234387248658,16.808344039436935
2014-08-11T09:30:00-04:00,38.85,38.97,38.77,38.86,6507689,8085104.2,48.50036148186289,54.447815583748316,NaN,NaN,-62.7499836804906,-111.18112452568798,-0.14209989883242663,-0.00994840871010183,0.1321514901223248,702376146,698130513.6,18.75590975797266,52.48309894081923,NaN,NaN,-0.3111657580683929,14.36269978265046
2014-08-12T09:30:00-04:00,38.82,38.935,38.65,38.84,6704924,8049497.65,48.14728947764817,53.00363454480964,NaN,NaN,-67.14753415161151,-103.81344733720303,-0.11960376477938968,-0.017353215851912296,0.10225054892747738,695671222,696094438,17.91121129532948,47.45618155389513,NaN,NaN,-0.928360364720579,12.17826261874031
2014-08-13T09:30:00-04:00,38.93,39.22,38.93,39.22,5492695,7920890.25,54.869697060796376,52.09344145053206,NaN,NaN,-14.016434316462906,-81.01821372525578,-0.07591528327784967,0.007356444830165287,0.08327172810801496,701163917,696985081.8,19.61660535159669,42.697566418123465,NaN,NaN,0.6588866907612358,10.532637486171872
2014-08-14T09:30:00-04:00,39.25,39.29,39.12,39.29,4614659,7868075.65,56.001295635433294,51.35775217287566,NaN,NaN,3.0933571942401294,-52.75201239880577,-0.04084452084849087,0.03221607704740137,0.07306059789589224,705778576,700171663.6,25.574189385381814,38.97413482661983,NaN,NaN,2.2872247089955375,9.354721375146681
2014-08-15T09:30:00-04:00,39.38,39.48,39.01,39.29,8910873,8075094.5,56.001295635433294,50.55367000400027,NaN,NaN,8.319374651030627,-26.50024406065886,-0.017387788641067548,0.051325862094557806,0.06871365073562535,705778576,702153687.4,29.094277987345947,35.480187188422505,NaN,NaN,3.595558343364586,8.53198379917781
2014-08-18T09:30:00-04:00,39.56,39.6763,39.45,39.66,4247989,7978414.5,61.863231755302,50.33062385000947,NaN,NaN,61.127452780279874,-1.7247567685047585,0.02121201966170845,0.09522867531276091,0.07401665565105246,710026565,703683771.2,31.77685852974355,32.66726369771644,NaN,NaN,6.6068467989009605,8.25696422770969
2014-08-19T09:30:00-04:00,39.77,39.92,39.72,39.91,5047776,7991315.2,65.23364619657923,50.303631672963014,NaN,NaN,99.28498985125199,31.561748032067943,0.05957328281485094,0.14848325916961613,0.08890997635476519,715074341,707564395,38.16636446028582,30.660669858824967,NaN,NaN,10.268555237728478,8.544334371998088
2014-08-20T09:30:00-04:00,39.85,39.98,39.82,39.91,7005292,8067908.1,65.23364619657923,51.519248459955065,NaN,NaN,105.32847485228635,55.43072986581778,0.07968387416973284,0.18851481906693124,0.1088309448971984,715074341,710346479.8,42.33596183367948,29.482327783147106,NaN,NaN,13.187583393256652,9.207655660749312
2014-08-21T09:30:00-04:00,39.91,40.155,39.91,40.1,3454481,7657652.15,67.746135038332,53.170414365577365,NaN,NaN,122.98756791205811,79.40957200938139,0.09924480804346103,0.23288695495152467,0.13364214690806364,718528822,712896529,45.934704549530494,29.301097133005577,NaN,NaN,16.459211402720385,10.243592195316609
2014-08-22T09:30:00-04:00,40.13,40.19,40.015,40.11,4407968,7640575.75,67.87771281363916,54.45598206968344,NaN,NaN,120.50809251529247,101.84731558223376,0.1057224323002024,0.26579518728331664,0.16007275498311424,722936790,716328171.8,50.419047431606074,30.01870416907368,NaN,NaN,19.160693893057818,11.517463866422496
2014-08-25T09:30:00-04:00,40.3,40.31,40.07,40.15,3430743,7424001.6,68.4324488051032,56.205045825481754,NaN,NaN,120.19791707761296,113.66140844170039,0.10533369089340389,0.2917398685998691,0.18640617770646523,726367533,719596365.4,54.30616951357024,31.522764265996624,NaN,NaN,21.572006188703497,12.953827055319781
2014-08-26T09:30:00-04:00,40.21,40.22,40.12,40.17,3355910,7226176.05,68.72328981036932,58.1017600180806,NaN,NaN,112.23768661603727,116.25194779465744,0.09914519291450091,0.31033766884959135,0.21119247593509044,729723443,722526185.8,57.521326392648575,33.794956466552655,NaN,NaN,23.672856593193423,14.48511698930173
2014-08-27T09:30:00-04:00,40.18,40.21,40.045,40.16,4331205,7054607.05,68.38403644598105,60.1394695930867,NaN,NaN,100.66954206695333,115.32016123759084,0.08750542930202596,0.3205742625626229,0.23306883326059694,725392238,724589765.2,59.673606795468565,36.51478227899585,NaN,NaN,25.36462802286022,16.039332851238658
2014-08-28T09:30:00-04:00,40.02,40.16,39.95,40.1,3528469,6360197.35,66.27018558740409,61.66316228146168,NaN,NaN,81.45899891315962,107.01444743781113,0.06966876787656617,0.3201547931063047,0.2504860252297385,721863769,725256754.6,60.372493978645394,39.389909090200334,NaN,NaN,26.316678583427723,17.507525098694238
2014-08-29T09:30:00-04:00,40.17,40.29,40.06,40.28,7684232,5969037.7,69.33284714090823,63.151196971393496,NaN,NaN,87.59752781494603,100.43233449774185,0.06404048832310583,0.3305366356336208,0.26649614731051496,729548001,726578996.8,61.78637447651772,42.46351371295356,NaN,NaN,27.991781111370496,19.00527595764799
2014-09-02T09:30:00-04:00,40.37,40.37,40.17,40.29,5688847,5936793.85,69.49854533890101,64.6762866757687,NaN,NaN,86.06081129967964,93.60491334215519,0.05536426564988589,0.3357014793728723,0.2803372137229864,735236848,728352859.8,63.659638331656375,45.731258501262616,NaN,NaN,29.44991393733252,20.497367097602922
2014-09-03T09:30:00-04:00,40.44,40.44,40.02,40.07,6891593,5666703.4,61.61151390078662,65.15784502148227,NaN,NaN,69.04722053685336,84.96682012631841,0.030428224168458085,0.31837249393355904,0.28794426976510096,728345255,728077222.2,63.141673981536144,48.84019197482972,NaN,NaN,28.687352570504824,21.667365022303194
2014-09-04T09:30:00-04:00,40.15,40.335,39.93,40.05,5213177,5470317.15,60.93450690462314,65.51021725499584,NaN,NaN,55.798799320973636,75.99267157712247,0.009302212448055125,0.29957203532516985,0.2902698228771147,723132078,727625190.2,62.247193472267234,51.4596922667501,NaN,NaN,27.867666195797643,22.553122332802403
2014-09-05T09:30:00-04:00,40.13,40.3,40.03,40.29,7026224,5478376.8,65.79212436033617,66.20956216391748,NaN,NaN,64.6436973343929,72.6296112613691,0.008243104981562221,0.3005737041040675,0.29233059912250525,730158302,729284096.8,64.24881808342998,53.97073084504182,NaN,NaN,28.450468745486194,23.39560039175723
2014-09-08T09:30:00-04:00,40.27,40.45,40.18,40.35,6387058,5496590.2,66.90022630384988,66.56934748881375,NaN,NaN,80.0986313427812,71.12983196693615,0.008311097313528304,0.30271947076441563,0.29440837345088733,736545360,730683568.6,65.8917505805527,56.40750884867105,NaN,NaN,29.2481600151505,24.23168033795627
2014-09-09T09:30:00-04:00,40.37,40.54,39.95,40.06,8562663,5599338.9,57.24766021157592,65.99891991845638,NaN,NaN,53.88406535107511,64.69448277721524,-0.013273155314904639,0.27781692930725654,0.2910900846221612,727982697,729232738.4,62.676103180189656,58.15820447152132,NaN,NaN,27.093331776174974,24.64048768627323
2014-09-10T09:30:00-04:00,40.07,40.355,39.96,40.3,7237241,5625954.75,62.11886220984573,65.77643534797541,NaN,NaN,55.40022029364246,61.965082728573066,-0.013443519392546066,0.2742856853814786,0.28772920477402464,735219938,730607675,64.4468879053413,59.73755633378288,NaN,NaN,26.68812323435838,24.933007050285394
2014-09-11T09:30:00-04:00,40.22,40.41,40.08,40.39,10322240,5867432,63.78525593814301,65.49351541224762,NaN,NaN,77.42715476878143,66.29075381813463,-0.00972515128865481,0.2755727656632061,0.2852979169518609,745542178,735089695,69.52295590214676,61.42243143039832,NaN,NaN,26.860811719560694,25.20840771732472
2014-09-12T09:30:00-04:00,40.36,40.38,40.09,40.22,5555691,5914483.6,58.54629545195552,64.82698560069879,NaN,NaN,59.105496045028694,65.18311356026179,-0.020334751196576573,0.2598794779561402,0.28021422915271677,739986487,737055332,71.44824864378018,62.9245172312679,NaN,NaN,25.385457814531215,25.23370058835422
2014-09-15T09:30:00-04:00,40.29,40.29,39.906,39.98,6882164,5813048.15,52.04698342579968,63.656595216462826,NaN,NaN,-32.50997962125696,42.66139136745416,-0.04378956057268335,0.2254772784368626,0.26926683900954596,733104323,736367124.6,69.78601139489848,64.03022022279136,NaN,NaN,21.991615132257532,24.77054552319755
2014-09-16T09:30:00-04:00,39.86,40.33,39.79,40.28,11911364,6196216.9,58.28135718729729,62.91074288624339,NaN,NaN,-7.8903733633266295,30.306503624573804,-0.03950461479785733,0.2198860705122243,0.25939068531008164,745015687,739773722.6,73.11967770700997,65.14438817381716,NaN,NaN,21.07760493178973,24.242982581567862
2014-09-17T09:30:00-04:00,40.27,40.51,40.12,40.36,7654467,6326551.45,59.78291116584014,62.29637679480476,NaN,NaN,140.0247296986345,47.231405505572205,-0.03200739887264581,0.21938143671927435,0.25138883559192016,752670154,743263765.8,76.03679305698547,66.31318719249694,NaN,NaN,20.829354735251776,23.755321460665563
2014-09-18T09:30:00-04:00,40.44,40.62,40.44,40.6,7395314,6346052.55,63.97232231648404,62.13224370402475,NaN,NaN,283.6489227123871,88.47575909429334,-0.012606033149258622,0.2356312941553469,0.24823732730460552,760065468,746168423.8,78.1610175673817,67.58379602026382,NaN,NaN,21.99668429234295,23.504087579476618
2014-09-19T09:30:00-04:00,40.57,40.57,40.185,40.34,15727192,6959688.1,57.040143556048605,61.25419344796335,NaN,NaN,115.05146430887238,99.66495274706207,-0.018640528813885254,0.22493666628724895,0.2435771951011342,744338276,747038781.6,78.76835034518315,68.79679429659707,NaN,NaN,20.662114478680593,23.098091422220044
2014-09-22T09:30:00-04:00,40.35,40.35,39.955,40.07,6380423,7058310.85,50.874823183564246,59.92392757972501,NaN,NaN,-71.22003638035503,91.92294139524247,-0.04089708249013785,0.19245584198846188,0.23335292447859973,737957853,748009487.6,79.45460207245104,69.92500599236811,NaN,NaN,17.402980186334023,22.284504102807755
2014-09-23T09:30:00-04:00,40.01,40.155,39.9106,39.98,5968495,7185198.45,48.9745799800873,59.0212894425322,NaN,NaN,-140.7457538313795,65.35186530163189,-0.06057419032286854,0.15763518657501407,0.2182093768978826,731989358,745404221.8,72.66600541526117,70.60531538049133,NaN,NaN,14.189456077269119,21.12806867058795
2014-09-24T09:30:00-04:00,39.99,40.25,39.8101,40.24,7144473,7374626.6,54.28666155799491,58.546443346344475,NaN,NaN,-74.07746839221058,22.531425683462878,-0.055128801796752974,0.1492983746519414,0.20442717644869438,739133831,742696957.2,66.32442116102018,70.89654592968797,NaN,NaN,13.210597056766444,19.997001297184877
2014-09-25T09:30:00-04:00,40.08,40.1,39.36,39.36,9351600,7625646.35,39.35340640341737,56.65796349227885,NaN,NaN,-313.4721002184065,-96.89277890269585,-0.10684906258259563,0.07086584822044983,0.17771491080304547,729782231,736640309.8,54.80188133482508,70.22176473335905,NaN,NaN,6.199729659467597,18.025962491796694
2014-09-26T09:30:00-04:00,39.43,39.87,39.43,39.79,4881540,7693299.9,47.02217976286267,55.23810302506548,NaN,NaN,-214.69160923110675,-162.84139361069168,-0.10784371311232671,0.04291026941263709,0.1507539825249638,734663771,734705408.8,51.71109069140216,69.20886045556259,NaN,NaN,3.670951682379047,15.975246661879888
2014-09-29T09:30:00-04:00,39.47,39.84,39.34,39.78,4826367,7550406.65,46.87373486422239,54.49710835739737,NaN,NaN,-188.20400316101296,-186.23818696682326,-0.10482636707060018,0.01972102368671358,0.12454739075731376,729837404,733081319,49.20267884783655,68.24647300325165,NaN,NaN,1.7902592176938754,13.948819884139029
2014-09-30T09:30:00-04:00,39.845,40.08,39.74,39.9,6760543,7603991.45,48.956171014994624,53.556916129193716,NaN,NaN,-78.09076918624744,-173.70719003779686,-0.09091733677756185,0.010900719785361446,0.1018180565629233,736597947,734003036.8,50.665327493562636,67.26207583098174,NaN,NaN,1.047380188597271,12.105757070490206
2014-10-01T09:30:00-04:00,39.77,39.82,39.17,39.28,13059195,7912371.55,40.19056995742858,51.871581416285544,NaN,NaN,-200.4235074536172,-198.97639785007817,-0.11792859637820097,-0.04559268890982793,0.07233590746837304,723538752,730884021,45.85384163451518,65.5714248118652,NaN,NaN,-2.8847926638891153,9.964249965578874
2014-10-02T09:30:00-04:00,39.3,39.395,38.86,39.26,13376786,8320552,39.94212600780319,50.54271217027466,NaN,NaN,-209.34485363331802,-178.15094853306047,-0.13061254464794975,-0.09092977334156416,0.039682771306385596,710161966,726959968,40.626512185434585,63.36987220769766,NaN,NaN,-5.911174743965235,7.696332149929717
2014-10-03T09:30:00-04:00,39.5,39.6991,39.36,39.58,6705074,8304494.5,45.72337603567597,50.09102592812297,NaN,NaN,-101.01717854972124,-155.4160623967834,-0.11165580010664705,-0.09988697882692321,0.011768821279723833,716867040,723400621.8,36.555714889058095,60.99627960013763,NaN,NaN,-6.45267595427287,5.675045277900775
2014-10-06T09:30:00-04:00,39.78,39.85,39.49,39.59,6947819,8332532.55,45.89864082644518,49.2065461880621,NaN,NaN,-69.70086021552274,-131.71543380768534,-0.09339001579623453,-0.10496869846556933,-0.011578682669334803,723814859,722196112.8,35.2678410717173,58.29257698333101,NaN,NaN,-6.814084980539736,3.8908838124092737
2014-10-07T09:30:00-04:00,39.48,39.51,38.97,38.97,9006692,8354734,37.757867177521476,47.63332876032506,NaN,NaN,-149.3033396627426,-145.95794790298436,-0.11650710803702655,-0.15721256771561798,-0.04070545967859143,714808167,717838156.8,31.01096688288935,55.07644654232415,NaN,NaN,-9.977440391987475,1.9096946403525954
2014-10-08T09:30:00-04:00,39.02,39.78,38.75,39.71,8670647,8426404.3,49.31326463509138,46.586253211654146,NaN,NaN,-86.3359728816381,-123.14044098858855,-0.07729278334791709,-0.1373214388634878,-0.06002865551557071,723478814,717826169.2,30.999882638956322,51.707794047436614,NaN,NaN,-8.421800530721667,0.43376675877055804
2014-10-09T09:30:00-04:00,39.67,39.74,39.01,39.05,15300359,8675310.25,41.85052585066001,45.50128051841211,NaN,NaN,-101.71561411256792,-101.61459308443855,-0.09023457724291217,-0.17282187706921093,-0.08258729982629875,708178455,717429467,30.609966978888494,48.26790952127271,NaN,NaN,-10.041736101472925,-1.0627336498356537
2014-10-10T09:30:00-04:00,38.79,38.99,38.05,38.05,30182617,9906656.55,33.56282996559308,44.264709574271315,NaN,NaN,-224.19235743641534,-126.24962886177737,-0.15668072845711717,-0.27843821039769523,-0.12175748194057806,677995838,709655226.6,24.188928183766606,44.320361386366685,NaN,NaN,-14.953040615828042,-3.047063216405995
2014-10-13T09:30:00-04:00,38,38.37,37.58,37.63,28604428,10992769.75,30.80371406348864,42.966790580228555,NaN,NaN,-246.78542461952355,-161.66654174257755,-0.21580780515599166,-0.3915172383855676,-0.17570943322957597,649391410,694770536.8,16.885545777649554,40.336042840823,NaN,NaN,-19.76610506894539,-5.435497766768766
2014-10-14T09:30:00-04:00,37.94,38.12,37.59,37.69,21542135,11474308.3,31.667930631508284,41.35116694262236,NaN,NaN,-204.23058774141424,-172.6519913583119,-0.2361235404054143,-0.47086385873634384,-0.23474031833092954,670933545,685995612.4,14.169431069808596,36.61068640573645,NaN,NaN,-22.945379690235892,-7.936909470121212
2014-10-15T09:30:00-04:00,37.15,37.58,36.58,37.43,29067214,12544945.65,29.923859508659888,40.677627878711114,NaN,NaN,-217.0644952429316,-198.7976958305706,-0.2509315734332052,-0.5484047851224361,-0.29747321168923085,641866331,669673115.8,10.716343949639992,33.4617194496518,NaN,NaN,-26.046598305559844,-10.524007875183873
2014-10-16T09:30:00-04:00,36.8,37.455,36.7,37.21,27123112,13531335.55,28.493879061018973,39.35417782857942,NaN,NaN,-181.3190701822067,-214.71838704449834,-0.2583865934831684,-0.6204564535431913,-0.36206986006002295,614743219,650986068.6,8.240393922253332,30.356669680426887,NaN,NaN,-28.98287618681467,-13.1609890625597
2014-10-17T09:30:00-04:00,37.58,37.92,37.4,37.65,12787073,13384329.6,35.1669205013235,38.517976802658076,NaN,NaN,-111.8999343068048,-192.25990241857625,-0.2181335095478646,-0.6347367469948537,-0.4166032374469891,627530292,640892959.4,7.264168499806573,27.361061798424743,NaN,NaN,-29.192579323991335,-15.45121624276422
2014-10-20T09:30:00-04:00,37.44,37.94,37.25,37.92,9221409,13526378.9,38.9329467097723,37.80203220942791,NaN,NaN,-92.8119657726777,-161.46521064920708,-0.16043987592599035,-0.6171530823544771,-0.45671320642848673,636751701,638365017.6,7.039234876559746,24.24491232578168,NaN,NaN,-28.12386506771116,-17.261594646328067
2014-10-21T09:30:00-04:00,38.19,38.68,38.19,38.66,11573294,13806618.85,47.87057451269954,38.35060396337583,NaN,NaN,-25.829247783194486,-125.7849426575631,-0.06447926232364887,-0.5373122843330478,-0.4728330220093989,648324995,633843307.6,6.642999707174383,21.444137902400197,NaN,NaN,-24.053754316140886,-18.231903170587042
2014-10-22T09:30:00-04:00,38.79,38.88,38.45,38.48,12079173,14053353.85,46.10303047369017,38.79066856808204,NaN,NaN,-13.331765878759075,-85.03839678472862,-0.008129350387182932,-0.48299470999337757,-0.47486535960619464,636245822,632719205.8,6.544375529024791,19.009699569799494,NaN,NaN,-21.42394434090634,-18.687909052061226
2014-10-23T09:30:00-04:00,38.75,39.12,38.671,38.91,32215984,15196573.05,50.77861651930446,39.151757174055504,NaN,NaN,14.711403822147957,-45.8323019838577,0.059386688997110804,-0.4006319983598061,-0.4600186873569169,668461806,643462923.2,18.93235154348737,17.75088790225873,NaN,NaN,-17.665005732902763,-18.54178000646716
2014-10-24T09:30:00-04:00,39.08,39.28,38.86,39.25,6903171,15297654.6,54.164476888749306,39.74217403564866,NaN,NaN,38.16363976972135,-15.819587168552465,0.12448319437187005,-0.30441469439207935,-0.4288978887639494,675364977,653029860.2,28.075108007618127,17.23712125482307,NaN,NaN,-13.454300284719373,-17.81499718907462
2014-10-27T09:30:00-04:00,39.13,39.39,39.09,39.29,5943486,15353510.55,54.56049457418895,40.9423617068392,NaN,NaN,52.44546085348153,13.23189815667937,0.16522169479936277,-0.22237077026474594,-0.3875924650641087,681308463,661941212.6,35.38511117302431,17.549560132689855,NaN,NaN,-10.013643405849587,-16.70051807718533
2014-10-28T09:30:00-04:00,39.4,39.85,39.4,39.83,7745481,15402757.45,59.631286083960134,41.67936323890125,NaN,NaN,94.4506352265739,37.28787475863313,0.22008974835475714,-0.11248027962066232,-0.33257002797541946,689053944,670087002.4,41.26180675612794,18.28255471248783,NaN,NaN,-5.366528361130747,-15.081376689177532
2014-10-29T09:30:00-04:00,39.78,39.92,39.54,39.79,13176100,15408602.7,59.10512561218299,42.91183465043861,NaN,NaN,96.21600806713478,59.19742954781191,0.24342178397293823,-0.028292798009246667,-0.2717145819821849,675877844,678013406.8,46.37288723074459,19.40847758762041,NaN,NaN,-1.8226190713251174,-13.187268458055758
2014-10-30T09:30:00-04:00,39.76,39.995,39.59,39.92,9188154,15199171.1,60.33022637095208,44.82379153653568,NaN,NaN,96.97726908847814,75.65060260107794,0.25605874600496215,0.04835885052401778,-0.20769989548094436,685065998,681334245.2,48.39874341996602,21.137750104491797,NaN,NaN,1.461999348621547,-11.094515914244715
2014-10-31T09:30:00-04:00,40.41,40.55,40.33,40.54,9962978,15362066.3,65.620049993369,47.310672674384286,NaN,NaN,140.80274294449916,96.1784232360335,0.29201683827303243,0.15732115236034616,-0.13469568591268627,695028976,685267045,50.77059528472677,23.558110783568743,NaN,NaN,6.108466162543922,-8.636947046132052
2014-11-03T09:30:00-05:00,40.59,40.78,40.53,40.71,9530826,15491216.65,66.9224855746396,49.828855170322235,NaN,NaN,144.75070812505643,114.63947269034847,0.3113236663917553,0.25445889707700786,-0.05686476931474743,704559802,689917312.8,53.49272600159906,26.366917564410922,NaN,NaN,10.32628973702992,-5.927913219966056
2014-11-04T09:30:00-05:00,40.65,40.81,40.45,40.7,6433195,15362541.8,66.76226516538252,52.460169860088136,NaN,NaN,127.25280378701763,121.19990640243722,0.3069849598000683,0.3268664304353379,0.01988147063526964,698126607,691731845.4,54.54881637551917,29.497808451973718,NaN,NaN,13.687995220654273,-3.1256405855917233
2014-11-05T09:30:00-05:00,40.95,40.97,40.63,40.81,7278101,15292914.5,67.67892651319943,55.25910182095817,NaN,NaN,123.83771450355147,126.72424768972057,0.29501157114900106,0.38864593457152097,0.0936343634225199,705404708,697637218.2,57.89950898974455,33.04488809965166,NaN,NaN,16.76300900076699,-0.28440493039762194
2014-11-06T09:30:00-05:00,40.79,40.82,40.54,40.79,8589617,14957377.4,67.31541845380426,57.55542310327822,NaN,NaN,105.41773104107544,128.41234008024003,0.2699118891680061,0.43102422488252756,0.16111233571452144,696815091,699987036.8,59.188769790383176,36.7537881918357,NaN,NaN,19.2236637236986,2.5024620201875525
2014-11-07T09:30:00-05:00,40.83,40.88,40.64,40.84,7475718,13822032.45,67.7813188010872,59.61602110980073,NaN,NaN,98.10516604240912,119.87282469982202,0.24175272030533873,0.46330323609619484,0.2215505157908561,704290809,701839403.4,60.22287400052275,40.55261955783306,NaN,NaN,21.428941367488864,5.2062447840877395
2014-11-10T09:30:00-05:00,40.82,40.99,40.75,40.95,4820924,12632857.25,68.83386324061502,61.1133988760804,NaN,NaN,94.5498370753913,109.83265048988899,0.21643013097788344,0.4920881795132104,0.27565804853532694,709111733,702749789.6,60.749273810423006,44.417353422350814,NaN,NaN,23.60950288350275,7.835281655432741
2014-11-11T09:30:00-05:00,40.98,40.99,40.8,40.97,3054257,11708463.35,69.03195593169738,62.751179265938056,NaN,NaN,87.46627738921717,101.8753452103289,0.18797602893416177,0.5106280847030291,0.32265205576886735,712165990,705557666.2,62.401938731777136,48.40717936540456,NaN,NaN,25.515814041412966,10.361071996287059
2014-11-12T09:30:00-05:00,40.84,41.13,40.82,41.1,4516594,10480932.35,70.3510996400425,64.1492137745622,NaN,NaN,87.63805576294337,94.63541346220727,0.1656422740610332,0.5297048983451589,0.36406262428412567,716682584,707813241.4,63.72332140220556,51.606534355312995,NaN,NaN,27.52778298351662,12.813459280176996
2014-11-13T09:30:00-05:00,41.2,41.46,41.131,41.32,5396126,9394583.05,72.486996829234,65.45796519888253,NaN,NaN,99.9427232491531,93.54041190382281,0.15368146405385635,0.5561644543514461,0.40248299029758977,722078710,712865965.2,66.55862887465543,54.35535727438709,NaN,NaN,29.89448003156989,15.253605101804553
2014-11-14T09:30:00-05:00,41.33,41.61,41.33,41.61,4343269,8972392.85,75.03959994950534,66.92075843997657,NaN,NaN,106.55146799824013,95.229672294989,0.15296618568028958,0.5936907223979517,0.44072453671766215,726421979,717292199.2,68.85506105198007,56.74606798002679,NaN,NaN,32.74249367846818,17.752017755613643
2014-11-17T09:30:00-05:00,41.49,41.5901,41.33,41.53,4132672,8717956,73.0267836381169,67.87757969384491,NaN,NaN,99.49389190982866,96.21848326187649,0.13537570825522321,0.6099441720366912,0.47456846378146794,722289307,719927714,70.16864635703084,58.810842237234134,NaN,NaN,34.65068452819626,20.16611300883973
2014-11-18T09:30:00-05:00,41.5,41.76,41.49,41.67,4829936,8380788.1,74.32471474914426,68.96469320362785,NaN,NaN,107.83759426978277,100.29274663798961,0.12186164230219987,0.6268955166592178,0.505033874357018,727119243,722918364.6,71.63083130327944,60.61498109955806,NaN,NaN,36.658240459069,22.52213121601534
2014-11-19T09:30:00-05:00,41.68,41.68,41.21,41.4,7166995,8135179.2,67.57160860241736,69.48193479158967,NaN,NaN,87.26537527194009,100.21821053978894,0.08516803225670633,0.6114939146779008,0.5263258824211945,719952248,723572297.4,71.95453239258461,62.297537454745104,NaN,NaN,36.62663956331641,24.53706097991549
2014-11-20T09:30:00-05:00,41.26,41.61,41.18,41.61,4897385,6769249.25,69.86501744833734,69.78514675265883,NaN,NaN,89.54682698858737,98.1390312876758,0.0663078361675924,0.6092106776306849,0.5429028414630925,724849633,724126482,72.24357844410831,63.831321966129494,NaN,NaN,37.22462370131376,26.349569940115245
2014-11-21T09:30:00-05:00,41.94,41.96,41.5033,41.67,6462782,6747229.8,70.50680969950461,70.0411699044349,NaN,NaN,112.87040557923468,99.40281880387471,0.049890182555705764,0.6052655696577247,0.555375387102019,731312415,725104569.2,72.7768525505957,65.20875957677211,NaN,NaN,37.89841506524102,27.999404957990354
2014-11-24T09:30:00-05:00,41.75,41.9,41.63,41.89,3113210,6605716,72.79469009135205,70.472057399147,NaN,NaN,116.68661637258174,102.84136369642533,0.045961224172895276,0.612826917318138,0.5668656931452427,734425625,727531832.8,74.10639902909826,66.60572976631347,NaN,NaN,39.12253938802935,29.58842416228164
2014-11-25T09:30:00-05:00,41.95,42.08,41.88,41.91,4744583,6455671.1,72.99974558912737,70.85211590457043,NaN,NaN,123.51590666278649,105.97702617502605,0.0371976128137389,0.6133627091624163,0.5761650963486774,739170208,729942025.8,75.39159179385429,67.85516425232132,NaN,NaN,40.19632298158115,31.103838279324428
2014-11-26T09:30:00-05:00,41.92,42.31,41.92,42.29,10241047,6308918.45,76.60746902590654,71.51583380257775,NaN,NaN,138.6681491954776,116.25758095973356,0.04875271571088191,0.6371059909872798,0.5883532752763979,749411255,735833827.2,78.23544152182089,69.21564080456686,NaN,NaN,42.23320842512195,32.69374830015265
2014-11-28T09:30:00-05:00,42.37,42.58,42.29,42.49,5432541,6121137.8,78.25437342523853,72.26390913287426,NaN,NaN,164.2013657243148,131.18848870687904,0.06083916068924888,0.664402226137959,0.6035630654487101,754843796,741832659.8,80.68316532737133,70.67709018505606,NaN,NaN,44.47605359362171,34.376934770648226
2014-12-01T09:30:00-05:00,42.39,42.44,41.83,42.005,11664727,6206225.25,66.10102859695577,72.06870665832717,NaN,NaN,103.76294696170633,129.36699698337338,0.028771284703839717,0.6395271713285098,0.6107558866246701,743179069,744205990.6,81.56644428039854,72.16403093291144,NaN,NaN,42.681356612805374,35.563280748099245
2014-12-02T09:30:00-05:00,41.99,42.09,41.85,42.02,5630638,6011215.85,66.27547708924973,71.87181531243806,NaN,NaN,82.00361500158111,122.43039670917324,0.002552643129652532,0.6139466905367357,0.6113940474070831,748809707,747082807,82.60476331454451,73.60708983168055,NaN,NaN,41.30446387495723,36.383449766221815
2014-12-03T09:30:00-05:00,42.11,42.24,41.925,42.17,4271682,5903140.2,68.04634405974409,71.70718991384531,NaN,NaN,92.46887907999111,116.22099119261415,-0.010015820493164407,0.5988742717906277,0.6088900922837921,753081389,749865043.2,83.5687244250038,75.02461861902327,NaN,NaN,40.655620819959395,36.99375991675576
2014-12-04T09:30:00-05:00,42.14,42.3,42.01,42.17,3766828,5727576.55,68.04634405974409,71.39000043031032,NaN,NaN,90.18608433155931,106.5245782198305,-0.022919578884197933,0.5802406186785447,0.6031601975627426,753081389,750599070,83.82341831654533,76.25781786487256,NaN,NaN,40.12887258363017,37.44163315488067
2014-12-05T09:30:00-05:00,42.2,42.28,42.02,42.12,7179458,5657068.6,66.69251042199213,70.79377974977366,NaN,NaN,79.93156282199539,89.67061763936661,-0.03849570203736241,0.5550405700160397,0.5935362720534021,745901931,748810697,80.5475208597058,77.09299356542441,NaN,NaN,39.31708508973136,37.70955485985934
2014-12-08T09:30:00-05:00,42.04,42.11,41.51,41.69,6689945,5617779.95,56.31551352115367,69.600117598562,NaN,NaN,12.495103369248389,71.41704892087503,-0.07909325829598668,0.49466969918341874,0.5737629574794054,739211986,748017280.4,79.07109866163572,77.72888301575333,NaN,NaN,35.405776108706114,37.380443609694595
2014-12-09T09:30:00-05:00,41.14,41.74,41,41.68,8221690,5787818.25,56.09691369227526,68.29813180878564,NaN,NaN,-51.2798022486248,44.76036547083388,-0.10626188475805731,0.44093560153183375,0.5471974862898911,730990296,744453398.2,72.63107311241518,77.80032885926302,NaN,NaN,32.17013659051682,36.63611403552634
2014-12-10T09:30:00-05:00,41.69,41.69,40.97,41.05,8270552,6048633,44.403012127268376,66.6432320605607,NaN,NaN,-106.66471363702895,4.933646927429871,-0.16291405312910168,0.34355491987851394,0.5064689730076156,722719744,738381069.2,63.18785413442525,77.17413755510879,NaN,NaN,25.06518368940948,34.983123986081075
2014-12-11T09:30:00-05:00,41.12,41.7,41.12,41.23,9038163,6274711.45,47.754125403305686,65.06388262877273,NaN,NaN,-91.20831401297013,-31.345232741476018,-0.18301251232476395,0.2777033326016607,0.46071584492642464,731757907,734116372.8,57.53050127691087,76.12320347173753,NaN,NaN,20.279950474792642,32.88267062732559
2014-12-12T09:30:00-05:00,40.91,41.215,40.57,40.615,8982960,6454053.15,39.08565397272599,62.81951436257425,NaN,NaN,-191.14670905811292,-85.56088711749769,-0.2294641405299887,0.17388566926393878,0.4033498097939275,722774947,729490976,52.08386443358216,74.64513289195087,NaN,NaN,12.739891072702363,30.005130690950843
2014-12-15T09:30:00-05:00,40.89,41.0555,40.1901,40.37,10251123,6749445.85,36.2617131193947,60.21001600743445,NaN,NaN,-202.77874476176066,-128.6156567436995,-0.265862822611863,0.0710212815290987,0.3368841041409617,712523824,724153343.6,46.60097358728015,72.6804596461067,NaN,NaN,5.65557253888164,26.526622383512386
2014-12-16T09:30:00-05:00,40.08,40.81,39.83,39.83,15651530,7325388.75,30.95337496226645,57.206703819801525,NaN,NaN,-215.77656493935157,-161.51500928184484,-0.31227268943581354,-0.0534567576538052,0.25881593178200835,696872294,717329743.2,40.702055674799844,70.20263563760281,NaN,NaN,-2.463477012796918,22.385179612611058
2014-12-17T09:30:00-05:00,39.95,40.7099,39.88,40.58,15282954,7848039.65,43.35606443250254,54.83160349170124,NaN,NaN,-150.03788835564393,-170.18964422556783,-0.27948797204934844,-0.0905440332796772,0.18894393876967125,712155248,715216844,39.05355979738331,67.40392980014299,NaN,NaN,-4.738131958565303,18.510420816728722
2014-12-18T09:30:00-05:00,41.3,41.76,41.18,41.74,10659258,8022652.8,56.4007552587527,53.270630765523684,NaN,NaN,-0.8641034774750382,-152.12080211846882,-0.17198200080528872,-0.026033562236939645,0.14594843856834908,722814506,713428163.8,37.662890788327864,64.33105304735416,NaN,NaN,-1.0346237007517634,15.718271599945796
2014-12-19T09:30:00-05:00,41.7,41.79,41.52,41.57,11694422,8362504.65,54.42271032834616,52.43646517490871,NaN,NaN,6.8106745081495985,-112.52932540521631,-0.10776334700160721,0.01124425481634006,0.11900760181794727,711120084,711097191.2,35.8702758204149,61.067041014498194,NaN,NaN,0.8315541114250438,13.59159767301426
2014-12-22T09:30:00-05:00,41.73,42.07,41.66,42.07,6107031,8344717.1,58.979490229061796,51.91532325632386,NaN,NaN,44.72517644939397,-63.02854116298539,-0.031039343879603304,0.08020842196844313,0.11124776584804644,717227115,712037849.4,37.16990790463458,57.82169419950463,NaN,NaN,4.09502551352872,12.234944507373468
2014-12-23T09:30:00-05:00,42.25,42.32,42.155,42.18,6699419,8524027.55,59.92867470553102,51.335489731022925,NaN,NaN,76.32389040970602,-4.608450093173866,0.02468262695661172,0.1421010495438111,0.11741842258719937,723926534,717448697.4,44.1777823120104,55.008055477147956,NaN,NaN,6.869496002939221,11.468451863882862
2014-12-24T09:30:00-05:00,42.28,42.28,42.13,42.14,2655636,8419580.2,59.39050581732489,50.717215570850136,NaN,NaN,69.3689053490873,39.27290864777238,0.05469098677338052,0.185782156053925,0.13109116928054448,721270898,719271827.4,46.34914440991087,52.33132162667407,NaN,NaN,8.803162520198766,11.087696243356563
2014-12-26T09:30:00-05:00,42.22,42.395,42.195,42.32,2278516,8021453.65,61.08409565174241,50.316614515832285,NaN,NaN,82.49871948269116,55.94547323980562,0.0809246997687128,0.23224704399143548,0.15132234422272267,723549414,719418809,46.52972356331519,49.90147896264617,NaN,NaN,10.904259389824674,11.061490978566292
2014-12-29T09:30:00-05:00,42.16,42.28,42.07,42.11,4638288,7981741,58.042787724057206,50.439991244611114,NaN,NaN,67.57758087183593,68.09885451254289,0.07834399003001313,0.2492523317602391,0.17090834173022595,718911126,720977017.4,48.50839920697148,47.71842900159873,NaN,NaN,11.690863940826274,11.15140140174629
2014-12-30T09:30:00-05:00,42.03,42.085,41.77,41.81,5503440,7673676.65,53.91313550112916,50.28400708810068,NaN,NaN,36.48325735938573,66.45047069454122,0.05191609187444843,0.2358034565732865,0.18388736469883807,713407686,720213131.6,47.57886823548715,45.928985796103866,NaN,NaN,11.078558432253509,11.140995263247321
2014-12-31T09:30:00-05:00,41.95,41.9965,41.31,41.35,5955293,7689909.4,48.24501677618993,50.55843599159507,NaN,NaN,-3.258804665258306,50.53393167954837,0.001597478621598175,0.1858842129758358,0.18428673435423762,707452393,716918303.4,43.69004309472073,44.536285007553545,NaN,NaN,8.735821261556675,10.797398977291515
2015-01-02T09:30:00-05:00,41.61,41.71,41.0601,41.27,8495232,7901086.9,47.313383077084545,50.52695439686499,NaN,NaN,-25.54039375243999,31.552071859242908,-0.03681051588608819,0.13827358949662738,0.17508410538271557,698957161,712455556,39.03606288586018,43.215253693907066,NaN,NaN,6.575192770359379,10.194226662015495
2015-01-05T09:30:00-05:00,41.12,41.12,40.52,40.64,7194733,8072482.15,40.65535356487681,50.63907579630433,NaN,NaN,-91.36319005440272,-3.2203100481758695,-0.10075557126104942,0.0491396413064038,0.14989521256745322,691762428,706098158.8,33.55287072026208,41.89161128581277,NaN,NaN,2.452540971989486,9.088271563440351
2015-01-06T09:30:00-05:00,40.76,40.76,39.96,40.15,8745602,8150789.35,36.36860006470433,50.64671057811216,NaN,NaN,-131.21733824572317,-42.97929387168769,-0.16819054092345234,-0.0603429635868622,0.10784757733659014,683016826,698919298.8,28.657682978553964,40.609947670903765,NaN,NaN,-2.5163383504385717,7.430470147171934
2015-01-07T09:30:00-05:00,40.46,40.59,40.2,40.49,6534578,8143021,41.01602442661242,51.36547125413688,NaN,NaN,-100.14006952803258,-70.30395924917136,-0.1809258674767744,-0.11830975700937785,0.06261611046739654,689551404,694148042.4,25.94807327029453,39.55609178486767,NaN,NaN,-5.115021590171444,5.638257041837166
2015-01-08T09:30:00-05:00,40.82,41.47,40.76,41.38,14211721,8442522.55,51.086795835087344,51.91766635432151,NaN,NaN,-10.525540516677406,-71.75730641945516,-0.12319682882621323,-0.09137992556537,0.03181690326084323,703763125,693410188.8,25.545812651944175,38.59125270305059,NaN,NaN,-3.8915952817791672,4.276849567034833
2015-01-09T09:30:00-05:00,41.5,41.6,40.9499,41.25,9169915,8487490.7,49.750615175004796,51.44265634833952,NaN,NaN,-3.505670098191839,-67.35036168860555,-0.08914156938721204,-0.07961005847317182,0.009531510914040218,694593210,692537398.6,25.05109940953305,37.690410461708105,NaN,NaN,-3.3870548414031996,3.182006080115114
2015-01-12T09:30:00-05:00,41.23,41.33,40.63,40.77,5628744,8317019.75,45.06390685399227,50.77417038588567,NaN,NaN,-40.51616432684912,-57.180956543094815,-0.0938428197621955,-0.10777201378870416,-0.013929194026508659,688964466,691977806.2,24.720548358235988,36.89400135726675,NaN,NaN,-4.530885807037949,2.0801643819503908
2015-01-13T09:30:00-05:00,41.11,41.615,40.45,40.74,11679230,8451833.25,44.7799724664005,49.75991911712415,NaN,NaN,-38.92948132031617,-38.723385158013414,-0.0936576168504708,-0.13100121508959717,-0.03734359823912636,677285236,690831488.2,24.02130814822219,35.954815660380156,NaN,NaN,-5.510227369957994,0.9958227031063358
2015-01-14T09:30:00-05:00,40.41,40.69,40.139,40.51,8830690,8380811.6,42.565655714181155,48.51970347488487,NaN,NaN,-92.4995641222535,-37.1952840768576,-0.10296945643739211,-0.1660554187858665,-0.06308596234847438,668454546,686612116.6,21.599501990264244,34.342081351684,NaN,NaN,-6.996088132460862,-0.14587884483183533
2015-01-15T09:30:00-05:00,40.68,40.78,39.96,39.99,9327741,8064622.15,37.99157886505334,46.99120869257977,NaN,NaN,-116.41537846432061,-58.37325166638624,-0.13601815054325314,-0.23310865052754082,-0.09709049998428768,659126805,677684852.6,17.564575182636034,32.28604069259294,NaN,NaN,-9.744527338851317,-1.5171143439774755
2015-01-16T09:30:00-05:00,39.86,40.42,39.8399,40.38,18821471,8241548,42.943725403227226,45.69546796054296,NaN,NaN,-117.05327029853076,-81.08277170645404,-0.12382809109409629,-0.25187561385190804,-0.12804752275781175,677948276,674355865.8,16.338853469322558,30.12954997159347,NaN,NaN,-10.503576810091051,-2.800894696279415
2015-01-20T09:30:00-05:00,40.62,40.81,40.2055,40.72,12015828,8309376.5,46.923377319289926,44.90122436020244,NaN,NaN,-69.03547779551546,-86.7866344001873,-0.086830934319817,-0.23658619065758302,-0.149755256337766,689964104,674555793.4,16.714749455718476,27.85857498936112,NaN,NaN,-9.88421335532471,-3.812797361857314
2015-01-21T09:30:00-05:00,40.54,40.96,40.34,40.79,13919088,8420609.8,47.73169833712308,44.459693134202006,NaN,NaN,-51.08122537990965,-89.21698321210599,-0.05325748559586996,-0.21632711333260346,-0.1630696277367335,703883192,679875384.6,26.214362208106223,26.332538844548196,NaN,NaN,-9.144800156592602,-4.574512046819498
2015-01-22T09:30:00-05:00,40.9,41.49,40.56,41.46,8812196,8555868.05,54.82347229788816,44.92958281432332,NaN,NaN,3.4770951237532732,-70.02165136290463,0.014822056463937111,-0.14454205715681212,-0.15936411362074923,712695388,688723553,38.732213779509195,25.978408179175943,NaN,NaN,-6.205233008047188,-4.8074721841377395
2015-01-23T09:30:00-05:00,41.45,41.64,41.314,41.45,6478772,8544835.7,54.70417054799611,45.45749620510271,NaN,NaN,44.25186496345638,-37.88820267734924,0.057530713380767595,-0.08745072189478975,-0.14498143527555735,706216616,698141515.2,48.70701370582637,26.669190380602096,NaN,NaN,-3.9139251122296943,-4.67982260243659
2015-01-26T09:30:00-05:00,41.4,41.51,41.15,41.28,9733510,8898729.4,52.608282859021436,46.31127686897018,NaN,NaN,33.45804873410061,-7.785938870822973,0.0717565822935256,-0.05528570740865035,-0.12704228970217596,696483106,701848481.2,52.01828036963762,27.98814821270035,NaN,NaN,-2.6080250355144314,-4.38385152144771
2015-01-27T09:30:00-05:00,40.6,40.6,39.91,40.09,10791955,9324401.35,40.81888908812542,46.6291546563574,NaN,NaN,-104.94233384509836,-14.967310080739555,0.002126683073158775,-0.12438393586072749,-0.12651061893388627,685691151,700993890.6,51.1977191683906,29.59815079768868,NaN,NaN,-5.299745212071454,-4.514693477251102
2015-01-28T09:30:00-05:00,40.81,40.94,40.02,40.02,13047244,9744849.15,40.247525846386175,46.57426190062696,NaN,NaN,-80.41473644398029,-20.834012293553684,-0.04494133634689118,-0.18268728936750023,-0.13774595302060905,672643907,694746033.6,45.54157250397874,30.997686457237556,NaN,NaN,-7.583735486838422,-4.9531280500492905
2015-01-29T09:30:00-05:00,40.04,40.48,39.66,40.4,16817569,10310555.6,44.7673086143561,46.122869956289016,NaN,NaN,-95.15010982315907,-40.55945328293616,-0.04658024413595557,-0.1959712581905535,-0.14939101405459793,689461476,690099251.2,41.839362537153875,32.16151144903825,NaN,NaN,-8.074004821352064,-5.39896758880683
2015-01-30T09:30:00-05:00,40.29,40.49,39.82,39.9,13006347,10663108.3,40.43346062920544,45.457358917303345,NaN,NaN,-103.99290948712425,-70.20840817305228,-0.07571252896934416,-0.24403167526627811,-0.16831914629693395,676455129,684146953.8,37.62050715053115,33.059326287680975,NaN,NaN,-9.894489313120419,-6.041184977994485
2015-02-02T09:30:00-05:00,40.04,40.36,39.39,40.31,15623563,11019524.85,45.12470535466185,45.46170166735117,NaN,NaN,-102.64878265109898,-97.4297744500922,-0.06230332914643388,-0.2461983077299763,-0.18389497858354242,692078692,683266071,37.02549121063719,33.9382507771382,NaN,NaN,-9.909927932733247,-6.593862542957165
2015-02-03T09:30:00-05:00,40.43,40.805,40.32,40.77,9883683,11153972.35,49.89279644410995,45.826903380044705,NaN,NaN,0.3724074103137158,-76.3668261990098,-0.01959999823816591,-0.20839497638124982,-0.1887949781430839,701962375,686520315.8,40.7535524855415,35.13341108694672,NaN,NaN,-8.37109281012885,-6.847752581124548
2015-02-04T09:30:00-05:00,40.7,41.145,40.7,40.85,5889364,11011160.45,50.69516522929454,46.40758263112423,NaN,NaN,40.528039847317466,-52.178270940750224,0.015019707452601533,-0.170020343827332,-0.18504005127993353,707851739,693561882.2,47.935812030939445,37.01457608985209,NaN,NaN,-6.900634590312644,-6.855307153865705
2015-02-05T09:30:00-05:00,41.02,41.25,40.89,41.23,5091765,10939019.8,54.428091154817906,47.581619223250264,NaN,NaN,70.77325297391793,-18.993598381334824,0.06186899747806332,-0.10770380443235439,-0.1695728019104177,712943504,698258287.8,52.106046471672094,39.481824039068954,NaN,NaN,-4.492602343740866,-6.517777895276442
2015-02-06T09:30:00-05:00,41.29,41.48,40.98,41.1,4790310,10467949.25,52.951095383065784,48.296431364667306,NaN,NaN,81.536881148869,18.112359745863827,0.0812396163331002,-0.06802328149404246,-0.14926289782714267,708153194,704597900.8,57.101194929381926,42.39341985764462,NaN,NaN,-2.959198707231978,-6.0094094398415185
2015-02-09T09:30:00-05:00,40.99,41.24,40.95,41.04,7165741,10367740.55,52.24639411628377,48.676646850166875,NaN,NaN,66.47461370523844,51.93703901713131,0.08665377154855494,-0.040945683391448995,-0.12759945494000394,700987453,706379653,58.413952691136835,45.371934374460224,NaN,NaN,-1.9025460769276026,-5.422714673710959
2015-02-10T09:30:00-05:00,41.32,41.7,41.17,41.65,11245749,10648590.8,58.3196884375236,49.43293185733834,NaN,NaN,124.30512908396483,76.72358335186154,0.12559680005771273,0.029396545132136964,-0.09620025492557575,712233202,708433818.4,59.936129470908114,47.78063203608893,NaN,NaN,0.9009898635663899,-4.5193283112427665
2015-02-11T09:30:00-05:00,41.71,41.88,41.59,41.81,6249959,10377127.25,59.76511410467892,49.7859062721091,NaN,NaN,142.37275964327293,97.09252731105263,0.1545094096494995,0.09693650713629864,-0.057572902513200866,718483161,710560102.8,61.50675481761895,49.407384967382484,NaN,NaN,3.6485095656059903,-3.3524943288358013
2015-02-12T09:30:00-05:00,42.13,42.41,42.07,42.38,6769238,10274054.65,64.4896515558656,50.48486920124263,NaN,NaN,180.5255378620159,119.04298428867223,0.20143258418136178,0.19421782771350138,-0.00721475646786042,725252399,713021881.8,63.30062400868499,50.449785703300954,NaN,NaN,7.580800199093854,-1.7905951105601363
2015-02-13T09:30:00-05:00,42.48,42.68,42.4,42.65,4315840,10023459.6,66.496524922579,51.47688649149675,NaN,NaN,184.50510031866287,139.636628122631,0.23758023679893672,0.2897605395308105,0.05218030273187376,729568239,717304890.8,66.24771804258617,51.46617410851153,NaN,NaN,11.491044956452967,0.10678204187030693
2015-02-17T09:30:00-05:00,42.69,42.74,42.56,42.67,5340289,9349400.5,66.64689182818819,53.321743830072656,NaN,NaN,169.2702929697153,160.19576397552638,0.2485831719841964,0.3629092677121193,0.11432609572792288,734908528,724089105.8,70.31420428221392,52.83163733092748,NaN,NaN,14.687146356721254,2.189691229706156
2015-02-18T09:30:00-05:00,42.67,42.75,42.55,42.71,3749777,8936097.95,66.96621863337968,55.23022188628648,NaN,NaN,146.93727523792475,164.72219320631837,0.24395887531729465,0.4192746898745412,0.17531581455724654,738658305,729374126.4,73.03928480909877,54.79575963843605,NaN,NaN,17.409784822680066,4.363990314416714
2015-02-19T09:30:00-05:00,42.68,42.9,42.6,42.86,3125425,8396414.8,68.1959150838124,56.90369377696192,NaN,NaN,134.96725223472228,163.24109172460822,0.23624605714310673,0.47062338598612996,0.23437732884302323,741783730,734034240.2,75.20100394270807,57.17873402454706,NaN,NaN,20.070768674756803,6.6078157944652975
2015-02-20T09:30:00-05:00,42.86,43.14,42.6372,43.08,6933497,8302479.85,69.96205825007944,59.01287932131007,NaN,NaN,127.42247195759543,152.62047854372412,0.23093051611161364,0.5230404739825403,0.29210995787092664,748717227,738727205.8,77.18492879735136,60.00476414217708,NaN,NaN,22.871762344149722,8.9312367301345
2015-02-23T09:30:00-05:00,43.13,43.14,42.89,43.11,4047028,8180892.65,70.20503745242374,60.80433161400735,NaN,NaN,116.35302861717504,138.99006420342658,0.21474449791056205,0.5605405802591292,0.3457960823485672,752764255,743366409,78.97552244443378,63.00119494459112,NaN,NaN,25.280549959445896,11.266852905750413
2015-02-24T09:30:00-05:00,43.08,43.3,42.86,43.24,4655463,7926990.3,71.28885511187416,62.33262151884765,NaN,NaN,106.54804001490035,126.44561361246357,0.19848589326868182,0.5939034489344195,0.39541755566573766,757419718,747868647,80.56931929187839,65.84517828790091,NaN,NaN,27.64880640598863,13.607131977213015
2015-02-25T09:30:00-05:00,43.12,43.17,42.88,42.97,5867350,7680760.05,65.92509622886476,63.42047373310267,NaN,NaN,88.09411891107888,114.67698234709442,0.15705464074592318,0.5917358565981417,0.43468121585221847,751552368,750447459.6,81.43732833811015,68.23814373841309,NaN,NaN,28.346047867098623,15.712691390053816
2015-02-26T09:30:00-05:00,43.1,43.3,42.98,43.24,7559392,7406367.45,68.47915094677654,64.42412086109971,NaN,NaN,89.81859898186045,105.64725169652206,0.13612113409219312,0.6048326334674599,0.46871149937526674,759111760,753913065.6,82.56456013548936,70.41375185725718,NaN,NaN,29.657040290538063,17.704741232980137
2015-02-27T09:30:00-05:00,43.23,43.32,43.05,43.09,6055998,6868288.9,65.54004997896445,65.3233319036639,NaN,NaN,81.09021640788296,96.38080058657954,0.10201892004912494,0.5962351494366729,0.49421622938754795,753055762,754780772.6,82.84544656825257,72.25262697431937,NaN,NaN,29.98612775591622,19.459225021971005
2015-03-02T09:30:00-05:00,43.24,43.46,43.1,43.43,6844453,6560194.2,68.80797477402595,66.5063019506455,NaN,NaN,87.62424174087343,90.63504321131923,0.09248864326160544,0.6098270334645548,0.5173383902029494,759900215,756207964.6,83.32138611647031,74.03172936184319,NaN,NaN,31.194254082364033,21.135657744884295
2015-03-03T09:30:00-05:00,43.39,43.39,42.945,43.14,8612123,6209622.2,63.294479491972346,66.8616441688204,NaN,NaN,71.26963482075381,83.57936217248994,0.058443245033920954,0.5903924464953505,0.5319492014614295,751288092,754981639.4,81.23580166149635,75.55313451831378,NaN,NaN,30.66025202757371,22.496314070982784
2015-03-04T09:30:00-05:00,43.03,43.05,42.74,42.97,5882663,6009571.2,60.24687661186751,66.89605577647673,NaN,NaN,46.92052383383811,75.34464315704177,0.01834187533764875,0.5548765456334905,0.5365346702958418,745405429,753752251.6,79.09830041567818,76.80967348960372,NaN,NaN,29.328297050088725,23.47231163942649
2015-03-05T09:30:00-05:00,43.07,43.07,42.77,42.92,7704334,6100319.7,59.341854021555775,66.52835595259747,NaN,NaN,42.969935519416055,65.97491046455289,-0.015836765073571457,0.5167387139538775,0.532575479027449,737701095,749470118.6,71.992662433835,77.43053337711444,NaN,NaN,27.970691591667023,24.114937346889423
2015-03-06T09:30:00-05:00,42.9,42.96,42.3215,42.39,8076686,6249565.75,50.65542295236065,65.39684866901044,NaN,NaN,-4.580762570786859,48.84071466881892,-0.07510783614480276,0.4386906838464455,0.5137985199912483,729624409,744783848,65.1002612176153,77.3485721753308,NaN,NaN,24.054277094155783,24.106271596498903
2015-03-09T09:30:00-04:00,42.47,42.77,42.41,42.59,6249286,6322514.55,53.42595413617593,64.45249597672384,NaN,NaN,-11.3432355378083,29.047219213082563,-0.10024118860799297,0.38849703423125703,0.48873822283925,735873695,739978544,58.875857549374714,76.53154740869944,NaN,NaN,21.551547607007464,23.741311026571555
2015-03-10T09:30:00-04:00,42.35,42.36,41.72,41.72,8797871,6404121.05,42.29998672881617,62.690622269255016,NaN,NaN,-134.97279430638056,-12.201266612344307,-0.17071657887750946,0.2753424992423632,0.44605907811987267,727075824,735136090.4,53.34101145718869,75.124527883563,NaN,NaN,15.263270969306411,22.530162446962247
2015-03-11T09:30:00-04:00,41.82,41.82,41.42,41.45,11520207,6417843.95,39.54744967884676,60.644303311757476,NaN,NaN,-201.75768099195207,-61.93690757750234,-0.22723734770352122,0.16201239349047114,0.38924974119399236,715555617,729166128,47.422123590765196,73.14032214413852,NaN,NaN,9.20296708328333,20.626277395008117
2015-03-12T09:30:00-04:00,41.33,41.75,41.29,41.72,12334908,6722091.4,43.50637294626046,58.75461150434183,NaN,NaN,-191.3022710588734,-108.79134889316022,-0.23706925971434278,0.09291316655106385,0.32998242626540664,727890525,727204014,45.630005154421866,70.8863990267864,NaN,NaN,5.514111534696093,18.467396557820685
2015-03-13T09:30:00-04:00,41.66,41.76,41.26,41.49,15187664,7143012.7,41.040750868615824,56.67144817692698,NaN,NaN,-178.63633534413887,-143.60246344783064,-0.24849059882455748,0.019369177734709808,0.2678597765592673,712702861,723819704.4,42.63702951224419,68.29079238877287,NaN,NaN,1.6909194540202237,16.070756971563476
2015-03-16T09:30:00-04:00,41.71,42.01,41.58,41.98,8639361,7359188.75,47.82482346017343,54.995445916091214,NaN,NaN,-107.06048943086202,-162.74591422644136,-0.21379435629141677,0.0006168311949963368,0.2144111874864131,721342222,720913409.8,40.19855966654055,65.40716670124873,NaN,NaN,0.6104687815948511,13.86214437299653
2015-03-17T09:30:00-04:00,41.88,42.11,41.81,41.99,9533738,7568861.2,47.95643506457392,53.71197011864187,NaN,NaN,-80.1139256139856,-151.77414048796237,-0.18215653944498691,-0.013284486819820529,0.16887205262516639,730875960,721673437,41.14649124853298,62.529249766278944,NaN,NaN,-0.19310837810350784,11.854251122839383
2015-03-18T09:30:00-04:00,41.94,42.71,41.765,42.56,15855386,8174141.65,54.934485844705975,52.74449403992254,NaN,NaN,-28.959014492242243,-117.21440718802042,-0.11794112786777017,0.02144564279045369,0.13938677065822386,746731346,727908582.8,48.37615148507314,60.087220576963496,NaN,NaN,1.3801984414214274,10.357957882636818
2015-03-19T09:30:00-04:00,42.5,42.648,42.41,42.44,8992350,8467487.9,53.31380376251737,51.87119073874776,NaN,NaN,-7.73403198436057,-80.50075937311786,-0.08043836537874856,0.03883881393478816,0.11927717931353672,737738996,729878277,50.44701842488313,57.7730471381514,NaN,NaN,2.1395882805171333,9.183905082334006
2015-03-20T09:30:00-04:00,42.52,42.75,42.45,42.54,19296143,9085620.2,54.517995926118225,50.850477963897205,NaN,NaN,5.082529502982868,-43.75698640369349,-0.04742130926264988,0.06000054273522437,0.10742185199787425,757035139,738744732.6,58.51443910943091,56.00112235193429,NaN,NaN,3.119800809680428,8.317604471954922
2015-03-23T09:30:00-04:00,42.55,42.745,42.53,42.54,3753071,9070922.35,54.517995926118225,50.223586280621916,NaN,NaN,11.676696984549297,-20.00954912061122,-0.025220299263842186,0.07589647791807153,0.10111677718191371,757035139,745883316,63.64614814321954,54.744718529200235,NaN,NaN,3.9110316655170876,7.688094071035232
2015-03-24T09:30:00-04:00,42.57,42.69,42.4,42.4,7117370,9194017.7,52.326569126921854,49.657850031697215,NaN,NaN,1.3263541556602165,-3.721493166682065,-0.019839381830188796,0.07631754989417772,0.09615693172436651,749917769,749691677.8,66.05832514551733,53.813291724188744,NaN,NaN,3.977190549107933,7.15796499647419
2015-03-25T09:30:00-04:00,42.35,42.43,41.31,41.31,8174282,9309364.3,39.13638316480577,48.214602113357934,NaN,NaN,-99.8198600364344,-17.89366227552052,-0.08586461180295317,-0.011173833029324953,0.07469077877362822,741743487,748694106,64.84459217511323,53.30271527713718,NaN,NaN,-0.4124479670736256,6.076477430253074
2015-03-26T09:30:00-04:00,41.08,41.55,40.94,41.34,9002360,9381512.7,39.58775357306078,47.4240543005508,NaN,NaN,-133.6076145383902,-43.06837878632645,-0.12151319365170184,-0.07720071329099909,0.04431248036070275,750745847,751295476.2,66.56955760378528,53.40766501900647,NaN,NaN,-3.689869617422609,4.6812849948708335
2015-03-27T09:30:00-04:00,41.35,41.48,41.145,41.37,7909332,9474179.4,40.066417006574156,46.46980164843639,NaN,NaN,-111.29636728550427,-66.34415814402387,-0.1359765702348574,-0.125658232432869,0.010318337801988396,758655179,751619484.2,66.78814226352694,53.9728282128745,NaN,NaN,-6.165505894281926,3.131743439277582
2015-03-30T09:30:00-04:00,41.68,41.9,41.6,41.87,6605417,9462227.6,47.528531650687164,46.84326914285574,NaN,NaN,-48.25824202820297,-78.33114594657431,-0.10609905637997874,-0.12230548267298502,-0.01620642629300629,765260596,753264575.6,67.93453666845218,55.01522287082189,NaN,NaN,-6.052813191154052,1.8196639206444913
2015-03-31T09:30:00-04:00,41.74,41.82,41.44,41.44,7963627,9429802.8,42.61455825631184,47.06234832696039,NaN,NaN,-71.05503703999338,-92.80742418570505,-0.1091043662101728,-0.1525868840557223,-0.04348251784554949,757296969,754740415.6,68.96935847373877,56.55431107674857,NaN,NaN,-7.531452882456592,0.4837900916300508
2015-04-01T09:30:00-04:00,41.48,41.5201,41.09,41.38,10427833,9657061.3,41.962617027103114,46.95208004702057,NaN,NaN,-97.00340492518264,-92.24413316345468,-0.10870124304000021,-0.17935907164554976,-0.07065782860554955,746869136,755765545.4,69.70080635675919,58.273654019772664,NaN,NaN,-8.908951113269017,-0.8580300804983874
2015-04-02T09:30:00-04:00,41.45,41.54,41.29,41.37,5469259,9545307.55,41.847707625812674,47.00971981539178,NaN,NaN,-81.7444453036909,-81.87149931651483,-0.10274427716845883,-0.19908817506612309,-0.09634389789766426,741399877,753896351.4,66.61733382801594,59.98653289947065,NaN,NaN,-10.049978397649644,-2.171165554377138
2015-04-06T09:30:00-04:00,41.08,41.8499,41.04,41.77,7344724,9508709.45,47.98360290210841,47.02106120410143,NaN,NaN,-52.8302822021035,-70.17828229983468,-0.0672191271259724,-0.18036780680512976,-0.11314867967915736,748744601,751914235.8,63.41368743987097,61.64475631185139,NaN,NaN,-9.228550470095351,-3.1793633994797403
2015-04-07T09:30:00-04:00,41.77,42.015,41.67,41.68,4684336,9430461.95,46.78739365901104,46.93755824656122,NaN,NaN,-8.214623133460446,-62.16955852088618,-0.046140948426721326,-0.17082486521255902,-0.12468391678583769,744060265,747674169.6,57.089012650667,62.78350784057525,NaN,NaN,-8.894505733395615,-3.9958123043248652
2015-04-08T09:30:00-04:00,41.68,41.94,41.6,41.81,7203527,9350744.75,48.7739051213912,46.49751676632445,NaN,NaN,-7.858350741074701,-49.53022126110243,-0.0210777538438065,-0.1510311090905958,-0.1299533552467893,751263792,746467534.2,55.39576733571553,63.28490897276399,NaN,NaN,-8.048712723249487,-4.574798078456954
2015-04-09T09:30:00-04:00,41.81,41.99,41.59,41.92,7290096,9139239.2,50.4591912740881,46.29361587429379,NaN,NaN,-1.0792136427948413,-30.345383004624875,0.003941004605637843,-0.125027099489742,-0.12896810409537984,758553888,748804484.6,57.99433106181469,63.82400273254482,NaN,NaN,-6.865286543189852,-4.90201071627594
2015-04-10T09:30:00-04:00,41.96,42.1185,41.83,42.08,4316277,8738307.65,52.88710991777696,46.17712401655513,NaN,NaN,28.58015140608718,-8.280463662669261,0.030802287532243608,-0.09046524468007533,-0.12126753221231894,762870165,753098542.2,62.33626972824615,64.09699063388877,NaN,NaN,-5.17185845675852,-4.940560393487737
2015-04-13T09:30:00-04:00,42.16,42.34,41.95,41.96,3887185,8173283.7,50.87335165341343,45.9167922827905,NaN,NaN,37.25102849087452,9.735798475926336,0.03947116575543305,-0.07192857501802763,-0.11139974077346068,758982980,755146218,64.23478724023964,64.1390362836759,NaN,NaN,-4.26591996423485,-4.844183189308754
2015-04-14T09:30:00-04:00,41.98,42.03,41.63,41.83,5851306,8033880.95,48.70954542345002,45.65843344682823,NaN,NaN,-11.046950735669236,9.16933295548458,0.035554820825737354,-0.06695621474128899,-0.10251103556702634,753131674,756960499.8,65.8760524791206,64.12601680750473,NaN,NaN,-4.064956052837151,-4.732865026955667
2015-04-15T09:30:00-04:00,41.94,42.29,41.9,42.2,12583053,8186346.7,54.62499500278589,46.76476286382681,NaN,NaN,43.5852585156159,19.458054806822705,0.05578339839294122,-0.03278178757584982,-0.08856518596879104,765714727,759850686.8,68.36646646959083,64.37757925711027,NaN,NaN,-2.1803081120662817,-4.368214039114327
2015-04-16T09:30:00-04:00,42.03,42.175,41.934,42.05,9114345,7849294.65,52.00632029541965,47.6518033439953,NaN,NaN,33.61767899591733,26.397433334565143,0.056772803320161463,-0.017599181818589216,-0.07437198513875068,756600382,759459985.6,67.64773112478798,64.4545916514676,NaN,NaN,-1.3118986273544,-3.931597551720052
2015-04-17T09:30:00-04:00,41.7,41.79,41.34,41.47,10159434,7907648.85,43.3522037371335,47.88650239617811,NaN,NaN,-63.844336690292735,7.912535715289158,0.01808060917584016,-0.05177122366895048,-0.06985183284479064,746440948,756174142.2,61.766531973951764,64.09590520221222,NaN,NaN,-3.2029655513754425,-3.827507265956536
2015-04-20T09:30:00-04:00,41.66,42.23,41.64,42.18,4845778,7185130.6,53.54347522887851,48.31614122319178,NaN,NaN,50.195126523884895,10.501355321891234,0.038828643205801205,-0.021316028837539136,-0.06014467204334034,751286726,754634891.4,59.17132983554697,63.46996185700471,NaN,NaN,-1.4258065955742352,-3.484407170187636
2015-04-21T09:30:00-04:00,42.43,42.44,42.11,42.16,5001390,7247546.55,53.25284252885893,49.07601867123086,NaN,NaN,114.67400817962924,35.64554710495093,0.04906962155948595,0.0011923549060171013,-0.04787726665346885,746285336,753265623.8,56.881756295523836,62.60656170141793,NaN,NaN,-0.1499502990564863,-3.0080561885974717
2015-04-22T09:30:00-04:00,42.23,42.63,42.09,42.59,6095141,7196435.1,58.472017932150884,50.25526159301999,NaN,NaN,168.09235914586887,60.54696723100152,0.08079424108771324,0.053115534706172696,-0.02767870638154054,752380477,750598773.8,52.6118187455624,61.38591972918959,NaN,NaN,2.695299348695992,-2.193291111841263
2015-04-23T09:30:00-04:00,42.49,42.93,42.39,42.76,5899808,7082711.4,60.35646609376236,51.5773157693021,NaN,NaN,191.7228944775852,92.1680103273351,0.10754459470770486,0.10675203700309055,-0.0007925577046143176,758280285,750934754.4,53.089587858943496,60.41965215997012,NaN,NaN,5.606549728061105,-1.0790281347123531
2015-04-24T09:30:00-04:00,43.1,43.18,42.89,43.13,6228816,6944034.2,64.16762016426173,52.73331700231305,NaN,NaN,223.12749271243175,149.56237620788,0.14229329396249615,0.17707405974850587,0.03478076578600972,764509101,754548385,57.99487614446982,60.03259421029861,NaN,NaN,9.34824314828644,0.41058204857318836
2015-04-27T09:30:00-04:00,43.29,43.43,43.16,43.25,9250682,7011101.7,65.3316951493149,54.057909965906184,NaN,NaN,220.11740371729357,183.5468316465617,0.163954885918702,0.23972437318438722,0.07576948726568522,773759783,759042996.4,63.15548776800888,60.46591386153732,NaN,NaN,12.729563606597866,2.1704365568624278
2015-04-28T09:30:00-04:00,43.29,43.55,42.95,43.39,9149837,7138322.7,66.6912451209349,55.337719965873596,NaN,NaN,179.15598041500922,196.44322609363772,0.17718086304181185,0.29724556606795005,0.1200647030261382,782909620,766367853.2,69.69078405447269,61.48698648430569,NaN,NaN,15.92438717587844,4.135286645293286
2015-04-29T09:30:00-04:00,43.18,43.44,42.91,43.18,8571130,7168697.85,62.718126018183,56.21335816188038,NaN,NaN,134.67316383467204,189.75938703139838,0.16168621927380378,0.3221724771183929,0.16048625784458914,774338490,770759455.8,72.80526629586379,62.5449104295949,NaN,NaN,17.43474090500792,6.035208682395377
2015-04-30T09:30:00-04:00,42.96,43.09,42.41,42.58,8652555,7079933.95,53.00240617306645,56.22159360868677,NaN,NaN,60.661458150224334,163.5470997659262,0.10374489708377138,0.29016737919930335,0.18642248211553197,765685935,772240585.8,73.78371298582684,63.36258494799352,NaN,NaN,15.6539084877555,7.40930865458968
2015-05-01T09:30:00-04:00,42.84,43.12,42.72,43.1,10548396,7333890.8,58.93912984820003,56.797720622600096,NaN,NaN,86.92028275314998,136.30565777406983,0.09347552691021394,0.3032668907532994,0.20979136384308544,776234331,774585631.8,75.29904886202604,64.15288934954968,NaN,NaN,16.099157633098066,8.650715651519448
2015-05-04T09:30:00-04:00,43.2,43.36,43.12,43.14,7698750,7351592.1,59.36435573194186,57.55877850177808,NaN,NaN,103.1444919702795,112.91107542466702,0.08277882178876655,0.31326489107904365,0.2304860692902771,783933081,776620291.4,76.56475337810164,64.9163679851912,NaN,NaN,16.580590031151647,9.783554848609763
2015-05-05T09:30:00-04:00,43.03,43.1,42.44,42.47,8104890,7522619.8,50.02026536327073,57.22986924181271,NaN,NaN,29.21841164743503,82.92356167115217,0.02687579936893658,0.2640808185014478,0.23720501913251124,775828191,775204005.6,73.73256700035793,65.29966088024598,NaN,NaN,13.808848033470014,10.358596732161226
2015-05-06T09:30:00-04:00,42.63,42.71,41.86,42.11,9873883,7656137.6,45.84472201910083,56.7897550792185,NaN,NaN,-34.091926341112845,49.1705436359952,-0.03470891773071205,0.19381887196912118,0.22852778969983323,765954308,773527169.2,70.41162139577466,65.49708161388789,NaN,NaN,10.086545180490507,10.319732224779695
2015-05-07T09:30:00-04:00,42.18,42.57,42.09,42.42,5640285,7573647.05,49.735797683892216,57.24572607541556,NaN,NaN,-20.259085455679827,32.98643491481438,-0.05378949494642668,0.16129092101679987,0.21508041596322655,771594593,774708900.8,71.3896213903708,66.1844451436321,NaN,NaN,8.327611853432058,10.035143600301462
2015-05-08T09:30:00-04:00,42.85,43.06,42.78,43.03,9819247,7848795.55,56.37767063162725,57.44816860418332,NaN,NaN,60.034380600561484,27.60925448429669,-0.02596116905333873,0.18262895464655315,0.20859012369989188,781413840,775744802.6,72.25534920376518,67.11901795564769,NaN,NaN,9.108705789721549,9.902795341647188
2015-05-11T09:30:00-04:00,43,43.05,42.77,42.81,6046481,7956760.35,53.62546807388562,57.47478471454237,NaN,NaN,43.53974833770644,15.68830575778208,-0.023099548508548423,0.17971568806420635,0.20281523657275477,775367359,774031658.2,68.56053963846585,67.95321676585783,NaN,NaN,8.808196949013084,9.746424142699459
2015-05-12T09:30:00-04:00,42.58,42.77,42.21,42.58,7650527,8046721.4,50.83165494404935,56.929044501106546,NaN,NaN,-16.453728834144993,6.5538776614660765,-0.03662211416273731,0.15703759386933314,0.19365970803207044,767716832,772409386.4,65.16245773380763,68.84969097930392,NaN,NaN,7.656000184722539,9.447792148702757
2015-05-13T09:30:00-04:00,42.76,43.01,42.67,42.76,9306475,7882892.5,52.89978798274353,56.39642463603377,NaN,NaN,27.447690542494446,18.861801038187533,-0.03345638370413856,0.15183922840189723,0.1852956121060358,777023307,774623186.2,67.52768194404939,69.88098341395434,NaN,NaN,7.367056748587777,9.150544234400616
2015-05-14T09:30:00-04:00,43.1,43.47,43.06,43.45,6976158,7775983.15,59.86832262104649,56.08933195437554,NaN,NaN,106.8188469417605,44.27738751767558,0.012626557043184994,0.20107880841001702,0.18845225136683202,783999465,777104160.6,69.98693792414683,70.73755925535984,NaN,NaN,9.445288669380066,9.192650582254823
2015-05-15T09:30:00-04:00,43.54,43.58,43.21,43.31,8468238,7691423.35,57.99349429475908,55.5651747504787,NaN,NaN,107.9857743291275,53.867666263388784,0.030195990406264916,0.22619723937466318,0.19600124896839827,775531227,775927638,67.38084688145184,71.03937062060575,NaN,NaN,10.501242868981658,9.379592337501514
2015-05-18T09:30:00-04:00,43.25,43.6,43.19,43.52,3393310,7618799.95,60.01616331848862,55.08838319316111,NaN,NaN,112.82571912013215,67.72486041987392,0.051240050576366825,0.2600513121888568,0.20881126161248997,778924537,776639073.6,68.15310015109017,70.92953605607843,NaN,NaN,11.998200390204463,9.753679202173364
2015-05-19T09:30:00-04:00,43.57,43.62,43.36,43.41,4565385,7596999.7,58.429095433058066,54.78202386565217,NaN,NaN,108.84780110727813,92.78516640815855,0.05282033624490534,0.27483668191862165,0.2220163456737163,774359152,777967537.6,69.60038507044283,70.70061596854838,NaN,NaN,12.744153024018601,10.180889748151255
2015-05-20T09:30:00-04:00,43.44,43.67,43.28,43.44,11010945,7842789.9,58.74947880521987,55.19252905366314,NaN,NaN,99.50564971751126,107.19675824316191,0.05093234864950702,0.2856817814856001,0.23474943283609306,785370097,779636895.6,71.36162920043147,70.52760998387727,NaN,NaN,13.44083322442514,10.646595959047524
2015-05-21T09:30:00-04:00,43.38,43.68,43.325,43.63,3713121,7733455.55,60.809529917688906,55.32612905862663,NaN,NaN,105.01870726357599,106.836730307525,0.05706422707910122,0.3060797166849696,0.24901548960586836,789083218,780653646.2,72.4100881406324,70.32125564663487,NaN,NaN,14.615317174294432,11.213556132654224
2015-05-22T09:30:00-04:00,43.49,43.71,43.49,43.6,3968539,7620441.7,60.297494316329654,55.39278181465432,NaN,NaN,103.19843080741263,105.87926160318202,0.053731412006498,0.31617975461399084,0.26244834260749283,785114679,782570336.6,74.31880112169075,70.16083048546265,NaN,NaN,15.450598586420897,11.818847911763749
2015-05-26T09:30:00-04:00,43.47,43.5,42.84,42.97,7924384,7554126.8,50.65191420043842,55.43789958873773,NaN,NaN,9.685110985471072,85.25113997624982,0.00622795903431006,0.27023329140038044,0.2640053323660704,777190295,782223488.2,73.33014497935356,70.13208605539093,NaN,NaN,13.37132919898319,12.040630952795098
2015-05-27T09:30:00-04:00,43.13,43.81,43.1,43.78,12587062,7725988.05,59.60015966358107,56.42043084905775,NaN,NaN,94.18896354154269,82.31937246310274,0.025412656573670755,0.2957711530831588,0.27035849650948807,789777357,785307129.2,76.343226517722,70.55577213553002,NaN,NaN,14.363508778862204,12.372470642233257
2015-05-28T09:30:00-04:00,43.64,43.77,43.56,43.69,4664843,7530673.7,58.33444782269194,57.0346201446863,NaN,NaN,103.75793287651841,83.16982909490416,0.027896683322597593,0.30522935066273504,0.27733266734013745,785112514,785255612.6,76.18836377700214,70.89853944886083,NaN,NaN,14.750307875880807,12.712161675611478
2015-05-29T09:30:00-04:00,43.69,43.71,43.26,43.37,7738375,7484964.7,53.94760811247281,56.86104425046098,NaN,NaN,57.655115924550856,73.69711082709914,0.005041191516729382,0.2836341567360492,0.2785929652193198,777374139,782913796.8,69.30600197607943,70.68787178974041,NaN,NaN,13.69470563464261,12.852525098330212
2015-06-01T09:30:00-04:00,43.62,43.64,43.22,43.49,6936313,7304360.55,55.30498883174183,56.981010018879275,NaN,NaN,53.42881162553129,63.74318699072287,-0.004430214779280961,0.2730551967452186,0.27748541152449957,784310452,782752951.4,68.84599109387368,70.7082611794124,NaN,NaN,13.245160513955609,12.908615871990982
2015-06-02T09:30:00-04:00,43.33,43.6001,43.115,43.4,5637768,7201311.45,54.01898619111682,57.20867653652696,NaN,NaN,37.17361472466754,69.24088773856217,-0.018407840847832257,0.25447561046470923,0.2728834513125415,778672684,783049429.2,69.2511214242321,71.0003085858713,NaN,NaN,12.502647607203842,12.850620405592819
2015-06-03T09:30:00-04:00,43.47,43.73,43.405,43.49,5657318,7078932.85,55.14229530457843,57.368855630943735,NaN,NaN,62.645451214747254,62.932185273203075,-0.02294801323439244,0.24419843476955094,0.2671464480039434,784330002,781959958.2,65.86172699461582,70.8813118037689,NaN,NaN,12.199734366205155,12.757636685680296
2015-06-04T09:30:00-04:00,43.25,43.5,42.99,43.09,8347252,7002601.3,49.369553843559984,56.618943575408984,NaN,NaN,-13.608069456075905,39.458984806684214,-0.05255332125474421,0.20145479643551312,0.25400811769025733,775982750,780134005.4,60.515804388660136,70.20480226551985,NaN,NaN,10.230426075951641,12.396606598576202
2015-06-05T09:30:00-04:00,43.04,43.13,42.76,42.95,7727487,7106961.4,47.49541533072842,55.869080792263944,NaN,NaN,-87.2102812090799,10.485905379958064,-0.07960463928892736,0.15450231857909813,0.2341069578680255,768255263,778310230.2,55.6565228193142,69.36735054679573,NaN,NaN,8.039653197971957,11.774184684204167
2015-06-08T09:30:00-04:00,42.94,42.95,42.39,42.47,8379498,7034973.95,41.65660650505181,54.557683877018455,NaN,NaN,-157.59425622662621,-31.71870819047344,-0.12515366170995607,0.07766488073058042,0.2028185424405365,759875765,773423292.8,45.18621651689453,67.7268588586389,NaN,NaN,4.260179489534833,10.700755370679977
2015-06-09T09:30:00-04:00,42.4,42.53,42.085,42.37,7706653,7117982.55,40.5384987151976,53.27978411145699,NaN,NaN,-192.09003750800179,-77.5714386370073,-0.15537296909734324,0.008602331068857438,0.16397530016620068,752169112,768122578.4,37.04552368448537,65.4015116167848,NaN,NaN,0.8269827073373537,9.290216418773888
2015-06-10T09:30:00-04:00,42.47,43.12,42.47,43.03,8964836,7183698,50.06500051742198,52.65946423375714,NaN,NaN,-87.04898581540714,-107.51032604303819,-0.12554421113257536,0.007045036250481473,0.13258924738305683,761133948,763483367.6,31.668126186580366,62.56626140150972,NaN,NaN,0.6611063592851374,8.057486410275494
2015-06-11T09:30:00-04:00,43.18,43.29,42.99,43.05,5644698,7000609.15,50.32472245232464,51.91054941480255,NaN,NaN,-39.096394980031,-112.6079911478292,-0.1001993261027716,0.007340089754592327,0.10753941585736393,766778646,761642546.8,29.818538821409106,59.524007878708055,NaN,NaN,0.6081800709245956,6.993299790368223
2015-06-12T09:30:00-04:00,42.84,42.91,42.63,42.67,6158829,6959742.7,45.4840973898768,50.85244963434163,NaN,NaN,-110.86665552506797,-117.33926601102681,-0.10429215750987471,-0.022825781029979453,0.08146637647989526,760619817,760115457.6,28.33981499641149,56.23979458404524,NaN,NaN,-0.9298389573672131,5.8614228264060175
2015-06-15T09:30:00-04:00,42.39,42.469,42.09,42.41,9179103,6995285.95,42.47375982313497,50.26829575024853,NaN,NaN,-165.6172714320894,-118.94386905211945,-0.11872560370964053,-0.0669406281571554,0.051784975552485124,751440714,758428447.4,26.760966381069977,52.91342468416785,NaN,NaN,-3.154291096802804,4.573463694519043
2015-06-16T09:30:00-04:00,42.39,42.74,42.32,42.69,9173344,7284287.65,46.57459932457897,49.337898583176944,NaN,NaN,-101.21823409949288,-100.76950837041767,-0.10415158370239977,-0.07840450407551458,0.025747079626885182,760614058,760117436.6,30.910951494610018,49.66826218251698,NaN,NaN,-3.7843607941829305,3.379488767561619
2015-06-17T09:30:00-04:00,42.72,42.88,42.46,42.71,11023877,7607212.25,46.86596355825681,48.51872113571729,NaN,NaN,-74.68784327103457,-98.29727986154316,-0.0885154501214598,-0.08489723302493957,0.0036182170965202293,771637935,762218234,35.784922348404905,46.78230208047433,NaN,NaN,-4.206100677571436,2.2958331325426116
2015-06-18T09:30:00-04:00,42.69,43.16,42.68,43.09,8963184,7504824.2,52.19998512348741,48.39389092221834,NaN,NaN,-19.152309060823352,-94.30846267770163,-0.0498571726988562,-0.05870324877705002,-0.00884607607819382,780601119,764982728.6,41.62131231689176,44.80482424767521,NaN,NaN,-2.971582333896038,1.5433452087656616
2015-06-19T09:30:00-04:00,42.81,42.91,42.54,42.54,13434832,7990909.75,45.13713875106813,47.66761591645593,NaN,NaN,-68.20563389242399,-85.77625835117283,-0.05803238508039414,-0.0813865574286865,-0.02335417234829236,767166287,766292022.6,44.20766611982931,43.04494389238632,NaN,NaN,-4.1022705248789055,0.7368286753878664
2015-06-22T09:30:00-04:00,42.9,43.02,42.785,42.89,5437990,8064382.3,49.792643504413476,47.36573429597712,NaN,NaN,-20.485411153935377,-56.74988629554203,-0.03756519843350862,-0.07031067039017813,-0.03274547195666951,772604277,770524735.2,51.66318573180191,41.78866277149846,NaN,NaN,-3.5582125805549967,0.12325135311031465
2015-06-23T09:30:00-04:00,42.98,42.99,42.82,42.92,3993334,7867829.8,50.18285944849261,47.01148887768528,NaN,NaN,-16.43744905276811,-39.79372928619707,-0.020554468451305777,-0.05843855752080174,-0.03788408906949596,776597611,773721445.8,56.40169974639649,41.112946539482785,NaN,NaN,-3.008355734418772,-0.3241210879652691
2015-06-24T09:30:00-04:00,42.82,43.07,42.72,42.72,4846785,7480815.95,47.530667266808635,46.88013983648875,NaN,NaN,-25.953246849962778,-30.04681000198272,-0.02123312400512193,-0.06442549407589837,-0.04319237007077644,771750826,773744024,56.434184581795364,40.82140226756388,NaN,NaN,-3.33441382300944,-0.7541629072572935
2015-06-25T09:30:00-04:00,42.95,42.98,42.61,42.62,4913848,7493266.2,46.21546778995515,46.788715012147804,NaN,NaN,-42.15539235758796,-34.647426661335636,-0.02653340650061911,-0.07635912819655033,-0.04982572169593122,766836978,770991195.8,51.40506986226208,40.51772705634587,NaN,NaN,-3.9823806270833337,-1.215336867232442
2015-06-26T09:30:00-04:00,42.59,42.64,42.135,42.26,10174298,7615062.35,41.73796215325822,46.79452612987683,NaN,NaN,-125.32282775224832,-46.070865433300504,-0.05098470325266968,-0.11355660076176832,-0.06257189750909864,756662680,768890474.4,47.89727544472533,40.711374122619496,NaN,NaN,-5.890716797509265,-1.8832482858434167
2015-06-29T09:30:00-04:00,41.81,42.06,41.35,41.36,13107438,7923618.6,33.10330914314622,46.263441160444586,NaN,NaN,-257.76256084179613,-93.52629537087266,-0.12050304135401832,-0.21320069920162155,-0.09269765784760323,743555242,763080667.4,39.8069651819564,40.90861994386743,NaN,NaN,-10.708456161717827,-3.1439922681111896
2015-06-30T09:30:00-04:00,41.67,41.69,41.29,41.4,11382948,8210877.6,33.75921466463265,45.098742170959625,NaN,NaN,-233.94323519340978,-137.027452599001,-0.15436100692743798,-0.2856489165069007,-0.13128790957946274,754938190,758748783.2,35.05277463533264,41.15038054734974,NaN,NaN,-14.246667482992523,-4.730088727379951
2015-07-01T09:30:00-04:00,41.77,41.86,41.495,41.68,8149497,8335486.55,38.31828033670528,44.24113916270111,NaN,NaN,-160.55713436190052,-163.94823010138856,-0.14842479207852652,-0.3168188996776209,-0.16839410759909437,763087687,757016155.4,33.33776291579444,41.40175369694869,NaN,NaN,-15.770988765554538,-6.307360161404892
2015-07-02T09:30:00-04:00,41.8,41.88,41.575,41.74,5160664,8176157.15,39.28264463676177,43.79817825176433,NaN,NaN,-126.63285692331479,-180.8437230145339,-0.13155913798929422,-0.33284303008571214,-0.20128389209641792,768248351,757298430,33.9051293695362,41.799276152171885,NaN,NaN,-16.705428037959297,-7.792798429484093
2015-07-06T09:30:00-04:00,41.45,41.76,41.335,41.57,7509025,8165234.05,37.49398145990027,43.44247979724755,NaN,NaN,-131.61729359452227,-182.1026161829887,-0.12310546137008649,-0.35516571880902603,-0.23206025743893954,760739326,758113759.2,35.6098342030683,42.43133813945747,NaN,NaN,-18.011671622072587,-9.252637456996736
2015-07-07T09:30:00-04:00,41.65,41.69,40.851,41.63,19659913,8729254.8,38.55735238593565,42.86981930163017,NaN,NaN,-132.46838080436254,-157.04378017550198,-0.10540876003321287,-0.36382120748045566,-0.2584124474472428,780399239,765482558.6,48.53037901999536,43.68986867698499,NaN,NaN,-18.78656110805576,-10.614626550005168
2015-07-08T09:30:00-04:00,41.29,41.3801,40.93,40.95,16160046,9151924.45,31.92792540696867,41.80281657653817,NaN,NaN,-143.72577732407254,-139.00028860163454,-0.12983122353590976,-0.42070147686713,-0.29087025333122024,764239193,767342759.2,51.192894059290275,44.790438084905375,NaN,NaN,-21.60460438676833,-12.184623383828477
2015-07-09T09:30:00-04:00,41.42,41.53,40.79,40.79,8993801,9153372.7,30.594973084901127,40.25960143092487,NaN,NaN,-126.79154707498002,-132.24717114425044,-0.1458918008774281,-0.47323500442800537,-0.3273432035505773,755245392,765774300.2,48.896143754543886,45.31006890188053,NaN,NaN,-24.328279584382262,-13.919431412479017
2015-07-10T09:30:00-04:00,41.31,41.58,41.21,41.44,6748349,9208555.25,41.31402338745279,39.9865217620952,NaN,NaN,-77.02372270029615,-122.32534429964669,-0.10384456334930331,-0.4571489077372064,-0.3533043443879031,761993741,764523378.2,47.08188315442014,45.51537011863702,NaN,NaN,-23.279691867401965,-15.25661147746801
2015-07-13T09:30:00-04:00,41.7,42.1,41.69,42.07,7071532,9254190.4,49.46112008061006,39.96284151753781,NaN,NaN,-15.371523144042989,-99.07619020955084,-0.028620329378200582,-0.3890797561106538,-0.36045942673245324,769065273,766188567.6,49.754521159004554,45.37903693486579,NaN,NaN,-19.50063804649773,-15.862900987329398
2015-07-14T09:30:00-04:00,42.08,42.34,42.06,42.23,6126352,9101552.85,51.30985120481934,40.043340928704005,NaN,NaN,13.748202194646808,-69.83287360974899,0.03352615409685794,-0.3185517341113808,-0.35207788820823877,775191625,765147044.8,48.11759350739211,44.78731506065118,NaN,NaN,-15.89939796796806,-15.86811484170635
2015-07-15T09:30:00-04:00,42.21,42.37,42.12,42.24,6538481,8969809.7,51.42943875326546,40.321824606308056,NaN,NaN,19.930584861298474,-37.101601172674776,0.07456887310368343,-0.25886679682863445,-0.3334356699323179,781730106,768645227.4,53.63512027468524,44.587381895857604,NaN,NaN,-13.047003968508285,-15.465099002678054
2015-07-16T09:30:00-04:00,42.57,42.8,42.49,42.78,5206622,8678946.95,57.49979683809024,41.127848109746274,NaN,NaN,71.14249290132022,2.485206822585269,0.13388603851729258,-0.16607812178570214,-0.2999641603029947,786936728,774983494.6,61.602872561646166,45.315796374385044,NaN,NaN,-8.526165167921398,-14.47382274056996
2015-07-17T09:30:00-04:00,43.15,43.44,43.09,43.44,7775002,8619537.85,63.503595610665336,42.68253621384679,NaN,NaN,137.72795191754932,45.43554174615438,0.20890073536984607,-0.03883824109068712,-0.2477389764605332,794711730,781527092.4,67.76231345220714,46.73472766063374,NaN,NaN,-2.4309966188139036,-12.753419008890523
2015-07-20T09:30:00-04:00,43.59,43.81,43.435,43.67,9309458,8413269.15,65.34106020338962,44.98523271814987,NaN,NaN,154.785254948836,79.46689736473017,0.26190422397791147,0.07964130351185617,-0.1822629204660553,804021188,788518275.4,72.78532781496338,49.09032499156281,NaN,NaN,3.0775097883913216,-10.491857752135974
2015-07-21T09:30:00-04:00,43.45,43.605,43.34,43.38,5975225,8440130.9,61.15995674551778,46.94242858107024,NaN,NaN,126.41283199295877,101.99982332439257,0.2645508653399391,0.14842566120886858,-0.11612520413107053,798045963,793089143,75.47579748321694,51.977683766411694,NaN,NaN,6.261330688563622,-8.098545117750318
2015-07-22T09:30:00-04:00,42.53,42.89,42.5,42.68,8591254,8670026.9,52.437627147090545,47.95095335324061,NaN,NaN,54.05008264448994,108.82372288103086,0.20872786200834312,0.14478462337935838,-0.06394323862898474,789454709,794634063.6,76.32763894521405,55.048389197084525,NaN,NaN,6.0955401968627365,-6.070818644234167
2015-07-23T09:30:00-04:00,42.8,42.97,42.49,42.59,6322622,8743818.75,51.42220834553337,48.81806504672429,NaN,NaN,54.783971413727926,105.5520185835124,0.15763659411577294,0.13310250401573143,-0.024534090100041504,783132087,793873135.4,74.94681202961962,57.97993795851905,NaN,NaN,5.637154059021962,-4.398251115197578
2015-07-24T09:30:00-04:00,42.8,42.86,42.325,42.36,9746087,8985430.7,48.820410179369,49.627095669543486,NaN,NaN,39.45782327528641,85.89799285505981,0.10289561639561474,0.10408543039447693,0.0011898139988621853,773386000,789607989.4,67.56820006895472,60.262678377510944,NaN,NaN,4.440147056197857,-3.1356228049982304
2015-07-27T09:30:00-04:00,42.02,42.286,41.92,41.98,8653585,8909395.05,44.78833823314145,50.07216608720104,NaN,NaN,-6.022248829760917,53.73649209934043,0.038929514273360874,0.04985170684056328,0.010922192567202406,764732415,781750234.8,56.52677863432286,60.833849778534336,NaN,NaN,2.139060642964188,-2.3820965981464566
2015-07-28T09:30:00-04:00,42.16,42.44,41.865,42.36,7887533,8648399.8,49.29792994137482,51.31288069680148,NaN,NaN,7.661137609969973,29.986153222742683,0.02094718793222058,0.03710617748247813,0.01615898955025755,772619948,776665031.8,50.74728290380651,60.802020410285486,NaN,NaN,1.6092997065011678,-1.811897126053939
2015-07-29T09:30:00-04:00,42.36,42.73,42.21,42.64,8376345,8498069.65,52.384084427351574,52.8692457926908,NaN,NaN,36.201408395202314,26.416418372885154,0.026299755397853692,0.04903368379757467,0.022733928399720976,780996293,774973348.6,48.95411745760114,60.80616138907529,NaN,NaN,2.1312369670039635,-1.2485922556170959
2015-07-30T09:30:00-04:00,42.46,42.79,42.26,42.72,6808201,8431004.85,53.25947565492365,53.72249238322443,NaN,NaN,38.76010742242723,23.211645574625017,0.03317411657232247,0.06420157411512406,0.03102745754280159,787804494,775907830,50.00503856188987,61.01495820389456,NaN,NaN,2.81266062360676,-0.6684132728708307
2015-07-31T09:30:00-04:00,42.77,42.84,42.5,42.58,10911997,8718571.5,51.47595876267703,53.8664094319435,NaN,NaN,39.71795086037146,23.263671091642028,0.026526446627352283,0.06418551582699195,0.03765906919963966,776892497,776609129.4,50.82328921965782,61.0912987796555,NaN,NaN,2.8631027978293444,-0.16391097705652002
2015-08-03T09:30:00-04:00,42.56,42.625,42.085,42.35,9198287,8803034.6,48.59675691681427,53.67261698280028,NaN,NaN,2.2267329895457593,24.913467455503362,0.005947862504059584,0.04509389732971414,0.039146034825654555,767694210,777201488.4,51.54467543547461,61.33609034594711,NaN,NaN,2.076891865315879,0.15620371471096556
2015-08-04T09:30:00-04:00,42.31,42.35,41.945,42.1,7382741,8189176,45.610485877627,53.256977491683244,NaN,NaN,-31.996516987991182,16.981936535911114,-0.023573495013436183,0.009679166058859323,0.033252661072295506,760311469,774739792.6,48.369182256281185,60.95995191606111,NaN,NaN,0.5380251500055758,0.210749634038767
2015-08-05T09:30:00-04:00,42.37,42.81,42.28,42.51,10392779,7900812.65,50.93546769909893,52.78809683889815,NaN,NaN,13.492688606554747,12.4401925781816,-0.014979064418093102,0.014528830549679128,0.02950789496777223,770704248,772681383.6,45.82686639374552,59.833094332639625,NaN,NaN,0.7495419830665916,0.2877199696141705
2015-08-06T09:30:00-04:00,42.51,42.68,41.94,42.09,6509876,7776616.4,45.97033627963187,51.53572117239576,NaN,NaN,-48.02972401052887,-4.917773708409615,-0.035879451163470355,-0.015341418986565714,0.02053803217690464,764194372,767959359.2,40.56013261289621,57.890081415545986,NaN,NaN,-0.5875546206467592,0.16268074243403768
2015-08-07T09:30:00-04:00,41.99,42.18,41.83,42.12,7912517,7834824.8,46.37245566318135,50.180820848095166,NaN,NaN,-96.50341893725819,-32.16204766793554,-0.045371259954182896,-0.03617604276582398,0.009195217188358917,772106889,767002237.6,39.56751148273358,55.51738024895815,NaN,NaN,-1.5486094038011613,-0.08178927845670503
2015-08-10T09:30:00-04:00,42.31,42.825,42.31,42.78,5572027,7759849.55,54.41120081667833,49.69876685317807,NaN,NaN,14.112875220514356,-29.78481922174182,-0.006906278318293602,0.0005623692904919153,0.007468647608785517,777678916,768999178.8,42.7173624055843,53.177492029127244,NaN,NaN,0.08518204921299642,-0.057936231646747674
2015-08-11T09:30:00-04:00,42.66,42.72,42.015,42.14,27344543,8820759.1,47.04659848722269,49.31369337747322,NaN,NaN,-59.65435533704563,-35.31638689155272,-0.023346529575835006,-0.02171451436100824,0.0016320152148267646,750334373,767003759.6,40.4486615747826,50.61470793123929,NaN,NaN,-0.9051143680188098,-0.1789616796998994
2015-08-12T09:30:00-04:00,41.83,42.41,41.44,42.33,10035699,8995620,49.24301702353413,49.15803685447327,NaN,NaN,-103.8443037302943,-58.78378535892252,-0.020316619550620772,-0.0237637592234492,-0.0034471396728284285,760370072,764936924.4,38.18642416852302,47.98896594116095,NaN,NaN,-1.0002671934352165,-0.2962910388049447
2015-08-13T09:30:00-04:00,42.36,42.49,42.125,42.21,6643870,9067482.4,47.8918919302242,49.0917141223915,NaN,NaN,-54.71607542475224,-60.1210556417672,-0.024979192621191942,-0.034671130449318355,-0.009691937828126414,753726202,762843290.4,35.99057547701369,45.73342132745088,NaN,NaN,-1.4908290139505587,-0.4669393209686038
2015-08-14T09:30:00-04:00,42.1,42.46,42.07,42.42,5953004,8976382.5,50.45391469594932,49.4963981554492,NaN,NaN,-40.14150765872499,-48.84867338606057,-0.013102083590550227,-0.026069542316314198,-0.012967458725763971,759679206,760357753.8,33.525803765728384,44.09049455112271,NaN,NaN,-1.1317733433048138,-0.5619156098737766
2015-08-17T09:30:00-04:00,42.26,42.665,42.115,42.66,5591698,8790494.5,53.28105484478782,49.78090707712156,NaN,NaN,12.215277290072233,-49.22819297214899,0.0104635522861736,0.00011198163195302868,-0.010351570654220571,765270904,757876151.4,31.226442846472636,42.69614883274171,NaN,NaN,0.013365333563580365,-0.47973261795415423
2015-08-18T09:30:00-04:00,42.56,42.62,42.39,42.44,4691890,8726327.75,50.439816838537276,49.642030820777684,NaN,NaN,33.34506629121122,-30.62830864649762,0.010740006864254626,0.0030734379260977107,-0.0076665689381569145,760579014,759925079.6,35.179383780667905,41.71223928438934,NaN,NaN,0.14790008432598792,-0.3900708033427054
2015-08-19T09:30:00-04:00,42.31,42.52,41.92,42.16,9227613,8758145.7,47.00429747158737,49.195232379110806,NaN,NaN,-60.33864651701711,-21.927177203842177,-0.007448776892220064,-0.016977540053431994,-0.00952876316121193,751351401,758121345.4,33.361465167067024,40.523412613330564,NaN,NaN,-0.7507214544669985,-0.4415923249318901
2015-08-20T09:30:00-04:00,41.71,41.89,41.13,41.13,13726872,9128358.2,37.016347822437545,48.16240302623656,NaN,NaN,-292.7174897448192,-69.52746006785557,-0.08410399879960129,-0.11465876166071354,-0.03055476286111225,737624529,754901010.8,30.346337954949092,39.06077323727994,NaN,NaN,-5.0502857534158165,-1.0999771004295937
2015-08-21T09:30:00-04:00,40.69,41,39.56,39.56,23666433,9824375.5,27.443757669477904,46.65147450856967,NaN,NaN,-427.2708172841199,-146.95332199293455,-0.22765630649349422,-0.31512514597798,-0.0874688394844858,713958096,745756788.8,23.77550150808996,37.077260813895315,NaN,NaN,-13.145998186736986,-2.8208372556163637
2015-08-24T09:30:00-04:00,37.01,39.61,31.32,38.14,36103937,11196893.1,21.921877073839156,44.95943102258484,NaN,NaN,-467.532010322161,-242.90277951538118,-0.39552163802291107,-0.5818708870131246,-0.18634924899021357,677854159,728273439.8,16.444099753076813,34.796897777952154,NaN,NaN,-22.52581339059356,-5.635833846327391
2015-08-25T09:30:00-04:00,39.47,39.54,37.66,37.7,18605422,11732787.55,20.542610882823467,42.78851267856516,NaN,NaN,-211.5432560458734,-291.8804439827981,-0.5063833394476472,-0.8193284232997726,-0.3129450838521254,659248737,708007384.4,11.873559429221373,32.37166156620043,NaN,NaN,-29.97902579958465,-9.113432696792714
2015-08-26T09:30:00-04:00,38.45,39.66,38.12,39.6,34388362,13033388.4,38.52843142048823,42.25694804576919,NaN,NaN,-128.75044754743953,-305.5628041888826,-0.42521723289288704,-0.8444666249682342,-0.41924939207534717,693637099,696464524,10.144135767892521,30.199090362985885,NaN,NaN,-28.51942241331278,-11.885716942009866
2015-08-27T09:30:00-04:00,40.14,40.53,39.625,40.52,20105542,13698255.45,45.01826172591859,42.160219907393284,NaN,NaN,-60.53808785264728,-259.1269238104482,-0.28951883237459974,-0.7811479325435968,-0.4916291001689971,713742641,691688146.4,9.525843518684098,28.053256936982343,NaN,NaN,-24.62785996890482,-13.706023088709145
2015-08-28T09:30:00-04:00,40.34,40.67,40.25,40.6,13836134,13844462.3,45.55652129072354,41.5277427983965,NaN,NaN,-39.90164113280512,-181.65308858018528,-0.17970114647643176,-0.7162555332645368,-0.5365543867881051,727578775,694412282.2,12.790643760221514,25.91563417659929,NaN,NaN,-21.67230514727238,-14.844063382789606
2015-08-31T09:30:00-04:00,40.27,40.67,40.13,40.23,11050274,13937061.65,43.43843392554286,41.27001675827652,NaN,NaN,-42.260393697382874,-96.59876525522964,-0.12017018912462674,-0.6867671231938886,-0.5665969340692618,716528501,702147150.6,21.457213476624958,24.559102169588034,NaN,NaN,-20.17412712493633,-15.605501060239138
2015-09-01T09:30:00-04:00,39.38,39.72,38.75,38.94,21289046,14632376.9,36.98245982450605,40.39426267263166,NaN,NaN,-88.79962229394494,-72.05003850484395,-0.1537170487077828,-0.7587432449539904,-0.6050261962462076,695239455,709345294.2,28.57115130152488,23.872296964802448,NaN,NaN,-21.313015689989328,-16.420860293060596
2015-09-02T09:30:00-04:00,39.52,39.92,39.14,39.88,12685139,14746994.9,43.56453115072873,40.08516547409628,NaN,NaN,-57.99607314252329,-57.89916362386068,-0.10118095635473856,-0.7315023916896308,-0.6303214353348923,707924594,712202793.2,31.233889597259846,23.53253368767717,NaN,NaN,-19.766530388070127,-16.898813163776243
2015-09-03T09:30:00-04:00,40.1,40.425,39.79,39.91,11031133,14973057.75,43.766402687125506,39.60748604489457,NaN,NaN,-35.29595563106588,-52.850737179544375,-0.055287228412663425,-0.6994304708507215,-0.6441432424380581,718955727,713245410.4,32.22663382929426,23.439735835074732,NaN,NaN,-18.546207278738656,-17.134155180199446
2015-09-04T09:30:00-04:00,39.38,39.58,39.11,39.3,13780461,15266454.95,40.58728764454592,38.70078838773444,NaN,NaN,-62.41329584387466,-57.35306812175829,-0.05667992492020957,-0.7149931485883201,-0.6583132236681105,705175266,708764708.6,30.208291120498657,23.367010711790872,NaN,NaN,-18.61204918600231,-17.345282895314142
2015-09-08T09:30:00-04:00,40.05,40.43,39.95,40.4,9454634,15460585.3,47.93213383343091,38.52166817308398,NaN,NaN,-14.18349955281053,-51.737689292843825,0.021619561412007604,-0.6312887719031011,-0.6529083333151087,714629900,708384988.4,30.036605800143207,22.999669427467683,NaN,NaN,-16.11990584469525,-17.170229030940014
2015-09-09T09:30:00-04:00,40.66,40.86,39.785,39.87,9652295,14575972.9,45.04280718710389,38.3815617241923,NaN,NaN,-14.307126311486739,-36.839190096352176,0.041691908220313545,-0.6007934480397168,-0.6424853562600303,704977605,710332618.4,32.166122669832006,22.914287820522322,NaN,NaN,-15.083172746617507,-16.872078133179656
2015-09-10T09:30:00-04:00,39.81,40.5,39.79,40.27,14024421,14775409,47.60959765817117,39.1382224267447,NaN,NaN,-9.10444963947156,-27.060865395741835,0.08347178949269263,-0.5381456193941645,-0.6216174088868571,719002026,712548104.8,34.604524266025436,23.2184439855992,NaN,NaN,-13.417253690778724,-16.37853178426524
2015-09-11T09:30:00-04:00,39.99,40.46,39.98,40.46,6859731,14786202.05,48.832078181892,40.665959606202854,NaN,NaN,3.8458046892408904,-19.232513331680483,0.12307540391348204,-0.4677731539950045,-0.5908485579084866,725861757,713929310.8,36.14559823262338,24.10202232306587,NaN,NaN,-11.709454483388546,-15.711520741282854
2015-09-14T09:30:00-04:00,40.63,40.67,40.26,40.36,7445376,14860820.65,48.19466612585924,42.54258739563286,NaN,NaN,20.474827615355455,-2.654888639834497,0.1404512532749378,-0.4152844913148144,-0.5557357445897522,718416381,716577533.8,39.108473848455915,25.72090618702152,NaN,NaN,-10.51759479601025,-14.969531320529624
2015-09-15T09:30:00-04:00,40.49,40.99,40.38,40.88,8805981,15021534.8,51.72355797260093,44.76979790204553,NaN,NaN,53.98858724748978,10.979528720225563,0.18223113413519498,-0.3279468269207584,-0.5101779610559534,727222362,719096026.2,41.87087738949266,27.863571755612327,NaN,NaN,-8.458770998609037,-14.039422703112397
2015-09-16T09:30:00-04:00,40.83,41.09,40.78,41.05,7718131,15172846.85,52.854230553483305,45.79306926868804,NaN,NaN,82.16377308798587,30.273708600120084,0.21436529480911998,-0.2422213425445534,-0.4565866373536734,734940493,725088603.8,47.92457584464652,30.562174618237613,NaN,NaN,-6.436883461328133,-12.953345668571789
2015-09-17T09:30:00-04:00,40.88,41.4,40.63,40.77,16782643,15550598.35,50.746097356980854,46.20220038519249,NaN,NaN,88.2898613991054,49.752570807835475,0.20956264855073514,-0.19463332666525446,-0.4041959752159896,718157850,724919768.6,47.773620260544845,33.29415867122767,NaN,NaN,-5.305408774597684,-11.860783255146917
2015-09-18T09:30:00-04:00,40.11,40.48,39.97,40.06,18115054,15770007.45,45.76177466574476,46.21686134055115,NaN,NaN,28.290282902828782,54.64146645055305,0.1539412588371009,-0.21176940166961344,-0.36571066050671436,700042796,719755976.4,43.283071457398336,35.472189221026014,NaN,NaN,-5.727524791441139,-10.98460347461752
2015-09-21T09:30:00-04:00,40.13,40.58,40.09,40.46,6960565,14934714.05,48.812172783618955,46.60069983041374,NaN,NaN,45.06785420952319,59.5600717693866,0.13987017397675472,-0.19087294303577096,-0.3307431170125257,707003361,717473372.4,41.42926252576138,36.89876415310719,NaN,NaN,-5.215262232109227,-10.160411868544907
2015-09-22T09:30:00-04:00,39.81,39.97,39.53,39.78,12288203,13743927.35,44.255461312420174,47.12019993669331,NaN,NaN,-38.47671775031757,41.06701076982513,0.08333777541262871,-0.22657089774673977,-0.3099086731593685,694715158,710971931.6,36.61852691091798,37.473576696635256,NaN,NaN,-6.111712346741276,-9.58202622257296
2015-09-23T09:30:00-04:00,39.92,40.025,39.66,39.88,5678204,13097566.45,45.06759545823802,47.22756167294398,NaN,NaN,-45.34749223072281,15.564757706083393,0.05274280390952285,-0.24398016827246494,-0.2967229721819878,700393362,704062505.4,32.32285542967273,37.551359970379046,NaN,NaN,-6.6169504474357765,-9.158443968981933
2015-09-24T09:30:00-04:00,39.43,39.99,39.22,39.88,11028166,11929556.65,45.06759545823802,47.320504013737725,NaN,NaN,-84.43952802360002,-18.981120178457694,0.03350677025813875,-0.2548395093593143,-0.28834627961745307,700393362,700509607.8,30.351198166965716,37.41740028021271,NaN,NaN,-7.031509048620685,-8.85459612321604
2015-09-25T09:30:00-04:00,40.25,40.3,39.63,39.81,10828935,11465726.3,44.540789399216074,47.60289699621416,NaN,NaN,-40.319699946418545,-32.70311674830716,0.017855078288684212,-0.2660274317565978,-0.28388251004528203,689564427,698413934,29.219024392511386,37.34673837107077,NaN,NaN,-7.517313936441685,-8.663555810819703
2015-09-28T09:30:00-04:00,39.64,39.7,38.88,38.9,12583343,11403086.75,38.27681216483461,46.913231162742996,NaN,NaN,-148.0444092634296,-71.32556944289772,-0.04837706314050838,-0.34435383897091754,-0.29597677583040916,676981084,692409478.6,26.203074481190612,37.072914705431295,NaN,NaN,-9.76545291900684,-8.820969683417866
2015-09-29T09:30:00-04:00,39,39.26,38.45,38.73,13103413,11505743.7,37.22363070731207,46.35471855704359,NaN,NaN,-169.61151870653714,-97.55252963414162,-0.0955047197501373,-0.4153576755180808,-0.3198529557679435,663877671,686241981.2,23.517875156515956,36.45518274019444,NaN,NaN,-11.945049290413627,-9.267266770131545
2015-09-30T09:30:00-04:00,39.2,39.56,39.09,39.5,12466813,11064632.05,44.65203584150589,46.1434641415675,NaN,NaN,-92.27812782941238,-106.93865675387954,-0.06798126719246972,-0.40482953975853064,-0.3368482725660609,676344484,681432205.6,21.65421292511722,35.530160501558136,NaN,NaN,-11.772786588233682,-9.625198172717566
2015-10-01T09:30:00-04:00,39.5,39.64,38.99,39.52,13518040,11106277.1,44.834631255790796,45.85793221827455,NaN,NaN,-87.52111045467294,-107.55497324009411,-0.042819075308595134,-0.3903721167018048,-0.3475530413932097,689862524,679326038,20.874148126227723,34.43934263681559,NaN,NaN,-11.581633032199832,-9.904688866929318
2015-10-02T09:30:00-04:00,39.06,40.08,38.92,40.08,14917041,11300572.5,49.825895473981554,45.97444860028329,NaN,NaN,-39.54920413616853,-107.40087407804413,0.014103212248640362,-0.3299240260824092,-0.3440272383310496,704779565,682369065.6,25.07385805943693,33.43687008045709,NaN,NaN,-9.974761208055403,-9.914699201375901
2015-10-05T09:30:00-04:00,40.33,40.97,40.25,40.87,8568850,11039991.95,55.88924094416958,46.27199738396677,NaN,NaN,91.42162023065865,-59.50766817922647,0.10259407070982285,-0.215784649943771,-0.31837872065359385,713348415,689642531.8,34.07999133535694,32.880378219447394,NaN,NaN,-6.662769670484724,-9.45013783982002
2015-10-06T09:30:00-04:00,40.73,41.01,40.72,40.92,9857852,11060152.85,56.24960565186644,46.51452417670841,NaN,NaN,106.93261765128136,-4.19884090766277,0.1587737569391458,-0.11991152447966158,-0.2786852814188074,723206267,701508251,45.57350225786793,32.712444391820355,NaN,NaN,-3.879822112136,-8.654378450150874
2015-10-07T09:30:00-04:00,41.14,41.275,40.617,41.11,15218922,11338484.2,57.66496249636769,47.008728829521765,NaN,NaN,108.91248937104265,36.03928253242824,0.2003289898260659,-0.02827404413622503,-0.22860303396229092,738425189,713924392,54.5110542543621,33.19368967709302,NaN,NaN,-1.1439249315864286,-7.581456518927382
2015-10-08T09:30:00-04:00,40.95,41.3837,40.75,41.3,15374751,11406000.7,59.09022782916129,47.96076119833723,NaN,NaN,111.83591515612378,75.91068765458758,0.23008291441581474,0.059000609057477504,-0.17108230535833724,753799940,726711875.2,61.51964070152741,34.49630176595938,NaN,NaN,1.567343230060163,-6.274485126214875
2015-10-09T09:30:00-04:00,41.42,41.51,41.25,41.48,11376513,11631839.8,60.44872835806735,48.791943739369266,NaN,NaN,124.40499956072354,108.70152839396602,0.24971767556009272,0.14106478909177866,-0.10865288646831406,765176453,738791252.8,66.73367157401955,36.30375955512068,NaN,NaN,4.245755804285496,-4.771593564714823
2015-10-12T09:30:00-04:00,41.57,41.595,41.35,41.53,6343682,11576755.1,60.83775781096627,49.97639348926541,NaN,NaN,117.29200246391811,113.8756048406179,0.253115201081841,0.20774111488398717,-0.04537408619785381,771520135,750425596.8,70.8329632054533,38.7476478618732,NaN,NaN,6.597034489032684,-3.1475038427508935
2015-10-13T09:30:00-04:00,41.31,41.69,41.3,41.44,8951820,11584047.05,59.69947614767001,51.02152782422484,NaN,NaN,106.73866581818118,113.83681447399786,0.23664606430323887,0.25043349418119476,0.013787429877955906,762568315,758298006.4,73.23622854339092,41.67003165571021,NaN,NaN,8.317602566976793,-1.509631498504081
2015-10-14T09:30:00-04:00,41.32,41.61,41.25,41.36,12756050,11835943,58.649040117601295,51.991631014179355,NaN,NaN,95.50338589077518,111.15499377794438,0.2086870402289337,0.27464623016412304,0.06595918993518934,749812265,760575421.6,73.90606413476782,44.78109351055322,NaN,NaN,9.5349653855336,0.06816805635844458
2015-10-15T09:30:00-04:00,41.53,41.91,41.51,41.89,8421884,11417905.05,63.26110817880132,53.32879664129259,NaN,NaN,117.5324643423857,112.29430361519675,0.213445170586905,0.33276565316882056,0.11932048258191559,758234149,761462263.4,74.17709245331615,47.99238408632499,NaN,NaN,11.905145561744112,1.7591648428421112
2015-10-16T09:30:00-04:00,42,42,41.72,41.97,7486266,10886465.65,63.915339802820405,55.16012004400586,NaN,NaN,111.6660218486381,109.74650807277968,0.20925591701337987,0.3808903788486404,0.17163446183526054,765720415,761571055.8,74.21247766381259,51.42162717079799,NaN,NaN,14.088303013964149,3.5204702958595453
2015-10-19T09:30:00-04:00,41.88,42.13,41.76,42.13,7092059,10893040.35,65.24823802534448,57.1618777095796,NaN,NaN,105.86290460895006,107.46068850178605,0.2043067006683829,0.4270178376707392,0.22271113700235629,772812474,761829523.6,74.30257228596722,55.049105537187366,NaN,NaN,16.330965958301643,5.350541104779845
2015-10-20T09:30:00-04:00,41.96,42.135,41.85,42.02,5928927,10575076.55,63.5113060960001,58.508968442043475,NaN,NaN,96.20537669420072,105.35403067698996,0.18144417495155962,0.4495163556918058,0.2680721807402462,766883547,762692570,74.62140959140244,58.83247672763631,NaN,NaN,17.825787058219422,7.132719098128356
2015-10-21T09:30:00-04:00,42.11,42.22,41.65,41.7,9417169,10762024.8,58.62231806228719,59.493803213936076,NaN,NaN,79.05237509867497,102.06382851856992,0.13473716795674717,0.43649364068618013,0.30175647272943296,757466378,764223392.6,75.20896593886168,62.713535142824455,NaN,NaN,17.88765040682796,8.669137856514013
2015-10-22T09:30:00-04:00,42,42.73,42,42.64,14236003,10922416.65,66.72529650010321,60.700903287230474,NaN,NaN,113.19360925016568,101.19605750012593,0.15563652367755243,0.49630212732637347,0.34066560364882104,771702381,766917039,76.25087552119524,66.3690363900929,NaN,NaN,20.39075903052946,10.343655167087647
2015-10-23T09:30:00-04:00,43.7,44,43.56,43.83,16691718,11215555.8,73.7370396063749,61.97574604881657,NaN,NaN,186.66796619034284,116.19644636846688,0.23341434786910475,0.632433538485202,0.39901919061609725,788394099,771451775.8,77.9323405800931,69.50134705043119,NaN,NaN,25.270326758783924,12.476036823044257
2015-10-26T09:30:00-04:00,43.79,43.79,43.5,43.66,8288147,11000796,71.42162807912112,63.059461936477625,NaN,NaN,164.3032913273986,127.88452371215658,0.25544123080750075,0.7183207291254732,0.4628794983179724,780105952,772910471.4,78.46062833502731,71.85042748451401,NaN,NaN,28.339562931386375,14.742254838521703
2015-10-27T09:30:00-04:00,43.56,43.68,43.36,43.41,7678977,10729574.2,68.03809512799384,63.80039998159378,NaN,NaN,143.33983896182045,137.31141616568053,0.23568220290143982,0.7574822519447721,0.5218000490433323,772426975,774019157,78.87457851101371,73.59067921713199,NaN,NaN,29.744656235209423,16.88545503804852
2015-10-28T09:30:00-04:00,43.61,44.06,43.4777,44.06,14779552,10845211.15,71.78123989054,64.70690084312083,NaN,NaN,153.68998326676817,152.23893779929915,0.24766710652064283,0.8313839321941359,0.583716825673493,787206527,779967186.8,80.98583812669708,74.9811218903584,NaN,NaN,32.203500857955866,19.073747298035283
2015-10-29T09:30:00-04:00,43.8,44,43.67,43.94,7609015,10549759.9,70.14791967420288,65.3997002228448,NaN,NaN,136.21105101452773,156.84242615217158,0.22921613841263455,0.8702369986892862,0.6410208602766516,779597512,781546213,81.5140154217479,76.0368607366247,NaN,NaN,33.640743135054755,21.154746703323777
2015-10-30T09:30:00-04:00,44.01,44.02,43.64,43.65,9339523,10270884,66.22607121151339,65.78457975145531,NaN,NaN,110.22733762136647,141.5543004383763,0.18128435298973167,0.8676263015138161,0.6863419485240845,770257989,777918991,76.27269040704178,76.42541267959531,NaN,NaN,33.61533373166114,22.93483056451483
2015-11-02T09:30:00-05:00,43.73,44.06,43.62,44.04,13743283,10529605.65,68.75592260135639,66.43146878386146,NaN,NaN,103.90737776072794,129.47511772504217,0.16037005349307676,0.8868045153904305,0.7264344618973537,784001272,778698055,76.62041016963059,76.66713993861242,NaN,NaN,34.36790445453953,24.568126834518356
2015-11-03T09:30:00-05:00,43.9,44.43,43.82,44.27,6879046,10380665.35,70.17479947944317,67.25473730970732,NaN,NaN,106.46800552977946,122.10075103863399,0.1469098108958986,0.910071725517227,0.7631619146213284,790880318,782388723.6,78.24678598277984,76.97719149918473,NaN,NaN,35.416619732286854,26.11791153419957
2015-11-04T09:30:00-05:00,44.37,44.44,44.21,44.32,7298611,9984649.8,70.4885571138687,67.77098366221213,NaN,NaN,102.39544260727675,111.8418429067357,0.12700521825017275,0.9219184374340443,0.7949132191838716,798178929,784583204,79.17445230619379,77.33414577439025,NaN,NaN,36.35714257401259,27.580658825601432
2015-11-05T09:30:00-05:00,44.36,44.575,44.1,44.19,6728787,9552351.6,68.47167771327447,68.09643637010171,NaN,NaN,90.12089524199146,102.62381175222845,0.09232821340899922,0.9103234859451206,0.8179952725361214,791450142,786953730,80.15876861359664,77.75888084223197,NaN,NaN,36.57682998107205,28.865826133525808
2015-11-06T09:30:00-05:00,44.14,44.36,43.98,44.34,6868946,9326973.25,69.55416255607346,68.40400240801092,NaN,NaN,78.7084620057202,96.32003662909919,0.06786848388222366,0.9028308773889009,0.8349623935066772,798319088,792565949.8,82.29263323533938,78.32959948147285,NaN,NaN,37.056345414699585,30.035900316550634
2015-11-09T09:30:00-05:00,44.21,44.21,43.7,43.91,10146232,9517100.75,62.88835075176989,68.35950559770876,NaN,NaN,55.47643949722686,86.63384897639898,0.01392603300317441,0.8523699347606453,0.8384439017574709,788172856,793400266.6,82.59235566640075,78.89895277254415,NaN,NaN,35.570128942014264,30.826504405902583
2015-11-10T09:30:00-05:00,43.66,43.67,43.44,43.62,17273264,9933172.95,58.79583191144888,68.37189944407746,NaN,NaN,26.626296666134703,70.66550720367003,-0.046765131345181454,0.779987487575994,0.8267526189211755,770899592,789404121.4,75.96031788109372,78.95262076841787,NaN,NaN,33.093885201581976,31.150415948142495
2015-11-11T09:30:00-05:00,43.72,43.94,43.53,43.6,8201149,9705427.9,58.51302519767256,67.78530863676097,NaN,NaN,30.30077618897867,56.24657392001042,-0.0911673710045412,0.7127934051654989,0.8039607761700401,762698443,782308024.2,65.84876712674567,78.2096130259572,NaN,NaN,30.980728789548053,31.126174925486147
2015-11-12T09:30:00-05:00,43.39,43.6,43.21,43.22,8033958,9686031.6,53.270195501883016,66.32339120072584,NaN,NaN,-6.089120599883023,37.00457075163553,-0.1457989595581608,0.6217120767223392,0.7675110362805,754664485,774950892.8,57.32812421835447,76.73788328583301,NaN,NaN,27.58303703601222,30.620012369847014
2015-11-13T09:30:00-05:00,43.07,43.125,42.36,42.37,15044928,10063964.7,43.81346859978034,64.35137980934435,NaN,NaN,-86.22569594708919,4.017739161073607,-0.23364022435024823,0.47546075584268976,0.709100980192938,739619557,763210986.6,46.89936821372174,74.4835075628826,NaN,NaN,21.260579340559886,29.282950508520283
2015-11-16T09:30:00-05:00,42.3,43.03,42.28,43.02,9079200,10163321.75,50.97999956594241,63.13294441205496,NaN,NaN,-80.49535780700438,-23.176620299772644,-0.24143287752070974,0.40730988329205076,0.6487427608127605,748698757,755316166.8,41.43995098571944,71.80960559679016,NaN,NaN,18.03626259984707,27.676280807281252
2015-11-17T09:30:00-05:00,43.11,43.36,42.94,43.03,9394585,10336604.65,51.08337196569399,61.65452527456597,NaN,NaN,-55.616916590067774,-39.62526295101314,-0.23893713844868913,0.35007133775189914,0.5890084762005883,758093342,752754916.8,39.82045475294778,68.86922107009379,NaN,NaN,15.551945557546304,25.944232914461974
2015-11-18T09:30:00-05:00,43.23,43.7182,43.18,43.68,10166809,10374086.65,57.37538731441552,60.74220153458115,NaN,NaN,-15.336630275677509,-48.75274424394438,-0.188735774290693,0.353088758337222,0.541824532627915,768260151,753867258.4,40.90067941623848,65.96826849827168,NaN,NaN,15.387785476341891,24.436168994730533
2015-11-19T09:30:00-05:00,43.72,44.0899,43.71,43.88,9367494,10130661.2,59.11786856492567,60.2344727741106,NaN,NaN,39.02600283604404,-39.72971955675896,-0.13955286871433947,0.36738344673499057,0.50693631544933,777627645,758459890.4,45.268927518227585,63.75371400621352,NaN,NaN,15.805744080233358,23.203251149802366
2015-11-20T09:30:00-05:00,44.06,44.215,44.013,44.2,7288219,9660486.25,61.80806502112837,59.73819723266575,NaN,NaN,80.26566757703289,-6.431446851934544,-0.08561037355279366,0.399923348508338,0.48553372206113166,784915864,767519151.8,52.69630802849986,62.044849567561336,NaN,NaN,17.001068985644636,22.31722512635126
2015-11-23T09:30:00-05:00,44.23,44.25,43.78,43.94,7227077,9607432.75,58.443017876925765,58.90021283248593,NaN,NaN,47.85627363205962,19.238879435878253,-0.0683315362356528,0.4001193017665656,0.46845083800221843,777688787,773317157.8,56.742390951229304,60.50882135102201,NaN,NaN,16.965583223418758,21.55270485450376
2015-11-24T09:30:00-05:00,43.61,44.085,43.51,43.95,11303412,9788654.5,58.53652034755576,58.04649592060644,NaN,NaN,19.504603263313715,34.26318340655455,-0.057552043942489806,0.39651078307410614,0.45406282701659595,788992199,779496929.2,60.609688513266946,59.18276679438437,NaN,NaN,16.964206515358576,20.897205091768733
2015-11-25T09:30:00-05:00,43.96,43.97,43.8,43.81,6576566,9378505.2,56.61594835863843,57.19965810956101,NaN,NaN,21.7529433051711,41.68109812272428,-0.060852770818317414,0.3779968634936992,0.4388496343120166,782415633,782328025.6,62.2736996435689,57.905261867953826,NaN,NaN,16.421704434136714,20.257847854964158
2015-11-27T09:30:00-05:00,43.86,43.99,43.79,43.91,3800711,9188090,57.68393449791524,56.351784676835415,NaN,NaN,28.286833949115103,39.533264345338495,-0.057350741642883285,0.3671612072584125,0.4245119489012958,786216344,784045765.4,63.28708150404037,56.54772245857533,NaN,NaN,16.25885760478301,19.68656353350971
2015-11-30T09:30:00-05:00,43.97,44.1023,43.81,43.96,17025593,9572393.5,58.237509644816804,56.019581740624474,NaN,NaN,37.1908635017241,30.918303530276727,-0.05282862817182782,0.35847616368651103,0.41130479185833885,803241937,787710980,65.4214175838066,55.321226881247185,NaN,NaN,16.26889357933562,19.198324968627695
2015-12-01T09:30:00-05:00,44.14,44.36,44.045,44.35,7779488,9274203.75,62.372340896633204,56.27504666813764,NaN,NaN,85.10175595354241,38.36739999457329,-0.02608578945944695,0.37869755503403013,0.4047833444934771,811021425,794377507.6,68.95649992224718,54.82095416990099,NaN,NaN,17.428516059477523,18.945495124463385
2015-12-02T09:30:00-05:00,44.4,44.565,44.02,44.07,9697088,9415105.85,57.937203880013655,56.23391657401914,NaN,NaN,78.46470859458618,50.15942106082778,-0.029515714415569216,0.36788870147401553,0.39740441588958475,801324337,796843935.2,70.1715022336465,55.12972096325107,NaN,NaN,17.200131902432172,18.696157521316067
2015-12-03T09:30:00-05:00,44.19,44.32,43.29,43.5,11854265,9642888.55,50.12348528096772,56.00915155823948,NaN,NaN,-7.327914122548762,44.34324957528381,-0.07011739098521935,0.3097576771580606,0.3798750681432799,789470072,798254823,70.87376487260178,56.09726672426873,NaN,NaN,14.615220142060611,18.113166467136715
2015-12-04T09:30:00-05:00,43.63,44.645,43.54,44.57,12840171,9948457.75,60.80870494964918,57.22309701180154,NaN,NaN,94.97812532551784,57.68150785056436,-0.027068413974548622,0.3460395506750942,0.3731079646496428,802310243,801473602.8,72.4663943258567,57.923482875135505,NaN,NaN,15.816728408758166,17.78510388736835
2015-12-07T09:30:00-05:00,44.52,44.5577,44.14,44.35,12814944,10245757.65,58.05479921367881,57.728439843782716,NaN,NaN,110.47528696190554,72.33839254260064,-0.016108618326116098,0.3529721917419977,0.3690808100681138,789495299,798724275.2,68.99603508141799,59.89177459625683,NaN,NaN,15.850326869492637,17.508707170528965
2015-12-08T09:30:00-05:00,43.97,44.36,43.84,44.24,11378344,10307363.25,56.67278484617158,58.127683620959694,NaN,NaN,69.81967434689545,69.28197622127125,-0.018779572663329358,0.3456063442389521,0.36438591690228145,778116955,792143381.2,61.41458328647191,61.43421234865141,NaN,NaN,15.438824879119517,17.213009700327614
2015-12-09T09:30:00-05:00,44.05,44.38,43.38,43.59,16254221,10256411.1,49.21697679409463,57.54494001236534,NaN,NaN,2.8612303290440044,54.161280568162816,-0.064272737196861,0.2840449954062052,0.3483177326030662,761862734,784251060.6,53.78202852587546,62.354308713625485,NaN,NaN,12.582809163129339,16.55155248072786
2015-12-10T09:30:00-05:00,43.71,44.0399,43.58,43.71,9073446,10300025.95,50.51140469191548,56.930192592864614,NaN,NaN,0.8344193285292049,55.79374725837842,-0.08493511490992367,0.24214883896566164,0.3270839538755853,770936180,780544282.2,50.60123055139651,62.735187501708985,NaN,NaN,10.72165098956692,15.718709410562012
2015-12-11T09:30:00-05:00,43.23,43.335,42.77,42.8,16960319,10746344,41.80842534069061,55.501646901404776,NaN,NaN,-137.09226793322406,9.379668606630025,-0.15448948993821904,0.13397209145281153,0.28846158139103056,753975861,770877405.8,43.39351038184909,62.070701955519645,NaN,NaN,5.979227736077801,14.327354885635696
2015-12-14T09:30:00-05:00,42.79,43.14,42.345,43.13,21034227,11045808.95,45.47714341559621,54.575513011309795,NaN,NaN,-163.7916300419939,-45.47371479414986,-0.17155625048469952,0.07401626828515617,0.2455725187698557,775010088,767980363.6,41.48631562084435,60.98098228906357,NaN,NaN,3.3803782716659905,12.763501083640024
2015-12-15T09:30:00-05:00,43.46,43.62,43.26,43.32,17021931,11442945.5,47.52832224429182,53.78921314679094,NaN,NaN,-81.77324015657378,-75.79229769484371,-0.1633735848760701,0.04135553767476807,0.20472912255083817,792032019,770763376.4,44.03116225595518,59.79680184211274,NaN,NaN,1.966357552133334,11.221052007710497
2015-12-16T09:30:00-05:00,43.59,43.985,43.15,43.91,18173802,11881906.35,53.39198069068679,53.558929741937256,NaN,NaN,-33.194049551258274,-83.00335367090416,-0.11389458999442528,0.06236088505780657,0.17625547505223185,810205821,780431993.8,51.86382770832156,59.053239561023645,NaN,NaN,2.6966363393617967,10.00327834080354
2015-12-17T09:30:00-05:00,44.09,44.09,43.21,43.22,12108646,11978998.2,46.804583347976376,52.78183323122733,NaN,NaN,-72.96613323977726,-97.76346418456545,-0.12255264751667189,0.02306466565639198,0.14561731317306387,798097175,785864192.8,55.62160358348846,58.505705423841356,NaN,NaN,1.0699286002553028,8.72708552072522
2015-12-18T09:30:00-05:00,42.88,42.97,42.1,42.17,22813935,12651320.25,38.9327212095163,51.40291977156301,NaN,NaN,-240.27422307030892,-118.39985521198241,-0.1898910502025457,-0.09174649958011827,0.09814455062242744,775283240,790125668.6,58.367361800779726,58.0018442964823,NaN,NaN,-3.2895103537917616,7.010428967222794
2015-12-21T09:30:00-05:00,42.52,42.63,42.235,42.6,11163279,12845073.25,43.14955790274176,50.02986384342791,NaN,NaN,-180.37522890920133,-121.7165749854239,-0.19559622350498546,-0.1463507287588044,0.04924549474618107,786446519,792412954.8,59.804866677950784,57.348156207603985,NaN,NaN,-5.2316962770436355,5.26155393232759
2015-12-22T09:30:00-05:00,42.76,42.98,42.56,42.91,9482597,12957849.25,46.04229904775065,49.18022778398056,NaN,NaN,-110.08137638803674,-127.3782022317165,-0.16958412435180334,-0.16273466069357312,0.006849463658230227,795929116,793192374.2,60.30780633478082,56.64360650054215,NaN,NaN,-5.7716344187992545,3.6853841678808985
2015-12-23T09:30:00-05:00,43.14,43.31,43,43.27,8045250,12794941.15,49.27050864741175,49.1193008815837,NaN,NaN,-51.57947556191601,-131.05528743384804,-0.12147845079605542,-0.14499859983683905,-0.023520149040783627,803974366,791946083.2,59.03579565028489,55.79803727037666,NaN,NaN,-5.128429768522875,2.426267891251788
2015-12-24T09:30:00-05:00,43.3,43.36,43.2,43.25,2457019,12588963.8,49.09477467057744,48.282591575935726,NaN,NaN,-36.989365521277044,-123.85993389014803,-0.08602057001588227,-0.13104586156063647,-0.045025291544754195,801517347,792630117.6,59.540206084193436,54.87473811025785,NaN,NaN,-4.6811071470475465,1.410928600066169
2015-12-28T09:30:00-05:00,43.09,43.25,42.8501,43.22,7177228,12757789.65,48.813529647479484,47.62250089263576,NaN,NaN,-53.02299139310096,-86.40968755470642,-0.06079095977977379,-0.12101399126947143,-0.06022303148969764,794340119,796441493.4,62.32397467472979,54.39816236692298,NaN,NaN,-4.404619656213011,0.5801359920262861
2015-12-29T09:30:00-05:00,43.48,43.924,43.39,43.81,6809184,12246969.2,54.35196513262425,47.45672805595381,NaN,NaN,28.77063593152333,-44.580514586561506,-0.0035893027636525812,-0.06470965994426336,-0.06112035718061078,801149303,799382050.2,64.3613151670736,54.60864321553741,NaN,NaN,-2.464501240328123,0.14518781597565622
2015-12-30T09:30:00-05:00,43.79,43.79,43.44,43.44,7196520,12217820.8,50.650687533964536,47.55913596594452,NaN,NaN,13.883628844531168,-19.787513540047918,0.009396431872748384,-0.0493748173396753,-0.05877124921242369,793952783,798986783.6,63.86141611845287,55.32859947215008,NaN,NaN,-1.933756846763431,-0.1518042787013562
2015-12-31T09:30:00-05:00,43.29,43.3168,42.83,42.83,8834468,12174689.8,45.187259740768354,47.17883989800544,NaN,NaN,-60.66229788809046,-21.604078005282812,-0.021349906386430126,-0.08545863219546135,-0.06410872580903122,785118315,795215573.4,59.14159299522416,55.93862536099491,NaN,NaN,-3.17964330042261,-0.584352710375821
2016-01-04T09:30:00-05:00,42.06,42.28,41.61,42.27,21638628,12663907.95,40.832821563078575,47.109153913890296,NaN,NaN,-168.67881409582208,-47.94196772019181,-0.07465534290186925,-0.15742790443636778,-0.08277256153449854,763479687,787608041.4,50.95957049860841,56.47905822647772,NaN,NaN,-5.6489555109986505,-1.3078673961790823
2016-01-05T09:30:00-05:00,42.4,42.5,41.97,42.16,16067215,12825260.15,40.01708318495529,46.71914961170166,NaN,NaN,-133.08847800000004,-63.95506504157163,-0.1104179227511329,-0.22079496497341466,-0.11037704222228177,747412472,778222512,43.047113597472645,56.59054379623689,NaN,NaN,-7.876204026606988,-2.2462012005259258
2016-01-06T09:30:00-05:00,41.54,41.915,41.385,41.64,13858365,12877431.2,36.32290823089076,45.91876289645872,NaN,NaN,-181.77497157215316,-106.06418654230693,-0.1592238237571341,-0.3094068219186994,-0.1501829981615653,733554107,764703472.8,34.69146798016746,55.92342277653777,NaN,NaN,-10.957925107283666,-3.4907331872056027
2016-01-07T09:30:00-05:00,40.79,41.3162,40.39,40.41,16840659,13150546.95,29.40751593620385,44.20558684256709,NaN,NaN,-242.48180326604927,-157.337272964423,-0.25859417780292493,-0.47342572041522146,-0.21483154261229653,716713448,749255605.8,28.002735680957684,54.21905906029749,NaN,NaN,-16.279287024419425,-5.31766944966472
2016-01-08T09:30:00-05:00,40.76,40.895,40.04,40.09,19233104,13299491.1,27.918309592973444,42.85656728863831,NaN,NaN,-218.93764434179832,-188.9923422551646,-0.32578473074349723,-0.6220624560416681,-0.29627772529817087,697480344,731728011.6,22.663425401491637,51.86490347586915,NaN,NaN,-21.029725662557684,-7.56224890864943
2016-01-11T09:30:00-05:00,40.37,40.5299,39.85,40.35,19135121,13802574.85,30.97674980477467,42.28828361687105,NaN,NaN,-184.47418006827826,-192.15141544965581,-0.3315265936503045,-0.7106859673610515,-0.379159373710747,716615465,722355167.2,20.4211047711607,49.15445654518208,NaN,NaN,-23.86849855808567,-9.891713144283178
2016-01-12T09:30:00-05:00,40.78,40.92,40.31,40.83,15841629,13746640.35,36.34645223488391,41.80234749773835,NaN,NaN,-126.60921796058167,-190.85556344177215,-0.28365710795360594,-0.7337307586527544,-0.45007365069914845,732457094,719364091.6,19.74956705762881,46.29336371515907,NaN,NaN,-24.529287663234804,-11.982795218419124
2016-01-13T09:30:00-05:00,41.13,41.13,39.66,39.73,21962326,13793045.3,30.492106430445332,40.69161945364511,NaN,NaN,-136.72002909708297,-181.84457494675812,-0.3048798620223899,-0.8311734782271358,-0.5262936162047459,710494768,714752223.8,18.726996137562608,43.3233058439292,NaN,NaN,-27.143451642308662,-14.148603278974772
2016-01-14T09:30:00-05:00,39.9,40.79,39.425,40.48,19795563,13931726.9,37.84329542611201,39.87538993783799,NaN,NaN,-114.99978533080477,-156.3481713597092,-0.24953820066074917,-0.8382163670306824,-0.5886781663699332,730290331,717467600.4,21.31039306784467,40.62863423089775,NaN,NaN,-26.75170556368538,-15.949046462504858
2016-01-15T09:30:00-05:00,39.16,39.72,38.86,39.34,20177759,14031924.75,32.25862461097135,38.67280779072326,NaN,NaN,-144.37873943519284,-141.43639037838813,-0.26915518492256574,-0.9251221475231404,-0.6559669626005746,710112572,719994046,23.739296228443422,38.07142638405846,NaN,NaN,-28.450438423741293,-17.73495959982435
2016-01-19T09:30:00-05:00,39.8,39.87,39.03,39.38,19658750,14409429.95,32.63427809610971,37.51714696562543,NaN,NaN,-119.93792600967855,-128.5291395666682,-0.25880813892456866,-0.9794771362562855,-0.7206689973317169,729771322,722625217.4,26.2910395234924,35.49764530182721,NaN,NaN,-29.601292053465826,-19.43014995034456
2016-01-20T09:30:00-05:00,38.71,39.46,38.027,39.07,29631845,14750325.45,31.190685271824805,35.86276983271118,NaN,NaN,-128.6059683102579,-128.9284896366034,-0.25196893474441473,-1.0356301657622353,-0.7836612310178206,700139477,716161694,24.15301630638976,32.625623954635515,NaN,NaN,-30.99021134958128,-21.081587293092664
2016-01-21T09:30:00-05:00,39.29,39.86,38.8,39.29,22135853,15298954.15,33.44089926249663,34.63349924189204,NaN,NaN,-94.53526148398367,-120.49153611398353,-0.21328925024815515,-1.0502727938280145,-0.8369835435798594,722275330,718517806.4,26.499441227129907,29.956911462398157,NaN,NaN,-31.409537140622344,-22.55700869988262
2016-01-22T09:30:00-05:00,40.04,40.39,39.98,40.38,11248235,15387236.05,43.329253611161505,34.500784518348695,NaN,NaN,-47.03914952994861,-106.8994089538123,-0.10067272565214791,-0.9628244506450443,-0.8621517249928964,733523565,719164453.2,27.16542211640676,27.67289925676834,NaN,NaN,-28.483179617309258,-23.403604545229282
2016-01-25T09:30:00-05:00,40.16,40.51,39.84,39.91,10480637,15509005.4,40.53297103260591,34.47936662331493,NaN,NaN,-49.79207944116922,-87.98207695500757,-0.04694366843534281,-0.9208313105370749,-0.8738876421017321,723042928,721750524.4,29.90095085488919,26.168712139359823,NaN,NaN,-26.986394680018012,-23.91543170734196
2016-01-26T09:30:00-05:00,40.07,40.39,39.815,40.3,11473681,15959838.5,43.775450719877064,34.74782144723792,NaN,NaN,-41.51947396380956,-72.29838654583378,0.02204948410492058,-0.8463257869705814,-0.8683752710755019,734516609,722699581.8,30.926256510569473,25.302936633152452,NaN,NaN,-24.722574596769174,-24.03073783440299
2016-01-27T09:30:00-05:00,39.97,40.21,39.29,39.47,18022352,16502094.7,38.91261489442089,34.93280049463293,NaN,NaN,-65.25457488573235,-59.628107860928665,0.019085335725345987,-0.8445186014188195,-0.8636039371441655,716494257,725970537.8,34.483074491704244,25.288051383976512,NaN,NaN,-24.340611565516078,-24.075005510276288
2016-01-28T09:30:00-05:00,40.05,40.13,39.5,39.98,17566801,17039975.55,43.09555763935264,35.91051775914356,NaN,NaN,-49.24740933759293,-50.57053743165052,0.056647300904861586,-0.7927948110130885,-0.84944211191795,734061058,728327683.4,37.00064220636004,25.93075899293382,NaN,NaN,-22.666862466475774,-23.873842218304787
2016-01-29T09:30:00-05:00,40.31,41.27,40.23,41.24,16113314,17485815.25,51.86507576141466,37.62100105688936,NaN,NaN,38.007551693653745,-33.561197186930045,0.16537532586491877,-0.6427229545868016,-0.8080982804517204,750174372,731657844.8,40.48041661878919,27.203401222740787,NaN,NaN,-18.10886598674233,-23.050274185224435
2016-02-01T09:30:00-05:00,41.07,41.58,41.035,41.39,14797320,17783957.85,52.79768192732161,39.17963906564272,NaN,NaN,92.41708913945543,-5.119363470805124,0.24179462498954407,-0.5058549992147903,-0.7476496242043343,764971692,740043597.6,48.23428836722769,29.19005719388843,NaN,NaN,-14.256981218934511,-21.794089475754447
2016-02-02T09:30:00-05:00,41.27,41.28,40.52,40.65,13951155,17399584.2,47.870165684549754,40.00276145490456,NaN,NaN,54.62721272776656,14.109973867510103,0.23660859508944365,-0.45188888034252983,-0.6884974754319735,751020537,743344383.2,50.94333626323359,31.418183565717346,NaN,NaN,-12.59661822582131,-20.480165011478284
2016-02-03T09:30:00-05:00,40.91,40.93,39.97,40.6,21506247,17671535.8,47.54727035247384,41.22098744933517,NaN,NaN,35.2133906506236,34.203566974781296,0.22404069535643367,-0.40844660623643136,-0.632487301592865,729514290,745948389.8,53.03162008075365,33.86851384737385,NaN,NaN,-11.39127368611409,-19.181751964997684
2016-02-04T09:30:00-05:00,40.52,40.905,40.21,40.64,18203043,17888769.7,47.85032650139933,41.93577538328426,NaN,NaN,58.36695673049207,55.72644018839829,0.21273776837431724,-0.3665650911249685,-0.5793028594992857,747717333,748679644.8,55.18641552595007,36.28822973723852,NaN,NaN,-10.335501177862676,-17.918001852549825
2016-02-05T09:30:00-05:00,40.48,40.55,39.34,39.5,23777385,18235606,40.64305482866556,42.5346632559767,NaN,NaN,-46.87290660658445,38.750348528350656,0.12703050420407147,-0.4205147292441964,-0.5475452334482679,723939948,743432760,50.402570347201376,38.1927493171498,NaN,NaN,-11.621640404349671,-17.018521645664087
2016-02-08T09:30:00-05:00,38.835,39.04,38.255,38.93,24820851,18514993.35,37.59403910614955,42.88893189955098,NaN,NaN,-160.79493183050963,-11.892055665642355,0.0352674995095581,-0.5034608590613203,-0.5387283585708784,699119097,730262241,40.833895698869966,39.2315247582482,NaN,NaN,-13.671828340397418,-16.540422602054562
2016-02-09T09:30:00-05:00,38.46,39.3,38.395,38.75,24755356,18796005.1,36.65877639704553,43.27950983706675,NaN,NaN,-128.92716106598454,-48.60293042439257,-0.030672250565493386,-0.5770686717777451,-0.5463964212122517,674363741,714930881.8,32.98398551435173,39.86230827310262,NaN,NaN,-15.614519586625264,-16.40815074270752
2016-02-10T09:30:00-05:00,39.08,39.535,38.79,38.83,16974976,18852672.45,37.404130202944756,43.562597761384474,NaN,NaN,-91.9388552629192,-74.03337960710112,-0.06030731340944062,-0.6217805629740525,-0.5614732495646119,691338717,707295767.2,29.901143595003575,40.10528701366503,NaN,NaN,-16.981403769126796,-16.49004403219599
2016-02-11T09:30:00-05:00,38.325,38.98,38.25,38.73,24627335,18985922.9,36.8208667976406,43.09771298899012,NaN,NaN,-118.25731053495049,-109.35823306018965,-0.07698350959271505,-0.6577026365555056,-0.5807191269627906,666711382,691094577,24.638754872238948,39.92481078193875,NaN,NaN,-18.274653521264543,-16.74498824492007
2016-02-12T09:30:00-05:00,39.04,39.3,38.82,39.27,10893423,18540815.9,42.0737642176661,43.207769645065845,NaN,NaN,-63.18317419955232,-112.62028657878322,-0.043644379614176,-0.6352746014805106,-0.5916302218663346,677604805,681827548.4,22.22889761681266,39.376806979219005,NaN,NaN,-17.944520297526104,-16.916349966720933
2016-02-16T09:30:00-05:00,39.71,39.98,39.495,39.97,10293312,18046593.55,48.09795466249933,43.516519926681724,NaN,NaN,2.6808590449735745,-79.92512840368657,0.029605996141244706,-0.5546227266897787,-0.5842287228310235,687898117,679583352.4,21.675985164718142,38.71607331165819,NaN,NaN,-15.870126978713248,-16.766889539862692
2016-02-17T09:30:00-05:00,40.2,40.87,40.15,40.79,11128836,17620097.85,54.11758901202012,44.60258950651024,NaN,NaN,75.73980316473632,-38.99173555754243,0.1316227034069204,-0.41970034357237296,-0.5513230469792934,699026953,684515994.8,26.03101974554066,38.112355115503654,NaN,NaN,-12.14088077240312,-16.106031144511324
2016-02-18T09:30:00-05:00,40.93,40.98,40.55,40.63,11578396,16717425.4,52.83005845814915,45.297910993567136,NaN,NaN,79.07094808985855,-4.789774886986874,0.18348040029038226,-0.32197254661631547,-0.5054529469066977,687448557,683737962.8,25.78745875896152,37.31141344068947,NaN,NaN,-9.483414053466458,-15.15994298864777
2016-02-19T09:30:00-05:00,40.48,40.78,40.375,40.66,8579509,16039608.2,53.05558051929879,45.38294704770171,NaN,NaN,61.27212935984529,31.116113091972284,0.21288810222519938,-0.2393428191251985,-0.4522309213503979,696028066,689601299.6,31.025144165343292,36.6360368368719,NaN,NaN,-7.259856417134373,-14.031359192717286
2016-02-22T09:30:00-05:00,41.03,41.26,40.97,41.2,6590650,15806728.95,57.0373150149401,45.685777982531604,NaN,NaN,105.25302132986627,64.80335219785601,0.25874477542473573,-0.12879995206947825,-0.387544727494214,702618716,694604081.8,35.225786387682845,35.70685812404728,NaN,NaN,-4.141835464887871,-12.618570088741656
2016-02-23T09:30:00-05:00,41.03,41.07,40.47,40.55,8189484,15692171.3,51.387314035889545,45.93700286477016,NaN,NaN,57.04141098375215,75.67546258561171,0.23597471093488992,-0.09257633882560157,-0.3285510497604915,694429232,695910304.8,36.316330866105396,34.6620720242524,NaN,NaN,-3.049742938655836,-11.251594781586538
2016-02-24T09:30:00-05:00,40.11,40.94,39.9,40.86,10144362,15625705.35,53.740846285693046,46.37940114571438,NaN,NaN,42.10676939182084,68.94885583102862,0.2321115043544521,-0.038411669317426345,-0.27052317367187845,704573594,697019633,37.28207116027775,33.53710424421841,NaN,NaN,-1.4410649828895765,-9.85009052462983
2016-02-25T09:30:00-05:00,41,41.39,40.68,41.37,9403419,15194758.7,57.395290294943706,47.0611842738247,NaN,NaN,86.0193630272442,70.33853881850575,0.2525357693912916,0.04514653806723601,-0.20738923132405557,713977013,702325324.2,41.825963896093306,32.58278627065721,NaN,NaN,1.0434623063762754,-8.293868691628957
2016-02-26T09:30:00-05:00,41.6,41.64,41.17,41.26,9772945,14805065.9,56.3610770269746,48.18390014513248,NaN,NaN,95.30983768271858,77.14608048308041,0.24696974572047278,0.10132295082653542,-0.14564679489393736,704204068,703960524.6,43.191991961630364,32.067744957402134,NaN,NaN,2.7873913812527755,-6.710831538360138
2016-02-29T09:30:00-05:00,41.22,41.606,40.97,40.97,13601895,14679494.95,53.618021320522296,49.32847030330197,NaN,NaN,78.1669420421441,71.72886462553598,0.2133552192669774,0.12104722918978439,-0.09230799007719301,690602173,701557216,41.64421511244535,32.12562491551466,NaN,NaN,3.499246493986118,-5.252248962310673
2016-03-01T09:30:00-05:00,41.32,42.19,41.26,42.19,12304420,14554849.95,61.99745300612479,51.13837577537906,NaN,NaN,132.0069529788196,86.72197302454947,0.25980095634380224,0.2324432053525598,-0.027357750991242435,702906593,703252688.2,43.190854915066865,32.85468701556574,NaN,NaN,6.843805684992059,-3.5242411555531397
2016-03-02T09:30:00-05:00,42.04,42.31,41.965,42.31,8748244,14294704.4,62.71104763659292,52.94601273492536,NaN,NaN,143.80037220025713,107.06069358623672,0.28320058415960686,0.3266429792082661,0.04344239504865928,711654837,704668936.8,44.51374626007375,33.89844434878504,NaN,NaN,9.747306613524072,-1.6283057599706807
2016-03-03T09:30:00-05:00,42.33,42.335,41.98,42.31,7883885,13613586.3,62.71104763659292,54.79531136627909,NaN,NaN,129.08545763712542,115.67391250821296,0.282625118936771,0.3967237937196231,0.11409867478285204,711654837,704204501.6,44.150656994342725,35.292151643221025,NaN,NaN,12.084193491373876,0.33062270450711306
2016-03-04T09:30:00-05:00,42.32,42.625,42.145,42.42,7885913,13097729.8,63.44086729772018,56.32153301485438,NaN,NaN,127.37301216663224,122.08654740499568,0.2734284799146508,0.45588427467616555,0.18245579476151474,719540750,707271838,47.21308914221536,37.07673675217836,NaN,NaN,14.232184676942005,2.3165601291406688
2016-03-07T09:30:00-05:00,42.18,42.35,41.85,42.16,15813499,12699535.5,60.43025289549516,57.202411460068376,NaN,NaN,99.09434255071847,126.27202750671059,0.23507462476213278,0.47629907571418073,0.24122445095204795,703727251,709896853.6,49.75241682913299,39.082196156779425,NaN,NaN,15.259380042400464,4.165534402463496
2016-03-08T09:30:00-05:00,41.91,42.245,41.75,41.9,11700533,12043519.6,57.49207111875232,57.443445896263526,NaN,NaN,81.14508340520928,116.0996535919885,0.17992038125152454,0.4661249275164536,0.2862045462649291,692026718,707720878.6,47.70383873326795,40.630254655902796,NaN,NaN,15.34244103932037,5.7622353505859065
2016-03-09T09:30:00-05:00,41.96,42.27,41.96,42.26,12160586,11413781.1,60.3655679620737,57.98169657511528,NaN,NaN,87.87667265679525,104.91491368329613,0.15628413300249583,0.48155971251804885,0.325275579515553,704187304,706227372,46.2948454931278,42.09506799405752,NaN,NaN,16.20260626775311,7.253716910181222
2016-03-10T09:30:00-05:00,42.44,42.63,41.7,42.22,12938424,11211953.5,59.88120217027415,58.469240978756375,NaN,NaN,84.06005417616929,95.90983299110492,0.127758536089438,0.4849737496273505,0.3572152135379125,691248880,702146180.6,42.59268611522065,42.92132099047734,NaN,NaN,16.78999997022142,8.616043061615535
2016-03-11T09:30:00-05:00,42.64,42.88,42.54,42.87,8820147,10421594.1,64.82096545291773,59.02521601004049,NaN,NaN,121.30121544446537,94.69547364667156,0.14140674957023425,0.5339736505007053,0.3925669009304711,700069027,698251836,39.35830661405934,43.21650100664709,NaN,NaN,18.734868365693377,10.061589533626655
2016-03-14T09:30:00-04:00,42.74,43,42.72,42.92,10060929,10379969.4,65.17616803691936,60.0101341529712,NaN,NaN,120.68932132829853,99.01446940218757,0.14216033558364316,0.570267320410025,0.4281069848263819,710129956,699532377,40.94629346025944,43.54721262051523,NaN,NaN,20.440699435159797,11.544319519559961
2016-03-15T09:30:00-04:00,42.75,43.12,42.73,43.08,6321100,10181358.8,66.34714610677489,60.910584140191325,NaN,NaN,119.88975796976061,106.76340431509784,0.14148824554593775,0.604967291758804,0.4634790462128663,716451056,704417244.6,46.682077507539375,44.218641645319636,NaN,NaN,22.211762897731642,13.068240002155916
2016-03-16T09:30:00-04:00,42.88,43.65,42.87,43.58,14756858,10362759.9,69.76827782899153,61.794368964051884,NaN,NaN,142.89158637573374,117.76638705888554,0.16133332681596468,0.6651457047328222,0.5038123779168575,731207914,709821366.6,52.212028212808804,44.96050338222789,NaN,NaN,24.786330840853736,14.742252979112747
2016-03-17T09:30:00-04:00,43.5,43.88,43.45,43.74,9367148,10252197.5,70.79154978468986,62.8251170181744,NaN,NaN,158.2838235113226,132.6111409259162,0.1709321446412,0.7174775587183575,0.5465454140771575,740575062,719686603,60.30566338791221,46.18290848410516,NaN,NaN,27.248632491187347,16.528878623694833
2016-03-18T09:30:00-04:00,43.69,43.72,43.395,43.59,9414370,10293940.55,68.45232296524716,63.8847099927976,NaN,NaN,136.82711370400284,135.7163205778237,0.1534325524335266,0.7383361046190657,0.5849035521855391,731160692,725904936,64.3986696988238,47.80822666884649,NaN,NaN,28.7082205652614,18.2687846153472
2016-03-21T09:30:00-04:00,43.49,43.76,43.47,43.74,8003471,10364581.6,69.53639199196209,64.42320563464312,NaN,NaN,128.39819026523023,137.25809436521004,0.13866115466299056,0.7582299955142773,0.6195688408512867,739164163,731711777.4,67.74355367641334,49.561990866085516,NaN,NaN,30.24648871371758,19.979885200828683
2016-03-22T09:30:00-04:00,43.54,43.92,43.535,43.75,13112858,10610750.3,69.6113631456036,64.91608531385818,NaN,NaN,119.67792639341971,137.21572804994184,0.11712356763723597,0.7659733003978317,0.6488497327605958,752277021,738876970.4,71.32377168796455,51.47699268236344,NaN,NaN,31.555067913606074,21.633482731225453
2016-03-23T09:30:00-04:00,43.69,43.74,43.41,43.5,10675096,10637287,65.28567276105838,65.09998710846286,NaN,NaN,92.10513197481737,127.05843716975858,0.075614559275334,0.7433679318547632,0.6677533725794292,741601925,740955772.6,72.28489570305526,53.48658116155718,NaN,NaN,31.583209324055023,23.05487224448682
2016-03-24T09:30:00-04:00,43.31,43.62,43.25,43.62,6743333,10504282.7,66.3660588258942,65.30892936047529,NaN,NaN,78.86014711354959,111.17370189020399,0.04720401647607886,0.7267583931745278,0.679554376698449,748345258,742509811.8,73.01308472960037,55.32943798922754,NaN,NaN,31.88219437284112,24.31591826282315
2016-03-28T09:30:00-04:00,43.66,43.715,43.43,43.51,6407959,10336033.4,64.38785825614723,65.59161545766473,NaN,NaN,77.05330815359626,99.21894078012267,0.013707015551778223,0.6966881461381718,0.6829811305863935,741937299,744665133.2,74.03214178215812,57.06370405730077,NaN,NaN,31.631506137750108,25.36100224495557
2016-03-29T09:30:00-04:00,43.43,44.22,43.38,44.19,10081507,10160014,70.28453971476893,66.50536321452306,NaN,NaN,106.12706701479577,94.7647161300358,0.029162602710253394,0.7194343839742103,0.6902717812639569,752018806,747236061.8,75.23350006408404,59.03010843807335,NaN,NaN,33.05577365227534,26.46025530314411
2016-03-30T09:30:00-04:00,44.42,44.67,44.35,44.45,10988322,10094209.1,72.1812308057012,67.34933913192502,NaN,NaN,146.21154656552878,100.07144016445758,0.047620630017805476,0.7497975687862137,0.7021769387684083,763007128,749382083.2,76.22235802695323,61.16778790477516,NaN,NaN,34.830874352854046,27.656058024531244
2016-03-31T09:30:00-04:00,44.39,44.58,44.28,44.36,14594927,10386543.25,70.50366456351215,68.10808644572772,NaN,NaN,123.85746620326273,106.42190701014665,0.04454820896730938,0.757862199977545,0.7133139910102356,748412201,750744138.4,76.85402773647033,63.61502659200728,NaN,NaN,35.83972657972546,28.82515353241613
2016-04-01T09:30:00-04:00,44.05,44.7199,44.01,44.7,9654907,10475094.35,73.05171284224679,68.69599697353695,NaN,NaN,120.25917609855034,114.7017128071468,0.055482042450668234,0.782666544073571,0.7271845016229027,758067108,752688508.4,77.76222760664407,66.35816380576334,NaN,NaN,37.46293155026484,30.059121820680232
2016-04-04T09:30:00-04:00,44.63,44.73,44.44,44.53,7646170,10463107.2,69.8047361827317,69.02660898395212,NaN,NaN,120.25240336025685,123.34153184847894,0.04194809196649052,0.7796196165810159,0.7376715246145253,750420938,754385236.2,78.55306850190385,69.04436202302365,NaN,NaN,37.91420923618064,31.18127716575172
2016-04-05T09:30:00-04:00,44.24,44.35,44.01,44.1,10726144,10208739.45,62.265916341945484,68.73509257217859,NaN,NaN,74.34778980211176,116.98567640594213,-0.0029005202200312885,0.7340458743394862,0.7369463945595175,739694794,751920433.8,74.41305652259736,71.02514623838495,NaN,NaN,36.05555808227698,31.877603010969615
2016-04-06T09:30:00-04:00,44.11,44.53,43.95,44.53,11138477,10180636.65,66.19737396603145,68.48002801053858,NaN,NaN,90.12487471401263,105.7683420356389,-0.010135715580645632,0.7242767500837104,0.734412465664356,750833271,749485662.4,70.46250880169009,72.32875199473361,NaN,NaN,35.60516238600504,32.41011149311753
2016-04-07T09:30:00-04:00,44.21,44.3,43.72,43.89,10631220,10104168.35,56.72440822762202,67.47523218503373,NaN,NaN,38.59804882379623,88.7164585597456,-0.06167806801021258,0.6573148806515903,0.7189929486618029,740202051,747843632.4,67.84647682589163,72.86738152601785,NaN,NaN,32.03701211236863,32.35681158158197
2016-04-08T09:30:00-04:00,44.12,44.285,43.74,43.89,8762796,9895386.95,56.72440822762202,66.63752398948908,NaN,NaN,30.135853793122287,70.69179409865998,-0.09730547119777055,0.5973611096645897,0.6946665808623602,740202051,744270621,62.41621957054136,72.72577794542624,NaN,NaN,29.245594681880384,31.912352024481745
2016-04-11T09:30:00-04:00,44.08,44.34,43.77,43.77,8138585,9861308.85,55.01251243832686,65.60010402137227,NaN,NaN,21.110060376810207,50.863325501970664,-0.12852638598405375,0.5340085983822931,0.6625349843663468,732063466,740599126.6,57.33781393628589,71.98251082113143,NaN,NaN,26.43803560491306,31.13030682168622
2016-04-12T09:30:00-04:00,43.85,44.105,43.55,44.07,9591974,9837861.1,58.39313752052625,64.79880219100961,NaN,NaN,3.969667700817476,36.78770108171181,-0.1282523908297728,0.5022194958291308,0.6304718866589036,741655440,740991255.8,57.73336142622435,71.01176723100713,NaN,NaN,25.016713948943707,30.256936411294433
2016-04-13T09:30:00-04:00,44.33,44.5899,44.28,44.52,7876600,9915636.1,62.89704732373817,64.62818608834388,NaN,NaN,105.23227068810706,39.8091802765307,-0.09838739684715347,0.5074876405999618,0.6058750374471152,749532040,740731009.6,57.3532999634969,69.94522467818153,NaN,NaN,25.154009652878834,29.527946874377918
2016-04-14T09:30:00-04:00,44.46,44.65,44.355,44.51,6502749,9502930.65,62.73452855424561,64.36879106894041,NaN,NaN,99.8203656812111,52.053643648013676,-0.08067279098295499,0.5050340487184215,0.5857068397013765,743029291,741296457.6,58.00024400503701,68.87287891214129,NaN,NaN,25.216095965493846,28.911968173108765
2016-04-15T09:30:00-04:00,44.45,44.565,44.25,44.34,6460875,9357617,59.90091682437881,64.04829525238551,NaN,NaN,66.92255734283387,59.410984357955996,-0.0815293985123926,0.48379509156088574,0.5653244900732783,736568416,740569730.6,56.807491856451165,67.64254677459078,NaN,NaN,24.449514858632377,28.27447484246928
2016-04-18T09:30:00-04:00,44.21,44.53,44.14,44.53,7113020,9242549.5,61.968515944180204,63.454293554486334,NaN,NaN,62.880126172101924,67.76499751701434,-0.07082099706533851,0.4767982437416052,0.5476192408069437,743681436,742893324.6,59.66370138932799,66.5304182978225,NaN,NaN,24.385458907053984,27.718901137409954
2016-04-19T09:30:00-04:00,44.61,44.66,44.03,44.28,6470997,9165925.8,57.74913741735159,62.423429741032784,NaN,NaN,41.96017594182789,75.36309916521643,-0.08134358084376347,0.4459397647522394,0.5272833455960029,737210439,742004324.4,58.08120206854476,65.23462144365047,NaN,NaN,23.10927694412009,27.0603833955114
2016-04-20T09:30:00-04:00,44.32,44.57,44.19,44.37,6877832,8854174.5,58.83577450936775,61.59000902287961,NaN,NaN,48.587509503245634,64.03414692824414,-0.08273831944671795,0.42386044628760544,0.5065987657343234,744088271,740915570.6,56.118074117075004,63.75348189940794,NaN,NaN,22.3466384903163,26.386991266197814
2016-04-21T09:30:00-04:00,44.31,44.3959,44.1,44.21,11277897,8884314.55,56.07470039691048,60.37736527678417,NaN,NaN,10.162425857909788,46.10255896358387,-0.09410462561532357,0.38896798371516894,0.4830726093304925,732810374,738871787.2,52.52884850437588,61.95109767781735,NaN,NaN,20.9225923521754,25.606362849908898
2016-04-22T09:30:00-04:00,43.51,43.73,43.21,43.44,14924441,9293369.95,45.10455431180106,58.613066571717695,NaN,NaN,-185.0134354359259,-4.284639592168136,-0.149839368053012,0.2957733992642275,0.44561276731723953,717885933,735135290.6,46.65394448794759,59.67258881967762,NaN,NaN,16.003692407739827,24.234552786741887
2016-04-25T09:30:00-04:00,43.32,43.465,43.21,43.45,9357526,9440848.3,45.25434646096167,57.397954437361705,NaN,NaN,-196.3503926951292,-56.13074336561435,-0.1803423874818718,0.22018478296489974,0.40052717044677155,727243459,731847695.2,42.18356277436904,57.370482123375595,NaN,NaN,12.144048869791016,22.50733794146319
2016-04-26T09:30:00-04:00,43.5,43.6,43.1,43.24,7367371,9305141.5,42.624011628138796,55.714142841797944,NaN,NaN,-179.64871558116798,-100.45252167021354,-0.2070604823254995,0.14170156753989716,0.34876204986539666,719876088,728380825,38.04372627613641,55.05485480012176,NaN,NaN,8.080353869176744,20.446340216850842
2016-04-27T09:30:00-04:00,42.69,43.09,42.53,43.04,12779629,9394706.85,40.22599120546235,54.53568448307225,NaN,NaN,-211.33839211106365,-152.4377019930754,-0.2288955437225899,0.06264262021215927,0.2915381639347492,707096459,720982462.6,31.042431463463927,52.42599441709122,NaN,NaN,3.9168156591203713,18.08497956574649
2016-04-28T09:30:00-04:00,43.11,43.26,42.36,42.5,22669609,9798440.95,34.57069771767881,52.953276589504874,NaN,NaN,-196.63788575805924,-193.7977643162692,-0.2677016908093576,-0.043088949576947755,0.2246127412324098,684426850,711305757.8,24.652071633360947,49.72855527872118,NaN,NaN,-1.707866948824942,15.257430063664858
2016-04-29T09:30:00-04:00,42.26,42.33,41.82,42.13,11896165,9910503.85,31.321449471733132,51.26105780617676,NaN,NaN,-220.01159403056383,-200.79739603519678,-0.3036515541146035,-0.15495170141084458,0.1486998527037589,672530685,702234708.2,20.41040981710354,47.090883555922446,NaN,NaN,-7.5932599982902085,11.993045769099847
2016-05-02T09:30:00-04:00,42.22,42.485,42.04,42.44,12552678,10155829.25,36.690395087939784,49.71086191813486,NaN,NaN,-155.76772875635422,-192.68086324744178,-0.2918385081319699,-0.21609828246120344,0.07574022567076644,685083363,693802689,17.411416773386364,44.21074465214831,NaN,NaN,-10.821534154869259,8.73382006567569
2016-05-03T09:30:00-04:00,42.15,42.24,41.91,42.05,12531192,10246081.65,33.17652006509152,47.587967113945815,NaN,NaN,-151.07039638761196,-186.9651994087306,-0.2947150609990354,-0.2926536005780278,0.002061460421007591,672552171,684337905.6,14.785281426794242,41.170171899526686,NaN,NaN,-14.726246189682376,5.382382029195967
2016-05-04T09:30:00-04:00,41.86,42.04,41.8,41.92,11245655,10251440.55,32.07384297869751,45.39791814426381,NaN,NaN,-140.56974127097902,-172.81146924071368,-0.28938366835436413,-0.35966812502194756,-0.07028445666758344,661306516,675179917,12.777154168990663,37.93995119695195,NaN,NaN,-18.21745389736321,2.0109768968303707
2016-05-05T09:30:00-04:00,42.04,42.135,41.84,41.94,13559918,10397875.45,32.44584126268296,43.43684131842839,NaN,NaN,-118.24171067463521,-157.13223422402885,-0.26895496140027386,-0.4064781584179258,-0.13752319701765192,674866434,673267833.8,12.39851741980182,34.767881594334135,NaN,NaN,-20.89817578443375,-1.261759200493075
2016-05-06T09:30:00-04:00,41.76,42.25,41.76,42.25,9229886,10421229.95,38.10409227419461,41.73223962771514,NaN,NaN,-96.16185401409312,-132.36228622073472,-0.22101433162784892,-0.41379111155246306,-0.19277677992461414,684096320,675580960.8,15.654830969273235,31.62439085004451,NaN,NaN,-21.52474838972079,-4.15647194181132
2016-05-09T09:30:00-04:00,42.27,42.45,42.22,42.25,7541183,10391359.85,38.10409227419462,40.329022117489636,NaN,NaN,-70.75882253703143,-115.36050497687015,-0.1776226280733055,-0.41480506501624603,-0.23718243694294053,684096320,675383552.2,15.601530230211296,28.590128575877838,NaN,NaN,-22.03034562992352,-6.709882468684491
2016-05-10T09:30:00-04:00,42.38,42.8,42.33,42.8,13920189,10607770.6,47.203365781223624,39.49813577976506,NaN,NaN,-41.022190322389115,-93.3508637638256,-0.10385221514804122,-0.3669977058779921,-0.26314549072995086,698016509,680476419.8,22.895217916548035,26.217067418697336,NaN,NaN,-19.670186219808603,-8.561354433130791
2016-05-11T09:30:00-04:00,42.69,42.93,42.49,42.49,7152065,10571543.85,43.33631030114038,38.58825077292433,NaN,NaN,-36.53302559453447,-72.5435206285367,-0.06955467334571191,-0.35008883241209077,-0.28053415906637885,690864444,686388005.4,30.412644619372173,24.6373385697685,NaN,NaN,-18.8301857900415,-10.028330341260892
2016-05-12T09:30:00-04:00,42.65,42.65,42.1,42.37,9336628,10713237.8,41.90517934597534,38.359723989651066,NaN,NaN,-52.280362513338616,-59.35125099627736,-0.049512010966553666,-0.34242417277457093,-0.29291216180801727,681527816,687720281.8,32.02120144741154,23.59214263830164,NaN,NaN,-18.56620097998089,-11.24802614679232
2016-05-13T09:30:00-04:00,42.36,42.62,42.16,42.21,10921355,10936261.8,40.00804455521659,37.98498813924071,NaN,NaN,-51.65960085588838,-50.45080036463641,-0.04189455899223854,-0.34528036054831546,-0.3033858015560769,670606461,685022310,30.484421149227302,22.756489665077236,NaN,NaN,-18.897745756056004,-12.34084323382999
2016-05-16T09:30:00-04:00,42.25,42.9,42.25,42.8,6394168,10900319.2,49.1499831219456,38.45112896022691,NaN,NaN,-16.16895913321907,-39.53282768387394,0.005494426434502375,-0.296517768512949,-0.30201219494745135,677000629,683603171.8,29.677604282106586,22.15890952264653,NaN,NaN,-16.25674754391768,-12.900258135271088
2016-05-17T09:30:00-04:00,42.67,42.875,42.2367,42.37,9940068,11073772.75,43.89942749127573,38.71351726635644,NaN,NaN,-27.109447834695352,-36.75027918633519,0.010220689600657695,-0.2892363329466292,-0.2994570225472869,667060561,677411982.2,26.395441989808262,21.8269817030997,NaN,NaN,-15.679540248719833,-13.297298437192337
2016-05-18T09:30:00-04:00,42.26,42.7796,42.2,42.45,10903724,11275067.35,45.07502318960524,39.4638262286369,NaN,NaN,-21.5810048746386,-33.759875042356015,0.02048273997118588,-0.2738535975833045,-0.2943363375544904,677964285,674831950.4,25.147315828485603,21.862356288465744,NaN,NaN,-14.851692434844143,-13.519354722571167
2016-05-19T09:30:00-04:00,42.35,42.4,41.965,42.22,8634847,11142914.85,42.328720701308,40.25005988789225,NaN,NaN,-60.180454009213506,-35.33989334153099,0.013846400786627466,-0.27702833657120607,-0.29087473735783353,669329438,672392274.8,23.99203303370878,22.11818651822326,NaN,NaN,-14.997116853349047,-13.730463598396579
2016-05-20T09:30:00-04:00,42.45,42.825,42.42,42.73,5873037,10690344.65,49.6537087268914,41.17601086210309,NaN,NaN,39.52471171613555,-17.1030308271262,0.04415987874807109,-0.23567488892274469,-0.2798347676708158,675202475,673311477.6,25.382942074258253,22.687581182571257,NaN,NaN,-12.740948720920514,-13.589104330185712
2016-05-23T09:30:00-04:00,42.71,42.89,42.61,42.65,8427695,10643853.1,48.610709966904665,42.278452997946886,NaN,NaN,66.29368488678547,-0.6105020231252951,0.058290632705622736,-0.20697147678878736,-0.2652621094944101,666774780,671266307.8,24.316720813957303,23.36839828165434,NaN,NaN,-11.255105008161753,-13.25567585561086
2016-05-24T09:30:00-04:00,42.82,43.52,42.82,43.45,9461493,10748559.2,58.09104374527329,44.13682448127372,NaN,NaN,200.8324543379695,44.97787841140767,0.11756429931320031,-0.1183067353529097,-0.23587103466611,676236273,673101450.2,27.268951627538513,24.403526671550612,NaN,NaN,-6.581593264513512,-12.302235485454096
2016-05-25T09:30:00-04:00,43.63,43.89,43.57,43.75,9841925,10601674,60.99684993994013,46.17618224393495,NaN,NaN,264.25713091364946,102.14550556906529,0.1698486607298311,-0.023560208753821144,-0.19340886948365224,686078198,674724232.8,29.87393580207251,25.651770841712807,NaN,NaN,-1.7788968793765465,-10.798901398871589
2016-05-26T09:30:00-04:00,43.75,43.9559,43.661,43.89,6517143,9794050.7,62.310184217975745,47.90518881134789,NaN,NaN,225.71976098765552,159.32554856843907,0.20441348277135865,0.062107983980546067,-0.14230549879081258,692595341,679377413.4,36.85755986124981,27.16625147685399,NaN,NaN,2.4765940320326503,-8.902402051599555
2016-05-27T09:30:00-04:00,43.88,44.16,43.83,44.1,7788018,9588643.35,64.25452595560421,49.77307693144856,NaN,NaN,208.89792112837347,193.20019045088668,0.23006143252142197,0.14527129186096488,-0.08479014066045709,700383359,684413590.2,43.424533512411244,29.153608854153983,NaN,NaN,6.593501170969263,-6.688701591232581
2016-05-31T09:30:00-04:00,44.14,44.25,43.93,44.19,12371423,9579580.6,65.08582684230963,51.05039557866899,NaN,NaN,173.82061343233067,214.7055761599957,0.24059347536112172,0.21595170354094506,-0.024641771820176656,712754782,693609590.6,53.03052716383987,31.306130943246256,NaN,NaN,10.180744564617783,-4.278780711825387
2016-06-01T09:30:00-04:00,44.04,44.195,43.97,44.08,6885457,9297293.85,63.15268439290205,52.46585087093768,NaN,NaN,136.9148126978864,201.92204783197909,0.22778715954321319,0.26009217760883985,0.032305018065626655,705869325,699536201,57.98207351954569,33.27537586468723,NaN,NaN,12.590036461647328,-1.8689496870435711
2016-06-02T09:30:00-04:00,43.9,44.04,43.68,44.04,7764500,9123236.1,62.42658016624617,53.93166521524274,NaN,NaN,101.81681417788145,169.4339844848255,0.20497220434849742,0.2885202735012484,0.08354806915275101,698104825,701941526.4,59.83282698915654,35.26192054624044,NaN,NaN,14.37273938908216,0.45129160954581904
2016-06-03T09:30:00-04:00,43.98,44.035,43.7,43.94,8304713,8860475.85,60.552182886974805,55.39910366751118,NaN,NaN,86.4544552430047,141.5809233358953,0.17278379259881016,0.2995278099012637,0.12674401730245355,689800112,701382480.6,59.18037300340557,37.311631392967456,NaN,NaN,15.375508028320986,2.5833225265137
2016-06-06T09:30:00-04:00,43.97,44.175,43.93,44.02,8635585,8830760.8,61.5468967384486,56.284597497261394,NaN,NaN,89.78353915399416,117.75804694101946,0.14750101988053332,0.3111202921531202,0.16361927227258688,698435697,700992948.2,58.70005402426328,39.38466351740722,NaN,NaN,16.489422931704464,4.569908298683809
2016-06-07T09:30:00-04:00,44.16,44.3,44.15,44.2,4409439,8674173.6,63.76109957436352,57.703288360339094,NaN,NaN,95.55439938011922,102.10480413057716,0.13391751436743995,0.3310161652318868,0.19709865086444686,702845136,699011019,56.20072627928843,41.513612395227234,NaN,NaN,18.057565692597247,6.4967164978143
2016-06-08T09:30:00-04:00,44.19,44.36,44.12,44.29,8158477,8386088,64.85091930651409,59.115852368689744,NaN,NaN,89.2855980623228,92.57896120346444,0.12233013784319866,0.3500113231684452,0.22768118532524653,711003613,700037876.6,57.21711890597201,43.80431261504769,NaN,NaN,19.68670230226188,8.381000184163955
2016-06-09T09:30:00-04:00,44.11,44.35,44.08,44.3,12919521,8674460.8,64.9769498459816,60.73358302188071,NaN,NaN,79.87168131941404,88.18993463177097,0.10721709748796593,0.36170255718520394,0.254485459697238,723923134,705201538.4,61.99336082655913,46.51869317167986,NaN,NaN,21.09098087322537,10.196711711172728
2016-06-10T09:30:00-04:00,43.96,44.105,43.81,43.96,8282597,8621759.25,57.436252335577684,61.289478993929734,NaN,NaN,48.792134931496186,80.65747056946927,0.06810593810630888,0.33961788233012413,0.27151194422381525,715640537,710369623.4,66.07548723230104,49.425303540111486,NaN,NaN,20.35668765824531,11.64813684646881
2016-06-13T09:30:00-04:00,43.57,43.83,43.46,43.47,11852077,8668295.35,48.66997564482549,61.293712256638365,NaN,NaN,7.323287778159115,64.16542029430227,0.006275617460621219,0.27935646604959175,0.2730808485889705,703788460,711440176,66.86930456820448,52.464773808272,NaN,NaN,17.010324138036587,12.414163602407065
2016-06-14T09:30:00-04:00,43.37,43.64,43.26,43.57,8420593,8769616.6,50.33591846439,60.73977473657528,NaN,NaN,-8.381289691124692,43.37828248005347,-0.02891526749325707,0.23693676422239918,0.26585203171565625,712209053,713312959.4,68.2681402759398,55.393287283157804,NaN,NaN,14.708385717605212,12.741909618863943
2016-06-15T09:30:00-04:00,43.64,43.725,43.41,43.46,7078108,8626518.6,48.47228920711006,59.845163255658846,NaN,NaN,-10.839464882943687,23.353269891000174,-0.05890011156581898,0.19222689225838252,0.2511270038242015,705130945,712138425.8,66.37533701962045,58.00053022726837,NaN,NaN,12.235908141287846,12.669623693495929
2016-06-16T09:30:00-04:00,43.24,43.62,43,43.55,9596270,8561145.9,50.10014276526608,58.97301743760814,NaN,NaN,-40.33816933418256,-0.6887002397191495,-0.07115227696579024,0.16218665761696371,0.23333893458275395,714727215,710299242,63.41055135085869,59.897172476526144,NaN,NaN,10.598256348010668,12.37371407271232
2016-06-17T09:30:00-04:00,43.25,43.35,42.855,43.05,11465214,8702664.25,42.13598563255886,57.39312170024777,NaN,NaN,-105.58401744396895,-31.563930714812177,-0.10913791537743109,0.09691654036096509,0.20605445573839618,703262001,707823534.8,59.55435683692841,61.04930271399166,NaN,NaN,6.577599221563564,11.545697665405354
2016-06-20T09:30:00-04:00,43.43,43.605,43.22,43.23,6855969,8751810.85,45.49509123884878,55.993783442857705,NaN,NaN,-73.79076346136861,-47.786740962717715,-0.1176167674172574,0.05903349646682443,0.17665026388408184,710117970,709089436.8,60.864894193916854,61.60890035899716,NaN,NaN,4.204338668575377,10.496932094429644
2016-06-21T09:30:00-04:00,43.36,43.63,43.32,43.53,5743865,8617619.35,50.63834811880423,55.09990228042215,NaN,NaN,-61.683804891036765,-58.44724400270013,-0.0992306699036225,0.05261192650455371,0.1518425964081762,715861835,709819993.2,61.637438862560025,61.86999788349818,NaN,NaN,3.7279482359449707,9.529934400360405
2016-06-22T09:30:00-04:00,43.54,43.7,43.33,43.38,6495250,8469307.2,48.18977978798648,54.08298796768931,NaN,NaN,-71.68481903185223,-70.61631483248183,-0.09346175403262275,0.035015403867397765,0.1284771579000205,709366585,710667121.2,62.560368564055395,62.06482228170524,NaN,NaN,2.5870630906278116,8.538095641827178
2016-06-23T09:30:00-04:00,43.66,44.01,43.5,43.97,9763425,8465382.2,56.99764018942546,53.8290920607215,NaN,NaN,8.06670487557544,-60.93533999053024,-0.048465369814560816,0.06789544563181948,0.1163608154463803,719130010,711547680.2,63.542219067203206,62.376382714833646,NaN,NaN,4.47165126870713,7.957175017095743
2016-06-24T09:30:00-04:00,42.42,43.138,42.19,42.28,23623029,9320676.5,37.38986680479,52.10358992260302,NaN,NaN,-220.31155761841686,-83.88084802541982,-0.12663456433554882,-0.041932389973055706,0.0847021743624931,695506981,709996676.2,60.531076351960806,62.50717002395489,NaN,NaN,-2.0474312130940144,6.527945555640064
2016-06-27T09:30:00-04:00,41.97,41.97,41.26,41.43,18516994,9857125.3,31.517193451706916,49.800453770984696,NaN,NaN,-301.14266818532707,-129.3512289702115,-0.22400833575664097,-0.19530824533330815,0.02870009042333284,676989987,703371079.6,49.69691809284593,62.04261229635186,NaN,NaN,-9.84243920039834,4.189319161920292
2016-06-28T09:30:00-04:00,41.89,42.25,41.82,42.25,13244697,9900789,41.12439535201325,48.10570205994892,NaN,NaN,-184.58345601330583,-153.93115919466533,-0.22122861103890537,-0.24783567337529888,-0.026607062336393504,690234684,698245649.4,43.24818139296261,61.04483104542262,NaN,NaN,-11.66259315273262,1.9247602598270186
2016-06-29T09:30:00-04:00,42.54,42.97,42.525,42.9,10504239,10081728.1,47.421070586181486,46.851710684248914,NaN,NaN,-81.29346999914246,-155.8528893881234,-0.16616511109447363,-0.23431345120448555,-0.06814834011001192,700738923,696520117,41.30494893555704,59.56708733892247,NaN,NaN,-10.348314927805948,0.17146380445088072
2016-06-30T09:30:00-04:00,43,43.39,42.9,43.37,13355324,10361269.3,51.46325176393696,46.425067786274575,NaN,NaN,-23.481522490162565,-162.16253486127098,-0.09232612898545237,-0.18355600134182737,-0.091229872356375,714094247,695512964.4,40.17040845343315,57.71672456900334,NaN,NaN,-7.7247724565271865,-0.9565699471174145
2016-07-01T09:30:00-04:00,43.4,43.602,43.34,43.47,7474705,10319768.9,52.30344251557003,46.684601134184895,NaN,NaN,11.867596590278614,-115.7267040195319,-0.033991905541419176,-0.13371975428314897,-0.0997278487417298,721568952,700725358.6,48.113648680835745,56.377034862762706,NaN,NaN,-5.498796911692259,-1.6054595134852494
2016-07-05T09:30:00-04:00,43.24,43.3,43.02,43.15,8680740,10322026.65,49.358967024648784,46.6148188884891,NaN,NaN,-24.52854771737427,-60.403879925941304,-0.015159685212005863,-0.11867745525673712,-0.10351777004473126,712888212,707905003.6,56.650802766066626,55.547225040628916,NaN,NaN,-4.785050533955445,-2.059686802123849
2016-07-06T09:30:00-04:00,43.01,43.46,42.86,43.45,7850842,10494096.8,52.08247117833464,46.87268902929086,NaN,NaN,-4.698067632852785,-24.426802249850695,0.017527732293734097,-0.08160810467756363,-0.09913583697129773,720739054,714005877.6,62.32366692070798,55.25782003356374,NaN,NaN,-3.293123563767624,-2.235892053787245
2016-07-07T09:30:00-04:00,43.41,43.65,43.29,43.45,6166060,10394475.95,52.08247117833464,47.01428391593861,NaN,NaN,33.2433289949932,-1.519442451023561,0.03800054213807988,-0.051635159298697886,-0.08963570143677776,720739054,718005903.8,65.51052935455397,55.40781846239912,NaN,NaN,-2.1412738197259173,-2.2223751632070554
2016-07-08T09:30:00-04:00,43.66,44.16,43.61,44.13,12748165,10385908.15,58.017834962416984,48.148701725214195,NaN,NaN,116.2363945916225,26.424140965333454,0.09305365448854655,0.026681366673905416,-0.06637228781464113,733487219,721884498.2,68.30962821226424,56.03319498920882,NaN,NaN,0.8241298233131978,-1.7871601651327336
2016-07-11T09:30:00-04:00,44.27,44.485,44.23,44.39,5831795,10263368.05,60.055170764935525,49.18870740564896,NaN,NaN,170.98714425719237,58.2480504987162,0.13987954849287992,0.10847714780145878,-0.031402400691421146,739319014,725434510.6,70.65697261754177,56.73262916232489,NaN,NaN,3.8867968388079377,-0.9765948788554948
2016-07-12T09:30:00-04:00,44.69,44.81,44.55,44.75,16042816,10472905,62.75061718353973,50.0538694817015,NaN,NaN,193.95269956323773,101.94429995483861,0.18515704328175517,0.20004390341077283,0.014886860129017652,755361830,733929234.2,75.36015224559021,57.71282297539847,NaN,NaN,7.299301084430058,0.20567597304244134
2016-07-13T09:30:00-04:00,44.88,44.91,44.734,44.76,10609441,10582347.4,62.82565766483411,51.09928933004776,NaN,NaN,177.99181826420778,138.48227713425072,0.20433231765427978,0.2703022571968674,0.06596993954258762,765971271,742975677.6,79.18620698917482,58.90038286290701,NaN,NaN,10.030652669470683,1.6092440725321902
2016-07-14T09:30:00-04:00,45.01,45.15,44.91,45.05,15488264,11002855.2,65.02606798075138,51.6727484579996,NaN,NaN,173.8770880216615,166.60902893958436,0.22354525757046068,0.34540151150566345,0.12185625393520279,781459535,755119773.8,83.00198699958472,60.29036628664854,NaN,NaN,13.002084575874266,3.2367927158667724
2016-07-15T09:30:00-04:00,45.2,45.2,44.88,45.01,4864805,10766281.95,64.45931638645482,53.60628057097566,NaN,NaN,142.61279820947,171.88430966315386,0.22020529754103396,0.39711287586149524,0.17690757832046128,776594730,763741276,85.09159873483827,62.04468931399693,NaN,NaN,15.272322940194558,4.956154176485027
2016-07-18T09:30:00-04:00,45.08,45.36,45,45.31,4107249,10398383.7,66.79671235829494,56.12624620716053,NaN,NaN,134.78685721265276,164.64425225424594,0.2241008162537003,0.45703359863758664,0.23293278238388634,780701979,772017869,86.77269350743339,64.69295898646746,NaN,NaN,17.90760872502986,6.806361969134289
2016-07-19T09:30:00-04:00,45.23,45.32,45.1439,45.21,4457922,10278481.35,65.25610803884965,57.84993997050598,NaN,NaN,115.94737142244294,149.043186626087,0.20628934672119298,0.49079446578537755,0.2845051190641846,776244057,776194314.4,87.53642988596182,67.85640530739597,NaN,NaN,19.695743763961893,8.647702225538232
2016-07-20T09:30:00-04:00,45.56,45.88,45.5,45.8,5384911,10260533.65,69.69689419776242,59.44107022847604,NaN,NaN,132.49070905350553,139.94296478394654,0.21937007704077655,0.5587177153651552,0.3393476383243787,781628968,779325853.8,88.09164293474237,71.1983120216235,NaN,NaN,22.65217277166328,10.648340874984667
2016-07-21T09:30:00-04:00,45.81,45.87,45.45,45.56,5473385,10209440.4,66.00135220534005,60.47950597429055,NaN,NaN,109.70642580097582,127.1088323398094,0.19765907649980757,0.5864214839491382,0.3887624074493306,776155583,778265063.4,86.68297893731481,74.52063848475791,NaN,NaN,24.092837281539996,12.568983218778286
2016-07-22T09:30:00-04:00,45.53,45.83,45.43,45.83,4707250,9956631.65,68.05357357703457,61.604515335823734,NaN,NaN,100.31468118307842,118.64920893453109,0.18737592313670776,0.6229823113702153,0.43560638823350756,780862833,779118684,86.86500046572475,77.28859218367855,NaN,NaN,25.919116354326167,14.476145095285126
2016-07-25T09:30:00-04:00,45.75,45.855,45.63,45.77,4244901,8987725.25,67.08449963451649,62.87062480795714,NaN,NaN,94.43953226080151,110.57974394416082,0.16330768619099695,0.6397409959722538,0.4764333097812568,776617932,778301874.6,85.65850228877876,79.36057072101514,NaN,NaN,27.156355072908468,16.287603663517032
2016-07-26T09:30:00-04:00,45.82,46.005,45.65,45.87,9057685,8514759.8,67.9048121458779,64.0007920199245,NaN,NaN,94.50532009682831,106.29133367903789,0.14169953762897192,0.6535577318174717,0.5118581941884998,785675617,780188186.6,86.13735870754049,81.0615487057889,NaN,NaN,28.419632715085662,18.02075067088398
2016-07-27T09:30:00-04:00,46.37,46.37,46.03,46.25,10910076,8398028.75,70.87518104120646,65.34312843870107,NaN,NaN,113.42934928344036,102.47906172502488,0.14031204361922278,0.6872482487125282,0.5469362050933054,796585693,783179531.6,86.88520113401643,82.58831097575049,NaN,NaN,30.38719622503149,19.78738575004791
2016-07-28T09:30:00-04:00,46.31,46.415,46.095,46.28,6329670,8189300.3,71.10256098970015,66.27775172636416,NaN,NaN,110.52203494706097,102.64218355424191,0.12901521700658036,0.7082052263515308,0.5791900093449505,802915363,788531487.6,88.12003875267443,84.0033403000655,NaN,NaN,32.07841698664961,21.543247355276723
2016-07-29T09:30:00-04:00,46.48,46.56,46.3099,46.45,10589749,8051021.55,72.41671789235004,67.16071937832234,NaN,NaN,115.56322123323132,105.69189156427248,0.12074003217009432,0.7301150495575683,0.609375017387474,813505112,795059943.4,89.42771355578402,85.34410750993995,NaN,NaN,33.89358152579944,23.307580808208538
2016-08-01T09:30:00-04:00,46.45,46.63,46.365,46.54,7841696,8069371.1,73.1138181885846,67.90094802153983,NaN,NaN,112.77414279835833,109.35881367178385,0.1094119486612759,0.7461399532140689,0.636728004552793,821346808,804005718.6,90.90504365493952,86.45445689632204,NaN,NaN,35.62322651815064,25.066958766771695
2016-08-02T09:30:00-04:00,46.45,46.55,45.97,46.19,11112406,8190954.4,66.11594957645542,68.13596887236993,NaN,NaN,84.64910745537134,107.38757114349247,0.06843506022287937,0.7222718298313922,0.6538367696085128,810234402,808917475.6,91.5991639011879,87.34109667575156,NaN,NaN,35.27635704962474,26.5254442357507
2016-08-03T09:30:00-04:00,46.15,46.35,46.1401,46.35,7980940,8197459.3,67.64071105467787,68.32272909193611,NaN,NaN,82.2567007286323,101.15304143253084,0.04341398265223495,0.7081042479238064,0.6646902652715715,818215342,813243405.4,92.16622817798383,87.9956853313515,NaN,NaN,35.38730451902342,27.791424276218233
2016-08-04T09:30:00-04:00,46.36,46.62,46.32,46.6,8376364,8307974.5,69.91848687909084,68.71266984141012,NaN,NaN,100.63733416950798,99.17610127702025,0.035349984945078905,0.7088777464529201,0.6735277615078412,826591706,817978674,92.743631084962,88.54225907064604,NaN,NaN,36.10936415247843,28.979701401398263
2016-08-05T09:30:00-04:00,46.75,47.07,46.7,47.05,6063052,7973718.85,73.53024837559963,69.19363669978902,NaN,NaN,140.4365684397757,104.15077071832911,0.05102004746534061,0.7373028208395169,0.6862827733741763,832654758,821808603.2,93.18138972597497,89.00002308625616,NaN,NaN,37.82806432162347,30.24375324714472
2016-08-08T09:30:00-04:00,47.1,47.22,46.94,47.04,5219585,7943108.35,73.3195741096996,69.7695985619926,NaN,NaN,140.07462392145945,109.61086694294936,0.05127229819553725,0.7503731461185978,0.6991008479230606,827435173,823026276.2,93.31938257749087,89.4130911356511,NaN,NaN,39.167879503058195,31.51862842656093
2016-08-09T09:30:00-04:00,47.04,47.26,47.04,47.14,14918477,7886891.4,74.11816651995251,70.08540372786331,NaN,NaN,133.6057799093047,119.40220143373604,0.0487508228693021,0.7600393765096882,0.7112885536403861,842353650,829450125.8,94.00829001880695,89.83570878451285,NaN,NaN,40.518180789606475,32.804278764138864
2016-08-10T09:30:00-04:00,47.16,47.18,46.93,46.99,3556299,7534234.3,70.69974052077879,70.42100289325178,NaN,NaN,111.17480581874202,125.18582245175796,0.028557480749026753,0.7469854045766695,0.7184279238276428,838797351,833566527.6,94.40634839390782,90.38737803141235,NaN,NaN,40.75207695878097,33.93967850623059
2016-08-11T09:30:00-04:00,47.14,47.29,47.09,47.16,5259325,7022787.35,72.2612027631943,70.72154783512035,NaN,NaN,119.99740264921644,129.05783614769967,0.018702887391502054,0.7418065330670203,0.7231036456755182,844056676,837059521.6,94.72650278760004,90.94891391154628,NaN,NaN,41.37570219004571,35.001967603918466
2016-08-12T09:30:00-04:00,47.15,47.15,47.01,47.11,3468714,6952982.8,71.0616996549036,71.00563355086227,NaN,NaN,100.88469585738035,121.14746163122061,0.001762501827906382,0.7253067729604012,0.7235442711324949,840587962,838646162.4,94.87012972412687,91.60688729978544,NaN,NaN,41.583315370360005,35.942160141981546
2016-08-15T09:30:00-04:00,47.17,47.43,47.135,47.34,8280742,7161657.45,73.26052897003765,71.38818475258797,NaN,NaN,115.49378564525385,116.23129397597947,-0.0008661492411748961,0.7224615845810263,0.7233277338222012,848868704,842932868.6,95.24679332950578,92.25756120135439,NaN,NaN,42.35861741218348,36.85879689486754
2016-08-16T09:30:00-04:00,47.26,47.26,46.99,46.99,4538978,7165710.25,65.14819572285728,70.9791143727059,NaN,NaN,79.43214082907434,105.3965661599334,-0.031398955045709886,0.6840790400150638,0.7154779950607737,844329726,843328083.8,95.28119455796569,92.85727501735077,NaN,NaN,40.72896598030388,37.411678192787015
2016-08-17T09:30:00-04:00,47.01,47.03,46.7,46.97,5287546,7160842,64.70725990673714,70.52230715249425,NaN,NaN,48.44858936007855,92.8513228682007,-0.05668957068203362,0.6446160317082317,0.7013056023902653,839042180,843377049.6,95.28574699595168,93.36911132044202,NaN,NaN,39.26408829127857,37.676308206857236
2016-08-18T09:30:00-04:00,46.96,47.04,46.815,46.99,3543209,7064333.2,64.96264116876522,69.98987310080962,NaN,NaN,48.70981782005626,78.59380590236867,-0.07468679366520092,0.6079471103087641,0.6826339039739651,842585389,843082792.2,94.69451759175257,93.74531160872547,NaN,NaN,38.10602004197836,37.73769561187454
2016-08-19T09:30:00-04:00,46.86,47.0599,46.75,47.02,4788309,7068386.15,65.36746297710343,69.43656201427525,NaN,NaN,42.08901296443054,66.83466932377871,-0.08636081231355774,0.5746828885820179,0.6610437008955756,847373698,844439939.4,94.85313650755452,94.02731824105513,NaN,NaN,37.22556550251522,37.66453416768035
2016-08-22T09:30:00-04:00,46.89,47.0699,46.81,47.02,4628665,7087574.35,65.36746297710343,69.38309868575011,NaN,NaN,40.40807347121257,51.81752688897046,-0.09517729379200546,0.5420720836555688,0.6372493774475743,847373698,844140938.2,94.18503467978408,94.21202329666914,NaN,NaN,36.479137250155205,37.495191750891046
2016-08-23T09:30:00-04:00,47.16,47.3,47.15,47.19,8315308,7050455.5,67.81161785207962,69.39530631413595,NaN,NaN,82.42183822018254,52.415466367192096,-0.09067462065046361,0.5239061016344948,0.6145807222849584,855689006,846412794.2,94.50191479137402,94.37885805476844,NaN,NaN,36.41603733145733,37.34102683382908
2016-08-24T09:30:00-04:00,47.17,47.19,46.82,46.93,6824434,6846173.4,60.75006416205739,68.74041897720498,NaN,NaN,29.83870842658747,48.69349018049388,-0.10529472663394812,0.4829623139925232,0.5882570406264713,848864572,848377272.6,94.76744433636964,94.5234161441547,NaN,NaN,34.444347032107494,36.92721543358314
2016-08-25T09:30:00-04:00,46.85,47.09,46.77,47.03,5912652,6825322.5,62.37302055552758,67.94347413291413,NaN,NaN,20.82234487008646,43.11599559049992,-0.10791986303368462,0.4533572118343656,0.5612770748680502,854777224,850815639.6,95.08475389177973,94.65937072742648,NaN,NaN,33.16955808176271,36.39040724046594
2016-08-26T09:30:00-04:00,47,47.39,46.795,47.05,12113571,6901513.6,62.70516824167007,67.18530228519774,NaN,NaN,49.47216896789863,44.59262679119354,-0.10774861279921188,0.4265913088690354,0.5343399216682473,866890795,854719059,95.5499780649961,94.81869897653401,NaN,NaN,32.179786631573336,35.78889001062414
2016-08-29T09:30:00-04:00,47.03,47.3,47.03,47.23,6982772,6858567.4,65.64454198722905,66.58004339000318,NaN,NaN,81.9675811920838,52.904528335367786,-0.09537721172299496,0.41511840701450353,0.5104956187374985,873873567,860019032.8,96.09097919963632,94.9674624894504,NaN,NaN,32.067798588580594,35.25730552176077
2016-08-30T09:30:00-04:00,47.14,47.24,46.91,47.07,5718155,6588854.85,61.0393452749336,65.8900151581571,NaN,NaN,34.840703510386625,43.388301393408604,-0.0974881434822274,0.38863543938471423,0.48612358286694163,868155412,862512314,96.31777183264259,95.1039927350743,NaN,NaN,30.707325264093132,34.607308342093965
2016-08-31T09:30:00-04:00,47.01,47.06,46.84,46.99,11161161,6747865.9,58.81751478896502,64.92975173142644,NaN,NaN,-38.14368941143931,29.791821825803247,-0.10323805405809894,0.357076015294318,0.4603140693524169,856994251,864138249.8,96.46193157708556,95.22795193432327,NaN,NaN,28.93695129893234,33.797257335928016
2016-09-01T09:30:00-04:00,46.98,47.18,46.77,47.14,9239600,6791027.7,61.63717992951536,64.25657175104156,NaN,NaN,-18.490556445265867,21.929241562732784,-0.09605402315767958,0.34024654040531743,0.436300563562997,866233851,866429575.2,96.6603587668311,95.35582543737358,NaN,NaN,28.13998807404343,32.98907601280165
2016-09-02T09:30:00-04:00,47.37,47.48,47.14,47.35,6907176,6833233.9,65.22675412467918,63.68273069065881,NaN,NaN,177.384095619329,47.51162689301885,-0.07709186070527685,0.33993573768140095,0.4170275983866778,873141027,867679621.6,96.7668906004272,95.46440381386797,NaN,NaN,28.447939080169892,32.34034216528283
2016-09-06T09:30:00-04:00,47.38,47.59,47.32,47.59,15107377,7327623.5,68.81776173577619,63.94484254872445,NaN,NaN,227.59054834864838,76.63622032433177,-0.049651183606502336,0.3549636188785499,0.4046148024850522,888248404,870554589,97.00362795906535,95.58743477108938,NaN,NaN,29.800402981978063,31.977493710525003
2016-09-07T09:30:00-04:00,47.59,47.72,47.46,47.71,11584977,7160948.5,70.46035864073312,64.3557781725813,NaN,NaN,226.96012430326846,115.06010448290813,-0.025879777987878327,0.3722650800002043,0.39814485798808263,899833381,876890182.8,97.4472331618209,95.74182664008003,NaN,NaN,31.43537216575481,31.900047775557834
2016-09-08T09:30:00-04:00,47.54,47.55,47.195,47.32,8302600,7398263.55,59.491814784855414,63.96500485944489,NaN,NaN,91.11006038887143,140.91085444297028,-0.03814236030836182,0.35046690760263033,0.38860926791099215,891530781,883797488.8,97.82525381412832,95.96545065596402,NaN,NaN,29.430523120763013,31.547258539158573
2016-09-09T09:30:00-04:00,46.89,47.055,46.16,46.16,16809191,7975756.85,39.697351670831004,62.13142548042543,NaN,NaN,-235.3780820274388,97.5333493265357,-0.12140019033157501,0.23685902999652342,0.3582592203280984,874721590,885495036.6,97.90727290922159,96.18360325608309,NaN,NaN,18.910042254560796,29.741941927073178
2016-09-12T09:30:00-04:00,45.93,47.03,45.86,46.93,19010477,8752845,51.28438203408175,61.125491127352454,NaN,NaN,-156.7165843626954,30.713213330130817,-0.12134716642289983,0.20657526229947365,0.3279224287223735,893732067,889613244.6,98.09497850711432,96.46288495803526,NaN,NaN,15.206559911773088,27.665458782030306
2016-09-13T09:30:00-04:00,46.75,46.9163,46.4,46.59,17358765,9206746.15,46.990784524176654,59.63828874678796,NaN,NaN,-131.23975030098413,-41.05284639979568,-0.13964032496939988,0.15337202251062365,0.2930123474800235,876373302,887238224.2,92.91876923115375,96.34980313230524,NaN,NaN,10.65962953542464,25.236054603943785
2016-09-14T09:30:00-04:00,46.6,47.1,46.59,46.81,17108742,9835234.35,49.91285653799509,58.86420248792637,NaN,NaN,-61.519630718044446,-98.74879740405827,-0.13241739737033603,0.1274906007671035,0.25990799813743953,893482044,885967956.8,90.1779652667318,96.02198319875967,NaN,NaN,8.435375518402664,22.835957591723627
2016-09-15T09:30:00-04:00,46.91,47.67,46.81,47.58,16319148,10386814.45,58.52939181271508,58.589657577725475,NaN,NaN,89.47579340650276,-99.075650800532,-0.07417859797042473,0.16718475067440863,0.24136334864483336,909801192,889622039,91.00033776635556,95.73023918980081,NaN,NaN,10.119868387365054,21.0193734196724
2016-09-16T09:30:00-04:00,47.4,47.4,47,47.21,15883059,11003806.95,53.74486426999731,57.94963586546313,NaN,NaN,40.70326526512994,-43.85938134201824,-0.05960008128959207,0.16686324703284328,0.22646332832243535,893918133,893461347.6,91.77916714264555,95.46089555249004,NaN,NaN,9.523348787536696,19.377084186510157
2016-09-19T09:30:00-04:00,47.33,47.56,46.99,47.12,7121315,11120457.25,52.618118767292145,57.01917706403907,NaN,NaN,42.27058086939845,-4.06194829559948,-0.055146427401044584,0.15753029407112962,0.2126767214721742,886796818,892074297.8,88.78964250466478,94.93937150284923,NaN,NaN,8.674702757703527,17.848172553823495
2016-09-20T09:30:00-04:00,47.28,47.37,47.0266,47.09,5001096,11139078.8,52.22508357822405,56.38958694284553,NaN,NaN,21.66115826174466,26.51823341694628,-0.05331755956358081,0.14602977201769818,0.19934733158127899,881795722,893158781.8,89.08889819074008,94.42302338557047,NaN,NaN,7.900823856105554,16.42712273986379
2016-09-21T09:30:00-04:00,47.27,47.65,47.09,47.62,12047883,11325707.55,58.169730668790095,56.34331664854732,NaN,NaN,98.62125692342096,58.54641094523936,-0.017370315805311287,0.17763443682463986,0.19500475262995115,893843605,893231094,89.10977350249595,93.89786923738549,NaN,NaN,9.29326617552024,15.408000373528997
2016-09-22T09:30:00-04:00,47.9,47.965,47.79,47.91,10498539,11509412.8,61.02727959467091,56.29975233891558,NaN,NaN,185.17763179640775,77.68677862322035,0.022800602226656308,0.22350550541327152,0.2007049031866152,904342144,892139284.4,86.42130351890597,93.16650814824798,NaN,NaN,11.395851630253476,14.83483626734678
2016-09-23T09:30:00-04:00,47.9,47.9,47.41,47.49,11986538,11813107.1,55.15112313236968,55.58006441089346,NaN,NaN,101.96211993575268,89.93854955734488,0.018150503069577495,0.22339303202358707,0.20524252895400957,892355606,891826779,85.62500526324857,92.37065919559237,NaN,NaN,11.17019764345916,14.311316463934263
2016-09-26T09:30:00-04:00,47.29,47.372,47.12,47.21,9620379,11688447.5,51.58507784112559,54.349158418418426,NaN,NaN,11.835123640126994,83.85145811149059,-0.005455671185950417,0.19842293997157157,0.20387861115752198,882735227,891014460.8,83.47198056956596,91.40411295348527,NaN,NaN,9.80324875643758,13.667306791434736
2016-09-27T09:30:00-04:00,47.27,47.75,47.15,47.73,8784549,11778536.35,57.129101499924545,53.396925765503525,NaN,NaN,79.06306654234773,95.33183976761123,0.011360894221171536,0.21807972893398642,0.20671883471281488,891519776,892959271.6,84.47827319974974,90.47775867048018,NaN,NaN,10.523578374377198,13.218202731855088
2016-09-28T09:30:00-04:00,47.77,47.84,47.52,47.82,9048720,11945064.6,58.02500319426775,53.29215350903298,NaN,NaN,108.5775212459583,97.32309263211869,0.02516460836594797,0.23817459517024986,0.2130099868043019,900568496,894304249.8,85.1515700498703,89.57249554446174,NaN,NaN,11.376495581852195,12.955101710426103
2016-09-29T09:30:00-04:00,47.76,47.877,47.39,47.53,11406897,11957351.4,54.10172540270375,54.32103734702389,NaN,NaN,72.96141674393665,74.87984962162446,0.012048244719636558,0.2280702927038476,0.21602204798421104,889161599,891268140.8,77.02876077395685,88.0811732490857,NaN,NaN,10.846027758434316,12.653805431570133
2016-09-30T09:30:00-04:00,47.64,47.925,47.6,47.78,9255328,11958137.8,56.81264823312237,54.71591350409822,NaN,NaN,100.24339793904632,74.5361052222832,0.01718055737325125,0.23749774470077512,0.22031718732752387,898416927,892480405,77.93387676840128,86.64109455346333,NaN,NaN,11.252134751259941,12.453566762954392
2016-10-03T09:30:00-04:00,47.65,47.76,47.5262,47.64,6231442,11924351.1,54.85858719995682,55.27789940951108,NaN,NaN,66.72627615183913,85.51433572462562,0.008553695631599079,0.2310093068670227,0.22245561123542362,892185485,894370456.6,79.30313525301639,85.66854926931067,NaN,NaN,10.997503646518926,12.245557746320754
2016-10-04T09:30:00-04:00,47.8,47.875,47.3034,47.47,8902234,11614093.95,52.497368603687924,55.46250741420342,NaN,NaN,46.69185064387205,79.04009254493049,-0.010178941230906291,0.20973193469679074,0.21991087592769704,883283251,892723151.6,74.93848594234397,84.5800150318544,NaN,NaN,10.091562651449463,11.937844161339141
2016-10-05T09:30:00-04:00,47.6,47.75,47.55,47.64,9007846,11485237.4,54.601707942118665,55.18195856630369,NaN,NaN,66.44727581103908,70.61404345794664,-0.012542480815154938,0.20423277490875336,0.2167752557239083,892291097,891067671.8,70.72568707310245,83.13182569662203,NaN,NaN,9.937082883672264,11.652021121672444
2016-10-06T09:30:00-04:00,47.68,47.795,47.47,47.75,5005874,11320401.1,55.96115552925394,55.34026508482202,NaN,NaN,65.76169377620029,69.17409886439937,-0.008322759675131658,0.20637180612999373,0.2146945658051254,897296971,892694746.2,72.36975142404677,81.74543885957927,NaN,NaN,10.190025927856695,11.443164665413052
2016-10-07T09:30:00-04:00,47.79,47.85,47.39,47.62,6073940,10783638.55,53.90668037873358,55.43230519992498,NaN,NaN,50.462052581921064,59.21782979297431,-0.015495253070429482,0.19532549946708855,0.21082075253751803,891223031,891255967,68.69579759754808,80.31016422335665,NaN,NaN,9.83983633268544,11.214117760737679
2016-10-10T09:30:00-04:00,47.87,48.06,47.84,47.95,6657950,10166012.2,58.11076913626259,55.85271131121345,NaN,NaN,123.2088474359455,70.51434404979558,-0.00004072970458213199,0.21076984040679037,0.2108105701113725,897880981,892395066.2,69.99455708843439,78.94628271604908,NaN,NaN,10.726141078127144,11.144406806079031
2016-10-11T09:30:00-04:00,47.95,48.01,47.2,47.41,8727329,9734440.4,50.06396173682877,55.273727816073354,NaN,NaN,9.345646754765431,63.045103271974256,-0.0267354569333767,0.17739124894465164,0.20412670587802834,889153652,893569146.4,71.31552973808384,77.67526530430537,NaN,NaN,9.080987027891602,10.849632552052256
2016-10-12T09:30:00-04:00,47.45,47.62,47.205,47.49,5520367,9155021.65,51.14333513545887,54.56773178327249,NaN,NaN,-39.72326594831629,41.810994920103184,-0.03882124907459841,0.15560014453478033,0.19442139360937874,894674019,894045730.8,71.85714229012919,76.63496807367845,NaN,NaN,8.057960081239266,10.450822199078972
2016-10-13T09:30:00-04:00,47.18,47.34,46.79,47.19,9669204,8822524.45,47.03735825034476,53.988177148842134,NaN,NaN,-149.75485974356414,-1.2923157838496864,-0.0652791173015122,0.11282249698248847,0.17810161428400068,885004815,891587299.6,65.035409757688,75.16428268042411,NaN,NaN,5.943919552940779,9.806978963916373
2016-10-14T09:30:00-04:00,47.38,47.69,47.33,47.37,9448281,8500785.55,49.64933095371996,53.84990951402745,NaN,NaN,-30.419669505724254,-17.468660201378754,-0.06857689626813035,0.09238049394883774,0.1609573902169681,894453096,892233312.6,65.95017060517378,73.91272482582467,NaN,NaN,4.930000572632147,9.110267765161485
2016-10-17T09:30:00-04:00,47.37,47.465,47.24,47.27,5075076,8398473.6,48.22636120469284,53.21399949293947,NaN,NaN,-89.37704097491294,-59.98583788355044,-0.07489815019980331,0.06733470246721396,0.14223285266701727,889378020,890532720.4,61.39645377309983,72.26402343820683,NaN,NaN,3.682430808628714,8.334862485656803
2016-10-18T09:30:00-04:00,47.62,47.74,47.47,47.53,5058937,8401365.65,52.072500996912524,52.78882076455695,NaN,NaN,5.825149128857033,-60.68993740873211,-0.05963802207964719,0.06768532506745828,0.12732334714710547,894436957,891589381.4,63.10128547708016,70.68900311157897,NaN,NaN,3.7034845976474307,7.673237073084035
2016-10-19T09:30:00-04:00,47.5,47.67,47.41,47.62,5034977,8050720.35,53.36399258885247,52.736125563567576,NaN,NaN,-3.026400669562442,-53.35056435298135,-0.042364138655632017,0.07436817382756544,0.11673231248319746,899471934,892548964.4,64.6289696266985,69.80330374391767,NaN,NaN,4.083881133191597,7.160471938813687
2016-10-20T09:30:00-04:00,47.5,47.52,47.17,47.4,6148003,7833193.55,49.82926345997313,52.23731236548549,NaN,NaN,-89.91103354056126,-41.38179911238077,-0.04442051727500321,0.06120666588944346,0.10562718316444666,893323931,894212787.6,67.16724630002156,69.03425871046196,NaN,NaN,3.420182832636502,6.626144923645517
2016-10-21T09:30:00-04:00,47.47,47.56,47.34,47.53,8076945,7637713.9,51.85850054923421,52.02302046186244,NaN,NaN,-30.93029710384559,-41.48392463200504,-0.0360475052081336,0.06056780165427966,0.09661530686241326,901400876,895602343.6,69.15787000828041,68.30959690726654,NaN,NaN,3.4213710727975544,6.168320087810094
2016-10-24T09:30:00-04:00,47.78,48.02,47.74,47.99,5393134,7426351.65,58.28755526222835,52.43660522318676,NaN,NaN,165.90982599131834,9.573448761241217,-0.00043449162243022754,0.09607219233437547,0.0965066839568057,906794010,899085541.6,73.4958070091451,68.20654841203805,NaN,NaN,5.355395226315272,6.052187964739405
2016-10-25T09:30:00-04:00,48.06,48.06,47.73,47.82,4362405,7205244.45,55.345919550457175,52.489763195210934,NaN,NaN,123.92205638473351,33.19283021241652,0.010180996258041766,0.1092329292793579,0.09905193302131614,902431605,900684471.2,75.21885031062727,68.52748864328983,NaN,NaN,6.119798728005896,6.061846645206046
2016-10-26T09:30:00-04:00,47.42,47.805,47.4,47.55,6279706,7066793.75,50.94807052300361,52.131685694764485,NaN,NaN,0.49262997582655316,33.896636341494315,-0.0018329330385779968,0.09676076672309364,0.09859369976167164,896151899,900020464.2,73.0937004812323,68.57919929023164,NaN,NaN,5.469608805110175,5.977241239478064
2016-10-27T09:30:00-04:00,47.76,47.77,47.43,47.49,8821067,6937502.25,49.997304894600774,51.852444588755006,NaN,NaN,-8.771112477722742,50.12462055406202,-0.013994865564455755,0.08110011780610193,0.09509498337055769,887330832,898821844.4,69.28816814913665,68.62151147248798,NaN,NaN,4.663531261438174,5.789568385472366
2016-10-28T09:30:00-04:00,47.62,47.93,47.32,47.44,10418875,6995679.6,49.17376875258996,51.214087418492674,NaN,NaN,-4.283375326401732,55.45400490955079,-0.02494194127982026,0.06391755677078237,0.08885949805060263,876911957,893924060.6,56.37277267333842,67.6485268714097,NaN,NaN,3.767339060372097,5.500678481886613
2016-10-31T09:30:00-04:00,47.56,47.63,47.42,47.42,5879960,6978105.5,48.82731633281611,51.12575560392035,NaN,NaN,-37.30516535633937,14.81100664001924,-0.03258232683991183,0.048131589500712835,0.08071391634062466,871031997,886771658,43.59347140423601,65.66837984756344,NaN,NaN,2.929200310635523,5.133324457422171
2016-11-01T09:30:00-04:00,47.52,47.57,46.6856,47.01,9065290,6986258.3,42.25489134486614,50.49086676173515,NaN,NaN,-191.08760585456463,-48.19092580784039,-0.06256424861101426,0.002508605576856837,0.0650728541878711,861966707,878678678.4,34.15786856416399,62.97557458142307,NaN,NaN,0.24686236147892907,4.435258443715994
2016-11-02T09:30:00-04:00,47.01,47.15,46.5955,46.71,8167290,6944230.5,38.202792978693665,49.85982638518864,NaN,NaN,-235.56232798233864,-95.40191739947343,-0.09781517097170231,-0.0571961095267568,0.04061906144494551,853799417,870208182,27.458794672786624,60.29153064678725,NaN,NaN,-3.346586774483884,3.32356626968744
2016-11-03T09:30:00-04:00,46.58,46.68,46.24,46.26,10125726,7200223.1,33.078594115395674,48.67620232530834,NaN,NaN,-275.7939158432376,-148.80647807257637,-0.14387039823693254,-0.13921893635122018,0.004651461885712367,843673691,861476753.8,22.549472809329203,57.19148080422692,NaN,NaN,-8.25237674575095,1.6698601246248128
2016-11-04T09:30:00-04:00,46.22,46.55,46.0634,46.18,8153967,7304224.45,32.25040746944093,47.53506277279035,NaN,NaN,-228.70113510485615,-193.69003002826724,-0.1703428180341558,-0.20827706065698237,-0.03793424262282658,835519724,853198307.2,19.06847163592768,54.16805350871463,NaN,NaN,-12.475013830298776,-0.35083615464998563
2016-11-07T09:30:00-05:00,46.86,47.2,46.75,47.18,13225998,7632626.85,49.32850808977392,47.33906327942331,NaN,NaN,-57.827756426508714,-197.79454824230112,-0.11384206284090372,-0.18023682117395623,-0.06639475833305251,848745722,848741052.2,17.501880040938246,50.910953120418775,NaN,NaN,-10.552934955076328,-1.8082788404251773
2016-11-08T09:30:00-05:00,47.09,47.605,47.04,47.41,9780031,7685261.95,52.30637789489097,47.26351937271177,NaN,NaN,8.057057515557517,-157.96561556827672,-0.05717732402194545,-0.13786641336048433,-0.08068908933853888,858525753,848052861.4,17.266017941504572,47.52788514290493,NaN,NaN,-7.980439546084455,-2.6900160840907885
2016-11-09T09:30:00-05:00,46.69,47.43,46.44,47.35,27129429,8765715.05,51.45681985375317,47.379773400838914,NaN,NaN,-45.11469341787707,-119.8760886553844,-0.021757066506110978,-0.1078854224711776,-0.08612835596506663,831396324,843572242.8,15.775395951068433,43.85703868940827,NaN,NaN,-6.262512425056355,-3.2003727042287267
2016-11-10T09:30:00-05:00,47.62,47.62,45.94,46.59,39515508,10258030.25,42.123962103693025,46.684449226157405,NaN,NaN,-105.52662235049308,-85.82262995683548,-0.04613200264204745,-0.14379335926762593,-0.09766135662557848,791880816,833213667.8,12.984480736358506,39.84465374141384,NaN,NaN,-8.016462416841982,-3.8883855203163344
2016-11-11T09:30:00-05:00,46.33,46.83,46.33,46.73,14091551,10490193.75,44.1340632721538,45.67348551258065,NaN,NaN,-104.75690800979771,-61.03378453782379,-0.049166591702141396,-0.15911959625325522,-0.10995300455111383,805972367,827304196.4,11.71152546079999,35.431490773674916,NaN,NaN,-8.699733257534495,-4.5757209113475
2016-11-14T09:30:00-05:00,46.77,46.8,45.8,46.02,18970968,11184988.35,37.097252586643975,44.37000930087971,NaN,NaN,-148.26671957864076,-79.1215771682502,-0.09279934011050439,-0.2259521796892443,-0.1331528395787399,787001399,814955331.8,9.594708044255668,30.744052040362657,NaN,NaN,-11.852383366934584,-5.615244119288512
2016-11-15T09:30:00-05:00,46.33,46.8327,46.31,46.67,17370846,11800583.8,45.64210006218883,43.99101141082151,NaN,NaN,-78.59256265561295,-96.45150120248431,-0.07258739625055019,-0.22388708489192766,-0.15129968864137747,804372245,804124630.2,8.195562358965006,26.10847074591499,NaN,NaN,-11.326414673987596,-6.431125627102666
2016-11-16T09:30:00-05:00,46.56,47.13,46.5,47.1,10124244,12055047.15,50.43853560685522,44.02252789026825,NaN,NaN,-28.827580804429438,-93.19407867979479,-0.027292824330745508,-0.18541571905480936,-0.15812289472406385,814496489,800744663.2,7.812674616522401,21.71736406501397,NaN,NaN,-9.136542592479893,-6.817613765013699
2016-11-17T09:30:00-05:00,47.16,47.44,47.0501,47.4,8524101,12173852.05,53.52001591024488,44.332974115815034,NaN,NaN,31.745091182636063,-65.73973597316896,0.023114546191082413,-0.12922971198521083,-0.15234425817629324,823020590,806972618,15.633958536676104,18.80744876953809,NaN,NaN,-6.313015898612802,-6.745528355527857
2016-11-18T09:30:00-05:00,47.51,47.61,47.265,47.36,8822991,12211154.35,53.04643424289875,44.634339680820936,NaN,NaN,50.60240679667655,-34.66787301187411,0.052333393743925594,-0.08692751599638626,-0.13926090974031186,814197599,808617664.4,17.62204481349528,16.952346870199463,NaN,NaN,-4.3040265578755506,-6.3967423844346705
2016-11-21T09:30:00-05:00,47.53,47.8775,47.46,47.84,8975710,12390283.15,57.86469918200161,45.74932595490204,NaN,NaN,103.87636818121787,15.760744540097615,0.09980589211403142,-0.014503544597772589,-0.114309436711804,823173309,815852046.4,25.892641745310556,16.361973525995648,NaN,NaN,-0.9763395676364129,-5.622399124892063
2016-11-22T09:30:00-05:00,48,48.068,47.88,47.99,8489187,12596622.25,59.27125768975723,47.254216291406586,NaN,NaN,141.9179445640039,59.862845984020986,0.1349435314986557,0.054369977661515634,-0.08057355383714007,831662496,821310096.6,31.481873285407715,16.64933628404001,NaN,NaN,2.1322643359381437,-4.514590059059176
2016-11-23T09:30:00-05:00,47.96,47.96,47.63,47.8,8116794,12688476.65,56.68980772114426,48.94073154896005,NaN,NaN,108.29169675685304,87.28670149627749,0.13850237781581368,0.09255441843262702,-0.04594795938318665,823545702,823119939.2,33.27884922148991,17.415720313480058,NaN,NaN,3.8863884956074837,-3.314450265535368
2016-11-25T09:30:00-05:00,47.83,48.01,47.78,48,3109508,12402898.7,58.72751262702982,50.831953345930685,NaN,NaN,120.4411569906869,105.02591465788767,0.14665490177020113,0.13737066782956475,-0.00928423394063637,826655210,823846863.2,34.027250037678385,18.48420448503368,NaN,NaN,5.957730521525422,-1.9898530102409693
2016-11-28T09:30:00-05:00,47.96,48.26,47.93,48.04,7487843,12256347.1,59.14155774027946,51.532885463823945,NaN,NaN,130.17233748616906,120.93990079578616,0.14671420269898164,0.1741085194330907,0.027394316734109046,834143053,827835954,38.128630434599614,19.95754379886663,NaN,NaN,7.756190073755397,-0.5975611410986315
2016-11-29T09:30:00-05:00,48.01,48.3,47.9,48.07,5928430,12258770.6,59.46996289706073,52.04457010683607,NaN,NaN,119.62272053821083,124.08917126718475,0.1407251515910682,0.2033007562229443,0.0625756046318761,840071483,831215588.8,41.44967938194631,21.68494818746961,NaN,NaN,9.326102659240522,0.8201051160926762
2016-11-30T09:30:00-05:00,48.14,48.14,47.49,47.5,11816590,12396335.6,51.07074844728064,52.01699357780232,NaN,NaN,63.3229568754394,108.37017372947184,0.09264772718126851,0.17838526360846174,0.08573753642719323,828254893,830534068.2,40.972075977425824,23.484711046495143,NaN,NaN,8.308223133799892,1.8898362614794213
2016-12-01T09:30:00-05:00,47.44,47.56,46.39,46.52,21865579,13081250.05,40.48404390323346,51.89985656348377,NaN,NaN,-47.13392194418194,77.28504998926486,-0.005665981271321341,0.07865505983804155,0.0843210411093629,806389314,827102790.6,38.56285326297066,25.31173765553887,NaN,NaN,3.6882306692267717,2.146749748300471
2016-12-02T09:30:00-05:00,46.48,46.8,46.37,46.69,10052653,13077596.4,42.70289805071173,51.79763047623792,NaN,NaN,-75.47410341664275,38.10199790779892,-0.05690982496285013,0.01318375990580023,0.07009358486865036,816441967,825060142,37.16194435339703,27.1296247192958,NaN,NaN,0.7285598917284059,1.9441511973616048
2016-12-05T09:30:00-05:00,46.95,47.255,46.76,47.14,9005036,13120149.85,48.20732323898273,52.59120695140497,NaN,NaN,-27.621075711237985,6.543315268317512,-0.05796624748250494,-0.0023642244844808147,0.05560202299802412,825447003,823320932,35.96395961534451,29.013142688659286,NaN,NaN,0.014792932352041809,1.6685285880745244
2016-12-06T09:30:00-05:00,47.25,47.36,47.06,47.28,9254789,12921589.4,49.82238645147017,52.88979883635364,NaN,NaN,-4.008014625641685,-18.182831764452988,-0.04716214626951171,-0.0033506598388655107,0.043811486430646196,834701792,822246993.8,35.209179055752685,30.94268673842984,NaN,NaN,-0.04965518662204595,1.4230737631178716
2016-12-07T09:30:00-05:00,47.25,48.2172,47.22,48.18,9972934,12931234.55,58.73157617248988,53.48215887675611,NaN,NaN,77.77419236795402,-15.29258466595007,0.019118449176751942,0.06770954790158612,0.04859109872483418,844674726,825530960.4,39.39757140197283,33.19875079453344,NaN,NaN,2.9795340765181964,1.645425236460775
2016-12-08T09:30:00-05:00,48.2,48.51,48.07,48.3,9677051,12058615.65,59.75754943776465,53.927696985864664,NaN,NaN,116.66599752727106,17.467399228340525,0.06687474552264266,0.1321845306281375,0.06530978510549484,854351777,835123453,49.638708071846295,35.627661475617025,NaN,NaN,5.686038369885757,2.2226556840929153
2016-12-09T09:30:00-05:00,48.48,48.65,48.4,48.65,12307454,10698212.95,62.67242127223013,54.61526748795976,NaN,NaN,133.3228672675753,59.22679336518414,0.1150425477053798,0.2091129697372196,0.0940704220318398,866659231,845166905.8,57.69891035822965,38.49029472881234,NaN,NaN,8.88600236252343,3.1745623524401316
2016-12-12T09:30:00-05:00,48.5,48.61,48.35,48.5,9585230,10472896.9,60.645027355871505,54.8138623575219,NaN,NaN,112.36414599699832,87.2238377068314,0.128772200844754,0.2550356730877823,0.1262634722430283,857074001,851492305.4,61.84113918699053,41.05804454607519,NaN,NaN,10.842525526399086,4.269985663005697
2016-12-13T09:30:00-05:00,48.71,49.35,48.68,49.11,13966966,10222696.8,65.52866101227407,55.260819737701674,NaN,NaN,167.3535888887518,121.49615840971009,0.16840488484458843,0.33676957829876386,0.16836469345417543,871040967,858760140.4,65.96505136004885,43.521128694263844,NaN,NaN,14.167710983857381,5.683946423127366
2016-12-14T09:30:00-05:00,49.14,49.33,48.84,48.94,17915012,10249905.1,63.17579106984124,55.7241042626086,NaN,NaN,152.9479549925494,136.53091093462916,0.1720338694023361,0.38340703020709554,0.21137316080475946,853125955,860450386.2,66.86200445278499,45.91992549649921,NaN,NaN,16.12300925188809,7.175241112950326
2016-12-15T09:30:00-05:00,49,49.405,48.92,49.16,11570018,10322193.8,64.9306907025422,56.16718841085948,NaN,NaN,149.9425772909649,143.18622688736795,0.1774029841918735,0.43312689104460134,0.25572390685272783,864695973,862519225.4,67.97450946705018,48.34472974145434,NaN,NaN,18.275657328985744,8.761014858098243
2016-12-16T09:30:00-05:00,49.08,49.0897,48.516,48.59,10565736,10424275.55,57.31012718009327,56.036371942274755,NaN,NaN,88.45392738654492,134.21243891116188,0.1327610293275952,0.4216751935122218,0.2889141641846266,854130237,860013426.6,65.12275172830881,50.272881262433565,NaN,NaN,17.761457238667628,10.046792341036726
2016-12-19T09:30:00-05:00,48.63,49.1,48.59,48.94,6626990,10314475.5,60.3846546860823,56.101707070062005,NaN,NaN,94.19245070206897,130.578099852176,0.1175229713926671,0.4358178784254605,0.3182949070327934,860757227,860750071.8,65.57991915826217,51.9964698178847,NaN,NaN,18.296963230121058,11.225388182334488
2016-12-20T09:30:00-05:00,49.07,49.2,49,49.12,5706485,10151014.25,61.90422055292238,56.87552650617928,NaN,NaN,105.84218066600147,118.27581820762593,0.11039664910829305,0.4562907184181597,0.34589406930986666,866463712,859834620.8,64.449309319453,53.67341505660092,NaN,NaN,19.197585034721197,12.36427344696116
2016-12-21T09:30:00-05:00,49.1,49.12,48.92,49.02,4623681,9957738.95,60.51543740242499,58.3063403275501,NaN,NaN,85.69812582817825,104.82585237475169,0.09060761700588743,0.45915359056722593,0.3685459735613385,861840031,861577436,65.66299226334401,55.60913927091331,NaN,NaN,19.524880560316763,13.387217320297674
2016-12-22T09:30:00-05:00,49.02,49.05,48.765,48.92,11105195,10107159,59.08786815550769,59.47669533503553,NaN,NaN,67.76790488842106,88.39091789424295,0.06371270438243132,0.44818685403937764,0.3844741496569463,850734836,858785208.6,62.01036288508221,57.384026308890824,NaN,NaN,19.391452340856688,14.244965180377534
2016-12-23T09:30:00-05:00,48.87,48.98,48.7836,48.97,6358653,10269616.25,59.601031901664385,60.29053166808421,NaN,NaN,61.99106972959712,83.09834636285339,0.043201274705222004,0.4384757430384738,0.3952744683332518,857093489,859377859,62.48733754622438,59.27855330395367,NaN,NaN,19.419239698436066,14.984147254385896
2016-12-27T09:30:00-05:00,49.02,49.4,49,49.17,6840653,10237256.75,61.67196055084932,61.13692981803987,NaN,NaN,81.21096427755191,80.50204907794996,0.03724031663619776,0.441824864128499,0.4045845474923012,863934142,860013242,63.02335552048228,61.2652801942915,NaN,NaN,20.002298140988216,15.70102595247194
2016-12-28T09:30:00-05:00,49.23,49.295,48.71,48.73,7777577,10329714.1,54.99298955026463,60.86988791645235,NaN,NaN,50.507046508810674,69.4350222465118,-0.0002163875041639729,0.4043140631120963,0.40453045061626025,856156565,857951812.6,60.02652472839118,62.738776860464235,NaN,NaN,18.620923637932513,16.11815419325202
2016-12-29T09:30:00-05:00,48.73,48.865,48.62,48.74,4796544,9978711.8,55.1119723907479,60.53806098452259,NaN,NaN,31.11620890423685,58.51863886172354,-0.026732030873890367,0.3711154120238973,0.3978474428977877,860953109,857774428.2,59.76317914865269,63.46195336595041,NaN,NaN,17.519803807823635,16.31838985247654
2016-12-30T09:30:00-05:00,48.85,48.85,48.21,48.36,8501616,9310513.65,49.73168336578191,59.61372256263343,NaN,NaN,-4.663795177079052,44.03229884862351,-0.06982799665888939,0.3105624470741759,0.3803904437330653,852451493,858117759.6,60.127795270803595,63.63544514541997,NaN,NaN,14.989233285570869,16.128510342918585
2017-01-03T09:30:00-05:00,48.67,48.96,48.5,48.79,13940564,9504909.2,55.0761697166899,59.2159470169776,NaN,NaN,20.107973321232155,35.65567956695052,-0.06920556575895676,0.29388348653436935,0.3630890522933261,866392057,859977473.2,62.129633341728905,63.656051870758425,NaN,NaN,14.286506741108068,15.865366971231367
2017-01-04T09:30:00-05:00,48.83,49.03,48.8,48.96,7223081,9415811.45,57.02164864573315,58.60830327651039,NaN,NaN,43.26309941374646,28.06610659418943,-0.05764877874866026,0.2910280788575008,0.3486768576061611,873615138,861913672.4,64.14782696782679,63.52625012845685,NaN,NaN,14.261344828555991,15.63622095084917
2017-01-05T09:30:00-05:00,48.91,49.16,48.85,49.04,5502865,9228215.25,57.94463838732774,58.234649513473705,NaN,NaN,57.34496822198145,29.43369093682359,-0.04545657154951899,0.29185614316926234,0.3373127147187813,879118003,866505960,68.44336642789258,63.63920455525025,NaN,NaN,14.4993439512388,15.473809950904831
2017-01-06T09:30:00-05:00,49.04,49.47,48.9,49.4,8750635,9167100.3,61.908945693090125,58.01881058422713,NaN,NaN,125.21912006737763,48.25427316945174,-0.015532680343759264,0.31789686428908226,0.3334295446328415,887868638,871889065.8,72.58920494385555,63.96882566073634,NaN,NaN,15.864541981491339,15.52962881241719
2017-01-09T09:30:00-05:00,49.43,49.55,49.36,49.39,8313464,9098920.95,61.73486179452174,58.33486305668631,NaN,NaN,175.60878139469713,84.30878848380698,0.000359293561565166,0.33387866158479795,0.3335193680232328,879555174,877309802,76.00748423894386,64.74630655435314,NaN,NaN,16.931977473461412,15.729964335423508
2017-01-10T09:30:00-05:00,49.4,49.57,49.23,49.4,7735815,8870339,61.850387866271944,58.43955828384271,NaN,NaN,145.50111151494858,109.38741612255026,0.007898784387674163,0.3433928485078255,0.3354940641201513,887290989,881489588.4,78.25886346481235,65.65194543339244,NaN,NaN,17.84866346045812,16.03263563899988
2017-01-11T09:30:00-05:00,49.31,49.63,49.245,49.63,7586507,8770402.85,64.50474605051284,58.625310105099175,NaN,NaN,164.5602046366842,133.64683716713782,0.023829751179201497,0.36528125309415316,0.34145150191495166,894877496,885742060,80.28573182085906,66.78311846920715,NaN,NaN,19.38066596271122,16.51092568524436
2017-01-12T09:30:00-05:00,49.44,49.565,49.04,49.51,6862721,8415190.6,62.07788772103972,58.73691369928594,NaN,NaN,104.93191539231569,143.16422660120466,0.021794709772679166,0.3686948891308006,0.34690017935812145,888014775,887521414.4,81.08053196661871,67.88437130515534,NaN,NaN,20.053684238478382,17.017034049992077
2017-01-13T09:30:00-05:00,49.51,49.75,49.51,49.66,4832928,7761086.4,63.90591826802771,59.08106013589452,NaN,NaN,155.31572958631435,149.183548504992,0.025786697398894998,0.3791335511067402,0.3533468537078452,892847703,888517227.4,81.52933908035601,69.27858389053205,NaN,NaN,21.127107896379062,17.60418745661879
2017-01-17T09:30:00-05:00,49.53,49.605,49.36,49.47,4825753,7423873.15,59.962969909378174,59.10691285073121,NaN,NaN,100.12971350206965,134.0877349264665,0.011590264674574358,0.36783468455106316,0.3562444198764888,888021950,890210582.6,82.29832795890852,70.6936546342952,NaN,NaN,21.009236293263182,18.090623004710846
2017-01-18T09:30:00-05:00,49.61,49.67,49.475,49.6,6157702,7203471.45,61.704006064220096,59.109201815971986,NaN,NaN,111.6039797273266,127.30830856894211,0.007133118768678504,0.36516081833733693,0.35802769956865843,894179652,891588315.2,82.92133519451988,72.11493889672646,NaN,NaN,21.372632909189775,18.55948156249355
2017-01-19T09:30:00-05:00,49.6,49.775,49.44,49.53,7250031,7234623.5,60.186316079880754,59.48015371094457,NaN,NaN,99.20249925430166,114.2367674924656,-0.0037657704713748297,0.3533204864794399,0.35708625695081475,886929621,889998740.2,79.4471122152219,73.50212371721436,NaN,NaN,21.283182326401366,18.948581671623238
2017-01-20T09:30:00-05:00,49.75,49.93,49.67,49.8,8755400,7387069.25,63.87697743213569,60.10622549961512,NaN,NaN,130.33005860047643,119.31639613409774,0.0035757067981935786,0.36155589044855674,0.35798018365036316,895685021,891532789.4,80.30473475053776,74.96937768877758,NaN,NaN,22.210596512192414,19.414583791704548
2017-01-23T09:30:00-05:00,49.75,49.91,49.54,49.89,11977629,7754766.65,65.04030727243779,61.19969863580483,NaN,NaN,111.80271503941765,110.61379322471839,0.01046971080542014,0.37106732215713834,0.3605976113517182,907662650,894495778.8,81.87767671581636,76.52294064913563,NaN,NaN,23.315577901029297,19.971868664465227
2017-01-24T09:30:00-05:00,49.85,50.275,49.83,50.2,6510953,7525054.55,68.77093286227955,62.17789600334694,NaN,NaN,156.26577258634148,121.84100504157277,0.030737875610102883,0.3990199558643468,0.3682820802542439,914173603,899726109.4,84.26638497426181,78.10413719431656,NaN,NaN,25.388997392577462,20.745744197052687
2017-01-25T09:30:00-05:00,50.47,50.68,50.43,50.68,9197791,7667011.45,73.48844924378638,63.35409604606503,NaN,NaN,216.8688978769401,142.89398867149544,0.06910515962432201,0.4546635297846464,0.3855583701603244,923371394,905564457.8,86.418401814406,79.69489254050079,NaN,NaN,28.80722473304605,21.897384273623167
2017-01-26T09:30:00-05:00,50.67,50.705,50.4,50.54,7126488,7681303.2,70.15946195365592,64.2265834436599,NaN,NaN,176.750083416747,158.40350550398452,0.07708088828964665,0.4819094805223827,0.40482859223273604,916244906,911427514.8,88.16854680059807,81.10383399569403,NaN,NaN,30.634186875842346,23.14549893108305
2017-01-27T09:30:00-05:00,50.72,50.83,50.63,50.74,6023012,7593574.95,72.10360317924663,64.95477326409966,NaN,NaN,175.8120756102019,167.4999089059296,0.08711200073038006,0.5137185931457111,0.42660659241533105,922267918,916744094.2,89.49099216218391,82.31110451128893,NaN,NaN,32.775801475068526,24.52125643736669
2017-01-30T09:30:00-05:00,50.57,50.57,50.1,50.33,8446577,7776076.6,63.03680593565103,65.04776927418033,NaN,NaN,103.8201976379813,165.90340542564235,0.05877821961298191,0.5000793669315584,0.4413011473185765,913821341,917975832.4,89.77611141563735,83.29457788105275,NaN,NaN,31.796430715149594,25.560567048478536
2017-01-31T09:30:00-05:00,50.17,50.22,49.86,50.08,9557845,7828888.05,58.22869143228748,64.78907667175285,NaN,NaN,54.48863923890097,145.54797875615424,0.01796022884908527,0.4637514333799331,0.4457912045308478,904263496,915993811,85.74479215557463,83.82928707325006,NaN,NaN,29.423817736032827,26.112460003843434
2017-02-01T09:30:00-05:00,50.54,50.62,50.18,50.46,11681141,7715916.9,62.86518952365276,64.67196549126285,NaN,NaN,98.05605930450456,121.78541104166713,0.01162131707308256,0.460317850872201,0.44869653379911845,915944637,914508459.6,82.74604931052544,84.00502403679765,NaN,NaN,28.872414991688416,26.50673928782129
2017-02-02T09:30:00-05:00,50.31,50.445,50.1,50.36,8598869,7784706.3,60.947967886995336,64.59125693168826,NaN,NaN,70.30143897855201,100.49568215402813,-0.00343344569906473,0.4444047266752875,0.44783817237435225,907345768,912728632,79.17297658061725,83.8687700806547,NaN,NaN,27.82407737369589,26.694930442946234
2017-02-03T09:30:00-05:00,50.55,50.755,50.54,50.69,6833575,7851241.8,64.76665909674163,64.65273841945353,NaN,NaN,111.26925388240122,87.587117808468,0.00428748147869118,0.4531975242227162,0.448910042744025,914179343,911110917,75.9622652930867,83.47112195299259,NaN,NaN,28.13871480274176,26.90118535148845
2017-02-06T09:30:00-05:00,50.62,50.725,50.49,50.72,6726518,7750035.95,65.1007609308736,65.0197234924175,NaN,NaN,97.70896273916969,86.36487082870568,0.006723954934864107,0.45731498641260515,0.45059103147774104,920905861,912527821,76.84786688779533,83.08180330505593,NaN,NaN,28.489817157778212,27.12813275238699
2017-02-07T09:30:00-05:00,50.82,50.98,50.78,50.92,10053184,7837021.95,67.325252184943,65.42124107246913,NaN,NaN,121.17415868336683,99.70197471759882,0.016554188806169268,0.47128376748545264,0.4547295786792834,930959045,917866930.8,79.85905450415416,82.8630689700298,NaN,NaN,29.456887919211532,27.460812061933353
2017-02-08T09:30:00-05:00,50.97,51.09,50.775,51.01,6353085,7767885.45,68.3043183407103,66.0010983768141,NaN,NaN,117.26136569461585,103.54303599562108,0.023445697996715753,0.48403670117517805,0.4605910031784623,937312130,922140429.4,81.8894382305921,83.03752082827053,NaN,NaN,30.541297652390075,27.9008814319986
2017-02-09T09:30:00-05:00,51.04,51.3,51.01,51.17,4870022,7632061.2,70.02395345569401,66.44016809278254,NaN,NaN,131.64054188239993,115.8108565763907,0.032547806169391846,0.5012757608902021,0.46872795472081025,942182152,929107706.2,84.61288905010828,83.34524613538272,NaN,NaN,31.96341862104149,28.481243887576156
2017-02-10T09:30:00-05:00,51.29,51.4,51.155,51.32,4177870,7497818.65,71.58065797783892,66.9073360003112,NaN,NaN,138.64709972903287,121.28642574571704,0.04184596773453253,0.5210354143889759,0.4791894466544434,946360022,935543842,86.61525934329387,83.68364489448825,NaN,NaN,33.62340097501826,29.215837757210743
2017-02-13T09:30:00-05:00,51.41,51.61,51.34,51.55,6579703,7585157.4,73.82524152825047,67.26835804788055,NaN,NaN,150.54063480990163,131.85276015986344,0.05578962445453728,0.548926477222615,0.4931368527680777,952939725,941950614.8,88.2538870320073,83.96846647004152,NaN,NaN,35.73305002029604,30.146868080508643
2017-02-14T09:30:00-05:00,51.49,51.72,51.34,51.72,6233755,7655557.5,75.37345557066105,67.40300135694302,NaN,NaN,148.52593894874548,137.32311621293917,0.06795782234508219,0.5780841306994304,0.5101263083543482,959173480,947593501.8,89.47596603707993,84.18686391451821,NaN,NaN,37.990065404419646,31.267324841067357
2017-02-15T09:30:00-05:00,51.68,51.93,51.63,51.89,5947517,7645048.25,76.84820319369418,67.88076858837434,NaN,NaN,161.3374415154576,146.13833137710753,0.0782204303736731,0.6079018463214396,0.5296814159477665,965120997,953155275.2,90.52259157426973,84.35500996978047,NaN,NaN,40.35377938352004,32.56538977570345
2017-02-16T09:30:00-05:00,51.96,52.15,51.885,52.01,7061549,7635624.15,77.85625379223188,68.29167220358757,NaN,NaN,162.53265116680117,152.31675323398775,0.08338150534911826,0.6339082976341643,0.5505267922850461,972182546,959155354,91.50420696079814,84.49881102682434,NaN,NaN,42.64105913320081,34.00477111248879
2017-02-17T09:30:00-05:00,51.95,52.19,51.87,52.19,7087697,7552239,79.31139387425222,69.45414277063051,NaN,NaN,148.08917197451842,154.20516768308488,0.0887135026735123,0.6614186706269365,0.5727051679534242,979270243,965737398.2,92.43042223575736,84.6884046568329,NaN,NaN,45.04084137515182,35.581352578583505
2017-02-21T09:30:00-05:00,52.3,52.48,52.22,52.46,7618703,7334292.7,81.29678434126038,71.10186369270001,NaN,NaN,158.5953637824144,155.8161134775874,0.09941451243055777,0.6969733084916214,0.5975587960610637,986888946,972527242.4,93.24815966482738,85.22435947892238,NaN,NaN,47.76154305936611,37.32137979012388
2017-02-22T09:30:00-05:00,52.41,52.56,52.3,52.52,6884815,7352985.8,81.71668051633014,72.44839876360552,NaN,NaN,143.72903820922744,154.8567333296838,0.09929145536626283,0.7216731152688922,0.6223816599026294,993773761,979447298.6,93.96386707304076,86.02563217624491,NaN,NaN,50.125381285853585,39.15052286094241
2017-02-23T09:30:00-05:00,52.59,52.63,52.28,52.51,6702668,7228229.65,81.3887187011411,73.90845239318737,NaN,NaN,125.58648798297821,147.70654262318794,0.08769699199141301,0.7320028998918957,0.6443059079004827,987071093,983837317.8,94.37148095859455,87.11123963181471,NaN,NaN,51.97874274131412,40.98312570099551
2017-02-24T09:30:00-05:00,52.2,52.65,52.17,52.63,7772505,7260530.5,82.30640566075682,75.16129143347418,NaN,NaN,111.55334175424788,137.5106807406773,0.07761669142050087,0.7413267721761088,0.6637100807556079,994843598,988369528.2,94.76455309664654,88.45426018921185,NaN,NaN,53.83177061418765,42.8186464028801
2017-02-27T09:30:00-05:00,52.62,52.62,52.48,52.6,7975631,7358161.45,81.22808189451437,76.3132429308771,NaN,NaN,105.66924359557085,129.02669506488778,0.05926431106108132,0.7377904695819595,0.6785261585208782,986867967,989889073,94.89332018601799,89.74322113908491,NaN,NaN,55.105327152130734,44.5738865099159
2017-02-28T09:30:00-05:00,52.51,52.56,52.27,52.35,7621497,7316907.45,72.68237332525744,76.69589444089955,NaN,NaN,82.06672845226888,113.72096799885867,0.022514252058621564,0.7066689735941551,0.6841547215355336,979246470,988360577.8,92.4306713863057,90.64119377352431,NaN,NaN,53.88821727209767,45.90450519022758
2017-03-01T09:30:00-05:00,52.67,53.16,52.55,53.09,9095297,7293780.05,79.54295779357565,77.4986544018185,NaN,NaN,120.44172932330662,109.06350622167452,0.03928755596935596,0.7332641664972286,0.6939766105278726,988341767,987274179,90.63034863068044,91.26554451638776,NaN,NaN,54.8885211528447,47.187936042030024
2017-03-02T09:30:00-05:00,53.04,53.05,52.71,52.74,7170112,7068228.6,70.52179507334782,77.5342145173652,NaN,NaN,101.79521010755134,104.30525064658914,0.019078184678287036,0.7178243413757315,0.6987461566974444,981171655,986094291.4,88.61169707622338,91.55117366111027,NaN,NaN,52.59832265956968,47.960848415964264
2017-03-03T09:30:00-05:00,52.7,52.86,52.59,52.86,7856975,7031133.9,71.70659202301451,77.54320980630631,NaN,NaN,89.05700106555824,99.8059825088512,0.006699016633991861,0.7071199274899342,0.7004209108559424,989028630,984931297.8,86.56500991967233,91.54758441656587,NaN,NaN,51.16627418707191,48.41876638326536
2017-03-06T09:30:00-05:00,52.64,52.87,52.55,52.78,6715162,7025213.25,69.69545898452267,77.24822533889719,NaN,NaN,79.70817719364673,94.6137692284664,-0.012902196444494085,0.6842931653003248,0.6971953617448189,982313468,984020398,84.91076007004588,91.30878963356862,NaN,NaN,49.38395759065845,48.55665084146437
2017-03-07T09:30:00-05:00,52.74,53,52.7,52.78,6980447,7037909.7,69.69545898452267,76.84265415417302,NaN,NaN,84.49654590828497,95.09973271966962,-0.03086769963615632,0.6586107371996235,0.6894784368357798,982313468,984633797.6,85.11701593305938,90.99743605471001,NaN,NaN,47.96824843257711,48.47259335448047
2017-03-08T09:30:00-05:00,52.84,53,52.765,52.84,5680931,6819297.05,70.41715172119942,76.38329333470911,NaN,NaN,84.09134278989708,87.8296554129877,-0.042966776635400494,0.6357699660415292,0.6787367426769297,987994399,984564324,84.97534105304246,90.60120387462236,NaN,NaN,46.99980689046006,48.26219528819184
2017-03-09T09:30:00-05:00,52.85,52.91,52.57,52.83,7650187,6884152.15,70.11743973851142,75.83052090230049,NaN,NaN,68.04191814551072,81.07899702057958,-0.055123944231721955,0.6098318123872772,0.6649557566189992,980344212,984398835.4,84.61405438921454,90.10905011950925,NaN,NaN,46.12069707584063,47.95626697214167
2017-03-10T09:30:00-05:00,53.08,53.22,52.89,53.11,7354788,7008390.45,73.51639514208301,75.41659242143126,NaN,NaN,111.3796493527745,85.54352667802284,-0.0480474619482647,0.6048964291836683,0.652943891131933,987699000,984132909.4,83.99604474397134,89.50659458438167,NaN,NaN,46.28334951933131,47.71727876459733
2017-03-13T09:30:00-04:00,53.11,53.22,53.06,53.16,7461245,7172559.2,74.08329213352289,74.90134297802145,NaN,NaN,120.33409263477171,93.66870976624783,-0.043855214225794525,0.5981248733496898,0.6419800875754843,995160245,986702264.8,85.12640471919447,88.92646923112218,NaN,NaN,46.575966856651924,47.554234206319414
2017-03-14T09:30:00-04:00,53.12,53.12,52.835,53.04,7239872,7205567.65,70.19949136610984,74.07868661014857,NaN,NaN,87.07923463246061,94.18524751108296,-0.052439561347007224,0.5764306358917253,0.6288701972387325,987920373,987823645.8,85.6043033910855,88.32935753955395,NaN,NaN,45.749096506010325,47.296357391989545
2017-03-15T09:30:00-04:00,53.12,53.49,52.96,53.4,8933564,7340558.1,74.51580953353661,73.58776452674824,NaN,NaN,135.65242059164615,104.49746307143278,-0.03783002593117968,0.581582664824758,0.6194126907559376,996853937,989595553.4,86.35059106712154,87.75643683302017,NaN,NaN,46.26946466247092,47.14965843062974
2017-03-16T09:30:00-04:00,53.6,53.6151,53.3713,53.43,10977953,7592079.9,74.84281517960913,73.05465092095199,NaN,NaN,167.11163248519824,124.31140593937027,-0.030422477047427288,0.5813845944466536,0.6118070714940809,1007831890,995093089,88.36580669676673,87.29938351874304,NaN,NaN,46.78727492376992,47.097889358221195
2017-03-17T09:30:00-04:00,53.43,53.51,53.32,53.34,6895356,7583770.25,71.86361683405565,72.38576055949065,NaN,NaN,138.51666627717003,129.73880932424936,-0.035506090428291004,0.5674244584587171,0.6029305488870081,1000936534,997740595.8,89.19328230578336,86.89223795586915,NaN,NaN,46.381393364339836,46.99553278766672
2017-03-20T09:30:00-04:00,53.35,53.5087,53.24,53.3706,4541841,7456477.45,72.26781743435748,72.35614942442636,NaN,NaN,122.50360908952891,130.17271261520082,-0.040375095090251056,0.5524616800241944,0.5928367751144454,1005478375,999804221.8,89.80212777970738,86.70448484111213,NaN,NaN,46.15314044867244,46.87519102495325
2017-03-21T09:30:00-04:00,53.53,53.66,52.59,52.61,14905546,7820819.6,52.19604049711873,70.40279818896515,NaN,NaN,16.136066381434656,115.98407896499562,-0.09525485849862014,0.4737682019911702,0.5690230604897903,990572829,1000334713,89.95874274039927,86.65651299180631,NaN,NaN,39.003683920834675,45.75069001007917
2017-03-22T09:30:00-04:00,52.62,53.02,52.55,52.94,11383320,8045744.85,57.687098064312984,69.48603411689123,NaN,NaN,-19.71767125284954,84.91006059609649,-0.10878685948731559,0.4330394861306459,0.5418263456179615,1001956149,1001355155.4,90.26834586864554,86.7748450484079,NaN,NaN,34.82870549566458,44.19040650801994
2017-03-23T09:30:00-04:00,52.86,53.02,52.715,52.8,11359352,8278579.05,54.81065426964847,68.27918142022223,NaN,NaN,-24.169026475015926,46.65392880405365,-0.12543986891445102,0.3850265094748977,0.5104663783893487,990596797,997908136.8,81.16453237804217,86.38909665257718,NaN,NaN,30.52815815964593,42.23865674396651
2017-03-24T09:30:00-04:00,52.98,53.16,52.655,52.84,13140900,8546998.8,55.49349176697881,67.26475519039766,NaN,NaN,-19.782188919200014,14.994157764779638,-0.131403005372547,0.34621262167366496,0.47761562704621197,1003737697,998468369.4,81.49125135350613,86.1448460299672,NaN,NaN,27.365622060449006,40.11393750346401
2017-03-27T09:30:00-04:00,52.4,52.95,52.33,52.84,6845008,8490467.65,55.49349176697881,66.25032896057311,NaN,NaN,-80.44130048671246,-25.594824150468657,-0.1326065516075115,0.3118574375368226,0.4444639891443341,1003737697,998120233.8,80.55614423050962,85.81906947978507,NaN,NaN,24.857488122407535,37.93444473474165
2017-03-28T09:30:00-04:00,52.79,53.34,52.7,53.22,8453958,8532090.7,61.845612783406445,65.63807617930219,NaN,NaN,34.00763212193368,-22.02051100236885,-0.10621083761143013,0.31170044213004644,0.41791127974147657,1012191655,1002443999,83.1432933241118,85.6882089277186,NaN,NaN,24.58024014495342,36.02670122191476
2017-03-29T09:30:00-04:00,53.2,53.34,53.08,53.31,5695430,8362097.35,63.1857664526117,65.14295665888078,NaN,NaN,78.33039477384195,-2.410897797030546,-0.08216519545754453,0.3152047854195459,0.3973699808770904,1017887085,1005630186.2,84.75323667671262,85.69815051968274,NaN,NaN,24.768684112454068,34.41841306342038
2017-03-30T09:30:00-04:00,53.27,53.4752,53.23,53.41,8754343,8441308.9,64.67063537508868,64.51111667552404,NaN,NaN,105.18967740803645,23.46084297957993,-0.060027597362190044,0.32233548417435287,0.3823630815365429,1026641428,1012839112.4,87.63154489042492,85.9578291015723,NaN,NaN,25.371929783509795,33.12605830914744
2017-03-31T09:30:00-04:00,53.36,53.49,53.2543,53.31,6103498,8353635.05,61.97849284413292,63.64648815485333,NaN,NaN,88.72203400176663,45.161687563773256,-0.052873131517393035,0.3162716671398016,0.36914479865719463,1020537930,1016199159,88.7021174291447,86.21323715228303,NaN,NaN,25.094038661454377,31.978626930905573
2017-04-03T09:30:00-04:00,53.36,53.44,52.935,53.26,13017947,8668774.3,60.61968120832311,62.96221600072571,NaN,NaN,40.638283120793304,69.37760428527442,-0.05217345986476307,0.3039279738262408,0.3561014336910039,1007519983,1016955616.2,88.93433857495124,86.45109680827343,NaN,NaN,24.48225492775488,30.90771664474119
2017-04-04T09:30:00-04:00,53.04,53.3,53.02,53.3,7520797,8695791.8,61.349719378524014,62.02178098965338,NaN,NaN,34.10429187154121,69.39693623519591,-0.0496937024935975,0.293984305574007,0.3436780080676045,1015040780,1017525441.2,89.11582413636044,86.64861345607622,NaN,NaN,24.17066108949837,29.94528013684936
2017-04-05T09:30:00-04:00,53.35,53.71,53.03,53.08,10477873,8935638.9,55.279834587258776,60.624425233056925,NaN,NaN,50.8136025919137,63.89357779881027,-0.06270754545165469,0.2652935762530362,0.32800112170469087,1004562907,1014860605.6,82.31650783632794,86.2165206803306,NaN,NaN,22.167289377040287,28.834138599733777
2017-04-06T09:30:00-04:00,53.14,53.25,52.96,53.09,6935088,8899883.95,55.49537811455927,59.45526532452147,NaN,NaN,-15.148959773934594,39.82585036241606,-0.06992928392435516,0.2405895167992469,0.31051880072360205,1011497995,1011831919,75.28590314591249,85.22313645462555,NaN,NaN,20.575031708855068,27.654266186751105
2017-04-07T09:30:00-04:00,53.01,53.2,52.87,53.06,6469388,8855613.95,54.64446792547747,58.19645464531576,NaN,NaN,-35.49554634623062,14.9823342928166,-0.07553539162264744,0.21609956119529272,0.29163495281794016,1005028607,1008730054.4,68.80440816571918,83.72329933934067,NaN,NaN,19.009326097674798,26.41927474545449
2017-04-10T09:30:00-04:00,53.09,53.215,52.8549,52.96,4843637,8724733.55,51.79366633391514,58.16771363365836,NaN,NaN,-43.86710132043273,-1.9187425954286126,-0.08413004785280398,0.1864723930019352,0.27060244085473917,1000184970,1007263051.8,65.91417375521874,82.00583012611351,NaN,NaN,16.88237612509355,25.0568606568315
2017-04-11T09:30:00-04:00,52.87,52.945,52.33,52.76,8457135,8785596.7,46.56170695738174,57.37304284030613,NaN,NaN,-144.76752678038017,-37.693106325812884,-0.1003373393083006,0.14518076671936342,0.24551810602766402,991727835,1002600462.8,57.628379487807706,79.67440395605365,NaN,NaN,13.481079951391969,23.403177698911566
2017-04-12T09:30:00-04:00,52.71,52.765,52.475,52.58,8684215,8773129.25,42.40950816952611,56.48724669029739,NaN,NaN,-145.7531878769196,-77.00646441957954,-0.11896142767361398,0.09681632143564656,0.21577774910926054,983043620,998296605.4,51.22705104075864,77.53601243196196,NaN,NaN,9.250548330311272,21.38137350339724
2017-04-13T09:30:00-04:00,52.52,52.87,52.37,52.37,9766588,8712561,38.136607702132736,55.247469257094096,NaN,NaN,-147.07668099412524,-103.39200866361769,-0.13976740479134514,0.0410684931200791,0.18083589791142424,973277032,990652412.8,42.25025310501592,74.73308398564123,NaN,NaN,4.194059501538449,18.926042931703126
2017-04-17T09:30:00-04:00,52.53,52.87,52.53,52.85,7066033,8721094.85,50.430302683403596,54.88581289398159,NaN,NaN,-75.67742935485803,-111.42838526534315,-0.11649751758637508,0.03521400092845539,0.15171151851483047,980343065,985715304.4,37.66008006372199,71.66907940229927,NaN,NaN,3.474189929904261,16.718635360017572
2017-04-18T09:30:00-04:00,52.71,52.9411,52.63,52.84,6243585,8806182.05,50.20645546079458,54.05444451379502,NaN,NaN,-53.1670843581698,-113.28838187289057,-0.09782671231732867,0.02942812811816964,0.1272548404354983,974099480,980498206.4,33.516298889367434,68.12429408553182,NaN,NaN,2.8445039279379887,14.736616584006203
2017-04-19T09:30:00-04:00,52.92,53.11,52.7,52.8,7260503,8423929.9,49.264481864481645,53.0600670432143,NaN,NaN,-30.701587470728327,-90.47519401096021,-0.08470884001979509,0.021368790410754457,0.10607763043054955,966838977,975520434.8,30.11187219847497,64.22133947994341,NaN,NaN,2.0559560970707773,12.925093657301142
2017-04-20T09:30:00-04:00,52.94,53.365,52.86,53.28,7568501,8233188.95,59.16536208402782,52.66683323670996,NaN,NaN,54.701565403631115,-50.38424335485006,-0.042380845306281875,0.0531015737976972,0.09548241910397907,974407478,973793206.4,29.01072347514264,60.0341379502804,NaN,NaN,4.690403103602989,11.74870929248712
2017-04-21T09:30:00-04:00,53.3,53.31,53.07,53.17,7616549,8046048.8,56.44681248906071,52.27171321134766,NaN,NaN,54.29666368374889,-10.109574419275228,-0.021519242316320533,0.06858336620857841,0.09010260852489894,966790929,972495985.8,28.177317487574143,55.710937954453925,NaN,NaN,5.9265298924796195,10.916969378200335
2017-04-24T09:30:00-04:00,53.75,53.8399,53.63,53.8,8104989,7794253.25,66.06425621052881,52.660611425790925,NaN,NaN,194.75592647909204,43.97709674751478,0.032068160444744975,0.13018780908083016,0.09811964863608519,974895918,971406556.4,27.463761565723786,51.32018245379482,NaN,NaN,10.748683440314204,10.892928529930888
2017-04-25T09:30:00-04:00,54.02,54.1872,53.925,54.08,10043734,7954189.55,69.30813861449643,53.22906994264609,NaN,NaN,236.5420273225376,101.91891908365626,0.08094904813595512,0.19930595880602908,0.11835691067007396,984939652,973574590.8,31.197829945010568,47.183182868698395,NaN,NaN,15.859391279077823,11.60242320838045
2017-04-26T09:30:00-04:00,54.12,54.21,53.97,54.02,8147176,7938850.45,67.81226843488888,54.12424378890539,NaN,NaN,194.9275691221896,147.04475040223983,0.10243506150410364,0.24640073755020353,0.1439656760460999,976792476,975565290.6,34.53048706509354,43.76989567075308,NaN,NaN,19.238982047009458,12.693360185327451
2017-04-27T09:30:00-04:00,54.16,54.28,54.105,54.24,8591719,8083664.9,70.34003206166076,55.18457621369834,NaN,NaN,184.26706681390968,172.95785068429558,0.12325964169205061,0.29804022816116316,0.17478058646911254,985384195,977760634,38.091861342386814,41.11317839907268,NaN,NaN,22.88281276334676,14.148996267901637
2017-04-28T09:30:00-04:00,54.41,54.49,54.25,54.38,11418367,8216866.1,71.85478134160999,56.41388431485067,NaN,NaN,174.07126634843058,196.9127712172319,0.13719164271060363,0.3462701398573671,0.20907849714676346,996802562,983762960.6,46.638721141068075,39.52991504016903,NaN,NaN,26.321225410724498,15.88788614544776
2017-05-01T09:30:00-04:00,54.58,54.855,54.48,54.79,7562960,8289839.2,75.75920891080382,58.125708784628436,NaN,NaN,176.87244737769595,193.33607539695268,0.16299125184831892,0.4128175619571621,0.2498263101088432,1004365522,989656881.4,53.43659253027652,38.63865923838744,NaN,NaN,30.713794429276863,18.005873043137633
2017-05-02T09:30:00-04:00,54.9,54.99,54.71,54.91,7535068,8015695.25,76.77474487850853,60.283782921851774,NaN,NaN,157.84003861138586,177.59567765472235,0.17599817715869287,0.4698240315572093,0.29382585439851644,1011900590,995049069,58.62920553237874,38.71014681299966,NaN,NaN,34.54124537931578,20.368069091163083
2017-05-03T09:30:00-04:00,54.73,54.8499,54.5601,54.81,7154453,7997378.05,73.99284383467571,62.53973546936247,NaN,NaN,121.37129820041625,162.88442347036766,0.1658640300774578,0.5011558919953387,0.3352918619178809,1004746137,1000639801.2,63.21017412705266,39.566084176306376,NaN,NaN,36.73744381987936,22.70655119526541
2017-05-04T09:30:00-04:00,54.83,54.86,54.59,54.77,7579850,7852476.9,72.85565848000438,65.01966766778187,NaN,NaN,105.21127305492725,147.07326471857118,0.1452077780277875,0.5168015844526153,0.37159380642482776,997166287,1002996219.6,64.97078066790155,41.18897900222678,NaN,NaN,38.156793829211544,24.91372871440057
2017-05-05T09:30:00-04:00,54.86,54.985,54.725,54.97,6825813,7847013.15,74.93031013912034,66.76966820033307,NaN,NaN,104.81951733666354,133.2229149162178,0.13402459071383416,0.5391245448171205,0.4050999541032863,1003992100,1004434127.2,66.03880417113085,43.216030724184556,NaN,NaN,40.001850700789895,27.06917471245619
2017-05-08T09:30:00-04:00,55.01,55.2396,54.91,55.21,6070112,7827049.35,77.1838921504832,68.69662796388225,NaN,NaN,110.634465333222,119.97531850732301,0.1316124154108811,0.5696154733668877,0.4380030579560066,1010062212,1005573465.2,66.89996659243396,45.600578417260735,NaN,NaN,42.29566017920837,29.244386921992213
2017-05-09T09:30:00-04:00,55.27,55.425,55.17,55.28,7694281,7969581.55,77.81042643904398,70.73562400492241,NaN,NaN,111.52622068062283,110.71255492117038,0.12367521656282443,0.5925970786595371,0.4689218620967127,1017756493,1006744645.8,67.8037479635433,48.292855257622755,NaN,NaN,44.35542805752342,31.403107084210955
2017-05-10T09:30:00-04:00,55.34,55.53,55.215,55.49,5302044,7811827,79.61861192586522,72.19657042219652,NaN,NaN,111.52846556944864,108.74398839497685,0.12134371317240022,0.620601503562213,0.4992577903898128,1023058537,1010407125.8,70.51501297436587,51.25744736471013,NaN,NaN,46.683331552861105,33.585996294018116
2017-05-11T09:30:00-04:00,55.32,55.45,55.1,55.42,9098048,7832518.65,77.35579051015554,73.69006885227473,NaN,NaN,97.11220928485214,107.12417564096184,0.1045024596182369,0.6298858649126089,0.525383405294372,1013960489,1013765966.2,72.77897874083261,54.44328031137145,NaN,NaN,47.94612515256601,35.637443273810675
2017-05-12T09:30:00-04:00,55.47,55.59,55.41,55.56,4653845,7576881.5,78.66197515502893,74.58990591973902,NaN,NaN,105.30480904292536,107.22123398221417,0.09261314925973774,0.6411498418690442,0.5485366926093065,1018614334,1016690413,74.60715991589983,57.8106659078126,NaN,NaN,49.400134937043276,37.6035420828439
2017-05-15T09:30:00-04:00,55.63,55.87,55.6,55.87,9949265,7721043.1,81.24214829375741,75.44233518254337,NaN,NaN,118.58460754264443,108.81126242409866,0.09508879700446526,0.667397688864888,0.5723088918604228,1028563599,1020390690.4,76.7361410601282,61.06340241603529,NaN,NaN,51.49924397769728,39.58864235353724
2017-05-16T09:30:00-04:00,56,56.13,55.81,56.13,9061070,7861917.35,83.08910825220137,76.53353802663712,NaN,NaN,132.11101989291768,112.92822226655764,0.10303073485348524,0.7010973104272793,0.5980665755737941,1037624669,1024364325.6,78.79245460849049,64.22497152627793,NaN,NaN,53.90476758130791,41.63380310036162
2017-05-17T09:30:00-04:00,55.69,55.74,54.57,54.6,18544954,8426139.9,51.163580841371875,75.1637915109022,NaN,NaN,28.09120992932911,96.24077113853374,-0.0004859381845661037,0.5974591528430864,0.5979450910276525,1019079715,1023568561.2,77.31853967377633,67.02687712137718,NaN,NaN,42.740456923248956,41.791896503631236
2017-05-18T09:30:00-04:00,54.46,55.13,54.37,54.92,16822248,8888827.25,55.05343830982893,73.9636955800607,NaN,NaN,1.7810766432995802,77.17454461022322,-0.05037240854657499,0.5349795803444337,0.5853519888910087,1035901963,1027956856,79.58633917868195,69.38027840977817,NaN,NaN,36.03658756963118,40.9697095130598
2017-05-19T09:30:00-04:00,55.22,55.41,55.16,55.24,10219114,9018955.5,58.60427013180901,72.73834281013248,NaN,NaN,53.633656704878454,66.84031414261385,-0.06391456674268414,0.5054587804626536,0.5693733472053377,1046121077,1033458204.6,82.01418852285055,71.42153526639059,NaN,NaN,32.322655499211095,39.73441608250998
2017-05-22T09:30:00-04:00,55.37,55.75,55.36,55.68,10510254,9139218.75,62.9396801177905,71.75012389865262,NaN,NaN,91.32833820049454,61.389060274183876,-0.04616311798524375,0.511669449723783,0.5578325677090268,1056631331,1039071751,84.0931136658266,73.24038584735116,NaN,NaN,31.054196529259443,38.49438471775991
2017-05-23T09:30:00-04:00,55.91,55.97,55.63,55.78,6610474,8967555.75,63.86592033476283,71.02677222008741,NaN,NaN,109.3705413131444,56.84096455822921,-0.031320793538241576,0.5186815757862249,0.5500023693244664,1063241805,1044195178.2,85.71592782046324,74.84793968259477,NaN,NaN,30.43940708639587,37.343673627565046
2017-05-24T09:30:00-04:00,55.93,56.02,55.795,56.01,9427733,9031583.6,65.97240473974989,70.53511123864067,NaN,NaN,120.8805651388197,75.39883560012734,-0.0107122283028952,0.5366120839458475,0.5473243122487427,1072669538,1054913142.8,88.38539450140271,76.52041209927343,NaN,NaN,30.680112599536198,36.39173633784664
2017-05-25T09:30:00-04:00,56.19,56.528,56.0757,56.41,6113536,8907674.45,69.32194992795638,70.13451408070038,NaN,NaN,166.09456654718971,108.26153358090536,0.02330358808842259,0.5764537973592709,0.5531502092708483,1078783074,1063489365,89.9964004896842,78.2316689791701,NaN,NaN,32.04566777948059,35.7708694009372
2017-05-26T09:30:00-04:00,56.36,56.45,56.235,56.38,36282202,10150866.2,68.7751454693448,69.53388931776193,NaN,NaN,148.95191602920107,127.32518544576988,0.03644493542630434,0.5987063785537288,0.5622614431274244,1042500872,1062765324,88.87560320211877,79.80135730843328,NaN,NaN,32.9216454816404,35.36383741246623
2017-05-30T09:30:00-04:00,56.4,56.6799,56.33,56.62,5925282,10068982.3,70.76207513031014,69.03043565285238,NaN,NaN,152.95804228250174,139.65112626217132,0.052961382675540514,0.62846317147185,0.5755017887963095,1048426154,1061124288.6,86.253685439911,81.1192099853167,NaN,NaN,34.27953700897423,35.20893735482452
2017-05-31T09:30:00-04:00,56.83,56.85,56.34,56.53,14246143,10404536.05,68.98919609422119,68.2711916648778,NaN,NaN,136.76927463213667,145.13087292596975,0.04954691894179153,0.6374354374735489,0.5878885185317574,1034180011,1055311929.8,77.52954065139073,81.62024767653274,NaN,NaN,34.83997810763857,35.15622889094082
2017-06-01T09:30:00-04:00,56.65,56.67,56.315,56.67,8436237,10468625.25,70.23832186802863,67.76280104758301,NaN,NaN,118.42136956729769,144.63903381166534,0.048384273388357824,0.6483688602672046,0.5999845868788468,1042616248,1049301271.8,69.68059470731546,81.39893453128153,NaN,NaN,35.67354672028798,35.23013143799041
2017-06-02T09:30:00-04:00,56.88,57.2,56.695,57.19,8491012,10514183.35,74.36815909527425,67.45609990045769,NaN,NaN,158.1127618574018,143.0426728737078,0.07283440635099514,0.6910275948175908,0.6181931884665957,1051107260,1043766109,63.322922373717596,80.59291756398281,NaN,NaN,37.7422344125595,35.589003291500276
2017-06-05T09:30:00-04:00,57.19,57.39,57.12,57.24,6765833,10511184.35,74.73124608655547,66.99103545708611,NaN,NaN,159.90706663969848,145.23370299580728,0.08189610997444219,0.7205633259346484,0.6386672159602063,1057873093,1046840553.2,65.22104274024318,79.77041054113377,NaN,NaN,39.50819524070576,36.14888785567249
2017-06-06T09:30:00-04:00,57.17,57.42,57.06,57.13,7685189,10591938.2,72.30461221167718,66.22071431133439,NaN,NaN,134.75721973929808,141.59353848716657,0.07044013072246413,0.7267173793632864,0.6562772486408223,1050187904,1047192903.2,65.4417785287477,78.81679082115215,NaN,NaN,40.269847286541385,36.73759634579662
2017-06-07T09:30:00-04:00,57.26,57.41,57.01,57.31,8703668,10642407.55,73.8036328229923,67.83786088145014,NaN,NaN,121.56500664228464,138.55268488919617,0.06507118190087102,0.737616226016911,0.67254504411604,1058891572,1052135215.4,68.46512482836394,78.18440404647983,NaN,NaN,41.34959147812117,37.39645279327156
2017-06-08T09:30:00-04:00,57.41,57.48,57.12,57.44,7102430,10732426.85,74.86188318219304,69.25274980090471,NaN,NaN,116.7248414695185,138.2133792696403,0.06045972141968303,0.7481196958906438,0.6876599744709607,1065994002,1056810766.2,71.04581105006598,77.57436632300725,NaN,NaN,42.56003225587931,38.13410700221552
2017-06-09T09:30:00-04:00,57.52,57.62,55.22,56.02,35142479,12034648.4,50.74691561871805,68.69151019282678,NaN,NaN,6.955893584229062,107.98200561500576,-0.04249039851846981,0.6345469763228735,0.6770373748413433,1030851523,1052759618.8,66.00553426573939,76.4308910189279,NaN,NaN,34.964202019026686,37.68126343318855
2017-06-12T09:30:00-04:00,55.44,55.78,54.77,55.69,35706388,13587275.55,46.96097886898411,67.55017438934061,NaN,NaN,-84.2866961980677,59.14325304745252,-0.13202237188925436,0.5120094099797754,0.6440317818690298,995145135,1040214027.2,53.37664944351901,74.23685786019163,NaN,NaN,27.553544495739242,36.23444644212436
2017-06-13T09:30:00-04:00,55.96,56.27,55.68,56.09,18293443,14004484.45,51.66783266240127,66.67888241274336,NaN,NaN,-22.949810824340783,27.60184693472475,-0.1615628966778372,0.44207816102173325,0.6036410576995704,1013438578,1032864162,47.62736119259414,71.51624595820098,NaN,NaN,23.19443098771929,34.371587091495066
2017-06-14T09:30:00-04:00,56.31,56.32,55.355,55.82,16180604,14360461.15,48.53675119493671,65.43347858811384,NaN,NaN,-40.709080114230915,-4.852970416578353,-0.19434298083525148,0.3607123316555061,0.5550553124907576,997257974,1020537442.4,39.87078014892511,68.05091636159544,NaN,NaN,18.63834689462841,32.12398134908554
2017-06-15T09:30:00-04:00,55.19,55.65,54.95,55.57,14750458,14170736.35,45.77092587066383,63.75126258402152,NaN,NaN,-92.87843714831192,-46.77362614014444,-0.22571587162508955,0.27291047295939563,0.4986263445844852,982507516,1003840145.2,32.216910681480755,63.92380994672377,NaN,NaN,14.045396769093646,29.541326409086697
2017-06-16T09:30:00-04:00,55.35,55.3691,55.02,55.25,21611258,14410186.85,42.4374452859735,61.86999828520929,NaN,NaN,-118.8247077288389,-71.92974640275801,-0.2585149264357298,0.1754826865398229,0.4339976129755527,960896258,989849092.2,27.460086249540765,59.53698730725391,NaN,NaN,9.152423734172656,26.62862602695612
2017-06-19T09:30:00-04:00,55.67,56.11,55.64,56.07,9929199,14395691.1,52.070419868954964,60.534880052255346,NaN,NaN,-42.691727578604805,-63.610752678865445,-0.21714714801249785,0.16256367795993043,0.3797108259724283,970825457,984985156.6,26.02165144602766,55.23469916483368,NaN,NaN,8.159377670822145,23.99016197607984
2017-06-20T09:30:00-04:00,56.05,56.08,55.62,55.62,10957735,14418065.15,47.38405672976976,58.991655811937385,NaN,NaN,-64.981415688745,-72.01707365174632,-0.21201511344432106,0.11469193416702694,0.326707047611348,959867722,974270985.4,23.145508535681003,51.35012544228299,NaN,NaN,5.697956345616446,21.3769897431565
2017-06-21T09:30:00-04:00,55.81,55.96,55.64,55.93,12293150,14702198.95,50.67731245177167,57.594440853633316,NaN,NaN,-56.93886905957454,-75.26303144081504,-0.1808793210226195,0.10060789633307365,0.28148721735569315,972160872,969251565,21.922991032878784,47.938868036966085,NaN,NaN,4.85764924134107,19.01708395718287
2017-06-22T09:30:00-04:00,56.1,56.14,55.77,55.95,8792805,14670452.55,50.890874109700256,55.917491926092325,NaN,NaN,-43.46073927413051,-65.37949186597876,-0.15317192858941864,0.09002230661891986,0.2431942352083385,980953677,968940797.2,21.846055226348597,44.97623466929688,NaN,NaN,4.277134489631793,16.91137689038986
2017-06-23T09:30:00-04:00,55.9,56.4392,55.81,56.3,16423571,15185954.3,54.59592450887535,54.47925467054374,NaN,NaN,-13.98011170240789,-44.410572660692566,-0.10765691927693091,0.10862308611217486,0.21628000538910577,997377248,976236995.2,28.215541614392805,42.33298458887899,NaN,NaN,4.9671233045092436,15.205054949549773
2017-06-26T09:30:00-04:00,56.6,56.72,55.94,56,9727935,13858240.95,51.041316789520984,52.960447854675444,NaN,NaN,-8.617377530606417,-37.59570265109288,-0.09460252227922042,0.09802685254008026,0.19262937481930067,987649313,979601766.4,31.0080565179466,39.87343301667891,NaN,NaN,4.437335261944878,13.66680927989193
2017-06-27T09:30:00-04:00,55.7,55.8,55.08,55.08,12895539,14206753.8,42.008556764902586,50.689370993383314,NaN,NaN,-107.20121313055886,-46.03966213945564,-0.1419294745583866,0.015217531621317448,0.15714700617970404,974753774,982578976.8,33.47406590543051,37.374071665040795,NaN,NaN,0.8409356003901598,11.834541611391678
2017-06-28T09:30:00-04:00,55.29,55.82,54.92,55.77,12975962,14143244.75,49.261030894424486,48.86073868711413,NaN,NaN,-78.12905526509903,-50.277699380560534,-0.1215514050122849,0.0052077499143479145,0.1267591549266328,987729736,985692749.6,36.048656028642505,34.87427487779626,NaN,NaN,0.34689902573371,10.193449813440541
2017-06-29T09:30:00-04:00,55.51,55.51,54.33,54.77,20973423,14770104.05,41.2160621684887,48.17996344066918,NaN,NaN,-135.00393524966776,-68.586338575668,-0.1673802031416199,-0.08246609900039203,0.08491410414122784,966756313,982853276.8,34.72875371063121,32.640219123859964,NaN,NaN,-3.1113671817909156,8.292761671264618
2017-06-30T09:30:00-04:00,55,55.09,54.67,54.72,15371868,15114146.85,40.85677669963619,47.74394900000147,NaN,NaN,-130.53282441712372,-91.89688111861115,-0.19129548799603618,-0.1542052558538174,0.037090232142218786,951384445,973654716.2,30.79505942816911,31.027248408477828,NaN,NaN,-5.815099178838102,6.2773529783928
2017-07-03T09:30:00-04:00,54.95,55.05,54.28,54.34,16552937,15603502.05,38.13592005507292,46.777383813763734,NaN,NaN,-149.01482373380134,-119.97637035925013,-0.22084595646241456,-0.2389672134357994,-0.018121256973384854,934831508,963091155.2,27.011234809377157,29.55466795253376,NaN,NaN,-8.921977377947783,4.106020070344146
2017-07-05T09:30:00-04:00,54.54,54.985,54.36,54.88,14809389,15959712.05,43.857645663433466,46.44316199008493,NaN,NaN,-115.30546603024885,-121.59722093918813,-0.1931637611387108,-0.2595759583967734,-0.06641219725806256,949640897,958068579.8,25.412424785990254,28.521928283752697,NaN,NaN,-9.582914619385932,2.1504579718112775
2017-07-06T09:30:00-04:00,54.4,54.68,54.25,54.38,12793357,16164196.5,40.154399887813234,46.041981562738464,NaN,NaN,-137.46621462965456,-133.46465281209925,-0.19699049843958205,-0.31265032030754014,-0.11565982186795808,936847540,947892140.6,22.505729068194725,27.828272454232266,NaN,NaN,-11.371695005214834,0.21872183223611885
2017-07-07T09:30:00-04:00,54.58,55.19,54.54,55.01,8818162,16249983.1,46.30638269671831,46.31833423493452,NaN,NaN,-74.07249750282662,-121.278365262731,-0.1478028790803986,-0.30041342071845634,-0.15261054163805773,945665702,943674018.4,21.412457684468407,27.39629898529853,NaN,NaN,-10.77841837642711,-1.3522981975729138
2017-07-10T09:30:00-04:00,55.02,55.535,54.94,55.41,5594233,14772570.8,49.83259646180244,46.1584897058522,NaN,NaN,-17.104504221072034,-98.59270122352068,-0.08230657433013874,-0.25549375955073117,-0.17318718522059243,951259935,943649116.4,21.40584668595058,27.066598645293023,NaN,NaN,-9.113643598991823,-2.4610618263470436
2017-07-11T09:30:00-04:00,55.35,55.62,55.14,55.53,6856538,13330078.3,50.87490269528314,46.40783584624601,NaN,NaN,2.523756836135812,-68.28498510953325,-0.02770307858814841,-0.20781603345577793,-0.18011295486762952,958116473,948306109.4,26.006805635869227,27.270977009592183,NaN,NaN,-7.46882315369099,-3.1764563016818927
2017-07-12T09:30:00-04:00,55.91,56.3,55.875,56.25,16551936,13243002.95,56.68930169025961,46.83726364899514,NaN,NaN,104.07284573455927,-24.409322756571626,0.055564349231893434,-0.11065751832776272,-0.16622186755965615,974668409,953311611.8,30.70252669767271,27.898086699934613,NaN,NaN,-4.111092677188674,-3.3099757838971473
2017-07-13T09:30:00-04:00,56.33,56.555,56.23,56.36,8125081,12840226.8,57.51660636916743,47.310530238957085,NaN,NaN,126.6979065781392,28.423501484987128,0.11337734088640433,-0.02450019145165072,-0.13787753233805505,982793490,962500801.8,38.42773003910243,29.08249204370274,NaN,NaN,-1.1863203252433123,-3.006596432660885
2017-07-14T09:30:00-04:00,56.6,56.92,56.52,56.86,6689615,12437184.65,61.14931815019257,47.778629784765464,NaN,NaN,149.92033353573143,73.22206769269873,0.17683581152789646,0.08316723207181553,-0.09366857945608092,989483105,971264282.4,44.75308149168891,30.263744892081036,NaN,NaN,2.46552960177861,-2.2248641420266715
2017-07-17T09:30:00-04:00,56.91,57.03,56.76,56.87,9837090,11848476.25,61.22073915350901,48.505731382193176,NaN,NaN,140.75337349090069,104.79364323509326,0.20883246128081684,0.1673719971449401,-0.041460464135876715,999320195,980876334.4,50.73158210370203,31.67256814820642,NaN,NaN,5.391471693475668,-1.1368161655263374
2017-07-18T09:30:00-04:00,56.76,57.13,56.62,57.13,9920176,11848025.1,63.11913357099258,50.013629725485316,NaN,NaN,132.14356573818975,130.71760501550403,0.23491057849822394,0.2521777589869032,0.01726718048867927,1009240371,991101114,56.165608322642065,33.29339260657867,NaN,NaN,8.41657752421708,0.22795436157986515
2017-07-19T09:30:00-04:00,57.22,57.47,57.17,57.42,6673574,11633817.05,65.16738084654773,51.1497975792084,NaN,NaN,146.35812314707078,139.17466049800638,0.2572911373754332,0.33888110220797074,0.08158996483253757,1015913945,999350221.2,59.99882635387469,35.00411905838097,NaN,NaN,11.59172136704738,1.8513496480752245
2017-07-20T09:30:00-04:00,57.58,57.6,57.21,57.54,10372868,11537802.95,66.00861720459223,52.920694367501525,NaN,NaN,133.3501323600723,140.505105654393,0.26474549104441464,0.41252182863805587,0.14777633759364123,1026286813,1008048885.8,63.6123648949433,37.0672341429747,NaN,NaN,14.47157453400886,3.6542389174943155
2017-07-21T09:30:00-04:00,57.29,57.48,57.23,57.47,5919823,11394153.85,65.02212302788206,54.6467905338048,NaN,NaN,112.97360443770236,133.11575983478718,0.24972485426851504,0.45993240542928504,0.21020755116077,1020366990,1014225662.8,65.96360779236895,39.57927331184611,NaN,NaN,16.612364866296257,5.505399767323164
2017-07-24T09:30:00-04:00,57.44,57.66,57.32,57.61,5378125,10841881.55,66.1129170659967,56.6451474631565,NaN,NaN,109.86045973018321,126.93717708264367,0.2342372714395885,0.5030041404602557,0.26876686902066715,1025745115,1019510646.8,67.87626083020177,42.49820374190501,NaN,NaN,18.731986444518444,7.394912149779632
2017-07-25T09:30:00-04:00,57.43,57.615,57.25,57.5,6880283,10699498.95,64.41321188655849,58.11340219337971,NaN,NaN,94.29076567387432,119.36661706978057,0.20278061047742935,0.5222426321174538,0.31946202164002446,1018864832,1021435539,68.56904455630301,45.58081943978449,NaN,NaN,20.10773879348043,9.21103024173689
2017-07-26T09:30:00-04:00,57.81,57.82,57.53,57.72,10602647,10584854.35,66.2803849160341,59.97954398110977,NaN,NaN,98.27825480149943,109.7506434006663,0.18356150189136722,0.5489138990042335,0.36535239711286627,1029467479,1024146245.8,69.56448006256517,48.94215879652524,NaN,NaN,21.80450715015554,11.010098371510981
2017-07-27T09:30:00-04:00,58.13,58.2,56.79,57.5,23047172,11088414.85,62.73556428162739,61.153056951460414,NaN,NaN,77.92673401708086,98.66596373206801,0.14452200561074624,0.5460049041262991,0.40148289851555286,1006420307,1020172944.6,66.25232765728526,52.145006651726455,NaN,NaN,22.36790316014178,12.632641912743953
2017-07-28T09:30:00-04:00,57.21,57.55,57.16,57.44,10293081,10554397.75,61.765350572571855,62.005396530801086,NaN,NaN,65.3674703260164,89.14473690973081,0.10498742053888488,0.532717174189159,0.4277297536502741,996127226,1015324991.8,62.35146205199808,55.06969346358699,NaN,NaN,22.598762224797103,14.056373385894403
2017-07-31T09:30:00-04:00,57.53,57.66,57.1,57.16,10982828,10334945.75,57.3110128054526,62.46511868152748,NaN,NaN,55.60217508055836,78.29307997980585,0.0529358180733438,0.4938995262419539,0.4409637081686101,985144398,1007204848.4,56.36513552538158,57.23814559855215,NaN,NaN,21.63305407718015,15.138756341792368
2017-08-01T09:30:00-04:00,57.45,57.5,57.24,57.45,8307155,9922656.65,60.48919481760439,62.736539619194964,NaN,NaN,57.48137177766491,70.93120120056396,0.032022839551666404,0.4809922576081931,0.4489694180565267,993451553,1002122192.6,52.939024893603154,58.82646689826147,NaN,NaN,21.615133749915753,16.063953114381423
2017-08-02T09:30:00-04:00,58.04,58.05,57.25,57.61,12573937,9810884.05,62.16293123809669,63.068419966975625,NaN,NaN,72.69163399783076,65.81387703983026,0.023353957328590635,0.47816186471726496,0.4548079073886743,1006025490,997433794.8,49.924473074613545,59.647662829369416,NaN,NaN,22.04435163702859,16.918295760473875
2017-08-03T09:30:00-04:00,57.69,57.69,57.305,57.48,10687844,9705608.4,59.941135126299464,62.98212117955469,NaN,NaN,57.863220926567706,61.80117442172762,0.004253523688796279,0.4601248119996697,0.4558712883108734,995337646,995217262.6,48.517834574259936,59.91657376383877,NaN,NaN,21.824834080530373,17.61922980619623
2017-08-04T09:30:00-04:00,57.6,57.785,57.48,57.61,4756919,9502546.25,61.42588524565838,62.996774471851076,NaN,NaN,69.11146718263396,62.54997379305113,-0.003801030041182263,0.4511200007593956,0.4549210308005779,1000094565,996010730.4,49.071024038132634,59.797962473440954,NaN,NaN,22.02128525578774,18.24809487042359
2017-08-07T09:30:00-04:00,57.69,57.96,57.665,57.96,7683006,9606984.9,65.16897592951383,63.143191783174025,NaN,NaN,100.17436577519157,71.46441193197776,0.009538542134315875,0.46684420846847274,0.45730566633415687,1007777571,1000537365,52.22493341274292,59.51648569416244,NaN,NaN,23.22498872688106,18.959079707060372
2017-08-08T09:30:00-04:00,57.88,58.33,57.72,57.88,10460698,9787192.9,63.648672220573516,63.03471259560444,NaN,NaN,130.43478260869566,86.05509409818393,0.008124919829669397,0.4674618161212436,0.4593368962915742,997316873,1001310429,52.76294517736953,58.99963703869779,NaN,NaN,23.835722854426766,19.655743013827
2017-08-09T09:30:00-04:00,57.51,57.89,57.48,57.85,6972812,9308236.7,63.05462311841699,62.82371301802049,NaN,NaN,87.12203498536175,88.94117429569012,0.0007107503139370253,0.46022533418399547,0.45951458387005845,990344061,998174143.2,50.288683636960705,58.04794552027046,NaN,NaN,24.196330614630853,20.30439838537041
2017-08-10T09:30:00-04:00,57.54,57.6,56.675,56.71,14911852,9647575.25,45.62743466802596,61.438378135173636,NaN,NaN,-121.21428316626971,53.125673477122646,-0.08091500970777327,0.35837082173534185,0.4392858314431151,975432209,994193055.8,47.25916661032482,56.71191400726731,NaN,NaN,18.849347687121515,20.09653399990628
2017-08-11T09:30:00-04:00,56.8,57.285,56.73,57.1,14968108,10061499.9,50.652271870004256,60.33404633545989,NaN,NaN,-120.42682926829578,15.218014186936696,-0.10695075240512886,0.305597390936704,0.4125481433418329,990400317,992254206.2,45.81170621473898,55.13587439187711,NaN,NaN,15.962660790798466,19.50598068431945
2017-08-14T09:30:00-04:00,57.62,58.09,57.5,58.01,9758534,10057572.1,59.95224712492629,60.0154059953433,NaN,NaN,122.49667994687815,19.682477021274003,-0.06334996496313117,0.3333606871379189,0.39671065210105005,1000158851,990730462.2,44.65416834888753,53.427668948490286,NaN,NaN,16.688552946292823,19.103491007458505
2017-08-15T09:30:00-04:00,58.13,58.225,57.92,58.1,7052565,9914191.55,60.7402858562774,59.6196846339321,NaN,NaN,166.82020574236054,26.95956164800699,-0.030574071784099655,0.3584930623709255,0.38906713415502514,1007211416,992709370.8,46.543287695765194,51.783298065147434,NaN,NaN,17.512372157028715,18.876188314539963
2017-08-16T09:30:00-04:00,58.19,58.48,58.08,58.27,9055919,10033308.8,62.251279849435264,59.58509288877552,NaN,NaN,185.01810080757218,46.53877481244908,-0.0011260814965890487,0.38765953228428884,0.3887856137808779,1016267335,997894025.6,51.239240593850084,50.71093470347349,NaN,NaN,18.662600376137004,18.845675751910967
2017-08-17T09:30:00-04:00,58.05,58.14,57.13,57.13,12968882,10163109.5,48.71208259735679,58.65271660483159,NaN,NaN,-31.841796547683895,64.41327213616623,-0.05890624161427438,0.3151528117630349,0.37405905337730927,1003298453,1003467274.4,55.74019159564516,50.238701099448285,NaN,NaN,14.728107108183277,18.25745165994987
2017-08-18T09:30:00-04:00,57.13,57.47,56.85,57.07,16696480,10701942.35,48.11889594868016,57.99613682934784,NaN,NaN,-113.19064529545842,65.8605089307337,-0.09927304888207161,0.24996774227471974,0.34924079115679135,986601973,1002707605.6,54.99501756425792,50.1408355307966,NaN,NaN,11.554186851725964,17.29984240163217
2017-08-21T09:30:00-04:00,57.11,57.17,56.67,57.05,7978621,10831967.15,47.90946569147465,57.09758474891,NaN,NaN,-135.34594127303714,14.291984686750647,-0.12383043928431597,0.1944527420513964,0.3182831813357124,978623352,998400505.8,50.84470933277886,49.99124156216629,NaN,NaN,9.031682525140262,16.118676704990467
2017-08-22T09:30:00-04:00,57.35,57.94,57.31,57.9,8461229,10911014.45,56.56239668359432,56.69754656644555,NaN,NaN,36.68389814282632,-11.735276833156197,-0.08138785234965878,0.2165483658986389,0.2979362182482977,987084581,994375138.8,47.255378550282686,49.80059195328551,NaN,NaN,9.70460699729285,15.202381032462236
2017-08-23T09:30:00-04:00,57.58,57.915,57.56,57.76,8923746,10827069.4,54.94351662264249,56.34057381618434,NaN,NaN,42.16216216215632,-40.30646456223936,-0.06216987596657336,0.22022387329008097,0.28239374925665434,978160835,986753838.8,41.30938178147127,49.28570246808632,NaN,NaN,9.706132421103513,14.41720265941099
2017-08-24T09:30:00-04:00,57.9,57.9562,57.42,57.71,8094109,10079416.25,54.34527678788123,55.83481606920025,NaN,NaN,28.356796074526514,-28.266746037797294,-0.05263078615334282,0.2166052665649758,0.26923605271831863,970066726,980107493.4,36.94369758997586,48.41946486464655,NaN,NaN,9.524069478892205,13.718183633622592
2017-08-25T09:30:00-04:00,57.9,58.07,57.58,57.7,8333057,9981415.05,54.21812629176703,55.052612523646914,NaN,NaN,44.073310361254805,3.1860450935453626,-0.046985627021057574,0.21050401894199666,0.25748964596305424,961733669,975133832.6,34.04418805626062,47.12084019632639,NaN,NaN,9.341401663881284,13.09292906651669
2017-08-28T09:30:00-04:00,57.84,57.915,57.65,57.81,5993304,9731938.85,55.452805073865946,54.46719344173922,NaN,NaN,42.077874727585346,38.67080829366986,-0.036311827365187094,0.21209986175657036,0.24841168912175746,967726973,972954556.8,32.82840879881289,45.6969447407152,NaN,NaN,9.53520928500585,12.584683383443714
2017-08-29T09:30:00-04:00,57.34,58.135,57.27,58.06,8689804,9751071.3,58.21117547429575,54.121232895730564,NaN,NaN,45.43350404194081,40.420729473492756,-0.014028476531511264,0.23087609345736837,0.24490456998887963,976416777,970820996,31.637201568407946,44.36469602153286,NaN,NaN,10.4817641491726,12.284266349976413
2017-08-30T09:30:00-04:00,58.12,58.52,57.985,58.48,7654021,9505075.5,62.42106460854779,55.32077789148212,NaN,NaN,147.40924533798884,61.470146108659264,0.025244362578527246,0.27646002321203866,0.2512156606335114,984070798,972002988.6,33.08580713341364,43.35231320175349,NaN,NaN,12.570764007974,12.325194586833211
2017-08-31T09:30:00-04:00,58.62,58.93,58.55,58.83,9425768,9441971.7,65.53685904544636,56.383962689727966,NaN,NaN,213.2928830564373,98.45736350504141,0.06858236320170563,0.3369436146356435,0.26836125143393785,993496566,976688956.6,38.63723243086894,42.83985078861991,NaN,NaN,15.329112096831293,12.75432565969008
2017-09-01T09:30:00-04:00,58.98,59.03,58.705,58.78,6013134,9504782.45,64.71140706918638,56.723902685746545,NaN,NaN,189.51373547078367,127.54544852694718,0.08651310009515167,0.3765026265528775,0.2899895264577258,987483432,981838909.2,44.123811321166166,42.80196814378267,NaN,NaN,17.347374809112036,13.41047553817893
2017-09-05T09:30:00-04:00,58.61,58.715,57.87,58.26,11901718,9715718.05,56.71133205501285,56.436120271370505,NaN,NaN,79.64048096032099,135.05796977349434,0.05738761459698327,0.3617240447039549,0.30433643010697164,975581714,983409857.4,45.718200158738576,42.74303331970934,NaN,NaN,16.777249468735885,13.89144324254421
2017-09-06T09:30:00-04:00,58.44,58.52,58.06,58.31,9113735,9648369.9,57.258492129134225,56.079492577063284,NaN,NaN,75.86102705898423,141.14347437690301,0.03654027700574708,0.3500117763641555,0.3134714993584084,984695449,985065591.8,47.421112728560956,42.470309900760114,NaN,NaN,16.470696633184502,14.25990801263568
2017-09-07T09:30:00-04:00,58.5,58.63,58.29,58.51,7693809,9684419.75,59.46552790729218,56.847595813487246,NaN,NaN,92.09960706911897,130.08154672312904,0.031463740923338646,0.3528011755125817,0.3213374345892431,992389258,986729283.8,49.14741978277013,41.9993976284119,NaN,NaN,16.83803535769988,14.628211919073424
2017-09-08T09:30:00-04:00,58.42,58.5,57.985,58.03,6259222,9251788.25,52.46365814304489,57.157935970227584,NaN,NaN,39.03273859382038,95.22951783060566,-0.006929565520548353,0.31267547768855763,0.319605043209106,986130036,985255977.8,47.65523708002278,41.47512759382368,NaN,NaN,15.057591487572818,14.68955185743048
2017-09-11T09:30:00-04:00,58.49,58.91,58.49,58.85,7037299,8855247.8,60.92765550988667,58.08780667154273,NaN,NaN,118.58206895072806,81.04318452659453,0.01878621923629764,0.343087817254478,0.32430159801818037,993167335,986392758.4,48.94331539361199,41.33931374102605,NaN,NaN,16.203226516680306,14.905791094466169
2017-09-12T09:30:00-04:00,59.02,59.1,58.72,58.99,7861747,8760408.45,62.16624689213332,58.48808168643837,NaN,NaN,129.51352032207453,91.01779239894522,0.03989744743829576,0.3741734073160501,0.3342759598777543,1001029082,991482232,54.358461763513716,41.84667682768539,NaN,NaN,17.51349860213333,15.27832073841862
2017-09-13T09:30:00-04:00,58.92,58.93,58.68,58.91,8128285,8814194.45,60.97673340032664,58.91902574198724,NaN,NaN,101.74365156275947,96.19431729970029,0.042885122936777764,0.3878823635487265,0.34499724061194875,992900797,993123301.6,55.979709244806095,42.894557360780745,NaN,NaN,18.204965205820546,15.696412805190324
2017-09-14T09:30:00-04:00,58.69,58.975,58.58,58.71,7626701,8742733.55,57.98937163479965,59.17931823105284,NaN,NaN,82.98280938356446,94.37095776258937,0.02660082429766003,0.3782482709840238,0.3516474466863638,985274096,991700269.2,54.182412246106296,44.125894121932916,NaN,NaN,17.894093015268545,16.010367120915785
2017-09-15T09:30:00-04:00,58.45,58.79,58.35,58.74,13123809,8750479.9,58.31923590565379,59.472254632044745,NaN,NaN,60.52283390173895,98.66897682417309,0.013708309491170523,0.3687828335503269,0.3550745240591564,998397905,994153843,56.76017059990644,45.74846430362191,NaN,NaN,17.734221574536672,16.256632042861625
2017-09-18T09:30:00-04:00,58.83,59.005,58.57,58.79,10411964,8436254.1,58.89848763041539,59.71837481465543,NaN,NaN,77.61379561760106,90.4753221575477,0.004862655277337591,0.3611528431558284,0.3562901878784908,1008809869,997282349.8,59.86114130484712,47.679373768338635,NaN,NaN,17.75869636604606,16.4712126604594
2017-09-19T09:30:00-04:00,58.88,59.17,58.73,59.05,5616132,8318129.65,61.866250519902266,59.97945160362732,NaN,NaN,100.57543813629883,84.68770572039254,0.012407825119625349,0.3717999692780225,0.35939214415839715,1014426001,999961733.6,62.35140303847159,49.873245301914615,NaN,NaN,18.60241504336139,16.775670143731112
2017-09-20T09:30:00-04:00,59.04,59.06,58.4,58.81,8950822,8342609.3,57.722985087478726,59.64387449497953,NaN,NaN,57.50909207500679,75.84079382284202,-0.0021061961858025446,0.35675939892614394,0.3588655951119465,1005475179,1002476610,64.5730745226548,52.12233582971755,NaN,NaN,18.178988907055764,16.97614425277749
2017-09-21T09:30:00-04:00,58.79,58.79,58.3,58.49,8104649,8301654.45,52.65907903233864,58.724033065471836,NaN,NaN,12.45915187541009,61.73606232121112,-0.034786254823219565,0.315382776582922,0.3501690314061416,997370530,1004895896.8,66.61410487533249,54.120683861464954,NaN,NaN,16.336542548251305,16.88477258070232
2017-09-22T09:30:00-04:00,58.3,58.6,58.27,58.52,4824802,8138189.1,53.074702301710026,57.892839867794955,NaN,NaN,-7.794738551479621,48.072547830567416,-0.05472382380322832,0.28176425165210617,0.3364880754553345,1002195332,1005655382.2,67.25195426579207,55.77269407179538,NaN,NaN,14.934502939258568,16.606162631924644
2017-09-25T09:30:00-04:00,58.33,58.33,57.57,57.83,13573050,8400188.75,43.5946834716353,56.95593639755369,NaN,NaN,-131.9598286811402,6.157822970819177,-0.11145347810260586,0.1971712278270772,0.30862470592968305,988622282,1001617864.8,60.621249869317055,56.83719762255098,NaN,NaN,10.608091176010525,15.74929528107977
2017-09-26T09:30:00-04:00,58.14,58.28,57.86,58.04,9053314,8553189.25,46.71420488460321,56.202773022944335,NaN,NaN,-106.9469924191703,-35.34666314027465,-0.1305799140221171,0.14539981340203667,0.2759797274241538,997675596,998267783.8,55.712893813713805,57.42946770006189,NaN,NaN,7.943506427857653,14.634182587762325
2017-09-27T09:30:00-04:00,58.3,58.81,58.21,58.63,7635478,8500472.95,54.35258880421058,55.83756308700993,NaN,NaN,-1.4725568942449705,-47.142992934125004,-0.1005864114923295,0.15024671305874193,0.25083312455107143,1005311074,998234962.8,55.66534088926527,57.895033493382975,NaN,NaN,8.024149287549857,13.689892116303401
2017-09-28T09:30:00-04:00,58.48,58.725,58.36,58.7,5589237,8397233.75,55.17361026048148,56.03113109539827,NaN,NaN,7.320883168963725,-48.17064667541427,-0.0743337205252371,0.15791597389452505,0.23224969441976215,1010900311,1000940919,58.78849640719048,58.690266302466384,NaN,NaN,8.343773723306512,12.926160917303845
2017-09-29T09:30:00-04:00,58.8,59.15,58.73,59.1,12428714,8547381.05,59.64073646249243,55.93920830629868,NaN,NaN,110.9619686800885,-24.419305229100647,-0.03057265657001701,0.1940338737072409,0.2246065302772579,1023329025,1005167657.6,63.15467898551121,59.70536370188775,NaN,NaN,10.047931504404135,12.514985286889601
2017-10-02T09:30:00-04:00,59.25,59.3773,58.901,59.19,7571862,8625317.45,60.592310604890564,55.82678428578134,NaN,NaN,142.1559360455378,30.403847716234953,0.0021544945814059024,0.2272996485040153,0.2251451539226094,1030900887,1013623378.6,70.00180723142039,60.82274552102394,NaN,NaN,11.714213998734262,12.400589388581695
2017-10-03T09:30:00-04:00,59.24,59.355,59.17,59.33,6466221,8353542.6,62.089673721538176,55.906280023010744,NaN,NaN,153.01048295845789,82.3953427917606,0.029436164269328796,0.2619403592592704,0.2325041949899416,1037367108,1021561681,74.74651174006792,62.16323141354264,NaN,NaN,13.541782324722696,12.563616950887551
2017-10-04T09:30:00-04:00,59.23,59.3799,59.03,59.29,6649636,8230337.65,61.37215347330756,56.147907297189874,NaN,NaN,126.14778659358556,107.91941148932669,0.04032029100670903,0.2829045587483279,0.24258426774161884,1030717472,1026642960.6,77.22920162189547,63.80943065467044,NaN,NaN,14.83723539393686,12.888419585608881
2017-10-05T09:30:00-04:00,59.47,59.87,59.44,59.86,6422654,8166779.9,67.19066340948308,56.78158069032053,NaN,NaN,205.2914316411493,147.51352118376383,0.07919306841676044,0.3415756032625694,0.262382534845809,1037140126,1031890923.6,79.47367591320037,65.43182389133429,NaN,NaN,17.854343746131914,13.597837322826457
2017-10-06T09:30:00-04:00,59.66,59.98,59.64,59.95,5926382,8150137.9,68.01002853073273,57.4324050403432,NaN,NaN,196.41722125620169,164.60457169898646,0.10275783895760648,0.3908298335428171,0.2880719945852106,1043066508,1035838420.2,80.99143031203172,66.94113024899033,NaN,NaN,20.563553499937797,14.592939633842363
2017-10-09T09:30:00-04:00,60.04,60.23,60,60.1,6949243,8145735.1,69.38243907976862,57.96927565176223,NaN,NaN,195.033698225115,175.1801241349019,0.11908739707582078,0.4369312409299866,0.3178438438541658,1050015751,1039661393,82.35237569059348,68.36977115271333,NaN,NaN,23.24113980548127,15.82839680121935
2017-10-10T09:30:00-04:00,60.29,60.34,59.85,60.16,5472917,8026293.6,69.93800132058676,58.841776811269945,NaN,NaN,161.10878049133694,176.79978364147772,0.12401102778658041,0.47285762858739133,0.3488466008008109,1055488668,1043285705,83.55449486857361,69.72558689170752,NaN,NaN,25.614668274672525,17.22643558314123
2017-10-11T09:30:00-04:00,60.08,60.38,60.08,60.36,4980942,7868926.45,71.77639311675571,60.20729924587116,NaN,NaN,151.11361771609856,181.7929498659803,0.13017936602741498,0.5115708083350796,0.38139144230766464,1060469610,1049236132.6,85.32227157016125,71.06188451276672,NaN,NaN,28.19534339901037,18.79342241397968
2017-10-12T09:30:00-04:00,60.22,60.5,60.14,60.21,6106396,7792911.2,68.39800453685876,61.30182083409608,NaN,NaN,129.71843913461862,166.67835136467417,0.11417162090688915,0.5241059684412761,0.40993434753438696,1054363214,1052680750.2,86.2440932852194,72.41846587129724,NaN,NaN,29.469123664170333,20.318522592578343
2017-10-13T09:30:00-04:00,60.43,60.605,60.43,60.5,5949956,7434218.55,71.21854383367094,63.27495371709862,NaN,NaN,133.338382233466,154.06258356012705,0.11292304066952985,0.5510881483712993,0.4381651077017694,1060313170,1056130082.6,87.11665365371825,74.31099471304017,NaN,NaN,31.412727917622117,21.903409067584597
2017-10-16T09:30:00-04:00,60.65,60.73,60.51,60.72,8306357,7328938.2,73.17456599876925,65.16497951096763,NaN,NaN,126.66832898069705,140.38950971124345,0.11626606076872115,0.5834976836626709,0.4672316228939497,1068619527,1059850837.8,88.00082868864216,76.61727577553506,NaN,NaN,33.66299939536317,23.583350542981538
2017-10-17T09:30:00-04:00,60.7,60.72,60.52,60.72,5131673,7304715.25,73.17456599876925,66.5094064534361,NaN,NaN,109.59815967626739,130.08738554822955,0.10800688045651868,0.602240223464598,0.49423334300807936,1068619527,1062477009.6,88.59574152209638,78.96944724930871,NaN,NaN,35.50083072131338,25.28584771131466
2017-10-18T09:30:00-04:00,60.9,60.95,60.68,60.87,6091317,7161740,74.54264815633593,67.89290916028285,NaN,NaN,110.32505041715727,121.9296720884413,0.10223510562258076,0.6220272250363053,0.5197921194137245,1074710844,1065325256.4,89.21999397210223,81.14312564680242,NaN,NaN,37.466384221105606,27.02592435557051
2017-10-19T09:30:00-04:00,60.61,60.76,60.29,60.69,6872564,7100135.75,69.93354035300489,68.6281094381766,NaN,NaN,81.4894121282824,112.28386668717405,0.07703211078199779,0.6160822578912217,0.5390501471092239,1067838280,1068020269.6,89.78951223419938,83.04561373599442,NaN,NaN,37.90939256942583,28.580705528978413
2017-10-20T09:30:00-04:00,61.06,61.17,60.96,61.1,7407398,7229265.55,73.89323062419126,69.57817515384093,NaN,NaN,112.84261807408787,108.18471385529844,0.07844803621201069,0.6371101923742373,0.5586621561622266,1075245678,1071006771.2,90.39508812144958,84.5022766567108,NaN,NaN,39.486741785389846,30.138710708465762
2017-10-23T09:30:00-04:00,61.2,61.25,60.74,60.81,7055234,6903374.75,67.15626568543442,69.94007457983352,NaN,NaN,95.28794838332239,101.9086377358235,0.05162279640740164,0.6231906516714787,0.571567855264077,1068190444,1070920954.6,90.22948679628328,85.60820344644047,NaN,NaN,38.80694650592433,31.3770301081027
2017-10-24T09:30:00-04:00,60.93,61.08,60.731,60.98,8035815,6852499.8,68.94375783896479,70.48090346309475,NaN,NaN,90.21279202825444,98.0315642062209,0.03774123131408458,0.6187443944066828,0.5810031630925983,1076226259,1072442301,90.55966461156376,86.56037937427391,NaN,NaN,38.76632511663335,32.43264368074993
2017-10-25T09:30:00-04:00,60.84,61.02,60.25,60.65,9225908,6932021.3,61.90105496400227,70.10307428841755,NaN,NaN,57.30146801163714,87.42684772511687,0.0007053535402787858,0.5818848550179467,0.581179501477668,1067000351,1070900202.4,87.33784156770842,87.12210549245307,NaN,NaN,36.529621113608236,33.017926171158265
2017-10-26T09:30:00-04:00,61,61.16,60.855,60.9,9436449,7124381.9,64.83196987211063,69.87607009851597,NaN,NaN,89.38590526877091,89.00614635321458,-0.01188907956543872,0.5663181520208695,0.5782072315863083,1076436800,1072619906.4,87.8566781911216,87.61248034095948,NaN,NaN,35.52743141363492,33.3764269200835
2017-10-27T09:30:00-04:00,61.88,62.71,61.88,62.54,14539163,7229904.35,77.21501636499084,70.43553990460326,NaN,NaN,232.009117903402,112.83944631907741,0.08022978265584302,0.678494459906112,0.598264677250269,1090975963,1075765963.4,88.76375033570369,88.07043567275308,NaN,NaN,39.538684128465675,34.25674937842381
2017-10-30T09:30:00-04:00,62.56,62.92,62.4434,62.68,8574688,7280045.65,77.92944935471597,71.00635762132679,NaN,NaN,237.1930917033463,141.2204749830822,0.13724253114762175,0.7698178411847962,0.6325753100371745,1099550651,1082038004.8,90.31669182346232,88.55344974095941,NaN,NaN,42.73820434762129,35.46838580259488
2017-10-31T09:30:00-04:00,62.92,63.0756,62.67,62.95,10111336,7462301.4,79.27886788892762,71.54224867648192,NaN,NaN,216.40498843377745,166.4589142641868,0.17724623799364936,0.8541331075292362,0.6768868695355869,1109661987,1088725150.4,91.64288459863972,89.00492210013645,NaN,NaN,45.71435379436652,36.932095515705115
2017-11-01T09:30:00-04:00,63.25,63.33,62.63,62.96,9550669,7607353.05,79.32927712153364,72.32305386110156,NaN,NaN,185.5731679301658,192.1132542478925,0.18749537401794736,0.9112560870580211,0.7237607130400737,1119212656,1099167611.4,93.20735862151383,89.50229819558605,NaN,NaN,47.97233379245721,38.509272412383986
2017-11-02T09:30:00-04:00,62.96,63.05,62.51,62.99,10224594,7797450.05,79.49047456729039,72.91390605636009,NaN,NaN,140.95423274529654,202.42691974319763,0.17940665823928004,0.9480190358391738,0.7686123775998938,1129437250,1109767701.4,94.36129685365711,90.0197727098674,NaN,NaN,49.78705818747684,40.12038466596868
2017-11-03T09:30:00-04:00,63.32,63.55,62.95,63.49,7659654,7884113.65,82.00871965356296,73.5449170317025,NaN,NaN,145.0153555398093,185.02816727047912,0.18983355399075763,1.0059043200883409,0.8160707660975832,1137096904,1118991889.6,95.13570062307215,90.52940641946954,NaN,NaN,52.20952778103535,41.8474051109782
2017-11-06T09:30:00-05:00,63.45,63.65,63.41,63.63,6000230,7836663,82.6510497910161,74.2218087311487,NaN,NaN,134.0544553143008,164.40043999267,0.18791205319413273,1.050960832590249,0.8630487793961164,1143097134,1127701186.2,95.73174451639397,91.03912091906224,NaN,NaN,54.36378472556449,43.635459341633386
2017-11-07T09:30:00-05:00,63.7,63.72,63.395,63.66,5775620,7851798.15,82.7928196285792,74.81110669345178,NaN,NaN,116.51518751732809,144.42247980938015,0.1709033123163637,1.076677919791571,0.9057746074752073,1148872754,1135543339.6,96.1850432457466,91.53662443860826,NaN,NaN,56.12807115179081,45.42011817165587
2017-11-08T09:30:00-05:00,63.66,64.02,63.485,64.01,9100464,8057774.25,84.39498153317564,75.8440667777497,NaN,NaN,114.42288269752129,130.1924227628512,0.1653619371492665,1.1124770289117905,0.947115091762524,1157973218,1143295452,96.5725462781717,92.02112687032056,NaN,NaN,58.15616867623977,47.239553958025
2017-11-09T09:30:00-05:00,63.52,63.61,62.86,63.5,10245418,8264725.35,73.63594526961589,75.82568925242289,NaN,NaN,76.85728250244465,117.37303271428084,0.11203848850554077,1.08716320239445,0.9751247138889092,1147727800,1146953562,96.74078276012222,92.47439077308289,NaN,NaN,56.52199661856443,48.56561719524492
2017-11-10T09:30:00-05:00,63.42,63.55,63.265,63.5,5983174,8266386.25,73.63594526961589,76.28852350843586,NaN,NaN,75.93709454353721,103.55738051502644,0.06385311535862626,1.054941108087192,0.9910879927285657,1147727800,1149079741.2,96.83793377197689,92.94642269991814,NaN,NaN,55.232853314810285,49.518079498039974
2017-11-13T09:30:00-05:00,63.26,63.56,63.25,63.48,4300290,8066082.9,73.21145768830871,76.59335921196042,NaN,NaN,69.58480219349859,90.663449890866,0.019992257832553095,1.0160783150192572,0.9960860571867041,1143427510,1149145816.4,96.84108511187941,93.39509559279784,NaN,NaN,54.066635062466275,50.167873150100874
2017-11-14T09:30:00-05:00,63.29,63.42,62.995,63.35,7370757,8178037.1,70.3717633442674,77.19840981055077,NaN,NaN,54.9621422264596,78.35284083269231,-0.025924327873578568,0.9636806473447308,0.9896049752183094,1136056753,1146582616.2,92.97031555168776,93.79741516308208,NaN,NaN,52.2832036092932,50.47006321569978
2017-11-15T09:30:00-05:00,63.04,63.1266,62.705,62.88,8492534,8298097.95,61.13866090974241,76.93460202752449,NaN,NaN,28.747942114121326,61.21785271601233,-0.09236129979144869,0.8741533504789984,0.9665146502704471,1127564219,1140500816.4,84.3547914604926,93.54728039660858,NaN,NaN,47.853945488149726,50.096332111764056
2017-11-16T09:30:00-05:00,63.34,63.89,63.34,63.76,7641083,8336523.9,69.26880386834031,76.36701542062087,NaN,NaN,77.38884685065231,61.324165585653816,-0.0818129601522285,0.8642484500801615,0.94606141023239,1135205302,1137996316.8,81.02490477065021,92.9945057133905,NaN,NaN,46.28033503050185,49.55118967158374
2017-11-17T09:30:00-05:00,63.67,63.72,63.305,63.35,8302190,8381263.5,62.688387314697,75.27836813204809,NaN,NaN,58.94966246389195,57.926679169724764,-0.10570299811608475,0.813932662587284,0.9196356607033688,1126903112,1133831379.2,75.67501963659394,91.94867198575704,NaN,NaN,42.69303882201727,48.571453835931386
2017-11-20T09:30:00-05:00,63.5,63.64,63.41,63.59,6579936,8357498.6,64.7965906310853,74.24391975648791,NaN,NaN,64.57764748174392,56.92524822737382,-0.10820358871712721,0.7843811748069598,0.892584763524087,1133483048,1131842486.8,73.18980451250533,90.63059483674745,NaN,NaN,40.501766102787165,47.41864130262507
2017-11-21T09:30:00-05:00,63.84,64.3,63.79,64.26,8173956,8364405.65,69.90827269248935,73.57099086869903,NaN,NaN,118.46462534317372,69.62574485071664,-0.06947838969464548,0.8057367764057801,0.8752151661004256,1141657004,1132962537,73.71335372393442,89.23816591549178,NaN,NaN,40.36624550908658,46.41115618926243
2017-11-22T09:30:00-05:00,64.26,64.28,64.03,64.14,12115822,8508901.35,68.00367771468257,72.75050537922705,NaN,NaN,127.55968988428303,89.38809440474897,-0.0572013024473399,0.8037135380412508,0.8609148404885907,1129541182,1133357929.6,73.90706557199502,87.77714939537306,NaN,NaN,39.62877959955422,45.44224524787554
2017-11-24T09:30:00-05:00,64.24,64.53,64.22,64.5,4336077,8253882.75,70.59214866569036,71.93503602295043,NaN,NaN,174.53788176370932,108.81790138736037,-0.03138211250467349,0.8216871998577489,0.8530693123624223,1133877259,1133092321,73.51514675913677,86.23282411937768,NaN,NaN,39.86942518101068,44.646128095466274
2017-11-27T09:30:00-05:00,64.39,64.585,64.28,64.5,6889160,7871382.6,70.59214866569036,71.07368594257001,NaN,NaN,164.49313758303222,129.92659641118843,-0.021331312339680553,0.8264051719378216,0.8477364842775021,1133877259,1134487150.4,74.28629600002485,84.70100636820847,NaN,NaN,40.05711394216984,43.990554644995356
2017-11-28T09:30:00-05:00,64.6,64.77,64.34,64.71,11311646,8008230.5,72.1181368965182,70.31120860456566,NaN,NaN,164.6473516675665,149.94053724835294,-0.008240385178258203,0.8374360028046794,0.8456763879829376,1145188905,1136828321.8,75.57195663771213,83.22864303906314,NaN,NaN,40.67505116538481,43.51691129076528
2017-11-29T09:30:00-05:00,64.6,64.61,62.84,63.28,33640233,9184675.35,52.23944275385827,68.01438440604298,NaN,NaN,-8.20287731343632,124.60703671703095,-0.09857240050233451,0.7224608873550196,0.8210332878573541,1111548672,1130806655.4,66.37890022379935,81.0719540351794,NaN,NaN,33.93895173137111,42.14863135370897
2017-11-30T09:30:00-05:00,63.56,64.01,63.33,63.84,21047475,9759515.65,57.21325384522111,66.84133501858622,NaN,NaN,11.719316566587807,101.4389620534919,-0.12177074159406531,0.6688198608647724,0.7905906024588377,1132596147,1131417648.4,66.81994289892157,78.93475118795081,NaN,NaN,30.283126079885868,40.45355917173424
2017-12-01T09:30:00-05:00,63.45,63.83,62.59,63.51,19211806,10208876.25,53.666479150242594,65.41494458148813,NaN,NaN,-71.13259057221978,52.30486758630608,-0.15819508154483186,0.5928467505277979,0.7510418320726298,1113384341,1127319064.8,61.03584169977617,76.37745889707932,NaN,NaN,26.143959442564174,38.40933063899566
2017-12-04T09:30:00-05:00,63.91,63.94,62.43,62.49,16805547,10666170.9,44.48659790063126,63.363168882368306,NaN,NaN,-130.32246977588468,-6.658253885477302,-0.24467342670544634,0.44520004869082186,0.6898734753962682,1096578794,1119859371.8,52.182164003787314,73.18753596078703,NaN,NaN,18.99325796203848,35.63560597085892
2017-12-05T09:30:00-05:00,62.38,63.23,62.11,62.51,13927081,11062513.45,44.68639098991355,61.52849942848588,NaN,NaN,-166.09984840650083,-72.80769390029077,-0.2910632842701827,0.3260443700585398,0.6171076543287225,1110505875,1112922765.8,45.56354965134939,69.80133839647714,NaN,NaN,13.768048234972033,32.511669151446505
2017-12-06T09:30:00-05:00,62.26,63.045,62.105,62.91,13262335,11436849.2,48.665676842397936,60.63757199510413,NaN,NaN,-134.76791062711175,-98.12070056302586,-0.28498051711212813,0.2608820079385623,0.5458625250506904,1123768210,1115366673.4,48.06299876805338,67.20906748987433,NaN,NaN,10.869619896953193,29.41994782937603
2017-12-07T09:30:00-05:00,62.95,63.4199,62.91,63.3,11685609,11566106.45,52.27100446584261,59.42344346635429,NaN,NaN,-50.58304293792191,-110.5811724639278,-0.24631644244126666,0.2379669719991071,0.48428341444037376,1135453819,1115938207.8,48.65671703742346,64.89705408035815,NaN,NaN,9.704910211375557,26.603513883947393
2017-12-08T09:30:00-05:00,63.72,63.91,63.445,63.6,10059018,11556786.45,54.89522738790438,58.86678918586911,NaN,NaN,14.308329313237413,-93.49298848683637,-0.19444005485636684,0.24123334586991518,0.435673400726282,1145512837,1122363907,54.89911315473562,63.4130607602254,NaN,NaN,9.613951413802383,24.176433531069534
2017-12-11T09:30:00-05:00,63.57,64.15,63.53,64.15,11421605,11828708,59.3120536674769,58.47503654561137,NaN,NaN,53.549781856980246,-56.71853816026337,-0.12060430729023475,0.2849180166134886,0.40552232390372334,1156934442,1134435036.6,63.80255309575285,62.74254280188593,NaN,NaN,11.00090332934454,22.294214930823106
2017-12-12T09:30:00-05:00,64.11,64.36,63.869,64.13,8397001,12033543.55,59.085474208541285,57.701979511043646,NaN,NaN,71.62425216537015,-9.173718045889174,-0.07297663697058743,0.314301527690489,0.38727816466107645,1148537441,1142041349.8,68.07880141483791,62.34007477980761,NaN,NaN,12.017303396777336,20.826084711673712
2017-12-13T09:30:00-05:00,64.35,64.46,64.07,64.15,10356137,12182812.55,59.25310614620189,57.0769386847236,NaN,NaN,78.4115271447195,33.46216950847708,-0.041553367843329414,0.33533645485691466,0.37688982270024407,1158893578,1149066423.4,71.43522761414239,62.163514925675294,NaN,NaN,12.881112030483216,19.691088614360783
2017-12-14T09:30:00-05:00,64.23,64.425,64.04,64.07,10946045,12305488.1,58.22547569930007,56.19360490141001,NaN,NaN,64.36188202633889,56.451154501329235,-0.028221020995262247,0.34161354645616626,0.3698345674514285,1147947533,1151565166.2,72.54117685008981,62.093945646457655,NaN,NaN,13.311348916736975,18.779697228985953
2017-12-15T09:30:00-05:00,64.03,64.65,63.87,64.56,21305213,12988694.6,62.51380367494178,55.61658025921368,NaN,NaN,80.58779608098313,69.70704785487838,0.00951377238662765,0.38172678293471307,0.3722130105480854,1169252746,1156313148,74.55696769165043,62.113279338716616,NaN,NaN,14.951087225747644,18.23275294280905
2017-12-18T09:30:00-05:00,65.02,65.2,64.91,65.13,10760780,13111624.1,66.78521491194363,55.23565726031551,NaN,NaN,153.96425806318763,89.78994309611986,0.0656491555728067,0.4542744550140938,0.3886252994412871,1180013526,1160928964.8,76.37289422606725,62.17048916645627,NaN,NaN,17.73717329615562,18.16195585042999
2017-12-19T09:30:00-05:00,65,65.0399,64.57,64.73,11976844,13381469.5,61.490104047557644,55.89641878129403,NaN,NaN,105.01193988258082,96.467480639562,0.06832220081556101,0.47402805046073837,0.40570584964517736,1168036682,1164828813,77.81367716097219,62.9872589476829,NaN,NaN,18.511944828443198,18.21195427586045
2017-12-20T09:30:00-05:00,65.01,65.01,64.4,64.71,8965187,13421031.05,61.22870470599788,56.18323669992095,NaN,NaN,88.8398759451325,98.5531503996446,0.06144095505924496,0.48250704346923357,0.4210660884099886,1159071495,1164864396.4,77.82696326444076,63.77347468807712,NaN,NaN,19.05839962456805,18.332875039961536
2017-12-21T09:30:00-05:00,64.82,64.93,64.516,64.58,15941851,13612332.5,59.45933989878213,56.59701246767377,NaN,NaN,79.02419280627885,101.48561255563258,0.04177201169061229,0.473281103023254,0.4315090913326417,1143129644,1163900818.6,76.491144657823,64.87742489936618,NaN,NaN,19.019074292919143,18.430903504669764
2017-12-22T09:30:00-05:00,64.47,64.595,64.37,64.54,5485693,13669813.3,58.89538432233489,57.62621149779546,NaN,NaN,58.88365890706148,97.14478512084825,0.020767448589556203,0.45746840206958694,0.43670095348003074,1137643951,1157579059.6,68.218312575942,66.0228640830915,NaN,NaN,18.834893678845077,18.488616386694808
2017-12-26T09:30:00-05:00,64.14,64.18,63.875,64.11,6219227,13636316.65,53.06827784677861,58.22491770185725,NaN,NaN,12.146409250478394,68.78121535830641,-0.024909383283417463,0.4055642243757589,0.43047360765917636,1131424724,1147861299.2,57.85908153096055,66.9011163602066,NaN,NaN,17.028595411478577,18.28004196166392
2017-12-27T09:30:00-05:00,64.12,64.3,64.07,64.18,5346813,13338075,53.868451041363514,58.5965444303548,NaN,NaN,30.050194410015024,53.78886626379325,-0.051690254805216496,0.36586078915265574,0.41755104395787224,1136771537,1141608270.2,52.350310197467735,67.20735289087905,NaN,NaN,15.738909021664115,17.917022970235376
2017-12-28T09:30:00-05:00,64.37,64.41,64.18,64.29,9658201,12138973.4,55.162174284550325,58.8030565602625,NaN,NaN,39.30057769779761,43.88100661432627,-0.06255308781673585,0.3393596841869524,0.40191277200368825,1146429738,1139079918.8,50.266337028404486,67.32232574737769,NaN,NaN,14.985193469027164,17.498190184348488
2017-12-29T09:30:00-05:00,64.33,64.35,63.9,63.95,6693188,11421259.05,50.45243972366716,58.48571458424555,NaN,NaN,10.539009642469065,30.18396998156431,-0.09144473259485536,0.28760685626011906,0.3790515888549744,1139736550,1138401300,49.69452336336453,66.95056933370833,NaN,NaN,13.011341351644754,16.857211779676526
2018-01-02T09:30:00-05:00,64.21,64.74,64.05,64.74,13722817,11146809.6,59.17450564846994,58.475889725745056,NaN,NaN,60.52537498428049,30.51231319700811,-0.057799558394785566,0.3068021408614925,0.36460169925627806,1153459367,1141564383.2,52.411871774811694,66.13694923935539,NaN,NaN,13.79311050973888,16.419483026828292
2018-01-03T09:30:00-05:00,64.86,65.32,64.79,65.28,11331794,10873121.95,63.85791047791403,58.81677803070024,NaN,NaN,135.14936737685795,55.11290482228402,-0.002543932295470952,0.36142178388693935,0.3639657161824103,1164791161,1148237670.6,57.61384355201078,65.38945224915345,NaN,NaN,15.99956099856789,16.359494165648236
2018-01-04T09:30:00-05:00,65.54,65.78,65.39,65.61,10746591,10714097.45,66.39501748286604,59.326914554747695,NaN,NaN,185.42230719182683,86.18732737864639,0.049964203899124926,0.4264209710563165,0.37645676715719156,1175537752,1155990913.6,62.713585920959886,64.76647784249755,NaN,NaN,18.661390196524962,16.688336455773484
2018-01-05T09:30:00-05:00,65.95,66.36,65.82,66.3,9677970,10534879.2,70.98187006399124,60.23808558079706,NaN,NaN,229.9619715254013,124.31960614416712,0.12085818383121893,0.5275294969462152,0.40667131311499627,1185215722,1163748110.4,66.99258166667192,64.37014961511056,NaN,NaN,22.59088663393449,17.531557909796486
2018-01-08T09:30:00-05:00,66.27,66.67,66.23,66.55,6733905,10287294,72.44917801387298,60.94775517643501,NaN,NaN,222.86291526655637,166.78438726898457,0.17120444252236816,0.6206768662679565,0.4494724237455883,1191949627,1174190725.8,71.70078101890817,64.16613628134326,NaN,NaN,26.25045978215541,18.777115320133476
2018-01-09T09:30:00-05:00,66.68,66.7,66.27,66.38,10606414,10314663.8,69.86222891803126,61.16754189115555,NaN,NaN,178.60427411277618,190.40016709468372,0.17883892518236855,0.673021080223549,0.49418215504118046,1181343213,1179767495,73.8463097423772,63.98566596107968,NaN,NaN,28.397399077310006,20.151441571158696
2018-01-10T09:30:00-05:00,66.02,66.17,65.83,66.15,10407785,10263972.8,66.40733988864784,61.518773022661996,NaN,NaN,114.93458980126101,186.35721157956434,0.1550656119792675,0.6880141700152649,0.5329485580359974,1170935428,1180996348.4,74.30853203854281,63.735298452334725,NaN,NaN,29.11869727001274,21.432478099566417
2018-01-11T09:30:00-05:00,66.3,66.45,66.14,66.42,7887761,10238510.8,68.38394517490585,62.029861627584,NaN,NaN,121.96806135391215,173.6663624119814,0.14440814317351836,0.7134587370028953,0.569050593829377,1178823189,1181653435.8,74.56736348914359,63.50246989695635,NaN,NaN,30.323386524958064,22.702607874622366
2018-01-12T09:30:00-05:00,66.34,66.9,66.25,66.81,8154313,10128419.6,71.03508895750393,62.85670084606412,NaN,NaN,129.09510238070143,153.49298858304144,0.14985909795439956,0.7563744662723764,0.6065153683179768,1186977502,1182005791.8,74.714473875558,63.37556484108028,NaN,NaN,32.17695147948712,24.056085532460187
2018-01-16T09:30:00-05:00,67.22,67.455,66.375,66.55,18201762,10491205.45,67.00139560675504,63.43570165209413,NaN,NaN,120.52061678543265,133.02452888681668,0.12329771183136284,0.7606375081071803,0.6373397962758175,1168775740,1177371014.4,69.05616921333485,63.4354117437512,NaN,NaN,32.50942564031749,25.263705547868373
2018-01-17T09:30:00-05:00,66.93,67.61,66.71,67.55,14688082,10160348.9,73.28485510380742,64.87974288473904,NaN,NaN,136.1765770019979,124.53898946466101,0.158193238347468,0.8350813442101526,0.6768881058626846,1183463822,1177795136.2,69.28539994905111,64.25157734504339,NaN,NaN,34.95917091769467,26.64877202927213
2018-01-18T09:30:00-05:00,67.55,67.845,67.49,67.67,14925416,10368580.7,73.92646217218379,66.31245796551192,NaN,NaN,139.27423748820823,129.40691900205047,0.17325938737650637,0.8934623400833175,0.7202029527068111,1198389238,1183285898.2,72.16070370018797,65.66660545238054,NaN,NaN,37.09452286479774,28.14102214863293
2018-01-19T09:30:00-05:00,67.8,67.91,67.45,67.8,11947212,10367099.1,74.63711429869161,67.70352510937916,NaN,NaN,125.11129046176119,130.0355648236203,0.17535035777534813,0.9393908999259963,0.7640405421506482,1210336450,1189588550.4,75.04816851674605,67.43673627297638,NaN,NaN,39.033351851735425,29.697069249076144
2018-01-22T09:30:00-05:00,67.75,68.47,67.611,68.46,9002067,10368943.1,77.92649185304961,69.66595740433505,NaN,NaN,135.11747902830302,131.24004015314057,0.20262282834458267,1.0173190775813765,0.8146962492367938,1219338517,1196060753.4,77.61569819449848,69.43110590377165,NaN,NaN,41.83474202025233,31.431022502101314
2018-01-23T09:30:00-05:00,68.68,68.9,68.54,68.76,10230061,10083353.6,79.24419232205096,71.09950645244797,NaN,NaN,149.3922300198397,137.014362800022,0.22081273001447999,1.0907121617548938,0.8698994317404138,1229568578,1208219321,81.47262871197834,71.50687425642641,NaN,NaN,44.56733055953165,33.30763793887708
2018-01-24T09:30:00-05:00,68.94,69.06,68,68.23,18509512,10734544.55,71.16193979708312,71.62122283238863,NaN,NaN,120.62079903399939,133.9032072064223,0.1788843709077529,1.093504895375105,0.9146205244673521,1211059066,1213738369.8,82.91194854343709,73.31388175581401,NaN,NaN,44.29195146235784,34.87682558508862
2018-01-25T09:30:00-05:00,68.66,68.72,67.94,68.11,12975913,11072378.85,69.43516964539297,71.8383765582834,NaN,NaN,102.83206800983386,126.61477331074744,0.12723053299756681,1.0736586907143106,0.9464281577167438,1198083153,1213677152.8,82.83507970988646,74.7511313121659,NaN,NaN,43.535013325783304,36.113709548045
2018-01-26T09:30:00-05:00,68.58,69.19,68.43,69.19,10048638,11307470.1,75.2549032340393,72.14359321328683,NaN,NaN,126.81458601652015,126.95543242169924,0.1484799453847656,1.1320280894477008,0.9835481440629352,1208131791,1213236221,82.2436277304104,75.84049174529007,NaN,NaN,44.81421199643687,37.35663846924384
2018-01-29T09:30:00-05:00,68.99,68.99,68.47,68.56,27591031,12204111.6,67.21503351219872,71.76972574888153,NaN,NaN,100.40054567366181,120.012045750771,0.1048431524192448,1.1146020845869913,1.0097589321677465,1180540760,1205476669.6,72.44105967514966,75.89336879216447,NaN,NaN,43.06179571980784,38.17166093361013
2018-01-30T09:30:00-05:00,68,68.34,67.7608,67.94,14831240,12611014.2,60.37855082453165,71.09232017077441,NaN,NaN,55.83512707455565,101.30062516171417,0.02322367367318834,1.0387885242592318,1.0155648505860435,1165709520,1192704858,59.80586455213302,74.89047985000418,NaN,NaN,39.18026422242627,38.315747117726715
2018-01-31T09:30:00-05:00,68.34,68.555,68,68.45,15348877,12692317.2,63.653413538518556,70.89561114576517,NaN,NaN,69.35058040023182,91.04658143496064,-0.005862960063551137,1.0082361505066046,1.0140991105701558,1181058397,1186704724.2,54.95624854677049,73.50817388630615,NaN,NaN,37.14253133855897,38.14814486355989
2018-02-01T09:30:00-05:00,68.2,68.985,68.19,68.51,16324964,12941975.7,64.03008945872406,70.5846214517522,NaN,NaN,77.8471192047335,86.04959167394058,-0.029202840720914613,0.9775955596690125,1.006798400389927,1197383361,1186564765.8,54.84453145351956,72.09940016947586,NaN,NaN,35.69149511930581,37.79719490009502
2018-02-02T09:30:00-05:00,67.74,67.8,66.47,66.48,21964705,13502881.4,46.479399111529375,68.83064360561116,NaN,NaN,-47.402106104169796,51.20625324980259,-0.18102961096765413,0.7805113866803595,0.9615409976480136,1175418656,1180022138.8,49.752880179916005,70.31642919121572,NaN,NaN,27.307629419344664,36.298685545702114
2018-02-05T09:30:00-05:00,65.77,67.015,63.67,63.7,49279802,15482973,33.099233841646495,66.4090606223891,NaN,NaN,-189.15156560053052,-6.704169005035874,-0.4528811089874454,0.39543961141370687,0.8483207204011523,1126138854,1169141757.6,42.65999745711009,68.43098835148538,NaN,NaN,13.092350266406966,32.983494791517096
2018-02-06T09:30:00-05:00,62.84,65.635,62.48,65.53,45134653,17403010.4,44.43808719911738,64.34857720062554,NaN,NaN,-179.4711967314467,-53.765433766236335,-0.4904792385152895,0.23522167225704038,0.7257009107723299,1171273507,1170254555,43.54644395778697,66.59249149496651,NaN,NaN,7.335997315073002,29.31956658059651
2018-02-07T09:30:00-05:00,65.37,66.04,64.69,64.69,23712554,18058317.4,41.002789849408984,61.99688632042734,NaN,NaN,-128.7687890907807,-93.38930766443885,-0.5485561998312943,0.04000566098321201,0.5885618608145063,1147560953,1163555066.2,39.57933970774627,64.26525120979211,NaN,NaN,1.7325086518932737,25.37855830506748
2018-02-08T09:30:00-05:00,64.87,64.99,61.99,62.01,27814273,18928641.8,32.397575707728166,58.979776421072806,NaN,NaN,-212.74803559497872,-151.5083386243813,-0.732598636774968,-0.32718643515420354,0.40541220162076436,1119746680,1148027730,32.246895019543246,61.208017388563334,NaN,NaN,-6.923766050607859,20.763940539971003
2018-02-09T09:30:00-05:00,63.01,63.99,60.971,63.53,36350175,20351762.5,40.07867156806751,56.276360686431225,NaN,NaN,-182.74095630085625,-178.57610866371857,-0.716242056308114,-0.4898903687643781,0.22635168754373586,1156096855,1144163369.8,30.721481024023745,57.85843044781513,NaN,NaN,-9.906122800690031,16.38250291987657
2018-02-12T09:30:00-05:00,64.21,65.07,63.74,64.67,17814755,20834784.6,45.11549379320326,53.83859650579924,NaN,NaN,-96.06923355153441,-159.95964225391936,-0.5977549448020305,-0.5208419934588022,0.07691295134322823,1173911610,1153717921,38.47135354985138,54.786910793377494,NaN,NaN,-9.978545714048465,12.61663882931585
2018-02-13T09:30:00-05:00,64.3,64.99,64.115,64.83,9542938,20401843.4,45.80405382063281,52.027318936052794,NaN,NaN,-78.88585936714584,-139.8425747810592,-0.4826445913222613,-0.5263927878095984,-0.04374819648733712,1183454548,1156154129.2,40.305029127851775,51.74355940654998,NaN,NaN,-9.768897566069649,9.418705058546493
2018-02-14T09:30:00-05:00,64.47,66.125,64.43,66.02,16058841,20470381.35,50.75269720172782,50.69285661864814,NaN,NaN,-41.51567650722509,-122.39195226434806,-0.3088527609101833,-0.4298141476250663,-0.12096138671488296,1199513389,1166544616.4,47.49245017574835,49.21908586839726,NaN,NaN,-7.758691102883023,6.964791321199419
2018-02-15T09:30:00-05:00,66.65,67.28,65.87,67.28,12152462,20331733.65,55.396720734329904,49.274415011526045,NaN,NaN,6.760010631565118,-78.4903430190393,-0.10221979814981427,-0.2487361344021508,-0.14651633625233654,1211665851,1184928450.6,57.29059271513422,47.436726224448954,NaN,NaN,-4.428218497939095,5.3372184898939175
2018-02-16T09:30:00-05:00,67.08,67.899,67.01,67.18,10167145,20242730.3,54.95380220779231,48.39861277549701,NaN,NaN,28.074758428286426,-36.32720007321076,0.0276062655802351,-0.11200850427704268,-0.13961476985727778,1201498706,1194008820.8,61.14712768993404,46.63001679693355,NaN,NaN,-2.0678870168046677,4.279346274651262
2018-02-20T09:30:00-05:00,66.84,67.77,66.77,67.24,16917649,20638509.4,55.185326178993144,48.027668157958544,NaN,NaN,26.49741459886451,-11.81387044313098,0.11263346215424934,0.0011770578355339012,-0.11145640431871544,1218416355,1202909769.8,64.52834172568564,46.96733659504446,NaN,NaN,-0.16373837420129841,3.6446198962437535
2018-02-21T09:30:00-05:00,67.5,68.065,66.8,66.81,14551218,20854567.25,53.07976108813834,47.27240726864567,NaN,NaN,29.03345559963634,9.76999255022545,0.133596960833631,0.05553979672332332,-0.07805716411030769,1203865137,1206991887.6,65.99014269667704,47.75547189146636,NaN,NaN,0.7626310773114353,3.232907207824851
2018-02-22T09:30:00-05:00,67.04,67.495,66.7,66.89,10979387,20478061,53.43572349290006,46.51566684251539,NaN,NaN,24.87218107994754,23.047564067659977,0.14555014760079732,0.10388052039068896,-0.04166962721010836,1214844524,1210058114.6,67.0873117855149,48.6299562008946,NaN,NaN,1.612015398758771,3.0013512351011253
2018-02-23T09:30:00-05:00,67.44,68.29,67.28,68.29,10386168,20348573.75,59.260536111616645,47.42860519966448,NaN,NaN,63.63732608497527,34.423027158342016,0.23513681762927652,0.2522513948264873,0.017114577197210767,1225230692,1212771082.8,68.06885259599353,49.93823994490014,NaN,NaN,4.157119133754579,3.1664609349087613
2018-02-26T09:30:00-05:00,68.58,69.36,68.58,69.36,10797190,20386001.35,63.063524324060154,49.56891166269403,NaN,NaN,109.91324875366053,50.790725223416835,0.3470906162470964,0.4509778475060813,0.10388723125898487,1236027882,1219676918,70.48202195079635,51.92552740873487,NaN,NaN,7.551211806424553,3.7928539165538746
2018-02-27T09:30:00-05:00,69.39,69.705,68.66,68.66,12790591,19645979.35,59.171956997980054,50.62133093404136,NaN,NaN,104.6227615660246,66.41579461684884,0.35344653994210007,0.5456954061866099,0.19224886624450988,1223237291,1220641105.2,70.8136738911336,53.873186689688204,NaN,NaN,9.211217352797618,4.566905836017266
2018-02-28T09:30:00-05:00,69.05,69.34,68.16,68.17,15232048,19666019.75,56.54170167124232,51.731253207029454,NaN,NaN,84.10183573719529,77.42947064436063,0.3058787066258121,0.574597249526775,0.2687185429009629,1208005243,1221469126.4,71.11383238800158,56.12565045256359,NaN,NaN,9.803922787847824,5.315051114850203
2018-03-01T09:30:00-05:00,68.33,68.59,66.53,67.04,21486816,19972916.7,50.92035411250293,53.05430880737051,NaN,NaN,40.10153323371019,80.47534107511316,0.18546562722756915,0.5005505769354244,0.3150849497078552,1186518427,1215803907,66.10468927165527,58.544064327714445,NaN,NaN,8.595833369622968,5.783734294103454
2018-03-02T09:30:00-05:00,66.28,67.815,66.1,67.68,19196109,20116473.95,53.72637743751051,54.02914494090215,NaN,NaN,36.4008613081992,75.02804811975795,0.1382413627043071,0.4878866530882391,0.349645290383932,1205714536,1211900675.8,62.82139967233617,60.83691565973676,NaN,NaN,8.432232121382988,6.162091126571959
2018-03-05T09:30:00-05:00,67.36,68.6,67.21,68.37,10888925,19562684.95,56.60685678651743,54.84995658328173,NaN,NaN,68.48882760134676,66.7431638892952,0.14224180658435498,0.5274475486143757,0.3852057420300207,1216603461,1208015791.6,59.64601155114293,62.34939123125759,NaN,NaN,9.160248730086408,6.590399355645452
2018-03-06T09:30:00-05:00,68.76,68.85,68.2175,68.52,10151938,17606291.75,57.23015487559669,55.6661066586363,NaN,NaN,81.59803651831238,62.13821887975276,0.14335345911415787,0.5643975659227181,0.4210441068085602,1226755399,1208719413.2,60.03997930864173,63.75903052988544,NaN,NaN,9.93138384073822,7.067682853515848
2018-03-07T09:30:00-05:00,68.01,68.97,68.01,68.9,11109750,15905046.6,58.84300983401566,56.24398613237115,NaN,NaN,81.2822707568269,61.57430588367909,0.1569475296756126,0.617228518903076,0.46028098922746336,1237865149,1214691394.4,63.313703162943455,64.88912002897082,NaN,NaN,11.034466707554087,7.634366261235596
2018-03-08T09:30:00-05:00,69.11,69.26,68.77,69.2,7623964,15100617.1,60.12156104252532,56.58147472581367,NaN,NaN,95.56340613829262,72.66668046459556,0.17218958611993584,0.6755179718773832,0.5033283857574473,1245489113,1226485531.6,68.75742138210323,65.7081792194686,NaN,NaN,12.315911904994673,8.303158496058321
2018-03-09T09:30:00-05:00,69.69,70.51,69.6,70.51,12342535,14327030.2,65.20467801717821,57.31368014076981,NaN,NaN,145.87918533924795,94.56234527080531,0.25172893996245427,0.8179895607105152,0.5662606207480609,1257831648,1236908954,72.62371724183663,66.52793561603308,NaN,NaN,14.999685265681192,9.259805177433018
2018-03-12T09:30:00-04:00,70.72,71.01,70.53,70.73,13506245,13184833.7,65.98874061379635,58.08535260039861,NaN,NaN,161.25557181712935,113.11569411396184,0.29726401507256794,0.9378406395887708,0.6405766245162029,1271337893,1247855840.4,75.98493695021673,67.34626384635672,NaN,NaN,17.439748870490547,10.428368562155521
2018-03-13T09:30:00-04:00,71.09,71.34,69.68,69.92,13809416,12984566.75,60.57645447607967,58.62083069953728,NaN,NaN,127.6252531396287,122.32113743822511,0.2526891246122749,0.9564380302815465,0.7037489056692716,1257528477,1254010456,77.646664305038,68.17887253266822,NaN,NaN,18.02353874132319,11.513392873465188
2018-03-14T09:30:00-04:00,70.27,70.33,69.51,69.86,13881448,13201492.25,60.18269280485378,59.10275707896254,NaN,NaN,96.1655450505384,125.2977922969674,0.20125906110153013,0.9553227320461843,0.7540636709446542,1243647029,1255166832,77.95531184317119,68.95515825107225,NaN,NaN,18.393212072307342,12.496224187585495
2018-03-15T09:30:00-04:00,69.88,70.31,69.56,69.9,11501443,12973622.35,60.36765068127751,59.18183669108117,NaN,NaN,90.83884400403632,124.35287987011614,0.15415141311390723,0.9467529373370382,0.792601524223131,1255148472,1257098703.8,78.48966882806711,69.69950226764892,NaN,NaN,18.748808363752882,13.38945049846655
2018-03-16T09:30:00-04:00,69.8,70.05,69.52,69.61,12202272,12976112.85,58.25486316975259,58.838360894344916,NaN,NaN,70.60528865365931,109.2981005329984,0.09081126087435154,0.9061156003160704,0.8153043394417189,1242946200,1254121614.2,75.45431114281222,70.05466578136433,NaN,NaN,18.503552950808057,14.120036563086765
2018-03-19T09:30:00-04:00,68.96,69.07,67.67,68.23,19868388,13461175,49.39546196181366,58.14003982033303,NaN,NaN,-26.59912431222387,71.72716130712776,-0.04915094590343927,0.7538656570624198,0.8030166029658591,1223077812,1244469598,66.47821403754409,69.74499007753651,NaN,NaN,15.699625338944726,14.345692102495045
2018-03-20T09:30:00-04:00,68.06,68.4575,67.82,68.2,9382796,13084432.35,49.22021819910433,57.61707671518031,NaN,NaN,-42.86036544101352,37.630037590999315,-0.14353545079227747,0.6235972894755122,0.7671327402677897,1213695016,1235702905.8,59.54905173975545,68.9189343169475,NaN,NaN,13.355176479814176,14.204189870683493
2018-03-21T09:30:00-04:00,68.05,68.69,67.605,67.79,10933467,12903544.8,46.77767937151769,57.32117137653851,NaN,NaN,-57.453022434663694,6.906324093958898,-0.22832850933877413,0.481722103594322,0.7100506129330961,1202761549,1227525809.8,53.90514733937757,68.04753846464196,NaN,NaN,10.655078813613338,13.697174005387756
2018-03-22T09:30:00-04:00,66.97,67.36,65.99,66.04,21195063,13414328.6,38.08928318253575,56.20423607261174,NaN,NaN,-168.0877868867444,-44.87900208419724,-0.38766010554898644,0.2254754809968631,0.6131355865458495,1181566486,1212809412.6,45.539815825226945,66.81313961841987,NaN,NaN,5.277968370876008,12.494430343314649
2018-03-23T09:30:00-04:00,66,66.29,64.25,64.28,20950788,13942559.6,31.710188236235652,54.425902604734475,NaN,NaN,-233.35450407536933,-105.670960630003,-0.5851132084011039,-0.1182559239555303,0.46685728444557356,1160615698,1196343312.2,38.36567769113399,65.29311577127638,NaN,NaN,-1.8915770930850977,10.439286423828971
2018-03-26T09:30:00-04:00,65.59,66.81,64.68,66.72,25125797,14658989.95,45.3701156016656,53.578756942310825,NaN,NaN,-138.2864463677667,-128.00842504111156,-0.5267415357603964,-0.19156963525492188,0.33517190050547446,1185741495,1188876048.8,35.624819698532974,63.54917579912575,NaN,NaN,-3.3603288784260403,8.467912809221112
2018-03-27T09:30:00-04:00,67.13,67.17,64.08,64.58,29748560,15506888.4,38.16045739390506,52.101431768017214,NaN,NaN,-154.98158159322136,-150.43266827155313,-0.6021681393007745,-0.4175382736204938,0.18462986568028078,1155992935,1177335632.6,31.83909475604227,61.30098948434709,NaN,NaN,-7.459232335474006,6.192606359978952
2018-03-28T09:30:00-04:00,64.43,65.205,63.77,64.15,26810987,16085835.35,36.891885717078495,50.442169244771016,NaN,NaN,-166.2538839104809,-172.19284056671657,-0.6470022549301819,-0.6241229529824466,0.022879301947735298,1129181948,1162619712.4,27.784482494775204,58.37435099239509,NaN,NaN,-10.987648212414426,3.7382842782084698
2018-03-29T09:30:00-04:00,64.61,66.07,64.16,65.42,17933797,15908184.4,42.92658014779566,48.85087653981511,NaN,NaN,-113.0454800017889,-161.18437918972546,-0.560346635881714,-0.6775539929044072,-0.11720735702269322,1147115745,1155729564.2,26.108039822527914,55.05180260530161,NaN,NaN,-11.655697274209825,1.5391440564344276
2018-04-02T09:30:00-04:00,65.16,65.45,63.15,63.86,26017139,16249235.9,38.10629857712777,46.85927353719593,NaN,NaN,-134.18432551981928,-141.35034347861543,-0.5751452745331105,-0.8361389501890812,-0.2609936756559708,1121098606,1147826145.8,24.297069301412122,51.35981205895843,NaN,NaN,-13.969868612437066,-0.6764291819757857
2018-04-03T09:30:00-04:00,64.34,64.64,63.41,64.49,18050721,16607325.7,40.98824107365561,45.460115437022786,NaN,NaN,-113.14674710313449,-136.322403625689,-0.5116861511422233,-0.9006013645837498,-0.38891521344152663,1139149327,1138507712.2,22.330337975010792,47.40864589252792,NaN,NaN,-14.765328687879903,-2.6891291113906592
2018-04-04T09:30:00-04:00,63.31,65.57,63.17,65.39,18149231,17007190.35,44.93296989747171,44.37084951506692,NaN,NaN,-84.43777465050178,-122.21364223714508,-0.3841062052447185,-0.8690479699974247,-0.48494176475270623,1157298558,1138768836.8,22.51960394338242,43.44895247111443,NaN,NaN,-14.062154752892154,-4.313847060176586
2018-04-05T09:30:00-04:00,65.99,66.09,65.22,65.66,16369083,17270157,46.097087257363484,43.35152355621592,NaN,NaN,-49.68201817588024,-98.89926909022495,-0.26235419407331506,-0.81288450734435,-0.550530313271035,1173667641,1147665975.4,28.87887027642006,39.90532400313965,NaN,NaN,-13.135748423386994,-5.574118683492359
2018-04-06T09:30:00-04:00,64.98,65.58,63.77,64.05,20238896,17900903.6,40.58721915216214,42.08954898353089,NaN,NaN,-78.20253717040111,-91.93068052394737,-0.2700167107937468,-0.8880512017632185,-0.6180344909694717,1153428745,1148928575.4,29.7599197447621,36.641438903278924,NaN,NaN,-14.144559574662033,-6.798467382230884
2018-04-09T09:30:00-04:00,64.52,65.81,64.465,64.55,10929668,17830260.25,42.8709935564032,41.623515526001576,NaN,NaN,-58.61265960076934,-76.81634734013738,-0.22312137127462905,-0.8969362050627581,-0.673814833788129,1164358413,1157580536.8,35.64332441023784,34.43894678704277,NaN,NaN,-14.226039383354964,-7.859549096677181
2018-04-10T09:30:00-04:00,65.57,66.41,65.21,66.14,16116758,17960785.9,49.51658786058279,41.644684787535745,NaN,NaN,-22.105870300190016,-58.60817197954848,-0.07441876331514508,-0.7668382879320603,-0.6924195246169152,1180475171,1165845705.6,40.74908688220699,33.09609215436073,NaN,NaN,-12.0973558743944,-8.464950064922498
2018-04-11T09:30:00-04:00,65.73,66.34,65.64,65.75,8657765,17703203.35,48.04041877896349,41.73488045949615,NaN,NaN,-16.642943359646875,-45.0492057213775,0.0041100727955657446,-0.687281933622458,-0.6913920064180238,1171817406,1168749475.2,42.475771104072216,32.2797081375532,NaN,NaN,-10.856599131416617,-8.806614217278801
2018-04-12T09:30:00-04:00,66.16,66.83,66.0748,66.54,10628033,17540532.6,51.213164116880115,42.67230052623504,NaN,NaN,15.881102898242844,-31.936581506552887,0.10983421246922653,-0.5540992408314906,-0.6639334533007172,1182445439,1170505034.8,43.546904937288765,32.137357359843335,NaN,NaN,-8.832609137577261,-8.810327777321438
2018-04-13T09:30:00-04:00,67,67.03,66,66.32,11210766,17525998.75,50.29218381898243,43.99958592500267,NaN,NaN,26.702075967654963,-10.955658878941671,0.16235543260978824,-0.4609891625384819,-0.6233445951482701,1171234673,1174066220.4,45.75352795620295,32.6650609502054,NaN,NaN,-7.466342721161359,-8.618329912155712
2018-04-16T09:30:00-04:00,66.78,67.08,66.39,66.83,9738678,17402819.05,52.427945626752724,44.50371664108032,NaN,NaN,60.81992706905962,12.930858455024117,0.22499369806669345,-0.34210247256490334,-0.5670961706315968,1180973351,1177389208,47.8037390363,33.5349837600459,NaN,NaN,-5.699541231097335,-8.201360100575943
2018-04-17T09:30:00-04:00,67.42,68.29,67.3,68.07,15222774,17170538.35,57.2387203262463,45.86644970767612,NaN,NaN,137.43077914776748,44.83818834461561,0.3367636185855386,-0.1461416473996735,-0.4829052659852121,1196196125,1180533398.8,49.73935841265129,34.81357402123226,NaN,NaN,-2.678990912033014,-7.412450216498382
2018-04-18T09:30:00-04:00,68,68.15,67.48,67.89,9882220,17195509.55,56.34792780035922,47.25616699933903,NaN,NaN,137.57745698756898,75.68226841405878,0.3820805097061245,-0.005304628852556448,-0.38738513855868095,1186313905,1183432698.6,51.524496484276725,36.509289306196656,NaN,NaN,-0.4677231557869926,-6.420346350682469
2018-04-19T09:30:00-04:00,67.46,67.53,66.895,67.14,12905816,17294127,52.669840021615904,47.95211413318333,NaN,NaN,100.9916089248277,92.70436961937575,0.346123435949218,0.04526915637784157,-0.30085427957137645,1173408089,1181625228.6,50.32448398394357,38.23903531772635,NaN,NaN,0.3885582126974856,-5.447645698771047
2018-04-20T09:30:00-04:00,66.94,66.99,65.925,66.21,16238478,17046297.75,48.44688579404267,48.690727505820114,NaN,NaN,44.61077493610039,96.28610941306485,0.24883427995674304,0.010188570374552341,-0.2386457095821907,1157169611,1178812216.2,48.43385511864811,39.96309144752892,NaN,NaN,-0.09897229188915553,-4.6835494977879195
2018-04-23T09:30:00-04:00,66.46,66.65,65.66,65.97,18960253,16946771,47.390889933831495,49.14805956726125,NaN,NaN,21.39665658228316,88.40145531570955,0.1616704657148975,-0.03655762743856883,-0.19822809315346632,1138209358,1170259417.6,43.12852033416361,41.44867590175412,NaN,NaN,-0.800843112311452,-4.128877157005567
2018-04-24T09:30:00-04:00,66.35,66.46,64.35,64.82,17423809,16561671.6,42.59939470093497,48.98137562465148,NaN,NaN,-38.80126557341494,53.155046371473055,0.02697973692781283,-0.16450342199370027,-0.1914831589215131,1120785549,1155177302.4,35.701863836382,42.39026589411123,NaN,NaN,-2.8420149977187785,-3.945039705678883
2018-04-25T09:30:00-04:00,64.92,65.05,64,64.83,15290801,15838783.65,42.65369078534217,48.73541873379281,NaN,NaN,-75.406481685387,10.558258636881856,-0.05647223282740088,-0.2620734499557642,-0.20560121712836332,1136076350,1145129791.4,31.776211651909705,42.59721884950335,NaN,NaN,-4.48502868774572,-4.0221809888312885
2018-04-26T09:30:00-04:00,65.64,66.27,65.37,66.01,16543440,15325406.3,48.80726019004916,49.32256452221332,NaN,NaN,6.3203753442007065,-8.375988079243537,-0.028638672620318772,-0.24139955790376177,-0.212760885283443,1152619790,1140972131.6,30.291908177701742,42.63521802328476,NaN,NaN,-4.185018892596574,-4.045443546512043
2018-04-27T09:30:00-04:00,66.67,66.72,65.54,65.89,13156483,15086540.6,48.24034775507999,49.706089822118805,NaN,NaN,15.999997973110366,-14.098143471841544,-0.015410269045731673,-0.23202372159060758,-0.2166134525448759,1139463307,1137430870.8,29.0473347641811,42.164075905709275,NaN,NaN,-4.096410375045291,-4.052724522016793
2018-04-30T09:30:00-04:00,66.06,66.465,65.375,65.46,8686115,14219989.4,46.1708210057767,49.46710647534693,NaN,NaN,-13.035594456541636,-20.984593679606505,-0.03177790213692408,-0.256335830216031,-0.22455792807910693,1130777192,1135944437.6,28.5176951290036,41.290405066194744,NaN,NaN,-4.590714664402975,-4.12958025664339
2018-05-01T09:30:00-04:00,65.37,66.32,65.21,66.28,9273887,13781147.7,50.529334981889185,49.64488620412734,NaN,NaN,-6.7359526396361,-14.571531092850739,0.014006768772230171,-0.20704946711381922,-0.2210562358860494,1140051079,1139797543.6,31.979967773845658,40.54070482832142,NaN,NaN,-3.798375767725674,-4.0822653296551445
2018-05-02T09:30:00-04:00,66.7,66.95,66.09,66.21,13293729,13538372.6,50.15598825352528,49.569373642459134,NaN,NaN,32.37431261615422,6.984627767457506,0.039517546576891605,-0.1716593026649349,-0.2111768492418265,1126757350,1137933743.6,31.192936460884624,39.65827850857827,NaN,NaN,-3.2438414618438984,-3.962490491396395
2018-05-03T09:30:00-04:00,65.91,66.615,65.325,66.36,15545417,13497189.3,50.991623946154505,49.61933365154285,NaN,NaN,-1.5940711115526154,5.401738476306842,0.06493354138483717,-0.13000992251078003,-0.1949434638956172,1142302767,1135870339,30.303775273946712,38.55472474555996,NaN,NaN,-2.555981308724343,-3.7615606081575303
2018-05-04T09:30:00-04:00,66.11,67.74,66.03,67.62,10841288,13027308.9,57.44540752092469,49.97772378684085,NaN,NaN,93.30811482853774,20.863361847392326,0.15964738976299903,0.0046157733081315655,-0.15503161645486746,1153144055,1138606488.6,33.029897525807485,37.49945035195335,NaN,NaN,-0.0674937682791495,-3.23383677388919
2018-05-07T09:30:00-04:00,67.94,68.405,67.83,68.09,13457406,13153695.8,59.58344528213451,50.14520414083286,NaN,NaN,171.71438342326718,57.81335742335409,0.24205091068667223,0.1475320219034728,-0.0945188887831994,1166601461,1145771342.4,39.6830520325769,36.78114275337661,NaN,NaN,2.670974015547195,-2.3902923753982783
2018-05-08T09:30:00-04:00,67.98,68.3,67.67,68.24,15147426,13105229.2,60.26951909336369,50.4253178046189,NaN,NaN,140.35310919893067,87.23116979106744,0.2914454927113983,0.2697879771060485,-0.021657515605349814,1181748887,1154110904,46.362433989837335,36.4124240037738,NaN,NaN,5.143960533836034,-1.313970531221948
2018-05-09T09:30:00-04:00,68.41,69.08,68.19,69.08,14413339,13393007.9,63.95912197823042,51.23169508723423,NaN,NaN,166.52275028129847,114.06085732409629,0.3609312905162099,0.4295065975399126,0.06857530702370267,1196162226,1167991879.2,55.24604924720051,36.763964379720726,NaN,NaN,8.421076931412031,0.07675053486862038
2018-05-10T09:30:00-04:00,69.4,70.03,69.33,69.98,11566266,13439919.55,67.4472425777538,52.58886342892788,NaN,NaN,193.22464004879066,153.02459955616496,0.44237373720874645,0.6215424785346357,0.17916874132588928,1207728492,1181077024.2,61.687763153871536,37.710672096522394,NaN,NaN,12.379924466981105,1.8343468108846894
2018-05-11T09:30:00-04:00,69.91,70.15,69.65,69.88,8760648,13317413.65,66.67509212982534,53.96630644292743,NaN,NaN,164.81248474594543,167.32547353964648,0.4622151091046867,0.7569376277067477,0.29472251860206095,1198967844,1190241782,65.43984942241049,39.304338459968605,NaN,NaN,15.413286600505693,3.7741953522591185
2018-05-14T09:30:00-04:00,70.11,70.42,69.795,69.87,10130922,13337025.85,66.59299066019724,55.68013472573188,NaN,NaN,145.46376077039886,162.07534900907282,0.44709611124160065,0.8535926576540618,0.40649654641246113,1188836922,1194688874.2,67.12242620659948,41.548664343555565,NaN,NaN,17.89520698575818,5.7914827284732695
2018-05-15T09:30:00-04:00,69.38,69.444,68.85,69.21,14262592,13289016.75,61.233710029085344,57.00727895742782,NaN,NaN,93.36698947125781,152.67812506353826,0.36835668980215364,0.8669424086651532,0.4985857188629995,1174574330,1193253962.8,66.0057818339458,43.99363364227243,NaN,NaN,18.640924279580382,7.627117235774286
2018-05-16T09:30:00-04:00,69.32,69.68,69.16,69.52,6680485,13128930,62.75008198013528,58.00319479957683,NaN,NaN,96.46690772925456,138.66695655312947,0.3149324444762315,0.8922512744582889,0.5773188299820574,1181254815,1190272480.6,63.63687543281947,46.37541701763798,NaN,NaN,19.689231608841055,9.35027643192668
2018-05-17T09:30:00-04:00,69.27,69.7401,68.875,69.16,10800144,13023646.4,59.82357634232578,58.83056827009439,NaN,NaN,77.72214615530126,115.5664577744316,0.23670021881808112,0.8731941035046589,0.6364938846865777,1170454671,1182817716.4,58.029011495657045,48.44553678417198,NaN,NaN,19.799655811768346,10.843044914761204
2018-05-18T09:30:00-04:00,68.93,69.24,68.81,68.87,7882919,12605868.45,57.49729281685122,59.63960197088543,NaN,NaN,59.307055099400564,94.4653718451226,0.15094764302879915,0.8251784384725767,0.6742307954437775,1162571752,1175538498,53.10769189978644,50.20196512494219,NaN,NaN,19.266029162457805,12.046328378717861
2018-05-21T09:30:00-04:00,69.5,69.805,69.12,69.47,11289236,12222317.6,60.88618955214829,60.37937729733251,NaN,NaN,72.31083553860815,79.83478679876447,0.12143042977867158,0.826018832667117,0.7045884028884454,1173860988,1172543311.2,51.18417523526772,51.573694229329476,NaN,NaN,19.71393481630934,13.141700726945215
2018-05-22T09:30:00-04:00,69.81,69.91,69.22,69.37,7391047,11720679.5,60.02713100700899,61.08445892258135,NaN,NaN,68.21078742375457,74.80354638926381,0.08375866421685185,0.8092867331595102,0.7255280689426583,1166469941,1170922433.4,50.12610730807869,52.92606357555763,NaN,NaN,19.859311298383737,14.101359380007862
2018-05-23T09:30:00-04:00,68.8,69.88,68.79,69.88,14693760,11690827.45,62.90194633242297,61.93519623588624,NaN,NaN,64.34074537952603,68.3783139193181,0.0816884714367746,0.8276386582386266,0.745950186801852,1181163701,1170904210.6,50.11356485006328,54.34104854528024,NaN,NaN,20.7664116562335,15.053509705182954
2018-05-24T09:30:00-04:00,69.86,69.94,69.098,69.8,11200659,11423688.4,62.146908600086704,62.271017741540675,NaN,NaN,63.61897052191663,65.55767879264118,0.06420257148286967,0.8262034011554391,0.7620008296725694,1169963042,1170805884.8,50.040806968704125,55.55611350548714,NaN,NaN,21.329287767787836,15.950049428412223
2018-05-25T09:30:00-04:00,69.85,70,69.58,69.75,9391355,11235432,61.64883429050179,62.41854552785263,NaN,NaN,67.5837658284952,67.21302093846012,0.039739243961233184,0.8116748846241109,0.7719356406628777,1160571687,1170405871.8,49.724516129975996,56.27336094101565,NaN,NaN,21.678154365621943,16.768350133727896
2018-05-29T09:30:00-04:00,69.4,69.76,68.91,69.37,29330387,12267645.6,57.853889608831444,62.246000564671746,NaN,NaN,39.92314921147674,60.73548367303383,-0.008965394767451507,0.7607288972035633,0.7696942919710148,1131241300,1161881934.2,43.42568676896208,56.0635932823817,NaN,NaN,20.99874663300227,17.372692490767093
2018-05-30T09:30:00-04:00,69.72,69.97,69.519,69.88,9965160,12302209.25,61.297331463805726,62.05587267078427,NaN,NaN,66.43074278202414,60.37947474468774,-0.013492685339810628,0.7528284352962515,0.7663211206360622,1141206460,1156829238,40.17681624202005,54.987219496297385,NaN,NaN,21.300224628339805,17.93376851042034
2018-05-31T09:30:00-04:00,69.88,70.36,69.74,69.9,15293517,12402198.65,61.4304151192472,61.62609928089095,NaN,NaN,82.62476718864436,64.03627910651142,-0.02133304460391916,0.7396548148811632,0.7609878594850824,1156499977,1151896493.2,37.2470827431282,53.241456609815714,NaN,NaN,21.587264362422086,18.45569648927773
2018-06-01T09:30:00-04:00,70.37,71.1,70.25,71.09,12722885,12261072.05,68.39429067176512,61.748899176743784,NaN,NaN,172.09022220027677,85.73052944218344,0.04387632243954287,0.815833262534511,0.7719569400949682,1169222862,1151748457.2,37.15950657991202,51.22143212106583,NaN,NaN,23.91777708715369,19.235993717545725
2018-06-04T09:30:00-04:00,71.27,71.73,71.2,71.66,9933038,12215659.55,71.08712646377343,62.06990887699923,NaN,NaN,248.307685225025,121.8753133214894,0.1117865053693764,0.9116900718066887,0.7999035664373123,1179155900,1155465299.8,40.91577570531025,49.34952851383088,NaN,NaN,26.767571078824915,20.311933340585608
2018-06-05T09:30:00-04:00,71.84,72.04,71.64,71.91,17274761,12406527.3,72.20566376795023,62.85361985834671,NaN,NaN,241.14464156580541,162.11961179235513,0.15715310688837814,0.996344950047785,0.8391918431594069,1196430661,1168503172,51.79967088984577,48.334806303538016,NaN,NaN,29.47420016727279,21.620828601540918
2018-06-06T09:30:00-04:00,72.03,72.38,71.66,72.38,17689542,12533633.1,74.22453343969471,63.67322353402954,NaN,NaN,217.25739990683783,192.28494321731787,0.199693338424906,1.0888085161905394,0.8891151777656334,1214120203,1183085920.6,60.552519802174096,48.11449518706335,NaN,NaN,32.415682846295205,23.162950636505816
2018-06-07T09:30:00-04:00,72.34,72.34,71.28,71.8,19523632,12789147.75,67.69031936028526,64.23513374959806,NaN,NaN,148.52311389062783,205.46461255771456,0.17076833826014182,1.1025756005908107,0.9318072623306689,1194596571,1190705239.4,64.20954603127865,48.55596193960766,NaN,NaN,32.99992789159697,24.56823310151884
2018-06-08T09:30:00-04:00,71.26,71.805,71.11,71.68,9904779,12706073.4,66.38812967139111,64.87019352492234,NaN,NaN,104.74897116485364,191.99636235062994,0.1275335214518999,1.0912241641455438,0.9636906426936439,1184691792,1193799025.4,65.60391166987506,49.448549066042574,NaN,NaN,33.097051264682406,25.786635696256493
2018-06-11T09:30:00-04:00,71.72,71.99,71.56,71.76,7323505,12634216.25,66.846035926268,65.29589683735946,NaN,NaN,104.52869093693042,163.24056349301102,0.09006888740873786,1.0762767519545662,0.9862078645458283,1192015297,1196370904.8,66.76315413392243,50.561333273089325,NaN,NaN,33.30344973408319,26.86046627308888
2018-06-12T09:30:00-04:00,71.89,72.165,71.77,72.11,7813398,12518340.05,68.84573284317665,65.92579696851429,NaN,NaN,104.28953061070311,135.86954130199055,0.0752103341769419,1.0802207822670056,1.0050104480900637,1199828695,1197050511.6,67.07889545579707,51.77224671221207,NaN,NaN,34.03742392880743,27.88574593819153
2018-06-13T09:30:00-04:00,72.11,72.43,71.71,71.74,14639032,12537162.05,64.42207253639185,66.03437741165492,NaN,NaN,89.1273781815183,110.24353695692666,0.029179606844352834,1.0414849566455047,1.0123053498011518,1185189663,1191264403.6,61.70435951042379,52.60016061652353,NaN,NaN,33.4188474771403,28.67618901518421
2018-06-14T09:30:00-04:00,72.02,72.425,71.91,72.25,11327426,12769509.1,67.52001728352198,66.41817088904317,NaN,NaN,92.4268527356162,99.02428472592433,0.022116809412819682,1.0399513615671765,1.0178345521543568,1196517089,1191648507.2,61.92246690937928,53.448850612286044,NaN,NaN,33.76011601692952,29.402464301147827
2018-06-15T09:30:00-04:00,71.74,71.83,71.29,71.72,16943176,13076660.7,61.52443920489865,66.40928552578579,NaN,NaN,52.28760174601983,88.53201084215758,-0.026572180031702697,0.9846193271147285,1.0111915071464312,1179573913,1190624931.4,60.92663831483907,54.24900219691913,NaN,NaN,32.259974016201255,29.810679974726888
2018-06-18T09:30:00-04:00,71.22,71.85,71,71.8,8290200,13097024.75,62.071906688609396,66.71057246005564,NaN,NaN,43.204857424406136,76.26724413965272,-0.05980996461313137,0.9364290513800171,0.9962390159931485,1187864113,1189794694.6,60.08262002305165,55.4387831436398,NaN,NaN,31.184918592060978,30.006999777203188
2018-06-19T09:30:00-04:00,70.92,71.46,70.52,71.43,12956679,13180396.9,57.96393313981572,66.47247257977065,NaN,NaN,11.543164933658904,57.71797100424387,-0.11020248344564809,0.8584859116860883,0.9686883951317364,1174907434,1184810442.4,55.143791169944315,56.50785278134868,NaN,NaN,29.060469024674173,29.87178109827047
2018-06-20T09:30:00-04:00,71.6,71.92,71.5,71.58,11465613,13384125.2,59.14441205807417,66.30918664682972,NaN,NaN,44.74154865569992,48.84080509908019,-0.13526923932078105,0.7996018459807601,0.9348710853015412,1186373047,1185047119.2,55.33155688375502,57.79960093425059,NaN,NaN,27.60526240254605,29.547992713166984
2018-06-21T09:30:00-04:00,71.86,71.9,70.865,71.03,14817113,13390292.85,53.24056704910969,65.22677781664005,NaN,NaN,8.292809847007774,32.013996521358514,-0.18751231556576897,0.70048069084433,0.8879930064100989,1171555934,1180054888.2,50.52712558460504,58.75443086315723,NaN,NaN,24.560364144665304,28.835474346238172
2018-06-22T09:30:00-04:00,71.21,71.23,70.511,70.8,15739988,13617259.3,50.950140119188816,63.78842164916972,NaN,NaN,-37.054020353166095,14.145672101521328,-0.23320128362275905,0.5964914018816501,0.8296926855044091,1155815946,1175303294.8,46.397654714096994,59.14599364949914,NaN,NaN,21.32161788318367,27.762066280087527
2018-06-25T09:30:00-04:00,70.23,70.3,68.725,69.33,18027741,14049078.6,39.310149164733204,61.43874203465422,NaN,NaN,-165.1347501122145,-27.522249405802803,-0.3509895626754519,0.39095573216009427,0.7419452948355462,1137788205,1165288113.2,39.13720018965473,58.24153145662836,NaN,NaN,14.060525020770756,25.804703243042276
2018-06-26T09:30:00-04:00,69.55,70.065,69.38,69.61,13862844,13275701.45,42.0269559008195,59.138915067591704,NaN,NaN,-149.48167121765115,-59.7272166360648,-0.3953127489484932,0.24780435864992967,0.6431171075984229,1151651049,1160636836.2,36.29646852543349,56.508956365432596,NaN,NaN,9.10030931741342,23.418361253666724
2018-06-27T09:30:00-04:00,69.83,70.15,68.64,68.66,22054604,13880173.65,36.119100479605315,56.883828004685995,NaN,NaN,-186.83902453106595,-106.04333127341798,-0.4688606724348987,0.057041267054799505,0.5259019394896982,1129596445,1149281515.8,30.479911029032266,54.099696722415,NaN,NaN,2.6464739092739658,20.45094877589633
2018-06-28T09:30:00-04:00,68.57,69.73,68.57,69.5,17799048,14005450.2,43.660550965136636,55.26042952566782,NaN,NaN,-162.28298211793634,-140.1584896664068,-0.44156834480121354,-0.026058491511818715,0.4155098532893948,1147395493,1144449427.6,28.39465943982634,51.44189299169723,NaN,NaN,-0.18197653632474098,17.503388017007605
2018-06-29T09:30:00-04:00,69.77,70.065,69.43,69.47,10009814,13869796.65,43.463203186071794,53.59022718708237,NaN,NaN,-112.7352646938403,-155.29473853454164,-0.4070169542222075,-0.09326133948836457,0.31375561473384295,1137385679,1140763374.2,26.883724859265456,48.59336232922173,NaN,NaN,-2.410767522846103,14.658508654171362
2018-07-02T09:30:00-04:00,68.87,70.11,68.77,70.09,12545908,14000440.15,48.630933304026584,52.146312934285945,NaN,NaN,-96.41075279531586,-141.54993907116193,-0.327317809156915,-0.09539164671230083,0.23192616244461417,1149931587,1143192050.6,29.543959493042095,45.91229547473923,NaN,NaN,-2.5890268035925703,12.194575017347944
2018-07-03T09:30:00-04:00,70.3,70.35,69.21,69.26,6361411,13454772.65,42.9686520031682,50.61392575334139,NaN,NaN,-87.26266392852062,-129.10613761333582,-0.31528847615683614,-0.16218443275143102,0.15310404340540512,1143570176,1141575876,28.793202874074638,43.56149857214286,NaN,NaN,-4.65520868994248,9.787463059163597
2018-07-05T09:30:00-04:00,69.69,70.28,69.49,70.24,13659996,13253295.35,50.32333466389904,49.385591280511186,NaN,NaN,-53.309167472572575,-102.40016620163715,-0.23007529016707529,-0.13449006930343899,0.0955852208636363,1157230172,1147102621.4,34.88669270060444,41.63037184294466,NaN,NaN,-3.8339811974357376,7.841542451077978
2018-07-06T09:30:00-04:00,70.28,71.17,70.11,71.06,12802009,12917214.2,55.49501230944284,48.95491793083577,NaN,NaN,2.8039075933663598,-69.3827882593766,-0.11314533703300338,-0.045846450427617924,0.06729888660538545,1170032181,1151629959,39.45720821868669,40.09684112179092,NaN,NaN,-1.2971681965765736,6.536012358555899
2018-07-09T09:30:00-04:00,71.44,71.62,71.07,71.6,8727604,12858355.45,58.55497419657991,48.703708467119384,NaN,NaN,49.24390076802789,-36.98695516700296,-0.00007665482853538852,0.06720306806971621,0.0672797228982516,1178759785,1159904780.2,46.80663278266569,39.148556318906216,NaN,NaN,1.8148907084644668,5.861566408542838
2018-07-10T09:30:00-04:00,71.61,71.97,71.61,71.77,11493129,13066836.65,59.499061726847245,48.813360509050206,NaN,NaN,74.19645787439156,-2.8655130330614695,0.0810322495035258,0.16857003477765886,0.08753778527413306,1190252914,1167969045.6,52.81781409652597,38.98241509937633,NaN,NaN,4.558591908932385,5.675427194312773
2018-07-11T09:30:00-04:00,71.26,71.77,71.15,71.49,12975071,13324920.3,57.188373327617626,48.673643456874736,NaN,NaN,55.21112053775361,25.629243860193377,0.10895488383204392,0.22373139006418796,0.11477650623214404,1177277843,1174710579,57.174746746289514,39.114071518128796,NaN,NaN,6.061605705113822,5.730595552998637
2018-07-12T09:30:00-04:00,71.8,72.66,71.72,72.62,11853325,13185634.95,63.3708587294424,49.39723571975565,NaN,NaN,114.5987189641338,59.210821147534645,0.19181221964350015,0.3545417807865192,0.16272956114301906,1189131168,1181090778.2,60.85857715966682,39.85203234491892,NaN,NaN,9.497096581291157,6.268667128468997
2018-07-13T09:30:00-04:00,72.63,72.72,72.3032,72.54,9258443,13082185.8,62.68072758650672,50.23513482456407,NaN,NaN,125.08473876533976,83.66698738192932,0.22710149155638373,0.4466064255884987,0.219504934032115,1179872725,1183058887,61.94600267909322,40.96262862813294,NaN,NaN,11.975057302040524,7.083865724693501
2018-07-16T09:30:00-04:00,72.56,72.71,72.23,72.37,6665953,12568324.65,61.156573769836626,51.795593724928594,NaN,NaN,112.2887656515027,96.27596035862429,0.22446490063699787,0.5000860598283623,0.27562115919136443,1173206772,1181948284.4,60.917514386377015,42.518365356470234,NaN,NaN,13.530171783267717,8.004766590204103
2018-07-17T09:30:00-04:00,71.85,73.03,71.81,72.91,7457575,12526693.4,64.13948806778372,53.37506030828318,NaN,NaN,113.37116201011617,104.11090118576922,0.24299426849056172,0.5793639948045666,0.33636972631400486,1180664347,1180030571,59.09306311546632,44.14669354147259,NaN,NaN,15.772592773436012,9.114456044951519
2018-07-18T09:30:00-04:00,72.89,72.9,72.53,72.79,7081957,12232957.3,62.9820121958576,55.29383971658692,NaN,NaN,109.87463506783365,115.04360409178521,0.23114521795880522,0.6253012487625114,0.39415603080370615,1173582390,1179291480.4,58.36752533255868,46.13866599172447,NaN,NaN,17.270190913738396,10.279561026206787
2018-07-19T09:30:00-04:00,72.61,72.89,72.4,72.53,7455318,12032442.55,60.437133418603466,56.4921670346917,NaN,NaN,94.9736665404655,111.11859360705155,0.19141541047732236,0.6334252939003591,0.4420098834230367,1166127072,1174690661.2,53.928722681922736,47.96252765187422,NaN,NaN,17.813868255674766,11.355890630416498
2018-07-20T09:30:00-04:00,72.81,72.95,72.46,72.55,7219886,11652581.2,60.56911957250601,57.714018205151284,NaN,NaN,88.34174762927492,103.76999537983859,0.15372585826744672,0.6341672062573451,0.4804413479898984,1173346958,1173385507.8,52.7042440239448,49.80685044935131,NaN,NaN,18.29685771289912,12.347457356485444
2018-07-23T09:30:00-04:00,72.4,72.96,72.115,72.92,12575508,11494357.2,63.02658066333783,58.74227873081637,NaN,NaN,79.89195075644584,97.29063240082722,0.1412766571510451,0.6570371694287047,0.5157605122776596,1185922466,1175928646.6,54.85520229652066,51.61479636388549,NaN,NaN,19.3900443321744,13.353541210155296
2018-07-24T09:30:00-04:00,73.65,73.936,73.015,73.32,10778640,11131902.15,65.52785557636095,60.353650414615856,NaN,NaN,109.63723151354219,96.54384630151242,0.14689275864256435,0.699376460580865,0.5524837019383007,1196701106,1179135998.4,57.48152854858609,53.66396248349345,NaN,NaN,21.043667005229832,14.452130609451658
2018-07-25T09:30:00-04:00,73.34,74.24,73.23,74.24,15288805,11203200.2,70.47519169319771,61.79306877385147,NaN,NaN,123.60480862985047,99.28988101391579,0.1963878233802001,0.7979684811635508,0.6015806577833507,1211989911,1186817502.6,63.02890495410741,55.6741205016008,NaN,NaN,24.0883705903972,15.828736321015306
2018-07-26T09:30:00-04:00,72.97,73.34,72.84,73.1,12547190,10727829.5,59.14750445894471,62.05396107024446,NaN,NaN,75.85935989484238,95.46701968479117,0.13887876408439936,0.7751791128888499,0.6363003488044505,1199442721,1193480632.4,67.045362783609,57.64470297052383,NaN,NaN,23.195048373374373,16.88106661420946
2018-07-27T09:30:00-04:00,73.19,73.24,71.4,71.85,31777544,11426754.3,49.712165431821404,61.42233187276172,NaN,NaN,18.077720447982028,81.4142142485326,0.009979836960738453,0.6487751450053736,0.6387953080446351,1167665177,1192344276.2,65.73379571468531,58.9966431799538,NaN,NaN,19.039332190384304,17.189390267948724
2018-07-30T09:30:00-04:00,71.81,71.92,70.32,70.73,17847711,11818649.15,43.080871779780566,60.249604019399804,NaN,NaN,-64.65867708282605,52.50408868067823,-0.1486342312814941,0.45300251894276755,0.6016367502242617,1149817466,1185123276.2,57.972860925623515,59.364860810603616,NaN,NaN,13.04432883583897,16.597238634790187
2018-07-31T09:30:00-04:00,70.95,71.38,70.525,70.92,14977005,11940204,44.43499199582201,59.338648209985834,NaN,NaN,-78.46635626100547,14.883371125768695,-0.2336184556644776,0.3096136806436647,0.5432321363081423,1164794471,1178741949.2,52.1168507026818,59.0035825217745,NaN,NaN,8.909095165394607,15.498932424876534
2018-08-01T09:30:00-04:00,71.43,71.79,71.17,71.56,14661395,12355203.2,48.84929052665053,58.30139333835785,NaN,NaN,-50.149221345091384,-19.867434869219675,-0.2387474944571245,0.2447977682367366,0.4835452626938611,1179455866,1172235140.2,46.9131379145974,58.00747971855525,NaN,NaN,6.983729315194763,14.282474837779137
2018-08-02T09:30:00-04:00,70.9,72.55,70.9,72.46,13104923,12327449.55,54.34242667461725,57.705800416080024,NaN,NaN,-22.647664854916986,-39.56883981917155,-0.17641923085880817,0.2630212241203509,0.43944045497915907,1192560789,1170858753.8,45.869814074936016,56.85918053254403,NaN,NaN,7.238147094595086,13.276142303038558
2018-08-03T09:30:00-04:00,72.48,72.72,72.15,72.72,7245702,12049634.2,55.81855508244811,57.32451336698085,NaN,NaN,26.78224044258081,-37.827935820251795,-0.11551859728759517,0.2950422083696651,0.4105608056572603,1199806491,1177287016.6,51.31550796077499,56.173322930715315,NaN,NaN,7.921949502837097,12.511257617295492
2018-08-06T09:30:00-04:00,72.69,73.15,72.515,73.11,7500345,11988271.25,58.01145149583957,56.88679646898483,NaN,NaN,65.41843958445854,-11.812512486794898,-0.05014569985836914,0.34787868083429885,0.398024380692668,1207306836,1188784890.6,59.21840797173043,56.18227613473418,NaN,NaN,9.17758525145749,12.035018707890062
2018-08-07T09:30:00-04:00,73.37,73.645,73.26,73.39,10272737,11927251.65,59.56324044769089,56.64259848697292,NaN,NaN,114.593658907635,26.799490546933196,0.007697719781532442,0.40764653041958354,0.3999488106380511,1217579573,1199341911,64.8589302753776,56.645947916364136,NaN,NaN,10.678803480903772,11.84127367546345
2018-08-08T09:30:00-04:00,73.35,73.73,73.16,73.59,7099160,11633456.1,60.681031321042376,56.66001976571856,NaN,NaN,114.51817956817682,59.73297072958684,0.05266660320819483,0.46578206464829464,0.4131154614400998,1224678733,1208386484.4,68.8358095308162,57.710739834142245,NaN,NaN,12.239372640968709,11.898144956249915
2018-08-09T09:30:00-04:00,73.66,73.9,73.56,73.62,11723235,11626951.6,60.85582563197962,56.680498769966675,NaN,NaN,122.29112043596002,88.72072778776223,0.07623959288974902,0.5084149525522861,0.43217535966253706,1236401968,1217154720.2,72.12880975144427,59.09820881467791,NaN,NaN,13.558440514823985,12.135330036046211
2018-08-10T09:30:00-04:00,73.07,73.38,72.82,73.03,11569162,11742487.55,55.6190476265323,56.15138926733771,NaN,NaN,48.01785479557618,92.96785065836131,0.04542559878675545,0.4889573581459814,0.44353175935922595,1224832806,1222159983.2,73.82884587605858,60.4534690703592,NaN,NaN,13.231130239556615,12.291872922261984
2018-08-13T09:30:00-04:00,73.14,73.7,72.91,72.93,12064769,12012428.35,54.75894602328428,55.38218144211795,NaN,NaN,54.13978929943002,90.71212060135561,0.013305338529532917,0.4601634325211421,0.4468580939916092,1212768037,1223252223.4,74.19869134809332,61.64755212746686,NaN,NaN,12.722863656000275,12.35344302708174
2018-08-14T09:30:00-04:00,73.18,73.4662,72.77,73.38,9179535,12098526.35,57.91301523423131,54.48488312362036,NaN,NaN,51.96926163563608,78.18724114695583,0.017119522614142624,0.46825749725928745,0.4511379746451448,1221947572,1224125823.2,74.50897845042758,62.46755737720402,NaN,NaN,13.156981964799275,12.46823430389853
2018-08-15T09:30:00-04:00,72.92,73.19,72.15,72.72,17741662,12631511.6,52.16838592090076,53.986374656617215,NaN,NaN,-2.127756276465631,54.85805397802734,-0.027619851278594343,0.4166131605469019,0.44423301182549624,1204205910,1220031258.6,70.24497880222555,62.69610137853376,NaN,NaN,11.876132067392046,12.38364827011189
2018-08-16T09:30:00-04:00,73.28,73.48,72.88,73.04,9104839,12713987.65,54.52376627835245,54.33006043136943,NaN,NaN,41.0752098612772,38.61487186309077,-0.03784208099573938,0.396930410580822,0.4347724915765614,1213310749,1215413014.8,65.67944229986455,62.69221899176086,NaN,NaN,11.464614097599341,12.252357674038668
2018-08-17T09:30:00-04:00,72.82,73.35,72.58,73.15,9024155,12804201.1,55.33793092782955,55.20556465623008,NaN,NaN,27.908265132240178,34.592953930423576,-0.03920922692307871,0.38576095792271303,0.42497018484579174,1222334904,1214913434.4,65.1858785268333,63.20743453470442,NaN,NaN,11.348589162985869,12.12324788674541
2018-08-20T09:30:00-04:00,73.32,73.34,72.75,73.04,10619833,12706417.35,54.291183874062355,55.909578361818674,NaN,NaN,27.489242020442035,29.26284447462598,-0.048905030114350434,0.3638388972028537,0.4127439273172041,1211715071,1214702841.2,64.96425700606008,64.12510641351716,NaN,NaN,10.970332677789637,11.958545714037443
2018-08-21T09:30:00-04:00,73.24,73.62,73.07,73.16,8002432,12567606.95,55.284864059686164,56.369262185606935,NaN,NaN,52.803630020852424,29.42971815166925,-0.048523277166744705,0.3520898308587732,0.4006131080255179,1219717503,1214256827.4,64.46437578127689,65.37876626113712,NaN,NaN,10.90881924347449,11.808584789671308
2018-08-22T09:30:00-04:00,72.94,73.49,72.83,73.38,6371245,12121728.95,57.12510969726221,56.568025258653,NaN,NaN,53.02222910940729,40.459715228843834,-0.03535275864064197,0.35642215972471547,0.39177491836535744,1226088748,1218633395,67.1366112359787,66.8978232012116,NaN,NaN,11.335238373855274,11.74096387312616
2018-08-23T09:30:00-04:00,73.25,73.94,73.25,73.54,9367818,11962760.35,58.4639489335937,56.75698196230626,NaN,NaN,84.40965534423452,49.126604325435295,-0.018605393694884176,0.3685181762467522,0.3871235699416364,1235456566,1223062558.4,69.62596175908202,68.20571275823353,NaN,NaN,12.049174673386744,11.7849939874491
2018-08-24T09:30:00-04:00,73.74,74.3,73.73,74.28,6557635,10701764.9,64.05463078747238,57.18863762599432,NaN,NaN,128.70554866693018,69.2860610323733,0.036562595217469296,0.432826813963473,0.3962642187460037,1242014201,1226998417.8,71.67894627411263,69.0957512084037,NaN,NaN,14.303520753838194,12.144783525504685
2018-08-27T09:30:00-04:00,74.68,75,74.48,74.96,8207455,10219752.1,68.27974214246757,57.81124488990694,NaN,NaN,206.65304266196324,105.11882116067754,0.1090074963819413,0.5325235892234303,0.42351609284148906,1250221656,1234699734.8,75.20975410040539,69.83509576733425,NaN,NaN,17.62855718532397,12.928179762621726
2018-08-28T09:30:00-04:00,75.11,75.255,74.88,75.09,7385363,9840170,69.02923292412683,58.40754500441296,NaN,NaN,222.2939263617322,139.01688042885348,0.15313538477413957,0.6149353238091635,0.4617999390350239,1257607019,1242277638,78.10260389119203,70.49700965021823,NaN,NaN,20.591963376525918,14.023005993179467
2018-08-29T09:30:00-04:00,75.18,75.82,75.17,75.77,11182347,9666217.6,72.66723836513981,59.25121734249584,NaN,NaN,230.57138647115795,174.52671190120364,0.2119521499066942,0.7267401264183917,0.5147879765116975,1268789366,1250817761.6,80.81912591192312,71.11774651882386,NaN,NaN,24.389634426977977,15.50395291229354
2018-08-30T09:30:00-04:00,75.56,76.03,75.31,75.54,10520312,9536987.05,69.68557982219879,60.2559696421863,NaN,NaN,187.3953804526809,195.1238569228929,0.2183351904937132,0.787706964628839,0.5693717741351259,1258269054,1255380259.2,82.09694968524488,71.70832536233716,NaN,NaN,26.67557823147234,17.09989938646194
2018-08-31T09:30:00-04:00,75.47,75.8,75.34,75.6,10269170,9688160.45,70.03104080909655,61.3468335554586,NaN,NaN,148.295875374875,199.04192226448185,0.2095286712539023,0.8312826132025037,0.6217539419486015,1268538224,1260685063.8,83.47538193565433,72.37094611859153,NaN,NaN,28.64591363591921,18.74932999352726
2018-09-04T09:30:00-04:00,75.25,75.42,74.8,75.31,11073920,9866839.2,66.10959966170441,61.93230387170668,NaN,NaN,98.26492433578032,177.36429859924527,0.1688495419146956,0.8328158693419709,0.6639663274272753,1257464304,1262133593.4,83.84123708194885,73.03753602084305,NaN,NaN,29.239586460078765,20.247938060177475
2018-09-05T09:30:00-04:00,75.21,75.27,73.99,74.37,16426553,10174530,55.300308531081384,62.15601262957673,NaN,NaN,44.17841910440519,141.7411971477799,0.0684594214770069,0.749540604273534,0.6810811827965271,1241037751,1258819739.8,79.50452857306642,73.69893243304595,NaN,NaN,26.414076293848126,21.128814950701855
2018-09-06T09:30:00-04:00,74.26,74.42,73.25,73.83,13978783,10518511.15,50.22031978469067,61.848623594315164,NaN,NaN,-10.750302572211911,93.47685933910591,-0.03872274272930132,0.6326777543849005,0.6714004971142018,1227058968,1250473660.2,69.72288584331807,73.98774982900693,NaN,NaN,22.348028830602864,21.302988362116285
2018-09-07T09:30:00-04:00,73.35,74.17,73.27,73.58,14230964,10643897.6,48.0209566766884,61.32598257637652,NaN,NaN,-22.89337672721129,51.419107903127475,-0.1259479827576081,0.5139655186671916,0.6399135014247997,1212828004,1241385450.2,60.93176583656191,73.6838846368447,NaN,NaN,18.319463144710173,20.87677047391541
2018-09-10T09:30:00-04:00,73.85,73.95,73.405,73.81,16654881,10898183.55,50.18253796081917,61.03250786828772,NaN,NaN,-22.324422047650224,17.295048418622418,-0.16517257856401057,0.43344777821978653,0.5986203567837971,1229482885,1233574382.4,54.5639381952121,72.94100472178413,NaN,NaN,15.626268678150486,20.126698788806134
2018-09-11T09:30:00-04:00,73.6,74.6,73.42,74.44,13595012,10974695.7,55.6259337566597,61.056869989500115,NaN,NaN,8.119926659949032,-0.733951116543832,-0.14635155512679565,0.4156809128753025,0.5620324680020982,1243077897,1230697101,52.39189596627548,72.0786847349983,NaN,NaN,14.93117003341079,19.38448039517823
2018-09-12T09:30:00-04:00,74.28,74.29,73.53,74.13,16268233,11329130.6,52.58136359177427,60.732316696250976,NaN,NaN,-9.31566764651994,-11.43276846672887,-0.1517903304176318,0.3722945549800585,0.5240848853976903,1226809664,1227851483.6,50.260951578679496,70.87328047376265,NaN,NaN,13.414920743859593,18.531686159275566
2018-09-13T09:30:00-04:00,74.59,75.19,74.57,75,12727444,11078419.7,59.31201499374558,60.79289284340469,NaN,NaN,62.06727086133415,3.1307462199803453,-0.09649876380104183,0.40346143064638795,0.4999601944474298,1239537108,1230347111.6,52.10097234069575,69.62149551530648,NaN,NaN,14.248882242286973,17.919857028277196
2018-09-14T09:30:00-04:00,75.07,75.265,74.6,74.94,9439156,11095135.55,58.693268130413145,60.40993836790045,NaN,NaN,56.14042775397774,18.93750711621815,-0.06517155785414086,0.4184957471297537,0.48366730498389454,1230097952,1233801101.2,54.604016654632886,68.40185768534364,NaN,NaN,14.717067135854789,17.462315615073994
2018-09-17T09:30:00-04:00,74.83,74.96,73.92,74,14792111,11383533.35,49.90891567133451,59.09773647710524,NaN,NaN,-6.10273596785539,22.181844332177118,-0.10651797780603678,0.35051983272634857,0.45703781053238535,1215305841,1230965692.4,52.192823651543485,66.75779122471066,NaN,NaN,12.230519016142742,16.714916100940957
2018-09-18T09:30:00-04:00,73.91,74.83,73.91,74.47,9650997,11335091.55,53.644650234486825,57.998837713559524,NaN,NaN,-2.326013739913636,20.092656252204584,-0.10102168889290047,0.33076069941625974,0.4317823883091602,1224956838,1227341480.6,49.20211747037717,64.69347076608103,NaN,NaN,11.392146963938469,15.954520509940602
2018-09-19T09:30:00-04:00,74.46,74.71,73.86,74.28,10435469,11456743.4,51.957686264404245,56.51958399207842,NaN,NaN,-21.469383580434997,17.661913065421572,-0.10834283136033573,0.2963538491087405,0.40469668046907625,1214521369,1224883821.6,47.2258947502804,62.29395425453513,NaN,NaN,10.188751293069192,15.130839193244686
2018-09-20T09:30:00-04:00,74.72,75.235,74.49,75.16,13700995,11823230.9,58.47155254471564,55.71858204368676,NaN,NaN,47.42824919122003,14.734108731398749,-0.0547820696033825,0.33621909346484813,0.39100116306823063,1228222364,1222620872.8,45.4170199208591,59.673959271364716,NaN,NaN,11.280502809228347,14.580791138385209
2018-09-21T09:30:00-04:00,75.19,75.31,74.58,74.61,23094735,12509576.75,53.58169638811754,54.54362887075968,NaN,NaN,26.4131008980395,8.7886433602111,-0.057003853234680324,0.3197463465248802,0.37675019975956053,1205127629,1217626808.2,41.62759143659339,56.68483137857465,NaN,NaN,10.572785234618124,14.008218866418483
2018-09-24T09:30:00-04:00,74.25,74.99,73.96,74.98,17256802,13044535.1,56.23335973589332,53.83818316177318,NaN,NaN,-1.1582581579321105,9.777538922195758,-0.03523041203410826,0.3327121847169252,0.36794259675103347,1222384431,1219042526.2,43.077518600850865,53.77313720135337,NaN,NaN,10.85426001745878,13.557653316567096
2018-09-25T09:30:00-04:00,74.89,75.042,74.58,74.89,10508525,13159588.6,55.404276981846145,53.84560947968494,NaN,NaN,24.549474479471876,15.15263656607286,-0.0288344566610233,0.33189952592475436,0.36073398258577766,1211875906,1216426339.8,41.04838224624069,51.0262696065801,NaN,NaN,10.825123007781968,13.167291843883506
2018-09-26T09:30:00-04:00,74.97,75.3,74.48,74.61,13320561,13456348.5,52.79627831851131,54.02960651781499,NaN,NaN,21.565786153174088,23.759670512794678,-0.044471734608697355,0.30514431432490596,0.3496160489336033,1198555345,1213233135,38.65501588651249,48.80713603823684,NaN,NaN,10.020915874783142,12.717809562583454
2018-09-27T09:30:00-04:00,74.88,75.255,74.88,75.05,14233197,13608891,56.27910932338814,54.619474564007824,NaN,NaN,64.61245250319122,27.196511175188913,-0.02704920637017255,0.3158045409708876,0.34285374734106017,1212788542,1210146370.6,36.44299803740992,47.05793833829741,NaN,NaN,10.379348630590874,12.383743715155942
2018-09-28T09:30:00-04:00,74.84,75.4,74.8,75.33,11710568,13668403.8,58.38343258217459,55.20525275124749,NaN,NaN,88.27708079179595,39.5693071539402,0.000032074593349196157,0.34289384058274663,0.34286176598939744,1224499110,1214020666.8,41.006136343650155,46.0895239203287,NaN,NaN,11.304311852169661,12.229539163300759
2018-10-01T09:30:00-04:00,75.81,75.995,75.46,75.69,10334066,13671648.6,60.983591527399156,55.5879425920146,NaN,NaN,166.05938598412902,73.01283598235243,0.036852969146889236,0.388927977423009,0.35207500827611976,1234833176,1216510415.8,43.798644491540955,45.47572024356195,NaN,NaN,12.864871355351104,12.320300905022236
2018-10-02T09:30:00-04:00,75.6,76.13,75.36,75.7,14006955,13818300.35,61.05637824947533,56.19330078185039,NaN,NaN,155.5460934008474,99.21215976662754,0.05542807496737845,0.4213601019853428,0.36593202701796435,1248840131,1223903260.8,51.18723703384787,45.54188349035969,NaN,NaN,14.152337898201935,12.58202047547648
2018-10-03T09:30:00-04:00,75.96,76.265,75.785,75.93,13292564,13661600.9,62.77640691033217,56.44075734732086,NaN,NaN,163.35195788938157,127.56939411386902,0.07550689039372671,0.4603156400101227,0.384808749616396,1262132695,1236618730.8,60.746046955554924,46.159388819992486,NaN,NaN,15.73156175098475,13.031954943406232
2018-10-04T09:30:00-04:00,75.56,75.62,74.07,74.56,23292417,14127282.6,48.91720071114739,55.742466817373305,NaN,NaN,0.9345707699591996,114.83381776722263,-0.00680472039891733,0.37630284911774936,0.3831075695166667,1238840278,1241829078,63.86836394270267,46.82112791199747,NaN,NaN,12.826746992222098,13.002639521808499
2018-10-05T09:30:00-04:00,74.53,74.76,72.9045,73.62,22288724,14530170.6,42.05652003982721,55.18158141512278,NaN,NaN,-138.7526878694814,69.42786403496716,-0.12152065128636813,0.2312067554087065,0.35272740669507463,1216551554,1240239566.8,62.241850339646525,47.53891553257626,NaN,NaN,7.876000709797994,12.27026254866414
2018-10-08T09:30:00-04:00,73.27,73.495,71.955,72.79,19973003,14696076.7,37.107670774220146,54.00036859653231,NaN,NaN,-244.49126805719158,-12.68226677329696,-0.2432364704117112,0.04868181868043564,0.29191828909214684,1196578551,1232588641.8,54.983479342386325,47.95186995200549,NaN,NaN,1.905739394119016,10.789616383729122
2018-10-09T09:30:00-04:00,72.76,73.48,72.605,73.05,15138932,14773272.7,39.508946225194386,53.11117287944588,NaN,NaN,-177.9589314838282,-79.38327175023207,-0.2928435008307775,-0.07413608694632501,0.21870741388445247,1211717483,1225164112.2,49.01056779732047,48.079346598222635,NaN,NaN,-1.9894787064066641,8.964031370852581
2018-10-10T09:30:00-04:00,72.61,72.62,69.46,69.51,44142990,16167010.55,25.328950614327297,50.74384417013243,NaN,NaN,-319.11689733159915,-175.87704279442823,-0.536493329894421,-0.45190924848357383,0.0845840814108472,1167574493,1206252471.8,37.75887526995675,47.53233626601533,NaN,NaN,-12.612342521995446,5.881692243302863
2018-10-11T09:30:00-04:00,69.31,70.49,68.07,68.63,68269507,18944113.7,23.108614834424827,48.56719548772581,NaN,NaN,-290.3528037079281,-234.1345176900057,-0.7180151366877523,-0.8129348394488431,-0.09491970276109088,1099304986,1178345413.4,27.665503946273162,46.535044302421035,NaN,NaN,-21.419578404583,1.9815107221763113
2018-10-12T09:30:00-04:00,70.57,71.055,69.45,70.83,35909369,20267624.35,37.79052844997466,47.249850395874475,NaN,NaN,-165.5396040713483,-239.4919009303791,-0.6528857233847348,-0.9110268569920095,-0.25814113360727464,1135214355,1162077973.6,23.690157523849265,45.150232796920925,NaN,NaN,-22.217235132712148,-1.4754529713791826
2018-10-15T09:30:00-04:00,70.57,70.63,69.63,69.67,19152748,20485656.2,34.09393184517491,45.72768288611224,NaN,NaN,-150.86810761265417,-220.7672688414716,-0.6495135870186858,-1.070033117380632,-0.4205195303619461,1116061607,1145974584.8,20.543222861715208,43.6855785551691,NaN,NaN,-24.374426767219205,-4.746734942213472
2018-10-16T09:30:00-04:00,70.55,72,70.38,71.77,20999283,21053070.5,44.64960243615855,45.14577746594419,NaN,NaN,-81.98462557652786,-201.57240766001152,-0.47550053146644367,-1.0148951946950007,-0.539394663228557,1137060890,1131043266.2,18.137416002383702,42.22003570630276,NaN,NaN,-21.510570387152594,-7.141568577204774
2018-10-17T09:30:00-04:00,71.86,71.91,70.8,71.44,24164921,21739543.1,43.471338020534354,44.23093665859749,NaN,NaN,-72.37470537699603,-152.2239692690909,-0.3576482667291139,-0.9864549966399494,-0.6288067299108355,1112895969,1120107561.4,16.603747169071696,40.80294635856431,NaN,NaN,-19.93405671665266,-8.969066882840186
2018-10-18T09:30:00-04:00,71.12,71.17,69.62,70.04,22960568,22202521.75,38.79409851575915,42.83169851099638,NaN,NaN,-97.60965380633242,-113.67533928877177,-0.34864425565860935,-1.0646120494840972,-0.7159677938254878,1089935401,1118233644.4,16.348638032705594,39.041696479211126,NaN,NaN,-20.48362326478122,-10.614003508831763
2018-10-19T09:30:00-04:00,70.45,71.21,69.75,70.01,22141736,22154871.8,38.69801404954583,41.23987154829258,NaN,NaN,-85.58565990247881,-97.68455045499789,-0.3201113961718052,-1.1161070390402443,-0.7959956428684392,1067793665,1104749506.4,14.609218272170608,36.95673746354181,NaN,NaN,-20.919903007589227,-12.086274865797115
2018-10-22T09:30:00-04:00,70.34,71.05,69.92,70.59,15981011,22091082.25,41.70420240571074,39.85757327373796,NaN,NaN,-71.24071800499908,-81.75907253346686,-0.2411755989244012,-1.0974651415239407,-0.8562895425995395,1083774676,1098292120.2,13.84929666107736,34.289741722629635,NaN,NaN,-20.250951793981898,-13.252657284109226
2018-10-23T09:30:00-04:00,69.12,70.69,68.42,70.32,24066081,22768960.05,40.70352494232223,38.28093884745154,NaN,NaN,-84.04098729693142,-82.17034487754758,-0.18848148795301634,-1.09189140254081,-0.9034099145877936,1059708595,1082821661.2,12.210562158337453,30.822921379971245,NaN,NaN,-20.039933006466168,-14.222268101588789
2018-10-24T09:30:00-04:00,70.14,70.31,67.09,67.17,34165356,23811199.8,31.275011070331402,37.02078244453612,NaN,NaN,-120.06316391545877,-91.70803658524012,-0.33836275428145957,-1.326363357439618,-0.9880006031581585,1025543239,1065351115.2,10.674476522505088,27.023357992814276,NaN,NaN,-23.3004453301756,-15.519150562815476
2018-10-25T09:30:00-04:00,68.13,69.84,68.02,69.48,23377176,24268398.75,41.90299889342519,37.00981664836454,NaN,NaN,-85.33265271397003,-89.25263636676765,-0.25814167731099147,-1.3106776997968979,-1.0525360224859064,1048920415,1057148118,10.036074278572045,23.29437398845181,NaN,NaN,-21.98113305206226,-16.44229091842216
2018-10-26T09:30:00-04:00,67.75,69.33,67.11,68.09,42743594,25820050.05,38.08626199151534,37.07971602102849,NaN,NaN,-107.41920861544602,-93.61934610936109,-0.2734392298238759,-1.3943350597657513,-1.1208958299418754,1006176821,1044824749.2,9.15066876999714,20.02060180470972,NaN,NaN,-22.371437932858505,-17.289311920484494
2018-10-29T09:30:00-04:00,69.03,69.52,65.59,66.94,34055312,27006112.35,35.22738634998578,36.77389031565644,NaN,NaN,-127.43861341446087,-104.85892519125346,-0.3318646231807496,-1.5357266089178125,-1.203861985737063,972121509,1022494115.8,7.806665822374256,17.077465949356423,NaN,NaN,-23.72036549079325,-18.20803385910003
2018-10-30T09:30:00-04:00,66.88,67.925,66.31,67.69,30560929,27833811.05,38.47118274704929,37.71262118227944,NaN,NaN,-125.11086562066914,-113.072900856001,-0.2922490081312621,-1.5691732459011405,-1.2769242377698784,1002682438,1011088884.4,7.223138655328015,14.896341905454369,NaN,NaN,-23.645159030994893,-18.984766026513583
2018-10-31T09:30:00-04:00,68.7,69.85,68.67,69.3,21144140,28226389.85,44.855489520848046,39.26596937416681,NaN,NaN,-48.08505893986317,-98.67727986088188,-0.13771061889659486,-1.449062511390622,-1.311351892494027,1023826578,1010745552.2,7.205677802622247,13.434925752336445,NaN,NaN,-21.340327003112474,-19.32127473745628
2018-11-01T09:30:00-04:00,69.4,70.16,68.81,70.11,15553097,27839423.85,47.79062083300474,39.980261687240386,NaN,NaN,-21.42408724334983,-85.89556676675782,0.030017720349289068,-1.2738297420574156,-1.3038474624067047,1039379675,1008837404.2,7.102909780307044,12.250122342083431,NaN,NaN,-18.512414849857038,-19.205723324942102
2018-11-02T09:30:00-04:00,69.57,69.98,68.16,68.74,20213140,27735644.65,43.56683851936537,40.656897878253986,NaN,NaN,-51.68718489858329,-74.74916202338528,0.05802974445005904,-1.2313102818441308,-1.2893400262941899,1019166535,1011435347,9.005737120819205,11.426016217733718,NaN,NaN,-17.57317757655682,-18.972502503744206
2018-11-05T09:30:00-05:00,68.7,68.81,67.68,68.67,14208230,27447406,43.3559902111215,40.56449700503707,NaN,NaN,-76.34960476529582,-64.53136029355225,0.0798325538187945,-1.1895493340206968,-1.2693818878394914,1004958305,1018002706.2,13.811815757641725,11.117044771680716,NaN,NaN,-16.910236880009972,-18.677893128925028
2018-11-06T09:30:00-05:00,68.61,69.43,68.55,69.1,9134209,27147169.85,45.11325281595874,40.681776633281665,NaN,NaN,-29.605563155495883,-45.4302998005176,0.12832748576164876,-1.1089725306374305,-1.2373000163990793,1014092514,1020284721.4,15.482279607500956,11.03693994585424,NaN,NaN,-15.842226265777725,-18.272797862761127
2018-11-07T09:30:00-05:00,69.9,71.13,69.81,71.13,16314800,25755760.35,52.590776331489245,41.667253620119524,NaN,NaN,82.9375848032544,-19.22577105189409,0.2928261163653392,-0.8712673709424053,-1.1640934873077444,1030407314,1021600868.6,16.487614724741903,11.046866852428264,NaN,NaN,-12.477262173955307,-17.444864192931725
2018-11-08T09:30:00-05:00,70.86,71.16,70.62,71.07,10409749,22862772.45,52.36370591060035,42.6433744673377,NaN,NaN,90.09827624440709,3.07870164565729,0.3873640005564245,-0.6798884866122137,-1.0672524871686382,1019997565,1017724446.6,15.88817122024814,11.138220634433802,NaN,NaN,-9.886784877874867,-16.36513857649503
2018-11-09T09:30:00-05:00,70.46,70.52,69.25,69.84,12941931,21714400.55,47.806712434938284,43.079268040853954,NaN,NaN,22.43250966129026,17.902640557632004,0.35754646457563166,-0.6203194064490987,-0.9778658710247303,1007055634,1015302266.4,15.508745147364579,11.256752669168606,NaN,NaN,-9.024463272188843,-15.316470675879861
2018-11-12T09:30:00-05:00,69.2,69.32,67.3,67.38,16431059,21578316.1,40.260311993349404,43.04760997307018,NaN,NaN,-90.56752703449685,15.0590561037918,0.17203779769048233,-0.7628186239116275,-0.9348564216021098,990624575,1012435520.4,15.050629246673097,11.45961460404972,NaN,NaN,-10.727974712947946,-14.660971252603874
2018-11-13T09:30:00-05:00,67.54,68.62,67.26,67.46,15703538,21313528.85,40.58875437210112,43.71287735176801,NaN,NaN,-95.8831341301494,1.803541908861098,0.0603743742058358,-0.8593884538448151,-0.9197628280506509,1006328113,1010882640.2,14.795672310596984,11.753985731770571,NaN,NaN,-11.959312357701119,-14.27501998190348
2018-11-14T09:30:00-05:00,68.21,68.35,66.3065,66.65,19496735,21080119.55,38.29314998157133,43.455031000921316,NaN,NaN,-127.66180543546801,-40.316336138883386,-0.05608602637037152,-0.9898703610136153,-0.9337843346432437,986831378,1002167453,13.421512953021491,11.995802779945532,NaN,NaN,-13.68926469948932,-14.191340655844314
2018-11-15T09:30:00-05:00,66.76,68.48,66.37,68.32,26301445,21247163.4,45.17754721037598,43.96155137369708,NaN,NaN,-77.7593483785911,-73.88786106348303,-0.011052394947846489,-0.9475998283280518,-0.9365474333802053,1013132823,1000794504.6,13.213315043746007,12.28599179949902,NaN,NaN,-13.049264644696972,-14.028186939966123
2018-11-16T09:30:00-05:00,67.52,68.62,67.38,68.21,17973021,21038727.65,44.822821528338935,44.6469396007223,NaN,NaN,-49.08914060507388,-88.19219111675585,0.019271578746775986,-0.9124579599467353,-0.9317295386935113,995159802,998415338.2,12.841567411553442,12.645627627297534,NaN,NaN,-12.644640373152935,-13.830537430421382
2018-11-19T09:30:00-05:00,67.89,67.96,65.43,65.61,19198619,21199608.05,37.3565741991592,44.56732470444444,NaN,NaN,-149.3713254241986,-99.95295079469619,-0.12016371559026784,-1.081934183181346,-0.9617704675910782,975961183,995482659.8,12.37923480092185,13.013920209125663,NaN,NaN,-14.70460805221684,-13.955404662106448
2018-11-20T09:30:00-05:00,63.78,65.07,63.38,64.2,28064763,21399542.15,34.044635304272845,43.79512083183192,NaN,NaN,-244.40973603283038,-129.65827117523241,-0.2824745044535135,-1.3148635981579702,-1.0323890937044566,947896420,983796321.2,10.722571833637275,13.26512692562674,NaN,NaN,-17.53527110105183,-14.466814153384359
2018-11-21T09:30:00-05:00,65.07,65.33,64.4,64.67,16503284,20516438.55,36.0789702735014,42.958574363295966,NaN,NaN,-175.0036555211468,-139.12664119236814,-0.32999358584415517,-1.4448810760096507,-1.1148874901654955,964399704,979309986.4,10.160424548907912,13.483520837669658,NaN,NaN,-19.16723440745539,-15.138302761108791
2018-11-23T09:30:00-05:00,63.98,64.79,63.9465,64.08,5338114,19614485.45,34.63478257590339,42.320570367334405,NaN,NaN,-170.20580998281045,-157.61593351321204,-0.3699670216215778,-1.5773462671924676,-1.2073792455708898,959061590,968495739.8,8.943292101804758,13.479060479168625,NaN,NaN,-20.94582870991592,-15.967949325224096
2018-11-26T09:30:00-05:00,64.92,65.53,64.575,65.53,12534629,18104037.2,40.896368534953,42.14488310475093,NaN,NaN,-109.63601344391134,-169.72530808097954,-0.2720842554887337,-1.547484564931807,-1.2754003094430733,971596219,963783023.2,8.467267908951541,13.097307061405044,NaN,NaN,-20.55002957445525,-16.622532217971404
2018-11-27T09:30:00-05:00,65.08,65.76,64.7,65.66,11568577,16979700.45,41.438011967650006,41.88236590130031,NaN,NaN,-91.52170915317666,-158.15538482677513,-0.17654625024532455,-1.496083122249729,-1.3195368720044045,983164796,965223745.8,10.043634556930058,12.70883241493569,NaN,NaN,-20.07324114515994,-17.115490636141196
2018-11-28T09:30:00-05:00,66.32,67.96,66.07,67.96,16609706,16282139.3,50.14345131974828,41.70755697189025,NaN,NaN,-12.988405028152291,-111.87111862583951,0.05140055929450571,-1.2552861728862723,-1.306686732180778,999774502,975599362.2,20.643094931918412,13.005652429734013,NaN,NaN,-16.857634833125836,-17.078654092853288
2018-11-29T09:30:00-05:00,67.75,67.85,66.94,67.3,14115418,15930703.2,47.941114247676815,41.391657567395704,NaN,NaN,-8.087728755145012,-78.48793327263915,0.16137185659000486,-1.104971911443272,-1.2663437680332768,985659084,979851238.2,24.565678552442776,13.62547438203363,NaN,NaN,-14.897067225763314,-16.766998826126148
2018-11-30T09:30:00-05:00,67.34,67.99,67.01,67.94,16509839,15978540.3,50.22413120618484,41.56433033677046,NaN,NaN,8.45163935451727,-42.756443405173606,0.2742286751126781,-0.923557924142429,-1.197786599255107,1002168923,988472704.8,31.914647646095503,14.797324560514411,NaN,NaN,-12.584875813549424,-16.16955268147233
2018-12-03T09:30:00-05:00,69.64,69.71,68.69,69.44,16231664,15779466.5,55.184752125467284,42.630361774778876,NaN,NaN,79.12575382077881,-5.0040899522355655,0.43723610978655403,-0.6512414620219147,-1.0884775718084687,1018400587,997833578.4,38.877374353815135,16.49923492531027,NaN,NaN,-9.01565945461459,-15.147567934778365
2018-12-04T09:30:00-05:00,68.95,69.1,66.65,66.81,20991080,16118609,46.444894720320335,43.04865751393739,NaN,NaN,4.131956214132497,14.126643121226255,0.358568358897583,-0.64026712318649,-0.998835482084073,997409507,1000682520.6,40.85963871832141,18.3609468115763,NaN,NaN,-8.663160255544941,-14.221223980602161
2018-12-06T09:30:00-05:00,65.24,66.96,64.91,66.96,21578006,16740798.85,46.96083816294845,43.66777809832148,NaN,NaN,-45.859607538022715,7.552402619252172,0.3091430328103437,-0.6124066910711434,-0.9215497238814871,1018987513,1004525122.8,43.520234678848304,20.510855506278215,NaN,NaN,-8.22606567397422,-13.364772793941027
2018-12-07T09:30:00-05:00,66.64,66.945,64.3,64.6,19937805,16921949.1,40.370981671020424,43.324451988367514,NaN,NaN,-80.50922355988986,-6.931896341696799,0.1197503136465714,-0.7718618318232728,-0.8916121454698442,999049708,1007203247.6,45.365060990994145,22.80740878822451,NaN,NaN,-10.032963313284416,-12.888800010990083
2018-12-10T09:30:00-05:00,64.24,65.74,63.87,65.49,20447973,17423860.3,43.58604374133725,43.2361107178674,NaN,NaN,-82.16677377593052,-25.055578967786357,0.05969149563625942,-0.8169977759245199,-0.8766892715607794,1019497681,1010668999.2,47.74382585813525,25.30042724869464,NaN,NaN,-10.4654174994214,-12.542602509337414
2018-12-11T09:30:00-05:00,66.51,66.6362,65.04,65.57,15813349,17567431.2,43.87895905937476,43.701995350739935,NaN,NaN,-40.60060313599269,-49.00085035914066,0.032016687052260795,-0.8366684127454533,-0.8686850997977141,1035311030,1014051087.8,50.0302684464037,27.989786794800487,NaN,NaN,-10.71798160263661,-12.281942379808727
2018-12-12T09:30:00-05:00,66.63,67.12,66.05,66.08,16928906,17592323.55,45.810635816186654,44.54242395873377,NaN,NaN,-1.2541488897262651,-50.07807137991241,0.05345893032608573,-0.8018614368901069,-0.8553203672161926,1052239936,1025017173.6,56.65294612153598,31.27052781536468,NaN,NaN,-10.360514193418657,-12.00745263889586
2018-12-13T09:30:00-05:00,66.4,66.89,65.81,66.19,12819551,17448124.2,46.24044097750911,45.26824329473432,NaN,NaN,-4.068083392728088,-41.71976655085349,0.07891384308201044,-0.7566780633636796,-0.83559190644569,1065059487,1034231568.4,61.294841161115855,34.92298614480811,NaN,NaN,-9.948644564470346,-11.713337199692214
2018-12-14T09:30:00-05:00,65.4,65.76,64.51,64.57,15516205,17249097.7,41.073576138820194,45.72815712065695,NaN,NaN,-76.434721695835,-40.90486617804252,-0.005034988273470042,-0.8418856417875276,-0.8368506535140575,1049543282,1044330283.2,65.63793275551154,38.972603334358595,NaN,NaN,-11.094629682629623,-11.624950411540416
2018-12-17T09:30:00-05:00,64.33,64.77,62.69,63.2,23263471,17097199,37.27982186067531,45.46983235820854,NaN,NaN,-138.07192503616648,-52.085896430089704,-0.13718933876558992,-1.008337326971045,-0.871147988205455,1026279811,1045686709.2,66.18675495271123,43.09542383748428,NaN,NaN,-13.250443355975955,-11.857163689316922
2018-12-18T09:30:00-05:00,63.69,64.25,63.19,63.7,19626573,17179876.6,39.476980370833154,45.32975867272163,NaN,NaN,-117.76040669486885,-67.51785714186494,-0.17297851173630852,-1.0873711278758407,-0.9143926161395322,1045906384,1047805780,67.0715798294643,47.168848499808156,NaN,NaN,-14.394945623530628,-12.219703965633165
2018-12-19T09:30:00-05:00,63.61,64.74,61.76,62.44,33606339,17900262.6,36.049762322764245,44.32306660150848,NaN,NaN,-138.53699793605227,-94.97442695113014,-0.25841656605528374,-1.2374133237086369,-0.9789967576533531,1012300045,1039817801.8,60.63078116839529,50.02511180241364,NaN,NaN,-16.424565866558975,-12.820398522908281
2018-12-20T09:30:00-05:00,62.17,62.8,60.43,61.32,39501833,18472116.1,33.283702297892134,43.276108605095295,NaN,NaN,-189.30978801561122,-132.02276787570676,-0.36097131679678873,-1.4302109036493391,-1.0692395868525504,972798212,1021365546.8,48.93958973562121,51.766105458354964,NaN,NaN,-19.011479447900435,-13.704838655050017
2018-12-21T09:30:00-05:00,61.07,61.82,58.94,59.2,41655117,19729707.75,28.781946991504896,41.744524018332434,NaN,NaN,-215.76179297043655,-159.8881821306271,-0.5318733289225432,-1.7340812480057295,-1.2022079190831862,931143095,997685509.4,38.6418644776906,52.24662094632605,NaN,NaN,-22.808946448122057,-15.005425482631736
2018-12-24T09:30:00-05:00,58.64,59.36,57.57,57.62,21117015,20518652.8,25.96344419991142,39.65728773793559,NaN,NaN,-226.64713609915893,-177.60322434322558,-0.700981329134589,-2.0784345805014226,-1.3774532513668336,910026080,974434763.2,31.60901749715606,51.727452599421824,NaN,NaN,-26.990241886376033,-16.717542111738066
2018-12-26T09:30:00-05:00,58.02,61.1,57.69,61.1,29060164,21344929.55,39.91887367511366,39.191143377563684,NaN,NaN,-137.01392973096424,-181.45392895044466,-0.5355848994656387,-2.046934375698882,-1.5113494762332433,939086244,953070735.2,26.78512426392858,50.722130138393766,NaN,NaN,-25.819074763592575,-18.017761062002997
2018-12-27T09:30:00-05:00,60.25,61.56,59.0838,61.54,23438844,21938442.9,41.42231782173151,38.79553478176248,NaN,NaN,-99.15897765858789,-173.57832489495178,-0.3619829194050046,-1.9638281254894991,-1.6018452060844945,962525088,943115743.8,24.879771021919566,49.39066844861314,NaN,NaN,-24.406274669163906,-18.930405863025985
2018-12-28T09:30:00-05:00,61.99,62.4218,60.87,61.4,19843317,22100123.45,41.07016134156995,38.845476186801726,NaN,NaN,-68.61673254117488,-149.4397138000645,-0.2285275747045401,-1.8875046744651698,-1.6589770997606297,942681771,937092455.6,23.77765262074483,47.84871070788104,NaN,NaN,-23.41620346338595,-19.571234091648837
2018-12-31T09:30:00-05:00,61.93,62.21,61.46,61.98,16860072,22237356.15,43.2237016427988,38.8195946083347,NaN,NaN,-54.06399268776132,-117.10015374352948,-0.08076173445411738,-1.7599292678282765,-1.6791675333741591,959541843,942772205.2,27.058867019519994,46.37121364797996,NaN,NaN,-21.949174647827398,-19.910939885388633
2019-01-02T09:30:00-05:00,60.71,62.39,60.63,62.02,15476054,22185666.9,43.377384123379436,38.78376782719217,NaN,NaN,-53.57002710206126,-82.48473194410994,0.03395005151695929,-1.63672996897796,-1.6706800204949193,975017897,955770568.6,34.05529528256474,45.23014413627717,NaN,NaN,-20.72565977202749,-20.027328440622757
2019-01-03T09:30:00-05:00,60.44,60.48,58.81,58.89,24946730,22621420.2,35.320710840959194,38.03448747181879,NaN,NaN,-106.30465719575436,-76.34287743706797,-0.08044855808045193,-1.7712407180954841,-1.6907921600150322,950071167,957967553.2,35.18688706011666,43.696854203318644,NaN,NaN,-22.140039387577527,-20.329144290187724
2019-01-04T09:30:00-05:00,59.97,61.7579,59.78,61.5,20767979,22610265.15,44.56652849764362,37.91492229468554,NaN,NaN,-53.99020758447498,-67.30912342224538,0.034044587985923025,-1.6482364250326285,-1.6822810130185515,970839146,959630364.8,36.08089475803885,41.895858031670286,NaN,NaN,-20.226809798898135,-20.314525077146353
2019-01-07T09:30:00-05:00,61.5,62.47,61.36,62.05,11923749,22127552.3,46.30831136507534,38.28883195370376,NaN,NaN,-20.414290374680334,-57.66863498894645,0.15445875025749145,-1.4892075751966871,-1.6436663254541786,982762895,967646589.6,40.352417743649895,40.089749816537314,NaN,NaN,-18.146961385177356,-20.004873121150784
2019-01-08T09:30:00-05:00,62.65,62.87,61.83,62.57,13002603,21780792.2,47.972788466612045,39.05261528269924,NaN,NaN,-0.9017277888822482,-47.036182009170645,0.2700052087659244,-1.3061598144967732,-1.5761650232626976,995765498,974891320.6,43.99505162061191,38.50462814995878,NaN,NaN,-15.953867142872555,-19.426157981396752
2019-01-09T09:30:00-05:00,62.91,63.71,62.84,63.38,14022385,21459512.8,50.54466585960793,39.84316424618315,NaN,NaN,34.83856027006711,-29.354464534744967,0.3943352745921469,-1.083245930022514,-1.4775812046146608,1009787883,981845317.8,47.32057952587201,37.09384241398792,NaN,NaN,-13.348217717150519,-18.557880800790148
2019-01-10T09:30:00-05:00,62.88,63.69,62.59,63.66,10934086,21215549.65,51.4383233093614,40.94234717379722,NaN,NaN,42.588830731301734,0.42423305066625544,0.48293101614211964,-0.8739174344370113,-1.356848450579131,1020721969,995975478.2,53.37842757936166,36.575817157628364,NaN,NaN,-10.966118979447655,-17.47334339774122
2019-01-11T09:30:00-05:00,63.29,63.575,63.15,63.54,7725602,20755384.45,51.0128761310269,42.20871673330685,NaN,NaN,58.59207311354315,22.940689190269886,0.5178570773553148,-0.7095271038849873,-1.2273841812403021,1012996367,1004406922.4,56.58648339090382,37.122023847291416,NaN,NaN,-9.131367477366158,-16.281632551973356
2019-01-14T09:30:00-05:00,62.98,63.17,62.73,62.95,7242062,20476510,48.87255312269761,43.64376002839204,NaN,NaN,51.30478089724765,37.284503444655485,0.4861385378212266,-0.619711008963769,-1.1058495467849956,1005754305,1009005204.4,58.27285015649885,38.52423711006343,NaN,NaN,-8.146451317909339,-15.119463804249925
2019-01-15T09:30:00-05:00,63.15,64.03,63.04,63.9,14326996,20417049.55,52.340000066913454,45.52779973317791,NaN,NaN,94.26565154585842,56.31797931160362,0.511482386129774,-0.46649656412277807,-0.9779789502525521,1020081301,1013868365,60.040728297432906,40.55507359579749,NaN,NaN,-6.319853427696591,-13.86237660759945
2019-01-16T09:30:00-05:00,63.97,64.35,63.84,63.96,9468643,19727308.15,52.558838381486524,46.43065435506168,NaN,NaN,111.62284234196261,71.67483572598272,0.5132997746309198,-0.33635423196390235,-0.8496540065948222,1029549944,1017820777.2,61.469511774713766,43.03252984656786,NaN,NaN,-4.747407949721993,-12.56023822790267
2019-01-17T09:30:00-05:00,63.73,64.74,63.56,64.37,10128415,19252400.25,54.10947363267243,47.33687977012888,NaN,NaN,116.9374185164339,86.54455328300915,0.5214422317196554,-0.19785121694525287,-0.7192934486649083,1039678359,1021612055.2,62.84200195419077,45.744117770301514,NaN,NaN,-2.9891999158904343,-11.192947040472351
2019-01-18T09:30:00-05:00,65.01,65.48,64.59,65.35,13652250,18254695.8,57.670872055328125,48.52264482111161,NaN,NaN,145.27913484687537,103.88196562967559,0.5683098742598489,-0.008906105840097212,-0.5772159800999461,1053330609,1029678903.6,65.6460434935405,48.73471711835835,NaN,NaN,-0.4501800725500748,-9.658266045054884
2019-01-22T09:30:00-05:00,64.82,64.93,63.74,64.25,14992512,17029229.75,52.724765454929745,49.201292236263825,NaN,NaN,94.13737911298537,112.44848527282315,0.5029567996409947,0.05148001945129721,-0.45147678018969745,1038338097,1036195662,67.7624842274119,51.642118347493486,NaN,NaN,0.4518727289745615,-8.21396050590782
2019-01-23T09:30:00-05:00,64.52,64.995,63.75,64.47,9576120,15425279.9,53.58221009755881,49.930208377276635,NaN,NaN,89.84571915495836,111.56449879464313,0.45378484570100863,0.11575427693656337,-0.33803056876444526,1047914217,1041762245.2,69.49147369389286,54.17327394830264,NaN,NaN,1.4383659120649426,-6.8350567319117115
2019-01-24T09:30:00-05:00,64.7,65.24,64.67,65.01,14170898,15077974.05,55.705820400211124,51.386287631508914,NaN,NaN,108.54016994479048,110.94796431520872,0.43671996476753644,0.20786938719497527,-0.22885057757256116,1062085115,1048269279.4,71.42102568950355,56.761426707544565,NaN,NaN,2.861475261795136,-5.4498378756678765
2019-01-25T09:30:00-05:00,65.5,66.125,65.26,65.93,10030815,14126506.6,59.13594995505351,52.42696059275248,NaN,NaN,136.66181801846443,114.89284421561482,0.46392908354572693,0.35106077685959747,-0.11286830668612945,1072115930,1054756793.6,73.23833284486417,59.41552942803208,NaN,NaN,5.07388068020911,-3.946449510542593
2019-01-28T09:30:00-05:00,64.95,65.07,64.51,65.05,9662469,13437687.85,54.76713721926842,53.03116243948055,NaN,NaN,86.10679231973253,103.05837571018624,0.40153275754959017,0.38904764025085825,-0.012485117298731904,1062453461,1056581364,73.7440142835371,61.800643466595446,NaN,NaN,5.798125160059837,-2.554367414742246
2019-01-29T09:30:00-05:00,65.18,65.19,64.25,64.35,8573987,12874221.35,51.50740748304571,53.28363522636867,NaN,NaN,66.19485719508708,97.4698713266066,0.2968163983395993,0.3585353806257672,0.061718982286167914,1053879474,1059689639.4,74.62371596933016,63.98840520578961,NaN,NaN,5.502473719026644,-1.403390109918119
2019-01-30T09:30:00-05:00,65.42,66.54,65.13,66.35,16995525,12880994,59.01357470447907,53.88855728671661,NaN,NaN,127.74653617692317,105.05003473099956,0.34269525446791105,0.49008805037105674,0.1473927959031457,1070874999,1064281795.8,75.90800205469569,66.03036395784844,NaN,NaN,7.529767227448815,-0.12722477600855697
2019-01-31T09:30:00-05:00,66.01,66.64,65.8,66.28,18250916,13019737.1,58.67126358906369,54.40519587812391,NaN,NaN,127.2714690916467,108.7962945603708,0.3476755926990552,0.5819872867769647,0.23431169407790947,1052624083,1062389589.4,74.24070734857375,67.52052679850645,NaN,NaN,9.05862556254607,1.1850395580706754
2019-02-01T09:30:00-05:00,66.31,67.03,66.21,66.67,9737796,12259290.4,60.06126312425681,55.051509234783204,NaN,NaN,144.92468247536695,110.44886745175131,0.3553241570413265,0.6784668903795676,0.3231427333382411,1062361879,1060438779.2,72.47331038826256,68.65530015546065,NaN,NaN,10.733776444081379,2.5491448275007755
2019-02-04T09:30:00-05:00,66.76,67.75,66.71,67.74,7604287,11601105.8,63.67133478685212,56.10856506793709,NaN,NaN,172.18217280197143,127.66394354819909,0.40683031920389356,0.8316806323431081,0.4248503131392145,1069966166,1061941320.2,73.00633811866373,69.70769215275814,NaN,NaN,13.275020588237805,4.081412793320351
2019-02-05T09:30:00-05:00,67.97,68.48,67.89,68.31,12060664,11607951.55,65.46231380559209,57.04587319212843,NaN,NaN,188.93333425130677,152.21163895944304,0.45028945538725984,0.9877121323732894,0.5374226769860295,1082026830,1067570791.4,74.96253317930471,70.77353535860613,NaN,NaN,15.94770060335443,5.7765967661823625
2019-02-06T09:30:00-05:00,68.39,68.73,68.125,68.54,10189649,11467303.85,66.18669365333955,58.019291425832215,NaN,NaN,171.34059446253718,160.93045061656582,0.46370236540111287,1.1170506337374206,0.6533482683363078,1092216479,1071839087.4,76.36130070673451,71.83723456803617,NaN,NaN,18.370694412587547,7.575753572811674
2019-02-07T09:30:00-05:00,67.91,68.2,67.14,67.6,14632128,11497791,60.59321697286198,58.482415950131475,NaN,NaN,112.05101092633183,157.88635898350284,0.38185621788256396,1.1306685406895127,0.7488123228069488,1077584351,1076831141,77.91531750265419,72.913899964355,NaN,NaN,18.908673164461547,9.194742085904513
2019-02-08T09:30:00-05:00,66.99,67.99,66.95,67.99,8480796,11375126.5,62.02707653233543,58.79357341277485,NaN,NaN,98.78247038046075,148.6579165645216,0.32860121418996724,1.1595638405444078,0.8309626263544405,1086065147,1081571794.6,79.306576975482,73.88965235592225,NaN,NaN,19.762452097847078,10.70441494475345
2019-02-11T09:30:00-05:00,68.2,68.41,67.8,67.96,7434660,11360579.4,61.84067426929028,59.444709756657744,NaN,NaN,105.73904355678182,135.3692907154837,0.2685059333985189,1.166595043102589,0.8980891097040702,1078630487,1083304658.8,79.8073278977654,74.74999833237607,NaN,NaN,20.417412474685428,12.091986020458018
2019-02-12T09:30:00-05:00,68.43,68.9472,68.33,68.86,9709099,11483931.25,65.21769810927717,60.27581604320907,NaN,NaN,121.80945276171133,121.94451441756459,0.26601204137655565,1.2306041614247647,0.964592120048209,1088339586,1084567210,80.18358411334731,75.51372050519423,NaN,NaN,21.93938857539448,13.498757814020369
2019-02-13T09:30:00-05:00,69.2,69.45,68.91,68.95,9120886,11223625.75,65.5460631928428,60.978690528397046,NaN,NaN,123.73544395721572,112.42348431650029,0.2474537149084315,1.2739092636837483,1.0264555487753169,1097460472,1085616008.6,80.50849410489205,76.16282539200769,NaN,NaN,23.29492872810624,14.898210801746922
2019-02-14T09:30:00-05:00,68.69,69.315,68.64,69.07,9742013,11237294.25,66.00686407431053,61.46947010834397,NaN,NaN,107.00285032916887,111.41385219706771,0.22114990313240268,1.30289292769082,1.0817430245584174,1107202485,1091539635.4,82.2760706964063,76.80837809568928,NaN,NaN,24.56012359973827,16.278484058602828
2019-02-15T09:30:00-05:00,69.59,69.69,69.23,69.62,7356002,11098673.6,68.11194413379954,62.42267060223906,NaN,NaN,115.79803433000916,114.81696498697738,0.21830781057699622,1.3546277877796626,1.1363199772026664,1114558487,1097238303.4,83.7982477949588,77.5265376322194,NaN,NaN,26.23587878727272,17.700969019841384
2019-02-19T09:30:00-05:00,69.34,69.85,69.27,69.64,8319114,10832016.8,68.18908872578521,63.61421926243474,NaN,NaN,107.23342448041333,115.11584117170369,0.19599912680533382,1.3813188857093337,1.1853197589039999,1122877601,1106087726.2,85.83299103999734,78.32720013726706,NaN,NaN,27.666310622213565,19.124589248751697
2019-02-20T09:30:00-05:00,69.7,70.005,69.35,69.72,9852085,10574995.45,68.51718079628516,64.29304826899231,NaN,NaN,104.23285136467503,111.60052089229643,0.1660409570290433,1.392870955190304,1.2268299981612607,1132729686,1114965746.2,87.52558804926048,79.1570277083074,NaN,NaN,28.972121227715775,20.53137953146085
2019-02-21T09:30:00-05:00,69.55,70.025,69.32,69.75,9754061,10583892.5,68.64776902314188,65.0056557999979,NaN,NaN,98.57846042638577,106.56912418613044,0.1292893702648399,1.3884417109923106,1.2591523407274707,1142483747,1123970401.2,88.96558143395997,80.20880442869212,NaN,NaN,30.124470122491037,21.901821044465162
2019-02-22T09:30:00-05:00,70.07,70.68,70.05,70.64,12246686,10487681.9,72.31641776450209,65.88102398858685,NaN,NaN,123.46919745951159,109.86239361219899,0.14479489450608063,1.4401459588600716,1.295351064353991,1154730433,1133475990.8,90.24565568478783,81.47825766415822,NaN,NaN,32.16701762720354,23.368277699142073
2019-02-25T09:30:00-05:00,71.17,71.47,70.93,70.98,20170501,10994666.2,73.58791092611602,66.58935085567713,NaN,NaN,141.38523552261114,114.97983385071939,0.15681160638137315,1.4913655723307073,1.3345539659493342,1174900934,1145544480.2,91.58103049848792,82.80502140557424,NaN,NaN,34.28836922442736,24.92829077418283
2019-02-26T09:30:00-05:00,70.73,71.33,70.67,71.13,14133959,11218240.7,74.15195935678915,67.21003982361978,NaN,NaN,128.09835728011933,119.1528204106606,0.15352890086601745,1.5264650920318559,1.3729361911658384,1189034893,1158775938.6,92.75250423214501,84.07573362363426,NaN,NaN,36.25391884308718,26.546237641169167
2019-02-27T09:30:00-05:00,70.86,71.15,70.33,71.06,9777532,11278417.95,73.36456651530105,67.7227450280456,NaN,NaN,111.34906224652516,120.5760625870306,0.126439092316033,1.5309850565608798,1.4045459642448468,1179257361,1168081473.6,93.44348360836892,85.29588954517956,NaN,NaN,37.740463035285664,28.145412697471524
2019-02-28T09:30:00-05:00,70.8,71.13,70.68,70.86,9438331,10900558.25,71.0433849343093,68.46918559672041,NaN,NaN,105.29153486983348,121.91867747572014,0.07726306876846789,1.5011248002054316,1.4238617314369637,1169819030,1173548530.2,93.81648418009175,86.43168716499655,NaN,NaN,38.46700204065272,29.619925460783126
2019-03-01T09:30:00-05:00,71.42,71.53,70.77,71.34,12334027,10604713.8,73.23230387113816,69.26955897806346,NaN,NaN,113.09165482061942,119.84316894794172,0.0600416351889701,1.4989137754231763,1.4388721402342062,1182153057,1179033055,94.17452908838979,87.49368374448996,NaN,NaN,39.68124299885791,31.057256537650954
2019-03-04T09:30:00-05:00,71.64,71.815,70.28,71.07,15826472,10909147.6,70.0256912307658,69.85420304674028,NaN,NaN,96.4558669484457,110.85729523310863,0.01575140064848335,1.4585613910448103,1.442809990396327,1166326585,1177318185.2,92.37347751013323,88.39126585965907,NaN,NaN,39.91739503576137,32.32299060880958
2019-03-05T09:30:00-05:00,71.03,71.12,70.64,70.86,8953880,10976627.25,67.5482788449393,70.02067309928758,NaN,NaN,78.3762063851466,100.91286505411409,-0.03939010744300031,1.3935723560925766,1.4329624635355769,1157372705,1170985747.6,85.8447173016684,88.79563251596771,NaN,NaN,39.482106011583575,33.34572138063444
2019-03-06T09:30:00-05:00,70.81,70.89,70.4,70.49,13122115,11029699.8,63.29909507379023,69.8601753764981,NaN,NaN,54.13546258909624,89.47014512262831,-0.10856342278911124,1.2972581850491878,1.405821607838299,1144250590,1163984393.4,79.18123130914687,88.70082803055735,NaN,NaN,37.966956343751505,34.005897803936875
2019-03-07T09:30:00-05:00,70.29,70.35,69.59,69.82,18498286,11445131.65,56.38248629415588,69.17271982077277,NaN,NaN,5.926813700502295,69.59720088876207,-0.20180328473188114,1.1535675019234475,1.3553707866553286,1125752304,1155171048.2,71.64244036563431,87.94128300693079,NaN,NaN,34.60741632055475,34.09182902059657
2019-03-08T09:30:00-05:00,68.98,69.87,68.84,69.81,12890714,11358060.95,56.283633779979354,68.32784050978562,NaN,NaN,-32.000799981931515,40.57870992825186,-0.2626601955741539,1.0270455421876363,1.2897057377617902,1112861590,1141312754.8,61.695557643616176,86.36251942469202,NaN,NaN,31.78839983857041,33.76276770887855
2019-03-11T09:30:00-04:00,70.06,71.375,70.06,71.31,14577194,11662880.85,65.93221291633051,68.16663509482457,NaN,NaN,67.79038997309732,34.845614533182186,-0.20306655211994462,1.0358725476118593,1.238939099731804,1127438784,1133535194.6,56.91923156973343,84.29725089110174,NaN,NaN,31.88385280167814,33.49435129356421
2019-03-12T09:30:00-04:00,71.51,71.975,71.29,71.73,18050877,12193691.7,68.05802002752904,68.13383789705628,NaN,NaN,120.73044380953658,43.31646201806018,-0.13956107918606508,1.0644877507492225,1.2040488299352876,1145489661,1131158585.8,55.50515668221471,82.01007722202704,NaN,NaN,32.6251429074252,33.37017866697292
2019-03-13T09:30:00-04:00,72.04,72.625,72,72.2,17833630,12599918.25,70.29203502975884,68.25128546895749,NaN,NaN,160.92333906196976,64.67403731263487,-0.07342383802742836,1.1122690324010023,1.1856928704284306,1163323291,1134973126,57.33718453737706,79.75090601512827,NaN,NaN,33.94811115067727,33.45274045035926
2019-03-14T09:30:00-04:00,72.32,72.57,72.1452,72.35,10656663,12676707.1,70.9893983055961,68.15649836474992,NaN,NaN,154.3505728987033,94.35878915227508,-0.029358383642151598,1.1489948908757412,1.1783532745178928,1173979954,1144618656,61.63836872793802,77.70752837535328,NaN,NaN,35.23442231024101,33.707266430342365
2019-03-15T09:30:00-04:00,72.37,73.32,72.32,72.99,21024520,13240832.45,73.81383278782101,68.17263564058598,NaN,NaN,184.78035936005816,137.71502102067302,0.02990048742713869,1.215728883801816,1.1858283963746774,1195004474,1161047232.8,67.62528298998288,75.99640355331717,NaN,NaN,37.23475858498426,34.21119388100549
2019-03-18T09:30:00-04:00,73.04,73.49,72.845,73.3,14837637,13614914.2,75.07944007785913,68.23888426351957,NaN,NaN,187.20480615706404,161.59790425746635,0.07444787146755272,1.2788882357091182,1.2044403642415655,1209842111,1177527898.2,72.29622436615506,74.53524070574646,NaN,NaN,39.287636811029856,34.93640001386611
2019-03-19T09:30:00-04:00,73.6,73.8,73.16,73.45,16153202,14006618.6,75.69164504503618,68.40510415850063,NaN,NaN,173.6119787503149,172.17421124562202,0.09705862499551854,1.3257636454859636,1.228705020490445,1225995313,1193629028.6,75.94735656036433,73.28551734517471,NaN,NaN,41.15670152969413,35.82501451612726
2019-03-20T09:30:00-04:00,73.37,73.85,72.81,73.25,13704293,14199229,73.1126242414803,68.5529069661557,NaN,NaN,134.5751079992676,166.9045650330816,0.08217723186351655,1.3314265603198407,1.2492493284563242,1212291020,1203422574.4,77.85878612040496,72.14568176948278,NaN,NaN,41.99151886734857,36.70594370915887
2019-03-21T09:30:00-04:00,73.26,75.25,73.245,75.09,27274148,15075233.35,79.89852306290922,69.02906547985364,NaN,NaN,179.79198353982386,171.9928471613057,0.17457733042080426,1.4674709914823296,1.2928936610615254,1239565168,1216539617.2,80.13571319907643,71.14290920596041,NaN,NaN,45.183166147442115,37.91697548605648
2019-03-22T09:30:00-04:00,74.7,75.01,73.285,73.32,26747361,15800267.1,63.33832084310443,68.55139616644927,NaN,NaN,119.60237286612865,158.95724986251977,0.09859596029962292,1.416138611436054,1.317542651136431,1212817807,1220102283.8,80.71577441432382,70.31021612768832,NaN,NaN,41.71793835700361,38.45997018190607
2019-03-25T09:30:00-04:00,73.08,73.49,72.53,73,21946894,15889086.75,60.88149926142509,68.07519762476967,NaN,NaN,62.78179447921961,134.0726475269509,0.013370309075086073,1.3342555374802885,1.3208852284052024,1190870913,1216308044.2,78.10008245678847,69.75702792448261,NaN,NaN,38.185944560942545,38.420823664625566
2019-03-26T09:30:00-04:00,73.64,74.11,72.975,73.4,13965286,15880653.1,62.82273894272932,68.04117218683675,NaN,NaN,80.34834789836991,115.41992135656191,-0.027263564677832308,1.286805772557912,1.3140693372357444,1204836199,1212076221.4,75.17402150773208,69.470798652953,NaN,NaN,36.069018724399704,38.08485153030759
2019-03-27T09:30:00-04:00,73.51,73.79,72.34,72.98,15831176,16183335.3,59.484810490672,68.26276677230219,NaN,NaN,50.61653628219558,98.62820701314752,-0.09008642654315024,1.2014613040568065,1.2915477305999568,1189005023,1207419022,71.97797181749321,69.49476518522863,NaN,NaN,33.24656842944565,37.39366823018445
2019-03-28T09:30:00-04:00,73.2,73.58,72.83,73.28,10539704,16238403.95,61.075691544460305,68.60505661262226,NaN,NaN,56.01747747367911,73.87330579991857,-0.11736959491890797,1.1448357369513218,1.2622053318702298,1199544727,1199414933.8,66.72723126037633,69.85417044356863,NaN,NaN,31.483940306964776,36.549421384010216
2019-03-29T09:30:00-04:00,73.89,74.03,73.53,74,14347178,16339061.5,64.66207561808116,68.51433251989013,NaN,NaN,83.30984096964636,66.61479942062212,-0.09387601531247691,1.1448603127296337,1.2387363280421106,1213891905,1199629753.4,66.79723832761056,70.55974235484557,NaN,NaN,31.139031854087463,35.77650859402125
2019-04-01T09:30:00-04:00,74.72,75.1,74.3,75.01,12590504,16177263.1,68.97979240726964,68.58017340415732,NaN,NaN,123.57865684368161,78.77417189351452,-0.021067041108985496,1.2124025266558789,1.2334695677648644,1226482409,1206752052.6,69.11729835896175,71.53203818889894,NaN,NaN,32.29466696861907,35.279102647535225
2019-04-02T09:30:00-04:00,75.07,75.37,74.84,75.27,11787177,16318927.95,69.99610523320462,68.55903556154631,NaN,NaN,133.15654119386934,89.3358105526144,0.031019868475987922,1.2722444033598492,1.2412245348838613,1238269586,1213438730,71.15513061188258,72.5190343370779,NaN,NaN,33.54257505859924,35.03102727768723
2019-04-03T09:30:00-04:00,75.72,76.26,75.58,75.88,13869223,16356283.35,72.28993615738011,68.65193112238804,NaN,NaN,165.41613717781357,112.29573073173802,0.08965358932244483,1.3532915215369172,1.2636379322144724,1252138809,1226065487.2,74.56786236217457,73.44256959666622,NaN,NaN,35.329728936632556,35.07369894325085
2019-04-04T09:30:00-04:00,75.85,76.05,75.11,75.56,11503077,16006522.9,69.2969631566637,68.32929757730537,NaN,NaN,138.35944266253148,128.76412376950847,0.0897622820848536,1.3758407848205394,1.2860785027356858,1240635732,1234283688.2,76.5154020579279,74.07757810151944,NaN,NaN,35.861058775680476,35.18617891931222
2019-04-05T09:30:00-04:00,75.81,76,75.6843,75.92,6709785,15697476.45,70.76348252753851,68.0210148951396,NaN,NaN,141.33695919853562,140.36954741528635,0.09637434820626112,1.4065464379935122,1.310172089787251,1247345517,1240974410.6,77.99296478531267,74.48448813145926,NaN,NaN,36.746723826534605,35.40911390605827
2019-04-08T09:30:00-04:00,75.74,76.25,75.42,76.21,7309911,15334112.3,71.92674938107996,67.75209377628559,NaN,NaN,130.1561841996203,141.68505288647407,0.10202909422447992,1.437708457567851,1.335679363343371,1254655428,1246609014.4,79.18091823889318,74.71545682278277,NaN,NaN,37.82628220700771,35.754423663336766
2019-04-09T09:30:00-04:00,75.88,76.155,75.68,75.85,13440126,15103574.75,68.29407932409066,67.40791199647205,NaN,NaN,109.53072158297431,136.9598889642951,0.06507335299251293,1.417021054584012,1.3519477015914991,1241215302,1247198157.6,79.3066977366965,74.8188790810893,NaN,NaN,37.67910348325738,36.02937792332543
2019-04-10T09:30:00-04:00,75.92,76.4,75.88,76.38,8617805,14642783.5,70.64468769296553,66.74692375576178,NaN,NaN,113.5411031423623,126.58488215720482,0.05999687033955725,1.4269437895159456,1.3669469191763883,1249833107,1246737017.2,78.9048615592951,74.73096110681921,NaN,NaN,38.24197450474533,36.345463149242555
2019-04-11T09:30:00-04:00,76.54,76.56,76.12,76.28,7697338,14494817.25,69.59626917729477,67.1939200653468,NaN,NaN,107.25701845249816,120.36439731519815,0.03482593376045062,1.4104793363769517,1.375653402616501,1242135769,1247037024.6,78.97948341253745,74.60694032097732,NaN,NaN,38.40809063378095,36.640124218462326
2019-04-12T09:30:00-04:00,76.71,76.81,76.28,76.81,8555372,13871359.85,71.97054101362815,67.98599447621845,NaN,NaN,112.34464725599496,114.56593492669003,0.03850543770072834,1.4237851997424116,1.3852797620416832,1250691141,1247706149.4,79.15658092213306,74.68240449707335,NaN,NaN,39.23504788120512,37.010827598854156
2019-04-15T09:30:00-04:00,76.81,77,76.37,76.78,9910693,13625012.65,71.62956334718189,68.61505336225078,NaN,NaN,105.63593243363093,109.66188457349217,0.024249299736715413,1.4155913867125776,1.3913420869758621,1240780448,1244931153.4,76.28610168430401,74.76183879539992,NaN,NaN,39.82039190097984,37.412193927729255
2019-04-16T09:30:00-04:00,77.02,77.25,76.8,77.17,9609547,13297829.9,73.39427708430232,69.60858669036723,NaN,NaN,113.20205796830555,110.39615185055841,0.0262469289516436,1.4241507481654168,1.3979038192137732,1250389995,1246766092,76.88305675852611,75.1122020054737,NaN,NaN,40.819136448818796,37.89890000217062
2019-04-17T09:30:00-04:00,77.66,77.7,77.22,77.6,12247872,13225008.85,75.22416731159167,70.61919210230519,NaN,NaN,125.16084243984415,112.72009971005477,0.04082027001456412,1.4489291567319782,1.408108886717414,1262637867,1249327044,77.72581891582902,75.89781540943461,NaN,NaN,42.208147963253836,38.514506853753936
2019-04-18T09:30:00-04:00,77.77,77.84,77.24,77.82,11491949,12435898.9,76.12878165134956,71.43824253325293,NaN,NaN,118.33631478508336,114.93595897657181,0.04901711795781738,1.4693802841646857,1.4203631662068683,1274129816,1255725853.4,79.71565802389347,76.82055967345481,NaN,NaN,43.63823484448125,39.24646799528641
2019-04-22T09:30:00-04:00,77.46,78.03,77.39,78,8084368,11502749.25,76.87281514713314,72.00202987181461,NaN,NaN,118.29610138278898,116.12624980193061,0.050123184753340766,1.4830171471485443,1.4328939623952035,1282214184,1262030462,81.47192359749212,77.70303290477841,NaN,NaN,45.055804775541105,40.07637324960851
2019-04-23T09:30:00-04:00,78.12,78.9499,78.04,78.85,16693005,11240054.8,80.03708154287546,72.71924246536253,NaN,NaN,153.88859816112523,125.77678294742948,0.0893704993285227,1.5446070865558568,1.455236587227334,1298907189,1273655810.2,84.19017088494108,78.63410720999687,NaN,NaN,47.316074200419024,41.110616242581436
2019-04-24T09:30:00-04:00,78.91,79.24,78.76,78.88,10938268,11088703.9,80.14035974215251,73.279987007132,NaN,NaN,155.47541049851094,134.23145345347055,0.09793242223384935,1.5776521150196459,1.4797196927857965,1309845457,1285546902.6,86.38968727296347,79.47852327505322,NaN,NaN,49.19183058780215,42.26507543475582
2019-04-25T09:30:00-04:00,79.24,79.46,78.44,78.86,11387585,10866524.35,79.84379520275226,74.03333215328118,NaN,NaN,138.5389693996108,136.90707884542388,0.08339841497787259,1.5839677115081372,1.5005692965302646,1298457872,1292710903.6,87.51650765278144,80.26431653182848,NaN,NaN,50.667652791867035,43.465443628628854
2019-04-26T09:30:00-04:00,78.38,78.58,77.725,78.56,11050219,10892050.1,75.340089463671,74.36023264871922,NaN,NaN,94.15693357509402,132.071202603426,0.03709119508955139,1.5469332903922037,1.5098420953026523,1287407653,1295366471,87.91588890321897,80.97309682596465,NaN,NaN,50.753601436883855,44.50660902980814
2019-04-29T09:30:00-04:00,78.57,78.8299,78.49,78.58,10613331,10705357.75,75.43955177510276,74.61114710543511,NaN,NaN,102.49892613664474,128.91176755419716,-0.006366243856456677,1.5018842904820815,1.5082505343385382,1298020984,1298527831,88.3920020824685,81.63103138622002,NaN,NaN,50.851001802292316,45.41295085444874
2019-04-30T09:30:00-04:00,78.54,78.82,78.1035,78.71,18842869,11017976,76.11393944303306,75.16970854250243,NaN,NaN,87.62577571158907,115.65920306428993,-0.03872493158024359,1.4598443698632337,1.4985693014434773,1316863853,1302119163.8,88.92579690763267,82.31810989842974,NaN,NaN,51.104652612521875,46.226051105602046
2019-05-01T09:30:00-04:00,79.5,79.7,78.5,78.51,15446826,11200958.45,72.80195928814084,75.32379937072925,NaN,NaN,98.84889648693033,104.33390026197381,-0.08340240828329915,1.3943162910893534,1.4777186993726525,1301417027,1300433477.8,86.90570542210244,82.88959874577313,NaN,NaN,50.480474342925916,46.83382585379117
2019-05-02T09:30:00-04:00,78.49,79.055,77.68,78.1,24988752,11756934.9,66.42124790622023,75.09701213708105,NaN,NaN,54.68150022001713,87.56240642605506,-0.14667061455182373,1.2943804311828728,1.4410510457346966,1276428275,1296027558.4,81.68272902761285,83.0826877182785,NaN,NaN,48.201170744911416,47.02916083823692
2019-05-03T09:30:00-04:00,78.38,78.91,78.27,78.84,13288420,11846202.05,71.30895282898288,75.04975583817783,NaN,NaN,73.70453271707221,83.47192625445071,-0.1445499006420623,1.2603636699321186,1.4049135705741809,1289716695,1296489366.8,81.80615434240401,83.27194296258358,NaN,NaN,47.43348255839784,47.0869210839742
2019-05-06T09:30:00-04:00,76.96,78.36,76.66,78.23,13022479,12161836.75,63.148965806456204,74.44399887098314,NaN,NaN,6.15996677941769,64.20413438300528,-0.18738023737676057,1.17068827385323,1.3580685112299906,1276694216,1292224013.2,76.66768556627876,83.2991989541532,NaN,NaN,44.22633696720468,46.67826621014998
2019-05-07T09:30:00-04:00,77.35,77.65,75.85,76.55,20625711,12827626.75,47.147267809190566,72.56921249418944,NaN,NaN,-78.63116260421319,30.95274671984483,-0.3239976076042037,0.953071501724736,1.2770691093289397,1256068505,1280064943.6,64.2736988625498,82.39853053301204,NaN,NaN,35.03068707640823,45.01432633390116
2019-05-08T09:30:00-04:00,76.3,77.12,76.17,76.46,13667465,12838993.7,46.467952695899584,70.51519716449715,NaN,NaN,-93.07778098465633,-7.432588774472504,-0.4100286236155326,0.7645333298095238,1.1745619534250564,1242401040,1268261746.2,54.98185194363528,80.77396146356963,NaN,NaN,27.80598465044927,42.555991807693744
2019-05-09T09:30:00-04:00,75.51,76.19,74.66,75.94,19300910,13373148.95,42.64476201337917,68.1234814760707,NaN,NaN,-163.38532801864147,-51.04595442220422,-0.48635026207400744,0.5666241258325471,1.0529743879065545,1223100130,1257596117.2,48.20083540297322,78.52290270493248,NaN,NaN,20.51204020746417,39.4068558648038
2019-05-10T09:30:00-04:00,75.45,76.52,74.3647,76.18,19596295,13968096.8,44.89812611061833,65.83957511631964,NaN,NaN,-147.87514177717455,-95.36188932105355,-0.5029754292535094,0.4242551013396678,0.9272305305931772,1242696425,1248192063.2,43.147851237903595,75.78546896496186,NaN,NaN,15.402255071403614,35.97762718003235
2019-05-13T09:30:00-04:00,74.03,74.47,73.1,73.31,25461207,14813388.55,29.813683676805326,62.25218955445748,NaN,NaN,-242.4410195797909,-145.08208659289528,-0.6786390377410377,0.07893173341687998,0.7575707711579177,1217235218,1236300263.6,37.75753596129208,72.46885218470122,NaN,NaN,3.462283963360493,31.33257814907923
2019-05-14T09:30:00-04:00,73.68,74.95,73.62,74.49,18404280,15238067.9,38.90253559217773,59.30663068660214,NaN,NaN,-166.31478197224587,-162.6188104665018,-0.6847679894234505,-0.09838921562139546,0.586378773802055,1235639498,1232214462.2,36.089335507684396,68.87596991575272,NaN,NaN,-2.1216529943495694,26.553402271446544
2019-05-15T09:30:00-04:00,73.97,75.53,73.85,75.3,15048875,15510034.3,44.24035945085184,56.76352813289497,NaN,NaN,-117.3622148813896,-167.47569724584847,-0.606366423728015,-0.17157925585796363,0.43478716787005134,1250688373,1233871928.8,37.29956398312658,65.28904536792024,NaN,NaN,-4.2050042977954565,22.15934419012626
2019-05-16T09:30:00-04:00,75.35,76.54,75.25,75.99,15444976,15669889.5,48.37775192573113,54.83764688018498,NaN,NaN,-59.812766614551954,-146.76118496503057,-0.48536879491774354,-0.17192382577712806,0.3134449691406155,1266133349,1242478572.6,43.30334943862917,62.10243540616383,NaN,NaN,-4.192718525619201,18.394763802162622
2019-05-17T09:30:00-04:00,75.21,76.4,75.2,75.38,13543996,15772491.85,45.18567769194697,52.67665587424528,NaN,NaN,-64.58928612268828,-130.10401383413333,-0.425872383910641,-0.21889551074768576,0.2069768731629552,1252589353,1244457158.2,44.61628196929694,58.975598255223005,NaN,NaN,-5.352008660660347,15.002367736045056
2019-05-20T09:30:00-04:00,74.11,74.69,73.705,74.07,14674612,16102004.05,39.203273216500605,50.04017971520725,NaN,NaN,-114.47461561255234,-104.51073304068561,-0.45174436028841913,-0.35770357719756873,0.09404078309085041,1237914741,1248593062.8,47.36037087973079,56.00663925323,NaN,NaN,-8.56912885218228,11.635011080584007
2019-05-21T09:30:00-04:00,74.85,75.22,74.6801,74.98,14841128,16009410.2,44.68219030605192,48.031624787915185,NaN,NaN,-73.97568225190483,-86.0429130966174,-0.3870625058146202,-0.38978734917742486,-0.002724843362804638,1252755869,1252016337,49.58683594223498,53.341005718953745,NaN,NaN,-9.09401006387815,8.673722345660842
2019-05-22T09:30:00-04:00,74.49,75.04,74.45,74.59,11521081,16038550.85,42.897927827692975,46.35138763944895,NaN,NaN,-77.6847895569098,-78.10742803172143,-0.35109476339301404,-0.4415932976040722,-0.09049853421105815,1241234788,1250125620,48.369954499530316,50.96152182409071,NaN,NaN,-10.117637783986686,5.989242327139767
2019-05-23T09:30:00-04:00,73.58,73.62,72.7404,73.28,16085696,16273456.4,37.4834648378029,43.935281354364676,NaN,NaN,-126.41795027168442,-91.42846476314791,-0.39292199333984257,-0.5816510258858614,-0.1887290325460188,1225149092,1241928768.6,43.397695370373974,48.218060468945716,NaN,NaN,-12.92188570967946,3.287652607594163
2019-05-24T09:30:00-04:00,73.68,74.06,73.22,73.3,11750019,16308446.4,37.61293122815375,42.11127888448592,NaN,NaN,-104.34165337158888,-99.37893821292803,-0.3955439107378559,-0.6831589209683386,-0.28761501023048275,1236899111,1238790720.2,41.63322103300147,45.71559871656876,NaN,NaN,-14.999550858631888,0.6751949695618698
2019-05-28T09:30:00-04:00,73.53,74,73.05,73.09,25772770,17066418.35,36.75229313711062,41.36878069362307,NaN,NaN,-103.41574875006478,-97.16716484043052,-0.38723179061605545,-0.771654748500552,-0.3844229578844966,1211126341,1233433040.2,38.7373426377171,43.89157327193785,NaN,NaN,-16.91650478928851,-1.8379049959881844
2019-05-29T09:30:00-04:00,72.55,73.01,72.17,72.66,14754806,16862015.2,34.98697252583325,40.54871068147547,NaN,NaN,-125.05849000888941,-107.38372639182744,-0.38565946913639615,-0.8664972943049918,-0.48083782516859563,1196371535,1222156173.4,33.46160237457967,42.354412588433895,NaN,NaN,-19.03564765597532,-4.294725375986346
2019-05-30T09:30:00-04:00,72.83,73.255,72.61,73.11,11420530,16660700.4,38.3256354563187,40.24020164168544,NaN,NaN,-100.6416591382597,-111.97510030809742,-0.3313554064635328,-0.8950320832480116,-0.5636766767844789,1207792065,1215467628.8,30.78365734861339,41.1103284416939,NaN,NaN,-19.80429452958955,-6.510378112215375
2019-05-31T09:30:00-04:00,72.23,72.57,71.86,71.89,12039782,16013251.9,33.32851169597119,39.41380061206779,NaN,NaN,-131.9693250256622,-113.08537525889297,-0.3526670912707369,-1.0045105408729,-0.6518434496021631,1195752283,1209588267,28.615738023434346,40.0723203549461,NaN,NaN,-22.07016119129081,-8.73320426636901
2019-06-03T09:30:00-04:00,72,72.4,70.145,70.63,19703698,16334015.8,29.10737700733688,39.36335013567718,NaN,NaN,-166.10458060012712,-125.43796070460061,-0.42200497485899136,-1.1793496681759024,-0.757344693316911,1176048585,1197418161.8,24.732919337396567,39.14199059609642,NaN,NaN,-25.462539342341927,-11.123109277222284
2019-06-04T09:30:00-04:00,71.53,72.99,71.165,72.99,15096174,16437700.55,43.53298856514945,39.69409677660373,NaN,NaN,-93.53776053693106,-123.46236306197389,-0.28582816526753607,-1.114629899901331,-0.828801734633795,1191144759,1193421845.4,23.600484316684984,38.249929796739316,NaN,NaN,-23.250524821702097,-12.855597212147972
2019-06-05T09:30:00-04:00,73.96,74.11,73.1,73.94,14395841,16126207.05,48.110301661251036,39.97052122020367,NaN,NaN,-18.94898564634527,-102.24046218946506,-0.11730878662972732,-0.9754377179209541,-0.8581289312912268,1205540600,1195255658.4,25.29089150040876,37.39216747654519,NaN,NaN,-19.8113784821146,-13.849280250714633
2019-06-06T09:30:00-04:00,74.14,74.95,73.795,74.8,11922461,16038956.85,51.91065687345383,40.222871573612444,NaN,NaN,34.341385738616225,-75.24385321408988,0.05717200412365797,-0.7866639261366544,-0.8438359302603123,1217463061,1197189857.6,27.122468633452826,36.23639027617545,NaN,NaN,-15.706083637683587,-14.114537877424484
2019-06-07T09:30:00-04:00,75.19,76.6352,75.04,76.19,11992069,15673514.8,57.34796377716525,41.09160629398517,NaN,NaN,119.25907450423925,-24.998173308109592,0.2599357763934681,-0.5189162097684772,-0.7788519861619453,1229455130,1203930427,33.26290228749531,35.42543458461819,NaN,NaN,-10.303723698951217,-13.570135851928303
2019-06-10T09:30:00-04:00,76.74,77.69,76.74,76.97,13463779,15366889,60.0759024109567,42.58250837930346,NaN,NaN,174.37303010254678,43.09734883242519,0.43027634040895957,-0.24100656065074588,-0.6712829010597055,1242918909,1217304491.8,43.444814403763395,35.14575197919194,NaN,NaN,-5.041641745548584,-12.351779551016914
2019-06-11T09:30:00-04:00,77.75,77.83,76.53,76.97,11550125,14671334.9,60.0759024109567,43.68205924393952,NaN,NaN,148.02739502886027,91.41037994558346,0.5206066671989168,-0.02052456706105943,-0.5411312342599762,1242918909,1227659321.8,49.82735073226953,35.162931607051554,NaN,NaN,-1.0149767674143364,-10.732236296216547
2019-06-12T09:30:00-04:00,76.6,76.805,76.36,76.54,7596943,14130968.05,57.71578998654745,44.740477969571984,NaN,NaN,105.66091571174222,116.33236021720094,0.527424699013623,0.11814963950705248,-0.4092750595065705,1235321966,1233615595,53.105714253340814,35.50120016089515,NaN,NaN,1.53926363762133,-8.97916487709685
2019-06-13T09:30:00-04:00,76.81,77.04,76.49,76.77,9867761,13871912.35,58.65148932667859,46.252479718777394,NaN,NaN,103.72418907597047,130.20892088467178,0.5224589802894237,0.24379866585520915,-0.2786603144342146,1245189727,1239160928.2,55.98900839105706,36.40057966237252,NaN,NaN,3.8905649283011448,-7.140632047754279
2019-06-14T09:30:00-04:00,76.07,76.35,75.77,76.1,8441689,13521748,54.8441624824944,47.483281951230296,NaN,NaN,72.38104251008625,120.8333144858412,0.45174105906304085,0.2860160093945865,-0.16572504966845436,1236748038,1240619509.8,56.74239732747149,37.47980654054895,NaN,NaN,4.782271904537365,-5.4373600545697585
2019-06-17T09:30:00-04:00,76.15,76.535,75.99,76.16,9351130,13312104.7,55.12509742904886,48.79562511494017,NaN,NaN,76.51718497571396,101.26214546047463,0.3890753667621098,0.3206191587841829,-0.0684562079779269,1246099168,1241255561.6,57.08737391014649,38.79052306000819,NaN,NaN,5.5863188271102135,-3.8625487857583343
2019-06-18T09:30:00-04:00,76.97,77.92,76.73,77.54,16181183,13387433.25,61.116992899885005,50.66205514165815,NaN,NaN,110.92879750574555,93.84242595585168,0.41809422947123603,0.4541615788611182,0.03606734938988214,1262280351,1245127850,59.219624678429085,40.63038179599744,NaN,NaN,8.12859324500859,-2.1495284956487737
2019-06-19T09:30:00-04:00,77.74,78.02,77.21,77.82,12371290,13263941.35,62.219279613501534,52.36874401002835,NaN,NaN,107.7480606018879,94.25985493388082,0.43190562678089417,0.5759493828659998,0.1440437560851057,1274651641,1252993785,63.21777007280204,42.94710413343948,NaN,NaN,10.543872043072842,-0.3361855615456859
2019-06-20T09:30:00-04:00,78.96,79.22,78.2987,78.96,13891896,13382482.1,66.39618652782843,54.730720783732444,NaN,NaN,128.03853752894116,99.12272462447496,0.489360053720729,0.755743823236017,0.26638376951528797,1288543537,1261664547,67.05239436885499,45.692579586683806,NaN,NaN,13.976654263735638,1.7085058420659314
2019-06-21T09:30:00-04:00,78.39,78.99,78.28,78.31,20715371,13613965.85,62.175373141910946,57.092720507630595,NaN,NaN,105.92793627543402,105.83210337754448,0.45580826134424673,0.8361440961955964,0.38033583485134964,1267828166,1267880572.6,69.5067039726237,48.8907070606286,NaN,NaN,15.613255090827732,3.6948985918890456
2019-06-24T09:30:00-04:00,78.45,78.715,78.34,78.46,8216118,13437270.8,62.76365125370404,58.466339271098775,NaN,NaN,95.89910687536776,109.70848775747524,0.41698962600782025,0.901572867361125,0.4845832413533047,1276044284,1273869595.8,71.69448771871436,52.32599301791642,NaN,NaN,17.115341329465537,5.612104697257116
2019-06-25T09:30:00-04:00,78.42,78.49,76.925,77.02,13122665,12804765.55,54.069687704588596,58.89200970276574,NaN,NaN,58.74475838695476,99.2716799337171,0.27448428337281816,0.8276885955693274,0.5532043121965092,1262921619,1273997849.4,71.74124522001568,55.64387542645977,NaN,NaN,15.80401195434373,7.068091448269489
2019-06-26T09:30:00-04:00,77.77,78.395,77.75,77.85,9069181,12520484.3,57.70621191283849,59.305977919864645,NaN,NaN,72.08011406440859,92.13809062622123,0.2187009785500581,0.8265805353840818,0.6078795568340237,1271990800,1273465681.2,71.2155678812022,58.79338251558472,NaN,NaN,15.80870910767636,8.316751113899041
2019-06-27T09:30:00-04:00,78.11,78.32,77.88,78.05,6837616,12291338.6,58.5576787624681,59.392386133100565,NaN,NaN,70.99760763115466,80.72990464666393,0.17949402798538838,0.8322470918157592,0.6527530638303708,1278828416,1271522657,69.22120816310476,61.36183293527112,NaN,NaN,16.064004148331204,9.42350154738935
2019-06-28T09:30:00-04:00,78.29,78.38,77.8,78.04,17783356,12578517.3,58.494268556828324,59.27941228637711,NaN,NaN,67.07465158040603,72.95924770765832,0.13892129566797007,0.8264046834153334,0.6874833877473633,1261045060,1270166035.8,67.79368595793696,63.10103804628351,NaN,NaN,16.25280206224804,10.399115906654878
2019-07-01T09:30:00-04:00,79.83,79.93,78.95,79.28,14290707,12307867.75,63.73792604932423,59.540985403403354,NaN,NaN,124.96600997085866,78.77262832675652,0.17907485751720753,0.9113269596438727,0.7322521021266651,1275335767,1270024332.4,67.63678232809008,64.37314030312783,NaN,NaN,17.988690477709106,11.48334084537691
2019-07-02T09:30:00-04:00,79.24,79.54,79.06,79.49,7784480,11942283.05,64.55463624147475,60.029474421612456,NaN,NaN,122.90675275884736,91.60502720113504,0.20158083900356594,0.9842281508811226,0.7826473118775567,1283120247,1274064058,69.78381961677647,65.56443354337324,NaN,NaN,19.650330436289487,12.650053644078707
2019-07-03T09:30:00-04:00,79.69,80.1,79.53,80.1,5341772,11489579.6,66.88756601271272,60.61776561347204,NaN,NaN,147.077224005614,106.60444918937613,0.23691348028938597,1.0787891622392891,0.8418756819499031,1288462019,1277358301.8,71.44732151940792,66.66859876682688,NaN,NaN,21.75914803036516,13.95135284211963
2019-07-05T09:30:00-04:00,79.45,80.09,79.16,79.95,5924127,11189662.9,65.74171185841686,61.3961619974665,NaN,NaN,126.14250300501496,117.6334282641482,0.22939202975753514,1.128615719146822,0.8992236893892869,1282537892,1278100197,71.82354132379163,67.74582333799259,NaN,NaN,23.185719161805398,15.270548030646168
2019-07-08T09:30:00-04:00,79.33,79.435,78.9701,79.34,7459937,10963056.3,61.153646766417395,61.8267726644214,NaN,NaN,86.28136555044372,121.47477105815571,0.16552579536837675,1.1061309335997578,0.940605138231381,1275077955,1280906776,73.2590035797004,68.90093974296073,NaN,NaN,23.141242985013406,16.3949330241272
2019-07-09T09:30:00-04:00,78.93,79.68,78.81,79.62,9249826,10752358.65,62.44910015247849,61.92192318246379,NaN,NaN,85.08870534186825,113.49931013235764,0.12611216960561555,1.0982453502384004,0.9721331806327849,1284327781,1282705178.8,74.16718272189753,69.96862246035133,NaN,NaN,23.45820154729373,17.403971384579563
2019-07-10T09:30:00-04:00,80.06,80.73,79.995,80.25,10108944,10680299.6,65.25654803646867,62.138870926961445,NaN,NaN,130.98644253187857,115.11524808696387,0.12613983978630738,1.129807980365669,1.0036681405793617,1294436725,1284968474.4,75.30392212902915,70.83191903579612,NaN,NaN,24.522312348142627,18.420877236517143
2019-07-11T09:30:00-04:00,80.45,80.855,80.28,80.55,11352423,10868073.6,66.53943961168176,62.14910329009383,NaN,NaN,132.23533127970606,112.14686954178231,0.12953977237271141,1.1655928560452509,1.0360530836725395,1305789148,1288433900.2,76.97461296848772,71.5406489357699,NaN,NaN,25.778860033072004,19.47201763602498
2019-07-12T09:30:00-04:00,80.8,81.19,80.66,81.14,7753421,10762356.6,68.966409834869,62.63417733959083,NaN,NaN,141.99539245629975,115.31744743203926,0.15308701878183406,1.227411857149832,1.074324838367998,1313542569,1294634835.6,79.63008974172189,72.2637479192769,NaN,NaN,27.56487183747013,20.62813966480286
2019-07-15T09:30:00-04:00,81.36,81.51,81.18,81.41,6286126,10654578.45,70.03745163778066,63.15373450988202,NaN,NaN,149.94491590356387,128.0501575026633,0.16725725690616988,1.2833964095007104,1.1161391525945406,1319828695,1303584983.6,82.72659134456453,73.05175532112334,NaN,NaN,29.373462358920012,21.877471478248168
2019-07-16T09:30:00-04:00,81.31,81.32,80.51,80.65,8005994,10587321.65,63.404193541863805,63.820484926830254,NaN,NaN,108.7570528013357,132.7838269945568,0.10869393374941971,1.2520065697813152,1.1433126360318955,1311822701,1309083967.6,84.30520139419976,73.94918076213649,NaN,NaN,29.097003065809552,22.90883313361408
2019-07-17T09:30:00-04:00,80.8,80.98,80.43,80.44,6708000,10113662.5,61.6662545879045,64.10334511790639,NaN,NaN,87.71505415251129,124.12954931868333,0.04246458927426455,1.1963933726247262,1.1539287833504617,1305114701,1311219562.8,84.88300910147566,74.9254265635846,NaN,NaN,28.378824300401558,23.69026044315515
2019-07-18T09:30:00-04:00,80.26,81.16,80.2,81.04,8022393,9896217.65,64.64785185753394,64.53835748183965,NaN,NaN,89.93151430305073,115.66878592335226,0.026497705132093152,1.1870509147655781,1.160553209633485,1313137094,1312689152,85.28448974173877,76.07280381920131,NaN,NaN,28.58403059917557,24.389370465443783
2019-07-19T09:30:00-04:00,81.85,81.88,80.59,80.69,11679742,9785609.95,61.63619805463639,64.76278101739737,NaN,NaN,95.39721415117003,106.34915026232632,-0.017815806424989145,1.1382834516022484,1.1560992580272376,1301457352,1310272108.6,81.45290011651008,77.0484619733851,NaN,NaN,27.908339523183578,24.89208033083518
2019-07-22T09:30:00-04:00,81,81.817,80.99,81.62,6924663,9096074.55,66.14877779968299,64.93498471385158,NaN,NaN,110.64008243538639,98.48818356869081,0.00415376813333701,1.1612914681939088,1.1571377000605718,1308382015,1307982772.6,77.88374414413052,77.780387817388,NaN,NaN,28.625666805299844,25.425449827187276
2019-07-23T09:30:00-04:00,82.09,82.15,81.46,82.07,5505508,8960544.05,68.10382014981334,65.18849785016148,NaN,NaN,123.19321840179077,101.37541668878183,0.03587466964041974,1.2019810371110964,1.1661063674706766,1313887523,1308395737,78.07041526841152,78.3722875067905,NaN,NaN,29.811650348265236,26.052049901626983
2019-07-24T09:30:00-04:00,81.96,82.78,81.96,82.75,9257101,8767265.85,70.84406789184098,65.47110512724207,NaN,NaN,147.94746325554087,113.42189850938776,0.08664094894032703,1.2744075536460855,1.1877666047057585,1323144624,1312001721.6,79.68299487883804,78.96054988960694,NaN,NaN,31.671961422129378,26.854894404555896
2019-07-25T09:30:00-04:00,82.57,82.57,81.9708,82.41,9923370,8809975.3,67.71172206849164,65.61182014224741,NaN,NaN,127.36534709796145,120.9086650683699,0.08139176047999319,1.2895063053057498,1.2081145448257566,1313221254,1312018553.6,79.69050222564249,79.52247566831056,NaN,NaN,32.30069996664684,27.632866627711746
2019-07-26T09:30:00-04:00,82.45,82.75,82.37,82.59,11120160,9024102.5,68.50564296188958,66.13696272763829,NaN,NaN,135.4178127717018,128.91278479247626,0.07430801005962562,1.3009995574002886,1.226691547340663,1324341414,1316595366,81.67348420061873,80.12350999837615,NaN,NaN,33.0467154759566,28.40627360603244
2019-07-29T09:30:00-04:00,82.63,82.68,81.9,82.54,8473219,8558595.65,68.00542636323776,66.53384317126395,NaN,NaN,113.5713265393771,129.4990336132744,0.051598307982511304,1.2911894323188022,1.239591124336291,1315868195,1318092602,82.28291403047709,80.70320509184613,NaN,NaN,33.52556787277038,29.137601358423574
2019-07-30T09:30:00-04:00,81.97,82.3649,81.79,82.01,7366949,8212407.75,62.77308829949237,66.35645319005137,NaN,NaN,81.25428128043458,121.11124618900317,-0.010465039372824503,1.2265098251202602,1.2369748644930847,1308501246,1317015346.6,80.21602091025541,81.05406929050515,NaN,NaN,32.48471623546511,29.615760626572364
2019-07-31T09:30:00-04:00,82.45,82.54,79.9201,80.77,16869250,8666646.25,52.58004870159152,65.35935383933062,NaN,NaN,1.9155120185036523,91.90485594159573,-0.13922771532749567,1.062940220333715,1.2021679356612107,1291631996,1310712821,69.25523739294877,80.5026853208238,NaN,NaN,28.31636551978494,29.43013275417416
2019-08-01T09:30:00-04:00,80.91,82.62,79.96,80.36,28833005,9841207.9,49.70605152941194,63.983613960369404,NaN,NaN,-10.987942856168429,64.23419795076974,-0.24976029692897073,0.8899675644999974,1.139727861428968,1262798991,1300628368.4,56.05658685411852,78.818863685995,NaN,NaN,23.94078151897637,28.645939720574475
2019-08-02T09:30:00-04:00,79.71,79.74,78.33,79.05,22371946,10663598.85,41.83737179537683,61.969322543054844,NaN,NaN,-169.873425886896,3.175950219050179,-0.3999389511893825,0.6398041724422399,1.0397431236316224,1240427045,1283845494.6,41.78441865251466,75.89442277942001,NaN,NaN,17.260471353625274,27.01944423958173
2019-08-05T09:30:00-04:00,76.94,77.05,75.14,75.75,27826563,11681930.15,29.268012048669547,59.53102386496954,NaN,NaN,-337.01617917621803,-86.94155092406884,-0.6931799917336197,0.17326813396459784,0.8664481256982175,1212600482,1263191952,31.24245768681577,72.10422680032116,NaN,NaN,5.08700796149643,23.886239056998114
2019-08-06T09:30:00-04:00,76.77,77.29,76.13,77.01,19150939,12176985.8,37.04514109554206,57.77237290122936,NaN,NaN,-233.20893842236632,-149.83419486462904,-0.7681291400927799,-0.09371329941775741,0.6744158406750225,1231751421,1247841987,25.993537741397688,67.89783598888701,NaN,NaN,-1.3066606200346962,20.28725338885057
2019-08-07T09:30:00-04:00,76.13,77.7,75.71,77.49,20582422,12700659.7,39.76237279873102,55.99483868274344,NaN,NaN,-177.3541082205764,-185.68811891244505,-0.750355257333443,-0.26352823099178124,0.48682702634166175,1252333843,1239982356.4,23.789637131238408,63.505346516708414,NaN,NaN,-5.047859476094025,16.66795155100134
2019-08-08T09:30:00-04:00,78.11,79.41,77.91,79.39,15991578,12932617.45,49.12320044443322,55.1010531391575,NaN,NaN,-72.53564988858896,-197.99766031892915,-0.5830648172830284,-0.2420039952621238,0.3410608220209046,1268325421,1241087642.4,24.75581431611819,59.45555467382328,NaN,NaN,-4.522864408708728,13.640692128185616
2019-08-09T09:30:00-04:00,78.92,79.139,77.89,78.49,15572602,13323576.5,45.51512412089863,53.62722073353005,NaN,NaN,-78.02489608143767,-179.6279543578375,-0.5081904730703949,-0.294177269317089,0.21401320375330588,1252752819,1243552797.2,26.97934279473685,55.81952600600944,NaN,NaN,-5.471546180174363,10.910372369848478
2019-08-12T09:30:00-04:00,77.95,78.24,77.1,77.46,10893391,13553939.75,41.73689255696366,51.74386876261222,NaN,NaN,-98.498211188358,-131.92436076026547,-0.5023038115910101,-0.4138665607354568,0.08843725085555332,1241859428,1249404586.4,32.108151966304646,52.536507198716095,NaN,NaN,-7.610765850884585,8.264495481172325
2019-08-13T09:30:00-04:00,77.39,79.6999,77.22,79.4,26082725,14457776.3,50.133285988287646,50.2645271980727,NaN,NaN,-48.76075447586321,-95.03472397096485,-0.34928256812661773,-0.3481659593027189,0.0011166088238988708,1267942153,1256642732.8,37.91671693672588,49.553201631422375,NaN,NaN,-6.204489331830476,6.197497650743354
2019-08-14T09:30:00-04:00,77.94,78.29,76.76,76.96,23569346,15300843.6,41.94564497458594,48.42409311993658,NaN,NaN,-88.73388635525957,-77.3106795979015,-0.3907871274785914,-0.4873673005243404,-0.096580173045749,1244372807,1255050525.6,37.16349208468281,46.515558049925254,NaN,NaN,-8.267859614931082,4.131018041361292
2019-08-15T09:30:00-04:00,77.03,77.22,76.17,76.82,15668558,15683151.85,41.52657969859647,46.4970171725585,NaN,NaN,-96.40330926608927,-82.08421147340155,-0.4043696441682774,-0.6020422282560958,-0.19767258408781835,1228704249,1247126291.2,33.5873700771174,43.08083561253231,NaN,NaN,-9.92307424982537,2.123290571191769
2019-08-16T09:30:00-04:00,77.61,78.4428,77.5,78.28,10862450,15642287.25,47.42558458098951,45.02702847382648,NaN,NaN,-48.720214225401165,-76.22327510219426,-0.29670924516529495,-0.568559140544437,-0.27184989537914206,1239566699,1244489067.2,32.467621111763876,39.52260040405279,NaN,NaN,-9.13809107291064,0.5145217648914249
2019-08-19T09:30:00-04:00,79.51,79.7099,79.055,79.47,7878240,15689966.1,51.70243700020369,44.236267666734435,NaN,NaN,-2.8080764687414534,-57.08524815827094,-0.13525438033079162,-0.44091787079263156,-0.30566349046183994,1247444939,1245606169.4,33.47927559716895,36.18426145311803,NaN,NaN,-6.97897075488787,-0.5559771665056172
2019-08-20T09:30:00-04:00,79.37,79.77,79.025,79.07,8337949,15831588.15,50.223484036586505,44.06794161923408,NaN,NaN,-2.775915025074445,-47.88828026811318,-0.04970773066938755,-0.3677981537985744,-0.31809042312918684,1239106990,1239839136.8,30.90533893148384,33.44498299158482,NaN,NaN,-5.793351588667307,-1.3041735125287157
2019-08-21T09:30:00-04:00,79.83,80.2,79.64,80,8403058,15788886,53.55033663632904,44.34253341258529,NaN,NaN,28.011549583106387,-24.539193080439993,0.06876741042418238,-0.23213116009895884,-0.30089857052314123,1247510048,1240466585,31.522192111521463,31.692526224256458,NaN,NaN,-3.7250671946895846,-1.6500154671231255
2019-08-22T09:30:00-04:00,80.21,80.39,79.1,79.81,7594419,15672438.45,52.774291799798476,45.1237419843297,NaN,NaN,28.289269831589213,0.399322739095701,0.1300383110351585,-0.13835068172919307,-0.2683889927643516,1239915629,1242708861,33.796828519582164,31.121984071904137,NaN,NaN,-2.3283985042147903,-1.746927329564792
2019-08-23T09:30:00-04:00,79.37,80.1,76.85,77.17,20399029,16136381.9,43.369591700269105,46.13099767372967,NaN,NaN,-40.13061568942844,2.1172424462902457,-0.0044068798816104815,-0.2738975926163647,-0.2694907127347542,1219516600,1238698841.2,31.764709429173337,31.15928776778682,NaN,NaN,-4.215369603399859,-2.099561940112659
2019-08-26T09:30:00-04:00,78.12,78.27,77.59,78.24,10353996,16230420.75,47.456597585912824,46.874673137327584,NaN,NaN,-33.545418008205814,-4.030225861602629,-0.017701709314982772,-0.2916178493784827,-0.2739161400634999,1229870596,1235183972.6,30.058665671875573,31.44965404853524,NaN,NaN,-4.390792170884998,-2.426880544508707
2019-08-27T09:30:00-04:00,78.75,78.89,77.67,78.12,10047596,16364453.1,47.046520754211166,47.39496941986187,NaN,NaN,-15.118607622502042,-6.498764381088151,-0.03026757648234929,-0.3117506106664365,-0.2814830341840872,1219823000,1231327174.6,28.264785398709037,31.769307496211713,NaN,NaN,-4.655674797455004,-2.745279723501035
2019-08-28T09:30:00-04:00,77.7,78.32,77.14,78.19,7139588,15877970,47.33242030549508,47.26705655279487,NaN,NaN,-29.439734302070097,-17.989021158123446,-0.029523478648040002,-0.3183873824941372,-0.2888639038460972,1226962588,1227217682.6,26.453242594558972,31.890552373243192,NaN,NaN,-4.7827658202929415,-3.0363491658998787
2019-08-29T09:30:00-04:00,79.25,79.79,78.97,79.55,8121072,14842373.35,52.678141648742645,47.77870066192657,NaN,NaN,89.47718878116069,-5.75143736820915,0.061916116859030645,-0.2114687577723089,-0.27338487463133954,1235083660,1226251288.8,26.030729736554363,31.822794297658728,NaN,NaN,-3.2677436911799402,-3.0694055266541733
2019-08-30T09:30:00-04:00,80.07,80.17,78.96,79.53,10075443,14227548.2,52.59359982277554,48.55417975234171,NaN,NaN,93.32003814888012,20.93869339945256,0.11719898312731489,-0.12688614572219592,-0.2440851288495108,1225008217,1227349612.2,27.449019877495346,31.489999148458065,NaN,NaN,-2.0760373432567762,-2.927495786168831
2019-09-03T09:30:00-04:00,78.87,79.5685,78.28,78.56,11838051,13428122.6,48.52596652206757,48.43937121904027,NaN,NaN,31.811554383265563,34.01008787774684,0.08602759196434567,-0.1365506388940787,-0.22257823085842438,1213170166,1224009526.2,25.827198058850072,30.62646208575265,NaN,NaN,-2.213356810454753,-2.825475932495391
2019-09-04T09:30:00-04:00,79.41,79.94,79.33,79.9,7729905,12857070.9,53.8374565832755,49.28878633394667,NaN,NaN,96.51644670294316,56.337098742835884,0.14952513210892565,-0.0356718157222673,-0.18519694783119295,1220900071,1224224940.4,26.130338423769913,29.83837968140173,NaN,NaN,-0.7328196295505639,-2.5265250320747015
2019-09-05T09:30:00-04:00,80.95,81.9,80.91,81.57,10043358,12330117.7,59.45290308135223,50.56923800414351,NaN,NaN,209.56133110359502,104.13731182396891,0.2897497094139613,0.17699018893625862,-0.11275952047770263,1230943429,1225021108.6,27.312760264976916,29.390193266248836,NaN,NaN,2.3759011913408323,-1.8261784287296252
2019-09-06T09:30:00-04:00,81.75,81.79,81.28,81.5,9150075,11988042.55,59.12822300148265,51.40514074846444,NaN,NaN,175.27601972383766,121.29707801250429,0.35901136986814797,0.3360046918574824,-0.02300667801066561,1221793354,1222363047.4,25.826429279994272,28.91582242112244,NaN,NaN,4.750156452163138,-0.8867020171735164
2019-09-09T09:30:00-04:00,81.88,81.92,80.46,80.89,12610706,11839947.75,56.24560149811393,51.72965249831517,NaN,NaN,126.28699303048802,127.89046898882589,0.3448842401358936,0.40809862215920134,0.06321438202330779,1209182648,1219197933.6,24.141711964596567,28.24885359022441,NaN,NaN,5.906729603146919,0.08378821430083161
2019-09-10T09:30:00-04:00,80.52,80.52,79.57,80.48,9858667,11788211.55,54.328439846222906,52.022863627574914,NaN,NaN,64.61739405081624,134.451636922336,0.29120867152600716,0.42722522143081676,0.1360165499048096,1199323981,1216428696.6,22.74379587806341,27.665886229265812,NaN,NaN,6.32674087089447,0.9756385938142086
2019-09-11T09:30:00-04:00,80.73,81.34,80.56,81.32,9409273,10954538.95,57.52295243128333,52.30662189864308,NaN,NaN,107.66743568547349,136.68183471884208,0.2946670259136225,0.5043503322968377,0.20968330638321522,1208733254,1213995333.2,21.562280807767664,26.9544639932834,NaN,NaN,7.6098288038409425,1.9233800523894562
2019-09-12T09:30:00-04:00,81.82,82.42,81.415,81.76,12771022,10414622.75,59.13532313599299,52.76098127979983,NaN,NaN,141.29673614501502,123.02891572712606,0.30755585243224215,0.5941281219235179,0.2865722694912758,1221504276,1212107502.6,20.665348271395047,26.01650111841289,NaN,NaN,9.146072062031596,2.9551931966240472
2019-09-13T09:30:00-04:00,81.63,81.63,81.07,81.16,16533550,10457872.35,56.012967177889365,53.66407952820128,NaN,NaN,97.68731541525008,107.51117486540856,0.2586085102298833,0.6098329072786299,0.35122439704874664,1204970726,1208742977,19.137449317637504,25.1145539675889,NaN,NaN,9.590267636236277,3.9030609737115087
2019-09-16T09:30:00-04:00,80.49,81.135,80.41,80.96,7725882,10301043.95,54.9710507038121,54.2008261794798,NaN,NaN,61.60254274270774,94.57428480785251,0.198407000419905,0.5992331475736279,0.4008261471537229,1197244844,1206355416.2,18.113966065115903,24.261361138534635,NaN,NaN,9.678399928614812,4.728109395840552
2019-09-17T09:30:00-04:00,81.02,81.29,80.835,81.29,7706046,10292434.25,56.41177903709828,54.86977319968603,NaN,NaN,72.59328400764629,96.16946279921852,0.16767861114122945,0.6104244110802597,0.44274579993903024,1204950890,1207480798,20.27819859957478,23.69089065288219,NaN,NaN,10.136493206037965,5.500735654440183
2019-09-18T09:30:00-04:00,81.16,81.34,80.18,81.28,8797790,10315426.3,56.35293836925236,55.514095918525825,NaN,NaN,54.16158047305982,85.4682917567358,0.1349540565939057,0.6114383706814124,0.4764843140875067,1196153100,1204964767.2,19.065000675150756,23.163159087210175,NaN,NaN,10.504617245075742,6.215575881673834
2019-09-19T09:30:00-04:00,81.53,82.18,81.35,81.46,8204618,10305504.3,57.21795903862104,55.838368589231436,NaN,NaN,87.8107393953419,74.77109240680117,0.11451158808444617,0.6196237991930644,0.5051122111086183,1204357718,1201535455.6,17.525928453987817,22.55567328131256,NaN,NaN,11.037200502290617,6.904379398904803
2019-09-20T09:30:00-04:00,81.47,81.51,80.05,80.26,15085791,10680072.9,50.09070783262647,55.65959058993507,NaN,NaN,25.097622802472326,60.25315388424561,0.014509549997892779,0.5232491486059843,0.5087395986080915,1189271927,1198395695.8,16.233770139357247,21.7545840143027,NaN,NaN,9.606092494382478,7.290338412544471
2019-09-23T09:30:00-04:00,80.27,80.75,80.1,80.51,7889342,10054588.55,51.447595491262646,55.86827837344901,NaN,NaN,10.4790307865669,50.02845149301744,-0.037614070556392765,0.4617220104126005,0.4993360809689933,1197161269,1198378980.8,16.226911070104606,21.06884922939231,NaN,NaN,8.745621244168436,7.498235959919323
2019-09-24T09:30:00-04:00,81.04,81.35,79.39,79.73,17731003,10423438.9,47.14130466216321,55.38998180765527,NaN,NaN,-17.298010489946506,32.05019259349888,-0.12264248389771415,0.3460329760968506,0.4686754599945647,1179430266,1193274856,14.247307692173251,20.22006131999255,NaN,NaN,6.783124597905823,7.396077193917394
2019-09-25T09:30:00-04:00,79.62,80.9,78.89,80.68,11963453,10519231.75,52.37042533534421,54.88409054008327,NaN,NaN,-27.67290920177533,15.683294658531855,-0.11315356852265407,0.3272334993412471,0.4403870678639012,1191393719,1192322979.8,13.90658068629709,19.262477064372565,NaN,NaN,6.500173017626261,7.268090883018661
2019-09-26T09:30:00-04:00,80.65,81.05,80.14,80.77,9116911,10618097.9,52.84634231364495,54.4353847766663,NaN,NaN,2.3542114719101486,-1.4080109261544889,-0.09954573824867813,0.3159548950530535,0.41550063330173165,1200510630,1191553562.2,13.62297684861106,18.390801890702335,NaN,NaN,6.39691126469719,7.143636651829879
2019-09-27T09:30:00-04:00,80.77,80.94,79.09,79.69,12782303,10851159.45,46.802791456241096,53.760898345103946,NaN,NaN,-78.62741743757299,-22.153018974163558,-0.15850937865469555,0.2173639099833622,0.37587328863805775,1187728327,1191244842.2,13.503978532777765,17.630963788429565,NaN,NaN,4.542290520845164,6.7720157759749195
2019-09-30T09:30:00-04:00,80.03,80.72,79.92,80.53,11007188,10897746.7,51.45307259528212,53.555514970036754,NaN,NaN,-34.42341923454611,-31.133508978386157,-0.13697725001003103,0.20465172612551896,0.34162897613555,1198735515,1191559691.4,14.325919749777754,17.02968692212345,NaN,NaN,4.2925727936591285,6.417809635644092
2019-10-01T09:30:00-04:00,80.89,81.43,79.75,79.78,11022587,10856973.5,47.4635812253802,52.83698845532938,NaN,NaN,-58.34814934540203,-39.34353674947725,-0.1672785691599506,0.13253076468561176,0.29980933384556235,1187712928,1193216223.8,18.703159349994593,16.82546396085394,NaN,NaN,2.873841932697681,5.911528535223177
2019-10-02T09:30:00-04:00,79.25,79.27,77.695,78.28,19760571,11458506.8,40.671389927251994,51.51813608327645,NaN,NaN,-262.86096768024754,-86.3811484451717,-0.2759616301535316,-0.045142703846352106,0.23081892630717946,1167952357,1188527951.4,16.183102994371097,16.505303583923656,NaN,NaN,-0.6282100770054079,4.9772801620476645
2019-10-03T09:30:00-04:00,78.25,79.27,77.28,79.24,17476528,11830165.3,45.99769860029557,50.80275975630548,NaN,NaN,-202.29459278695305,-127.31090929694433,-0.2704550774126345,-0.1072499204586137,0.16320515695402082,1185428885,1185511602.4,14.801292882295897,16.195578124256397,NaN,NaN,-1.8696229027286058,3.9991511527939116
2019-10-04T09:30:00-04:00,79.8,80.65,79.72,80.55,11020636,11923693.35,52.29187937321205,50.61139037554833,NaN,NaN,-21.236851650344516,-115.83279613949864,-0.17071274543219478,-0.05018577483622266,0.12052697059597212,1196449521,1187255841.2,19.102879467583875,16.266214795861252,NaN,NaN,-0.8197734958192618,3.3107333458491723
2019-10-07T09:30:00-04:00,80.28,80.88,80.15,80.21,10621149,11824215.5,50.64208129128075,50.19926910798994,NaN,NaN,-6.237282978684087,-110.19556888832624,-0.12204396695429742,-0.03202798809689966,0.09001597885739776,1185828372,1184674412.6,17.6801556365304,16.080640298500942,NaN,NaN,-0.5123244452277486,2.7645822328381837
2019-10-08T09:30:00-04:00,79.69,79.9345,78.73,78.74,14481367,12055350.5,44.15564863399615,49.32803412690021,NaN,NaN,-134.30093569858482,-125.3861261589628,-0.17977419736810402,-0.13470176785273225,0.045072429515371756,1171347005,1181401228,16.048081245643473,15.865146053536135,NaN,NaN,-2.419439885683769,2.024007644477905
2019-10-09T09:30:00-04:00,79.56,80.205,79.44,79.91,10278920,12098832.85,49.68007928350852,48.78961414439217,NaN,NaN,-52.81665004622846,-83.37726263215897,-0.13227857695189854,-0.12027579167450142,0.012002785277397114,1181625925,1184135941.6,22.486199260565357,16.219451111148818,NaN,NaN,-2.1512882999389062,1.4275367952755031
2019-10-10T09:30:00-04:00,79.83,80.78,79.77,80.46,9480037,11934283.6,52.079945802223506,48.93170257079196,NaN,NaN,6.860489315592621,-41.546246211649844,-0.06058469263682115,-0.06372808051862933,-0.003143387881808176,1191105962,1185271357,25.055961895011407,16.84960766512412,NaN,NaN,-1.1469007672165519,1.059760000633781
2019-10-11T09:30:00-04:00,81.45,82.29,81.32,81.57,15996561,11907434.15,56.580602660368605,49.29834594001381,NaN,NaN,161.78219196913903,-4.942437487753144,0.05839385931490288,0.06984893626182043,0.011455076946917546,1207102523,1187401957.4,29.761620014786445,17.816372589744244,NaN,NaN,1.2013363874979512,1.079985198757234
2019-10-14T09:30:00-04:00,81.49,81.86,81.48,81.52,5666424,11804461.25,56.32398667999547,49.9542517984304,NaN,NaN,137.55609544390896,23.81623819676547,0.12661089114326277,0.169718690875996,0.04310779973273324,1201436099,1190523502.8,36.09280989756398,19.37676560441501,NaN,NaN,2.9612087170956194,1.3487314156627175
2019-10-15T09:30:00-04:00,81.85,82.62,81.77,82.42,8119003,11825109.1,59.853546176658,50.48876042995282,NaN,NaN,184.31400023845134,87.53922538417271,0.21977374483573525,0.3178249807774023,0.09805123594166704,1209555102,1198165122.2,48.363479294901346,21.837972647886744,NaN,NaN,5.570288174637853,1.9518109526591654
2019-10-16T09:30:00-04:00,81.97,82.0063,81.5452,81.85,10125533,11891496.25,56.72686683669805,50.76594075302804,NaN,NaN,124.64507112309359,123.03156961803711,0.22937553102477817,0.38477064972263975,0.15539511869786157,1199429569,1201725851,52.901474387327355,24.64357961493791,NaN,NaN,6.790590385918333,2.643065157410475
2019-10-17T09:30:00-04:00,82.13,82.36,81.26,81.69,6866203,11824575.5,55.84499089989317,51.41181214186033,NaN,NaN,120.30739307261533,145.72095036944165,0.21174196638347037,0.42007257667719955,0.20833061029372918,1192563366,1202017331.8,53.2635659145005,27.483550142203818,NaN,NaN,7.525401950522752,3.3405418421408
2019-10-18T09:30:00-04:00,81.57,81.695,80.38,80.91,8726315,11506601.7,51.63104537466051,51.424524483244504,NaN,NaN,46.66987275912133,122.6984865274381,0.1379126377353709,0.3807214074629428,0.2428087697275719,1183837051,1197364237.4,47.04562125540687,29.820671678320185,NaN,NaN,6.922468360635513,3.8522456304971877
2019-10-21T09:30:00-04:00,81.39,81.82,81.1,81.78,6345480,11429408.6,55.6508023118529,52.00932598942113,NaN,NaN,84.658672195704,112.1190018777971,0.1377159628064779,0.41495372323566926,0.27723776042919135,1190182531,1195113523.8,44.34874509327604,31.652499231411717,NaN,NaN,7.5983869923787015,4.387408682194547
2019-10-22T09:30:00-04:00,81.94,82.23,80.62,80.68,9235221,11004619.5,49.99355425788962,52.67519487018096,NaN,NaN,47.860083685092654,84.82821856712539,0.057646438494881935,0.34929580854779374,0.2916493700529118,1180947310,1189391965.4,38.33295254449571,33.234631342134904,NaN,NaN,6.442801378805756,4.681036210281863
2019-10-23T09:30:00-04:00,80.43,80.76,80.26,80.75,8953875,10854140.6,50.3395213024684,52.985325063193294,NaN,NaN,-0.16294946613701541,59.86661444927927,0.006246815130143524,0.2994578889655912,0.2932110738354477,1189901185,1187486288.6,36.554384102835414,34.788423572173436,NaN,NaN,5.615351880204425,4.814509877413657
2019-10-24T09:30:00-04:00,81.61,82,81.305,81.93,7308684,10763729.25,55.880743662627246,53.24167251243723,NaN,NaN,82.73171319572322,52.351478473900826,0.046334752523560285,0.35112951448989804,0.30479476196633776,1197209869,1188415589.2,38.063547595484614,36.14275700988063,NaN,NaN,6.563263160324668,5.0643317749723735
2019-10-25T09:30:00-04:00,81.93,83.02,81.88,82.92,8152726,10532250.4,59.92134231641633,53.9044768713755,NaN,NaN,128.6005366967903,68.73761126143464,0.12943288227233762,0.4665858648067598,0.33715298253442216,1205362595,1192720698,44.63393434511251,38.068026917636494,NaN,NaN,8.646419265003418,5.576058559262522
2019-10-28T09:30:00-04:00,83.65,84.01,83.61,83.97,7229856,10343383.8,63.71678218398595,55.301700696374766,NaN,NaN,182.33707550492176,88.27329192327818,0.2386668821777883,0.6354865852566576,0.39681970307886927,1212592451,1197202682,50.51903169555998,40.5302376640591,NaN,NaN,11.656204561019914,6.444650845227864
2019-10-29T09:30:00-04:00,83.9,84.05,83.18,83.21,7760442,10180276.55,59.336708883333785,55.991459953505135,NaN,NaN,138.65398116116555,106.43207141849275,0.24250217077401953,0.6999474165463937,0.45744524577237416,1204832009,1201979621.8,55.89947320939251,42.91690008897533,NaN,NaN,12.801878344864761,7.352826202318849
2019-10-30T09:30:00-04:00,83.46,83.82,82.9,83.72,12779335,9831214.75,61.26119604651584,56.647263542383165,NaN,NaN,129.29884317357212,132.32442994643458,0.2605702584163415,0.783158068792801,0.5225878103764595,1217611344,1207521653.6,61.17424380665366,45.496777368378346,NaN,NaN,14.33895985795956,8.350845295981808
2019-10-31T09:30:00-04:00,83.85,83.94,83.13,83.67,11230889,9518932.8,60.95660455179776,56.95983510605667,NaN,NaN,128.7698637066614,141.5320600486222,0.25028024569053664,0.8354381174896304,0.5851578717990937,1206380455,1209355770.8,62.761667220456005,47.85392359735474,NaN,NaN,15.485542909603858,9.370087812213528
2019-11-01T09:30:00-04:00,83.95,84.67,83.82,84.67,9920592,9463930.6,64.73329872892046,57.56050025240846,NaN,NaN,156.5871068458254,147.12937407842924,0.2891934522143659,0.9466496870670511,0.6574562348526852,1216301047,1211543461.2,64.61979942344158,49.891565706346,NaN,NaN,17.63136859946426,10.550270781820775
2019-11-04T09:30:00-05:00,85.32,85.37,84.93,85.11,10181562,9441951.25,66.27891996125312,58.019455522736685,NaN,NaN,166.21796116854128,143.90555121115312,0.3205093666387735,1.058092943151152,0.7375835765123786,1226482609,1214321492.8,66.87983305758311,51.21416240368041,NaN,NaN,19.88168353629148,11.883329746745162
2019-11-05T09:30:00-05:00,85.35,85.38,84.72,85.01,7899848,9112875.3,65.57550454276168,58.6515010731698,NaN,NaN,140.29289008916766,144.23333299675355,0.31022976943756897,1.1253707883093398,0.8151410188717708,1218582761,1217071643.2,68.99156325851271,52.363454465907935,NaN,NaN,21.528997123003737,13.261282229067815
2019-11-06T09:30:00-05:00,85,85.045,84.54,84.97,8538613,9025859.95,65.27707499464108,59.325221365651785,NaN,NaN,115.30479007519925,141.43452237707896,0.2775397682913987,1.1620657292360193,0.8845259609446205,1210044148,1215558204,66.4795206029076,53.30745122936559,NaN,NaN,22.811869277294242,14.625651807385875
2019-11-07T09:30:00-05:00,85.54,86.12,85.4,85.64,14042469,9253981.55,67.91129400408623,60.48809626775362,NaN,NaN,138.64012782943655,143.40857520163402,0.27719499603002284,1.231019705982149,0.9538247099521262,1224086617,1219099436.4,69.2965556838647,54.89680368854115,NaN,NaN,24.67506624404026,16.061282441193644
2019-11-08T09:30:00-05:00,85.42,86.12,85.08,86.12,6286580,8768482.5,69.68562760337844,61.49058378857687,NaN,NaN,123.46439475754272,136.78403278397747,0.2843845205419855,1.3093053606296081,1.0249208400876226,1230373197,1221913866.4,71.35682456531316,56.82595222225809,NaN,NaN,26.781451754193252,17.592735200193587
2019-11-11T09:30:00-05:00,85.63,86.28,85.52,86.16,4244082,8697365.4,69.8353150236776,62.907852414704585,NaN,NaN,119.05170651500498,127.3507818532702,0.26719156762567997,1.3589102996197227,1.0917187319940427,1234617279,1223540800.4,72.50537170714169,59.26683930530423,NaN,NaN,28.57448930110943,19.161557214610138
2019-11-12T09:30:00-05:00,86.28,86.77,86.07,86.45,8281547,8705492.6,70.95508674629636,64.38039280354944,NaN,NaN,123.8587206262173,124.06394796068014,0.25096286555081493,1.4054223139325615,1.1544594483817465,1242898826,1228404013.4,75.64868789316454,62.05928957604202,NaN,NaN,30.41866115898793,20.769714920949824
2019-11-13T09:30:00-05:00,86.11,86.72,86.09,86.64,7686192,8583525.55,71.69641813357812,65.51008383718879,NaN,NaN,112.22182553849748,123.44735505333979,0.22923551108520757,1.4410038372382559,1.2117683261530483,1250585018,1236512187.4,79.79596282917127,65.04017637844821,NaN,NaN,32.1936296893235,22.401702745003206
2019-11-14T09:30:00-05:00,86.3,86.61,86.06,86.54,6091442,8544787.5,70.67398952121167,66.27813006610275,NaN,NaN,98.16352201257901,115.35203388996828,0.18617109504506324,1.4444821949593774,1.2583110999143141,1244493576,1240593579.2,81.50360712788695,67.67372443436066,NaN,NaN,33.456680149378535,23.98098523134254
2019-11-15T09:30:00-05:00,87.15,87.24,86.88,87.24,7062496,8461596.55,73.52059026446008,66.9784020718509,NaN,NaN,116.17989364051827,113.89513366656338,0.18262033949694834,1.4865865242854994,1.303966184788551,1251556072,1244830154.2,83.10032740138243,70.00095984191941,NaN,NaN,35.37241714094811,25.608332647000477
2019-11-18T09:30:00-05:00,87.21,87.6286,86.88,87.5,6512351,8469940.1,74.51027904163307,68.0622285117294,NaN,NaN,114.80357042084778,113.04550644773194,0.17552611653782035,1.5233738304608266,1.3478477139230063,1258068423,1249520383,84.67735518945678,72.05652284049543,NaN,NaN,37.2897561172254,27.277107428461182
2019-11-19T09:30:00-05:00,87.85,87.9268,87.35,87.67,7043682,8360363.15,75.16391177970785,69.05527963552883,NaN,NaN,120.02925648306407,112.2796136191013,0.16043915847555712,1.5483966620174527,1.3879575035418956,1265112105,1253963038.8,86.0091532434341,73.83044494312261,NaN,NaN,39.10548866942193,28.966876177169862
2019-11-20T09:30:00-05:00,87.47,87.725,86.4826,87.14,12379895,8531664.15,69.20562071354533,69.64449507565367,NaN,NaN,91.27858963771496,108.09096643894479,0.09609535419924864,1.5080766962909564,1.4119813420917078,1252732210,1254392477.2,86.1346058684363,75.4999405608355,NaN,NaN,39.15577698470021,30.422433435388484
2019-11-21T09:30:00-05:00,86.97,87.07,86.52,86.7,9377772,8635118.55,64.62549189640812,69.63679458761706,NaN,NaN,68.30439271880924,102.11914058019083,0.009775890516208863,1.4242012052369688,1.41442531472076,1243354438,1254164649.6,85.69558582556849,77.00535387527313,NaN,NaN,37.94859794077708,31.49759979330114
2019-11-22T09:30:00-05:00,86.95,87.09,86.245,86.59,5890416,8522003.05,63.494147799365145,69.43788229033935,NaN,NaN,56.89765642088716,90.2626931362646,-0.06475493399340215,1.3334816472290072,1.3982365812224093,1237464022,1251346239.6,80.24659813479863,77.96012280935996,NaN,NaN,36.62568378200125,32.2301832202583
2019-11-25T09:30:00-05:00,86.98,87.85,86.9501,87.85,7369881,8529004.3,69.97750780206772,69.75231109457549,NaN,NaN,101.68115884945071,87.6382108219852,-0.04041204985251445,1.3477215189067664,1.3881335687592808,1244833903,1248699335.6,75.39779320899031,78.4177106629655,NaN,NaN,37.228119148783925,32.94417406719053
2019-11-26T09:30:00-05:00,87.9,88.15,87.76,87.93,9727323,8627348.35,70.33771007337174,70.11378502877054,NaN,NaN,117.23580894232133,87.07952131383664,-0.03058587091162046,1.3499012301197553,1.3804871010313757,1254561226,1246589159.8,71.67930019806725,78.78912349119119,NaN,NaN,37.822685986723926,33.64110434140959
2019-11-27T09:30:00-05:00,88.2,88.42,87.935,88.42,9349030,8455833.1,72.51300313994449,70.4424785384747,NaN,NaN,130.04197645477026,94.8321986772477,-0.004138632539910203,1.375313810356488,1.3794524428963981,1263910256,1248824769,73.18798896757912,79.0670830114565,NaN,NaN,38.96679154529053,34.401916799106864
2019-11-29T09:30:00-05:00,88.19,88.328,88.01,88.16,5680094,8178293.35,69.59649998304381,70.43611227987937,NaN,NaN,118.38219478782898,104.84775909105164,-0.016513859140369513,1.3588101189709363,1.3753239781113058,1258230162,1251799913.8,75.0898098939953,79.33372482064807,NaN,NaN,39.101641028601385,35.07330597474894
2019-12-02T09:30:00-05:00,88.2,88.2,86.52,86.9,11587418,8261634.65,57.5221548316128,69.55660083758903,NaN,NaN,42.277441748870345,101.92371615664828,-0.11635355023401694,1.2298820403187847,1.3462355905528016,1246642744,1253635658.2,76.21106397936894,79.59841712580716,NaN,NaN,35.36731677546297,35.11530751770809
2019-12-03T09:30:00-05:00,85.53,86.19,85.16,86.13,11250999,8315106.5,51.62745412191881,68.17605565013348,NaN,NaN,-74.07467748347763,66.77254889006261,-0.23424466307181446,1.0534297617130335,1.287674424784848,1235391745,1251747226.6,72.59125993268947,79.38002941434466,NaN,NaN,30.190412155145463,34.411751037342
2019-12-04T09:30:00-05:00,86.69,86.76,86.35,86.48,6915096,8265868.9,53.9380851636394,66.90760329513786,NaN,NaN,-23.69435218083067,38.58651666543221,-0.2852603359581578,0.9310990048371508,1.2163593407953086,1242306841,1249296349.6,68.0722618394542,78.54262220079343,NaN,NaN,26.6777912078006,33.3068996331218
2019-12-05T09:30:00-05:00,86.79,86.87,86.3901,86.8,7810387,8229457.6,56.00717854619713,65.85997393977968,NaN,NaN,-20.004256812972777,8.577270011883606,-0.2929498167100302,0.8501720699077708,1.143121886617801,1250117228,1246537744,63.296012856864536,77.24207975286326,NaN,NaN,24.41529106266416,32.03666983734214
2019-12-06T09:30:00-05:00,87.46,87.84,87.39,87.76,9205570,7987612.65,61.58253620373844,65.00725579258527,NaN,NaN,73.30076613010908,-0.4390157196603752,-0.2315691875793353,0.8536604021436318,1.0852295897229671,1259322798,1246756271.2,63.5144058852406,75.84308535885313,NaN,NaN,24.196303267044602,30.916617470156776
2019-12-09T09:30:00-05:00,87.61,87.89,87.3,87.3,5803432,7963455.25,57.80239492606634,63.81383549861623,NaN,NaN,49.71176545663901,1.0478490218933572,-0.22020771529130045,0.8099699456088416,1.030177660900142,1253519366,1248131595.6,64.92876882695236,74.43247204724568,NaN,NaN,22.807449867146513,29.758164955441025
2019-12-10T09:30:00-05:00,87.44,87.83,87.15,87.37,6177498,8060126.05,58.22265313773353,62.603745595618065,NaN,NaN,39.02447112564635,23.66767874371816,-0.2064676088814894,0.7720931497982804,0.9785607586797698,1259696864,1252992619.4,69.43823524850625,73.24883504760797,NaN,NaN,21.825686869924926,28.624953800367297
2019-12-11T09:30:00-05:00,87.6,88.035,87.42,87.96,4939468,7893022.1,61.686208920438474,62.066644753253286,NaN,NaN,75.85852782144353,43.578254744173,-0.1583011331384514,0.7806843422567056,0.938985475395157,1264636332,1257458517.6,72.88737976560154,72.30260461169121,NaN,NaN,22.03380992586097,27.683361818294966
2019-12-12T09:30:00-05:00,87.71,89.03,87.5,88.9,12097367,8113580.85,66.45751319903863,62.1975034177269,NaN,NaN,143.44544604696733,76.26819531616101,-0.0683848596571126,0.8535044008237662,0.9218892604808788,1276733699,1262781811.8,76.31824169265036,71.63279431648277,NaN,NaN,23.75944460231271,27.122802216011785
2019-12-13T09:30:00-05:00,88.81,89.69,88.64,89.49,13172979,8467657.7,69.06178374426122,62.595191699505186,NaN,NaN,209.58588177745392,103.52521844562997,0.0208054991749258,0.947896134449536,0.9270906352746102,1289906678,1268898587.8,79.52446520473774,71.581213392907,NaN,NaN,26.0560620365705,26.970410761805887
2019-12-16T09:30:00-05:00,90.17,90.6,90.15,90.29,9873486,8608207.2,72.21219820764787,62.75481244276091,NaN,NaN,257.01678074329595,144.98622150296137,0.1182196522386102,1.074865200572873,0.9566455483342627,1299780164,1278150747.4,83.22418407528599,72.14024131192812,NaN,NaN,29.075350369934828,27.271116420110022
2019-12-17T09:30:00-05:00,90.45,90.49,89.96,90.08,7459673,8655573.3,70.19163802563627,62.74437872506552,NaN,NaN,191.61778525045423,175.50488432792295,0.15095642237579532,1.1453410763040068,0.9943846539282115,1292320491,1284675472.8,85.24848020002226,73.10946845492491,NaN,NaN,30.864985772637226,27.784526327613907
2019-12-18T09:30:00-05:00,90.19,90.42,90.04,90.07,6485833,8627680.85,70.09106320626333,62.571383015516865,NaN,NaN,156.41061579850418,191.61530192333507,0.1538580188598273,1.1867071775029956,1.0328491586431683,1285834658,1288915138,86.39709903830499,74.0529763171196,NaN,NaN,32.26211993985614,28.424182557934227
2019-12-19T09:30:00-05:00,90.13,90.73,90.1,90.72,6862859,8351829.05,72.8174765304999,62.801452768906586,NaN,NaN,149.5155603305733,192.82932478005628,0.17967638459146418,1.2574446393824985,1.0777682547910343,1292697517,1292107901.6,87.20507212511282,74.91835219077086,NaN,NaN,34.312127212549655,29.265317508593572
2019-12-20T09:30:00-05:00,90.96,91.06,90.72,90.95,11707905,8468335.7,73.73001200730491,63.95915685288459,NaN,NaN,146.35063335659714,180.1822750958849,0.19129215829274604,1.3168834526569668,1.1255912943642208,1304405422,1295007650.4,87.90758868653162,75.75381824128249,NaN,NaN,36.27893071852343,30.267262252869266
2019-12-23T09:30:00-05:00,91.23,91.44,91.1,91.21,7765182,8562074,74.76147614221412,65.6115869971914,NaN,NaN,139.0817600854756,156.59527096432083,0.19487564079909658,1.3691858453630914,1.1743102045639948,1312170604,1297485738.4,88.48924132750572,76.8893883409122,NaN,NaN,38.22882089293478,31.404627772878623
2019-12-24T09:30:00-05:00,91.37,91.37,91.03,91.24,2445364,8315848.15,74.88401590826155,67.10772490752154,NaN,NaN,116.88581239643229,141.64887639351645,0.17811456303866136,1.3969534083623216,1.2188388453236603,1314615968,1301944833.8,89.47068552735684,78.4178471757624,NaN,NaN,39.86608774613652,32.61340776905832
2019-12-26T09:30:00-05:00,91.43,91.94,91.37,91.92,4134648,8036214.4,77.5453079822818,68.64616272438475,NaN,NaN,121.11203954725059,134.58916114326576,0.19055607479865522,1.4570339388219793,1.266477864023324,1318750616,1308528025.4,90.72765737134476,80.37725035536813,NaN,NaN,42.120256461937174,33.97152901089816
2019-12-27T09:30:00-05:00,92.29,92.29,91.68,91.91,9666200,8052072.9,77.41539712226117,69.77708136142208,NaN,NaN,113.49949907680191,127.38594889251146,0.17618049544261538,1.4867034833265933,1.310522987883978,1309084416,1311805405.2,91.2854169373567,82.36089400194786,NaN,NaN,43.93321143554807,35.39462650013386
2019-12-30T09:30:00-05:00,91.89,91.9,90.675,91.38,8304189,8183277.65,70.65896018233697,70.6954074511557,NaN,NaN,79.87023560260317,114.08986934171267,0.11216333836084114,1.4507271608350294,1.3385638224741883,1300780227,1311080366.2,89.99568772954065,84.1513882092756,NaN,NaN,43.652070062991456,36.5742612948278
2019-12-31T09:30:00-05:00,91.07,91.77,90.95,91.67,5801615,7893987.5,72.09409689800846,71.68622486260391,NaN,NaN,77.97810567085138,101.86913845878783,0.07246252862937341,1.4291419832609051,1.3566794546315317,1306581842,1309962613.8,87.93307209960038,85.47244798435374,NaN,NaN,43.807841543419514,37.60762990176947
2020-01-02T09:30:00-05:00,92.5,93.39,92.32,93.39,13288838,7995879.45,78.73699450549395,72.9041381186793,NaN,NaN,129.2086332266379,104.33370262482894,0.14117801887858872,1.5331519782297676,1.3919739593511788,1319870680,1311013556.2,88.2067551525706,86.56668908342296,NaN,NaN,46.17689192043836,38.83181019015074
2020-01-03T09:30:00-05:00,92.03,92.98,92.02,92.34,15012379,8400743.6,68.0822951437787,73.020193971875,NaN,NaN,101.28873272880453,100.36904126113974,0.09714786399976938,1.5134087893508905,1.4162609253511211,1304858301,1308235093.2,82.85634186037296,87.03369623826029,NaN,NaN,44.499062011243936,39.64141759316406
2020-01-06T09:30:00-05:00,91.42,92.66,91.25,92.56,7815550,8401001.75,69.02798745563236,73.01777995125866,NaN,NaN,84.91619239446965,94.65237992467328,0.0655860698913473,1.4982435127153053,1.432657442823958,1312673851,1308952980.2,83.14089034312669,87.29201231957379,NaN,NaN,43.49544138171355,40.1919924200997
2020-01-07T09:30:00-05:00,92.72,92.975,92.38,92.52,7712131,8326329.8,68.6298315783034,72.7618966205912,NaN,NaN,99.5956490944454,98.59746262304174,0.026751647649491783,1.4660970023858226,1.4393453547363309,1304961720,1309789278.8,83.4847861978526,87.31062675689996,NaN,NaN,42.5847010836806,40.5338079434684
2020-01-08T09:30:00-05:00,92.62,93.92,92.45,93.51,11633365,8617826.45,72.8100269757416,72.94892440274158,NaN,NaN,125.28681888631992,108.05920526613545,0.05106586888847575,1.5031776908469254,1.4521118219584497,1316595085,1311791927.4,84.31013870469806,87.2436023643768,NaN,NaN,43.127181959693296,40.904289945786246
2020-01-09T09:30:00-05:00,94.37,94.63,93.89,94.57,7777728,8697837.95,76.43136826920832,73.40180333580908,NaN,NaN,172.04197840731578,116.62587430227101,0.11803669183651988,1.5996576867540995,1.4816209949175796,1324372813,1312692354,84.68083530900269,87.12101209799808,NaN,NaN,44.84461666734491,41.46719376315177
2020-01-10T09:30:00-05:00,94.98,95.105,94.19,94.35,7666025,8834165.8,74.22186799689285,73.50211701197999,NaN,NaN,164.54692723951223,129.27751320441257,0.1262774859534468,1.6394678523593882,1.5131903664059414,1316706788,1315062051.4,85.64225912004183,87.00938259763586,NaN,NaN,45.47987148966512,42.04043343836796
2020-01-13T09:30:00-05:00,94.78,95.64,94.73,95.53,7762948,8617444.85,77.91040531801418,73.80071653417352,NaN,NaN,179.94817725763386,148.28391017704539,0.18633235715481833,1.7461058128494642,1.5597734556946459,1324469736,1317421228.4,86.54744326420152,86.91222935318372,NaN,NaN,47.3114295703463,42.793432885793436
2020-01-14T09:30:00-05:00,95.65,95.74,94.925,95.08,8068835,8362237.65,73.58612477898161,73.7167628653712,NaN,NaN,153.46929857732118,159.05864007362055,0.17126763132698142,1.7738579948533726,1.6025903635263912,1316400901,1319709064.6,87.37846447015465,86.83288814908721,NaN,NaN,47.34235864929893,43.443279423437076
2020-01-15T09:30:00-05:00,95.14,95.65,94.865,95.19,7208606,8228993.65,73.96650310250433,73.65122623638854,NaN,NaN,132.148334361016,160.43094316855976,0.1452566533730626,1.7841611802427195,1.638904526869657,1323609507,1321111949,87.87315844290625,86.71877907162643,NaN,NaN,47.485164191397466,44.0206915331457
2020-01-16T09:30:00-05:00,95.8,96.49,95.665,96.47,5771568,8144588.4,77.94634781465818,73.67987193870114,NaN,NaN,151.40038238685167,156.30262396446696,0.1880839124673419,1.8740094174538342,1.6859255049864923,1329381075,1322113601.4,88.22793658193643,86.5402275866687,NaN,NaN,48.949931100638615,44.72486861421612
2020-01-17T09:30:00-05:00,96.92,97.21,96.4,97.12,10830761,8361834.8,79.64784809481326,73.83933272245486,NaN,NaN,155.31134042956475,154.45550660247744,0.2311787597476329,1.9748989546710334,1.7437201949234005,1340211836,1326814611,89.74439108381033,86.43015431141541,NaN,NaN,50.72807153125727,45.58246903093629
2020-01-21T09:30:00-05:00,96.82,97.64,96.8,97.08,8987526,8468068.15,79.24267374596975,74.4524551198572,NaN,NaN,141.9566313666153,146.85719742427375,0.2276211318232848,2.0282466097025065,1.8006254778792217,1331224310,1328165525.8,90.13756304309524,86.44028826238359,NaN,NaN,51.99006254430705,46.4978395328464
2020-01-22T09:30:00-05:00,97.69,98.11,97.35,97.43,7745908,8269968.3,80.19217892297554,75.030889550212,NaN,NaN,137.28339062333808,143.62001583347714,0.21937922727023595,2.0748495119670167,1.8554702846967808,1338970218,1332679389.2,91.33316532099307,86.68315206391163,NaN,NaN,53.321456605289,47.47264197176677
2020-01-23T09:30:00-05:00,97.53,97.97,97.1125,97.89,7478243,8255621.35,81.3966374384227,75.2208640454212,NaN,NaN,122.36625734116296,141.66360042950652,0.21515329651676707,2.1244119053427397,1.9092586088259726,1346448461,1337247180,92.34454860996478,86.97870873943978,NaN,NaN,54.80816195319844,48.52057339768558
2020-01-24T09:30:00-05:00,98.61,98.83,97.09,97.43,11808677,8723787,76.39399949413396,75.8145572133037,NaN,NaN,114.64788931543194,134.31310181522258,0.1544634020155793,2.102337861345447,1.9478744593298676,1334639784,1338298921.8,92.55983927106739,87.67181569734653,NaN,NaN,54.57093145171395,49.384910262546775
2020-01-27T09:30:00-05:00,95.16,95.86,94.71,95.11,17787340,9406421.6,57.27475637269404,74.97504070737955,NaN,NaN,23.234746731842094,107.89778307567806,-0.05748845455765417,1.8760138911328,1.933502345690454,1316852444,1333627043.4,81.58425119783774,87.56062718696874,NaN,NaN,47.44030138046694,49.107108993678224
2020-01-28T09:30:00-05:00,95.94,97.19,95.74,96.93,15592195,9702721.35,64.73174537155558,74.69660597832613,NaN,NaN,66.73880258981706,92.85421732031841,-0.08880135594926997,1.8225006507538666,1.9113020067031365,1332444639,1333871109.2,81.70629255189286,87.43359192654304,NaN,NaN,43.99226567742417,48.37641709135622
2020-01-29T09:30:00-05:00,97.73,97.87,96.785,97.18,10565002,9815762,65.61940336383438,74.18299000604704,NaN,NaN,85.28019770178227,82.45357873600724,-0.10524312169895733,1.7797481045794399,1.8849912262783972,1343009641,1334678993.8,82.12848084962134,87.277759222609,NaN,NaN,41.71798878622919,47.42521304776664
2020-01-30T09:30:00-05:00,97.14,98.11,96.55,98.02,9966782,10024020.35,68.48916346744463,73.6156896630639,NaN,NaN,88.89706206114063,75.75973968000278,-0.07360975118545743,1.7929790372965755,1.866588788482033,1352976423,1335984586.2,82.81857234705932,87.14474043961305,NaN,NaN,40.87254496764749,46.48911760774962
2020-01-31T09:30:00-05:00,97.45,97.5,94.99,95.33,13482334,10033695.15,53.18036309144459,72.11272502696046,NaN,NaN,16.702857718771803,56.17073336067075,-0.23861067195001562,1.5683254485445133,1.806936120494529,1339494089,1336955447.2,83.33393437786987,86.97986010088648,NaN,NaN,33.99764498650262,44.70462151900005
2020-02-03T09:30:00-05:00,95.44,96.825,95.33,96.59,12542833,9910217.85,57.924444227385955,70.68515637762988,NaN,NaN,24.13701537414524,56.351187089131386,-0.26558492206370543,1.474954967914897,1.7405398899786024,1352036922,1343992342.8,86.49572543076097,86.97616596992644,NaN,NaN,30.41327113982914,42.66300003626135
2020-02-04T09:30:00-05:00,98.27,99.33,98.025,99.12,9548876,9996884.15,65.48661216491433,70.10661976233936,NaN,NaN,140.86756744314954,71.17694005979789,-0.12297893946249272,1.5868162156504866,1.7097951551129793,1361585798,1349820574.6,88.45014192036898,87.05271435922747,NaN,NaN,30.47714972291118,40.92216427721133
2020-02-05T09:30:00-05:00,100.75,100.8,98.98,99.7,16348539,10428704.55,66.95297350104238,69.60565336223495,NaN,NaN,175.8308157099695,89.28706366143533,-0.005723144129099023,1.7026412249516056,1.7083643690807047,1377934337,1356805513.8,90.26799464449381,87.22377408791229,NaN,NaN,31.087540463675474,39.51721801813478
2020-02-06T09:30:00-05:00,100.11,100.64,99.66,100.61,6752848,10184678.7,69.16645050329456,68.97851783999468,NaN,NaN,179.88743284952903,107.48513781911302,0.11056977565511406,1.8465765886495973,1.7360068129944832,1384687185,1363147666.2,91.565994526618,87.4622067982467,NaN,NaN,32.378328758676986,38.49737669535509
2020-02-07T09:30:00-05:00,100.14,100.53,99.485,99.69,8298964,10210740.5,64.46534442318688,67.89405329202137,NaN,NaN,142.65973644143324,132.6765135636453,0.10312458100808519,1.8649125392545898,1.7617879582465046,1376388221,1370526492.6,92.77361081825703,87.67857963642146,NaN,NaN,31.73704687646118,37.531615292655964
2020-02-10T09:30:00-05:00,99.11,101.06,99.09,101.04,8173756,10236127.05,67.91185630746956,67.08470918927136,NaN,NaN,148.5524437492275,157.55959923866175,0.1631440779331994,1.9657180556630038,1.8025739777298044,1384561977,1377031503.6,93.63839407655027,87.92863899595397,NaN,NaN,32.431506336129885,36.80302829886652
2020-02-11T09:30:00-05:00,101.81,101.9,100.395,100.7,7552887,10225624,66.1711473391469,66.0832069332836,NaN,NaN,153.969165948483,160.17991893972845,0.15407912511502886,1.9951728841235905,1.8410937590085616,1377009090,1380116162,94.00477681644816,88.11946838848647,NaN,NaN,32.3926911644027,36.17298013680026
2020-02-12T09:30:00-05:00,101.39,101.83,100.82,101.79,6076388,10126001.65,68.92140979032688,65.1921192441339,NaN,NaN,146.56260490970928,154.3262767796764,0.19309665915792218,2.0824645829559643,1.889367923798042,1383085478,1381146390.2,94.12644590550674,88.24674676673946,NaN,NaN,33.27134371193268,35.75846064753347
2020-02-13T09:30:00-05:00,100.99,102.05,100.84,101.52,7401430,10135642.85,67.45840783262943,64.55386269688357,NaN,NaN,125.22024275646031,143.39283876106265,0.1729738717071474,2.1055852634319763,1.9326113917248289,1375684048,1379345762.8,90.66321751357617,88.11127378406151,NaN,NaN,33.51135033223881,35.43744488820566
2020-02-14T09:30:00-05:00,101.72,102.13,101.395,101.96,6196234,10156876.15,68.62714898890465,65.36474788375577,NaN,NaN,120.94958292849323,139.05080805847464,0.1617542451199634,2.134804198124783,1.9730499530048198,1381880282,1380444175,90.88357123637682,88.77551092967144,NaN,NaN,34.06065626489673,35.24076079916153
2020-02-18T09:30:00-05:00,101.14,101.8,101.03,101.58,10318287,10131252.45,66.40884495044466,65.48454071081927,NaN,NaN,95.91386343877413,128.52309199638398,0.10400394366981636,2.1030548825920903,1.999050938922274,1371561995,1377844178.6,85.72619538350963,89.06264684621549,NaN,NaN,33.868072696073845,35.04466249872043
2020-02-19T09:30:00-05:00,102.24,102.94,102.17,102.79,8307784,10097265.35,69.76068661848406,65.78034665757995,NaN,NaN,120.70591045447179,121.87044089758174,0.12134952233902219,2.150737841846052,2.0293883195070297,1379869779,1378416316.4,85.9156016211922,89.33315547275627,NaN,NaN,34.70864622667082,34.996660174141915
2020-02-20T09:30:00-05:00,102.57,102.815,100.33,101.72,13162328,10368086.35,63.70688711284017,65.43875548939393,NaN,NaN,78.3839152791195,108.23470297146378,0.03907360630986867,2.0782303273943654,2.0391567210844967,1366707451,1375140711,79.41805510818115,89.09026138426498,NaN,NaN,33.58431704863801,34.7948968704985
2020-02-21T09:30:00-05:00,101.2,101.29,98.82,99.44,14949541,10741651.25,53.12725803133127,65.4349622708144,NaN,NaN,16.712717454106315,86.53319791099298,-0.17863852300633987,1.815858567326572,1.9944970903329118,1351757910,1370355483.4,70.97363008328921,88.20738250608065,NaN,NaN,28.992402372580152,33.96596908508159
2020-02-24T09:30:00-05:00,94.67,96.71,93.8,95.33,21182625,11210348.65,40.175313190511794,64.16716719675196,NaN,NaN,-126.09849993362643,37.12358133856906,-0.5862057888619332,1.2617398542554952,1.8479456431174284,1330575285,1360094484,56.982208030435956,86.09927412034314,NaN,NaN,19.455016298878277,31.892975829909687
2020-02-25T09:30:00-05:00,96.19,96.54,91.94,92.28,31467190,11894341.15,33.624236081068474,61.89128319076297,NaN,NaN,-169.4661250323319,-15.95241635565213,-1.022422421429304,0.5699176163307982,1.5923400377601022,1299108095,1345603704,43.83874668121641,82.9127458889751,NaN,NaN,8.750649235817983,28.586929173610873
2020-02-26T09:30:00-05:00,92.63,94.7086,92.001,92.7,27879788,12508720.8,35.19142040139862,59.62260082650271,NaN,NaN,-162.37316874924693,-72.56823219639588,-1.229951124367636,0.054901132300557265,1.2848522566681932,1326987883,1335027324.8,37.11056147984139,79.1157863772142,NaN,NaN,1.5082709713907967,24.718549430436575
2020-02-27T09:30:00-05:00,89.66,91.56,87.64,87.7,33912921,13676116.75,27.014166031860384,56.6117233642574,NaN,NaN,-218.8298761707074,-132.01099048636127,-1.6263520963887388,-0.7480878638177302,0.8782642325710086,1293074962,1320300827,30.167821445574404,74.7302025857111,NaN,NaN,-8.572616263817977,19.96266861697164
2020-02-28T09:30:00-05:00,84.21,89.205,84.06,88.37,55929513,15974253.3,29.382128509200385,54.10577937040123,NaN,NaN,-200.84651968111834,-175.5228379134062,-1.7548016143810936,-1.3152377854053583,0.43956382897573526,1349004475,1319750140,29.94223777236111,70.24224736814709,NaN,NaN,-14.983441214525314,14.970367212472077
2020-03-02T09:30:00-05:00,89.96,93.5,88.38,93.48,35004311,17050352.15,44.240896587379396,52.41499653325193,NaN,NaN,-104.37467315088213,-171.17807255685733,-1.4212208408951366,-1.3369622221431854,0.08425861875195112,1384008786,1330436840.2,39.41076946944745,66.36884561049689,NaN,NaN,-14.398366238115964,10.774833862388071
2020-03-03T09:30:00-05:00,94.01,94.66,88.98,89.93,47494582,18797939.6,38.22371388046264,50.418751286203054,NaN,NaN,-101.65752598017308,-157.61635274642555,-1.3649570059681464,-1.621937638708232,-0.25698063274008554,1336514204,1337918062,45.01345675259427,62.86946560593589,NaN,NaN,-16.447211985509085,6.885970169831335
2020-03-04T09:30:00-05:00,91.87,93.82,90.6,93.79,22363837,19438687.65,46.71069051670896,48.83227133808749,NaN,NaN,-68.31276573348028,-138.80427214327224,-1.0094595967985662,-1.5188051287382933,-0.5093455319397271,1358878041,1344296093.6,49.31641462706861,59.668749086047455,NaN,NaN,-14.479157333078813,3.8338090979870283
2020-03-05T09:30:00-05:00,91.29,93.0301,90.24,90.83,24509510,19846736.2,41.9511584351001,47.01032495254968,NaN,NaN,-78.79285289854107,-110.79686748883896,-0.9179798466543861,-1.6568203402577097,-0.7388404936033236,1334368531,1352554807.4,54.303057350071626,57.07159478865428,NaN,NaN,-14.901596863397096,1.1573225320750105
2020-03-06T09:30:00-05:00,87.79,89.44,86.49,88.91,28815932,20949890.4,39.163595217512594,44.905785397450245,NaN,NaN,-108.44570049986628,-92.31670365258856,-0.9283141378518477,-1.8992331659181332,-0.9709190280662855,1305552599,1343864432.2,48.855913363712844,54.06961922632114,NaN,NaN,-16.29308943744057,-1.3355934635700724
2020-03-09T09:30:00-04:00,81.58,86,81.5006,82.16,29559872,22012935.8,31.291441510963054,42.397399437487266,NaN,NaN,-153.76145706032,-102.19406043447614,-1.3080452576158266,-2.6059756000860688,-1.2979303424702422,1275992727,1322261220.4,38.51349719220662,50.69728364122806,NaN,NaN,-20.79251198788033,-4.115153252757253
2020-03-10T09:30:00-04:00,85.68,87.65,82.62,87.64,35582326,23383364.3,41.5614723259067,40.38316984516032,NaN,NaN,-107.24514795283893,-103.3115848290093,-1.1159296921230601,-2.6928424576240673,-1.5769127655010071,1311575053,1317273390.2,36.58766860262113,47.17385985418728,NaN,NaN,-20.039960897475424,-6.3901257734312775
2020-03-11T09:30:00-04:00,85.29,85.82,82.31,83.5,31673415,24589390.7,37.05522679560707,38.47947982250081,NaN,NaN,-121.19928699116228,-113.88888908054568,-1.1868452146499062,-3.06046928381339,-1.8736240691634838,1279901638,1301478109.6,31.257307751799075,43.73380647158855,NaN,NaN,-21.315234769699263,-8.52228420146956
2020-03-12T09:30:00-04:00,77.44,81.9,75,75.35,32745333,25922837.95,30.129597933990723,36.8367898155479,NaN,NaN,-177.59731579237408,-133.64978165931228,-1.67210979010581,-3.963761306795746,-2.291651516689936,1247156305,1284035664.4,26.64152228391292,40.56722734306168,NaN,NaN,-25.38597381739431,-10.931382718030239
2020-03-13T09:30:00-04:00,80.09,84.38,76.295,84.19,32924833,27199008.1,42.650099977934445,37.01356030036381,NaN,NaN,-116.49241202853,-135.25912396504503,-1.303568769048686,-3.9211124780007935,-2.6175437089521076,1280081138,1278941372.2,25.459033247240455,38.31557200140486,NaN,NaN,-23.04496296221922,-12.661894181485808
2020-03-16T09:30:00-04:00,71.72,79.21,71.19,72.56,40622419,28920317.35,34.01430638656002,37.041422465041784,NaN,NaN,-172.66699736554568,-139.04023202609017,-1.7225749518073412,-4.770762398711284,-3.0481874469039427,1239458719,1271634570.6,23.825569418308163,36.88605933976856,NaN,NaN,-25.19567964826207,-14.452434962453845
2020-03-17T09:30:00-04:00,74.27,78.44,71.94,77.5,50407288,30924767.4,39.60793935090983,37.35688810429259,NaN,NaN,-137.62971018526676,-145.11714447257572,-1.551850681902939,-4.9880007992826165,-3.4361501173796776,1289866007,1267292761.4,22.885923652101923,35.87001378064431,NaN,NaN,-24.27051068689253,-15.855017208802227
2020-03-18T09:30:00-04:00,72.35,75.8216,70.27,74.58,53706206,33194688.5,37.58005945998456,38.111594777730026,NaN,NaN,-143.9894251591574,-149.67517210617476,-1.518514293579305,-5.334292984353809,-3.8157786907745037,1236159801,1258544394,21.081787664331685,35.221011367698395,NaN,NaN,-24.42232222642977,-17.078917925606163
2020-03-19T09:30:00-04:00,73.89,77.39,72.12,74.85,61727056,35622924.9,37.89668094948698,38.71977709489335,NaN,NaN,-116.89649869631951,-137.53500868696383,-1.3659981675293382,-5.523276400186177,-4.1572782326568385,1297886857,1268690504.4,28.155562431104983,35.093391700465816,NaN,NaN,-24.416316735130543,-18.12711775553822
2020-03-20T09:30:00-04:00,76.26,77.04,71.18,71.42,45221994,37136547.55,35.437475289675476,38.0909612879145,NaN,NaN,-117.97351210558986,-137.8312287023758,-1.379789608104736,-5.882015242787759,-4.502225634683023,1252664863,1263207249.4,26.75958955663907,34.189735992408075,NaN,NaN,-25.272466196076728,-19.147881818472293
2020-03-23T09:30:00-04:00,70.69,72.22,68.1,70.4,42479164,38201374.5,34.71601199769431,37.84041115343104,NaN,NaN,-130.690536786757,-129.43593658661808,-1.3401510500035263,-6.177414447187431,-4.8372633971839045,1210185699,1257352645.4,25.316289618983404,32.782795482864444,NaN,NaN,-26.170064192143528,-20.151050728996754
2020-03-24T09:30:00-04:00,74.66,77.67,74.36,77.61,37664515,38511240.75,43.476010799683635,37.60936260221495,NaN,NaN,-61.67751906171454,-114.24549836190764,-0.7408276740111654,-5.763297989697861,-5.022470315686696,1247850214,1248949486.8,23.368103969715847,30.929344721624968,NaN,NaN,-23.948591646845742,-20.693556574403754
2020-03-25T09:30:00-04:00,78.2,81.09,76.02,77.51,28740430,38554272.85,43.38904931942496,37.712069093952444,NaN,NaN,-39.5333857574394,-93.35429048156404,-0.2869408451498492,-5.381146372124007,-5.094205526974158,1219109784,1245539483.4,22.60780294027525,28.665397978068086,NaN,NaN,-22.270472080370496,-20.91883021811329
2020-03-26T09:30:00-04:00,78.49,82.51,78.3,82.31,28212927,38269273.15,48.69388888294624,38.39280435576914,NaN,NaN,-6.420181138034006,-71.25902696990694,0.365356224897341,-4.637510245852482,-5.002866470749823,1247322711,1235426654.2,20.479719510078198,26.638526988522756,NaN,NaN,-19.127684494544187,-20.66295225760342
2020-03-27T09:30:00-04:00,79.76,81.26,78.25,78.59,29242721,36934933.55,45.16181651202062,39.38354542727324,NaN,NaN,-21.136677818507977,-51.891660112490584,0.5632592835260315,-4.298792366342283,-4.862051649868315,1218079990,1228509679.6,19.15181049606923,25.255549367370083,NaN,NaN,-17.623435875074065,-20.228735631527798
2020-03-30T09:30:00-04:00,79.64,82.09,79.39,81.9,23740069,36371721.45,48.725708540190354,39.89527658543636,NaN,NaN,5.299457846157813,-24.69366118590762,0.913336968315237,-3.720380439474269,-4.633717407789506,1241820059,1234836551.6,24.005626449231613,24.356832070699404,NaN,NaN,-15.249332199191423,-19.517392284051173
2020-03-31T09:30:00-04:00,81.71,83.18,79.95,80.37,20001080,34997046.35,47.19877435127743,40.619815696555676,NaN,NaN,13.303000049476164,-9.69755736366947,1.029483937379486,-3.346862486065149,-4.376346423444635,1221818979,1229630304.6,22.792979153019942,23.752237170786607,NaN,NaN,-13.781050469780512,-18.69791488201251
2020-04-01T09:30:00-04:00,77.59,79.25,75.965,76.54,27492406,35253474.8,43.522030836471984,41.576418046732904,NaN,NaN,-33.85677712329865,-8.56223563684132,0.8437920208591922,-3.321606397370644,-4.165398418229836,1194326573,1224673662.4,21.67059929155576,23.397171242761097,NaN,NaN,-13.63849823869147,-17.97514107582379
2020-04-02T09:30:00-04:00,76.27,78.43,75.96,78.33,22111821,35133590.35,45.65285819011167,41.790900776174134,NaN,NaN,-20.947697120484875,-11.467738833331495,0.8353797135089351,-3.1211737763436673,-3.9565534898526025,1216438394,1218496799,20.32726868317785,23.03061663104234,NaN,NaN,-12.892636209470382,-17.249068952059016
2020-04-03T09:30:00-04:00,77.99,78.83,76.15,77.12,15785970,34482092.25,44.43250097525599,42.53505753250956,NaN,NaN,-17.249849863605952,-10.69037324235109,0.745166826961662,-3.025094956150525,-3.770261783112187,1200652424,1215011285.8,19.589338658546268,22.728028719630775,NaN,NaN,-12.623727208323535,-16.58830584581109
2020-04-06T09:30:00-04:00,80.51,84.245,80,83.7,17993567,33903777,51.953955683539554,43.41691584198311,NaN,NaN,94.75691038421927,7.201117265261192,1.103853245906007,-2.390445225729678,-3.4942984716356853,1218645991,1210376472.2,18.621292216560548,22.423412188520675,NaN,NaN,-10.078121190256711,-15.658279466446178
2020-04-07T09:30:00-04:00,86.65,86.68,82.86,82.95,22149449,33232133.15,51.10484727424389,44.38297211443021,NaN,NaN,132.8524877791931,31.11101481120458,1.2547987375080636,-1.925800049750606,-3.1805987872586696,1196496542,1205311984.8,17.597937723033624,22.17456576414224,NaN,NaN,-8.261644940473035,-14.601617391307158
2020-04-08T09:30:00-04:00,84.04,85.5257,83.25,85.18,13714334,32334179.1,53.536410481958825,45.50009565246391,NaN,NaN,140.70070648880204,66.02251153362472,1.4549401264013078,-1.361923629257035,-2.8168637556583427,1210210876,1208488845.4,20.547589251587468,21.631139108462417,NaN,NaN,-6.023059469162438,-13.376109116715055
2020-04-09T09:30:00-04:00,86.19,86.625,84.595,85.2,19630728,31678448.85,53.558717102554425,46.79447006766956,NaN,NaN,133.9657052514629,97.00519200801428,1.5310716684207906,-0.9030241701323547,-2.4340958385531453,1229841604,1211169487.4,23.050602771615843,21.366211480960754,NaN,NaN,-4.190615161118635,-12.063895694486995
2020-04-13T09:30:00-04:00,84.86,85.51,83.65,85.39,12650785,30664746.45,53.785706529896906,48.15659110568402,NaN,NaN,113.06266151813675,123.06769428436283,1.5328446804684042,-0.5180399879676401,-2.0508846684360442,1242492389,1219537480.4,30.41962789387148,21.73073564345276,NaN,NaN,-2.606197912740817,-10.712796011380398
2020-04-14T09:30:00-04:00,87.29,89.13,86.94,88.97,15889475,29428099.25,57.95558889959775,49.19084668424932,NaN,NaN,153.03379901933846,134.72307201138665,1.7007664795249553,0.07507343097014996,-1.6256930485548053,1258381864,1227484655,36.6267062042424,22.67777866020466,NaN,NaN,-0.034777127890268426,-9.187364742310379
2020-04-15T09:30:00-04:00,87.2,87.74,86.38,87.03,12929050,27554187.35,55.056513069641554,50.02423695212193,NaN,NaN,115.17828021890486,131.188230499329,1.6078744861476342,0.38415005912973754,-1.2237244270178966,1245452814,1237275909.4,43.333806233871364,24.158207466890094,NaN,NaN,1.4070339421423592,-7.673879215959988
2020-04-16T09:30:00-04:00,88.17,88.31,86.65,88.09,11833788,25460566.45,56.34156659848228,50.570499646088784,NaN,NaN,114.04555886779956,125.8572009751285,1.5441673325246463,0.7064847386379114,-0.8376825938867349,1257286602,1246691054.6,48.93087091605562,26.190432567317053,NaN,NaN,2.9746636641573887,-6.152658804514648
2020-04-17T09:30:00-04:00,89.65,89.67,87.97,89.26,14142398,23081333.55,57.776632999528644,51.47155796662508,NaN,NaN,121.78218345277183,123.42049661539029,1.5055927786355443,1.0443083794076955,-0.4612843992278488,1271429000,1255008533.8,53.317581808993495,28.6308448039545,NaN,NaN,4.697090466854284,-4.602694622890516
2020-04-20T09:30:00-04:00,88.05,89.2199,87.71,87.83,10203510,21330409.35,55.38058112460643,51.94690600836908,NaN,NaN,99.83076891468205,120.77411809469936,1.315435516798026,1.1830099967696839,-0.13242552002834224,1261225490,1258755154,55.18497939110469,30.857941442659722,NaN,NaN,5.569349473945385,-3.149545466199673
2020-04-21T09:30:00-04:00,86.59,86.8,83.64,84.15,16382549,20025578.6,49.671717971204224,52.123544838363856,NaN,NaN,37.654302699926475,97.69821883081696,0.8936496209312342,0.9846365061357005,0.09098688520446632,1244842941,1256047369.4,53.518698857360576,33.05263570725548,NaN,NaN,4.79521360962253,-2.0145798839393585
2020-04-22T09:30:00-04:00,86.19,87.87,85.88,87.39,12019067,18743306.2,54.15283686819568,52.88288812634413,NaN,NaN,71.45267160138629,88.95309710731325,0.7883755236420987,1.0764562897570897,0.288080766114991,1256862008,1258329208.2,54.75841033597874,35.41605078185712,NaN,NaN,5.367511656698854,-0.9599953781338997
2020-04-23T09:30:00-04:00,87.59,88.58,86.72,86.79,10584849,17835527.15,53.20803123372643,53.422543343745176,NaN,NaN,71.81754782254116,80.50749489826157,0.6401468356358548,1.0882643106598096,0.4481174750239547,1246277159,1256127319.6,53.28163326565573,37.76993396631983,NaN,NaN,5.583892761280704,-0.02515421536038498
2020-04-24T09:30:00-04:00,87.15,88.6459,86.591,88.63,8442812,16847021.4,55.75729176207677,54.23145697137523,NaN,NaN,77.63300524188148,71.6776592560835,0.6270215106867066,1.231894363382338,0.6048728526956314,1254719971,1252785513.8,51.03217105183054,40.01585056584013,NaN,NaN,6.468474614972333,0.9025070461157176
2020-04-27T09:30:00-04:00,89.43,89.69,88.85,89.39,7799271,15774848.9,56.80409706112369,54.577895641202666,NaN,NaN,99.14990277350249,71.54148602784758,0.6289122217577219,1.3910131298927837,0.7621009081350618,1262519242,1253044264.2,51.203950160263375,42.343183276104625,NaN,NaN,7.4957755423755295,1.844402545581405
2020-04-28T09:30:00-04:00,90.5,90.56,88.08,88.2,12633813,15219536.1,54.62472429663564,54.82931542851636,NaN,NaN,84.18966135524238,80.84855775891076,0.514237716484927,1.4048980537412206,0.8906603372562936,1249885429,1254052761.8,51.91201751889371,44.794188975808915,NaN,NaN,7.80328667762511,2.6956717073019343
2020-04-29T09:30:00-04:00,90.08,92.135,89.76,91.82,11462932,14792628.7,59.69111767310314,55.26893737074096,NaN,NaN,121.89756861152584,90.93753716093867,0.6383047300958757,1.6885412498761383,1.0502365197802626,1261348361,1254950032.4,52.57143902684092,47.08160681689844,NaN,NaN,9.50632769382875,3.6686225625200506
2020-04-30T09:30:00-04:00,92.01,92.01,90.73,91.41,15430638,14189540.3,58.88911716468925,55.64968023232201,NaN,NaN,120.0751139180911,100.58905038004868,0.6468664939059925,1.8588196371627532,1.2119531432567607,1245917723,1254878145.2,52.50931269688736,49.18580038298927,NaN,NaN,10.70727765849622,4.6741447190880745
2020-05-01T09:30:00-04:00,89.4,90.65,88.56,88.9,11995309,13683714.7,54.09714966400648,55.6719261704727,NaN,NaN,70.36317613588868,99.13508455885011,0.4470915494385648,1.7708175800549668,1.323726030616402,1233922414,1250718633.8,48.90784290426405,50.50638716944588,NaN,NaN,10.440240266261707,5.497872654398593
2020-05-04T09:30:00-04:00,88.49,90.17,88.08,90.08,10729034,13430867.9,55.91341079988961,55.52605630620783,NaN,NaN,70.13825437555676,93.33275487926096,0.3616758924856387,1.7758208962234505,1.4141450037378118,1244651448,1247145075,45.98944245099424,51.17515404421386,NaN,NaN,10.708250401621907,6.242212332573352
2020-05-05T09:30:00-04:00,91.11,92.48,90.95,91.32,8687332,12965556.15,57.802904949377755,55.722227154760425,NaN,NaN,137.06771550140718,103.90836570849392,0.3554207786299597,1.8584209770252613,1.5030001983953016,1253338780,1247835745.2,46.65202317698942,51.41216954015086,NaN,NaN,11.45120630389024,6.986354328475764
2020-05-06T09:30:00-04:00,92.2,92.92,91.62,92.03,8470506,12281609,58.88936700119388,55.90421289781125,NaN,NaN,145.8018186785312,108.689215721895,0.36447642532540137,1.9585957300520533,1.594119304726652,1261809286,1247927930.2,46.74592784584655,51.25610217799308,NaN,NaN,12.3711039759551,7.755604278115669
2020-05-07T09:30:00-04:00,93.28,93.935,93.14,93.41,10545529,12123168.75,60.99166759727653,56.13385822622182,NaN,NaN,171.13930004415445,118.90205294710765,0.4245809674105274,2.1248455139898113,1.7002645465792838,1272354815,1253215348.6,51.96827260427658,51.159722949084724,NaN,NaN,13.735527098698078,8.6098789667703
2020-05-08T09:30:00-04:00,94.3,94.91,93.75,94.78,7612262,11522245.45,63.01378648676154,56.67908718066146,NaN,NaN,178.3094230078975,140.4913023215094,0.5119253061835196,2.3401711793086832,1.8282458731251636,1279967077,1262424281.2,59.430415713970454,51.462968400718,NaN,NaN,15.469625788475753,9.589842798442508
2020-05-11T09:30:00-04:00,94.13,95.969,93.94,95.41,10384357,11408924.05,63.93951892789839,57.69821582042533,NaN,NaN,167.1329468521012,159.89024081681833,0.5633724346800524,2.532461416475229,1.9690889817951767,1290351434,1271564278.4,65.20788505070921,52.29791027167147,NaN,NaN,17.19303131260006,10.6760125861793
2020-05-12T09:30:00-04:00,95.8,96.07,93.37,93.44,13521010,11290500.8,58.969232190507,58.042244057733285,NaN,NaN,120.42859967292597,156.56241765112208,0.422412978068591,2.497105204380915,2.074692226312324,1276830424,1276262607.2,67.75029112402504,53.225901756531925,NaN,NaN,17.394318297390676,11.635770544923783
2020-05-13T09:30:00-04:00,93.49,94.209,90.62,91.83,16992167,11493656.65,55.19314873661393,58.18403816508239,NaN,NaN,55.24534660741354,138.45112323689855,0.19025772343844505,2.3125143806103807,2.1222566571719357,1259838257,1275868401.4,67.3058835984788,54.227633923162145,NaN,NaN,16.529373905077385,12.33485673923144
2020-05-14T09:30:00-04:00,91.19,93.06,90.19,93,15237595,11663847,57.33144893057588,58.296477962832334,NaN,NaN,45.932680897294304,113.40979940752652,0.09009214100867302,2.234871833432777,2.144779692424104,1275075852,1276412608.8,67.62163930791291,55.41259594145374,NaN,NaN,16.359668503513632,12.909829848414612
2020-05-15T09:30:00-04:00,91.53,93.49,91.27,93.47,14016705,11657562.35,58.19453476790566,58.39579494188819,NaN,NaN,58.95466367837843,89.53884754162269,0.03302827051048052,2.1860650305622045,2.153036760051724,1289092557,1278237704.8,68.71295914769782,56.6632394405562,NaN,NaN,16.44386029489196,13.414691340768519
2020-05-18T09:30:00-04:00,95.31,96.3,94.98,95.76,10017664,11648270.05,62.20590170660654,58.93730761402897,NaN,NaN,128.79381053478065,81.87102027815858,0.12204397045589621,2.3055917231215943,2.183547752665698,1299110221,1279989462.2,69.76628241284811,57.93854407583865,NaN,NaN,17.62998834282487,14.016876626776568
2020-05-19T09:30:00-04:00,95.8,96.89,95.37,95.41,10046350,11331460.1,61.23873182512698,59.04785148203067,NaN,NaN,128.68980522786606,83.5232613891466,0.12919636966692405,2.345043214749353,2.215846845082429,1289063871,1282436151.6,71.22350101329829,59.27083421772847,NaN,NaN,18.363951671977617,14.637887347519575
2020-05-20T09:30:00-04:00,96.73,97.68,96.68,97.5,9095994,11185306.45,64.76199741422356,59.46734292842598,NaN,NaN,154.59416900099953,103.3930258678638,0.24008413240279314,2.51595201058592,2.275867878183127,1298159865,1290100473.2,75.24808919931448,60.89503253933041,NaN,NaN,20.008847210260388,15.40516732791112
2020-05-21T09:30:00-04:00,97.4,97.69,96.085,96.14,10290837,11170605.85,60.883828977009834,59.95210573649764,NaN,NaN,120.57537862042693,118.32156541249033,0.1894601510794196,2.5126930670324015,2.323232915952982,1287869028,1292659108.4,76.4330557749839,62.86111917295325,NaN,NaN,20.346269876880875,16.111039120621083
2020-05-22T09:30:00-04:00,96,96.61,95.61,96.49,9274577,11212194.1,61.52242751057795,60.35274978726111,NaN,NaN,97.42727691441735,126.0160880596981,0.14895391745533582,2.5094253127721515,2.3604713953168157,1297143605,1294269318,77.17367022457995,65.08856401392366,NaN,NaN,20.800986964520703,16.7810316697496
2020-05-26T09:30:00-04:00,98.42,98.49,96.305,96.39,13000746,11472267.85,61.21492720122661,60.596465662393165,NaN,NaN,109.50926612305385,122.15917917735275,0.0878552509496604,2.470290459003891,2.382435208054231,1284142859,1291275845.6,72.60556255277582,66.94238825505126,NaN,NaN,21.10116657872758,17.398193799603597
2020-05-27T09:30:00-04:00,96.38,96.98,94.33,96.94,19428369,11811995.65,62.33012934510069,60.84223440124366,NaN,NaN,73.1059784012808,111.04241381203569,0.05833378110779819,2.4553524344389785,2.3970186533311804,1303571228,1294177317,74.19967887138785,68.90337047116135,NaN,NaN,21.6457306268055,18.004984774918153
2020-05-28T09:30:00-04:00,96.58,98.52,96.51,96.75,10579144,11767806.25,61.67043675842702,60.890717912754404,NaN,NaN,99.22364302461295,99.96830861675839,0.0027938249019427985,2.400510934458609,2.397717109556666,1292992084,1293143760.8,72.57946673893717,70.37559862363712,NaN,NaN,21.94506697343579,18.567853660420674
2020-05-29T09:30:00-04:00,97.04,98.2,96.23,97.97,17778913,11885220,64.28436053382976,60.9814732018307,NaN,NaN,97.00202415114076,95.25363772290116,0.02383402007554869,2.427509634651102,2.4036756145755533,1310770997,1297724154.6,75.16735887819284,71.49966599251015,NaN,NaN,22.884135965275927,19.18446541825714
2020-06-01T09:30:00-04:00,97.51,98.145,97.08,97.94,13361675,11953538.3,64.16847562639167,60.99782725172309,NaN,NaN,98.12734576782682,95.39365149358305,0.011943806406493174,2.41860537258367,2.406661566177177,1297409322,1297777298,75.19660798131909,72.21314620183942,NaN,NaN,23.652150931065645,19.82270620580121
2020-06-02T09:30:00-04:00,98.14,98.86,97.21,98.86,11194894,11976831.3,66.18184175494468,61.513013649182916,NaN,NaN,112.2045001253297,95.93269829403823,0.04063631336707729,2.4574569578860235,2.416820644518946,1308604216,1302669569.4,77.79008512195348,72.9302743445486,NaN,NaN,24.8477952014373,20.540576062320653
2020-06-03T09:30:00-04:00,99.26,99.95,98.83,99.63,11018264,12093377.9,67.81203316285354,62.414362536771456,NaN,NaN,143.25916254504213,109.9633351227905,0.08359590682265727,2.5213155280472677,2.4377196212246104,1319622480,1305879819.8,79.3182548087465,73.78830085956771,NaN,NaN,26.32256886463025,21.366575034079165
2020-06-04T09:30:00-04:00,99.24,99.93,98.26,98.81,7569440,12048324.6,64.25953364394766,62.90922573058373,NaN,NaN,118.13494602889077,113.74559572364606,0.031585203366176096,2.4772011254323303,2.445615922066154,1312053040,1309692011,80.99091014098755,74.7432487762159,NaN,NaN,26.712935734145947,22.13034084837442
2020-06-05T09:30:00-04:00,99.51,101.7,99.34,101.41,10378152,12039955.75,69.68279571049979,63.72981579791188,NaN,NaN,166.5681825851918,127.65882741045627,0.14095986589331844,2.6218157544328022,2.480855888539484,1322431192,1312024050,81.95248375083389,75.68892910501134,NaN,NaN,28.632834319302308,23.059268487078405
2020-06-08T09:30:00-04:00,101.23,101.96,100.3,101.92,8065209,12062603.1,70.62440043121546,64.33113713538394,NaN,NaN,163.35748624240327,140.70485550537154,0.212053955295616,2.745923332659004,2.533869377363388,1330496401,1318641465.8,84.36878581242146,76.73196506212373,NaN,NaN,30.515218975948706,24.124404271202735
2020-06-09T09:30:00-04:00,101.41,102.9,101.32,102.4,7353865,11911078.5,71.52092280906083,65.06557934852206,NaN,NaN,164.96437204946116,151.25682989019782,0.25302980966456534,2.8501566394440943,2.597126829779529,1337850266,1324490675.8,86.13573516704592,77.79712464453428,NaN,NaN,32.35838063898316,25.30068660945708
2020-06-10T09:30:00-04:00,103.14,104.89,102.95,104.11,12194804,11844768.2,74.50597764445195,65.76157793639553,NaN,NaN,187.91008721890182,160.18701482496976,0.35089913618321367,3.035750750008546,2.6848516138253324,1350045070,1330575193.8,87.69406585751383,78.6861229772628,NaN,NaN,34.894451557580794,26.67122445918904
2020-06-11T09:30:00-04:00,102.3,102.45,98.11,98.14,19871015,11988710.6,53.444378737306735,65.23018863355959,NaN,NaN,52.204299445134545,147.00088550821852,-0.011621711212537189,2.670324474809661,2.681946186022198,1330174055,1334199396.8,88.5216519547157,79.54959413295794,NaN,NaN,29.95209713230922,27.139920555349068
2020-06-12T09:30:00-04:00,100.77,101.27,97.68,99.41,21643497,12309005.7,56.275993963241184,64.8554433801784,NaN,NaN,40.76142417057311,121.83953382529478,-0.18163588424964372,2.4549013307101433,2.636537214959787,1351817552,1340076668.8,89.7280719498967,80.44633711333769,NaN,NaN,26.99186113295944,27.118769209293408
2020-06-15T09:30:00-04:00,97.6,100.82,97.28,100.37,14963178,12356329.35,58.33874428624487,64.65000174339399,NaN,NaN,33.987850496880654,95.96560667619028,-0.24144767024920366,2.3347276271482826,2.5761752973974863,1366780730,1347333534.6,90.98762477727026,81.75934155794445,NaN,NaN,25.317129153582947,26.861392058477627
2020-06-16T09:30:00-04:00,102.77,103.39,100.92,102.51,13968901,12553891.2,62.57704720867557,64.66763873364933,NaN,NaN,120.00235789970061,86.97320384623816,-0.15319615098705075,2.384680108663673,2.537876259650724,1380749631,1355913407.6,92.20469098727594,83.04541385193646,NaN,NaN,25.332639484256266,26.642998833588862
2020-06-17T09:30:00-04:00,103.09,103.46,102.32,102.49,8662126,12484680,62.51303966515365,64.72782465555836,NaN,NaN,122.84666985410223,73.96052037327826,-0.1142646997478729,2.395045384965883,2.5093100847137557,1372087505,1360321894.6,92.74669705137143,84.48593030282461,NaN,NaN,25.32437689274855,26.454624270611674
2020-06-18T09:30:00-04:00,102.3,103.06,102.08,102.95,6858594,12372810,63.43932090239359,64.66746468188437,NaN,NaN,108.1568667184526,85.15103382794189,-0.0773940516655518,2.412567520131816,2.4899615717973678,1378946099,1370076303.4,93.77761430633231,85.81523426197745,NaN,NaN,25.59681265010158,26.332079753395945
2020-06-19T09:30:00-04:00,104.19,104.31,101.75,102.24,15639984,12640267.35,60.93652450289611,64.43661103020611,NaN,NaN,96.51177925289569,96.30110484440641,-0.11823816534359954,2.3421638651178682,2.4604020304614678,1363306115,1372374016,93.99415597416534,87.15791626146645,NaN,NaN,25.084625528100226,26.153872006925127
2020-06-22T09:30:00-04:00,102.09,103.97,101.93,103.88,7368979,12544987.45,64.42753488966153,64.31130339697162,NaN,NaN,99.68382763661756,109.44030027235378,-0.05541027150976685,2.3911391910742594,2.4465494625840263,1370675094,1373152888.8,94.06949701130942,88.32073139642046,NaN,NaN,25.68514016699818,26.08691031550699
2020-06-23T09:30:00-04:00,104.81,105.83,104.48,104.63,9513994,12370649.85,65.92718642567921,64.17667148717346,NaN,NaN,136.44514564974773,112.72885782236321,0.012432256578418954,2.46208978330705,2.449657526728631,1380189088,1373040780.2,93.88693106883892,89.3613511292842,NaN,NaN,26.629113008607625,26.164367843092794
2020-06-24T09:30:00-04:00,104.2,104.78,101.71,102.27,12712839,12034873.35,57.68612445163553,63.707142259151155,NaN,NaN,66.54649241399986,101.46882233434273,-0.11863982725967803,2.3013577426540337,2.4199975699137117,1367476249,1372118529,92.2999656466675,90.16914080826133,NaN,NaN,24.90508537325135,25.98447034740116
2020-06-25T09:30:00-04:00,102.42,103.69,101.31,103.58,10267229,12019277.6,60.628162584297485,63.060382750136704,NaN,NaN,58.59964611995758,91.55737821464372,-0.13303549064009434,2.2537032066135936,2.386738697253688,1377743478,1371878004.8,91.86385047124138,90.87709557400474,NaN,NaN,24.35931978083778,25.75230598074925
2020-06-26T09:30:00-04:00,103.38,103.53,101.23,101.54,22137768,12237220.35,54.296981505190736,61.89413854113494,NaN,NaN,26.788067569186698,77.61263587790194,-0.28703194860911285,2.027948761492297,2.31498071010141,1355605710,1370337923.8,88.96524242337887,91.20541390335883,NaN,NaN,21.846636177668653,25.194353151737737
2020-06-29T09:30:00-04:00,101.53,102.66,100.31,102.65,9273601,12032816.65,56.93233655315678,60.852096665713226,NaN,NaN,11.47206800832689,59.970283952243804,-0.3187748864185216,1.9165121020782578,2.2352869884967794,1364879311,1369178767.2,86.74663372130505,91.24904951437735,NaN,NaN,20.58960425438035,24.53653188068668
2020-06-30T09:30:00-04:00,102.66,104.91,102.52,104.49,8249959,11885569.9,60.951856327782586,59.883945143093975,NaN,NaN,98.59933361757246,52.40112154580875,-0.22491422194887978,1.9541442110606795,2.1790584330095593,1373129270,1367766803.6,83.9987445501892,90.98509799242558,NaN,NaN,20.793415935204994,24.001801031332153
2020-07-01T09:30:00-04:00,104.56,105.27,104.08,104.66,10854569,11877385.15,61.311129420524914,60.445855906180995,NaN,NaN,124.13725103529856,63.91927327006848,-0.16331085761398834,1.974919860992074,2.1382307186060623,1383983839,1371068321.6,85.18082103199986,90.7464672122316,NaN,NaN,21.064178695429554,23.582140697631782
2020-07-02T09:30:00-04:00,105.65,106.22,105.05,105.27,9572331,11977529.7,62.63945075860281,60.900388534421104,NaN,NaN,154.18476098568397,83.03629624321374,-0.09670310367029789,2.0173518390181897,2.1140549426884876,1393556170,1374230860,86.23018566795074,90.4966181920926,NaN,NaN,21.678176576542217,23.310145823190418
2020-07-06T09:30:00-04:00,106.63,107.61,106.57,107.11,8023129,11859778.55,66.38816232531916,61.47534696578355,NaN,NaN,203.08998702677215,118.29668013473085,0.04826574863323785,2.174387128480035,2.126121379846797,1401579299,1383425577.8,88.7290848838519,90.33529391399131,NaN,NaN,23.36178868409181,23.317523374747758
2020-07-07T09:30:00-04:00,106.99,108.07,105.88,105.99,7931783,11853107.25,62.2910372712727,61.45491768454049,NaN,NaN,152.6508874063361,146.5324440143327,0.04574002018998424,2.1832964050842776,2.1375563848942933,1393647516,1389179218.8,89.957264084319,90.17476342092296,NaN,NaN,23.556641404656013,23.35168309330608
2020-07-08T09:30:00-04:00,106.83,107.73,106.26,107.72,6663528,11818590.4,65.8018227650598,61.689830763105206,NaN,NaN,148.4453675730095,156.5016508054201,0.13267603996014454,2.3034014348444742,2.1707253948843297,1400311044,1394615573.6,90.95965532685585,90.04711758345755,NaN,NaN,24.809824611714895,23.55998902450734
2020-07-09T09:30:00-04:00,108.6,108.62,106.56,108.11,8884227,11653061.55,66.55771322287649,61.91257307171113,NaN,NaN,142.84519108493336,160.24323881534707,0.18530955548874228,2.4023623392452578,2.2170527837565155,1409195271,1399657860,91.77925332142458,89.904377513107,NaN,NaN,26.054662400459705,23.916370935357676
2020-07-10T09:30:00-04:00,107.86,108.13,106.8,108.08,7362292,11027625.4,66.43606629513673,62.305397485442604,NaN,NaN,122.90138549307171,153.9865637168246,0.1864580132872553,2.4501253003655847,2.2636672870783294,1401832979,1401313221.8,92.03456774440725,89.76440692526714,NaN,NaN,27.03225088782076,24.3614966428524
2020-07-13T09:30:00-04:00,109,109.72,105.57,105.84,14455211,10668211.1,57.92335493121749,61.8408132026966,NaN,NaN,91.6489122114724,131.69834875376463,0.013814417710436011,2.2809353092163747,2.2671208915059387,1387377768,1398472915.6,87.03954345780603,89.26226738573119,NaN,NaN,25.387005544748735,24.50799791455188
2020-07-14T09:30:00-04:00,105,107.21,103.88,107.06,15026568,10671380.6,60.86459407366818,61.47919946326725,NaN,NaN,51.71641122165335,111.5114535168281,-0.03793077649352128,2.219707420889037,2.2576381973825583,1402404336,1400224279.6,87.49038758953569,88.80537142292381,NaN,NaN,24.85476818714872,24.557536524922856
2020-07-15T09:30:00-04:00,108.04,108.565,106.38,107.64,11888968,10567383.95,62.216793930469905,61.80281871175542,NaN,NaN,94.12893040001094,100.64816608222836,-0.051943479254245695,2.1927088483147514,2.244652327568997,1414293304,1403020731.6,88.19643666696271,88.51226221008775,NaN,NaN,24.806121854817594,24.59304871490782
2020-07-16T09:30:00-04:00,106.49,106.79,105.4906,106.31,8590293,10563792.3,57.325464058960655,61.566911674231356,NaN,NaN,42.010292086154166,80.48118628247252,-0.16334496654001018,2.0404711193939846,2.203816085933995,1405703011,1402322279.6,86.87753503532495,88.15609682180799,NaN,NaN,23.313479690833564,24.41025314004007
2020-07-17T09:30:00-04:00,106.94,107.13,105.85,106.83,6355290,10538627.1,58.69281901255473,61.880900067614505,NaN,NaN,51.33876465040292,66.16866211393875,-0.2115130329033157,1.9394247948048502,2.150937827708166,1412058301,1404367344,87.46844516132131,88.04918273166103,NaN,NaN,22.462398897943988,24.13198824831206
2020-07-20T09:30:00-04:00,107.13,109.82,106.53,109.56,8509221,10182088.95,65.02822095942429,62.45917752520503,NaN,NaN,117.4362457187478,71.32612881539383,-0.07600344841092976,2.0559335171945037,2.1319369656054334,1420567522,1411005294.8,89.17271142153297,88.22247399596303,NaN,NaN,23.65326288987147,24.063598911391974
2020-07-21T09:30:00-04:00,110.34,110.38,108.06,108.46,9397495,10283514.75,60.97049197564956,62.46050864290982,NaN,NaN,119.04715117307254,84.79227680567767,-0.07672033231648356,2.036036550209829,2.1127568825263126,1411170027,1412758433,89.57592649547236,88.62084413491183,NaN,NaN,23.390849806357274,23.967491896387017
2020-07-22T09:30:00-04:00,108.56,109.6706,108.47,109.33,7513734,10183501.75,62.94017257716893,62.576868868384395,NaN,NaN,114.29045180165345,88.82458108600616,-0.03688808835262325,2.0666467720855337,2.103534860438157,1418683761,1413636524.4,89.78119643410365,88.94944237791924,NaN,NaN,23.772471261788354,23.939631805730066
2020-07-23T09:30:00-04:00,108.75,109.47,106.005,106.49,11674801,10131599.85,53.45630580637577,61.920929943225325,NaN,NaN,42.89991260425238,89.0025051896258,-0.21040796600408163,1.8405249029330548,2.0509328689371364,1407008960,1413897714.2,89.84525219610963,89.20766141564488,NaN,NaN,21.00069969795583,23.51978436176232
2020-07-24T09:30:00-04:00,104.71,105.89,103.47,105.2,11455846,10191030.7,49.78664101484073,60.735106992476865,NaN,NaN,-64.03479324980815,65.92779360958359,-0.40915968021903204,1.5394832686633464,1.9486429488823784,1395553114,1410596676.8,82.78247549588028,88.78290360221833,NaN,NaN,17.505603904574336,22.660615725021177
2020-07-27T09:30:00-04:00,105.84,106.97,105.63,106.86,8453995,9506842.05,54.148614091584896,60.153505336784875,NaN,NaN,-4.015449816181748,41.637454502597684,-0.42411266155145166,1.4185021219430638,1.8426147834945155,1404007109,1407284594.2,76.30138394305611,87.80748359212812,NaN,NaN,15.969097749516298,21.704684585663337
2020-07-28T09:30:00-04:00,106.53,106.86,105.53,105.61,8912742,9488799.1,50.58514256353106,59.06659960810425,NaN,NaN,-47.95809997925722,8.236404272131733,-0.5078230610607681,1.2078359571685553,1.7156590182293234,1395094367,1404069462.2,70.52894353817132,86.3481470357935,NaN,NaN,13.547201162703843,20.539329810954836
2020-07-29T09:30:00-04:00,106.01,107.43,106.01,107.14,6593623,9405982.3,54.52954608977951,58.20744481288303,NaN,NaN,-3.9568500539373597,-15.413056098986427,-0.4516705038723494,1.1510708883888867,1.6027413922612361,1401687990,1400670308,64.93565753106009,84.43074733648174,NaN,NaN,12.775670110671737,19.43023556805725
2020-07-30T09:30:00-04:00,106.17,107.81,105.6,107.74,10778368,9402172.25,56.01240064407827,57.46289726637887,NaN,NaN,1.3158794035216506,-23.729862739132567,-0.3691191437656012,1.1413424625542348,1.510461606319836,1412466358,1401761787.6,65.87159132180257,82.56196330629568,NaN,NaN,12.610721038811329,18.456019206736404
2020-07-31T09:30:00-04:00,109.44,110.47,107.661,110.43,12594112,9553261.3,61.996259281577466,57.753819005690296,NaN,NaN,175.34689928501115,24.146475767831298,-0.14012878955321595,1.335300619378316,1.4754294089315318,1425060470,1407663258.8,70.46235234634388,81.37787822690554,NaN,NaN,14.433459594486786,17.88136783355789
2020-08-03T09:30:00-04:00,111.93,113.51,111.88,113.15,12165777,9760393.7,66.89953649195523,58.18488632128223,NaN,NaN,297.95973258514965,84.54151224809758,0.17087654818444697,1.6890250941620906,1.5181485459776436,1437226247,1414307086.4,74.60402920896621,80.45742405686487,NaN,NaN,17.72074022975824,17.85842103301508
2020-08-04T09:30:00-04:00,112.91,113.45,112.42,113.44,8985819,9813095.5,67.38273043400123,58.553881785820174,NaN,NaN,231.21493773817235,140.3761197915835,0.3615174896903297,1.9700454080905558,1.6085279184002261,1446212066,1424530626.2,79.39246772893023,79.8285691327197,NaN,NaN,20.440586623065677,18.22730183159374
2020-08-05T09:30:00-04:00,113.8,114.12,113.29,113.86,6480270,9803932.6,68.10882616961035,59.324121936580866,NaN,NaN,198.16521550904298,180.80053290417956,0.4741949711208473,2.2012716323012853,1.727076661180438,1452692336,1434731495.4,82.86425201731856,79.54190606000495,NaN,NaN,22.849125418257486,18.887562343974274
2020-08-06T09:30:00-04:00,113.77,115.57,113.515,115.46,8199668,9769704.65,70.77763248831016,60.18732289913482,NaN,NaN,186.23449587174983,217.7842561978252,0.6063237834579203,2.4849813905028384,1.8786576070449181,1460892004,1444416624.6,85.38227384023283,79.39289382278433,NaN,NaN,25.75276189301977,19.86830513669506
2020-08-07T09:30:00-04:00,115,115.005,112.84,113.74,13738125,10088496.3,64.52624928307596,60.15146777939566,NaN,NaN,132.02758877161583,209.12039409514614,0.5304613240732663,2.541734262136501,2.0112729380632346,1447153879,1448835306.4,86.36658639940174,79.19245632120354,NaN,NaN,26.3003548692337,20.78716938420058
2020-08-10T09:30:00-04:00,113.96,114.15,111.885,113.42,8240675,9777769.5,63.404219294668536,60.325305445039874,NaN,NaN,98.59488158019971,169.24742389415616,0.41634650119755845,2.5317060645601828,2.1153595633626243,1438913204,1449172697.8,86.44165973236994,78.96858012383906,NaN,NaN,26.40756923704341,21.590083648892413
2020-08-11T09:30:00-04:00,113.05,113.53,111.15,111.38,9422235,9497552.85,56.64224697537941,59.87545361634062,NaN,NaN,62.35385011257185,135.47520636903604,0.17352260587718416,2.3322628207091043,2.15874021483192,1429490969,1445828478.4,81.64273363705539,78.38726135262132,NaN,NaN,24.408514429760846,21.992716617587902
2020-08-12T09:30:00-04:00,112.28,114.206,112.14,113.91,7098900,9258049.45,62.048095157247865,60.48915285568863,NaN,NaN,84.31221480902968,112.70460622903337,0.15400681782565684,2.351248737113991,2.1972419192883343,1436589869,1442607985,77.1980618476245,77.48389061344382,NaN,NaN,24.3745638805138,22.332980512291602
2020-08-13T09:30:00-04:00,114.07,114.91,113.55,113.96,5726835,9114876.55,62.148536825236306,61.372145413574025,NaN,NaN,89.18005651510546,93.2937183577045,0.11686045611325824,2.343317489429907,2.226457033316649,1442316704,1438892925,72.30776524545624,76.73569702412783,NaN,NaN,24.37823635564456,22.625159918484883
2020-08-14T09:30:00-04:00,114.01,114.21,113.25,113.88,4167137,9005468.9,61.866412885805644,61.92341675601836,NaN,NaN,73.0431617472439,81.4968329528301,0.062048221139411996,2.304017309740914,2.241969088601502,1438149567,1437092062.6,69.99312464368148,76.2851070741725,NaN,NaN,24.300374419159095,22.864476275724055
2020-08-17T09:30:00-04:00,114.57,114.9,114.43,114.64,4087430,8784379.35,63.55883828046587,62.850109307228,NaN,NaN,83.44000596158332,78.46585782910684,0.05250212414015776,2.307596743776699,2.2550946196365413,1442236997,1437756821.2,70.37017197876841,76.27376624850088,NaN,NaN,24.71129729260769,23.128307849564575
2020-08-18T09:30:00-04:00,114.86,115.38,114.1,115.07,4465044,8537756.8,64.51833912347192,63.56359452392031,NaN,NaN,79.89340963983365,81.9737697345592,0.05064889563060104,2.3184057391747928,2.2677568435441917,1446702041,1441199035.6,72.3103901754255,76.80053286595555,NaN,NaN,25.319871957431705,23.441388436402736
2020-08-19T09:30:00-04:00,115.36,115.87,114.735,114.93,7119708,8518055.5,63.92815222772174,64.12900535132341,NaN,NaN,80.01276896747194,81.11388056624766,0.017223049901132992,2.289285655920608,2.272062606019475,1439582333,1441797528.4,72.64578121466917,77.28440357258887,NaN,NaN,25.672319339809057,23.760092851175067
2020-08-20T09:30:00-04:00,114.5,116.69,114.38,116.46,6401540,8254392.45,67.43418822184486,64.51742884705679,NaN,NaN,89.3112464988632,81.14011856299922,0.07229658118909565,2.3624333325058444,2.2901367513167488,1445983873,1442530962.2,73.07616725526695,77.47110463751196,NaN,NaN,26.962853613885514,24.217630102990846
2020-08-21T09:30:00-04:00,116.57,118.0699,116.51,117.94,7644345,8063817.4,70.42837030964084,64.76948840546291,NaN,NaN,126.28287802692157,91.78806181893474,0.17659710023540587,2.510883126611006,2.3342860263756,1453628218,1445626692.4,74.87320741310624,77.49033165209337,NaN,NaN,28.978497703485353,24.89775404591863
2020-08-24T09:30:00-04:00,119.64,119.68,117.97,118.96,8219599,8052097.6,72.31743067214285,65.1219669939016,NaN,NaN,160.75519063100103,107.25109875281828,0.27652591009710425,2.6799434139969804,2.403417503899876,1461847817,1449548856.4,76.97047217795581,77.31733196988093,NaN,NaN,31.26650004587302,25.807574903054974
2020-08-25T09:30:00-04:00,118.69,119.61,118.51,119.56,9313627,8072141.85,73.39410465034884,65.49948688538292,NaN,NaN,168.07143190241106,124.88670320533376,0.34104250671052627,2.829720637288034,2.4886781305775076,1471161444,1454440737,79.29207331109082,77.06217634800751,NaN,NaN,33.50494609154078,26.907199358552948
2020-08-26T09:30:00-04:00,120.81,122.31,120.54,121.99,8231540,8154037.7,77.25283784242208,65.96200155353377,NaN,NaN,212.5088069026953,151.38591079237844,0.4959903674331061,3.1086660898688905,2.6126757224357844,1479392984,1462402867.2,82.40171913952952,76.84927958367156,NaN,NaN,36.78547914296436,28.318382184897434
2020-08-27T09:30:00-04:00,122.5,123.06,120.99,122.09,9086646,8069451.6,77.39811254337533,66.88142035784087,NaN,NaN,191.16801853338615,171.75726519928304,0.5496705505852653,3.299763910667366,2.7500933600821007,1488479630,1470902018.6,84.99241328991627,76.75112436156546,NaN,NaN,39.471113141218225,29.91162946437183
2020-08-28T09:30:00-04:00,122.57,123.56,122.41,123.16,6546671,7767079.55,78.94741648727008,67.99164872874097,NaN,NaN,176.81625786303067,181.86394116650484,0.5977144349455017,3.497236403763978,2.899521968818476,1495026301,1479181635.2,87.00013728820626,76.79101561555376,NaN,NaN,42.246487947624715,31.673752104836527
2020-08-31T09:30:00-04:00,123.65,124.35,122.88,123.55,9519980,7634789.7,79.49902622108539,69.62427581771996,NaN,NaN,154.5375334931582,180.6204097389363,0.5949487331108458,3.6432078852070333,3.0482591520961875,1504546281,1487721328,88.68196291674165,77.29381770695993,NaN,NaN,44.712269731854384,33.53639748012479
2020-09-01T09:30:00-04:00,124.66,126.07,123.88,125.91,12809980,7825997.75,82.4890127610102,71.08434136084584,NaN,NaN,157.58817108016194,178.52375757448647,0.6848463388670485,3.904317075679998,3.2194707368129496,1517356261,1496960291.4,90.1644963207593,78.21999159789813,NaN,NaN,47.93489091490367,35.59332511366463
2020-09-02T09:30:00-04:00,127.71,127.72,124.8101,127.03,20196950,8511831.75,83.7037259986131,72.62399773037275,NaN,NaN,151.9447929377371,166.4109547814948,0.7474161231217762,4.15374089071517,3.406324767593394,1537553211,1508592336.8,91.64786297231953,79.60142714981694,NaN,NaN,51.04383608575858,37.80054096682091
2020-09-03T09:30:00-04:00,125,125.1,118.8,119.79,27080966,9455896.65,56.44549593050577,72.23678937642276,NaN,NaN,54.64763988569707,139.106879051957,0.2543581647579538,3.724272473540836,3.469914308782882,1510472245,1512990859.8,92.13114318180774,81.18271418825454,NaN,NaN,43.532255551094565,38.619357336002864
2020-09-04T09:30:00-04:00,119.12,120.82,113.05,118.12,31272148,10332597.8,52.22112834192123,71.426952952241,NaN,NaN,-14.675956714771727,100.80843613639652,-0.20622493170839595,3.212133144147387,3.418358075855783,1479200097,1509825619,88.17709673268756,82.45463738496305,NaN,NaN,36.10087899589731,38.25957471598778
2020-09-08T09:30:00-04:00,113.63,116.33,112.58,112.78,23930197,11117073.9,41.52059457203787,69.78425691285285,NaN,NaN,-76.32986962223266,54.63495551331833,-0.8560496847622554,2.3482959699029635,3.204345654665219,1455269900,1499970342.8,77.08414563659116,82.79561991790345,NaN,NaN,25.01525635718164,36.36752923615833
2020-09-09T09:30:00-04:00,115.53,117.6001,114.27,116.46,18391935,11565558.9,49.23981791767737,68.73509017642111,NaN,NaN,-42.81401768424332,14.554517760437284,-1.012836116577501,1.9383005089433425,2.9511366255208435,1473661835,1491231457.6,68.81694276059062,82.52213145689784,NaN,NaN,19.430465022953523,33.94794863427193
2020-09-10T09:30:00-04:00,118.06,118.24,113.14,113.83,16054935,12013360.65,44.69874380658767,67.1111298610456,NaN,NaN,-65.09074956288006,-28.852590739686143,-1.2527576768509885,1.385189529457108,2.6379472063080964,1457606900,1475242195.4,56.81130190675772,81.36035536057577,NaN,NaN,13.31819943458566,31.00084160574532
2020-09-11T09:30:00-04:00,114.9,115.34,111.52,112.96,18583050,12656171.4,43.276917141168454,65.17174034901186,NaN,NaN,-97.38054955807134,-59.25822862843984,-1.4170352639344501,0.8666531263900339,2.283688390324484,1439023850,1460952516.4,48.643688018413826,79.48681826095488,NaN,NaN,8.267218518615653,27.753181164726797
2020-09-14T09:30:00-04:00,114.84,115.95,114.3,115.33,12363975,13066013.3,48.11840077483501,63.44323821348986,NaN,NaN,-63.71091187037551,-69.0652196595606,-1.3152900307464381,0.6395758518914363,1.9548658826378744,1451387825,1455390062,45.8786580811535,77.26597439689756,NaN,NaN,5.986294398645339,24.643625912429446
2020-09-15T09:30:00-04:00,117.09,117.3,115.685,116.47,9130229,13318153.25,50.31516613791944,61.79474260545919,NaN,NaN,-41.68917397629627,-62.137080530373304,-1.127638415240289,0.5453178635875133,1.6729562788278023,1460518054,1456439692.8,46.49668700973201,74.92344680394338,NaN,NaN,4.971714703014342,21.833352882513005
2020-09-16T09:30:00-04:00,116.99,117.15,114.56,114.67,9820058,13585903.95,46.93586074337418,59.62924424124149,NaN,NaN,-62.92133964090351,-66.15854492170534,-1.0810331669225586,0.32166482017460396,1.4026979870971625,1450697996,1451846925,44.12245828365713,72.18921388566677,NaN,NaN,3.014385562267284,19.144928979620758
2020-09-17T09:30:00-04:00,111.99,114.51,111.81,113.72,15201819,13990009.5,45.2100265234943,57.330095239821404,NaN,NaN,-100.48050846692223,-73.23649670251379,-1.068567265661687,0.06698890502005383,1.1355561706817408,1435496177,1447424780.4,41.903767637558076,69.11145348192689,NaN,NaN,0.9000391047290499,16.538516140350513
2020-09-18T09:30:00-04:00,113.91,114.11,110.3821,111.76,20918798,14715872.4,41.79542387565367,54.6763814818488,NaN,NaN,-115.57768336296218,-76.87592346349194,-1.1401730883984802,-0.28966018981635955,0.8505128985821206,1414577379,1442535486.2,39.53657289915698,65.72119888270909,NaN,NaN,-1.9626469811286775,13.895492837282058
2020-09-21T09:30:00-04:00,109.5,112.49,109.11,112.44,19190883,15293199.3,43.39282654427075,52.09736721921919,NaN,NaN,-114.70174245998496,-87.07408958141384,-1.08964242586579,-0.5115401337501169,0.5781022921156731,1433768262,1439011573.6,37.875814211755326,62.09218826092435,NaN,NaN,-3.779469742979766,11.37049818295894
2020-09-22T09:30:00-04:00,113.71,114.51,111.78,114.22,12768728,15520655.75,47.457831163281575,49.59513996223857,NaN,NaN,-70.80239383982418,-92.89673355411942,-0.8925249356710536,-0.5375538774731439,0.3549710581979097,1446536990,1436215360.8,36.56336226498207,58.26353582836884,NaN,NaN,-4.076755347517251,9.163747678605198
2020-09-23T09:30:00-04:00,114.28,114.39,110.32,110.66,11853417,15647645.25,41.10079762595538,46.55207364990587,NaN,NaN,-90.39604126120386,-98.39167387817949,-0.9526149662324359,-0.8357976495926351,0.11681731663980072,1434683573,1433012476.2,35.064555889492965,54.22187103673837,NaN,NaN,-6.393256514818779,6.941318508116058
2020-09-24T09:30:00-04:00,109.63,112.66,109.49,111.28,15919317,16032034.1,42.54426306463634,45.559128445200905,NaN,NaN,-93.77660963773823,-97.05089411234269,-0.901838632209857,-1.0104809736225207,-0.10864234141266357,1450602890,1436033818.8,37.66056168404239,50.33111521546941,NaN,NaN,-7.801410722139181,4.83521433236531
2020-09-25T09:30:00-04:00,111.34,114.28,110.64,113.94,9663212,16060862.4,48.38838242664067,45.28536087982372,NaN,NaN,-60.31949085970101,-85.99925561169046,-0.6519916811837885,-0.9236319428923991,-0.27164026170861066,1460266102,1445171563.4,44.84265319501829,47.23579781992161,NaN,NaN,-7.170627979721389,3.1200940020672103
2020-09-28T09:30:00-04:00,115.83,116.13,114.87,116.12,8736611,16170359.4,52.640024423388056,46.07960586920588,NaN,NaN,-7.029072961868576,-64.46472171206717,-0.3196149717906687,-0.6711589764469466,-0.35154400465627783,1469002713,1452218453.6,49.65935740192733,45.27688437458848,NaN,NaN,-5.273795476976699,1.920966933632366
2020-09-29T09:30:00-04:00,115.97,116.46,115.48,115.73,12225778,16305649.3,51.81763111221042,46.26373538310111,NaN,NaN,4.787347816865215,-49.346773380729296,-0.1162168738922772,-0.4968150970216243,-0.3805982231293471,1456776935,1454266442.6,50.99863194318825,44.00414788763117,NaN,NaN,-4.002073673246434,1.0748182755068232
2020-09-30T09:30:00-04:00,115.67,117.89,115.62,116.7,11157916,16223046.1,53.75289353261072,46.91046036353132,NaN,NaN,40.8812713023519,-23.091310868018148,0.08273436921677452,-0.27718026160837894,-0.35991463082515346,1467934851,1460916698.2,55.169441929406844,43.88687217496325,NaN,NaN,-2.3724047864859794,0.58235783807928
2020-10-01T09:30:00-04:00,118.32,118.48,117.18,117.93,13538164,15890106.8,56.157610626010865,47.830509898162916,NaN,NaN,101.17986684543459,15.899984428616426,0.28487308120835003,-0.0038232793147159327,-0.28869636052306596,1481473015,1467090723.2,58.68530147426962,44.60413027895296,NaN,NaN,-0.2885298174649772,0.4579453158586718
2020-10-02T09:30:00-04:00,115.03,116.94,114.48,114.94,18625844,15467350.7,49.4291825620801,47.924137168680424,NaN,NaN,35.20972765772563,35.00582813210176,0.20845336695645397,-0.028129651827498492,-0.23658301878395246,1462847171,1467606937,58.97500370048089,45.53958353747635,NaN,NaN,-0.45250476386021465,0.32788101875597375
2020-10-05T09:30:00-04:00,115.76,117.53,115.69,117.46,6135274,14210507,54.38923620145046,48.215142173218354,NaN,NaN,92.09948713826573,54.83154015212862,0.3126048956535832,0.15417310078302648,-0.15843179487055667,1468982445,1467602883.4,58.971506782603576,46.43064209268146,NaN,NaN,0.9645658602596634,0.4188359961136437
2020-10-06T09:30:00-04:00,117.18,118.29,115.23,115.64,13430628,13685528.55,50.5342093686026,48.47216707502038,NaN,NaN,66.24026537236416,67.12212366322841,0.24679403518900178,0.15006074911569556,-0.09673328607330622,1455551817,1467357859.8,58.74476147421555,47.47509232057849,NaN,NaN,0.958547590839625,0.4959376525030696
2020-10-07T09:30:00-04:00,116.85,117.99,116.755,117.76,6495913,13090727.45,54.57322477432825,49.14096695007994,NaN,NaN,102.52478222220017,79.45082584719808,0.3287830578834391,0.3142455362809926,-0.014537521602446452,1462047730,1466180435.6,57.59867263039242,48.59615696292379,NaN,NaN,2.2259658282533326,0.7430845347531072
2020-10-08T09:30:00-04:00,118.79,118.79,117.97,118.37,5054753,12540718.35,55.69423469192507,50.13373915124219,NaN,NaN,119.82009497106785,83.17887147232473,0.40199814847274884,0.4879601639884896,0.08596201551574077,1467102483,1463306329.2,54.78874545902418,49.685597860057165,NaN,NaN,3.5903694640623494,1.1498395246544275
2020-10-09T09:30:00-04:00,118.93,120.21,118.9,120.18,7212565,11972194.1,58.9326161729852,51.243724124721794,NaN,NaN,150.88027651634908,106.31298124404941,0.5415408138519462,0.7628880328306735,0.22134721897872733,1474315048,1465599904.6,56.60797448020697,51.02360930780371,NaN,NaN,5.7410230873912145,1.8057228907596827
2020-10-12T09:30:00-04:00,121.95,124.27,121.34,123.46,9581881,11833089.4,64.05927638120858,52.42954164028801,NaN,NaN,213.8487866619004,130.66284114877635,0.8079189457830417,1.2312459012075294,0.4233269554244877,1483896929,1468582801.4,58.92296791754155,52.62072399727224,NaN,NaN,9.308744100065747,2.877583063517692
2020-10-13T09:30:00-04:00,123.86,124.08,122.2,122.67,8806934,11816924.65,62.05010067722217,53.9259204296642,NaN,NaN,179.04795849784352,153.22437977387222,0.8782518066522113,1.5211417137397518,0.6428899070875406,1475089995,1472490437,61.79826941806556,54.53027496359885,NaN,NaN,11.591612883674522,4.122444466397239
2020-10-14T09:30:00-04:00,122.97,123.62,121.1088,122.02,7277862,11689814.85,60.37228423507913,55.199350513267255,NaN,NaN,136.60694312497984,160.04081195442814,0.8289530842765279,1.6790812624332005,0.8501281781566726,1467812133,1473643317.6,62.6294001849134,56.313763427946775,NaN,NaN,12.970410883641753,5.38643966886074
2020-10-15T09:30:00-04:00,120,121.71,119.68,121.47,6593821,11259414.95,58.920498958258804,55.95164455123999,NaN,NaN,95.932413818353,155.2632757238852,0.7117483382838321,1.7398136010114627,1.0280652627276305,1461218312,1472466483.4,61.16649706955595,57.479752276128046,NaN,NaN,13.700304781806826,6.5741346849958955
2020-10-16T09:30:00-04:00,122.14,122.63,121.01,121.12,5772118,10502080.95,57.965237106556884,56.33201688575205,NaN,NaN,98.42541633543699,144.77230368770276,0.5692667930315616,1.7396487540170824,1.1703819609855208,1455446194,1468692712.6,56.60082226644652,57.975571195022276,NaN,NaN,14.046224147928218,7.64157603684337
2020-10-19T09:30:00-04:00,121.73,122.19,118.53,118.9,8308206,9957947.1,52.18589062630175,56.35832113675856,NaN,NaN,54.040893959251186,112.81072514717293,0.297774852226907,1.5426005262691547,1.2448256740422476,1447137988,1461340924.4,48.93722224123606,57.82832764488283,NaN,NaN,12.707567021023927,8.36528903458345
2020-10-20T09:30:00-04:00,119.35,120.57,118.58,119.31,7283499,9683685.65,53.11561644374295,56.31280134469658,NaN,NaN,39.63614415246628,84.92836227809748,0.12681551771142852,1.4033450711815334,1.2765295534701049,1454421487,1457207222.8,45.22906202209291,57.11830050864613,NaN,NaN,11.847489371795849,8.862746225613792
2020-10-21T09:30:00-04:00,119.02,120.27,118.86,119.13,6085884,9395309,52.63175611842922,56.06095459415503,NaN,NaN,31.45975809402877,63.89892527190726,-0.010111415879458407,1.263890283620782,1.2740016995002403,1448335603,1453311916.8,41.99945299387748,55.92645418861811,NaN,NaN,11.0013976637764,9.168267859637021
2020-10-22T09:30:00-04:00,119.18,119.57,117.21,118.57,6743249,8936505.6,51.07296102664263,56.178367341623776,NaN,NaN,-3.840846690461168,43.94427317014443,-0.14275723005670882,1.0955551619293544,1.2383123919860632,1441592354,1449386725.2,38.97903262626486,54.49817054045983,NaN,NaN,9.867467639942767,9.268153542537842
2020-10-23T09:30:00-04:00,118.74,118.76,117.45,118.44,5156729,8711181.45,50.697583355780736,55.914677852647365,NaN,NaN,-21.040893693190313,20.05101116441896,-0.23799924071284373,0.9408133410950086,1.1788125818078523,1436435625,1445584611.4,36.258916108614166,52.87584263517488,NaN,NaN,8.812324614690409,9.203035124273923
2020-10-26T09:30:00-04:00,117.13,118.065,114.43,115.87,9094576,8729079.7,43.83793380529729,55.43637245526842,NaN,NaN,-93.25620905155307,-9.408409437741891,-0.45997717967871243,0.6038411072094618,1.0638182868881743,1427341049,1441625223.6,33.627223988196036,51.08173281474491,NaN,NaN,5.903689394880597,8.731700020074875
2020-10-27T09:30:00-04:00,116.43,116.935,115.79,116.45,9532363,8594408.95,45.62600763283199,54.797285516590115,NaN,NaN,-85.91006777420219,-34.51765182307558,-0.54768027080249,0.37921794838506173,0.9268982191875518,1436873412,1438115608.6,31.448339991986614,49.21385191200164,NaN,NaN,3.9085771013428,8.042682460256007
2020-10-28T09:30:00-04:00,114.24,114.31,111.32,111.51,16377839,8855405.1,35.31345426284577,53.3415154859416,NaN,NaN,-196.63621629286644,-80.13684670045463,-0.897650177827747,-0.19516450309713207,0.702485674730615,1420495573,1432547602.6,28.313849791151824,47.32278793572504,NaN,NaN,-1.4741040786091832,6.683141526132408
2020-10-29T09:30:00-04:00,111.94,114.68,111.87,113.37,9704369,8663715.35,40.74415205968792,52.042339477848934,NaN,NaN,-146.3955210794128,-108.64778157824495,-0.9576518029920331,-0.49457907900942644,0.4630727239826067,1430199942,1430269120.2,27.122525535535516,45.21668443967708,NaN,NaN,-4.286360934815487,5.116069745996994
2020-10-30T09:30:00-04:00,111.78,112.48,109.57,110.86,12925097,8378678,36.313612748486875,50.060506361225954,NaN,NaN,-187.3830186183759,-141.91620656328206,-1.1094620510770263,-0.9237548398636761,0.1857072112133501,1417274845,1426436964.2,25.201884257638596,42.80803560682688,NaN,NaN,-8.191088799680285,3.2150470966145264
2020-11-02T09:30:00-05:00,111.71,112.62,110.08,111.14,12019857,8672907.15,37.134853021737435,48.28084581440561,NaN,NaN,-152.224671353204,-153.70989902361225,-1.1302780508341885,-1.2271403523293856,-0.09686230149519709,1429294702,1426827694.8,25.77899860170409,40.23523054851534,NaN,NaN,-11.013527973311197,1.182393515196566
2020-11-03T09:30:00-05:00,112.01,114.1,111.55,113.1,10485071,8525629.3,42.704490574019985,47.018860552901394,NaN,NaN,-103.43813551808971,-157.21551257238974,-0.9581083768924226,-1.2944977726107254,-0.3363893957183028,1439779773,1427408967,26.685251425193158,37.66779135139247,NaN,NaN,-11.675694041669754,-0.6544761357843365
2020-11-04T09:30:00-05:00,116.54,118.38,115.37,117.5,15381903,8969928.8,52.81172596301287,46.58251962466954,NaN,NaN,-13.94000378897361,-120.67627007161119,-0.5161056177234601,-0.9815214178726279,-0.46541580014916784,1455161676,1434342187.6,36.62510457102599,35.914834744354614,NaN,NaN,-8.754157205486653,-1.811573431456096
2020-11-05T09:30:00-05:00,120.59,121.5,120.09,121.15,11094927,9271937.5,59.23586456243887,46.67327872866111,NaN,NaN,62.46268128042364,-78.90462959964391,0.025165837956769632,-0.4339585027032058,-0.4591243406599754,1466256603,1441553519.8,44.98055706736883,35.084815801563344,NaN,NaN,-3.8872722564651725,-2.108101835028821
2020-11-06T09:30:00-05:00,120.86,121.97,119.21,121.58,9727649,9397691.7,59.92798592652275,47.22628553581975,NaN,NaN,60.550983978940245,-29.31782908018069,0.39473240981248486,0.034291171605630666,-0.3604412382068542,1475984252,1453295401.2,55.31179762931558,35.5401426149976,NaN,NaN,0.07301417337570057,-1.7965138338281752
2020-11-09T09:30:00-05:00,124.16,125.36,120.59,120.7,19884050,9912800.15,57.76637256561673,47.55848240166789,NaN,NaN,88.45942147042845,18.818989484545803,0.5528035819776457,0.3305632392652029,-0.22224034271244275,1456100202,1458656501.2,59.08905596673847,36.53014218247228,NaN,NaN,2.5474700433949953,-1.1759447085105794
2020-11-10T09:30:00-05:00,119.65,120.49,117.49,118.45,11769185,10060912.7,52.54741003752528,47.552457681603315,NaN,NaN,24.38362471178504,44.383341530520745,0.48133703230421654,0.3794309476678279,-0.10190608463638862,1444331017,1459566750,59.711719491727656,37.79530407517586,NaN,NaN,2.9648138768834653,-0.5844077677400017
2020-11-11T09:30:00-05:00,119.65,121.59,119.41,121.26,7244276,10059233.4,57.688719398663274,48.02501185103337,NaN,NaN,69.16547762777508,61.004437813870496,0.5915673945500363,0.6375531585511567,0.04598576400112045,1451575293,1458849473.4,58.95032218017024,39.22182475759768,NaN,NaN,5.037381259397244,0.21870495042246196
2020-11-12T09:30:00-05:00,121.26,121.86,119.615,120.18,7177078,10088396.25,55.21269521367823,48.34751984088319,NaN,NaN,65.5261067219837,61.617122902182494,0.560304389392078,0.7463662507412181,0.18606186134914,1444398215,1454477795.8,54.39753713911971,40.517440545490935,NaN,NaN,5.916867254366974,1.0327281367002492
2020-11-13T09:30:00-05:00,121.09,121.45,119.95,121.2,5926508,10096115.75,57.08606463244305,49.29381489996503,NaN,NaN,73.97731830132282,64.30238976665902,0.5747349880932617,0.9044805964657172,0.3297456083724554,1450324723,1449345890,49.55885128416858,41.65541392377468,NaN,NaN,7.216180268256991,1.9160784412083554
2020-11-16T09:30:00-05:00,121.21,122.59,120.96,122.37,7432091,10052310,59.19448745620685,50.262992030206085,NaN,NaN,93.66556860705323,65.34361919398398,0.6253116889096589,1.111385219509529,0.48607353059987013,1457756814,1449677212.4,49.86888743667389,42.97116731268092,NaN,NaN,8.936337945874838,2.91897265616071
2020-11-17T09:30:00-05:00,121.76,122.35,121.172,121.69,4969705,9936620.3,57.42847254710378,51.842636193367376,NaN,NaN,83.66356160845291,77.19960657331755,0.5764048621454072,1.2065796082816291,0.6301747461362219,1452787109,1451368430.8,51.50735125976885,44.62784598901071,NaN,NaN,9.835753829757179,3.9070842523887768
2020-11-18T09:30:00-05:00,121.48,122.06,120.34,120.39,4771764,9870914.3,54.105162000085386,52.79699404625291,NaN,NaN,63.856449799993094,76.13780100776115,0.4268267694410024,1.163708207937475,0.7368814384964726,1448015345,1450656441.2,50.755262274431516,46.315898613217556,NaN,NaN,9.633968029848832,4.725210506311642
2020-11-19T09:30:00-05:00,120.15,121.58,119.62,121.36,6077626,9837633.15,56.14446222337457,54.213483294459174,NaN,NaN,58.05965976730984,74.64451161682638,0.36588428067784284,1.1942367893437762,0.8283525086659334,1454092971,1452595392.4,52.777476293020335,48.285583758601966,NaN,NaN,10.046367494116573,5.485375790283775
2020-11-20T09:30:00-05:00,121.47,121.5,120.07,120.11,4958384,9827715.9,52.883395958951134,55.33837921854587,NaN,NaN,48.45641189755042,69.54033033607189,0.221182439310027,1.1048305578034672,0.8836481184934402,1449134587,1452357365.2,52.49249986655688,50.19369099180574,NaN,NaN,9.466230636493217,6.0540693397422665
2020-11-23T09:30:00-05:00,120.48,121.27,119.04,120.08,4904344,9618204.3,52.80412456969922,56.059781646808666,NaN,NaN,36.74870730947745,58.15695807655675,0.10892079838865798,1.0197991164792626,0.9108783180906046,1444230243,1449652051,49.23833548256092,51.804625567332,NaN,NaN,8.969240681557633,6.470522388573033
2020-11-24T09:30:00-05:00,120.54,121.985,119.67,121.75,6820664,9482619.35,56.69555696853557,56.33719814720315,NaN,NaN,52.703272511292866,51.96490025712474,0.1311187633147528,1.0747767722340456,0.9436580089192927,1451050907,1449304810.6,48.81998803894522,52.67568867218338,NaN,NaN,9.610471222043367,6.919086507640224
2020-11-25T09:30:00-05:00,122.17,122.52,121.55,122.01,6093186,8968386.7,57.28605263204202,56.19792586646052,NaN,NaN,68.21130579187042,52.835871455500204,0.14614799810166823,1.126343006546378,0.9801950084447097,1457144093,1451130560.2,51.169205378754285,53.11773498013948,NaN,NaN,10.30411577863278,7.402662117782018
2020-11-27T09:30:00-05:00,122.66,123.18,122.43,122.66,3512927,8658814.6,58.798640100739036,56.11725830747597,NaN,NaN,83.37687150743477,57.89931380352518,0.18045194243508167,1.2057599364885618,1.0253079940534802,1460657020,1452443370,52.84527968023249,52.941555126633546,NaN,NaN,11.301768572170474,7.959677325551797
2020-11-30T09:30:00-05:00,122.62,123.66,121.23,123.48,16114637,8818291.6,60.68985389537334,56.32607840245858,NaN,NaN,90.31237800318917,66.27050702465293,0.23547634822303753,1.319653429332277,1.0841770811092395,1476771657,1457970784,59.19579874513964,52.949179610805054,NaN,NaN,12.671782266836207,8.632835174306713
2020-12-01T09:30:00-05:00,124.5,125.75,123.98,125.06,11332100,8783903.75,64.10846016868001,57.15186769754106,NaN,NaN,193.7954717959168,97.6798599219408,0.3485681938255931,1.519887323391231,1.1713191295656378,1488103757,1466745486.8,66.83230121378254,53.45779259095183,NaN,NaN,14.85058234364981,9.521084769927155
2020-12-02T09:30:00-05:00,124.53,125.01,123.59,124.87,8019437,8660622.05,63.39449476211501,57.559423080644756,NaN,NaN,171.05002717107328,121.34921085389688,0.3783754019497061,1.6442883820027703,1.2659129800530642,1480084320,1472552169.4,70.73542394659934,54.29958557426819,NaN,NaN,16.4848746343227,10.515911893412232
2020-12-03T09:30:00-05:00,125.01,125.63,124.455,124.79,6887703,8235912.05,63.075967350055336,58.12108537610026,NaN,NaN,173.76461726876676,142.45987314927615,0.36057641863136114,1.7166335033422655,1.3560570847109044,1473196617,1475762674.2,72.65169607926386,55.60345406999277,NaN,NaN,17.779099015331028,11.553510053686345
2020-12-04T09:30:00-05:00,124.97,126.06,124.7,126.04,5179357,7940133.55,65.95442993039856,58.75454004023994,NaN,NaN,171.42816891817913,160.07013263142503,0.3979275152013717,1.853466478712619,1.4555389635112472,1478375974,1479306465,74.62671424114734,57.39401570977697,NaN,NaN,19.71037247374349,12.718776113694508
2020-12-07T09:30:00-05:00,126.11,126.77,125.89,126.4,4452714,7676386.8,66.75816627197088,59.29480281279451,NaN,NaN,168.69099535191594,175.74585610117038,0.4101829291115089,1.9682676249006335,1.5580846957891246,1482828688,1480517871.2,75.28380993545177,59.209367316832534,NaN,NaN,21.572071182613524,13.98353255211151
2020-12-08T09:30:00-05:00,126.28,127.21,125.739,126.81,3943420,6879355.3,67.69358864535707,60.02802539124117,NaN,NaN,145.89974362402236,166.16671046679147,0.4083223995902887,2.0684876952769855,1.6601652956866968,1486772108,1480251541.4,74.82502049921023,60.87491511964977,NaN,NaN,23.42032535299474,15.331645809380543
2020-12-09T09:30:00-05:00,126.73,127.105,123.95,124.38,8635910,6722691.55,57.38642742364302,60.262401492923864,NaN,NaN,84.69256331820532,148.8952176962179,0.21553898764349144,1.9295890302410612,1.7140500425975698,1478136198,1479861917,74.11344678237622,62.543356870217245,NaN,NaN,22.28637194822588,16.325178114929876
2020-12-10T09:30:00-05:00,123.62,125.15,123.33,124.56,4998714,6610413.45,57.89781140313273,60.38764072004945,NaN,NaN,49.70175073901466,124.08264439026748,0.07926768240916471,1.8131346456090256,1.7338669631998609,1483134912,1481849576,75.39876420299885,64.15916314950142,NaN,NaN,21.48210865715624,17.061882478105073
2020-12-11T09:30:00-05:00,123.81,124.3,122.9,124.3,6511630,6577141.05,56.83681375127517,60.67002770521545,NaN,NaN,26.65028662051624,95.12706793073491,-0.04269980132336482,1.6804922115456549,1.7231920128690197,1476623282,1481499037.6,74.69439142603449,65.74501254660696,NaN,NaN,20.519257197438648,17.555793152295582
2020-12-14T09:30:00-05:00,124.68,125.87,124.6,124.75,5528014,6557216.35,58.26243205822976,61.059906811539065,NaN,NaN,64.53254264587243,74.29537738952621,-0.10390032701565066,1.5933166040994564,1.697216931115107,1482151296,1481363559.2,74.40508366343127,67.54263741666914,NaN,NaN,20.05789348308283,17.91323605669376
2020-12-15T09:30:00-05:00,126.1,126.83,125.29,126.83,4557288,6413476.2,64.15557400633992,61.592765171382226,NaN,NaN,98.74864721009403,64.86515810674054,-0.01954546608910679,1.6727850985037236,1.6923305645928304,1486708584,1481350854.4,74.37599074331447,69.36806618126694,NaN,NaN,21.29667678532137,18.396584732211988
2020-12-16T09:30:00-05:00,127,128.14,126.58,127.69,5154629,6422722.4,66.27579570217978,62.23488967639207,NaN,NaN,126.06830975148931,73.14030739339734,0.07380566830743684,1.7845876499771265,1.7107819816696896,1491863213,1484096257.4,76.51312991780429,71.1783465054848,NaN,NaN,22.97290619797427,19.0503449416066
2020-12-17T09:30:00-05:00,128.62,128.98,128.09,128.7,5752497,6471759.05,68.62313967530743,62.936639646004096,NaN,NaN,150.23501474613477,93.24696019482136,0.1773063034329032,1.9324148609608187,1.7551085575279155,1497615710,1486992417,78.54593776792068,73.01410779746253,NaN,NaN,25.111706684755614,19.91625376205646
2020-12-18T09:30:00-05:00,128.89,128.91,127.43,128.25,8846673,6610211.4,66.40538182826222,63.344891641210445,NaN,NaN,127.37242360378157,113.39138759147443,0.18816486856209425,1.9903146432305334,1.8021497746684392,1488769037,1489421568,80.10156922507016,74.50737711745755,NaN,NaN,26.280607050627196,20.825447088995137
2020-12-21T09:30:00-05:00,126.33,128.14,125.2,128.08,7616125,6743098.45,65.54360471901563,63.447401966234416,NaN,NaN,84.91097311618563,117.46707368553707,0.15782803513742216,1.9994348185902169,1.8416067834527947,1481152912,1489221891.2,79.59069118369257,75.41869068673684,NaN,NaN,27.018906995868658,21.710227075691353
2020-12-22T09:30:00-05:00,128.79,129.77,128.2,129.19,7167621,6856262.3,68.42494488844474,63.80671983240082,NaN,NaN,143.52527276603607,126.42239879672547,0.18458791859324752,2.072341681694354,1.8877537631011065,1488320533,1489544281,79.81453919900873,76.06719891905179,NaN,NaN,28.483685551589822,22.677864000819707
2020-12-23T09:30:00-05:00,129.34,129.4345,128.02,128.21,5650370,6797747.6,63.385288306902936,63.82881418646137,NaN,NaN,112.42543616723268,123.69382407987413,0.11193249014948714,2.0276693757879656,1.9157368856384784,1482670163,1487705671,74.77735253874718,76.2190315233006,NaN,NaN,28.32929358923282,23.485211084878724
2020-12-24T09:30:00-05:00,128.43,129.38,128.34,129.06,2192320,6602704.3,65.74209935733839,63.81364771695707,NaN,NaN,115.08197761711338,116.66321665406988,0.09730539581780873,2.0373686304107395,1.9400632345929307,1484862483,1485155025.6,68.3343235589332,75.76957504599959,NaN,NaN,28.866526283111178,24.25397039891193
2020-12-28T09:30:00-05:00,130.34,130.78,129.73,130.52,4085462,6631331.05,69.38705968070575,64.001425817581,NaN,NaN,153.7502800783668,121.93878794898691,0.15852310981577733,2.1382171218626524,1.9796940120468751,1488947945,1485190807.2,68.3754895111635,75.27612358712186,NaN,NaN,30.43710375861311,25.137275164583528
2020-12-29T09:30:00-05:00,131.23,131.4,129.67,129.9,4420699,6046634.15,66.1674729743328,63.892417555364965,NaN,NaN,135.37435846531824,132.03146501881344,0.1309676996174649,2.1434036365687064,2.0124359369512415,1484527246,1485865674,69.18906392020374,74.87355526004997,NaN,NaN,30.805258611097425,25.946987085514085
2020-12-30T09:30:00-05:00,130.35,130.62,129.64,129.83,4070885,5683573.4,65.79626787372098,64.49312044465626,NaN,NaN,109.98572650246675,125.32355576609957,0.08401672835013319,2.117456847388908,2.033440119038775,1480456361,1484292839.6,64.9925681948494,74.22206393236948,NaN,NaN,31.001456180850433,26.669054099133565
2020-12-31T09:30:00-05:00,129.89,130.39,128.97,130.02,5529167,5559059.9,66.34811530195182,65.09671358028619,NaN,NaN,91.3521144619012,121.10889142503329,0.04377134412968431,2.0881542992008804,2.044382955071196,1485985528,1484955912.6,65.93072461517215,73.54577539038186,NaN,NaN,31.313988710716657,27.332616186502577
2021-01-04T09:30:00-05:00,130.68,130.71,126.24,127.9,10508554,5740102.45,55.57394789299761,65.0065088761235,NaN,NaN,30.5912750773765,104.2107509170859,-0.1376799456615201,1.8722830229942957,2.009962968655816,1475476974,1483078810.8,60.95098221315583,72.56410330374767,NaN,NaN,28.348581864252264,27.477754140466818
2021-01-05T09:30:00-05:00,127.61,128.94,127.53,128.73,6180342,5790151.7,58.42075868815616,65.01781792111824,NaN,NaN,30.83166392970419,79.62702768735338,-0.20954847629854134,1.748027373282639,1.9575758495811804,1481657316,1481620685,57.32869458097167,71.34436122642913,NaN,NaN,26.66891803896947,27.362206125967198
2021-01-06T09:30:00-05:00,126.89,128.98,126.12,126.51,13628900,6248961,49.31777220049905,63.95797493498675,NaN,NaN,-19.86897104672732,48.57836178494426,-0.403131460614524,1.4536615238130253,1.8567929844275493,1468028416,1478320919,50.07592271210199,69.60864208134252,NaN,NaN,22.11021909571171,26.611922264502127
2021-01-07T09:30:00-05:00,127.73,130.17,127.68,129.92,9825978,6543088.9,59.704130960799944,63.48857031060248,NaN,NaN,60.173135797525845,38.615843643956076,-0.30264250113981994,1.4784898580027743,1.7811323591425943,1477854394,1477800525.6,49.02259958002072,67.64503277150084,NaN,NaN,21.615559425625662,25.898156144662632
2021-01-08T09:30:00-05:00,130.56,131.11,129.28,130.76,6193811,6420983.95,61.78185024833041,62.999906780104126,NaN,NaN,101.5500920637063,40.6554391643171,-0.18642435425619364,1.5481019163223522,1.7345262705785458,1484048205,1477413061,48.20948805892686,65.4781435065727,NaN,NaN,21.960039839800736,25.335568101110933
2021-01-11T09:30:00-05:00,129.49,130.6,129.14,129.68,8928693,6617482.9,57.664975894871766,62.37559207057624,NaN,NaN,73.21040851618076,49.179265852077954,-0.1885448204474789,1.4988452450191971,1.687390065466676,1475119512,1477341568.6,48.051119190110185,63.188825646932706,NaN,NaN,20.824109142785034,24.691073964207234
2021-01-12T09:30:00-05:00,129.52,129.69,127.83,129.06,8544586,6719130.7,55.3833797498531,61.64986171563605,NaN,NaN,16.07278671111448,46.22749040836001,-0.2349406212319336,1.393714288926759,1.6286549101586927,1466574926,1474325090.6,41.81025064235319,60.49022275112275,NaN,NaN,19.16919918150834,23.902234709535964
2021-01-13T09:30:00-05:00,129.23,130.28,128.98,129.88,6802482,6782854.1,57.76361688441215,60.88833828677658,NaN,NaN,62.921579671993044,62.785600552104086,-0.2142222863442429,1.360877052228389,1.575099338572632,1473377408,1475394889,44.56035053020577,57.97206641763683,NaN,NaN,18.573460459756987,23.140981245281825
2021-01-14T09:30:00-05:00,130.2,130.47,128.55,128.74,7811465,6945562.95,53.49112750367868,60.181612515117706,NaN,NaN,22.39049164379063,55.22907172135704,-0.27711856594368456,1.2287011311430263,1.5058196970867108,1465565943,1472937198.8,39.895518863478294,55.480506869403335,NaN,NaN,16.710356574835412,22.222320578075195
2021-01-15T09:30:00-05:00,128.55,129.12,127.16,127.42,6320564,7003859.7,48.974156134512896,58.98390228491588,NaN,NaN,-92.2807642724616,16.462900454123464,-0.3999813093317044,1.0058430604220803,1.4058243697537847,1459245379,1467976633.6,32.50012765393973,52.92092144761809,NaN,NaN,13.675172091139173,21.00129936565576
2021-01-19T09:30:00-05:00,128.3,129.3,127.85,129.08,5783021,7005385.9,54.21073986446806,57.89987944089891,NaN,NaN,-22.428238315464892,-2.6648289122056688,-0.36290092596095525,0.9521982123025907,1.315099138263546,1465028400,1465958411.2,30.058773242997205,50.18401314274907,NaN,NaN,12.773253492324022,19.825864240894084
2021-01-20T09:30:00-05:00,130.0701,132.1,129.89,131.64,5885017,6857303.1,60.878630477687295,57.522104976852795,NaN,NaN,160.41228781939435,26.2030713094503,-0.16925208226636923,1.1035340354305845,1.2727861176969537,1470913417,1466826109.4,32.409571296959854,47.55690652680308,NaN,NaN,14.295751297046428,19.035848106058705
2021-01-21T09:30:00-05:00,132.35,133.78,131.64,133.34,4474102,6700201.95,64.56847698590718,57.43440562772323,NaN,NaN,243.8568444069486,62.39012425644141,0.0578820155965436,1.3451386371926333,1.2872566215960897,1475387519,1467228131.6,33.52440561443785,45.30918062820226,NaN,NaN,16.8513188107082,18.723772492437202
2021-01-22T09:30:00-05:00,132.78,133.5,132.51,132.83,5621759,6622908.85,62.65913132462637,57.17090677219999,NaN,NaN,199.44566428483725,97.80115878465074,0.15292831546479113,1.4784170159270786,1.3254887004622875,1469765760,1468068095,35.903197790191626,43.16435728356079,NaN,NaN,18.23093526883634,18.653367174779937
2021-01-25T09:30:00-05:00,134.33,134.79,130.7,133.94,9102612,6795520.95,65.07950225126439,57.84987494064762,NaN,NaN,176.96274658300354,151.64986095574378,0.26323811923965623,1.654536349511858,1.3912982302722017,1478868372,1471992693.6,45.68337290555114,42.07381376158902,NaN,NaN,20.155616245212524,18.867974184841735
2021-01-26T09:30:00-05:00,134.41,134.62,133.52,134.03,4296729,6900741.4,65.27603324785133,58.33953740919727,NaN,NaN,183.14838990426514,192.76518659968977,0.31163817935244853,1.7808459544627624,1.4692077751103139,1483165101,1475620033.8,52.84505785460946,41.75355399542029,NaN,NaN,21.73563284550884,19.27763970779418
2021-01-27T09:30:00-05:00,133.39,133.82,130.31,131.5,12242268,7308581.7,55.77346583844563,58.80065838333631,NaN,NaN,73.22148239004923,175.32702551382073,0.1507846347495323,1.6576885685472291,1.5069039337976968,1470922833,1475621917,52.84853378011502,41.95159764313551,NaN,NaN,20.089949543394408,19.393683970022785
2021-01-28T09:30:00-05:00,132.17,134.24,131.72,132.04,8090826,7492088.05,57.20543524602707,58.6221801179954,NaN,NaN,94.01023913595776,145.35770445962257,0.06278375246982182,1.5853836243849742,1.5225998719151523,1479013659,1476347145,54.24723011390411,42.32478553841289,NaN,NaN,19.208608887438047,19.36724467251068
2021-01-29T09:30:00-05:00,131.38,131.9,128.2294,128.93,9511655,7764126.55,47.638731335368284,57.611957338498094,NaN,NaN,-24.60673138416925,100.54722532582129,-0.20801891059888167,1.2625762336665503,1.470595144265432,1469502004,1476294393.8,54.121470762672125,42.747070017251836,NaN,NaN,15.131395181230104,18.762123316613454
2021-02-01T09:30:00-05:00,130.46,132.8,129.5,132.16,5616337,7768485.05,55.889490801537875,57.48513697468854,NaN,NaN,42.54279063682129,73.66323413658485,-0.17412415954971783,1.2529399448282845,1.4270641043780024,1475118341,1475544387.6,52.2662266535859,43.04814912178582,NaN,NaN,14.501448494522219,18.153455484886134
2021-02-02T09:30:00-05:00,133.44,134.34,133.25,133.95,4297696,7457942.15,59.68113243564322,57.79211930938783,NaN,NaN,116.81099872048728,60.39575589982928,-0.04252836287588302,1.3739036507831486,1.4164320136590316,1479416037,1474794574.8,50.40591521888785,43.662125162966866,NaN,NaN,15.348496635661842,17.752747077854092
2021-02-03T09:30:00-05:00,134.22,134.5,133.09,133.49,5787414,7438295.75,58.294372369207906,57.830030415444675,NaN,NaN,99.37587330042271,65.62663408190397,-0.00008672554979360925,1.4163236067217895,1.416410332271583,1473628623,1475335732.8,51.74096978025233,44.1750265379702,NaN,NaN,15.539569658465716,17.436578875084326
2021-02-04T09:30:00-05:00,134.21,135.62,133.825,135.62,4067118,6960206.65,62.62500970351731,58.482450572576,NaN,NaN,133.82451747069317,73.58948974885105,0.1495378980929094,1.6033327048877197,1.4537948067948103,1477695741,1475072149.2,51.02053752286034,44.96967072792605,NaN,NaN,17.17504716294212,17.399217201921154
2021-02-05T09:30:00-05:00,136.03,136.05,134.93,135.32,4706874,6704251.45,61.653953384561305,59.3881503761509,NaN,NaN,131.42263744724414,104.79536351513373,0.20308142086993852,1.7076465828822336,1.504565162012295,1472988867,1475769521.8,52.88952854028331,46.42605650552201,NaN,NaN,18.145647554421192,17.50585010942116
2021-02-08T09:30:00-05:00,135.87,136.8,135.68,136.74,5856818,6687401.8,64.46282138599366,60.12044191340272,NaN,NaN,143.3734309008778,124.96149156794505,0.30289984921324975,1.8831899735288573,1.5802901243156076,1478845685,1476514990.6,54.87191962073389,48.19842410393177,NaN,NaN,19.85331550252919,17.841202308436593
2021-02-09T09:30:00-05:00,136.38,137.23,136.3392,136.58,5276284,6504781.35,63.89489348264977,60.33588927090005,NaN,NaN,135.81222926482147,128.76173767681186,0.3249675660571276,1.986499581887017,1.6615320158298894,1473569401,1475345663.4,51.230335487593884,49.54276440326277,NaN,NaN,21.045053271355062,18.298895303139233
2021-02-10T09:30:00-05:00,137.13,137.3,135.22,136.38,4732228,6314163.45,63.14599252235414,60.23428323778911,NaN,NaN,114.0008035486113,131.6867237264496,0.29385244366265106,2.028847570408203,1.7349951267455521,1468837173,1474387373.4,48.395728744934516,50.60500176972682,NaN,NaN,21.80368651097101,18.799579761400913
2021-02-11T09:30:00-05:00,137.3,137.97,136.77,137.88,3782103,6163144.5,66.33317108605803,60.49671464932,NaN,NaN,137.958316462791,132.51348352486917,0.3388547334183216,2.1585635435184543,1.8197088101001326,1472619276,1473372080.4,45.521873664738294,51.29205004648015,NaN,NaN,23.402319247897907,19.457113973757625
2021-02-12T09:30:00-05:00,137.52,138.68,137.14,138.59,3377754,5941458.95,67.75465038446967,60.687796658834664,NaN,NaN,139.1052199656807,134.05000002855647,0.37801857518193627,2.292232029077553,1.9142134538956168,1475997030,1473973713,47.510948873411195,51.42259118704158,NaN,NaN,25.1568470978833,20.271361562918436
2021-02-16T09:30:00-05:00,139.14,139.24,137.78,138.14,4861056,5868483.55,65.85673276898271,60.72927519605833,NaN,NaN,133.20450548411588,132.0162149452041,0.33657988672660766,2.3349383123038763,1.9983584255772686,1471135974,1472431770.8,43.16138392334549,50.73090019195131,NaN,NaN,26.099515061498497,21.103954919858445
2021-02-17T09:30:00-05:00,136.87,137.22,135.54,136.92,7637678,5961216.4,60.877874862941525,61.09387584066518,NaN,NaN,68.89105303247844,118.63197969873548,0.1968866435990071,2.2444667300760273,2.04758008647702,1463498296,1470417549.8,38.23692234029302,49.68721366053545,NaN,NaN,25.519751404066,21.734782989030954
2021-02-18T09:30:00-05:00,135.5,136.48,134.53,136.25,5478031,5940867.1,58.27237000074249,61.17008546600199,NaN,NaN,37.54553620023747,103.34092622906071,0.03758327035961262,2.0945591744265357,2.056975904066923,1458020265,1468254168.2,33.779105389750114,48.225204751667306,NaN,NaN,24.29675151398732,22.10077849259615
2021-02-19T09:30:00-05:00,136.95,137.07,135.44,136.05,5843082,6009316.1,57.48150849450055,61.87314097736858,NaN,NaN,47.124806862777575,85.17422430905803,-0.09575176434207666,1.9372861986393275,2.033037962981404,1452177183,1464165749.6,27.301280227529617,46.30947685629997,NaN,NaN,23.063601676362747,22.23832466170566
2021-02-22T09:30:00-05:00,134.38,134.82,132.97,133.05,7131326,6084794.45,47.14547878705058,61.24856869061949,NaN,NaN,-41.74282504303051,49.004615307315795,-0.3842919257438502,1.5526730558015913,1.9369649815454415,1445045857,1457975515,20.797924475296995,44.061740986422194,NaN,NaN,18.689999619538682,21.731421084253235
2021-02-23T09:30:00-05:00,130.84,133.5,128.61,132.68,12098528,6234590.25,46.04576310156356,60.27461373818524,NaN,NaN,-103.95575194383247,1.572563821726129,-0.5862695668140627,1.204128023027863,1.7903975898419258,1432947329,1450337786,15.797694057033993,41.58972518914692,NaN,NaN,14.786942783763713,20.739352755611876
2021-02-24T09:30:00-05:00,131.69,134.83,130.68,134.71,8236124,6431560,52.58113783653901,59.86652555728032,NaN,NaN,-42.42947355183109,-20.691541495135787,-0.5689048753427264,1.0792664956635178,1.6481713710062442,1441183453,1445874817.4,13.721716172111186,38.874064217136834,NaN,NaN,13.266680290352786,19.67182811771772
2021-02-25T09:30:00-05:00,133.51,134.4,129.42,130,17156072,6677250.2,40.36444880460442,58.27648549307226,NaN,NaN,-108.84170601762182,-49.96898993870766,-0.8438053498647167,0.5934146836753484,1.4372200335400651,1424027381,1439076240.6,11.288207640101234,36.03604065408261,NaN,NaN,7.342210645021511,17.91045419304683
2021-02-26T09:30:00-05:00,131.29,132.7,129.53,130.69,17755942,7160506,42.47311232509052,56.90642541739577,NaN,NaN,-110.77412041764465,-81.5487753947921,-0.94094264349622,0.26104172916978996,1.20198437266601,1441783323,1436997468.6,10.66537128558521,33.02002942160418,NaN,NaN,3.4533373966955003,15.84515179356807
2021-03-01T09:30:00-05:00,132.91,134.98,132.0701,134.9,12387609,7304303.7,53.31889430209843,56.11043062568898,NaN,NaN,-28.503519157843783,-78.90091421775476,-0.6947865464909047,0.3335011895523792,1.0282877360432838,1454170932,1438822483.6,15.09460420179974,30.178792605966027,NaN,NaN,3.9709469003249773,14.148836808819055
2021-03-02T09:30:00-05:00,135.09,135.18,132.565,132.76,12401434,7643558.55,48.330844965964154,54.998712874497144,NaN,NaN,-51.37325647433641,-68.38441512385555,-0.6500233184531126,0.21575858797689307,0.8657819064300056,1441769498,1440586917.4,19.26241550139791,27.89536974980917,NaN,NaN,2.5507407560588278,12.491965944139023
2021-03-03T09:30:00-05:00,132.12,132.5,129.28,129.42,14944652,8175906.35,41.76383920140691,53.471416208715205,NaN,NaN,-142.9772384178035,-88.49396809705004,-0.8089354633896312,-0.14538742280703332,0.6635480405825979,1426824846,1437715196,17.736397070077047,25.705417487319348,NaN,NaN,-1.133062348903608,10.545533330847219
2021-03-04T09:30:00-05:00,129.02,129.96,124.96,126.56,38477759,9810423.6,37.11355195642266,51.3843005565984,NaN,NaN,-202.87306836702786,-107.30024056693124,-1.0547007428469788,-0.6548278879761256,0.39987285487085317,1388347087,1430579137.2,14.633908639962257,23.499134271263923,NaN,NaN,-5.891384801527361,8.197402169079421
2021-03-05T09:30:00-05:00,128.14,129.31,124.71,128.95,23042887,10759212.05,42.841232308896636,49.60477069405747,NaN,NaN,-158.2671315389156,-116.79884279118544,-1.0045738509604374,-0.8558444588296936,0.14872939213074376,1411389974,1424500467.4,12.610386415870352,21.006236952868147,NaN,NaN,-7.552103550679007,5.947472780542503
2021-03-08T09:30:00-05:00,128.83,129.45,125.7,125.83,17621212,11404928.95,37.978296223892166,47.613453797979574,NaN,NaN,-148.92232368396054,-140.8826036964088,-1.12096091358753,-1.2524717498536688,-0.13151083626613874,1393768762,1412420033.4,9.730673432517335,18.618329060666134,NaN,NaN,-10.728718486038654,3.5651597424594805
2021-03-09T09:30:00-05:00,128.77,130.91,128.6,130.11,11493641,11686770.1,46.88518691979851,46.61397608775508,NaN,NaN,-74.96661698404746,-145.601275798351,-0.8608088859290937,-1.2075219436775058,-0.34671305774841216,1405262403,1405118614.4,8.471487401667972,16.49222656505006,NaN,NaN,-9.94900548856799,1.6345647094555564
2021-03-10T09:30:00-05:00,131.51,131.53,129.49,129.59,9229490,11884430.4,46.0204626100846,45.738839845565224,NaN,NaN,-60.29589332076742,-129.06500677894377,-0.6826498791748274,-1.2000254067169465,-0.517375527542119,1396032913,1398960227.8,7.580467599821915,14.620895294340903,NaN,NaN,-9.673872539420413,0.019073673901846444
2021-03-11T09:30:00-05:00,131.54,133.1793,131.26,132.36,6681427,11981890.35,51.1852687822679,45.28910843754861,NaN,NaN,-11.517299393955513,-90.79385298432932,-0.35370588786175483,-0.9595078873693126,-0.6058019995075578,1402714340,1401833678.4,12.219700895083164,13.543639627737587,NaN,NaN,-7.610752909465887,-1.0709015522935441
2021-03-12T09:30:00-05:00,130.78,131.45,129.94,131.41,6221073,12103838.85,49.43817654879287,45.452872563387345,NaN,NaN,-36.539636580398685,-66.44835399262593,-0.18409211913253032,-0.8359171484232206,-0.6518250292906903,1396493267,1398854337,11.571127196260619,12.884582679234985,NaN,NaN,-6.580548396087907,-1.8579939585498817
2021-03-15T09:30:00-04:00,131.51,132.89,130.985,132.81,8294043,12349653.3,52.03637294535397,45.88077326651523,NaN,NaN,2.2077876562154235,-36.22233172459072,0.027156211939233454,-0.6178797643666485,-0.6450359763058819,1404787310,1401058046.6,15.158098690416466,12.838897295905157,NaN,NaN,-4.901660592807052,-2.2928034777294775
2021-03-16T09:30:00-04:00,133.83,135.09,133.24,133.81,6553407,12434270.85,53.86019171785261,45.97213425803762,NaN,NaN,63.43008411178048,-8.542991505425118,0.22783733347851398,-0.3602393094577394,-0.5880766429362534,1411340717,1402273709.4,17.1544926409547,13.084095615108264,NaN,NaN,-2.9716701774038814,-2.389784434825821
2021-03-17T09:30:00-04:00,132.73,134.5,131.7201,133.7,9683241,12536549,53.61866619050872,46.9188640713165,NaN,NaN,49.765744060731414,13.46933597087465,0.3400182025954186,-0.1630538896919802,-0.5030720922873988,1401657476,1403398622,19.052635534858553,13.638697607590927,NaN,NaN,-1.502554482247841,-2.263037298743252
2021-03-18T09:30:00-04:00,131.87,132.095,129.83,129.99,8792426,12702268.75,46.10861155346127,47.178542587628705,NaN,NaN,-30.632209849438425,9.646353879778061,0.1603295614936558,-0.30266014042032907,-0.46298970191398486,1392865050,1401428764,18.263511891327525,14.18142193657252,NaN,NaN,-2.506200081200193,-2.297774839094244
2021-03-19T09:30:00-04:00,130.02,130.59,128.98,129.6,13612610,13090745.15,45.38891035178512,46.612115162606315,NaN,NaN,-56.36583032465046,5.681115130927701,0.018631561699522903,-0.4397002497895812,-0.4583318114891041,1379252440,1397980598.6,16.940809871023887,14.313293770088531,NaN,NaN,-3.52646817907172,-2.473302459091026
2021-03-22T09:30:00-04:00,130.02,132.51,129.81,131.87,7991863,13133772,50.255872151645654,46.74961710444071,NaN,NaN,13.08996160081607,7.85754991984783,0.07788592382710352,-0.36097440670522474,-0.43886033053232826,1387244303,1394471997.2,15.695218164363396,14.058493960300353,NaN,NaN,-2.9357341691592853,-2.53936413195792
2021-03-23T09:30:00-04:00,132.23,132.81,130.7,131.05,6464580,12852074.6,48.571900145750554,47.23590717189382,NaN,NaN,18.3582240663608,-1.156822089236106,0.06261302276544112,-0.36059405207552686,-0.423207074840968,1380779723,1388359798.4,13.792660963071853,13.776798524085695,NaN,NaN,-2.9429089793073766,-2.5970133958649853
2021-03-24T09:30:00-04:00,131.84,131.8638,129.44,129.46,7104975,12795517.15,45.39554371161407,47.827478011550355,NaN,NaN,-28.758995580009497,-16.861770017384288,-0.04785380120309152,-0.4830243263448324,-0.43517052514174087,1373674748,1382763252.8,12.320043742637708,13.611522459991082,NaN,NaN,-3.882643575673026,-2.780674850123277
2021-03-25T09:30:00-04:00,128.69,129.96,127.72,129.38,11286833,12502055.2,45.235256549048664,47.99847974298979,NaN,NaN,-73.79353682720695,-25.494035412937997,-0.11572173752928322,-0.5798226970533449,-0.46410095952406166,1362387915,1376667825.8,10.948905364566357,13.492845242040799,NaN,NaN,-4.6909090320821445,-3.053565447545972
2021-03-26T09:30:00-04:00,129.31,132.81,129.26,132.67,7439540,11986235.1,52.64114707583499,49.04582623241428,NaN,NaN,30.275667956073516,-8.165735756793197,0.061997513323298004,-0.38660406786993917,-0.4486015811932372,1369827455,1374782828.8,10.557591614840774,13.551910826492472,NaN,NaN,-3.21685089704213,-3.0768919403311377
2021-03-29T09:30:00-04:00,132.27,132.64,130.98,131.98,8658866,11799797.95,51.08097226592509,49.34552518570903,NaN,NaN,49.39521568338095,-0.904684940280221,0.13019411162024963,-0.28585894166792514,-0.41605305328817477,1361168589,1369567686,9.541545633407651,13.628343557331021,NaN,NaN,-2.451164791006333,-2.987502347570451
2021-03-30T09:30:00-04:00,131.05,131.19,129.94,130.73,6617521,11510602.3,48.288813813702795,49.50755027168175,NaN,NaN,1.6989213662079297,-4.236545480310795,0.09013442427564744,-0.30338502294361547,-0.3935194472192629,1354551068,1364321955,8.640753444005526,13.704078260486993,NaN,NaN,-2.6011985992787734,-2.932316097814497
2021-03-31T09:30:00-04:00,131.73,133.62,131.62,132.81,7715169,11149128.15,52.902197301124794,49.63018802302867,NaN,NaN,89.14790310772024,19.34483425723513,0.19662917529733548,-0.14773297809759356,-0.34436215339492904,1362266237,1362040252.8,8.274820031672377,13.42230105595765,NaN,NaN,-1.3680797103951834,-2.708853756754595
2021-04-01T09:30:00-04:00,134.26,135.49,134.13,135.48,7175750,9584027.7,58.073036972035794,50.24696376754603,NaN,NaN,175.0913342426018,69.12180847119689,0.4266030422208956,0.18889164938119052,-0.2377113928397051,1369441987,1363451067.2,10.790509983154863,13.366542683592955,NaN,NaN,1.3292741994470663,-2.131978334440072
2021-04-05T09:30:00-04:00,136.27,138.52,136.09,138.28,6433395,8753553.1,62.6981490554209,51.00851920397937,NaN,NaN,246.47872761298942,112.36242040258007,0.7292395983559504,0.6738381051052329,-0.0554014932507175,1375875382,1364660652.6,12.99379214664421,13.211949359037792,NaN,NaN,5.1853319753568785,-1.0866482901833647
2021-04-06T09:30:00-04:00,138.06,138.51,137.23,137.69,5658137,8155399.35,61.16697513311765,51.53043230506973,NaN,NaN,210.88026097652138,144.65942946120816,0.8435510471262242,0.9990373156570627,0.15548626853083852,1370217245,1366470383.8,16.323637584600633,13.152602569298216,NaN,NaN,7.827590439037764,0.18681438541965356
2021-04-07T09:30:00-04:00,137.58,138.665,137.08,138.42,5042596,7832847.1,62.39080043095954,52.157013322244794,NaN,NaN,176.91219871551002,179.70208493106855,0.9161482647986969,1.3006715995292097,0.3845233347305128,1375259841,1370612138.4,23.536125645164816,13.47285186289152,NaN,NaN,10.364801079673331,1.6408124845987502
2021-04-08T09:30:00-04:00,139.72,140.45,139.48,140.42,7072277,7724986.45,65.5903596838233,53.54856676012779,NaN,NaN,190.7657311457114,200.02565053866678,1.0377544902816258,1.681716447582545,0.6439619573009192,1382332118,1374625314.6,29.846034525963788,14.300174908222683,NaN,NaN,13.54012917261115,3.3407148686005215
2021-04-09T09:30:00-04:00,139.91,141.81,139.66,141.77,4700653,7625947.75,67.59439189871924,55.1346725849088,NaN,NaN,172.21499675018978,199.4503830401844,1.1398570792323406,2.068783306341345,0.9289262271090044,1387032771,1378143471.4,34.91651630406386,15.58415393915411,NaN,NaN,16.82723026335863,5.267359924994537
2021-04-12T09:30:00-04:00,141.19,141.54,140.395,141.09,7953528,7712570.5,65.52431313415416,56.22527551223084,NaN,NaN,142.25801540995928,178.60624059957837,1.092234957820777,2.2942199243849757,1.2019849665641986,1379079243,1378784243.6,35.82627745472739,17.022086745608682,NaN,NaN,18.957488098667973,7.223092521233599
2021-04-13T09:30:00-04:00,141.63,142.53,141.37,142.42,5658115,7580774.1,67.61345637446814,57.58538667142495,NaN,NaN,137.35685267195268,163.90155893866464,1.0790487987681887,2.5507959650244345,1.4717471662562458,1384737358,1381688266.2,39.92484864911923,18.888671580326353,NaN,NaN,21.38936590820483,9.246845862229488
2021-04-14T09:30:00-04:00,142.4,142.47,140.64,140.91,5608105,7533509,62.94946914805833,58.83923848831382,NaN,NaN,106.67605231671135,149.85432965890487,0.9044361383097148,2.602292339143389,1.6978562008336744,1379129253,1382462148.6,41.00613754669461,20.93767828061613,NaN,NaN,22.13996681572585,11.088720284157539
2021-04-15T09:30:00-04:00,142.2,143.44,142.18,143.33,5514430,7325068.45,66.89123074501097,60.386093788025406,NaN,NaN,115.483021552603,134.7977877402832,0.886539984211625,2.8060311810982057,1.9194911968865807,1384643683,1382924461.6,41.68144177358248,23.13285945268871,NaN,NaN,23.995306236751578,12.932518277385258
2021-04-16T09:30:00-04:00,143.44,143.57,142.7,143.3,5848011,7177847.7,66.79635847805727,61.39718031675557,NaN,NaN,105.34730473711663,121.42424933766856,0.8094349658608975,2.9312849042127027,2.1218499383518052,1378795672,1381277041.8,39.92749055131688,25.230709376722718,NaN,NaN,25.462457186849345,14.722509550165842
2021-04-19T09:30:00-04:00,142.66,143.32,141.26,142.11,5127324,6753583.4,62.98054700288848,62.247149940824386,NaN,NaN,83.36778255606357,109.64620276688945,0.6233875948872956,2.901084431960925,2.2776968370736292,1373668348,1380194862.8,38.77327539628424,27.318690074071043,NaN,NaN,25.634621037017443,16.28138261971607
2021-04-20T09:30:00-04:00,141.81,142.425,140.06,140.85,4936743,6600827.4,59.12893570472132,63.02144436161142,NaN,NaN,61.4735836933736,94.46954897117362,0.3729221155745943,2.743849481541872,2.370927365967278,1368731605,1376993712.2,35.503777877099864,29.23747753357778,NaN,NaN,24.67810840073738,17.480914874147686
2021-04-21T09:30:00-04:00,140.6,142.32,140.21,142.27,4627069,6508951.85,61.95290523465365,63.66792349972062,NaN,NaN,64.17887011066075,85.9701125299635,0.26539180233682913,2.7026671188883142,2.437275316551485,1373358674,1375839596.4,34.378239973581074,31.102007529428402,NaN,NaN,24.651658840359715,18.505306869320833
2021-04-22T09:30:00-04:00,142.02,142.63,139.98,140.6,5826055,6445005.85,56.96767347578301,63.58896896427399,NaN,NaN,51.096133411215305,73.09273490168599,0.05528593598846232,2.506382736537063,2.4510968005486005,1367532619,1372417383.6,31.217914895191413,32.561107880288155,NaN,NaN,23.158377586509346,19.17003125749062
2021-04-23T09:30:00-04:00,140.86,143.15,140.83,142.7,4446405,6102984.45,61.19616822873,63.48168461951036,NaN,NaN,66.16463463224127,65.2562008807109,0.032368381627848386,2.4915572775834107,2.4591888959555623,1371979024,1371054054,30.03342458971636,33.77822448336474,NaN,NaN,23.107322801190108,19.73250147801912
2021-04-26T09:30:00-04:00,142.75,143.58,142.65,143.43,3867508,5924382.85,62.572949107878046,63.58211133199325,NaN,NaN,81.29125179707539,64.84089472891327,0.04047423733055755,2.509781692618759,2.4693074552882015,1375846532,1371489690.8,30.935188453558368,34.82190668829029,NaN,NaN,23.467917244228957,20.26613230176338
2021-04-27T09:30:00-04:00,143.66,143.77,142.57,143.08,5411046,5761991.85,61.44724946608968,63.514714834502534,NaN,NaN,77.8264775214176,68.11147349452207,-0.001415282809625218,2.46753835177617,2.4689536345857954,1370435486,1371830467,31.677008328910986,35.403398308557875,NaN,NaN,23.446210952957717,20.720429251934
2021-04-28T09:30:00-04:00,142.245,142.44,141.405,141.75,5345586,5698395.1,57.233628520800714,62.91780546571521,NaN,NaN,43.05738403159509,63.887176278708935,-0.13498310291735782,2.300224755939098,2.435207858856456,1365089900,1370176712.2,29.99335296736251,35.41392105437207,NaN,NaN,22.220054703672215,20.934661459325174
2021-04-29T09:30:00-04:00,142.91,143.09,140.19,141.63,6707380,5648005.65,56.854807128722044,62.150692267858275,NaN,NaN,29.80899697317402,59.629748991100676,-0.24148423248535478,2.1333525682497623,2.374836800735117,1358382520,1368346692.4,28.2067368789304,34.93465109543397,NaN,NaN,21.10544101604485,20.959058538856556
2021-04-30T09:30:00-04:00,140.19,140.95,139.37,139.7,5291731,5553804.7,51.00723311406263,61.11375798070888,NaN,NaN,-61.36122160463308,34.124577743725816,-0.44039709969214824,1.8243404261199316,2.26473752581208,1353090789,1364569045.4,24.90835097023667,34.15479920368463,NaN,NaN,18.411610316355485,20.595137364213546
2021-05-03T09:30:00-04:00,140.45,140.73,138.955,139.31,5402870,5502278.45,49.89057801384737,59.84783809780739,NaN,NaN,-92.94406353931427,-0.7224853235521266,-0.5875215561985665,1.5303355805638716,2.117857136762438,1347687919,1358937322.8,20.97124275755121,32.80097021142977,NaN,NaN,15.85152778039446,19.91747885223939
2021-05-04T09:30:00-04:00,138.27,138.31,135.29,136.81,9959803,5717361.75,43.34056789887488,58.447202294294286,NaN,NaN,-243.73407235316998,-65.03459529846964,-0.8277897232498386,1.0831199827001399,1.9109097059499784,1337728116,1352395848.8,17.509297839610127,31.122624518066598,NaN,NaN,11.50933720574242,18.716315759882683
2021-05-05T09:30:00-04:00,137.93,138.13,136.22,136.48,5622932,5746378.55,42.546521090395494,56.70829446182175,NaN,NaN,-221.7322641748817,-117.992524939765,-0.9734722785276877,0.6940693577903687,1.6675416363180564,1332105184,1345798905.6,14.847364554153685,29.205904716678823,NaN,NaN,7.71082827196196,17.144103261608294
2021-05-06T09:30:00-04:00,136.42,137.93,135.44,137.85,7169589,5751244.15,46.896303850240045,55.28686198840624,NaN,NaN,-180.10814104028955,-159.97595254245772,-0.9415247157710898,0.4906357416041942,1.432160457375284,1339274773,1341977356.2,13.561169061804875,27.32259603885654,NaN,NaN,5.6426484282575124,15.501038285415325
2021-05-07T09:30:00-04:00,139.23,139.85,138.43,139.03,9598536,5996138.3,50.38085344573448,54.38688387718094,NaN,NaN,-76.00022359172377,-162.90375293987586,-0.8098962111755512,0.419790193405845,1.2296864045813962,1348873309,1341133860.2,13.287559626139299,25.50218776956047,NaN,NaN,4.872231236306841,13.982637278399826
2021-05-10T09:30:00-04:00,138.36,138.43,135.47,135.52,10140538,6105488.8,41.63020490760545,53.13697453452981,NaN,NaN,-149.84458137672036,-174.28385650735706,-0.9201487331071997,0.07950048819739663,0.9996492213045963,1338732771,1339342830.6,12.701562470425003,23.873458097655124,NaN,NaN,1.307015789162872,12.171834208508834
2021-05-11T09:30:00-04:00,132.93,135.39,132.61,135.11,13523408,6498753.45,40.7400658222873,51.62177171936079,NaN,NaN,-179.91973352338732,-161.52098874140054,-0.9762960141441472,-0.22072079637558772,0.7555752177685595,1325209363,1336839080,11.910769008086163,22.26863874297692,NaN,NaN,-1.82361683624082,10.172484059258883
2021-05-12T09:30:00-04:00,133.12,133.85,130.958,131.31,14707256,6953711,33.57459776783426,49.95083774022159,NaN,NaN,-198.20549120876328,-156.81563414817683,-1.2097045493712872,-0.7565554689455496,0.45314908042573765,1310502107,1332518464.6,10.675571819388978,20.801328523276744,NaN,NaN,-7.195897754970343,7.6912866572261365
2021-05-13T09:30:00-04:00,132.75,134.245,132.16,133.05,11307520,7243365.5,38.875934662963104,48.35653534266681,NaN,NaN,-143.33647266811937,-149.46130047374282,-1.1856743245818555,-1.0289438253015817,0.15673049928027377,1321809627,1329025435.4,9.791501001560178,19.355476838408446,NaN,NaN,-9.85034803915071,5.185338843458016
2021-05-14T09:30:00-04:00,134.54,136.445,134.28,135.98,8411544,7371542.15,46.603878843159016,47.21588746661546,NaN,NaN,-77.29163537727123,-149.7195828308523,-0.9229007649571159,-0.9968954569161212,-0.07399469195900527,1330221171,1325295007.8,8.940019069925754,17.784393311006117,NaN,NaN,-9.43201287177101,3.097145741282441
2021-05-17T09:30:00-04:00,135.18,135.22,133.75,134.98,8133575,7521854.7,44.534384413560495,46.007825677149086,NaN,NaN,-86.88402665832294,-137.12747188717282,-0.7729624737692996,-1.0401977841706298,-0.2672353104013302,1322087596,1321965972.8,8.250493289738685,16.111070808208094,NaN,NaN,-9.787624127887144,1.256464331401072
2021-05-18T09:30:00-04:00,135.37,135.65,133.81,133.9,5868626,7568448.85,42.347248205087475,44.94451279745529,NaN,NaN,-81.70288102124195,-117.48410138674373,-0.7049508311141399,-1.148423849294005,-0.4434730181798652,1316218970,1320167894.2,7.896245070007325,14.532705958397008,NaN,NaN,-10.779321027898844,-0.46293357707034444
2021-05-19T09:30:00-04:00,131.82,134.47,131.5,134.37,15290626,8101626.7,43.64435749051167,44.00090925186883,NaN,NaN,-93.61094765486739,-96.56519267596457,-0.591330402809837,-1.1826360216921614,-0.5913056188823245,1331509596,1324369392,16.877303760481084,13.723460735650628,NaN,NaN,-11.173116704469258,-1.992959738127332
2021-05-20T09:30:00-04:00,134.91,137.395,134.89,136.94,8414074,8231027.65,50.237315055784464,43.94591510484896,NaN,NaN,-26.783674910194332,-73.25463312437958,-0.31971458623129845,-0.9909488516714475,-0.6712342654401491,1339923670,1327992200.6,23.778926156988632,13.64278753470434,NaN,NaN,-9.39488356976893,-3.050377428361846
2021-05-21T09:30:00-04:00,137.64,137.77,136.065,136.19,7074194,8362417.1,48.45575264052938,43.84342757818339,NaN,NaN,-16.11166542708954,-61.01863913434322,-0.17445482075167928,-0.8893027913797482,-0.7148479706280689,1332849476,1328517861.6,24.755158860539893,13.913067256346386,NaN,NaN,-8.496088449282736,-3.828336145636259
2021-05-24T09:30:00-04:00,137.32,139.0899,137.25,138.61,6614516,8499767.5,54.110656807048834,44.61271964305296,NaN,NaN,33.93664475352178,-36.854504851974276,0.08669227501285204,-0.6064826268620038,-0.6931749018748559,1339463992,1331993140.8,31.043314667931014,14.879782744083593,NaN,NaN,-5.887515452426503,-4.122504618034865
2021-05-25T09:30:00-04:00,139.17,139.49,138.34,138.65,5622933,8510361.85,54.20009827155721,45.44511801313594,NaN,NaN,60.350693723089734,-8.443789903107938,0.2547019128874022,-0.3747975107656032,-0.6294994236530054,1345086925,1337766731.8,40.0124160446398,16.67728642197546,NaN,NaN,-3.7972557397483695,-4.076040492565366
2021-05-26T09:30:00-04:00,138.85,139.25,138.19,138.64,6655692,8575867.15,54.17167173232304,45.96478714757044,NaN,NaN,66.21488367759409,23.521376363384352,0.3517560533175045,-0.18980435700612475,-0.5415604103236292,1338431233,1339151059.2,41.961654896695464,18.70589255303907,NaN,NaN,-2.117067623330378,-3.7961872255317965
2021-05-27T09:30:00-04:00,138.52,139.09,137.88,137.91,5677344,8524365.35,52.026528441363304,46.08233536154392,NaN,NaN,63.33328525144044,41.5447683957113,0.3524984830229438,-0.10093730654494948,-0.45343578956789327,1332753889,1337717103,40.49382984232502,20.649197568480904,NaN,NaN,-1.2812928180091798,-3.4369165958857084
2021-05-28T09:30:00-04:00,138.61,139.2,138.33,138.4,4611851,8490371.35,53.36154343179661,46.92028811327186,NaN,NaN,81.22009181310023,61.01111984374925,0.3698898134337488,0.00892647722429274,-0.3609633362094561,1337365740,1338620355.8,41.87312365416925,22.732880510176923,NaN,NaN,-0.2117245290567402,-2.9761748720529986
2021-06-01T09:30:00-04:00,139.02,139.17,137.47,137.72,6453653,8542910.5,51.23088247266534,47.66963215972744,NaN,NaN,66.80123236167042,67.58403736537898,0.3212949496134267,0.040655350807327295,-0.2806395988060994,1330912087,1336909974.8,39.98321534554751,24.73805524856702,NaN,NaN,0.1392383449485635,-2.5311158410527757
2021-06-02T09:30:00-04:00,138,139.23,137.74,138.67,5049066,8297373.65,53.99460300030233,49.12820396204659,NaN,NaN,76.83259603996433,70.8804178287539,0.33717913651606374,0.14083432183898026,-0.19634481467708348,1335961153,1335084820.4,38.011639856940874,26.690631536963583,NaN,NaN,1.1938734158001663,-1.9989745186452126
2021-06-03T09:30:00-04:00,137.55,138.1,136.54,137.38,6360681,8334261.1,49.86247428859007,49.91295679244852,NaN,NaN,30.7105604524238,63.77955318371984,0.24892480151220905,0.11481118721317785,-0.1341136142990312,1329600472,1333318668.2,36.15382209347932,28.573654472100664,NaN,NaN,0.992342247217731,-1.5716435520933636
2021-06-04T09:30:00-04:00,138.22,140.1793,138.22,140.02,5591273,8255345.3,57.09842535400885,50.662567257509224,NaN,NaN,99.21987886959235,70.95687190735023,0.35026096537854334,0.30371259242414794,-0.04654837295439537,1335191745,1333806239.4,37.068252996735296,30.582814038301347,NaN,NaN,2.9830569403536957,-0.9209720531723551
2021-06-07T09:30:00-04:00,139.9,140.15,139.305,139.99,5891970,8070017,56.99775710817465,51.552808164267375,NaN,NaN,108.09651090555316,76.3321557258408,0.3939250938146909,0.4458579943139682,0.05193290049927736,1329299775,1332193046.4,35.26840914512343,32.51266517082883,NaN,NaN,4.561835929669213,-0.13771376990927398
2021-06-08T09:30:00-04:00,140.66,141.25,139.61,140,4451349,7785557.55,57.02495580712572,52.60121585012725,NaN,NaN,109.22540294310305,84.81698984212734,0.40080743355304405,0.5529421924405824,0.15213475888753836,1333751124,1332760853.8,36.43825310660269,34.55138003058564,NaN,NaN,5.8659458821756365,0.7199518946742846
2021-06-09T09:30:00-04:00,140.68,140.92,140.02,140.1,4881736,7353473.95,57.3156992153528,53.57774025904447,NaN,NaN,102.08585459293339,89.86764155272115,0.38910494562317377,0.6385159409165055,0.2494109952933318,1338632860,1333295195.2,37.58146746526684,36.03024886664177,NaN,NaN,7.034657145418581,1.6220526447806125
2021-06-10T09:30:00-04:00,140.39,141.48,139.89,141.13,5637924,6900007.35,60.2952954829997,54.29616743241699,NaN,NaN,113.27765972180308,106.38106140659701,0.4248308899850937,0.780449607774699,0.35561871778960524,1344270784,1336229257.6,43.581936844878165,37.44474963006245,NaN,NaN,8.874200322694179,2.6580737416254077
2021-06-11T09:30:00-04:00,141.31,141.97,141.18,141.97,6050333,6637148,62.588889736465745,55.30567722498388,NaN,NaN,139.45866740650655,114.42881911397986,0.4753176121701742,0.949765733002323,0.4744481208321488,1350321117,1339255132,49.02445381683349,39.17827069836913,NaN,NaN,11.109990688535765,3.865490448326887
2021-06-14T09:30:00-04:00,142.11,143.42,141.53,143.41,5713464,6502244,66.19413313034556,56.16878267664792,NaN,NaN,165.4461515938367,125.89874725163654,0.5696167598343334,1.1864690706250656,0.6168523107907322,1356034581,1344602093.2,56.931006375394205,41.027391534616505,NaN,NaN,14.15540083872973,5.335477646955864
2021-06-15T09:30:00-04:00,143.3,143.3,142.27,142.53,7539957,6472563.1,62.24635461990513,56.74351527295848,NaN,NaN,147.3975461418649,133.5331758913889,0.5370781179842888,1.2881999582710932,0.7511218402868044,1348494624,1347550793.2,60.56370693107553,42.49534088364762,NaN,NaN,15.686998044294137,6.8142662751470455
2021-06-16T09:30:00-04:00,142.8,143.07,140.365,141.76,9601427,6659203.15,58.934324150720066,57.083704731415416,NaN,NaN,99.3085804785668,132.9777210685156,0.43254156964571466,1.2917988023439477,0.8592572326982331,1338893197,1347602860.6,60.62685861392172,43.82856972059236,NaN,NaN,16.074413543701553,8.137144456369118
2021-06-17T09:30:00-04:00,141.35,143.9885,141.35,143.4,7932183,6291281,63.40102740602451,57.896168943176924,NaN,NaN,132.81537287060613,136.88526369827622,0.44117282702293925,1.4107232664769072,0.9695504394539679,1346825380,1348113779.8,61.28205598377823,45.31344301641045,NaN,NaN,17.737236698104745,9.508586205188493
2021-06-18T09:30:00-04:00,142.71,143.27,141.92,142.09,10408302,6390992.4,57.976381858369585,58.22580025936071,NaN,NaN,101.636063462566,129.32074290948808,0.3310153774488984,1.3833196612650909,1.0523042838161925,1336417078,1345332972,55.835911919588476,46.310785035368966,NaN,NaN,17.552190512687847,10.657672534831258
2021-06-21T09:30:00-04:00,141.89,143.43,140.97,143.35,6138321,6344198.75,61.39754604412182,58.95199051446474,NaN,NaN,97.75572078772421,115.7826567482656,0.3154350482193924,1.446598094090433,1.1311630458710407,1342555399,1342637135.6,51.0952041979484,47.10449852482617,NaN,NaN,18.430034110567043,11.768009902793512
2021-06-22T09:30:00-04:00,143.26,144.73,143.1,144.65,4626583,6244802.1,64.59971825692078,59.70949874708035,NaN,NaN,141.09860258229818,114.52286803635225,0.36178433863385107,1.5833934691633544,1.2216091305295034,1347181982,1342374607.2,50.6442554350722,48.006828208978405,NaN,NaN,20.173214187594056,12.968753372050733
2021-06-23T09:30:00-04:00,144.67,144.995,144.17,144.49,4135464,6170428.65,63.8971755238172,60.71197740673943,NaN,NaN,135.89058153445558,121.83926824752999,0.3505218396100056,1.6597614300420105,1.3092395904320049,1343046518,1343205271.4,52.08521079839086,49.14478454504352,NaN,NaN,21.374258371558305,14.169539800551814
2021-06-24T09:30:00-04:00,145.42,145.8425,145.11,145.4,6139494,6144618.75,66.15184661004974,61.358650353599494,NaN,NaN,146.36365666214596,124.54892500583796,0.37122577601042694,1.7732718104450385,1.4020460344346115,1349186012,1343677397.8,52.92642667721761,50.27751123650654,NaN,NaN,23.062844341886994,15.44001187788541
2021-06-25T09:30:00-04:00,145.53,145.64,144.99,145.23,7192858,6220394.45,65.33101581963888,61.953883118704084,NaN,NaN,126.9666829400422,129.61504890133318,0.3411111447264208,1.8284349653426375,1.4873238206162167,1341993154,1344792613,54.93887611310738,51.682544591362536,NaN,NaN,24.22076277560646,16.694404863274134
2021-06-28T09:30:00-04:00,145.83,146.92,145.8,146.75,6278823,6303743.05,69.03113951359072,62.81146766916587,NaN,NaN,149.45975334563983,139.95585541291632,0.38779746902434487,1.9720706568966477,1.5842731878723029,1348271977,1345935928.6,56.969887796933804,53.14908992638619,NaN,NaN,26.350796849403057,18.073889432721124
2021-06-29T09:30:00-04:00,146.83,147.89,146.49,147.82,4914556,6226788.2,71.34925919724935,63.8138648107299,NaN,NaN,160.64311932551288,143.86475876155924,0.45057195254089155,2.1474881285484173,1.6969161760075258,1353186533,1347136838.8,59.05733544842028,54.68308049661143,NaN,NaN,28.883446656977124,19.618111893329125
2021-06-30T09:30:00-04:00,147.59,148.02,147.2,147.66,5506796,6249674.7,70.49945808321195,64.54273356788792,NaN,NaN,149.69956254372622,146.6265549634134,0.4406167693034668,2.2476871376368592,1.8070703683333924,1347679737,1348063482.6,60.64384521058673,55.90178823701918,NaN,NaN,30.714698112931593,21.20333849612948
2021-07-01T09:30:00-04:00,147.46,147.91,146.91,147.91,5818357,6222558.5,71.0790797940137,65.14917571485562,NaN,NaN,128.88132399182078,143.13008842934835,0.4107588945282994,2.3205189864937665,1.9097600919654671,1353498094,1348925899,62.115210119370786,56.836842258629,NaN,NaN,32.40308239298739,22.803301909966326
2021-07-02T09:30:00-04:00,148.62,150.015,148.58,149.86,6390214,6262505.55,75.17606634584982,65.79074237310593,NaN,NaN,159.31264736977352,149.59928131529463,0.4775454232914167,2.506691871079738,2.0291464477883214,1359888308,1352504929.8,67.53899876835833,57.59455600098358,NaN,NaN,35.20597545269948,24.57511241607106
2021-07-06T09:30:00-04:00,150.18,151.14,148.99,150.43,5935320,6264673.05,76.23580894929938,66.7899891109198,NaN,NaN,155.54948010673698,150.81722666751406,0.5122489329962714,2.6694576140336608,2.1572086810373894,1365823628,1356015260,71.80292047892972,58.397356968687454,NaN,NaN,37.86524769807566,26.473703170643148
2021-07-07T09:30:00-04:00,151.39,151.56,150.04,151.25,7441850,6414198.1,77.71003110789734,68.13111103643247,NaN,NaN,151.9782702814642,149.08425685870432,0.53981110960201,2.8319725680399017,2.2921614584378918,1373265478,1360031049,75.7304280140253,59.47618335440914,NaN,NaN,40.575799036804646,28.488288294380503
2021-07-08T09:30:00-04:00,148.87,150.235,148.2,149.82,8543366,6597279.6,69.60111236542672,68.57397424781834,NaN,NaN,102.24972305783848,139.59428896152676,0.41663229982874306,2.8129518332238206,2.3963195333950775,1364722112,1363439524,78.47138880382222,60.703992841555134,NaN,NaN,40.516389022572355,30.20658839840791
2021-07-09T09:30:00-04:00,149.64,151.34,149.42,151.2,4887909,6559778.85,72.57522042336976,69.61674843103265,NaN,NaN,117.34599117572698,137.28722239830802,0.3838072429232242,2.8760785870491077,2.4922713441258835,1369610021,1366661909.4,80.69157595664674,62.47939741563073,NaN,NaN,41.379185227647056,31.802673659727787
2021-07-12T09:30:00-04:00,151.8,151.87,150.83,151.32,4810115,6497767.95,72.82420256106711,70.43293818224302,NaN,NaN,119.19532571974254,129.2637580683018,0.32804988084288755,2.902333695179493,2.5742838143366056,1374420136,1369568275,82.44957507668303,64.71899533554034,NaN,NaN,42.14479862152524,33.28012008284171
2021-07-13T09:30:00-04:00,151.06,153.04,150.93,151.94,7601420,6592165.75,74.1309757642437,71.11374228990894,NaN,NaN,119.46983424698381,122.04782889635116,0.2920030270791849,2.9392875981855866,2.6472845711064017,1382021556,1372807860.6,84.17874134405734,67.1143157576107,NaN,NaN,43.16724890697476,34.69256705771786
2021-07-14T09:30:00-04:00,153.16,153.84,152.39,153.06,6443364,6537336.1,76.34392582441504,72.00279588280878,NaN,NaN,130.5095653889615,117.75408791785067,0.301443271655224,3.0240886606754316,2.7226453890202076,1388464920,1375847749,85.6113333807649,69.50903879920885,NaN,NaN,44.71436790060922,36.12425289241663
2021-07-15T09:30:00-04:00,152.88,153,150.99,151.8,6253342,6369931.85,69.17464323214689,72.2187099272443,NaN,NaN,95.33489424462577,116.37112215520813,0.18632598494128327,2.9555528701968115,2.769226885255528,1382211578,1379345642.2,87.0629452377944,71.94736155353577,NaN,NaN,43.87143766300872,37.23099357392979
2021-07-16T09:30:00-04:00,152.1,152.82,150.15,150.3,7540473,6350346.35,61.74132764000235,71.96230362869883,NaN,NaN,68.50517817945965,106.60295955595466,-0.016567824838802814,2.748517104207025,2.7650849290458277,1374671105,1380357859,87.45728730644065,74.27010521020243,NaN,NaN,40.75760786245105,37.734795615147114
2021-07-19T09:30:00-04:00,148.51,148.919,147.37,148.23,12126987,6436280.6,53.23914405752924,70.83430395326587,NaN,NaN,-7.8167342784792515,81.2005475563103,-0.300180536940025,2.3898592578707962,2.6900397948108212,1362544118,1377982655.4,81.20241263975016,76.00099984183217,NaN,NaN,35.08980650347715,37.35694002776569
2021-07-20T09:30:00-04:00,148.97,151.26,148.11,150.43,7357765,6497252.8,59.60578940507551,69.99548468239631,NaN,NaN,31.971642192190558,63.700909145351645,-0.34633324954962097,2.257123232873795,2.603456482423416,1369901883,1375558720.8,75.28495013308797,77.1601151764513,NaN,NaN,32.342252990703564,36.64055616532824
2021-07-21T09:30:00-04:00,150.37,151.91,150.09,151.88,6116978,6571772.55,63.16548728406867,69.47162962531465,NaN,NaN,66.59329917274914,50.917655902109175,-0.2883051177153031,2.243075085279287,2.53138020299459,1376018861,1373069509,69.6700942166069,77.80484724830988,NaN,NaN,31.3167584598677,35.88001363597674
2021-07-22T09:30:00-04:00,152.2,153.118,152.2,153,4789080,6604453.35,65.68119874310722,69.08606669310704,NaN,NaN,107.98944435657752,53.44856592449953,-0.18842310483800562,2.295851321947083,2.4842744267850887,1380807941,1372788781.6,69.04467920531499,78.2998093258773,NaN,NaN,31.341467424546828,35.231649891486754
2021-07-23T09:30:00-04:00,153.68,154.595,153.13,154.52,6288077,6611882.5,68.79597440872843,68.63034584045552,NaN,NaN,142.27070943031833,68.20167217467126,-0.041587350432550796,2.4322902387444003,2.473877589176951,1387096018,1375273764.2,71.48485295437534,78.58165605344996,NaN,NaN,32.424894989749085,34.83068490552423
2021-07-26T09:30:00-04:00,154.13,154.715,153.55,154.44,4496686,6477073.9,68.44387900106307,68.07377941558148,NaN,NaN,138.29769905422646,97.42455884121242,0.024967250512724526,2.505086652317857,2.4801194018051325,1382599332,1379284807,74.9212960573212,78.8043971661922,NaN,NaN,33.152749292589164,34.59097981796208
2021-07-27T09:30:00-04:00,154.25,154.3,151.05,152.98,9044949,6615380.2,62.18848245867834,66.9650973692087,NaN,NaN,78.73255930094545,106.77674226296338,-0.050411003866889015,2.417105646971521,2.46751665083841,1373554383,1380015307,75.50037866536044,78.787965069859,NaN,NaN,31.764840565858183,34.187245639090094
2021-07-28T09:30:00-04:00,153.03,153.595,151.33,152.79,6970581,6718181.45,61.40200154497018,66.37944659631896,NaN,NaN,65.02154664764879,106.46239175794331,-0.12963523969324742,2.305472601221851,2.4351078409150984,1366583802,1378128295.2,70.94330618340163,78.25024488268609,NaN,NaN,30.42039045722454,33.64912347025216
2021-07-29T09:30:00-04:00,152.63,154.02,152.61,153.5,6015348,6743609.05,63.27127775805564,65.71487926308222,NaN,NaN,92.10737143150301,103.28597717292841,-0.14938563445785213,2.248375797842783,2.3977614323006353,1372599150,1376486537,67.14599505402796,77.28270338964191,NaN,NaN,29.84884451264328,33.10622647630803
2021-07-30T09:30:00-04:00,152.52,153.56,152.48,153.4,5074728,6706427.6,62.809893168817574,64.99957144935011,NaN,NaN,74.00045360289823,89.63192600744439,-0.1821754571289218,2.170042110889483,2.3522175680184048,1367524422,1372572217.8,59.032833653360676,75.61007900226173,NaN,NaN,29.253489308396663,32.55583545232069
2021-08-02T09:30:00-04:00,154.09,154.3,152.64,152.85,6102935,6692063.65,60.20932862631379,64.00516808235513,NaN,NaN,72.81835909961286,76.53605801652168,-0.249721977909918,2.0400650956310074,2.2897870735409254,1361421487,1368336648.8,51.74676274188099,73.29350910210628,NaN,NaN,28.022373519820317,31.90819803339207
2021-08-03T09:30:00-04:00,153.13,153.91,151.89,153.83,5412613,6665928.3,63.137974413259776,63.06188583870118,NaN,NaN,64.40812173206096,73.67117050274479,-0.23730223094013692,1.9931592848657544,2.2304615158058914,1366834100,1366992592.2,49.652499088371364,70.72502093836387,NaN,NaN,27.76664201474915,31.31654717358594
2021-08-04T09:30:00-04:00,153.71,154.52,153.22,154.14,5661391,6576905.35,64.03960844269236,62.69509763945444,NaN,NaN,92.98831504816675,79.26452418284836,-0.21762921517924294,1.9584249968318375,2.1760542120110804,1372495491,1368174930,51.51156602814164,68.18563670910297,NaN,NaN,27.80001136831411,30.814184915689964
2021-08-05T09:30:00-04:00,154.42,155.04,153.96,154.99,3337331,6316603.6,66.46192628666093,63.032283257072905,NaN,NaN,120.67124413083175,84.97729872271412,-0.1594837235887545,1.9766995575251372,2.1361832811138917,1375832822,1368821664.4,52.543802306882434,65.69181635199166,NaN,NaN,28.504384558416746,30.484213436079504
2021-08-06T09:30:00-04:00,154.45,155.04,154.41,154.86,3801418,6262279.05,65.73264190288091,63.92467596031231,NaN,NaN,117.97480097516502,93.77216819716747,-0.1424503271090356,1.9581203722275973,2.100570699336633,1372031404,1369723060.8,54.01323061616149,63.749731921735325,NaN,NaN,28.89648403859482,30.25739495072455
2021-08-09T09:30:00-04:00,155.04,155.32,154.21,154.36,3599065,6201726.55,62.87496527239711,64.15818852226386,NaN,NaN,102.30607055141074,99.66971048752706,-0.17536597666326426,1.8813632285075528,2.056729205170817,1368432339,1371125231.2,56.280982400761864,62.3923056551406,NaN,NaN,28.475860936579505,30.00289009156097
2021-08-10T09:30:00-04:00,154.64,154.78,152.805,153.25,5210674,6082189.25,56.95521792788964,63.71459785396535,NaN,NaN,43.129331951515375,95.41395253141795,-0.27639230825265537,1.711238819854998,1.9876311281076533,1363221665,1370402744.2,54.781939890119055,61.32886606039147,NaN,NaN,26.44701535491641,29.494907986326034
2021-08-11T09:30:00-04:00,153.78,154.06,152.49,153.27,5416129,6030827.5,57.033713459281664,63.0969203336921,NaN,NaN,23.852193674729477,81.5867282567305,-0.34206921448559524,1.5600446100006593,1.9021138244862545,1368637794,1369631204.8,53.153772224370215,60.19380127603828,NaN,NaN,24.78800350227431,28.82249306003293
2021-08-12T09:30:00-04:00,153.11,154.24,152.48,154.15,3474356,5891878.2,60.45111509684514,62.50085895427186,NaN,NaN,39.41603169936244,65.33568577043663,-0.3264840579701209,1.4940087520236034,1.8204928099937243,1372112150,1368887070.4,51.56204086188371,58.77074326943174,NaN,NaN,24.230427487775437,28.166483692567574
2021-08-13T09:30:00-04:00,154.25,155.03,154.08,154.99,2815609,5655635,63.440295821291905,62.143460155716774,NaN,NaN,95.90725118203287,60.92217581181018,-0.2625909978331613,1.4922540627022727,1.754845060535434,1374927759,1369466341.4,52.74826972590915,57.186955674330875,NaN,NaN,24.572054206316658,27.6529937659603
2021-08-16T09:30:00-04:00,154.62,155.71,153.31,155.69,4747107,5286641,65.76261522648895,62.398755353417535,NaN,NaN,111.1220783822329,62.6853773779746,-0.18010483431022806,1.529714017647649,1.709818851957877,1379674866,1371714846.8,57.13629563339895,55.8752354577622,NaN,NaN,25.52639717241128,27.349194252596153
2021-08-17T09:30:00-04:00,154.74,154.99,153.4431,154.4,9526334,5395069.45,58.40035567872913,62.184352077257465,NaN,NaN,56.622226742958766,65.38395633626328,-0.2168755904353361,1.4387243639137068,1.655599954349043,1370148532,1373100220.2,59.62418121120336,55.066726531176606,NaN,NaN,24.214758565556384,26.901417725876186
2021-08-18T09:30:00-04:00,154.04,154.73,152.1,152.27,6740591,5426250.1,48.70469416726353,61.143881820772314,NaN,NaN,-72.61295949523502,46.09092570227038,-0.37957922387529375,1.1811259245049257,1.5607051483802195,1363407941,1372054249.6,56.93714390520082,54.337522877688954,NaN,NaN,19.808306705547448,25.88811615154351
2021-08-19T09:30:00-04:00,151.43,154.33,151.21,153.76,9645672,5669079.7,54.40701126021287,60.543675970157686,NaN,NaN,-69.03205793431664,24.401307775534566,-0.3808008709189017,1.0847040597315925,1.4655049306504941,1373053613,1372242542.2,57.31011460460645,54.21447151706366,NaN,NaN,17.91113262952388,24.748547076969277
2021-08-20T09:30:00-04:00,154.34,155.88,153.97,155.74,7384860,5723918.85,60.66477278408314,60.57620769571264,NaN,NaN,131.65188974457988,31.550235488043967,-0.2486061190749278,1.1547472818068343,1.403353400881762,1380438473,1373344685,59.52015409459732,54.769713756543396,NaN,NaN,18.457791407921015,23.849867695676668
2021-08-23T09:30:00-04:00,156.15,157.973,156.14,157.75,5401237,5769146.4,65.79694679281737,60.76613429425247,NaN,NaN,254.9501977928091,60.3158593701592,-0.03723726689879037,1.3568068172582741,1.3940440841570645,1385839710,1374577653.8,61.896650191442426,55.64429597819133,NaN,NaN,20.80210459738878,23.414472967349827
2021-08-24T09:30:00-04:00,157.95,158.13,157.43,157.57,4768512,5555324.55,64.97931834791892,60.83325643034008,NaN,NaN,228.40775565366482,94.6729651523004,0.07300026050972552,1.4852944097942213,1.4122941492844958,1381071198,1376762187,65.73496570498384,56.66025309796578,NaN,NaN,22.313264631064367,23.25715749073762
2021-08-25T09:30:00-04:00,157.94,158.36,157.22,157.48,4715225,5442556.75,64.54741774420931,60.696505820164965,NaN,NaN,189.5864622328582,147.11284949791906,0.11964900683105606,1.561855407823316,1.44220640099226,1376355973,1379351793.4,69.63931666548406,57.88136126643732,NaN,NaN,23.357390955481396,23.27147655712959
2021-08-26T09:30:00-04:00,157.29,157.61,156.36,156.49,6028330,5443205.85,59.83603048415037,60.27531929025564,NaN,NaN,121.45626168334029,185.21051342145046,0.06628753099578444,1.5250658147369904,1.458778283741206,1370327643,1378806599.4,67.88552953116229,58.87223976036595,NaN,NaN,22.768513056991864,23.199624628538484
2021-08-27T09:30:00-04:00,156.63,158.11,156.36,158,7044381,5541688.5,64.13590907698627,60.36538670486914,NaN,NaN,134.1157785886587,185.70329119026624,0.11243195902413072,1.5993182325213695,1.4868862734972388,1377372024,1378193309.6,65.87575498374582,59.55758065915052,NaN,NaN,23.64238344744301,23.262875888381988
2021-08-30T09:30:00-04:00,158.47,159.885,158.47,159.7,5013407,5487212.1,68.25626092181797,61.172604061578305,NaN,NaN,181.38370003211455,170.98999163812732,0.23039489362527843,1.7748798905288368,1.5444849969035583,1382385431,1377502453.8,63.59185046263075,60.186859985758495,NaN,NaN,25.779808512161246,23.622437691779023
2021-08-31T09:30:00-04:00,159.8,159.85,158.56,158.86,10985556,5765859.25,64.32382729427,61.6933264783632,NaN,NaN,140.54729437269768,153.4178993819339,0.2245664821707274,1.8251930996169676,1.6006266174462402,1371399875,1375568189.2,57.57336631395756,60.50254527787188,NaN,NaN,26.249882559275978,23.9977869585643
2021-09-01T09:30:00-04:00,159.41,160.13,158.77,158.9,10145178,5990048.6,64.42892211686538,61.97745555122178,NaN,NaN,124.89601983067978,140.4798109014982,0.19710129992638326,1.8470032423542193,1.649901942427836,1381545053,1376606005.2,59.77320220023418,61.089056802039764,NaN,NaN,26.651762420865648,24.376926310321636
2021-09-02T09:30:00-04:00,159.49,159.7,158.09,158.73,10885699,6367467,63.571802952201445,61.986848917715314,NaN,NaN,96.2003530392903,135.4286291726882,0.14366343602844944,1.8294812374633977,1.6858178014349483,1370659354,1376672347.4,59.91628054678222,61.60105757495927,NaN,NaN,26.730713096312474,24.713181565463184
2021-09-03T09:30:00-04:00,158.54,159.78,158.49,159.36,10602400,6707516.1,65.40837357650003,61.96154594271611,NaN,NaN,96.0585090730597,127.81717526956841,0.12747439259521975,1.845160792178973,1.7176863995837532,1381261754,1377450293.4,61.63929642783056,61.92270048884724,NaN,NaN,27.322896491409455,25.08599798345551
2021-09-07T09:30:00-04:00,159.55,159.74,158.645,159.4,9862178,7020671.75,65.52721025705307,62.47060698402496,NaN,NaN,88.07831473298677,109.15609820974282,0.09753788302903255,1.8396087533700438,1.7420708703410113,1391123932,1379197993.6,65.2529112373229,62.32475263357007,NaN,NaN,27.84138640230171,25.47962490043354
2021-09-08T09:30:00-04:00,159.38,159.43,157.66,158.79,5733152,7046795.65,62.027604927376125,63.42224346689015,NaN,NaN,63.17494011676908,93.68162735855711,0.01885025927580175,1.7656336944357633,1.7467834351599616,1385390780,1381996174.6,70.1080638929436,63.26553263269455,NaN,NaN,27.33875236787064,25.745214538638837
2021-09-09T09:30:00-04:00,158.9,159.45,158.06,158.19,5580573,7055017.85,58.706448746875076,63.729346144508874,NaN,NaN,56.726544430193556,80.04773227845985,-0.08567347003727788,1.6396915976133641,1.725365067650642,1379810207,1381649205.4,68.82389101635312,64.0879452335336,NaN,NaN,25.99382384519984,25.78073015386184
2021-09-10T09:30:00-04:00,159.07,159.46,156.4741,156.63,8540107,7308305.4,51.052595286308076,63.04276203752494,NaN,NaN,16.030657819323075,64.0137932344664,-0.26198115327567817,1.3978886260560444,1.6598697793317225,1371270100,1381771354.6,69.03889984288165,64.76785564412533,NaN,NaN,22.484160102814883,25.309791575140846
2021-09-13T09:30:00-04:00,157.82,158.23,155.65,156.68,11318867,7733468.3,51.27187784878576,62.005257112951256,NaN,NaN,-14.415299329008045,41.91903155405287,-0.3706957412700782,1.1965001027441247,1.5671958440142029,1382588967,1382036797.2,69.53066976734863,65.31314275669006,NaN,NaN,19.683111019765533,24.505980067230087
2021-09-14T09:30:00-04:00,157.35,157.67,156.06,156.48,9215775,7956901.7,50.30115103558084,60.95681659064139,NaN,NaN,-24.76636196405406,19.350096214644704,-0.4464548136924311,1.009127326898664,1.4555821405910951,1373373192,1378486649.2,56.58541492385296,64.65960341518071,NaN,NaN,17.07088976586424,23.443824309892108
2021-09-15T09:30:00-04:00,157.01,157.975,156.13,157.85,8169647,7889067.35,56.391771057102254,60.374270398705164,NaN,NaN,-6.5471149595587725,5.405685199379135,-0.3963752986236764,0.9601130173114996,1.356488315935176,1381542839,1377717061,54.228424574634275,63.55882540869144,NaN,NaN,16.40137103891832,22.437759556895852
2021-09-16T09:30:00-04:00,157.29,158.1,156.315,157.94,8074251,7955750.35,56.76660690855101,60.15502585759093,NaN,NaN,-13.289080839685722,-8.597439854596718,-0.3508310359490072,0.917949520998917,1.2687805569479242,1389617090,1379678437.6,58.92438712274167,62.91874380808997,NaN,NaN,15.95424053456665,21.511542553705965
2021-09-17T09:30:00-04:00,157.53,157.54,155.25,155.48,11331497,8040041.6,45.30393461777753,58.8098848247903,NaN,NaN,-119.2711344516416,-35.65779830878964,-0.4724523149585198,0.6782151632497744,1.1506674782082942,1378285593,1381081536.2,61.93314760871239,62.63712899558758,NaN,NaN,11.858560453587682,20.132545110831924
2021-09-20T09:30:00-04:00,152.93,153.71,150.345,152.38,17834652,8562531.2,35.559443463010254,56.474397863446896,NaN,NaN,-336.2081398045473,-100.01636640389748,-0.732240618995925,0.23536670446338803,0.967607323459313,1360450941,1376653931,49.58915498639949,61.63693646157106,NaN,NaN,4.352681877321367,17.87827893461613
2021-09-21T09:30:00-04:00,153.31,153.685,151.85,152.44,9227485,8753843.6,35.84706012849652,54.440343065891646,NaN,NaN,-237.25164238201234,-142.51342248748915,-0.8616780632516858,-0.10949025560529435,0.7521878076463915,1369678426,1375914977.8,47.874146497522176,60.94413504611139,NaN,NaN,-1.2260750953699446,15.149085501760977
2021-09-22T09:30:00-04:00,153.27,155.13,152.59,154.53,13995333,9215184.65,45.04774220628599,53.05597307227884,NaN,NaN,-137.34704448999483,-168.67340839357635,-0.7711149930434529,-0.21170593365792456,0.5594090593855283,1383673759,1376341161.8,48.97029035328465,60.172498485614994,NaN,NaN,-2.887120609174134,12.572484628770248
2021-09-23T09:30:00-04:00,155.33,156.97,154.85,156.6,9767336,9467790.2,52.33860540826429,52.253601819140464,NaN,NaN,-43.490583118768505,-174.7137088493929,-0.5469261545027608,-0.12424863374292272,0.4226775207598381,1393441095,1377105962.8,50.9631333109745,59.532987968771586,NaN,NaN,-1.627082786287443,10.54397499804772
2021-09-24T09:30:00-04:00,155.65,156.97,155.58,156.71,5826250,9457686.2,52.697760587712295,51.345700891369916,NaN,NaN,-30.437655051539657,-156.94701296937254,-0.374571688248151,-0.04553708955035063,0.3290345986978004,1399267345,1381302313.2,60.15720278992028,59.42712413749228,NaN,NaN,-0.5518351976833914,8.958859255800418
2021-09-27T09:30:00-04:00,155.39,155.75,154.2,155.19,7507472,9480840.75,47.38421221214829,50.049772459591,NaN,NaN,-77.33132251569177,-105.17164951160142,-0.34691017564432347,-0.10460312085760393,0.24230705478671952,1391759873,1387564099.6,69.3822652071998,59.722077992483484,NaN,NaN,-1.4387405274623504,7.473487858191451
2021-09-28T09:30:00-04:00,153.2,153.55,150.47,150.59,19095344,10184937.6,35.664284734456174,48.16667816009671,NaN,NaN,-178.9374591331839,-93.50881286183574,-0.607157191515033,-0.5166394346070717,0.09051775690796124,1372664529,1388161320.2,70.09348928634046,59.72103694915469,NaN,NaN,-6.935549101691678,5.415054006779576
2021-09-29T09:30:00-04:00,151.21,152,150.14,150.4,12505979,10260958.75,35.27617618006215,46.49308726246722,NaN,NaN,-168.5136663055022,-99.74213722493721,-0.7513973852181186,-0.8487289746146871,-0.09733158939656844,1360158550,1383458278.4,58.55772589374577,58.987739440397014,NaN,NaN,-11.102383401793778,3.0554200912690965
2021-09-30T09:30:00-04:00,151.28,151.93,149.24,149.32,16708259,10589112.8,33.073005240990526,45.208830830658826,NaN,NaN,-156.22308493472192,-122.2886375881279,-0.8704505750773642,-1.1853948082432737,-0.31494423316590947,1343450291,1373460117.6,42.53219520554474,57.09440339487295,NaN,NaN,-15.181114095149786,0.4502009217806848
2021-10-01T09:30:00-04:00,149.86,151.9,148.34,151.57,22741929,11181924.3,41.298455253402544,44.496443502417165,NaN,NaN,-122.87829504065141,-140.77676558595024,-0.7529793204946776,-1.2561683837842565,-0.5031890632895789,1366192220,1366845092.6,35.59193339605274,54.67020793978039,NaN,NaN,-15.697789917263307,-1.8566549123684566
2021-10-04T09:30:00-04:00,150.7,150.875,146.88,148.06,25386520,11921130.3,34.230674327806355,43.348552309004695,NaN,NaN,-148.15393156229635,-154.94128739527116,-0.8592907150593105,-1.577302457113717,-0.7180117420544065,1340805700,1356654258,28.009256063556094,52.62905373547348,NaN,NaN,-18.837594596517267,-4.2825034386754295
2021-10-05T09:30:00-04:00,148.36,151.025,148.22,150.17,16483772,12252210,40.79061408687388,42.234183953988385,NaN,NaN,-105.45538344551537,-140.24487225773746,-0.7396779517332401,-1.6426091817209567,-0.9029312299877166,1357289472,1353579246.6,26.19573249836617,50.62671858716861,NaN,NaN,-18.867755696758003,-6.366110904115796
2021-10-06T09:30:00-04:00,148.44,151.26,147.945,151.15,20002378,12965671.3,43.60414660358103,41.2940082179191,NaN,NaN,-87.9395364643269,-124.13004628950239,-0.5551586862643361,-1.5968795878181368,-1.0417209015538007,1377291850,1357005906.6,31.516980478044516,48.669046683975964,NaN,NaN,-17.88097977843238,-8.011092171875308
2021-10-07T09:30:00-04:00,152.46,153.71,152.25,152.53,9947806,13184032.95,47.39491134774124,41.44336369863079,NaN,NaN,-20.083561741015853,-96.90214165076118,-0.3128377030295848,-1.4327680303407817,-1.119930327311197,1387239656,1365763779.6,42.856859913530265,47.30645470574866,NaN,NaN,-15.768304129857944,-9.11926530872997
2021-10-08T09:30:00-04:00,153.12,153.23,151.71,151.96,9213492,13217702.2,46.018978967255435,42.19047337750544,NaN,NaN,-28.26534468625504,-77.9795515798819,-0.17072201330084757,-1.3333328439372565,-1.162610830636409,1378026164,1368130568.4,45.48406829491886,47.01323422778576,NaN,NaN,-14.559380915552047,-9.896424681133125
2021-10-11T09:30:00-04:00,151.28,153.15,151.015,151.12,7485264,13026022.05,43.99209389863955,42.77226150394423,NaN,NaN,-37.74242674446598,-55.897250616315816,-0.11570465876212777,-1.3072416540890686,-1.1915369953269408,1370540900,1374077608.4,51.51598126858132,47.27336528286141,NaN,NaN,-14.215976855164444,-10.513503563137599
2021-10-12T09:30:00-04:00,151.71,151.9,150.09,150.34,8926658,13011566.2,42.13622305419542,42.56429585022347,NaN,NaN,-60.43700604370243,-46.893575135953235,-0.11407017983110657,-1.334124720115824,-1.2200545402847174,1361614242,1374942562.4,52.34191471541348,47.51419559444205,NaN,NaN,-14.500249654948972,-11.083038719110652
2021-10-13T09:30:00-04:00,150.99,151.59,150.01,151.26,9761744,13091171.05,45.07920654879618,42.04576736026147,NaN,NaN,-50.63041765169616,-39.431751373427076,-0.0372307177153659,-1.2665929374289249,-1.229362219713559,1371375986,1373759389.6,51.0605528206483,47.52115413084732,NaN,NaN,-13.85072760810554,-11.478422846109922
2021-10-14T09:30:00-04:00,152.8,154.74,152.58,154.67,7600209,13067468.95,54.34744807127784,42.16360218051615,NaN,NaN,59.513735093053214,-23.512292006613258,0.24170855856528517,-0.9272265215069524,-1.1689350800722376,1378976195,1372106697.4,49.246998979559024,46.74185385867867,NaN,NaN,-10.165533469366778,-11.290867220860902
2021-10-15T09:30:00-04:00,155.21,155.94,154.74,155.91,6389617,12820374.95,57.17743974848085,42.86311843311133,NaN,NaN,117.87790431130475,5.716357792898703,0.49366239207061513,-0.5518570899839688,-1.045519482054584,1385365812,1373574627,50.914611352908175,45.422735726229256,NaN,NaN,-6.21745391139003,-10.566093890936491
2021-10-18T09:30:00-04:00,155.04,157.31,154.61,157.23,5815132,12219398.95,60.01871786060036,44.60272079926449,NaN,NaN,126.38379533828764,38.54160220944943,0.7194746932092219,-0.14617611554305654,-0.8656508087522784,1391180944,1377702635.8,55.3569095033158,44.370122884584646,NaN,NaN,-2.02616309213074,-9.346103776821383
2021-10-19T09:30:00-04:00,157.65,158.79,157.33,158.79,6600707,12088060.05,63.132050013478725,46.592426073079956,NaN,NaN,156.22119051173655,81.87324152053722,0.9307409452988283,0.2977753728712571,-0.6329655724275712,1397781651,1384936117.6,61.869060184667475,44.60664676250763,NaN,NaN,2.505360521765405,-7.653037448451842
2021-10-20T09:30:00-04:00,158.94,159.17,157.66,158.35,6012667,11688926.75,61.67330716867863,48.63530478220054,NaN,NaN,137.5901432037982,119.51735369163609,0.9920584150936567,0.6071074464394997,-0.38495096865415707,1391768984,1389014717.2,64.97174102383937,46.20947146381438,NaN,NaN,5.707094164330524,-5.744447218054361
2021-10-21T09:30:00-04:00,157.87,159.045,157.545,158.96,5011583,11451139.1,62.951400259723826,50.18194371122349,NaN,NaN,130.54765781309288,133.72413823564403,1.0209239752555543,0.8912040004152857,-0.12971997484026854,1396780567,1392575591.6,67.46112768625113,48.485842484542836,NaN,NaN,8.723792802932023,-3.677555786484878
2021-10-22T09:30:00-04:00,158.9,159.56,157.75,158.41,6245006,11472076.9,60.97695801858233,52.092392546278916,NaN,NaN,123.4924613397059,134.84704964132425,0.9515807445159665,1.0597559558046896,0.10817521128872312,1390535561,1393609541.4,68.16851646716185,51.354361084800395,NaN,NaN,10.67108486791275,-1.6277499787137883
2021-10-25T09:30:00-04:00,159.01,159.5001,158.31,158.93,5168556,11355131.1,62.184586184648865,53.620533410405706,NaN,NaN,117.41419136279836,133.0531288462264,0.8904332882825781,1.2212168216419457,0.3307835333593676,1395704117,1394514176,68.80746339687695,54.39805614897973,NaN,NaN,12.641350419368603,0.4106929352979818
2021-10-26T09:30:00-04:00,160,160.67,159.3,159.38,6594759,10730101.85,63.24463699507824,55.02342558122693,NaN,NaN,117.31504837568178,125.27190041901545,0.8311315213808811,1.369697935085469,0.5385664137045879,1402298876,1395417621,69.46663098116734,57.10874547063137,NaN,NaN,14.591799565911098,2.436565311099855
2021-10-27T09:30:00-04:00,159.65,160.46,159.08,159.24,8724011,10541003.45,62.65617031594886,56.11351550752748,NaN,NaN,99.96485395760266,117.74684256977635,0.7365485548975801,1.459252107326563,0.7227035524289829,1393574865,1395778797.2,69.74191982198184,59.02910689266362,NaN,NaN,16.07108288831528,4.384353536416344
2021-10-28T09:30:00-04:00,160.21,160.96,159.91,160.84,6378440,10024512.5,66.49329986336073,57.575967000106424,NaN,NaN,105.37921895074457,112.71315479730667,0.7341742033186156,1.6404213065772524,0.9062471032586368,1399953305,1396413344.8,70.24942331286547,60.798060822516945,NaN,NaN,18.4829967614465,6.398445425706367
2021-10-29T09:30:00-04:00,159.26,161.63,159.07,161.53,10065876,9390709.85,68.01941668890183,59.292204342268015,NaN,NaN,98.32143568021914,107.67894966540932,0.7299714870255449,1.818711462040568,1.088739975015023,1410019181,1400310068.8,73.21992360871306,62.34834241824064,NaN,NaN,20.974171372509847,8.480691989535435
2021-11-01T09:30:00-04:00,161.53,161.61,160.47,161.29,12210619,8731914.8,66.87840817917751,61.05950327976674,NaN,NaN,97.27988290881261,103.65208797461216,0.6638289204563483,1.9185261255854584,1.25469720512911,1397808562,1400730957.8,73.5273801568937,63.86158994977494,NaN,NaN,22.76799062398463,10.521734651599605
2021-11-02T09:30:00-04:00,161.51,163.11,161.51,162.71,13407298,8578091.1,70.07676098045286,62.84504288202793,NaN,NaN,113.05538598688969,102.80015549685375,0.6667552798921592,2.088141304994309,1.42138602510215,1411215860,1402514354.6,74.84520534119221,65.56049370124236,NaN,NaN,25.28309422390935,12.630500304786711
2021-11-03T09:30:00-04:00,162.99,164,162.04,163.66,12989308,8227437.6,72.02316793345446,64.10759430075483,NaN,NaN,119.85981825177916,106.77914835568905,0.6813053273153413,2.2730176842463266,1.5917123569309852,1424205168,1408640415.2,78.75714200464338,67.66836106017696,NaN,NaN,28.023560390507633,14.829508888461127
2021-11-04T09:30:00-04:00,164.28,166.62,163.99,166.22,14345699,8447332.25,76.46567249071356,65.48532521091431,NaN,NaN,154.27899283931123,116.55910313340237,0.8035717457435896,2.596177039110472,1.7926052933668826,1438550867,1416359927.6,82.45899222709292,69.92153112261873,NaN,NaN,31.992258718229373,17.281330292713733
2021-11-05T09:30:00-04:00,167.44,168.02,166.0409,167.08,12112064,8592260.85,77.74421572497775,66.75143220122699,NaN,NaN,170.72571721587772,131.0399594405341,0.8766217599708344,2.8883824933304254,2.011760733359591,1450662931,1424488677.6,85.35340881323374,72.0641382161843,NaN,NaN,35.701401102089726,19.912768979767446
2021-11-08T09:30:00-05:00,167.62,168.27,167.23,167.98,6390457,8537520.5,79.02825117675022,67.88687514146066,NaN,NaN,165.81469039714437,144.74692093820045,0.9155491913092328,3.1561972224961323,2.2406480311868995,1457053388,1436337642.8,88.36675325772117,73.95683057854528,NaN,NaN,39.214821446837654,22.67020504649176
2021-11-09T09:30:00-05:00,168.23,168.41,166.435,167.29,8411559,8511765.55,75.43491553899474,68.86984716791181,NaN,NaN,140.83428933236485,150.30270160729546,0.8274918012082546,3.2750127826972175,2.447520981488963,1448641829,1443822836.6,89.79508450920002,75.72992654178533,NaN,NaN,41.0955036661962,25.302390563592393
2021-11-10T09:30:00-05:00,166,166.83,164.03,164.53,12894393,8668398,63.07971472808812,68.87901248708069,NaN,NaN,86.56773665196133,143.6442852873319,0.5304703137290296,3.11060887365025,2.5801385599212203,1435747436,1446131290.2,90.19492051587743,77.35376888675864,NaN,NaN,38.83223221569215,27.23522508532093
2021-11-11T09:30:00-05:00,165.71,165.78,165.03,165.3,5051904,8540982.75,64.81131165107519,69.15289488940161,NaN,NaN,80.51138494274525,128.8907637080187,0.34211183962705993,3.0077783594550453,2.6656665198279854,1440799340,1446580984.8,90.27485784861409,78.93279327114807,NaN,NaN,37.51707664912855,28.704061023007732
2021-11-12T09:30:00-05:00,165.85,167.585,165.57,167.31,6122277,8527615.75,68.91039690228422,69.63330994066128,NaN,NaN,98.40699158792448,114.42701858242806,0.31008946066688825,3.053278345661596,2.7431888849947077,1446921617,1445832722,88.97502408321992,80.37333332017258,NaN,NaN,37.68297506538024,29.98676302906095
2021-11-15T09:30:00-05:00,167.98,168.22,166.19,167.14,6245195,8549118.9,68.18692358923246,69.9863304116723,NaN,NaN,95.05546661352447,100.27517382570407,0.23790491969966832,3.040570034619293,2.8026651149196247,1440676422,1442557328.8,83.31963692240758,81.36283374454688,NaN,NaN,37.59080186891214,31.073054291896835
2021-11-16T09:30:00-05:00,166.94,169.13,166.84,168.9,6769409,8557554,71.52055593709973,70.61950081318307,NaN,NaN,105.51930024641565,93.21217600851425,0.26695740430649995,3.13636187030275,2.86940446599625,1447445831,1442318129.2,82.90520071400971,82.30306809397744,NaN,NaN,38.55458528494738,32.1418444337612
2021-11-17T09:30:00-05:00,168.57,169.45,167.86,168.39,7708937,8642367.5,69.25585570621527,70.81682623052981,NaN,NaN,100.02123155170628,95.90287498846322,0.2124657692155245,3.1349866775156556,2.922520908300131,1439736894,1443116020.8,83.2052903185022,83.22848716580863,NaN,NaN,38.64656277939997,33.0710899117096
2021-11-18T09:30:00-05:00,169.36,170.31,168.14,170.07,9984005,8890988.6,72.36064116679515,71.12691369323649,NaN,NaN,108.51597113142375,101.50379222619894,0.24774327126642515,3.2321999973831623,2.984456726116737,1449720899,1444900332.6,83.88651136962821,83.99038629158828,NaN,NaN,39.690459775122264,34.01671417791141
2021-11-19T09:30:00-05:00,170.68,171.96,170.1105,171.31,8858784,9021677.5,74.41445443397373,71.66520271143621,NaN,NaN,131.12449486427224,108.04729288146848,0.30879259530152803,3.370447470243647,3.061654874942119,1458579683,1447231945.8,84.75660824957592,84.79247401249415,NaN,NaN,41.21327279590237,35.04479398048155
2021-11-22T09:30:00-05:00,171.98,174.25,169.3,169.4,14232502,9474874.8,66.24852588939814,71.39175734778944,NaN,NaN,120.65547178885627,113.16729391653485,0.18106544981537986,3.287986687211344,3.106921237395964,1444347181,1447966097.6,85.03069851758057,85.52000923937904,NaN,NaN,39.89373850391796,35.73750034097247
2021-11-23T09:30:00-05:00,168.75,169.55,166.87,169.01,14620677,9876170.7,64.68758964330462,70.8677874699216,NaN,NaN,60.682122736758195,104.19985841460337,0.038302702683678636,3.1547996157505622,3.1164969130668836,1429726504,1444422232.2,77.7620183013918,85.44892897486106,NaN,NaN,38.35227692282472,36.11103985266565
2021-11-24T09:30:00-05:00,168,170.28,167.18,170.24,9120520,9895996.15,67.30412773745877,70.21339141611769,NaN,NaN,73.11909991642804,98.81943208754771,-0.0031028933851655616,3.1126182963354267,3.1157211897205923,1438847024,1444244258.2,77.40416242135328,85.08786970302252,NaN,NaN,37.838390550274795,36.35780423803838
2021-11-26T09:30:00-05:00,167.81,169.11,165.33,165.99,12383935,10196270.9,52.757760348607064,68.42864460351977,NaN,NaN,4.805727566476955,78.07738337455835,-0.3285229666158247,2.7050674814508113,3.033590448066636,1426463089,1439592696.2,68.52781207128056,83.88604136431158,NaN,NaN,32.15097905579054,35.75682921200298
2021-11-29T09:30:00-05:00,168.46,170.595,167.93,170.14,12489882,10317471.2,61.50647718476861,67.17708931837824,NaN,NaN,81.55994986840739,68.16447437538537,-0.27808160752417965,2.6859884386614112,2.964070046185591,1438952971,1435667353.8,62.060163010595176,82.00699920380258,NaN,NaN,30.40662816515721,34.9925147767393
2021-11-30T09:30:00-05:00,169.5,171.05,167.28,168.72,27033357,11058608.1,57.577397440419176,65.90155231133713,NaN,NaN,57.60961618631032,55.555303254876186,-0.3495323869235625,2.5271545625311376,2.8766869494547,1411919614,1429181840.4,53.136836669442594,79.38855292953419,NaN,NaN,27.602169419110645,33.93675115422092
2021-12-01T09:30:00-05:00,170.5,171.79,166.26,166.41,19545620,11365524.2,51.78231316891315,65.09459505711034,NaN,NaN,16.869049391944717,46.79268858591349,-0.549638295147866,2.1896390805198678,2.7392773756677338,1392373994,1421711338.4,45.09378807887727,76.16704346974846,NaN,NaN,23.182742976452875,32.40046427168263
2021-12-02T09:30:00-05:00,164.87,168.71,164.51,167.94,23436247,11887871.15,55.0120564346316,64.39464825593579,NaN,NaN,-45.160801286782316,23.136708345271412,-0.5735802973722635,2.0223020039524044,2.595882301324668,1415810241,1417103981.8,40.974472268391345,72.6455873568754,NaN,NaN,20.82167643160241,30.746351723099743
2021-12-03T09:30:00-05:00,168.42,168.94,163.05,165.13,24235027,12382337.55,48.57648274189955,62.94222581590833,NaN,NaN,-113.11645762430535,-0.4477286928850475,-0.7615124523066159,1.6439917359413982,2.405504188248014,1391575214,1410126406.8,35.66141698917238,68.83747256444343,NaN,NaN,16.513711599686204,28.71311741975495
2021-12-06T09:30:00-05:00,165.61,167.2,163.89,166.7,18900173,12721743,51.95812275004177,61.783025755966136,NaN,NaN,-95.11586066634955,-35.78289079983644,-0.7611217353992266,1.4541020189989808,2.2152237543982074,1410475387,1404430890,32.0125008975093,65.17267713409355,NaN,NaN,14.261263779037986,26.64856689965253
2021-12-07T09:30:00-05:00,170.02,172.73,169.9956,172.52,14345548,13119497.55,61.94783505463899,61.09925997864751,NaN,NaN,156.48769501739727,-16.007275033619045,-0.3697545512485232,1.7530305653375535,2.1227851165860767,1424820935,1407011154.2,35.245112711256226,61.768385133896864,NaN,NaN,16.084896984653323,25.139471197509785
2021-12-08T09:30:00-05:00,172.58,173.43,171.39,173.31,11630788,13280459,63.0703621948999,60.65743901355355,NaN,NaN,167.90339511335003,14.19959411066202,-0.07400710998627202,2.0302762291032366,2.1042833390895086,1436451723,1415826700,44.88673931715236,59.0313457766576,NaN,NaN,17.858098283387847,24.099275066920935
2021-12-09T09:30:00-05:00,172.88,174.01,171.3,171.44,8600510,13065764.85,58.65920201126249,59.678764788158354,NaN,NaN,133.46993052428297,49.92574047287508,-0.02328214925589922,2.0751806525196344,2.0984628017755336,1427851213,1418234894.4,47.19956181254323,56.41084937972297,NaN,NaN,17.734467616534474,23.19001685972287
2021-12-10T09:30:00-05:00,173.24,175.1,172.73,174.88,12388524,13432595.85,63.69018714088303,58.91274569579473,NaN,NaN,179.37062020406228,108.42315603854861,0.21013324089028007,2.3611293528883834,2.1509961119981034,1440239737,1427967799,55.35416375723855,54.31067477312744,NaN,NaN,19.43865515475412,22.654108044727334
2021-12-13T09:30:00-05:00,175.24,175.58,172.03,172.28,10486993,13650831.65,57.94998609958773,58.31999285366542,NaN,NaN,126.9054707833431,152.82742232848713,0.1598818068201533,2.3508483705232948,2.1909665637031415,1429752744,1431823270.4,58.113824230792744,52.388040895499735,NaN,NaN,18.792855960104877,22.102500604066982
2021-12-14T09:30:00-05:00,170.2,171.29,167.41,169.45,13547388,14015941.3,52.41279319261433,57.44322167861611,NaN,NaN,-7.605327334109809,120.00881785818572,-0.08057469957520791,2.0902481892341314,2.1708228888093393,1416205356,1430100154.6,56.43485113388857,50.86467181210664,NaN,NaN,16.300710492320324,21.273673445246033
2021-12-15T09:30:00-05:00,169.59,174.11,167.98,173.94,14135413,14384241.5,59.091527544329175,56.856607379106855,NaN,NaN,73.85356269667001,101.19885137484971,0.039686012165566886,2.220430404016298,2.180744391850731,1430340769,1428877963.8,55.21630808713396,49.279825073948125,NaN,NaN,16.621384090212644,20.609060680241264
2021-12-16T09:30:00-05:00,174.59,174.87,168.01,169.01,15637803,14780684.8,50.680814714611614,56.70825411953575,NaN,NaN,24.669894303146854,79.43884413062248,-0.22151982286235983,1.9038446132727813,2.125364436135141,1414702966,1426248314.4,52.58542007245343,48.14108278831761,NaN,NaN,13.692948347356785,19.62104463268634
2021-12-17T09:30:00-05:00,167.15,169.52,166.28,167.88,22411626,15402065.85,48.96064641963821,55.812123350597865,NaN,NaN,-61.733254719598804,31.21806914589026,-0.46511664668317776,1.5439686277811688,2.0090852744643466,1392291340,1416658635,44.29654212398472,46.87225272498829,NaN,NaN,10.860396530283545,18.369523475200225
2021-12-20T09:30:00-05:00,165,166.09,164.36,165.57,16324761,15775364.7,45.55658978060922,54.95349423204001,NaN,NaN,-128.25099649278016,-19.813224309334394,-0.7591514837768893,1.0601459197432348,1.8192974035201241,1375966579,1405901402,37.21086534484659,45.734683344660006,NaN,NaN,7.405819179071238,16.803280004324655
2021-12-21T09:30:00-05:00,167.34,169.9,165.79,169.76,8405416,15484010.4,52.06650664098616,54.97379376575951,NaN,NaN,-28.600684904461605,-24.012295823404756,-0.6528410238064903,1.0032461237620112,1.6560871475685015,1384371995,1399534729.8,33.76804739527215,44.92570186725964,NaN,NaN,6.777469810581397,15.371021405218476
2021-12-22T09:30:00-05:00,169.53,172.1,169.08,171.98,6688099,15087381.5,55.12797269048905,54.98207349832075,NaN,NaN,46.81639538041446,-29.419729286655848,-0.42540769856626826,1.124327524360666,1.5497352229269343,1391060094,1391678594.8,30.07086147858601,44.14687252513069,NaN,NaN,7.327869489714664,14.221999703003647
2021-12-23T09:30:00-05:00,172.21,173.6299,172.19,172.94,4896285,14876169.75,56.42407685101743,55.54261593468632,NaN,NaN,91.19155361945374,-16.115397423394473,-0.2134200048537256,1.2829602168597773,1.496380221713503,1395956379,1387929277.4,28.46885839903055,43.63311834012056,NaN,NaN,8.182715758929902,13.359244853850255
2021-12-27T09:30:00-05:00,173.63,176.69,173.59,176.65,6639571,14588951.55,61.10032497054596,56.19563037900805,NaN,NaN,146.5192402381631,25.535101568157906,0.15375892391144097,1.6885788766028043,1.5348199526913633,1402595950,1389990199.4,30.6557241599795,43.53620571601129,NaN,NaN,10.476429770968334,12.947414127724267
2021-12-28T09:30:00-05:00,176.98,177.04,175.29,175.73,5711982,14250056.55,59.39808038639846,56.0135050455623,NaN,NaN,135.40887476465704,78.26707581964534,0.3031343549079235,1.9137378963262677,1.6106035414183442,1396883968,1394173677.2,34.99984556616246,43.518686634218874,NaN,NaN,11.766022032859444,12.778643828457863
2021-12-29T09:30:00-05:00,175.79,176.59,174.97,175.88,4843886,13140583,59.59572902675816,55.765316962123606,NaN,NaN,115.93019133875515,107.17325106828869,0.37575826190614947,2.080301368801031,1.7045431068948815,1401727854,1397644849,38.44552065178119,43.05859958669237,NaN,NaN,12.849197622387242,12.788722941876346
2021-12-30T09:30:00-05:00,175.95,176.54,174.51,174.72,5263212,12426462.6,57.273770529822016,55.66635757059215,NaN,NaN,93.81904819556038,116.57378163131789,0.31201116668812,2.0945570652550316,1.7825458985669116,1396464642,1398725758.6,39.520660411675486,42.51010662948753,NaN,NaN,13.084938257200232,12.831039415494043
2021-12-31T09:30:00-05:00,174.55,174.97,173.79,173.87,5121541,11510727.3,55.565372102790356,55.086013639299814,NaN,NaN,64.36005926124716,111.20748275967655,0.18520343651592608,2.014050194211819,1.828846757695893,1391343101,1397803103,38.89613991598946,41.33453349796974,NaN,NaN,12.803294837972953,12.827075904419601
2022-01-03T09:30:00-05:00,174.1,175.68,173.34,175.52,10151434,10806547.65,58.17353239089315,55.10198123153591,NaN,NaN,75.11770040992654,96.92717479402926,0.18464003624698577,2.0596468030046253,1.8750067667576396,1401494535,1397582820,38.73874377524464,39.9505991797163,NaN,NaN,13.291982684878837,12.893491158770921
2022-01-04T09:30:00-05:00,175.82,176,172.35,173.66,8323998,10277738.9,54.30400209584286,55.23706758176652,NaN,NaN,47.46746860688932,79.33889356247572,0.03881283858389395,1.923522814987507,1.884709976403613,1393170537,1396840133.8,38.17781502473295,38.646525171919464,NaN,NaN,12.623480508785189,12.85491820877296
2022-01-05T09:30:00-05:00,172.65,172.78,168.26,168.32,11814245,10151173.75,45.04096331811558,54.233455851322695,NaN,NaN,-70.17937183578691,42.116980927567305,-0.4125923227845192,1.368969572922964,1.7815618957074832,1381356292,1392765821.4,35.169253022150414,37.214592667277785,NaN,NaN,9.062842160717745,12.313193059050786
2022-01-06T09:30:00-05:00,166.98,169.2,166.47,167.47,11883563,10163812.5,43.76136157561068,53.73920919853692,NaN,NaN,-110.66277400606367,1.2206164872425007,-0.7443827354001087,0.8510834764573474,1.595466211857456,1369472729,1387367438.8,31.614361663417284,35.716659923775204,NaN,NaN,5.7851710069766344,11.380618480183049
2022-01-07T09:30:00-05:00,167.36,168.16,164.84,165.93,15244335,10496003.75,41.46302005630078,53.203664458298526,NaN,NaN,-124.5022748362142,-36.55185033224977,-1.0261455283403165,0.3127843014320604,1.3389298297723768,1354228394,1379944497.4,27.498430114146217,34.51679478021531,NaN,NaN,2.3448135456098878,10.089789203815455
2022-01-10T09:30:00-05:00,163.46,166.17,161.29,165.96,16250705,10689112.8,41.52744603389649,52.91586847639047,NaN,NaN,-143.61965315736066,-80.29932104570722,-1.1592489818464582,-0.1101313975356959,1.0491175843107623,1370479099,1373741410.2,24.614461064864997,33.61705161735948,NaN,NaN,-0.4183236799492712,8.588630220420495
2022-01-11T09:30:00-05:00,165.53,168.19,164.3,167.95,9603795,10644952.9,45.78960625567052,52.46751844886793,NaN,NaN,-84.51288230923947,-106.69539122893298,-1.0644733544252958,-0.28147410872085743,0.7829992457044384,1380082894,1371123881.6,23.49471115190825,32.88324188569063,NaN,NaN,-1.6240345914874579,7.129678104433644
2022-01-12T09:30:00-05:00,169.2,170.36,167.9,168.74,9071990,10421183,47.42789984924636,51.91751324592202,NaN,NaN,-38.99998588434899,-100.45951403864538,-0.9059908753146771,-0.3494893484389081,0.556501526875769,1389154884,1372683600,25.664737605501116,32.56851875189885,NaN,NaN,-2.1810328509038546,5.799576539385431
2022-01-13T09:30:00-05:00,169.61,170.1,163.9516,164.37,10471339,10237979.3,40.19206677246196,50.758083954596636,NaN,NaN,-87.21626130770632,-95.77021149897391,-1.043120298037984,-0.7473988456717109,0.295721452366273,1378683545,1374525763.2,28.25320480335563,32.553114923636365,NaN,NaN,-4.903045406304674,4.270630547143988
2022-01-14T09:30:00-05:00,163.25,165.86,163.25,165.76,11175680,10014873.15,43.1624211239385,49.47680510841038,NaN,NaN,-97.51382904118864,-90.37252233996881,-0.9883777571912505,-0.9397507441227901,0.04862701306846037,1389859225,1381651929.4,37.34255792812426,33.03074590707527,NaN,NaN,-6.29156155267498,2.7617459614555635
2022-01-18T09:30:00-05:00,163.35,164.32,161.33,161.78,12354917,9512037.7,37.43018128768962,47.90766945850261,NaN,NaN,-129.02164693954253,-87.45292109640518,-1.1566914230693603,-1.39723726576824,-0.24054584269887966,1377504308,1383056971.2,38.98387716040678,33.31531959237844,NaN,NaN,-9.368533736745862,1.028848861712503
2022-01-19T09:30:00-05:00,162.29,164.29,159.36,159.52,12480662,9319832.75,34.618675070863034,46.12359417593867,NaN,NaN,-142.52131630231193,-99.05460789501967,-1.3435864020211277,-1.9200288452252892,-0.5764424432041616,1365023646,1380045121.6,36.76089878486402,33.19498945902721,NaN,NaN,-12.853865229810607,-0.954396008505084
2022-01-20T09:30:00-05:00,160.94,162.745,157.25,157.46,18804527,9839788.3,32.24142529774953,44.335569516504926,NaN,NaN,-149.14330913482618,-121.0832725451151,-1.5165046064483332,-2.4720732012645783,-0.955568594816245,1346219119,1371457968.6,31.28358815751612,32.606627155158684,NaN,NaN,-16.525191370044766,-3.1787953458678953
2022-01-21T09:30:00-05:00,157.08,158.8899,154.29,154.33,24008262,10705796.45,28.984606598994105,42.436943409090915,NaN,NaN,-166.1910942671558,-136.87823913700498,-1.7364262608982675,-3.1261014209390794,-1.389675160040812,1322210857,1360163431,25.83179081950749,31.673459362552826,NaN,NaN,-20.750463034294597,-5.689033587071709
2022-01-24T09:30:00-05:00,151.76,155.24,146.24,155.13,33714822,12146723.3,30.905714737850687,40.489242148159306,NaN,NaN,-181.70357343775706,-153.71618801631868,-1.7195190251897865,-3.539073941528045,-1.8195549163382585,1355925679,1353376721.8,23.213926049671926,30.564543810726203,NaN,NaN,-23.55963846279398,-8.241977140746318
2022-01-25T09:30:00-05:00,152.09,154.42,149.8,151.54,24443149,13036902.2,27.332436696232392,38.56270176247285,NaN,NaN,-162.31943765207072,-160.37574615882434,-1.8312987469799995,-4.108678350063258,-2.2773796030832583,1331482530,1344172366.2,20.220890937990063,29.281906375958858,NaN,NaN,-27.180796054945517,-10.947522699917632
2022-01-26T09:30:00-05:00,155.66,157.475,150.62,152.43,26798133,14091209.75,29.50837113714445,37.45323089240348,NaN,NaN,-126.75343745450917,-157.2221703892638,-1.7278002487450772,-4.437129914014605,-2.709329665269528,1358280663,1342823769.6,19.817719054668515,28.185368235424438,NaN,NaN,-29.4393107834291,-13.589206711847842
2022-01-27T09:30:00-05:00,154.9,155.72,150.83,151.38,19728064,14835418.65,28.42689099695197,36.357911565356424,NaN,NaN,-119.26502258306273,-151.24651307891108,-1.6146633566725606,-4.727658861110228,-3.112995504437668,1338552599,1341290465.6,19.345439183880742,27.30901662974325,NaN,NaN,-31.62152910146746,-16.165252767507788
2022-01-28T09:30:00-05:00,153.26,158.04,150.98,158,22118045,15678160.3,42.68849828983907,36.44544572489488,NaN,NaN,-78.03591422875104,-133.61547707123015,-1.008254503017493,-4.373313633209534,-3.365059130192041,1360670644,1348982423,28.545085993850506,27.383777764007842,NaN,NaN,-28.884779379355162,-17.982327997771698
2022-01-31T09:30:00-05:00,158.04,162.18,157.27,161.97,14560541,16150110.3,49.2228714142409,36.99511896634806,NaN,NaN,-22.11150137404941,-101.6970626584886,-0.29128008741565425,-3.729159239461609,-3.4378791520459546,1375231185,1352843524.2,32.69508507917317,27.960965193601282,NaN,NaN,-24.262021814587133,-18.879427114459617
2022-02-01T09:30:00-05:00,162.19,162.661,160.04,162.39,11694942,16227285.7,49.87400280657755,37.286861577127134,NaN,NaN,-1.176632177961194,-69.4685015636667,0.23152087648009267,-3.148478056445839,-3.3799989329259317,1386926127,1363932243.6,42.94388449144229,29.350191860710854,NaN,NaN,-20.46629368420454,-19.106122338708893
2022-02-02T09:30:00-05:00,162.74,163.98,161.64,163.71,12752408,16448706.2,51.959075388420004,37.6105169727824,NaN,NaN,25.469768159421545,-39.02386044088057,0.66211980672281,-2.552349174522419,-3.214468981245229,1399678535,1372211818,49.16796258936446,31.02899364527252,NaN,NaN,-16.718748198689728,-18.765068890134728
2022-02-03T09:30:00-05:00,161.39,162.49,158.37,158.96,13932676,16554627.75,44.74605348191336,37.935801737743205,NaN,NaN,-11.95429750485573,-17.56171542523916,0.6234732567219199,-2.4351274103428295,-3.0586006670647494,1385745859,1381650470,55.171578792127306,32.9517346444705,NaN,NaN,-15.721954799098814,-18.330338305701027
2022-02-04T09:30:00-05:00,158.11,161,157.44,159.6,14860912,16703495.2,45.837064357653276,38.12684768300854,NaN,NaN,-15.41660558622919,-5.0378536967347785,0.635294832820839,-2.2644821260387005,-2.8997769588595395,1400606771,1389637695.4,59.52773607652868,34.536390226499385,NaN,NaN,-14.590019072465003,-17.796006986667308
2022-02-07T09:30:00-05:00,159.72,160.67,157.93,158.54,7311339,16306845.4,44.277652129514514,38.6159527431389,NaN,NaN,-15.268111497787373,-3.6691757214823655,0.5681911521547756,-2.1895380186660702,-2.757729170820846,1393295432,1393250544.8,61.35693233798965,36.134465596326734,NaN,NaN,-14.133280441470147,-17.27276033735343
2022-02-08T09:30:00-05:00,158.04,160.93,157.67,160.5,10569885,16022804.4,47.813070198566194,39.55840953797484,NaN,NaN,-0.6038786553344702,-3.554625016957021,0.6465706575691406,-1.94951584885942,-2.5960865064285605,1403865317,1396638382.8,63.04367579727643,38.01180681149905,NaN,NaN,-12.682010910060537,-16.6169389905973
2022-02-09T09:30:00-05:00,162.57,164.11,161.9,164.06,8897790,15987504.15,53.574692310378865,41.08221432459122,NaN,NaN,68.88304041685171,5.12802943452899,0.9126620191431227,-1.4552589824996573,-2.36792100164278,1412763107,1399255297.2,64.33855121908135,40.37287560161091,NaN,NaN,-9.589280505791201,-15.612987778482145
2022-02-10T09:30:00-05:00,160.8,163.53,158.93,159.77,15846103,16326209.8,46.86066034127771,42.3590753061829,NaN,NaN,32.00265101018075,13.919419137536286,0.7794097843832639,-1.3936587711637003,-2.173068555546964,1396917004,1401489526.2,65.45153994295762,43.202857681857346,NaN,NaN,-9.036237699764536,-14.673452052951058
2022-02-11T09:30:00-05:00,159.93,160.63,154.3,154.89,17439412,16674613.45,40.62398103045923,43.05323718422637,NaN,NaN,-42.61579517844004,8.479581219094117,0.36341316813805147,-1.7188020953744,-2.0822152635124516,1379477592,1397263690.4,61.53939767781903,45.94039136958214,NaN,NaN,-10.692179401637032,-14.104698817049055
2022-02-14T09:30:00-05:00,154.48,156.085,153.04,154.84,20515193,17141589.1,40.564411379805925,43.99837823305306,NaN,NaN,-72.48480510989899,-2.963757503328206,0.09941610539034329,-1.9579451317745225,-2.0573612371648657,1358962399,1390397083.8,55.712205346092176,48.47548525587514,NaN,NaN,-11.986941998635105,-13.802162128704206
2022-02-15T09:30:00-05:00,157.17,159.02,156.62,158.91,12222707,17134978.6,47.33427234723186,45.27165689091645,NaN,NaN,5.262976093992937,-1.7903865534627244,0.20723076583265954,-1.7983227798740415,-2.005553545706701,1371185106,1383861041.6,50.78294911902746,50.68728740332936,NaN,NaN,-10.897810588235277,-13.387254765780073
2022-02-16T09:30:00-05:00,157.83,159.3,156.11,158.75,10159114,17018901.2,47.10711335641442,46.6059584880209,NaN,NaN,5.937784223040399,-14.379437792224987,0.27201694974219004,-1.6655323585289636,-1.9375493082711537,1361025992,1373513618.6,44.12663387552926,52.45737273844711,NaN,NaN,-10.112407573816789,-12.91941945264246
2022-02-17T09:30:00-05:00,157.27,157.43,153.705,154,12453212,16701335.45,40.84086670432241,46.47398480334114,NaN,NaN,-56.13136247447802,-32.00624048915674,0.012894460771561311,-1.921431232306702,-1.9343256930782633,1348572780,1363844773.8,38.98458763314335,53.20305142696803,NaN,NaN,-11.438834066746653,-12.707907254657345
2022-02-18T09:30:00-05:00,154.53,154.75,151.27,152.44,12655401,16133692.4,39.00574350291287,45.744189952532,NaN,NaN,-96.62090555238426,-42.807262563945585,-0.23211512166113923,-2.2244695951546873,-1.992354473493548,1335917379,1355132731.2,35.02423447753536,53.369419241136754,NaN,NaN,-13.097964730238216,-12.763629751168898
2022-02-22T09:30:00-05:00,150.84,153.45,149.38,151.03,13446751,15120288.85,37.37123593838401,44.851135176232454,NaN,NaN,-125.76437988860856,-53.4631775196875,-0.4453335136310903,-2.549021365532411,-2.103687851901321,1322470628,1347834377,32.08376964808532,52.59369675232555,NaN,NaN,-14.961507378382127,-13.077612269342216
2022-02-23T09:30:00-05:00,152.6,153.01,147.09,147.25,18939677,14845115.25,33.337986257954455,43.521057381199206,NaN,NaN,-159.96507106740023,-86.50878695196613,-0.7776814009715332,-3.0757896031157372,-2.298108202144204,1303530951,1334303546,27.47786866311567,51.044404329022065,NaN,NaN,-17.878786061218996,-13.763494239610328
2022-02-24T09:30:00-05:00,142.19,152.39,141.72,152.28,25483891,14779403.15,42.2669848603479,43.34398105108738,NaN,NaN,-150.1467649068154,-117.72569677793729,-0.6032690111998948,-3.0521944661440727,-2.448925454944178,1329014842,1327901316,25.60484668506362,48.93249489280323,NaN,NaN,-17.507931921697264,-14.29841390847989
2022-02-25T09:30:00-05:00,152.51,154.4,150.64,154.35,14150831,14500541.5,45.502109813191375,43.32005572648296,NaN,NaN,-71.94722175058483,-120.88886863315865,-0.30789739578205744,-2.83379719967175,-2.5258998038896925,1343165673,1326819894.6,25.29124498441496,46.48703124336653,NaN,NaN,-16.153985073392967,-14.563495503467474
2022-02-28T09:30:00-05:00,152.71,154.72,151.43,154.07,17411146,14265196.55,45.13369247978585,43.38120146578807,NaN,NaN,-62.61403305088606,-114.08749413285902,-0.101464498782736,-2.6527304273681125,-2.5512659285853765,1325754527,1324787324.2,24.679420974361037,43.86720900310735,NaN,NaN,-15.195544325803276,-14.653788192372588
2022-03-01T09:30:00-05:00,153.49,154.28,149.81,150.99,14962491,14285294.05,41.18357565969379,42.90766614158289,NaN,NaN,-83.15259416543407,-105.56513698822411,-0.1400564216063147,-2.7263364555932696,-2.586280033986955,1310792036,1322451605.8,23.96205634172445,41.07566475628221,NaN,NaN,-15.58423759072815,-14.786709534994811
2022-03-02T09:30:00-05:00,152.1,154.9,150.92,154.26,12796200,14340356.95,46.53377893981628,42.404743757971275,NaN,NaN,-48.31869715746404,-83.23586220623687,0.07535927994674907,-2.4920809340535186,-2.5674402140002677,1323588236,1326463062.8,27.841410023153117,38.46872609943019,NaN,NaN,-14.237409988942737,-14.708238171273086
2022-03-03T09:30:00-05:00,155.56,155.57,151.64,152.42,11725349,14289004,44.10273960201805,42.207749419452725,NaN,NaN,-45.29919850843921,-62.26634892656163,0.11240957132981455,-2.4269282498379994,-2.539337821167814,1311862887,1323032671.8,26.591996715042455,35.6930444402934,NaN,NaN,-13.866688910540386,-14.588016848311272
2022-03-04T09:30:00-05:00,151.23,151.86,148.56,149.75,13366370,14260688.7,40.77396257399637,42.21846238684823,NaN,NaN,-97.38887704266735,-67.35467998497813,-0.017503223486317054,-2.5612168505257102,-2.543713627039393,1298496517,1314098840.6,23.61923846081855,32.98446163907908,NaN,NaN,-14.577719154739407,-14.586545749229577
2022-03-07T09:30:00-05:00,149.62,150.31,144.19,144.27,16432135,14339249.85,34.94423045571895,41.81702089227059,NaN,NaN,-153.18267261059486,-85.4684078969199,-0.4245427446853811,-3.0743920578961195,-2.6498493132107384,1282064382,1305360811.6,21.131014766589544,30.514376597686034,NaN,NaN,-17.14749596024564,-14.95239577937473
2022-03-08T09:30:00-05:00,143.88,148.03,141.45,143.57,18449216,14896143.7,34.27019244658845,40.883872327938924,NaN,NaN,-169.1688247402776,-102.6716540118886,-0.677926193002496,-3.4972570544638586,-2.8193308614613626,1263615166,1295925437.6,18.824873448526958,28.231656906935996,NaN,NaN,-19.39640822444498,-15.58725470009905
2022-03-09T09:30:00-05:00,147.47,149.93,146.29,149.25,17663668,15250832.85,43.751249592182624,40.64416777335093,NaN,NaN,-87.61662025456056,-110.5312386313079,-0.41301638651200756,-3.335601344601372,-2.9225849580893644,1281278834,1287463557.2,17.029854836190083,26.296172689840343,NaN,NaN,-18.276540142673912,-15.971438334752602
2022-03-10T09:30:00-05:00,146.61,147.05,144.42,146.64,13724235,15492155.1,40.83638397650423,40.64384757850678,NaN,NaN,-121.05221387003606,-125.68184170362728,-0.3652445038749268,-3.3791405879330227,-3.013896084058096,1267554599,1278601899.6,15.376290034226145,24.60986571848911,NaN,NaN,-18.30547604296732,-16.30487229306899
2022-03-11T09:30:00-05:00,147.94,148.31,143.84,144.06,10728861,15236293,38.131923315107386,40.58143185080639,NaN,NaN,-120.60972774004246,-130.32601184310232,-0.45332775025545446,-3.580555771877414,-3.1272280216219595,1256825738,1270267743.8,13.99953920395781,23.108101770376432,NaN,NaN,-19.20003815842762,-16.718467416691652
2022-03-14T09:30:00-04:00,143.4,145.03,140.98,141.39,13926221,15060633.45,35.51089761796932,40.44855054220534,NaN,NaN,-153.53637823838483,-130.3967529686603,-0.6266552543290347,-3.910547089533253,-3.2838918352042183,1242899517,1262434770.8,12.83624029377593,21.73327824506862,NaN,NaN,-20.782309859143332,-17.29901633704189
2022-03-15T09:30:00-04:00,142.51,146.43,142.035,146.14,11496942,14609720.9,43.01517408198506,41.1397782439218,NaN,NaN,-97.43842659015031,-116.05067333863485,-0.36937075388424123,-3.7456052775595197,-3.3762345236752784,1254396459,1260591029.4,12.571438682726779,20.668533246469416,NaN,NaN,-19.684166835883865,-17.639752122590746
2022-03-16T09:30:00-04:00,147.99,150.945,145.642,150.89,13588036,14677987.35,49.36105380098423,41.64649745396726,NaN,NaN,-13.732764514726766,-101.2739021906681,0.14516760066015788,-3.194775022850081,-3.3399426235102387,1267984495,1257932161.6,12.181179136818528,19.709699850166196,NaN,NaN,-16.585487489764027,-17.489142889329788
2022-03-17T09:30:00-04:00,150.08,152.06,149.27,151.96,9259422,14633002.75,50.69308767398644,42.0172815868812,NaN,NaN,35.33222888951464,-69.99701363875795,0.5587948671640328,-2.641449039555198,-3.2002439067192308,1277243917,1259870025.2,14.270053172859122,18.922471863626495,NaN,NaN,-13.708864208369148,-16.949103077763983
2022-03-18T09:30:00-04:00,151.42,155.35,150.68,155.07,13948944,14707789.35,54.444004591767616,42.682303880594176,NaN,NaN,96.68117519042192,-26.53883305266508,1.016404421513125,-1.9297383798278247,-2.9461428013409496,1291192861,1266743449.8,21.410476451631013,18.688975826288637,NaN,NaN,-10.086670963293939,-15.968755632839692
2022-03-21T09:30:00-04:00,153.95,155.31,152.46,154.49,11170710,14633554.8,53.624697376094346,43.57095543176565,NaN,NaN,101.81823561611147,24.53208971823417,1.2397888020409216,-1.3964067987897977,-2.6361956008307192,1280022151,1274167976.6,28.352305474197152,19.002565050036687,NaN,NaN,-7.439921310840261,-14.750350729696915
2022-03-22T09:30:00-04:00,154.6,157.52,154.39,156.71,8742909,14398362.7,56.33336729787233,44.270926028769644,NaN,NaN,132.5511432009607,70.53000367645637,1.48051893218683,-0.785546935597182,-2.266065867784012,1288765060,1281041696.8,34.15144134483384,19.453281573013886,NaN,NaN,-4.392222751155143,-13.270618161333806
2022-03-23T09:30:00-04:00,155.25,156.68,154.15,154.3,6180313,13760394.5,52.73258285369833,44.887343403889666,NaN,NaN,96.55277127440014,92.58711083428176,1.420651385340026,-0.4902516361089795,-1.9109030214490055,1282584747,1283961747.2,36.50269528269949,20.161188613560817,NaN,NaN,-2.869814766324312,-11.784789104903878
2022-03-24T09:30:00-04:00,155.16,158.35,154.64,158.31,7131733,12842786.6,57.590063185792985,46.088493447589435,NaN,NaN,119.6562417173845,109.45191339985573,1.5819848436650574,0.06657803313231625,-1.5154068105327412,1289716480,1286456259.8,38.52223037364469,21.225688035905538,NaN,NaN,-0.029961062846198615,-10.105527956038495
2022-03-25T09:30:00-04:00,158.56,158.78,156.2402,158.22,7437788,12507134.45,57.447370355204974,47.69586058326701,NaN,NaN,120.38972123583962,114.19362260893926,1.6082473550661258,0.494902383299916,-1.1133449717662098,1282278692,1284673426,37.60175108022939,22.402169201165528,NaN,NaN,2.2013833414810993,-8.347397770678553
2022-03-28T09:30:00-04:00,157.49,160.17,157.09,160.1,9296456,12101399.95,59.693964900251544,49.511844329957235,NaN,NaN,130.36307392844756,119.90259027140648,1.6705285661335547,0.9748157359007337,-0.695712830232821,1291575148,1286984025.4,39.61559528223411,23.88722076071604,NaN,NaN,4.747469663753246,-6.476702422902582
2022-03-29T09:30:00-04:00,161.97,163.65,160.81,163.5,9414863,11824018.55,63.45205360548855,50.91904461662194,NaN,NaN,157.84025370971835,124.96041237315804,1.8453160928421535,1.610932285819871,-0.23438380702228262,1300990011,1289429015.6,41.7576449856236,25.653491485675573,NaN,NaN,8.114384178783238,-4.392261479804608
2022-03-30T09:30:00-04:00,162.66,163.12,160.47,161.32,9340178,11651217.45,59.614029598439835,52.26030501818877,NaN,NaN,126.43150326873914,130.93615877202583,1.7211493348651399,1.9170528615591422,0.19590352669400235,1291649833,1291242032.8,43.3620778585325,27.652476330268886,NaN,NaN,9.8501023361795,-2.3576380775211643
2022-03-31T09:30:00-04:00,161.3,161.6,158.69,158.93,9712060,11550553,55.640477226378316,53.51091601185097,NaN,NaN,91.61440791895173,125.32779201233927,1.3987882926945256,1.9443888925621593,0.5456005998676338,1281937773,1289686291.4,42.285623716408146,29.67291093830105,NaN,NaN,10.160852825767815,-0.5692822341941672
2022-04-01T09:30:00-04:00,159.09,159.46,156.69,158.46,14104780,11587473.5,54.86598285409604,54.89342210014574,NaN,NaN,66.02823377310652,114.45549451979267,1.0884434044247708,1.9061548553985972,0.8177114509738265,1267832993,1286797151.6,40.28552992974085,31.63357448372712,NaN,NaN,10.195525033143849,0.9685473754255491
2022-04-04T09:30:00-04:00,158.87,161.55,158.81,161.47,11524148,11342074.15,58.819406392699385,56.02229583662534,NaN,NaN,87.22220156272618,105.82732004664838,1.0215034878895082,2.0945908108357116,1.0730873229462035,1279357141,1284353550.2,38.62160242637779,33.49430046541648,NaN,NaN,11.365939719626844,2.453889138882877
2022-04-05T09:30:00-04:00,160.77,161.14,157.52,158.07,11794076,11009317.15,53.15551650642594,56.29332888701403,NaN,NaN,61.824724823944514,86.6242142694936,0.6992347549882232,1.9471307666814823,1.2478960116932591,1267563065,1277668161,34.43152032758968,35.08361055047156,NaN,NaN,10.698213849566239,3.631649811837643
2022-04-06T09:30:00-04:00,155.44,155.8,152.96,154.33,17112659,10981766.7,47.712904362935106,56.08045865051036,NaN,NaN,-0.6077668162677016,61.21636025249226,0.2105330228871236,1.5110622903021635,1.30052926741504,1250450406,1269428275.6,30.097405069738457,36.214135685962944,NaN,NaN,8.412227991972468,4.314589551856903
2022-04-07T09:30:00-04:00,153.51,155.61,152.46,154.57,11600094,10875559.65,48.080284499065364,55.62590721531734,NaN,NaN,-9.138996929025373,41.065679282896824,-0.10335268178266377,1.1713384151867103,1.274691096969374,1262050500,1265450821,28.24892438834975,36.70259625287143,NaN,NaN,6.683168267567003,4.652957939815489
2022-04-08T09:30:00-04:00,153.88,154.24,152.08,152.41,13177292,10997981.2,45.0147699636692,55.010912400144115,NaN,NaN,-38.019169240350365,20.25619868020545,-0.4441395113919473,0.71951670772944,1.1636562191213873,1248873208,1261658864,26.573308940670017,36.5755250719052,NaN,NaN,4.294970349739054,4.601816855518855
2022-04-11T09:30:00-04:00,150.5,150.69,148.37,148.57,10797665,10841553.4,40.11771783596563,53.85265172429364,NaN,NaN,-114.97833308010749,-20.183908248361284,-0.890124227647273,0.05100093456229615,0.9411251622095691,1238075543,1253402544.4,23.328644954807956,35.802468186903354,NaN,NaN,0.6530288888567103,4.037704288852835
2022-04-12T09:30:00-04:00,150.41,151.55,147.35,147.91,11086114,10821012,39.325845528797096,52.89502762965783,NaN,NaN,-130.92217054741778,-58.733287322633736,-1.1736967413410833,-0.525995764466785,0.6477009768742983,1226989429,1245287817.2,20.65871696073529,34.670755449620195,NaN,NaN,-2.550444502865054,3.0965401757502793
2022-04-13T09:30:00-04:00,148,150.75,147.45,150.29,7223362,10502778.3,43.64564996369156,51.89899811379344,NaN,NaN,-121.04926733207687,-82.82158742579558,-1.143926302873735,-0.7822069017178706,0.3617194011558645,1234212791,1242040294.2,19.68761221492899,33.3254255811405,NaN,NaN,-4.055572630889771,2.0748097748017007
2022-04-14T09:30:00-04:00,150.45,150.72,146.565,146.64,8703516,10474983,39.053454175021756,50.58514695806606,NaN,NaN,-141.0918784502445,-109.2121637300394,-1.3015324614150683,-1.2651961756129708,0.03633628580209741,1225509275,1234732049.2,17.674136142596055,31.902024514166694,NaN,NaN,-6.8014615677068315,0.8067710115861961
2022-04-18T09:30:00-04:00,145.92,148.07,145.88,147.12,7030285,10129050.05,39.948278839598146,49.174740810876536,NaN,NaN,-139.58878872160628,-129.52608762629058,-1.3017872582914864,-1.5908977870622607,-0.28911052877077426,1232539560,1231465319.6,16.844848291054575,30.2755425862253,NaN,NaN,-8.770675835996952,-0.5614356809256822
2022-04-19T09:30:00-04:00,146.75,150.14,146.21,149.88,6781075,9909568.3,44.95294873936714,47.853376177582156,NaN,NaN,-99.05186603127916,-126.34079421652491,-1.0549326032150954,-1.6077762827896436,-0.5528436795745482,1239320635,1231714338,17.16392093810326,28.518848011402415,NaN,NaN,-9.009392877035772,-1.7682867089414094
2022-04-20T09:30:00-04:00,151.33,151.73,149.3,149.74,7826295,9863737.6,44.749226170123066,46.791604504130966,NaN,NaN,-67.52122057684872,-113.66060422241112,-0.8488018801649124,-1.6138460297806887,-0.7650441496157763,1231494340,1232615320.2,18.38415834606633,26.734710903369116,NaN,NaN,-9.260567473194786,-2.8386125324061773
2022-04-21T09:30:00-04:00,151.2,152.62,146.75,147.2,9254614,10017452.65,41.109155008832865,45.75365291716343,NaN,NaN,-79.6865380459499,-105.38805836518573,-0.8302296438548289,-1.8028312044343124,-0.9726015605794835,1222239726,1230220707.2,17.64039147881131,24.9743371721122,NaN,NaN,-10.52717116261939,-3.9369780510080643
2022-04-22T09:30:00-04:00,147.04,147.9,142.8801,143.08,11047441,10213238.05,35.994579120896944,44.405695507649206,NaN,NaN,-122.90507512868592,-101.750697700874,-1.0291286682736376,-2.2590123959215305,-1.2298837276478929,1211192285,1227357309.2,16.766865126022438,23.29443254327517,NaN,NaN,-13.24489747796468,-5.266680826287581
2022-04-25T09:30:00-04:00,142.45,145.33,141.56,145.23,14353773,10559037.3,40.17733717851126,43.0741191352072,NaN,NaN,-116.36711404641707,-97.10636276583617,-0.9514255057306813,-2.4191656098112446,-1.4677401040805633,1225546058,1225958608.8,16.341189174576456,21.702974453860786,NaN,NaN,-14.277125268025683,-6.55388717510731
2022-04-26T09:30:00-04:00,143.91,144.13,139.75,139.82,12976644,10743046.7,34.132819649228395,41.7153550739788,NaN,NaN,-136.15771604371307,-104.52753276832296,-1.184719826534239,-2.948639887248362,-1.763920060714123,1212569414,1220608364.6,14.79399022740543,20.300293732419057,NaN,NaN,-17.206038360232263,-8.07562305869659
2022-04-27T09:30:00-04:00,141.38,144.62,141.07,141.89,20024298,11273518.45,37.97772745334577,41.01998529472242,NaN,NaN,-112.64554818384501,-113.55239828972219,-1.1206553295948463,-3.1647392227076807,-2.0440838931128344,1232593712,1220828239,15.149541667468398,19.23258920368548,NaN,NaN,-18.377024926853874,-9.547251897004772
2022-04-28T09:30:00-04:00,144.12,148.41,143.35,147.57,13881208,11500569.95,47.10236795568612,40.95013411305247,NaN,NaN,-57.51771772900308,-109.11863422633283,-0.6406344867196987,-2.844877001512458,-2.2042425147927593,1246474920,1225675277.8,22.797573344280877,18.843206986251992,NaN,NaN,-16.29060241047089,-10.510587684642788
2022-04-29T09:30:00-04:00,145.96,147.66,141.15,141.42,14794925,11754713.2,40.205322323072146,40.606602138724114,NaN,NaN,-97.60484639492675,-104.058588479581,-0.6785665777866092,-3.052450737026021,-2.3738841592394118,1231679995,1229772819.8,28.652305486181362,18.991706739502803,NaN,NaN,-16.939384672315278,-11.428987254310286
2022-05-02T09:30:00-04:00,141.26,143.76,139.66,143.57,18502156,11974582,43.329429815559706,40.83601013726655,NaN,NaN,-108.71412648106748,-102.52799096651108,-0.5079198703617616,-3.008783997191614,-2.5008641268298524,1250182151,1234700038.4,35.032518928812564,19.82769773764599,NaN,NaN,-16.36829689956446,-12.134602917918025
2022-05-03T09:30:00-04:00,143.55,144.7,142.49,143.82,13734908,12085120,43.6977920493203,41.148292031589634,NaN,NaN,-78.69581987743659,-91.03561173325579,-0.3355815043960213,-2.920341007324879,-2.5847595029288577,1263917059,1244969567.4,45.8928549206788,21.63013616335624,NaN,NaN,-15.808931896137496,-12.659507057663664
2022-05-04T09:30:00-04:00,144.38,149.14,141.99,148.87,14325244,12211678.4,50.6727342244025,41.650226621640414,NaN,NaN,-14.383139439216048,-71.38312998433,0.13587254290517592,-2.414918824297388,-2.5507913672025637,1278242303,1254099285.6,53.35766921351209,24.035140234683603,NaN,NaN,-12.977488162896023,-12.704932929839716
2022-05-05T09:30:00-04:00,146.68,146.86,140.02,141.71,18221118,12267101.35,42.61233043331629,41.90443206866145,NaN,NaN,-87.10641689546503,-77.30086981762238,-0.009431251989815426,-2.562580432189833,-2.5531491802000175,1260021185,1256808538.6,55.32729409325836,26.724651516873767,NaN,NaN,-13.319111725611906,-12.792672757807171
2022-05-06T09:30:00-04:00,140.42,142.82,138.46,140.57,17431060,12558649.65,41.48095252899499,42.013908760761225,NaN,NaN,-123.66982784473737,-82.5138661075845,-0.14948601684350704,-2.7400067012544014,-2.5905206844108943,1242590125,1258990564.6,56.90569807741557,29.586140787328127,NaN,NaN,-13.963187684609224,-12.95988917592175
2022-05-09T09:30:00-04:00,138.03,138.92,134.51,135.13,20562328,12927901.45,36.5006902415945,41.410176010920324,NaN,NaN,-194.67281759885407,-99.70560433114181,-0.5529841347004405,-3.2817508527864447,-2.7287667180860042,1222027797,1253359693.8,51.81762075907606,32.06140506025475,NaN,NaN,-16.240099827662014,-13.428490697598932
2022-05-10T09:30:00-04:00,138.35,139.13,135.15,137.19,18185204,13297278.4,39.46460610892549,41.03270314940621,NaN,NaN,-153.64391667603368,-114.69522369086124,-0.6205585630541486,-3.50446492190369,-2.8839063588495413,1240213001,1248618882.2,47.93179388434586,34.171950455846144,NaN,NaN,-17.072285955384046,-13.94903287728252
2022-05-11T09:30:00-04:00,135.95,138.53,132.45,132.86,17390920,13612518.7,35.69332242903627,40.64585796513503,NaN,NaN,-178.82146355872484,-147.582888514763,-0.8804206608584328,-3.984432184922582,-3.1040115240641493,1222822081,1237534837.8,40.318971934205884,35.7918490598029,NaN,NaN,-19.03776220997611,-14.675994210524461
2022-05-12T09:30:00-04:00,130.89,133.4,128.43,131.49,18253301,14164015.65,34.56775891221588,40.543942235943526,NaN,NaN,-206.13676013888892,-171.38895716344777,-1.056275602397283,-4.424356027060753,-3.36808042466347,1204568780,1226444356.8,34.427031181587466,37.05328949234326,NaN,NaN,-20.962327374389048,-15.57404180536226
2022-05-13T09:30:00-04:00,133.28,136.53,132.42,135.86,12247852,14341232.45,40.96294612562406,40.6000571607373,NaN,NaN,-121.556743067671,-170.9663402080345,-0.8015370231822354,-4.370001703641265,-3.568464680459029,1216816632,1221289658.2,32.080493464301114,38.17752551303788,NaN,NaN,-20.537988588887725,-16.283177060151612
2022-05-16T09:30:00-04:00,134.73,136.47,133.51,134.66,8711740,14425305.2,39.81224476887472,41.00573038356918,NaN,NaN,-105.81444151004477,-153.19466499027266,-0.6439021068536599,-4.373342314026104,-3.729440207172444,1208104892,1218505077.2,30.856942348025072,39.324879235939285,NaN,NaN,-20.552092989185727,-16.89302219287077
2022-05-17T09:30:00-04:00,137.56,138.77,136,138.56,9301114,14551307.15,45.200137650560286,41.521616826227365,NaN,NaN,-53.97198164518921,-133.26027798410377,-0.2284556993854272,-4.015009831404228,-3.786554132018801,1217406006,1213943678.2,28.91168370966699,40.307889381810604,NaN,NaN,-18.86717774294812,-17.175044414310392
2022-05-18T09:30:00-04:00,136.73,137.13,131.72,132.22,11835072,14751746,39.07617922437444,40.94831763113367,NaN,NaN,-104.46133331418608,-118.388251935196,-0.32616861182371437,-4.194264896798444,-3.8680962849747296,1205570934,1210493448.8,27.49952271514786,40.643742908301114,NaN,NaN,-19.387698830424252,-17.491137902326656
2022-05-19T09:30:00-04:00,131.23,133.02,130.15,130.77,10437449,14810887.75,37.81431636641951,40.77753149137276,NaN,NaN,-124.4517205027779,-102.05124400797379,-0.42758579178651823,-4.402578524707877,-3.974992732921359,1195133485,1208606389.8,26.730498394887135,40.506470973208664,NaN,NaN,-20.203307970879294,-17.878590769262747
2022-05-20T09:30:00-04:00,132.59,132.95,127.0355,131.06,10126274,14764829.4,38.24384782060057,40.41427563458996,NaN,NaN,-122.62464389404549,-102.26482417324868,-0.41399098915859867,-4.492481469369608,-4.078490480211009,1205259759,1206295015.2,25.779543999047803,39.84554419251118,NaN,NaN,-20.72416812459902,-18.285101820025073
2022-05-23T09:30:00-04:00,131.47,134.24,131.06,134.07,8609841,14477632.8,42.67012621681669,40.34087093226828,NaN,NaN,-74.94011233255432,-96.08995833775062,-0.15449395122317888,-4.271607919239983,-4.117113968016804,1213869600,1207447956.8,27.171343224576376,38.50829335707529,NaN,NaN,-19.84538562865129,-18.507999506971675
2022-05-24T09:30:00-04:00,132.2,132.87,129.77,132.08,8561017,14256851.45,40.59837132560261,39.62127358235399,NaN,NaN,-88.81794689672748,-103.05915138805827,-0.07320961576461293,-4.20862598772257,-4.135416371957957,1205308583,1205028472.2,26.06665795865871,36.55893541030005,NaN,NaN,-19.714463079809114,-18.680351445948453
2022-05-25T09:30:00-04:00,131.21,134.61,131.11,133.62,6828314,13597052.25,42.90851051103297,39.642429302190905,NaN,NaN,-61.278460916374364,-94.42257690849593,0.11755660395395928,-3.9884706170155084,-4.106027220969468,1212136897,1206341664.8,27.782819748596253,34.5914729571099,NaN,NaN,-18.939613930873517,-18.71738894379489
2022-05-26T09:30:00-04:00,132.84,137.42,132.56,136.83,7778315,13291907.6,47.49236911548086,40.07181620122561,NaN,NaN,-18.858127880417648,-73.30385838402388,0.4732512305420995,-3.514463182791843,-3.9877144133339426,1219915212,1211298010.2,34.00898337060296,32.95599333519471,NaN,NaN,-16.91651387011781,-18.460121076126736
2022-05-27T09:30:00-04:00,138.36,141.49,138.1,141.46,8140893,12959206,53.31474472463571,41.27282009287141,NaN,NaN,64.73223908031359,-35.83248178915204,1.0032161346164195,-2.7336942450634183,-3.7369103796798377,1228056105,1215857279.4,39.20164679339271,32.054852337645904,NaN,NaN,-13.317868576609609,-17.725513576195716
2022-05-31T09:30:00-04:00,140.91,141.83,139.08,140.45,9710448,12519620.6,51.96117137686845,42.165431897724474,NaN,NaN,70.17580471089501,-6.809298380462172,1.2524104800135292,-2.1713972796629264,-3.4238077596764556,1218345657,1216752490.8,40.196698314410256,31.502345511221932,NaN,NaN,-10.769256750764585,-16.731762601134125
2022-06-01T09:30:00-04:00,141.96,142.915,138.99,140.03,6652398,12165495.1,51.37703254642003,43.28569690610903,NaN,NaN,80.14120930255287,26.982532859393892,1.3473580241333982,-1.739610229509708,-3.0869682536431062,1211693259,1218029426,41.663337450076696,31.59837161949842,NaN,NaN,-8.844967511891412,-15.605077588385166
2022-06-02T09:30:00-04:00,139.04,143.43,138.39,143.42,6934165,11795941.15,55.705389980268144,44.79552769668419,NaN,NaN,114.4917356451524,62.13657217169926,1.5807237519794848,-1.1110635636687505,-2.6917873156482353,1218627424,1219327531.4,43.18865052942675,32.22420157291551,NaN,NaN,-5.881557187122716,-14.216003245347673
2022-06-03T09:30:00-04:00,140.7,141.6701,139.34,139.99,5631869,11166478.7,50.77986729146316,45.49673635138698,NaN,NaN,92.28716206276573,84.36563016033593,1.4497746422922724,-0.8795690127828948,-2.329343655075167,1212995555,1217943600,41.92992570410964,32.92773244718755,NaN,NaN,-4.727810843874599,-12.860547187994378
2022-06-06T09:30:00-04:00,141.75,142.63,139.305,140,6294778,10609664.6,50.79352783242619,46.281113713069225,NaN,NaN,98.81200822903521,91.18158399008026,1.3135730529671408,-0.6873773388662414,-2.000950391833382,1219290333,1216190445.6,40.32652436286661,33.60413116253337,NaN,NaN,-3.7895260991838056,-11.56468703245001
2022-06-07T09:30:00-04:00,138.51,141.94,138.23,141.67,5508335,9856964.95,53.13287452693002,46.84773777566706,NaN,NaN,86.74363205242283,94.49514945838581,1.2841626467783704,-0.3957470833604191,-1.6799097301387895,1224798668,1217481047.8,42.08236810640787,34.544894333729154,NaN,NaN,-2.3364552327709203,-10.246368203924426
2022-06-08T09:30:00-04:00,141.25,141.93,139.68,140.07,4407144,9168061.95,50.648445059734335,47.674328192478484,NaN,NaN,78.04178783239801,94.07526516435485,1.1116180002661058,-0.29038722980615717,-1.402005230072263,1220391524,1219220700.8,44.45486404399738,35.75599014293269,NaN,NaN,-1.7729969913905377,-9.035886602133871
2022-06-09T09:30:00-04:00,139.05,140.41,136.3,136.33,4882603,8542646.1,45.314628380242944,48.21006476489445,NaN,NaN,21.662730937019703,75.5094642227283,0.7193012575271727,-0.5028786581632971,-1.2221799156904698,1215508921,1218597000.2,43.76271887519788,36.97257732009774,NaN,NaN,-2.8096328058605144,-8.14642177409482
2022-06-10T09:30:00-04:00,133.98,134.4,131.05,131.09,10443151,8152138.6,39.10150707249348,48.27132614002965,NaN,NaN,-83.72670310853925,40.3066911884673,0.11243558570137813,-1.081635433563747,-1.1940710192651252,1205065770,1217011043.2,41.973146124031494,38.12926318616801,NaN,NaN,-5.7088966464974575,-7.798203898723768
2022-06-13T09:30:00-04:00,126.96,128.17,124.82,125.28,18166347,8448063.35,33.6004512824381,47.623492216145465,NaN,NaN,-169.79179254805103,-13.414068966949944,-0.633724628876779,-1.986226805361099,-1.35250217648432,1186899423,1210532861.2,35.57397307337189,38.729451032510546,NaN,NaN,-10.165886314138737,-8.13644424378305
2022-06-14T09:30:00-04:00,126.22,126.91,124.9,126.07,9125172,8468734.95,34.940736832946286,47.21937546667001,NaN,NaN,-147.74514858015334,-60.311825093465174,-1.005436045033811,-2.6092972327765835,-1.6038611877427726,1196024595,1204778046.6,31.045845094722722,39.08510725651512,NaN,NaN,-13.286068088465743,-8.872104793023434
2022-06-15T09:30:00-04:00,127.64,130.63,125.91,128.73,12534785,8630418.5,39.3778715719931,46.96718697102431,NaN,NaN,-97.67008111009112,-95.454198881963,-1.0013338584957467,-2.855528510862456,-1.8541946523667092,1208559380,1202411617.8,29.389231072279884,39.19985092249252,NaN,NaN,-14.539844984933406,-9.681781963296286
2022-06-16T09:30:00-04:00,125.46,125.57,122.465,123.49,16345406,8855935.2,34.400575069638066,46.03205882489268,NaN,NaN,-141.40966664675295,-128.06867839871754,-1.2637713316516783,-3.4339088169313072,-2.170137485279629,1192213974,1197752628.4,26.402192667362144,38.65650872940389,NaN,NaN,-17.285909143632118,-10.768085846201405
2022-06-17T09:30:00-04:00,123.47,125.8,122.6,124.62,13842437,9026184.6,36.271292634883494,44.814669389910385,NaN,NaN,-122.1147289913911,-135.74628357528792,-1.2701143847542964,-3.757780466222499,-2.487666081468203,1206056411,1197950756.6,26.743181293209204,37.76661833653365,NaN,NaN,-18.906951022625858,-11.930780871404899
2022-06-21T09:30:00-04:00,126.11,128.36,126.11,127.46,8622498,8950995.8,40.837730935724394,44.02013792982867,NaN,NaN,-81.87855477793445,-118.1636360212646,-1.0035868506870678,-3.7421496448270375,-2.7385627941399697,1214678909,1203506653.8,35.73490151311677,37.44791856501268,NaN,NaN,-18.857072854738135,-12.920251154738219
2022-06-22T09:30:00-04:00,126.07,128.679,125.72,126.92,7581741,8899590.8,40.24720588848282,43.22515031140458,NaN,NaN,-76.63607114696394,-103.94182053462673,-0.7934174589814318,-3.7303346178667596,-2.936917158885328,1207097168,1205721168.4,38.951372685883356,37.25420679614172,NaN,NaN,-18.990785882540564,-13.787470401567125
2022-06-23T09:30:00-04:00,128.01,129.065,126.84,128.82,8021088,8872594.35,43.351139491436534,42.34270384791661,NaN,NaN,-60.31780893565934,-96.47136609974037,-0.4720662272750653,-3.5269999429791596,-3.0549337157040943,1215118256,1207032943.6,40.84021888257657,37.086461678509565,NaN,NaN,-18.19545283765049,-14.417182178150464
2022-06-24T09:30:00-04:00,130.3,133.48,130.3,133.45,12746063,9168481.8,50.147180671976464,42.2975119465247,NaN,NaN,-14.304391688402259,-71.05031110807022,0.07742402186315678,-2.9581536883751482,-3.035577710238305,1227864319,1214163012.6,49.91166080805617,37.656585614505744,NaN,NaN,-15.375292906422425,-14.554055139332172
2022-06-27T09:30:00-04:00,133.88,134.275,131.95,132.55,6958648,9127498.45,48.91865142168443,42.16359220290029,NaN,NaN,-7.334674145181569,-48.09430013882832,0.3880140545722308,-2.5505601420230164,-2.938574196595247,1220905671,1217132864.6,53.13512594979726,38.57148572785794,NaN,NaN,-13.434300401787446,-14.394090176825783
2022-06-28T09:30:00-04:00,132.67,133.99,128.52,128.58,7631100,9102008.8,43.81906699143941,41.49832023607953,NaN,NaN,-31.418292484246045,-38.00224768009063,0.33577982671176265,-2.518849413205544,-2.8546292399173065,1213274571,1216851997,52.789121012094895,39.33625379254987,NaN,NaN,-13.269489974993482,-14.233433005135455
2022-06-29T09:30:00-04:00,128.42,129.61,127.38,128.84,6803575,8956665.15,44.22911562251734,41.03979670484974,NaN,NaN,-47.048020783547,-32.08463760740724,0.3280559937400582,-2.4445592477422338,-2.772615241482292,1220078146,1219448192.6,55.66311719935325,40.13684330364672,NaN,NaN,-13.017766117737665,-14.05976630693577
2022-06-30T09:30:00-04:00,127.13,128.72,125.11,127.12,7860161,9017053.3,42.04296759981269,40.80610664910472,NaN,NaN,-61.126723313945504,-32.24642048306447,0.22152862973482002,-2.495704454313767,-2.717233084048587,1212217985,1218868138.4,54.85956825251119,40.92947540202624,NaN,NaN,-13.430311287899817,-13.969844161359205
2022-07-01T09:30:00-04:00,126.32,127.73,125.23,127.41,6965317,9018610.9,42.55849452992206,41.053034324635334,NaN,NaN,-58.49328850821279,-41.084199847026575,0.18642606278517615,-2.4842005055671166,-2.6706265683522927,1219183302,1217131935,52.420292157794556,41.675700118723604,NaN,NaN,-13.629248332132551,-13.921187614326826
2022-07-05T09:30:00-04:00,125.68,129.04,124.96,129.01,7170535,9095544.2,45.441934081101145,41.898854524539836,NaN,NaN,-41.97107762522134,-48.01148054303453,0.28110754635942126,-2.319242135403016,-2.600349681762437,1226353837,1218221568.2,53.80843965833702,42.97816201764969,NaN,NaN,-13.013218149207578,-13.791477690738361
2022-07-06T09:30:00-04:00,129.29,131.16,128.65,130.12,8083462,9184978.4,47.41409377941833,42.789808592144986,NaN,NaN,1.2973375526451383,-41.4683545356563,0.42026044241343863,-2.075024128745639,-2.4952845711590776,1234437299,1222454113.8,58.83270098447314,44.962937438346145,NaN,NaN,-11.953705763879642,-13.528938844044259
2022-07-07T09:30:00-04:00,130.69,133.11,130.69,132.81,6541124,9236617.85,51.947389821927786,43.68763132428318,NaN,NaN,55.91310764727586,-20.876128849491728,0.6798665837786433,-1.6454513414357734,-2.3253179252144167,1240978423,1226634169.2,63.1013032447487,47.37094259352249,NaN,NaN,-9.735635925614996,-12.987038427125793
2022-07-08T09:30:00-04:00,131.39,133.298,130.98,132.87,6313461,9331933.7,52.04668930063779,44.948068055068866,NaN,NaN,80.12526308396157,7.37426843008969,0.8319714935208107,-1.2853535583134033,-2.117325051834214,1247291884,1233648949,68.9245752662811,50.40825563630241,NaN,NaN,-7.873997407072519,-12.256603995689611
2022-07-11T09:30:00-04:00,131.71,132.28,130.14,131.04,5708344,9373220.75,48.73852628984674,45.83858474470911,NaN,NaN,67.91735728545214,32.65639758882268,0.7862115072768456,-1.1345606677381568,-1.9207721750150024,1241583540,1238128996.6,71.96737321256737,53.638555059113706,NaN,NaN,-7.118678452728937,-11.522614632409514
2022-07-12T09:30:00-04:00,131.52,132.26,128.49,129.25,8276696,9264898,45.680037661176414,46.184463796527105,NaN,NaN,40.68282660401331,49.187178434669605,0.6195932230958756,-1.1462806461451578,-1.7658738692410334,1233306844,1239519598,72.85583201176142,56.29005009473119,NaN,NaN,-7.289962549817145,-10.917950049182032
2022-07-13T09:30:00-04:00,126.82,129.74,126.26,128.91,7581328,8735647.05,45.10109950206944,46.53117048321186,NaN,NaN,-13.89463897907314,46.14878312832595,0.47708113921210016,-1.1695224452259083,-1.6466035844380085,1225725516,1237777241.4,69.86790301841009,58.498373689911666,NaN,NaN,-7.587102949146125,-10.442114749176902
2022-07-14T09:30:00-04:00,127.88,130.55,126.23,130.09,6864408,8622608.85,47.58398939046885,46.83351690457131,NaN,NaN,1.8785949775549313,35.34188059438176,0.45306455817013536,-1.0802728867253393,-1.5333374448954746,1232589924,1236099541.6,67.0178160479287,60.36820205886539,NaN,NaN,-7.193953518208344,-9.978091716181394
2022-07-15T09:30:00-04:00,131.34,132.44,130.79,132.38,6764646,8334101.9,52.11058314942788,46.97375993867498,NaN,NaN,86.21233268528465,36.559294514646375,0.5743826325977879,-0.8153591541482399,-1.3897417867460278,1239354570,1234512078.8,64.34322600711434,61.3990281445124,NaN,NaN,-5.601109938440993,-9.352808605075623
2022-07-18T09:30:00-04:00,133.68,134.16,130.6,131.1,4948846,7764273.9,49.53554496986487,47.01782376354502,NaN,NaN,80.66145947868608,39.10811495329317,0.5512957655090862,-0.7006220798596701,-1.2519178453687563,1234405724,1233076515.6,61.93601770054607,62.02766326956589,NaN,NaN,-4.922653038834411,-8.719929238469735
2022-07-19T09:30:00-04:00,132.56,135.24,131.76,135.1,6165272,7380415.65,56.73115682469108,47.94011589449156,NaN,NaN,137.85978792755492,58.543507218001494,0.7746096807805807,-0.2836557443930303,-1.058265425173611,1240570996,1234529346,63.427251460257274,62.78752973014891,NaN,NaN,-2.141631027717132,-7.780172351219363
2022-07-20T09:30:00-04:00,135.12,137.78,134.76,137.21,6268566,7262719.05,59.97334754653342,49.06470388906414,NaN,NaN,189.32661612361105,99.18775823853832,1.018275471646469,0.21457891438447518,-0.8036965572619937,1246839562,1238752155.2,67.42230890936219,63.627471995149556,NaN,NaN,1.2376656018243246,-6.491909786498836
2022-07-21T09:30:00-04:00,137.38,139.17,135.95,139.14,6478770,7207570.5,62.72468661399526,50.541969532934324,NaN,NaN,198.76931389948754,138.56590202292486,1.2481160251947419,0.7564484742314335,-0.4916675509633083,1253318332,1242897836.8,70.79517573979254,64.76572967281251,NaN,NaN,4.962823585259059,-4.855519304819137
2022-07-22T09:30:00-04:00,139.08,139.65,136.425,137.22,5291806,7071106.4,58.42236768435839,51.67510332967977,NaN,NaN,163.76903690446963,154.07724286676185,1.2086998516338054,1.0192072635789486,-0.18949258805485686,1248026526,1244632228,72.09675152614787,66.17119105626632,NaN,NaN,6.85261142709242,-3.1829292002603435
2022-07-25T09:30:00-04:00,137.16,137.31,135.32,136.35,6975583,6782582.4,56.53025181361419,52.467126024859276,NaN,NaN,112.78961406214908,160.50287378345445,1.0668387143925395,1.1440558049358174,0.07721709054327797,1241050943,1245961271.8,73.08658159467586,67.54820119457624,NaN,NaN,7.863823826499837,-1.6048216250088894
2022-07-26T09:30:00-04:00,136.24,136.28,133.64,134.14,5083917,6688845.85,51.929386974270685,52.78964696734873,NaN,NaN,68.94555618490321,146.7200274349241,0.7802564430887122,1.0525376444041683,0.2722812013154561,1235967026,1245040477.8,71.20203807397912,68.4317252723981,NaN,NaN,7.370202254158231,-0.3226753565564435
2022-07-27T09:30:00-04:00,136.35,140.64,136.15,139.91,8536752,6734128.45,60.881221793926294,53.42777782249148,NaN,NaN,142.5538843048341,137.36548107116872,0.9254754798867639,1.429125551173911,0.503650071287147,1244503778,1244573321,70.21286992369595,68.93969432089433,NaN,NaN,9.870724283469965,1.1335245920187575
2022-07-28T09:30:00-04:00,140.07,142.36,138.82,142.04,6204042,6704151.8,63.57764985548527,54.251417862123446,NaN,NaN,157.0856210401439,129.0287424993,1.0993209472301546,1.8778012553248402,0.7784803080946856,1250707820,1244051218.6,69.05816653270678,68.94923655421044,NaN,NaN,12.820805998010677,2.8031362214461746
2022-07-29T09:30:00-04:00,142.48,144.67,141.88,144.22,5088675,6565577.5,66.14941501200235,55.49505277084889,NaN,NaN,172.6874135552327,130.81241782945258,1.2826809483715125,2.3818314935590763,1.0991505451875638,1255796495,1245605212.4,70.60758003411397,68.85210847003519,NaN,NaN,16.107367360137115,4.703740669830594
2022-08-01T09:30:00-04:00,142.92,145.35,142.57,143.91,6258003,6530211.8,65.4417815838586,56.90660590818334,NaN,NaN,155.12974709073836,139.28044443517044,1.3005629684753832,2.7248542557817927,1.4242912873064095,1249538492,1247302722.2,72.24268784423458,68.80831245806898,NaN,NaN,18.49431791106647,6.673823132864291
2022-08-02T09:30:00-04:00,142.67,144.54,141.66,142.89,7960900,6569730.05,63.05175530903404,58.18879560868081,NaN,NaN,123.25414661812427,150.14216252181464,1.1655144034711786,2.8811842916453827,1.715669888174204,1241577592,1248424835.4,73.30006592209278,69.05346695118918,NaN,NaN,19.754312294576486,8.542464441680318
2022-08-03T09:30:00-04:00,143.59,147.1,143.56,146.69,7121765,6521645.2,67.77374949752334,59.63092133061327,NaN,NaN,145.21964978637484,150.67531561812282,1.2466360759299961,3.2739649830866995,2.0273289071567033,1248699357,1249263951.2,74.09477854766061,69.55896427259862,NaN,NaN,22.37160784335927,10.518056356205882
2022-08-04T09:30:00-04:00,146.64,147.43,145.7,147.36,5839913,6486584.65,68.5372412102057,60.804254049240264,NaN,NaN,139.42277231459278,147.1427458730126,1.256405909664827,3.5978362942377373,2.3414303845729103,1254539270,1250030241.2,74.83151628923027,70.30812786417832,NaN,NaN,24.720313926980804,12.546950294888013
2022-08-05T09:30:00-04:00,145,147.43,144.88,147.02,3960514,6368937.3,67.66120297534687,62.09894390677469,NaN,NaN,117.84337211019461,136.17393758400496,1.1536221987052775,3.7834581329545074,2.62983593424923,1250578756,1248986693.4,71.8353382109771,71.01522218635196,NaN,NaN,26.381689811231983,14.523341654365723
2022-08-08T09:30:00-04:00,146.89,148.03,144.98,145.77,5551413,6361090.75,64.40199879871466,62.64686119063351,NaN,NaN,103.33327441979549,125.81464304981637,0.9249767860076412,3.786056916758781,2.86108013075114,1245027343,1248084463.6,69.25358434030454,71.43138882064105,NaN,NaN,26.867490537759544,16.286791494850554
2022-08-09T09:30:00-04:00,144.59,144.88,143.53,144.31,4282862,6161399.05,60.72281666430595,62.70039469904583,NaN,NaN,69.65076188210688,115.0939661026129,0.6139197487585486,3.6284798166993255,3.014560067940777,1240744481,1247917841.4,68.76208143349086,71.52708685807882,NaN,NaN,26.234238151275903,17.70785530291132
2022-08-10T09:30:00-04:00,147.74,148.37,146.56,148.25,9636552,6264160.25,66.31538808263343,62.956873375377135,NaN,NaN,104.55378275276415,106.96079269589077,0.6107309630338484,3.7779737717330875,3.167242808699239,1250381033,1248254176.6,69.23669588113071,71.4157668681744,NaN,NaN,27.34118587003661,19.08404538392922
2022-08-11T09:30:00-04:00,149.18,150.05,147.4,147.67,5512907,6196585.2,64.85150063136562,63.416097157306226,NaN,NaN,104.86727700654943,100.04969363428211,0.5108273745236289,3.805777026853775,3.2949496523301463,1244868126,1246319947.8,63.28200396916061,70.78614204267531,NaN,NaN,27.811000216388166,20.33075321713764
2022-08-12T09:30:00-04:00,148.64,150.62,148.18,150.61,4046959,6060700.85,68.63149547282933,64.28047170439301,NaN,NaN,115.06166384029568,99.49335198030232,0.5790158302189523,4.018719440103837,3.4397036098848845,1248915085,1245987213.6,62.28954536037803,70.01492516879689,NaN,NaN,29.37753065775781,21.623149994369093
2022-08-15T09:30:00-04:00,150.01,151.78,149.84,151.56,3581283,5992322.7,69.76306977255513,65.55430618998476,NaN,NaN,125.23325393306854,103.87334788295693,0.6206697260175496,4.2155407674068215,3.594871041389272,1252496368,1247481018.6,64.94741331916106,69.56816625773845,NaN,NaN,31.005742225592066,22.963520313115232
2022-08-16T09:30:00-04:00,150.87,151.86,149.74,151.15,5495341,5958826.15,68.61269675994815,66.10655440184347,NaN,NaN,116.2726584409041,113.19772719471639,0.5553020530389832,4.288998607688001,3.7336965546490175,1247001027,1248732327.8,67.0428597635461,69.3417369605849,NaN,NaN,32.01308968166422,24.25631593719366
2022-08-17T09:30:00-04:00,149.77,151.22,148.99,150.07,6316380,5961216.85,65.54658652959918,66.24719273570875,NaN,NaN,95.47857682336868,111.3826860088373,0.3822585350729448,4.211519723490198,3.8292611884172536,1240684647,1246793050.6,60.96059109219117,68.76333871483378,NaN,NaN,32.00430489915071,25.363171503187523
2022-08-18T09:30:00-04:00,150.22,151.45,149.64,150.85,4988433,5886700,66.70385149446659,66.28679534159905,NaN,NaN,95.44676291955616,109.49858319143864,0.2686267208256443,4.165044589449309,3.8964178686236646,1245673080,1246954041.4,61.2746809579128,68.0967030665337,NaN,NaN,32.31199656927372,26.355860798342693
2022-08-19T09:30:00-04:00,149.61,149.79,147.7783,148.11,5073265,5875772.95,59.183443180572034,65.83977116993573,NaN,NaN,55.87697570496062,97.66164556437164,-0.027060652328753765,3.8625920532127225,3.8896527055414762,1240599815,1245290987.4,56.240914736074195,66.95371927309368,NaN,NaN,30.387974997198224,26.93187711246491
2022-08-22T09:30:00-04:00,146.09,146.14,143.62,143.98,5372124,5795600,50.02784939063488,64.90949217576436,NaN,NaN,-25.4878724519995,67.51742028735802,-0.5100013781089592,3.2521509829052775,3.7621523610142367,1235227691,1241837252,47.511618993629476,65.111687349632,NaN,NaN,25.645796005662262,26.748151240064534
2022-08-23T09:30:00-04:00,143.7,145.12,143.405,143.6,7388683,5910838.3,49.27256640786644,63.587979097931715,NaN,NaN,-54.608494164510695,33.341189766275065,-0.8445136911280025,2.7065102471042337,3.551023938232236,1227839008,1238004848.2,40.07800782211669,62.681918012093156,NaN,NaN,21.612163627389496,26.014438723968098
2022-08-24T09:30:00-04:00,143.5,144.3,142.9,143.69,4491636,5708582.5,49.467154034130076,62.22583001392631,NaN,NaN,-76.66537865810906,-1.0876013300204932,-1.0365391428367863,2.2553500096862535,3.29188915252304,1232330644,1236334047.6,37.335428512703224,60.00362602805551,NaN,NaN,18.404486171788403,24.927302645085284
2022-08-25T09:30:00-04:00,144.06,146.13,143.87,146.12,3563308,5576545.8,54.53788335993804,61.288450041397105,NaN,NaN,-39.29256281495855,-28.03546647692344,-0.9774944831097505,2.0700210486358515,3.047515531745602,1235893952,1234378222,34.370406478849745,57.32755947576069,NaN,NaN,17.025374306856644,23.79845573962405
2022-08-26T09:30:00-04:00,146.06,146.41,139.78,139.88,7160945,5680159.3,42.6911732695414,59.737676789313305,NaN,NaN,-129.02381217444423,-65.01562405280441,-1.3152503978459658,1.403452534438145,2.7187029322841108,1228733007,1232004860.4,31.138741651493476,54.605070712274184,NaN,NaN,11.572332285542245,22.05186667475522
2022-08-29T09:30:00-04:00,138.37,139.38,137.5,138.03,6615764,5698047.35,39.92239670800624,58.25193250672046,NaN,NaN,-202.6168924809146,-100.44142805858743,-1.6008502363214978,0.7176401368822383,2.318490373203736,1222117243,1229382770.8,28.005763539371983,51.69390514840855,NaN,NaN,6.200113187712084,19.787330462320487
2022-08-30T09:30:00-04:00,138.81,139.049,135.35,136.59,6634391,5631721.9,37.86389804873068,56.21968321858456,NaN,NaN,-203.4001557117907,-130.19976036804343,-1.8089741374911505,0.057272701339798004,1.8662468388309486,1215482852,1226911539.6,25.410832994078334,48.56348637076195,NaN,NaN,1.1699672558950465,17.12770714711685
2022-08-31T09:30:00-04:00,137.41,137.85,135.19,135.26,7085662,5629916.75,36.01670699078087,54.16005510139993,NaN,NaN,-180.37413590259717,-150.94151181694104,-1.9464844623109587,-0.56685873905775,1.3796257232532088,1208397190,1222124848.8,21.294961080348614,45.56441187870395,NaN,NaN,-3.5306692854950925,14.176510513886573
2022-09-01T09:30:00-04:00,133.94,134.77,131.78,134.6,7994304,5737636.3,35.10156198091508,51.765059851977476,NaN,NaN,-183.15392311517292,-179.7137838769839,-1.9853327804541063,-1.1020402523144242,0.8832925281396822,1200402886,1215026635.6,16.918659462080583,42.32363431453985,NaN,NaN,-7.614555105548703,11.063501139681534
2022-09-02T09:30:00-04:00,135.99,136.76,132.15,132.85,8303264,5954773.8,32.72706425060581,49.11963088612396,NaN,NaN,-151.0515858669315,-184.11933861548138,-2.025341449745217,-1.648384284041839,0.3769571657033779,1192099622,1207699958.6,13.77246971538922,38.66828119998472,NaN,NaN,-11.812312945373982,7.795527698959318
2022-09-06T09:30:00-04:00,133.03,133.6,131.1,131.97,7495104,6051958.35,31.570535145410105,46.473762199371244,NaN,NaN,-145.97588091843687,-172.79113630298585,-2.0038425537309457,-2.127846026460304,-0.12400347272935852,1184604518,1200197413.6,11.428757755218726,34.69584534224704,NaN,NaN,-15.631078607535573,4.448869655174334
2022-09-07T09:30:00-04:00,132.23,134.62,131.78,134.08,5828475,6129239,37.29260003052048,44.45562030657991,NaN,NaN,-110.45480063366534,-154.20206528736077,-1.749536937706646,-2.3109246448626664,-0.5613877071560202,1190432993,1195187441.8,10.182627034406238,31.068847909548122,NaN,NaN,-17.248909456319154,1.3491869249609785
2022-09-08T09:30:00-04:00,133.09,135.24,132.49,134.54,5605301,5927676.45,38.49998268477013,42.44105824874445,NaN,NaN,-91.22504430803708,-136.37224696844876,-1.4639552971310044,-2.3913318285697756,-0.9273765314387712,1196038294,1192715662.6,9.625023583341289,27.3795866685073,NaN,NaN,-18.228459769518636,-1.4476197456789666
2022-09-09T09:30:00-04:00,135.66,137.57,135.4,137.2,5709315,5937496.85,45.08457614827606,41.43399631786616,NaN,NaN,-55.85766919173476,-110.91299618376112,-1.030005601135437,-2.2148835328580674,-1.1848779317226303,1201747609,1192984607.2,10.201224400710899,24.09103735883849,NaN,NaN,-17.120141715884927,-3.6865514557083894
2022-09-12T09:30:00-04:00,138.05,139.46,138.03,139.4,5090477,5989672.75,49.865543391862786,41.42240303223958,NaN,NaN,-26.454473086752902,-85.99357362772541,-0.552818576743864,-1.8759011526524603,-1.3230825759085962,1206838086,1195932300,16.48599001269625,21.874921003057548,NaN,NaN,-14.68013981753187,-5.25706407882603
2022-09-13T09:30:00-04:00,135.42,136.18,131.64,132,10074357,6314326.45,37.91000805969758,40.61079172165609,NaN,NaN,-84.02201818007231,-73.60280108005247,-0.684935752182233,-2.1792522661363876,-1.4943165139541545,1196763729,1198364142.2,21.37496033728857,20.538989039855544,NaN,NaN,-16.502678590765605,-6.863580437674541
2022-09-14T09:30:00-04:00,132.62,133.45,131.21,132.48,6614581,6370288.45,38.93276151072738,39.85833511284161,NaN,NaN,-88.51958913990461,-69.21575878130034,-0.687582897229611,-2.3537951354911684,-1.6662122382615574,1203378310,1200953205.6,26.320318837708854,19.75219549164166,NaN,NaN,-17.55467478602949,-8.390879630296677
2022-09-15T09:30:00-04:00,131.42,132.22,128.65,129.43,7442643,6426601.6,34.98888964874243,38.46197841918479,NaN,NaN,-111.06334810257977,-73.18341954020886,-0.8326511805314969,-2.7070262139259285,-1.8743750333944316,1195935667,1200932680.2,26.306192534482108,19.176180209901123,NaN,NaN,-19.777975127327068,-10.017607558443876
2022-09-16T09:30:00-04:00,128.3,128.975,126.88,128.71,10381060,6696232.95,34.11044911983198,37.84906955134841,NaN,NaN,-130.27173544295076,-88.06623279045206,-0.9087886178470947,-3.0103608057033,-2.1015721878562053,1185554607,1197694079.8,24.107613799622555,18.673956791910342,NaN,NaN,-21.81292738702464,-11.702653248241127
2022-09-19T09:30:00-04:00,127.11,129.56,127.03,129.44,7841637,6834651.55,35.8684890041161,37.55950471535625,NaN,NaN,-117.23723016210216,-106.2227842055219,-0.8431233604109258,-3.1554763883698627,-2.312353027958937,1193396244,1195005711.4,22.431661795292584,18.27580666733324,NaN,NaN,-22.912240752293297,-13.304022891677151
2022-09-20T09:30:00-04:00,128.23,129.49,127.5602,128.68,6054822,6868786.45,34.82665307274448,37.34255864564295,NaN,NaN,-109.74443422413862,-111.36726741433517,-0.7851878727841819,-3.293837868939164,-2.508649996154982,1187341422,1193121250,21.313155940439685,17.983115449216193,NaN,NaN,-24.119325849218328,-14.849066171325891
2022-09-21T09:30:00-04:00,129.35,131.25,126.65,126.67,8404352,6919569.9,32.165647996592,37.06748300320089,NaN,NaN,-108.91299776462466,-115.4459491392792,-0.8131168069015562,-3.5250460047819274,-2.7119291978803712,1178937070,1188233002,18.707362198762965,17.79828695767436,NaN,NaN,-25.95179486019153,-16.435170269735266
2022-09-22T09:30:00-04:00,125.96,126.76,124.67,125.38,8017124,7095844.3,30.55220065002102,36.742528622422746,NaN,NaN,-145.05641046127815,-122.24456161101887,-0.8455978405927524,-3.768926498621312,-2.9233286580285593,1170919946,1183229857.8,16.48571752106885,17.76736253331638,NaN,NaN,-27.967295192372365,-18.082616687254852
2022-09-23T09:30:00-04:00,124.24,124.43,122.11,123.74,9698339,7402595.85,28.58884945520981,36.446941851323025,NaN,NaN,-166.29374986081564,-129.44896449459185,-0.8996382264601892,-4.047876441103796,-3.1482382146436065,1161221607,1178363257.8,14.661757208978344,17.83088306857275,NaN,NaN,-30.268474826224523,-19.82345356425052
2022-09-26T09:30:00-04:00,123.36,125.43,122.53,122.88,8597045,7474400.85,27.587674730832305,36.16245182171033,NaN,NaN,-143.18022095703327,-134.63756265357807,-0.9125304749989529,-4.2889013083922976,-3.3763708333933447,1152624562,1170208921.4,12.221761839202443,17.887526217428725,NaN,NaN,-32.47661314904377,-21.631047790649557
2022-09-27T09:30:00-04:00,124.51,125.68,121.9,123.04,9357359,7611480.6,28.0922144123585,35.50528142041304,NaN,NaN,-126.16782069685024,-137.9222399481204,-0.8317821766276841,-4.41609855417795,-3.5843163775502656,1161981921,1165137021.2,10.996004134119488,17.94562458169396,NaN,NaN,-34.15524319984725,-23.420218563392083
2022-09-28T09:30:00-04:00,122.22,124.94,121.28,124.34,9466597,7753090.9,32.22426046578876,35.05701554762866,NaN,NaN,-112.88834466704395,-138.71730932860424,-0.6219268202180506,-4.361724902822829,-3.739798082604778,1171448518,1163639310.8,10.65613451942717,18.01927536284295,NaN,NaN,-34.47795191623901,-24.99989475665593
2022-09-29T09:30:00-04:00,122.56,122.84,119.67,121.1,15548343,8176224.95,27.918347147192605,33.830856333265565,NaN,NaN,-133.85911081532365,-136.47784939941334,-0.6304653223078733,-4.52787973548962,-3.8974144131817465,1155900175,1160635356.6,9.989235841879761,18.004133322926442,NaN,NaN,-36.038371445505355,-26.576819997920133
2022-09-30T09:30:00-04:00,120.61,122.4,118.56,118.78,9756456,8264332.55,25.3103444444251,32.07691355130573,NaN,NaN,-136.3391461043481,-130.48692864811983,-0.7152920528124831,-4.791529479197351,-4.076237426384868,1146143719,1157619779,9.356209223701697,17.49486326656969,NaN,NaN,-38.194024313475815,-28.236420614428088
2022-10-03T09:30:00-04:00,119.72,123.19,119.26,122.46,8666140,8282476.35,35.58872609759868,31.91110769687009,NaN,NaN,-100.07742393420607,-121.86636924355439,-0.4589517313732667,-4.649927090601452,-4.190975359228185,1154809859,1158056838.4,10.243994345436036,16.699794267151653,NaN,NaN,-36.79991951597402,-29.45977760036322
2022-10-04T09:30:00-04:00,124.94,126.71,124.85,126.57,8889540,8352198.15,44.735884379662906,32.325616473222624,NaN,NaN,-30.50780050846774,-102.73436520587788,0.026275344761866215,-4.158131178275852,-4.184406523037718,1163699399,1158400334,10.98192137004402,15.604194448032738,NaN,NaN,-32.38966889288572,-29.878333499295007
2022-10-05T09:30:00-04:00,124.86,127.91,124.13,126.99,7300156,8425782.2,45.58628744235549,33.0825734584807,NaN,NaN,-21.457080146997722,-84.44811230186865,0.3939807330234961,-3.6919306067583477,-4.085911339781844,1170999555,1158310541.4,10.95656259480306,14.507792309484234,NaN,NaN,-28.674153970774768,-29.706307852363544
2022-10-06T09:30:00-04:00,126.66,128.05,125.8,125.95,7174110,8504222.65,43.78940618280891,33.773927534407626,NaN,NaN,-12.361679418341328,-60.148626022472186,0.5746783290839739,-3.3675634284268767,-3.9422417575108506,1163825445,1159895595.4,14.70096290109106,13.83588867387484,NaN,NaN,-26.199533459825748,-29.205340082001
2022-10-07T09:30:00-04:00,123.38,123.39,120.12,120.77,7874463,8612480.05,36.14687795831625,33.79381245970763,NaN,NaN,-95.34329009361312,-51.949454820325194,0.36317566099905374,-3.488272181262033,-3.851447842261087,1155950982,1161857048,19.22746283483211,13.607017319556237,NaN,NaN,-26.48818623574621,-28.817175246821744
2022-10-10T09:30:00-04:00,120.77,120.94,117.55,118.74,8353096,8775611,33.66703686983146,33.71098273092813,NaN,NaN,-132.14013460949417,-58.3619969553828,0.11713467511349851,-3.705029498369214,-3.8221641734827125,1147597886,1160414653.4,18.452014049611137,13.40265004163991,NaN,NaN,-27.554263142756408,-28.636759231955267
2022-10-11T09:30:00-04:00,118.06,118.875,116.05,116.92,10522406,8798013.45,31.575509919781027,33.66883001115592,NaN,NaN,-151.07380015089717,-82.47519688386868,-0.12452164842429081,-3.9778162340130763,-3.8532945855887855,1137075480,1155089869.6,15.902288974190895,13.202287668456192,NaN,NaN,-29.112009891261625,-28.704652183284747
2022-10-12T09:30:00-04:00,117.01,117.81,116.36,116.56,7055821,8820075.45,31.16311319852862,33.7124666217636,NaN,NaN,-145.84020696047273,-107.35182224656369,-0.2573041275508552,-4.174924745027354,-3.917620617476499,1130019659,1146893890.4,12.938667778400287,12.948926972551293,NaN,NaN,-30.47134586112182,-28.95703699440433
2022-10-13T09:30:00-04:00,113.41,120.805,112.97,120.18,19057309,9400808.75,39.69265657424353,34.50559570169459,NaN,NaN,-113.7348964052247,-127.62646564394035,-0.06030516312059886,-3.993002071377248,-3.932696908256649,1149076968,1143944195,12.067051703219548,12.763590864997095,NaN,NaN,-28.918395148552573,-28.951516730711223
2022-10-14T09:30:00-04:00,121.16,121.42,116.61,116.8,11242212,9443866.35,35.29509679685749,35.056125849267815,NaN,NaN,-95.20566116593214,-127.59893985840418,-0.1135187890964029,-4.074595394627153,-3.96107660553075,1137834756,1140320949.8,11.079706201342418,12.682015462292807,NaN,NaN,-29.031260324472502,-28.96290867267712
2022-10-17T09:30:00-04:00,119.66,120.96,119.34,120.36,7299764,9416772.7,42.51858572007696,36.08658094267627,NaN,NaN,-48.74491774668372,-110.91989648584209,0.12238204606712788,-3.8080990479468397,-3.9304810940139676,1145134520,1139828276.6,10.948525631167328,12.678624140653367,NaN,NaN,-26.661015423655538,-28.634066779959753
2022-10-18T09:30:00-04:00,123.48,123.92,119.85,121.38,6998992,9463981.2,44.43268341877092,36.95861115360357,NaN,NaN,-9.84432509501829,-82.6740014746663,0.36475211327277535,-3.4745409524229984,-3.8392930656957738,1152133512,1142839883,17.38742152631376,13.15943035543098,NaN,NaN,-24.1582848773889,-27.994669365306773
2022-10-19T09:30:00-04:00,120.32,122.23,119.81,121.03,5491995,9318363.35,43.8925758290439,38.09962748802152,NaN,NaN,-20.225064957402232,-57.550973074052216,0.5102099870940067,-3.2015305818282656,-3.711740568922272,1146641517,1146164254.6,23.926266701069082,14.154932559658787,NaN,NaN,-22.336973020358172,-27.186427030314118
2022-10-20T09:30:00-04:00,121.07,123.73,120.5,121.1,6214824,9228248.35,44.039089176611924,39.43739496889201,NaN,NaN,5.939123979214846,-33.6161689971643,0.6129405805375701,-2.9455648432503097,-3.5585054237878797,1152856341,1146920129.2,25.372631607512602,15.298962729930995,NaN,NaN,-20.83184310250462,-26.27862932634133
2022-10-21T09:30:00-04:00,120.8,124.6,120.39,124.34,8562953,9171479.05,50.484225269385774,40.50135919544823,NaN,NaN,46.33021806853752,-5.308993150270377,0.8844102136766439,-2.452992656692075,-3.337402870368719,1161419294,1151637036.8,33.8276059480942,16.983506415835148,NaN,NaN,-17.519688074084247,-25.02735200459032
2022-10-24T09:30:00-04:00,124.87,126.52,123.35,126.06,6692591,9076256.35,53.54312625170791,41.1304479005943,NaN,NaN,105.52891653587386,25.545773706241143,1.1483927223493642,-1.9019119674320137,-3.050304689781378,1168111885,1156232509.8,40.857826949557484,19.117499671514683,NaN,NaN,-13.790647166474098,-23.422108456288
2022-10-25T09:30:00-04:00,126.37,128.56,126.37,128.47,5132495,8865013.15,57.504435285648405,41.981744175115224,NaN,NaN,154.0242996145963,58.319498648164064,1.435260815865235,-1.2562286699498344,-2.6914894858150693,1173244380,1160454683.4,46.483451884132705,21.655134620752513,NaN,NaN,-9.343739536581998,-21.41091289633
2022-10-26T09:30:00-04:00,125.23,128.26,125.03,125.61,7584690,8770917.8,51.853732792495386,42.557767504378546,NaN,NaN,104.21183091313758,83.20687782227202,1.3818447130623217,-0.9641835944871673,-2.346028307549489,1165659690,1164258318,51.004861682724496,24.248270248012044,NaN,NaN,-7.229518999439405,-19.384999482488485
2022-10-27T09:30:00-04:00,126.08,126.85,123.89,124.18,5847421,8285871.7,49.24791733191554,43.4935560310642,NaN,NaN,64.09342470373757,94.83773796717657,1.2060549844217805,-0.8384595770222631,-2.0445145614440436,1159812269,1165649503.6,52.58280924306181,26.630794991457027,NaN,NaN,-6.276318617147704,-17.5123307874398
2022-10-28T09:30:00-04:00,124.87,129.85,124.87,129.58,7467722,8171435,57.859874505027456,45.22161586214963,NaN,NaN,117.54029136838466,109.079752627146,1.395904826536728,-0.2996335282731337,-1.6955383548098617,1167279991,1166821643,53.929118928836544,29.164873911401695,NaN,NaN,-2.498096201573557,-15.367440132316052
2022-10-31T09:30:00-04:00,128.29,128.64,127.11,127.87,6646133,8070434.65,54.6948197883367,46.87299513847504,NaN,NaN,99.18114639504661,107.81019859898053,1.3480530863441396,-0.01047199687968714,-1.3585250832238267,1160633858,1165326037.6,51.90408128185335,31.736430504806158,NaN,NaN,-0.4670611064466635,-13.238814557191853
2022-11-01T09:30:00-04:00,129.46,129.69,126.25,126.8,4706640,7861289.65,52.750349000620936,48.4149405529102,NaN,NaN,89.7229407649628,94.94992682905385,1.1914938858746627,0.13084227411950167,-1.060651611755161,1155927218,1161862605.2,47.45972030983056,34.202219971336895,NaN,NaN,0.5601880705747495,-11.26752846751091
2022-11-02T09:30:00-04:00,126.71,128.34,122.38,122.42,9047620,7948662.85,45.60330349210116,48.837129618471465,NaN,NaN,30.030150753768005,80.11359079717992,0.7610539244907264,-0.10933420614175304,-0.8703881306324794,1146879598,1158106586.8,43.145078392334185,36.422079020559366,NaN,NaN,-0.9030114004383151,-9.786883172214825
2022-11-03T09:30:00-04:00,120.71,120.93,118.73,118.82,8005349,7990224.8,40.71991629393623,49.22461672540566,NaN,NaN,-62.016770118698226,54.89155183269277,0.22955836410020702,-0.5834401755072207,-0.8129985396074277,1138874249,1153918982.8,38.89906530862393,38.4091760996509,NaN,NaN,-3.819387647383892,-8.934383811524691
2022-11-04T09:30:00-04:00,121.29,121.62,118.22,120.99,8948144,8043908.85,44.57283162230413,49.371348575564745,NaN,NaN,-44.14875709138869,22.553742140738102,0.030289697836355045,-0.7751364173119839,-0.805426115148339,1147822393,1150027463.2,35.411424411740654,40.156526012549,NaN,NaN,-4.932398296383742,-8.362671595075984
2022-11-07T09:30:00-05:00,121.2,123.21,120.34,123.01,5213814,7886944.75,47.963351487831815,49.62353915192624,NaN,NaN,-9.275386649319781,0.8624355318648249,0.04005871934699834,-0.755352715964591,-0.7954114353115893,1153036207,1148507933,34.12484076666463,41.35205595828835,NaN,NaN,-4.7499709711152995,-7.846571505938743
2022-11-08T09:30:00-05:00,124.03,125.69,122.36,124.19,6360973,7678873.1,49.891627589422576,50.052042849096146,NaN,NaN,24.846537189696882,-12.112845183188359,0.1266382660403197,-0.6371136027611897,-0.7637518688015094,1159397180,1149201925.4,35.28136317779152,42.16313427805424,NaN,NaN,-4.002268751569158,-7.297385398171659
2022-11-09T09:30:00-05:00,123.04,123.09,120.7801,120.96,5981274,7625145.75,44.978377356315384,50.1191348619321,NaN,NaN,-38.541296510800656,-25.82713463610209,-0.02490201271309378,-0.7948793846928766,-0.7699773719797828,1153415906,1150509187,37.507009519994476,43.02987555751723,NaN,NaN,-4.924265638184709,-6.958368289602095
2022-11-10T09:30:00-05:00,126.93,131.04,126.29,130.9,13966058,7370583.2,58.517127620989775,50.69291360133239,NaN,NaN,133.89173382342253,13.354566152322054,0.5227881961145655,-0.11649212683657595,-0.6392803229511415,1167381964,1156210730,46.19749217295403,43.913438859292924,NaN,NaN,-0.7571352886390359,-6.072477860893087
2022-11-11T09:30:00-05:00,130.78,133.58,130.14,133.14,7988913,7207918.25,60.854730776820986,51.215171067411895,NaN,NaN,177.39730788513256,57.6637791476263,0.9874441510063582,0.5950248658068062,-0.39241928519955194,1175370877,1161720426.8,52.99947153807268,44.780699187044014,NaN,NaN,3.3249485097602727,-4.7299883793711786
2022-11-14T09:30:00-05:00,132.09,133.6512,131.3691,132,7263280,7206094.05,59.031558411343674,51.32425129067584,NaN,NaN,154.7642043867575,90.47169735484177,1.1577435225457184,1.054760117982596,-0.10298340456312233,1168107597,1164734704.8,56.25765223795891,45.47885635517446,NaN,NaN,5.874479155833512,-3.2150644457705084
2022-11-15T09:30:00-05:00,135,135.55,132.26,133.6,6358058,7174047.35,60.8063560480432,51.963724380357824,NaN,NaN,157.67479948938936,117.03734981478026,1.3068401829970666,1.5305668241832109,0.22372664118614433,1174465655,1167748399.8,59.295822355611286,46.07106783180922,NaN,NaN,8.494213789188537,-1.5423104122049307
2022-11-16T09:30:00-05:00,132.57,132.96,131.22,131.77,5047993,7151847.25,57.72609605042381,52.56930857453699,NaN,NaN,109.08090582346217,146.56179028163282,1.2129583615735804,1.7399245931531198,0.5269662315795394,1169417662,1170948751,62.29109874084598,46.76451708165096,NaN,NaN,9.667857231228389,0.05914210828554345
2022-11-17T09:30:00-05:00,129.67,132.55,129.62,131.94,4080155,7045113.8,57.939252217510486,52.57497841114292,NaN,NaN,87.66294459436592,137.3160324358215,1.0965745253707921,1.8976843882930297,0.8011098629222375,1173497817,1172171921.6,63.39965360255018,47.44098384405907,NaN,NaN,10.664449254477557,1.5741859863129737
2022-11-18T09:30:00-05:00,133.43,133.47,130.98,132.09,5956171,6914774.7,58.13981654624788,52.82104960813658,NaN,NaN,93.11687122438624,120.45994510367225,0.968412226815833,2.0116251464420287,1.0432129196261957,1179453988,1172988543.8,64.15724242612396,48.3162096400784,NaN,NaN,11.529608983579429,2.996389271636753
2022-11-21T09:30:00-05:00,131.34,131.88,130.41,130.67,4181923,6789241.3,55.444457579503556,53.013485935199625,NaN,NaN,64.93061415062716,102.49322705644617,0.7371849561654049,1.9646941148329518,1.2275091586675468,1175272065,1174421437.4,65.50640494662105,49.60525854270629,NaN,NaN,11.518664296063218,4.213857132269105
2022-11-22T09:30:00-05:00,131.24,133.27,130.3,133.2,4509597,6758096.4,59.084047713616805,53.97639623673645,NaN,NaN,80.02403954861914,86.96307506829213,0.7038794517657587,2.1073584733747452,1.4034790216089865,1179781662,1175484638.8,66.51360902817083,51.27443930240891,NaN,NaN,12.537808193185807,5.402992998114348
2022-11-23T09:30:00-05:00,132.91,134.78,132.82,134.38,4740303,6615877.05,60.69664718599777,55.403305586169424,NaN,NaN,98.74605047242888,84.89610399808547,0.7086152758410784,2.2892481164103344,1.580632840569256,1184521965,1178505499.4,69.26011810991253,53.44308593107238,NaN,NaN,13.849809356355403,6.609681049291641
2022-11-25T09:30:00-05:00,133.47,134.01,133.21,133.6,1631466,6405079.3,59.04019497217605,56.43668868258885,NaN,NaN,83.54986222323713,84.07348752385971,0.6102487092635063,2.343443727148639,1.7331950178851325,1182890499,1180384035.8,70.86065641835147,55.97517393154458,NaN,NaN,14.503537565487138,7.737374837319569
2022-11-28T09:30:00-05:00,132.09,132.94,130.21,130.74,6520125,6357699.45,53.29676688010311,56.81764692489394,NaN,NaN,42.30043569931273,73.910200418845,0.3182844786232104,2.1310506161641456,1.8127661375409352,1176370374,1179767313,69.57979513732674,58.50767067230616,NaN,NaN,13.457108843611158,8.554479695361225
2022-11-29T09:30:00-05:00,130.57,130.96,128.93,129.46,5785113,6314648.45,50.90976312997101,56.89037089207597,NaN,NaN,16.633375668736523,64.25075272246687,0.020388704299374005,1.8382520179151527,1.8178633136157787,1170585261,1178829952.2,67.58030824538193,60.81473817713404,NaN,NaN,11.891510681057522,9.031198407603553
2022-11-30T09:30:00-05:00,129.4,135.98,129.27,135.96,11667227,6662677.8,60.56784387514829,58.003904214849754,NaN,NaN,73.83166388201445,63.012277589145924,0.2308462965674003,2.106421184325029,1.8755748877576288,1182252488,1179324117.4,68.10074270087964,63.00000483291155,NaN,NaN,13.43076157381782,9.659707431348448
2022-12-01T09:30:00-05:00,136.09,136.8,134.47,136.15,7582905,6589442.05,60.81055503444018,58.167720458667645,NaN,NaN,101.29314240808733,63.52169597627763,0.3456817917277992,2.307677127417378,1.9619953356895787,1189835393,1180386803,69.24415318497704,64.64619490519891,NaN,NaN,14.723460197707075,10.383100683685395
2022-12-02T09:30:00-05:00,133.87,135.81,133.35,135.36,4467191,6412534.15,59.17949974366127,58.048061099156236,NaN,NaN,84.72194685167462,63.75611290196512,0.3312341532471468,2.376038027248512,2.0448038740013654,1185368202,1180882343.6,69.78797984495667,65.84537406997633,NaN,NaN,15.313127431383943,11.087390219070903
2022-12-05T09:30:00-05:00,134.32,135.075,132.23,133.11,5763284,6253291.15,54.68101364403816,57.737307901491555,NaN,NaN,57.111167115328726,66.71825918516831,0.14258298150270576,2.2230326008797476,2.080449619377042,1179604918,1181529252.4,70.52079933015233,66.8641702908473,NaN,NaN,14.497682131388492,11.574574777973416
2022-12-06T09:30:00-05:00,132.97,133.17,129.42,130.26,5899848,6287592.85,49.5437592201096,56.9328366994963,NaN,NaN,-16.037732764692517,60.18403749848252,-0.18398175760107183,1.8504724223757023,2.034454179976774,1173705070,1182153214.2,71.24527871445487,67.71770288790755,NaN,NaN,12.217276749968862,11.666389345401337
2022-12-07T09:30:00-05:00,129.79,130.6,128.67,129.6,5206945,6229891.45,48.409508789190205,56.26736618083675,NaN,NaN,-74.79833505664882,30.458037710749863,-0.43968897024752573,1.484842967167367,1.9245319374148928,1168498125,1179402341.6,63.80081045537671,67.82553943894547,NaN,NaN,10.015505232680885,11.430548757869843
2022-12-08T09:30:00-05:00,130.32,132.1,129.54,131.72,4482893,6154972.4,52.19538516781995,55.85708996300172,NaN,NaN,-54.53445471255283,-0.7074817133781721,-0.4591642179096045,1.3505766650278872,1.8097408829374917,1172981018,1176031466.6,56.069374574048794,67.30194807976679,NaN,NaN,9.210328228081048,11.113374396471444
2022-12-09T09:30:00-05:00,131.13,132.75,130.42,130.91,5201474,5716743.2,50.66555434830437,55.32321409172005,NaN,NaN,-50.71040791197675,-27.793952666108446,-0.5154921486831667,1.1653756970835332,1.6808678457667,1167779544,1172513735,49.348678915180336,66.24419354327081,NaN,NaN,8.10314189546476,10.683341182041918
2022-12-12T09:30:00-05:00,131.12,133.77,131.08,133.77,7403098,5687452.45,55.6125055639603,55.335217519181235,NaN,NaN,25.507576723299135,-34.11467074451437,-0.3565800869762381,1.2351427370464023,1.5917228240226404,1175182642,1171629279.8,47.79739749542579,64.97926443961401,NaN,NaN,8.572819568774078,10.381838094432226
2022-12-13T09:30:00-05:00,138.64,139.3325,133.98,135.35,9303753,5789476.1,58.111459989807045,55.26574696748054,NaN,NaN,159.54019855062182,1.0009155185485128,-0.15196409227817265,1.4017677086749245,1.5537318009530972,1184486395,1173785544.8,51.77734340130847,63.926674037695264,NaN,NaN,9.706510153854486,10.285362674349692
2022-12-14T09:30:00-05:00,135.22,136.8,132.64,134.21,9770478,5960097.1,55.67590769530669,54.90712271814546,NaN,NaN,82.80923823252381,32.52243017638303,-0.10266575504617381,1.4253996071453798,1.5280653621915536,1174715917,1175029103.2,53.9575237581518,62.83363158399808,NaN,NaN,9.959464084804132,10.238805732986041
2022-12-15T09:30:00-05:00,132.01,132.5,128.7,129.19,9613088,6188351.85,46.44475566057987,54.00744848160288,NaN,NaN,-95.90359056576533,24.248603005740538,-0.40068035639977695,1.0272149166918325,1.4278952730916095,1165102829,1173453465.4,50.822286718023506,61.402319462546075,NaN,NaN,7.254561038663156,9.812485062368486
2022-12-16T09:30:00-05:00,128.75,129.51,126.83,127.48,11999622,6584325.2,43.78182686787754,53.327809909301045,NaN,NaN,-162.1720489109103,1.9562748059538309,-0.6886118624223756,0.5671304450636399,1.2557423074860155,1153103207,1170518198,45.516353321687866,59.683502190000446,NaN,NaN,4.170726853995924,9.006519604029549
2022-12-19T09:30:00-05:00,127.13,127.33,124.59,125.42,7138284,6643430.85,40.75063748306673,52.602158077379315,NaN,NaN,-196.17534684675908,-42.38030990805781,-0.9758963309134163,0.03587189384424505,1.0117682247576614,1145964923,1164674654.2,37.1916877593329,57.51288644099695,NaN,NaN,0.6185338671830523,7.808235927337193
2022-12-20T09:30:00-05:00,124.76,126.25,124.155,125.61,6311037,6749886.55,41.155304285322806,51.21554810667749,NaN,NaN,-177.52757007454304,-109.7938636330908,-1.101901313530074,-0.365608417154931,0.736292896375143,1152275960,1158232567.2,30.556692156648566,54.831168544980436,NaN,NaN,-2.110019459634688,6.391342300626924
2022-12-21T09:30:00-05:00,126.19,128.285,125.88,127.69,7335276,6891170.5,45.54043441473865,50.12482520527025,NaN,NaN,-108.82342304705,-148.12039588900555,-0.9970872089007538,-0.5100661147507992,0.48702109414995454,1159611236,1155211631,28.031252974816837,51.887389958540425,NaN,NaN,-3.1720624845361636,5.025141617032197
2022-12-22T09:30:00-05:00,126.09,126.225,122.355,124.47,7662453,7037278,40.50784475250686,48.791135563044925,NaN,NaN,-159.27164456015313,-160.79400668788313,-1.089055755450774,-0.8742986001635131,0.21475715528726103,1151948783,1152580821.8,26.014819605102602,48.7607356556937,NaN,NaN,-5.67416507974322,3.4966692317785664
2022-12-23T09:30:00-05:00,123.58,124.72,122.6676,124.6,4115796,7161494.5,40.79232004961499,47.799086020586124,NaN,NaN,-142.76630531145855,-156.91285796799275,-1.0832713601163748,-1.1393320448582074,-0.05606068474183262,1156064579,1153173096.2,27.283041835393007,45.672324406068036,NaN,NaN,-7.597755252395346,1.9117514483251505
2022-12-27T09:30:00-05:00,124.17,124.39,122.69,123.42,4765105,7073743.5,38.970745662553625,47.04387076647498,NaN,NaN,-131.59575331700893,-143.99693926204273,-1.0976526872078955,-1.4281265437517021,-0.33047385654380657,1151299474,1154240006.4,29.623327865882473,42.69932791688431,NaN,NaN,-9.746156547009853,0.24633602042015013
2022-12-28T09:30:00-05:00,123.12,124.27,121.29,121.43,5181482,7043561.95,36.04728772126735,46.16085497590907,NaN,NaN,-131.39581834497326,-134.7705889161288,-1.1731101406966882,-1.7968615324146668,-0.6237513917179787,1146117992,1153008412.8,28.483723163728314,40.17667882462371,NaN,NaN,-12.470524488693217,-1.5703583380246164
2022-12-29T09:30:00-05:00,122.62,125.03,122.605,124.61,5477143,6734057.75,43.35942766573016,45.52971515433122,NaN,NaN,-89.05426607977365,-130.8167575226735,-0.9502822453269422,-1.8116041983766564,-0.8613219530497143,1151595135,1151405192.6,27.02619890408215,38.10216627676895,NaN,NaN,-12.685419107675736,-3.1582241622604905
2022-12-30T09:30:00-05:00,123.32,124.51,122.55,124.44,4452935,6577559.25,43.07587993933875,44.987595553690824,NaN,NaN,-84.22461996159348,-115.80735260296157,-0.7637991668508191,-1.816070911613238,-1.052271744762419,1147142200,1150443876,26.161741429416097,36.4459564563572,NaN,NaN,-12.940196026882317,-4.5556487143493225
2023-01-03T09:30:00-05:00,125.77,126.6,122.38,123.26,7598070,6734103.2,41.06832522625544,43.94872552956905,NaN,NaN,-73.09969852387422,-101.87403124544471,-0.6725870542638084,-1.8930055625921796,-1.2204185083283712,1139544130,1147139786.2,23.392245893257325,34.702731341916596,NaN,NaN,-13.725862932185187,-5.865679316897303
2023-01-04T09:30:00-05:00,123.9,124.37,122.22,123.58,5906502,6741264.1,41.859665758784644,42.787883084496016,NaN,NaN,-78.55702885190382,-91.26628635242369,-0.5486109693799057,-1.9061822200532532,-1.3575712506733475,1145450632,1145970017.8,22.48472963012111,32.61040178683179,NaN,NaN,-14.15955284993159,-7.050518393045058
2023-01-05T09:30:00-05:00,122.96,123.28,120.97,121.18,5670515,6729797.45,37.76388041230498,41.508452564281605,NaN,NaN,-98.11161204584022,-84.60944509259707,-0.582931742846561,-2.086235929231549,-1.5033041863849879,1139780117,1144702442.8,21.5108644827271,30.292783267158594,NaN,NaN,-15.715250289673552,-8.288337235420556
2023-01-06T09:30:00-05:00,122.25,125.29,120.81,124.73,6912740,6815087.2,46.15614842275558,41.487837761579875,NaN,NaN,-59.79174855694805,-78.75694158803196,-0.33362704967806245,-1.920337998482566,-1.5867109488045035,1146692857,1143721987.2,20.761806823022937,28.14560613180141,NaN,NaN,-14.567240280035476,-9.185323384651259
2023-01-09T09:30:00-05:00,125.85,128.475,125.81,126.18,10713633,7126624.2,49.17104456114488,41.87278188252754,NaN,NaN,3.1034444069792406,-61.29132871431742,-0.052877063218458975,-1.652807277827577,-1.599930214609118,1157406490,1145774845.2,26.530533133772835,26.789476118378918,NaN,NaN,-12.68253543416912,-9.684925106010953
2023-01-10T09:30:00-05:00,125.87,127.1599,125.2,126.96,8604527,7296776.85,50.76800784257081,42.588308336777835,NaN,NaN,0.47367271012523954,-46.57665446751752,0.19022752843703872,-1.3621458040628198,-1.5523733324998585,1166011017,1151068222.6,38.88565811728897,26.910474001090062,NaN,NaN,-10.653501431207866,-9.823293152467654
2023-01-11T09:30:00-05:00,127.36,129.16,126.97,129.16,6878986,7270571.25,55.05702987656017,43.581288736151926,NaN,NaN,52.7222041303048,-20.320807871075793,0.48718028714065764,-0.9433979735740365,-1.4305782607146942,1172890003,1156556096.8,48.546428351861806,28.19545515789101,NaN,NaN,-7.5793137819607015,-9.50272467096666
2023-01-12T09:30:00-05:00,129.36,130.71,127.78,130.12,7679335,7189350.35,56.82461493892803,44.38730163073688,NaN,NaN,101.07250231134717,19.516015000361683,0.7220729938805315,-0.5279870183640298,-1.2500600122445613,1180569338,1164713941,58.93768338872481,30.40305733031301,NaN,NaN,-4.491781936433628,-8.786875708890513
2023-01-13T09:30:00-05:00,128.89,130.6798,128.59,130.49,5076582,6954655.55,57.518100863174055,45.60231992435597,NaN,NaN,132.32723205521597,57.93981112279448,0.8664560264576047,-0.16698997917255554,-1.0334460056301602,1185645920,1172504553.6,65.99953004286536,33.259108075867495,NaN,NaN,-1.749102737050478,-7.781479570056222
2023-01-17T09:30:00-05:00,130.31,131.85,130.15,131.08,5212859,6734644.1,58.658412487330374,46.878469384192776,NaN,NaN,161.40052253419515,89.59922674823767,0.9586056090734184,0.16481100571161278,-0.7937946033618056,1190858779,1179195011.4,70.6653192277022,36.35784217531815,NaN,NaN,0.8766332246086097,-6.544606313675532
2023-01-18T09:30:00-05:00,131.82,132.52,129.31,129.39,6967961,6483061.05,54.17281396895303,47.96433140607845,NaN,NaN,130.84404611457438,115.67330142912749,0.8654965141995963,0.2880760393876898,-0.5774204748119065,1183890818,1182770971.6,72.81278585918396,39.442803460553975,NaN,NaN,1.955289290755741,-5.330335513042493
2023-01-19T09:30:00-05:00,128.38,129.1,127.41,127.88,7322513,6492272.5,50.45992771555674,48.99380569138484,NaN,NaN,59.63129130721068,117.05511886450867,0.6706663398003949,0.2609124499385871,-0.4097538898618078,1176568305,1183506632,73.24668820162276,42.64015810611787,NaN,NaN,1.8473876353113927,-4.304946491849081
2023-01-20T09:30:00-05:00,128.52,131.435,128.06,131.34,7063936,6529917.45,57.626456755247894,50.01287919777896,NaN,NaN,102.96449696369969,117.43351779497917,0.7379378880266274,0.5126684701714765,-0.2252694178551509,1183632241,1184119212.6,73.62417681224413,45.96858509955801,NaN,NaN,3.9453960410405204,-3.126326130007709
2023-01-23T09:30:00-05:00,131.87,135.1,131.57,134.33,11736438,6749975.55,62.654206916859096,51.4113311247447,NaN,NaN,160.3046388209439,123.02899914812474,0.9342870208107161,0.9425893581582443,0.008302337347528138,1195368679,1186063764.4,74.83788533069098,49.44545252107764,NaN,NaN,7.428353368531735,-1.618514773073503
2023-01-24T09:30:00-05:00,133.57,134.78,133.37,134.27,6287839,6681244.85,62.49396293847036,52.94173381847433,NaN,NaN,145.7367593852798,119.89624651834167,1.0044732332040796,1.2638938788526275,0.25942064564854805,1189080840,1185708176.6,74.16580051300508,53.07213499391677,NaN,NaN,10.13511407366666,0.060575062175091565
2023-01-25T09:30:00-05:00,132,134.33,130.77,133.99,7171147,6834012.4,61.7008877579438,54.358963961271414,NaN,NaN,108.86967575366681,115.50137244616016,0.9755744103251902,1.4788886585550358,0.5033142482298456,1181909693,1185311951.6,73.37506583251769,56.707159008373665,NaN,NaN,12.114607651575476,1.7825797178037177
2023-01-26T09:30:00-05:00,135.3,136.19,133.9,136.13,5580870,6874800.65,65.3229723085222,56.32747052528693,NaN,NaN,137.702856233851,131.11568543148823,1.0383011460013303,1.8011906807315086,0.7628895347301783,1187490563,1187496403.2,74.96012160962475,60.52496308886635,NaN,NaN,14.944773877366957,3.6628931691698945
2023-01-27T09:30:00-05:00,135.27,137.66,135.21,136.7,6774660,6954459.55,66.23884054089046,57.76194853372514,NaN,NaN,141.78030773232072,138.87884758521244,1.0526085370303573,2.078650206018125,1.0260416689877676,1194265223,1189622999.6,76.4311521541596,64.50134489823326,NaN,NaN,17.55269425558992,5.647150467229898
2023-01-30T09:30:00-05:00,135.13,135.72,133.975,134.09,4852957,6923250.25,58.60604110787396,58.435876858491504,NaN,NaN,96.92321588071165,126.20256299716598,0.8304783250767103,2.0641395753336553,1.233661250256945,1189412266,1188431717,73.81508430886427,67.87881283931122,NaN,NaN,17.60799341626761,7.355842317092428
2023-01-31T09:30:00-05:00,134.09,136.02,134,135.96,4435803,6922393.65,61.98592183484288,59.237156429368085,NaN,NaN,101.23628946436003,117.30246901298202,0.7558083427062445,2.178421678639751,1.4226133359335063,1193848069,1189385162.8,74.56544258375305,70.42736887263008,NaN,NaN,18.68072280516906,8.97368238681766
2023-02-01T09:30:00-05:00,135.86,140.27,135.21,139.16,9426375,7013808.9,66.95785914412335,60.087215662765445,NaN,NaN,137.9270856456441,123.1139509913775,0.8606327521014454,2.498404276060313,1.6377715239588677,1203274444,1193658113,77.65573811484566,72.50660528427179,NaN,NaN,21.24577600661352,10.72683861821707
2023-02-02T09:30:00-05:00,141.54,143.76,140.89,142.96,9412026,7189085.1,71.69263035592378,61.149216763979425,NaN,NaN,184.04041963546157,132.38146367169958,1.1087947422769677,3.0237649518050773,1.9149702095281096,1212686470,1198697294.4,80.64274631623232,74.05696692195089,NaN,NaN,25.15543036053693,12.78806600997705
2023-02-03T09:30:00-05:00,140.5,144.09,140.29,141.77,8072663,7309192.5,68.38773953242716,61.925619526068935,NaN,NaN,157.34574878786967,135.4945518828094,1.1128115796280422,3.305984684063162,2.19317310443512,1204613807,1200767011.2,81.72343497549623,75.18010298856737,NaN,NaN,27.19288157297406,14.845896804690907
2023-02-06T09:30:00-05:00,140.2,141.3,139.51,140.04,6488729,7287991.95,63.78432196278961,62.29175591717317,NaN,NaN,117.63379294079098,139.63666729482526,0.9265945346647628,3.3514162727660732,2.4248217381013104,1198125078,1202509573.6,82.60401334933334,76.03286685439818,NaN,NaN,27.374513709549532,16.635699219670713
2023-02-07T09:30:00-05:00,140.25,144.08,140.19,143.54,7854072,7145013.9,68.41634893429134,63.30915127184018,NaN,NaN,139.84756934662386,147.35892327127803,0.9625588683067043,3.628020323484691,2.6654614551779865,1205979150,1204935789.8,83.77608697055261,76.81595979092451,NaN,NaN,29.093287817183644,18.41535473360113
2023-02-08T09:30:00-05:00,143.82,144.59,141.52,141.81,6288539,7029214.5,64.05528767587606,64.28024841186298,NaN,NaN,124.79626479219199,144.7327591005876,0.7999366277591689,3.665382239876948,2.865445612117779,1199690611,1204219023.2,82.01796991688799,77.44247991344345,NaN,NaN,29.040796660736007,19.93327500890611
2023-02-09T09:30:00-05:00,144,144.24,140.47,141.03,6312014,7000865.9,62.1322724888102,64.60209239283174,NaN,NaN,100.33592828887696,127.99186083127067,0.580172659582515,3.590661436595923,3.010488777013408,1193378597,1200357448.6,73.11553641148086,77.40614845624607,NaN,NaN,28.38702509203478,21.140953592210206
2023-02-10T09:30:00-05:00,139.98,140.86,139.05,140.38,4930785,6863438.4,60.50221675922321,64.44837881014345,NaN,NaN,63.40966548465164,109.20464417062706,0.34308771934996596,3.4393484262008656,3.0962607068508996,1188447812,1197124249.6,66.59758807478268,76.81755579510977,NaN,NaN,27.361185265919534,22.029558117025825
2023-02-13T09:30:00-05:00,140.93,143.121,140.84,142.81,4205914,6819905,64.27557518266079,64.57563682758563,NaN,NaN,87.7574817767388,103.22938193781661,0.3033511519735379,3.4754496468178218,3.172098494844284,1192653726,1196029979.2,64.50178779184594,76.12726917216982,NaN,NaN,27.624999194942955,22.828906842442557
2023-02-14T09:30:00-05:00,142.14,144.23,141.25,143.42,6310973,6874810.7,65.17497949060393,64.82378623706134,NaN,NaN,89.04248836437576,93.06836574136699,0.2725522311683286,3.5127887838046945,3.240236552636366,1198964699,1194627089,61.815974451571904,75.30161978781655,NaN,NaN,28.105580093782223,23.58271730691965
2023-02-15T09:30:00-05:00,142.55,144.1,142.21,144.09,5246227,6788724,66.18206524160337,64.88515001799571,NaN,NaN,88.87726027270807,85.88456483747021,0.2521776425669673,3.5554586058450752,3.303280963278108,1204210926,1195531152,62.88841511741423,74.43935503837295,NaN,NaN,28.79172722964018,24.326861581594013
2023-02-16T09:30:00-05:00,142,143.61,141.48,141.59,6500646,6747630.65,59.292032328504206,64.3889494313967,NaN,NaN,62.97206321656003,78.41179182300684,0.03652813488028306,3.348941131878462,3.312412996998179,1197710280,1196397488.6,63.93377282523019,73.54668508630655,NaN,NaN,27.334912159575737,24.75658309273426
2023-02-17T09:30:00-05:00,140.58,140.74,138.6,139.82,5303339,6659600.8,54.93167794678493,64.12649491989035,NaN,NaN,10.991980706195765,67.92825486731564,-0.24370756586972853,3.007778539661018,3.2514861055307467,1192406941,1197189314.4,64.90675878825746,72.91037612054893,NaN,NaN,24.76081419007126,24.757187535210974
2023-02-21T09:30:00-05:00,137.95,138.78,136.375,136.5,6138857,6379721.75,47.826947367354094,63.115139600784005,NaN,NaN,-46.93175196393483,40.99040811918096,-0.6480961427663274,2.4413659270728374,3.089462069839165,1186268084,1195912186,62.001418002652365,72.01294579332745,NaN,NaN,20.153777002343745,24.099557459087084
2023-02-22T09:30:00-05:00,136.78,137.4,135.65,136.3,7169194,6423789.5,47.42898212056307,61.72021981338684,NaN,NaN,-69.4569405298562,9.29052234033457,-0.9085143664524651,1.9538191117735835,2.8623334782260486,1179098890,1191939024.2,53.91585886066691,70.31724013231468,NaN,NaN,16.367120629506324,22.994923626289832
2023-02-23T09:30:00-05:00,138.84,139.08,136.61,138.56,6560208,6393242.55,52.2628229526521,60.33237642743887,NaN,NaN,-42.15547068755948,-16.916023851718933,-0.9059810673030144,1.7298571440972808,2.635838211400295,1185659098,1188228658.6,47.664574008355295,67.96165639603774,NaN,NaN,14.538056451491657,21.78679974417581
2023-02-24T09:30:00-05:00,136.1,136.68,135.3,136.09,7173792,6472888.65,47.159125721220974,58.81604686949556,NaN,NaN,-96.98324950406743,-48.90708639584444,-1.0385602833293297,1.337637857238633,2.3761981405679626,1178485306,1184383663.8,42.203645813616575,65.13881431304634,NaN,NaN,11.335476110158336,20.293753510744743
2023-02-27T09:30:00-05:00,137.46,138.16,136.57,136.82,4694488,6368880.05,48.75199306529633,57.74230909110319,NaN,NaN,-68.70104900513539,-64.84569233811067,-1.0422917715411115,1.0733334261415735,2.115625197682685,1183179794,1182538234.4,39.84413734546016,62.08453745562683,NaN,NaN,9.208176713897648,18.710099682623728
2023-02-28T09:30:00-05:00,136.38,137.84,136.14,136.52,5243149,6388389.65,48.110149198205384,56.29186625281134,NaN,NaN,-84.99517544588133,-72.45837703449997,-1.028424989326944,0.830093961024005,1.858518950350949,1177936645,1180871946.6,37.789747662343444,58.79979893361189,NaN,NaN,7.292842799520452,17.079062985037545
2023-03-01T09:30:00-05:00,136.58,136.8,135.1,135.52,7534677,6543333.35,45.93903667065478,54.997848323866954,NaN,NaN,-115.33561284810948,-81.63411149815063,-1.0465832478750434,0.5502898905071447,1.5968731383821881,1170401968,1179132562.2,35.71935714181234,55.49275516396363,NaN,NaN,5.0504097967507064,15.360683958139425
2023-03-02T09:30:00-05:00,135.15,137.62,134.92,137.19,5485632,6346296.2,49.99730013749161,54.13106458448705,NaN,NaN,-88.16935548015316,-90.83688845666936,-0.9110837583095377,0.4580184404952661,1.3691021988048038,1175887600,1177178262.6,33.49867613332785,52.662979429809845,NaN,NaN,4.257828774147456,13.774561788997715
2023-03-03T09:30:00-05:00,138.07,140.145,137.94,140.14,7219834,6236686.6,56.24568253139701,53.82702642535661,NaN,NaN,-7.956520093377787,-73.03154257453143,-0.6026145223518884,0.6158340458649434,1.2184485682168318,1183107434,1178102688.2,35.540120448511814,50.44458888507621,NaN,NaN,5.455388289487413,12.586108431924815
2023-03-06T09:30:00-05:00,141.04,142.72,140.695,140.81,7999615,6233034.2,57.54333237748707,53.34615193927277,NaN,NaN,49.985338192672984,-49.29426513496976,-0.34603246051809977,0.7859079925692072,1.131940453087307,1191107049,1179688139.2,38.9988063533233,48.62294735375316,NaN,NaN,6.825224688834315,11.763125040054744
2023-03-07T09:30:00-05:00,140.7,141.24,138.71,139.06,7060055,6261600.5,53.11253805453466,52.48454897955354,NaN,NaN,1.2255185330754081,-32.05012633917842,-0.2890727983326744,0.7705994551714639,1.0596722535041383,1184046994,1180910209,41.5999407555559,47.17894494689488,NaN,NaN,6.694341190975798,11.039013061614895
2023-03-08T09:30:00-05:00,139.55,140.38,138.73,140.21,6623474,6200070.6,55.535488766902986,51.72407923136065,NaN,NaN,8.787293351503338,-7.225545099255842,-0.17448842807938747,0.841561718404904,1.0160501464842915,1190670468,1184963909,49.31970242287284,46.209751182999064,NaN,NaN,7.300347960511981,10.504918047171621
2023-03-09T09:30:00-05:00,140.43,142.01,137.93,138.2,7812295,6276258.4,50.612503093710444,51.10411285744681,NaN,NaN,1.8585842748721408,10.78004285174922,-0.23105883245649628,0.7272266059136712,0.9582854383701674,1182858173,1186358023.6,51.68509530644413,45.33484564594293,NaN,NaN,6.350880760046874,9.911484149010944
2023-03-10T09:30:00-05:00,138,138.345,135.23,135.77,15278402,6724577.8,45.37559225759385,50.42153530821888,NaN,NaN,-83.28057970040321,-4.2847690696558685,-0.418217008663179,0.4355141775411937,0.8537311862043727,1167579771,1183252491,46.48082055400927,44.01870720063948,NaN,NaN,3.8827606664017558,9.050237937209632
2023-03-13T09:30:00-04:00,134.92,138.4,134.08,136.51,17219746,7339025.85,47.16835024165683,50.374492656383346,NaN,NaN,-77.91020048062119,-29.863876804314703,-0.474158734024799,0.261032768673374,0.735191502698173,1184799517,1181990984.6,44.51978268734405,42.77001896383175,NaN,NaN,2.399548536814048,8.100139451438833
2023-03-14T09:30:00-04:00,138.27,140.15,137.7,139.66,10601051,7658782.7,54.077491123094454,50.849386156564165,NaN,NaN,15.33703366194234,-27.041573778541316,-0.29004269893116663,0.37263812903421467,0.6626808279653813,1195400568,1184261699.4,48.71415988181146,42.39846903677064,NaN,NaN,3.2651034874419045,7.4094200280107
2023-03-15T09:30:00-04:00,138.13,139.9099,137.455,139.74,11530017,7919734.9,54.24116108769832,50.99069602335318,NaN,NaN,19.258522020401863,-24.947328044761612,-0.16037393901252117,0.4622134041997299,0.6225873432122511,1206930585,1187513722.8,54.0697120343523,42.85597889577043,NaN,NaN,4.000740013096941,6.922465740165878
2023-03-16T09:30:00-04:00,139.25,143.86,138.79,143.66,13045319,8309689.5,61.48479311311887,52.01395797991732,NaN,NaN,139.6965161267327,2.6202583256105014,0.17379622669020145,0.8398326265750029,0.6660363998848015,1219975904,1194937269,63.45207002932274,44.37372348260658,NaN,NaN,7.059182339510213,6.9419966829293545
2023-03-17T09:30:00-04:00,143.94,145.18,142.62,143.46,11539931,8561653.75,60.95462130123174,52.885574282484136,NaN,NaN,191.38393252952866,57.55316077159688,0.35530126772687354,1.1101629845433933,0.7548617168165198,1208435973,1203108509.4,70.57674164832503,46.56890950423974,NaN,NaN,9.314634513713582,7.280944944469958
2023-03-20T09:30:00-04:00,142.89,143.71,141.82,143.53,5991508,8596062.2,61.081113009256185,53.8120716975592,NaN,NaN,145.38385822096458,102.21197251191403,0.4480249378353627,1.3148928891107232,0.8668679512753605,1214427481,1209034102.2,74.4643109881971,49.18852117037214,NaN,NaN,11.16433898832511,7.835715522163551
2023-03-21T09:30:00-04:00,144.31,144.95,142.805,144.69,6533200,8615779.35,63.20821312368653,55.045584301347176,NaN,NaN,158.42593845805396,130.82975347113637,0.5487815507231568,1.5528448896793066,1.0040633389561497,1220960681,1214146124.8,77.25618801045592,52.15543766098954,NaN,NaN,13.359739208790087,8.624861763110198
2023-03-22T09:30:00-04:00,144.69,147.57,143.17,143.25,7112585,8612948.9,58.90429807476523,55.68179843972386,NaN,NaN,151.2910370379363,157.23625647464323,0.4821145182939468,1.6067064868235832,1.1245919685296364,1213848096,1215529627,77.95854943099621,55.33114289653728,NaN,NaN,14.023018948623832,9.396027075326431
2023-03-23T09:30:00-04:00,145.08,147.55,144.21,145.58,8797909,8724833.95,63.26313285381525,56.18304489132517,NaN,NaN,152.10898060102662,159.71874936950204,0.5534981406006916,1.8164646442805008,1.2629665036798092,1222646005,1216063647.2,78.23790707966245,58.38098479876232,NaN,NaN,15.930430092720925,10.329513220668503
2023-03-24T09:30:00-04:00,145.12,146.03,144.16,145.96,5937705,8663029.6,63.93498313510638,56.63959137401226,NaN,NaN,121.57130224707625,145.75622331301153,0.5819612127051275,1.9904180195612184,1.408456806856091,1228583710,1220093194.6,80.26994563197788,61.32892331866622,NaN,NaN,17.685235902928245,11.380330746705608
2023-03-27T09:30:00-04:00,146.18,146.68,144.49,144.83,5405293,8698569.85,60.39769620679222,57.15995981345923,NaN,NaN,105.45885856654418,137.77122338212746,0.4843393544922061,2.0138809999713487,1.5295416454791426,1223178417,1221843381.8,81.09561605913447,64.15004298320754,NaN,NaN,18.172830985485337,12.35068792367414
2023-03-28T09:30:00-04:00,144.58,144.63,142.845,144.15,4984008,8685612.8,58.307108502541055,57.35793265171909,NaN,NaN,65.01161702765603,119.08835909604787,0.340421445104641,1.955068451859944,1.614647006755303,1218194409,1221290127.4,79.95652765751709,66.33838764282498,NaN,NaN,17.995766711841227,13.157127750555153
2023-03-29T09:30:00-04:00,145.96,147.5,145.75,147.17,7128293,8665293.6,64.22901599816144,58.33054071632273,NaN,NaN,120.30825415707632,112.89180251987587,0.41037994915933695,2.127621943204474,1.717241994045137,1225322702,1223585048.6,81.1399261870869,68.44230413429946,NaN,NaN,19.62667717063961,14.081349096281505
2023-03-30T09:30:00-04:00,148.53,149.09,147.88,148.88,5601209,8671072.45,67.08023260768223,59.88087216990048,NaN,NaN,145.74520019026951,111.61904643772445,0.5261882267848494,2.374977277526199,1.8487890507413494,1230923911,1225240629.8,81.967089534658,70.97703763291723,NaN,NaN,21.90598120831543,15.199153683714922
2023-03-31T09:30:00-04:00,148.7,151.145,148.51,151.01,7534883,8686824.9,70.26008674596008,61.530281920207855,NaN,NaN,158.74088712792405,119.05296341389403,0.690267522347241,2.7116234536754007,2.0213559313281597,1238458794,1227215646.6,82.92895219153115,73.72054974035916,NaN,NaN,24.89142033077943,16.583763204724136
2023-04-03T09:30:00-04:00,150.09,150.98,149.37,150.77,10571060,8815397.15,69.44610501883854,62.62804005561814,NaN,NaN,141.52281895371937,126.26575549132906,0.7231797264278268,2.925330589362943,2.2021508629351163,1227887734,1228157510,83.38412087289171,76.19697552543633,NaN,NaN,27.044264347605218,18.078120510850006
2023-04-04T09:30:00-04:00,150.99,151.51,149.38,149.94,7912365,8858012.65,66.57360789960629,63.508929113611565,NaN,NaN,126.47584607131726,138.5586013000613,0.6328529320405414,2.993217027985793,2.3603640959452514,1219975369,1228513702,83.5626157778153,78.30361150711225,NaN,NaN,28.0105079547244,19.49703300283206
2023-04-05T09:30:00-04:00,149.23,149.37,147.16,148.23,7868780,8920277.95,60.97752424540276,63.47269562306042,NaN,NaN,79.96200682039462,130.48935183272496,0.41241545676484126,2.875883416901303,2.4634679601364615,1212106589,1225870479.4,76.95599724562797,79.26817773684834,NaN,NaN,27.188579144978153,20.59582530885293
2023-04-06T09:30:00-04:00,147.15,149.26,146.51,149.07,7848007,8922063.55,62.63890640730098,63.59300170206536,NaN,NaN,73.4515973751762,116.0306312697063,0.28377788856664177,2.8181903208447636,2.534412432278122,1219954596,1223676616.4,71.87656723602007,79.36102242168371,NaN,NaN,26.97867413747807,21.50766085579938
2023-04-10T09:30:00-04:00,147.59,149.02,146.78,148.99,4758588,8396072.85,62.36657233271202,63.68482022516935,NaN,NaN,67.16694268396624,97.71584238091475,0.16006307963068211,2.7344912818164744,2.5744282021857923,1215196008,1219024059.2,62.46096505342282,78.50364056919982,NaN,NaN,26.73134803413875,22.253901881276434
2023-04-11T09:30:00-04:00,148.73,148.75,147.34,147.59,6375397,7853855.4,57.64343672666962,63.287336196811,NaN,NaN,52.3417757665332,79.87963374347751,-0.0386850368311511,2.5260719061468535,2.5647569429780046,1208820611,1215210634.6,55.98719046023788,76.98442645846997,NaN,NaN,25.173825749765133,22.671033862489104
2023-04-12T09:30:00-04:00,148.59,148.99,146.505,146.75,6617886,7654697.15,54.95428070362837,63.005192098872655,NaN,NaN,33.53955523585107,61.29237557638428,-0.23821780937088066,2.266984681264404,2.5052024906352846,1202202725,1211656105.8,50.7111964048248,75.03818695660058,NaN,NaN,23.08388396983095,22.730012449252225
2023-04-13T09:30:00-04:00,147.32,149.71,147.08,149.48,6820898,7419241.2,61.27699091319491,62.86332481739977,NaN,NaN,63.83653785138483,58.06728178258231,-0.19941054508695988,2.2559393092765845,2.4553498543635444,1209023623,1211039512.6,49.83390887968218,73.00932994231627,NaN,NaN,23.032960133646554,22.773290689879985
2023-04-14T09:30:00-04:00,148.64,149.8686,147.35,148.65,6501848,7092067.65,58.58462825694912,62.481156611817106,NaN,NaN,54.21546842535976,54.22005599261902,-0.23998709027756382,2.1553659915165895,2.3953530817941533,1202521775,1207552948.4,45.08440686241469,70.49607717306176,NaN,NaN,22.190425891969447,22.69002429017848
2023-04-17T09:30:00-04:00,148.84,149.52,148.03,149.19,4153212,6722731.7,59.82151527776291,62.440000831172156,NaN,NaN,58.703858509434575,52.527439157712685,-0.24021560122505248,2.0950835802628376,2.33529918148789,1206674987,1205848744.2,42.9306379077185,67.77000730510348,NaN,NaN,21.84455032713159,22.569242295457496
2023-04-18T09:30:00-04:00,150.33,150.73,149,149.65,4606530,6653482.8,60.892965761382825,62.624704921089425,NaN,NaN,85.34169658968753,59.12742332234355,-0.2197006802184145,2.060673331214872,2.2803740114332864,1211281517,1206340925.4,43.76616119096515,65.1849811289212,NaN,NaN,21.853440320474178,22.46698487045988
2023-04-19T09:30:00-04:00,148.3,149.5,148.1,149.22,4311606,6542403.1,59.30099231596521,62.27270322950398,NaN,NaN,48.025702225510194,62.02465272027538,-0.2435565824950614,1.9759282833144596,2.219484865809521,1206969911,1207294362.6,45.43279058910465,62.634471443351025,NaN,NaN,21.427474122263863,22.318483335003304
2023-04-20T09:30:00-04:00,147.85,149.71,147.58,148.24,5708126,6472180.15,55.7252746994009,61.46163480748389,NaN,NaN,24.2078907393399,54.09892329786639,-0.328517291764423,1.8088382511039924,2.1373555428684154,1201261785,1205741995,43.188414034738344,59.864566050499626,NaN,NaN,20.071564706462,21.997494959497402
2023-04-21T09:30:00-04:00,147.59,148.025,146.8,147.76,6118874,6338228.4,54.007542278233174,60.30073877407483,NaN,NaN,-30.676377064390856,37.12055419991627,-0.41466594022017134,1.6190231175932013,2.0336890578133726,1195142911,1204266222.2,41.10931049425665,56.87744878640859,NaN,NaN,18.452430800030857,21.491057222430754