time,open,high,low,close,Volume,Volume MA,RSI,RSI-based MA,Upper Bollinger Band,Lower Bollinger Band,CCI,Smoothing Line,Histogram,MACD,Signal,OnBalanceVolume,Smoothing Line,RSI,RSI-based MA,Upper Bollinger Band,Lower Bollinger Band,True Strength Index,Signal
1999-03-10T09:30:00-05:00,51.125,51.15625,50.28125,51.0625,5232202,NaN,NaN,NaN,NaN,NaN,NaN,NaN,NaN,NaN,NaN,NaN,NaN,NaN,NaN,NaN,NaN,NaN,NaN
1999-03-11T09:30:00-05:00,51.4375,51.734375,50.3125,51.3125,9688602,NaN,NaN,NaN,NaN,NaN,NaN,NaN,NaN,NaN,NaN,9688602,NaN,NaN,NaN,NaN,NaN,NaN,NaN
1999-03-12T09:30:00-05:00,51.125,51.15625,49.65625,50.0625,8743602,NaN,NaN,NaN,NaN,NaN,NaN,NaN,NaN,NaN,NaN,945000,NaN,NaN,NaN,NaN,NaN,NaN,NaN
1999-03-15T09:30:00-05:00,50.4375,51.5625,49.90625,51.5,6369000,NaN,NaN,NaN,NaN,NaN,NaN,NaN,NaN,NaN,NaN,7314000,NaN,NaN,NaN,NaN,NaN,NaN,NaN
1999-03-16T09:30:00-05:00,51.71875,52.15625,51.15625,51.9375,4905800,NaN,NaN,NaN,NaN,NaN,NaN,NaN,NaN,NaN,NaN,12219800,NaN,NaN,NaN,NaN,NaN,NaN,NaN
1999-03-17T09:30:00-05:00,51.9375,52,51.40625,51.5625,3965000,NaN,NaN,NaN,NaN,NaN,NaN,NaN,NaN,NaN,NaN,8254800,7684440.4,NaN,NaN,NaN,NaN,NaN,NaN
1999-03-18T09:30:00-05:00,51.5,52.59375,51.484375,52.5625,4848400,NaN,NaN,NaN,NaN,NaN,NaN,NaN,NaN,NaN,NaN,13103200,8367360,NaN,NaN,NaN,NaN,NaN,NaN
1999-03-19T09:30:00-05:00,53.25,53.25,51.1875,51.21875,7160400,NaN,NaN,NaN,NaN,NaN,NaN,NaN,NaN,NaN,NaN,5942800,9366920,NaN,NaN,NaN,NaN,NaN,NaN
1999-03-22T09:30:00-05:00,51.4375,51.5625,50.5,50.59375,5024800,NaN,NaN,NaN,NaN,NaN,NaN,NaN,NaN,NaN,NaN,918000,8087720,NaN,NaN,NaN,NaN,NaN,NaN
1999-03-23T09:30:00-05:00,50.3125,50.5,48.71875,48.8125,10962398,NaN,NaN,NaN,NaN,NaN,NaN,NaN,NaN,NaN,NaN,-10044398,3634880.4,NaN,NaN,NaN,NaN,NaN,NaN
1999-03-24T09:30:00-05:00,49.25,50.5,48.5,50.46875,8447000,NaN,NaN,NaN,NaN,NaN,NaN,NaN,NaN,NaN,NaN,-1597398,1664440.8,NaN,NaN,NaN,NaN,NaN,NaN
1999-03-25T09:30:00-05:00,51.25,52.3125,50.91406,52.3125,8133800,NaN,NaN,NaN,NaN,NaN,NaN,NaN,NaN,NaN,NaN,6536402,351081.2,NaN,NaN,NaN,NaN,NaN,NaN
1999-03-26T09:30:00-05:00,51.875,52.46875,51.53125,51.75,8256204,NaN,NaN,NaN,NaN,NaN,NaN,NaN,NaN,NaN,NaN,-1719802,-1181439.2,NaN,NaN,NaN,NaN,NaN,NaN
1999-03-29T09:30:00-05:00,52.375,53.65625,52.0625,53.625,5113800,NaN,NaN,NaN,NaN,NaN,NaN,NaN,NaN,NaN,NaN,3393998,-686239.6,NaN,NaN,NaN,NaN,NaN,NaN
1999-03-30T09:30:00-05:00,53.5625,54,53.03125,53.25,4940600,NaN,57.383966244725734,NaN,NaN,NaN,NaN,NaN,NaN,NaN,NaN,-1546602,1013319.6,NaN,NaN,NaN,NaN,NaN,NaN
1999-03-31T09:30:00-05:00,54.125,54.1875,52.3125,52.46875,8256602,NaN,54.2997542997543,NaN,NaN,NaN,NaN,NaN,NaN,NaN,NaN,-9803204,-627841.6,NaN,NaN,NaN,NaN,NaN,NaN
1999-04-01T09:30:00-05:00,54,54.0625,52.6875,53.5625,8715796,NaN,57.72542506228418,NaN,NaN,NaN,NaN,NaN,NaN,NaN,NaN,-1087408,-2152603.6,NaN,NaN,NaN,NaN,NaN,NaN
1999-04-05T09:30:00-04:00,54.429685,55.578125,54.09375,55.5,5697200,NaN,63.01436349677461,NaN,NaN,NaN,NaN,NaN,NaN,NaN,NaN,4609792,-886684.8,NaN,NaN,NaN,NaN,NaN,NaN
1999-04-06T09:30:00-04:00,55.4375,56.21875,54.96875,55.609375,7522400,NaN,63.293548893451515,NaN,NaN,NaN,NaN,NaN,NaN,NaN,NaN,12132192,860954,NaN,NaN,NaN,NaN,NaN,NaN
1999-04-07T09:30:00-04:00,56.125,56.25,53.84375,55.03125,11923602,7195360.4,60.68597685471815,NaN,NaN,NaN,141.29240609951157,NaN,NaN,NaN,NaN,208590,1211992.4,34.557138944749525,NaN,NaN,NaN,NaN,NaN
1999-04-08T09:30:00-04:00,54.9375,55.734375,53.8125,55.46875,7952400,7331370.3,61.96307211136767,NaN,NaN,NaN,119.40747475975331,NaN,NaN,NaN,NaN,8160990,4804831.2,44.756893032844225,NaN,NaN,NaN,NaN,NaN
1999-04-09T09:30:00-04:00,55.375,55.9375,55.21875,55.8125,4946800,7094280.2,62.98061867544612,NaN,NaN,NaN,127.81163444237089,NaN,NaN,NaN,NaN,13107790,7643870.8,51.22586673397667,NaN,NaN,NaN,NaN,NaN
1999-04-12T09:30:00-04:00,54.5,55.8125,54.4375,55.4375,10934000,7203800.1,61.06155252365399,NaN,NaN,NaN,98.64599233626328,NaN,NaN,NaN,NaN,2173790,7156670.4,50.14076828434901,NaN,NaN,NaN,NaN,NaN
1999-04-13T09:30:00-04:00,55.78125,55.90625,54.25,54.6875,9962204,7383460.3,57.300933008040886,NaN,NaN,NaN,78.93587742167486,113.21867701191476,NaN,NaN,NaN,-7788414,3172549.2,42.25770025338701,NaN,NaN,NaN,NaN,NaN
1999-04-14T09:30:00-04:00,55.375,55.4375,52.50781,52.8125,21253796,8200860.1,49.15108749332411,NaN,NaN,NaN,19.28362297626962,88.81692038726639,NaN,NaN,NaN,-29042210,-2677610.8,33.843707879034056,NaN,NaN,NaN,NaN,NaN
1999-04-15T09:30:00-04:00,53,53.617185,51.125,53.53125,17650602,8885140.2,51.971103421056405,NaN,NaN,NaN,-18.992646316899492,61.136896171935824,NaN,1.2493751697163162,NaN,-11391608,-6588130.4,29.600906739793032,NaN,NaN,NaN,NaN,NaN
1999-04-16T09:30:00-04:00,53.40625,53.40625,51.6875,51.96875,17274000,9506420.2,45.99878317846696,NaN,NaN,NaN,-37.29106469791821,28.116356343878017,NaN,0.9934514092208389,NaN,-28665608,-14942810,22.974230782530228,NaN,NaN,NaN,NaN,NaN
1999-04-19T09:30:00-04:00,52.3125,52.75,49.00781,49.53125,19460602,10121430.3,38.55532432642841,56.098964970678075,NaN,NaN,-113.8829452432608,-14.3894311720268,NaN,0.5871755124312656,NaN,-48126210,-25002810,17.805372287785744,NaN,NaN,NaN,NaN,NaN
1999-04-20T09:30:00-04:00,49.3125,51.0625,48.84375,50.65625,17413602,10740870.4,43.12945356594589,55.08078549362237,NaN,NaN,-119.79215660327635,-54.135037977017056,NaN,0.35192031679919467,NaN,-30712608,-29587648.8,16.03474741715918,NaN,NaN,NaN,NaN,NaN
1999-04-21T09:30:00-04:00,51.125,53.1875,50.4375,53.15625,10940398,10739770.4,51.72911924046798,54.897168703673344,NaN,NaN,-44.26277054130343,-66.84431668053165,NaN,0.36302327957407954,NaN,-19772210,-27733648.8,19.519996568580396,NaN,NaN,NaN,NaN,NaN
1999-04-22T09:30:00-04:00,53.65625,54.75,53.304685,54.59375,13630602,10998950.5,55.862056295826164,54.764070934640635,NaN,NaN,38.36395126069987,-55.37299716501177,NaN,0.4822575292743565,NaN,-6141608,-26683648.8,21.507137420768615,NaN,NaN,NaN,NaN,NaN
1999-04-23T09:30:00-04:00,54.3125,55.71875,53.75,55.3125,7064400,10945480.5,57.80726384117703,54.39213524495509,NaN,NaN,66.58654193096613,-34.59747583923491,NaN,0.6275150465121797,NaN,922792,-20765968.8,31.73706345499636,NaN,NaN,NaN,NaN,NaN
1999-04-26T09:30:00-04:00,55.6875,57,55.50781,56.585935,5421000,10803720.3,61.07999509042945,54.23402425902494,NaN,NaN,122.91659797979851,12.762432805376955,NaN,0.8357541834191693,NaN,6343792,-9871968.4,45.75342374092245,32.97963953863403,NaN,NaN,NaN,NaN
1999-04-27T09:30:00-04:00,57,57.28125,55.00781,55.71875,16482796,11372170.1,57.79250945059738,54.027348015873464,NaN,NaN,94.35222362026117,55.59130885008447,0.2079058073720993,0.9202030891620367,0.7122972817899375,-10139004,-5757247.6,49.93484141051543,34.078046857617316,NaN,NaN,NaN,NaN
1999-04-28T09:30:00-04:00,55.25,55.4375,53.57031,53.8125,7676800,11508980.1,51.26111780841015,53.26292270851935,NaN,NaN,12.142192870215167,66.87230153238818,0.08921384640512364,0.823814589796342,0.7346007433912184,-17815804,-5365966.4,50.32694908742573,34.47590800437314,NaN,NaN,NaN,NaN
1999-04-29T09:30:00-04:00,53.5625,53.875,52.25,53.375,19148204,12053560.2,49.86815238798674,52.326317973700824,NaN,NaN,-40.81378405811556,51.0367544686251,-0.024474155205819526,0.704008049383944,0.7284822045897635,-36964008,-11530446.4,44.42387376298317,33.99005136358789,NaN,NaN,NaN,NaN
1999-04-30T09:30:00-04:00,54.125,54.40625,51.8125,53.71875,15295204,12382530.6,50.99494116066526,51.60727430491591,NaN,NaN,-33.40352451769789,31.03874117889229,-0.07915272772236515,0.6295412949368071,0.7086940226591723,-21668804,-16048765.6,40.6594035173464,33.3128110230877,NaN,NaN,NaN,NaN
1999-05-03T09:30:00-04:00,53.5625,53.78125,52.53906,53.4375,11109796,12653160.4,50.00462585792131,51.0861095084788,NaN,NaN,-32.07322610586519,0.0407763617595549,-0.13368462697039152,0.5415882389461828,0.6752728659165743,-32778600,-23873244,35.11071565228616,32.80231212300907,NaN,NaN,6.395321084813762,NaN
1999-05-04T09:30:00-04:00,53.53125,54.375,52.28125,52.59375,15428398,13048460.3,47.052498927859226,50.93621032523131,NaN,NaN,-35.16978445408799,-25.863625253110275,-0.22085868357792626,0.39919951144416643,0.6200581950220927,-48206998,-31486842.8,30.71792556617099,32.57904195780456,NaN,NaN,4.970083645813277,NaN
1999-05-05T09:30:00-04:00,52.625,54.1875,51.03125,54.1875,12642602,13084410.3,52.729350149905414,50.99037080586338,NaN,NaN,-28.76796284565124,-34.045656396283555,-0.1678634667685086,0.4102288615614569,0.5780923283299655,-35564396,-35036561.2,28.902317774486477,32.52914274599696,NaN,NaN,5.315913442158967,NaN
1999-05-06T09:30:00-04:00,53.6875,54.15625,51.71875,52.21875,15173398,13445460.2,46.14727067753917,51.000977055797115,NaN,NaN,-46.27793553283632,-35.138486691227705,-0.25675879430139603,0.2571438354532205,0.5139026297546165,-50737794,-37791318.4,27.54182279847919,32.855399318564736,NaN,NaN,3.5497646123362534,NaN
1999-05-07T09:30:00-04:00,52.6875,53.125,51.5625,52.96875,16430398,14019640.1,48.77078695351668,51.73065295773199,NaN,NaN,-48.94121469033055,-38.24602472575424,-0.25583884745611146,0.1941040704344772,0.44994291789058866,-34307396,-40319036.8,26.317653504658182,33.463419405484196,NaN,NaN,2.8687402792301695,NaN
1999-05-10T09:30:00-04:00,53.3125,53.859375,52.6875,53.5,10604204,14003150.3,50.60635090162046,52.26471705313731,NaN,NaN,0.37350122854916473,-31.756679258871365,-0.21204965725125374,0.18488084632652146,0.3969305035777752,-23703192,-38503955.2,28.766083943427418,34.37280058593193,NaN,NaN,2.8374965125473754,NaN
1999-05-11T09:30:00-04:00,53.9375,54.625,53.625,54.34375,8800796,13945079.9,53.45862074549491,52.388252874924945,NaN,NaN,56.7737453076138,-13.367973306531008,-0.12326003352748455,0.24285546166841954,0.3661154951959041,-14902396,-31843034.8,37.0349616187382,35.62386951808606,NaN,NaN,3.631308495749557,NaN
1999-05-12T09:30:00-04:00,54.59375,55.65625,53,55.46875,12507398,13507760,57.022205127398024,52.471120648608654,NaN,NaN,80.4592668074533,8.477472624089904,0.007310143827239157,0.37525317497995303,0.3679430311527139,-2394998,-25209155.2,44.00631105703373,37.23095334924785,NaN,NaN,5.3573393100422715,NaN
1999-05-13T09:30:00-04:00,55.90625,56,54.1875,54.4375,9864000,13118429.9,53.01499046697069,52.12881540759391,NaN,NaN,79.35147690068591,33.60335511079435,0.019599359416786477,0.39244223042369697,0.3728428710069105,-12258998,-17513396,50.810252145402764,38.59332396999117,NaN,NaN,5.640885767603343,NaN
1999-05-14T09:30:00-04:00,53.375,54,53,53.40625,12205398,12864999.8,49.28507727257432,51.28632127774712,NaN,NaN,-3.1806158922898127,42.755474870402495,-0.042936532237889236,0.31917220570954896,0.3621087379474382,-24464396,-15544796,52.40351360986292,39.0683303892012,NaN,NaN,4.7617240119205855,NaN
1999-05-17T09:30:00-04:00,52.9375,54.53125,52.41406,54.367185,9906796,12387309.5,52.62951131781659,50.91753569683421,NaN,NaN,5.315414381817447,43.743857501056155,-0.02185866309909612,0.334785409073568,0.35664407217266414,-14557600,-13715677.6,53.89769764427675,39.351391548755586,NaN,NaN,4.992867012884885,NaN
1999-05-18T09:30:00-04:00,54.3125,54.625,53.5,54.125,9267796,11980019.2,51.704068690033274,50.949175045521564,NaN,NaN,15.233324984366568,35.435773436406706,-0.026208732670022994,0.3238831563351354,0.3500918890051584,-23825396,-15500277.6,52.17666438718876,39.48351407016723,NaN,NaN,4.916310066984563,NaN
1999-05-19T09:30:00-04:00,54.34375,54.90625,53.5,54.875,7985600,11832279.3,54.37941331880877,51.27140796915172,NaN,NaN,35.51863235240259,26.44764654539656,0.017110160010058384,0.37147958901773137,0.354369429007673,-15839796,-18189237.2,49.606360427302185,39.85369168904715,NaN,NaN,5.600813937335406,4.679889859955416
1999-05-20T09:30:00-04:00,54.992185,54.992185,53.28125,53.367185,5997200,11450609.2,48.55592868994544,51.09719279267173,NaN,NaN,-7.947753270042486,8.987800511250878,-0.056091289355729324,0.28425531731301135,0.34034660666874067,-21836996,-20104836.8,47.79985249053458,40.363723758560596,NaN,NaN,4.475946005548188,4.650755023611526
1999-05-21T09:30:00-04:00,53.53125,53.6875,52.59375,52.875,10471602,11620969.3,46.794331296839616,50.86788603830875,NaN,NaN,-70.3524504825455,-4.446566406800277,-0.13354511350862758,0.17341521478295618,0.30696032829158376,-32308598,-21673677.2,46.31234888195111,41.16384041782238,NaN,NaN,3.023934887353765,4.418352147003275
1999-05-24T09:30:00-04:00,52.96875,53.0625,51.1875,51.53125,9569796,11828409.1,42.28393616969149,50.52727441272534,NaN,NaN,-158.95188598112057,-37.30002647938788,-0.26364449890923214,-0.022595295344956412,0.24104920356427573,-41878394,-27137836,41.471610580045215,41.931960775956256,NaN,NaN,0.3761080490065766,3.8408887044323183
1999-05-25T09:30:00-04:00,51.46875,52.21875,49.625,49.84375,17771204,11892829.5,37.40762444322183,49.43286543367651,NaN,NaN,-262.2163093264719,-92.78995334155556,-0.44125750021865623,-0.3105226717090446,0.13073482850961166,-59649598,-34302676.4,36.13772712279475,42.44877572940685,NaN,NaN,-3.529610473973905,2.7879602503742866
1999-05-26T09:30:00-04:00,50.5,51.4375,48.9375,51.234375,26772000,12847589.5,43.21889173825772,49.22369550944212,NaN,NaN,-219.273051048354,-143.74829002170688,-0.4418958869288603,-0.42163503015146375,0.020260856777396558,-32877598,-37710236.8,33.90431282434835,42.90323930268322,NaN,NaN,-5.06543539411239,1.66604658687619
1999-05-27T09:30:00-04:00,51.03125,51.929685,50.375,51.1875,23334796,13056919.1,43.07372144845982,48.816762259080924,NaN,NaN,-139.82380028216306,-170.123499424131,-0.4223072701153047,-0.5076232308667343,-0.08531596075142962,-56212394,-44585316.4,29.890472514713167,43.15844066054428,NaN,NaN,-6.327264291369781,0.5241450328410513
1999-05-28T09:30:00-04:00,51.5,52.3125,50.84375,52.03125,12969796,12940648.7,46.553717935491555,48.52728847578601,NaN,NaN,-86.32479984349499,-173.31796929632088,-0.33326749648707077,-0.5019003313602681,-0.16863283487319733,-43242598,-46772116.4,28.725569397451636,43.155546764403155,NaN,NaN,-6.37535312913747,-0.46149756172730894
1999-06-01T09:30:00-04:00,51.9375,52.1875,50.59375,50.875,6960200,12733168.9,42.70132964874751,47.75891054030405,NaN,NaN,-103.3553072451565,-162.1986535491281,-0.33224043892249394,-0.5839333835263147,-0.2516929446038208,-50202798,-48436997.2,27.8361135603416,42.4984861888034,NaN,NaN,-7.57939453002521,-1.4783399857698662
1999-06-02T09:30:00-04:00,50.84375,52,49.57031,51.734375,11996602,12561579.1,46.26077811599401,46.99023718234662,NaN,NaN,-96.31707000882555,-129.0188056855988,-0.25704216495351234,-0.5729956507957112,-0.3159534858421989,-38206196,-44148316.8,33.54448219669105,41.75121269877893,NaN,NaN,-7.539954616978334,-2.3442849330853615
1999-06-03T09:30:00-04:00,52.125,52.125,50.6875,51,11147796,12486838.8,43.75912741159178,46.329104106962404,NaN,NaN,-77.58834944454692,-100.6818653648374,-0.2404203778793899,-0.6164789581914363,-0.37605858031204636,-49353992,-47443595.6,31.48370475085838,40.370745027740035,NaN,NaN,-8.247942099756479,-3.1876645283240923
1999-06-04T09:30:00-04:00,51.375,52.742185,51.375,52.5625,12987204,12377529.1,49.95955609190334,46.37728116548591,NaN,NaN,-24.997478352466647,-77.71660097889811,-0.1142553762660452,-0.5188778006446029,-0.40462242437855767,-36366788,-43474474.4,36.540695809393874,39.23768661342082,NaN,NaN,-6.970538574505314,-3.728075106349981
1999-06-07T09:30:00-04:00,52.929685,53.992185,52.8125,53.65625,11491796,12130599,53.79928926808288,46.46083673336208,NaN,NaN,37.61514984552389,-52.928611041094335,0.044301293352883964,-0.3492458076874527,-0.3935471010403367,-24874992,-39800953.2,40.88918256865314,38.30850696516199,NaN,NaN,-4.690218354451735,-3.8655241417930886
1999-06-08T09:30:00-04:00,53.78125,54.03125,52.03906,52.3125,8134800,12007128.8,48.8408168068035,46.2563187417028,NaN,NaN,3.661076641322411,-31.525334263798563,0.05919210315858253,-0.31955697209210854,-0.37874907525069107,-33009792,-36362352,44.70849511740856,37.77506630303484,NaN,NaN,-4.282566564665197,-3.9251016307748183
1999-06-09T09:30:00-04:00,52.5,53.335935,52.46875,53.1875,8384398,11986308.9,51.9465906788525,46.082545695991634,NaN,NaN,18.15600752798997,-8.63071875643546,0.12471586526666772,-0.2228542436673564,-0.3475701089340241,-24625394,-33646191.6,47.589190825838756,37.63098276007316,NaN,NaN,-2.9773121531386266,-3.789703133969648
1999-06-10T09:30:00-04:00,52.625,52.9375,51.94531,52.578125,9392398,11830558.9,49.68440829768866,46.163151382259,NaN,NaN,-3.8926863684184814,6.108413858790229,0.12352691965829937,-0.19316145936114992,-0.3166883790194493,-34017792,-30578951.6,50.71207948176852,37.83899897373272,NaN,NaN,-2.5840008154883782,-3.617459945615181
1999-06-11T09:30:00-04:00,52.9375,52.992185,51.3125,51.78125,16567602,12165739,46.81342145557229,46.164514965025624,NaN,NaN,-24.628582497010058,6.182193029881546,0.06833871298395844,-0.23126498778950122,-0.29960370077345966,-50585394,-33422672.8,47.864517039382385,37.94986812783496,NaN,NaN,-3.114535442339545,-3.5456135880043758
1999-06-14T09:30:00-04:00,51.96875,51.96875,50.6875,50.804685,14136796,12262308.9,43.496316617444386,46.251113568436544,NaN,NaN,-73.69110083430476,-16.07905710608418,-0.02942528116072396,-0.3363853022243646,-0.3069600210636406,-64722190,-41392112.4,40.92845950934606,37.91107162278502,NaN,NaN,-4.5705527405183295,-3.6920334669349404
1999-06-15T09:30:00-04:00,50.929685,51.867185,50.78125,51.5625,9147796,12224358.9,46.65515905738429,46.91165175516243,NaN,NaN,-52.33463256330187,-27.278198947009038,-0.0379988580013767,-0.35445859356536147,-0.31645973556398477,-55574394,-45905032.8,37.60521950732757,38.015892507394504,NaN,NaN,-4.86388712967506,-3.8594411330406717
1999-06-16T09:30:00-04:00,52.84375,54.210935,52.78125,54.210935,15060204,12513979.3,55.92821094434292,47.81946026988281,NaN,NaN,108.78219722185861,-9.152961008235305,0.13052139053447992,-0.15330799739588485,-0.2838293879303648,-40514190,-49082792,35.4240826561237,38.12444749537847,NaN,NaN,-2.085560853647683,-3.606029664555959
1999-06-17T09:30:00-04:00,53.5,55.0625,53.5,54.8125,16278204,12928609.5,57.725772894801274,48.86603537319291,NaN,NaN,158.38659185700155,23.3028946368487,0.2702825618548024,0.05402381438813819,-0.21625874746666418,-24235986,-47126430.8,37.81536372354189,38.690511153151945,NaN,NaN,0.7318510273440761,-2.9863324228559542
1999-06-18T09:30:00-04:00,54.3125,55.21875,54.21875,55.0625,5392800,12898389.5,58.483625483956814,49.718171626654716,NaN,NaN,171.64756472121394,62.5581240804935,0.36163950357626773,0.23579063200367045,-0.12584887157259725,-18843186,-40777989.2,44.94052760529089,39.84872245371189,NaN,NaN,3.2237929004663024,-2.0991716623813463
1999-06-21T09:30:00-04:00,55.4375,56.742185,55.34375,56.710935,10565204,12903069.6,63.171821903755664,51.18034964486958,NaN,NaN,214.59711315949204,120.21576687925285,0.5062891352057566,0.5070125474345986,0.0007234122288419242,-8277982,-29489147.6,54.84786557101208,41.778133311616934,NaN,NaN,6.911778946585663,-0.8118930039574879
1999-06-22T09:30:00-04:00,56.375,57.09375,55,55,10862796,12967719.6,56.09183589294749,51.88256805750911,NaN,NaN,151.62263788495474,161.00722096890416,0.4612177390563844,0.5772455860493224,0.11602784699293801,-19140778,-22202424.4,59.86767088834464,43.65836107530647,NaN,NaN,7.839383485002142,0.42400363732245916
1999-06-23T09:30:00-04:00,55.00781,56,54.65625,55.867185,9607000,12559509.4,58.62305834534248,52.94427740991988,NaN,NaN,123.90621584058319,164.0320246926491,0.4630739821849409,0.6948703247241141,0.23179634253917325,-9533778,-16006342,63.57590352995509,45.950660988099095,NaN,NaN,9.406653775033723,1.707239371281211
1999-06-24T09:30:00-04:00,55.84375,55.875,54.5,54.75781,14988796,11970349.2,54.30971656002159,53.2550031576426,NaN,NaN,90.80341917642744,150.51539015653427,0.36705137227027923,0.6906105578770223,0.32355918560674307,-24522574,-16063659.6,63.51743515057936,47.877570941040915,NaN,NaN,9.354559573938017,2.799713685946469
1999-06-25T09:30:00-04:00,55.125,55.5625,54.1875,54.6875,8635602,11235389.5,54.038340948810486,53.27207827769457,NaN,NaN,71.45082253303406,130.4760417188983,0.28018797390862793,0.673794152992528,0.39360617908390005,-33158176,-18926657.6,60.52331677955753,49.28000909896265,NaN,NaN,9.232006405749594,3.718612645918344
1999-06-28T09:30:00-04:00,55.15625,56.0625,54.703125,55.984375,7666200,10970209.7,58.188412977331254,53.93976371844656,NaN,NaN,94.46282279586882,106.44918364617365,0.2902308624198808,0.756394757108751,0.46616389468887026,-25491976,-22369456.4,57.04122556979399,50.160918416990185,NaN,NaN,10.381894961105335,4.670510119516486
1999-06-29T09:30:00-04:00,55.9375,56.96875,55.65625,56.75,9000398,11072219.6,60.458367735601094,54.54774779392859,NaN,NaN,118.34370239255003,99.79339654769271,0.325921640599215,0.873565945437889,0.547644304838674,-16491578,-21839616.4,57.446982149309974,50.865046368666704,NaN,NaN,12.027474353971598,5.721505010152931
1999-06-30T09:30:00-04:00,56.804685,59.9375,56.13281,57.625,19467602,11445769.6,62.93499817035774,55.49421849911925,NaN,NaN,157.33498972839604,106.47915132525527,0.3820542652058886,1.0252121363460347,0.6431578711401461,2976024,-19337656,59.39722963963006,51.48541423708538,NaN,NaN,14.165143195195661,6.927739036587607
1999-07-01T09:30:00-04:00,57.8125,58.34375,56.8125,58.015625,6822600,11229509.8,64.01848278753823,56.72315145140254,NaN,NaN,135.85372057070293,115.48921160411037,0.416274418328488,1.163500894050756,0.7472264757222681,9798624,-12473416.4,64.23960406199313,52.655063310129016,NaN,NaN,16.246308981461738,8.258963314426769
1999-07-02T09:30:00-04:00,58,58.8125,58,58.75,3302000,10745249.6,66.0290078336979,58.33262939542065,NaN,NaN,149.75226036078064,131.1494991696597,0.45595493020146316,1.317170138474097,0.8612152082726339,13100624,-3221656.4,69.5165580751627,54.697070350544486,NaN,NaN,18.603766332938925,9.736792317071362
1999-07-06T09:30:00-04:00,59.0625,59.65625,58.0625,58.375,8794796,10610399.6,64.06058241034134,59.57587392063187,NaN,NaN,137.81374482758252,139.81968357600243,0.42514083683928905,1.3926412543217452,0.9675004174824562,4305828,2737904.4,72.34725764024918,57.17864450289603,NaN,NaN,20.02755897434937,11.206901839539649
1999-07-07T09:30:00-04:00,58.34375,58.71875,57.9375,58.46875,10520000,10729659.6,64.34674187162344,60.177197558294765,NaN,NaN,112.6246687697335,138.6758768514391,0.3807029642653097,1.4433791228140933,1.0626761585487836,14825828,9001385.6,74.97723100053396,60.00386938463961,NaN,NaN,21.28505057503153,12.646637373181346
1999-07-08T09:30:00-04:00,58.46875,59.492185,58.1875,59.25,11225000,10871689.7,66.72448685174939,60.81996284093391,NaN,NaN,120.10114637859566,131.22910818147903,0.3730624223390684,1.5290041864726192,1.1559417641335508,26050828,13616346.4,76.73308675090881,62.78370674373725,NaN,NaN,23.040029299576247,14.131407648380616
1999-07-09T09:30:00-04:00,59.46875,59.90625,59.03125,59.84375,4191200,10611629.8,68.44678352477155,61.531616986706396,NaN,NaN,125.39920639652503,129.13820534664347,0.3760701675241369,1.626029473538722,1.249959306014585,30242028,17705027.2,78.19306999321833,65.15888834287493,NaN,NaN,25.030788116315154,15.688462000942692
1999-07-12T09:30:00-04:00,60.0625,60.375,59.1875,59.53125,7816200,10174059.7,66.49599683207416,61.76905805301486,NaN,NaN,115.92844401201532,122.37344207689041,0.3269024839885928,1.658587411000326,1.3316849270117332,22425828,19570068,78.84516162283714,66.8729809180053,NaN,NaN,26.203747205687577,17.190645601620535
1999-07-13T09:30:00-04:00,59.25,59.46875,58.78125,59.25,6230000,9778719.9,64.70850006171885,62.38453406506996,NaN,NaN,89.04170968667052,112.619035048708,0.2488589288613945,1.6427585880884763,1.3938996592270818,16195828,21948068,79.67952668834091,68.28811347514788,NaN,NaN,26.73730670017647,18.554454329985667
1999-07-14T09:30:00-04:00,59.84375,60.375,59,60.25781,6909400,9666800.1,68.02535384954216,63.056126601084216,NaN,NaN,104.48045633864943,110.99019256249119,0.238505306842705,1.692031292780463,1.453525985937758,23105228,23603948,80.26327179712169,69.48006835137406,NaN,NaN,28.123040323131725,19.92139518614939
1999-07-15T09:30:00-04:00,60.46875,60.8125,60.13281,60.8125,6539800,9240779.9,69.712585701163,64.15633153973718,NaN,NaN,119.48939710819793,110.86784270841163,0.24166051583125703,1.7556016307268294,1.5139411148955724,29645028,24322788,80.52482429852314,70.69488186194147,NaN,NaN,29.785333861267848,21.330529282594885
1999-07-16T09:30:00-04:00,60.84375,61.71875,60.82031,61.375,4913800,8672559.7,71.36285783966892,65.39379703194136,NaN,NaN,134.95603439561768,112.77920830823015,0.2530650198726283,1.8302723897363578,1.5772073698637294,34558828,25186148,80.85301664475465,72.14700328088414,NaN,NaN,31.680971380874624,22.80916386806342
1999-07-19T09:30:00-04:00,61.625,61.625,60.50781,60.75,6833000,8744569.7,66.99491087156451,66.02283259581516,NaN,NaN,112.36223093345549,112.06596569251819,0.19268191713724647,1.8180597662852875,1.625377849148041,27725828,26246148,81.27034271882603,73.87765450581499,NaN,NaN,32.12526670711897,24.14003570221421
1999-07-20T09:30:00-04:00,60.00781,60.09375,58.25,58.40625,14837398,8958179.4,53.71692461300933,65.54130094420147,NaN,NaN,29.923508873996877,100.24232552998346,-0.01965665549632556,1.6008070297776342,1.6204636852739598,12888430,25584668.4,80.09710170959934,75.4955201886928,NaN,NaN,28.30571234808586,24.73513236591016
1999-07-21T09:30:00-04:00,58.53125,59.19531,58.0625,58.6875,10980398,8964059.5,54.872757707719764,64.96542662544161,NaN,NaN,14.516703377831757,82.24957493781992,-0.14854066492974205,1.4347878541117822,1.5833285190415243,23868828,25737388.4,80.16828524510396,76.97916701765521,NaN,NaN,25.564291471907858,24.853583666766976
1999-07-22T09:30:00-04:00,58.6875,58.6875,57.03125,57.19531,15148398,9241129.4,48.02074599937637,63.8227311405729,NaN,NaN,-37.81304406906974,50.78908670236641,-0.33119890168637345,1.1693298919335575,1.500528793619931,8720430,21552468.8,72.51469603791868,77.57024501593561,NaN,NaN,20.88752423317691,24.287003747682682
1999-07-23T09:30:00-04:00,57.625,57.867185,56.6875,57.28125,12115000,9097439.6,48.42022746965778,62.56496111457004,NaN,NaN,-66.8710141053103,10.423677002180815,-0.43651909665792,0.9548799227975309,1.3913990194554509,20835430,18807789.2,67.93392603064217,77.45719986989843,NaN,NaN,17.28815958039676,23.287168866641835
1999-07-26T09:30:00-04:00,56.5,57.125,55.78125,55.875,10720000,9201659.5,42.64479514399417,61.03526202411667,NaN,NaN,-133.35698912596902,-38.7201670097041,-0.5820774111237104,0.663802255550813,1.2458796666745233,10115430,15285709.6,62.47957922674244,76.75236569750508,NaN,NaN,12.225458951287058,21.706924593019725
1999-07-27T09:30:00-04:00,57,57.875,56.515625,57,13732796,9504989.3,47.98949604376785,59.86688732212699,NaN,NaN,-94.92587575510993,-63.690043935525445,-0.582360658278001,0.517928843827022,1.100289502105023,23848226,17477668.8,64.39550570109547,75.99652817611663,NaN,NaN,9.584067085496516,19.975087806230697
1999-07-28T09:30:00-04:00,57.6875,58.4375,56.94531,58.117185,10161796,9563059.2,52.70297578653184,58.86535081746859,NaN,NaN,-59.65537162164605,-78.524458935421,-0.49074487670639155,0.4868584062220336,0.9776032829284251,34010022,19505907.6,66.11948650598728,75.23841387290794,NaN,NaN,8.863448207416573,18.38771072068582
1999-07-29T09:30:00-04:00,57.03125,57.5,56.3125,56.875,13033796,9241368.9,47.543692664947365,57.37227289890972,NaN,NaN,-112.21535963085448,-93.40492204777794,-0.4957821896073009,0.35787554591929904,0.8536577355266,20976226,21957066.8,68.12799688135021,74.51948007920308,NaN,NaN,6.544811825403646,16.695868021359797
1999-07-30T09:30:00-04:00,57.125,57.75,56.50781,56.59375,10947398,9447608.8,46.435300573799694,55.9393660233187,NaN,NaN,-102.78202338480891,-100.58712390367768,-0.49868111069878596,0.23030634715311749,0.7289874578519034,10028828,19795746.4,64.49723704101366,73.49462832335855,NaN,NaN,4.350306760189805,14.932216412621226
1999-08-02T09:30:00-04:00,56.6875,57.8125,56.21875,56.4375,9642398,9764628.7,45.79652948051208,54.58851098180393,NaN,NaN,-97.3205756996696,-93.3798412184178,-0.49097395989649284,0.11527000798128739,0.6062439678777802,386430,17849946.4,61.32841830570065,72.18383486745567,NaN,NaN,2.394406972639003,13.141100778338052
1999-08-03T09:30:00-04:00,57.210935,57.21875,55.25,56.07031,13005000,9975138.9,44.25581268721621,52.89068661306636,NaN,NaN,-115.05335545897607,-97.40533715919102,-0.4893658193227278,-0.00546330627562952,0.4839025130470983,-12618570,10556587.2,51.178590098265616,70.10635760325167,NaN,NaN,0.32124336868884484,11.309692576959593
1999-08-04T09:30:00-04:00,56.07031,56.492185,55.00781,55.054685,13227602,10110519,40.22482364159645,50.784417894525895,NaN,NaN,-127.46940299106271,-110.96814343307435,-0.5319309647357895,-0.18101119287263856,0.35091977186315093,-25846172,-1414651.6,39.59520082101679,67.18281306914407,NaN,NaN,-2.7059814023835838,9.307453437053425
1999-08-05T09:30:00-04:00,55.0625,55.929685,53.75,55.929685,18695204,10484029.2,44.882706231438064,48.892978493937974,NaN,NaN,-124.4375179746844,-113.41257510184032,-0.47808408584603834,-0.24668533544439697,0.23139875040164135,-7150968,-7040090.4,35.52611335708791,63.945177120025015,NaN,NaN,-3.9265436079292573,7.416882430627328
1999-08-06T09:30:00-04:00,55.53125,56.5625,54.9375,55.328125,12392204,10894079.4,42.43453015338128,47.13866558549631,NaN,NaN,-97.8649487700544,-112.42916017888942,-0.4597717196522322,-0.3433158991636489,0.11645582048858329,-19543172,-12954490.4,31.823247771064274,60.41324176661346,NaN,NaN,-5.681709901396318,5.54565495462395
1999-08-09T09:30:00-04:00,55.53125,55.6875,54.50781,54.617185,7983400,10902439.4,39.67984324370138,46.13601691626003,NaN,NaN,-115.91818960227702,-116.14868295941089,-0.4706241254109907,-0.4718243362751551,-0.001200210864164386,-27526572,-18537090.8,28.774582053888622,56.74734750549127,NaN,NaN,-7.998434854033302,3.610784981958629
1999-08-10T09:30:00-04:00,54.46875,54.867185,52.9375,54.125,16767204,11429299.6,37.84804995724685,44.919966362654826,NaN,NaN,-140.631639384424,-121.26433974450052,-0.48415446354375563,-0.6063932902938589,-0.12223882675010328,-44293776,-24872132,25.758871075439544,52.86096077908666,NaN,NaN,-10.481899922981853,1.597544281252846
1999-08-11T09:30:00-04:00,55.09375,56,54.265625,55.90625,13101398,11738899.5,47.32543748840202,44.8703014690138,NaN,NaN,-77.6616360555186,-111.30278635739168,-0.35246519862751813,-0.562820325034501,-0.21035512640698284,-31192378,-25941373.2,25.277341449548715,49.48686402277452,NaN,NaN,-9.775581119309903,-0.027187918827546564
1999-08-12T09:30:00-04:00,56.125,56.5,55.125,55.25,12715000,12047659.5,44.62554461965844,44.59925269401385,NaN,NaN,-62.93388258439734,-99.00205927933428,-0.29141068483600463,-0.5746184824519887,-0.283207797615984,-43907378,-33292655.2,22.204070406360287,46.22044576389724,NaN,NaN,-10.025398000144536,-1.4555036447299734
1999-08-13T09:30:00-04:00,56.40625,57.71875,56.3125,57.65625,14342602,12519099.6,54.80641295879005,45.46793968078499,NaN,NaN,26.49153080393802,-74.1307633645358,-0.08172346378903717,-0.3853621273522805,-0.3036386635632433,-29564776,-35296976,21.43872538024975,43.28895620343348,NaN,NaN,-6.7051096009544775,-2.2054473527620453
1999-08-16T09:30:00-04:00,57.625,58.3125,57.25,58.117185,11470602,12750979.7,56.45787500211088,46.0728238920952,NaN,NaN,80.98652383029037,-34.74982067802232,0.0861725136680963,-0.1959230214781229,-0.2820955351462192,-18094174,-33410496.4,24.090817150303224,40.41004987837688,NaN,NaN,-3.5284322033403286,-2.394445188558943
1999-08-17T09:30:00-04:00,58.625,58.6875,57.34375,58.40625,11408398,12579529.7,57.50658150579582,46.415938586328345,NaN,NaN,102.50721677407859,13.877950553678204,0.20790841823090345,-0.022210012357589903,-0.23011843058849335,-6685776,-25888896.4,33.70096439607714,38.09444115624045,NaN,NaN,-0.6655403445853527,-2.1474587822770013
1999-08-18T09:30:00-04:00,58.125,58.84375,57.53125,57.75,7035200,12382269.8,54.30863136275726,46.89914849331477,NaN,NaN,100.39512603549714,49.48930297188135,0.23352882588403895,0.06179260176655532,-0.17173622411748363,-13720976,-22394616,37.650114041321395,35.917449524809825,NaN,NaN,0.7413187308455521,-1.7347762804023508
1999-08-19T09:30:00-04:00,57.21875,57.625,56.69531,57.0625,10157796,12132739.7,51.102478875546566,47.23251837201097,NaN,NaN,42.43169239415744,70.56241796759231,0.19503627660939374,0.07205912164425854,-0.1229771549651352,-23878772,-18388894.8,41.921047495516866,34.30486455727434,NaN,NaN,0.9508486845416225,-1.3511155711246403
1999-08-20T09:30:00-04:00,57.125,57.96875,56.8125,57.96875,6920800,11873029.7,54.88351296039937,47.88158862057435,NaN,NaN,71.33520414719963,79.53115263624463,0.2196416856289209,0.1515749520710159,-0.06806673355790499,-16957972,-15867534,44.49816059602709,33.102703292297655,NaN,NaN,2.291524825485135,-0.8307383716089581
1999-08-23T09:30:00-04:00,58.5,59.8125,58.367185,59.8125,9652000,11819629.7,61.419746015375914,49.10758385830004,NaN,NaN,162.2189955372329,95.77764697763314,0.3418342682959,0.35922610181197,0.017391833516070015,-7305972,-13709893.6,46.67860471602986,32.7812757649951,NaN,NaN,5.667496286689171,0.09758086529077448
1999-08-24T09:30:00-04:00,59.375,60.875,59.25781,60.21875,13891398,11827559.8,62.701942240205035,50.71309232962922,NaN,NaN,181.26490395942028,111.52918441470146,0.42627006254900435,0.5502294117023254,0.1239593491533211,6585426,-11055653.2,49.31645672475918,33.47565118669099,NaN,NaN,8.787664212281122,1.3390213434322527
1999-08-25T09:30:00-04:00,60.59375,61.75,59.9375,61.5,11352000,11887070,66.48508493333932,52.25611937976503,NaN,NaN,198.66491757782453,131.18314272316695,0.5374832695788907,0.7958134361269344,0.25833016654804375,17937426,-4723972.8,55.031514157716884,34.86889410102163,NaN,NaN,12.715771344187518,2.9642713435401475
1999-08-26T09:30:00-04:00,61.5,61.71875,60.38281,60.47656,9753000,11723030.2,61.149606556769974,53.592910551435644,NaN,NaN,156.8156738484292,154.0599390140213,0.5113450953719664,0.8975115357630017,0.3861664403910353,8184426,1688666.8,59.956330401531744,36.87840000319788,NaN,NaN,14.310984641517729,4.585230386108373
1999-08-27T09:30:00-04:00,60.929685,60.9375,59.71875,59.875,9635398,11657430.2,58.193469056504526,54.9153123952073,NaN,NaN,110.30826715102177,161.85455161478575,0.42624587973202327,0.9189737900560644,0.4927279103240411,-1450972,4790066.8,62.117204289335184,39.260015877158345,NaN,NaN,14.69114316686015,6.028932211930055
1999-08-30T09:30:00-04:00,60.125,60.3125,58.875,59.03125,10141602,11682390.4,54.233276311631435,56.08568570623477,NaN,NaN,72.0465434187956,143.82006119109826,0.29222456651010686,0.8580086184616746,0.5657840519515678,-11592574,3932746.4,61.13510304915979,41.78688958956694,NaN,NaN,13.773979442096504,7.1353675305252615
1999-08-31T09:30:00-04:00,59.4375,60.0625,58.125,59.6875,14590398,11761660.3,56.7013420647269,56.75539317597226,NaN,NaN,61.46675941867686,119.86043228294959,0.22962590582961828,0.8528164342385907,0.6231905284089724,2997824,3215226,60.2761573786668,44.286805013075366,NaN,NaN,13.761220320077284,8.081917929032693
1999-09-01T09:30:00-04:00,60.0625,60.625,59.6875,60.117185,10752000,11637880.2,58.287472744675604,57.73124518490206,NaN,NaN,84.4872333162645,97.0248954306376,0.2000928924168508,0.8733066439300359,0.6732137515131851,13749824,2377705.6,59.2300814687308,46.93152008895897,NaN,NaN,14.220002309567608,8.958787126251966
1999-09-02T09:30:00-04:00,59,60.21875,58.875,59.90625,14583204,11432280.2,57.180103131203154,57.90079448293157,NaN,NaN,60.78755901582096,77.81927246411593,0.15149403151621887,0.8625812909084587,0.7110872593922398,-833380,574144.4,56.9384567022267,49.4672151833859,NaN,NaN,14.281166393777035,9.71912702161269
1999-09-03T09:30:00-04:00,61.625,62.679685,61.40625,62.65625,14195398,11522439.9,66.19674185297006,58.5964278294215,NaN,NaN,140.6547641671703,83.88857186734563,0.2821073682452979,1.0637214696988622,0.7816141014535642,13362018,3536742.4,59.69691244325152,52.01050770431078,NaN,NaN,17.312098608548983,10.803837248317874
1999-09-07T09:30:00-04:00,62.53125,63.15625,62.28125,62.375,9009000,11573719.9,64.69628701148812,59.109978222685235,NaN,NaN,139.87390589433534,97.45404436245357,0.3241101983878414,1.186751849438366,0.8626416510505246,4353018,6725860.8,62.48295445722245,54.06636413724973,NaN,NaN,19.254179142596456,12.01102894750053
1999-09-08T09:30:00-04:00,62,62.625,61.03125,61.53125,14303398,11450529.6,60.281816846038765,59.536634328633916,NaN,NaN,103.27524431976158,105.81574134267052,0.2717356733099556,1.2023112426879692,0.9305755693780136,-9950380,4136220,58.92111864824557,55.585721609172886,NaN,NaN,19.516237487664174,13.083201596095336
1999-09-09T09:30:00-04:00,61.5625,62.5625,61.25,62.40625,12677602,11429339.8,63.09418986616824,60.39318511367832,NaN,NaN,109.88299241209936,110.89489316183752,0.2720200786431525,1.2706006676819541,0.9985805890388016,2727222,1931699.6,55.9948147365872,56.59099069782077,NaN,NaN,20.607434838318177,14.158092059270027
1999-09-10T09:30:00-04:00,63.25,63.742185,62.53125,63.125,10251000,11306139.8,65.26963146394192,61.13505072107422,NaN,NaN,141.95406375203865,127.12819410908105,0.2947036736327395,1.366960181079726,1.0722565074469865,12978222,4694020,58.758732163875734,57.6096029526671,NaN,NaN,22.187033690671218,15.305083720898768
1999-09-13T09:30:00-04:00,63.0625,63.1875,62.03125,62.367185,7240800,10951049.7,61.175160232013425,61.1175803079769,NaN,NaN,105.41917710964178,120.08107669757536,0.23533491716275456,1.3664251539004297,1.1310902367376752,5737422,3169100.8,56.64363749556702,58.32139100834833,NaN,NaN,22.27384337286805,16.300620814037238
1999-09-14T09:30:00-04:00,62.125,63.148435,62,62.710935,10022602,10878649.7,62.32954792621209,61.09098071412027,NaN,NaN,96.92150396774062,111.49059631225639,0.19741247369622816,1.3778558288579603,1.1804433551617322,15760024,5450502,59.020290537704476,59.01452199498728,NaN,NaN,22.682481668871496,17.212315221870703
1999-09-15T09:30:00-04:00,63.492185,63.492185,61.4375,61.5,16096000,11113029.8,56.011511605416814,60.34286833355437,NaN,NaN,68.5806454326562,104.55167653483531,0.07525381325416114,1.2745106217294335,1.1992568084752724,-335976,7373382.8,60.96264595382798,59.43817426613807,NaN,NaN,21.11878758553131,17.770382702393647
1999-09-16T09:30:00-04:00,61.46875,62.03125,60.19531,61.46875,15371000,11529819.8,55.85416492770168,59.96462250290664,NaN,NaN,22.859230818443727,87.14692421610418,-0.0181854951454139,1.176524939543505,1.1947104346889188,-15706976,3686543.2,55.52814629969474,59.12187540172114,NaN,NaN,19.814742071484602,18.06243404083521
1999-09-17T09:30:00-04:00,62.03125,63.4375,61.9375,63.3125,14506398,11747249.9,62.54038005766177,60.27511614584644,NaN,NaN,96.51266549116437,78.05864456392933,0.03097374095648009,1.2334276108845188,1.2024538699280387,-1200578,850783.2,51.70985556324535,58.37849334985758,NaN,NaN,20.672261336090735,18.435266511586
1999-09-20T09:30:00-04:00,63.5,63.75,63.03125,63.460935,6187200,11710569.9,63.02590012685444,60.903160704076654,NaN,NaN,115.08732802030721,79.9922747460624,0.05867233561473628,1.2757942894464591,1.2171219538317228,4986622,700623.2,51.50787993687638,57.69083455612305,NaN,NaN,21.505665261677244,18.87389490445618
1999-09-21T09:30:00-04:00,62.90625,63.03125,61.75781,61.9375,12265796,11841259.7,55.12837038806607,60.79080558431516,NaN,NaN,44.778671660372865,69.56370828458887,-0.03536075385180859,1.1729210115169622,1.2082817653687707,-7279174,-3907216.4,45.61940258396957,56.64392349935896,NaN,NaN,19.781290544686367,19.003522853060492
1999-09-22T09:30:00-04:00,62.03125,62.921875,61.28125,62.59375,12441796,11768779.6,57.59347293614895,60.74123416942041,NaN,NaN,41.69468829139296,64.18651685633623,-0.06158053579182221,1.131306095628993,1.1928866314208153,5162622,-2807496.8,47.17166642803767,55.78260813930945,NaN,NaN,19.100107071162352,19.017320598503616
1999-09-23T09:30:00-04:00,63.25,63.375,59.63281,60,19766000,12189479.6,46.678482524799584,59.991118411820146,NaN,NaN,-35.571408256396374,52.500389041368194,-0.25118881895074563,0.8789006077323833,1.130089426683129,-14603378,-2586777.2,47.495603651570626,55.108118635691156,NaN,NaN,14.679013996416051,18.397562512491106
1999-09-24T09:30:00-04:00,59.625,60.3125,58.625,60.078125,23570796,12880369.4,47.004272374925264,58.62022773481694,NaN,NaN,-106.43055426205933,11.911745090723466,-0.3621809391548889,0.6773632527395179,1.0395441918944068,8967418,-553178,50.50686240856145,54.45168649035615,NaN,NaN,11.366589293094293,17.39313776686299
1999-09-27T09:30:00-04:00,60.9375,61.375,60.3125,60.5,12608796,13029039.3,48.82267914371165,57.486398601404346,NaN,NaN,-48.660822852664715,-20.837885083870923,-0.3953167755609396,0.5453982224432323,0.9407149980041719,21576214,2764740.4,55.03777062838005,53.91988764543884,NaN,NaN,9.233173480422169,16.22742858308573
1999-09-28T09:30:00-04:00,60.19531,61,58.90625,60.78125,20622000,13553059.2,50.05309573845506,56.75577566514836,NaN,NaN,-84.36013218812931,-46.66564585357135,-0.3859901183889266,0.4582273500180136,0.8442174684069402,42198214,12660218,65.25418544715836,54.372249559646896,NaN,NaN,7.854600865177165,15.03131033767022
1999-09-29T09:30:00-04:00,60.78125,61.21875,59.5625,59.5625,15557000,13601389.3,45.00380217538783,55.46360511580691,NaN,NaN,-98.50439563730234,-74.70546263931041,-0.4453844578268288,0.2874868961234043,0.7328713539502331,26641214,16955936.4,68.59069752139321,55.27195547284733,NaN,NaN,5.094759796641901,13.611803117523317
1999-09-30T09:30:00-04:00,60.125,60.8125,59.375,60.1875,17604204,13943999.5,47.90606610505909,54.223350447315276,NaN,NaN,-97.6662508025749,-87.12443114854611,-0.42605929823983724,0.20029723115043652,0.6263565293902738,44245418,28725695.6,75.52533069510451,56.46956965364939,NaN,NaN,3.6504092017590564,12.188746843842708
1999-10-01T09:30:00-04:00,59.375,60.210935,58.75,60.210935,19607398,14195209.2,48.01683977415702,53.28347041461125,NaN,NaN,-124.23451015227475,-90.68522232658918,-0.39582673612387287,0.13157310923543264,0.5273998453593055,63852816,39702775.2,79.96757672763185,58.13556531308258,NaN,NaN,2.515308866433285,10.80682713278422
1999-10-04T09:30:00-04:00,60.53125,61.78125,60.1875,61.5625,12434204,14107149.5,54.08134293558117,52.69431291528047,NaN,NaN,-26.40890799982233,-86.23483935602071,-0.27468214323201917,0.18404716631928153,0.4587293095513007,76287020,50644936.4,83.23427543828785,59.865135663124256,NaN,NaN,3.3025457032900607,9.734786928570768
1999-10-05T09:30:00-04:00,61.78125,62.75,60.6875,62,19526398,14633019.4,55.87580843905662,52.68461983196903,NaN,NaN,18.173306505933528,-65.72815161720814,-0.16061368716047375,0.2579622006007085,0.41857588776118226,95813418,61367977.2,85.69596696534128,61.63180144966093,NaN,NaN,4.486165602113714,8.984983881934046
1999-10-06T09:30:00-04:00,62.375,63.335935,61.429685,63.242185,19098204,14872759.7,60.58552322918894,53.02257399636097,NaN,NaN,69.81003370399516,-32.06526574894866,-0.005240885625832248,0.4120247807288919,0.4172656663547242,114911622,79022058.8,88.65055957900512,63.997688112468815,NaN,NaN,6.984431939531353,8.699190747305089
1999-10-07T09:30:00-04:00,63.59375,63.898435,62.625,63.09375,22013602,15339559.7,59.7646111158624,52.824304786232446,NaN,NaN,96.09574208273835,6.687132828113988,0.07914160582943641,0.5161926736415197,0.43705106781208325,92898020,88752579.2,89.89010226505977,66.72484859116985,NaN,NaN,8.777120991989603,8.710323639402876
1999-10-08T09:30:00-04:00,62.84375,63.9375,62,63.75781,22523204,15953169.9,62.23024002682073,52.76747192194433,NaN,NaN,96.99659061775024,50.93335298211899,0.1662764296354184,0.6448966048563562,0.47862017522093786,115421224,99066260.8,91.01075852277853,69.54648277587714,NaN,NaN,11.035936660659008,9.042554071010896
1999-10-11T09:30:00-04:00,63.9375,64.6875,63.78125,64.65625,13016000,16241929.9,65.326148003081,53.495884608731096,NaN,NaN,150.0308718707582,86.2213089562351,0.2651472170180864,0.8100541964935459,0.5449069794754595,128437224,109496301.6,91.979054632506,72.85788649362974,NaN,NaN,13.932658701039704,9.741140446729297
1999-10-12T09:30:00-04:00,64.4375,64.5,63,63.1875,20182796,16749939.6,57.08795788909392,53.459776391084304,NaN,NaN,97.47363362169746,102.08137437938788,0.21451804920251083,0.8130545409785981,0.5985364917760873,108254428,111984503.6,92.19504764766754,76.07384229503188,NaN,NaN,13.989323584219399,10.348023752085025
1999-10-13T09:30:00-04:00,62.46875,63.21875,61.0625,61.3125,22570602,17073669.7,48.6528420694084,53.60080207284208,NaN,NaN,4.858067457317226,89.09098113005231,0.046424414449132034,0.6565670098375023,0.6101425953883702,85683826,106138944.4,86.31443349312488,78.84661585514289,NaN,NaN,11.209754979966707,10.47112821321098
1999-10-14T09:30:00-04:00,61.53125,62.125,60.53125,61.69531,22130398,17411639.6,50.2684833156579,53.83395999718012,NaN,NaN,-18.963641870239268,66.07910433945678,-0.04249957750770572,0.5570181235037381,0.5995177010114439,107814224,109122185.2,86.77794547561132,81.4374075027893,NaN,NaN,9.50636635262053,10.333305090269487
1999-10-15T09:30:00-04:00,60.125,61,59.50781,59.875,33703008,18371470.1,43.29274183639116,53.43896447522866,NaN,NaN,-83.54776559504224,29.970233096898276,-0.21764113490827464,0.32746628237610054,0.5451074172843752,74111216,100860183.6,78.81641584151446,83.13588216087034,NaN,NaN,5.622686326583957,9.660359552600125
1999-10-18T09:30:00-04:00,59.9375,60.15625,57.41406,59.117185,24714796,19297849.9,40.75703136189171,52.774959876902706,NaN,NaN,-135.46142885201152,-27.128227047655674,-0.36933898528184655,0.083433685682067,0.45277267096391355,49396420,85052022.8,66.2854119357646,83.20954119577077,NaN,NaN,1.6249761550300457,8.512447638661543
1999-10-19T09:30:00-04:00,59.75781,60.0625,58.4375,59.4375,26657204,20017420.3,42.295515080211466,52.58151079867582,NaN,NaN,-101.21740445391576,-66.86643466277832,-0.42874498613678347,-0.08315856170706581,0.34558642442971765,76053624,78611862,61.96322778649068,82.7361505004206,NaN,NaN,-1.0881230040925782,7.140937546839526
1999-10-20T09:30:00-04:00,60.34375,61.742185,59.75,61.25,22486398,20519650.4,50.17955972563317,52.7439032001454,NaN,NaN,-15.778739099969208,-70.99379597423561,-0.3309851257417553,-0.06814498274747649,0.2628401429942788,98540022,81183101.2,63.000543842439455,81.84152286808738,NaN,NaN,-0.9068279799976382,5.991256757291359
1999-10-21T09:30:00-04:00,60.25,62.25,59.8125,62.25,22454796,20654090.2,53.920286151958685,53.16557794141695,NaN,NaN,10.963525944061871,-65.00836241137537,-0.19093895154525206,0.02416645356271374,0.2151054051079658,120994818,83819220,64.0820431602495,80.70684189898863,NaN,NaN,0.4782544425675734,5.203684998045104
1999-10-22T09:30:00-04:00,62.617185,63.25,61.75,61.96875,16589398,20305020.3,52.72130662837701,53.06843249090237,NaN,NaN,52.00567683616056,-37.89767392513481,-0.11306118021955996,0.07377892983351586,0.18684011005307583,104405420,89878060.8,66.50538742027557,79.51192132627348,NaN,NaN,1.2096280080023876,4.633105428039002
1999-10-25T09:30:00-04:00,61.6875,62.679685,61.4375,62,13855398,20367350.4,52.84676891804355,52.85207252511572,NaN,NaN,33.18056311448253,-4.169275531836003,-0.058031131628325516,0.11430119551766893,0.17233232714599445,118260818,103650940.4,71.25338131091186,78.4803080652428,NaN,NaN,1.8302163233212956,4.232692698793615
1999-10-26T09:30:00-04:00,62.75,63.09375,61.375,61.5,13542398,20013370.3,50.53601650478417,52.13425061622967,NaN,NaN,26.449265134754743,21.3640583858981,-0.05397722830876983,0.10486079176003216,0.158838020068802,104718420,109383899.6,72.9709152069897,77.36033346724172,NaN,NaN,1.6915609845304016,3.8696738824702988
1999-10-27T09:30:00-04:00,61.34375,61.625,60.44531,61.40625,15225204,19996780.5,50.093729380481754,51.44347334941676,NaN,NaN,-24.084261971847006,19.70295381152254,-0.05603774663650468,0.08879083677317112,0.1448285834096758,89493216,107574538.4,71.51857452208873,76.04808148560093,NaN,NaN,1.4562575559988937,3.5249001215458122
1999-10-28T09:30:00-04:00,62.375,63.75,61.8125,63.53125,14103796,19821760.1,58.87873591308684,51.20408019843577,NaN,NaN,78.07698943152238,33.12564650901464,0.07990051273414508,0.24470422432735717,0.16480371159321208,103597012,104094977.2,68.68731837994025,74.45355004682675,NaN,NaN,3.94721041222396,3.585230163071262
1999-10-29T09:30:00-04:00,65,66.25,64.78125,65.75,18998000,19791290.2,65.67318959293542,51.22886888342538,NaN,NaN,199.94339506985236,62.713190155753,0.3010084208541939,0.5410642376609545,0.24005581680676058,122595012,107732895.6,70.02346730586433,72.8852938092095,NaN,NaN,8.561428070966366,4.296115578484848
1999-11-01T09:30:00-05:00,65.75,66.53125,65.32031,65.40625,9681796,19653669.8,63.91127604834958,51.71624875194363,NaN,NaN,172.20822933019704,90.5187233988959,0.399689350281294,0.739667504658378,0.33997815437708406,112913216,106663375.2,69.0900604636896,71.23493758178249,NaN,NaN,11.655567912034101,5.347465911849027
1999-11-02T09:30:00-05:00,65.75,66.5625,65.19531,65.44531,12834796,19319089.7,64.02936758493652,52.81457200305278,NaN,NaN,144.25406914847514,114.07968420163998,0.4399814708931969,0.8899549929935802,0.44997352210038327,125748012,110869293.6,70.74176350224272,70.12260401100521,NaN,NaN,14.140637635673405,6.603633300966796
1999-11-03T09:30:00-05:00,66.375,67.125,66.1875,66.75,18752602,19301809.6,67.81751289130744,54.06807411559918,NaN,NaN,154.7132836603813,149.83919332808563,0.5213311808631794,1.1016374981793575,0.5803063173161781,144500614,121870773.2,74.56966560046668,69.25058401992344,NaN,NaN,17.51566667171265,8.162495211073347
1999-11-04T09:30:00-05:00,67.679685,67.8125,66.78125,67.5,20048602,19203559.6,69.78724642041303,55.9605387287436,NaN,NaN,152.63120665705858,164.7500367731929,0.5875632670458123,1.3147604011234435,0.7271971340776312,164549216,134061214,78.00377293654645,69.19253809814002,NaN,NaN,20.95744493948294,9.990345172274717
1999-11-05T09:30:00-05:00,68.875,69.21875,68.1875,68.1875,15134602,18834129.5,71.50870353496512,58.15708674110599,NaN,NaN,158.99115912735525,156.55958958469347,0.6355201445885057,1.5215973148132633,0.8860771702247576,179683818,145478975.2,80.64069762650189,70.21791564747839,NaN,NaN,24.371135580936144,12.044743802083492
1999-11-08T09:30:00-05:00,68.4375,69.804685,68.21875,69.5625,10890796,18727869.3,74.62300578219143,60.46619321981884,NaN,NaN,152.05538580559337,152.52902087977276,0.7119346615521647,1.7759954971649634,1.0640608356127987,190574614,161011254.8,83.53276917574473,71.75859717528225,NaN,NaN,28.36842524766059,14.376698294308792
1999-11-09T09:30:00-05:00,70.125,70.25,68.5,69.09375,14629796,18450219.3,71.74390527217759,62.006503616000586,NaN,NaN,129.51847710797009,149.58190247167173,0.6828936395734853,1.9176778850796552,1.23478424550617,175944818,171050616,85.0838409631077,73.33597554104425,NaN,NaN,30.769762319541012,16.718564583627682
1999-11-10T09:30:00-05:00,69.125,70.59375,68.8125,70,16561000,18149739.2,73.84493104465135,63.429692536907204,NaN,NaN,121.50946436931795,142.94113861345903,0.6754703421686994,2.079122173217044,1.4036518310483448,192505818,180651656.8,86.40287315036709,74.93032054033836,NaN,NaN,33.462179570895934,19.11050958180886
1999-11-11T09:30:00-05:00,70.75,71.34375,70.125,71.25,18501398,17968289.2,76.44642463295139,65.12434382294823,NaN,NaN,126.24201388502144,137.66330005905164,0.7023835456322032,2.281631263088599,1.5792477174563957,211007216,189943256.8,87.55027372878163,76.43352670523164,NaN,NaN,36.62582383084293,21.61269733167087
1999-11-12T09:30:00-05:00,71.625,72.25,69.375,72.1875,28646602,17715468.9,78.19792661985055,66.93514080164873,NaN,NaN,120.17644773540842,129.90035778066226,0.7278634739127607,2.4890770598473466,1.7612135859345859,239653818,201937256.8,88.85738689451392,77.69095567548892,NaN,NaN,39.84964701759209,24.217975858231043
1999-11-15T09:30:00-05:00,72.25,72.5,71.6875,72.046875,10909398,17025199,77.26973179984924,68.84469189415339,NaN,NaN,125.84194418877631,124.65766945729885,0.6806469862396498,2.612022318734148,1.9313753324944982,228744420,209571218,89.60543622980198,78.87913574854694,NaN,NaN,42.16056004455238,26.78120217056266
1999-11-16T09:30:00-05:00,72.3125,74.21875,72,73.875,19126398,16648658.7,80.50873875412879,71.0171925636996,NaN,NaN,135.1047224375945,125.77491852322373,0.7144306531944258,2.8244136489875302,2.1099829957931044,247870818,223956418,90.85176126570475,80.26007765880524,NaN,NaN,45.30339597502688,29.427229856914693
1999-11-17T09:30:00-05:00,73.875,74.19531,72.5,72.875,21683602,16608518.9,74.27393816562737,72.1168498674525,NaN,NaN,118.50150859086199,125.17332736753254,0.615099989732129,2.878857982958266,2.263757993226137,226187216,230692697.6,91.37338161061535,81.8805107467106,NaN,NaN,45.960743399018725,31.789160362929554
1999-11-18T09:30:00-05:00,73.375,75.109375,72.9375,75.109375,17738398,16372699,78.31487625153768,73.01982748592408,NaN,NaN,127.04607548792765,125.33413968811378,0.6425512394440935,3.066947042531254,2.4243958030871604,243925614,237276377.2,91.86178583626577,83.44039064173928,NaN,NaN,47.92591291114017,34.094410726959644
1999-11-19T09:30:00-05:00,74.78125,75.90625,70.15625,75.78125,17939796,16440218.9,79.36451687346857,74.12363040200401,NaN,NaN,108.13174694743445,122.92519953051897,0.6468482923243792,3.2329561684926347,2.5861078761682554,261865410,241718695.6,92.18336246556001,85.08991221330145,NaN,NaN,49.843056563699356,36.34421727506532
1999-11-22T09:30:00-05:00,75.9375,77.5,75.125,77.5,18841602,16689529.1,81.79246197984497,75.39242285878319,NaN,NaN,146.2462798583397,127.00606666443166,0.7017423032963288,3.4632857552886662,2.7615434519923374,280707012,252111214,92.89107234934085,86.67200570237989,NaN,NaN,52.31549766653794,38.62582875956141
1999-11-23T09:30:00-05:00,76.4375,76.5,74.25,74.96875,24047602,17214789.3,68.92961538274504,75.47185875102873,NaN,NaN,108.48273026722372,121.68166823035752,0.5126473887288179,3.4023526879033597,2.8897052991745418,256659410,253868932.4,93.00640413073248,87.98891559739887,NaN,NaN,49.81525043527832,40.22431757037811
1999-11-24T09:30:00-05:00,75.1875,77.742185,74.40625,77.4375,18617796,17384418.9,73.33420195848163,75.72521271803362,NaN,NaN,122.0172823503035,122.38482298224581,0.4984575023618012,3.512777177126793,3.014319674764992,275277206,263686930.4,93.62822287043029,89.10494773553343,NaN,NaN,49.32317909781476,41.52415493144049
1999-11-26T09:30:00-05:00,78.40625,78.78125,77.375,77.6875,8045200,17081489.1,73.7401756744776,75.88460358514166,NaN,NaN,137.20586842572573,124.41678156980542,0.4519070294175087,3.5792034615368777,3.127296432119369,283322406,271566288.8,94.08292107079555,90.06510655298298,NaN,NaN,49.09276499861403,42.60538494103671
1999-11-29T09:30:00-05:00,77.53125,78.1875,76.3125,76.40625,20485204,17155849.3,68.02426124659546,75.41326468974195,NaN,NaN,105.812238671421,123.95287991460273,0.2887630351958337,3.488250226114161,3.1994871909183273,262837202,271760647.2,94.0941166011109,90.8194885119377,NaN,NaN,46.9432568060785,43.22508092175697
1999-11-30T09:30:00-05:00,76.5625,76.6875,73.9375,74,23697796,17856649.3,58.805160848827555,74.48906865950266,NaN,NaN,57.23720327484961,106.1510645979047,-0.011360262773719043,3.1852868624511785,3.1966471252248976,239139406,263447126,86.55060132519864,90.92425710922991,NaN,NaN,41.77980634783538,43.01861312548246
1999-12-01T09:30:00-05:00,74.3125,75.46875,73.75,75.09375,23205796,18375199.3,61.36806948423077,73.59786426232976,NaN,NaN,49.12274685545511,94.279067915551,-0.15821885969389626,2.9988735506075272,3.1570924103014235,262345202,264584284.4,86.70757833532987,90.9460217652987,NaN,NaN,38.53063529234805,42.37747343503469
1999-12-02T09:30:00-05:00,75.375,77.625,75.328125,77.47656,17229204,18299029.4,66.28871076832877,72.87231327199957,NaN,NaN,90.70971012766172,88.01755347102264,-0.11869013039770948,3.0087297473042867,3.127419877701996,279574406,265443724.4,86.83266481177913,90.8947639855128,NaN,NaN,37.48660621722758,41.6787781182051
1999-12-03T09:30:00-05:00,79.3125,80.1875,78.90625,79.125,21444602,18368829.4,69.21048439623277,72.23035311316974,NaN,NaN,143.52863622782272,89.28210703144202,-0.011004856221552561,3.1136638074250556,3.124668663646608,301019008,268983044.8,87.36018136467767,90.78782073338164,NaN,NaN,37.66055082577762,41.104745647858316
1999-12-06T09:30:00-05:00,79.429685,80.5,78.6875,79.84375,16018398,18413019.2,70.41451970762881,71.74069510658256,NaN,NaN,138.3622462496462,95.79210854708705,0.07444901827862616,3.217729936494891,3.1432809182162647,317037406,279823085.6,88.83546210804735,90.73282258182773,NaN,NaN,38.19973574008727,40.68974423246245
1999-12-07T09:30:00-05:00,80.09375,80.40625,78.835935,79.84375,23397000,19038329.4,70.41451970762881,71.01967946040399,NaN,NaN,127.21623519807545,109.78791493173223,0.09545041860745718,3.2625939414755862,3.167143522868129,317037406,295402685.6,90.54375594228097,90.71082220158317,NaN,NaN,38.618062775596925,40.39378973862452
1999-12-08T09:30:00-05:00,79.867185,80.492185,78.6875,78.875,19563000,19284989.6,66.3581822942675,70.45426832673543,NaN,NaN,106.90422892608001,121.3442113458572,0.012912416034215557,3.1832840429108984,3.170371626876683,297474406,302428526.4,91.19784588944536,90.69828393578531,NaN,NaN,37.72942746101999,40.01316655610959
1999-12-09T09:30:00-05:00,80,80.4375,77.25,79,28444398,19879159.5,66.62534242741093,69.6193016250121,NaN,NaN,86.04008194956647,120.41028571023817,-0.060424160111514524,3.0948414267372897,3.155265586848804,325918804,311697406,91.98545592795449,90.70711751376307,NaN,NaN,37.090376342392545,39.59562509700715
1999-12-10T09:30:00-05:00,79.90625,80.1875,78.125,79.5,20427602,19975469.7,67.72928248996053,68.78821345476152,NaN,NaN,89.036045095203,109.51176748371422,-0.10007969311415499,3.0301659704561104,3.1302456635702653,346346406,320762885.6,92.67574930004963,90.7422880019409,NaN,NaN,36.864768426077646,39.205502715445796
1999-12-13T09:30:00-05:00,79.63281,81.335935,79.28125,80.992185,16209204,19353599.8,70.83025978404514,68.00519901220439,NaN,NaN,118.06844111824137,105.45300645743323,-0.05299876157769301,3.0639972115981493,3.1169959731758423,362555610,329866526.4,93.29984178380292,90.7714858186882,NaN,NaN,37.566221201322826,38.971319641999656
1999-12-14T09:30:00-05:00,80.75,81.21875,79,79.53125,27760000,20196129.9,64.31413619672153,67.67552192748842,NaN,NaN,90.10884545725659,98.03152850926946,-0.142361579136419,2.9390439992553183,3.0814055783917373,334795610,333418167.2,93.53141773822885,90.80898679065224,NaN,NaN,36.23429811616006,38.580316566879716
1999-12-15T09:30:00-05:00,78.625,81,77.9375,81,31796602,20829640.1,67.5465910622119,67.26212114918344,NaN,NaN,83.19762068618994,93.29020686129145,-0.1252700254545509,2.9248180465735487,3.0500880720280996,366592212,347241728.4,94.34995079142095,90.8605387850087,NaN,NaN,36.058605231948654,38.220072090460995
1999-12-16T09:30:00-05:00,82.125,83.25,81.75,83.125,27217602,21106340.1,71.56039013671405,67.10642218220032,NaN,NaN,155.51110509198756,107.18441148977566,-0.00018504412155095906,3.049856766876161,3.050041810997712,393809814,360819930.4,95.01695548748064,90.92725552905765,NaN,NaN,37.19097907085799,38.07305880194628
1999-12-17T09:30:00-05:00,84.5,84.875,83.429685,83.78125,23892398,21414040.1,72.68397995327322,67.43925923267732,NaN,NaN,175.9075557739477,124.55871362552462,0.09229919208901283,3.1654158011089777,3.073116609019965,417702212,375091091.6,95.604316130061,91.03512692398267,NaN,NaN,38.462120606913444,38.128639059798736
1999-12-20T09:30:00-05:00,84.40625,85.25,83.6875,84.875,15391398,21286620.2,74.49274173292355,68.55980072439846,NaN,NaN,178.50229835344072,136.64548507256447,0.18721159574434765,3.3071311037003994,3.1199195079560518,433093610,389198691.6,96.09440595359423,91.71682725458234,NaN,NaN,40.092728441629255,38.409223257203095
1999-12-21T09:30:00-05:00,85.125,88.75,84.640625,88.6875,26003398,21644710,79.57074474569922,69.85999181450335,NaN,NaN,223.57548251349957,163.3388124838131,0.4517480430862775,3.6846045618138987,3.2328565187276213,459097008,414058971.2,96.776461376748,92.43603318611223,NaN,NaN,43.42758009118634,39.12613137634356
1999-12-22T09:30:00-05:00,89.1875,89.3125,87.4375,89.15625,22313602,21558010,80.09542909051433,70.84618598037375,NaN,NaN,208.60975848291963,188.421240043159,0.5943141785919988,3.9757492419676197,3.381435063375621,481410610,437022650.8,97.25357373275223,93.18038382332459,NaN,NaN,46.20735961786462,40.13773541084657
1999-12-23T09:30:00-05:00,89.867185,90.75,89,89.65625,17542000,21504220.2,80.66583548832534,71.66442534409465,NaN,NaN,185.06138814360057,194.33129665348162,0.6535978729577083,4.198432404572756,3.544834531615048,498952610,458051210,97.60338850536046,93.91204147623048,NaN,NaN,48.612564021561056,41.34842521237721
1999-12-27T09:30:00-05:00,90.3125,93.57031,87.90625,89.6875,19282796,22066100,80.70305621096867,72.39932080861891,NaN,NaN,158.6412228496754,190.87803006862714,0.62616978576929,4.3275467638266605,3.7013769780573704,518235406,478157848.8,97.88127047154339,94.55817064505163,NaN,NaN,50.538941539559076,42.66135611626033
1999-12-28T09:30:00-05:00,89.75,90.5,88.5625,89.1875,15345398,21809109.7,78.11197124182077,72.94913877534691,NaN,NaN,120.8116833778424,179.3399070735075,0.5104999579362679,4.339501925477705,3.8290019675414375,502890008,492117128.4,98.05029145827814,95.09435175333715,NaN,NaN,51.40745639820248,43.91079901368064
1999-12-29T09:30:00-05:00,90,92.5,89.875,92.5,16512398,21449839.8,82.19134394549735,74.0800788932919,NaN,NaN,135.79926460520625,161.78466349184882,0.5877268307413313,4.563660505968102,3.9759336752267704,519402406,504178208,98.18501572862449,95.5934353132785,NaN,NaN,53.55564114102796,45.28863360330168
1999-12-30T09:30:00-05:00,93.625,93.75,91.5,91.5,21887000,21383900,77.49572060886047,74.85653447768115,NaN,NaN,127.39657344019028,145.54202648330292,0.5052560346465951,4.607503718535014,4.102247683888419,497515406,507399167.2,98.22038179110825,96.03878716064663,NaN,NaN,53.847574069426116,46.5113393841766
1999-12-31T09:30:00-05:00,92.625,93.1875,91.375,91.375,14453204,21245100,76.90427832807816,75.51189132326098,NaN,NaN,109.2760007673256,130.38494900804795,0.3817019640859618,4.5793751389958715,4.19767317490991,483062202,504221085.6,96.22796744418379,96.29251702808479,NaN,NaN,53.90437592414498,47.56748746131494
2000-01-03T09:30:00-05:00,96.1875,96.1875,90,94.75,36358016,21990770.7,81.09872119160059,76.2453528523721,NaN,NaN,116.47828655493856,121.95236174910056,0.4613664489228988,4.774381236063533,4.313014787140634,519420218,504458048,96.23410147192104,96.5021070058075,NaN,NaN,55.33861604644598,48.67764868776223
2000-01-04T09:30:00-05:00,92,93.5,87.9375,88.00781,33782784,22878990,58.31461290449886,75.81681547435618,NaN,NaN,57.26306886266938,109.24263884606596,0.017521265689557808,4.334916369252582,4.317395103563024,485637434,501007533.2,93.84104860432596,96.52422349624301,NaN,NaN,47.574008356111044,48.51998578324063
2000-01-05T09:30:00-05:00,87.5,90.03125,84.25,86.1875,42498400,23834060,53.91085626527952,74.84283441743243,NaN,NaN,11.383860783975466,84.3595580818198,-0.4171195888159174,3.7959956175431273,4.213115206359045,443139034,485754858.8,83.90818620741919,95.77838316881432,NaN,NaN,39.903034085039366,47.28899268349759
2000-01-06T09:30:00-05:00,86.875,88,80,80.75,37009408,24706380.4,43.37394277571297,72.8295167487895,NaN,NaN,-51.11515833641276,48.65721172649919,-1.0530966720562183,2.8967443662887717,3.94984103834499,406129626,467477702.8,73.82429446127848,94.26462166694272,NaN,NaN,28.798379704641885,44.64747654366106
2000-01-07T09:30:00-05:00,82.9375,88.5,82.5,88.5,28129398,24690630.4,56.4415649402391,71.66934424785849,NaN,NaN,-1.8793716580609878,26.426137241421873,-0.9379327714001913,2.777425074094751,3.715357845494942,434259024,457717067.2,69.05172212454639,92.36800780940597,NaN,NaN,25.090901075521586,41.85368004821256
2000-01-10T09:30:00-05:00,91,93.9375,89.9375,92.25,29672204,25152860.5,61.11730974177645,70.71395624849085,NaN,NaN,85.84224667358374,20.298929265150967,-0.6111382527890608,2.951435029508616,3.562573282297677,463931228,446619269.2,63.98664617741941,90.07459639682205,NaN,NaN,24.39710442060003,39.3598835299822
2000-01-11T09:30:00-05:00,91.75,92.875,87,88.25,32512602,25968030.4,54.40831825821255,68.91664007081322,NaN,NaN,32.66585379464343,15.37948625154578,-0.6620228583662193,2.7350447093399026,3.397067567706122,431418626,435775507.6,59.40166169317605,87.40496784799548,NaN,NaN,21.02462341269808,36.74056065608447
2000-01-12T09:30:00-05:00,89,89.242185,86,86.5625,29047204,26032390.6,51.823736882119704,66.89723348449932,NaN,NaN,-17.358174693805545,9.631079155989578,-0.7978747354308822,2.399724148417519,3.1975988838484013,402371422,427621985.2,56.14402918304261,84.4685718087305,NaN,NaN,17.546822092408952,33.99859800413083
2000-01-13T09:30:00-05:00,88.5,91.5,87.078125,91.25,25163204,25700720.7,57.81798134011596,65.26524390248436,NaN,NaN,35.2228258466463,26.89867599260139,-0.5712047475408903,2.483592949422288,3.0547976969631785,427534626,431902985.2,57.46305835437861,81.60140536937466,NaN,NaN,17.101090000953086,31.58466828939115
2000-01-14T09:30:00-05:00,93,93.625,92,92.6875,21898000,25434740.6,59.48289237337651,63.749517914084926,NaN,NaN,101.65768242187612,47.60608680858881,-0.3353010094774511,2.6356714351163646,2.9709724445938157,449432626,434937705.6,58.41781161980232,78.78258687996458,NaN,NaN,17.380145812419936,29.555450792680976
2000-01-18T09:30:00-05:00,92.0625,94.4375,91.4375,94,16749000,25077570.7,60.99660094568167,62.526991464360705,NaN,NaN,110.18802929604452,52.47524333308097,-0.11318918860667093,2.829485958835477,2.9426751474421478,466181626,435387785.2,58.566348203506344,75.96230521890945,NaN,NaN,18.120524766012526,27.92188993172834
2000-01-19T09:30:00-05:00,93.492185,96,92.429685,95.28125,18995602,25257780.9,62.47059184008159,61.118366313973866,NaN,NaN,135.55243303949803,73.0525591820519,0.08689833615149833,3.051298067631521,2.9643997314800226,485177228,446139505.6,62.053502045234104,73.38148281295298,NaN,NaN,19.191893859045113,26.674747635630737
2000-01-20T09:30:00-05:00,95.5,96.875,94.00781,95.5,25955602,25255391.1,62.72956554279844,60.06364095211229,NaN,NaN,141.0240092105356,104.72899596292011,0.19468821341893605,3.2077599982536924,3.0130717848347564,511132830,467891787.2,67.93354369210428,71.21813723445275,NaN,NaN,20.111518931691084,25.73714353506793
2000-01-21T09:30:00-05:00,96.5,96.5625,95.0625,96.25,18696204,25074521.2,63.655583765925975,59.117305626244274,NaN,NaN,134.15496257394253,124.51542330837938,0.2724365899444656,3.3536175222653384,3.0811809323208728,529829034,488350668.8,72.28370733702292,69.5078329410841,NaN,NaN,21.13412391657429,25.07956930385455
2000-01-24T09:30:00-05:00,97.4375,97.625,90.96875,91.25,28337204,25614281.4,54.019528324594546,57.18307756431527,NaN,NaN,58.802232165206284,115.9443332570454,-0.04029266761333172,3.030815097804208,3.0711077654175396,501491830,498762509.6,74.20181957163645,67.93409851963521,NaN,NaN,19.018403713465034,24.213688505227477
2000-01-25T09:30:00-05:00,91.875,94.117185,89.40625,93.15625,33273398,26313811.5,56.710096133982255,57.06846922356409,NaN,NaN,29.503600262985692,99.80744745043363,-0.14053938108333108,2.895433539063376,3.035972920146707,534765228,512479230,76.50835319598993,66.6960488476112,NaN,NaN,18.1078580628627,23.34142701346108
2000-01-26T09:30:00-05:00,93.25,93.3125,89,89.5,23090000,26701041.6,50.59480476353209,56.8316084020107,NaN,NaN,-13.314543636313958,70.03405211527124,-0.4570164913281607,2.4647023059865063,2.921718797314667,511675228,517778830,77.35090957053515,66.22767194497662,NaN,NaN,15.345554201607536,22.199159468910572
2000-01-27T09:30:00-05:00,91.75,92.5,87.625,90.5,30730204,27411931.9,52.11569801161418,57.45601949028935,NaN,NaN,-21.51982218360032,37.52528583644404,-0.5942397419402132,2.1789191198894002,2.7731588618296135,542405432,524033350.4,78.33835378572599,66.55010475386574,NaN,NaN,13.588180002297268,20.969019545108672
2000-01-28T09:30:00-05:00,90,90.46875,84.75,85.75,35313600,28083261.9,45.025435327165546,56.6405816607841,NaN,NaN,-92.33572227729357,-7.772851133803174,-0.9775138508883847,1.5512665482191323,2.528780399107517,507091832,519485910,75.7524280548871,67.02872660603293,NaN,NaN,9.691314836886582,19.357918872505515
2000-01-31T09:30:00-05:00,85.875,90,83.5,90,36012192,29161211.3,51.39688004165875,55.94626525363283,NaN,NaN,-65.09679912379504,-32.55265739160344,-0.9183290827670012,1.3808690456487653,2.2991981284157665,543104024,527808348.8,77.23359605782929,67.97493731177649,NaN,NaN,8.468683170647784,17.802313772240126
2000-02-01T09:30:00-05:00,89.53125,92.5,88.4375,92.5,26416602,28664140.6,54.721228335142804,55.968615973413556,NaN,NaN,17.254488859204464,-35.002479672359684,-0.694510079636836,1.4310605288697218,2.1255706085065578,569520626,534759428.4,78.41933018601318,69.33334220412199,NaN,NaN,8.569523477714656,16.48334373016506
2000-02-02T09:30:00-05:00,92.25,94.71875,92.09375,92.875,26169204,28283461.6,55.216040987682696,56.2109234095252,NaN,NaN,62.62001401367346,-19.815568142362196,-0.5132640961418766,1.483990488329212,1.9972545844710887,595689830,551562348.8,80.9959808071338,71.1084816058428,NaN,NaN,8.802674330466052,15.386105244493773
2000-02-03T09:30:00-05:00,94.3125,96.625,92.28125,96.125,30578602,27687471.7,59.361049440405765,56.32114255954591,NaN,NaN,95.96483597742237,3.68136348984234,-0.18355765435386107,1.7678075165287623,1.9513651708826234,626268432,568334948.8,83.15766928971897,72.94381095836712,NaN,NaN,10.31590209308674,14.661790508578482
2000-02-04T09:30:00-05:00,97,98.242185,96.21875,96.90625,26636204,27168811.5,60.311990516899876,56.38036385551187,NaN,NaN,139.00450521978934,49.94940898925892,0.06478567751694397,2.0323472677788033,1.9675615902618593,652904636,597497509.6,86.11502015325843,74.92218299647114,NaN,NaN,11.825215915306645,14.256565566682506
2000-02-07T09:30:00-05:00,97.25,98.5,96.25,98.40625,17760000,26650341.6,62.14361393308037,56.46229335461177,NaN,NaN,142.21926691164595,91.41262219634712,0.29483490673754265,2.336105223683788,2.041270316946245,670664636,623009632,88.0859287000977,77.03072446051337,NaN,NaN,13.63015686868735,14.167078609826055
2000-02-08T09:30:00-05:00,99.375,102.25,99.375,102.25,21984796,26265971.2,66.42025516210076,56.74441216332743,NaN,NaN,194.06844944030107,126.77541431256643,0.6502588472797877,2.8540938760459795,2.203835028766192,692649432,647635393.2,89.61784944944567,78.99960641795704,NaN,NaN,16.56849015226029,14.510137401602373
2000-02-09T09:30:00-05:00,102.0625,102.19531,98.75,99,27294204,26005051.3,60.22507517342838,56.56551999408672,NaN,NaN,144.95403920944332,143.2422193517204,0.6114446935398865,2.96814089569105,2.3566962021511637,665355228,661568472.8,90.372155045212,80.60236437175045,NaN,NaN,17.173098678873792,14.890560441212576
2000-02-10T09:30:00-05:00,99.8125,102.25,98.554685,102.1875,26340204,25869701.3,63.792115774195665,56.575272280391694,NaN,NaN,144.90882340806564,153.03101683784908,0.7369970467285092,3.2779425105618003,2.540945463833291,691695432,674653872.8,91.03120547799436,81.94147138181984,NaN,NaN,18.826932392147448,15.45289929134613
2000-02-11T09:30:00-05:00,102.0625,102.0625,98,99,24875000,25855291.1,58.1737450583711,56.87200204709002,NaN,NaN,105.07577981609568,146.24527175711032,0.5504721081456792,3.22903559901539,2.6785634908697107,666820432,677437032,91.16965861032183,83.15345988458309,NaN,NaN,18.435419545065788,15.878973613306082
2000-02-14T09:30:00-05:00,99.992185,100,97.75,99.359375,22813796,25901080.9,58.6162877599947,57.00815859180519,NaN,NaN,82.34286685440725,134.2699917456626,0.4032197535904367,3.1825881828577565,2.7793684292673198,689634228,681230950.4,91.36533958084918,84.21467319778732,NaN,NaN,18.257892741200305,16.218819203005257
2000-02-15T09:30:00-05:00,98.9375,100.625,95.875,100.25,30571796,26592220.7,59.75279862585985,57.66230101054289,NaN,NaN,72.2849250425901,109.91328686612039,0.32128602013781515,3.180975954439589,2.8596899343017737,720206024,686742268.8,91.65465243368277,85.23636911658357,NaN,NaN,18.442373404957497,16.53646980328415
2000-02-16T09:30:00-05:00,99.90625,101.6875,99.3125,100,25309398,26907910.5,59.260825192229596,58.172667237729705,NaN,NaN,88.24110020306425,98.57069906484459,0.21106353603559835,3.1235193543462714,2.912455818310673,694896626,692650548.4,91.96544768131743,86.20973296626869,NaN,NaN,18.457086895936218,16.810843673663015
2000-02-17T09:30:00-05:00,101.1875,103.25,99.625,101.875,30076602,27113960.5,61.80109727416529,59.37092880537255,NaN,NaN,97.80104968518367,89.14914432026819,0.22401973494118232,3.192480486987151,2.9684607520459685,724973228,699306107.6,92.3127511152593,87.3926131848667,NaN,NaN,19.178331809308187,17.14905626446947
2000-02-18T09:30:00-05:00,102.625,103,98.4375,98.8125,25269000,27442600.3,55.692718828579245,59.67777443300973,NaN,NaN,66.57955231054109,81.44989881915727,-0.0021075407574908667,2.965826326099105,2.9679338668565958,699704228,705882866.8,92.65081490336392,88.49384310240488,NaN,NaN,18.05436071004439,17.278385470980172
2000-02-22T09:30:00-05:00,99,99.9375,96.25,98.65625,37227008,27887090.5,55.391900269772,59.72567957119753,NaN,NaN,34.67630344416183,71.91658613710817,-0.1807588520900012,2.7419853017440943,2.9227441538340955,662477220,700451465.2,89.16343576988206,89.26127921553837,NaN,NaN,17.051753137790744,17.246009423381683
2000-02-23T09:30:00-05:00,99.679685,105,99.15625,104.125,32167602,27831800.7,62.937498284781185,60.277212235276,NaN,NaN,98.39209654310346,77.13802043721084,0.03909839318930031,2.971617145320721,2.9325187521314207,694644822,695339224.8,85.88656590164565,89.61060672228923,NaN,NaN,18.407214438402725,17.411895854098976
2000-02-24T09:30:00-05:00,104.875,106.804685,102,106.5,48862400,29120420.7,65.65461652840614,60.72675274156172,NaN,NaN,128.86684143652909,85.26316868390381,0.2996827906820112,3.3071222404839347,3.0074394498019235,743507222,705061344,86.87448865601701,89.87609381988193,NaN,NaN,20.40153980357541,17.838987846881324
2000-02-25T09:30:00-05:00,106.1875,107.5,103.875,104.1875,32615796,29214700.3,60.96780812123935,60.77359685615739,NaN,NaN,124.89940852041525,90.68284045095012,0.2723055766093112,3.3478214205635624,3.075515843954251,710891426,702244983.6,85.01791279892329,89.797729008858,NaN,NaN,20.6515581228524,18.240783600591477
2000-02-28T09:30:00-05:00,103.25,105.6875,100.5,103.75,38215808,29359810.7,60.093785857214705,60.627180565024126,NaN,NaN,90.75366041202477,95.51766207124686,0.18491224211854718,3.3066561466024353,3.121743904483888,672675618,696839261.6,81.42118146169247,89.3216756346862,NaN,NaN,20.597463290591698,18.577452127734364
2000-02-29T09:30:00-05:00,105.75,107.09375,104.9375,107,23975000,28757951.1,64.19960418553794,60.468562638126784,NaN,NaN,151.44718147007626,118.87183767642975,0.2993894519837945,3.495980719463631,3.1965912674798367,696650618,703673941.2,82.43309178907998,88.80847865894579,NaN,NaN,21.79595043533153,19.037237600248247
2000-03-01T09:30:00-05:00,107.25,108.5625,106.5,107.625,24466398,28660440.9,64.94652004222316,60.80580870018355,NaN,NaN,163.66450508893848,131.92631938559674,0.3661903870205907,3.654329251255575,3.2881388642349845,721117016,708968380,83.19658964929494,88.29593827352315,NaN,NaN,22.992922514616723,19.60233544515803
2000-03-02T09:30:00-05:00,108.0625,108.1875,104.75,105.13281,32739204,28988940.9,59.606269776729356,60.50681970036453,NaN,NaN,114.76548176934574,129.1060474521601,0.19984053579941818,3.5379395339842574,3.3380989981848392,688377812,697942498,75.80731671971733,87.20851764793193,NaN,NaN,22.456367011734873,20.010054240383294
2000-03-03T09:30:00-05:00,108,111.125,107,109.523435,32014796,29060750.6,65.05744630247257,60.998512646371786,NaN,NaN,163.62309803537664,136.85078535515237,0.3348663194986736,3.756681897558181,3.4218155780595074,720392608,699842734.4,76.19965298077778,86.13923153153594,NaN,NaN,23.687748224950436,20.535439095321458
2000-03-06T09:30:00-05:00,111.75,113.21875,110.25,111.5,23269000,28892390.4,67.20318759768492,61.61186263477823,NaN,NaN,183.2911850744578,155.358290287639,0.4968873402544327,4.042924753377548,3.5460374131231154,743661608,714039932.4,78.94674579584006,85.252189118321,NaN,NaN,25.386143664446,21.228396890910677
2000-03-07T09:30:00-05:00,113.8125,113.875,108.75,109.75,39467392,29977760,63.48601750829054,61.87852112638041,NaN,NaN,142.18201524574343,153.50525704277243,0.428381863854407,4.081514742941124,3.653132879086717,704194216,715548652,79.22121945771971,84.36408676289507,NaN,NaN,25.661669696928207,21.86172157748461
2000-03-08T09:30:00-05:00,111,112,106.28125,111.5625,43508384,31053939.4,65.6078290228208,62.331878542851214,NaN,NaN,109.25514345256956,142.62338471549862,0.4453520737803234,4.209822971312121,3.764470897531798,747702600,720865768.8,80.20088873767213,83.52376112406326,NaN,NaN,26.535844369845424,22.529453404964727
2000-03-09T09:30:00-05:00,111.21875,115,109.09375,115,30096796,31194069,69.2566170088331,62.86441566675607,NaN,NaN,142.54103390586715,148.17849514280292,0.6176958377519521,4.536590694721738,3.918894856969786,777799396,738750085.6,83.08897523631202,82.86491998985274,NaN,NaN,28.450634009214603,23.375336348428995
2000-03-10T09:30:00-05:00,114.875,116.4375,113.50781,114.6875,29668398,31360478.7,68.54465855094502,63.782411361210755,NaN,NaN,151.05129958210088,145.66413545214775,0.6376660973440265,4.715977478649819,4.0783113813057925,748130998,744297763.6,83.87474388344637,82.23805777414434,NaN,NaN,29.773919068066025,24.289419594091427
2000-03-13T09:30:00-05:00,110,114.125,109.53125,111.1875,37543808,31993919.1,60.983188850494585,64.18178911697666,NaN,NaN,89.92089736827087,126.99007791091037,0.3562125489079815,4.523577067440769,4.167364518532787,710587190,737682880,79.15212403244786,81.52296407861333,NaN,NaN,28.612846761931365,24.90705204663999
2000-03-14T09:30:00-05:00,112.75,113.375,105,107,39103808,32808419.7,53.39398232723197,63.50010940572315,NaN,NaN,35.8765710410313,105.72898906996792,-0.14409986708958122,3.9872396846708114,4.131339551760393,671483382,731140713.2,74.67391081249535,80.72206014367403,NaN,NaN,25.105539688337707,24.935407424025378
2000-03-15T09:30:00-05:00,106.5,107,101.875,102.96875,51199616,33839810.7,47.2923413241872,62.188518319707505,NaN,NaN,-44.17101497283299,75.04375738488743,-0.7450616349831547,3.200012508031449,3.9450741430146037,620283766,705656946.4,60.350411737481714,78.82748322092151,NaN,NaN,20.00854194408571,24.23156949831971
2000-03-16T09:30:00-05:00,105.375,109.25,101,108.5,55280384,35338360,54.90671899327449,61.75558338199573,NaN,NaN,-10.230546594507846,44.489441284812415,-0.7656505013949606,2.988011016270903,3.7536615176658636,675564150,685209897.2,51.769966655646336,76.45262992497317,NaN,NaN,18.192294617607814,23.368815943932297
2000-03-17T09:30:00-05:00,108,111.0625,107.9375,110.8125,31422204,35405640.1,57.66061996996458,61.58178581862072,NaN,NaN,51.92260180072695,24.663701728537657,-0.6250616074959812,2.972334508295887,3.5973961157918684,706986354,676980968.4,48.76502935543391,74.12004763166898,NaN,NaN,17.678991662978895,22.555983903796097
2000-03-20T09:30:00-05:00,111,111.5,106.25,107.25,21164400,35200410.1,52.35592810713327,60.73580895587753,NaN,NaN,14.82582488580783,9.644687232045044,-0.7643236511849762,2.641991551810648,3.406315202995624,685821954,672027921.2,46.99679581574741,71.58888363357379,NaN,NaN,15.434204917980832,21.538586905822488
2000-03-21T09:30:00-05:00,106.125,111.875,103.5625,111.5,33431296,35010624.5,57.391987787945375,60.196199509143405,NaN,NaN,20.053995505516582,6.480172124942101,-0.5713729477073648,2.692099018361418,3.2634719660687828,719253250,681581894.8,50.70950209707106,69.26837737984351,NaN,NaN,15.2899393715283,20.64592297235189
2000-03-22T09:30:00-05:00,113.5,115.96875,111.125,114,24334192,34618954,60.065983761896945,60.22903622236966,NaN,NaN,124.85323313763998,40.285021747036694,-0.290691162204602,2.90010801331303,3.190799175517632,743587442,706242630,58.742815676046355,68.04948444815274,NaN,NaN,16.078586308599206,19.993446306101507
2000-03-23T09:30:00-05:00,114.48437,117.75,113.5625,116.375,19226896,33137178.8,62.47530617909457,60.04459764212837,NaN,NaN,157.19535156517108,73.77020137897247,0.02295029885954758,3.2194870490920664,3.196536750232519,762814338,723692667.6,63.300709588049834,67.12813134867217,NaN,NaN,17.51659126587065,19.639609871782813
2000-03-24T09:30:00-05:00,117.48437,120.5,115.01562,117.875,22062400,32609509,63.95446803555594,59.81254624483345,NaN,NaN,173.4760283527729,98.08088668938167,0.2849158781596932,3.5526815979321356,3.2677657197724423,784876738,739270744.4,66.82431070494883,66.26224312789421,NaN,NaN,19.146893197793084,19.569221775498566
2000-03-27T09:30:00-05:00,118,119.5,117.125,117.35937,11752199,31286328.55,63.034634201448384,59.78030458005901,NaN,NaN,154.6714502398097,126.05001176018204,0.3714771687141698,3.7321121806651547,3.360635011950985,773124539,756731261.4,70.26982800715685,65.62285802428258,NaN,NaN,20.177991980376472,19.65618894762398
2000-03-28T09:30:00-05:00,116.98437,117.8125,114.375,115,18334096,31004283.35,58.862845523654585,59.29852004440427,NaN,NaN,95.19156979055127,141.077526617189,0.22505091224523266,3.6419486522575255,3.416897740012293,754790443,763838700,71.56443241841305,65.00596828719264,NaN,NaN,19.811542271335355,19.67838227958275
2000-03-29T09:30:00-05:00,115.375,115.4375,110,110.5,27189296,31140428.25,51.81866569627711,58.052952093507415,NaN,NaN,14.345152972883323,118.97591058423765,-0.19685446090723335,3.1708296638782514,3.3676841247854847,727601147,760641441,70.08593717656201,64.07717985435336,NaN,NaN,17.269879245107088,19.334310417514796
2000-03-30T09:30:00-05:00,107.25,112.75,103.5,107.25,42319696,31619452.85,47.40621380788141,56.54306318328859,NaN,NaN,-78.4684595379994,71.84314836360356,-0.6890870797453097,2.5063252751038476,3.1954123548491573,685281451,745134863.6,63.25982384709441,62.6046855660425,NaN,NaN,13.697364857602365,18.529032480384448
2000-03-31T09:30:00-05:00,108.14062,110.625,104,109.5,31348896,31586157.85,50.54585688350639,55.79753947136086,NaN,NaN,-71.20988517982231,22.90596565708452,-0.8470280866187663,2.1366272465756992,2.9836553331944655,716630347,731485585.4,57.91298632289715,61.08760430107459,NaN,NaN,11.69992958033787,17.553446351806365
2000-04-03T09:30:00-04:00,107.76562,109.125,100.75,103.5,31536608,31999538.25,43.14866882426596,55.06573136400614,NaN,NaN,-128.63334757692434,-33.75499390626229,-1.3117272370022328,1.3439962869416746,2.6557235239439074,685093739,713879425.4,51.8278307873783,59.455741442137665,NaN,NaN,7.420315980797569,16.105856298805108
2000-04-04T09:30:00-04:00,103.625,103.9375,88.3125,100.75,66194128,33335875.05,40.24180507182338,54.56212163169443,NaN,NaN,-212.51524425511934,-95.29635671539641,-1.7339390523872469,0.4882997084598486,2.2222387608470955,618899611,686701259,44.12091783520834,58.29649187768957,NaN,NaN,2.943123703321548,14.225465928021743
2000-04-05T09:30:00-04:00,97.5,103.9375,96.25,99,37005104,33010711.05,38.465886462211785,53.38777645090424,NaN,NaN,-151.30662843284938,-128.42671299654296,-2.03961792661942,-0.32728364742717986,1.7123342791922402,581894507,657559931,37.65520633538322,57.28829471195649,NaN,NaN,-1.2529131096961514,12.014268922633473
2000-04-06T09:30:00-04:00,102.375,103.875,99.75,102.3125,30496896,33030716.05,43.54459890810086,52.379489232199695,NaN,NaN,-105.1011195310596,-133.753244995155,-1.928506394353581,-0.6982987137497361,1.2302076806038449,612391403,642981921.4,34.899902046261005,56.297928475587,NaN,NaN,-3.1986574350984807,9.840993728671766
2000-04-07T09:30:00-04:00,104.125,107.375,102.625,106,20645296,32579560.95,48.62768683570509,52.11318628424054,NaN,NaN,-51.58521493089293,-129.8283109453691,-1.5336562798901734,-0.686862669258872,0.8467936106313014,633036699,626263191.8,32.00733290477906,55.227252553374974,NaN,NaN,-3.2171159286005815,7.975549491918573
2000-04-10T09:30:00-04:00,107.625,107.6875,99.25,100,26985200,32051630.55,42.00114215960653,51.01384016793062,NaN,NaN,-87.74733714754325,-121.65110885949291,-1.5964011198391457,-1.1487077891676307,0.44769333067151496,606051499,610454743.8,29.51623315770027,53.7134476291342,NaN,NaN,-5.470324526654721,6.054710346408102
2000-04-11T09:30:00-04:00,97.125,101.5,95.75,97.73437,34495600,31821220.15,39.7958615920143,49.565974298653295,NaN,NaN,-125.69793447534973,-104.28764690353898,-1.7007111336336966,-1.678195586370606,0.022515547263090685,571555899,600986001.4,28.105265456679675,51.525051184893734,NaN,NaN,-8.010933772174862,4.045332615181964
2000-04-12T09:30:00-04:00,97.625,98.75,63.125,92,34824896,31002484.15,34.813534093564485,47.590133435401135,NaN,NaN,-243.14831792936585,-122.65598480284227,-2.043095908355014,-2.5313543381806767,-0.4882584298256628,536731003,591953300.6,26.789637817275533,48.917117486981276,NaN,NaN,-11.92026261549166,1.7645332965143035
2000-04-13T09:30:00-04:00,92.8125,96,88.25,89,46323808,30554655.35,32.51970437613021,45.34479317401359,NaN,NaN,-144.40596874968892,-130.51695464656814,-2.3375952210316884,-3.4102524561152734,-1.072657235083585,490407195,567556459,23.579129952185795,45.82817600464106,NaN,NaN,-15.869165613421949,-0.754566547762304
2000-04-14T09:30:00-04:00,86.0625,88.5,78,79.75,60840400,32025565.15,26.682060604669275,42.74818077424366,NaN,NaN,-188.4683210923967,-157.8935758788689,-2.9801752596915754,-4.797876309698054,-1.817701050006479,429566795,526862478.2,19.402342975500872,42.19478421666564,NaN,NaN,-21.591459795134213,-3.731265583101148
2000-04-17T09:30:00-04:00,78.01562,90,78,89,55386192,33736654.75,38.55967423278171,41.29795425346702,NaN,NaN,-134.6850240604293,-167.2811132614461,-2.61982124364266,-5.092477604559804,-2.472656360917144,484952987,502642775.8,17.42406489107566,38.32761510757011,NaN,NaN,-21.962797180045193,-6.335770096950297
2000-04-18T09:30:00-04:00,89.48437,93,87.375,91.75,36252608,33877720.35,41.58928682065821,40.56728433377996,NaN,NaN,-86.24208631538119,-159.3899436294524,-2.0585816574069766,-5.045883432675865,-2.987301775268888,521205595,492572715,16.6633139253304,34.51171344676784,NaN,NaN,-21.14015653301213,-8.45068244495913
2000-04-19T09:30:00-04:00,92.5,93.625,89.0625,89.0625,28077904,34064905.95,39.53745051218756,40.00522981265897,NaN,NaN,-78.23722820305217,-126.40772568418967,-1.7431686170964449,-5.1662625466394445,-3.4230939295429996,493127691,483852052.6,16.01135074643973,31.136822511006795,NaN,NaN,-21.20072997325691,-10.272117806144527
2000-04-20T09:30:00-04:00,90.375,90.96875,86.1875,86.875,21252000,34166161.15,37.89849388452535,39.10184674130318,NaN,NaN,-87.12374951089943,-114.95128183643176,-1.5624875002946403,-5.3762033049113,-3.8137158046166597,471875691,480145751.8,15.729669991342504,28.123728487324325,NaN,NaN,-21.78688933559288,-11.91708516749429
2000-04-24T09:30:00-04:00,83.4375,85.25,79.875,85,31245600,34625321.15,36.50176982136775,38.62706824109616,NaN,NaN,-109.14189234354558,-99.08599608666154,-1.4522211006462298,-5.628992180424447,-4.176771079778217,440630091,482358411,16.672162408003885,25.612609317369003,NaN,NaN,-22.69721099281275,-13.457103142539784
2000-04-25T09:30:00-04:00,86.5,90.5,86,90.4375,28614304,35468426.4,43.0559678818175,38.82807987038145,NaN,NaN,-60.74106355566308,-84.29720398570828,-0.9218930561168026,-5.329137399924221,-4.4072443438074185,469244395,479216692.6,16.39183335416533,23.631960425865934,NaN,NaN,-21.35114009104756,-14.584822706612323
2000-04-26T09:30:00-04:00,90.625,92.42187,87.125,87.375,25679696,35835706.4,40.51920229301785,38.974745286867595,NaN,NaN,-53.90903173491247,-77.83059306961454,-0.6964281446375837,-5.277779524604398,-4.581351379966814,443564699,463688513.4,15.045306040305519,22.016967547646093,NaN,NaN,-21.041512364610057,-15.507206943469143
2000-04-27T09:30:00-04:00,83.5,92.48437,82.25,91.375,37032896,36327886.4,45.07133198242629,39.083797649319415,NaN,NaN,-50.26711396333088,-72.23657022167026,-0.22156523066990186,-4.858307918304192,-4.63674268763429,480597595,461182494.2,14.833528139059425,20.58365512570312,NaN,NaN,-19.33027132457083,-16.05335899791224
2000-04-28T09:30:00-04:00,93.5625,94.75,92.125,94.5,24826704,35453236.8,48.39418547396578,39.06711898062375,NaN,NaN,0.6853152189049709,-54.67475727570938,0.32938695712966304,-4.225008991222211,-4.554395948351874,505424299,467892215.8,18.15533795171028,19.59422691476963,NaN,NaN,-16.86322042717063,-16.1690534878063
2000-05-01T09:30:00-04:00,95.75,96.875,94.25,95.75,23203392,35045961.6,49.70482459543674,39.61738201175448,NaN,NaN,27.44450400083393,-27.35747800683348,0.7787397444215278,-3.580971267824964,-4.359711012246492,528627691,485491735.8,26.277761407907207,19.36290750407013,NaN,NaN,-14.467220524605636,-15.925934493063346
2000-05-02T09:30:00-04:00,94.875,95.625,89.75,90,20304608,34484361.6,44.15014356627597,39.92840215277317,NaN,NaN,-8.187408185140006,-16.846746932728855,0.6923576280284802,-3.494263977210892,-4.186621605239372,508323083,493307473.4,29.61824387657326,19.470977391205384,NaN,NaN,-14.058172861708032,-15.65911140286973
2000-05-03T09:30:00-04:00,89.5,90.25,85.51562,89.375,26587296,32504020,43.580051269861606,40.554581951080095,NaN,NaN,-45.505112275321416,-15.16596304081068,0.6002030501782585,-3.436367792516549,-4.0365708426948075,481735787,500941691,32.820293320005746,19.901738498543256,NaN,NaN,-13.897066236244271,-15.407390664780378
2000-05-04T09:30:00-04:00,89,90.75,87.625,89.125,17749296,31541229.6,43.33898499168241,41.32738770933383,NaN,NaN,-31.511061575260005,-11.414752563196512,0.5318249403386459,-3.3717896672715,-3.903614607610146,463986491,497619470.2,32.13512608791453,20.512881079666734,NaN,NaN,-13.833348234661393,-15.182527460477665
2000-05-05T09:30:00-04:00,88.125,92.3125,88.03125,91.5,20569200,31044844.8,46.373812004453086,42.733941380746955,NaN,NaN,-4.646938699914882,-12.481203346960488,0.6482431844338135,-3.093310627067879,-3.7415538115016926,484555691,493445748.6,31.252417382282587,21.359314965865426,NaN,NaN,-12.930997403481692,-14.86088030947824
2000-05-08T09:30:00-04:00,90.5,90.75,87.75,88.25,13901102,30707635.1,42.981211849752974,43.04976549624491,NaN,NaN,-22.883054528237533,-22.54671505277478,0.5139335300297065,-3.0991368989645594,-3.613070428994266,470654589,481851128.2,28.879185959764015,22.17753789934317,NaN,NaN,-13.097666366116387,-14.60899260328369
2000-05-09T09:30:00-04:00,88.5,89.125,84.75,85.5,19796800,30348215.1,40.29497218824307,42.9573144510724,NaN,NaN,-67.06587275410386,-34.32240796656755,0.26025069370872655,-3.2877570618583576,-3.548007755567084,450857789,470358069.4,26.713704964505766,22.895422973569982,NaN,NaN,-14.005426274749876,-14.522768842064574
2000-05-10T09:30:00-04:00,84.375,85.4375,79.5,80,34814400,30364155.1,35.51434779322169,42.669949971146266,NaN,NaN,-165.60327723949143,-58.34204095940154,-0.23104620639680906,-3.8368155135630957,-3.6057693071662866,416043389,457219589.8,24.45608645925212,23.49861838162801,NaN,NaN,-16.270286465474342,-14.772414216837397
2000-05-11T09:30:00-04:00,82.75,85.25,80.875,84.75,24707008,29858260.7,41.92282507501586,42.95740219903844,NaN,NaN,-113.79318429208583,-74.7984655027667,-0.19086274782867818,-3.8443477419521344,-3.653484994123456,440750397,452572371,23.69334815003593,24.067452535820397,NaN,NaN,-16.277573097833013,-14.987436914122485
2000-05-12T09:30:00-04:00,85.375,87.5625,84,84.6875,17830800,28433610.3,41.86387257279382,43.340409538426016,NaN,NaN,-62.87472055601959,-86.44402187398764,-0.12635167254027513,-3.8114245847988,-3.685072912258525,422919597,440245152.2,21.75511240849869,24.4305203929986,NaN,NaN,-16.300502511113656,-15.175017713692652
2000-05-15T09:30:00-04:00,84.8125,88.625,82.625,88.625,17946496,26288915.1,46.92733754786595,43.616935943143766,NaN,NaN,-44.30421708323025,-90.72825438498619,0.20558434072872167,-3.428092486347623,-3.6336768270763447,440866093,434287453,20.866665722496776,24.750151276450847,NaN,NaN,-14.812230084169684,-15.123190909475085
2000-05-16T09:30:00-04:00,90,91.5,88.0625,91.0625,23826896,24710950.3,49.83985943010277,44.282697167221265,NaN,NaN,43.24523177331575,-68.66603347950226,0.5915414259037006,-2.8942500446967188,-3.4857914706004194,464692989,437054493,22.45071749784273,25.2791092377035,NaN,NaN,-12.690823167323304,-14.775709803453402
2000-05-17T09:30:00-04:00,89.25,90.5,87.75,89.1875,20336800,23915159.9,47.67261150329649,44.468502847283425,NaN,NaN,17.53976051233644,-32.03742592913669,0.714563446438707,-2.592587162552036,-3.3071506089907428,444356189,442717053,25.72730053893443,26.057235837694574,NaN,NaN,-11.529620788165476,-14.311982801269412
2000-05-18T09:30:00-04:00,89,89.35937,85.375,85.6875,19061104,23464319.9,43.84033280274024,44.1432276564816,NaN,NaN,-40.90443394321686,-17.4596758593629,0.5610015064159062,-2.60589872597086,-3.1669002323867663,425295085,439625990.6,25.103764042731086,26.553551987053204,NaN,NaN,-11.639549803647856,-13.930206658752047
2000-05-19T09:30:00-04:00,83.75,85,81.3125,81.6875,28178096,23810624.7,39.893349622598215,43.44240801556457,NaN,NaN,-129.24378035842477,-30.73348781984394,0.20894460106141022,-2.9057194810600038,-3.114664082121414,397116989,434465469,24.055541935217093,26.394822024718195,NaN,NaN,-12.926273525583854,-13.786787639728018
2000-05-22T09:30:00-04:00,81.625,82.25,75.57812,82,43876896,24442189.5,40.345217442787195,43.170627578172514,NaN,NaN,-177.40153304909063,-57.352951013016025,0.02566774985135023,-3.082579394807226,-3.108247144658576,440993885,434491027.4,24.072451739973545,25.998694014961075,NaN,NaN,-13.840378173992699,-13.794443430337259
2000-05-23T09:30:00-04:00,81.375,82.625,74.625,75.125,31906896,24606819.1,34.24561866903581,42.50388239239924,NaN,NaN,-187.22359978364926,-103.44671732440902,-0.500961318526334,-3.734448792816494,-3.23348747429016,409086989,423369827.4,21.798070661802527,25.211392396517986,NaN,NaN,-16.602224341149675,-14.195554989024746
2000-05-24T09:30:00-04:00,75,79.875,72.25,79.75,49469600,25796314.3,40.736722983160156,42.318006534647644,NaN,NaN,-159.8519085636771,-138.92505113961175,-0.48014521272712996,-3.8336689901990724,-3.3535237774719424,458556589,426209907.4,23.778609583194083,24.614498360466524,NaN,NaN,-16.931475989337383,-14.586400846212266
2000-05-25T09:30:00-04:00,80.25,82.25,76.5,77.5,29631504,25426244.7,38.73347015587691,41.77226783117793,NaN,NaN,-115.93516939853089,-153.93119823067454,-0.5549443828755267,-4.047204256066351,-3.4922598731908243,428925085,426935907.4,24.30634485479881,24.118350322789116,NaN,NaN,-17.825104449673674,-15.049072789563896
2000-05-26T09:30:00-04:00,77.75,79.25,75.75,77.6875,18199504,25094884.7,39.00266329379622,41.48808579146673,NaN,NaN,-118.0286077468739,-151.68816370836436,-0.5289318734553783,-4.153424715010047,-3.6244928415546687,447124589,436937427.4,31.357296039542888,24.29535818563046,NaN,NaN,-18.461348199562423,-15.536540705277972
2000-05-30T09:30:00-04:00,80,85.9375,80,85.5,30882400,25478835.1,49.04821024865197,42.113317081495936,NaN,NaN,-16.460954304725668,-119.50004795949137,0.04671905428533529,-3.5660940236979997,-3.612813077983335,478006989,444340048.2,36.10170054677628,24.965929298649787,NaN,NaN,-15.818315648333206,-15.576794268571577
2000-05-31T09:30:00-04:00,84.46875,86.67187,82.75,83,29666800,25946944.7,46.414023306447724,42.89186533244065,NaN,NaN,-5.186755369983669,-83.09267907675824,0.2784699812188154,-3.2647256014598156,-3.543195582678631,448340189,452190688.2,40.77672602724731,26.131689267792297,NaN,NaN,-14.466659093930398,-15.418203529337124
2000-06-01T09:30:00-04:00,85.1875,88.375,84,87.5,28987808,26066970.3,51.46668870877831,43.5735698777094,NaN,NaN,41.61144331345203,-42.80000870133242,0.7286112408641396,-2.6324315315984563,-3.361042772462596,477327997,455944969.8,42.92718156410417,27.505534511654314,NaN,NaN,-11.679597263138177,-14.884116919880132
2000-06-02T09:30:00-04:00,92.625,94.10937,91.875,93.25,32238704,26791440.7,57.040685853564696,44.65762796919304,NaN,NaN,147.85351226551222,9.957727631476192,1.3701496088469183,-1.6483557614039483,-3.0185053702508666,509566701,472073293,51.135894435809256,29.604161799319353,NaN,NaN,-7.395562744586186,-13.81432346626671
2000-06-05T09:30:00-04:00,92.25,95.3125,91.875,93.625,23780608,26952011.1,57.38443621513516,45.40456358828369,NaN,NaN,148.60442453444455,63.28433408773988,1.7518786838846063,-0.8286570153951089,-2.5805356992797153,533347309,489317837,58.07859939279719,32.26215706148367,NaN,NaN,-3.9256430490046506,-12.401654835229273
2000-06-06T09:30:00-04:00,93.1875,95,90.875,91.375,23199008,27416906.4,54.56331030944806,45.74195293680837,NaN,NaN,120.61551790392991,90.69962852947101,1.7792392051453199,-0.35648669284806545,-2.1357258979933853,510148301,495746099.4,60.34069235697666,34.9685838371361,NaN,NaN,-1.8941745189481023,-10.900586218617677
2000-06-07T09:30:00-04:00,91.5625,93.4375,89.5625,93.4375,22520896,27553111.2,56.666360503670504,46.38436357969222,NaN,NaN,104.62173920492125,112.66132744445198,1.8542125275848123,0.1820397614876299,-1.6721727660971824,532669197,512611901,65.58743522709264,37.81573631486168,NaN,NaN,0.4277221566279305,-9.282256450725448
2000-06-08T09:30:00-04:00,94.625,94.875,91.625,93,19308800,26777831.2,56.07347719113148,47.25815960743445,NaN,NaN,106.51906996160874,125.64285277408335,1.7913281209769412,0.5669873851239942,-1.224340735852947,513360397,519818381,67.56212094396237,40.848476093521064,NaN,NaN,2.154261883625979,-7.648468117246673
2000-06-09T09:30:00-04:00,94.75,94.75,93,93.5625,17013008,26393131.2,56.70074568772638,48.45868789780075,NaN,NaN,102.47969374055802,116.56808906909251,1.7050685297376835,0.9069949263191575,-0.7980736034185261,530373405,523979721.8,68.67975810335412,44.03592010553085,NaN,NaN,3.759512322753243,-6.0187566258181135
2000-06-12T09:30:00-04:00,94.3125,94.3125,90.8125,91,16421301,26322656.25,52.988519210302236,49.36178088119468,NaN,NaN,71.78637090990462,101.20447834418452,1.4053633004246733,0.9586305221123155,-0.44673277831235775,513952104,520100680.8,66.38368603771495,47.05815112679809,NaN,NaN,4.144970425453163,-4.566795618493646
2000-06-13T09:30:00-04:00,90.5,94.1875,89.35937,94.1875,25039392,26677301.05,56.779138076322525,50.97131798171516,NaN,NaN,71.179610168224,91.31729679704333,1.3513339833703115,1.2424347009005317,-0.10889928246977981,538991496,525869319.8,68.0920833598832,50.364866319518136,NaN,NaN,5.55257068536132,-3.121171860800079
2000-06-14T09:30:00-04:00,94.875,94.875,91.5625,92.15625,20239600,26497936.25,53.80197726539886,51.90455043044649,NaN,NaN,71.32349849775257,84.65764865560959,1.117993478122254,1.2885925651830377,0.1705990870607837,518751896,523085859.6,66.34017360078454,53.40497803506032,NaN,NaN,5.922605264813286,-1.8292036999981698
2000-06-15T09:30:00-04:00,91.875,93.8125,90.875,93.79687,18676496,26414921.05,55.81708011902895,53.12480828495735,NaN,NaN,66.41565815733074,76.63696629475399,1.016278320770069,1.44094698802337,0.424668667253301,537428392,527899458.6,67.8792844414385,56.51733086267743,NaN,NaN,6.795946896379783,-0.5970393290870337
2000-06-16T09:30:00-04:00,94.75,95.3125,93.0625,94.17187,21158496,26519790.65,56.28643143620884,54.35936315227254,NaN,NaN,74.14389428120381,70.96980640288317,0.9193102425510908,1.5738064704421646,0.6544962278910738,558586888,533542155.2,69.63224516142219,59.25125579995453,NaN,NaN,7.648882258628372,0.5809494691580239
2000-06-19T09:30:00-04:00,94.01562,98.25,92.6875,97.8125,19986496,26110210.65,60.656122612730364,55.18849974970671,NaN,NaN,88.83392796513479,74.37931781392919,1.0367103519517622,1.9503841678307765,0.9136738158790143,578573384,546466411.2,73.23516850621333,61.903646368485745,NaN,NaN,9.6463650212526,1.8760088337429635
2000-06-20T09:30:00-04:00,98.25,99.6875,97.1875,98.39062,20876192,24960175.45,61.31738892469174,56.25302586529557,NaN,NaN,105.8388744851137,81.31117067730713,1.0845128744059545,2.2693149088864573,1.1848020344805028,599449576,558558027.2,76.09296637554283,64.42623496479257,NaN,NaN,11.495210299083551,3.2501804716487617
2000-06-21T09:30:00-04:00,96.8125,99.71875,96.6875,98.6875,20841008,24406881.05,61.67363045992266,56.98209313323445,NaN,NaN,102.79094733794156,87.60466044534493,1.0657671864871947,2.517011017589496,1.4512438311023015,620290584,578865764.8,79.96260294521085,67.07162220630019,NaN,NaN,13.139948801689247,4.663004518797402
2000-06-22T09:30:00-04:00,98.625,99,94.76562,94.76562,21406608,23003731.45,54.52936976052419,56.802713412302985,NaN,NaN,74.96266775023395,89.31406236392556,0.7346325430882772,2.369534509962648,1.6349019668743707,598883976,591156881.6,81.87483638205234,69.26726091674612,NaN,NaN,12.673379208334573,5.807343760159855
2000-06-23T09:30:00-04:00,95,95.5,91.4375,91.64062,24801104,22762211.45,49.59908660508581,56.24661701158518,NaN,NaN,19.2000543310099,78.32529437388678,0.27423782333163116,1.9776992460389096,1.7034614227072784,574082872,594256078.4,82.33267548570932,70.9996949233827,NaN,NaN,10.823576451847986,6.523948430401017
2000-06-26T09:30:00-04:00,93.0625,94.42187,92,94.1875,22073104,22955891.45,53.30468095786948,56.15671491504385,NaN,NaN,24.067621980660135,65.37203317699185,0.11830113145576848,1.851337837026989,1.7330367055712206,596155976,597772596.8,82.86166610328985,72.60833590526222,NaN,NaN,10.284063147291693,7.0611076756711135
2000-06-27T09:30:00-04:00,93.76562,95.0625,92.39062,92.71875,14741500,22148846.45,50.977028864163444,55.75033408365049,NaN,NaN,9.11217609031341,46.02669349803179,-0.09517046537986085,1.6140736238463944,1.7092440892262553,581414476,594165576.8,80.2087751014266,73.65271732485749,NaN,NaN,9.155242566421501,7.360269802921169
2000-06-28T09:30:00-04:00,92.98437,95.5,92.5,93.89062,19233808,21627196.85,52.74987844981163,55.512934173556225,NaN,NaN,14.744139688950947,28.417331968233675,-0.16477817998490596,1.5032713642451228,1.6680495442300287,600648284,590237116.8,77.3058452150863,74.34869762993777,NaN,NaN,8.697625076539913,7.551320556295275
2000-06-29T09:30:00-04:00,92.9375,93.375,90.625,91.70312,21258400,21240726.45,49.17493355677438,54.97537616420251,NaN,NaN,-93.45062459637386,-5.265326501087879,-0.35457743138924713,1.2248277549934699,1.579405186382717,579389884,586338298.4,74.42685821512143,74.7592047807783,NaN,NaN,7.276141239251367,7.5120092252890025
2000-06-30T09:30:00-04:00,91.8125,93.95312,91.3125,93.1875,15065602,20382071.35,51.57329442534523,54.874288679562724,NaN,NaN,-49.211287740051034,-18.947594915300066,-0.37462186206679626,1.1111278587992217,1.485749720866018,594455486,590412821.2,75.4556041823024,75.40719893396313,NaN,NaN,6.732491164075083,7.400649502258442
2000-07-03T09:30:00-04:00,93.5,95.25,93.25,95.125,5186000,19452340.95,54.58568085531474,54.71761316377645,NaN,NaN,28.950216496787267,-17.97107601207464,-0.25744559880126316,1.163942722364439,1.4213883211657021,599641486,591109923.2,75.63618582420945,75.9460633957007,NaN,NaN,7.110587319605884,7.359212047593791
2000-07-05T09:30:00-04:00,93.625,93.96875,90.875,91.25,16069500,19095865.55,48.13636394254466,54.3129264978583,NaN,NaN,-84.60641902670955,-36.71479503547924,-0.43075803666842605,0.8829407753301695,1.3136988119985955,583571986,591541425.2,75.75509432891594,76.61855773342438,NaN,NaN,5.51698949374004,7.096037397043255
2000-07-06T09:30:00-04:00,91.5625,94.75,90.0625,94.5625,23457600,19142700.75,53.22411510459908,54.127714711113306,NaN,NaN,-37.98016651736125,-47.25965627674168,-0.3173865969375729,0.9169655658266294,1.2343521627642022,607029586,592817685.6,76.12622756940385,77.20762509970761,NaN,NaN,5.681034337332372,6.893894102798844
2000-07-07T09:30:00-04:00,95,97,94.4375,95.40625,16488500,19001685.75,54.449846549872966,53.99653007637503,NaN,NaN,68.45211581672443,-14.879108194122026,-0.18709684422079165,1.0004811074882127,1.1875779517090044,623518086,601643326,78.5693049804543,77.84598651535278,NaN,NaN,6.178839597457863,6.791743459178703
2000-07-10T09:30:00-04:00,94.6875,95.875,94,94.25,12591102,18780590.45,52.42256429059309,53.408418767650936,NaN,NaN,25.93800669100313,0.15075069208880762,-0.18024192089917657,0.9622755505850336,1.1425174714842101,610926984,604937625.6,79.41603837934721,78.28747722057662,NaN,NaN,6.007511717332274,6.679710353200642
2000-07-11T09:30:00-04:00,94.0625,95.75,92.8125,93.20312,14316398,18675345.3,50.58611587115362,52.641899263826794,NaN,NaN,-12.833526476203279,-8.205997902509301,-0.24372235803150377,0.8378645239448304,1.0815868819763341,596610586,604331445.6,78.79908153942068,78.4807711608536,NaN,NaN,5.342384671664438,6.488663827266898
2000-07-12T09:30:00-04:00,95.4375,97.75,94.625,96.96875,18217696,18334260.5,56.49044478822611,52.27167171584847,NaN,NaN,89.0744394759357,26.530173798019746,-0.04028124921002152,1.0312353204638072,1.0715165696738287,614828282,610582704.8,80.4829612917696,78.51793961417924,NaN,NaN,6.503245431929345,6.490746913647248
2000-07-13T09:30:00-04:00,97.9375,99.75,97.125,98.9375,19404304,18292495.7,59.23307416256737,52.6076506017087,NaN,NaN,152.69747805088224,64.66570271166844,0.20521551974507313,1.3280359693551702,1.122820449610097,634232586,616023304.8,81.83519313161457,78.51510795343368,NaN,NaN,8.314636641737858,6.7513025890887635
2000-07-14T09:30:00-04:00,100.25,101.125,98.8125,100.625,17140192,18215680.5,61.47471599308062,53.45590984370833,NaN,NaN,174.22998443468748,85.82127643526107,0.44578616979652463,1.6800531618557528,1.2342669920592282,651372778,621594243.2,83.12451056268505,78.57166760178909,NaN,NaN,10.514886764827207,7.288957471337112
2000-07-17T09:30:00-04:00,100.9375,102.0625,99.875,101.4375,12857898,17800650.6,62.54268625354918,54.11576736482831,NaN,NaN,168.91388947257676,114.41645299157578,0.6138016202594068,2.0015190173834867,1.38771739712408,664230676,632254981.6,85.27798594316316,78.74426187606575,NaN,NaN,12.648465302734053,8.054601447250961
2000-07-18T09:30:00-04:00,100.375,100.78125,98.35937,99.25,20473904,17825021,57.88977720157874,54.609535103215116,NaN,NaN,106.80373336432929,138.3439049596823,0.534681260197486,2.0560689723709373,1.5213877121734514,643756772,641684218.8,86.87351899729563,79.22031501148498,NaN,NaN,13.158512769433386,8.783731636134165
2000-07-19T09:30:00-04:00,98.3125,98.9375,95.65625,96.625,21262096,17844316.2,52.81228867167383,54.613992976205274,NaN,NaN,44.59536818228195,129.44809070095155,0.2756697072624079,1.8659748462514614,1.5903051389890535,622494676,643217497.6,87.11800331904996,79.92118344748238,NaN,NaN,12.089523392717737,9.25598760136039
2000-07-20T09:30:00-04:00,97.875,100.1875,97.26562,100.1875,19338096,17769170.6,58.17400247924479,55.25678361352459,NaN,NaN,101.79627185282254,119.26784946133962,0.31172714115383426,1.9799640654313464,1.6682369242775121,641832772,644737534.8,87.36916451776469,80.84563389767118,NaN,NaN,12.79713577553567,9.761865911956859
2000-07-21T09:30:00-04:00,98.4375,99.51562,97.14062,97.3125,14369398,17417310.1,52.945564536043825,55.354802907145924,NaN,NaN,62.78873356362107,96.97959928712633,0.11930120924840493,1.8173634358380184,1.6980622265896135,627463374,639955654,81.9556713935559,81.30992441276074,NaN,NaN,11.74774118846605,10.045562380029601
2000-07-24T09:30:00-04:00,97.9375,99,94.3125,94.3125,18449904,17099750.1,48.08871881328594,54.890734189858144,NaN,NaN,2.735525982715188,63.743926589154015,-0.2144955041261032,1.4299428464319845,1.6444383505580877,609013470,628912212.8,71.01247012648821,80.97965900578063,NaN,NaN,9.27912242568268,9.936070957980041
2000-07-25T09:30:00-04:00,95.625,96.73437,93.8125,96.07812,18997200,16945954.9,50.94107291402809,55.091070544964104,NaN,NaN,-9.67705226352696,40.44776946358278,-0.3147828955456342,1.250959731126045,1.5657426266716792,628010670,625762992.4,68.21522821286506,80.44109714034843,NaN,NaN,8.131664753904909,9.678298643112164
2000-07-26T09:30:00-04:00,95.5,96.125,93.25,95.625,20236896,17220724.7,50.17905558038967,54.87356629323485,NaN,NaN,-28.432621743703542,25.842171478385673,-0.40433128654166306,1.0603285184946003,1.4646598050362634,607773774,622818812,65.61308087961541,79.69015809107782,NaN,NaN,6.979968623624784,9.292822926042538
2000-07-27T09:30:00-04:00,93.9375,95.0625,91.5625,91.5625,25756608,17546864.7,43.846276899655734,54.11616846107648,NaN,NaN,-92.02159562681915,-12.921402017542658,-0.7118750521339057,0.5748159898688812,1.2866910420027868,582017166,610855690.8,56.22744568613965,78.09431099862677,NaN,NaN,3.934112023812634,8.527292797152551
2000-07-28T09:30:00-04:00,92.1875,92.875,86,86.8125,36359504,18301919.9,37.83399962157335,53.074128127575065,NaN,NaN,-195.62511599167107,-64.60417192860108,-1.182184279499825,-0.19103930737199448,0.9911449721278305,545657662,594494548.4,46.44279375479977,75.73907923973054,NaN,NaN,-0.8141821170947692,7.192796380831505
2000-07-31T09:30:00-04:00,87.625,90.125,85.71875,89.5,27316000,18914439.8,42.627467755655246,52.50565326218232,NaN,NaN,-177.50767574697878,-100.65281227453987,-1.2525190464186633,-0.5745038358954986,0.6780152105231647,572973662,587286586.8,42.90081394297598,73.17491726855592,NaN,NaN,-3.1704681390310845,5.712330020851136
2000-08-01T09:30:00-04:00,89.8125,89.98437,87.48437,88.40625,15711898,19440734.7,41.23396977837364,51.41590504719286,NaN,NaN,-147.5217913136886,-128.2217600845722,-1.30692630266288,-0.955642667805435,0.35128363485744474,557261764,573136805.6,36.944241325750184,70.06500869955453,NaN,NaN,-5.500926112467607,4.110436287519887
2000-08-02T09:30:00-04:00,87.875,90.39062,86.6875,86.85937,23445200,19809519.7,39.27831197553125,49.990564890975996,NaN,NaN,-146.48174991355734,-151.83158571854295,-1.3744373341052603,-1.3667630327741307,0.007674301331129618,533816564,558345363.6,31.95022156149598,66.50179644454606,NaN,NaN,-8.026585590920664,2.376576019171237
2000-08-03T09:30:00-04:00,84.25,90.8125,83.3125,90.8125,35590096,20416144.5,46.289135209350704,48.90588054928101,NaN,NaN,-123.43593916549185,-158.11445442627752,-1.0924921082763213,-1.357940834014272,-0.2654487257379507,569406660,555823262.4,31.176355976743892,62.79121397412168,NaN,NaN,-8.001211144637656,0.8940349957699667
2000-08-04T09:30:00-04:00,92,92.76562,89.125,90,22236192,20703529.1,45.13565049566395,47.662520852289205,NaN,NaN,-70.18335658761515,-133.02610254546633,-0.9079358678289993,-1.4003685605241998,-0.4924326926952005,547170468,556125823.6,31.391044030179785,58.94214669462287,NaN,NaN,-8.332778049766192,-0.42408115359234166
2000-08-07T09:30:00-04:00,90.875,93.03125,90.25,92.26562,15046102,20826279.1,48.95536793533722,47.02434876184338,NaN,NaN,-43.97669554460383,-106.31990650499134,-0.5955881029199099,-1.236917821345088,-0.641329718425178,562216570,553974405.2,30.65869154647831,54.92680187670734,NaN,NaN,-7.440319053655145,-1.4264008536013135
2000-08-08T09:30:00-04:00,92.0625,93.4375,91.5,92,14368301,20828874.25,48.52878954812704,46.71838453873289,NaN,NaN,-33.74170268547888,-83.56388877934938,-0.3796972297783482,-1.1159512556481133,-0.7362540258697651,547848269,552091706.2,29.999117476039174,50.84688145934944,NaN,NaN,-6.842976246295761,-2.200197338271949
2000-08-09T09:30:00-04:00,93.6875,94.4375,91.39062,91.60937,18466400,20841309.45,47.86819484994806,45.98225542235456,NaN,NaN,-27.65488338448884,-59.79851547353569,-0.24269346339132525,-1.0396208551089217,-0.7969273917175964,529381869,551204767.2,29.675224511417937,46.72588574461038,NaN,NaN,-6.533008207219604,-2.819170319550185
2000-08-10T09:30:00-04:00,91.8125,92.23437,89.6875,89.9375,15270801,20634634.3,45.042166641190875,45.417727001293635,NaN,NaN,-53.82339510203768,-45.87600666084486,-0.2435291671376425,-1.1013388506396495,-0.857809683502007,514111068,540145648.8,25.91770671456483,42.723173981825305,NaN,NaN,-7.048725909650706,-3.4233925467074022
2000-08-11T09:30:00-04:00,89.25,91.10937,87.875,90.875,20825008,20818875.1,46.93406885944624,45.3352520045908,NaN,NaN,-60.31219566467269,-43.90177447625638,-0.16363722172923578,-1.0623562106635518,-0.898718988934316,534936076,537698770.4,25.158655594036233,39.447901515221595,NaN,NaN,-6.967904001178531,-3.9297513259175636
2000-08-14T09:30:00-04:00,91.375,93,90.20312,92.9375,12466398,20799300.1,50.935742603400016,45.33487126811736,NaN,NaN,-14.796904951628875,-38.06581635766139,0.034833016545004813,-0.85517771825306,-0.8900107347980648,547402474,534735951.2,24.23318546191173,36.306327033010646,NaN,NaN,-5.773681549417938,-4.1931699292747595
2000-08-15T09:30:00-04:00,92.75,93.98437,92,93.0625,14048801,20478044.95,51.17604581615881,45.40608485638659,NaN,NaN,14.775096706041248,-28.362456479357366,0.1734955785599912,-0.6731412615980759,-0.8466368401580671,561451275,537456552.4,26.892568660491676,33.54057616021609,NaN,NaN,-4.719878465465674,-4.268414005873462
2000-08-16T09:30:00-04:00,93.4375,94.6875,92,93.42187,15163398,20173110.05,51.90534818156166,45.981732805094154,NaN,NaN,30.156761276127764,-16.800127547234048,0.2819644414839084,-0.49418128830318153,-0.77614572978709,576614673,546903113.2,35.37457903522255,32.051085685150575,NaN,NaN,-3.6378013451843847,-4.178326482917879
2000-08-17T09:30:00-04:00,92.9375,95.875,92.875,95.4375,14370199,19924715.2,55.8855846788392,47.271131737755994,NaN,NaN,78.83235367310435,9.73102220779436,0.47087835161290814,-0.1875477902709548,-0.658426141883863,590984872,562277874,46.29566748452443,32.040576665845194,NaN,NaN,-1.5825739577112874,-3.807504693602652
2000-08-18T09:30:00-04:00,95.9375,96.625,94.6875,95.14062,14637102,19938100.4,55.16147759727323,48.16641815501442,NaN,NaN,109.6593170666956,43.72532475406802,0.5516582667488916,0.031146691552251582,-0.52051157519664,576347770,570560212.8,51.09061692039981,32.62556259280404,NaN,NaN,-0.03523903988045509,-3.268609600213767
2000-08-21T09:30:00-04:00,96,96.85937,94.375,95.75,13507102,19690960.3,56.40995937548643,49.25041741195105,NaN,NaN,115.87666003057711,69.86003775050922,0.6170053273254243,0.2507450839601404,-0.36626024336528396,589854872,579050692.4,55.47899081701269,33.949473270751355,NaN,NaN,1.6213705207957712,-2.5700410114981187
2000-08-22T09:30:00-04:00,96,97.35937,95.26562,95.4375,14828301,19482515.35,55.55566843367956,50.413085730390215,NaN,NaN,124.88721569481848,91.88246154826467,0.6090152648833239,0.39500883773887097,-0.21400642714445295,575026571,581765751.6,56.81340952118153,35.72541526787175,NaN,NaN,2.8284157998342287,-1.7988328955934976
2000-08-23T09:30:00-04:00,94.6875,97.4375,93.82812,97,21311808,19536260.95,58.90668003900499,51.314338932508385,NaN,NaN,122.56533128130208,110.36417554929953,0.6737478174637987,0.6281783446852955,-0.045569472778503234,596338379,585710492.8,58.74802969783986,37.69482053366432,NaN,NaN,4.795835761880043,-0.8567373730972775
2000-08-24T09:30:00-04:00,97.4375,98.6875,96.0625,98.5625,13514398,18924150.45,61.99278231380777,52.51841977666151,NaN,NaN,148.89032046197735,124.37576890707412,0.7791325013363293,0.9283461538919084,0.1492136525555791,609852777,589484073.8,60.567804297467035,39.77887483847055,NaN,NaN,7.394690206883485,0.3220379954714029
2000-08-25T09:30:00-04:00,98.48437,99.95312,97.625,98.375,11697898,17691070.15,61.396912280575236,53.407101515607074,NaN,NaN,149.8191380559185,132.4077331049187,0.7910160020177911,1.137983655077818,0.34696765306002686,598154879,593845495.6,62.620235283502446,42.06184224825798,NaN,NaN,9.436760009754838,1.6241411403690362
2000-08-28T09:30:00-04:00,98.25,99.84375,97.9375,98.4375,12272102,16938875.25,61.52965171512669,54.33573452753563,NaN,NaN,133.57522678180962,135.94744645516522,0.7578233502314731,1.2942468408493681,0.5364234906178951,610426981,597959917.4,64.49756743928438,44.526017245632644,NaN,NaN,11.202506837602813,2.9924790971167186
2000-08-29T09:30:00-04:00,98.625,99.17187,97.85937,98.82812,11142301,16710395.4,62.39986648152949,55.37371107264859,NaN,NaN,115.43971845148282,134.05794700649807,0.7173304721482031,1.433086580803149,0.7157561086549459,621569282,607268459.6,68.36823223064445,47.28980351129168,NaN,NaN,12.953461596335803,4.415476597005159
2000-08-30T09:30:00-04:00,98.3125,99.5,97.76562,98.89062,10505699,16063420.35,62.545852234717835,56.62397432932909,NaN,NaN,106.5100920766362,130.8468991655649,0.6518098641324154,1.5305184388204651,0.8787085746880497,632074981,614415780,70.98406669664028,50.508829224297074,NaN,NaN,14.494496118393105,5.855336528632009
2000-08-31T09:30:00-04:00,99.625,101.875,99.5625,101.875,15469398,15057385.45,68.7792304431919,58.18434301388235,NaN,NaN,148.26562118208355,130.72195930958614,0.7590190074301049,1.8274823339756807,1.0684633265455759,647544379,621954100.4,73.47550398173239,53.960032680561085,NaN,NaN,17.733812594519446,7.552261680901642
2000-09-01T09:30:00-04:00,103,103.51562,101.1875,102.5,14007699,14645960.8,69.9087014024678,59.5395543566729,NaN,NaN,159.27825153056511,132.61378200451546,0.8165716545635349,2.0891778947499944,1.2726062401864595,661552078,634633540.2,77.0456684447231,57.732352893619044,NaN,NaN,20.823305535642923,9.448125088721826
2000-09-05T09:30:00-04:00,101.625,101.75,99.42187,99.51562,16286801,14707995.75,58.94329649831126,60.09435797682664,NaN,NaN,98.36363566466257,125.57146378108605,0.6077802356369966,2.0323315347327053,1.4245512990957088,645265277,641601199.4,78.73919605814477,61.43568342202283,NaN,NaN,20.519316049003056,11.02972379733343
2000-09-06T09:30:00-04:00,99.25,99.48437,95.75,96.0625,20829600,15031060.7,49.30636712079797,59.90871647248639,NaN,NaN,22.770989331033714,107.03771795699622,0.21169556140148593,1.6891707508475662,1.4774751894460803,624435677,642174478.4,78.8772794042485,64.54301916266753,NaN,NaN,17.045171334575375,11.889073445510851
2000-09-07T09:30:00-04:00,96.8125,99.42187,96.5625,98.25,16529801,14934230.75,54.39327862187172,59.80212318270299,NaN,NaN,40.6227104028393,93.86024162223683,0.07847121021109293,1.5755642022099465,1.4970929919988536,640965478,643952577.8,79.32578244062822,66.90231308810353,NaN,NaN,15.751388563568494,12.440832748090514
2000-09-08T09:30:00-04:00,97.76562,98,94.82812,94.875,22961104,15318745.9,46.62031908035444,59.1920404314945,NaN,NaN,-21.247127941961978,59.95769179742773,-0.2381781490600463,1.1993703056737957,1.437548454733842,618004374,638044576.8,73.72439086043823,68.51901122667769,NaN,NaN,11.84708086255687,12.356011050157136
2000-09-11T09:30:00-04:00,94.5,96.125,92,92.78125,27175392,15636265.1,42.55728201828911,58.20256347740899,NaN,NaN,-94.82122296275391,9.137796898763927,-0.5708862292654309,0.7239406681520535,1.2948268974174844,590828982,623899957.6,62.369361734638105,69.01118057793666,NaN,NaN,7.198490171679482,11.619222353231757
2000-09-12T09:30:00-04:00,93.5,94.6875,90.84375,91.3125,23873808,16206635.6,39.92843354932909,57.08633241424109,NaN,NaN,-135.58290815304926,-37.651511864778435,-0.8550312922239338,0.22603778213756698,1.0810690743615008,566955174,608237937,52.69188738533083,68.71678613966161,NaN,NaN,2.5460411098990994,10.323053604184235
2000-09-13T09:30:00-04:00,90.25,93.75,90,93.4375,33706496,17189520.35,45.20252831647344,56.10746443406027,NaN,NaN,-129.5159942945328,-68.10890858989173,-0.8625491244516009,0.00288266879699961,0.8654317932486005,600661670,603483135.6,50.14791225746659,68.1024920367778,NaN,NaN,0.4545439347535884,8.913266508551285
2000-09-14T09:30:00-04:00,95.25,95.9375,92.64062,93.375,28446896,17853695.25,45.077173387879,54.89920665363679,NaN,NaN,-85.35238967269993,-93.30392860499957,-0.8339234860999541,-0.17697256437634223,0.6569509217236119,572214774,589732994.8,43.59328303342604,66.89002623220344,NaN,NaN,-1.2074926298391961,7.467443774495502
2000-09-15T09:30:00-04:00,93.125,93.625,90.6875,91.375,24538704,18362120.5,41.1450185483191,53.45264281561849,NaN,NaN,-134.33027610996456,-115.9205582386001,-0.9058904672051246,-0.4754121622827938,0.43047830492233075,547676070,575667334,38.10634289907399,65.13903391902997,NaN,NaN,-3.8846806563305343,5.845711712948925
2000-09-18T09:30:00-04:00,91.8125,93,88.51562,89.8125,28948608,19077695.8,38.33177350251144,51.795651514717406,NaN,NaN,-151.7327288692845,-127.30285941990618,-1.0071493897758153,-0.8284584322974382,0.17869095747837693,518727462,561247030,33.45695278846263,62.921847158256995,NaN,NaN,-7.020564859799731,4.00767220255626
2000-09-19T09:30:00-04:00,90.75,93.78125,89.875,93.5,27517696,19778225.5,47.46162337263838,50.72863414979661,NaN,NaN,-93.09928741729236,-118.80613527275482,-0.7841215415068944,-0.801460969405241,-0.017339427898346665,546245158,557105026.8,32.24016006711811,60.341270575147966,NaN,NaN,-6.760713508476737,2.469331386694403
2000-09-20T09:30:00-04:00,93.375,95.23437,91.3125,94.6875,33083008,20690960.85,50.02740871590139,49.834459612738286,NaN,NaN,-55.99954355524073,-104.1028451248964,-0.5272855040363447,-0.6764463079437775,-0.14916080390743283,579328166,552838326,30.989854404533702,57.48454112571178,NaN,NaN,-5.708110392824213,1.3011254181917435
2000-09-21T09:30:00-04:00,93.75,94.48437,92.0625,92.39062,24138704,20832305.65,45.40820248746293,48.16510047304336,NaN,NaN,-66.35190686367972,-100.30274856309236,-0.48388611916370966,-0.7540184528620699,-0.27013233369836026,555189462,549433263.6,29.99027560870826,54.37845338478149,NaN,NaN,-6.333367654801453,0.21048355062128699
2000-09-22T09:30:00-04:00,87.625,93,87.5,92.9375,33577392,21835455.35,46.67079404059906,46.50524994719559,NaN,NaN,-94.3687947087273,-92.3104522828449,-0.3939547666496733,-0.7625757920104519,-0.36862102536077856,588766854,557651420.4,35.405622111978374,51.40416436101401,NaN,NaN,-6.435174845084619,-0.7388962201938425
2000-09-25T09:30:00-04:00,93.625,94.25,90.0625,90.1875,20393104,22270215.65,41.47611317136883,45.25759399527113,NaN,NaN,-78.9855994793627,-77.76102640486054,-0.48907370528044314,-0.9799631569613325,-0.4908894516808894,568373750,567580678,41.31228421127018,48.73081351480868,NaN,NaN,-8.201768194247656,-1.8050207879158158
2000-09-26T09:30:00-04:00,90.76562,92.5,88.9375,88.9375,25511008,22932160.95,39.33305778657071,44.54521475711204,NaN,NaN,-98.07608126461892,-78.75638517432587,-0.5983510958110257,-1.2388283214446716,-0.6404772256336458,542862742,566904194.8,41.03695804443443,46.02793341767911,NaN,NaN,-10.328525621158889,-3.022664335521969
2000-09-27T09:30:00-04:00,90.625,91.1875,88,89.5,28388800,23794485.9,40.81504302430001,43.575340785856916,NaN,NaN,-101.9226834820441,-87.94101315968655,-0.5937409494628126,-1.3826534124621617,-0.788912462999349,571251542,565288870,40.34552335868496,43.2436291975403,NaN,NaN,-11.602904223810672,-4.2484128909917835
2000-09-28T09:30:00-04:00,88.71875,93,88.71875,92.45312,28755104,24706956.15,47.99729965707781,43.67369654133716,NaN,NaN,-60.26348090026715,-86.72332796700402,-0.36407293365563187,-1.2440036300688888,-0.8799306964132569,600006646,574252306.8,45.80252904536223,41.24921049646344,NaN,NaN,-10.462603832614478,-5.13615445408074
2000-09-29T09:30:00-04:00,92,92.125,88.6875,88.6875,27018000,25284386.25,41.141342128337705,43.57255797776919,NaN,NaN,-92.92242152030292,-86.43405332931916,-0.43332707700217044,-1.42158954266597,-0.9882624656637995,572988646,571096665.2,44.26723502611908,39.956201445854944,NaN,NaN,-11.73864667602693,-6.079367628644481
2000-10-02T09:30:00-04:00,90.25,90.25,86,86.75,24968096,25832406.1,38.12390264700791,43.44366291331768,NaN,NaN,-148.2857155697888,-100.29407654740437,-0.5686554343505308,-1.699081758601963,-1.1304263242514323,548020550,567026025.2,42.297635650775554,39.2137548933867,NaN,NaN,-13.793415573850101,-7.18137447795957
2000-10-03T09:30:00-04:00,88.0625,88.5,83.26562,83.375,35725808,26804356.45,33.5129606492072,42.608693794227236,NaN,NaN,-212.96302064648592,-123.27146442377777,-0.8287455038291103,-2.16635820403782,-1.33761270020871,512294742,560912425.2,39.4580795502591,38.45019541430046,NaN,NaN,-17.15383970920951,-8.606012368138133
2000-10-04T09:30:00-04:00,83.5,86.85937,82.125,85.625,37675600,27646656.45,38.824982286722516,42.1621087155732,NaN,NaN,-191.31861508393644,-141.15065074415625,-0.7925362085988232,-2.328282960957239,-1.5357467523584156,549970342,556656185.2,37.56722862148167,38.019762956304426,NaN,NaN,-18.110384814427178,-9.96377986046514
2000-10-05T09:30:00-04:00,85.25,87.1875,84.5625,85.875,23442896,27992311.2,39.40428680569101,42.037770733956904,NaN,NaN,-142.21155036031703,-157.54026463616623,-0.698339340232921,-2.408670927649567,-1.7103315874166458,573413238,551337503.6,35.291334791014805,37.81869094858591,NaN,NaN,-18.670429297203896,-11.20758692285639
2000-10-06T09:30:00-04:00,85.5625,86.5625,81.25391,83,36335504,28661031.2,35.268123399841926,41.818938583766226,NaN,NaN,-175.2086030663054,-173.9975009453667,-0.7705734827385649,-2.673548440839852,-1.9029749581012871,537077734,544155321.2,32.43388302509371,37.745614536916705,NaN,NaN,-20.49545413885295,-12.534425096570184
2000-10-09T09:30:00-04:00,82.5625,83.8125,79.375,82.625,28834400,28743981.6,34.75566580824443,40.91137018630951,NaN,NaN,-177.71393317920197,-179.88314446724934,-0.7820362730603012,-2.8805202994266637,-2.0984840263663624,508243334,536199878,29.577209238477153,37.55540376344235,NaN,NaN,-22.100931984839686,-13.90106893775154
2000-10-10T09:30:00-04:00,81.8125,83.3125,77.875,78.3125,35269600,29313771.2,29.45513750628976,39.44192224276583,NaN,NaN,-178.68050230905246,-173.02664079976267,-1.004307491185945,-3.3538683903487936,-2.3495608991628485,472973734,528335676.4,27.041670968294554,37.27339066085384,NaN,NaN,-25.320838869046074,-15.532464642222187
2000-10-11T09:30:00-04:00,76.875,80.45312,76.0625,77.0625,48462800,30051586.4,28.11662532745933,38.20680958847986,NaN,NaN,-175.59301040663078,-169.88151986430154,-1.1493269079167057,-3.7862195340587306,-2.636892626142025,424510934,503243794.8,20.888669380761826,36.62327593028623,NaN,NaN,-28.35534052633349,-17.364304054238087
2000-10-12T09:30:00-04:00,79.25,79.5625,74.3125,75.125,53223696,31290426.4,26.13424231418827,36.739913036593364,NaN,NaN,-168.26609471090632,-175.0924287344194,-1.279579330057575,-4.236366788713994,-2.956787458656419,371287238,462818594.8,14.976298966345425,35.16403856274101,NaN,NaN,-31.524817210932593,-19.387234505194446
2000-10-13T09:30:00-04:00,74.6875,81.625,74.625,81.25,42410096,32183996,40.43249184807502,36.6653686563581,NaN,NaN,-109.27001337254102,-161.90471079566652,-0.8763017042177714,-4.052164588928633,-3.175862884710862,413697334,438142514.8,12.626902269332376,33.11508270974546,NaN,NaN,-29.425112610781124,-20.821217091706828
2000-10-16T09:30:00-04:00,81.125,82.3125,79.75,81.625,27634000,32118265.6,41.18316558139353,36.797519213131146,NaN,NaN,-71.55135899050114,-140.67219595792633,-0.5247125581396102,-3.8317535823853746,-3.3070410242457644,441331334,424760114.8,11.567113371681245,31.010093804548806,NaN,NaN,-27.564277923792837,-21.784511496290545
2000-10-17T09:30:00-04:00,83.125,83.17187,78,78.25,52082400,33346500.8,36.70045750248066,36.50362024728691,NaN,NaN,-83.11964176123077,-121.560023848362,-0.46207194707251187,-3.8846309580864045,-3.4225590110138926,389248934,408015154.8,10.391813517879925,28.870543101634162,NaN,NaN,-27.46697902645707,-22.59629257202862
2000-10-18T09:30:00-04:00,76.75,81.1875,74.5625,78,64770608,34930880.8,36.38452929199267,35.67413664978083,NaN,NaN,-100.36056638403812,-106.51353504384346,-0.38333904936270846,-3.9017328227172783,-3.51839377335457,324478326,388008633.2,9.190307650303652,26.255384430558546,NaN,NaN,-27.48985031575903,-23.295372249704393
2000-10-19T09:30:00-04:00,82.39062,85.10937,81.4375,85.0625,42443696,35846130.4,49.58717814515941,36.27741065098238,NaN,NaN,-8.720491846408818,-74.60441447094396,0.1688932471591178,-3.307277214405673,-3.4761704615647906,366922022,387135590,9.14064155016122,23.7463420394187,NaN,NaN,-22.781321903610674,-23.22193648597672
2000-10-20T09:30:00-04:00,84.5,87.875,84.39062,86.3125,40690896,36201805.6,51.505523686364114,37.23324072522211,NaN,NaN,33.31768053814056,-46.08687568880766,0.6176317513302925,-2.704130772401925,-3.3217625237322173,407612918,385918706.8,9.06708933624455,21.372731588380766,NaN,NaN,-18.445493706516064,-22.53958751748234
2000-10-23T09:30:00-04:00,86.1875,87.5,84.125,86.1875,28988192,36631560,51.29531617834583,38.50340897730344,NaN,NaN,36.19842957897344,-24.53691797491273,0.8888217421255256,-2.2107353460753103,-3.099557088200836,378624726,373377385.2,8.323702740583485,19.148847530546796,NaN,NaN,-15.147536921627852,-21.483580289503127
2000-10-24T09:30:00-04:00,86.4375,87,82.375,82.4375,31457200,36928869.6,45.319643028331186,38.96731331598977,NaN,NaN,6.614641243597162,-6.590061373947134,0.8011467011058215,-2.098123711818559,-2.8992704129243805,347167526,364961103.6,7.858089381593942,17.0267661562691,NaN,NaN,-14.19252808522641,-20.442001403177883
2000-10-25T09:30:00-04:00,81.25,82,76.89062,77.875,48633200,37941089.6,39.318159756400746,38.96116138389761,NaN,NaN,-79.88092566270566,-2.4941332296806644,0.43946025380289466,-2.349945095670762,-2.7894053494736566,298534326,359772303.6,7.576692120054631,15.047148822629092,NaN,NaN,-15.403097199320385,-19.722157945483954
2000-10-26T09:30:00-04:00,78.1875,80,73.625,79.875,69995120,40003090.4,42.88848361832759,39.50547282807516,NaN,NaN,-91.93119915986946,-19.136274692372794,0.3427907667422141,-2.360916891045889,-2.703707657788103,368529446,360093788.4,7.796998035997277,13.287371323407916,NaN,NaN,-15.19929181485215,-19.076034212536552
2000-10-27T09:30:00-04:00,80.85937,81.85937,77.48437,79.71875,51045392,41204460,42.67722242442984,40.07129830065984,NaN,NaN,-48.35924401839598,-35.471659603680095,0.27890822327643905,-2.3550723786925545,-2.6339806019689935,317484054,342068015.6,6.815952158644237,11.661567246276993,NaN,NaN,-15.105388238689038,-18.508799073415478
2000-10-30T09:30:00-05:00,78.1875,79.875,75.70312,76.76562,35494096,41730760,38.78831849798897,40.737954085781205,NaN,NaN,-90.10981007129594,-60.73330753373398,0.05979869352016198,-2.559232235068791,-2.619030928588953,281989958,322741062,5.951323467782444,10.15511385338327,NaN,NaN,-16.24779537328623,-18.185798544825584
2000-10-31T09:30:00-05:00,78,82.5625,77.875,81.70312,43862400,42137589.6,47.41599674525154,42.11648061562351,NaN,NaN,-10.700426990731692,-64.19632118059975,0.2583072589456128,-2.2961468549069366,-2.5544541138525494,325852358,318478028.4,5.777237655823157,9.075725873030509,NaN,NaN,-14.394008035655654,-17.644114186372736
2000-11-01T09:30:00-05:00,80.3125,82.8125,79.1875,81,45185104,42513064.8,46.41275859476499,43.56494606423613,NaN,NaN,1.1933408659071836,-47.98146787487718,0.34760468342802175,-2.119948259567522,-2.467552942995544,280667254,314904614,5.628609779140376,8.408033788230147,NaN,NaN,-13.24493400494466,-17.015659874740155
2000-11-02T09:30:00-05:00,82.1875,83.25,81.0625,82,26594000,42670620,48.09483216144501,44.1122560866197,NaN,NaN,38.91307022167621,-21.812613998568043,0.4716664402047779,-1.8779698927395714,-2.3496363329443493,307261254,302650975.6,5.140259495098533,7.873273590070588,NaN,NaN,-11.800491844679527,-16.27063587044578
2000-11-03T09:30:00-05:00,82.875,83.9375,81.64062,83.0625,29836496,42345669.6,49.894461006867836,44.73449147415358,NaN,NaN,63.65543483793303,0.5903217726977601,0.6139278654370908,-1.5822265011479857,-2.1961543665850765,337097750,306573714.8,7.895257907977879,7.61099819980606,NaN,NaN,-10.077698859725604,-15.385930583200041
2000-11-06T09:30:00-05:00,83.625,84.125,82,82.4375,23478608,42077880,48.822139744498855,45.60032592001202,NaN,NaN,60.17959892928702,30.648203572814356,0.6510473378021513,-1.3823451943323875,-2.0333925321345387,313619142,312899551.6,12.317723561223715,7.748563202902045,NaN,NaN,-8.957903773167285,-14.467641038909647
2000-11-07T09:30:00-05:00,81.4375,82.46875,80.25,82.125,24339200,41531360,48.26360902587491,46.44883161528933,NaN,NaN,21.748520225539526,37.137993016068606,0.6387791583365785,-1.2349185842138155,-1.873697742550394,289279942,305585068.4,11.622790106260098,7.922311949756078,NaN,NaN,-8.18152626110319,-13.569624642080154
2000-11-08T09:30:00-05:00,82.125,82.25,75.625,75.70312,40330096,41124724.8,38.51295146514287,45.657815423859574,NaN,NaN,-87.25857645080018,19.447609552727133,0.20485660785322146,-1.6176269827338672,-1.8224835905870886,248949846,299241586.8,11.041020913142802,8.058053332826193,NaN,NaN,-10.469915490030228,-13.126809048930165
2000-11-09T09:30:00-05:00,74.75,76.9375,73,75.6875,64953696,41711224.8,38.49258129423445,44.72831953870745,NaN,NaN,-158.6939138265713,-20.07378725692237,-0.06223815910107788,-1.900281289463436,-1.8380431303623581,183996150,274588566,9.128643109497517,8.06245003091569,NaN,NaN,-12.293835854979719,-13.007812878365815
2000-11-10T09:30:00-05:00,74.25,75.6875,71.75,71.75,49227008,42052070.4,33.65954231836895,43.468621405851955,NaN,NaN,-185.17613826315826,-69.84010187714063,-0.4609103203128313,-2.4141810307533973,-1.953270710440566,134769142,234122844.4,6.98884914326257,7.967103345392766,NaN,NaN,-15.459259443248442,-13.358019530491905
2000-11-13T09:30:00-05:00,70.95312,74.1875,68.26562,70.0625,75015504,44421145.6,31.815824943796684,42.504062971242355,NaN,NaN,-195.04608916536193,-120.88523949607043,-0.7765133382598925,-2.9239123832654315,-2.147399045005539,59753638,183349743.6,5.307709008176644,7.784933318720102,NaN,NaN,-18.66785503085069,-14.116567459114588
2000-11-14T09:30:00-05:00,73,76,72.75,75.84375,44828000,44058425.6,43.27873098402458,42.78696091607262,NaN,NaN,-96.30198972310828,-144.4953414858,-0.5450977872067737,-2.8287712790140063,-2.2836734918072326,104581638,146410082.8,4.466001804945577,7.56274115335517,NaN,NaN,-17.81397204885042,-14.644768114791136
2000-11-15T09:30:00-05:00,75.5625,78.0625,74.79687,77.375,37757104,42707750.4,45.8742493687671,43.00022989824687,NaN,NaN,-56.97929017048878,-138.4394842297377,-0.2529354633034382,-2.59984282093653,-2.346907357633092,142338742,125087862,4.0652584609784554,7.296188326568112,NaN,NaN,-16.2838041292438,-14.878916116855802
2000-11-16T09:30:00-05:00,75.375,77,72.875,72.875,33888000,42279965.6,40.071137565014055,42.81408097971717,NaN,NaN,-94.3885338049779,-125.57840822541903,-0.32233766464832536,-2.7498294384434985,-2.427491773795173,108450742,109978780.4,3.8047264033007338,7.081100772615004,NaN,NaN,-16.895723729679972,-15.167031490116397
2000-11-17T09:30:00-05:00,73.1875,75.1875,71,72.82812,49911296,42740985.6,40.014348138143504,42.901654525442495,NaN,NaN,-107.64243667612182,-110.07166790801173,-0.3298009398340769,-2.8397429485877694,-2.5099420087536926,58539446,94732841.2,3.557007798846911,6.910078224833896,NaN,NaN,-17.387780071265134,-15.484281287423359
2000-11-20T09:30:00-05:00,70.9375,72.0625,69.25,69.85937,46860192,43634585.6,36.48776754039302,42.12106672509545,NaN,NaN,-144.36335026022888,-99.93512012698514,-0.48376609316714303,-3.1146496252126212,-2.630883532045478,11679254,85117964.4,3.4063808700126685,6.740731311561718,NaN,NaN,-18.926975065066408,-15.976094684229508
2000-11-21T09:30:00-05:00,70.1875,71.125,68.4375,69.75,42124192,44167935.2,36.36062856175929,41.40305743702362,NaN,NaN,-137.37366802901605,-108.14945578816669,-0.5379031254077478,-3.303262438805163,-2.7653593133974153,-30444938,58112649.2,3.0196059645573143,6.554373896234357,NaN,NaN,-20.186663057237215,-16.57760445180204
2000-11-22T09:30:00-05:00,68.4375,70.125,66.5,66.625,56618800,44567215.2,32.83962760985011,40.313399969052554,NaN,NaN,-148.30862813892017,-126.41532338185296,-0.7178563441614836,-3.66267974359927,-2.9448233994377864,-87063738,12232153.2,2.500203526435982,6.365798469901317,NaN,NaN,-22.370997872092207,-17.40523208327206
2000-11-24T09:30:00-05:00,68.375,70.625,68.17187,70.4375,19980000,42066459.2,40.41983326702871,39.63664084477832,NaN,NaN,-100.6860256763847,-127.67482175613432,-0.5228640835205915,-3.598403503838526,-3.0755394203179343,-67083738,-22874742.8,2.1898121904009145,5.958266632931534,NaN,NaN,-21.89468375929962,-18.04658232270457
2000-11-27T09:30:00-05:00,72.5625,72.9375,68.75,69.5625,35415600,41284969.6,39.32286041755094,38.95812089285347,NaN,NaN,-81.55376978047757,-122.45708837700548,-0.4010386629428382,-3.576837748996482,-3.175799086053644,-102499338,-55082499.6,1.950564736701665,5.217755288322816,NaN,NaN,-21.841662288952048,-18.588736603597066
2000-11-28T09:30:00-05:00,68.9375,69.9375,65.3125,65.45312,48807392,41950634.4,34.5767439808602,37.98048767535242,NaN,NaN,-121.2019838860287,-117.82481510216545,-0.5369556173570116,-3.8469936077499085,-3.310037990392897,-151306730,-87679696.4,1.7430048135194482,4.512056338841341,NaN,NaN,-23.303422329782585,-19.262263135909283
2000-11-29T09:30:00-05:00,65.8125,66.75,62.5,62.9375,66173872,43066208,32.028270091165695,37.517296148639765,NaN,NaN,-145.55354931819014,-119.46079136000026,-0.724361637421091,-4.2154900371692605,-3.4911283997481695,-217480602,-125086829.2,1.5404306170045032,3.8334427462600345,NaN,NaN,-25.34250543214858,-20.130869178229183
2000-11-30T09:30:00-05:00,61.75,64.25,60.5,62.98437,74865504,44550228,32.128643164843155,37.062729139397526,NaN,NaN,-148.68960043590494,-119.5369858193972,-0.7690327810289497,-4.4524193760343564,-3.6833865950054068,-142615098,-136197101.2,1.4852189360692876,3.287483876729447,NaN,NaN,-26.92784328774379,-21.10186547958841
2000-12-01T09:30:00-05:00,64.0625,66.76562,62.125,64,57110400,46076048,34.38957265004089,37.11487416308837,NaN,NaN,-113.7844688085036,-122.15667444582098,-0.6583219528773117,-4.5062890361020465,-3.847967083224735,-85504698,-139881293.2,1.4664492029046983,2.893026738132456,NaN,NaN,-27.593589765829062,-22.029254663337078
2000-12-04T09:30:00-05:00,64.125,65.35937,61.75,63.6875,49076000,47038023.2,34.01411680537949,37.27189501034429,NaN,NaN,-114.25297303064879,-128.69651509585523,-0.5392820645792509,-4.522069663948798,-3.9827875993695474,-134580698,-146297565.2,1.432495581137104,2.6162257790582033,NaN,NaN,-28.245082509247972,-22.917230069895776
2000-12-05T09:30:00-05:00,66.0625,71,65.5,70.6875,76517184,49689952,47.769908200382,37.592693382941256,NaN,NaN,-28.803906657956425,-110.21689965024078,0.04663384918660807,-3.9244952878862875,-3.9711291370728956,-58063514,-127648922,8.093138838565338,2.875306995745329,NaN,NaN,-24.47421366141823,-23.139656297256128
2000-12-06T09:30:00-05:00,70.59375,72.29687,67.75,68,63346800,51640332,43.979227049545806,37.45733464585402,NaN,NaN,-16.08611283135616,-84.32341235287399,0.27612402423528914,-3.6259741067787843,-3.9020981310140734,-121410314,-108434864.4,14.503565664112344,3.620900367397749,NaN,NaN,-22.500982507537483,-23.048417184439177
2000-12-07T09:30:00-05:00,67,68.98437,65.5,66.5,41471296,51697392,41.977051081113096,37.59347132557538,NaN,NaN,-54.8480686052497,-65.55510598674293,0.3453373304575864,-3.47042646794209,-3.8157637983996766,-162881610,-112488166.8,14.277330234442346,4.368943498193579,NaN,NaN,-21.506174595068686,-22.828096814529108
2000-12-08T09:30:00-05:00,71.09375,74,67.625,68,65840496,51741732,44.688817503133,37.9273619945032,NaN,NaN,11.118994038159698,-40.57441341741027,0.5011298223190161,-3.1893515205009066,-3.690481342819923,-97041114,-114795450,14.142099223530636,5.125021457099559,NaN,NaN,-19.855873215392343,-22.403493443223855
2000-12-11T09:30:00-05:00,72.05859,74.78125,70.95312,74.375,51822800,51871521.6,54.43542392191825,39.20933745032642,NaN,NaN,88.52941954413777,-0.017934902452955724,1.0129905054411559,-2.424243211018478,-3.437233716459634,-45218314,-96922973.2,20.429214945094202,6.3409381767482405,NaN,NaN,-15.012605064100226,-21.347652246206195
2000-12-12T09:30:00-05:00,73.5,73.875,71.3125,71.65625,31047696,49673131.2,50.35976398547452,40.20927569487752,NaN,NaN,61.35924858063886,18.014696145266107,1.1385445592286856,-2.0140530174237767,-3.1525975766524623,-76266010,-100563472.4,20.106244319154868,7.561412344933779,NaN,NaN,-12.364116876647113,-20.0642900505549
2000-12-13T09:30:00-05:00,73.4375,73.5,68.3125,68.73437,51659104,50014686.4,46.34383448502515,41.17386190024716,NaN,NaN,22.164751207432325,25.664868953023802,0.9998290953789319,-1.9028112074287975,-2.9026403028077294,-127925114,-101866432.4,19.984469136303375,8.810288459924308,NaN,NaN,-11.48733471653772,-18.839010717123873
2000-12-14T09:30:00-05:00,68.51562,69.6875,65.25,65.375,41511600,50202411.2,42.17916518807063,41.29952846603586,NaN,NaN,-48.60436555584899,26.91360956290395,0.6725479089603286,-2.0619554166073186,-2.734503325567647,-169436714,-103177453.2,19.854169637526567,10.07202827757614,NaN,NaN,-12.1375163434784,-17.881654378031662
2000-12-15T09:30:00-05:00,64.25,65.625,62.5625,63.875,59023600,51459191.2,40.432008035332515,41.3787532958774,NaN,NaN,-103.6491289541473,3.959984964442552,0.36136177820491433,-2.2828011028115043,-2.6441628810164186,-228460314,-129461293.2,17.404163365335933,11.175856751050016,NaN,NaN,-13.222383704183407,-17.216044281767626
2000-12-18T09:30:00-05:00,65.15625,65.96875,62.5625,64,42734496,51100351.2,40.6526250188372,41.81274479859005,NaN,NaN,-90.13550169403146,-31.77299928319129,0.1794566948262557,-2.419842012483599,-2.599298707309855,-185725818,-157562794,15.23897097090942,12.139854333720729,NaN,NaN,-14.01509252731025,-16.758765459702285
2000-12-19T09:30:00-05:00,63.45312,65.85937,58.75,59.125,80489680,52781825.6,35.18026808010481,42.0378875120857,NaN,NaN,-141.7775459506436,-72.40035818944779,-0.2313791047883127,-2.8885225882952454,-2.6571434835069327,-266215498,-195552691.6,12.902135063504161,12.951404651327847,NaN,NaN,-16.487013817312558,-16.719943796503753
2000-12-20T09:30:00-05:00,57.3125,58.375,54.75,55.73437,81399376,54745584.8,31.95803902676505,42.02570150222298,NaN,NaN,-209.8376824527981,-118.80084492149388,-0.6689111653007864,-3.4932824401329157,-2.8243712748321292,-347614874,-239490643.6,10.833044607283398,13.619106484985997,NaN,NaN,-19.645944702936063,-17.137943925994083
2000-12-21T09:30:00-05:00,55.01562,58.75,54.25,56.0625,85869120,56208100.8,32.6014053544784,41.897975266825654,NaN,NaN,-170.21653207108386,-143.12327822454085,-0.8613926120009201,-3.9011120398332793,-3.039719427832359,-261745754,-257952451.6,10.100113347997407,14.23579678106405,NaN,NaN,-21.955033609730943,-17.82609959509935
2000-12-22T09:30:00-05:00,57.625,60.75,57.625,60.5,57243008,58071251.2,40.75931165386464,42.37977489886031,NaN,NaN,-100.43094459102855,-142.4796413519171,-0.6259772047192942,-3.822190933731477,-3.196213729012183,-204502746,-253160938,11.768586144913698,14.97408896419095,NaN,NaN,-21.423277762751628,-18.339982190478246
2000-12-26T09:30:00-05:00,60.59375,61.92187,58,60.875,37078896,58154416,41.404769263917444,41.925122117684275,NaN,NaN,-81.61341543464624,-140.77522410004005,-0.39253773434427597,-3.6868858969425276,-3.2943481625982516,-167423850,-249500544.4,13.095497797131799,15.331400318374266,NaN,NaN,-20.805159177459707,-18.6921503314756
2000-12-27T09:30:00-05:00,59.6875,62.1875,58.9375,61.5625,33952496,57411671.2,42.638705425595084,41.829370573116364,NaN,NaN,-64.85409048841355,-125.39053300759403,-0.15173633287774546,-3.4840185786954336,-3.332282245817688,-133471354,-222951715.6,22.230908142187417,15.883353352522487,NaN,NaN,-19.942336684644825,-18.870748381928344
2000-12-28T09:30:00-05:00,60.78125,62.48437,60.25,61.4375,30996304,55652792.8,42.463612196583995,41.86412493850714,NaN,NaN,-52.898525137186496,-94.00270154447172,0.02955016294619739,-3.2953445421349414,-3.324894705081139,-164467658,-186322272.4,32.73680032779052,17.201886930618784,NaN,NaN,-19.283286050449703,-18.929682334574252
2000-12-29T09:30:00-05:00,61.5625,62.23437,58,58.375,49190608,54369048,38.31256787450094,41.40867853646199,NaN,NaN,-78.35051759938362,-75.6294986501317,-0.023501207027263327,-3.3542712138652178,-3.3307700068379544,-213658266,-176704774.8,35.21159763996434,18.706851103221194,NaN,NaN,-19.870654880513044,-19.06410698399408
2001-01-02T09:30:00-05:00,58.5625,58.6875,52.4375,53.4375,62512896,54639172.8,32.7533701223454,39.85996040792107,NaN,NaN,-132.60137908706537,-82.06358554933905,-0.34025452657989863,-3.7560881650628275,-3.415833638482929,-276171162,-191038458,33.24818981854689,19.62249216561067,NaN,NaN,-22.141002734533725,-19.50366351978546
2001-01-03T09:30:00-05:00,52.1875,65.25,52.15625,62.4375,118227184,58096732,47.661207453592496,39.667206369929495,NaN,NaN,-54.0162824042304,-76.54415894325588,0.08454781139911827,-3.310148874234031,-3.394696685633149,-157943978,-189142483.6,33.77422066838214,20.598776190555473,NaN,NaN,-19.029750407097247,-19.435961646544285
2001-01-04T09:30:00-05:00,61.625,63.625,60.23437,61.3125,58452608,57193503.2,46.280082592881385,39.6626526633478,NaN,NaN,-25.172657571728934,-68.60787235991896,0.3055274809708175,-3.0127873344196274,-3.318314815390445,-216396586,-205727530,31.440211631668646,21.417043511652995,NaN,NaN,-17.078451383714523,-19.099174466140035
2001-01-05T09:30:00-05:00,61.3125,61.3125,56,56.625,68776368,57464981.6,40.95476208491398,39.57519529883662,NaN,NaN,-73.45113528024405,-72.71839438853047,0.1591241449741183,-3.119409634172797,-3.2785337791469154,-285172954,-229868589.2,28.367239731065652,22.025119946905786,NaN,NaN,-17.24328878811429,-18.834047940707787
2001-01-08T09:30:00-05:00,56.3125,57.5,53.51562,57.25,55546608,58168747.2,41.914478533974496,39.68108604873961,NaN,NaN,-94.18828824758684,-75.8859485181711,0.12879562618914253,-3.1175392464104874,-3.24633487259963,-229626346,-233062205.2,27.977660689440214,22.78036975577038,NaN,NaN,-17.06187934353974,-18.58088099825521
2001-01-09T09:30:00-05:00,57.75,59.125,56.625,57.25,53307904,57542117.6,41.914478533974496,39.771218442678,NaN,NaN,-67.09634405032777,-62.78494151082359,0.13263083398898434,-3.0805463301133997,-3.213177164102384,-229626346,-223753242,30.954248955438516,23.90288961180817,NaN,NaN,-16.91919711966607,-18.34349758702819
2001-01-10T09:30:00-05:00,56.125,60.375,55.75,60.1875,74232496,58662602.4,46.64191319914104,40.58990737975201,NaN,NaN,-44.07287439576953,-60.796259909131415,0.344840250785837,-2.782126850620088,-3.126967101405925,-155393850,-223243216.4,31.12220904495537,25.204323467626118,NaN,NaN,-15.356480282088286,-17.916780829179633
2001-01-11T09:30:00-05:00,59.26562,63.6875,59.1875,61.9375,65401296,60380282.4,49.28979077684319,41.82788964761473,NaN,NaN,27.22849721378232,-50.316028952029164,0.599960780145802,-2.3770161262236726,-2.9769769063694747,-89992554,-197962410,39.03828490033652,27.21898348855848,NaN,NaN,-13.256527585471057,-17.251030365792694
2001-01-12T09:30:00-05:00,62.75391,64.625,61.5,62.73437,60792704,60836962.4,50.494508071456224,43.105968413113146,NaN,NaN,79.13948225220278,-19.797905445539808,0.8064093619261161,-1.9689652039618295,-2.7753745658879456,-29199850,-146767789.2,51.25555011334323,30.158657543226038,NaN,NaN,-11.180912914990367,-16.38387072996379
2001-01-16T09:30:00-05:00,62.5625,62.92187,60.5625,61.98437,32137200,60368242.4,49.3072129926215,43.716532794452924,NaN,NaN,60.62061612478855,11.163875428935263,0.8709733344134989,-1.686657897871072,-2.557631232284571,-61337050,-113109930,57.31262711399297,33.4118033267317,NaN,NaN,-9.781865461273002,-15.44072712015082
2001-01-17T09:30:00-05:00,64.5,65.60937,63.14062,63.875,61377904,60485957.6,52.348919058473626,44.49825777977836,NaN,NaN,133.49354259368027,51.28185275773687,1.009755945630951,-1.295436300245882,-2.305192245876833,40854,-67176490,63.9046196780213,37.04102631822381,NaN,NaN,-7.716862759400812,-14.337317925757961
2001-01-18T09:30:00-05:00,64.125,66.75,62.6875,66.5625,54874192,61092942.4,56.357640753881554,45.47818173179883,NaN,NaN,162.42953733167937,92.58233510322665,1.236335091656691,-0.759773381305969,-1.9961084729626601,54915046,-25114710.8,68.67498767509538,40.3584605705744,NaN,NaN,-4.735839314766901,-12.96567812418781
2001-01-19T09:30:00-05:00,68.14062,68.3125,65.5625,66.3125,56280400,59882478.4,55.886644553033214,46.43696975725948,NaN,NaN,174.6994787439457,122.07653140925932,1.3157835063366403,-0.35137909004185985,-1.6671625963785002,-1365354,-7389270.8,70.4474972724079,43.05208178090421,NaN,NaN,-2.409339757500015,-11.457629786089555
2001-01-22T09:30:00-05:00,65.875,67,64.75,66.375,35771392,57601079.2,55.98567832140797,47.699334789181414,NaN,NaN,138.25769158794347,133.90017327640746,1.3157924950016113,-0.02242197762648601,-1.3382144726280973,34406038,5331906.8,71.68577209579612,45.657379956320774,NaN,NaN,-0.4504076308397797,-9.88516947819673
2001-01-23T09:30:00-05:00,65.90625,68.40625,65.3125,67.76562,49829200,55799083.2,58.232481464643456,49.51927131363128,NaN,NaN,148.27328502137786,151.43070705572532,1.3477684776531036,0.34649612443828204,-1.0012723532148216,84235238,34446364.4,74.33616578707208,48.592235382644,NaN,NaN,1.8589852009075518,-8.207433095467547
2001-01-24T09:30:00-05:00,68.0625,69.125,66.75,67.125,53866608,55630263.2,56.7941747487235,50.171626120426346,NaN,NaN,138.9556368352392,152.52312590403713,1.2654036905442627,0.5804822599655068,-0.6849214305787559,30368630,40511919.6,74.86406051765478,51.52722394330634,NaN,NaN,3.4665545343103115,-6.539720576927853
2001-01-25T09:30:00-05:00,66.875,67.67187,64.39062,64.5,57076192,56630128,51.21237066159014,50.5239324110484,NaN,NaN,79.37154818136418,135.91152807397407,0.9861674156379834,0.5477878389687234,-0.43837957666926,-26707562,24187398,70.65190635927154,54.32805928099226,NaN,NaN,3.424643615106835,-5.116239978065755
2001-01-26T09:30:00-05:00,63.5625,65.9375,63,65.54687,45679808,57216493.6,53.18830842339155,51.39775714951109,NaN,NaN,57.70005955591858,112.51164423636865,0.8302564233822045,0.5994409525584956,-0.23081547082370885,18972246,28254918,71.08839901162659,57.379570658175176,NaN,NaN,3.916109871358786,-3.8259042852908207
2001-01-29T09:30:00-05:00,64.75,67.25,64.25,67,31507808,57242068.8,55.860614654921484,52.393909729578716,NaN,NaN,76.78918205460657,100.21794232970129,0.7838506826988081,0.7489978825498014,-0.03485280014900677,50480054,31469721.2,71.44982156232001,60.48472500623802,NaN,NaN,5.066289143259307,-2.5555909383550883
2001-01-30T09:30:00-05:00,67.14999,67.74001,66,66.75,42830000,56924038.4,55.27597466037111,53.34830231003561,NaN,NaN,81.571059416029,86.87749720863152,0.6980370457998755,0.8376935071008376,0.1396564613009621,7650054,16152684.4,67.14307440766491,63.06964110996847,NaN,NaN,5.879586348868725,-1.3505656116088296
2001-01-31T09:30:00-05:00,67.25,68,64.3,64.3,59310496,56763918.4,49.77767758792016,53.5722854806627,NaN,NaN,50.36756914094412,69.1598836697725,0.45003196763279635,0.7021964208419575,0.2521644532091612,-51660442,-253130,62.778265255291565,65.33078798213533,NaN,NaN,5.106062280726497,-0.4281901984180687
2001-02-01T09:30:00-05:00,64.55,65.61,63.60001,65.14999,45153808,53110249.6,51.57726730184044,53.73567666101964,NaN,NaN,30.087496490632372,59.30307333162615,0.3229412107909981,0.6558409666979088,0.33289975590691073,-6506634,3787055.6,63.40911389154792,67.07156148150759,NaN,NaN,4.9280303899527595,0.33698417134919234
2001-02-02T09:30:00-05:00,64.94,65.3,60,61.55,47438304,52559534.4,44.331831027415014,53.29548544358813,NaN,NaN,-28.1138845764197,42.1402845051585,-0.006423860441636786,0.3248699303548648,0.33129379079650156,-53944938,-10796381.2,59.48976383330512,67.659719604362,NaN,NaN,2.6059962229837996,0.6611287501541363
2001-02-05T09:30:00-05:00,61.19,61.89999,60.12,61.5,36015200,50921476,44.23887796353158,52.93346151293884,NaN,NaN,-61.57840014887031,14.466768064463116,-0.21873798229235664,0.05787131293105574,0.2766092952234124,-89960138,-38884419.6,52.72951948750422,67.33235477389852,NaN,NaN,0.6897589419110809,0.6652187775479855
2001-02-06T09:30:00-05:00,61.49001,63.12,61.16,61.60001,42399008,50264096,44.48959310159467,52.37208108744749,NaN,NaN,-56.79690800202727,-13.206825419148135,-0.3364851437672626,-0.14399713448566587,0.1924880092815967,-47561130,-49926656.4,50.30911921981642,66.36124759831246,NaN,NaN,-0.8325165813016816,0.4512565834266045
2001-02-07T09:30:00-05:00,60.50999,61.2,58.58,60.60001,61951808,50696291.2,42.43505103413997,51.377610393180234,NaN,NaN,-120.16140673789792,-47.31262059491657,-0.4582202164420834,-0.38028726127100754,0.07793295517107585,-109512938,-61497155.6,47.83154045426393,64.87242993968164,NaN,NaN,-2.7101875862854397,-0.00037829796083038714
2001-02-08T09:30:00-05:00,60.89999,61.5,58.58,58.78999,48146608,49391996.8,38.93063137141165,50.16646659449298,NaN,NaN,-140.04695460506667,-81.33951081405637,-0.6267224884149447,-0.705470155347605,-0.07874766693266036,-157659546,-91727738,42.01029881059198,62.84120147812336,NaN,NaN,-5.372781634994652,-0.7678644889656621
2001-02-09T09:30:00-05:00,58.25,58.60001,56,56.39999,55403104,48892087.2,34.83933916204208,48.65601379739542,NaN,NaN,-190.07555787729183,-113.7318454742308,-0.8512889086799275,-1.1428588027825697,-0.2915698941026422,-213062650,-123551280.4,36.91684339371472,60.35770657083183,NaN,NaN,-8.989188022387612,-1.942339279454512
2001-02-12T09:30:00-05:00,56.25,57.94,55.62,57.08,50540304,48379467.2,36.87212807262759,47.13027426939427,NaN,NaN,-160.7580449550144,-133.56777443545963,-0.9013619824048826,-1.4182723721087456,-0.5169103897038629,-162522346,-138063722,34.842220298002346,57.5367104644697,NaN,NaN,-11.453842504660797,-3.301125454483981
2001-02-13T09:30:00-05:00,57.64999,59.17999,54.98,55.3,58908800,49718047.2,33.891631260104106,45.494378305921465,NaN,NaN,-146.87666005881127,-151.58372484681644,-0.9943787986333378,-1.7598838879955352,-0.7655050893621974,-221431146,-172837725.2,30.429482668309873,54.36281204665935,NaN,NaN,-14.495195919602816,-4.900278378072386
2001-02-14T09:30:00-05:00,55.39999,57.75,54.125,57.45,63039600,49801132,40.181336650169484,44.706447305105705,NaN,NaN,-125.77948687673643,-152.70734087458413,-0.8563660162670852,-1.835962609696054,-0.9795965934289688,-158391546,-182613446.8,29.305822422776416,51.409520336909694,NaN,NaN,-15.3238441150877,-6.3893591976460025
2001-02-15T09:30:00-05:00,58.8,60.49001,58.3,58.39999,67767808,50445812.8,42.77220949169129,43.962440238555686,NaN,NaN,-67.43560357495255,-138.1850706685613,-0.6554132187774515,-1.7988631169007832,-1.1434498981233316,-90623738,-169206285.2,32.962055227568555,48.68621006661983,NaN,NaN,-15.25995304536777,-7.6565868901776835
2001-02-16T09:30:00-05:00,55.96001,56.87,54.53,55.13,66756192,50969602.4,36.854988980849384,42.604895547550534,NaN,NaN,-120.26370640923244,-124.22270037494943,-0.6933605625175723,-2.010150601270297,-1.3167900387527247,-157379930,-158069741.2,35.926392714497425,46.14882229177537,NaN,NaN,-17.05314607263405,-8.998952487671449
2001-02-20T09:30:00-05:00,55.74001,55.84,52.3,52.99001,55293008,51945683.2,33.58084556336813,41.05524346919317,NaN,NaN,-134.2959765982493,-118.93028670359641,-0.8053623549634181,-2.3234929824569974,-1.5181306274935793,-212672938,-168099859.6,34.44890890137742,43.81352475561197,NaN,NaN,-19.63587613846286,-10.518513009213079
2001-02-21T09:30:00-05:00,51.55,54.07001,50.92,51.5,72319632,53070204.8,31.48360616870802,39.74852408210659,NaN,NaN,-142.52886439679554,-118.06072757119327,-0.9145929333075264,-2.6613717941279873,-1.7467788608204609,-284992570,-180812144.4,32.617992221165,41.65921953888864,NaN,NaN,-22.452679274329252,-12.223393904229674
2001-02-22T09:30:00-05:00,51.45,52.16,48.89,51,103867184,55570233.6,30.788720233563268,38.26362786294393,NaN,NaN,-149.50808738791358,-122.80644767342872,-0.9510958532739624,-2.935648677412914,-1.9845528241389514,-388859754,-226905786,27.012005874980375,39.05942610913382,NaN,NaN,-24.943639885175596,-14.040571901507663
2001-02-23T09:30:00-05:00,50.09,51.60001,48.23,51.17999,93314320,57382140,31.37589689819748,37.33820399657126,NaN,NaN,-137.08091553046393,-136.73551006453096,-0.8945378294994044,-3.102725111013207,-2.2081872815138026,-295545434,-267890125.2,23.19478898564688,36.466927905729655,NaN,NaN,-26.801772850278326,-15.8636006084749
2001-02-26T09:30:00-05:00,52.08099,52.60001,50.25,52.14999,78335008,59014900,34.59624367542237,36.649444404563454,NaN,NaN,-103.91467343576673,-133.46570346983782,-0.7301604488896136,-3.1208878426258195,-2.390727393736206,-217210426,-279856224.4,22.208011961648197,34.28682022531137,NaN,NaN,-27.475722775706018,-17.522475203793633
2001-02-27T09:30:00-05:00,51.53999,52.08,48.89999,49,66727312,60775875.2,29.718924550067598,35.594396650882956,NaN,NaN,-118.49515337860245,-130.30553882590846,-0.768084871528703,-3.3508334831470847,-2.5827486116183818,-283937738,-294109184.4,21.058801916753097,32.19751184652113,NaN,NaN,-29.58360294104072,-19.24549345197179
2001-02-28T09:30:00-05:00,49.45,50.21001,46.86,47.45,102211680,63744959.2,27.653056528116224,34.53853990045268,NaN,NaN,-136.2143171886669,-129.04262938428275,-0.8269618395836713,-3.616450911097971,-2.7894890715142995,-386149418,-314340554,19.515093512533284,30.174908493540368,NaN,NaN,-32.00741744425575,-21.068625450869497
2001-03-01T09:30:00-05:00,46.97,49.2,45.75,48.8,101703184,65864593.6,32.08143507739567,34.049311593737265,NaN,NaN,-125.00522176669502,-124.14205626003903,-0.7089289908512146,-3.6756503100783178,-2.966721319227103,-284446234,-293457850,25.579267862176536,29.001263425796413,NaN,NaN,-32.7080463600885,-22.731399866472213
2001-03-02T09:30:00-05:00,47.2,49.63,45.64999,46.7,95924368,68403121.6,29.097742607623502,33.639197554135926,NaN,NaN,-119.58877771460264,-120.64362869686674,-0.704755120838878,-3.847665220275701,-3.142910099436823,-380370602,-310422883.6,23.997386680360492,28.078445089128248,NaN,NaN,-34.23620387226755,-24.374943295871546
2001-03-05T09:30:00-05:00,47.5,48.36,47.09,47.55,43869104,68224661.6,31.860137964886533,33.28119826072585,NaN,NaN,-102.8562881769003,-120.43195164509345,-0.5822962662965798,-3.870780432307548,-3.288484166010968,-336501498,-334281098,21.942275552696444,27.157020464463535,NaN,NaN,-34.66100269100236,-25.844380352318804
2001-03-06T09:30:00-05:00,49.3,50.66,49.10001,49.39999,60815296,69464666.4,37.56191807484869,33.54336160463618,NaN,NaN,-64.11462301434288,-109.55584557224157,-0.326973973902283,-3.697201633388822,-3.370227659486539,-275686202,-332630790.8,22.43708391501859,26.586134839228443,NaN,NaN,-33.27416203754385,-26.90577773592238
2001-03-07T09:30:00-05:00,50.39999,50.42999,48.97,49.42,55187600,70104096,37.62271730186954,33.36060307975761,NaN,NaN,-59.93269410545572,-94.29952095559932,-0.11779967772876532,-3.5174772566474957,-3.3996775789187303,-220498602,-299500627.6,31.78556199042754,26.76325909406066,NaN,NaN,-32.14262950377882,-27.65389941704473
2001-03-08T09:30:00-05:00,49.35001,49.81,48.10001,48.5,48927392,69452875.2,35.892207374628754,32.86917435711028,NaN,NaN,-68.83698399929806,-83.06587340211993,-0.00823606667200627,-3.4099726622587383,-3.401736595586732,-269425994,-296496579.6,32.579066722593055,26.7359027722767,NaN,NaN,-31.667079872733368,-28.227210910714536
2001-03-09T09:30:00-05:00,47.25,47.37,44.95,45.10001,79986816,71044885.6,30.338396847246898,32.40370349042439,NaN,NaN,-119.03705325750579,-82.95552851070056,-0.12509840523289428,-3.5581096021278498,-3.4330111968949555,-349412810,-290305021.2,34.276038948850044,26.618020360444746,NaN,NaN,-32.93565068037807,-28.89984516352361
2001-03-12T09:30:00-05:00,44,44.95,41.8,42.3,80650000,72307230.4,26.677387673936693,31.910599355465006,NaN,NaN,-159.6818329066455,-94.3206374566496,-0.3391795790136518,-3.85698567066202,-3.517806091648368,-430062810,-309017283.6,31.680746022851523,26.420294440550038,NaN,NaN,-35.24739373642189,-29.806637816794794
2001-03-13T09:30:00-05:00,42.78,44.74001,42.13,44.45,80001376,73780284,33.33013913276096,32.04249456718308,NaN,NaN,-135.4638167981998,-108.59047621342097,-0.286302013442826,-3.875683608451901,-3.589381595009075,-350061434,-323892330,29.7521935513206,26.21559453556116,NaN,NaN,-35.016946030360835,-30.550967561589943
2001-03-14T09:30:00-05:00,42.7,45.19,42.31,43.75,97182880,75693988,32.30249281285239,32.15062117998944,NaN,NaN,-126.07697460009602,-121.81933231234905,-0.2500996129386732,-3.9020061111824162,-3.651906498243743,-447244314,-369241472.4,24.79633419041241,26.05733227237773,NaN,NaN,-35.15223655423205,-31.208291703395957
2001-03-15T09:30:00-05:00,45.2,45.319,42.05,42.14999,74099808,76246998.4,30.02382067261749,32.05404430673373,NaN,NaN,-125.19734221531397,-133.09140395555224,-0.28311318050743095,-4.005797973878032,-3.722684793370601,-521344122,-419625098,20.675690791775693,25.87739668710122,NaN,NaN,-35.974812725355925,-31.889223277961666
2001-03-16T09:30:00-05:00,41.88,42.8,40.56,41.10001,77770816,76747148.8,28.598126420213234,31.625607359933074,NaN,NaN,-149.24171843324626,-139.1323369907003,-0.3220324483279535,-4.125225353780543,-3.8031929054525895,-599114938,-469565523.6,17.560638384255697,25.545441431573185,NaN,NaN,-37.08966463242057,-32.6321434714558
2001-03-19T09:30:00-05:00,41.44,43.25999,40.75,43.25999,53233808,76071029.6,35.39458604720036,32.03101175258542,NaN,NaN,-115.21106244242092,-130.23818289785538,-0.15702695708531067,-3.999476601809228,-3.842449644723917,-545881130,-492729187.6,16.33157810833265,25.207782588114583,NaN,NaN,-35.92911174977272,-33.10313893978679
2001-03-20T09:30:00-05:00,43.44,43.81,40.2,40.35001,104988192,78555788.8,31.099677013329398,32.277198930100646,NaN,NaN,-119.32516765695381,-127.0104530696062,-0.1960503447010722,-4.0875125756002575,-3.8914622308991853,-650869322,-552890765.2,13.657877688065255,24.78941002922401,NaN,NaN,-36.29476812009541,-33.559085965545165
2001-03-21T09:30:00-05:00,40.52,41.8,39.71001,40.35001,96083008,79743957.6,31.099677013329398,32.20707335409591,NaN,NaN,-120.44510844357181,-125.88407983830136,-0.17475444667853823,-4.109905289247358,-3.9351508425688198,-650869322,-593615766.8,12.201648657153399,23.833865800293783,NaN,NaN,-36.581515893627575,-33.990861669556935
2001-03-22T09:30:00-05:00,40.60001,42.8,39.49001,42.8,130194192,81060308,38.39848892667333,32.87141237688518,NaN,NaN,-87.98193902250244,-118.44099919973905,0.039982983748987344,-3.885172112882586,-3.925155096631573,-520675130,-593481968.4,12.234757462942596,22.99367799904965,NaN,NaN,-34.53029754295297,-34.06792393718494
2001-03-23T09:30:00-05:00,43.55,43.83,41.5,42.8,95267632,81157973.6,38.39848892667333,33.33843744558424,NaN,NaN,-60.280954176073614,-100.64884634830455,0.20826516067860634,-3.664823645783315,-3.8730888064619213,-520675130,-577794006.8,16.22388264720425,22.585221362943063,NaN,NaN,-32.90100942219467,-33.90122186361491
2001-03-26T09:30:00-05:00,43.47,43.5,41.55,41.81,57662704,80124358.4,36.58237510906885,33.26847009088568,NaN,NaN,-63.156259808602826,-90.23788582154091,0.27495428930740706,-3.5293959448276624,-3.8043502341350695,-578337834,-584285347.6,15.901809708243846,22.11841606245915,NaN,NaN,-32.04852725654938,-33.63655120546269
2001-03-27T09:30:00-05:00,41.8,43.72,41.42,43.25,69925184,80284252,40.95670465307746,33.50661204454339,NaN,NaN,-46.66735290440724,-75.7063228710316,0.4289211557584376,-3.2681987894370224,-3.69711994519546,-508412650,-555794013.2,23.116165217701223,21.499173435835843,NaN,NaN,-30.029673078247264,-33.12128290157477
2001-03-28T09:30:00-05:00,41.89999,42.2,39.67999,39.7,77963008,79071818.4,34.61733964251668,33.415550063678246,NaN,NaN,-95.44779701793121,-70.70686058590348,0.31009307934218633,-3.309503596017727,-3.6195966753599134,-586375658,-542895280.4,26.2026940403545,21.043718244247376,NaN,NaN,-30.154864265079155,-32.69750881064683
2001-03-29T09:30:00-05:00,39.38,40.61,38.45,38.95,79633008,77968309.6,33.43973064194236,33.63707390615649,NaN,NaN,-119.1076517119672,-76.93200312379643,0.2044942756090835,-3.363978830848559,-3.5684731064576427,-666008666,-571961987.6,23.87653172898179,20.300896299971072,NaN,NaN,-30.617934583995403,-32.400426778268056
2001-03-30T09:30:00-05:00,39.3,39.98,38,39.14999,63658304,76355006.4,34.08365117068135,34.166092727352535,NaN,NaN,-119.7184652276946,-88.81950533412063,0.17288304611670702,-3.352369298811759,-3.525252344928466,-602350362,-588297034,22.659096464449405,19.656492760085207,NaN,NaN,-30.804703099476182,-32.17246625272636
2001-04-02T09:30:00-04:00,39.17,39.85001,37.3,37.39999,69702192,77646660.8,31.23599833157671,34.01651124155366,NaN,NaN,-136.57051049827754,-103.50235547205557,0.06446506596542267,-3.4446710124716873,-3.50913607843711,-672052554,-607039978,21.316071974799016,19.053912647476523,NaN,NaN,-31.812322241147967,-32.12101710821516
2001-04-03T09:30:00-04:00,37.2,37.75,34.62,34.66,88979312,79054861.6,27.378963613871292,33.66483058448358,NaN,NaN,-194.12711227366705,-132.99430734590754,-0.14973622576121048,-3.696306360638623,-3.5465701348774124,-761031866,-657563821.2,18.186814887724125,18.581804125855932,NaN,NaN,-33.93149894412413,-32.37965737048787
2001-04-04T09:30:00-04:00,34.711,35.81,33.60001,34.05,76426192,80116791.2,26.591718273733633,33.419680413134735,NaN,NaN,-203.39997798984905,-154.5847435402911,-0.2827393972547845,-3.899994381445893,-3.6172549841911086,-837458058,-707780301.2,15.717128332904593,18.227621093079424,NaN,NaN,-35.896279481356586,-32.882031957754826
2001-04-05T09:30:00-04:00,36,37.96001,35.71001,37.31,86971808,82019012,37.01496293094413,34.020883021044085,NaN,NaN,-115.89381862222402,-153.94197692234246,-0.11025813477525448,-3.7550776526601766,-3.644819517884922,-750486250,-724675818,14.980058563478195,18.04329396302389,NaN,NaN,-34.33033582965124,-33.088932510882884
2001-04-06T09:30:00-04:00,36.89999,37.10001,35.5,36.3,86117632,82325552.8,35.34070803949314,34.01703459192213,NaN,NaN,-119.34632644018268,-153.86754916484009,-0.02759702399863828,-3.67931579788322,-3.6517187738845815,-836603882,-771526522,13.139894287693764,17.81531654726397,NaN,NaN,-33.57039527937327,-33.15771290638151
2001-04-09T09:30:00-04:00,36.78999,37.39,35.85001,37.05,51630192,80874562.4,37.59789769755698,34.48119321222411,NaN,NaN,-92.39744494717755,-145.03293605462008,0.10681531129725919,-3.5181996347630076,-3.6250149460602668,-784973690,-794110749.2,12.352194033612761,17.722053429088792,NaN,NaN,-32.264304717217485,-33.03008316507236
2001-04-10T09:30:00-04:00,37.89999,40.46001,37.78,39.8,94167872,81582887.2,45.157676176214494,35.48533600957304,NaN,NaN,-17.23212976735066,-109.6539395533568,0.3940100687463186,-3.1325023601273685,-3.526512428873687,-690805818,-780065539.6,15.735351421103985,17.974460769370975,NaN,NaN,-28.689552734696004,-32.41000738930431
2001-04-11T09:30:00-04:00,42.16,42.5,40.45,41,92773376,81362412,48.11169055866121,36.179136126143604,NaN,NaN,44.31795052809749,-60.11035384976749,0.6620952571971941,-2.6988933573771945,-3.3609886145743886,-598032442,-732180416.4,26.19514580404055,18.971631365163685,NaN,NaN,-24.804149055581917,-31.32345619877254
2001-04-12T09:30:00-04:00,40.3,42.8,40,42.8,79520816,81633462.4,52.26513493208785,37.16961084081608,NaN,NaN,64.36589705491215,-24.058410714340248,0.9409310187168614,-2.1848248411783118,-3.125755859895173,-518511626,-685785491.6,34.65813538576364,20.28836370363221,NaN,NaN,-20.181406656288306,-29.731734835560506
2001-04-16T09:30:00-04:00,41.94099,42.42999,40.06,40.25,65200704,81004956.8,46.57708335877305,37.8835185729378,NaN,NaN,36.47024967470096,7.104904508636473,0.9321365900604528,-1.960585122319607,-2.8927217123800597,-583712330,-635207181.2,42.410917281078255,22.181871387406098,NaN,NaN,-17.971547875729062,-28.051708127013157
2001-04-17T09:30:00-04:00,39.951,42.7,39.89999,41.25,94431632,83064848,48.92459508734987,38.452653603957266,NaN,NaN,50.923601258423034,35.76911374975659,0.9679503277188424,-1.6827838027315067,-2.650734130450349,-489280698,-576068582.8,49.89649830853818,24.094752322465883,NaN,NaN,-15.433141612621315,-26.249055767814323
2001-04-18T09:30:00-04:00,43.72099,51,43.2,45.55,129098880,84270382.4,57.56042931187753,40.09144572319732,NaN,NaN,190.19350645351258,77.25424099392924,1.2382383205172998,-1.1029362298037242,-2.341174550321024,-360181818,-509943782.8,56.677271028374804,26.27150782161019,NaN,NaN,-10.129622515265876,-23.94627958887883
2001-04-19T09:30:00-04:00,46.10001,48.75,45.58,48.3,109699120,84951188,61.98705607343975,42.1305403968757,NaN,NaN,183.25306052434428,105.04126299317859,1.5395817161844512,-0.41669740509045994,-1.956279121274911,-250482698,-440433834,62.43282265619208,29.02552860212521,NaN,NaN,-4.123291516815996,-21.114424150012713
2001-04-20T09:30:00-04:00,48.17999,49.44,47.31,48.39999,80571120,82470034.4,62.141678270099405,44.134685189691275,NaN,NaN,175.43105722559005,127.25429502731417,1.6719666525293524,0.13367919438677944,-1.538287458142573,-169911578,-370713824.4,67.14733622639552,32.20326001369279,NaN,NaN,0.5492974050040341,-18.01960678501032
2001-04-23T09:30:00-04:00,46.99001,47.72,44.89,45.14999,79313008,81672303.2,54.39663505837664,45.7890163844627,NaN,NaN,110.17082898791253,141.9944108899565,1.4739125769036916,0.3041032629870415,-1.16980931391665,-249224586,-303816275.6,70.91855523118687,35.74629453200621,NaN,NaN,2.0595561570638647,-15.15115493614258
2001-04-24T09:30:00-04:00,45.10001,46.42,43.75,44.3,88875184,83232927.2,52.551857212102696,47.5870802129078,NaN,NaN,80.67109126022774,147.94390889031743,1.2289317385899028,0.36635535932072827,-0.8625763792691744,-338099770,-273580090,72.4574764074753,39.62277035484558,NaN,NaN,2.6737239368539854,-12.604743668571643
2001-04-25T09:30:00-04:00,43.89999,45.58,43.10001,45.10001,68399312,83156633.6,54.128668318070325,49.55400521607471,NaN,NaN,71.91335813935301,124.28787922748552,1.069878576181284,0.4747718409574304,-0.5951067352238535,-269700458,-255483818,73.36589355728466,43.74053929944415,NaN,NaN,3.6523530415357692,-10.282301281413442
2001-04-26T09:30:00-04:00,45.89999,46.25,43.87,43.95,71105312,82813748.8,51.48021867530511,50.58723776924335,NaN,NaN,66.46973503980166,100.93121413057699,0.8461368554436339,0.46256433408068887,-0.383572521362945,-340805770,-273548432.4,70.85361455455362,47.73150758452097,NaN,NaN,3.6671922011279023,-8.289516498193251
2001-04-27T09:30:00-04:00,45.14999,45.47,44.241,45.14999,56462000,81655198.4,54.0089263064116,51.9206819311661,NaN,NaN,64.25325009472523,78.69565270440403,0.7416215032097697,0.5434543576492672,-0.19816714556050255,-284343770,-296434870.8,67.69105202252895,51.62801885129492,NaN,NaN,4.423170662278462,-6.473418332411578
2001-04-30T09:30:00-04:00,46.25,47.57001,45.3,46.14999,73852000,82164883.2,56.06390939367781,53.2396827666033,NaN,NaN,80.46509131883907,72.75450517058934,0.7028605964157112,0.6804085999591365,-0.022451996456574724,-210491770,-288688307.6,68.2083089072618,55.61774134226984,NaN,NaN,5.652092669845336,-4.741202474946305
2001-05-01T09:30:00-04:00,46.2,48.08,45.39999,48.05,54476896,81403618.4,59.74436788422211,54.28158931717527,NaN,NaN,85.52825957622406,73.7259388337886,0.763179787070749,0.9315227373818615,0.16834295031111254,-156014874,-252271328.4,70.59189090495282,59.536065591116184,NaN,NaN,7.812464088188407,-2.947821537355632
2001-05-02T09:30:00-04:00,48.8,49.39999,47.5,48.98,77552192,80832262.4,61.446735750726255,55.23409254517992,NaN,NaN,101.71845281169507,79.686957768257,0.8187952184696441,1.1918369733981677,0.37304175492852365,-78462682,-214023773.2,72.89077958037436,62.871468003711456,NaN,NaN,10.116136609412072,-1.081541802103103
2001-05-03T09:30:00-04:00,47.89999,47.901,46.2,46.8,67121120,80367008.8,55.51976714447761,55.46656627463633,NaN,NaN,67.07677772067161,79.808366304431,0.6682078374785976,1.2083015517767706,0.540093714298173,-145583802,-174979379.6,75.03614909770862,65.75561184027896,NaN,NaN,10.372470405755864,0.5547456561624637
2001-05-04T09:30:00-04:00,45.3,48.2,45.11,48.2,72670880,79651962.4,58.30147026622346,56.30402248231137,NaN,NaN,67.02094143903672,80.36190457329329,0.6232148234803334,1.3191122436485898,0.6958974201682564,-72912922,-132693210,77.14564370305654,68.23666372756313,NaN,NaN,11.414345424810094,2.1061170516835537
2001-05-07T09:30:00-04:00,48,48.60001,47.10001,47.2,45558192,77623990.4,55.62554104748676,56.782661479464004,NaN,NaN,75.38630479389302,79.34614726830408,0.4921820953430325,1.311125039347047,0.8189429440040146,-118471114,-114289078.8,78.0163434652635,70.24522409590064,NaN,NaN,11.500556693969857,3.4481798577244542
2001-05-08T09:30:00-04:00,48.3,48.35001,46.99001,48.2,56891200,77887040.8,57.71560657800129,56.79374556990142,NaN,NaN,76.73867722383667,77.58823079782661,0.440603838461743,1.3696977420811933,0.9290939036194503,-61579914,-95402086.8,78.90456260201648,71.83288777973219,NaN,NaN,12.172229719908882,4.694472695179373
2001-05-09T09:30:00-04:00,47.05,47.95,46.44,46.55,60981008,76227697.6,53.258202895843056,56.170256057215944,NaN,NaN,46.17802786913708,66.48014580931502,0.2714088879399149,1.268355013544344,0.9969461256044291,-122560922,-104221734.8,77.33326062497828,72.89720477750264,NaN,NaN,11.444114892721093,5.65870729482819
2001-05-10T09:30:00-04:00,47.92,48.05,45.72,45.77,61115808,74644819.2,51.24344724348442,55.391810983886295,NaN,NaN,25.263079403505202,58.11740614588173,0.09226632311133631,1.1122790294935996,1.0200127063822633,-183676730,-111840320.4,75.92669557500567,73.52430187383193,NaN,NaN,10.251562692411932,6.314829494483011
2001-05-11T09:30:00-04:00,45.84,46.42,45.09,45.55,48757392,73106648,50.6613104413003,55.12500208266655,NaN,NaN,-14.934413903182891,41.72633507743781,-0.04819266625607033,0.9597718735621754,1.0079645398182457,-232434122,-143744560.4,70.17085196873882,73.4708944979428,NaN,NaN,9.105155707934,6.713447524976009
2001-05-14T09:30:00-04:00,45.3,45.36,44.11,44.82001,43047392,71998982.4,48.6849753328778,54.848796234150484,NaN,NaN,-74.45643675557783,11.75778676754365,-0.1894789771652876,0.7711158183616362,0.9605947955269238,-275481514,-175146640.4,64.9517026573858,72.93476780150782,NaN,NaN,7.582803977543004,6.837641303914151
2001-05-15T09:30:00-04:00,44.89999,46.3,44.58,45.14999,69004128,70727607.2,49.64131882113334,54.52827127008356,NaN,NaN,-67.33303599470281,-17.05655587616425,-0.255800705273186,0.6408439139354414,0.8966446192086274,-206477386,-204126134.8,60.480969126487025,72.01441605645086,NaN,NaN,6.545716948676955,6.795937824594552
2001-05-16T09:30:00-04:00,44.31,47.52,44.06,47.14999,80090368,68277181.6,55.10285874718322,54.78703127521771,NaN,NaN,-10.335864390212206,-28.359334328034112,-0.16449959412839632,0.6910201265481319,0.8555197206765283,-126387018,-204891354,60.36281810254161,71.2650734527357,NaN,NaN,7.102909819549691,6.839790966731001
2001-05-17T09:30:00-04:00,47.45,48.78999,47.25999,47.89999,73781808,66481316,56.98676306822167,54.99973390106128,NaN,NaN,94.3565396112553,-14.540642286484086,-0.05858684803822234,0.7822861606287503,0.8408730086669727,-52605210,-178677050,63.02743905375243,70.93195824068025,NaN,NaN,8.097858004072403,7.019514829208344
2001-05-18T09:30:00-04:00,47.64,48.38,47.09,48.03999,41091392,64507329.6,57.346550319360716,55.09135111003862,NaN,NaN,89.32672529654488,6.311585553461465,0.012136822947555359,0.8560440373514169,0.8439072144038615,-11513818,-134492989.2,67.04832821401075,70.8491024768766,NaN,NaN,9.023252571741528,7.305763078141656
2001-05-21T09:30:00-04:00,48.17,51.14999,47.64999,51.05,85420496,64812704,64.26704531205796,55.414399497741265,NaN,NaN,184.08821951824447,58.02051680822592,0.24022688274397552,1.144190817833831,0.9039639350898554,73906678,-64615350.8,72.19796329772115,70.96382193350291,NaN,NaN,11.96532374514397,7.971414601999129
2001-05-22T09:30:00-04:00,51.31,51.95,50.17999,50.89999,77228816,64230385.6,63.71223719213964,55.57622102927079,NaN,NaN,208.19855022497737,113.12683405216197,0.3527816688420842,1.3449410211424606,0.9921593523003764,-3322138,-23984301.2,74.67614593320104,71.09134810156196,NaN,NaN,14.21330161610096,8.863112746870819
2001-05-23T09:30:00-04:00,50.44901,50.45,48.64,48.64999,65610368,64090938.4,55.91517254919163,55.604464272464654,NaN,NaN,107.6249568097643,136.71899829215727,0.25220035917692485,1.3074098012715325,1.0552094420946077,-68932506,-12493398.8,75.34546664172407,71.11344221184878,NaN,NaN,13.935554369365253,9.587747264370023
2001-05-24T09:30:00-04:00,48.97,49.99001,48.27,49.89999,61738000,63622572.8,58.922782257705876,55.648843700427676,NaN,NaN,102.17591369339071,138.28287310858434,0.2460891200034383,1.3628208420989054,1.1167317220954671,-7194506,-3411258,75.88791451711151,71.0236044128527,NaN,NaN,14.595259098571875,10.303106097827431
2001-05-25T09:30:00-04:00,49.96001,50.02,48.64999,48.99001,36188496,62608897.6,55.93125205552729,55.67068020100199,NaN,NaN,84.71840494510641,137.36120903829664,0.1611044877044765,1.3181123317260628,1.1570078440215863,-43383002,-9785094.8,74.64663706992155,70.78291109889972,NaN,NaN,14.262609874805518,10.868749494538587
2001-05-29T09:30:00-04:00,48.5,48.5,46.10001,46.12,66603312,62246463.2,47.70486622608321,54.95562731872213,NaN,NaN,-38.30094992660116,92.88337514932752,-0.09431314984652861,1.0391164067134255,1.1334295565599541,-109986314,-46563693.2,67.7594045388166,69.98682838009972,NaN,NaN,11.307733257431243,10.93146146066611
2001-05-30T09:30:00-04:00,45.438,45.85001,44.08,44.42999,81392000,63592218.4,43.63500062618448,54.26825572803224,NaN,NaN,-132.37809009952966,24.768047084426122,-0.3676456765845224,0.6738724608293012,1.0415181374138236,-191378314,-84174928.4,61.50936391386042,68.8565500435913,NaN,NaN,7.472107687562842,10.437268064508501
2001-05-31T09:30:00-04:00,44.53999,45.85001,44.3,44.73,67973184,63113268,44.53954925609025,53.78940587178979,NaN,NaN,-110.73524888187941,-18.903994053902633,-0.510041999869224,0.40396563757729353,0.9140076374465176,-123405130,-95069453.2,59.789040030664296,67.70386036185263,NaN,NaN,4.681331595423848,9.614991426067837
2001-06-01T09:30:00-04:00,45.53999,46.23,44.33,46.05,61868800,62850652,48.458772940778395,53.63208176460966,NaN,NaN,-76.86357955615934,-54.711892703812644,-0.49664952911386495,0.2931957260541864,0.7898452551680514,-61536330,-105937818,58.0449300251735,66.8377230801694,NaN,NaN,3.4926068680095894,8.740365060630944
2001-06-04T09:30:00-04:00,46.338,46.89999,45.28999,45.83,41679504,61301083.2,47.85182892957206,53.57257130723067,NaN,NaN,-51.36231868734828,-81.92803743030359,-0.4834609533721659,0.18551906345284408,0.66898001682501,-103215834,-117904384.4,56.104318460139716,66.20576706608038,NaN,NaN,2.351770439765284,7.827708686221564
2001-06-05T09:30:00-04:00,46.30099,48.36,46.2,47.85001,68143120,62430329.6,53.598587364872685,53.8552333460692,NaN,NaN,12.473008157391462,-71.77324581350506,-0.3270374315733532,0.26018322735831845,0.5872206589316716,-35072714,-102921664.4,57.99776278016819,66.02839518420048,NaN,NaN,3.071657872305498,7.1482728556621264
2001-06-06T09:30:00-04:00,48.08,48.89,47.07001,47.48,61160896,62643814.4,52.45822705194518,53.66633108212362,NaN,NaN,27.543143975947814,-39.788998998409554,-0.24081710841636084,0.28619927341122064,0.5270163818275815,-96233610,-83892723.6,60.3377664807082,66.02660578264094,NaN,NaN,3.3294120473281446,6.602721311614415
2001-06-07T09:30:00-04:00,47.138,49.49001,47.075,48.7,65357200,62862624,55.79760521117366,53.581391235191624,NaN,NaN,49.271296546892174,-7.787689912655236,-0.10109900736919908,0.40064262261608263,0.5017416299852817,-30876410,-65386979.6,62.524368282299804,65.9906721561086,NaN,NaN,4.533922334917971,6.30717860065778
2001-06-08T09:30:00-04:00,48.72,48.77,46.95,47.35001,56389392,62626303.2,51.48787026726623,53.16291408861345,NaN,NaN,16.12384752087815,10.809795502752259,-0.09895412204152121,0.3780489774333802,0.4770030994749014,-87265802,-70532874,61.50889278915672,65.59499819719046,NaN,NaN,4.301485899815728,6.020651071966058
2001-06-11T09:30:00-04:00,46.89999,48.47,45.49001,46.05,48870096,62631938.4,47.66951315983618,51.977376077740466,NaN,NaN,-30.677362040453637,14.946786832131187,-0.17973475822576174,0.2523346516926992,0.43206940991846093,-136135898,-77116886.8,60.16253422786562,64.73532469220078,NaN,NaN,2.955672114192942,5.582796935141327
2001-06-12T09:30:00-04:00,44.87,46.8,44.23,45.8,78444368,64401787.2,46.94845398173393,50.779962991282915,NaN,NaN,-82.06856402280044,-3.9615276039071885,-0.24083801327110926,0.13102189332957437,0.37185990660068363,-214580266,-113018397.2,53.3101812973508,63.209184361068615,NaN,NaN,1.6479869522290722,5.0206812232967195
2001-06-13T09:30:00-04:00,46.274,46.75,44.52,44.55,68526688,64377915.2,43.41255215539333,49.88691867744018,NaN,NaN,-97.04842196668613,-28.87984079243398,-0.34967347870390353,-0.06523194177919578,0.28444153692470775,-283106954,-150393066,47.27371660234835,61.20405935825607,NaN,NaN,-0.52450231839665,4.228512145911953
2001-06-14T09:30:00-04:00,44.02499,44.39999,42,42.25,91025504,64924672,37.77505297921165,48.37636658611916,NaN,NaN,-176.12748630366116,-73.95959736254466,-0.5489328043598031,-0.40172446852504606,0.14720833583475698,-374132458,-219044275.6,38.622642794920324,58.5422542352424,NaN,NaN,-4.263339946122528,3.0153904184784555
2001-06-15T09:30:00-04:00,41.8,43.10001,41.28101,42.60001,84583872,65464775.2,39.07171686100502,47.172114072224716,NaN,NaN,-166.2235573059036,-110.429078327901,-0.6240539744986923,-0.6328591322886084,-0.008805157789916113,-289548586,-259500832.4,34.60381283058902,55.682052503861506,NaN,NaN,-6.919824011362116,1.596074071358374
2001-06-18T09:30:00-04:00,42.64,43.17,41.39999,42.03,63415392,66580975.2,37.69411679224061,46.45706054123597,NaN,NaN,-145.79696803547623,-133.45299952690553,-0.6747209596692065,-0.8522063573764243,-0.17748539770721775,-352963978,-302866448.4,30.89307655247123,53.048743361979696,NaN,NaN,-9.536240604180076,0.005743403424310012
2001-06-19T09:30:00-04:00,43.32001,43.56,41.25999,41.82001,73378688,65978884.8,37.174118211323474,45.99556894017446,NaN,NaN,-129.03456234541437,-142.8461991914283,-0.6828910274952346,-1.031099182076261,-0.3482081545810264,-426342666,-345218928.4,27.761927375008227,50.63821218063311,NaN,NaN,-11.843703975010705,-1.6870347934949776
2001-06-20T09:30:00-04:00,41.3,42.97,41.28,42.77,83583680,66296628,41.13072060930238,45.75208117968962,NaN,NaN,-114.92172397395566,-146.4208595928822,-0.588412901914481,-1.0837242819741277,-0.4953113800596467,-342758986,-357149334.8,26.9337922976229,48.29140877113016,NaN,NaN,-12.75362873372035,-3.267976784955745
2001-06-21T09:30:00-04:00,42.67,44.23,42.3,43.35001,67204128,66376316,43.471458204988046,45.395844412847445,NaN,NaN,-76.4185279755879,-126.47906792726755,-0.45681972402507554,-1.0663360350909912,-0.6095163110659156,-275554858,-337433814.8,30.617129760642783,46.33228018080654,NaN,NaN,-12.88363428489606,-4.641642142090076
2001-06-22T09:30:00-04:00,43.621,44.2,42.59,43.25,51868608,65882846.4,43.15284332333576,45.060202583830566,NaN,NaN,-67.13302338411907,-106.66096114291065,-0.35121798541213267,-1.0485387928310814,-0.6973208074189488,-327423466,-345008790.8,29.991551589942034,44.46708254722099,NaN,NaN,-13.075758060643269,-5.846515844740532
2001-06-25T09:30:00-04:00,43.61,43.8,42.64999,43.36,39194400,66033141.6,43.64211544715118,44.34902601827903,NaN,NaN,-62.61149749763998,-90.02386703534339,-0.253240150625321,-1.0138709957006,-0.760630845075279,-288229066,-332061808.4,32.52905077200043,42.647888832351875,NaN,NaN,-13.112414426010771,-6.884501356350566
2001-06-26T09:30:00-04:00,42.53999,43.89,42.481,43.50999,55150800,65460516,44.345505577774,43.76954591298108,NaN,NaN,-55.41240862828163,-75.29943629191685,-0.16204773715282172,-0.9631905165163062,-0.8011427793634844,-233078266,-293408928.4,39.57108656143741,41.164554552403956,NaN,NaN,-12.96767668830196,-7.753526403772193
2001-06-27T09:30:00-04:00,43.681,44.14999,43,43.78999,53286496,64055240.8,45.70776468383593,43.04884301817124,NaN,NaN,-38.8169946925915,-60.07849043564401,-0.07122247726244102,-0.8901708759415357,-0.8189483986790946,-179791770,-260815485.2,44.802663278697715,39.8987184807181,NaN,NaN,-12.504443144200883,-8.432228795262006
2001-06-28T09:30:00-04:00,44.40199,46.36,44.35001,44.35001,89940624,65153612.8,48.42679344502277,42.83019467372527,NaN,NaN,11.035129943542556,-42.587758851817924,0.03264400032527193,-0.7781433982725048,-0.8107873985977767,-89851146,-223674742.8,50.10370401943815,39.08406214002391,NaN,NaN,-11.40823766446178,-8.857372919433402
2001-06-29T09:30:00-04:00,45.09,46.52,44.7,45.7,59719600,65046152.8,54.36053130650125,43.30812454134421,NaN,NaN,33.279853540306874,-22.50518346693274,0.1895792457350256,-0.5738133414289948,-0.7633925871640204,-30131546,-164216358.8,57.19162637262881,38.87185443607843,NaN,NaN,-8.76869203311373,-8.844704221387735
2001-07-02T09:30:00-04:00,45.65199,46.48,45.19,45.45,50873008,65505828,53.14117805628112,43.750461975240434,NaN,NaN,36.536533657028045,-2.6755772359991328,0.26901044843458544,-0.4271295266207886,-0.6961399750553741,-81004554,-122771456.4,61.31657261583759,39.44373953025605,NaN,NaN,-6.833621110599096,-8.557406634132215
2001-07-03T09:30:00-04:00,45.25,45.69,44.8,45.64,24758304,63336587.2,53.985940643272585,44.50570401008895,NaN,NaN,30.027496434584712,14.412403776574138,0.323166346619445,-0.2921820417810679,-0.6153483884005129,-56246250,-87405053.2,64.4633798561932,40.6715726198164,NaN,NaN,-4.960403970507598,-8.04354911075727
2001-07-05T09:30:00-04:00,44.87,45.189,43.45,43.45,44376304,62497357.6,44.11414104955548,44.958496015113504,NaN,NaN,-16.265696636040825,18.92266338788427,0.2060186305674565,-0.3578251001911923,-0.5638437307586488,-100622554,-71571210,65.80457903449994,42.61313949407209,NaN,NaN,-5.966542211129977,-7.746833839381943
2001-07-06T09:30:00-04:00,43.00999,43.11,41.49001,41.64999,53427696,61900882.4,37.96865354376983,44.87970577816814,NaN,NaN,-94.33563149678848,-2.151488900181934,0.01206089724707926,-0.5487676091997997,-0.560828506446879,-154050250,-84411030.8,63.704926251641325,44.69179045271868,NaN,NaN,-8.838397128818972,-7.902771452158661
2001-07-09T09:30:00-04:00,41.89799,42.69,41.5,42.00999,45536704,61358248,39.77567261928355,45.02838833724264,NaN,NaN,-90.9614717912927,-26.99975396650185,-0.08205297916089405,-0.6633947303979966,-0.5813417512371025,-108513546,-100087430.8,61.13992078123794,46.852279326202016,NaN,NaN,-10.632714207940722,-8.292763274413241
2001-07-10T09:30:00-04:00,42.75999,42.88,40.39999,40.5,58598400,61844663.2,35.150393236298214,44.883836553312264,NaN,NaN,-127.41163302076309,-59.78938730206007,-0.22780443326127675,-0.8660972928136985,-0.6382928595524218,-167111946,-117308909.2,58.35995772039831,49.037852922301305,NaN,NaN,-13.703211710777374,-9.065684479608118
2001-07-11T09:30:00-04:00,40.42,41.10001,39.87,41,77386496,61791769.6,37.73243314521861,44.64110173444914,NaN,NaN,-150.8103918525377,-95.95696495948457,-0.26948871012597253,-0.9751537472098875,-0.7056650370839149,-89725450,-124004749.2,57.26962803727778,51.20469833227666,NaN,NaN,-15.430068755318866,-9.974882233281082
2001-07-12T09:30:00-04:00,42.63,43.83,42.3,43.60001,70337008,61882285.6,49.08493547075062,45.04206439628932,NaN,NaN,3.014407337699402,-92.10094416473652,-0.10912858626627675,-0.8420757699167609,-0.7329471836504842,-19388442,-107757926.8,59.258592154479786,53.25051707469358,NaN,NaN,-13.166133269864563,-10.430775238507294
2001-07-13T09:30:00-04:00,43.38,44.42999,42.89999,43.14999,62472800,60454650.4,47.471670518751786,45.35055205310475,NaN,NaN,16.765443392688027,-69.88072918684121,-0.02493435200954386,-0.764115123662414,-0.7391807716528701,-81861242,-93320125.2,60.99605731248176,55.46512462630356,NaN,NaN,-11.891081801133428,-10.6393904617396
2001-07-16T09:30:00-04:00,43.37,43.86,41.89999,42.35001,53371392,58894026.4,44.661560242897146,45.42336953851517,NaN,NaN,-34.56628368070395,-58.60169156472347,-0.01516982185927318,-0.7581430489769616,-0.7429732271176884,-135232634,-98663942.8,59.976535118169,57.425659222458464,NaN,NaN,-11.731697241327998,-10.795434287395086
2001-07-17T09:30:00-04:00,41.82899,43.39999,41.53999,43.3,59775504,58712032,48.5560264705726,45.72412103085792,NaN,NaN,-34.53456160552394,-40.02627728167563,0.059145311138014134,-0.6690415881951708,-0.7281868993331849,-75457130,-80332979.6,62.30412818848734,59.04944791010489,NaN,NaN,-10.35759636462275,-10.732886012713324
2001-07-18T09:30:00-04:00,42.27901,42.85001,41.14,41.64999,64711296,58278662.4,42.907829839954346,45.52412568486638,NaN,NaN,-88.86945229562266,-27.638089370292626,0.003963059321293483,-0.7232330751815681,-0.7271961345028616,-140168426,-90421574.8,60.22815367973962,60.151268653036446,NaN,NaN,-11.008763040289047,-10.772297016652713
2001-07-19T09:30:00-04:00,42.46001,43.35001,41.75,42.64,76495504,57924253.6,46.89905822824955,45.41500174081115,NaN,NaN,-44.972381132053094,-37.23544706424312,0.038977976527041935,-0.6784736638440592,-0.7174516403711011,-63672922,-99278470.8,58.388779350057284,60.743059748080675,NaN,NaN,-10.24766722284403,-10.697349903251473
2001-07-20T09:30:00-04:00,41.49001,42.14,41.36,41.64999,49006400,57014367.2,43.615423743413736,44.64749405773347,NaN,NaN,-89.18266255830616,-58.42506825444195,0.0022421026420136325,-0.714649012068584,-0.7168911147105976,-112679322,-105442086.8,57.0822758915989,60.73524899943568,NaN,NaN,-10.670673736854273,-10.693539022337587
2001-07-23T09:30:00-04:00,42.24001,42.39999,40.55,40.61,55316608,57186767.2,40.41431673432046,43.738432534736276,NaN,NaN,-105.8912378821743,-72.69005909473603,-0.08073473888575311,-0.817809538317789,-0.7370747994320359,-167995930,-111994746,55.65646004138062,60.33095524411733,NaN,NaN,-12.05258403832917,-10.887688310336385
2001-07-24T09:30:00-04:00,40.381,40.89999,39.31,40.14999,70420368,58748065.6,39.049123343032726,42.67151701329057,NaN,NaN,-142.1058209094791,-94.20431095552706,-0.15114776048811296,-0.9260095000421771,-0.7748617395540641,-238416298,-144586579.6,49.088669209041804,59.23276162646366,NaN,NaN,-13.59605516640395,-11.27459786120318
2001-07-25T09:30:00-04:00,40.14101,40.72,39.39999,40.5,68844880,59432769.6,40.69076778848355,42.426990351785435,NaN,NaN,-121.87851525874719,-100.80612354815196,-0.15795677585268608,-0.9723077093699217,-0.8143509335172356,-169571418,-150467178,47.98830475721028,57.96017060665725,NaN,NaN,-14.372162197776857,-11.717107052142277
2001-07-26T09:30:00-04:00,40.45,41.89,39.98,41.10001,69152688,60226079.2,43.500139715275665,42.82209650689299,NaN,NaN,-77.01789279086168,-107.21522587991367,-0.10822866108705154,-0.94963675987605,-0.8414080987889985,-100418730,-157816339.6,46.58295856865497,56.73717291501537,NaN,NaN,-14.206102704026623,-12.072677859554327
2001-07-27T09:30:00-04:00,41.64,42.25999,40.89999,41.95,47484896,58103292.8,47.30792334576729,43.36011441592755,NaN,NaN,-38.42016259322465,-97.06272588689737,-0.009471183797686855,-0.853247078536107,-0.8437758947384202,-52933834,-145867242,49.188465411416466,55.883497531456705,NaN,NaN,-12.943972405485429,-12.197148508973056
2001-07-30T09:30:00-04:00,42.13,42.3,41.39999,41.7,39455200,57090072.8,46.319150903378684,44.15788282071901,NaN,NaN,-27.300905231476037,-81.34465935675772,0.04466271263735777,-0.787947503941723,-0.8326102165790807,-92389034,-130745862.8,52.35559117754545,55.454614206967214,NaN,NaN,-12.177652604981187,-12.19436337983136
2001-07-31T09:30:00-04:00,41.84,42.78,41.5,41.75999,55701904,57331517.6,46.60753148032312,44.791818416083615,NaN,NaN,-5.564231753489282,-54.03634152555976,0.08767066704258752,-0.7230218827758463,-0.8106925498184339,-36687130,-90400029.2,59.592554419022065,55.62053751994894,NaN,NaN,-11.46653408287955,-12.090387765981102
2001-08-01T09:30:00-04:00,42.63699,43.5,42.41,43.10001,53861104,58786657.6,52.71781384391463,45.051309728452466,NaN,NaN,83.4549959729639,-12.969639279217537,0.2029392535240333,-0.5570184829133922,-0.7599577364374255,17173974,-53050950.8,64.90671132618664,56.02397460364229,NaN,NaN,-9.056061038700467,-11.656912519226726
2001-08-02T09:30:00-04:00,43.799,44.004,42.82001,43.91,53163392,59226012,55.99595001102909,45.6601868350437,NaN,NaN,135.60987011587014,29.55591330212883,0.3231690185316529,-0.3559964632728594,-0.6791654818045123,70337366,-18899731.6,68.9303612363853,56.59071059820683,NaN,NaN,-6.007939693174263,-10.84991640121923
2001-08-03T09:30:00-04:00,43.53,43.53,42.56,43.17999,51510000,59130127.2,52.4654464864407,46.2176072810111,NaN,NaN,85.35104991702478,54.310155804178706,0.3411899413307099,-0.25267805514112496,-0.5938679964718349,18827366,-4547491.6,70.46306996553304,57.33974880158998,NaN,NaN,-4.3993257125206435,-9.928403445690861
2001-08-06T09:30:00-04:00,42.539,42.85001,42.35001,42.5,31099104,58408247.2,49.34456175496222,46.273931229896064,NaN,NaN,41.06665303293723,67.98366745706136,0.29661817404870494,-0.2230952789109537,-0.5197134529596587,-12271738,11475967.6,72.11688160408939,58.040659759847266,NaN,NaN,-3.920348403467195,-9.070109868230338
2001-08-07T09:30:00-04:00,42.10001,42.82001,41.94,42.28,38353600,57396007.2,48.34262700267626,46.66213102723335,NaN,NaN,20.723523612932684,73.24121853034576,0.24383048129922863,-0.21492535133562285,-0.4587558326348515,-50625338,8688326,71.36821089744127,58.83637813254025,NaN,NaN,-3.8025688911849977,-8.317604014366719
2001-08-08T09:30:00-04:00,41.85001,42.64999,40.3,40.5,76057312,57329548,41.075467901402355,46.246160289601406,NaN,NaN,-76.8501088352474,41.18019756870349,0.08854912917285113,-0.3480694211687876,-0.4366185503416387,-126682650,-20082998.8,63.98508522882691,59.23611426673808,NaN,NaN,-5.918172061502675,-7.974828021100427
2001-08-09T09:30:00-04:00,40.41,40.88,39.98,40.67,66830688,57154232,41.972650329622844,46.12881933147349,NaN,NaN,-115.41343881030551,-9.02446421653164,0.0014094651173170991,-0.43485671894499234,-0.43626618406230944,-59851962,-46120864.4,58.12469736730217,59.31057294357403,NaN,NaN,-7.378165302009794,-7.889590489801765
2001-08-10T09:30:00-04:00,40.429,40.75,39.23,40.28,68480880,57454636,40.45100208175763,46.13143971343329,NaN,NaN,-133.97569299701996,-52.88981279934059,-0.0741934079920119,-0.5290079440523243,-0.4548145360603124,-128332842,-75552906,52.29425775476484,59.07041563738719,NaN,NaN,-9.040335411477747,-8.053982621469762
2001-08-13T09:30:00-04:00,40.59,41.34,40.2,41.10001,48420608,57207096.8,44.968504724337,46.55425266924073,NaN,NaN,-64.6440503116827,-74.03195346826458,-0.061212903324223356,-0.5313306652155916,-0.4701177618913682,-79912234,-89081005.2,49.82054024323982,59.1226921398299,NaN,NaN,-9.192882351257529,-8.216682582868014
2001-08-14T09:30:00-04:00,41.49001,41.7,40.53999,40.60001,51157104,56776176.8,42.83469740731348,46.707390499157164,NaN,NaN,-52.738497027286144,-88.72435759630834,-0.07749095094208486,-0.5669814505689743,-0.48949049962688945,-131069338,-105169805.2,46.97456928421541,59.05028246318741,NaN,NaN,-9.932891314773663,-8.461855258854536
2001-08-15T09:30:00-04:00,40.62,40.92999,39.07001,39.10001,58797904,56480507.2,37.14086471033332,46.25315657023271,NaN,NaN,-129.509452894124,-99.25622640808366,-0.1748954164115728,-0.7081097701413555,-0.5332143537297827,-189867242,-117806723.6,44.80939279832488,58.923599193878125,NaN,NaN,-12.36365958743079,-9.019255877222573
2001-08-16T09:30:00-04:00,38.649,39.59,38.041,39.56,68197376,56065600.8,39.7842525920596,45.715751516396445,NaN,NaN,-154.0288462137239,-106.97930788876734,-0.19256164093971484,-0.7739164049044263,-0.5813547639647114,-121669866,-130170304.4,42.7340386958631,58.46256871419574,NaN,NaN,-13.594510141865756,-9.672863629314456
2001-08-17T09:30:00-04:00,38.44099,38.8,37.71001,37.75999,56641808,56447371.2,33.79519300380562,44.82118309499837,NaN,NaN,-186.8456707280185,-117.55330343496705,-0.30311242144744577,-0.9602452907740187,-0.6571328693265729,-178311674,-140166070.8,41.07756570868909,57.65699546642028,NaN,NaN,-16.67334030142745,-10.672931725330598
2001-08-20T09:30:00-04:00,37.85001,38.64999,37.52,38.28,49921296,56177605.6,36.75716026455564,44.11758515101498,NaN,NaN,-155.043250070881,-135.6331433868067,-0.3173370766475112,-1.053804215135962,-0.7364671384884507,-128390378,-149861699.6,39.47903312808962,56.22031537421083,NaN,NaN,-18.26072372318857,-11.756902010738878
2001-08-21T09:30:00-04:00,38.28999,38.64999,36.64999,36.69,56401600,55476667.2,32.03741736892333,42.64041397422989,NaN,NaN,-171.22611615598206,-159.33066721254588,-0.4043733361647124,-1.2419338086943412,-0.8375604725296288,-184791978,-160606227.6,37.72691211182791,54.27890114461377,NaN,NaN,-21.23055004808336,-13.11028030178809
2001-08-22T09:30:00-04:00,37.45,37.84,36.53999,37.69,65213200,55295083.2,37.47513568468611,41.31749866520539,NaN,NaN,-144.98370488568918,-162.42551761085892,-0.3662745162110317,-1.2954036177934185,-0.9291291015823868,-119578778,-146548534.8,41.391852977982595,52.31186484044215,NaN,NaN,-21.924630513084086,-14.36947318911609
2001-08-23T09:30:00-04:00,37.679,38.46001,37.299,37.32001,54614000,54568148.8,36.317330679944035,40.1640618218842,NaN,NaN,-112.1783961487639,-154.0554275978669,-0.3383354033530366,-1.3520483557736824,-1.0137129524206459,-174192778,-157053117.2,39.52015966864273,50.10165696209284,NaN,NaN,-22.84434671607125,-15.58016940725254
2001-08-24T09:30:00-04:00,37.86,39.39,37.75,39.3,58447392,55116273.6,45.9424526188398,39.92105402644688,NaN,NaN,-61.14082849321022,-128.91445915090526,-0.16748744409890248,-1.223072257544274,-1.0555848134453716,-115745386,-144539859.6,42.83618111045172,48.010178355404435,NaN,NaN,-20.419486937890063,-16.271500483057903
2001-08-27T09:30:00-04:00,39.28,39.89999,38.83,39.35001,50918800,55689453.6,46.16378149023823,39.76542220412988,NaN,NaN,-35.86388350023003,-105.07858583677508,-0.038808197915556786,-1.1040950608398177,-1.065286862924261,-64826586,-131827101.2,46.07123318108377,46.203251375664614,NaN,NaN,-18.463762682428197,-16.584680797253657
2001-08-28T09:30:00-04:00,39.32001,39.44,38.011,38.12,65266800,56167698.4,41.64725478270319,39.806264124222785,NaN,NaN,-62.05039543416085,-83.24344169241084,-0.0249044971653003,-1.0964174843808863,-1.071512987215586,-130093386,-120887382.8,48.75863004373438,45.11564743387229,NaN,NaN,-18.212738098723342,-16.817260411749327
2001-08-29T09:30:00-04:00,38.37,38.45,37.13,37.56,59040496,56426668,39.74089478936391,39.64685301420429,NaN,NaN,-86.07992589618135,-71.46268589450928,-0.04085350436761681,-1.1225798676751069,-1.08172636330749,-189133882,-134798403.6,45.6438248716901,44.22415654132856,NaN,NaN,-18.5990369903814,-17.071799922982482
2001-08-30T09:30:00-04:00,36.8,37.31,35.75,36.17,76090496,57573023.2,35.408415591107584,39.28666826487215,NaN,NaN,-129.29826681883893,-74.88666002852428,-0.1275530848278994,-1.2411677193423643,-1.1136146345144649,-265224378,-153004723.6,41.873597662907024,43.47982367762444,NaN,NaN,-20.329777344985693,-17.53722526898294
2001-08-31T09:30:00-04:00,36.03799,37.03,35.94,36.63,54299696,57712508,37.824145211044346,38.77635687106552,NaN,NaN,-116.05041659121282,-85.8685776481248,-0.13569942132357737,-1.2832389111689366,-1.1475394898453593,-210924682,-172040582.8,38.31042056727245,42.65767227219819,NaN,NaN,-20.98814500811527,-18.0302138031447
2001-09-04T09:30:00-04:00,36.51801,37.5,35.35001,35.47,74060320,59860568.8,34.33663885215498,38.169352688554206,NaN,NaN,-125.58663848448472,-103.81312864497575,-0.19725839086542996,-1.3941124784271466,-1.1968540875617166,-284985002,-216072266,31.61003752731125,41.560205718133616,NaN,NaN,-22.65578638495098,-18.691009886259884
2001-09-05T09:30:00-04:00,35.49001,35.91,34.14999,35.33,95447120,62715244.8,33.93002257073408,37.94000682143997,NaN,NaN,-156.48595738914887,-122.70024103597333,-0.2235247322531404,-1.476260002878142,-1.2527352706250017,-380432122,-266140013.2,26.03426044205834,40.21912483554315,NaN,NaN,-24.112897317326844,-19.465565233555164
2001-09-06T09:30:00-04:00,34.74001,35.52,33.78,33.89999,88601008,63342429.6,30.019568803296536,37.2425294079569,NaN,NaN,-170.35527263626395,-139.55531038398985,-0.308109379449264,-1.6378719949365816,-1.3297626154873177,-469033130,-322119862.8,21.47346252309879,38.70051225177427,NaN,NaN,-26.63446691678839,-20.489694045445624
2001-09-07T09:30:00-04:00,33.621,35.10001,33.35001,33.7,95522496,64777020,29.507382937848845,36.93625726038856,NaN,NaN,-162.58643158347593,-146.21294333691725,-0.34561349748835335,-1.7617794873477592,-1.416165989859406,-564555626,-381986112.4,17.868376116918668,37.04271299521924,NaN,NaN,-28.822774826647667,-21.680134157045917
2001-09-10T09:30:00-04:00,33.49001,34.32001,33.342,34.10001,80367872,65371369.6,32.006229090853736,36.59690503369557,NaN,NaN,-146.38761123731908,-152.28038226613853,-0.31256410275121493,-1.8068711182984245,-1.4943070155472096,-484187754,-436638726.8,15.336945405698685,35.318278157905596,NaN,NaN,-29.92487509605377,-22.857954291189895
2001-09-17T09:30:00-04:00,31.25,32.8,31.09,31.2,97736880,67837183.2,25.068246931494443,36.09910714530779,NaN,NaN,-196.63499437890695,-166.49005344502297,-0.4469128070744526,-2.0529480243902754,-1.6060352173158228,-581924634,-496026653.2,13.155862439918636,33.56320318134065,NaN,NaN,-33.34904365275724,-24.35668134284237
2001-09-18T09:30:00-04:00,31.53,32.5,30.37,30.5,66274192,68593037.6,23.731039855890444,35.117386014679525,NaN,NaN,-184.3588680240776,-172.0646355720087,-0.5377225125033176,-2.2781883579449698,-1.7404658454416522,-648198826,-549579994,11.559454935304913,31.43231760686367,NaN,NaN,-36.5628883089156,-26.10042519513855
2001-09-19T09:30:00-04:00,30.64,31,28.25999,29.97,116627504,71484517.6,22.741886338833467,34.14771141888591,NaN,NaN,-188.35498736458592,-175.6645785176731,-0.5844078408761866,-2.4709756465368855,-1.886567805660699,-764826330,-608738634,10.10125795346245,29.330967484350793,NaN,NaN,-39.482653628969295,-28.012172114257226
2001-09-20T09:30:00-04:00,29.3,30.09,28.8,28.97,90830688,72616183.2,20.966165262993982,32.36369089346835,NaN,NaN,-166.1239439550836,-176.37208099199466,-0.6296518607958244,-2.6736326316554795,-2.043980770859655,-855657018,-666958912.4,8.910020542842247,26.907670300950112,NaN,NaN,-42.51740056139052,-30.08434760670484
2001-09-21T09:30:00-04:00,27.41,28.97,27.2,28.19,112285184,75398352,19.67566814288388,30.471682797228755,NaN,NaN,-164.1206025327101,-179.91867925107286,-0.6561457402172719,-2.864162946131245,-2.208017205913973,-967942202,-763709802,7.357260437135309,24.142386533525222,NaN,NaN,-45.452235947484006,-32.27976022681615
2001-09-24T09:30:00-04:00,29.08,30,28.59,29.61,85674496,77186012,28.325028455927907,29.52009520245909,NaN,NaN,-116.42618982320825,-163.87691833993313,-0.5276041926212449,-2.867522446690529,-2.339918254069284,-882267706,-823778416.4,6.589452936774407,21.130302454456658,NaN,NaN,-45.230369102449,-34.129847209049416
2001-09-25T09:30:00-04:00,29.71001,30.42999,28.95,29.7,83856000,78558732,28.847981793565722,28.7420299884735,NaN,NaN,-97.29009115785574,-146.46316296668877,-0.3923027794349858,-2.8302967283630167,-2.437993948928031,-798411706,-853820992.4,6.238773976641227,18.315655961953166,NaN,NaN,-44.895805526501874,-35.66784125439977
2001-09-26T09:30:00-04:00,29.95,30,28.41,28.67,59735600,78284852,26.46788787451524,28.10342086585976,NaN,NaN,-98.35196415767768,-128.4625583253071,-0.33043878319808817,-2.851042427925641,-2.520603644727553,-858147306,-872485187.6,6.024276575557835,15.754990169999653,NaN,NaN,-45.32507037024764,-37.04744541380661
2001-09-27T09:30:00-04:00,28.39999,28.78999,27.42,28.48,70034000,79055852,26.04107392062771,27.261772916544285,NaN,NaN,-100.79679160378268,-115.39712785504693,-0.2634869756593683,-2.8499623643017635,-2.5864753886423952,-928181306,-886990045.2,5.855777985874752,13.436801414185533,NaN,NaN,-45.796718114290314,-38.29734151387571
2001-09-28T09:30:00-04:00,28.84,29.92,28.31,28.98,84805120,80373738.4,29.27331476807838,26.900106910538817,NaN,NaN,-76.0338576408284,-97.77977887667058,-0.15222122279809813,-2.776751917140018,-2.62453069434192,-843376186,-862076842,10.48682422831456,11.928000464257195,NaN,NaN,-45.26559943116627,-39.2928069306315
2001-10-01T09:30:00-04:00,28.85001,28.98,27.85001,28.73,53450704,80500333.6,28.600279105513607,26.519410948737352,NaN,NaN,-80.04265886684577,-90.5030726853981,-0.06652938704066624,-2.707692428142753,-2.6411630411020868,-896826890,-864988678.8,10.42229286167526,10.812859922801263,NaN,NaN,-45.006820959344076,-40.10909464901901
2001-10-02T09:30:00-04:00,28.64999,29.41,28.39999,28.82001,74170880,80945537.6,29.231154690442963,26.463095654962096,NaN,NaN,-67.37972443251931,-84.5209993403308,0.020491383100961436,-2.615548812225885,-2.6360401953268466,-822656010,-869837539.6,10.308535058711612,10.015365103916464,NaN,NaN,-44.62276098446338,-40.75390412551106
2001-10-03T09:30:00-04:00,28.429,31.61,28.33,31,136211872,84804106.4,42.48586454125642,27.390130055205496,NaN,NaN,-29.53971851488542,-70.75855021177236,0.23711426802160052,-2.339647360299846,-2.5767616283214467,-686444138,-835496906,17.20131822107838,9.967718111356442,NaN,NaN,-40.184686357421725,-40.672587301498304
2001-10-04T09:30:00-04:00,31.64999,33.2,30.94,31.3,127386880,87368925.6,44.03919377297999,28.249627532500227,NaN,NaN,15.817607721501794,-47.43567034671546,0.4030965169149687,-2.0728909821777357,-2.4759874990927044,-559057258,-761672096.4,29.707658092195416,10.99419758896335,NaN,NaN,-36.07970329640911,-40.01646101505699
2001-10-05T09:30:00-04:00,31,31.89999,30.25999,31.75999,96560192,89481950.4,46.428303718979066,29.775345874463415,NaN,NaN,10.191184740648819,-30.190661870420012,0.5379285819930386,-1.8035767716014064,-2.341505353594445,-462497066,-685496272.4,39.81017116616292,12.898076783695087,NaN,NaN,-31.927520516045917,-38.86089808662684
2001-10-08T09:30:00-04:00,31.13,32.35001,30.96001,31.86,67779632,89167916,46.95851331321134,31.434451121414906,NaN,NaN,34.81312800897274,-7.219504495256274,0.6219690650129985,-1.564044022328197,-2.1860130873411956,-394717434,-585074381.2,50.01014785498455,15.64455484938649,NaN,NaN,-28.358104556250684,-37.36049901085882
2001-10-09T09:30:00-04:00,31.86,32.02,30.87,31.09,57547504,87272935.2,43.39723264905377,32.909833000716354,NaN,NaN,30.790889899311438,12.414618371109881,0.6128292283965981,-1.4199765518454477,-2.032805780242046,-452264938,-510996166.8,55.94148630303652,18.918856874356067,NaN,NaN,-26.19570913726789,-35.76552902891726
2001-10-10T09:30:00-04:00,30.871,32.53999,30.75101,32.5,73838880,86534828.8,50.76120795849484,35.03805033610927,NaN,NaN,66.4579307768134,31.614148229449643,0.6834906433215813,-1.1784424760900691,-1.8619331194116504,-378426058,-449392550.8,60.17346753085005,22.580531659213765,NaN,NaN,-21.975770488707834,-33.79556352317305
2001-10-11T09:30:00-04:00,33.192,35.25,33.14,34.7,117223008,87619854.4,59.594179658970745,37.889372587258336,NaN,NaN,173.58577767426738,63.16778222000274,0.8493238895566133,-0.8002782574658838,-1.649602147022497,-261203050,-389821709.2,63.79501723032633,26.611800001584555,NaN,NaN,-15.004555955340217,-31.111133870625505
2001-10-12T09:30:00-04:00,34.33,34.8,33.14,34.55,111900688,89196495.2,58.8194086446701,40.06754260073992,NaN,NaN,162.66401893720698,93.66234905931438,0.9142084521615672,-0.5068415818205381,-1.4210500339821053,-373103738,-371943043.6,64.82872114896335,30.771747731026625,NaN,NaN,-9.770268612921905,-28.062438833810706
2001-10-15T09:30:00-04:00,34.12,34.55,33.66,34.39999,78295680,88224435.2,58.00720470473725,42.15034423725217,NaN,NaN,145.57128166185672,115.81397978989116,0.9103346754152937,-0.2831316897129881,-1.1934663651282817,-451399418,-383279440.4,63.5889708142803,34.868190362286555,NaN,NaN,-5.804433473696186,-24.882723782365776
2001-10-16T09:30:00-04:00,34.66901,35.10001,34.07001,34.96001,81141808,88967816,60.21583340986413,44.56091177549138,NaN,NaN,141.82919742717635,138.02164129546415,0.9068051923856342,-0.059959874646239086,-0.9667650670318733,-370257610,-366877974.8,64.64248600847708,39.05520532178078,NaN,NaN,-1.8023397149955014,-21.585526058455738
2001-10-17T09:30:00-04:00,35.87,36,32.3,32.45,141490128,90210947.2,48.02413800810201,46.1311306388824,NaN,NaN,89.8512009195036,142.70029532400218,0.7056875924086577,-0.08465557652105105,-0.7903431689297088,-511747738,-393542310.8,61.525766762502265,43.031633091539895,NaN,NaN,-2.01425451292968,-18.789630123380586
2001-10-18T09:30:00-04:00,32.7,33.53999,32.39999,33.33,94346128,90386719.2,51.715234767729335,47.73412492457175,NaN,NaN,66.1814022987154,121.21942024889181,0.6060026193184054,-0.03283989478170213,-0.6388425141001075,-417401610,-424782022.8,57.99758864850711,46.42525912155365,NaN,NaN,-0.9737869109035541,-16.244509664455297
2001-10-19T09:30:00-04:00,32.869,33.75,32,33.55,73418496,88443384.8,52.621099597856,49.44989781688192,NaN,NaN,60.59777667139263,100.80617179572894,0.5316184420244005,0.025680538430393085,-0.5059379035940074,-343983114,-418957898,58.47567286390538,49.85764340742723,NaN,NaN,0.13194139919832962,-13.905016655361923
2001-10-22T09:30:00-04:00,33.44,34.5,33.22,34.45,74105504,87864935.2,56.23814153166081,51.37896830554034,NaN,NaN,86.39732187345703,88.971379838049,0.5191760002966854,0.14303209677684947,-0.37614390351983595,-269877610,-382653536.4,61.42327177704779,53.50869603016553,NaN,NaN,2.197349735228831,-11.604678599563243
2001-10-23T09:30:00-04:00,34.82201,35.401,34,34.63,104050816,88874676,56.94608069480227,52.41184088793647,NaN,NaN,98.14178746724954,80.23389784606363,0.49907766669470865,0.24770317984854984,-0.2513744868461588,-165826794,-341767373.2,64.48119363591094,56.88582998836785,NaN,NaN,4.070972379454839,-9.365299888274945
2001-10-24T09:30:00-04:00,34.60001,35.67999,34.32001,35.38,90165008,90396146.4,59.85983404737505,53.54188662182183,NaN,NaN,102.46611913839804,82.75688148984253,0.5104729256641964,0.38671667023408673,-0.12375625543010971,-75661786,-254550182.8,69.95280609163814,59.760483416899476,NaN,NaN,6.539058147657512,-7.0932487402845945
2001-10-25T09:30:00-04:00,34.705,36.82001,34.23,36.8,118522688,92820580.8,64.72717827530468,54.84894909013081,NaN,NaN,121.04777949280222,93.73015692865987,0.582604763722441,0.6044996992229414,0.021894935500500534,42860902,-162497680.4,74.42999983299876,62.23332832167347,NaN,NaN,10.275738890067219,-4.611964793091478
2001-10-26T09:30:00-04:00,36.5,37.06,36.00999,36.00999,93816880,93271168.8,60.34318335059027,55.804996949943586,NaN,NaN,126.87237196305894,106.98507598699314,0.5466582934281896,0.7052178022857376,0.15855950885754796,-50955978,-103892253.2,76.80014110124216,64.14689926783473,NaN,NaN,12.04826998104038,-2.231931253929784
2001-10-29T09:30:00-05:00,36,36.158,34.03999,34.03999,92131504,95205208.8,51.05664308949397,56.35209769568932,NaN,NaN,61.61724581404157,102.02906077511004,0.36830465669839507,0.6189403297305418,0.25063567303214673,-143087482,-78534227.6,77.7607061447603,65.705414970815,NaN,NaN,10.52026165765287,-0.41018940941797655
2001-10-30T09:30:00-05:00,33.71001,34.09,32.84,33.38,96075872,96300458.4,48.37089272189056,56.181360893074725,NaN,NaN,-3.0894452879654564,81.78281422406704,0.1928048962496544,0.49164179334421476,0.29883689709456035,-239163354,-93201539.6,75.80563440209532,66.82199831876109,NaN,NaN,8.3963742790985,0.8478911175129487
2001-10-31T09:30:00-05:00,34.03999,34.96001,33.67999,33.89999,106165008,94798115.2,50.57679666550113,55.53726210782689,NaN,NaN,27.272751210438138,66.74414063847505,0.10315800320002472,0.42778440109459126,0.32462639789456654,-132998346,-104668851.6,74.23417852365968,67.56765269685633,NaN,NaN,7.358760760394423,1.7780153522103022
2001-11-01T09:30:00-05:00,34.44,35.563,33.782,35.34,92676192,93062580.8,56.1626721945937,55.34749521853572,NaN,NaN,62.00418984984903,54.93542270988441,0.13049987156737397,0.487751237353784,0.35725136578641004,-40322154,-121305462.8,71.90528600873535,68.07312161541147,NaN,NaN,8.25864376876502,2.7038194117181193
2001-11-02T09:30:00-05:00,35.271,35.85001,34.89,35.60001,64913104,91480226.4,57.10537004279733,55.28307845696859,NaN,NaN,91.20932655772215,47.802813628817056,0.1541324443122738,0.5499169211767523,0.3957844768644785,24590950,-106196077.2,72.7416806362724,68.72688660269661,NaN,NaN,9.26702001328064,3.641419497655622
2001-11-05T09:30:00-05:00,36.25999,37.16,36.16,36.75999,64281504,91305320,61.122131345518284,55.34781402380103,NaN,NaN,160.24738781706333,67.52884202942141,0.2312839277953735,0.6848893866086954,0.45360545881332187,88872454,-59804090,75.18449564716411,69.47988729117426,NaN,NaN,11.399928455390999,4.749777920189247
2001-11-06T09:30:00-05:00,36.60899,38.2,36.39,38.19,107185312,93787210.4,65.42104057654596,56.59044992154711,NaN,NaN,197.6394978076163,107.67463064853776,0.35464116034991033,0.8969069092507098,0.5422657489007995,196057766,27240134,78.98916175110296,70.72727264750289,NaN,NaN,14.656688098273623,6.165050802772729
2001-11-07T09:30:00-05:00,37.61,38.84,37.5,38.14,92542368,94722384.8,65.14978142229208,57.55006039687303,NaN,NaN,198.79528310418752,141.97913702728766,0.4052335917318971,1.0488077385656709,0.6435741468337738,103515398,74542882.8,80.7191776717177,72.35024329201792,NaN,NaN,17.137848184977486,7.732593285944837
2001-11-08T09:30:00-05:00,38.55099,39.39999,37.25,37.75,105882192,94155344,62.95702476791869,58.288340766163216,NaN,NaN,160.4329558496333,161.66489022724448,0.3849447015504188,1.1247550237717974,0.7398103222213785,-2366794,82133954.8,80.98969630871582,73.95838782379009,NaN,NaN,18.538737115701643,9.276328118767237
2001-11-09T09:30:00-05:00,37.59801,38.08,37.12,37.73,74112688,92265944,62.84021874560989,58.75991771001672,NaN,NaN,114.83864356417524,166.39075362853512,0.3440275181328689,1.1698447198874646,0.8258172017545957,-76479482,61919868.4,77.85709223623695,75.13223214230361,NaN,NaN,19.643834286961802,10.757400428509317
2001-11-12T09:30:00-05:00,37,38.35001,36.3,38,112981312,94000225.6,63.816226672467,59.25064242270707,NaN,NaN,96.71155123159313,153.68358631144108,0.3100488807222691,1.213378302657432,0.903329421935163,36501830,51445743.6,76.21215886345666,75.97015822998546,NaN,NaN,20.838502334644367,12.197557843671467
2001-11-13T09:30:00-05:00,39.03,39.5,38.63,39.36,97911376,94838704,68.32862056730207,59.855555745558995,NaN,NaN,143.96901918245283,142.94949058640842,0.35105499529259887,1.3421481660509116,0.9910931707583127,134413206,39116831.6,74.22428935616739,76.27526417745183,NaN,NaN,23.249255696465074,13.776371822641982
2001-11-14T09:30:00-05:00,39.96001,40.24001,38.74001,39.64,88629504,92195672.8,69.1807756897163,60.173669846588396,NaN,NaN,139.3700764378231,131.0644492531355,0.3671872891548835,1.4500772822019172,1.0828899930470337,223042710,63022294,75.55566007610742,76.35566848053101,NaN,NaN,25.496608533348073,15.450691352742853
2001-11-15T09:30:00-05:00,39.162,40.11,38.95,39.48,86342624,91795497.6,68.05396298524477,60.72443982049229,NaN,NaN,123.41325740167787,123.66050956354442,0.33796680639563226,1.5053485010415741,1.1673816946459419,136700086,90835670,77.04150347647114,76.37290865019023,NaN,NaN,27.063292988859157,17.10963444361661
2001-11-16T09:30:00-05:00,39.48,39.67999,38.92,39.37,64034096,91326277.6,67.24305582537433,61.88061215876946,NaN,NaN,105.07297254901377,121.70737536051215,0.2842724563455401,1.5227222650778671,1.238449808732327,72665990,120664764.4,78.54756387084755,76.42911277348219,NaN,NaN,28.165373809180394,18.689025781554292
2001-11-19T09:30:00-05:00,39.78999,40.49001,39.49001,40.49001,69180320,91080018.4,71.02839013608484,63.4990048312119,NaN,NaN,122.58589567646554,126.88224424948662,0.29590155721243105,1.608326755247866,1.312425198035435,141846310,141733660.4,79.5671284579561,76.69779092032938,NaN,NaN,30.238570182467257,20.33896069597043
2001-11-20T09:30:00-05:00,40.08,40.23,38.48,38.62,85209312,90137943.2,58.80895722045015,64.08701629942254,NaN,NaN,75.67319475413628,113.2230793638233,0.1563740042332138,1.5078927033269522,1.3515186990937385,56636998,126178418.8,76.6699003587195,76.87177105140508,NaN,NaN,28.39284577008401,21.489515706558084
2001-11-21T09:30:00-05:00,38.47,38.95,37.98,38.64,60827104,88671048,58.89041506648427,64.28185507598616,NaN,NaN,48.48636586198313,95.04633724865532,0.04967826870495129,1.4136165349749277,1.3639382662699764,117464102,105062697.2,72.79496725992668,76.93531971220446,NaN,NaN,26.94458658714692,22.268811546642205
2001-11-23T09:30:00-05:00,38.75999,39.42999,38.57001,39.28,27042800,84097053.6,61.51327870269245,64.5967056945501,NaN,NaN,65.93518295889284,83.55072236009832,0.008607771803377462,1.3746979810241982,1.3660902092208207,144506902,106624060.4,72.90401757057707,76.94691520751194,NaN,NaN,26.46421865035331,22.868155418600935
2001-11-26T09:30:00-05:00,39.58,40.36,39.00999,40.25,75256128,83169016,65.14319522646585,64.88392454318921,NaN,NaN,89.91282927590001,80.51869370547556,0.03186309662094211,1.4059190799969983,1.3740559833760562,219763030,136043468.4,74.94216620353659,76.92960596153854,NaN,NaN,27.12888535609529,23.476831123957272
2001-11-27T09:30:00-05:00,40.05,40.97,39.2,40.2,100259120,83575396.8,64.80390616312069,64.83984351365883,NaN,NaN,93.35957219291038,74.67342900876453,0.029050878202812935,1.4103695811295722,1.3813187029267593,119503910,131574988.4,74.03129521449343,76.575472637495,NaN,NaN,27.568918229593052,24.061414996190955
2001-11-28T09:30:00-05:00,39.73,40.37,38.69,38.75,101523504,83847778.4,55.73757541505505,64.16754308457047,NaN,NaN,52.88335614060377,70.11546128605804,-0.07936349233931739,1.2821143375026125,1.3614778298419299,17980406,123843670,72.39184328529232,75.98066303846463,NaN,NaN,25.16454308573061,24.21900472326805
2001-11-29T09:30:00-05:00,39.035,40,36.74001,39.95,83820192,82730537.6,60.6447446488708,64.00238021892419,NaN,NaN,27.07485690583098,65.8331594948276,-0.07898629095959597,1.262744966142435,1.341731257102031,101800598,120710969.2,71.69898187998965,75.31704057926991,NaN,NaN,24.60486513031952,24.27412763856112
2001-11-30T09:30:00-05:00,39.73,40.03999,39.36,39.64999,66020816,81397768.8,58.88700530747786,63.72000783048619,NaN,NaN,69.67512238355886,66.5811473797608,-0.10598752163062786,1.2092468550637463,1.3152343766943742,35779782,98965545.2,66.91166456229257,74.5352243168453,NaN,NaN,23.610741494570767,24.17935818941964
2001-12-03T09:30:00-05:00,39.28999,39.60001,38.87,38.97,60391904,81171708.8,54.99615010912672,63.09000236167618,NaN,NaN,24.799279420781563,53.558437408737106,-0.17274144287007154,1.0993075731067847,1.2720490159768563,-24612122,50090514.8,57.60224728740753,73.20594491855607,NaN,NaN,21.57433405897397,23.80721188507026
2001-12-04T09:30:00-05:00,39.34,40.84,38.44,40.83,79390368,81927152,62.328364803307664,62.661412664248004,NaN,NaN,100.69785392079214,55.026093754313465,-0.09842228895268046,1.1490211547860056,1.247443443738686,54778246,37145382,55.40356476122256,71.8616074474886,NaN,NaN,22.117240493223814,23.56578740052077
2001-12-05T09:30:00-05:00,41.20799,43.14999,41.12,42.85001,115730192,82354396,68.35780937098488,62.602629355767185,NaN,NaN,286.28898041355353,101.70721860890342,0.07085859127123184,1.3360166828277258,1.265158091556494,170508438,67650988.4,59.34202675710814,70.70349078184579,NaN,NaN,24.760122963215572,23.736406766620025
2001-12-06T09:30:00-05:00,42.709,43.24001,42.36,42.91,77684320,81611493.6,68.51895628135247,62.635843162632014,NaN,NaN,257.462749131625,147.7847970540622,0.16554025986635534,1.472083416389438,1.3065431565230827,248192758,96929420.4,62.742885299832835,69.6821609120859,NaN,NaN,26.8261999857804,24.17780579792865
2001-12-07T09:30:00-05:00,42.48801,42.60001,41.14,41.73,81629184,80398843.2,61.84687913896569,62.25040197074569,NaN,NaN,151.15765072203723,164.0813027217579,0.12899065362279982,1.4677814735515824,1.3387908199287826,166563574,123086178.8,65.51785299241759,68.75146727791234,NaN,NaN,26.351354236720447,24.48831271775605
2001-12-10T09:30:00-05:00,41.325,42.23,40.88,41,69086000,80147508.8,58.07901610963114,61.325446683141855,NaN,NaN,103.8117704674311,179.88380093108782,0.04052777036350186,1.38945053288316,1.348922762519658,97477574,147504118,67.91996531944912,67.91952705373328,NaN,NaN,24.728553340333423,24.522632806695675
2001-12-11T09:30:00-05:00,41.46001,42.25999,41.13,41.23,66045120,77800699.2,58.928025623471676,61.333951569071964,NaN,NaN,100.68391513180062,179.88101317328952,-0.014663392405147135,1.3305935220132241,1.3452569144183713,163522694,169253007.6,69.92931316155246,67.43805653964992,NaN,NaN,23.69616194121382,24.404565540198266
2001-12-12T09:30:00-05:00,41.5,41.94,40.60001,41.56,76091120,76709686.4,60.174304532964236,61.42565795953482,NaN,NaN,77.33261474976489,138.08974004053178,-0.039692086180042496,1.2956418066933182,1.3353338928733607,239613814,183074082.8,71.16533086922209,67.32165394031388,NaN,NaN,23.220349383358705,24.2353918035069
2001-12-13T09:30:00-05:00,40.71001,41,39.75999,39.75999,79566320,76256527.2,51.07116692650111,60.679792832664006,NaN,NaN,-2.5458263630234534,86.08802494160207,-0.18034527906310927,1.109902294044474,1.2902475731075833,160047494,165445030,67.36196649848316,66.92579314945003,NaN,NaN,19.835919477327995,23.606895756909914
2001-12-14T09:30:00-05:00,39.87199,40.46001,39.57001,40.11,69999008,75439346.4,52.57358414204864,59.78196346949135,NaN,NaN,-12.93255255539486,53.269984286115665,-0.24847609824675332,0.9796524502991417,1.228128548545895,230046502,178141615.6,68.6610197994581,66.47713983487299,NaN,NaN,17.56529568445098,22.743810032272922
2001-12-17T09:30:00-05:00,40.02,41.24001,40.02,40.8,62448800,75360081.6,55.47608501795954,59.11569053055126,NaN,NaN,25.727511521120803,37.65313249685361,-0.24531607365418484,0.921483456478164,1.1667995301323488,292495302,217145161.2,72.30744894064438,66.35400795816949,NaN,NaN,16.540546053220805,21.857629463836904
2001-12-18T09:30:00-05:00,41.16,41.5,40.16,41.25999,50841200,74443125.6,57.35002144957881,59.230865247302965,NaN,NaN,40.94957626763851,25.706264724021196,-0.21175755892718162,0.9021025814733719,1.1138601404005535,343336502,253107922.8,75.17556026046378,66.55284488496746,NaN,NaN,16.248278516719097,21.056293614248645
2001-12-19T09:30:00-05:00,40.56,41.32001,40.32001,40.50999,79590688,74162194.4,53.40337882773908,58.713624831507836,NaN,NaN,19.584779206439173,14.156697615356041,-0.2376411490271262,0.8168087041166459,1.054449853143772,263745814,257934322.8,75.5416729218889,66.82732281653168,NaN,NaN,14.819167926567347,20.165275658865603
2001-12-20T09:30:00-05:00,40.10001,40.3,38.67999,38.78999,83034816,75272580,45.645483805051256,57.76780186704879,NaN,NaN,-84.68057799843382,-2.2702527117260365,-0.3607865399386636,0.6034666782204425,0.9642532181591061,180710998,262067023.6,75.86983688347237,67.46719226804453,NaN,NaN,11.00744885013961,18.85701468619046
2001-12-21T09:30:00-05:00,39.422,39.71001,39.14999,39.48,56203904,76730635.2,48.85535045989928,57.32917332067541,NaN,NaN,-73.83100804879227,-14.449943810405518,-0.3838147449636651,0.4844847869545248,0.8682995319181899,236914902,263440703.6,75.98517685089476,68.78025866543648,NaN,NaN,8.8628530606305,17.429277311110464
2001-12-24T09:30:00-05:00,39.53999,39.63,39.14999,39.32001,13660398,73650848.7,48.145399600359646,56.316104377607694,NaN,NaN,-75.8788165131746,-34.7712094172646,-0.3962544837109817,0.3729814272794627,0.7692359109904444,223254504,249592544,72.23658676656828,69.98261738010402,NaN,NaN,6.929738739144177,15.929343229400995
2001-12-26T09:30:00-05:00,39.37399,40.3,39.16,39.69,37693504,70522567.9,49.95651262659262,55.00172603872254,NaN,NaN,-49.159206704700054,-52.79296601173231,-0.36668023567478825,0.3108856163969591,0.6775658520717474,260948008,233114845.2,67.9415795663118,70.59687115218999,NaN,NaN,5.850294927049424,14.489479186207914
2001-12-27T09:30:00-05:00,39.85001,40.202,39.60001,40.00999,34249808,67158883.1,51.53315823934101,53.78845475000743,NaN,NaN,-37.51952068386859,-64.21382598979388,-0.31467791038205317,0.28421846409418094,0.5988963744762341,295197816,239405245.6,68.70651885966487,71.02284497789228,NaN,NaN,5.394733441513819,13.190229794108758
2001-12-28T09:30:00-05:00,40.29201,40.802,40.23,40.33,38242896,64880018.3,53.12372336246463,53.16537219454307,NaN,NaN,-7.1219080624338655,-48.70209200259388,-0.2506256576267626,0.28561430244278085,0.5362399600695434,333440712,269951188.4,72.17813014945655,71.49857906053792,NaN,NaN,5.451668449248637,12.084721030557311
2001-12-31T09:30:00-05:00,40.31,40.45,38.91,38.91,46173008,63887627.9,45.921991803769714,52.29701331555297,NaN,NaN,-83.46755626925781,-50.629401646686986,-0.2928506153638746,0.17017669086470022,0.4630273062285748,287267704,280021748.8,73.23244589269507,71.87804195862692,NaN,NaN,3.362342951908833,10.838667019321814
2002-01-02T09:30:00-05:00,39.57001,40.14999,38.92999,40.11,61704304,63953247.9,51.86111135540897,51.79223372497706,NaN,NaN,-64.53285861338755,-48.36021006672958,-0.23160482265561733,0.17352127790905314,0.40512610056467047,348972008,305165249.6,75.70764834476158,72.290780185999,NaN,NaN,3.3539982168765206,9.769428618972487
2002-01-03T09:30:00-05:00,40.31,41.55,40.25999,41.5,85762816,64271870.3,57.66147640816573,51.61274600177716,NaN,NaN,37.61026394250962,-31.00631593728764,-0.09606294342235489,0.2850474212867269,0.3811103647090818,434734824,339922612.8,78.64709013382411,72.825191562042,NaN,NaN,5.240483770598376,9.122436497776185
2002-01-04T09:30:00-05:00,41.95,42.28999,40.92999,41.67,86868368,62828779.1,58.322893827308654,52.13072649469199,NaN,NaN,84.88001868809884,-6.526408062894154,0.0013023512306903906,0.3827383037474448,0.3814359525167544,521603192,385203688,81.74599388892688,73.85262208993083,NaN,NaN,6.945999959745425,8.81151699234322
2002-01-07T09:30:00-05:00,42.118,42.22,40.11,41.21001,75096192,62699372.7,55.78350127936328,52.360006290214464,NaN,NaN,61.365506305891365,7.171074810770892,0.029427794287589903,0.41822069537624174,0.38879290108865183,446507000,407816945.6,83.06759600706783,74.88166324761724,NaN,NaN,7.605874485311388,8.63928234848153
2002-01-08T09:30:00-05:00,41.108,41.77,40.84,41.49001,66932320,61964529.5,57.01050929762224,52.46960802447608,NaN,NaN,82.73643034988524,40.411872134599506,0.05983801871534339,0.46359042448283105,0.40375240576748767,513439320,453051268.8,85.35217112360887,75.81342911782897,NaN,NaN,8.50705902109869,8.620393301712552
2002-01-09T09:30:00-05:00,42.03999,42.60001,40.89999,41.11,85104368,62765447.9,54.78836100995646,52.28663227878877,NaN,NaN,96.60447240268947,72.6393383378149,0.047829466382828145,0.4635392387460229,0.41570977236319473,428334952,468923857.6,86.06277486207804,76.59108730365858,NaN,NaN,8.63911426568231,8.623067725136803
2002-01-10T09:30:00-05:00,41.174,41.53999,40.67999,41.38,75530816,63239732.7,56.09771964614835,52.479085194389434,NaN,NaN,68.91821734278349,78.90092901786969,0.051236261351032375,0.4797550990519852,0.42851883770095284,503865768,482750046.4,86.66943062911567,77.38592713988906,NaN,NaN,9.112458719627146,8.69298072434971
2002-01-11T09:30:00-05:00,41.35699,41.60001,40.47,40.85001,60821808,62476267.1,52.861510863409684,52.9945156985579,NaN,NaN,50.844216585318364,72.09376859731358,0.012956236859591075,0.44471413377544167,0.4317578969158506,443043960,467038200,82.2861221446596,77.84423322997385,NaN,NaN,8.628829458778121,8.683816257839483
2002-01-14T09:30:00-05:00,40.49001,40.67999,39.7,39.96001,71298880,62062895.1,47.867608266269634,52.92396268472721,NaN,NaN,-31.618671843985428,53.496932967338225,-0.07245010335825797,0.3411952677180281,0.4136453710762861,371745080,452085816,78.23118699571108,78.00466252603216,NaN,NaN,6.758110081413464,8.408715375492909
2002-01-15T09:30:00-05:00,40.036,40.75,39.56,40.34,66891008,61907495.1,50.03785166798617,53.05913783241482,NaN,NaN,-22.827452913543503,32.38415631465248,-0.10170424049096105,0.28651507046258473,0.3882193109535458,438636088,437125169.6,74.28667883138141,78.15109767351883,NaN,NaN,5.786273082869138,8.034080762260942
2002-01-16T09:30:00-05:00,39.53799,39.94,38.77,38.78,90940816,63332095.9,42.259882855301186,52.50937856303687,NaN,NaN,-109.45119401966183,-8.826976969817784,-0.21780353946306896,0.1159648866247096,0.33376842608777857,347695272,420997233.6,70.17867160250685,78.31088996181848,NaN,NaN,2.4517420890158346,7.236603808940212
2002-01-17T09:30:00-05:00,39.48,39.97701,39.00999,39.64999,74828880,64531479.9,47.19000847832945,52.19915358010747,NaN,NaN,-68.06565813387388,-36.223752065149256,-0.22667688308479167,0.050422322231788996,0.27709920531658067,422524152,404728910.4,66.20182445648547,78.13198321873423,NaN,NaN,1.1350103949723536,6.364947606944804
2002-01-18T09:30:00-05:00,38.83,39.45,38.22,38.59,81983504,64651120.7,42.43573416807907,51.435725780508506,NaN,NaN,-123.98103563056078,-71.1888025083251,-0.29052809221593584,-0.08606090995333915,0.2044671822625967,340540648,384228248,61.47426614971954,77.3674215044673,NaN,NaN,-1.5356680856186584,5.236288222292881
2002-01-22T09:30:00-05:00,39,39.02,37.33,37.39999,81764816,64587620.7,37.82805985323958,50.85758778404206,NaN,NaN,-176.08825469311208,-100.08271907815042,-0.39312657681798513,-0.28694103875988475,0.1061855380581004,258775832,361634398.4,56.67101852509027,76.18446240678124,NaN,NaN,-5.37313466452899,3.720656381318328
2002-01-23T09:30:00-05:00,37.64999,38.69,37.35001,38.42999,74961008,65525475.9,43.54213326186495,50.26337506307463,NaN,NaN,-141.53228437925188,-123.8236853712921,-0.3720608540851864,-0.35889052954838263,0.013170324536803793,333736840,340654548.8,52.56399834344821,74.53134454954456,NaN,NaN,-6.709586960581788,2.23062161818974
2002-01-24T09:30:00-05:00,38.94,39.51401,38.35001,38.94,77212624,68703087.2,46.179816963926086,49.44325653134323,NaN,NaN,-80.58601153633863,-118.05064887462746,-0.30692564702573755,-0.37048673424536815,-0.0635610872196306,410949464,353305387.2,54.696077129975485,72.82055790641252,NaN,NaN,-6.939739311729269,0.9205700567727386
2002-01-25T09:30:00-05:00,38.472,39.14999,38.36,38.83,58828192,69759821.6,45.684068132572634,48.54048326743351,NaN,NaN,-84.10108208794348,-121.25773366544138,-0.25645108025236285,-0.38412493753508414,-0.1276738572827213,352121272,339224811.2,51.9000050072402,70.6887015577206,NaN,NaN,-7.272242675039369,-0.24983176205756252
2002-01-28T09:30:00-05:00,39.15401,39.39,38.42,39.05,47785392,70436600.8,46.91157522513679,47.90677426356019,NaN,NaN,-65.51505591253837,-109.56453772183688,-0.19616714603557855,-0.37288278982719447,-0.17671564379161592,399906664,351098014.4,54.03384819155475,68.6148624280411,NaN,NaN,-7.186106599586768,-1.2407281674188777
2002-01-29T09:30:00-05:00,39.132,39.408,37.515,37.98,83329312,72690921.6,41.94637270778294,46.830764507143094,NaN,NaN,-96.6238102627739,-93.67164883576925,-0.21477275550885316,-0.4451815881776824,-0.23040883266882922,316577352,362658318.4,56.07697691880326,66.52377712769785,NaN,NaN,-8.605196231453977,-2.292795033709606
2002-01-30T09:30:00-05:00,38.00101,38.85001,36.85001,38.27,101371808,75450861.6,43.68606224191837,46.037743166568944,NaN,NaN,-105.2092519397058,-86.40704234786003,-0.1945679324838291,-0.4736187482736156,-0.2790508157897865,417949160,379500782.4,58.94044827425784,64.58646808571068,NaN,NaN,-9.265284344388906,-3.28886493523522
2002-01-31T09:30:00-05:00,38.578,38.75,38.02,38.50999,69653008,75848296.8,45.15090723211062,45.25582799413768,NaN,NaN,-71.94247328936777,-84.67833469846587,-0.15384471415410494,-0.47135670848241773,-0.3175119943283128,487602168,394831323.2,61.40676225726422,62.781991773435585,NaN,NaN,-9.397713990297763,-4.161557657387012
2002-02-01T09:30:00-05:00,38.401,38.88,37.7,38.14,61202192,74620265.6,43.28168285602042,44.57155456503845,NaN,NaN,-75.94495433816034,-83.04710914850924,-0.1409725969038852,-0.49372774045816925,-0.35275514355428406,426399976,409687064,63.68323689479156,61.453214255587866,NaN,NaN,-10.029089605757585,-4.999776507154237
2002-02-04T09:30:00-05:00,37.961,38.07001,36.61,36.92,82754624,74414578.4,37.734326275987854,43.84774870858975,NaN,NaN,-126.09718860366615,-95.1635356867348,-0.20015613525871967,-0.6029503126276836,-0.40279417736896395,343645352,398434801.6,60.75977151840685,60.205256007208995,NaN,NaN,-12.263020553817952,-6.037382799534767
2002-02-05T09:30:00-05:00,36.59,37.33,36.19,36.31,86839312,75001734.4,35.298255643398875,42.79492042111922,NaN,NaN,-149.8146460253014,-105.8017028392403,-0.2620152924716053,-0.7303132929584706,-0.46829800048686526,256806040,386480539.2,57.72779780265005,59.02247879087104,NaN,NaN,-14.896031457695347,-7.30290403641485
2002-02-06T09:30:00-05:00,36.84,36.89,35.7,36.06,98524320,76581334.4,34.320343675596305,42.22781047971173,NaN,NaN,-161.98921113579473,-117.1576946784581,-0.2987371716847088,-0.8417194650927513,-0.5429822934080425,158281720,334547051.2,46.801389241758194,57.35267290796042,NaN,NaN,-17.356375067969733,-8.739114183779833
2002-02-07T09:30:00-05:00,35.996,36.55,35,35.19,97704880,77211360,31.092139116404127,41.07796266814564,NaN,NaN,-180.85514247870424,-138.9402285163254,-0.35666453957353683,-0.9888129678749635,-0.6321484283014267,60576840,249141985.6,35.05178160106206,55.12766984685874,NaN,NaN,-20.49511673528728,-10.418543119709469
2002-02-08T09:30:00-05:00,35.46001,36.24001,34.97,36.17,80470368,77458337.6,38.14952645434047,40.771804974307166,NaN,NaN,-152.39890193504138,-154.23101803570157,-0.3059708599063701,-1.0146120031843893,-0.7086411432780192,141047208,192071432,29.68812957711431,52.85723152024408,NaN,NaN,-21.096074684634647,-11.943904771841638
2002-02-11T09:30:00-05:00,36.14,39.17,35.98,36.63,57618800,77298187.2,41.19400706442401,41.01222977510605,NaN,NaN,-54.89143074230246,-139.98986646342885,-0.22234087412989223,-0.9865672359403845,-0.7642263618104923,198666008,163075563.2,27.394503317231838,50.7660518625399,NaN,NaN,-20.67400892950184,-13.191062508650237
2002-02-12T09:30:00-05:00,36.312,36.98,36.03999,36.33,51465392,76306512.8,39.81745761759276,40.7461815148009,NaN,NaN,-94.7998630729044,-128.98690987294944,-0.17044573648713113,-0.9772835324194062,-0.8068377959322751,147200616,141154478.4,25.773359843861343,48.85243482685513,NaN,NaN,-20.723539995356134,-14.267130721036793
2002-02-13T09:30:00-05:00,36.722,37.14999,36.61,36.95,60978096,76010867.2,43.98354626245366,40.589305036124294,NaN,NaN,-56.70630922075997,-107.93032948994248,-0.08206108469295781,-0.9094141517984724,-0.8273530671055146,208178712,151133876.8,27.866142751897044,46.936010942706666,NaN,NaN,-19.533230667259012,-15.019430713354252
2002-02-14T09:30:00-05:00,37.14999,37.57001,36,36.88,77498496,75338751.2,43.61643377001727,40.44161686737034,NaN,NaN,-55.29944003514312,-82.81918900123028,-0.01928593606673268,-0.8514604871889304,-0.8321745511221977,130680216,165154552,30.817422425405155,45.43011218686131,NaN,NaN,-18.66186632163914,-15.53977865739495
2002-02-15T09:30:00-05:00,36.838,36.91,35.64,35.78,79829632,75588788.8,38.21812603950031,39.82065621125345,NaN,NaN,-92.90650357893252,-70.92070933000852,-0.04154134209240623,-0.8841012287377055,-0.8425598866452992,50850584,147115227.2,29.16410624792738,43.65370204803077,NaN,NaN,-19.460672370656848,-16.099906330718078
2002-02-19T09:30:00-05:00,35.375,35.46001,34.32001,34.67999,72417120,75110469.6,33.72317859190363,39.233285202976354,NaN,NaN,-159.65889971440635,-91.87420312442927,-0.11583154435418075,-0.9873493170880252,-0.8715177727338445,-21566536,103068718.4,25.55855409802561,41.47381470368952,NaN,NaN,-21.579426155539476,-16.882694877121136
2002-02-20T09:30:00-05:00,34.908,35.17,33.92999,35.14999,106536320,76349044.8,37.12579985403517,38.764695032413265,NaN,NaN,-142.06841677951843,-101.3279138657521,-0.1183833597636531,-1.0194969724384109,-0.9011136126747578,84969784,90622552,24.631874980219877,39.02320232554394,NaN,NaN,-22.293907728782568,-17.65572528450134
2002-02-21T09:30:00-05:00,34.78999,34.95,33.48,33.48,109293184,78065653.6,31.02995645145559,37.756055690937906,NaN,NaN,-163.91652762332004,-122.7699575462641,-0.21213651648694587,-1.16628425828344,-0.9541477417964942,-24323400,44122129.6,21.49601268479671,36.172434498939126,NaN,NaN,-24.99235664281559,-18.703815478546232
2002-02-22T09:30:00-05:00,33.619,34.2,33.09,33.64999,99812688,79195656.8,32.24940997020981,36.96803619909429,NaN,NaN,-160.17646112954503,-143.74536176514448,-0.2402314845838498,-1.2544370975263064,-1.0142056129424566,75489288,33083944,20.81847432488577,33.11066574394586,NaN,NaN,-26.73444880735308,-19.851048811232925
2002-02-25T09:30:00-05:00,34.008,35.25,33.955,35.00999,88992320,80703863.2,41.20591554823677,37.21600686139779,NaN,NaN,-91.98536864849805,-143.5611347790576,-0.149209193141,-1.2007171043687066,-1.0515079112277066,164481608,55810148.8,25.99068571619705,30.627159615216588,NaN,NaN,-25.29622179259804,-20.628930665713657
2002-02-26T09:30:00-05:00,35.23199,35.42999,34.37,34.88,94679808,83048584,40.652729839797274,37.598469303997675,NaN,NaN,-75.59159383714226,-126.7476736036048,-0.08304565300667477,-1.15531497748605,-1.0722693244793753,69801800,74083816,29.95279707437237,28.64323099176818,NaN,NaN,-24.33487947483923,-21.15835192416017
2002-02-27T09:30:00-05:00,35.397,35.50999,34.06,34.39999,95150880,83639662.4,38.592393500371884,37.903615720053075,NaN,NaN,-80.04878757575489,-114.34374776285208,-0.058079679550243624,-1.1448689239171799,-1.0867892443669362,-25349080,52020043.2,28.003444063137692,27.300520621866717,NaN,NaN,-24.16249967301116,-21.58751588828174
2002-02-28T09:30:00-05:00,34.51401,34.97,33.75,33.78,95705120,83356328,36.05092952248893,38.25781503477342,NaN,NaN,-97.3798306626483,-101.03640837071772,-0.06904512158410858,-1.1730956463470719,-1.1040505247629633,-121054200,32673883.2,26.382145836660115,26.681260924409433,NaN,NaN,-24.786950488324642,-22.044577974002156
2002-03-01T09:30:00-05:00,34.15401,35.75,34.09,35.74001,85998320,84173593.6,47.762671333640995,38.94446824043774,NaN,NaN,-31.935311943166123,-75.38817853344193,0.06285008829891181,-1.0254879143893234,-1.0883380026882352,-35055880,10564849.6,24.627341643824494,26.31977607203159,NaN,NaN,-21.387724372949382,-21.950741745280332
2002-03-04T09:30:00-05:00,35.702,37.23,32.74001,37.14999,105721312,86399549.6,54.25329489099898,39.877274513764526,NaN,NaN,9.471881726357202,-55.096728458470885,0.24212854458998234,-0.7856773219507573,-1.0278058665407397,70665432,-8198385.6,23.216010931310805,26.021312330180084,NaN,NaN,-16.168414691332835,-21.12469502328783
2002-03-05T09:30:00-05:00,36.938,37.87,36.81,37.42,91438192,86833728,55.39624805365543,40.99004525919757,NaN,NaN,126.41921906602371,-14.69456587783768,0.3684057466883027,-0.5672986831803613,-0.935704429868664,162103624,10261979.2,27.611412888197037,26.15260183334692,NaN,NaN,-11.719854176692658,-19.781146330917093
2002-03-06T09:30:00-05:00,37.08,37.95,36.60001,37.60001,86833504,86833437.6,56.182243834548686,41.861380800061504,NaN,NaN,119.93228875213005,25.301649387739307,0.4482598689052447,-0.37537959373710805,-0.8236394626423528,248937128,65119220.8,38.8192343605006,26.93496551967575,NaN,NaN,-7.948830104169856,-18.09081544138177
2002-03-07T09:30:00-05:00,38.12,38.33,37.00999,37.67999,85502192,86182331.2,56.548615512101215,42.785108067353214,NaN,NaN,125.38818693362913,69.85525290699479,0.4874254631511845,-0.21435763370337213,-0.7017830968545566,334439320,156217924.8,52.086272530018555,28.454169098576706,NaN,NaN,-4.8157062541414115,-16.194371271776006
2002-03-08T09:30:00-05:00,38.231,39.03,38.13,38.67,84446880,85519431.2,60.90598961297902,44.405669751173114,NaN,NaN,154.04259537665723,107.05083437095945,0.5560001985416715,-0.006782848677467257,-0.5627830472191387,418886200,247006340.8,61.13218061640636,30.737602982039494,NaN,NaN,-0.7149068323566271,-13.98301920900181
2002-03-11T09:30:00-05:00,38.35001,39.19,38.06,38.53,71055184,85048672,59.98982822376832,46.28185901059202,NaN,NaN,130.59988034643445,131.27643409497492,0.5660313776979111,0.1447561749032502,-0.4212752027946609,347831016,302439457.6,65.42443137456205,33.585165644649244,NaN,NaN,2.35495317422018,-11.649023154255811
2002-03-12T09:30:00-05:00,37.57899,38,37.32001,38,82664816,86300972.8,56.52347096548108,47.66740694712387,NaN,NaN,86.58124838916957,123.3088399596041,0.5126637501015411,0.21955448483226547,-0.2931092652692756,265166200,323051972.8,66.88868953710691,36.60350954156974,NaN,NaN,3.9842308202679906,-9.415701157895269
2002-03-13T09:30:00-05:00,37.41,37.66,36,37.08,71383008,87296853.6,51.01317760982677,49.094779887007526,NaN,NaN,42.46523098950712,107.81542840707951,0.39629924461946997,0.20226479050506185,-0.19403445411440812,193783192,312021185.6,65.29505470513661,39.732012543022584,NaN,NaN,3.7823188094802194,-7.530269733984484
2002-03-14T09:30:00-05:00,37.069,37.39999,36.72,36.86,70726192,87784258.4,49.763841388461195,50.345810702596914,NaN,NaN,45.96232210565589,91.93025544148486,0.2903186547223523,0.16886386428853228,-0.12145479043382003,123057000,269744721.6,59.44906572253919,42.49134049999783,NaN,NaN,3.25441082817619,-5.989601082247246
2002-03-15T09:30:00-05:00,36.899,37.33,36.59599,37.23,63973296,87107998.4,51.89751597972597,51.109496447703286,NaN,NaN,47.81420712848662,70.68457779185073,0.2333929063039224,0.17028634244608298,-0.06310656385783943,187030296,223373540.8,53.76319531177253,44.47509118539608,NaN,NaN,3.406732880147266,-4.64726765904803
2002-03-18T09:30:00-05:00,37.63499,37.94,37.05,37.44,78950368,87064035.2,53.11468490348202,51.99963609510934,NaN,NaN,61.80253063307715,56.92510784917927,0.19945514811674026,0.18621237128808588,-0.013242776828654365,265980664,207003470.4,51.876886045025415,46.04109754044272,NaN,NaN,3.8672831726492087,-3.430903254519853
2002-03-19T09:30:00-05:00,37.60899,37.88,37.22,37.38,58947600,86390559.2,52.704342507030134,53.00763245272778,NaN,NaN,56.849171624490076,50.978692496243355,0.1640195223598252,0.19178162612112715,0.02776210376130194,207033064,195376843.2,50.52110806244612,47.6495021118219,NaN,NaN,4.14267982585153,-2.348962814466798
2002-03-20T09:30:00-05:00,36.879,37.08,36.03999,36.06,61823296,84154908,44.55003325895268,53.614711291046625,NaN,NaN,2.8526922346809247,43.05618474527812,0.04871856620603899,0.08866031151885068,0.03994174531281169,145209768,185662158.4,49.360321668393176,49.290800385517116,NaN,NaN,2.0107782708025312,-1.7261426594283227
2002-03-21T09:30:00-05:00,36.14999,37.14,35.89999,37.02,92291872,83304842.4,50.54310664578476,53.81331381334261,NaN,NaN,11.64984370691904,36.19368906553074,0.03479706889257664,0.08343808142853248,0.048641012535955847,237501640,208551086.4,52.14993127428137,51.256699644835464,NaN,NaN,1.9213116488599258,-1.205077758244287
2002-03-22T09:30:00-05:00,36.944,37.14,36.47,36.67999,58930192,81260717.6,48.5419961146874,53.40536390074892,NaN,NaN,8.585909338832897,28.348029507600007,0.0021051295287608726,0.05127242444690694,0.049167294918146066,178571448,206859316.8,51.92226089366,53.30714607071756,NaN,NaN,1.2504125083028041,-0.8542934344518456
2002-03-25T09:30:00-05:00,36.69,36.901,35.52,35.56,87435184,81182860.8,42.56396271273866,52.48877209068343,NaN,NaN,-47.20057977829023,6.547407425326542,-0.0904192932265264,-0.06385682161501194,0.026562471611514465,91136264,171890436.8,47.32336478424796,54.71514263472119,NaN,NaN,-1.23811360406584,-0.9091248872538448
2002-03-26T09:30:00-05:00,35.427,36.42,35.39999,35.89,92457504,81071745.6,44.724002605768376,51.6703262886277,NaN,NaN,-60.491228344279314,-16.920672568427335,-0.12285421607539461,-0.1270052984827288,-0.004151082407334184,183593768,167202577.6,46.72586891135604,55.27990224549658,NaN,NaN,-2.6288845047428584,-1.1548048326094182
2002-03-27T09:30:00-05:00,35.63699,36,35.39999,35.61,64537008,79541052,43.23815842877948,50.719579354104724,NaN,NaN,-86.48629418147425,-34.78846985165838,-0.1545746775775615,-0.19736942937928603,-0.042794751801724554,119056760,161971976,46.027573575912456,54.847138034489,NaN,NaN,-4.2174323601637616,-1.5923230508314672
2002-03-28T09:30:00-05:00,36.02,36.37,35.89999,36.06,59573392,77734465.6,46.324526063684985,49.67804624344086,NaN,NaN,-68.49748090759675,-50.81793477456153,-0.1372452879971754,-0.2143513617981938,-0.07710607380101842,178630152,150197678.4,44.41836487651876,53.65329405306846,NaN,NaN,-4.671407520658509,-2.0321922608067586
2002-04-01T09:30:00-05:00,35.8,36.89999,35.3,36.75,70732688,76971184,50.746811679514366,49.01783077599415,NaN,NaN,-59.88786642932537,-64.51268992819318,-0.0744517881595761,-0.17017080900048853,-0.09571902084091244,249362840,164355956.8,46.82580416662446,52.32482068107292,NaN,NaN,-3.755621690152068,-2.278396464998946
2002-04-02T09:30:00-05:00,35.98599,36.14999,35,35.09,77764000,75573318.4,41.819962112683704,47.96758014365149,NaN,NaN,-141.79544086818206,-83.43166214617153,-0.13625582310801115,-0.26603879972592637,-0.1297829766179152,171598840,180448472,49.50304464392223,51.0829889029883,NaN,NaN,-5.832663659679755,-2.7861489213819186
2002-04-03T09:30:00-05:00,35.3,35.45,34.3,35.03,85768496,75289833.6,41.53555703914898,47.29060724574593,NaN,NaN,-158.82412027546974,-103.09824053240963,-0.17049649267579725,-0.3429035924626618,-0.17240709978686453,85830344,160895787.2,46.4433562235824,49.73643901144872,NaN,NaN,-7.553200558769202,-3.4671562981515303
2002-04-04T09:30:00-05:00,34.508,35.16,34.28,34.75999,90533808,75474848.8,40.21028765166546,46.608210550260516,NaN,NaN,-150.3043497416833,-115.86185164445143,-0.1986797779189901,-0.4207568221856022,-0.22207704426661207,-4703464,136143742.4,42.834049481588856,48.549652137095116,NaN,NaN,-9.361900681136236,-4.309262638577916
2002-04-05T09:30:00-05:00,35.00999,35.175,34.17999,34.37,68433312,74621404.8,38.3090190998555,45.637603630269766,NaN,NaN,-141.5235126848196,-130.46705799989599,-0.228793009537617,-0.5080683061886333,-0.2792752966510163,-73136776,85790356.8,36.60228940908863,47.32387314404627,NaN,NaN,-11.442636187128514,-5.328316002656573
2002-04-08T09:30:00-04:00,33.479,34.8,33.425,34.8,74959872,74147054.4,41.58849432139446,44.814304302977796,NaN,NaN,-144.10479770075176,-147.31044425418128,-0.20568599709124452,-0.536382793015072,-0.33069679592382745,1823096,36282408,31.716470342481884,45.88384345100744,NaN,NaN,-12.260920556720558,-6.3186880818085704
2002-04-09T09:30:00-04:00,34.78,34.98,33.498,33.59,80925008,74640545.6,35.81831365249229,43.60815938479652,NaN,NaN,-150.23640702771638,-148.99863748608814,-0.2546250431549541,-0.6489780998675201,-0.394353056712566,-79101912,-13857742.4,27.68576508752099,44.252747524227075,NaN,NaN,-14.81536200007726,-7.53249864156124
2002-04-10T09:30:00-04:00,33.75999,34.25,33.13,33.84,85758192,74795214.4,37.74035263780983,43.121753626143466,NaN,NaN,-148.56473957888383,-146.94676134677098,-0.25240156611360043,-0.7098550143545665,-0.4574534482409661,6656280,-29692555.2,26.53870060780612,42.62263173418514,NaN,NaN,-16.32453982876869,-8.788504525448019
2002-04-11T09:30:00-04:00,33.66,33.85001,32.88901,33,90671184,75759623.2,34.05058048131818,41.943716042967274,NaN,NaN,-154.37358157468898,-147.7606077133721,-0.2872129484499021,-0.8164696338033437,-0.5292566853534416,-84014904,-45554843.2,25.40327523187092,40.7121563025844,NaN,NaN,-18.78803522065098,-10.217008910477013
2002-04-12T09:30:00-04:00,33.325,33.8,32.95,33.52,78359808,76141304,38.086021886825954,41.19686074097718,NaN,NaN,-124.40104546180409,-144.336114268769,-0.2559655537757608,-0.8492136275731426,-0.5932480737973818,-5655096,-32058507.2,28.21733460175308,39.01894728173391,NaN,NaN,-19.626259306007032,-11.561187538409872
2002-04-15T09:30:00-04:00,33.80299,33.96001,33.2,33.78999,69329120,76409095.2,40.134291917839505,41.023312827055804,NaN,NaN,-98.74451608911777,-135.2640579464422,-0.20032349436283547,-0.8436524417509261,-0.6433289473880907,63674024,-19688321.6,30.794253044743343,37.83829644319786,NaN,NaN,-19.709175888386195,-12.725185874120776
2002-04-16T09:30:00-04:00,34.431,35.22,34.41701,35.2,72092320,76066192.8,49.5256506107715,41.366287684556035,NaN,NaN,-17.140254862622246,-108.6448275134234,-0.05909818952305934,-0.7172016842919149,-0.6581034947688555,135766344,23285329.6,38.98840800911008,37.28562066446601,NaN,NaN,-16.739539409472044,-13.298664950599528
2002-04-17T09:30:00-04:00,35.39999,35.5,34.45,35.02,69130128,76575319.2,48.48009116893277,41.74071145170984,NaN,NaN,-7.236242341253451,-80.37912806589733,0.02702974476536313,-0.6243163138121517,-0.6513460585775148,66636216,35281316.8,41.08543075720013,36.932610463129414,NaN,NaN,-14.67853518699623,-13.49578927008477
2002-04-18T09:30:00-04:00,34.785,35.14999,34,34.35001,91120000,78040154.4,44.6975572836144,41.62449939599052,NaN,NaN,-37.3715267474139,-56.978717100442296,0.04277712262067879,-0.5978746553016663,-0.6406517779223451,-24483784,47187540.8,43.17312687132589,36.84366489132992,NaN,NaN,-14.075562537415601,-13.578614022560604
2002-04-19T09:30:00-04:00,35.058,35.06,34.38,34.46001,62431696,76547145.6,45.450085043446116,41.24616177912849,NaN,NaN,-21.573135146108317,-36.41313503730315,0.06326546951897405,-0.5615699410236275,-0.6248354105426015,37947912,55908142.4,44.718320419873905,36.6931303379906,NaN,NaN,-13.366856761102147,-13.548362985209396
2002-04-22T09:30:00-04:00,34.00999,34.02,33.256,33.59,64641600,76832716,40.72942493938651,41.168266266750116,NaN,NaN,-97.51362004849663,-36.16695582917891,0.022965187445509905,-0.5961289262357141,-0.619094113681224,-26693688,37834600,42.159687246868735,36.16860480962963,NaN,NaN,-14.170499897318425,-13.637239686939257
2002-04-23T09:30:00-04:00,33.59801,33.94,32.7,33.00999,73101376,76116025.6,37.90299951188523,40.90879787194557,NaN,NaN,-120.42838387278991,-56.82458163121244,-0.034868842017116486,-0.6626801662026196,-0.6278113241855031,-99795064,-9277681.6,36.32516064053687,35.44587655369781,NaN,NaN,-15.716136982718496,-13.93422501490772
2002-04-24T09:30:00-04:00,33.213,33.31,32.2,32.5,68965120,74941406.4,35.5659165926717,40.57705708201745,NaN,NaN,-147.21654003562307,-84.82064117008638,-0.0961129433027833,-0.7479525033139822,-0.6518395600111989,-168760184,-56356961.6,31.616452793129582,34.64461964737929,NaN,NaN,-17.731673553353787,-14.476717663257157
2002-04-25T09:30:00-04:00,32.308,32.73,32,32.42,103085632,76868837.6,35.19927037203075,40.3549321728871,NaN,NaN,-148.51208300833883,-107.04875242227135,-0.1286238764481923,-0.8126194055714393,-0.683995529123247,-271845816,-105829368,27.57183263580312,33.99958702071604,NaN,NaN,-19.473366693203722,-15.190524667535238
2002-04-26T09:30:00-04:00,32.662,34,31.00999,31.03999,100194624,78899899.2,29.54174749701322,39.49445025685987,NaN,NaN,-157.3550045419975,-134.20512630144918,-0.22409158092724857,-0.9641100052823077,-0.7400184243550592,-372040440,-187827038.4,22.44636224951877,33.33743644264725,NaN,NaN,-22.908868146421312,-16.29314516451896
2002-04-29T09:30:00-04:00,31.244,31.55,30.56799,31.12,85336368,79630083.2,30.241806432674863,39.0961283125872,NaN,NaN,-201.62919393690942,-155.02824107913176,-0.2603289796121355,-1.0654296488702286,-0.8051006692580931,-286704072,-239829115.2,19.91759504270631,32.78256715373191,NaN,NaN,-25.447596705402383,-17.600923956073736
2002-04-30T09:30:00-04:00,31.032,32.19501,30.942,31.73,95421120,80512939.2,35.50331606568324,38.93633998600672,NaN,NaN,-143.32993700370102,-159.60855170531397,-0.2231262797380188,-1.0840085189306166,-0.8608822391925978,-191282952,-258126692.8,19.10213553923161,32.251383934548016,NaN,NaN,-26.05268718265592,-18.808318702728332
2002-05-01T09:30:00-04:00,31.67,31.84,30.58,31.56,109968368,81722932.8,34.717417801083556,38.98397122313282,NaN,NaN,-141.42459688974225,-158.4501630761378,-0.19111220371266358,-1.0997724938334272,-0.9086602901207637,-301251320,-284624920,17.955635221853996,31.719409648118237,NaN,NaN,-26.775504389013527,-19.94648808648336
2002-05-02T09:30:00-04:00,31.39799,31.99001,30.46001,30.50999,85858368,81489160.8,30.261679856889984,38.42508964956597,NaN,NaN,-141.01453868419424,-156.9506542113089,-0.21975308632725077,-1.1833516480298272,-0.9635985617025764,-387109688,-307677694.4,16.999708096683804,30.918150612041863,NaN,NaN,-28.801142483243215,-21.21143871459191
2002-05-03T09:30:00-04:00,30.47,30.51401,23.88,29.74001,92128128,82673901.6,27.476784825385934,37.52098200010499,NaN,NaN,-245.3636281471005,-174.5523789323295,-0.26653819740799545,-1.2967713084625707,-1.0302331110545753,-479237816,-329117169.6,16.139149797118506,29.8713575229258,NaN,NaN,-31.42723434735748,-22.670838090701277
2002-05-06T09:30:00-04:00,29.63699,29.98399,28.85001,28.97,96519184,83751867.2,24.999122243312158,35.76908711671504,NaN,NaN,-155.02338237052118,-165.23121661905185,-0.32163762661050654,-1.4322801443177084,-1.110642517707202,-575757000,-386927755.2,14.070752095722355,28.09152495768382,NaN,NaN,-34.470075671277385,-24.356443459355006
2002-05-07T09:30:00-04:00,29.27,29.35001,28.42,28.7,102059808,84808607.2,24.17591120810647,34.033074262370306,NaN,NaN,-148.18132375121198,-166.20149396855405,-0.34641735891322867,-1.5436642163487377,-1.197246857435509,-677816808,-484234526.4,11.418162854675032,25.972434393217743,NaN,NaN,-37.196094018860556,-26.190679253570085
2002-05-08T09:30:00-04:00,30.13,31.88,30,31.77,129922816,87016838.4,45.964349470592936,34.12355941858306,NaN,NaN,-43.98761151185011,-146.71409689297562,-0.13695374569044527,-1.3684390395485657,-1.2314852938581204,-547893992,-533563060.8,10.352682557211807,23.62811694220959,NaN,NaN,-31.740645572594495,-26.983531584859286
2002-05-09T09:30:00-04:00,31.578,31.89,30.8,30.95,106527120,87809635.2,42.455139647501994,33.9096347474442,NaN,NaN,-39.80134687781399,-126.47145853169954,-0.0395899372287265,-1.2809727153940287,-1.2413827781653022,-654421112,-587025345.6,9.335876183748326,21.100799496772048,NaN,NaN,-28.725768070713386,-27.232422511409872
2002-05-10T09:30:00-04:00,31.01401,31.099,29.5,29.56,112373808,89510335.2,37.26189494545681,33.661954033592075,NaN,NaN,-79.21054842707915,-93.24084258769528,-0.053877921283669084,-1.3087301797698885,-1.2548522584862194,-766794920,-644536766.4,8.382133536827283,18.688117088911945,NaN,NaN,-28.15588731308496,-27.364346054506314
2002-05-13T09:30:00-04:00,29.87,30.98,29.675,30.75999,93973808,90742569.6,43.66822697601893,34.07375599531592,NaN,NaN,-56.578271315425006,-73.55182037667605,0.028011823692653204,-1.219837478870403,-1.2478493025630562,-672821112,-663949588.8,8.082000194989519,16.67074848565856,NaN,NaN,-25.30004213526391,-27.06944549461454
2002-05-14T09:30:00-04:00,32.05499,32.64999,31.87,32.57001,107841680,92530037.6,51.68263926594964,35.22495047197862,NaN,NaN,28.61638758508165,-38.19227810941734,0.20475795505176264,-0.9919018587483528,-1.1966598138001154,-564979432,-641382113.6,12.025618437929907,15.271403174572871,NaN,NaN,-19.79790792512786,-26.030654413259303
2002-05-15T09:30:00-04:00,32.082,33.63,31.85001,32.81,204584496,99302756,52.644654011886004,36.47104930339685,NaN,NaN,56.13173088511523,-18.168409630024275,0.3310305759355556,-0.782871593880671,-1.1139021698162266,-360394936,-603882302.4,18.298339500274082,14.609010807749367,NaN,NaN,-15.342145239018345,-24.50372453122488
2002-05-16T09:30:00-04:00,32.54201,33.05,32.22,32.86,89899184,99241715.2,52.855261253887335,38.136300286030725,NaN,NaN,61.958815972937956,2.1836229401261207,0.40616875525359886,-0.6061912257492281,-1.012359981002827,-270495752,-527097230.4,29.398871520047564,15.10561861278714,NaN,NaN,-11.875019828484525,-22.699623859404827
2002-05-17T09:30:00-04:00,33.28999,33.411,32.47,32.92999,82720128,100256136.8,53.169229884705594,39.7739733897472,NaN,NaN,83.82388362842842,34.79050935122764,0.4456679640641763,-0.4552750259226066,-0.9009429899867829,-187775624,-411293371.2,42.16199895785119,16.694504606726063,NaN,NaN,-9.050383732716618,-20.74973241273508
2002-05-20T09:30:00-04:00,32.60001,32.7,31.94,32.21001,78157376,100931925.6,49.516072849581256,40.77488458859706,NaN,NaN,54.01911033546772,56.90998568140619,0.4093289354815667,-0.3892818206348245,-0.7986107561163912,-265933000,-329915748.8,49.122462930496674,18.83881370610214,NaN,NaN,-7.764827644421127,-18.89474601726166
2002-05-21T09:30:00-04:00,32.369,32.59,31.092,31.33,104169872,102485350.4,45.40926570747477,41.53858801048215,NaN,NaN,23.84163544155671,55.9550352527012,0.3162152366739792,-0.4033417102739172,-0.7195569469478964,-370102872,-290940436.8,52.095952447570056,21.277407793653285,NaN,NaN,-7.926673045563034,-17.327878449876142
2002-05-22T09:30:00-04:00,30.99001,31.59,30.41,31.39999,89542496,103514219.2,45.79433233654744,42.64806318760054,NaN,NaN,-5.72799961725055,43.58308915222805,0.2523035105707375,-0.4041775587344745,-0.656481069305212,-280560376,-274973524.8,53.30007997225665,23.870291499051344,NaN,NaN,-7.945055893216281,-15.987475227496162
2002-05-23T09:30:00-04:00,31.63,32.10001,30.8,32.03,94453808,103082628,49.263562020172216,44.204261558656704,NaN,NaN,32.114766586595714,37.6142792749596,0.24520949086863797,-0.3499692057194146,-0.5951786965880526,-186106568,-258095688,54.5991855653178,26.617436911065578,NaN,NaN,-6.95426904003832,-14.69701720071647
2002-05-24T09:30:00-04:00,31.592,31.69,31.00999,31.24001,55876896,100866741.6,45.34458579345442,45.65750895509543,NaN,NaN,11.971209115323036,23.243744372338522,0.18291962438042242,-0.3665291661125245,-0.5494487904929469,-241983464,-268937256,53.568333256829845,29.438692708287544,NaN,NaN,-7.252075865933117,-13.633454152890277
2002-05-28T09:30:00-04:00,31.47099,31.52699,30.49001,31.10001,68838624,100041854.4,44.666445827522004,47.121118570767976,NaN,NaN,-7.510388291524373,10.937844646940103,0.13036334065840083,-0.38649461466994595,-0.5168579553283468,-310822088,-277915073.6,52.68131963069068,32.38606104943152,NaN,NaN,-7.688639324726472,-12.784194891724018
2002-05-29T09:30:00-04:00,30.66499,30.89999,30.24001,30.28,73479312,98944764,40.81608813774111,46.75338561842141,NaN,NaN,-42.89016278007865,-2.408514997386964,0.04296919128544141,-0.463146466221545,-0.5061156575069864,-384301400,-280754779.2,52.38584287816301,35.38842964378518,NaN,NaN,-9.196601457362569,-12.271681543958097
2002-05-30T09:30:00-04:00,30.013,30.72,29.89999,30.53999,92089680,98050829.6,42.50827075821091,46.75718069775776,NaN,NaN,-44.37487602093869,-10.137890278124596,0.007145829810566329,-0.49718337024377846,-0.5043292000543448,-292211720,-283085048,52.12746776117175,38.444971899315426,NaN,NaN,-9.98050215128203,-11.94437020214723
2002-05-31T09:30:00-04:00,30.75999,31.03999,30,30.03999,79907680,97753295.2,40.13181151395025,46.962174738364446,NaN,NaN,-42.43444827603527,-25.047733250650786,-0.04299311421454077,-0.5580705928225207,-0.5150774786079799,-372119400,-320287614.4,48.052671914448304,41.278581783431214,NaN,NaN,-11.32732853622512,-11.856221392729786
2002-06-03T09:30:00-04:00,30.008,30.25,28.78999,28.98,77072624,97000520,35.58932978516367,46.38511065330335,NaN,NaN,-122.3550311661659,-51.91298130694857,-0.13511568530408746,-0.6839720852380893,-0.5488563999340018,-449192024,-361729326.4,43.93285319323134,43.83935699759134,NaN,NaN,-13.903727382415981,-12.148722248399242
2002-06-04T09:30:00-04:00,28.75101,29.67999,28.61,29.36,98375680,97093344.8,38.28615941727557,45.428219235540915,NaN,NaN,-130.4906739786578,-76.50903844437525,-0.15651880937906337,-0.7445049116578311,-0.5879861022787677,-350816344,-369728177.6,43.16362866128283,46.06350058497369,NaN,NaN,-15.284996099799153,-12.596761370027801
2002-06-05T09:30:00-04:00,29.42101,29.8,28.97,29.66,95370192,96758864,40.40749641310239,44.554136549913515,NaN,NaN,-119.0039326470372,-91.73179241776697,-0.13722304207600888,-0.7595149048737788,-0.6222918627977699,-255446152,-343957128,46.418739742952816,48.07210060230789,NaN,NaN,-15.844333939548298,-13.060700308530729
2002-06-06T09:30:00-04:00,29.511,29.51801,27.89999,28.88,93207504,94923098.4,36.859862231108366,43.411608048286446,NaN,NaN,-143.59276013723314,-111.57536924102587,-0.1620398319853421,-0.8248416527794475,-0.6628018207941054,-348653656,-355245515.2,45.197671309326076,49.20058630154207,NaN,NaN,-17.372982547780463,-13.676740628423548
2002-06-07T09:30:00-04:00,27.63,28.78999,27.52,28.3,106055312,94899508,34.43860717521588,42.07370642618004,NaN,NaN,-151.5615745996214,-133.40079450574308,-0.20007172670039153,-0.9128914791695948,-0.7128197524692033,-454708968,-371763428.8,43.39867168769655,49.28892006795959,NaN,NaN,-19.39846728755052,-14.494130151155973
2002-06-10T09:30:00-04:00,28.36,28.75,28.14,28.25,73149808,92938308,34.22986093509802,40.981834146574094,NaN,NaN,-127.32434755356944,-134.3946577832238,-0.21011353256398713,-0.9754616681741872,-0.7653481356102001,-527858776,-387496779.2,41.69626666368923,48.75847747747334,NaN,NaN,-21.113109728693622,-15.43969866223278
2002-06-11T09:30:00-04:00,28.60001,28.69,27.36301,27.46001,84609504,92470092.8,31.029599044664494,39.9547150992305,NaN,NaN,-135.06176625056838,-135.30887623760592,-0.24883082674307944,-1.0763866690390493,-0.8275558422959699,-612468280,-439827166.4,36.55935189707208,47.64872029529492,NaN,NaN,-23.572344982841244,-16.60150527946256
2002-06-12T09:30:00-04:00,27.24899,27.96001,26.834,27.86,152986368,94727327.2,34.37510076856748,39.13905570151765,NaN,NaN,-132.19053134013026,-137.94619597622452,-0.22698285754644176,-1.1112844142290221,-0.8843015566825804,-459481912,-480634318.4,33.1315625284318,46.20811190645029,NaN,NaN,-24.7152609735181,-17.76061323575621
2002-06-13T09:30:00-04:00,27.765,28.21001,27.353,27.67999,97610368,89378620.8,33.58554450635954,38.01919730767389,NaN,NaN,-108.54449659971925,-130.93654326872175,-0.2048159664253627,-1.1403215147142838,-0.9355055482889211,-557092280,-522322043.2,30.033577613088198,44.453425624148174,NaN,NaN,-25.888320475058148,-18.9217142699422
2002-06-14T09:30:00-04:00,26.862,27.72,26.2,27.62,122091632,90988243.2,33.31094925367111,37.159651840546516,NaN,NaN,-120.37494389558984,-124.69921712791543,-0.17548499325331324,-1.1548617898555626,-0.9793767966022494,-679183912,-567217032,27.095221407946667,42.56248906351367,NaN,NaN,-26.939010886240528,-20.067042357984818
2002-06-17T09:30:00-04:00,28.002,28.75,27.91,28.56,87635872,91234030.4,41.39630781961772,36.92607055426764,NaN,NaN,-58.98329558302551,-111.03100673380663,-0.07898429888625169,-1.078107170210064,-0.9991228713238123,-591548040,-579954884.8,26.308754060078016,40.67873437989847,NaN,NaN,-25.618013333589385,-20.860038211642614
2002-06-18T09:30:00-04:00,28.317,29.14999,28.28,29.02,100205680,92336445.6,44.91584914795957,37.2189106264261,NaN,NaN,-33.69887464390551,-90.75842841247406,0.02410589213510783,-0.9689905061549275,-0.9930963982900354,-491342360,-555729700.8,30.443791398944185,39.1114449885257,NaN,NaN,-23.468375169234847,-21.232657777012932
2002-06-19T09:30:00-04:00,28.104,28.3239,27.25,27.34,93516128,91803758.4,36.33352747920313,36.7778575350684,NaN,NaN,-89.63258208331351,-82.2468385611107,-0.01070264893628503,-1.0064747094603916,-0.9957720605241066,-584858488,-580805016,28.651630966260797,37.434599503174915,NaN,NaN,-24.12685706169888,-21.646114817682353
2002-06-20T09:30:00-04:00,27.27,27.45,25.67,26.46001,99923184,92322792.8,32.798356714628554,36.25403933511684,NaN,NaN,-136.96298449742508,-87.93053614065187,-0.07903955976706012,-1.0945715102329316,-1.0155319504658715,-684781672,-606342894.4,26.91391752015784,35.924688475011315,NaN,NaN,-25.852206707943704,-22.24698508771969
2002-06-21T09:30:00-04:00,26.367,26.78,25.64999,25.82001,101815808,92690892.8,30.47590663385668,35.8887948243092,NaN,NaN,-149.71941866554462,-93.79943109464281,-0.14931332113904072,-1.2021736018896725,-1.0528602807506318,-786597480,-627825608,25.51218400099826,34.60892638985181,NaN,NaN,-28.04224310951524,-23.07487909083334
2002-06-24T09:30:00-04:00,25.457,26.8,25.21001,26.33,139673120,96880704,34.458595816312965,35.61539742424044,NaN,NaN,-136.07824210028804,-109.21842039809533,-0.14338720573868557,-1.2320942879239887,-1.088707082185303,-646924360,-638900872,24.795205897626815,33.29689619244781,NaN,NaN,-28.57777385628117,-23.861006914468742
2002-06-25T09:30:00-04:00,26.584,26.72,25.3,25.46001,136737872,100275666.4,31.177494949821508,34.956111605434664,NaN,NaN,-139.05865405717458,-130.29037628074914,-0.17775143184506015,-1.3108963719916282,-1.133144940146568,-783662232,-697364846.4,21.379538924455332,31.508381848269412,NaN,NaN,-30.097139979898817,-24.751883066673038
2002-06-26T09:30:00-04:00,24.438,25.78,24.39,25.45,149032320,104053316.8,31.140753556375188,34.54760384295373,NaN,NaN,-154.90005540205743,-143.34387094449792,-0.18028038793902978,-1.3584954250703554,-1.1782150371313256,-932694552,-766932059.2,18.171751739905076,29.5779590218822,NaN,NaN,-31.304554953838494,-25.687979050553817
2002-06-27T09:30:00-04:00,26,26.25,20.59,26.21001,121381008,105517883.2,37.192691944235015,34.74432418359795,NaN,NaN,-177.68884381999004,-151.48904280901093,-0.11317126851958625,-1.3196791227808085,-1.2065078542612222,-811313544,-792238433.6,17.162942680248662,27.703978378493066,NaN,NaN,-30.486806541533007,-26.373525834979414
2002-06-28T09:30:00-04:00,26.05,26.75,25.85001,26.10001,87860000,105915499.2,36.69007298123066,34.92005361546457,NaN,NaN,-67.09127060590092,-134.96341319708216,-0.06119638889943513,-1.2830033403855161,-1.221806951486081,-899173544,-814753646.4,16.296125804295116,25.889682602822056,NaN,NaN,-29.97108330484821,-26.887462616389243
2002-07-01T09:30:00-04:00,25.978,26.14,24.78,24.85001,64782400,105300988,31.483352742636825,34.952464593891165,NaN,NaN,-106.75378758129685,-129.09852229328393,-0.09404462446371076,-1.3393627320657195,-1.2453181076020088,-963955944,-878159963.2,14.13157697227011,24.287698679621915,NaN,NaN,-31.127179801961248,-27.493136500042386
2002-07-02T09:30:00-04:00,24.608,24.75,23.09,23.95,111611008,105962754.4,28.36244235211464,34.522988992715966,NaN,NaN,-153.1447454013148,-131.915740562112,-0.15578649565938862,-1.4400512271762445,-1.2842647315168558,-1075566952,-936540907.2,12.486965882129795,22.813084633457485,NaN,NaN,-33.13038225169379,-28.298457321706874
2002-07-03T09:30:00-04:00,23.85201,24.75,23.62,24.75,101076320,106248060.8,34.571094322790074,34.59338540817529,NaN,NaN,-117.57530873099536,-124.45079122789957,-0.1235559913917601,-1.438709720756556,-1.315153729364796,-974490632,-944900123.2,12.266833379933232,21.54403147394641,NaN,NaN,-32.815487424553844,-28.943747336399298
2002-07-05T09:30:00-04:00,25.26401,26.39,25.05,26.34,56771104,104426240.8,44.80910946147877,35.414682565875836,NaN,NaN,-34.68283402610892,-95.84958926912336,0.016582564489875384,-1.2944255237524516,-1.311008088242327,-917719528,-966181320,11.701277269170845,20.444464035462424,NaN,NaN,-28.953152594817166,-28.945090944744706
2002-07-08T09:30:00-04:00,26.2,26.55,25.08,25.38,97348192,103990884.8,40.67110568949826,35.36288241372444,NaN,NaN,-43.448806257809736,-91.12109639950509,0.05423666417569173,-1.2432122580227123,-1.297448922198404,-1015067720,-989360155.2,11.100955833678782,19.358192733576768,NaN,NaN,-27.183648777651705,-28.693456349445707
2002-07-09T09:30:00-04:00,25.25101,25.48,24.59,24.66,91053008,104886044.8,37.84808278897806,34.858041959511475,NaN,NaN,-79.57804702620062,-85.68594828848586,0.040874225033475486,-1.2463561409065598,-1.2872303659400353,-1106120728,-1017793112,10.39634948533049,17.92623259689007,NaN,NaN,-26.70424725096492,-28.40928362109131
2002-07-10T09:30:00-04:00,24.998,25.03,23.83,23.89999,115303376,106420738.4,35.08011563844035,34.768512542314134,NaN,NaN,-108.81899587360265,-76.82079838294342,-0.006410416507536043,-1.2952433865744553,-1.2888329700669192,-1221424104,-1046964542.4,9.715030151743974,16.57361825299601,NaN,NaN,-27.237535317374984,-28.24189100627469
2002-07-11T09:30:00-04:00,23.767,24.89,23.53,24.8,170214320,107282136,40.61847468635513,35.32709239743746,NaN,NaN,-90.94339079942942,-71.49441479663025,0.033475110640411865,-1.2469890817664044,-1.2804641924068163,-1051209784,-1062308372.8,9.36729793895286,15.32028828290994,NaN,NaN,-25.828021489229265,-27.89705250383963
2002-07-12T09:30:00-04:00,25.25,25.526,24.55,24.8,130025632,108902899.2,40.61847468635513,36.051561544044496,NaN,NaN,-52.538828933434495,-75.06561377809535,0.06839351335399213,-1.1949723007143263,-1.2633658140683184,-1051209784,-1089006424,8.778518728455992,14.125026477728351,NaN,NaN,-24.73339922304472,-27.445102035154644
2002-07-15T09:30:00-04:00,24.688,25.64,23.75,25.57001,140525312,109824583.2,45.252772088020414,36.822574134880746,NaN,NaN,-45.63478833826319,-75.50281019418604,0.14735249499585423,-1.0791751953235007,-1.226527690319355,-910684472,-1068129774.4,13.3641757437195,13.308524323877828,NaN,NaN,-22.3544566004088,-26.717866973048096
2002-07-16T09:30:00-04:00,25.252,26.02699,24.89999,25.19,148231376,112854358.4,43.45053858367697,37.69922010872756,NaN,NaN,-12.624787488705715,-62.11215828668706,0.17604866212493597,-1.006466862663185,-1.182515524788121,-1058915848,-1058688798.4,15.434500344369994,12.883878711014587,NaN,NaN,-20.939650147765864,-25.892407426579204
2002-07-17T09:30:00-04:00,26.077,26.44,24.89,25.64999,157983376,115743243.2,46.2414830714005,38.777843645515084,NaN,NaN,25.470463975208474,-35.25426631692484,0.224942357465737,-0.9013375779559496,-1.1262799354216866,-900932472,-994590472,28.012522783100252,13.58679092838567,NaN,NaN,-18.924124057728648,-24.896938373886268
2002-07-18T09:30:00-04:00,25.38901,25.57001,24.52,24.73,113974192,116766146.4,41.79823955557289,39.10681133203922,NaN,NaN,-33.37352831632524,-23.740293820303997,0.1953525950468058,-0.8820891916131792,-1.077441786659985,-1014906664,-987329848,29.29538161505559,14.453393709443308,NaN,NaN,-18.50795369875514,-23.984226277438964
2002-07-19T09:30:00-04:00,24.332,24.71001,23.8,23.99001,124783008,118009137.6,38.586562426977984,39.242274863878315,NaN,NaN,-106.51775113023666,-34.536078259664464,0.12916399742938678,-0.9159867898732514,-1.0451507873026382,-1139689672,-1005025825.6,27.986340392950538,15.288409037204412,NaN,NaN,-19.14012394484451,-23.2922116584969
2002-07-22T09:30:00-04:00,23.855,24.5,23.09,23.39999,150017312,120419212.8,36.1982711989776,39.579054753616944,NaN,NaN,-145.443202155805,-54.49776102317283,0.05278201877080124,-0.9791732638391366,-1.0319552826099379,-1289706984,-1080830328,23.203254394397504,15.936385995927795,NaN,NaN,-20.403207745967737,-22.879496813849876
2002-07-23T09:30:00-04:00,23.453,23.75,22.28,22.39999,150829008,120977007.2,32.523985653383605,39.87630784656472,NaN,NaN,-199.3078406250635,-91.83437165044438,-0.052269170818713295,-1.0972917461333296,-1.0450225753146163,-1440535992,-1157154356.8,19.575584333035266,16.442715885278187,NaN,NaN,-22.667193179202314,-22.84916772318594
2002-07-24T09:30:00-04:00,21.81599,23.66,21.64,23.62,186473872,123463807.2,40.463863114557675,40.29721990311955,NaN,NaN,-155.88012557255507,-128.1044895599971,-0.027987725592565793,-1.0800072323053236,-1.0520195067127578,-1254062120,-1227780286.4,16.936831986762627,16.77628721433743,NaN,NaN,-22.0767868387567,-22.738827596838906
2002-07-25T09:30:00-04:00,23.258,23.39999,21.8,22.25,153921680,123708275.2,35.423135415618674,39.62679318555812,NaN,NaN,-168.26979349341568,-155.08374259541517,-0.08914056171183438,-1.1634452088525506,-1.0743046471407163,-1407983800,-1306395713.6,14.580742305584735,16.98196328836699,NaN,NaN,-23.271529646286094,-22.814927889617074
2002-07-26T09:30:00-04:00,22.569,22.84399,22.00999,22.67,96037376,122441093.6,37.974144833235485,39.434153124396495,NaN,NaN,-142.88928626324576,-162.358049622017,-0.08619942991665352,-1.1820539345365333,-1.0958545046198798,-1311946424,-1340847064,13.682471384689165,17.166357256296305,NaN,NaN,-23.39827323122438,-22.898262938418117
2002-07-29T09:30:00-04:00,23.27699,24.12,23.08,23.83,96715872,122883887.2,44.495753035412044,39.90898671342749,NaN,NaN,-51.59689180846347,-143.5887875525487,0.004181917434312066,-1.0906271078269896,-1.0948090252613016,-1215230552,-1325951777.6,16.089446411217637,17.573007036716813,NaN,NaN,-21.342121889889146,-22.67595707434255
2002-07-30T09:30:00-04:00,23.731,24.69,23.59,24.31,117358368,125512685.6,46.979971753443934,40.75897643592775,NaN,NaN,-7.787041844929626,-105.28462779652193,0.10122561548917841,-0.9682770058998287,-1.069502621389007,-1097872184,-1257419016,26.275758083781426,18.755916174719488,NaN,NaN,-18.882490115957253,-22.134033223144648
2002-07-31T09:30:00-04:00,24.00301,24.19,23.36,23.85001,93840128,124624141.6,44.90573986123525,41.065209662704895,NaN,NaN,-38.92753863097041,-81.894110408205,0.1371392754194185,-0.898078527114734,-1.0352178025341525,-1191712312,-1244949054.4,27.98873835362427,20.086019061481732,NaN,NaN,-17.511694310190386,-21.47369909272261
2002-08-01T09:30:00-04:00,23.74001,23.89999,22.66,22.73,85188496,123829750.4,40.24634808901225,41.038629191466114,NaN,NaN,-84.79629741516482,-65.19941119255482,0.09042165571869143,-0.9221907328857881,-1.0126123886044796,-1276900808,-1218732456,31.58766006107504,21.715243442383095,NaN,NaN,-17.803566138295267,-20.949394384947276
2002-08-02T09:30:00-04:00,22.78,22.84,21.82001,22.25,86720688,125327229.6,38.40708951048661,40.549651864499424,NaN,NaN,-127.9013390586244,-62.20182175163054,0.03499921937723971,-0.9688633643829299,-1.0038625837601696,-1363621496,-1229067470.4,30.931377789672467,22.970043588522593,NaN,NaN,-18.614729916328105,-20.61587088943025
2002-08-05T09:30:00-04:00,22.11,22.32401,21.3,21.44,84911120,124705376,35.461940499973764,39.97903771566347,NaN,NaN,-152.42220226958855,-82.36688384385556,-0.04411349106044704,-1.0590044475857283,-1.0148909565252813,-1448532616,-1275727883.2,28.093455187975394,23.87425464878012,NaN,NaN,-20.22437505217727,-20.559942912679826
2002-08-06T09:30:00-04:00,21.804,23.00999,21.78999,22.5,114818496,125893650.4,41.756284533091794,39.65866639149857,NaN,NaN,-89.71619506004157,-98.75271448687796,-0.014488012427676944,-1.0330009720598774,-1.0185129596322005,-1333714120,-1322896270.4,25.542238372655035,23.697805762319746,NaN,NaN,-19.62237086416786,-20.42600404860669
2002-08-07T09:30:00-04:00,23.201,23.37,21.96001,22.8,126214368,126439200,43.43764987934329,39.775767128910736,NaN,NaN,-63.57964664750234,-103.68313609018435,0.03327103657147168,-0.976924163917861,-1.0101952004893326,-1207499752,-1326053758.4,25.376110450250238,23.417857821976508,NaN,NaN,-18.622775119672283,-20.168399915901773
2002-08-08T09:30:00-04:00,22.757,23.60001,22.3,23.57001,111674000,123512184,47.61748508738929,40.42083303322583,NaN,NaN,-29.252071930266204,-92.57429099320461,0.11981135665256593,-0.8604310046736252,-0.9802423613261911,-1095825752,-1289838747.2,30.925355900546975,23.62778750109054,NaN,NaN,-16.490871821334906,-19.643038759535077
2002-08-09T09:30:00-04:00,23.207,23.717,22.88,23.33,93577808,121689792.8,46.46489642702521,41.1541634066578,NaN,NaN,-13.916002123532378,-69.77722360618621,0.16139224842372668,-0.7785020507965328,-0.9398942992202595,-1189403560,-1254995160,35.86684221251542,24.53232948809896,NaN,NaN,-15.085066647092054,-18.99189988632893
2002-08-12T09:30:00-04:00,23.05,23.48,22.89999,23.39999,62889504,117808002.4,46.8687733793664,42.178791101370855,NaN,NaN,-12.23625560672581,-41.74003427361366,0.19202933268629996,-0.6998576333623845,-0.8918869660486844,-1126514056,-1190591448,43.86105832443398,26.2670062017703,NaN,NaN,-13.823833626904076,-18.253604706411092
2002-08-13T09:30:00-04:00,23.23,23.87,22.55,22.60001,88333680,114813117.6,42.88626693739092,42.35181994585895,NaN,NaN,-26.89149139951614,-29.175093541508573,0.15824387715266564,-0.6940821196078524,-0.852325996760518,-1214847736,-1166818171.2,46.51148987475151,28.379481765198076,NaN,NaN,-13.845610466830866,-17.62389124361392
2002-08-14T09:30:00-04:00,22.67,24.2,22.47,24.03999,102656880,112046792.8,50.96336848352597,43.46183659356661,NaN,NaN,43.25393009132512,-7.808378193743081,0.228439055593192,-0.566777177269028,-0.79521623286222,-1112190856,-1147756392,48.6066553303246,30.809904124108066,NaN,NaN,-11.371646306912952,-16.73071339551378
2002-08-15T09:30:00-04:00,24.243,24.55,23.72,24.53,120286688,112362417.6,53.37952389872124,44.56222081252987,NaN,NaN,134.23191182052813,24.888418556415786,0.29898200881017367,-0.4214887218495029,-0.7204707306596766,-991904168,-1126972075.2,50.86656934284274,33.465911121119035,NaN,NaN,-8.579743221519847,-15.56628908494322
2002-08-16T09:30:00-04:00,24.13,25,23.731,24.7,95853008,110915917.6,54.22225170741466,45.25697071767292,NaN,NaN,153.08145988446063,58.28791095801439,0.34494123127096765,-0.28929419157096703,-0.6342354228419347,-896051160,-1068301595.2,56.6600788115568,36.36381343542897,NaN,NaN,-6.05720828630381,-14.207848970851876
2002-08-19T09:30:00-04:00,24.77,25.59,24.67999,25.3,76021504,107216127.2,57.16527447338872,45.98449234052612,NaN,NaN,198.3677279577444,100.40870767090843,0.39973799377547903,-0.13456293062258595,-0.534300924398065,-820029656,-1007004715.2,61.73644931339448,38.896719951829915,NaN,NaN,-3.0296040919681575,-12.610956845297059
2002-08-20T09:30:00-04:00,25.188,25.42999,24.85001,25.19,89981808,104173767.2,56.44876855015804,46.80899438973489,NaN,NaN,160.95474461891274,137.97795487459422,0.41097979327290746,-0.020576182806930632,-0.4315559760798381,-910011464,-946037460.8,66.00188138938458,41.611944454384215,NaN,NaN,-0.7356783060845845,-10.91448848255242
2002-08-21T09:30:00-04:00,25.396,25.85001,25,25.75,101371120,99918629.6,59.249071546731365,48.16633177957197,NaN,NaN,161.17849318675746,161.5628674936807,0.43615400072780186,0.11363652482991426,-0.3225174758978876,-808640344,-885327358.4,69.63216537165361,44.32940911942554,NaN,NaN,2.049394271665679,-9.062505231949835
2002-08-22T09:30:00-04:00,25.748,26.21001,25.42,26.16,80359312,96240511.2,61.215349806501436,49.79549322928731,NaN,NaN,163.2486228911224,167.36620970779956,0.4581743652564582,0.2502004806726852,-0.20797388458377303,-728281032,-832602731.2,72.38954471858185,47.29070675720478,NaN,NaN,4.986248757799455,-7.055540376271365
2002-08-23T09:30:00-04:00,25.802,25.81,24.95,25.14999,75212880,95199286.4,54.26858681028832,51.13882510859549,NaN,NaN,103.87201591717053,157.52432091434153,0.385397625388237,0.27377314715152323,-0.11162447823671377,-803493912,-814091281.6,73.30599319613779,50.52017375778781,NaN,NaN,5.619884329402959,-5.24476541831789
2002-08-26T09:30:00-04:00,25.3,25.39,24.61,25.25,83341808,94530583.2,54.81537019880974,52.07161694186106,NaN,NaN,78.49320110187881,133.54941554316838,0.32697945801560063,0.297099844282787,-0.0298796137328136,-720152104,-794115771.2,74.29740392981954,54.00268558329957,NaN,NaN,6.292154776279088,-3.5966339619468934
2002-08-27T09:30:00-04:00,25.431,25.51801,24.14999,24.37,92351808,93280255.2,49.23689766493161,52.48584892654594,NaN,NaN,49.43815136524222,111.2460968924343,0.21733614153263292,0.24179056318297754,0.02445442165034463,-812503912,-774614260.8,75.2633133997547,57.56605722254989,NaN,NaN,5.253330686843989,-2.3323532978339103
2002-08-28T09:30:00-04:00,24.026,24.093,23.39,23.48,115697120,94373104.8,44.32393692454076,52.25059548634248,NaN,NaN,-14.83721025247698,76.04295620458738,0.08020004814307721,0.12470448182919114,0.04450443368611393,-928201032,-798526398.4,71.70500380544688,60.47888921575702,NaN,NaN,2.8293245471256108,-1.5949707485539788
2002-08-29T09:30:00-04:00,23.2,24.22,23.02,23.78999,97065120,94966936,46.332593014578556,52.24114524259629,NaN,NaN,-15.641367266353052,40.26495817309228,0.009418681706236914,0.056277785818910075,0.04685910411267316,-831135912,-819097374.4,68.69606444902529,62.82383366122201,NaN,NaN,1.4053593374368318,-1.1663521648410058
2002-08-30T09:30:00-04:00,23.62,24.007,23.38,23.49001,59501808,93605992,44.653697034776606,52.08292550369701,NaN,NaN,-24.6033401138439,14.569886966889408,-0.055010678671711964,-0.021904244226966796,0.03310643444474517,-890637720,-836526136,66.1628357594154,64.41681776372069,NaN,NaN,-0.2727968300098391,-1.0387014027222676
2002-09-03T09:30:00-04:00,23.06,23.42999,22.34,22.64,81871504,93454011.2,40.20775841714965,51.89160346653692,NaN,NaN,-89.2373296448592,-18.976219182458195,-0.14705748034069333,-0.15071541598112148,-0.003657935640428163,-972509224,-886997560,59.33874760426535,65.33305045868596,NaN,NaN,-3.1056877316878895,-1.3339851640030707
2002-09-04T09:30:00-04:00,22.5,23.02,22.24001,22.73,82711872,91848680,40.87895738966975,51.171288388404335,NaN,NaN,-101.29147779039279,-49.1221450135852,-0.19126469781891842,-0.2427388079140762,-0.051474110095157774,-889797352,-902456248,57.38642559746984,65.96017690633919,NaN,NaN,-5.2295929647022215,-1.8905005641029493
2002-09-05T09:30:00-04:00,22.39999,22.5,21.92999,22.17,92293120,90152617.6,38.019136111728855,50.074117832190595,NaN,NaN,-129.9493322818017,-72.14456941945014,-0.24421512589024907,-0.3567430174579691,-0.11252789156772004,-982090472,-913234136,56.00295561861366,66.32706164032282,NaN,NaN,-7.908356275169946,-2.7501942371125203
2002-09-06T09:30:00-04:00,22.66,23.22,22.60001,22.85001,86010880,88869461.6,43.2141988366485,49.28782834142158,NaN,NaN,-78.91965132857571,-84.80022623189467,-0.22017872305918268,-0.3877512953916984,-0.1675725723325157,-896079592,-926222872,54.303892805366075,66.15876263988063,NaN,NaN,-8.74592669110185,-3.6067274448252817
2002-09-09T09:30:00-04:00,22.677,23.37,22.39,23.08,72684320,87824787.2,44.896450936717976,48.41148380308796,NaN,NaN,-72.42520233374854,-94.3645986758756,-0.17736588727972963,-0.38927993143217776,-0.21191404415244813,-823395272,-912774382.4,55.79916502703978,65.73467090514102,NaN,NaN,-8.964912338316976,-4.3721824296098095
2002-09-10T09:30:00-04:00,23.23,23.67,23.03,23.64999,74622128,88411418.4,48.93407165095565,47.87471973885921,NaN,NaN,-38.6774367108992,-84.25262008908359,-0.10292640825205335,-0.3405720544675148,-0.23764564621546147,-748773144,-868027166.4,60.43788115637015,65.33724231706854,NaN,NaN,-7.989154013479852,-4.888892655876958
2002-09-11T09:30:00-04:00,24.12,24.35001,23.42,23.45,73908496,87690159.2,47.61574728118338,47.043768005605784,NaN,NaN,-21.783595938027595,-68.35104371861055,-0.06146993712437221,-0.3144830676209267,-0.2530131304965545,-822681640,-854604024,61.73517950027958,64.77317189768469,NaN,NaN,-7.542321756193665,-5.267953955922202
2002-09-12T09:30:00-04:00,23.237,23.26401,22.71001,22.81,70772496,86095940,43.5703740868081,45.78341259705626,NaN,NaN,-75.67655300377169,-57.49648786300454,-0.07080010091705774,-0.3415132566428767,-0.27071315572581894,-893454136,-836876756.8,63.44022552022554,64.13393481208782,NaN,NaN,-8.30984370113728,-5.70250963381007
2002-09-13T09:30:00-04:00,22.60001,23.08,22.52,22.99001,79653632,84064287.2,44.986108204014236,45.12037841089383,NaN,NaN,-72.96065521706953,-56.304688640703304,-0.05898075071533504,-0.34443909411998774,-0.2854583434046527,-813800504,-820420939.2,64.99932972804199,63.54060170722382,NaN,NaN,-8.556129349199333,-6.110169593151394
2002-09-16T09:30:00-04:00,22.86,23.005,22.37,22.66,58853600,82214316.8,42.862999468278694,44.26663764442732,NaN,NaN,-78.66695211359196,-57.55303859667199,-0.06693874058303761,-0.3691317691334497,-0.3021930285504121,-872654104,-830272705.6,63.260006909673635,62.752216205784826,NaN,NaN,-9.356573797763254,-6.57394162238166
2002-09-17T09:30:00-04:00,23.05,23.21001,22.17999,22.17999,89176320,82872057.6,39.912404645327754,43.60060242874133,NaN,NaN,-84.52091030416526,-66.7217333153252,-0.09629569571923513,-0.422562648199456,-0.32626695248022086,-961830424,-872884161.6,56.2489615458765,61.39404821622211,NaN,NaN,-10.889828002039671,-7.190496819475661
2002-09-18T09:30:00-04:00,22.00999,22.55,21.78,21.92999,92396192,82992776.8,38.42866822189695,43.179511807123916,NaN,NaN,-107.45090716518358,-83.8551955607564,-0.12262798939670783,-0.4795519392261056,-0.3569239498293978,-1054226616,-919193156.8,49.79057083522001,59.82873157549161,NaN,NaN,-12.60524330430391,-7.964032031593982
2002-09-19T09:30:00-04:00,21.7,22.13,21.55,21.58,86253120,82236876.8,36.38917892301276,42.46926794344064,NaN,NaN,-123.09414852817382,-93.33871466563681,-0.15178573573485582,-0.5466561194979676,-0.39487038376311173,-1140479736,-968598276.8,43.987824648067324,58.06385730399462,NaN,NaN,-14.65725814592409,-8.920207190783998
2002-09-20T09:30:00-04:00,21.83099,21.89999,21.48,21.67,78120192,82124920.8,37.31054485379799,41.94475707337074,NaN,NaN,-124.43914684521319,-103.63441299126555,-0.15276083952069636,-0.5858214331639822,-0.4330605936432858,-1062359544,-1018310084.8,39.05560788627909,56.127626741627736,NaN,NaN,-16.132812372388685,-9.950579359584667
2002-09-23T09:30:00-04:00,21.45,21.52,20.81,21.02,72763312,82002442.4,33.5328478872711,41.467977749807986,NaN,NaN,-168.9473451732681,-121.69049160320078,-0.1828973907629895,-0.6616823320970227,-0.47878494133403315,-1135122856,-1070803835.2,34.638829539727965,54.36334687987506,NaN,NaN,-18.54213661215969,-11.1779446813811
2002-09-24T09:30:00-04:00,20.687,21.45,20.64999,21.03,91502128,82410458.4,33.644160915635865,40.95120657309128,NaN,NaN,-162.4688065481689,-137.28007085200153,-0.18719544623591622,-0.7127792491289284,-0.5255838028930122,-1043620728,-1087161896,33.372294610399734,52.64805180937005,NaN,NaN,-20.50347653680893,-12.510163517870788
2002-09-25T09:30:00-04:00,21.35001,22.03999,21.10001,21.87,98052368,82695486.4,42.3742641738136,41.26228714895448,NaN,NaN,-92.21787214066045,-134.23346384709689,-0.1216778047089786,-0.6776810587792355,-0.5560032540702569,-945568360,-1065430244.8,36.684444451474455,51.268158154574394,NaN,NaN,-19.817821342063453,-13.554114635612597
2002-09-26T09:30:00-04:00,22.16,22.33,21.37,21.60001,104434320,82132346.4,40.52859093112958,41.070458012845975,NaN,NaN,-73.25211743088765,-124.26505762763966,-0.08639522022009916,-0.6639972793453808,-0.5776020591252816,-1050002680,-1047334833.6,39.38644414586309,50.20262610746704,NaN,NaN,-19.758862670756578,-14.440507212061737
2002-09-27T09:30:00-04:00,21.55,22.21001,21.31,21.31,92254624,81891821.6,38.58450457447651,40.6196047012573,NaN,NaN,-78.94629852603094,-115.1664879638032,-0.07299367255968836,-0.668844149824892,-0.5958504772652037,-1142257304,-1063314385.6,37.850323603902446,48.92056600581437,NaN,NaN,-20.2549728219302,-15.27114515632866
2002-09-30T09:30:00-04:00,21.07001,21.24001,20.49001,20.72,91527008,83493081.6,34.91513469874893,39.61825206181396,NaN,NaN,-140.22425882148906,-109.4218706934474,-0.09298755977439876,-0.7120849269832021,-0.6190973672088034,-1233784312,-1083046676.8,35.98400566972677,47.17386061391129,NaN,NaN,-21.769319654493486,-16.199455798923637
2002-10-01T09:30:00-04:00,20.91,21.99001,20.47,21.98,102096192,84504316,46.59557078817151,39.545382312313116,NaN,NaN,-68.84752154368745,-90.69761369255113,-0.014590330464766432,-0.6373352802897614,-0.622744949824995,-1131688120,-1100660155.2,34.355588319316055,45.218175529556746,NaN,NaN,-19.380950031700415,-16.653954975034605
2002-10-02T09:30:00-04:00,21.50999,21.97,20.97,21.25,94883504,85112897.6,41.903482618927924,39.42631863603596,NaN,NaN,-69.74402813780833,-86.2028448919807,-0.005597064458751522,-0.6297412803984344,-0.6241442159396828,-1226571624,-1156860808,29.73216498114374,42.81045691962233,NaN,NaN,-18.89387150225431,-16.973943050351707
2002-10-03T09:30:00-04:00,21.06,21.39999,20.67999,20.74001,74364624,84216472.8,38.95241348595633,38.99534044188897,NaN,NaN,-100.58402851213813,-91.6692271082308,-0.026523018879345606,-0.6572979895388649,-0.6307749706595193,-1300936248,-1207047521.6,26.325183598409154,40.048017910362844,NaN,NaN,-19.460030589511405,-17.329098413088808
2002-10-04T09:30:00-04:00,20.94,21.02,20.11011,20.35001,81850368,84008447.2,36.81707755926694,38.56348887695956,NaN,NaN,-127.3495339746234,-101.34987419794929,-0.057386855115928226,-0.7025085395544295,-0.6451216844385013,-1382786616,-1255153384,23.540631969367936,37.210919700341016,NaN,NaN,-20.609174665901755,-17.79768073491923
2002-10-07T09:30:00-04:00,20.25999,20.59,19.85001,20.16,79871312,84367796.8,35.787728887762384,38.2688691799906,NaN,NaN,-141.66727892431066,-101.6384782185136,-0.07996793901254384,-0.7450816082041811,-0.6651136691916373,-1462657928,-1300928107.2,21.238548320041588,34.710175898495656,NaN,NaN,-21.85380899363625,-18.37712762902166
2002-10-08T09:30:00-04:00,20.28,20.61,19.75999,20.2,94102624,85341821.6,36.192170085007064,38.109119313069904,NaN,NaN,-135.03259069492938,-114.87549204876197,-0.08131285251115217,-0.7667547348305774,-0.6854418823194253,-1368555304,-1348301544,19.151209115180365,32.52165006134997,NaN,NaN,-22.738845856064412,-19.00023023288491
2002-10-09T09:30:00-04:00,19.94,20.53,19.84,20.06,103305632,86811678.4,35.35287473154008,38.035097585107565,NaN,NaN,-128.42730926534506,-126.61214827426934,-0.08057869427772335,-0.7861652501665795,-0.7055865558888561,-1471860936,-1397359406.4,17.259498168448303,30.61248388423433,NaN,NaN,-23.710058273287217,-19.673062810085238
2002-10-10T09:30:00-04:00,20.10001,21.21001,19.91,21.08,109583008,88752204,45.304782989344446,38.60611459478945,NaN,NaN,-63.64506554943858,-119.2243556817294,-0.004367754776559041,-0.7110462493595548,-0.7066784945829958,-1362277928,-1409627742.4,16.812252436064654,29.023672780647587,NaN,NaN,-21.556786118867738,-19.942166139911308
2002-10-11T09:30:00-04:00,21.55,22.38,21.42,22.22,124799504,91009497.6,53.854900707489534,40.057689796233625,NaN,NaN,74.53214685271396,-78.84801951626194,0.12282354026848508,-0.5531490692473895,-0.6759726095158746,-1237478424,-1380566104,21.97043092435274,28.118787165263647,NaN,NaN,-16.702492921651643,-19.479355680159927
2002-10-14T09:30:00-04:00,21.87,22.5,21.78,22.48,78913376,92012486.4,55.561135818223086,41.62318800356129,NaN,NaN,106.77682240356037,-29.159199250687738,0.21886127280244572,-0.4023960185128175,-0.6212572913152632,-1158565048,-1319747528,31.53772577301079,27.987746534021575,NaN,NaN,-12.253771586035986,-18.447129380999364
2002-10-15T09:30:00-04:00,23.44,23.634,23.17999,23.56,118106128,93458976.8,61.868305133649024,43.01561950069239,NaN,NaN,220.34340778412488,41.91600044512312,0.3421697544836858,-0.1935450982106559,-0.5357148526943417,-1040458920,-1254128251.2,40.07497654035762,28.22992739751323,NaN,NaN,-6.114388582881585,-16.68530926698254
2002-10-16T09:30:00-04:00,22.718,23.16,22.07001,22.78,97493632,93713848.8,55.71766933385685,44.10055367231577,NaN,NaN,129.9206794297328,93.58559818413869,0.35662625025575306,-0.08993203987465037,-0.44655829013040343,-1137952552,-1187346574.4,47.280252243513466,28.793770833059686,NaN,NaN,-3.047447250237504,-14.737043264590392
2002-10-17T09:30:00-04:00,23.60001,23.81,22.58,23.55,95857184,94194052,59.95048944281807,45.62669544862588,NaN,NaN,167.5070410606673,139.81601950615988,0.40020315223172437,0.05369565015925204,-0.34650750207247233,-1042095368,-1123310062.4,53.10317303262804,29.883260077968657,NaN,NaN,0.9753338702268682,-12.492417959616498
2002-10-18T09:30:00-04:00,23.28,23.85001,22.92999,23.81,85208000,94548442.4,61.29580656278396,47.51102915319981,NaN,NaN,157.73904717904065,156.45739957142519,0.4262886349675703,0.18635329163699055,-0.23993534333057975,-956887368,-1067191851.2,57.530167147423505,31.42227161208985,NaN,NaN,4.597376735799176,-10.051018717414259
2002-10-21T09:30:00-04:00,23.52,24.45,23.3,24.28999,85705312,95195542.4,63.71880201808976,48.73411709819397,NaN,NaN,162.9481651829087,167.69166812729486,0.45311104071441033,0.32645345756243316,-0.12665758315197717,-871182056,-1009715252.8,61.5351565919822,33.36366934585171,NaN,NaN,8.366851334313044,-7.419894424310359
2002-10-22T09:30:00-04:00,23.73801,24.34,23.64999,24.14,90275184,95134195.2,62.404114315083845,50.19844793363368,NaN,NaN,138.84273577617407,151.3915337257047,0.4377526771282156,0.4205332632582923,-0.01721941386992326,-961457240,-993914916.8,62.57984401382883,35.70993213390065,NaN,NaN,10.986969306405637,-4.790342462779503
2002-10-23T09:30:00-04:00,23.85001,24.63,23.67,24.60001,88296880,94646420.8,64.80269359975077,52.044896513190416,NaN,NaN,130.90430632815176,151.5882591053885,0.4346923833283904,0.5261460652905647,0.09145368196217435,-873160360,-940956478.4,65.9207619252415,38.538187728674394,NaN,NaN,13.929550002143742,-2.1160721106476106
2002-10-24T09:30:00-04:00,24.67999,24.86,23.92,23.98,88944000,93871904.8,59.31031931441725,53.6515566385583,NaN,NaN,110.7868155539778,140.24421400405058,0.3695856019281542,0.5534356843723671,0.18385008244421291,-962104360,-924958276.8,66.88267567074672,41.63404799305859,NaN,NaN,14.776007788155358,0.29708216060995607
2002-10-25T09:30:00-04:00,23.99001,24.75101,23.99001,24.62,71738688,92846108,62.81391134996055,55.581998243001024,NaN,NaN,106.10208395735144,129.91682135971274,0.34857082344567225,0.6195636117513033,0.270992788305631,-890365672,-911653937.6,67.69919492134152,44.952665607437154,NaN,NaN,16.588784257941878,2.624468174514516
2002-10-28T09:30:00-05:00,25,25.03999,24.17,24.49001,90285680,92784041.6,61.652740072028095,57.4006103849311,NaN,NaN,99.41482816439066,117.21015395600912,0.30636026122309595,0.653943114834501,0.347582853611405,-980651352,-933547796.8,64.86496505148222,48.21793388860158,NaN,NaN,17.708059070064873,4.779266873878853
2002-10-29T09:30:00-05:00,24.31,24.47,23.37,23.92,90364128,92197438.4,56.70277666624658,58.925603380267276,NaN,NaN,63.10028404878573,102.06166361053145,0.2242980343654677,0.6279553965682396,0.40365736220277193,-1071015480,-955459444.8,62.064487193949624,51.418290247565956,NaN,NaN,17.17991941684697,6.5507886657314405
2002-10-30T09:30:00-05:00,24.06799,24.78999,23.85001,24.56,103512000,92628863.2,60.53414016146603,60.01341460684739,NaN,NaN,77.80650197353296,91.4421027396077,0.19826818450776768,0.6514925928374815,0.45322440832971383,-967503480,-974328068.8,59.67521399844501,54.47993035916455,NaN,NaN,17.88468807506908,8.169917152779675
2002-10-31T09:30:00-05:00,24.66,25.03999,24.36,24.55,81518624,92986563.2,60.44413815114047,60.484074424251034,NaN,NaN,82.26834509636883,85.73840864808592,0.16678949598841925,0.6617112783152379,0.49492178232681866,-1049022104,-991711617.6,57.479778804352996,57.01631235059314,NaN,NaN,18.423586420730448,9.634727048201214
2002-11-01T09:30:00-05:00,24.37801,25.39999,24.14,25.25,86668816,93227485.6,64.43079383279976,61.11762142529222,NaN,NaN,90.21175030026126,82.5603419166679,0.17847614013688073,0.7180169574979196,0.5395408173610389,-962353288,-1006109140.8,55.6535567187344,58.73887170385911,NaN,NaN,20.08803023541816,11.12805607494649
2002-11-04T09:30:00-05:00,26.05,26.82001,25.8,25.89999,110564816,94762160.8,67.68738541421882,61.5332700167615,NaN,NaN,148.01823591317515,92.28102346642478,0.2130070407596386,0.8057996183105871,0.5927925775509485,-851788472,-980336564.8,58.21293842190227,60.03444040968373,NaN,NaN,22.533424172580343,12.75739437460847
2002-11-05T09:30:00-05:00,25.71001,26.17,25.56,26.10001,79619184,94037988.8,68.63893485618,62.45621755407029,NaN,NaN,131.97512702155456,106.05599206097857,0.2308445915826185,0.8813483170292216,0.6505037254466031,-772169288,-920567326.4,63.47727890195167,61.19137088528646,NaN,NaN,24.821137529072683,14.480786253817643
2002-11-06T09:30:00-05:00,26.28999,26.61,25.64,26.47,116768000,94711107.2,70.37671080947621,63.20094765168873,NaN,NaN,148.99343323921406,120.29337831411479,0.2476049470655438,0.9600099092785328,0.712404962212989,-655401288,-858146888,68.00991914988163,62.256138465090295,NaN,NaN,27.270890662708524,16.30794402651634
2002-11-07T09:30:00-05:00,25.99001,26.10001,25.31,25.53999,82741376,93369025.6,61.197249465726216,63.193907859041744,NaN,NaN,105.28990558282108,124.89769041140524,0.17928422712581704,0.9365102461202603,0.7572260189944433,-738142664,-795971000,71.76833233031724,63.27315026386841,NaN,NaN,26.631986106232368,17.782807180761484
2002-11-08T09:30:00-05:00,25.49001,25.87,24.96001,25.07001,77013632,90979732,57.14110592667765,62.724072423940875,NaN,NaN,72.22250338003464,121.29984102735992,0.09016723730633858,0.8699350656273666,0.779767828321028,-815156296,-766531601.6,73.36402552351751,64.11806947326379,NaN,NaN,24.827598696786563,18.789205968765067
2002-11-11T09:30:00-05:00,24.95,25.02,24.14999,24.31,74621504,90765138.4,51.228027252605735,61.925780490906725,NaN,NaN,-1.9777701669859094,91.3006398113277,-0.02602733812770497,0.7472336556613968,0.7732609937891017,-889777800,-774129467.2,72.2293442410498,64.80731948949385,NaN,NaN,21.35100821271346,19.155177717900553
2002-11-12T09:30:00-05:00,24.39999,25.39999,24.39999,24.92999,88867632,89303213.6,55.29242490541377,61.24647558416836,NaN,NaN,30.284048897445736,70.96242418650594,-0.06497481036150854,0.6920424808372161,0.7570172911987246,-800910168,-779877643.2,71.33049039540803,65.19372866593433,NaN,NaN,19.68956352714505,19.231518547792625
2002-11-13T09:30:00-05:00,24.7,25.45,24.493,25.23,119372624,90397163.2,57.15314295150111,61.09239155824577,NaN,NaN,35.69650559779368,48.303038658221865,-0.07373588931484654,0.6648474295551665,0.738583318870013,-681537544,-785104894.4,70.47163948297919,65.45008322395093,NaN,NaN,18.90527552934779,19.184912402300505
2002-11-14T09:30:00-05:00,25.58,26.42,25.52,26.10001,86195872,89914097.6,62.081717296009536,61.04009198296355,NaN,NaN,117.61391179838274,50.7678399013342,-0.026573324148821853,0.7053666636839857,0.7319399878328076,-595341672,-756544696,72.42520254529754,65.78765519709064,NaN,NaN,19.795836182449538,19.27218722803608
2002-11-15T09:30:00-05:00,25.90199,26.45,25.75,26.44,69316128,89119504,63.83255831858472,61.19579328628903,NaN,NaN,121.62150781024917,60.6476407873771,0.01940468593607725,0.7561958452529041,0.7367911593168268,-526025544,-698718545.6,75.90156243959598,66.57598358195592,NaN,NaN,21.071714243028364,19.52926251589212
2002-11-18T09:30:00-05:00,26.715,26.77,25.99001,26.05,76934816,88680979.2,60.3880127201298,61.45902443299498,NaN,NaN,111.02968600790066,83.24913202235442,0.015599512966389062,0.7562905505248132,0.7406910375584241,-602960360,-641355057.6,78.76193903461478,67.768658713432,NaN,NaN,21.074140325457886,19.74995934583009
2002-11-19T09:30:00-05:00,25.8,26.05,25.3,25.64999,88217872,88578113.6,56.991075908591014,61.20594841493248,NaN,NaN,47.702137209665416,86.73274968479834,-0.019883690486887096,0.7158364244498152,0.7357201149367023,-691178232,-619408670.4,79.75214496416004,69.20272521098308,NaN,NaN,20.043619300921776,19.791910767986042
2002-11-20T09:30:00-05:00,25.56,26.75,25.53999,26.74001,75625504,87944544.8,63.084889976434,61.394573545310585,NaN,NaN,100.70823012683293,99.7350945906062,0.021773570987302704,0.7629370786708307,0.741163507683528,-615552728,-606211707.2,80.34557119369744,70.83599609593624,NaN,NaN,21.073589928146376,19.97500779086609
2002-11-21T09:30:00-05:00,26.92999,29.7,26.75,27.73,105595376,88777113.6,67.57803991999026,61.619376837252766,NaN,NaN,217.90959707783426,119.7942316464965,0.10316393165273852,0.8701184222494511,0.7669544905967126,-509957352,-589134843.2,81.1167980605267,72.65479904892142,NaN,NaN,23.486086526183865,20.47659046734006
2002-11-22T09:30:00-05:00,27.37,27.94,27.32001,27.72,73821632,88881260.8,67.48868230490214,61.605183758015855,NaN,NaN,162.05276775758955,127.88048363596458,0.14113945482674606,0.9433788091301452,0.8022393543033991,-583778984,-600685531.2,78.86267488702806,74.12978022500182,NaN,NaN,25.330005806224147,21.169935515752073
2002-11-25T09:30:00-05:00,27.75999,28.205,27.53999,27.99001,72711008,88002527.2,68.69244174958534,61.60900567897338,NaN,NaN,158.45258949432903,137.36506433325025,0.16746055794839387,1.0115650517388914,0.8441044937904976,-511067976,-582307054.4,79.82340428698409,75.29736060964699,NaN,NaN,27.206642778748197,22.032322267608663
2002-11-26T09:30:00-05:00,27.78,27.92999,26.89999,27.05,80053632,87487002.4,60.31912573371089,60.89060674499014,NaN,NaN,103.57519252581777,148.53967539648073,0.10749477458766032,0.978472962025073,0.8709781874374126,-591121608,-562295729.6,80.8443417579613,76.2141050816527,NaN,NaN,26.223192045456038,22.631017950158288
2002-11-27T09:30:00-05:00,27.53,28.2,27.487,27.91,73686816,85995743.2,64.57377763133366,61.13178732824781,NaN,NaN,132.70425626402445,154.93888062391903,0.11121697860026791,1.0099994106877475,0.8987824320874795,-517434792,-542672142.4,81.81603053614998,76.93179781064075,NaN,NaN,26.750917343459847,23.219575006344225
2002-11-29T09:30:00-05:00,28.21001,28.28999,27.22,27.72,34652096,83652416.8,62.96743337231827,61.547953574364996,NaN,NaN,109.47705776536945,133.25237276142605,0.08740042217249011,1.0080329598030922,0.920632537630602,-552086888,-551098049.6,79.94093969898586,77.40157739460277,NaN,NaN,26.673344783328247,23.712970688770515
2002-12-02T09:30:00-05:00,28.42,28.78999,27.57001,28,85998624,83618907.2,64.37393239000218,62.486946798464736,NaN,NaN,117.08607352761554,124.25903391543125,0.07736670621094155,1.017340920394279,0.9399742141833374,-466088264,-527559905.6,81.23477197200192,78.04482223252793,NaN,NaN,27.030791673274674,24.186945115128253
2002-12-03T09:30:00-05:00,27.55,27.58,26.92999,27.17,76699120,81925622.4,57.412954402084935,62.63841319108411,NaN,NaN,49.0548099712311,102.37947801081167,0.00548385039553223,0.9468290271777526,0.9413451767822204,-542787384,-533903787.2,79.74190355094501,78.64563745792341,NaN,NaN,25.168797142939177,24.327209690529813
2002-12-04T09:30:00-05:00,26.56,26.95,26.21001,26.57001,130339872,84461656.8,52.95516876676226,62.338557892174194,NaN,NaN,3.1625964859536557,82.29695880283883,-0.08673042793031083,0.8329321418693318,0.9196625697996427,-673127256,-550304916.8,75.86041631534553,79.03055008880673,NaN,NaN,22.182606596847386,24.020837820003752
2002-12-05T09:30:00-05:00,26.95,27,26.13,26.2,85192496,82882881.6,50.35838827646461,61.50117724792098,NaN,NaN,-6.784312257316864,54.39924509857057,-0.17197956064007225,0.7046881189995524,0.8766676796396247,-758319752,-598481908.8,65.73811190720751,78.55290075751459,NaN,NaN,18.909474940513544,23.290643122933723
2002-12-06T09:30:00-05:00,25.81,26.72,25.74001,26.47,81765008,82834063.2,52.200374440337804,60.67030697090335,NaN,NaN,-18.93462849105503,28.716907847285672,-0.2071582553842808,0.6177198604092737,0.8248781157935545,-676554744,-623375480,61.19442656100658,77.50239105190106,NaN,NaN,16.749022755412742,22.356125927573583
2002-12-09T09:30:00-05:00,26.22,26.55,25.2,25.22,75950496,82780906.4,44.05095373879283,59.50337418652214,NaN,NaN,-68.15477016955234,-8.331260892147897,-0.30564033776375243,0.442827693588864,0.7484680313526164,-752505240,-680658875.2,52.245584484364564,75.60836572688318,NaN,NaN,12.095730635192952,20.890355171519207
2002-12-10T09:30:00-05:00,25.42,25.95,25.35001,25.60001,69645504,82532106.4,46.7715651287077,58.773409130816184,NaN,NaN,-77.89284814304331,-33.72079251500278,-0.33391711727645446,0.33107163475704837,0.6649887520335028,-682859736,-708673345.6,48.50947257310405,73.37674627037917,NaN,NaN,9.137329266284548,19.211351470771397
2002-12-11T09:30:00-05:00,25.44,26.07001,25.32001,25.72,64276704,81302560,47.63738953784841,57.67001624234579,NaN,NaN,-78.42989337160277,-50.039290486514076,-0.3325410618388912,0.2493124247348888,0.58185348657378,-618583032,-697764500.8,50.00862702465703,71.2098216868763,NaN,NaN,7.0150536346446035,17.46902320846757
2002-12-12T09:30:00-05:00,26,26.17,25.56,25.86,62382400,78453048.8,48.68617860799136,56.320597577203,NaN,NaN,-71.65669902269411,-63.01376783958951,-0.31061639922617623,0.19358298754105974,0.504199386767236,-556200632,-657340676.8,55.21241934862517,69.35950892174047,NaN,NaN,5.572801412979932,15.769562951969334
2002-12-13T09:30:00-05:00,25.52,25.57001,25.00999,25.03999,72695632,77778036.8,43.2250973397489,54.58748436540634,NaN,NaN,-117.96461240626915,-82.81976462263233,-0.3375192326082151,0.08230034600696712,0.4198195786151822,-628896264,-647808980.8,56.365791512617754,67.75258868071116,NaN,NaN,2.6322495670761383,13.892803896984592
2002-12-16T09:30:00-05:00,25.22,25.96001,25.07001,25.85001,60359200,77330190.4,49.277587971348545,53.20070909553228,NaN,NaN,-79.94980292980007,-85.17877117468188,-0.2888219223963228,0.058792175619778675,0.3476140980161015,-568537064,-611015345.6,60.58525982125021,66.37843550458732,NaN,NaN,1.9201647979892231,12.182426882842396
2002-12-17T09:30:00-05:00,25.81,26.2,25.66,25.92999,62797104,76623304.8,49.846116982971346,52.452637041908034,NaN,NaN,-54.285301213367035,-80.45726178874664,-0.24122386397735868,0.04608426804440313,0.2873081320217618,-505739960,-575591390.4,64.17697521273277,65.18790932278527,NaN,NaN,1.5160981413671126,10.658665634060213
2002-12-18T09:30:00-05:00,25.55,25.60001,25.05,25.38,67548496,75589836,46.02569637850208,51.12777409527721,NaN,NaN,-96.35430420613658,-84.04214395565339,-0.23646337985517357,-0.00827109279720517,0.2281922870579684,-573288456,-566532475.2,65.0539855798239,63.990620397333416,NaN,NaN,0.03175592948929968,9.140535676264369
2002-12-19T09:30:00-05:00,25.17101,25.78,24.81,25.06,96176496,76617385.6,43.91663707625092,49.767002931272394,NaN,NaN,-96.65217254269356,-89.04123865965327,-0.24358583746876544,-0.07629000977798839,0.16729582769077705,-669464952,-589185339.2,61.03033869126682,62.63986318249634,NaN,NaN,-1.8307677131825308,7.573206620629097
2002-12-20T09:30:00-05:00,25.33,25.45,25.07001,25.32001,65596624,74617448,46.078724910161995,48.4602023969981,NaN,NaN,-85.54889414851546,-82.55809500810254,-0.22021285716726707,-0.10797024376830677,0.11224261339896029,-603868328,-584179752,61.5955926544468,61.23706465981383,NaN,NaN,-2.7740214101066933,6.095031187666842
2002-12-23T09:30:00-05:00,25.17999,25.75999,25.13,25.67,46003808,73226556.8,48.932589668694135,47.85446205889876,NaN,NaN,-62.34494345820428,-79.03712311378338,-0.17270695438854916,-0.10364107958672619,0.06906587480182298,-557864520,-582045243.2,61.8497147196833,59.95905117186657,NaN,NaN,-2.765914377898083,4.829181821157567
2002-12-24T09:30:00-05:00,25.5,25.73,25.32001,25.35001,16773102,70429661.5,46.50891195919816,47.394015144072746,NaN,NaN,-61.457916686849316,-80.47164620847984,-0.154928265577434,-0.12459445716996953,0.030333808407464483,-574637622,-595824775.6,59.12959854367472,58.76399275960437,NaN,NaN,-3.439249074846576,3.6479774074426894
2002-12-26T09:30:00-05:00,25.53,25.91,25.17,25.28,33816800,68117819.9,45.97239659021471,47.08073002362632,NaN,NaN,-58.14652422968766,-72.83009021319006,-0.1404077543575868,-0.14517588453951902,-0.004768130181932215,-608454422,-602857968.8,57.73392581418432,58.19226518153129,NaN,NaN,-4.142967437496306,2.5349852867371183
2002-12-27T09:30:00-05:00,25.17999,25.85001,24.75,24.82001,42540608,66560509.5,42.503113579713826,46.38806853358176,NaN,NaN,-84.37115670600288,-70.37388704585193,-0.15325818978457237,-0.19634086741264767,-0.04308267762807531,-650995030,-599163984.4,58.29077548907246,57.98486153353599,NaN,NaN,-5.725381196784009,1.3549329319483858
2002-12-30T09:30:00-05:00,24.84,24.97,24.36,24.63,57458704,67700839.9,41.12261470688491,46.17890145987405,NaN,NaN,-135.31588249458457,-80.32728471506574,-0.16501176395406333,-0.24934738257065447,-0.08433561861659114,-708453734,-620081065.6,53.95590848621636,58.10702753366826,NaN,NaN,-7.444450908049122,0.0978780976630278
2002-12-31T09:30:00-05:00,24.53999,24.71001,24.28,24.37,46028000,65702308.7,39.244278899735995,45.64123815780464,NaN,NaN,-170.21958032376048,-101.90221208817698,-0.17955220805936348,-0.3087758786907955,-0.129223670631432,-754481734,-659404508.4,46.895324484317925,57.99173124161211,NaN,NaN,-9.43746040735732,-1.2643131173398787
2003-01-02T09:30:00-05:00,24.72,25.55,24.45,25.39999,66305120,65182608.7,49.15270576371083,45.74947503108053,NaN,NaN,-66.71506029143869,-102.95364080909485,-0.11234379019284743,-0.2696534083724913,-0.15730961817964387,-688176614,-682112306.8,43.36624369519112,57.5172752895074,NaN,NaN,-8.366550220258388,-2.2789184177568087
2003-01-03T09:30:00-05:00,25.46001,25.71001,25.28,25.67999,39091296,60620179.9,51.46977769117059,45.94830353702191,NaN,NaN,14.918253584665559,-88.34068524622421,-0.04502650116618995,-0.21359274463738132,-0.16856624347119137,-649085318,-690238486,42.14398344878465,56.58381558237594,NaN,NaN,-6.778788659783837,-2.92175702376067
2003-01-06T09:30:00-05:00,25.71001,26.59,25.2,26.32001,67359312,59728520.7,56.364538144916,46.88683502310528,NaN,NaN,118.37049894738706,-47.79235411554622,0.04190840249885458,-0.11618074034762316,-0.15808914284647774,-581726006,-676384681.2,44.99052004885182,55.771296192106945,NaN,NaN,-3.8631824578266443,-3.0562463714843804
2003-01-07T09:30:00-05:00,26.41,26.92999,26.25,26.64999,88784000,60079470.3,58.67858981642167,47.55833515489621,NaN,NaN,223.03900151105066,23.878622685580826,0.11670042944312767,-0.01221360604256816,-0.12891403548569583,-492942006,-633282335.6,52.77541747902939,55.21345031051975,NaN,NaN,-0.7119524248257278,-2.7213472362474302
2003-01-08T09:30:00-05:00,26.39,26.97,25.84,25.89999,75091008,60036495.9,51.93691290315854,47.70767772062387,NaN,NaN,132.69944132292986,84.4624270149189,0.11077303041047888,0.009552252527402771,-0.10122077788307611,-568033014,-595992591.6,58.276736235251846,54.7920046692711,NaN,NaN,-0.012835968152631022,-2.3344170550910306
2003-01-09T09:30:00-05:00,26.24001,26.98,26.224,26.7,75427872,60325614.3,57.54068069195948,48.530176600156544,NaN,NaN,170.88706365281627,131.98285180376988,0.15322852597313197,0.09031487958333884,-0.06291364638979312,-492605142,-556878297.2,63.12870360543385,54.654484528243245,NaN,NaN,2.441103783609821,-1.6521997924194805
2003-01-10T09:30:00-05:00,26.35001,27.25999,26.22,27.10001,82638000,61243679.1,60.048855545813794,49.68247791941103,NaN,NaN,169.5953662249364,162.91827433182408,0.19790759097120786,0.18447084232421673,-0.01343674864699114,-409967142,-509054662,68.02474795111014,55.15408518966063,NaN,NaN,5.271675483676974,-0.6630747529771298
2003-01-13T09:30:00-05:00,27.33,27.47,26.73,26.94,72945184,61771818.3,58.5586813775403,50.57390338136662,NaN,NaN,162.03758273158846,171.65169108866434,0.20544795627427495,0.24337319669585256,0.0379252404215776,-482912326,-489291926,69.8088735316853,55.740748109463375,NaN,NaN,7.098798692328588,0.4457643106379726
2003-01-14T09:30:00-05:00,26.91,27.32001,26.85001,27.08,47262496,60500161.5,59.50555781772857,51.32911539201194,NaN,NaN,139.04375117712482,154.85264102187915,0.20799290556737848,0.2979163723808007,0.08992346681342223,-435649830,-477833490.8,70.82531086481893,56.3818621198302,NaN,NaN,8.870746750258613,1.6493332305837782
2003-01-15T09:30:00-05:00,27.24001,27.353,26.58,26.74001,55450400,60254721.5,56.15023642827936,52.01778142551774,NaN,NaN,103.02202052723445,148.9171568627401,0.17616751607518646,0.3101328619074053,0.13396534583221884,-491100230,-462446934,72.17976082489815,57.314016568489016,NaN,NaN,9.404696910860459,2.757242327766161
2003-01-16T09:30:00-05:00,26.78999,26.98,26.25,26.44,69707504,60600241.5,53.29453035620745,52.54079098023151,NaN,NaN,64.38279454522618,127.61630304122207,0.1266177123978941,0.29223748632958646,0.16561977393169236,-560807734,-476087452.4,69.1163068067212,58.12704378224165,NaN,NaN,9.033711356095079,3.653880760384578
2003-01-17T09:30:00-05:00,25.90401,25.94,25.27,25.31,77452128,61095423.1,44.180335294176906,52.660592531264584,NaN,NaN,-33.555764868898976,86.98607682245499,0.015299461703573852,0.18474410106115968,0.16944463935758583,-638259862,-521745996.4,59.945118396888226,58.245211132799916,NaN,NaN,5.747565013895595,3.952978510886152
2003-01-21T09:30:00-05:00,25.41,25.55,25.02,25.03,68031184,59688157.5,42.25215001048013,52.74127362437853,NaN,NaN,-61.988334631134094,42.18089334991049,-0.0746884246042327,0.07608410860229498,0.15077253320652767,-706291046,-566421740.4,52.59158943911038,58.14775977229234,NaN,NaN,2.4526699038250754,3.7386487098774266
2003-01-22T09:30:00-05:00,24.968,25.53,24.87,24.92999,80967008,60456676.7,41.554546933824945,52.90629276967059,NaN,NaN,-68.83948395318795,0.6042463238479258,-0.13493276671608778,-0.017893425188582057,0.11703934152750572,-787258054,-636743385.2,43.53814542642204,57.90796126815693,NaN,NaN,-0.4196850881955714,3.144601024438427
2003-01-23T09:30:00-05:00,25.39999,25.84,25.11,25.50999,78658816,62089427.1,47.0178854542252,52.75380560470733,NaN,NaN,-33.9251967978348,-26.785197141165924,-0.12967213494947655,-0.045050827159339946,0.08462130779013659,-708599238,-680243186.8,39.058940596074656,57.60029676107718,NaN,NaN,-1.2891324297134779,2.511210530988155
2003-01-24T09:30:00-05:00,25.53,25.53101,24.64,24.82001,74576320,64979588,41.98936852010653,52.0766335210599,NaN,NaN,-74.59680229674903,-54.58111650956096,-0.16438163327769062,-0.12085573380697667,0.04352589947071393,-783175558,-724716751.6,35.084749661420645,57.09606577626547,NaN,NaN,-3.6376707040998233,1.6327989259755866
2003-01-27T09:30:00-05:00,24.45,25.03,24.37,24.53,76589632,67118229.6,40.0505103873128,50.911345824088244,NaN,NaN,-97.79017198271953,-67.42799793232507,-0.1964242955517777,-0.20200446996900823,-0.005580174417230507,-859765190,-769017817.2,31.632095019654557,56.14189255989423,NaN,NaN,-6.1729012710379685,0.517698897830793
2003-01-28T09:30:00-05:00,24.77,25.05,24.42,24.78,65295104,68255954.4,42.51470591808434,49.75678268849271,NaN,NaN,-85.13880403707256,-72.05809181351276,-0.19020584000765167,-0.2433374744267951,-0.053131634419143425,-794470086,-786653625.2,30.35158776001022,54.54019043710715,NaN,NaN,-7.540279937675395,-0.633440935812948
2003-01-29T09:30:00-05:00,24.75999,25.45,24.34,25.14999,95805120,70173275.2,46.049161554409,49.336229020724886,NaN,NaN,-68.60437379006385,-72.01106978088794,-0.1522410397056874,-0.24343293405125266,-0.09119189434556527,-698664966,-768935007.6,33.27417315244263,52.75429307404935,NaN,NaN,-7.652019489935608,-1.636095014973328
2003-01-30T09:30:00-05:00,25.32001,25.42,24.49001,24.53999,70503120,71397031.2,41.51689752796319,48.191673080439436,NaN,NaN,-85.78740954174349,-82.38351232966968,-0.1585621073440831,-0.28939452852566916,-0.13083242118158606,-769168086,-781048777.2,32.2769716437618,50.550597933929915,NaN,NaN,-9.134527615103535,-2.707299672134786
2003-01-31T09:30:00-05:00,24.06,24.75999,24.00999,24.44,90548000,72609175.2,40.80789291281667,46.81731860665393,NaN,NaN,-113.58823385462318,-90.18179864124451,-0.15940029639688852,-0.3300827916776967,-0.1706824952808082,-859716086,-796356882.8,31.01213582573419,47.9068399249745,NaN,NaN,-10.546547172965864,-3.827192172253511
2003-02-03T09:30:00-05:00,24.528,24.79601,24.38,24.49001,53194496,73314335.2,41.347399081827774,45.58794129981732,NaN,NaN,-91.64915797657282,-88.95359584001517,-0.14682202902656302,-0.354210031564012,-0.20738800253744896,-806521590,-785708162.8,32.97960967827525,45.2761782211595,NaN,NaN,-11.553492995117267,-4.930949432662619
2003-02-04T09:30:00-05:00,24.17999,24.3,23.82001,24.19,69504128,73421576,39.04809692135253,44.12669409293331,NaN,NaN,-113.48641728315754,-94.62311848923216,-0.14849678183659332,-0.3930089798331906,-0.2445121979965973,-876025718,-802019289.2,31.497815339834446,42.46707139794632,NaN,NaN,-13.06419108251004,-6.092841096926536
2003-02-05T09:30:00-05:00,24.33,24.86,24.00999,24.08,80168128,72990782.4,38.20910769361193,42.845184897599935,NaN,NaN,-90.87130640851584,-99.07650501292257,-0.14655280975346863,-0.42770321018843305,-0.2811504004349644,-956193846,-853525065.2,27.32308175045577,39.263022892629,NaN,NaN,-14.560460415997115,-7.3025009996509045
2003-02-06T09:30:00-05:00,24.03999,24.35001,23.86,24.21001,103594688,74415966.4,39.85397990498286,41.88514557965532,NaN,NaN,-95.402950697809,-100.99961324413566,-0.12679169625163744,-0.43964002074951125,-0.3128483244978738,-852599158,-870211279.6,26.115455600850524,36.1915335207811,NaN,NaN,-15.39851937085677,-8.459075052680314
2003-02-07T09:30:00-05:00,24.36,24.45,23.64999,23.81,72338880,74261516.8,36.6236416780934,41.34538174993507,NaN,NaN,-101.60603651855976,-98.60317377692297,-0.13043470816096264,-0.4758917096990771,-0.3454570015381145,-924938038,-883255670,25.178574210103676,33.70820893601077,NaN,NaN,-17.030312768932106,-9.683537583573427
2003-02-10T09:30:00-05:00,23.899,24.25,23.62,24.02,67603312,73509782.4,39.40065130520045,41.14170327098652,NaN,NaN,-98.25214010808243,-99.9237702032249,-0.10932929957112997,-0.48211862600202693,-0.37278932643089696,-857334726,-893418297.2,24.442865309464864,31.69758578389324,NaN,NaN,-17.682460131651116,-10.826240804727382
2003-02-11T09:30:00-05:00,24.25,24.61,23.92,24.14999,78007312,73762888.8,41.12049734281,41.110699728771166,NaN,NaN,-72.72812889523104,-91.7721125256396,-0.07867530855560045,-0.47113346212539753,-0.3924581535697971,-779327414,-874078636.4,28.711805161623914,30.6385614792648,NaN,NaN,-17.77934159549856,-11.819540917694694
2003-02-12T09:30:00-05:00,24.07001,24.33,23.78,23.82001,51815008,73990514.4,38.15982500570708,40.47798112530558,NaN,NaN,-93.366574000271,-92.27116604399063,-0.07281827780841271,-0.483481000830313,-0.41066272302190027,-831142422,-849068351.6,33.912022388547925,30.27092446444146,NaN,NaN,-18.665023023860076,-12.797466932861177
2003-02-13T09:30:00-05:00,23.85001,23.98,23.32001,23.94,77763008,75106144.8,39.85560408431938,40.325569379892215,NaN,NaN,-115.32726905444287,-96.2560297153174,-0.053928534817737406,-0.478073391544072,-0.4241448567263346,-753379414,-829224402.8,37.78960425787726,30.464128364188362,NaN,NaN,-18.966234201159462,-13.678719399760931
2003-02-14T09:30:00-05:00,23.83,24.5,23.62,24.49001,67562000,74998869.6,47.02641314989959,40.823848148648416,NaN,NaN,-52.09130322006685,-86.35308305561882,-0.00029458598549025883,-0.4245130892081974,-0.42421850322270716,-685817414,-781400278,46.01103056164488,31.49119518861624,NaN,NaN,-17.192928342781148,-14.180749248763819
2003-02-18T09:30:00-05:00,24.7,25.34,24.67999,25.25,74026496,74827588,55.008640349248225,41.716272036588684,NaN,NaN,86.41981832374566,-49.41869136925319,0.08570588220693154,-0.31708615046404276,-0.4027920326709743,-611790918,-732291516.4,52.8951232724574,33.10144772521961,NaN,NaN,-13.021229333064039,-14.015103546520994
2003-02-19T09:30:00-05:00,25.2,25.24001,24.71001,25.08,45608800,73706468.8,53.08184135252266,42.218606307882524,NaN,NaN,77.17343723655412,-19.43837814289616,0.12793964082309311,-0.24286748164210792,-0.37080712246520103,-657399718,-707905977.2,55.90201948476835,34.71772246324287,NaN,NaN,-10.165132969492822,-13.465107749802684
2003-02-20T09:30:00-05:00,25.14999,25.27,24.84,24.98,59952896,72655763.2,51.92956682128354,42.96236840026255,NaN,NaN,81.76658635221477,15.588253927600993,0.14470294651055393,-0.18992843932700865,-0.3346313858375626,-717352614,-685148015.6,58.560610862721866,36.595125264597165,NaN,NaN,-8.148444311000514,-12.705584401402374
2003-02-21T09:30:00-05:00,24.92999,25.37,24.50999,25.17,70344688,72240056.8,53.973903456992005,43.9027977248465,NaN,NaN,88.39770798624728,56.33324933573901,0.16280042078441986,-0.13113085985703776,-0.2939312806414576,-647007926,-663873718,60.93178275377638,38.73224290231446,NaN,NaN,-5.854917461613574,-11.72691769571826
2003-02-24T09:30:00-05:00,25.13,25.21201,24.71001,24.74001,56709200,71346700.8,48.90496766673227,44.44262405233968,NaN,NaN,68.28968796975771,80.40944757370394,0.14084805809459222,-0.11787120802321738,-0.2587192661178096,-703717126,-667453660.4,60.30643892301185,40.6841592769385,NaN,NaN,-5.298289666926561,-10.808542263033731
2003-02-25T09:30:00-05:00,24.45,24.95,24.08,24.77,74635184,71248978.4,49.26286764577906,45.172250532655866,NaN,NaN,19.20357752447728,66.96619941385026,0.12397784040477539,-0.10374696561184038,-0.22772480601661577,-629081942,-670911865.2,59.66937091344749,42.696413246482294,NaN,NaN,-4.742790983050401,-9.942006365893254
2003-02-26T09:30:00-05:00,24.67999,24.94,24.2,24.22,60143696,70991408,43.2759835696699,45.53417023808858,NaN,NaN,-3.7917601393593725,50.773159938667554,0.07388120001744078,-0.13537330599481479,-0.20925450601225556,-689225638,-677277049.2,58.44554826321737,44.91944656882241,NaN,NaN,-6.018337886773016,-9.381482297447507
2003-02-27T09:30:00-05:00,24.42,24.92,24.27,24.77,66519184,69527111.2,49.840717902827826,46.24750866650607,NaN,NaN,36.80075728503988,41.779994125232555,0.07561607025591416,-0.11473441819236285,-0.190350488448277,-622706454,-658347817.2,61.00685729949386,47.41168954729693,NaN,NaN,-5.115224657122134,-8.772016920258167
2003-02-28T09:30:00-05:00,24.81,25.22,24.72,25.16,50595200,68531715.2,53.91366659756407,47.48251044646827,NaN,NaN,102.93080968500027,44.68661446498315,0.0993638119162846,-0.06614572355292125,-0.16550953546920585,-572111254,-643368482.8,62.9528594822267,50.10985278102,NaN,NaN,-3.060192047857823,-7.95604193848669
2003-03-03T09:30:00-05:00,25.27,25.48,24.56,24.64999,60441200,67026375.2,48.38103731488979,48.12396659001751,NaN,NaN,70.03712889747597,45.0361026505268,0.078000893225468,-0.06800841893737086,-0.14600931216283886,-632552454,-629135548.4,64.75283220954196,52.98913613102551,NaN,NaN,-3.060134972712498,-7.256626657661806
2003-03-04T09:30:00-05:00,24.66,24.77,24.42,24.5,56092608,67171280.8,46.85808761599615,48.53379446667366,NaN,NaN,12.030066268873703,43.60140039940608,0.052281221577587106,-0.08065778519085498,-0.1329390067684421,-688645062,-641048172.4,62.036060698349054,55.36944009793445,NaN,NaN,-3.5327021407676926,-6.724637440962646
2003-03-05T09:30:00-05:00,24.39999,24.78,24.32001,24.55,69205504,67156349.6,47.45191424164464,49.197515126383486,NaN,NaN,6.142463984380636,45.58824522415409,0.03782282437558415,-0.0856604762989619,-0.12348330067454605,-619439558,-627090956.4,63.944765303671765,57.51463602044329,NaN,NaN,-3.740097927354568,-6.298274653304349
2003-03-06T09:30:00-05:00,24.42999,24.67999,24.23,24.49001,59550304,66125458.4,46.77654056743685,49.69186773232045,NaN,NaN,-10.687383885329497,36.09061699008022,0.024075198190990313,-0.09338930293580816,-0.11746450112679847,-678989862,-638347638,61.26925683831139,59.19175406190288,NaN,NaN,-4.100996663050948,-5.984377797553863
2003-03-07T09:30:00-05:00,24.08,24.95,23.96001,24.53999,73329808,64612214.4,47.44763666877914,49.72195512652613,NaN,NaN,-11.383150580307305,13.227824937018704,0.018456899035093746,-0.0943933773329313,-0.11285027636802504,-605660054,-645057398,59.66669570049418,60.167158714677825,NaN,NaN,-4.220451758182027,-5.732388363357886
2003-03-10T09:30:00-05:00,24.33,24.457,23.91,24.00999,55990496,63794795.2,41.475406118732614,48.75529553863216,NaN,NaN,-85.64953267149829,-17.90950737677615,-0.018826610572213714,-0.1363835395832922,-0.11755692901107848,-661650550,-650877017.2,58.243733174464474,60.5492022791069,NaN,NaN,-6.0691151722766135,-5.780492193203418
2003-03-11T09:30:00-05:00,24.06,24.24001,23.78,23.8,54945104,63161884.8,39.36142908645192,47.775266091055684,NaN,NaN,-122.51510337789657,-44.8185413061302,-0.05353759719968834,-0.1844789255106889,-0.13094132831100055,-716595654,-656467135.6,56.841443627891984,60.61630400361573,NaN,NaN,-8.256011238831523,-6.13413777115029
2003-03-12T09:30:00-05:00,23.75999,24.24001,23.53999,24.23,77964128,63159725.6,45.48849199228578,47.31518931755584,NaN,NaN,-103.64474423571122,-66.77598295014857,-0.04385187930502854,-0.18575617744228623,-0.1419042981372577,-638631526,-660305529.2,55.8471769131092,60.42248729292911,NaN,NaN,-8.383076975765741,-6.455414800381069
2003-03-13T09:30:00-05:00,24.64,25.64999,24.39999,25.62,128537632,66995856.8,59.67338776144065,47.722295339302164,NaN,NaN,120.59095427123658,-40.52031531883536,0.054517996108295386,-0.07375680300188847,-0.12827479911018386,-510093894,-626526335.6,62.125816262605845,60.50777540070265,NaN,NaN,-3.355750898304407,-6.012605671512975
2003-03-14T09:30:00-05:00,25.73,25.98,25.36,25.72,89832320,67599322.4,60.470337516972556,48.548393185747905,NaN,NaN,182.89895010349915,-1.6638951820740715,0.12086762807322508,0.0228097359813475,-0.09805789209187758,-420261574,-589446639.6,67.57636613376977,61.027055915756776,NaN,NaN,0.7731600688610215,-5.043210565745261
2003-03-17T09:30:00-05:00,25.42999,26.8,25.35001,26.60001,141198368,71281140.8,66.70593793990032,49.794326778185145,NaN,NaN,233.65207524224294,62.196426400674184,0.21317236861576494,0.16840756867782858,-0.04476479993793635,-279063206,-512929170.8,75.43329827800841,62.153050727511136,NaN,NaN,6.710860834062224,-3.364057508629906
2003-03-18T09:30:00-05:00,26.8,26.97,26.42,26.92999,97193008,72439466.4,68.6997649059001,51.61031115934444,NaN,NaN,252.9359238914609,137.28663185454565,0.28131900877710564,0.30688396103344573,0.025564952256340076,-181870198,-405984079.6,81.99890852298235,63.835433603208635,NaN,NaN,12.127127458071042,-1.151031084815485
2003-03-19T09:30:00-05:00,26.85001,27.75999,26.33,26.7,91369808,74727516.8,65.74456701189251,52.74630038142048,NaN,NaN,212.71287717904494,200.55815613749692,0.29437430002148135,0.3935328272831917,0.0991585272617104,-273240006,-332905775.6,84.95736082340979,65.5461838549169,NaN,NaN,15.445107184384025,1.2198458107844448
2003-03-20T09:30:00-05:00,26.53999,27.14,26.17,26.8,93099808,76384862.4,66.4209237065347,53.6396758892041,NaN,NaN,152.08753778212838,206.85747283967527,0.2926032734292594,0.4649126190482846,0.17230934561902525,-180140198,-266915036.4,87.03025193576127,67.26599760159796,NaN,NaN,18.283485579690193,3.657508634913837
2003-03-21T09:30:00-05:00,27.21001,27.38,26.2,27.17,93395184,77537387.2,68.8700499028773,55.103176788346055,NaN,NaN,139.91653681803766,198.26099018258296,0.2981961053740789,0.5450544773366239,0.246858371962545,-86745014,-200211724.4,88.72199302805465,68.97808051720601,NaN,NaN,21.44718102622009,6.198890405100444
2003-03-24T09:30:00-05:00,26.47,26.60001,25.97,26.03999,85300688,78966961.6,55.545401086815836,55.7236991791189,NaN,NaN,73.41320199845455,166.2132155338253,0.2117044925498538,0.5114889876498623,0.2997844951000085,-172045702,-178808223.6,89.20841125801564,70.91896270003933,NaN,NaN,19.744694316895885,8.13400524964265
2003-03-25T09:30:00-05:00,26.158,26.75999,26.00999,26.41,78789184,79174661.6,58.384596850494994,56.504605079751066,NaN,NaN,77.00971011946525,131.02797277942616,0.16727542169923693,0.5088787722240546,0.3416033505248177,-93256518,-161085487.6,89.60808330896876,72.75205684327484,NaN,NaN,19.335300322694096,9.73419026007857
2003-03-26T09:30:00-05:00,26.5,26.77,26.36,26.56,68026624,79568808,59.51348652752496,57.41438693404307,NaN,NaN,79.0592057772705,104.29723849907127,0.1371176038414571,0.5130003553266391,0.375882751485182,-25229894,-111483465.2,90.65162070475564,74.85079711944942,NaN,NaN,19.37447176900582,11.111373332782463
2003-03-27T09:30:00-05:00,26.27,26.64999,26.10001,26.37,64201392,79452918.4,57.38985318949122,58.12454525695108,NaN,NaN,59.42169745228444,85.76407043310249,0.09547512907180672,0.49522666282494043,0.3997515337531337,-89431286,-93341682.8,91.00730719585795,77.0894122262611,NaN,NaN,18.743808539315097,12.201721219429983
2003-03-28T09:30:00-05:00,26.14,26.42999,25.95,26.08,45395696,79192943.2,54.210238192423645,59.03417611935758,NaN,NaN,40.418769643859015,65.86451699826674,0.04221788766937118,0.45252389333984766,0.4103060056704765,-134826982,-102958076.4,89.07270076312004,79.2914813397365,NaN,NaN,17.240416725601424,12.92153486316876
2003-03-31T09:30:00-05:00,25.60001,25.73,25.21001,25.25,89399184,80640842.4,46.303178690491414,59.530015376788974,NaN,NaN,-13.195633619959777,48.54274987458387,-0.050085193412671924,0.3476995139046366,0.39778470731730853,-224226166,-113394169.2,86.91339830439509,81.43947810234388,NaN,NaN,13.25972997832169,12.969848451047751
2003-04-01T09:30:00-05:00,25.44,25.67,25.25,25.45,73423504,81507387.2,48.26150070335795,59.728087427579844,NaN,NaN,-12.781422829958712,30.58452328469908,-0.09617642230917489,0.2775641794308399,0.3737406017400148,-150802662,-124903398,84.48107519544357,83.48475655108204,NaN,NaN,10.66088476474875,12.63999649586218
2003-04-02T09:30:00-05:00,26.06,26.56,26.03,26.36,75971008,81845662.4,56.10556387517387,59.47324286427507,NaN,NaN,45.98859860914797,23.970401851074588,-0.06535703231575446,0.2920443113453217,0.3574013436610762,-74831654,-134823750,82.34202190838332,84.92877124006615,NaN,NaN,10.941404752474288,12.397340532521053
2003-04-03T09:30:00-05:00,26.64,26.85001,26.31,26.48,71118320,82424063.2,57.03070924040615,59.22755513023462,NaN,NaN,58.49284969958286,23.784632300534277,-0.03821415227744346,0.30963365331427184,0.3478478055917153,-3713334,-117680159.6,83.13665261023743,86.04022027409955,NaN,NaN,11.456731358828996,12.262967793422188
2003-04-04T09:30:00-05:00,26.57001,26.60001,25.97,26.05,65743872,82044766.4,52.741064857920954,58.230064195807515,NaN,NaN,26.45174990876903,20.991228353516284,-0.049811129393000475,0.2855838938504647,0.33539502324346515,-69457206,-104606204.4,83.73768333607958,86.63339063539036,NaN,NaN,10.527041187275941,12.014978278258438
2003-04-07T09:30:00-04:00,27.11,27.2,26.07001,26.09,83879376,83439210.4,53.09450224319937,57.115402577043184,NaN,NaN,44.3907320187026,32.50850148124876,-0.054973734119412476,0.26667785559419954,0.321651589713612,14422170,-56876537.2,85.73638749827467,86.90035341933981,NaN,NaN,9.892622890160387,11.711784651387287
2003-04-08T09:30:00-04:00,26.14999,26.28999,25.88,26.06,54282608,83406085.6,52.775709387336455,56.1890556038606,NaN,NaN,-7.370852780192595,33.59061549120199,-0.060174706823393154,0.2464332061843706,0.30660791300776374,-39860438,-34688092.4,86.5631606564356,87.01505340741308,NaN,NaN,9.28773833288325,11.365492320172425
2003-04-09T09:30:00-04:00,26.10001,26.28,25.41,25.46001,76543632,83335060.8,46.732280179751235,54.78272392337607,NaN,NaN,-87.02140951812336,6.988613865747707,-0.10136536411954505,0.1799012078583324,0.28126657197787747,-116404070,-43002575.6,84.58463629112168,86.8403665756531,NaN,NaN,6.933014660488189,10.73228122593182
2003-04-10T09:30:00-04:00,25.46001,25.77,25.3,25.77,57234704,79769914.4,49.92291261753643,53.42935697442315,NaN,NaN,-114.81132127759241,-27.67222032968735,-0.10465054627248693,0.1504533891372688,0.25510393540975573,-59169366,-54093782,81.8955975196969,86.3527668964847,NaN,NaN,5.874896828287532,10.038369169125492
2003-04-11T09:30:00-04:00,26.02,26.168,25.36,25.50999,67992368,78677916.8,47.360461184937506,52.84471841000327,NaN,NaN,-102.47033997079923,-53.456638305601,-0.12014264489227369,0.10492562929441362,0.22506827418668732,-127161734,-65634687.6,79.07845049200876,85.62919827034135,NaN,NaN,4.229623343389208,9.20854833687745
2003-04-14T09:30:00-04:00,25.60001,26.14,25.491,26.03,53422608,74289128.8,52.60051424940085,52.43156965278225,NaN,NaN,-58.21789562279058,-73.97836383389964,-0.09242079733595673,0.1095422775167414,0.20196307485269813,-73739126,-83266946.8,74.84250808479081,84.57451432575722,NaN,NaN,4.356135716656777,8.515346533988783
2003-04-15T09:30:00-04:00,25.97,26.46001,25.849,26.28,64621296,72660543.2,54.92370473781355,52.1037280963743,NaN,NaN,1.3590925714384172,-72.23237476357343,-0.05608727228227134,0.13185398449985897,0.1879412567821303,-9117830,-77118425.2,75.33859428776665,83.48072672454371,NaN,NaN,5.154167389565119,8.035178084785402
2003-04-16T09:30:00-04:00,26.64999,26.83,26.12,26.22,70747184,71629412,54.236636511390586,51.87849833365283,NaN,NaN,45.79212223531503,-45.669668412885756,-0.03591641957543046,0.14304573231284223,0.1789621518882727,-79865014,-69810614,75.94572660221283,82.40489953928333,NaN,NaN,5.611831628476414,7.688985733884118
2003-04-17T09:30:00-04:00,26.162,26.98,26.14999,26.82001,70275008,70488172,59.66990545496689,52.26847456669163,NaN,NaN,99.21572625080228,-2.8642589072068176,0.015268750879413234,0.19804809048753924,0.182779339608126,-9590006,-59894742,76.78101607554856,81.52692206159966,NaN,NaN,7.662636781930628,7.685221597890762
2003-04-21T09:30:00-04:00,26.948,27.106,26.62,26.92,52750096,68455917.6,60.51129843346433,53.28334026261827,NaN,NaN,147.1097577299174,47.05176063293651,0.051264974802886776,0.24686055811173446,0.1955955833088477,43160090,-25830377.2,79.4243519738502,80.99199018084644,NaN,NaN,9.589020131092488,7.95719281691958
2003-04-22T09:30:00-04:00,26.737,27.46001,26.64999,27.42999,70905808,67736173.6,64.57120299731935,54.44831899790122,NaN,NaN,176.19758717746993,93.9348571929886,0.10190247867810717,0.32297368165648166,0.2210712029783745,114065898,11730627.6,81.8746411754735,80.80581632227715,NaN,NaN,12.530898413347503,8.610579330694998
2003-04-23T09:30:00-04:00,27.5,27.75,27.25999,27.63,70578320,67325630.4,66.04559780338433,55.15832142134483,NaN,NaN,200.70902810954075,133.8048443006091,0.13904789575885085,0.39488107267693806,0.2558331769180872,184644218,50483037.2,83.99265729266048,80.92371884972553,NaN,NaN,15.423964877522408,9.583920123098913
2003-04-24T09:30:00-04:00,27.36,27.75,27.27,27.48,72510816,67549840,63.897923772323686,55.648836745053224,NaN,NaN,167.6443296358575,158.17528578071756,0.14313577128495258,0.43475289102427794,0.29161711973932536,112133402,88882720.4,85.76741854575172,81.11163070226226,NaN,NaN,17.230397101331825,10.676273977132187
2003-04-25T09:30:00-04:00,27.32001,27.42,26.86,26.95,63355808,67507560.8,56.86207511716722,55.94319462071367,NaN,NaN,95.30893494937693,157.3939275204325,0.1017125793787807,0.41875784396280125,0.31704526458402055,48777594,100556240.4,86.26593408094199,81.29222004118103,NaN,NaN,16.75791175785793,11.545079374378721
2003-04-28T09:30:00-04:00,27.05,27.63,26.95,27.48,59685008,68222026.4,61.435128904546666,56.53895366795276,NaN,NaN,114.1242678474587,150.79682954394076,0.10135030437423337,0.44373314505181227,0.3423828406775789,108462602,113616742.8,86.82207492010713,81.36976914274047,NaN,NaN,17.750807138768195,12.431611912148647
2003-04-29T09:30:00-04:00,27.64,28.06,27.41,27.73,80373376,67770736,63.405774134220714,57.29824400701592,NaN,NaN,140.0513232933842,143.56757676712363,0.10864326394217083,0.47818692060529244,0.3695436566631216,188835978,128570758.8,87.44876766941891,81.433026786525,NaN,NaN,19.17659077567115,13.39518032122329
2003-04-30T09:30:00-04:00,27.64999,27.78999,27.42999,27.45,60413104,67120216,59.724710527700886,58.226274746155184,NaN,NaN,106.25755353200964,124.67728185161741,0.086281085443847,0.47739501346793034,0.39111392802408335,128422874,117326490,84.20605104256956,81.40598498305698,NaN,NaN,19.27031897342686,14.234485842966658
2003-05-01T09:30:00-04:00,27.44,27.87,27.19,27.69,66057504,66624540.8,61.773274382044015,59.07272915790573,NaN,NaN,96.07126218641727,110.36266836172936,0.07949243640830433,0.49047947353446375,0.4109870371261594,194480378,133795885.2,85.07880158112168,81.63335670173016,NaN,NaN,19.954269082447677,15.051597734321088
2003-05-02T09:30:00-04:00,27.60699,28.28999,27.57001,28.28,85039632,67320606.4,66.30995199319102,60.426264215638135,NaN,NaN,125.6150789075938,116.42389715337272,0.1049758491247268,0.5422068485320679,0.4372309994073411,279520010,179944368.4,87.21130648473195,82.21427498692468,NaN,NaN,21.97913996288741,16.041246624116276
2003-05-05T09:30:00-04:00,28.325,28.71001,28.17,28.25,80670688,68066947.2,65.88180760910853,61.374928027045826,NaN,NaN,138.83246994280432,121.36553757244185,0.10954466956807157,0.5741618363674306,0.464617166799359,198849322,198021712.4,87.93849925966525,83.14970292798715,NaN,NaN,23.475525247786948,17.1032864274978
2003-05-06T09:30:00-04:00,28.22,28.89999,28.21001,28.61,77620880,67754022.4,68.50940227642346,62.34533499408939,NaN,NaN,137.21793854921572,120.79886062360815,0.1254043380687121,0.6213725893852491,0.495968251316537,276470202,215548557.2,88.61447372006742,84.09798003029435,NaN,NaN,25.553769903034677,18.310498352574495
2003-05-07T09:30:00-04:00,28.41,28.69,28.12,28.28999,70379680,68558876,63.80531927010488,63.02881233399756,NaN,NaN,109.11303980049261,121.36995787730476,0.10382702993613002,0.6257520387366995,0.5219250088005695,206090522,231082086.8,89.19257289126575,85.04418333665527,NaN,NaN,25.931899543690122,19.3992699513053
2003-05-08T09:30:00-04:00,27.855,28.19,27.75999,27.77,80333808,68748384.8,56.96116505136388,62.83533087659733,NaN,NaN,64.18098963320044,114.99190336666138,0.046917169058198094,0.5805714701233171,0.533654301065119,125756714,217337354,85.07625925068831,85.63670070630812,NaN,NaN,24.13842583897747,20.076292220972753
2003-05-09T09:30:00-04:00,28.03999,28.48,27.995,28.41,58580496,68815674.4,62.31862905282672,62.964425920837506,NaN,NaN,94.1351711018199,108.6959218055066,0.04476577570428397,0.589611520695474,0.54484574499119,184337210,198300794,79.59710068501957,85.64903989996307,NaN,NaN,24.27213800834608,20.675698762026087
2003-05-12T09:30:00-04:00,28.36,28.96001,28.17,28.84,67597120,68795912,65.43210065360242,63.02591861057203,NaN,NaN,123.9313389163671,105.71569560021916,0.06354496888151506,0.6242769560930839,0.5607319872115688,251934330,208917795.6,80.35692477232446,85.5406315854524,NaN,NaN,25.39554760889715,21.349962883007667
2003-05-13T09:30:00-04:00,28.63,28.99001,28.53999,28.66,65188000,69384181.6,63.08238635132782,62.814260649710846,NaN,NaN,121.91739285759056,102.65558646189413,0.05538500509944644,0.6299632435858769,0.5745782384864304,186746330,190973021.2,75.25562394570844,84.91655777495585,NaN,NaN,25.56759592788646,21.952481889418923
2003-05-14T09:30:00-04:00,28.87399,28.97,28.36,28.60001,62228304,69264532,62.279671039435314,62.69867116879025,NaN,NaN,101.99277891790082,101.23153428537577,0.038300382623544516,0.622453716765861,0.5841533341423165,124518026,174658522,70.85180960660708,83.85115713644551,NaN,NaN,25.467436721927537,22.45461829406301
2003-05-15T09:30:00-04:00,28.75,28.98,28.56,28.92,62485104,68851428,64.84907516514215,63.26917117221702,NaN,NaN,111.11883625644381,110.61910361002444,0.04067970269697241,0.635002962513532,0.5943232598165596,187003130,186907805.2,72.16868701622877,82.84421091753742,NaN,NaN,26.141618797805755,22.981332651740544
2003-05-16T09:30:00-04:00,28.73,28.94,28.48,28.7,70645872,68869971.2,61.735475984687355,63.29062453508421,NaN,NaN,89.32451529925343,109.65697244951116,0.020580299435194793,0.6200486341105531,0.5994683346753583,116357258,173311814.8,68.47103934432204,81.5334226621242,NaN,NaN,25.79741156732033,23.383629639680514
2003-05-19T09:30:00-04:00,28.52,28.67999,27.61,27.69,91762880,70820610.4,49.89213171127632,62.325364362016764,NaN,NaN,-5.303250181342215,83.81005462996929,-0.06301754927751013,0.5206963980784707,0.5837139473559808,24594378,127843824.4,57.80461556862472,79.41598322635319,NaN,NaN,21.52652307385582,23.118328701705558
2003-05-20T09:30:00-04:00,27.75999,27.96001,27.41,27.77,72017376,70876188.8,50.6989011690966,61.680663693545014,NaN,NaN,-49.67266599536472,49.49204285937823,-0.11232777275793004,0.44330423140856823,0.5556320041664983,96611754,109816909.2,54.199590735957756,77.27266463302377,NaN,NaN,18.399516034971892,22.444212606457892
2003-05-21T09:30:00-04:00,27.64999,27.75,27.44,27.69,64102800,70552412.8,49.834807174209836,60.82791603584258,NaN,NaN,-63.19588000851755,16.454311074094562,-0.1475170621034556,0.3712356765371787,0.5187527386406343,32508954,91415094.8,50.72209324593617,74.8186140376534,NaN,NaN,15.615920908631399,21.46874236391125
2003-05-22T09:30:00-04:00,27.75999,28.32001,27.62,28.09,62474096,70050576.8,54.05164675082316,59.95232280424487,NaN,NaN,-11.955284066320198,-8.160512990458246,-0.14104224294950019,0.3424499349537591,0.48349217790325927,94983050,73011078.8,47.4435237408541,71.9780581273764,NaN,NaN,14.461916135097447,20.46776718836642
2003-05-23T09:30:00-04:00,28.041,28.25,27.95,28.10001,37940608,68779816.8,54.15550250876036,59.11472958279143,NaN,NaN,-6.744933755402853,-27.3744028013895,-0.13335937538582598,0.3167929586709768,0.45015233405680277,132923658,76324358.8,48.09400526475035,69.13202284202534,NaN,NaN,13.560627791930344,19.48103298887555
2003-05-27T09:30:00-04:00,27.92999,29.22,27.89999,29.10001,101570320,70874082.4,63.122926148791585,58.729981287960584,NaN,NaN,92.70477353364514,-7.772798058392036,-0.061839273100565584,0.37285324268109576,0.43469251578166135,234493978,118304278.8,55.593373202640024,66.77337280506623,NaN,NaN,15.596171299884587,18.92605274759113
2003-05-28T09:30:00-04:00,29.16,29.39999,28.96001,29.19,76399008,70675364,63.80898313538965,58.73024299262378,NaN,NaN,150.4665666994589,32.25504848057269,-0.011990198806246855,0.41970476727385275,0.4316949660800996,310892986,161160525.2,61.68015936578682,64.80820041038916,NaN,NaN,17.431966734527883,18.712611888582092
2003-05-29T09:30:00-04:00,29.23,29.8,29.16,29.31,97637312,72536574.4,64.75071175301434,59.28663918559884,NaN,NaN,170.25882791022983,78.94599006432216,0.023605220314347364,0.4612014914730338,0.43759627115868643,408530298,236364794,69.5640439003883,63.70018502822488,NaN,NaN,19.212616288718234,18.78404108860154
2003-05-30T09:30:00-04:00,29.53,29.87,29.45,29.78999,78160880,73141743.2,68.3035190877285,59.714131330948966,NaN,NaN,186.40437075154134,118.61792102789448,0.0713206735480777,0.5267471130937835,0.45542643954570583,486691178,314706419.6,75.27156965877886,63.391218526350535,NaN,NaN,21.878265301378534,19.226073118998254
2003-06-02T09:30:00-04:00,30.08,30.2,29.31,29.58,103101312,74044827.2,65.20704852819756,59.698056179134326,NaN,NaN,161.4237117438097,152.25165012773698,0.0799359405326654,0.5553463652115376,0.4754104246788722,383589866,364839661.2,78.1016006643572,63.23012394721002,NaN,NaN,23.175510276683617,19.79027842723902
2003-06-03T09:30:00-04:00,29.44,29.88,28.66,29.86,82208000,74121692.8,67.33356944379604,60.001712114310635,NaN,NaN,113.76333739149344,156.46336289930665,0.0946801686575508,0.5937606355008107,0.4990804668432599,465797866,411100438.8,80.33774481740993,63.593132580902974,NaN,NaN,24.91223838230125,20.52198699224791
2003-06-04T09:30:00-04:00,29.81,30.58,29.72,30.42,87114880,74596392.8,71.13358919703307,60.63413483985333,NaN,NaN,180.01671005998827,162.3733915714125,0.1301461446982276,0.6617631477160444,0.5316170030178168,552912746,459504390.8,82.36670479464897,64.41562509433454,NaN,NaN,27.653969214299735,21.54084159539817
2003-06-05T09:30:00-04:00,30.13,30.67999,29.97,30.64,89486624,75551740,72.48762929041794,61.179745848801595,NaN,NaN,165.9943324414944,161.5204924776654,0.1547462907291256,0.7250498664292238,0.5703035757000982,642399370,506278205.2,84.07664661970149,65.26619363743973,NaN,NaN,30.3394629506974,22.79778750329806
2003-06-06T09:30:00-04:00,31.17,31.47,30.02,30.13,157178128,79393956,64.88889445311993,61.40499002511821,NaN,NaN,148.60895687654238,153.96140970266563,0.12430677202582396,0.7256870407323781,0.6013802687065541,485221242,505984218,84.02149623002997,66.37694055784745,NaN,NaN,30.31081895159453,23.871077710197557
2003-06-09T09:30:00-04:00,30,30.22,29.53,29.73,94981120,81213987.2,59.61080352244902,62.099180868773395,NaN,NaN,73.37320241025317,136.35130783595434,0.06770177037379488,0.6860074816737978,0.6183057113000029,390240122,507314269.2,84.07239979171054,68.25321085949643,NaN,NaN,28.61133139548159,24.548256808095275
2003-06-10T09:30:00-04:00,29.86,30.2,29.67999,30.17999,69923632,81330312.8,63.23391300929467,62.994538857358975,NaN,NaN,81.08142013450023,129.8149243845557,0.05175414868010675,0.6829983971501363,0.6312442484700296,460163754,506187446.8,83.82874395689903,70.36957894670653,NaN,NaN,28.309237303684643,25.085539736036612
2003-06-11T09:30:00-04:00,30.07001,30.64,29.8,30.52,87395872,82440706.4,65.73506276911276,64.13027139985205,NaN,NaN,95.59934464659815,112.93145130187767,0.05498916092104733,0.6999806996213387,0.6449915387002914,547559626,505116822.8,83.58088960586278,72.71663582955843,NaN,NaN,28.847346575103316,25.62294071304614
2003-06-12T09:30:00-04:00,30.638,30.75,30.25999,30.64999,79562128,83307397.6,66.66863583070776,65.03148490555809,NaN,NaN,102.8951846866095,100.3116217509007,0.056549574619678245,0.7156785069748892,0.659128932355211,627121754,502061299.6,82.82820139582158,75.24411280491324,NaN,NaN,29.566061513169036,26.18624368449227
2003-06-13T09:30:00-04:00,30.655,30.73,29.86,29.96001,83365872,84351436,57.68463538505197,65.28356582529321,NaN,NaN,67.2749616259174,84.0448227007757,0.004521125209875132,0.6647803388675548,0.6602592136576797,543755882,513768227.6,83.44340817346685,77.76907015553584,NaN,NaN,27.31119881662411,26.3469515605111
2003-06-16T09:30:00-04:00,30.17,30.89999,30,30.88,71592816,84398783.2,64.54512938340272,65.38515177062257,NaN,NaN,91.51845147780904,87.67387251428688,0.024365851541149786,0.690716528084117,0.6663506765429672,615348698,558789942.8,85.58262708544719,79.9111597185935,NaN,NaN,27.644100629207436,26.532258570324863
2003-06-17T09:30:00-04:00,31.02,31.11,30.56,30.75999,67724624,83196870.4,63.10779012960554,65.3350665559237,NaN,NaN,101.59990823773445,91.77757013493373,0.02179309359125181,0.693592043532032,0.6717989499407802,547624074,576282006.8,86.32207600387106,81.6712966213138,NaN,NaN,27.432294030136006,26.660835064583598
2003-06-18T09:30:00-04:00,30.66,31.22501,30.45,30.92,80241008,83608052,64.25086766308718,65.2993634066432,NaN,NaN,102.0921733024055,93.0761358660952,0.023124910369409002,0.7007050879025414,0.6775801775331324,627865082,592343098,86.9822763790734,82.91545608407702,NaN,NaN,27.619062502937368,26.797724698634138
2003-06-19T09:30:00-04:00,30.98,31.24001,30.38,30.42,79539632,84379893.6,58.184156436170824,64.57655178867478,NaN,NaN,80.99549545128208,88.69619801902971,-0.015338779738023556,0.6584067028606029,0.6737454825986264,548325450,576583837.2,82.76115721028229,83.45042662347012,NaN,NaN,25.8452038210265,26.66165028754733
2003-06-20T09:30:00-04:00,30.69,30.78,30.25,30.38,71569184,84834648,57.71465695647305,64.04138096212303,NaN,NaN,54.93286261119512,86.22777821608524,-0.04733810686272777,0.6145728490202167,0.6619109558829445,476756266,563183914,79.23994530981233,83.53173695528834,NaN,NaN,24.292832333858865,26.323247722734692
2003-06-23T09:30:00-04:00,30.33,30.371,29.56,29.91,86598496,87267542.4,52.36759124644092,62.972382519454804,NaN,NaN,-19.294280990676796,64.06523172238808,-0.10094194122166256,0.5357335293558663,0.6366754705775288,390157770,518145728.4,68.66529199822722,82.69799032534672,NaN,NaN,21.29245306392891,25.604562771476722
2003-06-24T09:30:00-04:00,29.73,30.13,29.53,29.67999,83041120,86341082.4,49.929659459525595,61.457816109632844,NaN,NaN,-56.841680034176754,32.37691406800584,-0.14973139235082122,0.4495112301390023,0.5992426224898235,307116650,470044243.6,59.528218178540236,81.06666985276752,NaN,NaN,18.060441981504457,24.526831230052114
2003-06-25T09:30:00-04:00,29.67,30.17999,29.47,29.52,94353120,87238788,48.24713538016639,59.72635225890059,NaN,NaN,-75.54230959780504,-3.149982512036266,-0.18813587674149945,0.36407277656294923,0.5522086533044487,212763530,387023933.2,47.72443525431668,78.4700833266686,NaN,NaN,14.888468900300749,23.149922325801917
2003-06-26T09:30:00-04:00,29.71001,30.28,29.61,30.22,79266688,86320256.8,55.33844445636503,59.04417725913238,NaN,NaN,-29.52116877969714,-25.253315358232115,-0.16270668621295215,0.3488252955382585,0.5115319817512106,292030218,335764886.8,42.16510617883996,75.48034118015504,NaN,NaN,14.183150156676358,21.868954873069693
2003-06-27T09:30:00-04:00,30.25,30.57001,29.772,29.83,82545504,86539488,51.134497177982496,58.43872680595621,NaN,NaN,-30.480828477969183,-42.33605357606498,-0.16779123720727035,0.3017929352421227,0.46958417244939304,209484714,282310576.4,37.287152267935674,72.1385377855997,NaN,NaN,12.271449962116646,20.497882742933545
2003-06-30T09:30:00-04:00,30.16,30.34,29.8,29.95,72086000,84988722.4,52.3343747359437,57.66018835785972,NaN,NaN,-41.18445012671116,-46.714087403271854,-0.15880523095648463,0.27107763375378724,0.4298828647102719,281570714,260593165.2,35.49072604948809,68.68582222078462,NaN,NaN,11.078756940100517,19.152293342528825
2003-07-01T09:30:00-04:00,29.7,30.38,29.25999,30.35001,105918192,86174232,56.1956117769014,56.97879900127318,NaN,NaN,-58.1057621577156,-46.96690382797962,-0.12323960002286716,0.27583336468168795,0.3990729647045551,387488906,276667616.4,37.87644485156402,65.421219024049,NaN,NaN,11.22003397334607,18.019113432645575
2003-07-02T09:30:00-04:00,30.412,30.99001,30.38,30.97,81992000,85918088,61.41307990344875,56.60340214932611,NaN,NaN,103.06814339440314,-11.244813229537986,-0.058559286750039796,0.3258738562670054,0.3844331430170452,469480906,328011091.6,44.88746587790304,62.71116648705481,NaN,NaN,13.01112545050764,17.303686578054442
2003-07-03T09:30:00-04:00,30.7,31.10001,30.47,30.58,50050800,83946296.8,56.82778258521939,56.54219837790951,NaN,NaN,83.28277678183962,11.315975882769365,-0.04334283735241251,0.33025459632652954,0.37359743367894205,419430106,353491069.2,48.02247649826146,60.18109993882586,NaN,NaN,13.074456854496885,16.699510903260506
2003-07-07T09:30:00-04:00,30.97,31.89999,30.96201,31.89,88708192,80522800,66.00836194177967,56.64671498922214,NaN,NaN,210.39474067790562,59.491089713944326,0.048661764604827185,0.434424639434976,0.3857628748301488,508138298,413221786,54.54944076409234,57.96444377301479,NaN,NaN,16.467139983627916,16.66631505759871
2003-07-08T09:30:00-04:00,31.78,32.31,31.62,32.28,82302496,79888868.8,68.17792474656035,57.00886746186177,NaN,NaN,237.65556220974617,115.25909218123579,0.12514949897066047,0.5421997485434744,0.41705024957281395,590440794,474995802,60.12613438633014,56.09330508604758,NaN,NaN,19.93232738048445,17.132888246582386
2003-07-09T09:30:00-04:00,32.17999,32.49001,31.92999,32.2,89848496,80885112,67.23000119158702,57.22166271389748,NaN,NaN,210.85493850225404,169.05123231322972,0.15762240489883628,0.6140782556963593,0.45645585079752304,500592298,497616480.4,61.96643617542902,54.30645935721583,NaN,NaN,22.303433252523206,17.87153753314536
2003-07-10T09:30:00-04:00,31.85001,31.99001,31.33,31.60001,103214816,81676059.2,60.442489514013666,57.38297221945767,NaN,NaN,118.93453730738413,172.2245110958259,0.12726158533048287,0.6155328324606266,0.48827124713014375,397377482,483195795.6,60.0632788690311,52.685182332840746,NaN,NaN,22.084395966348854,18.473374452174433
2003-07-11T09:30:00-04:00,31.65199,31.99001,31.61,31.84,67778368,81086871.2,62.0911160529214,57.69557644063256,NaN,NaN,119.9351454623024,179.55498483191846,0.11242487460132455,0.6288023403817995,0.5163774657804749,465155850,492340944.4,60.88375305448198,51.374025743174286,NaN,NaN,22.432738007254027,19.038997817185802
2003-07-14T09:30:00-04:00,32.34399,32.75,32.07001,32.22,84558128,81146484,64.60643346297249,58.56977945609909,NaN,NaN,149.2253735717704,167.32111141069143,0.11677501151421055,0.6623462301732381,0.5455712186590276,549713978,500656080.4,61.65512372250774,50.87329943776576,NaN,NaN,23.51704536731054,19.67871889577505
2003-07-15T09:30:00-04:00,32.53,32.64999,31.94,32.25999,76114688,81372577.6,64.87059832050636,59.63698937474059,NaN,NaN,120.4572731659579,143.88145360193374,0.11095825370584578,0.6842690357913348,0.573310782085489,625828666,507733654.8,62.33594448630925,51.07385131689212,NaN,NaN,24.460201135593223,20.361787787177644
2003-07-16T09:30:00-04:00,32.46001,32.5,31.73,32.16,81709632,82071828,63.59255136195125,60.73309051629665,NaN,NaN,92.90368814562474,120.29120353060792,0.08988791442179722,0.6856706751127355,0.5957827606909383,544119034,516439002,63.20139675983526,52.1793485672863,NaN,NaN,24.871161684195915,21.005984058180253
2003-07-17T09:30:00-04:00,31.67,31.84,31.043,31.17999,110496688,83584612,52.64504865571305,60.54070510196436,NaN,NaN,28.881030516114794,102.28050217235405,0.003995774529880203,0.6007774788532885,0.5967817043234083,433622346,523687974.8,63.94435493906714,53.73500919301681,NaN,NaN,21.78463008064144,21.117219204246137
2003-07-18T09:30:00-04:00,31.39999,31.96001,30.92,31.28,80587632,83637012,53.52433837677337,60.71140804473514,NaN,NaN,28.479402335867047,83.98935354706698,-0.04910756017497975,0.5353972541046836,0.5845048142796634,514209978,533498800.4,64.97503647092745,55.712715207516226,NaN,NaN,19.568668583422074,20.895997686985556
2003-07-21T09:30:00-04:00,31.24001,31.3,30.61,30.88,111931680,85655136.8,49.56060487686964,60.51328162622985,NaN,NaN,-8.771411353746355,52.38999656196362,-0.11067328648137664,0.4461632061779426,0.5568364926593192,402278298,504011664.4,59.4723120054476,57.42568563294191,NaN,NaN,16.463545496812674,20.262790231246573
2003-07-22T09:30:00-04:00,31.11,31.5,30.86,31.34,91610688,85905746.4,53.79797744808512,60.3420220313144,NaN,NaN,10.842387617346372,30.467019452241306,-0.11918026110433644,0.4078611662788987,0.5270414273832351,493888986,477623728.4,54.98455376826098,58.64769341270597,NaN,NaN,15.078954054462844,19.522242205991756
2003-07-23T09:30:00-04:00,31.39,31.64,30.99001,31.60001,69189632,85213172,56.04571156729654,59.9586385787321,NaN,NaN,20.639587254417226,16.014199273999797,-0.10647634708826392,0.39394599352290527,0.5004223406111692,563078618,481415645.2,55.504157339612455,59.40602851711378,NaN,NaN,14.601181573777735,18.819233544246895
2003-07-24T09:30:00-04:00,31.85001,32.02,31.08,31.17999,83615504,84676291.2,51.672430011002795,59.590399109145196,NaN,NaN,16.17013424315622,13.472020019408086,-0.12429906395434731,0.34504851066823505,0.46934757462258236,479463114,490583798.8,56.80246406480357,60.03317048615251,NaN,NaN,12.862710386332694,17.968301664544867
2003-07-25T09:30:00-04:00,31.13,31.84,30.769,31.8,83055632,84865738.4,57.005653796207554,58.94734852731862,NaN,NaN,14.890975461446786,10.754334644524032,-0.09366539777933625,0.35226582739841206,0.4459312251777483,562518746,500245552.4,58.18707322079109,60.29300137591671,NaN,NaN,13.008136360598646,17.25970662112398
2003-07-28T09:30:00-04:00,31.86,31.98801,31.60001,31.89,56219008,83549413.6,57.73478623019593,58.20141006186402,NaN,NaN,52.02604168556593,22.91382525238651,-0.06787659448282851,0.36108548207421265,0.42896207655704116,618737754,543537443.6,63.787956721187406,60.554560114120804,NaN,NaN,13.344060720761547,16.700328635357916
2003-07-29T09:30:00-04:00,31.92999,32.02,31.23,31.64999,80601632,83975195.2,55.0534509275181,57.331656471573375,NaN,NaN,18.342243028290625,24.41379633457536,-0.06738211180837594,0.34473443679657123,0.4121165486049472,538136122,552386870.8,64.82517741517574,60.75875591695985,NaN,NaN,12.839611051475568,16.148797551946153
2003-07-30T09:30:00-04:00,31.71001,31.74001,31.33,31.42,56642304,81511400.8,52.53559144268235,56.76687803790685,NaN,NaN,-16.39573294132918,17.006732295426083,-0.08197451041202852,0.30964841058991155,0.39162292100194007,481493818,536069910.8,61.336613321259435,60.8497083778333,NaN,NaN,11.686900913193849,15.51138374641011
2003-07-31T09:30:00-04:00,31.78999,32.33,31.52,31.8,85711120,81697356.8,56.10747151551638,56.33947485666363,NaN,NaN,46.99472091096394,23.171649628987627,-0.06614314302863467,0.30894399221614677,0.37508713524478143,567204938,553618275.6,63.60504777378879,61.0440865720695,NaN,NaN,11.73003095419124,14.971190490378842
2003-08-01T09:30:00-04:00,31.69,31.78999,31.3,31.46001,73569632,82873298.4,52.314186285300785,55.46145720111565,NaN,NaN,-35.52775748721662,13.087903039254945,-0.07786998113891608,0.27774965882113634,0.3556196399600524,493635306,539841587.6,60.5990740343548,60.968654451487154,NaN,NaN,10.654251419067464,14.354484908762931
2003-08-04T09:30:00-04:00,31.42,31.92,30.84,31.45,96430320,83259404.8,52.20228452222535,54.556577644095576,NaN,NaN,-56.6171530547967,-8.64073590881758,-0.08501899418500791,0.24934589722879252,0.33436489141380044,397204986,495535034,52.07527838632878,60.23574973005998,NaN,NaN,9.748294527270541,13.696457711406875
2003-08-05T09:30:00-04:00,31.41,31.48,30.17999,30.21001,111179680,84703264,40.61311025537424,52.91518899362579,NaN,NaN,-194.10793222679564,-51.130770959834834,-0.1672246267481441,0.12533410797862032,0.2925587347267644,286025306,445112870.8,44.41815351739019,58.89408949845676,NaN,NaN,5.028665802582317,12.45820172443194
2003-08-06T09:30:00-04:00,30.36,30.77,30.10001,30.19,96848128,85053245.6,40.45702190747296,52.04461565446578,NaN,NaN,-219.89411607163518,-91.83044758589604,-0.21392752698418177,0.025149325996537186,0.23907685298071896,189177178,386649542.8,37.52790088829817,57.007199923401835,NaN,NaN,1.2738917631818618,10.860443158539072
2003-08-07T09:30:00-04:00,30.22,30.50999,30.02,30.31,67364320,83260720.8,41.899155584958834,51.21424545505045,NaN,NaN,-193.38223720559114,-139.90583920920704,-0.2265070639783653,-0.04405697699223765,0.18245008698612764,256541498,324516854.8,31.86974923869677,54.64253654967107,NaN,NaN,-1.3729167053771842,9.11282032083675
2003-08-08T09:30:00-04:00,30.42999,30.55,29.92999,30.07001,66706624,83207133.6,39.821883672888724,50.51862251190896,NaN,NaN,-172.11607586882255,-167.22350288552823,-0.2394967632372625,-0.11692086706045046,0.12257589617681201,189834874,263756768.4,27.50278263866585,52.358998737758085,NaN,NaN,-4.215960395185414,7.208708789976441
2003-08-11T09:30:00-04:00,30.08,30.60001,30.03,30.39999,63737296,82166092,43.93754249240806,49.81430572936059,NaN,NaN,-125.47136744487788,-180.99434576354446,-0.21514258734312633,-0.1463523380020959,0.06879024934103042,253572170,235030205.2,25.709129092866547,50.26789697522991,NaN,NaN,-5.470287986305433,5.397423536221888
2003-08-12T09:30:00-04:00,30.50999,30.89999,30.326,30.86,59770000,81348857.6,49.157772986535264,49.32231011644908,NaN,NaN,-66.55882365557348,-155.48452404930003,-0.15987011581625482,-0.13104739542928812,0.028822720386966712,313342170,240493578,26.68838579970391,48.20962757952215,NaN,NaN,-5.00217647863593,3.9117663912422
2003-08-13T09:30:00-04:00,30.98,31.06599,30.64999,30.87,58071600,80166956,49.26836247251487,49.15059100655708,NaN,NaN,-36.32162271154214,-118.77002537728143,-0.11647034042681584,-0.11676520514655309,-0.0002948647197372478,371413770,276940896.4,33.03041371210327,46.5116239829007,NaN,NaN,-4.59229948803535,2.696899837059693
2003-08-14T09:30:00-04:00,30.88,31.19,30.67,30.89999,51191200,77201681.6,49.62226936685821,48.623206404460696,NaN,NaN,-24.900634549307473,-85.0737048460247,-0.08124605433954504,-0.10185243264416854,-0.02060637830462351,422604970,310153590.8,38.270865912224785,45.08903774657454,NaN,NaN,-4.1571713532050465,1.7177468098790158
2003-08-15T09:30:00-04:00,31,31.28999,30.92999,31.17,28131296,74578864.8,52.8138977127254,48.271714367498525,NaN,NaN,7.199709811025692,-49.21054771005504,-0.037489829981644025,-0.06746866578167854,-0.029978835800034513,450736266,362333869.2,45.48808006552162,43.78190369974127,NaN,NaN,-2.893794459873592,1.0589551999143576
2003-08-18T09:30:00-04:00,31.31,32.00999,31.05,31.97,67352688,72349915.2,60.74849437669668,48.678503185297,NaN,NaN,79.43694230736773,-8.228885759605905,0.04322844496126463,0.024056720401546272,-0.019171724559718356,518088954,415237226,51.65908375378725,42.84146843821351,NaN,NaN,0.7780499385826508,1.018825876866971
2003-08-19T09:30:00-04:00,32.11,32.38,31.84599,32.37,68390816,71188921.6,64.00744730331763,49.49792146105667,NaN,NaN,134.6855205102293,32.019983073554656,0.11725683988645937,0.12739932529835585,0.010142485411896485,586479770,469864746,57.0641092107366,42.53628957317617,NaN,NaN,4.961719971211161,1.5820964617732838
2003-08-20T09:30:00-04:00,32.10001,32.52,32.02,32.28999,58280304,70643455.2,62.88278408701359,49.981872359020755,NaN,NaN,129.3359135497375,65.15149032581057,0.1523110879671244,0.20053134537080197,0.04822025740367758,528199466,501221885.2,59.839903311093195,42.267350682983626,NaN,NaN,8.02273902167577,2.5021882560450677
2003-08-21T09:30:00-04:00,32.59,32.82001,32.27,32.64,77253808,70325370.4,65.7203697321599,50.93945689093926,NaN,NaN,145.08353324616297,99.14832388490467,0.18819521826757754,0.2834642802381495,0.09526906197057197,605453274,537791546,62.8558674466335,42.42855021243211,NaN,NaN,11.527912966720683,3.791577500427298
2003-08-22T09:30:00-04:00,33.25999,33.37,32.33,32.44,93034368,70824307.2,62.76751068391476,51.69411590248851,NaN,NaN,140.28671262039936,125.7657244467794,0.1871891090130794,0.3292554482369212,0.14206633922384182,512418906,550128074,63.842347591706734,43.26905515567338,NaN,NaN,13.608949026998859,5.194059147080378
2003-08-25T09:30:00-04:00,32.36,32.50999,32.21001,32.50999,43082304,70167472,63.3874699299228,53.32085587924198,NaN,NaN,102.47783808494397,130.37390360229466,0.17991714340810452,0.36696276848397247,0.18704562507586794,555501210,557610525.2,64.45889249589277,44.70053651128071,NaN,NaN,15.499813399755851,6.666309754605446
2003-08-26T09:30:00-04:00,32.28,32.59,31.81,32.53999,79913312,70133056,63.6667342473016,54.97869247494402,NaN,NaN,85.89603823096667,120.61600714644212,0.16613693294643206,0.394716791258908,0.22857985831247596,635414522,567397475.6,65.2925269577706,46.6837240876716,NaN,NaN,17.14241374893119,8.162896039509123
2003-08-27T09:30:00-04:00,32.49001,32.83,32.37,32.8,47272000,69664540.8,66.08150423801466,56.70600309301943,NaN,NaN,104.96763902881452,115.74235224225751,0.16329990327582716,0.4327047374072599,0.26940483413143274,682686522,598294886.8,67.85586473870148,49.254160909100506,NaN,NaN,19.253250612256455,9.747232407044455
2003-08-28T09:30:00-04:00,32.94,33.12,32.52,33.09,55356800,68146824.8,68.58902951372137,58.76079922450748,NaN,NaN,113.97074652626677,109.51979489827826,0.16901226732987545,0.48067016829377707,0.3116579009639016,738043322,624812896.4,69.9099092709532,52.28324138283532,NaN,NaN,21.82166316832897,11.472151087227957
2003-08-29T09:30:00-04:00,33.03999,33.46001,32.98,33.39,53194608,67128073.6,70.97918564408572,60.692345163913025,NaN,NaN,123.35203142454743,106.13285865910788,0.18003673767157652,0.5367038230533723,0.35666708538179576,791237930,680576701.2,73.71383092237758,55.712148656371824,NaN,NaN,24.76652953896073,13.371348008904066
2003-09-02T09:30:00-04:00,33.49001,33.89,33.13,33.87,80504320,66331773.6,74.34316049079824,62.491301414217524,NaN,NaN,129.15116849942868,111.46752474200483,0.20488965171372653,0.6127791500239539,0.40788949831022736,871742250,743824909.2,77.22987275783771,59.32225486766709,NaN,NaN,28.452993887416817,15.525868848691601
2003-09-03T09:30:00-04:00,34.10001,34.2,33.64999,33.85001,85258000,65035689.6,73.95866746857332,64.25489462822169,NaN,NaN,131.05013863992127,120.49834482379575,0.2047319568508999,0.6638044443738522,0.4590724875229523,786484250,774038854.8,78.69587406826366,62.5840734645357,NaN,NaN,31.333385094415473,17.784085455223583
2003-09-04T09:30:00-04:00,33.83,34.22,33.7,34.16,63903104,63388438.4,76.02905731677491,66.14109376750146,NaN,NaN,127.91113164035991,125.08704334610483,0.20949829065160674,0.7209453508374608,0.5114470601858541,850387354,807579021.2,80.21842627582345,65.58032777622131,NaN,NaN,34.4640907017568,20.16694334758547
2003-09-05T09:30:00-04:00,33.966,34.34,33.67,33.94,91046688,64572556.8,71.67384521017352,67.48823287446204,NaN,NaN,118.14255897090182,125.92140583503185,0.18280083850223505,0.7399481083136479,0.5571472698114128,759340666,811838490,80.40990473870026,68.0747438243055,NaN,NaN,35.88455176335078,22.412315978409083
2003-09-08T09:30:00-04:00,34,34.53,33.95,34.5,69355008,64704976,75.5181970858637,68.54321163940254,NaN,NaN,131.0024957663019,127.45149870338273,0.18714315712132645,0.7910762162130709,0.6039330590917444,828695674,819330038.8,80.7626053423544,70.15356679491744,NaN,NaN,38.372300148475375,24.692313716989982
2003-09-09T09:30:00-04:00,34.33,34.386,33.92,34.09,88014688,65918845.6,68.21829732474686,68.84398664093321,NaN,NaN,108.12818856165434,123.24690271582787,0.1483833001870607,0.7894121843255704,0.6410288841385097,740680986,793117786,75.63173393165982,71.47982570355481,NaN,NaN,38.204772114125994,26.62266491658084
2003-09-10T09:30:00-04:00,33.75,33.89,33.11,33.27,111708880,68515789.6,56.46276938209362,68.38541416201035,NaN,NaN,50.24541685514078,107.08595835887179,0.058136252670758504,0.7136991999769577,0.6555629473061992,628972106,761615357.2,69.88539047109766,72.19736050069798,NaN,NaN,33.92994903425369,27.66656264767696
2003-09-11T09:30:00-04:00,33.278,33.78,33.00999,33.64,96963120,70460365.6,59.82673070332253,67.96443994566484,NaN,NaN,47.58666945621184,91.02106592204215,0.016159446590678916,0.6757622555445479,0.659602808953869,725935226,736724931.6,65.64173110484396,72.39635076199873,NaN,NaN,31.569388648100844,28.22410921916609
2003-09-12T09:30:00-04:00,33.34,33.84,33.05,33.82001,105031504,73152380.8,61.38977787409791,67.86603045924934,NaN,NaN,48.33138988800286,77.05883210546236,-0.00552356236527074,0.6526983559972805,0.6582219183625513,830966730,751050144.4,66.88794806565141,72.61389365299478,NaN,NaN,30.19720446826032,28.505979969036694
2003-09-15T09:30:00-04:00,33.84,33.91,33.444,33.49001,54625008,74477066.4,57.0106006937328,67.41053979952149,NaN,NaN,46.045138403409815,60.06736063288393,-0.045885210688767386,0.600865405001592,0.6467506156903594,776341722,740579354,65.03122394772731,72.65477447098297,NaN,NaN,27.627064202243503,28.380420573780523
2003-09-16T09:30:00-04:00,33.52,34.42999,33.52,34.39999,87608880,75489876,64.52538809686655,67.47187221734757,NaN,NaN,90.98112824886954,56.63794857032697,-0.016601235545483428,0.6259990712585051,0.6426003068039885,863950602,765233277.2,67.3307084066852,72.80035886019115,NaN,NaN,27.915459300248052,28.313997534704455
2003-09-17T09:30:00-04:00,34.33,34.50101,34.03,34.25999,79821680,76061419.2,62.709173057693754,67.2309914187532,NaN,NaN,99.81884240170373,66.55263367963957,-0.012169280321021048,0.6273887064027122,0.6395579867237332,784128922,796264640.4,70.00437619731123,72.95382396437756,NaN,NaN,27.532547957566457,28.2023618808276
2003-09-18T09:30:00-04:00,34.17,34.86,34,34.78,91633312,77729069.6,66.48290740307169,67.08055412513538,NaN,NaN,123.61389969972848,81.75807972834289,0.018601612413377655,0.6628100022404553,0.6442083898270776,875762234,826230042,72.35702169365813,73.12861770885648,NaN,NaN,28.481781133032726,28.242278916856904
2003-09-19T09:30:00-04:00,34.78999,34.86,34.36,34.58,69834496,77358104,63.80836250102327,66.56835247205949,NaN,NaN,119.74461295876486,96.04072434249528,0.018276426902594123,0.6670539234553203,0.6487774965527262,805927738,821222243.6,71.34985099711841,72.9597619999094,NaN,NaN,28.373184749595637,28.260979750105296
2003-09-22T09:30:00-04:00,34.13,34.2,33.77,33.92,97494688,77581120,55.826907262861596,65.2457629557783,NaN,NaN,38.58526864035916,94.54875038988516,-0.030919912289284368,0.6101276061911207,0.6410475184804051,708433050,807640509.2,68.5624354702981,72.34065933651372,NaN,NaN,25.575632237099867,27.877358676818805
2003-09-23T09:30:00-04:00,33.97,34.56,33.91,34.52,77858320,79319920.8,60.64619849556012,64.29487231484879,NaN,NaN,78.42813812767167,92.03815236564557,-0.027688061278535736,0.6064374418822354,0.6341255031607711,786291370,792108662.8,65.41512658659238,71.39203451639435,NaN,NaN,24.84927437336829,27.4447752048973
2003-09-24T09:30:00-04:00,34.50999,34.8,33.17,33.22,115575808,81103045.6,48.34034149391475,62.317106898930206,NaN,NaN,-15.262754753336296,69.02183293463757,-0.11295510988316282,0.49293161580681755,0.6058867256899804,670715562,769425990.8,61.010458106598,70.0200367900211,NaN,NaN,19.457805955509258,26.303779597841867
2003-09-25T09:30:00-04:00,33.38,33.98,32.75999,32.78999,117989120,84638901.6,45.08175689749597,60.41767201945323,NaN,NaN,-116.85351741806066,20.92834951107975,-0.19344353778451717,0.3640823034593339,0.5575258412438511,552726442,704818832.4,50.5664217775952,67.88835943565645,NaN,NaN,14.050965831747622,24.553377631256975
2003-09-26T09:30:00-04:00,32.89,33.17,32.52,32.58,106691680,87205645.6,43.53829660422632,58.13339341362199,NaN,NaN,-184.37737111945594,-39.89604730456441,-0.2522354230695438,0.24223156240692134,0.4944669854764651,446034762,632840237.2,41.95038657382779,65.1160580950474,NaN,NaN,9.34889336936851,22.381308450987195
2003-09-29T09:30:00-04:00,32.75999,33.17,32.45,33.14,97110320,89401431.2,48.59295028826477,56.73158291101612,NaN,NaN,-146.29407746456647,-76.87191652554952,-0.24463250948478588,0.18867634862048277,0.43330885810526865,543145082,599782643.6,38.689810081133395,62.47734924858123,NaN,NaN,7.194113196216661,20.211709128877118
2003-09-30T09:30:00-04:00,32.92,32.96001,32.35699,32.42,119186320,91335531.2,43.23386526944475,55.78666118868406,NaN,NaN,-169.220263893921,-126.40159692986806,-0.27694222225621684,0.08713108028499761,0.36407330254121445,423958762,527316122,32.691322329987756,59.82063009564481,NaN,NaN,3.501871189559381,17.8245894232603
2003-10-01T09:30:00-04:00,32.61,33.23,32.42,33.14999,106833680,92414315.2,49.33479823832754,55.03723744118441,NaN,NaN,-104.08439870846988,-144.1659257208948,-0.23940848575573442,0.06481269534654643,0.30422118110228086,530792442,499331498,30.71112852344926,57.32558705411662,NaN,NaN,2.572167345951317,15.64567198364473
2003-10-02T09:30:00-04:00,33.10001,33.42999,32.92999,33.25999,83940688,93416194.4,50.20329458897068,54.23820292081818,NaN,NaN,-61.38274823746727,-133.0717718847761,-0.19908646185691842,0.05536310378113285,0.25444956563805127,614733130,511732835.6,32.65781560729535,54.880577592805466,NaN,NaN,2.1427371982414694,13.716681300015694
2003-10-03T09:30:00-04:00,33.85001,34.47,33.82001,34.19,112935872,94510653.6,56.92611998507606,54.23216858448556,NaN,NaN,59.44999224167921,-84.30629921254906,-0.10634565973194587,0.12151749097311892,0.2278631507050648,727669002,568059683.6,40.794151530085976,53.14935813440252,NaN,NaN,4.098144365046432,12.342604595020084
2003-10-06T09:30:00-04:00,34.28,34.45,34.06,34.44,49243904,93505098.4,58.54625808226174,53.80508786915664,NaN,NaN,79.46002311514337,-39.155479096607095,-0.028765675332217633,0.19190605653979276,0.2206717318720104,776912906,614813248.4,46.565141255581466,51.6661033378951,NaN,NaN,6.181397049398109,11.46243208850266
2003-10-07T09:30:00-04:00,34.16,34.64999,34.00999,34.64999,80178624,93113295.2,59.91025874708949,53.60516541839918,NaN,NaN,90.14492387057633,12.717558456292366,0.032757149317534845,0.26161816851892894,0.2288610192013941,857091530,701439802,55.26570308655993,50.61334097284144,NaN,NaN,8.283952386539932,11.00836355965084
2003-10-08T09:30:00-04:00,34.81,34.84,34.22,34.42999,71430496,91099376,57.76573958368052,52.982510574156954,NaN,NaN,87.21479289940798,50.97739677786793,0.0534749117507505,0.2957046588898322,0.2422297471390817,785661034,752413520.4,59.44974637532656,49.69139273581776,NaN,NaN,9.354571608366799,10.772107566610263
2003-10-09T09:30:00-04:00,34.91,35.27,34.42999,34.69,118275120,92164976,59.6060744358646,52.682347140931334,NaN,NaN,108.89594762936689,85.03313595123475,0.07804202903920693,0.33978228343809036,0.26174025439888343,903936154,810254125.2,63.6090458335125,49.13847808127448,NaN,NaN,10.79252484446411,10.775024320589385
2003-10-10T09:30:00-04:00,34.77,35.03,34.64,35.00999,68398192,90333310.4,61.811515322827006,53.10981914521459,NaN,NaN,107.37385690416612,94.61790888373214,0.10738390839835887,0.39597013989683205,0.2885862314984732,972334346,859187194,66.71915262160724,49.00681502065371,NaN,NaN,12.659279314270474,11.044203605400968
2003-10-13T09:30:00-04:00,35.14,35.37,34.92,35.24001,60980608,90651090.4,63.360142966698,53.303672321724434,NaN,NaN,123.87765140152722,103.50143454100892,0.132193941457306,0.45382865832010566,0.32163471686279965,1033314954,910467603.6,69.64680793573778,49.3090779741641,NaN,NaN,14.672808394754167,11.56257571816571
2003-10-14T09:30:00-04:00,35.10001,35.42999,34.96001,35.33,64216896,89481491.2,63.97563753031793,54.42047918146751,NaN,NaN,116.54877704924144,108.78220517674193,0.14362523392508997,0.5011662592691621,0.35754102534407217,1097531850,958555667.6,72.12330251414588,50.10285257470322,NaN,NaN,16.51120015318494,12.269522066025601
2003-10-15T09:30:00-04:00,35.8,35.85001,35.03,35.17999,97791120,90379963.2,62.10283277168181,55.63627031533793,NaN,NaN,114.98136070609722,114.33551873807978,0.13042815346237607,0.5205762171720423,0.3901480637096662,999740730,1001371606.8,74.14592521720746,51.78710282038982,NaN,NaN,17.564943737870635,13.026010876289178
2003-10-16T09:30:00-04:00,35.10001,35.53,35,35.46001,74087632,89502679.2,64.20905673535529,57.11275318184715,NaN,NaN,104.88176874908069,113.53268296202255,0.12963253656957413,0.5521887344216339,0.4225561978520597,1073828362,1035350048.4,75.65550800892873,54.1946114943256,NaN,NaN,19.055505490521455,13.887367249750932
2003-10-17T09:30:00-04:00,35.41299,35.49001,34.60001,34.61,98011008,90911504.8,54.33689452751977,57.523034913222496,NaN,NaN,65.29823236210501,105.11755805361031,0.06424029092164046,0.5028565615041103,0.4386162705824698,975817354,1036046650,75.68685059659829,56.83725724543023,NaN,NaN,17.533225858355973,14.408204193837367
2003-10-20T09:30:00-04:00,34.64999,35.67999,34.08,35.03999,76162192,89844880,57.866022864495626,58.5681890271547,NaN,NaN,62.4729837848426,92.83662453027338,0.043328292456210726,0.49277663615273326,0.44944834369652253,1051979546,1039779568.4,75.86616254459328,59.92117440361634,NaN,NaN,17.279393565971553,14.81837410414225
2003-10-21T09:30:00-04:00,35.14,35.45,34.939,35.25,75015184,89702723.2,59.51189379297097,59.295124423914956,NaN,NaN,78.62086810633517,85.25104274169215,0.037254529084647214,0.4960165050523315,0.4587619759676843,1126994730,1045672144.4,76.16499287521492,63.167879000171034,NaN,NaN,17.55085209660581,15.208728103065615
2003-10-22T09:30:00-04:00,34.89,34.92999,34.44,34.57001,88815184,88364692,52.37752542094288,59.450426626198684,NaN,NaN,30.430063119105245,68.34078322429374,-0.016083150687428716,0.4386580376083984,0.4547411882958271,1038179546,1053359907.6,76.57256319985946,66.30464668535419,NaN,NaN,15.58584105122075,15.262601381373491
2003-10-23T09:30:00-04:00,34.14999,34.507,34.05,34.17,99351376,87432804.8,48.68044178071816,58.86144961160169,NaN,NaN,-7.488084622190611,45.86681255003949,-0.07834456202575657,0.3568104857636314,0.43515504778938796,938828170,1026359869.2,71.92106913113331,68.52799794257184,NaN,NaN,12.773641629591584,14.907035702547505
2003-10-24T09:30:00-04:00,33.78999,34.23,33.49001,34.2,101828496,87189645.6,48.971354979437756,58.177527961399974,NaN,NaN,-40.78625519515913,24.64991503858666,-0.11531455264138335,0.29101185698765875,0.4063264096290421,1040656666,1039327731.6,72.7764370269546,70.4002333548128,NaN,NaN,10.601235397536495,14.291921373260218
2003-10-27T09:30:00-05:00,34.28,34.45,34.03999,34.21001,63646096,85516434.4,49.07508592280162,57.40358704537941,NaN,NaN,-24.42863139058392,7.269592003501356,-0.13550723263468595,0.23694236883568465,0.3724496014703706,1104302762,1049792374.8,73.47855529241366,71.70115136951662,NaN,NaN,8.85868527157693,13.515744787305461
2003-10-28T09:30:00-05:00,34.42999,35.41,34.37,35.36,107497376,84931987.2,59.30891635024472,57.51381395727686,NaN,NaN,60.415288594381146,3.6284761011105573,-0.07106597691603633,0.2836171303253252,0.35468310724136154,1211800138,1066753456.4,74.62104637935454,72.78481565551863,NaN,NaN,10.383223712899957,13.068241776676103
2003-10-29T09:30:00-05:00,35.2,35.41,35.07001,35.32001,74110880,83295847.2,58.86590610641654,57.46094479088771,NaN,NaN,84.49362382975166,14.441188243239832,-0.032735696887020105,0.3137634861325864,0.3464991830196065,1137689258,1086655398.8,75.93124138345647,73.66497248051462,NaN,NaN,11.463818175691355,12.839038405106853
2003-10-30T09:30:00-05:00,35.81,36,35.14,35.39,95149632,83856294.4,59.436981331724624,57.29133522009469,NaN,NaN,117.77774234524294,39.494353636726544,-0.005687329241883032,0.3393900214672527,0.34507735070913576,1232838890,1145457542.8,79.32707588983791,74.56553842824539,NaN,NaN,12.509734411733527,12.791994977482092
2003-10-31T09:30:00-05:00,35.44,35.49001,35.06,35.17999,55497200,80984360.8,56.88499820698812,56.828824880115405,NaN,NaN,67.58680378731967,61.1689654332223,-0.004984149134443394,0.3388471642910815,0.3438313134255249,1177341690,1172794547.6,80.69101423493316,75.35441030675933,NaN,NaN,12.68065765083542,12.776089645103996
2003-11-03T09:30:00-05:00,35.42999,35.98,35.36,35.75999,71175248,82080928,61.76734090808762,56.67108940709896,NaN,NaN,136.04496583414988,93.26368487816906,0.02959746842894362,0.38082814896170447,0.35123068053276085,1248516938,1201637382.8,82.03758521984844,76.06257335716667,NaN,NaN,14.286918707638371,12.991922368323193
2003-11-04T09:30:00-05:00,35.69,35.87,35.446,35.52,60072512,81075622.4,58.80026296237849,56.43519156357729,NaN,NaN,109.12618031773388,103.00586322283962,0.03120330394788562,0.3902348104676179,0.35903150651973226,1188444426,1196966240.4,81.05175516196842,76.55584692464959,NaN,NaN,14.775737507539354,13.24675310249693
2003-11-05T09:30:00-05:00,35.52,35.89,35.14999,35.84,68430496,80925622.4,61.458766119539284,56.23874223387615,NaN,NaN,102.90649141456328,106.68843673980193,0.047722512496780556,0.41868464714070797,0.3709621346439274,1256874922,1220803373.2,82.225572198118,77.0251372238774,NaN,NaN,15.974856700388457,13.636482187910005
2003-11-06T09:30:00-05:00,35.78999,35.966,35.34,35.939,90631632,79543448,62.269914719224246,56.80538653328362,NaN,NaN,112.16016593069138,105.56492145689162,0.05851069716901891,0.444100506105201,0.3855898089361821,1347506554,1243736906,83.2976136403607,77.56876315557471,NaN,NaN,17.196524637698204,14.14505968073689
2003-11-07T09:30:00-05:00,36.08,36.17999,35.60001,35.63,63605808,79303828.8,58.15580518895766,56.82608527074519,NaN,NaN,110.45380737014072,114.13832217345585,0.03897028808465236,0.43430266904199755,0.3953323809573452,1283900746,1265048717.2,84.24838298832208,78.16749318726963,NaN,NaN,17.09086087843306,14.565888423264914
2003-11-10T09:30:00-05:00,35.7,35.743,35.09,35.19,68950496,79702323.2,52.80575657157284,56.34707546921675,NaN,NaN,31.652188842919703,93.2597667752098,-0.00700409060019902,0.38657726770709644,0.39358135830729546,1214950250,1258335379.6,82.65230385135736,78.63087254270837,NaN,NaN,15.424703838285971,14.688576339696494
2003-11-11T09:30:00-05:00,35.149,35.3,34.85001,35.06,75928496,80287903.2,51.30402788240231,56.27039707360671,NaN,NaN,-11.406283906422017,69.15327393037862,-0.047337276897088554,0.33440976218593477,0.3817470390830233,1139021754,1248450845.2,80.24186416366331,78.89296546869436,NaN,NaN,13.608774491640144,14.534318932831301
2003-11-12T09:30:00-05:00,35.17,35.963,35.14,35.81,81156192,79456156.8,58.61615369477338,56.98009078175351,NaN,NaN,77.05884607902298,63.98374486327056,-0.025752905431198403,0.3495559072940253,0.3753088127252237,1220177946,1241111450,78.41326061303201,79.35669343168713,NaN,NaN,14.167094307883287,14.481858272124441
2003-11-13T09:30:00-05:00,35.71001,35.89999,35.55,35.77,64326000,78968075.2,58.11494126843607,57.63320408811053,NaN,NaN,86.69607459040412,58.8909265952131,-0.01684855505595889,0.3542481189052751,0.37109667396123397,1155851946,1202780528.4,69.50472083461557,79.12299941794863,NaN,NaN,14.469110207640295,14.480037120055277
2003-11-14T09:30:00-05:00,35.811,36.02,34.95,35.03999,91047872,78619918.4,49.753491633046785,57.68166163884233,NaN,NaN,22.146335609852102,41.22943224315538,-0.060355001953661946,0.29565292151915656,0.3560079234728185,1064804074,1158961194,60.97611644209629,78.22996807149738,NaN,NaN,12.100750789399243,14.1401390728187
2003-11-17T09:30:00-05:00,34.84,34.91,34.256,34.67999,108519312,80237774.4,46.221677404121124,56.74685885697636,NaN,NaN,-84.93715233425154,17.911564007721125,-0.11068010633161574,0.2176577905582988,0.32833789688991455,956284762,1107228096.4,52.74707190870015,76.6675413235935,NaN,NaN,8.988701526366976,13.404219423325596
2003-11-18T09:30:00-05:00,34.87,34.97,33.82001,33.88,108732000,81923615.2,39.50977563420995,55.36427810896159,NaN,NaN,-121.10467441294823,-4.028114093584113,-0.1904677595415719,0.09025319746294969,0.2807209570045216,847552762,1048934298,45.32439991637257,74.48133836165893,NaN,NaN,3.912280503505556,12.04822814906559
2003-11-19T09:30:00-05:00,34.00999,34.39999,33.88,34.21001,86402496,81802980.8,43.17552324607631,54.20274538855814,NaN,NaN,-118.98020093779965,-43.235923496948644,-0.21199129228527563,0.01573184164792707,0.2277231339332027,933955258,991689760.4,39.45303925935977,71.63319288805334,NaN,NaN,0.9687967903609898,10.46545224067922
2003-11-20T09:30:00-05:00,33.89,34.67999,33.81,33.882,117403184,82705571.2,40.545470963868134,53.03563629976386,NaN,NaN,-121.56241662770213,-84.8876217405699,-0.23737783204069793,-0.06899915611766971,0.16837867592302821,816552074,923829786,33.854359571588375,68.2877175549573,NaN,NaN,-2.3035709490316343,8.641306070720526
2003-11-21T09:30:00-05:00,34.08,34.265,33.73,34.23199,81824368,81705364.8,44.43486865888897,51.797602567678254,NaN,NaN,-129.7011120666828,-115.25711127587688,-0.22004541722473464,-0.1066780956078901,0.11336732161684454,898376442,890544259.6,31.493589248457,64.67743212842933,NaN,NaN,-3.789537349947635,6.8654712963393605
2003-11-24T09:30:00-05:00,34.52,35.25,34.47,35.17999,92188496,83132484.8,53.33895314784154,51.40750900949704,NaN,NaN,-24.148249328815805,-103.09933067478974,-0.13818105395614783,-0.059358995828340255,0.07882205812780757,990564938,897400294.8,32.53712249064928,61.212101223335104,NaN,NaN,-2.0686648406000376,5.589166133919447
2003-11-25T09:30:00-05:00,35.28999,35.45,35.09,35.17999,72575008,81386366.4,53.338953147841536,50.827522368661484,NaN,NaN,12.125719531923359,-76.45325188581543,-0.08034498351206767,-0.021609171262277016,0.05873581224979065,990564938,926002730,36.85833625020031,57.971584369912414,NaN,NaN,-0.7446494476480576,4.68433533655266
2003-11-26T09:30:00-05:00,35.39999,35.52,34.81,35.34,72865632,81324104,54.75812718097227,50.29096611592921,NaN,NaN,10.155543481320153,-50.62610300199146,-0.030206657030240898,0.02097749096198953,0.05118414799223043,1063430570,951897792.4,40.569812005564295,54.91959853885553,NaN,NaN,0.765256428421243,4.124466921105315
2003-11-28T09:30:00-05:00,35.25999,35.5,35.20799,35.38,24809104,77807077.6,55.12555985294233,50.07452002049954,NaN,NaN,30.809904522037492,-20.151638772043537,0.004888627989084196,0.05729493297858568,0.05240630498950148,1088239674,1006235312.4,47.53832754629315,52.29745172156775,NaN,NaN,2.0914322196070665,3.8340333923198506
2003-12-01T09:30:00-05:00,35.71001,36.00999,35.47,35.89999,82815872,79173011.2,59.706852869559945,50.56745547035575,NaN,NaN,83.87957004589128,22.5644976504713,0.059336171502720095,0.1265765193679016,0.0672403478651815,1171055546,1060771133.2,53.43924943299523,50.210804977399015,NaN,NaN,4.655932415647546,3.9514475385095214
2003-12-02T09:30:00-05:00,35.82001,36.05,35.58,35.7,65084608,78868479.2,57.28457108019049,50.994637127340624,NaN,NaN,80.68393207032216,43.53093393029889,0.07697642479098371,0.16346087885391114,0.08648445406292743,1105970938,1083852333.2,55.70987664172983,48.45852015440378,NaN,NaN,6.090840391434781,4.257075088927415
2003-12-03T09:30:00-05:00,35.84,36.12,35.25,35.25,107817184,81255712.8,52.157104114944254,50.533276443067116,NaN,NaN,49.73314126856011,51.052418277626245,0.05449135144130453,0.15459864336455809,0.10010729192325356,998153754,1085370096.4,55.86230502100807,46.84773761211636,NaN,NaN,5.81724237823663,4.479956130257303
2003-12-04T09:30:00-05:00,35.38,35.71001,35.08,35.63,102447184,82956547.2,55.75834625973522,50.36494822815992,NaN,NaN,42.252230257306145,57.471755632823445,0.06087966956779202,0.17620687888299358,0.11532720931520156,1100600938,1092804170,56.649283298860254,45.92949207384812,NaN,NaN,6.670302412082113,4.7928627419465615
2003-12-05T09:30:00-05:00,35.27,35.5,34.95799,35.03999,87631184,82806524.8,49.52501841093071,50.348628712294484,NaN,NaN,4.59560116122296,52.22889496066053,0.022987854747198902,0.14406202774920018,0.12107417300200128,1012969754,1077750186,54.52901873222706,45.468985094571735,NaN,NaN,5.468511527278189,4.889383996993937
2003-12-08T09:30:00-05:00,35.02,35.33,34.78,35.235,87125680,83982518.4,51.45664026094146,50.72255463063879,NaN,NaN,2.364045061153202,35.925789963712916,0.009374210469456315,0.13279193608882167,0.12341772561936536,1100095434,1063558163.6,52.532819573580056,45.45368135634887,NaN,NaN,5.070243006615327,4.915220998368421
2003-12-09T09:30:00-05:00,35.45,35.46001,34.35001,34.42999,109997120,86034849.6,43.97523492942499,51.04151600886843,NaN,NaN,-47.077243330281284,10.37355488359223,-0.05214900302262605,0.058231471841082794,0.11038047486370885,990098314,1040383638.8,49.35548572741714,45.74161605713777,NaN,NaN,2.2601242542184745,4.535921463489857
2003-12-10T09:30:00-05:00,34.53,34.7,34.13,34.56,103567376,87416793.6,45.35700698047684,51.19733627561133,NaN,NaN,-77.7887668666239,-15.130826743444572,-0.08068620767278843,0.009522715272723303,0.09020892294551174,1093665690,1059486026,51.93604101386202,46.633259039602216,NaN,NaN,0.44056129848065434,3.9508700113456854
2003-12-11T09:30:00-05:00,34.5,35.39,34.493,35.3,108425376,88780252.8,52.53308298552624,52.05359427715833,NaN,NaN,7.182927426094083,-22.144687309686987,-0.04794041666219549,0.030283402117767366,0.07822381877996286,1202091066,1079784051.6,54.58416835024871,48.113959666649386,NaN,NaN,1.166454802491388,3.553096410080786
2003-12-12T09:30:00-05:00,35.28999,35.34,34.89999,35.24001,72224624,89175184,51.937604207431775,52.5895039591971,NaN,NaN,26.63637978100882,-17.73653158572982,-0.02944444666556087,0.04141826044801178,0.07086270711357265,1129866442,1103163389.2,57.489392998251226,49.97080279163468,NaN,NaN,1.5569533720606217,3.2679331189350482
2003-12-15T09:30:00-05:00,35.92999,35.99001,34.64999,34.78,106241808,89934880.8,47.49203595927212,52.17186701715644,NaN,NaN,25.570601583498874,-13.095220281260685,-0.046310809756320445,0.012974194918172088,0.059285004674492534,1023624634,1087869229.2,55.01029042094494,51.57602907237008,NaN,NaN,0.5086101118498604,2.8737441179228784
2003-12-16T09:30:00-05:00,34.78999,35.02299,34.42,34.85001,89884880,89003159.2,48.218472555299414,51.806118403403424,NaN,NaN,-33.23924795928618,-10.327621207061666,-0.050527245640682616,-0.003874052376360737,0.04665319326432188,1113509514,1112551469.2,58.14701801988941,53.09664919877645,NaN,NaN,-0.12070884169329504,2.4459651236919964
2003-12-17T09:30:00-05:00,34.81,35,34.57401,34.91,68579808,86995549.6,48.87121443904272,51.385624636122735,NaN,NaN,-30.64319144717208,-0.8985061231713019,-0.047118210863518285,-0.012244570315075975,0.03487364054844231,1182089322,1130236195.6,60.28365783399685,54.50478104366449,NaN,NaN,-0.4513331596981039,2.032065368921982
2003-12-18T09:30:00-05:00,34.95,35.64,34.94901,35.56,90025632,87176706.4,55.42743332892391,51.40718702726428,NaN,NaN,59.059230544393415,9.476754500488564,-0.0013479342791600513,0.033188722699492246,0.0345366569786523,1272114954,1144240973.2,61.94068062692617,55.53352054942398,NaN,NaN,1.226271820128773,1.9169520048086666
2003-12-19T09:30:00-05:00,35.61,35.64999,35.2,35.46001,89768368,85794965.6,54.27448050370959,51.01916042970354,NaN,NaN,65.4324381218461,17.235966168656024,0.020714656994243595,0.06042997822145679,0.0397153212272132,1182346586,1154737002,63.180533660258966,56.22932656565711,NaN,NaN,2.2681491140018446,1.967123020407692
2003-12-22T09:30:00-05:00,35.35001,35.67999,35.28999,35.57001,63610608,84884277.6,55.37422881570766,50.8827074108119,NaN,NaN,76.44476234182797,27.410798320321838,0.04011503124930284,0.08985911028884175,0.04974407903953891,1245957194,1199203514,67.94484187210739,57.10325265354122,NaN,NaN,3.4442358982998336,2.178139145820855
2003-12-23T09:30:00-05:00,35.60001,36.02,35.53,35.84,67049184,83627312,58.04165657328819,51.303032586407895,NaN,NaN,128.8313238900622,59.824912690191525,0.06694853754047117,0.13342975096512788,0.06648121342465671,1313006378,1239102886.8,71.50747415008148,58.22076473418932,NaN,NaN,5.215912635123137,2.6121067871497523
2003-12-24T09:30:00-05:00,35.84,36.02,35.8,35.89999,44840304,82240576.8,58.63331830845176,51.508387732744794,NaN,NaN,131.79155865076257,92.31186270977847,0.08348003158705694,0.1708312529084779,0.08735122132142095,1357846682,1274254358.8,74.22534075786513,59.47619740983253,NaN,NaN,6.85281468754977,3.217922201492612
2003-12-26T09:30:00-05:00,35.96001,36.09,35.82001,35.85001,25499008,79872245.6,57.90076118486043,52.10665507373977,NaN,NaN,117.76722324890063,104.0534612506799,0.08547951933868399,0.19420062049477593,0.10872110115609195,1332347674,1286300902.8,75.10187223462204,60.945686945717874,NaN,NaN,8.039280485208563,3.9066876705948905
2003-12-29T09:30:00-05:00,36.03,36.53,36.02,36.44,63368096,81800195.2,63.670882600011545,52.97910095510191,NaN,NaN,167.110017416319,124.38897710957448,0.11891237582251546,0.2573615709342363,0.13844919511172082,1395715770,1328974739.6,77.96109796075241,62.761992544801615,NaN,NaN,10.814823938045267,4.893564280230659
2003-12-30T09:30:00-05:00,36.53,36.58,36.3,36.56,48266896,80072746.4,64.72974750821035,54.46156613930087,NaN,NaN,172.53236413983842,143.60649746917656,0.1400297641044327,0.3134864002422617,0.173456636137829,1443982666,1368579834,80.2302189605631,64.96733063288347,NaN,NaN,13.443374634253308,6.1149657593767515
2003-12-31T09:30:00-05:00,36.62,36.64,36.25,36.46001,60522608,79844646.4,63.07992626496473,55.72748894533572,NaN,NaN,150.24058803043104,147.88835029725035,0.13796264309833034,0.34590994001074193,0.2079472969124116,1383460058,1382670570,80.98051684236894,67.04193604920539,NaN,NaN,15.21796862118121,7.415394739634531
2004-01-02T09:30:00-05:00,36.66,36.78999,36.22,36.36,55259008,77216737.6,61.3944084776411,56.360440766201066,NaN,NaN,129.84083475470146,147.4982055180381,0.12115656160411015,0.3593929989175493,0.23823643731343913,1328201050,1376741443.6,79.6113742036615,68.82959361016346,NaN,NaN,16.283461195964207,8.682261376253056
2004-01-05T09:30:00-05:00,36.58,37.158,36.56,37.09,69748000,75581778.4,68.09566159642219,57.51458772255752,NaN,NaN,157.51909520716916,155.4485799096918,0.14868654661366365,0.4240946205805187,0.27540807396685507,1397949050,1389861718.8,80.40103085821207,70.46613917158922,NaN,NaN,19.329565557094227,10.203304830658936
2004-01-06T09:30:00-05:00,37.08,37.42,36.95,37.34,60068800,74203659.2,70.01524982414709,59.12338871290574,NaN,NaN,159.47715465239887,153.92200735690778,0.17159098652168964,0.4898968071189671,0.31830582059727747,1458017850,1402322134.8,81.14780049618345,72.3331041769634,NaN,NaN,22.493116557068504,11.958992220146017
2004-01-07T09:30:00-05:00,37.28,37.67999,37.07001,37.67999,71864816,73440616,72.44349887097826,60.85374773545423,NaN,NaN,156.6163388990864,150.73880230875739,0.19574739678338082,0.5629900665765035,0.3672426697931227,1529882666,1419502134.8,82.15726301396711,74.04812167654039,NaN,NaN,25.972143016571042,13.960870905349593
2004-01-08T09:30:00-05:00,37.85001,38,37.60001,37.979,78254816,71853500.8,74.4065259306025,62.67769855627993,NaN,NaN,165.22711072082674,153.73610684683655,0.21636080308942285,0.6376936736549013,0.4213328705654784,1608137482,1464437619.6,84.49572628528252,75.77755513734651,NaN,NaN,29.545636573711242,16.18726600082983
2004-01-09T09:30:00-05:00,37.71001,38.35001,37.59,37.73,94320000,71391132,69.93848879835173,63.71420251838191,NaN,NaN,145.35009596870805,156.83795908963788,0.19820708635060136,0.6690917285037301,0.47088464215312875,1513817482,1501560906,86.11478752827374,77.50427705887134,NaN,NaN,31.2258376440392,18.33563337843117
2004-01-12T09:30:00-05:00,37.85001,38.35001,37.67999,38.33,77691632,69854444.8,73.99133718196126,65.12254942397132,NaN,NaN,143.07878997950817,153.94989804410565,0.21043597829851846,0.7339296150262768,0.5234936367277584,1591509114,1540272918.8,87.57222295958388,79.24654058025168,NaN,NaN,34.03979551420088,20.579085112112555
2004-01-13T09:30:00-05:00,38.27,38.36,37.60001,37.94901,93054688,70895948,67.74567971318899,66.00622448807714,NaN,NaN,117.60106074275372,145.57467926217663,0.17798292584928843,0.7459722940393689,0.5679893681900805,1498454426,1548360234,87.85892916131355,80.66897538662354,NaN,NaN,34.40697889028141,22.55449850899382
2004-01-14T09:30:00-05:00,38.11,38.25,37.75,38.08,69028624,69035288.8,68.72320669855023,66.76919235416729,NaN,NaN,107.76349631155465,135.80411074467028,0.1514930473516667,0.7573556773796639,0.6058626300279972,1567483050,1555880310.8,88.13307670473887,81.85651842624192,NaN,NaN,35.0022186237741,24.332744239676718
2004-01-15T09:30:00-05:00,37.92999,38.46001,37.63,38.17999,104554128,69768751.2,69.48349577852159,67.54420503060085,NaN,NaN,99.7162386511874,122.70193633074243,0.1278057830871736,0.7656198588869643,0.6378140757997907,1672037178,1568660250,88.60402168780315,82.88356706409465,NaN,NaN,35.71059575057244,25.958151598376105
2004-01-16T09:30:00-05:00,38.38,38.63,38.17,38.57001,77353680,70207444.8,72.31085548052732,68.57349748029132,NaN,NaN,113.8302472811497,116.39796659323073,0.1253346104673635,0.794482338883995,0.6691477284166315,1749390858,1615774925.2,90.15516701720524,83.95880240570773,NaN,NaN,37.18215039942353,27.561579998525737
2004-01-20T09:30:00-05:00,38.73,39,38.30701,38.53999,82061872,69809256.8,71.75974878846628,69.15127363660953,NaN,NaN,112.86165143393008,110.35453888411512,0.10919918157878294,0.8056467053901102,0.6964475238113272,1667328986,1630938899.6,90.5987042815776,84.86148857148096,NaN,NaN,38.21344800615727,29.083275428187385
2004-01-21T09:30:00-05:00,38.39,38.66,38,38.38,112286624,70935169.6,68.75237955158134,69.43860449685032,NaN,NaN,85.81444377265326,103.99721549009503,0.07680183863652879,0.7924498221069882,0.7156479834704594,1555042362,1642256486.8,90.92724297907777,85.62556171566057,NaN,NaN,38.23143370367596,30.39015518182861
2004-01-22T09:30:00-05:00,38.55,38.69,38.06,38.14999,90937504,72301514.4,64.56319566344999,69.54455231102783,NaN,NaN,75.94836605265773,97.63418943831564,0.03126660551597671,0.7547312403654303,0.7234646348494536,1464104858,1621580848.4,85.07792200471559,85.91823351297104,NaN,NaN,37.04928528144007,31.341459481773104
2004-01-23T09:30:00-05:00,38.21001,38.46001,37.78,38.00999,88798000,73388955.2,62.083579599986976,69.59377881976681,NaN,NaN,53.89540248719511,88.47002220551721,-0.0144432054798449,0.7054106279996475,0.7198538334794924,1375306858,1562234784.4,70.96618252616554,85.30071982172134,NaN,NaN,35.34876799584552,31.913932126640592
2004-01-26T09:30:00-05:00,37.98,38.64999,37.84,38.59,84668128,75380346.4,67.63023405368432,69.56053399528552,NaN,NaN,72.36650749833154,80.17727424895358,-0.011883979569263792,0.7049988590179126,0.7168828385871764,1459974986,1504351610,60.436648503225676,83.87469251065089,NaN,NaN,35.41614455318164,32.414248187575026
2004-01-27T09:30:00-05:00,38.50999,38.63,37.69,37.74001,97342192,78972505.6,54.9450832347344,68.4840935246132,NaN,NaN,36.138133039588894,64.83257057008532,-0.07043698856948155,0.6288366028753245,0.699273591444806,1362632794,1443412371.6,51.7337994899856,81.7736924387796,NaN,NaN,31.132848693040067,32.23119111692718
2004-01-28T09:30:00-05:00,37.94,38.06,37.004,37.10001,128136128,82210907.2,47.69158743300582,66.7160998504723,NaN,NaN,-39.96999964274485,39.6756818870057,-0.15066290561504603,0.5109449594259985,0.6616078650410445,1234496666,1379303232.4,44.47758830967588,79.08228710275883,NaN,NaN,24.825904806475748,31.173293072576975
2004-01-29T09:30:00-05:00,37.23,37.31,36.66,37.24001,144018816,86998503.2,49.26927971865517,64.92058226390465,NaN,NaN,-86.66700382411547,7.152607911651072,-0.19014623739521663,0.4239250682970237,0.6140713056922403,1378515482,1362185357.2,42.75326225470458,76.1006825291461,NaN,NaN,20.428526412612573,29.638326406867776
2004-01-30T09:30:00-05:00,37.2,37.44,36.97,37.07001,84304880,88187616.8,47.39974996491624,63.31067234723067,NaN,NaN,-87.42583277048355,-21.111639139884655,-0.22137321859686798,0.33735478244615535,0.5587280010430233,1294210602,1345966106,41.126350633069784,72.88722275091725,NaN,NaN,16.29662388142315,27.732368903232828
2004-02-02T09:30:00-05:00,37.2,37.48,36.82001,36.97,94528320,90151082.4,46.28700800177901,61.331791691503376,NaN,NaN,-110.92338676690802,-57.76961799293257,-0.24081715661828973,0.2577065552701612,0.4985237118884509,1199682282,1293907565.2,36.34563572224526,69.22818080539307,NaN,NaN,12.63009496523693,25.57490119780484
2004-02-03T09:30:00-05:00,36.91,37.24001,36.72,36.92999,73805504,90353957.6,45.82354305943764,59.765924787664,NaN,NaN,-130.7780802754186,-91.15286065593406,-0.24747849724786164,0.18917559032862385,0.4366540875764855,1125876778,1246556362,32.630151095560976,65.28326808641074,NaN,NaN,9.529926463924918,23.28276195010771
2004-02-04T09:30:00-05:00,36.62,37.75999,36.32899,36.33,110027680,92851901.6,39.44514674802553,57.674634791197946,NaN,NaN,-142.2667274463008,-111.61220621664525,-0.28095131681877206,0.08546494155302042,0.3664162583717925,1015849098,1202826848.4,29.61881525430779,61.10367798280851,NaN,NaN,4.67980236835123,20.62519629557107
2004-02-05T09:30:00-05:00,36.50999,36.71001,36.33,36.47,96939872,94105654.4,41.49163612648084,55.675216244623606,NaN,NaN,-157.24428978722435,-125.72766340926702,-0.2816095735222575,0.014404291468970598,0.2960138649912281,1112788970,1149681546,26.426835101205953,56.66245036948013,NaN,NaN,1.318883604116029,17.867151625363206
2004-02-06T09:30:00-05:00,36.60001,37.28,36.53,37.131,107239008,95554864,50.07127691677758,54.08667491864149,NaN,NaN,-85.05788442691777,-125.25407374055388,-0.22777494300923765,0.011295186229681065,0.2390701292389187,1220027978,1134845021.2,25.597477818686116,52.0511868553002,NaN,NaN,1.0195889021849542,15.460356950623456
2004-02-09T09:30:00-05:00,37.34,37.38,37.05,37.12,58882496,93782988.8,49.940033993766576,52.528123861877226,NaN,NaN,-55.31894753450772,-114.13318589407382,-0.18497365169678848,0.007853064617933114,0.1928267163147216,1161145482,1127137661.2,25.15581279988595,47.37669460660794,NaN,NaN,0.7442551923991881,13.35805669944856
2004-02-10T09:30:00-05:00,37.05,37.41,37.03,37.17999,65095808,93153197.6,50.69898535626985,51.23859570506926,NaN,NaN,-47.475647050051684,-97.47269924900044,-0.14637954973737957,0.009852279142997133,0.1562318288803767,1226241290,1147210563.6,28.610580798814524,42.92550445087485,NaN,NaN,0.7404762731178255,11.555545209972742
2004-02-11T09:30:00-05:00,37.237,37.67,37,37.58,92485680,93124747.2,55.539327809802764,50.59403371552303,NaN,NaN,-21.20617180475003,-73.26058812069029,-0.09041268850142281,0.04321596825359819,0.133628656755021,1318726970,1207786138,37.92301987822283,39.557297156125365,NaN,NaN,2.19367502580166,10.218135183662588
2004-02-12T09:30:00-05:00,37.52,37.7,37.24001,37.24001,70728496,93209740.8,50.959730104320826,49.799473037261166,NaN,NaN,-20.86311511118427,-45.98435318548227,-0.07350979608341897,0.041741411650747295,0.11525120773416626,1247998474,1234828038.8,41.58628841340333,37.45873329092807,NaN,NaN,2.075023762226254,9.054833552028825
2004-02-13T09:30:00-05:00,37.39,37.58,36.75999,36.94,90596880,92511878.4,47.25680176907653,48.34422787407489,NaN,NaN,-51.665890559939946,-39.305954412086706,-0.07925854618271565,0.0161780250057717,0.09543657118848735,1157401594,1222302762,40.39717315904711,36.02734219491532,NaN,NaN,0.8518976271887783,7.8829855627659615
2004-02-17T09:30:00-05:00,37.28,37.62,37.22,37.44,69765184,92132453.6,53.34185786662395,48.229711776352715,NaN,NaN,-5.93903949900266,-29.429972804985688,-0.04766813250717615,0.03585140555451716,0.08351953806169331,1227166778,1235507021.2,42.271207959481785,35.35144279987933,NaN,NaN,1.7044591185856748,7.000338927883064
2004-02-18T09:30:00-05:00,37.50999,37.67,37.32001,37.55,71116128,91585166.4,54.58328492944892,48.721975883241505,NaN,NaN,15.77927813308073,-16.778987768359237,-0.019110519615571406,0.05963138854222905,0.07874190815780045,1298282906,1249915344.4,44.328188716807894,35.34077140038877,NaN,NaN,2.7740957804735915,6.396589906824568
2004-02-19T09:30:00-05:00,37.83,37.89999,36.82001,36.98,100889376,91015304,47.52664753696051,48.5975021559776,NaN,NaN,-22.96054710638476,-17.12986282868618,-0.0373032994133652,0.032112783891093954,0.06941608330445916,1197393530,1225648656.4,41.63726316680129,35.26105717982425,NaN,NaN,1.4805158383836217,5.694293611333004
2004-02-20T09:30:00-05:00,36.97,37.14,36.55,36.86,132369376,93086897.6,46.17326735045652,48.50989625494476,NaN,NaN,-88.16797291165705,-30.590834388780735,-0.055041653581121175,0.0006140163280576871,0.05565566990917886,1065024154,1189053792.4,37.90077116215175,35.03065864618725,NaN,NaN,0.020792912811390972,4.883793511544202
2004-02-23T09:30:00-05:00,37,37.03,35.89999,36.45,125298128,94911904,41.794160578840035,48.18897858187769,NaN,NaN,-160.155992580846,-52.28885479296194,-0.08994698017577343,-0.05677805531053792,0.033168924865235504,939726026,1145518678.8,33.99262487632329,34.86258644290711,NaN,NaN,-2.620010802334573,3.8118214667043775
2004-02-24T09:30:00-05:00,36.27,36.67,36,36.36,124564624,96906728.8,40.87767744850031,47.835702466810744,NaN,NaN,-175.67605278118734,-86.23625744939889,-0.11315577782580039,-0.10827579741701499,0.004879980408785404,815161402,1063117603.6,28.08879591207136,34.53820392980071,NaN,NaN,-5.031716805730195,2.5484588563565813
2004-02-25T09:30:00-05:00,36.42999,36.67,36.33,36.58,74520624,95765650.4,44.104327798495206,48.16850111327286,NaN,NaN,-119.51502351071886,-113.29511777815881,-0.10777539351901547,-0.12983926148998393,-0.022063867970968463,889682026,981397427.6,23.693745310512213,34.11498464810102,NaN,NaN,-6.112960930839961,1.311113172471361
2004-02-26T09:30:00-05:00,36.47,36.84,36.30499,36.67,71463376,92932012.8,45.41672271630472,48.44886444111743,NaN,NaN,-89.31971885760626,-126.56695212840309,-0.09280856683596614,-0.13807457651592614,-0.04526600967996,961145402,934147802,21.590247167995315,33.76951408144312,NaN,NaN,-6.630069456802633,0.17665851114650466
2004-02-27T09:30:00-05:00,36.75999,36.94,36.27,36.57001,99452128,90703678.4,44.175731108182134,48.02775402621775,NaN,NaN,-81.6209828031419,-125.25755410670008,-0.08453091802961958,-0.15092965721698448,-0.0663987391873649,861693274,893481626,19.948737376286942,33.36603262127174,NaN,NaN,-7.406076040553847,-0.9065892819535455
2004-03-01T09:30:00-05:00,36.67999,37.07001,36.47,37.05,79781008,90477484.8,51.08532509245901,48.10956053326721,NaN,NaN,-19.68876057465551,-97.16410770546199,-0.04367421263206536,-0.1209915049774466,-0.07731729234538123,941474282,893831277.2,20.005053763305085,32.99812126151597,NaN,NaN,-6.067147881557069,-1.6438119390397632
2004-03-02T09:30:00-05:00,36.983,37.17999,36.61,36.62,91604880,90331312.8,45.63582863481907,47.74790648173501,NaN,NaN,-29.706525135557296,-67.97020217633596,-0.042513255266262706,-0.13045886142820962,-0.08794560616194691,849869402,900772877.2,21.190426193825616,32.46811021830248,NaN,NaN,-6.54256378870752,-2.3436336318494426
2004-03-03T09:30:00-05:00,36.50999,36.63,36.21001,36.42,84023184,90842196.8,43.32107051286454,46.87517381766799,NaN,NaN,-100.81956443189078,-64.23111036057034,-0.051518724049473885,-0.15234401122378927,-0.10082528717431538,765846218,876005715.6,20.04890428650411,31.191387676036857,NaN,NaN,-7.636511164050967,-3.0997589935925176
2004-03-04T09:30:00-05:00,36.44,36.83,36.39,36.75999,66033632,88642494.4,48.1369799336728,46.673548805478845,NaN,NaN,-49.05175048028934,-56.17751668510698,-0.031845908353853855,-0.1406326726166327,-0.10878676426277885,831879850,850152605.2,18.904123451859363,29.57123303592657,NaN,NaN,-7.102138647245466,-3.6715275155429388
2004-03-05T09:30:00-05:00,36.41,37.14999,36.36,36.63,118130816,89702041.6,46.50982155127254,46.6201930756357,NaN,NaN,-41.61979292373602,-48.1772787092258,-0.02514982341827675,-0.1402240435356248,-0.11507422011734804,713749034,820563757.2,17.661180018408146,27.947233525880932,NaN,NaN,-7.142457874294229,-4.167374709650266
2004-03-08T09:30:00-05:00,36.69,36.82001,35.73,35.77,112721872,89976184.8,37.482603582638724,45.487389198208184,NaN,NaN,-145.4240636232674,-73.32433931894816,-0.07346853298779069,-0.2069098863520864,-0.13344135336429572,601027162,752474333.2,15.186648217436826,26.012622115734864,NaN,NaN,-10.205966138631982,-5.030030628076226
2004-03-09T09:30:00-05:00,35.83,35.98,35.52,35.66,126229184,93343519.2,36.50658216433411,44.196196143557124,NaN,NaN,-187.74397350412917,-104.93182899266253,-0.10570580582982086,-0.2655736106515718,-0.15986780482175095,474797978,677460048.4,13.021945802270182,23.776461907553596,NaN,NaN,-12.946949720608162,-6.161019069866502
2004-03-10T09:30:00-05:00,35.75,35.99899,35.13,35.19,134315632,96804510.4,32.60048119749206,43.13004140502367,NaN,NaN,-200.72775611868616,-124.9134673300216,-0.14890704862910967,-0.346001615608138,-0.19709456697902836,340482346,592387274,11.091120433136837,21.594594569434708,NaN,NaN,-16.60247079155581,-7.652655030107832
2004-03-11T09:30:00-05:00,35.07001,35.53,34.8,34.87,152504688,99805460.8,30.228933221498423,41.99116039581237,NaN,NaN,-218.645598841466,-158.83223700225693,-0.18680357599872413,-0.4305990369774335,-0.24379546097870938,187977658,463606835.6,8.932068278260672,19.52540150629963,NaN,NaN,-20.417565418420633,-9.47621365700966
2004-03-12T09:30:00-05:00,35.2,35.59,35.14999,35.50999,118398816,102188976.8,39.67993035998614,41.840143951608525,NaN,NaN,-144.3752938854068,-179.3833371945911,-0.15769852969617698,-0.4409186230989306,-0.2832200934027536,306376474,382132323.6,7.886125451342963,17.660651547372463,NaN,NaN,-20.558142745697914,-11.059346383965124
2004-03-15T09:30:00-05:00,35.36,35.39999,34.81,34.89,115887632,103453514.4,34.766751626091946,41.40364925000792,NaN,NaN,-161.42446776285607,-182.58341802250885,-0.1681734828817642,-0.4934369470049589,-0.3252634641231947,190488842,300024659.6,6.9969067106464,16.15408803298497,NaN,NaN,-22.398180969319334,-12.679179896158583
2004-03-16T09:30:00-05:00,35.11,35.25,34.63,34.95,123745376,106152524,35.59783270306038,40.79604245747687,NaN,NaN,-143.7372218317227,-173.78206768802755,-0.15912862399461714,-0.5241742441164661,-0.36504562012184893,314234218,267911907.6,6.679673481807342,14.938797188077478,NaN,NaN,-23.542704514530687,-14.231111984497455
2004-03-17T09:30:00-05:00,35.21001,35.62,35.17999,35.5,91960128,107194724,42.79268784238302,40.6086113950539,NaN,NaN,-79.16200508415288,-149.46891748112088,-0.10668992991751225,-0.4984080325187392,-0.39171810260122697,406194346,281054307.6,8.507933096755295,14.004346182988908,NaN,NaN,-22.099596017991267,-15.355181132139428
2004-03-18T09:30:00-05:00,35.37,35.46001,34.97,35.34,111342368,107717373.6,41.345606593260555,40.40645964398807,NaN,NaN,-86.782471730597,-123.0962920589471,-0.0748691169950953,-0.4853044988450961,-0.4104353818500008,294851978,302429171.6,11.543262954930114,13.403955152891992,NaN,NaN,-21.409290952414736,-16.22005396360733
2004-03-19T09:30:00-05:00,35.28,35.45599,34.72501,34.75,100132624,106105536,36.450684828395055,39.36112819655493,NaN,NaN,-102.77842562917361,-114.77691840770046,-0.08491024571998718,-0.5165731889999847,-0.43166294327999755,194719354,280097747.6,11.127894791019372,12.769872369157296,NaN,NaN,-22.423624831042325,-17.1062783732409
2004-03-22T09:30:00-05:00,34.53,34.55,34.03,34.31,134556320,106568445.6,33.28578120684969,38.47898195169997,NaN,NaN,-148.42821483109492,-112.17766782134822,-0.1108970787106826,-0.5702842916683508,-0.4593872129576682,60163034,254032586,10.646352805074756,12.016724269960806,NaN,NaN,-24.32341769846417,-18.137298276844223
2004-03-23T09:30:00-05:00,34.59,34.64999,34.006,34.03,126105008,106645464.8,31.416386264745213,37.62864736254859,NaN,NaN,-135.78067552743562,-110.58635856049082,-0.13505251440359178,-0.628202855962158,-0.4931503415585662,-65941974,177997347.6,9.372250736380224,11.254106159237669,NaN,NaN,-26.477011445356386,-19.32868587234596
2004-03-24T09:30:00-05:00,34.14999,34.63,34.00999,34.42,118985312,108868699.2,36.74516056212286,36.814945978866454,NaN,NaN,-112.4554404219506,-117.24504562805035,-0.11372815113985135,-0.6353105304833804,-0.521582379343529,53043338,107367146,8.37017999556845,10.501681626645462,NaN,NaN,-26.55829938182819,-20.361487802271995
2004-03-25T09:30:00-05:00,34.64999,35.46001,34.62,35.343,142146624,112402861.6,47.20091017532663,36.86430945201318,NaN,NaN,-39.51592776728272,-107.7917368353875,-0.030741765063224902,-0.5600095856725602,-0.5292678206093353,195189962,87434742.8,8.106755910264894,9.819222761778084,NaN,NaN,-22.955686095737885,-20.732087558481407
2004-03-26T09:30:00-05:00,35.3,35.584,35.2,35.22,78444128,111352461.6,46.10716062148681,37.480349240502335,NaN,NaN,-17.447732783140264,-90.72559826618084,0.01985968918170422,-0.5044432091322051,-0.5243028983139093,116745834,71840038.8,7.89734281797061,9.29855809038764,NaN,NaN,-20.508644829613413,-20.700167168643123
2004-03-29T09:30:00-05:00,35.50999,35.96001,35.49001,35.78999,103919632,112559392.8,51.693414450654984,38.56512297523954,NaN,NaN,32.52206983962215,-54.535541332037404,0.09169002230861756,-0.4096903704281374,-0.5013803927367549,220665466,103940525.2,12.885784761484473,9.28883230176009,NaN,NaN,-16.53890716691292,-20.105701454110235
2004-03-30T09:30:00-05:00,35.67,35.94299,35.517,35.91,95854496,112771873.6,52.80269571293578,40.00813829777123,NaN,NaN,47.60234534556747,-17.858937157436788,0.14413508821801785,-0.3212115324642326,-0.46534662068225047,316519962,180432912.4,23.516270393084312,10.176343013184908,NaN,NaN,-13.045538825465172,-19.097106792875227
2004-03-31T09:30:00-05:00,35.92,36,35.61,35.84,86058000,112873614.4,52.05187371077509,41.566919761291,NaN,NaN,57.83601480138853,16.19935388723104,0.169226079850611,-0.25381402086898674,-0.42304010071959774,230461962,215916637.2,27.91096746409444,11.531978669315894,NaN,NaN,-10.47116118888769,-17.864828849448436
2004-04-01T09:30:00-05:00,35.81,36.25,35.78,36.16,93091872,114226526.4,55.188798499084875,42.6746960569409,NaN,NaN,99.76794336528157,44.056128113743895,0.20035994484269493,-0.1725901696662291,-0.372950114508924,323553834,241589411.6,31.00010062621648,13.182976896092573,NaN,NaN,-7.336858547976792,-16.360833092095344
2004-04-02T09:30:00-05:00,36.89,37.16,36.52,37.10001,146006624,115620316.8,62.872864512611905,44.682275548835186,NaN,NaN,213.27739978883935,90.20115462813982,0.2727602060380828,-0.03199985696132046,-0.3047600629994033,469560458,312152336.4,38.76690071404885,15.45226218204989,NaN,NaN,-1.8420458301322935,-14.286720626100623
2004-04-05T09:30:00-04:00,37.03999,37.5,36.97,37.45,67379376,113353192,65.26136376141892,46.8010991958608,NaN,NaN,228.7584678404896,129.44843422831332,0.32895472989415875,0.10643334936829518,-0.22252138052586357,536939834,375407210,44.76869463073453,18.172906549830405,NaN,NaN,3.4627531545695582,-11.751081514576311
2004-04-06T09:30:00-04:00,37.16,37.39999,36.92,36.98,98707680,111977116.8,59.706397334929434,48.00922130247126,NaN,NaN,169.301694237123,153.7883040066244,0.31896640122170217,0.17618662100126414,-0.14277978022043802,438232154,399749648.4,46.92466292201241,20.916958680205912,NaN,NaN,6.137348861192343,-9.195591460895075
2004-04-07T09:30:00-04:00,36.994,37.11,36.66,36.94,91091680,109815919.2,59.244210018597904,49.287692975709646,NaN,NaN,124.69439116892924,167.15997928013255,0.2947341539461615,0.2256379122122638,-0.06909624173389765,347140474,423085350.8,48.9807095390503,23.591062007643067,NaN,NaN,8.106895373796808,-6.7238076273676635
2004-04-08T09:30:00-04:00,37.35001,37.39,36.74001,36.94,77246688,106053019.2,59.244210018597904,50.91580191786699,NaN,NaN,117.20569454015856,170.64752951510795,0.26472533668211523,0.2618104291187464,-0.002914907563368832,347140474,427802678.8,49.407374807014826,26.325310580214172,NaN,NaN,9.685416805479871,-4.379632708389444
2004-04-12T09:30:00-04:00,37.07001,37.24001,36.98,37.17,55325504,102899353.6,61.244827424103896,52.91287664767087,NaN,NaN,110.24224785448033,150.04049912823615,0.24674368913556735,0.30551470385609036,0.058771014720523006,402465978,414383782.8,48.17323576476958,29.005802220192376,NaN,NaN,11.595155244822001,-2.0975201436449518
2004-04-13T09:30:00-04:00,37.34,37.36,36.46001,36.63,100740688,102142006.4,54.482691606744055,54.56046988638507,NaN,NaN,76.22402589539708,119.53361073921765,0.1875410863223441,0.29319737262345313,0.10565628630110904,301725290,367340874,44.02176636450259,31.480767622201114,NaN,NaN,11.301977883587336,-0.18330613975462517
2004-04-14T09:30:00-04:00,36.41,36.95,36.36,36.81,113763808,101642928,56.217987824327686,55.95138611939971,NaN,NaN,60.33859029668176,97.74098995112941,0.15112675947504195,0.2945647356449115,0.14343797616986953,415489098,362792262.8,43.630247197189036,33.9993438508883,NaN,NaN,11.557013402212055,1.4938823662406149
2004-04-15T09:30:00-04:00,36.75,36.86,36.02,36.14999,123788496,103234346.4,48.8621475219684,56.070045929874105,NaN,NaN,29.174685754684422,78.63704886828044,0.0769526574679456,0.23962879800480152,0.16267614053685592,291700602,351704288.4,42.63482318782298,36.46563437071388,NaN,NaN,9.501020585473812,2.6377592547025
2004-04-16T09:30:00-04:00,36.2,36.32001,35.78999,36.09,110813680,103207912,48.244251221782875,56.222695258466686,NaN,NaN,5.039456982565915,56.203801356761915,0.021116272884782683,0.18907148164283427,0.1679552087580516,180886922,318453578,39.709033204912934,38.73789796978118,NaN,NaN,7.660093104232477,3.355235518921068
2004-04-19T09:30:00-04:00,36.00999,36.59,35.98,36.53,85887376,102495649.6,52.94441232181751,56.31205224926401,NaN,NaN,24.800246130298714,39.11540101192558,0.011560715342335659,0.18240610293597115,0.1708453875936355,266774298,291315242,37.4501233259102,40.49249358152588,NaN,NaN,7.44786239380749,3.9398965010476994
2004-04-20T09:30:00-04:00,36.61,36.78999,35.64,35.67999,119746688,101755168,44.530992435151504,55.72121630085085,NaN,NaN,-11.713191439205996,21.52795754500496,-0.05083777201361256,0.10729817257661978,0.15813594459023234,147027610,260375706,35.00524117489206,41.313134351655,NaN,NaN,4.479674426508192,4.017007633256341
2004-04-21T09:30:00-04:00,35.89999,36.11,35.45,35.99001,119168320,101408333.6,47.789795995275924,55.416782178315195,NaN,NaN,-41.97281519640532,1.065676446387546,-0.06893987809893712,0.07196109696656094,0.14090097506549806,266195930,230517072.4,32.781068026382144,41.660998677532696,NaN,NaN,3.0798348750696167,3.8831258106582376
2004-04-22T09:30:00-04:00,36,37.00999,35.98,36.92,137853008,102351718.4,56.118259409630426,55.483172243354154,NaN,NaN,34.97244769474081,2.2252288343988207,-0.018606763289704398,0.11764252095336758,0.13624928424307198,404048938,252986739.6,36.07285860476679,42.02333853314343,NaN,NaN,4.68563686905825,3.997770247572525
2004-04-23T09:30:00-04:00,37.08,37.25999,36.89999,37.21001,92016624,99845218.4,58.349513105343995,55.1600757142636,NaN,NaN,86.94170972235939,18.60567938235752,0.031182057203124502,0.1752268557469776,0.1440447985438531,496065562,316022467.6,44.31191854203019,42.4194112351421,NaN,NaN,6.715803354726687,4.386060691451691
2004-04-26T09:30:00-04:00,37.17999,37.28999,36.64999,36.94,74493184,99647671.2,55.5190425966544,54.464195631066126,NaN,NaN,59.66771746418857,25.57917364913549,0.0422094740137931,0.19680664106109447,0.15459716704730136,421572378,346982083.6,47.8658431278883,42.640636127795936,NaN,NaN,7.447067521058994,4.823347381395592
2004-04-27T09:30:00-04:00,36.95,37.19,36.69,36.87,87639504,98833664.8,54.777179212127365,54.112108622294556,NaN,NaN,48.64258313251424,37.65032856347953,0.04103188552930265,0.20588702395892966,0.164855138429627,333932874,384363136.4,51.860573831679474,42.99320119277216,NaN,NaN,7.802883064802919,5.248995336168067
2004-04-28T09:30:00-04:00,36.71001,36.72,36.019,36.2,111768688,99629374.4,48.14582740253548,53.319367006861526,NaN,NaN,-49.89462553994468,36.065966494771665,-0.006117950947342576,0.1572076997454488,0.16332565069279137,222164186,375556787.6,50.87163398028191,43.128267224288706,NaN,NaN,6.001040956526596,5.356430424790713
2004-04-29T09:30:00-04:00,36.09,36.34,35.3,35.64,156988816,103175915.2,43.41497039386939,52.18870703366663,NaN,NaN,-138.07421236276943,1.456634483269616,-0.07257674242782225,0.07260472265801354,0.1451814650858358,65175370,307782074,43.92877775884362,42.73693886370505,NaN,NaN,2.9079722349436223,5.006650683383986
2004-04-30T09:30:00-04:00,35.66,35.8,34.72,34.77,150908880,106066765.6,37.28532914437073,50.47731429939997,NaN,NaN,-207.96887158141428,-57.52548177748512,-0.1672721918674442,-0.06390877474846945,0.10336341711897473,-85733510,191422259.6,35.0774160172451,41.8015231674533,NaN,NaN,-1.9578375012519154,4.011723799864572
2004-05-03T09:30:00-04:00,35,35.52,34.89,35.10001,117051376,104619003.2,40.70516263538827,49.49320508716028,NaN,NaN,-164.05204630447972,-102.26943453121878,-0.1977386576256698,-0.14380990491311252,0.05392875271255728,31317866,113371357.2,30.62051442700384,40.84429088620339,NaN,NaN,-4.742296724958143,2.761149439175613
2004-05-04T09:30:00-04:00,35.21001,35.75,35.03,35.25,126233312,107561700,42.24662550171127,48.49525063554482,NaN,NaN,-126.3792024082755,-137.27379163937673,-0.19738830769740556,-0.19280663190919967,0.00458167578820589,157551178,78095018,28.837119243900986,39.787638889539956,NaN,NaN,-6.471376971725766,1.4422170947611301
2004-05-05T09:30:00-04:00,35.42,35.7,35.2,35.53,97566816,107504656.8,45.11509044986023,48.227603701822794,NaN,NaN,-97.97439697416232,-146.88974592622026,-0.16899411828621005,-0.2066609720695567,-0.03766685378334663,255117994,84685779.6,29.661382069515867,38.860964523946585,NaN,NaN,-7.017281899102194,0.23371723849494108
2004-05-06T09:30:00-04:00,35.2,35.52299,34.85001,35.25999,102722496,108086197.6,42.902208082776326,47.84602919189376,NaN,NaN,-112.84764968220377,-141.8444333901071,-0.15922624541145985,-0.23669966054767144,-0.07747341513621159,152395498,102129805.2,31.90937684641318,38.303846212625174,NaN,NaN,-8.137922156135533,-0.9622312464522695
2004-05-07T09:30:00-04:00,35.09,35.64,34.91,34.97,137713120,111109519.2,40.5989673141212,46.96421169134402,NaN,NaN,-104.60431920939722,-121.17152291570372,-0.16255720302841,-0.2806699189217241,-0.1181127158933141,14682378,122212982.8,34.504645729395435,38.09345495573127,NaN,NaN,-9.76587047493542,-2.2198939933784336
2004-05-10T09:30:00-04:00,34.67,34.89999,34.42,34.67101,157122880,116199388,38.31501506665971,46.520213307880326,NaN,NaN,-142.26876669767933,-116.81486699434363,-0.17412749775532202,-0.3357720880874666,-0.1616445903321446,-142440502,87461309.2,32.21641289752219,37.89425293591914,NaN,NaN,-11.818620414355411,-3.591140624946573
2004-05-11T09:30:00-04:00,34.97,35.38,34.92,35.19,120803632,117202535.2,44.18466961913898,46.26270428101339,NaN,NaN,-80.19642870410921,-107.57831225351038,-0.1376570709523664,-0.3337159290226026,-0.1960588580702362,-21636870,51623699.6,30.006448728035096,37.69606584318006,NaN,NaN,-11.844651933744512,-4.770213669060564
2004-05-12T09:30:00-04:00,35.12,35.3495,34.27,35.25999,197861312,121407410.4,44.9454995559789,45.464650005752574,NaN,NaN,-92.28001783755515,-106.43943642618895,-0.10132787337971211,-0.32271869979487633,-0.22139082641516422,176224442,35844989.2,29.061215501943067,37.19523419297836,NaN,NaN,-11.645506769945015,-5.752398397758343
2004-05-13T09:30:00-04:00,35.06,35.45,34.92,35.00999,138093312,122122651.2,42.70619251824317,44.3472699638168,NaN,NaN,-67.79459974693458,-97.42882643913511,-0.08718169964553443,-0.33036795097208227,-0.24318625132654784,38131130,12992115.6,27.700205352325526,36.0086832508566,NaN,NaN,-12.112938840612182,-6.661047032451749
2004-05-14T09:30:00-04:00,35.2,35.314,34.64,34.75,133742880,123269111.2,40.44915782048126,43.27084962266157,NaN,NaN,-82.5425975513462,-93.01648210752491,-0.08811981503230926,-0.35333602011693444,-0.2652162050846252,-95611750,-9066710,26.414288864376374,34.47642937489146,NaN,NaN,-13.15216523779837,-7.588349633215552
2004-05-17T09:30:00-04:00,34.38,34.61501,34.11,34.42,150694880,126509486.4,37.72390964650728,42.052758939403,NaN,NaN,-122.70802314331885,-89.1043333966528,-0.10273032481072891,-0.39362911109803633,-0.2908987862873074,-246306630,-29839935.6,25.22662077287447,32.57400415640539,NaN,NaN,-14.833922281514504,-8.623431440115402
2004-05-18T09:30:00-04:00,34.66,34.89999,34.60001,34.73,96712000,125357752,41.69778349986179,41.592184374926305,NaN,NaN,-79.88022197862745,-89.04109205155646,-0.08406707141647318,-0.39598262555789887,-0.3119155541414257,-149594630,-55431487.6,23.806488253578877,30.640779461640886,NaN,NaN,-15.144671750769334,-9.55503719878025
2004-05-19T09:30:00-04:00,35.16,35.511,34.63499,34.69,141760496,126487360.8,41.33129970160531,41.4433507540503,NaN,NaN,-55.602215103929076,-81.70553150483123,-0.06767140294338347,-0.396504807820655,-0.32883340487727153,-291355126,-148947401.2,19.48898563861259,28.895080024481523,NaN,NaN,-15.50078130546903,-10.404429214021503
2004-05-20T09:30:00-04:00,34.78,35.02,34.56,34.85001,95036000,124346510.4,43.471626630218815,41.88522914589659,NaN,NaN,-66.02645397369457,-81.35190235018324,-0.04063809304639188,-0.3796310211852614,-0.3389929281388695,-196319126,-195837452.4,17.75065813338057,27.65745446134834,NaN,NaN,-15.224684086115579,-11.093037052892086
2004-05-21T09:30:00-04:00,35.02,35.17,34.73801,35.019,111482368,125319797.6,45.72369955940307,42.2436960690405,NaN,NaN,-44.36672845636421,-73.71672853118683,-0.0076887413101093816,-0.34860385477650624,-0.34091511346639686,-84836758,-193682454,18.112161795364855,26.76400070194555,NaN,NaN,-14.381304392591815,-11.562789529992047
2004-05-24T09:30:00-04:00,35.3,35.46001,35,35.25999,100146496,126602463.2,48.85307852731654,42.71558557086945,NaN,NaN,3.820894990031591,-48.41094490451675,0.03185380736562338,-0.30109785425936764,-0.332951661624991,15309738,-141359180.4,26.553024304125188,26.600851063390138,NaN,NaN,-12.792347162217574,-11.73844062030998
2004-05-25T09:30:00-04:00,35.14999,36.08,34.94901,35.96001,146419680,129541472,56.668429122095546,43.54082404745769,NaN,NaN,114.41782318358122,-9.551335872075024,0.10267757936087651,-0.20460468742389537,-0.3072822667847719,161729418,-79094370.8,35.12319224609699,26.990980361717362,NaN,NaN,-8.931951791316028,-11.337513644739415
2004-05-26T09:30:00-04:00,35.86,36.19099,35.81,36.19,93840880,128645081.6,58.89096818777194,44.68287834067166,NaN,NaN,216.77515378905457,44.9241379065217,0.1591648774589579,-0.10832616996107447,-0.2674910474200324,255570298,30290714,46.85528801272292,28.0585454450252,NaN,NaN,-5.009548092592929,-10.433518565861347
2004-05-27T09:30:00-04:00,36.28999,36.5,36,36.42,110216816,126306481.6,61.04293122719492,46.14316147731978,NaN,NaN,243.37075318338702,106.80357933793803,0.20334306317997913,-0.013312218445058477,-0.2166552816250376,365787114,142711962,55.71836892456712,29.57381138753746,NaN,NaN,-1.0461666441392257,-9.092468291329615
2004-05-28T09:30:00-04:00,36.38,36.55,36.21001,36.55,56403296,121581202.4,62.24592020566176,47.85251184439135,NaN,NaN,206.76075465380592,157.02907595997206,0.23064501587887798,0.07165098822355986,-0.15899402765531812,422190410,244117395.6,61.89197121636325,31.69349412459754,NaN,NaN,2.612403759888505,-7.420343712584169
2004-06-01T09:30:00-04:00,36.25999,36.55,36.11,36.5,90659120,120261589.6,61.45981984648285,49.08645114634448,NaN,NaN,158.15510705144243,187.89591837225422,0.23392519305859896,0.13341246366793058,-0.10051272939066838,331531290,307361706,65.15485931531049,34.2040948808315,NaN,NaN,5.438790686004068,-5.58332451278585
2004-06-02T09:30:00-04:00,36.56,36.66,36.17,36.42,103543808,119127114.4,60.150897504166124,50.17255099978643,NaN,NaN,134.2882224230198,191.86999822014192,0.21952934166632432,0.17389894769223702,-0.0456303939740873,227987482,320613318.8,65.81532328721781,36.8293882940654,NaN,NaN,7.486088345031922,-3.716265533097597
2004-06-03T09:30:00-04:00,36.3,36.36099,35.82001,35.98,97710688,119134308,53.413102748364075,50.937330301937926,NaN,NaN,79.22822557601694,164.3606125775344,0.17133444157445946,0.168537657993987,-0.002796783580472438,130276794,295554618,63.36930147269643,39.3771808740919,NaN,NaN,7.480533166079205,-2.1167228617866254
2004-06-04T09:30:00-04:00,36.35001,36.62,36.17,36.19,91290192,118562692.8,55.94928207525207,52.04448203442155,NaN,NaN,96.31883010604949,134.9502279620669,0.1455723844869289,0.17916869702818872,0.0335963125412598,221566986,266710592.4,60.578469997232446,41.81747952643877,NaN,NaN,8.18399870273578,-0.6451912097119963
2004-06-07T09:30:00-04:00,36.44,37.10001,36.34,37.05,107680000,117061036.8,64.4778997618611,53.95548132837542,NaN,NaN,128.3425900388456,119.26659503907483,0.17637098097140716,0.25406003875551875,0.07768905778411159,329246986,248121907.6,58.78177297508811,44.21427611231117,NaN,NaN,11.60300897466388,1.1045516737702714
2004-06-08T09:30:00-04:00,36.89999,37.19,36.85001,37.10201,72579312,112833858.4,64.92023890144108,55.61422814277394,NaN,NaN,131.47070137097242,113.92971390298082,0.1890401667030414,0.31398926616291334,0.12494909945987194,401826298,262180909.2,59.754004550770425,46.781955847824854,NaN,NaN,14.465499292694073,3.0132584764736716
2004-06-09T09:30:00-04:00,36.98,37.05099,36.37,36.57899,98242368,111705795.2,57.20566571746157,56.74811142962081,NaN,NaN,85.88904975690494,104.24987936975785,0.1525541173450708,0.31564174614121043,0.16308762879613964,303583930,277300198.8,60.82419227034978,49.73447060723465,NaN,NaN,14.563945998508387,4.663356693907202
2004-06-10T09:30:00-04:00,36.69,36.84,36.55,36.84,57137008,104669580,59.774615037816645,57.912610601592085,NaN,NaN,84.21137621327918,105.24650949721031,0.1368584391967786,0.3341606777921129,0.1973022385953343,360720938,323389027.6,63.969456076945725,53.03581331748931,NaN,NaN,15.444734718382092,6.203553554546472
2004-06-14T09:30:00-04:00,36.61,36.61,36.10001,36.32001,85281184,102028973.6,52.95445879278852,58.42909340397676,NaN,NaN,44.05531684808598,94.7938068456176,0.08486303282255672,0.3033810296235302,0.21851799680097347,275439754,334163581.2,64.68330687092842,56.362323680029654,NaN,NaN,13.991040749870946,7.316051725307111
2004-06-15T09:30:00-04:00,36.56,36.99001,36.56,36.78999,91983504,99941004.8,57.65695730968219,59.05794188843145,NaN,NaN,78.87999366515301,84.90128757087908,0.07582549779114284,0.31329986903990203,0.2374743712487592,367423258,341798835.6,65.20933416420493,59.12348867003535,NaN,NaN,14.290383946717334,8.312384899794285
2004-06-16T09:30:00-04:00,36.75,36.89999,36.64999,36.73,65478608,95680191.2,56.8754745527161,59.072730847761484,NaN,NaN,74.39762581455366,73.48667245959534,0.06019261786446417,0.3127151435793394,0.2525225257148752,301944650,321822506,62.5829332103404,61.08489873890988,NaN,NaN,14.282684177574783,9.165284796620071
2004-06-17T09:30:00-04:00,36.64999,36.65601,36.25,36.39,77857376,94737460,52.52979106436577,58.618361053232476,NaN,NaN,33.54706009620955,63.01827452745626,0.023238629730950255,0.281570812878563,0.25833218314761275,224087274,305923174.8,60.49452599772831,62.05913002355312,NaN,NaN,12.913667213964692,9.700767999097874
2004-06-18T09:30:00-04:00,36.3,36.84,36.25999,36.44,78778192,91588344.8,53.097343859904136,58.05081909842598,NaN,NaN,39.36778414689728,54.04955611417988,-0.0003059034955277262,0.2579498037782031,0.2582557072737308,302865466,294352080.4,58.95267277211334,62.290151726949276,NaN,NaN,11.978643522077025,10.026178788094896
2004-06-21T09:30:00-04:00,36.52,36.63,36.06,36.14999,65453808,90109235.2,49.407518446095075,57.13379040131408,NaN,NaN,-6.143795997277868,44.00973354510712,-0.03590935349206284,0.21336901540865227,0.2492783689007151,237411658,286746461.2,57.907928948580405,62.00557727925051,NaN,NaN,10.072808969668719,10.032840242605442
2004-06-22T09:30:00-04:00,36.16,36.7,36.015,36.67999,101630496,89616641.6,55.49440506071472,56.707689345187795,NaN,NaN,18.227207041335244,31.879176220343574,-0.024791740031853082,0.21828869386089877,0.24308043389275186,339042154,281070240.4,57.0947024648514,61.429851789932,NaN,NaN,10.250039149778198,10.063868657915835
2004-06-23T09:30:00-04:00,36.57001,37.19,36.50999,37.12,95323312,89375482.4,59.816805959816,56.68382566344849,NaN,NaN,124.6638928797048,41.9324296333738,0.009340481020494507,0.25475603516837,0.24541555414787547,434365466,307554403.6,59.92272778245638,61.00895211102047,NaN,NaN,11.781277737006954,10.30921281207171
2004-06-24T09:30:00-04:00,37.02,37.35001,36.92,37.05,92382880,86673642.4,58.837796229039995,57.071303769211056,NaN,NaN,148.92734538229527,65.00848669059096,0.023539609246893245,0.274840065706492,0.25130045645959875,341982586,331133466,62.30494684161444,60.932926780228904,NaN,NaN,12.712051537619953,10.65247548715003
2004-06-25T09:30:00-04:00,37,37.39,36.98,37.33,81028368,86033016.8,61.54873142707953,57.47126443719873,NaN,NaN,156.89126492233063,88.51318284567762,0.04678325009872769,0.3097795190830084,0.2629962689842807,423010954,355162563.6,64.61338465055181,61.2211349697517,NaN,NaN,14.32145747217987,11.176615770725721
2004-06-28T09:30:00-04:00,37.49001,37.52,36.89999,37.021,94237872,85234069.6,57.08090302498251,56.94290752742169,NaN,NaN,119.416954298868,113.6253329049068,0.03678211370225931,0.3089739111121048,0.2721917974098455,328773082,373434848.4,66.30328635395557,61.75838592538509,NaN,NaN,14.345425693172334,11.62930290250381
2004-06-29T09:30:00-04:00,37.10001,37.59,37.08,37.37,68362368,85832023.2,60.56294119385138,56.63167197687956,NaN,NaN,144.5098585827845,138.88186321319665,0.048376259995541626,0.3326621224042725,0.2842858624087309,397135450,385053507.6,67.3703318002579,62.30240930034849,NaN,NaN,15.429968230983853,12.172255092286672
2004-06-30T09:30:00-04:00,37.45,37.89999,37.35001,37.74001,97879376,86193036,63.906328794240856,57.11029076807808,NaN,NaN,183.17331979908792,150.58374859707328,0.07412867663627398,0.3769467082040734,0.3028180315677994,495014826,397183379.6,68.49209149949488,62.850116388144556,NaN,NaN,17.40129537472039,12.91926084692006
2004-07-01T09:30:00-04:00,37.66,37.66,36.77,37.03999,122182816,87124986.4,54.4937139677215,56.733083548785565,NaN,NaN,72.7225393597565,135.34278739256553,0.03894946954179368,0.3515048684950415,0.3125553989532478,372832010,403353264.4,69.07447594094023,63.21476066414417,NaN,NaN,16.05407840425271,13.367091926539011
2004-07-02T09:30:00-04:00,37.03999,37.19,36.63,36.82001,74089872,85943945.6,51.90642481672765,56.65822397906693,NaN,NaN,10.349651948156142,106.0344647977306,-0.0020300890821522977,0.3100177876005574,0.3120478766827097,298742138,378499501.2,63.94692877416461,63.16216222866104,NaN,NaN,14.12524527964524,13.47539954841133
2004-07-06T09:30:00-04:00,36.60001,36.60001,35.83,36.03,130381184,87898495.2,43.85376239742972,55.672281485334615,NaN,NaN,-143.98909419524364,53.35325509890829,-0.08087033541702732,0.2109599574114256,0.2918302928284529,168360954,346417075.6,57.96529476323859,62.64473084287773,NaN,NaN,9.582484610925878,12.919268843056265
2004-07-07T09:30:00-04:00,35.96001,36.28999,35.92,36.09599,96161632,87322576.8,44.62653251393757,54.79735705399329,NaN,NaN,-133.3729819518288,-2.2233130080143724,-0.12449575125478052,0.1362106037599773,0.2607063550147578,264522586,319894502.8,53.509130631822316,61.9966020872693,NaN,NaN,6.302228829738196,11.973977412582256
2004-07-08T09:30:00-04:00,35.81,36.13,35.55,35.7,108939504,89140586.4,40.98144699074254,53.97247533444877,NaN,NaN,-164.42431113737223,-71.7428391953064,-0.17296101050625046,0.044505091881944736,0.2174661023881952,155583082,252008154,44.15284792580704,60.829339367846345,NaN,NaN,2.3505280270056006,10.599198928928448
2004-07-09T09:30:00-04:00,35.84,36.03999,35.63,35.75,86044880,88530712,41.62974787976023,53.15336133586707,NaN,NaN,-137.29972523936112,-113.74729211512992,-0.1930629078556773,-0.023862532431401462,0.16920037542427585,241627962,225767344.4,41.157135995957375,59.558229598120924,NaN,NaN,-0.5892495066373826,9.000849152419043
2004-07-12T09:30:00-04:00,35.57001,35.69,34.71001,35.60001,81863808,89767052,40.203075284474075,52.49590111003699,NaN,NaN,-174.0941699649391,-150.636056497749,-0.20665628994595492,-0.08911998700816781,0.11753630293778711,159764154,197971747.6,38.200525456288325,58.15055792010007,NaN,NaN,-3.439097442245953,7.223713924609759
2004-07-13T09:30:00-04:00,35.69,35.81,35.41,35.55,81627872,89584386.4,39.71436954027962,51.36875571572019,NaN,NaN,-124.43986428104989,-146.72621051491024,-0.20860617169597684,-0.14322141168218394,0.0653847600137929,78136282,179926813.2,36.37368642857481,56.670485346080305,NaN,NaN,-5.911137433564138,5.347306587727774
2004-07-14T09:30:00-04:00,35.2,35.64999,35.05,35.19,119867680,90978595.2,36.2941417660561,49.68856541616592,NaN,NaN,-139.5781056658484,-147.96723525771418,-0.22246329892629485,-0.21269436364407568,0.009768935282219178,-41731398,118676016.4,30.961273968086743,54.60181007362534,NaN,NaN,-9.09016165544093,3.284811124417959
2004-07-15T09:30:00-04:00,35.32001,35.49001,35.06,35.07001,90553504,92232340,35.20584007360506,48.00056854792057,NaN,NaN,-129.9017201531181,-141.06271706086335,-0.22723332708392988,-0.27427272357269317,-0.04703939648876329,-132284902,61102419.6,26.908200107635068,52.073471021198245,NaN,NaN,-12.05654416843039,1.093188939725338
2004-07-16T09:30:00-04:00,35.44,35.45,34.619,34.67,120434128,94361177.6,31.784198484527337,45.87453048059541,NaN,NaN,-136.73419191887933,-140.94961039676699,-0.24340999633626564,-0.35130189190909533,-0.10789189557282969,-252719030,-37766978.8,21.663530413082825,49.005624289950454,NaN,NaN,-15.710630071049131,-1.307356633242443
2004-07-19T09:30:00-04:00,34.78,34.97,34.47,34.60001,106431632,95743849.6,31.21258900005762,44.02679376452935,NaN,NaN,-136.83659867185176,-133.4980961381495,-0.244272233478987,-0.4132321874215634,-0.16895995394257643,-359150662,-141549942,17.75212598744912,45.537684263771425,NaN,NaN,-18.889646824044178,-3.819112374785548
2004-07-20T09:30:00-04:00,34.74001,35.58701,34.71001,35.42999,120053872,98473852.8,44.06027241452993,42.84803170886353,NaN,NaN,-78.91936175252768,-124.39399563244505,-0.17749975263217205,-0.3908346447327915,-0.21333489210061946,-239096790,-204996556.4,15.866126883330168,41.85881248399086,NaN,NaN,-17.89664075032671,-5.830187857005714
2004-07-21T09:30:00-04:00,35.59,35.64999,34.34,34.39999,136156320,100200144,35.25908642640846,40.80180011116123,NaN,NaN,-103.10556239248035,-117.09948697777148,-0.19013048514084924,-0.450997998526681,-0.26086751338583175,-375253110,-271700898.8,14.16254591572698,37.97813065657887,NaN,NaN,-20.077667371955734,-7.865542073427145
2004-07-22T09:30:00-04:00,34.48,35.11,34.25,34.87,132842496,102076103.2,41.04618029037812,39.841261991350976,NaN,NaN,-96.99415235453446,-110.51797341805472,-0.15570700987727337,-0.4555012757324235,-0.2997942658551501,-242410614,-293726041.2,13.641699550282254,34.01864662867474,NaN,NaN,-19.798797582426147,-9.570292860427003
2004-07-23T09:30:00-04:00,34.64,34.66,34.03,34.21001,107145184,102814218.4,36.15845777597018,38.71640720272545,NaN,NaN,-119.85234328053869,-107.14160369038659,-0.16535447657110297,-0.5064873615690288,-0.3411328849979259,-349555798,-313093394.8,13.182601272472013,30.392623235696693,NaN,NaN,-21.321255725486118,-11.249001841149733
2004-07-26T09:30:00-04:00,34.24001,34.41,33.7,34.06,113051312,104415365.6,35.13437842891045,38.093594062116935,NaN,NaN,-127.37252182330623,-105.2487883206775,-0.16919641124842977,-0.5526283990584631,-0.3834319878100333,-462607110,-333784684.4,12.691193948091637,27.15875889175762,NaN,NaN,-22.842801617306804,-12.905258952029314
2004-07-27T09:30:00-04:00,34.19,34.71001,34.03999,34.53,103529376,104879940.8,40.792386889151786,37.81972651748937,NaN,NaN,-91.93343347854652,-107.85160266588127,-0.12924492777563146,-0.5449881475295726,-0.41574321975394113,-359077734,-357780873.2,12.126621443346906,24.20286537829509,NaN,NaN,-22.18543597492363,-14.230998526728502
2004-07-28T09:30:00-04:00,34.41,34.62601,33.81,34.38,155066192,109215132,39.605040184549665,37.721411745618454,NaN,NaN,-98.42267155893525,-106.91502449917225,-0.10321127723916074,-0.544757316302892,-0.4415460390637313,-514143926,-385559036.4,11.489441497058735,21.86976491909878,NaN,NaN,-22.043474636922518,-15.347066542470504
2004-07-29T09:30:00-04:00,34.71001,34.92,34.5,34.78,99079184,109275122.4,44.263986950111715,37.90957167921499,NaN,NaN,-54.25808025648654,-98.36781007956266,-0.05193082725560838,-0.5064595731332417,-0.45452874587763337,-415064742,-420089862,10.734371814233299,19.69671033468992,NaN,NaN,-20.423399459969982,-16.072256959256144
2004-07-30T09:30:00-04:00,34.75999,35.10001,34.64999,34.89,83039808,107317972,45.508874733493414,38.28855735414494,NaN,NaN,-32.21104408313754,-80.83955024008242,-0.005903140062751722,-0.461907670956073,-0.45600453089332127,-332024934,-416583689.2,11.371275339225619,17.780335326328302,NaN,NaN,-18.740648013147077,-16.453455681240563
2004-08-02T09:30:00-04:00,34.61,35.02,34.46001,34.96001,81363008,107681628.8,46.33050026987763,38.7611381205448,NaN,NaN,-32.40826882923756,-61.846699641268685,0.03188075583024447,-0.41615358610551567,-0.44803434193576014,-250661926,-374194652.4,18.904660918253853,16.53254778987681,NaN,NaN,-17.134893143957253,-16.55080389020009
2004-08-03T09:30:00-04:00,34.84,34.92999,34.188,34.23,85839184,105454528.8,39.62183461233777,38.99883046670778,NaN,NaN,-75.76715189097392,-58.61344332375417,0.011388838688867975,-0.43379829357467514,-0.4451871322635431,-336501110,-369679327.6,19.687761520738192,15.727296900780477,NaN,NaN,-17.740519433683303,-16.720763253554836
2004-08-04T09:30:00-04:00,34.14999,34.461,34.00999,34.24001,86875312,104990212.8,39.75066294401989,39.3234606717374,NaN,NaN,-102.92227514593183,-59.51336404115348,0.002645381196750063,-0.44188040576760557,-0.44452578696435563,-249625798,-316775702,28.410486843626813,15.834603096208456,NaN,NaN,-18.184355332213826,-16.929847836220407
2004-08-05T09:30:00-04:00,34.35001,34.39999,33.59801,33.60001,109939184,105040196.8,34.658811587260885,39.52879017907552,NaN,NaN,-150.53981295102162,-78.76971058006049,-0.03976417192006343,-0.4942310018644349,-0.4544668299443715,-359564982,-305675750,30.125276735552134,16.439013547813403,NaN,NaN,-20.17431123908008,-17.3933426080575
2004-08-06T09:30:00-04:00,33.39999,33.41,32,32.72,148859808,108180943.2,29.13286316805113,39.3802383339322,NaN,NaN,-271.9096827102263,-126.70943830547826,-0.11627804960253452,-0.5998143919475396,-0.4835363423450051,-508424790,-340955721.2,27.842509226124605,17.159755207718792,NaN,NaN,-23.87009409259349,-18.31859282013407
2004-08-09T09:30:00-04:00,32.81,32.96001,32.64999,32.8,78649008,108020203.2,30.22204023784346,38.39179317845459,NaN,NaN,-210.0969925887275,-162.24718305737625,-0.14862625667362273,-0.6693191631870334,-0.5206929065134107,-429775782,-376778492.4,25.712005806175483,17.863032273636318,NaN,NaN,-26.41973286665287,-19.475898541065327
2004-08-10T09:30:00-04:00,32.97,33.48199,32.92,33.21001,106347120,109256165.6,35.678360505276174,38.42174132694514,NaN,NaN,-140.10234755693344,-175.11422219056814,-0.13019731402975465,-0.683439549050604,-0.5532422350208493,-323428662,-374164002.8,26.15612624203358,18.71971658265822,NaN,NaN,-26.8411888769926,-20.528082874769222
2004-08-11T09:30:00-04:00,32.85001,33.03999,32.55,32.92,121295680,109327565.6,33.67267684237693,37.895062509230776,NaN,NaN,-155.49698910129305,-185.62916498164037,-0.12528520829794487,-0.7098487453932805,-0.5845635370953356,-444724342,-413183711.6,23.863187909267253,19.449822894014293,NaN,NaN,-27.812653597103278,-21.568735835102657
2004-08-12T09:30:00-04:00,32.69,32.85699,32.37,32.47,114044000,110502090.4,30.78115374655026,37.510969364272206,NaN,NaN,-152.05977691424567,-185.9331577742852,-0.13902733247918408,-0.7583477026943157,-0.6193203702151316,-558768342,-453024383.6,21.765173802455365,20.062863789013104,NaN,NaN,-29.55219444229305,-22.70922992184414
2004-08-13T09:30:00-04:00,32.64999,32.74001,32.35001,32.52,91431184,109051943.2,31.485158921870976,37.2503108280551,NaN,NaN,-130.21154819254565,-157.59353087074905,-0.13151547839817956,-0.7837147182128561,-0.6521992398146765,-467337158,-444806857.2,23.263752778275403,20.81804656259766,NaN,NaN,-30.733818110834626,-23.855599663128498
2004-08-16T09:30:00-04:00,32.61,33.19,32.586,32.88699,77887120,107624717.6,36.58343250317586,36.949671229056825,NaN,NaN,-86.57552783968639,-132.88923792094084,-0.09054651467238384,-0.7653823831551563,-0.6748358684827724,-389450038,-436741708.4,24.786511877261205,21.722324450734394,NaN,NaN,-30.220910202126166,-24.764929740128164
2004-08-17T09:30:00-04:00,33.12,33.44,32.98779,33.25999,89590000,106101524,41.35955059770815,37.07499340142528,NaN,NaN,-50.488140008166894,-114.96639641118755,-0.030165025587508332,-0.7125421504671579,-0.6823771248796495,-299860038,-432027983.6,25.714349756589712,22.73838932641518,NaN,NaN,-28.331972003826838,-25.27450720637083
2004-08-18T09:30:00-04:00,33.06,33.91,33.00999,33.85001,107996368,104693526.4,48.02744859198508,37.34381209013053,NaN,NaN,-14.947931763509926,-86.8565849436309,0.05313702247259966,-0.6159558467888999,-0.6690928692614996,-191863670,-381455849.2,34.98147859163362,24.47032552480092,NaN,NaN,-24.5424868567524,-25.169932870711055
2004-08-19T09:30:00-04:00,33.73,33.85001,33.41,33.672,106839008,103393352,46.31629946136621,37.401485284978584,NaN,NaN,-5.520462077419872,-57.548721976265746,0.0973034114793353,-0.5474636049123305,-0.6447670163916658,-298702678,-329442716.4,42.87471425548752,26.72057116167677,NaN,NaN,-21.959740160189053,-24.711333912065054
2004-08-20T09:30:00-04:00,33.57001,34.14101,33.50999,34.00999,92054880,102638836.8,49.96169822102261,37.660856567203226,NaN,NaN,20.1327514520903,-27.479862047338553,0.14733319285459534,-0.46060052532342155,-0.6079337181780169,-206647798,-277304844.4,49.493660400435054,28.905499696118284,NaN,NaN,-18.65125837723309,-23.84560883566049
2004-08-23T09:30:00-04:00,34.05,34.27,33.91,34.09,83583872,101165464.8,50.81318209274082,38.46023853008916,NaN,NaN,39.75389068437071,-2.213978342527123,0.1816159081030373,-0.38091383304922033,-0.5625297411522576,-123063926,-224027622,55.205291311845976,31.44246610976884,NaN,NaN,-15.707500702021424,-22.683021959426338
2004-08-24T09:30:00-04:00,34.25,34.31,33.81,34.08,86881184,100333055.2,50.69706474899015,39.242124373301316,NaN,NaN,40.29577866171011,15.942805391448289,0.19807334347981131,-0.3149380618024935,-0.5130114052823048,-209945110,-206044636.4,56.973975784314035,33.48271531981793,NaN,NaN,-13.334722717818623,-21.347550639196665
2004-08-25T09:30:00-04:00,34.06,34.60001,33.89999,34.55,88421184,97000804.8,55.808490721902004,40.75281574006139,NaN,NaN,67.93691077689725,32.519773899529724,0.23267654222558365,-0.22216572750032526,-0.4548422697259089,-121523926,-191976687.6,58.359126848089026,35.49941889928485,NaN,NaN,-9.707185732122186,-19.684641366757454
2004-08-26T09:30:00-04:00,34.46001,34.55,34.31,34.39999,57789200,94936305.6,53.888187063860265,42.52105316119063,NaN,NaN,78.318795838821,49.2876254827779,0.23674129040290987,-0.1589156567222716,-0.39565694712518146,-179313126,-168098777.2,60.67333925120359,37.84447818679049,NaN,NaN,-7.1946453487889475,-17.900356221333382
2004-08-27T09:30:00-04:00,34.46001,34.67999,34.44,34.56,58623104,93715470.4,55.64149473328781,44.33672848229379,NaN,NaN,96.5227598704985,64.56562716645954,0.24069721942398614,-0.09478542284519875,-0.3354826422691849,-120690022,-150907222,62.29795919287378,40.45776057155466,NaN,NaN,-4.574351949259144,-15.996641325322777
2004-08-30T09:30:00-04:00,34.41,34.42999,33.944,33.98,62423200,92768480,48.45020039636616,45.24900276022879,NaN,NaN,56.70527792435518,67.95590461445643,0.196603259317141,-0.08972856812275865,-0.28633182743989966,-183113222,-162917081.2,60.42013960224494,42.90519009728404,NaN,NaN,-4.278902561075227,-14.322678644715985
2004-08-31T09:30:00-04:00,34.02,34.121,33.64999,34.02,81401184,92546580,48.94032108719455,46.33954877771576,NaN,NaN,40.38120449468827,67.97298978105206,0.16382289080679394,-0.08155321393140724,-0.24537610473820118,-101712038,-141270466.8,62.60788521849257,45.67266847651441,NaN,NaN,-3.899945936834009,-12.833716829304274
2004-09-01T09:30:00-04:00,33.92999,34.47,33.8,34.27,96703008,93037964.8,52.011319321124446,47.85598917589964,NaN,NaN,69.4807327488757,68.28175417544774,0.15288038730833098,-0.054275620602787455,-0.20715600791111843,-5009030,-117967487.6,64.85970737426544,48.75084944592942,NaN,NaN,-2.705965308001935,-11.38689518340394
2004-09-02T09:30:00-04:00,34.17999,34.88,34.16,34.78,83288624,91705436.8,57.61221018403041,49.72220712319673,NaN,NaN,108.23681580073362,74.26535816783027,0.1724432059099869,0.008397999476365214,-0.1640452064336217,78279594,-66448943.6,69.26632502970328,52.03674746388856,NaN,NaN,0.052299294511746024,-9.7527245437017
2004-09-03T09:30:00-04:00,34.44,34.67,34.05,34.14101,90264816,88775687.2,49.7738049766959,50.66437658559102,NaN,NaN,67.38895128317382,68.43859645036534,0.13638176364277235,0.00643199811984374,-0.1299497655229286,-11985222,-44707983.6,70.92340462328218,55.33223980289005,NaN,NaN,0.05622060789293363,-8.351446664902467
2004-09-07T09:30:00-04:00,34.39999,34.61,34.12,34.42999,96621808,89674327.2,52.895119202892126,51.4883457716756,NaN,NaN,72.81810871824518,71.66116260914333,0.12625654854265786,0.02787092015539372,-0.09838562838726414,84636586,8841978,74.5615837267051,58.82132794361258,NaN,NaN,1.038189945445084,-7.010070006281388
2004-09-08T09:30:00-04:00,34.31,34.67999,34.17999,34.299,101706816,89442312,51.337723895308166,51.724794007627246,NaN,NaN,67.61611474660077,77.10814465952583,0.10582917018262614,0.03390083434101854,-0.0719283358416076,-17070230,25770339.6,75.60091617904607,61.72271634271347,NaN,NaN,1.3644976564262057,-5.81370319732316
2004-09-09T09:30:00-04:00,34.45,34.75,34.13,34.59,104577008,88606378.4,54.53995487228538,52.31219796555005,NaN,NaN,76.73358927765436,78.55871596528156,0.10670464227415193,0.06145246700108231,-0.045252175273069614,87506778,44273501.2,76.72049299124765,64.14027196669633,NaN,NaN,2.604290107248157,-4.611132725241543
2004-09-10T09:30:00-04:00,34.62,35.19,34.47,35.12,108640192,88336188,59.73676093159883,53.0104167305912,NaN,NaN,133.1706257980881,83.54547796475245,0.13589565481877852,0.12461739325040355,-0.011278261568374977,196146970,67846976.4,78.09929176369732,66.18353134978649,NaN,NaN,5.339666393686506,-3.1895899939661074
2004-09-13T09:30:00-04:00,35.25,35.72,35.14,35.58,109452816,89237269.6,63.62357129513402,53.92544453076215,NaN,NaN,210.04515466899582,112.07671864191684,0.17652708828935326,0.2093805987933166,0.03285351050396334,305599786,131363978,81.31117764239238,68.0482375162541,NaN,NaN,8.946787797374625,-1.4558217380602885
2004-09-14T09:30:00-04:00,35.45,35.73,35.36,35.63,76928624,89189344.8,64.03003476136325,54.87779953164594,NaN,NaN,206.47739596553922,138.80857609137564,0.19563160596853102,0.2773930179646271,0.0817614119960961,382528410,190942342.8,83.72258536345346,69.95885248619263,NaN,NaN,11.941243640827528,0.45804474463797096
2004-09-15T09:30:00-04:00,35.42,35.45,35.10001,35.25301,90500000,89234844.8,58.703891340716915,55.084613861561294,NaN,NaN,141.61100912653276,153.60755496736206,0.17254659121414448,0.2974446510137767,0.12489805979963223,292028410,252762070.8,85.77375751721337,71.91704039113007,NaN,NaN,12.890728728590734,2.234142456631223
2004-09-16T09:30:00-04:00,35.25999,35.57001,35.13,35.32001,67154320,87192742.4,59.35104609866139,55.4748180783328,NaN,NaN,131.60229053772096,164.58129521937536,0.15216928547151382,0.3151096666390245,0.1629403811675107,359182730,307097261.2,87.28978903845231,73.81821537593355,NaN,NaN,13.84897539689888,3.893404305240888
2004-09-17T09:30:00-04:00,35.23,35.52,35.16,35.42999,84071184,86054351.2,60.446778430772376,55.818052628153126,NaN,NaN,117.1214807116926,161.3714662020963,0.1369533899279461,0.3341321185774433,0.1971787286494972,443253914,356518650,88.49113716133184,75.68915665939484,NaN,NaN,14.954209117629617,5.473519278439277
2004-09-20T09:30:00-04:00,35.28999,35.77,35.17999,35.433,111328816,87018048,60.478178421512155,56.67719391566356,NaN,NaN,111.3866749307829,141.6397702544537,0.11863148871444767,0.3454680895425568,0.22683660082810914,554582730,406315238.8,89.56170683456828,77.77069717598938,NaN,NaN,15.871304546655649,6.958917173898759
2004-09-21T09:30:00-04:00,35.543,35.85001,35.42,35.57001,93737008,87525704.8,61.9585645537668,57.60706844899015,NaN,NaN,113.92650797198273,123.12959265574239,0.10760444944959208,0.3613421626400992,0.25373771319050714,648319738,459473504.4,90.57013274165233,79.76800057050079,NaN,NaN,17.05159284083447,8.400727983461003
2004-09-22T09:30:00-04:00,35.44,35.46001,34.87,34.95,101516192,88257455.2,52.394269679212314,57.63442204599642,NaN,NaN,40.198521334611655,102.84709509735816,0.05317124377907845,0.3202017679143552,0.2670305241352767,546803546,510428531.6,91.42527008520716,81.66554076413948,NaN,NaN,15.35507074155208,9.394205520331157
2004-09-23T09:30:00-04:00,34.98,35.14999,34.877,34.91901,92599184,88466355.2,51.9625028872756,57.23087152479966,NaN,NaN,21.676245102576598,80.8618860103293,0.011854064832410582,0.28184810517578995,0.26999404034337937,454204362,529432858,91.7266148573417,83.26984718039937,NaN,NaN,13.845633234572801,10.03012376522282
2004-09-24T09:30:00-04:00,34.99001,35.19,34.75,34.799,103282000,90740995.2,50.236024092316406,57.26388717591541,NaN,NaN,9.202755613999212,59.27814099079063,-0.02478439411426231,0.2390135477005515,0.2637979418148138,350922362,510966547.6,88.47299886484869,84.52338962622555,NaN,NaN,12.087173779894659,10.323988053033082
2004-09-27T09:30:00-04:00,34.62,34.74001,34.38,34.5,86108880,92115284,46.124165726685405,56.780247641900644,NaN,NaN,-43.57966937042494,28.284872130549083,-0.06793590844581474,0.17887805625754538,0.24681396470336012,264813482,453012698,79.00199862520704,84.84056211897567,NaN,NaN,9.350348739113219,10.184896722473102
2004-09-28T09:30:00-04:00,34.55,34.69,34.23,34.57001,87265184,93357383.2,47.21364293824135,56.48567043068159,NaN,NaN,-54.841040469578964,-5.468637557763257,-0.08920341022527215,0.13530970192176994,0.2245131121470421,352078666,393764483.6,70.67259688221992,84.48853931205953,NaN,NaN,7.354499266904573,9.780554228820455
2004-09-29T09:30:00-04:00,34.56,35.12,34.53,35.08,95886128,94081630.4,54.44107296703914,56.47860743744972,NaN,NaN,-0.873746386019546,-13.683091101889497,-0.06735775097229058,0.14031592343167887,0.20767367440396944,447964794,373996733.2,68.0930399342482,83.872292665131,NaN,NaN,7.608336324274986,9.47023738531396
2004-09-30T09:30:00-04:00,35.05,35.27,34.89,35.14,74676816,92980320.8,55.217929192383494,56.155833741791476,NaN,NaN,25.224279840061726,-12.973484154392471,-0.048198571782966326,0.14742545967526155,0.19562403145822788,522641610,387684182.8,68.93844952073815,83.21794679063392,NaN,NaN,8.03748485099622,9.265558451839997
2004-10-01T09:30:00-04:00,35.45,36.14999,35.36,36.10001,118325680,94732173.6,65.38762120869333,56.281837307045706,NaN,NaN,143.6282741816868,13.911619559145015,0.025818807823278223,0.22789754123732564,0.20207873341404742,640967290,445693168.4,72.28951757373636,82.57354250001562,NaN,NaN,11.884003935196894,9.639622092319554
2004-10-04T09:30:00-04:00,36.36,36.62,36.25,36.313,108512624,95644564,67.16899845212822,56.506048999243205,NaN,NaN,200.6264619242868,62.75284581808736,0.08260821381330782,0.3053390006806822,0.22273078686737438,749479914,542626454.8,76.79467630813653,82.07869185320726,NaN,NaN,15.588578855537532,10.489473058493552
2004-10-05T09:30:00-04:00,36.23,36.49001,36.16,36.36,89827184,95304832.8,67.56568954512392,57.13903458527228,NaN,NaN,166.8033325014093,107.08172041228502,0.1148410903536663,0.3662821498094573,0.251441059455791,839307098,640072141.2,80.26777031158105,81.68540705280496,NaN,NaN,18.651285330781313,11.655446240248946
2004-10-06T09:30:00-04:00,36.31,36.95,36.11,36.64999,88007808,94619882.4,69.97617330382275,57.8979722427838,NaN,NaN,177.0628431134363,142.66903831217618,0.14523801737962733,0.4329885811803251,0.2877505638006978,927314906,735942163.6,82.96852995539469,81.37674568972942,NaN,NaN,22.009427529086583,13.134586424368608
2004-10-07T09:30:00-04:00,36.53999,36.67,36.17,36.24001,82456128,93513838.4,62.86306494874372,58.0705641369246,NaN,NaN,129.46237804380482,163.5166579529248,0.1278892727122879,0.44761215469105764,0.31972288197876975,844858778,800385597.2,84.50389886461502,81.09194295424966,NaN,NaN,22.693216084879598,14.50010494729875
2004-10-08T09:30:00-04:00,36.08,36.24001,35.5,35.58,115122624,93837960,53.44449917501397,57.56815847646045,NaN,NaN,42.520401330737855,143.29508338273502,0.06527609987168709,0.4013180068183786,0.3360419069466915,729736154,818139370,84.90755981604521,80.75950388149799,NaN,NaN,20.102476995396458,15.300443811312709
2004-10-11T09:30:00-04:00,35.69,35.86,35.60001,35.75,51312096,90930924,55.302128897107785,57.09269878669909,NaN,NaN,34.49857816569176,110.069506631016,0.03039486806313102,0.37403549202560527,0.34364062396247425,781048250,824453037.2,85.05663943857628,80.36568293127827,NaN,NaN,18.627964492834252,15.775803908672929
2004-10-12T09:30:00-04:00,35.42999,35.84,35.2,35.69,98308192,91999902.4,54.47593898972813,57.241389451735934,NaN,NaN,12.532005912490424,79.21524131323223,-0.000023327284227270262,0.3436114648571902,0.34363479214141746,682740058,793139629.2,80.7940683721271,79.606311380344,NaN,NaN,17.200111738842608,15.979276455840026
2004-10-13T09:30:00-04:00,36.06,36.14,35.42999,35.61,132823120,94116058.4,53.331880179321104,57.33920211545347,NaN,NaN,29.872330699366078,49.777138830418195,-0.02732590588605771,0.3094774097838453,0.336803315669903,549916938,717660035.6,71.49341696832073,78.16108295969966,NaN,NaN,15.698494995707318,15.93916481867821
2004-10-14T09:30:00-04:00,35.69,35.78,35.33,35.45,99445632,95730624,51.023900609655094,57.39547900954909,NaN,NaN,0.3920145737996291,23.96306613641716,-0.05628756182406869,0.2664438633898172,0.32273142521388587,450471306,638782541.2,63.29363734495155,76.36255713684986,NaN,NaN,13.764559228241438,15.628506877187242
2004-10-15T09:30:00-04:00,35.49001,35.856,35.28,35.63,129195008,97986815.2,53.463806779445164,57.91973908474622,NaN,NaN,8.52133292172915,17.163252454615424,-0.06294458099638789,0.24405069896840104,0.3069952799647889,579666314,608768573.2,60.45241780078157,75.03758707796233,NaN,NaN,12.808306635954558,15.225621128439716
2004-10-18T09:30:00-04:00,35.50999,36.25,35.39999,36.14,109313312,97886040,59.60433888224696,58.80478879503233,NaN,NaN,51.937081345983145,20.650953090673706,-0.03406922151908215,0.26440875306593625,0.2984779745850184,688979626,590354848.4,58.71113958976428,74.18319727135835,NaN,NaN,13.799099673192003,15.021832349118615
2004-10-19T09:30:00-04:00,36.38,36.57001,35.78999,35.88,130141504,99706264.8,55.5780380642147,58.886000587687725,NaN,NaN,66.75651251323872,31.49585441082337,-0.033498500031083234,0.25660484954616436,0.2901033495772476,558838122,565574461.2,56.35844987889195,73.34501226740433,NaN,NaN,13.413217435162602,14.792030218553471
2004-10-20T09:30:00-04:00,35.83,36.23,35.64999,36.048,106851808,99973045.6,57.57237127300064,59.054175022017525,NaN,NaN,48.131284471958836,35.14764516534192,-0.023308185474715692,0.260968117733853,0.28427630320856867,665689930,588729059.6,58.05001904106087,72.56726723314166,NaN,NaN,13.685386260268286,14.63393822451273
2004-10-21T09:30:00-04:00,36.24001,36.78999,36.10001,36.60001,124414320,101563802.4,63.388567544901356,58.91138547460381,NaN,NaN,108.81084285340025,56.83141082126205,0.016937055678757695,0.30544762280701576,0.28851056712825807,790104250,656655648.4,62.62658391506321,71.87705768609358,NaN,NaN,15.78803338100801,14.798808961154913
2004-10-22T09:30:00-04:00,36.61,36.64999,35.74001,35.8,114377632,102118584,52.21654973105316,57.84335342309845,NaN,NaN,45.323849479259614,64.19191413276813,-0.012410940291433081,0.2729968917639667,0.28540783205539977,675726618,675867709.2,63.82855104550237,70.95090588161972,NaN,NaN,13.82230666190688,14.659308632690909
2004-10-25T09:30:00-04:00,35.73,35.81,35.49001,35.625,102980000,102962140,50.134989754883804,56.598303438081295,NaN,NaN,-27.593234573844097,48.28585094880269,-0.043925193495580495,0.23050134018592416,0.27442653368150466,572746618,652621107.6,61.26119862116426,69.59329361801852,NaN,NaN,11.571762363600934,14.218230594249484
2004-10-26T09:30:00-04:00,35.64999,35.84,35.41,35.82001,98245184,103511140,52.41158344727697,55.34368987689946,NaN,NaN,-34.64398431113302,28.005751583928337,-0.05143189734849779,0.21013666199588243,0.2615685593443802,670991802,675051843.6,62.81538303759417,68.15378312388991,NaN,NaN,10.483529127825703,13.6847018133318
2004-10-27T09:30:00-04:00,35.84,36.89999,35.71001,36.73,152572880,106345477.6,61.29235645343416,55.23149641294877,NaN,NaN,103.81344985310044,39.14218466015666,0.002247956422635089,0.2643785048726741,0.262130548450039,823564682,706626794,64.94726019642295,66.75688036187618,NaN,NaN,12.636519486750815,13.534961480963089
2004-10-28T09:30:00-04:00,36.67999,37.12,36.57001,36.96001,111151184,108169196,63.16356375829711,55.92571531175471,NaN,NaN,170.04216445478588,51.38844898043378,0.04806451390534727,0.3222111908317231,0.27414667692637584,934715866,735549117.2,66.8235665210255,65.46516655508906,NaN,NaN,14.977834970443027,13.74108626517451
2004-10-29T09:30:00-04:00,36.91,37.24001,36.67,36.89999,100828496,107294336.8,62.316988473957245,56.426776710101095,NaN,NaN,151.83615440886945,72.69090996635575,0.06793214417365512,0.35906185714344474,0.2911297129697896,833887370,767181267.6,68.79117811661504,64.30334788923469,NaN,NaN,16.53454746719251,14.14015215117708
2004-11-01T09:30:00-05:00,36.98,37.17999,36.8,37.03799,72528496,105495130.4,63.527401110219394,57.07330971870761,NaN,NaN,144.5456142735456,107.11867973583371,0.08297633826119438,0.3948501357962826,0.3118737975350882,906415866,833915117.2,72.4970552587122,63.71070409541934,NaN,NaN,18.16869936358267,14.71565889580645
2004-11-02T09:30:00-05:00,37.09,37.55,37.00999,37.161,109171680,106462355.2,64.61836837078984,57.879487446669664,NaN,NaN,154.82657844787585,145.01279228763548,0.09306290784279325,0.4282024323385798,0.33513952449578654,1015587546,902834266,75.70553559507088,64.01156971161576,NaN,NaN,19.832730317374057,15.446669098887538
2004-11-03T09:30:00-05:00,37.77,37.89999,37.14999,37.41,141197632,109121846.4,66.78424047118864,59.00522600820778,NaN,NaN,164.1687727634456,157.0838568697045,0.10734165805720342,0.4693165970672908,0.36197493901008737,1156785178,969478365.2,78.3372580857525,65.08611405024442,NaN,NaN,21.89075739957178,16.36725314184243
2004-11-04T09:30:00-05:00,37.25999,37.78,37.11,37.62,112608496,110629464.8,68.53370519049304,60.08164732328263,NaN,NaN,140.41906690019178,151.15923735878567,0.12076592795488789,0.5129323489536972,0.39216642099880933,1269393674,1036413926.8,80.60925225410554,66.52588793976756,NaN,NaN,24.146247251082812,17.478538014591056
2004-11-05T09:30:00-05:00,38.02,38.16,37.61,37.96001,117078368,110727252,71.18041207269545,60.90850969402895,NaN,NaN,156.25775433606333,152.04355734422447,0.1409725882281715,0.5683821562840237,0.4274095680558522,1386472042,1146930861.2,83.65701863192768,68.30773644277922,NaN,NaN,26.90656487250912,18.825398994293636
2004-11-08T09:30:00-05:00,37.95,38.10001,37.85001,38,66505680,111486931.2,71.48421362543264,62.0446650912588,NaN,NaN,141.000455723135,151.33452563414235,0.14490317232773425,0.60853853346552,0.46363536113778575,1452977722,1256243232.4,86.00079263376439,70.42504663955582,NaN,NaN,29.245188999388315,20.313940423592875
2004-11-09T09:30:00-05:00,37.92999,38.14999,37.81,37.92,85250192,110834031.2,69.89682616731953,62.924983297995865,NaN,NaN,120.92768564124563,144.5547470728163,0.13043843436600233,0.6266834040952887,0.49624496972928633,1367727530,1326671229.2,87.26771897754814,72.51202520644777,NaN,NaN,30.766997459144797,21.807234285814577
2004-11-10T09:30:00-05:00,37.92999,38.06,37.64,37.78999,95167008,108951225.6,67.28199811331356,63.203085481453876,NaN,NaN,97.6798112019668,131.25695476052056,0.10171331343423429,0.6233866115220792,0.5216732980878449,1272560522,1349826298,87.66303258248647,74.30034296840657,NaN,NaN,31.36174273446394,23.17216406419306
2004-11-11T09:30:00-05:00,37.91,38.38,37.86,38.28999,99805808,108969234.4,71.67125451974073,64.59270725207442,NaN,NaN,116.20219697665624,126.41358077581344,0.10552982019759938,0.6535855733348441,0.5480557531372447,1372366330,1370420829.2,88.01932561405619,76.028255437589,NaN,NaN,33.19367195665935,24.6038080488311
2004-11-12T09:30:00-05:00,38.34,38.75999,38.17,38.66,102697504,107644359.2,74.4074429334708,66.32645390768776,NaN,NaN,132.75346167904402,121.71272224440959,0.12100653924678961,0.6993139271957318,0.5783073879489422,1475063834,1388139187.6,88.33155106096065,77.9618520404316,NaN,NaN,35.635745623887885,26.179799130982072
2004-11-15T09:30:00-05:00,38.64,38.86,38.5,38.83,82736368,106315512,75.57473128203817,67.98096446731357,NaN,NaN,132.38016000846392,119.98866310147537,0.12994036895403605,0.7407328491414873,0.6107924801874512,1557800202,1409103683.6,88.70657444776333,79.81122285544367,NaN,NaN,38.02385240283206,27.871806741246356
2004-11-16T09:30:00-05:00,38.66,38.67999,38.32001,38.593,97452624,104681068,70.73122614183194,68.65516944505627,NaN,NaN,104.9521780629161,116.79356158580947,0.10803496670401203,0.7458361885674663,0.6378012218634542,1460347578,1427627693.2,89.04171206956664,81.5322551320968,NaN,NaN,38.634077591708746,29.409274005598125
2004-11-17T09:30:00-05:00,38.83,39.32001,38.83,39.11,125450128,105610984,74.56128312619585,69.46929225704903,NaN,NaN,135.68168257174355,124.39393585976477,0.1158207336774475,0.7825771389602636,0.6667564052828161,1585797706,1490275130,90.11057390862197,83.1956128026394,NaN,NaN,40.38210120083987,30.976820747775516
2004-11-18T09:30:00-05:00,38.98,39.36,38.88699,39.28999,94980192,104139277.6,75.75098285926828,70.42886328457125,NaN,NaN,128.35011131896513,126.82351872822656,0.12003703777313779,0.8168027024992384,0.6967656647261006,1680777898,1551957443.6,91.03750959019428,84.78463647932362,NaN,NaN,42.188883020848266,32.578543929643054
2004-11-19T09:30:00-05:00,39.24001,39.28999,38.59,38.67999,118558368,104348314.4,64.70626478984974,70.51306783311627,NaN,NaN,94.36735591338201,119.14629757509415,0.07110614113183289,0.7856483411408917,0.7145422000090588,1562219530,1569388582.8,91.28607579901757,86.12670937505972,NaN,NaN,40.18796520823017,33.665604112298354
2004-11-22T09:30:00-05:00,38.61,39.07001,38.48,39.05,79973120,103197970.4,67.7754399139142,70.73857294333945,NaN,NaN,90.52005629317749,110.77427683203686,0.05380853059638546,0.7818028632545406,0.7279943326581552,1642192650,1586267072.4,91.53100345868326,87.25709993674631,NaN,NaN,39.50482603541176,34.499778672743126
2004-11-23T09:30:00-05:00,39.00999,39.14999,38.61,38.99001,91926496,102882036,66.76175754828478,70.73696702027489,NaN,NaN,89.00884423673847,107.58561006680134,0.029680584313542258,0.765095063050083,0.7354144787365408,1550266154,1604250787.6,91.79561017381364,88.21841080017927,NaN,NaN,38.648041483387466,35.09238764569232
2004-11-24T09:30:00-05:00,39.09,39.39,39.07001,39.33,74091008,98957942.4,69.54211863693526,70.80899655216362,NaN,NaN,111.46440144954154,102.74215384236092,0.02799448384188552,0.7704075835388977,0.7424130996970122,1624357162,1611962678.8,91.9123071800767,89.02577186632006,NaN,NaN,38.77953322712619,35.6191227287543
2004-11-26T09:30:00-05:00,39.37,39.48,39.17,39.21001,31303200,94965543.2,67.39931570973152,70.53891824052333,NaN,NaN,103.23769785837914,97.71967115024374,0.011044231632523549,0.7562183892376666,0.745174157605143,1593053962,1594417891.6,88.81715381050415,89.3943529505041,NaN,NaN,38.2381128351436,35.9932641725242
2004-11-29T09:30:00-05:00,39.46001,39.64,38.97,39.203,94786880,94663462.4,67.26890707952606,70.23782491581572,NaN,NaN,93.80540709223762,97.60728138601488,-0.007399787320276685,0.7359244234547972,0.7433242107750739,1498267082,1581627402,86.52946847040066,89.43211551026384,NaN,NaN,37.764290320783864,36.24626790798987
2004-11-30T09:30:00-05:00,39.3,39.39,39.06,39.12199,87703872,95422231.2,65.68716146647611,69.93713458004119,NaN,NaN,80.17858072309721,95.53898627199881,-0.03051884588837961,0.7051756534145994,0.735694499302979,1410563210,1535301514,78.62981636036062,88.815122466179,NaN,NaN,36.930257393740035,36.34398069166846
2004-12-01T09:30:00-05:00,39.27,39.961,39.27,39.92,102435008,95085397.6,72.5375591759103,70.31253179879809,NaN,NaN,131.09026625857697,103.95527067636651,0.0008103720079027932,0.7367074643128575,0.7358970923049547,1512998218,1527847926.8,77.4053657715761,88.08243197968541,NaN,NaN,38.26489977515916,36.618397703595704
2004-12-02T09:30:00-05:00,39.82001,40.39,39.75999,40.07001,122306128,94140822.4,73.60437075211378,70.45061152968188,NaN,NaN,160.32588823590766,113.72756803363973,0.023268692226876664,0.7649829575885505,0.7417142653616738,1635304346,1530037363.6,77.51612423957016,87.33220331007927,NaN,NaN,39.683690052115004,37.056296610527035
2004-12-03T09:30:00-05:00,40.31,40.59,40.08,40.13,114276496,94224222.4,74.03869929147638,70.42427269811085,NaN,NaN,169.79977340700344,127.0399831433646,0.03319170322984499,0.7832038943989801,0.7500121911691351,1749580842,1561342739.6,79.09413837970764,86.6723881185612,NaN,NaN,40.96202579567805,37.614257922691465
2004-12-06T09:30:00-05:00,40.12,40.42599,39.91,40.27,70505184,91895563.2,75.0696743442001,70.38819720255098,NaN,NaN,144.13867996653585,137.10663771822425,0.039768045308146704,0.7997222478043184,0.7599542024961717,1820086026,1625706528.4,81.90593116322206,86.1866278839511,NaN,NaN,42.331559029335395,38.288158080783454
2004-12-07T09:30:00-05:00,40.33,40.5,39.53,39.58,121669504,94653754.4,62.00113407057221,69.76461919746102,NaN,NaN,95.94872517198252,140.26066660800132,-0.009157282966586688,0.7485075987879384,0.7576648817545251,1698416522,1683277190.8,83.98126415027602,85.8251673182875,NaN,NaN,39.45462168466631,38.454795738481
2004-12-08T09:30:00-05:00,39.66,39.98,38.81,39.81,96436624,95213076,64.2360997202151,69.02710609703385,NaN,NaN,48.644132398318916,123.77143983594969,-0.03157211440667673,0.7181997387461792,0.7497718531528559,1794853146,1739648176.4,85.7096244364932,85.51081378456401,NaN,NaN,37.76340578369163,38.356025744939664
2004-12-09T09:30:00-05:00,39.5,40.19,39.24001,40.05,134422560,97175853.6,66.45336314828265,68.36299040339202,NaN,NaN,80.36750120212787,107.77976242919371,-0.03548552164834151,0.705414951092429,0.7409004727407705,1929275706,1798442448.4,87.25428898326041,85.24058374121158,NaN,NaN,37.03266823958902,38.16697467274672
2004-12-10T09:30:00-05:00,39.85001,40.07001,39.74001,39.92999,86252368,96498181.6,64.30643394860944,68.33443105758914,NaN,NaN,81.58523717594822,90.13685518298269,-0.05049156582956127,0.6777860154538189,0.7282775812833802,1843023338,1817130947.6,87.70906701658426,84.98508311389492,NaN,NaN,35.789041007251846,37.827269863390306
2004-12-13T09:30:00-05:00,40.22,40.34,39.98,40.28,74339248,95080268.8,67.59468319634126,68.32151986347678,NaN,NaN,109.06356221922556,83.12183163352061,-0.041552959472614726,0.6763363819426118,0.7178893414152265,1917362586,1836586259.6,88.18182019968236,84.74585573825199,NaN,NaN,35.70725068946717,37.524409981401284
2004-12-14T09:30:00-05:00,40.25999,40.59,40.25,40.47701,92019744,95544437.6,69.30857852521504,68.50343564754324,NaN,NaN,127.08819991503928,89.34972658213196,-0.02774428152305597,0.6832089895114066,0.7109532710344626,2009382330,1898779421.2,89.56374219177218,84.5864365966776,NaN,NaN,36.155611333919154,37.328867317475265
2004-12-15T09:30:00-05:00,40.49001,40.67999,40.155,40.33,95230000,95433306.4,66.4829092514311,68.2849206914358,NaN,NaN,108.81520056311811,101.3839402150918,-0.03349832864095126,0.6690803602332736,0.7025786888742248,1914152330,1922639258,90.04468925090866,84.45303531602273,NaN,NaN,35.6967861712292,37.09571286801154
2004-12-16T09:30:00-05:00,40.32001,40.45,39.82001,39.95,86265056,93474052.8,59.706812108364105,67.73545614848098,NaN,NaN,58.476480831856826,97.00573614103759,-0.06600480420602728,0.6200726836166908,0.686077487822718,1827887274,1902361571.6,86.40047242901271,84.28041521734477,NaN,NaN,33.22013094488291,36.542058307564595
2004-12-17T09:30:00-05:00,39.64999,39.81,37.21001,39.47501,102214000,93835743.2,52.503336877912155,66.68077256265141,NaN,NaN,-112.85630217188749,58.117428271470445,-0.11948674206346066,0.5367190602433922,0.6562058023068529,1725673274,1878891558.8,82.25123633584644,83.97482720773378,NaN,NaN,28.699666868605433,35.421716673427575
2004-12-20T09:30:00-05:00,39.57001,39.771,39.09,39.2,106719872,93243818.4,48.83005623045708,65.47669361722149,NaN,NaN,-46.92036818539368,26.920642190546594,-0.17027749090120425,0.4433589386803476,0.6136364295815518,1618953402,1819209722,72.69143611483726,83.55065719019639,NaN,NaN,23.738408604814957,33.75267266362577
2004-12-21T09:30:00-05:00,39.38,39.71001,39.278,39.67999,83240688,93407196.8,54.7770136567846,64.20808322299823,NaN,NaN,-24.374487279882022,-3.3718952484376623,-0.16814848658890869,0.403450821345416,0.5715993079343247,1702194090,1757772074,64.39425468206244,82.621292112374,NaN,NaN,21.345256645767424,31.98018466107458
2004-12-22T09:30:00-05:00,39.535,39.92999,39.48801,39.73,75507440,92586244,55.35914600410069,62.904852883854424,NaN,NaN,-5.770061550173478,-26.28894767109598,-0.1600190868266541,0.37157544940100706,0.5315945362276612,1777701530,1730481914,61.0602798856295,81.44587465852109,NaN,NaN,19.634695571455207,30.216543362557527
2004-12-23T09:30:00-05:00,39.61,39.91,39.53999,39.758,45816384,91172512.8,55.70295961475471,61.59515719266003,NaN,NaN,-6.843008131271028,-39.35284546372155,-0.14959482292528864,0.3446010075710504,0.49419583049633903,1823517914,1729608042,60.95145563156215,80.14996874793925,NaN,NaN,18.360951795954527,28.522887424471385
2004-12-27T09:30:00-05:00,39.98,40.02,39.39999,39.59,67278368,92971271.2,53.062299120302235,60.02320181952446,NaN,NaN,-24.241876634568204,-21.629960356257687,-0.1504459450263264,0.306138399213431,0.4565843442397574,1756239546,1735721296.4,61.46881063246643,78.69017442431384,NaN,NaN,16.523526708936622,26.808693036537846
2004-12-28T09:30:00-05:00,39.67,40.00101,39.61,39.97,62616688,91362761.6,57.9213865810743,59.73179128456032,NaN,NaN,8.533595433173103,-10.539167632544334,-0.12300466689330808,0.3028285106231223,0.4258331775164304,1818856234,1775701862.8,64.75742251938044,77.31704287924988,NaN,NaN,16.342195239341546,25.313479065509803
2004-12-29T09:30:00-05:00,39.92,40.16,39.89999,40.02,50112176,89483176.8,58.529719015358204,59.32419266278483,NaN,NaN,38.68755054755583,2.073239932943245,-0.10004825409544621,0.30077285989712266,0.40082111399256887,1868968410,1809056726.8,67.26743113811918,75.99974335793745,NaN,NaN,16.36931241901655,24.035740973153622
2004-12-30T09:30:00-05:00,40.07001,40.123,39.92999,39.99001,41728208,86447836.8,57.98820418379002,58.71953845103536,NaN,NaN,32.321282521696524,9.691508747317247,-0.08598302581593631,0.29334233172264845,0.37932535753858476,1827240202,1818964461.2,67.99655965074479,74.62419126275778,NaN,NaN,16.244119531318933,22.922652195748668
2004-12-31T09:30:00-05:00,40.03,40.121,39.89999,39.91499,44145568,82539808.8,56.57804819692586,58.167510897343675,NaN,NaN,25.438004176390287,16.147711208849508,-0.08090567894304967,0.27819325885977264,0.3590989378028223,1783094634,1810879805.2,66.69109913872605,73.12290784291076,NaN,NaN,15.763335979891679,21.899892736340526
2005-01-03T09:30:00-05:00,40.08,40.29201,39.37,39.49899,101052192,81878593.6,49.40362101805515,56.86814931318038,NaN,NaN,-31.29908065984173,14.7362704037948,-0.10330407152533982,0.2299688483961475,0.33327291992148733,1682042442,1796040384.4,64.25268120831595,71.41368362924173,NaN,NaN,13.259450329333875,20.665543821053863
2005-01-04T09:30:00-05:00,39.69,39.74001,38.55,38.78,136759312,85191300,39.96983838002867,54.77252501709564,NaN,NaN,-173.145811972654,-21.599611077370618,-0.16085022763868712,0.13221013537312842,0.29306036301181554,1545283130,1741325763.6,56.106983074967864,69.02391512089856,NaN,NaN,7.745320183884871,18.819797587172577
2005-01-05T09:30:00-05:00,38.67999,38.96001,38.47,38.53999,128424256,85529037.6,37.40230210595768,52.695338792418966,NaN,NaN,-205.30597679169045,-70.39831654521988,-0.20647566159316616,0.034965786020357825,0.24144144761352399,1416858874,1650903856.4,45.77816962920519,65.86202086220547,NaN,NaN,2.3491483174237047,16.466847691494166
2005-01-06T09:30:00-05:00,38.63,38.71001,38.34,38.347,103981120,85906262.4,35.4314102842237,50.961381519266084,NaN,NaN,-193.84530217109497,-115.63163348377819,-0.23876635084967499,-0.057016490948569754,0.18174985990110523,1312877754,1548031366.8,37.35314845502686,62.358640578349345,NaN,NaN,-2.7200851827371677,13.72585728088969
2005-01-07T09:30:00-05:00,38.57001,38.873,38.21001,38.55,123159248,85343096.8,39.06848596841383,50.001749311444776,NaN,NaN,-146.94743753523105,-150.10872182610245,-0.23519099567156043,-0.11223888468834531,0.12295211098321512,1436037002,1478619840.4,32.94712210218479,58.8369181330878,NaN,NaN,-5.822478649087607,10.933237862321505
2005-01-10T09:30:00-05:00,38.44,38.87,38.38901,38.53,88824624,85471709.6,38.83637887771257,49.28791521482016,NaN,NaN,-118.43638181611183,-167.53618205735648,-0.2230182158869595,-0.15582065887548424,0.06719755701147526,1347212378,1411653827.6,29.35014511455276,55.74111163306748,NaN,NaN,-8.382102550743296,8.173903517597962
2005-01-11T09:30:00-05:00,38.37,38.496,38.069,38.259,107283376,87118916,35.73812127777359,47.927994330605095,NaN,NaN,-134.11675295649508,-159.7303702541247,-0.22160478414195375,-0.20980842316596693,0.011796360975986825,1239929002,1350583002,26.507911810653766,53.03494428510972,NaN,NaN,-11.524231940202375,5.359884166483628
2005-01-12T09:30:00-05:00,38.44,38.60001,38.00999,38.58,127885808,88912219.2,41.67370716101325,46.950462984670274,NaN,NaN,-105.91410722723953,-139.8519963412345,-0.18872405862346792,-0.22410871230334806,-0.035384653679880154,1367814810,1340774189.2,26.071216918086762,50.535725501713806,NaN,NaN,-12.470392544370718,2.8127017792187217
2005-01-13T09:30:00-05:00,38.60001,38.85001,38.00999,38.07001,102117504,89256594.4,35.986589919416346,45.54215086357469,NaN,NaN,-102.28919978072092,-121.54077586315968,-0.1904456051063309,-0.2734416600627938,-0.0829960549564629,1265697306,1331338099.6,25.63372046854556,48.013030132926914,NaN,NaN,-15.147241581773322,0.24699558479128703
2005-01-14T09:30:00-05:00,38.2,38.52,38.19,38.42999,93530064,89619844.8,42.0029942339088,44.75220051454658,NaN,NaN,-85.09215652391599,-109.16971966089666,-0.15781142196220593,-0.2802603324092203,-0.12244891044701439,1359227370,1315976173.2,24.90111471317752,45.40105185297771,NaN,NaN,-15.447411697780042,-1.9950625984331887
2005-01-18T09:30:00-05:00,38.28,38.78999,38.22,38.72,92042128,89111251.2,46.37566942494726,43.92750643196608,NaN,NaN,-60.839183445972836,-97.65027998686887,-0.10946010865952593,-0.2592740462714218,-0.14981393761189588,1451269498,1336787597.2,27.907134072972312,42.768888392519976,NaN,NaN,-14.2618058832586,-3.74745449626539
2005-01-19T09:30:00-05:00,38.73,38.75,38.06,38.08,105302880,89040401.6,39.328692654184906,42.55600454902513,NaN,NaN,-81.75877280121404,-87.17868395581266,-0.11289384220287371,-0.290931240365488,-0.1780373981626143,1345966618,1357995120.4,30.940699020208854,40.17412181266924,NaN,NaN,-15.624079719075862,-5.444115242381171
2005-01-20T09:30:00-05:00,37.64999,37.811,37.32001,37.35001,121107312,90933732.8,33.142546904027995,40.78131474332783,NaN,NaN,-145.0248357994218,-95.00082967024912,-0.15409108154442025,-0.3706512500931396,-0.21656016854871935,1224859306,1329404019.6,29.15929033134846,37.400031146998074,NaN,NaN,-19.09038236633377,-7.393581974374399
2005-01-21T09:30:00-05:00,37.49001,37.55,36.99001,37.05,115496688,92933195.2,30.98543934841797,38.95327125414871,NaN,NaN,-155.33247631429364,-105.60948497696367,-0.189006603525523,-0.45281842295562313,-0.2638118194301001,1109362618,1298137082,27.307648822710036,34.58692755299693,NaN,NaN,-22.593979040291508,-9.565067269505414
2005-01-24T09:30:00-05:00,37.12,37.2,36.46001,36.53,137586432,97521697.6,27.62883061400248,37.397929082430664,NaN,NaN,-180.39130035350533,-124.66931374288154,-0.2317630009864865,-0.5535155706632082,-0.3217525696767217,971776186,1220646845.2,23.35018769084742,31.665320873177752,NaN,NaN,-26.709337340399863,-12.014248708204622
2005-01-25T09:30:00-05:00,36.77,37.09,36.66,36.71001,120045504,100160054.4,30.438094296959022,36.717090219354255,NaN,NaN,-158.75976587288991,-144.25343022826496,-0.2319913086796334,-0.6117417055262635,-0.3797503968466301,1091821690,1148757283.6,20.396933912693953,29.11460307587247,NaN,NaN,-28.963678683697115,-14.435595847560693
2005-01-26T09:30:00-05:00,36.96001,37.28999,36.82401,37.14999,107711312,102414785.6,36.88673997505101,36.68026435286091,NaN,NaN,-122.36915761534578,-152.37550719109132,-0.1884324321636155,-0.6152909370511495,-0.42685850488753396,1199533002,1119470560.4,19.324645626409435,27.225065647101342,NaN,NaN,-28.635572627685647,-16.464163959007116
2005-01-27T09:30:00-05:00,37.09,37.27,36.87,37.10001,109788752,105398614.4,36.47310450369096,36.75467108282287,NaN,NaN,-109.90524631108806,-145.35158929342455,-0.15055065210385676,-0.6150468200173549,-0.4644961679134981,1089744250,1092447549.2,18.36526380278447,25.86878817194117,NaN,NaN,-28.510437445828334,-18.185060171410147
2005-01-28T09:30:00-05:00,37.21001,37.27,36.62,36.92,111793312,108901869.6,34.95285382956607,36.46069735861945,NaN,NaN,-105.17898411647666,-135.32089085386116,-0.12616806706345518,-0.6222062517428171,-0.4960381846793619,977950938,1066165213.2,17.457491968428656,24.762386019530016,NaN,NaN,-28.871236288012707,-19.711656759496226
2005-01-31T09:30:00-05:00,37.36,37.53,37.25999,37.39999,89381312,111163656.8,41.90618067749582,36.67996891574683,NaN,NaN,-55.38977192587243,-110.32058516833456,-0.06911747067077989,-0.5824350230178368,-0.5133175523470569,1067332250,1085276426,20.533398548360935,24.132618407659173,NaN,NaN,-26.963249703963733,-20.747598608705868
2005-02-01T09:30:00-05:00,37.47,37.64819,37.37,37.52,76815312,109951812.8,43.53150683742447,37.236639312864746,NaN,NaN,-37.169952230015994,-86.00262243975978,-0.017397434105985266,-0.5350643449795385,-0.5176669108735532,1144147562,1095741600.4,22.242164372033045,23.8279221620434,NaN,NaN,-24.92157919680461,-21.343881549862832
2005-02-02T09:30:00-05:00,37.64999,37.73,37.31,37.58,101911120,108209403.2,44.36950300728139,37.42919615902675,NaN,NaN,-28.822402636591058,-67.29327144400884,0.024480215314527598,-0.4870666417303937,-0.5115468570449213,1246058682,1105046736.4,23.8109068340179,23.66647144175277,NaN,NaN,-23.019393796283307,-21.583240442208613
2005-02-03T09:30:00-05:00,37.38,37.41299,37,37.15401,90926368,106334508.8,39.84807127900896,37.70501625614052,NaN,NaN,-59.66707909099936,-57.2456379999911,0.026923009768286432,-0.4778930948345632,-0.5048161046028496,1155132314,1118124349.2,26.06840798144438,23.69752054981697,NaN,NaN,-22.672866967958623,-21.738901374458614
2005-02-04T09:30:00-05:00,37.14999,37.82001,37.14999,37.75,99370368,106103971.2,47.854398674794105,38.12297371620375,NaN,NaN,-14.162903637381289,-39.04242190417202,0.06967975887033384,-0.4177164060149323,-0.48739616488526616,1254502682,1173434698,34.859607779260315,24.4088414831086,NaN,NaN,-19.79068560784794,-21.460584836371375
2005-02-07T09:30:00-05:00,37.8,37.91,37.52,37.674,71633056,103527661.6,46.99538844727861,38.167239360655984,NaN,NaN,5.900482849547027,-26.784370949088135,0.0924194881206783,-0.3718718047344183,-0.46429129285509657,1182869626,1196542173.2,38.16760360128279,25.14173216370221,NaN,NaN,-17.740100839172527,-20.929087122485825
2005-02-08T09:30:00-05:00,37.64999,38.00999,37.62,37.74001,73225184,102747689.6,47.87065347472161,38.77737941926575,NaN,NaN,24.359962266242,-14.478388049836536,0.11027298666993679,-0.3264500595176756,-0.4367230461876124,1256094810,1218931622.8,41.279192460312444,25.88019598085247,NaN,NaN,-15.815656369826915,-20.198597014963124
2005-02-09T09:30:00-05:00,37.77,37.8,37.065,37.11,93432496,102055145.6,40.924673366709314,39.333245595171554,NaN,NaN,-35.8687861178145,-15.887664746081223,0.07945827576939718,-0.3374002014758659,-0.4168584772452631,1162662314,1202252349.2,39.67732381787407,26.63148408703287,NaN,NaN,-16.19283494328649,-19.62634529043789
2005-02-10T09:30:00-05:00,37.25999,37.32001,36.88,37.14999,110426560,101182183.2,41.50486646788098,40.08463324656178,NaN,NaN,-61.90381051933604,-16.335011031748557,0.062331365384522885,-0.3389442705146095,-0.4012756358991324,1273088874,1225843661.2,43.04395232873778,27.755505766034855,NaN,NaN,-16.32375070854492,-19.15454606445318
2005-02-11T09:30:00-05:00,37.06,37.85001,36.927,37.7,108768880,101514752,48.933461961182985,41.60639262850324,NaN,NaN,5.449985045149963,-12.412433295242309,0.08708774323959567,-0.29241595684963784,-0.3795037000892335,1381857754,1251314675.6,46.51473618872715,29.410116373026266,NaN,NaN,-14.11486544632716,-18.434591690435177
2005-02-14T09:30:00-05:00,37.71001,37.94,37.688,37.869,55056976,99591097.6,50.992891125238124,43.07459240195175,NaN,NaN,76.56053201995782,1.719576538839847,0.11228432584014392,-0.23914829278905358,-0.3514326186291975,1436914730,1302123696.4,52.70592094739434,31.717901161219153,NaN,NaN,-11.67089902129612,-17.46834988055817
2005-02-15T09:30:00-05:00,37.89,38.48,37.82001,38.12,133212256,101649604,53.96246545229325,44.294287078897625,NaN,NaN,149.36422530690365,26.720429146972172,0.14141310349335245,-0.1746662392625069,-0.31607934275585936,1570126986,1364930131.6,59.02062441428462,34.55332821749595,NaN,NaN,-8.707061238203279,-16.216737217364614
2005-02-16T09:30:00-05:00,38.03,38.16,37.83,37.98,80616368,100415278.4,52.06733350857194,45.408160579246264,NaN,NaN,127.74576958483105,59.44334028750129,0.14620451054818479,-0.13332370457062837,-0.27952821511881315,1489510618,1430299792.4,64.35519218072643,37.838323101634664,NaN,NaN,-6.801631837869983,-14.871722163151095
2005-02-17T09:30:00-05:00,38.05,38.14,37.42999,37.47,116323056,100176065.6,45.7623646026662,46.180268491610555,NaN,NaN,57.20860165789857,83.26582272294822,0.11154478646373367,-0.14009723203914604,-0.2516420185028797,1373187562,1450319530,65.82256412013922,41.292971112471136,NaN,NaN,-7.02390450572706,-13.75060535494766
2005-02-18T09:30:00-05:00,37.48,37.57001,37.25999,37.35001,69387120,97870587.2,44.4001010682265,46.35840566237703,NaN,NaN,-4.972102282813019,81.18140525735562,0.07861007161956346,-0.15337942897842538,-0.23198950059798884,1303800442,1434708067.6,63.62304239964215,44.37080281613407,NaN,NaN,-7.6120536932187965,-12.873669403272109
2005-02-22T09:30:00-05:00,37.03,37.5482,36.78999,36.89,122635008,97123016,39.540488886992435,46.07333295163188,NaN,NaN,-81.77672739343916,49.51395337467622,0.026604601016702034,-0.1987337493271113,-0.22533835034381333,1181165434,1383558208.4,56.91265154259555,46.847266185459965,NaN,NaN,-9.644837270468575,-12.412407670014462
2005-02-23T09:30:00-05:00,37.03999,37.07001,36.69701,36.94,95421056,95891793.6,40.3052767920411,45.78303107911472,NaN,NaN,-124.19831835314369,-5.198555357333248,-0.002140827673427742,-0.228014384935598,-0.22587355726217026,1276586490,1324850109.2,50.348773008800656,48.742828055087315,NaN,NaN,-11.06100340684127,-12.219349918132577
2005-02-24T09:30:00-05:00,36.85001,37.44,36.75999,37.41,99841008,95498278.4,47.081620878700726,46.299713193378416,NaN,NaN,-56.86174724342455,-42.120058722984375,0.012007868339680955,-0.21086372183756907,-0.22287159017725003,1376427498,1302233485.2,48.04967940967291,50.31291887138934,NaN,NaN,-10.252396422699048,-11.938356561642074
2005-02-25T09:30:00-05:00,37.38,37.7,37.28999,37.62,80143680,94016024.8,49.82240882971326,46.44028534730121,NaN,NaN,17.622758645798967,-50.03722732540429,0.035680111741391796,-0.1782714505005103,-0.2139515622419021,1456571178,1318910208.4,49.867515070181625,51.3849122493123,NaN,NaN,-8.747852690230436,-11.482570294297554
2005-02-28T09:30:00-05:00,37.46001,37.60001,36.923,37.22,96018816,93227300,45.037550884534994,46.30043980710524,NaN,NaN,-62.78861528607267,-61.60052992605622,0.025070494908083718,-0.18261344360679743,-0.20768393851488115,1360552362,1330260592.4,51.12115225007073,52.31016572422572,NaN,NaN,-8.91326501970367,-11.115526683641285
2005-03-01T09:30:00-05:00,37.37,37.7,37.33,37.63,79293568,92722912.8,50.305715296445264,46.47437279437122,NaN,NaN,17.19147319446759,-41.80688980847488,0.045165012838599194,-0.15122767246663216,-0.19639268530523135,1439845930,1381996691.6,56.46505385279711,53.39487010940319,NaN,NaN,-7.390558052228813,-10.583388307725217
2005-03-02T09:30:00-05:00,37.42999,38.02,37.356,37.61,107985184,94281406.4,50.053680743338106,47.12644474984471,NaN,NaN,43.42628636763378,-8.281968864319378,0.05590636412481215,-0.12650973014921618,-0.18241609427402833,1331860746,1393051542.8,57.53344055561535,54.67030701924186,NaN,NaN,-6.253807620852426,-9.964876781029105
2005-03-03T09:30:00-05:00,37.71001,37.73,37.02,37.3,90101312,93690916,46.190772735726625,47.461152340405114,NaN,NaN,-35.505270935940025,-4.010673602822473,0.041587707955997505,-0.13043145932903144,-0.17201916728502895,1241759434,1366117930,54.05298163473744,55.45666625538469,NaN,NaN,-6.431833082857355,-9.460156252718855
2005-03-04T09:30:00-05:00,37.59,37.75,37.39999,37.52,86649872,93477091.2,49.18780861505999,47.479319958539186,NaN,NaN,13.762577777532742,-4.782709776475724,0.04604110724882832,-0.11446778322399354,-0.16050889047282185,1328409306,1340485555.6,50.89732300736168,55.76970817100145,NaN,NaN,-5.693095245047605,-8.92200468019439
2005-03-07T09:30:00-05:00,37.61,38.28999,37.56,38.06,94886368,93252891.2,55.70873154565538,47.8161657028547,NaN,NaN,112.69405998681118,30.313825278101053,0.08234372810511775,-0.05757923034142465,-0.1399229584465424,1423295674,1353034218,52.363555962540424,55.74525352922616,NaN,NaN,-2.9694146120666627,-8.071634670461858
2005-03-08T09:30:00-05:00,37.97,38.21001,37.64999,37.67999,89618432,94152160,50.77084111008909,47.588192535554406,NaN,NaN,77.61667179767903,42.39886499874334,0.0778052137412391,-0.04266644126999353,-0.12047165501123262,1333677242,1331800480.4,49.66128170042098,55.07672904966447,NaN,NaN,-2.2103757306463896,-7.234311964773934
2005-03-09T09:30:00-05:00,37.67,37.92999,37.47,37.57001,98090880,95395444.8,49.4059414297824,47.39809310135515,NaN,NaN,32.953869180003466,40.30438156121728,0.06496153340831622,-0.03926973825083735,-0.10423127165915357,1235586362,1312545603.6,47.27861121254878,53.856973266223214,NaN,NaN,-2.0137324750059307,-6.488514894807076
2005-03-10T09:30:00-05:00,37.61,37.67,37.08,37.52,98047632,95626201.6,48.763973573064625,47.612493742097904,NaN,NaN,-27.96227866331213,41.81298001574286,0.051264707714160265,-0.04015038701645324,-0.0914150947306135,1137538730,1291701462.8,44.77422078359143,52.353520170755516,NaN,NaN,-2.0408211523886153,-5.853130074461582
2005-03-11T09:30:00-05:00,37.69,37.82201,37.0199,37.17,102865440,95248145.6,44.41433527289224,47.6135104710026,NaN,NaN,-55.54969012478098,27.950526435280114,0.01848965366425502,-0.06830302765029472,-0.08679268131454974,1034673290,1232954259.6,38.57261337566319,50.56420381189987,NaN,NaN,-3.361874868246658,-5.497236473573736
2005-03-14T09:30:00-05:00,37.24001,37.36,37.0305,37.34,71602368,93389820,46.89220182563806,48.138632823763,NaN,NaN,-73.65643679282547,-9.319572920647222,0.00861790170358824,-0.07602030418506445,-0.08463820588865269,1106275658,1169550256.4,33.22398820231369,48.87215643045117,NaN,NaN,-3.7513304382129498,-5.247821325665052
2005-03-15T09:30:00-05:00,37.44,37.48,36.99001,37.03999,93917504,95332846.4,43.22977016746738,48.34752520772202,NaN,NaN,-83.11059676960494,-41.465026634104014,-0.016395592780309526,-0.10513269686403959,-0.08873710408373006,1012358154,1105286438.8,28.856416679251694,47.33698812119768,NaN,NaN,-5.177075800736251,-5.237714822103795
2005-03-16T09:30:00-05:00,36.92,37.17999,36.53,36.61501,159757440,96660105.6,38.62739735425531,47.74365209883307,NaN,NaN,-168.01771543066576,-81.65934355623786,-0.057526313994648665,-0.1606449965770409,-0.10311868258239223,852600714,1028689309.2,24.690186262163593,45.66845289637558,NaN,NaN,-7.866253780336647,-5.613220387565631
2005-03-17T09:30:00-05:00,36.60001,36.89,36.53999,36.71001,101801120,97719343.2,40.161034924790236,47.05355396276713,NaN,NaN,-165.14887089462843,-109.09666200250112,-0.0732878373718268,-0.19472847929717574,-0.12144064192534894,954401834,992061930,22.981518450941124,43.74802456642983,NaN,NaN,-9.612649203324365,-6.18456736124545
2005-03-18T09:30:00-05:00,36.74001,36.785,36.35001,36.50999,109185312,97362456,38.00749960496805,46.55140744279806,NaN,NaN,-175.00623170489104,-132.9879703185231,-0.09098264330110423,-0.23516894605172922,-0.144186302750625,845216522,954170576.4,21.33648369313063,41.620548240934106,NaN,NaN,-11.726262407174765,-6.976238082092495
2005-03-21T09:30:00-05:00,36.61,36.75,36.25,36.58,92838624,98535031.2,39.23569364591451,45.7606916106173,NaN,NaN,-151.75913725635368,-148.60851041122876,-0.09152155070537513,-0.2585882411323439,-0.16706669042696878,938055146,920526474,19.969636316819106,39.01373270264996,NaN,NaN,-13.129472750058943,-7.855271606087702
2005-03-22T09:30:00-05:00,36.63,36.75,36.11,36.13,114134320,98109996.8,34.50382965629129,44.64998796154253,NaN,NaN,-163.85751843421477,-164.75789474415075,-0.11425645009737931,-0.3098872530486929,-0.1956308029513136,823920826,882839008.4,18.537081635581544,36.22827849407612,NaN,NaN,-15.828590911064977,-8.994317221084454
2005-03-23T09:30:00-05:00,36.09,36.494,36.07001,36.25999,97524000,98215144,36.872221401246364,43.98437715193679,NaN,NaN,-152.2359978887244,-161.60155123576246,-0.11243754586662383,-0.3361777352845934,-0.22374018941796955,921444826,896607830.8,20.77321465996168,33.85115228159213,NaN,NaN,-17.3894545239534,-10.193622550065733
2005-03-24T09:30:00-05:00,36.39,36.64999,36.27,36.27,77711680,97108677.6,37.06096252905502,43.118173860079295,NaN,NaN,-111.81704324459793,-150.93518570575637,-0.10272471857075874,-0.35214608763141797,-0.24942136906065923,999156506,905558765.2,22.26703768498807,31.80613190142259,NaN,NaN,-18.6126528070312,-11.396341158203656
2005-03-28T09:30:00-05:00,36.41,36.61099,36.31,36.34,59773984,96090192.8,38.44690305216886,41.885186110544545,NaN,NaN,-94.10250454147877,-134.7544402730739,-0.08451074361979921,-0.35505979858540826,-0.27054905496560905,1058930490,948301558.8,29.138031242899828,30.147165850019693,NaN,NaN,-19.272053825245628,-12.52144296778108
2005-03-29T09:30:00-05:00,36.27,36.58,35.94,36.05,119633312,97270917.6,35.00759256977986,40.75923978623673,NaN,NaN,-108.85345079510594,-126.17330298082433,-0.08470496257220705,-0.37643025818086784,-0.2917252956086608,939297178,948549965.2,29.17721191695746,28.68401800834373,NaN,NaN,-20.821423470548364,-13.707154468176407
2005-03-30T09:30:00-05:00,36.23,36.78,36.22,36.73,115019568,99057217.6,46.983685399562646,40.5862214983639,NaN,NaN,-53.73392708870871,-104.14858471172313,-0.034330705911955195,-0.3346386779986048,-0.3003079720866496,1054316746,994629149.2,36.221829588199235,27.894247892318763,NaN,NaN,-18.549178968272575,-14.39887225390443
2005-03-31T09:30:00-05:00,36.75,36.75,36.44,36.57001,86651184,97990517.6,44.88788332773208,40.30935790941157,NaN,NaN,-47.230919841877636,-83.14756910235376,-0.008429762992551493,-0.31084517582733895,-0.30241541283478746,967665562,1003873296.4,37.563572197992144,27.379201564775958,NaN,NaN,-17.314994304891542,-14.81546111833116
2005-04-01T09:30:00-05:00,36.82001,36.884,36.13,36.2,143853504,100678127.2,40.39955076975051,40.02258758775859,NaN,NaN,-65.36150044654205,-73.8564605427426,-0.012609761846098244,-0.3181776151424103,-0.30556785329631203,823812058,968804406.8,34.59057321831999,27.094770124965727,NaN,NaN,-17.646368563037605,-15.219876467574938
2005-04-04T09:30:00-04:00,36.25999,36.60001,36.03,36.46001,100153680,101353317.6,44.59219597236682,39.85830145538207,NaN,NaN,-66.10735215212918,-68.25743006487266,0.004810354965111896,-0.29955490958992215,-0.30436526455503404,923965738,941811456.4,32.46095298127918,27.04026760917755,NaN,NaN,-16.606377348247026,-15.417948021956665
2005-04-05T09:30:00-04:00,36.5,36.66901,36.41499,36.56,66463056,99932152,46.160712444606816,40.06765447517775,NaN,NaN,-35.661970921814124,-53.6191340902143,0.02463274816649591,-0.27357432934691417,-0.2982070775134101,990428794,952037779.6,34.115880558659384,27.41594360056381,NaN,NaN,-15.285239556795412,-15.398989669790772
2005-04-06T09:30:00-04:00,36.66,36.905,36.42,36.5,82219312,99562196,45.331440390908384,40.54651469208154,NaN,NaN,-18.96600832822826,-46.665550338118216,0.03465538801288487,-0.254887842497304,-0.2895432305101889,908209482,922816326.8,31.723797749664158,27.91834442109956,NaN,NaN,-14.442730407196422,-15.262381203705866
2005-04-07T09:30:00-04:00,36.52,36.952,36.50999,36.94,88708944,99093099.2,52.12393201256932,41.40100734120862,NaN,NaN,32.69467837660074,-30.68043069442254,0.06984017423624639,-0.20224301271488088,-0.27208318695112726,996918426,928666899.6,32.740640090715885,28.615424538226332,NaN,NaN,-11.58976189426164,-14.737721302356691
2005-04-08T09:30:00-04:00,37.02,37.07001,36.60001,36.64,92409808,98811208,47.766154801632666,42.09805414097037,NaN,NaN,39.02387580940248,-9.803355443233631,0.07156741059361482,-0.18262392370910874,-0.25419133430272356,904508618,944806211.6,35.590386855443526,29.633560478391537,NaN,NaN,-10.4774274819602,-14.129107899442907
2005-04-11T09:30:00-04:00,36.75,36.78,36.39999,36.48,71013440,97218608,45.577574554506896,42.55104563444126,NaN,NaN,-12.534662467428907,0.9111824937064273,0.06100491462059293,-0.1779351910269824,-0.23894010564757534,833495178,926712099.6,33.85835326026492,30.625611688637665,NaN,NaN,-10.216121414556618,-13.570109830173438
2005-04-12T09:30:00-04:00,36.44,36.74001,35.91,36.66,145341312,100905555.2,48.43973852453309,43.54646769645853,NaN,NaN,-46.87698675026249,-1.3318206719832433,0.06485211916471756,-0.1578749566916784,-0.22272707585639595,978836490,924393638.8,33.63249816299901,31.70385572631034,NaN,NaN,-9.142381691785193,-12.937577238975118
2005-04-13T09:30:00-04:00,36.56,36.60001,35.98,36.06,109071056,101663232.8,40.74707875940722,43.82324322204145,NaN,NaN,-129.35661341807122,-23.409941689951832,0.027603779135704276,-0.18822235193676562,-0.2158261310724699,869765434,916704829.2,32.84989414805571,32.56647568974563,NaN,NaN,-10.649093997591237,-12.610651061634563
2005-04-14T09:30:00-04:00,36.08,36.10001,35.5,35.55,158933936,101622057.6,35.57543540366791,43.71713414165665,NaN,NaN,-280.0989705759534,-85.96867148046266,-0.027769157397192268,-0.25053757781896024,-0.22276842042176798,710831498,859487443.6,27.686807510654802,32.95360210586468,NaN,NaN,-13.735718906424148,-12.771375039461647
2005-04-15T09:30:00-04:00,35.23,35.37,34.67999,34.74001,170274368,105045720,29.230076334040575,43.05878937607606,NaN,NaN,-380.68353575205987,-169.91015379275512,-0.11068086849628356,-0.3611195060421224,-0.25043863754583884,540557130,786697146,22.781298468826407,32.49954976485944,NaN,NaN,-18.892633111855265,-13.645840478375021
2005-04-18T09:30:00-04:00,34.72,35.10001,34.64,34.75,110713936,105122151.2,29.39733844227007,42.65805693839679,NaN,NaN,-275.86973913418285,-222.57716912610596,-0.1539255090128694,-0.44284552381192555,-0.28892001479905616,651271066,750252323.6,20.794696706910045,31.90079867842748,NaN,NaN,-22.703323507771476,-14.939766625431657
2005-04-19T09:30:00-04:00,35.02,35.10001,34.75,34.99001,97511440,105355792,33.46590676868955,41.69250132190586,NaN,NaN,-190.81418892815455,-251.36460956168435,-0.15501047625063302,-0.48268311011234744,-0.3276726338617144,748782506,704241526.8,18.590583200185705,30.641423936426516,NaN,NaN,-24.461515120125576,-16.300016410387933
2005-04-20T09:30:00-04:00,35.21001,35.28999,34.59,34.70399,140456064,106671879.2,31.161344352749694,40.71203425226425,NaN,NaN,-157.8348792569004,-257.0602627294502,-0.1628304067376366,-0.5312106422837601,-0.36838023554612354,608326442,651953728.4,16.455922372792045,29.133734663197934,NaN,NaN,-26.66535693936102,-17.780779343098374
2005-04-21T09:30:00-04:00,35.09,35.71001,34.96001,35.62,125000944,108045726.4,44.37306802433745,40.99585691330618,NaN,NaN,-75.13012909008619,-216.06649443227676,-0.09737987816048677,-0.49010508324673197,-0.3927252050862452,733327386,656452906,17.335496391983924,27.901229175602502,NaN,NaN,-23.94347102169368,-18.66116386861199
2005-04-22T09:30:00-04:00,35.47,35.47,34.817,35.09,115150752,109917680,39.63339175403968,40.6416566119971,NaN,NaN,-94.6407472958466,-158.85793674103405,-0.08149490180321528,-0.4945938323402643,-0.41309893053704905,618176634,671976806.8,20.44765771320347,27.043136656454237,NaN,NaN,-23.40332955745799,-19.338616109875705
2005-04-25T09:30:00-04:00,35.3,35.463,35.149,35.375,72220000,110539980.8,43.14991897584222,40.426599935656775,NaN,NaN,-64.63620858532022,-116.61123063126156,-0.04531223066504486,-0.4697392188683551,-0.42442698820331026,690396634,679801920.4,22.04090901066847,26.1806386887406,NaN,NaN,-21.745738829408808,-19.68249078409472
2005-04-26T09:30:00-04:00,35.28,35.7,35.03999,35.05,108099440,109963287.2,40.26912261333583,40.0650058086873,NaN,NaN,-63.86358471316345,-91.22110978826332,-0.03712961226936323,-0.4708390035400143,-0.43370939127065106,582297194,646504858,20.18811541534869,25.356661379146633,NaN,NaN,-21.381996106771815,-19.92527725876288
2005-04-27T09:30:00-04:00,34.87,35.25,34.73,35.10001,112639744,109844296,40.922721394574566,39.26491933597339,NaN,NaN,-78.16842792348463,-75.28781952158019,-0.022908942853771097,-0.4623455698378649,-0.4394366269840938,694936938,663826957.2,23.777815893803933,24.71645965079578,NaN,NaN,-20.89099079911221,-20.06323633595564
2005-04-28T09:30:00-04:00,34.92999,35.14999,34.72,34.75,98661312,110444802.4,37.80478405762942,38.55339285425887,NaN,NaN,-84.43152194092603,-77.14809809174815,-0.031125338790272294,-0.4783433004719342,-0.4472179616816619,596275626,636416605.2,22.0850829135004,23.751795083514132,NaN,NaN,-21.46312096241725,-20.263219854021585
2005-04-29T09:30:00-04:00,35,35.064,34.35001,34.98,144508368,110477545.6,40.986673172014626,38.225471326938,NaN,NaN,-83.52858401786682,-74.92566543615222,-0.01588831142533753,-0.46707835096333383,-0.4511900395379963,740783994,660938077.2,27.085939364817094,23.268051233839287,NaN,NaN,-20.94977544795022,-20.36129922458282
2005-05-02T09:30:00-04:00,35.07001,35.2636,34.886,35.12,68205376,108880130.4,42.901534723563266,37.829885341154444,NaN,NaN,-50.852507972426295,-72.16892531357344,0.007542740076182386,-0.4417616144427683,-0.4493043545189507,808989370,684656624.4,31.65529419937016,23.126822379294367,NaN,NaN,-19.95656750669305,-20.303480407741425
2005-05-03T09:30:00-04:00,35.05,35.60001,35.03,35.3,104075312,110760743.2,45.356551872026465,38.15913342062724,NaN,NaN,-25.01698361917072,-64.3996050947749,0.037416867846530866,-0.40253326971078707,-0.43995013755731793,913064682,750810122,42.48200944530762,23.81483061481236,NaN,NaN,-18.406832882867157,-20.032530761330815
2005-05-04T09:30:00-04:00,35.28999,35.832,35.24001,35.728,90934880,111196521.6,50.776088585117535,39.24489436215936,NaN,NaN,12.419839785861805,-46.281951552905596,0.08550483987298196,-0.33306908771609045,-0.4185739275890724,1003999562,812622646.8,50.39005146852764,25.436490897517565,NaN,NaN,-15.39326069977916,-19.369777895394865
2005-05-05T09:30:00-04:00,35.75999,35.924,35.53,35.75999,79625248,110742336.8,51.16594261671078,40.81174195377866,NaN,NaN,39.9866162632409,-21.398323912072208,0.11702072978877132,-0.27229801535310827,-0.3893187451418796,1083624810,910092483.6,59.78039540129423,28.07928353555098,NaN,NaN,-12.842263817507435,-18.43727588426809
2005-05-06T09:30:00-04:00,35.97,36.02,35.72301,35.85699,77397632,109991728,52.39706662967593,42.454579681450504,NaN,NaN,71.50966799860255,9.60932649122166,0.14037951707599172,-0.21384434879688996,-0.3542238658728817,1161022442,994140173.2,65.79306228494374,31.29345250541053,NaN,NaN,-10.368886448128176,-17.28464882196239
2005-05-09T09:30:00-04:00,35.87,36.06,35.657,36.03,66371680,109759640,54.59573533460847,43.96385315044471,NaN,NaN,91.8470380800689,38.149235701720706,0.16193191154830489,-0.15180897643750058,-0.31374088798580546,1227394122,1077821123.6,70.51870994889455,35.00260441603259,NaN,NaN,-7.63852772539818,-15.906631522453216
2005-05-10T09:30:00-04:00,35.85001,35.96001,35.619,35.76601,77475632,106366356,50.744368511505506,45.362640590355845,NaN,NaN,83.1336907721431,59.77937057998347,0.1529648871978086,-0.1225347789885447,-0.2754996661863533,1149918490,1125191885.2,72.80875818432062,39.02780697399891,NaN,NaN,-6.311150008574888,-14.535848449042026
2005-05-11T09:30:00-04:00,35.83,36.026,35.3,35.95,132093936,107517500,53.22120112899016,45.994650097831034,NaN,NaN,89.35444640365694,75.16629190354249,0.1535793477398252,-0.0835254815115718,-0.237104829251397,1282012426,1180794458,75.2399481768256,43.16383924434475,NaN,NaN,-4.481659998245911,-13.09953581321401
2005-05-12T09:30:00-04:00,36.00999,36.2,35.65601,35.85001,116671440,105404375.2,51.699687941285724,46.856528396920034,NaN,NaN,112.61858341547037,89.69268533398838,0.14169410778095265,-0.05998719452520618,-0.20168130230615883,1165340986,1197137693.2,75.92142099449666,47.12625090729426,NaN,NaN,-3.34774058879887,-11.706422209726131
2005-05-13T09:30:00-04:00,35.99001,36.47,35.888,36.24001,133310000,103556156.8,56.87794089661929,47.83710139126125,NaN,NaN,145.19884195783462,104.4305201258348,0.15354440918624399,-0.009750790823353839,-0.16329520000959782,1298650986,1224663402,77.0662916829103,51.05663538388296,NaN,NaN,-0.8346679423810727,-10.153314457248266
2005-05-16T09:30:00-04:00,36.24001,36.53799,36.13,36.48399,79136944,101977307.2,59.782764985298044,49.23093298925854,NaN,NaN,153.7668381318553,116.81448013619206,0.1699818616653586,0.04918212707210046,-0.12079973459325816,1377787930,1254742163.6,78.28152862070527,55.2061648985513,NaN,NaN,2.1822236676486306,-8.391094725120137
2005-05-17T09:30:00-04:00,36.349,36.74001,36.21001,36.7,91709008,101687185.6,62.20994603293265,50.751449034855554,NaN,NaN,156.76914104807153,131.54157019137776,0.18626037004558146,0.11202572796371868,-0.07423464208186278,1469496938,1318657853.2,80.63030499700294,59.267056977351224,NaN,NaN,5.476900340382381,-6.409952572905492
2005-05-18T09:30:00-04:00,36.8,37.36,36.71001,37.2,128146752,101071720,67.1517254486296,52.84765913421271,NaN,NaN,205.33725238139021,154.7381313869244,0.21928496232328656,0.19987156082224544,-0.01941340150104113,1597643690,1381784106,82.62849621204695,63.59158649867597,NaN,NaN,10.018629284660964,-4.063012307538855
2005-05-19T09:30:00-04:00,37.3,37.52,37.2,37.51199,93998432,99521594.4,69.80507884551656,54.90611668231999,NaN,NaN,206.76501494862407,173.56741769355517,0.24857631810434147,0.2913069961293857,0.042730678025044246,1691642122,1487044333.2,85.34356894706829,67.75284575455106,NaN,NaN,14.737236591431483,-1.377262464828807
2005-05-20T09:30:00-04:00,37.45,37.69,37.35001,37.66,66708496,97099481.6,71.00178855634704,56.913277670375976,NaN,NaN,187.07012231910073,181.9416737658084,0.2629608760787907,0.3714317731235326,0.10847089704474192,1758350618,1578984259.6,87.2221365484089,71.72190592233954,NaN,NaN,18.99002050496578,1.5323493879989911
2005-05-23T09:30:00-04:00,37.66,37.98599,37.60001,37.85001,93084816,98142722.4,72.50814925203647,58.85267748323383,NaN,NaN,172.01669029338112,185.59164419811356,0.2693290805345876,0.44513224771297644,0.17580316717838884,1851435434,1673713760.4,88.81314468338364,75.03127272505925,NaN,NaN,23.015824817553426,4.601417306506767
2005-05-24T09:30:00-04:00,37.75,38,37.7,37.97,100988432,97787172,73.44622375790509,60.47197285271866,NaN,NaN,149.10519794344728,184.0588555771887,0.265256589832215,0.5073739044686576,0.2421173146364426,1952423866,1770299146,90.15863438117809,77.87188579024858,NaN,NaN,26.63803681297064,7.749505807430177
2005-05-25T09:30:00-04:00,37.83,37.881,37.59,37.81,76490880,95979728.8,70.01548935923897,61.81836904861353,NaN,NaN,119.47303537200985,166.88601217531263,0.23638067925025086,0.5375931636992561,0.3012124844490053,1875932986,1825957005.2,90.84217519283436,80.09058434678717,NaN,NaN,28.731970130441404,10.747000710717495
2005-05-26T09:30:00-04:00,37.98,38.27,37.98,38.19,84087872,95251056.8,73.21548712641382,63.30539908409481,NaN,NaN,130.1890910384105,151.5708273932699,0.22739496763636396,0.5854561939944602,0.3580612263580963,1960020858,1879632752.4,91.45832777044389,81.92381759575146,NaN,NaN,31.556241553231164,13.719749402505162
2005-05-27T09:30:00-04:00,38.14999,38.25,38.02,38.21001,50134128,90532344.8,73.37661259635854,64.64689031707695,NaN,NaN,114.99606318721366,137.15601556689248,0.2078550933232291,0.6178800930121326,0.41002499968890355,2010154986,1929993626,92.00204692160702,83.45834166523092,NaN,NaN,33.89635302031218,16.602121347906163
2005-05-31T09:30:00-04:00,38.19,38.24001,37.92,38.08,75294944,90886823.2,70.41282833731745,66.05178030463495,NaN,NaN,96.6448695824806,122.08165142471239,0.17267671706954713,0.6258708960258375,0.45319417895629033,1934860042,1946678547.6,92.1796592082561,84.84197745265487,NaN,NaN,35.055436315692155,19.23830920044702
2005-06-01T09:30:00-04:00,38.03,38.67999,38.02,38.41,110985248,91232320,73.35474687925401,67.48989071536809,NaN,NaN,105.49419548780908,113.35945093358472,0.1585037377460461,0.6513238511388479,0.49282011339280185,2045845290,1965362832.4,92.38363512181427,86.06652652015407,NaN,NaN,36.93678515656939,21.7666629084645
2005-06-02T09:30:00-04:00,38.33,38.66,38.3,38.66,76148752,90493013.6,75.35407070900901,69.17948948449119,NaN,NaN,106.86944991616346,110.83873384241546,0.15277283008634934,0.6837861510007386,0.5310133209143892,2121994042,2014575043.6,92.9083029858849,87.27987523382465,NaN,NaN,39.15048450660862,24.25006599391366
2005-06-03T09:30:00-04:00,38.63,38.64,38.02,38.10001,97066496,91365076,63.80509206821417,69.67428599674795,NaN,NaN,79.23643980082839,100.64820359489903,0.10059380334660717,0.6567555750976481,0.556161771751041,2024927546,2027556381.2,93.04441659025001,88.42116987006321,NaN,NaN,37.48878809719673,26.141312008668383
2005-06-06T09:30:00-04:00,38.12,38.19,37.96001,38.11,53078544,90149121.6,63.9113539124229,69.96918520582831,NaN,NaN,61.72236091284444,89.99346314002518,0.05818282461747959,0.6288903025228905,0.5707074779054109,2078006090,2041126602,93.19153025913093,89.4861699870936,NaN,NaN,36.20373202961438,27.57880058308924
2005-06-07T09:30:00-04:00,38.14999,38.47099,37.73801,37.78999,109623120,92311693.6,58.0338368061663,69.67089168963071,NaN,NaN,50.76956486506821,80.8184021965427,0.002925083242357851,0.5743638319583582,0.5714387487160003,1968382970,2047831187.6,93.26729700402403,90.38881227330941,NaN,NaN,33.25788246428223,28.39009799468824
2005-06-08T09:30:00-04:00,37.88,37.95,37.56,37.71001,79250432,92400433.6,56.63205399374021,68.91948658571003,NaN,NaN,23.942727941667744,64.50810868731443,-0.04217657097438687,0.5187180349980167,0.5608946059724036,1889132538,2016488637.2,88.31927427584479,90.79529642072353,NaN,NaN,30.431297076433633,28.68169786350901
2005-06-09T09:30:00-04:00,37.66,38.06,37.5,37.95,99440624,90767768,59.77201433324759,68.20283912054796,NaN,NaN,27.439710942703382,48.622160892622425,-0.05803241644694279,0.48835408541372516,0.546386501860668,1988573162,1989804461.2,84.22256715252654,90.71522486397055,NaN,NaN,28.90843584367659,28.71408900353295
2005-06-10T09:30:00-04:00,37.89999,37.89999,37.38,37.547,86005680,89234480,52.85191088377626,66.90641928679291,NaN,NaN,-8.859881324773394,31.002896667502068,-0.09562821800618138,0.4268512293529412,0.5224794473591226,1902567482,1965332448.4,80.53317495933405,90.23744189332236,NaN,NaN,25.373855930933903,28.236912850304517
2005-06-13T09:30:00-04:00,37.48,37.95,37.46001,37.73,82360368,86686998.4,55.37825205945327,65.6828552016084,NaN,NaN,-6.201691537233618,17.41808617748645,-0.10726426177617282,0.38839912013890654,0.49566338191507936,1984927850,1946716800.4,77.74331406033909,89.44673970596202,NaN,NaN,23.188950633616585,27.51577539077767
2005-06-14T09:30:00-04:00,37.69,37.84,37.5,37.58,62764608,85868381.6,52.877208381641985,64.21363981758961,NaN,NaN,-35.5949999751035,0.14517320945210344,-0.12302605674724404,0.3418808109810243,0.46490686772826834,1922163242,1937472854.8,76.329270633024,88.4589280096653,NaN,NaN,20.615692374213978,26.530049245554284
2005-06-15T09:30:00-04:00,37.83,37.87,37.25,37.7,104082256,86487044,54.64206714860616,63.11553823111585,NaN,NaN,-63.08715715504321,-17.260803809890085,-0.12303636280483476,0.3111114142222249,0.43414777702705964,2026245498,1964895446.8,77.62919225509488,87.51514351411247,NaN,NaN,18.98117235794297,25.451638261609812
2005-06-16T09:30:00-04:00,37.74001,38,37.66,37.89999,90509312,84605172,57.498937000366716,61.99292750782677,NaN,NaN,-13.968816768176783,-25.542509352066116,-0.10778820082064355,0.29941252600125523,0.4072007268218988,2116754810,1990531776.4,78.80124692979213,86.61106631120879,NaN,NaN,18.40634142934265,24.445167285571646
2005-06-17T09:30:00-04:00,38.12,38.21001,37.75,37.87,89171248,84363812.8,56.91996878223725,60.81745294967525,NaN,NaN,3.913935718834259,-22.987745943344585,-0.09820677573291664,0.284442257155753,0.38264903288866964,2027583562,2015534992.4,79.90694581281781,85.74713051772383,NaN,NaN,17.772771064648452,23.49196782543976
2005-06-20T09:30:00-04:00,37.72,38.08,37.58,37.87,68165248,84436650.4,56.91996878223725,59.853677267169516,NaN,NaN,-32.29422689956148,-28.20625301581016,-0.0905417008396322,0.26947190683912936,0.36001360767876156,2027583562,2024066134.8,80.28479957700961,84.89749768692052,NaN,NaN,17.24944064750421,22.600178228591826
2005-06-21T09:30:00-04:00,37.83,38.011,37.7,37.85001,97916256,84678222.4,56.48032815899321,58.64836164429374,NaN,NaN,-29.891447572935423,-27.065542535376544,-0.08554892526299984,0.2530774511000118,0.3386263763630116,1929667306,2025566947.6,80.35478997948067,84.03829446246813,NaN,NaN,16.695478355847847,21.756649675342686
2005-06-22T09:30:00-04:00,38.00999,38.10001,37.63,37.81,75517504,83404676,55.55541701084742,57.234172094425055,NaN,NaN,-31.18953139833865,-20.68601738403563,-0.08357547099708007,0.2341570376166615,0.3177325086137416,1854149802,1991147808.4,73.87730380461095,82.67893737809142,NaN,NaN,15.988589622064003,20.932641096302874
2005-06-23T09:30:00-04:00,37.88,38.17999,37.33,37.39,122223744,85691319.2,46.87721041626546,56.025037690714434,NaN,NaN,-94.8622980210531,-36.86471363461088,-0.10765750923843376,0.18316062206569939,0.29081813130413314,1731926058,1914182058,61.867417432756554,80.45200886684188,NaN,NaN,12.861923540847231,19.779681445523497
2005-06-24T09:30:00-04:00,37.38,37.41,36.95799,36.97,142330000,88603425.6,40.126898384367365,54.326148010139036,NaN,NaN,-219.93986081082156,-81.63547294054203,-0.14656283192585812,0.10761459139681051,0.2541774233226686,1589596058,1826584557.2,51.588257737502815,77.48034654386845,NaN,NaN,7.860955893323027,18.077006366637715
2005-06-27T09:30:00-04:00,36.95,37.06,36.7,36.8,72888192,89741128.8,37.75692730205871,52.87779733127421,NaN,NaN,-242.6727244313245,-123.71117244689465,-0.17643115853106991,0.03363847515883123,0.21006963368990114,1516707866,1724409418,42.68058598328606,73.86701004238715,NaN,NaN,2.9126250125711346,15.910666173199632
2005-06-28T09:30:00-04:00,36.95,37.25999,36.89999,37.14999,73382064,89645484.8,44.963806484578285,52.04435108061978,NaN,NaN,-151.83595458999005,-148.1000738503056,-0.1654828547247546,0.003216065283957903,0.1686989200087125,1590089930,1656493942.8,37.985540117938825,70.27174331682245,NaN,NaN,0.7714789672782784,13.747925143782295
2005-06-29T09:30:00-04:00,37.25,37.25999,36.97,37.06799,71580368,87675240.8,43.687496188352256,50.89545692741298,NaN,NaN,-134.92203967951954,-168.84657550654174,-0.156716829595698,-0.027197116985909986,0.129519712609788,1518509562,1589365894.8,34.003931591308174,66.68469791959257,NaN,NaN,-1.3558667038919021,11.590240594114553
2005-06-30T09:30:00-04:00,37.14,37.21001,36.75,36.78,87963248,88265965.6,39.45194565314277,49.938316553796305,NaN,NaN,-153.89866829511183,-180.6538495613535,-0.16256675520081937,-0.07368873139123622,0.08887802380958315,1430546314,1529089946,30.874503647590316,63.137649968753735,NaN,NaN,-4.531921562615412,9.287074571724558
2005-07-01T09:30:00-04:00,36.86,37.00101,36.67999,36.72501,55292736,86177277.6,38.68079522890146,48.74564106589975,NaN,NaN,-145.70607911224454,-165.8070932216381,-0.16203097461284854,-0.11366069445647753,0.048370280156371015,1375253578,1486221450,28.841524561711708,59.64466500456607,NaN,NaN,-7.33696443091606,6.912211857061612
2005-07-05T09:30:00-04:00,36.64,37.19,36.60001,37.11,79288688,87487784.8,46.5569196845718,48.29419187325188,NaN,NaN,-97.43579549353062,-136.7597074340793,-0.129073046505364,-0.11297102797533398,0.016102018530030016,1454542266,1473788330,28.260310100760236,56.21116782369008,NaN,NaN,-7.390974987665257,4.868899450672059
2005-07-06T09:30:00-04:00,37.03,37.28,36.864,36.92999,79331936,85973225.6,43.72869175343779,47.51466505931129,NaN,NaN,-76.12529973528106,-121.61757646313751,-0.11328404998100368,-0.12550304394622458,-0.012218993965220904,1375210330,1430812410,26.28829448543513,52.54396084014297,NaN,NaN,-8.309039420949656,2.9863367547260995
2005-07-07T09:30:00-04:00,36.58,37.09,36.5498,37.06,120216320,88021520,46.267511862660356,46.71242040661798,NaN,NaN,-86.92954321315824,-112.01907716986527,-0.08904094304169177,-0.12352017276733562,-0.03447922972564385,1495426650,1426195827.6,26.077778965607223,48.7779988427012,NaN,NaN,-8.294849339031012,1.3747387413322265
2005-07-08T09:30:00-04:00,37.08,37.81,36.993,37.77,101469248,88122951.2,57.53531187069026,46.75637348436462,NaN,NaN,23.48230817145143,-76.54288187655263,-0.023553278045287243,-0.0639208272822529,-0.04036754923696566,1596895898,1459465744.4,30.40318497836988,45.24201592595493,NaN,NaN,-4.3278153776667505,0.5600881529038013
2005-07-11T09:30:00-04:00,37.87,38.16,37.8,38.12,96455504,88645442.4,61.789170241068625,47.10417358856686,NaN,NaN,103.79078496118268,-26.643509061867185,0.041432028999728254,0.01142248701269466,-0.030009541987033594,1693351402,1523085309.2,37.88753823132943,42.213640115549204,NaN,NaN,0.4931439427583111,0.5505246943115885
2005-07-12T09:30:00-04:00,38.12,38.46001,38.00999,38.3,86105568,88832702.4,63.79770930546098,47.62684367045741,NaN,NaN,130.03064995683826,18.849780028206602,0.09175239581074304,0.0846809527763952,-0.007071443034347834,1779456970,1588068250,44.4577819831155,39.64956811580883,NaN,NaN,5.030693771046781,1.1905488481309017
2005-07-13T09:30:00-04:00,38.33,38.42999,38.17,38.39,72552496,89322096.8,64.79417650833085,48.286755063134805,NaN,NaN,126.80884071408643,59.43660811808011,0.12429047339825214,0.14829164871346734,0.024001175315215204,1852009466,1683428077.2,52.41283925264352,38.11639207638258,NaN,NaN,8.951236680029904,2.2992185384021875
2005-07-14T09:30:00-04:00,38.64999,38.88,38.52,38.77,103210944,89278531.2,68.71028196139272,49.84626017350104,NaN,NaN,158.87424092686248,108.59736494608424,0.16220109618376294,0.22675254554491886,0.06455144936115594,1955220410,1775386829.2,58.57452920176424,37.88118577416884,NaN,NaN,13.661599653849352,3.922415840608925
2005-07-15T09:30:00-04:00,38.85001,39,38.649,38.89,67732880,88139709.6,69.85078946782714,51.96939525089102,NaN,NaN,153.42492837037923,134.58588898586981,0.1845295070244377,0.29521333314170306,0.11068382611726536,2022953290,1860598307.6,63.31467918880193,38.71878730640449,NaN,NaN,17.818432990407718,5.9075611477230385
2005-07-18T09:30:00-04:00,38.75999,38.89,38.688,38.733,59117168,86637005.6,66.43869772834806,54.01809313848312,NaN,NaN,129.47476218275702,139.72268443018467,0.17782272415299882,0.3329622313085139,0.15513950715551506,1963836122,1914695251.6,65.97640971819663,40.38277471604091,NaN,NaN,20.20005596897351,7.949346122187391
2005-07-19T09:30:00-04:00,38.92,39.196,38.84,39.17999,78687504,87163118.4,70.81048566810591,55.86428450873508,NaN,NaN,140.751206592896,141.86679575739623,0.19140876181957864,0.39440045942998836,0.20299169761040972,2042523626,1967308582.8,68.37938769878106,42.55376382895822,NaN,NaN,23.757007658342186,10.207583484495219
2005-07-20T09:30:00-04:00,38.94,39.57001,38.89999,39.46001,91982320,86866421.6,73.1684736615173,57.97006861396117,NaN,NaN,140.39719545704216,144.58446670598738,0.2059098491039475,0.4603790089903441,0.2544691598863966,2134505946,2023807878.8,70.76705667118509,45.179701334663704,NaN,NaN,27.513831307435115,12.67990460205806
2005-07-21T09:30:00-04:00,39.56,39.69299,39.21001,39.47,127792688,89480180.8,73.25149226031961,60.38432194304522,NaN,NaN,130.76096151753077,138.96181082412105,0.20252230684586242,0.5076220434437246,0.3050997365978622,2262298634,2085223523.6,73.14122096741444,48.198752571794,NaN,NaN,30.494140984611533,15.224795513851415
2005-07-22T09:30:00-04:00,39.46001,39.59,39.22,39.42,71717376,86954862.4,72.0499123007499,62.76783030532011,NaN,NaN,110.58383725657714,130.39359260136058,0.18381008775796048,0.5348623462953128,0.35105225853735234,2190581258,2118749117.2,74.3651363156692,51.45043912564811,NaN,NaN,32.57090224693553,17.70281076143486
2005-07-25T09:30:00-04:00,39.44,39.62601,39.2,39.27,52058528,82441288.8,68.42373595077815,64.32974575290628,NaN,NaN,96.57851593690276,123.81434335218975,0.14967287681378583,0.5381433545545846,0.3884704777407988,2138522730,2153686438.8,75.6123281868454,54.83272613179705,NaN,NaN,33.29383295643156,19.93009964643439
2005-07-26T09:30:00-04:00,39.36,39.53,39.19,39.42,69662880,82280023.2,70.04718191120645,66.20963790703262,NaN,NaN,88.9149211482807,113.4470862632667,0.12646127319594386,0.5465470692357286,0.42008579603978474,2208185610,2186818835.6,76.7667389343959,58.43832930672282,NaN,NaN,34.36888932753655,21.99278388659184
2005-07-27T09:30:00-04:00,39.44,39.75999,39.226,39.72,83631440,82792492,73.0333779755056,68.12148548652155,NaN,NaN,94.15092275344385,104.19783172254704,0.12059883795361148,0.5708343434817991,0.4502355055281876,2291817050,2218281056.4,77.83947119830344,62.13559303762969,NaN,NaN,36.20481024799068,24.023073366791674
2005-07-28T09:30:00-04:00,39.75,39.92101,39.64,39.91,67122752,82569611.2,74.75031225313441,69.35112837098185,NaN,NaN,102.93316596492136,98.63227261202516,0.11862303171614874,0.5985142951733735,0.47989126345722477,2358939802,2237609290,78.49634351404319,65.57081864732064,NaN,NaN,38.27860225782281,26.059577494081836
2005-07-29T09:30:00-04:00,39.87,39.92,39.52,39.575,74758624,81909380,66.68814754423782,69.70105532120822,NaN,NaN,85.4531451517012,93.60613419104997,0.08541222488172584,0.5866565445593821,0.5012443196776563,2284181178,2256329274,79.1412361205149,68.51751135369103,NaN,NaN,37.638034962754624,27.713642846749377
2005-08-01T09:30:00-04:00,39.64,39.83,39.52,39.64999,59877296,82138608,67.53232372195441,69.9678134938149,NaN,NaN,81.13290621608455,90.51701224688631,0.060334822419148115,0.5766628477015914,0.5163280252824433,2344058474,2297436422.8,80.52258377464307,71.09356862451443,NaN,NaN,37.36060091264081,29.091779713305296
2005-08-02T09:30:00-04:00,39.69,40.14,39.65401,40.08,79724688,82160408,71.9257413653838,70.4772109836044,NaN,NaN,100.98316002397448,92.93066002202508,0.06418891086591794,0.5965641638648407,0.5323752529989227,2423783162,2340555933.2,81.8782585220957,73.1982414294753,NaN,NaN,38.47817652442054,30.432693543464616
2005-08-03T09:30:00-04:00,39.89,40.13,39.88,40.06,61975632,81292592.8,71.44152648472591,70.6722998781282,NaN,NaN,102.0699196527099,94.51445940187828,0.057109773227059124,0.6037624695327466,0.5466526963056875,2361807530,2354554029.2,82.3087480186233,74.89354277353665,NaN,NaN,39.225690219306784,31.688835925727783
2005-08-04T09:30:00-04:00,39.88,39.94,39.57001,39.673,72061744,78884864,62.65219704889916,70.15811470534763,NaN,NaN,69.10355547661621,87.74853730421725,0.019997754035879667,0.571649888850537,0.5516521348146574,2289745786,2340715226,80.2783767439242,76.10523545604539,NaN,NaN,37.13446599237559,32.46678307810604
2005-08-05T09:30:00-04:00,39.61,39.78999,39.427,39.48,71262816,77374542.4,58.76904263573145,69.61028219873216,NaN,NaN,45.022537462734554,79.66241576642393,-0.021657772253943608,0.5245799194972278,0.5462376917511714,2218482970,2327575584.4,78.3033211849215,76.98572913224004,NaN,NaN,34.169982749742985,32.710097316911316
2005-08-08T09:30:00-04:00,39.52,39.61,39.14,39.19,64634752,75783504.8,53.41214052254414,68.36754325976347,NaN,NaN,0.22649679979987633,63.481133883167004,-0.0701183801966564,0.45858971650535096,0.5287080967020074,2153848218,2289533533.2,72.72468937058773,77.29610782308336,NaN,NaN,29.909480117732794,32.3100091456001
2005-08-09T09:30:00-04:00,39.37,39.59,39.306,39.45,64615440,74708998.4,57.18061480148364,67.22555334118962,NaN,NaN,15.842826006496145,46.453067079671335,-0.08504436726567177,0.4224026376199177,0.5074470048855895,2218463658,2248469632.4,67.16238693651812,77.03863141346429,NaN,NaN,27.469206111910054,31.618465855072948
2005-08-10T09:30:00-04:00,39.55,39.685,38.97,39.11,104471008,76304924,51.332988633789505,65.65994593929462,NaN,NaN,-39.72848704831272,18.09338573946681,-0.11626582371333549,0.3621147252439201,0.47838054895725557,2113992650,2198906656.4,61.08916986390937,76.17777062035678,NaN,NaN,23.4526914234211,30.451926650551254
2005-08-11T09:30:00-04:00,39.13,39.541,39.10001,39.43201,93638064,75826280,55.92974483483831,64.50850540601522,NaN,NaN,-25.353793631424793,-0.7980840821413949,-0.11355135937950067,0.33644134973287976,0.44999270911238043,2207630714,2182483642,59.179560231199886,75.09308661432327,NaN,NaN,21.533090784799874,29.1778072411582
2005-08-12T09:30:00-04:00,39.12,39.32001,38.97,39.21001,86470128,76763142.4,52.26458752298315,63.354280518315576,NaN,NaN,-87.38551621117082,-27.279694816922472,-0.12416745483002467,0.2947833905748496,0.41895084540487426,2121160586,2163019165.2,56.908985698056036,73.75713357940973,NaN,NaN,18.75912318485966,27.689423804544123
2005-08-15T09:30:00-04:00,39.14,39.63,39.077,39.446,63066320,76960600,55.59577721412309,62.32203732566676,NaN,NaN,-36.6819115512781,-34.66137648713807,-0.11307151903383961,0.27761144661257475,0.39068296564641436,2184226906,2169094902.8,57.45767464504826,72.37791470159918,NaN,NaN,17.5099637818315,26.235215229870892
2005-08-16T09:30:00-04:00,39.3,39.33,38.74001,38.81,94913008,77771875.2,46.23202703478747,60.40765511561547,NaN,NaN,-170.11803275605754,-71.8535482396488,-0.14433922178222502,0.21025893841863308,0.3545981602008581,2089313898,2143264950.8,54.29256246102546,70.69599264893647,NaN,NaN,13.09969131975749,24.358711814140406
2005-08-17T09:30:00-04:00,38.92,39.17,38.78999,39.03999,75633808,76954449.6,49.54164325515659,58.6070359014742,NaN,NaN,-143.7586167117222,-92.6595741723307,-0.1449260908320696,0.17344054666077113,0.3183666374928407,2164947706,2153455962,55.33790474652032,69.04181845125626,NaN,NaN,10.66609460031728,22.4026236407371
2005-08-18T09:30:00-04:00,38.87,39.10001,38.77,38.843,72727120,74201171.2,46.879932494764525,57.192163397940384,NaN,NaN,-149.25924742849796,-117.44066493174532,-0.15317059328116672,0.12690339589138233,0.28007398917254905,2092220586,2130373936.4,52.41401880507962,67.13273150015374,NaN,NaN,7.824446863583033,20.32002695828652
2005-08-19T09:30:00-04:00,38.89,39.00101,38.78999,38.82001,52177680,73224186.4,46.56549512687096,55.69453278400585,NaN,NaN,-137.43121801259633,-127.44980529203045,-0.15432918128053577,0.08716251257187935,0.24149169385241512,2040042906,2114150400.4,50.39838953480047,64.98100334016499,NaN,NaN,5.493503124105303,18.20195212483206
2005-08-22T09:30:00-04:00,38.88,39.17999,38.597,38.84,93266688,75284594.4,46.899004728725004,53.90690873853022,NaN,NaN,-120.74019701556489,-144.2614623848878,-0.1478910896697852,0.0566278317651836,0.2045189214349688,2133309594,2103966938,49.12145380599159,62.64123157472898,NaN,NaN,3.7159302403244348,16.132520427045257
2005-08-23T09:30:00-04:00,38.84,38.92,38.61,38.73,57532048,74678052.8,45.226214938315636,52.0343864852152,NaN,NaN,-127.63317526242714,-135.7644908861617,-0.14498762626324244,0.02328438860591575,0.1682720148691582,2075777546,2101259667.6,48.76769645264893,60.24544217715938,NaN,NaN,1.7515304006261052,14.07809328041395
2005-08-24T09:30:00-04:00,38.649,39.17999,38.46001,38.5,95038000,75248380.8,41.863908089253464,50.54950870238337,NaN,NaN,-118.98068098324381,-130.80890374046604,-0.15177946721736776,-0.021452319152551524,0.13032714806481624,1980739546,2064418035.6,44.112016826225165,57.662130754466595,NaN,NaN,-0.9299443287473439,11.934087907676624
2005-08-25T09:30:00-04:00,38.53,38.692,38.49001,38.588,52338688,74509177.6,43.59184745387572,49.46542333225081,NaN,NaN,-127.06603163436856,-126.37026058164015,-0.14365214438806892,-0.04923803242026992,0.094414111967799,2033078234,2052589565.2,42.70247394616301,55.11921309455527,NaN,NaN,-2.6931852346260343,9.844477458776243
2005-08-26T09:30:00-04:00,38.53,38.60001,38.27,38.4599,63884160,73965454.4,41.65113733388886,48.62535167591829,NaN,NaN,-135.61818449484892,-126.00765387809068,-0.14006341128012278,-0.08066515213235448,0.059398259147768306,1969194074,2038419798.8,41.01184062131035,52.85400961246403,NaN,NaN,-4.736465100772209,7.761485664555035
2005-08-29T09:30:00-04:00,38.25999,38.85001,38.25999,38.75999,74971184,74720148.8,47.54291836940214,47.936944787912466,NaN,NaN,-93.38677342786276,-120.53696916055023,-0.11186218728573065,-0.08042947495939501,0.03143271232633564,2044165258,2020590931.6,38.92371594201883,50.83696168428552,NaN,NaN,-4.87398597985365,5.956418286782366
2005-08-30T09:30:00-04:00,38.56,38.655,38.32001,38.62,87506256,75109227.2,45.24761512756303,47.50227525175343,NaN,NaN,-101.63340129511444,-115.3370143670877,-0.09754260652966898,-0.09049554583575059,0.007047060693918392,1956659002,1996767222.8,36.26652128632473,49.06391535731518,NaN,NaN,-5.641175359214639,4.29961919449708
2005-08-31T09:30:00-04:00,38.64,39.00999,38.478,38.98,93452000,76683045.6,51.7048675679099,47.20049830411568,NaN,NaN,-41.43467353086646,-99.82781287661223,-0.060543913845172194,-0.06863283161254685,-0.008088917767374656,2050111002,2010641514,38.883231189301334,47.61417756860815,NaN,NaN,-4.378895050439866,3.0598314452203734
2005-09-01T09:30:00-04:00,38.99001,39.14999,38.78,38.92,74917184,76825817.6,50.63307084431239,47.08396139849635,NaN,NaN,-6.5405188234967175,-75.72271031443786,-0.03793535275629496,-0.055508108712743365,-0.0175727559564484,1975193818,1999064630.8,37.49972358587392,46.22780170345228,NaN,NaN,-3.651975294011816,2.1010019110443463
2005-09-02T09:30:00-04:00,38.98,39.03101,38.74001,38.77,53270336,75926193.6,47.95664929119799,46.5383094040017,NaN,NaN,-26.235077452014824,-53.84608890587104,-0.031188552900654955,-0.056558447082267094,-0.02536989418161214,1921923482,1989610512.4,36.36188753277402,44.72095976686126,NaN,NaN,-3.794417615275912,1.2587991215700236
2005-09-06T09:30:00-04:00,38.94,39.41,38.89999,39.34,78129744,76600943.2,57.21230904520927,47.32261526188898,NaN,NaN,80.81221114605505,-19.006291991087476,0.011282526879958493,-0.011266735581664022,-0.022549262461622515,2000053226,1980788106,35.285908920513364,43.36334165682468,NaN,NaN,-0.9379880679736966,0.944972380206635
2005-09-07T09:30:00-04:00,39.3,39.479,39.21001,39.409,57470400,76243691.2,58.18184936008529,47.93977284081245,NaN,NaN,127.42672224601807,26.80573271713903,0.04192012430736914,0.029850892922588912,-0.012069231384780228,2057523626,2000961030.8,39.68109401324748,42.24499803301948,NaN,NaN,1.656914525367307,1.0466784009438739
2005-09-08T09:30:00-04:00,39.28999,39.57001,39.27,39.39999,73544560,74697368.8,57.997044550885825,48.73385227339254,NaN,NaN,133.85616278723742,61.86389998075981,0.05846069036778241,0.06100663157494779,0.0025459412071653746,1983979066,1987734643.6,37.8652593779291,41.205800931080155,NaN,NaN,3.6899722696446147,1.4242918107582654
2005-09-09T09:30:00-04:00,39.41,39.69,39.31,39.619,75389936,73784962.4,61.22139176672146,49.78070203338187,NaN,NaN,160.17035324241775,95.20607439394271,0.07971688643234082,0.1021920492475914,0.02247516281525058,2059369002,2004569680.4,41.532701009189886,40.572537464965116,NaN,NaN,6.414433357374222,2.137169174560545
2005-09-12T09:30:00-04:00,39.63,39.86301,39.58,39.73,51700992,72046505.6,62.780844393497354,50.915119152294174,NaN,NaN,177.45538253805742,135.94416639195714,0.09573982632647113,0.1421499457233395,0.046410119396868364,2111069994,2042398982.8,48.84001950812779,40.5524350151177,NaN,NaN,9.157178404222005,3.1400276359407533
2005-09-13T09:30:00-04:00,39.679,39.91,39.53999,39.63,66186128,72202496,60.42337192238909,52.000630365442284,NaN,NaN,155.33295591320967,150.84831534538807,0.09395897615619252,0.163858839592109,0.06989986343591649,2044883866,2051365110.8,50.42162646391172,40.67057287306505,NaN,NaN,10.813889164616356,4.236293568608696
2005-09-14T09:30:00-04:00,39.64999,39.67999,39.14999,39.17999,98671680,72390429.6,51.12042068444341,52.661809836527276,NaN,NaN,67.59605664678189,138.88218222554082,0.05856143837348603,0.14310166140277403,0.084540223029288,1946212186,2029102822.8,46.57180317762623,40.84627189816513,NaN,NaN,9.513037270673157,4.990114097475048
2005-09-15T09:30:00-04:00,39.25999,39.34,39.05,39.16,80476192,72632548.8,50.74665577352189,53.17286757364486,NaN,NaN,32.894597934244956,118.68986925494235,0.0312586079120578,0.12361348291936025,0.09235487500730245,1865735994,2005454208.4,42.830699863045986,40.8554308922282,NaN,NaN,8.356797351852945,5.471068848100462
2005-09-16T09:30:00-04:00,39.25,39.46001,39.10899,39.39999,71052752,72548830.4,55.00045748646565,54.126390441686056,NaN,NaN,54.86877751954691,97.62955411036816,0.02698071421655754,0.12608076777799937,0.09910005356144183,1936788746,1980938157.2,39.30568076631156,40.73356233115686,NaN,NaN,8.60709121364839,5.919072043178737
2005-09-19T09:30:00-04:00,39.32001,39.38,38.91,39.09,73395504,73609721.6,49.10149717317529,54.23771749909842,NaN,NaN,14.397609870761585,65.017999576909,0.0021987258234173607,0.10184846084071353,0.09964973501729617,1863393242,1931402806.8,33.33578914667321,40.334424702917886,NaN,NaN,7.001346016066131,6.073682610734079
2005-09-20T09:30:00-04:00,39.16,39.541,38.80901,38.92999,115514320,74722103.2,46.338771203740144,54.31565721882536,NaN,NaN,5.80415227155551,35.112238848578194,-0.02456935723554489,0.06893803847286506,0.09350739570840995,1747878922,1872001818,27.869386151643923,39.734629336154974,NaN,NaN,4.810075736519403,5.893167342989125
2005-09-21T09:30:00-04:00,38.82001,38.87,38.47,38.5,116424064,77666704,39.84993763305093,53.46887650919257,NaN,NaN,-87.53105292452048,4.086816934317727,-0.06835255315037553,0.008066704270440539,0.07641925742081607,1631454858,1809050352.4,23.47589361931162,38.63410522401285,NaN,NaN,0.6968048515355104,5.150829844210038
2005-09-22T09:30:00-04:00,38.44,38.73,38.24001,38.64,119165184,78873063.2,42.665051168032754,52.89973224660116,NaN,NaN,-98.08000459965038,-22.10810357246134,-0.08397408519323286,-0.02854834907072501,0.055425736122507854,1750620042,1786027162,22.103472656369377,37.53437301476253,NaN,NaN,-1.7726383719272167,4.16176295619043
2005-09-23T09:30:00-04:00,38.5,38.88,38.41,38.75,70170128,79764635.2,44.84909722075203,52.677764241569314,NaN,NaN,-72.51902513285158,-47.58566410294104,-0.082848661368342,-0.04813509058791965,0.03471357078042235,1820790170,1762827446.8,20.78486883453499,36.42172882203117,NaN,NaN,-3.1269776265631712,3.120514301511345
2005-09-26T09:30:00-04:00,38.97,39.03,38.55,38.75999,69345120,80037683.2,45.05380646753265,51.80929977173527,NaN,NaN,-59.5753881384882,-62.380263704791005,-0.07747914232516305,-0.062135357126031465,0.015343785199131585,1890135290,1768175856.4,21.94099051402381,35.468520364424776,NaN,NaN,-4.157376779051456,2.0808155757166586
2005-09-27T09:30:00-04:00,38.8,38.89999,38.50999,38.67,64094336,79493840.8,43.487896867975,50.759731736584534,NaN,NaN,-79.03324079210348,-79.3477423175228,-0.07593488507261234,-0.07957482114163383,-0.0036399360690215,1826040954,1783808262.8,25.36944155127,34.44625947428352,NaN,NaN,-5.464400278789166,1.002927596501541
2005-09-28T09:30:00-04:00,38.77,38.95,38.558,38.67999,72059504,78721503.2,43.721743839039526,49.74006740002409,NaN,NaN,-76.18624176906444,-77.07878008643159,-0.07031561932811853,-0.09153446022916967,-0.021218840901051136,1898100458,1837137382.8,35.73869973289632,34.29436235678118,NaN,NaN,-6.4805972142406905,-0.06614737646163493
2005-09-29T09:30:00-04:00,38.63,39.211,38.44501,39.2,117774064,79937606.4,54.31827390838347,49.24698755299995,NaN,NaN,-30.365881576271335,-63.535955481755785,-0.02972823998250509,-0.0583791408791825,-0.02865090089667741,2015874522,1890188278.8,44.064592152760575,34.47521172417909,NaN,NaN,-4.218854445677566,-0.6593912434924822
2005-09-30T09:30:00-04:00,39.16,39.48,39.13,39.46001,79260128,80154753.6,58.523489741338686,48.94289079213148,NaN,NaN,53.56580662207775,-38.318989130769914,0.014123982110321513,-0.01099592325877552,-0.025119905369097032,2095134650,1945057174.8,51.11870171122628,34.63797473868612,NaN,NaN,-0.9288010929751169,-0.6978783648471444
2005-10-03T09:30:00-04:00,39.55,39.75,39.50999,39.56,81694192,81575946.4,60.0466654930749,48.91598319003761,NaN,NaN,97.66837103404315,-6.870237296263644,0.047479444465797285,0.034229400213149574,-0.01325004425264771,2176828842,2002395885.2,57.193985483026815,35.121714668622914,NaN,NaN,2.2363531768646268,-0.2787024303168914
2005-10-04T09:30:00-04:00,39.62,39.88,39.28999,39.3,85379632,81938440.8,54.447454276869394,49.15362844663946,NaN,NaN,67.25829929483119,22.38807072112329,0.04942525666421368,0.04853152657761939,-0.0008937300865942896,2091449210,2055477536.4,61.91329464049299,36.217535487399104,NaN,NaN,3.266172540504587,0.22770827980046265
2005-10-05T09:30:00-04:00,39.31,39.34,38.73,38.75999,106227376,84376289.6,45.05115174573705,48.74680673036911,NaN,NaN,-40.3781497279568,29.54968912934482,0.013599871756252185,0.016106109608720942,0.0025062378524687567,1985221834,2072901811.6,63.34198324471885,37.682627157518596,NaN,NaN,1.0215870611202629,0.34111953427471986
2005-10-06T09:30:00-04:00,38.73,38.86,37.92,38.25,162273376,88812730.4,38.324480135195536,47.55566549099267,NaN,NaN,-141.13705157957284,7.395455128684487,-0.042136932463668605,-0.050164927727117004,-0.008027995263448396,1822948458,2034316598.8,58.14086722884158,39.02799761912788,NaN,NaN,-3.3881355922314795,-0.19163119808330864
2005-10-07T09:30:00-04:00,38.41,38.57001,38.179,38.34,91132560,89599861.6,40.02632711008518,46.90743905791481,NaN,NaN,-121.5421851651769,-27.626143228766445,-0.06904601447566167,-0.09433551335802548,-0.025289498882363814,1914081018,1998105872.4,53.68569512497086,40.48156233186343,NaN,NaN,-6.223624040840141,-1.0533444613342846
2005-10-10T09:30:00-04:00,38.28999,38.461,38.06,38.13,64031808,90216402.4,37.43095259064035,46.271166299836246,NaN,NaN,-135.09661920426694,-74.17914127642845,-0.09546374946102812,-0.14461918570864896,-0.049155436247620844,1850049210,1932749946,46.726226080269875,41.82847946962242,NaN,NaN,-9.40271609444304,-2.2461118374926783
2005-10-11T09:30:00-04:00,38.21001,38.24001,37.8,37.94,114769632,92645577.6,35.20663014760676,45.93950147944737,NaN,NaN,-156.2896138347198,-118.88872390233867,-0.11869472185619767,-0.19752383856786793,-0.07882911671167026,1735279578,1861516019.6,40.55528282700299,43.04843584160038,NaN,NaN,-12.730318058308368,-3.7438555833234908
2005-10-12T09:30:00-04:00,37.75999,38.056,37.42999,37.487,146123808,95018184,30.545945476801265,45.07385107293084,NaN,NaN,-186.8936706227111,-148.19182808128954,-0.155224003540829,-0.2728591211377065,-0.1176351175968775,1589155770,1782302806.8,35.017109217144494,43.97083845308431,NaN,NaN,-17.25100379192424,-5.67344818455217
2005-10-13T09:30:00-04:00,37.47,37.91,37.33,37.78,138583632,97923556,36.40963148348515,44.471032091697495,NaN,NaN,-159.9486441848488,-151.9541466023447,-0.1502117184387192,-0.3053997656452765,-0.1551880472065573,1727739402,1763260995.6,33.8214519993613,44.90202296485762,NaN,NaN,-19.018612936066784,-7.5799002919114
2005-10-14T09:30:00-04:00,37.87,38.07001,37.64,38.06,131480624,100944949.6,41.493047729656006,44.21669218184916,NaN,NaN,-107.72599689353105,-149.19090894801553,-0.11991200307462038,-0.30507805104983277,-0.18516604797521238,1859220026,1752288797.2,33.11970124166531,45.7005023025463,NaN,NaN,-18.770606920546722,-9.178572667430732
2005-10-17T09:30:00-04:00,38.06,38.19,37.82001,38.17999,64214160,100485882.4,43.57470798989419,44.22289297627196,NaN,NaN,-77.38432466330347,-137.64845003982288,-0.0852891381452903,-0.29177747065682524,-0.20648833251153495,1923434186,1766965792.4,35.06070508044205,46.392735411772875,NaN,NaN,-17.901785635908684,-10.424745948641867
2005-10-18T09:30:00-04:00,38.14,38.17999,37.91,37.91,88096064,99114969.6,40.11604831439117,43.96534329593993,NaN,NaN,-77.89569118934372,-121.96966551074763,-0.07446481595052179,-0.2995693524496872,-0.2251045364991654,1835338122,1786977501.2,37.714965934344626,46.533897283304896,NaN,NaN,-18.27067283618967,-11.545592646862982
2005-10-19T09:30:00-04:00,37.74001,38.672,37.61,38.67,132942256,99940879.2,51.73045754078238,43.78049926968271,NaN,NaN,-28.738812866310546,-90.33869395946752,-0.01322311220939243,-0.24163342676090593,-0.2284103145515135,1968280378,1862802422.8,46.61809342793727,46.7162902315318,NaN,NaN,-14.442180003905255,-11.959390840726163
2005-10-20T09:30:00-04:00,38.67,38.85001,38.10001,38.306,132676944,100616467.2,47.02612177243074,42.959258700475,NaN,NaN,-13.131960546892138,-60.975357231876174,0.0047079222472088955,-0.2225254117425024,-0.2272333339897113,1835603434,1884375229.2,48.85793106967187,46.55480661427792,NaN,NaN,-12.972514026565232,-12.10412272441746
2005-10-21T09:30:00-04:00,38.69901,38.86,38.3288,38.55,110053008,102610611.2,50.289541163842856,42.26232124838699,NaN,NaN,10.836977972382392,-37.262762258693485,0.033343103101539956,-0.18555445511278634,-0.2188975582143263,1945656442,1901662512.4,50.64506788314424,46.087026785714876,NaN,NaN,-10.671608645629604,-11.899477856019194
2005-10-24T09:30:00-04:00,38.71201,39.181,38.467,39.16,111785120,104732611.2,57.361472161976174,42.47046538303748,NaN,NaN,60.390082022008905,-9.707880921631014,0.09046760132709711,-0.10581305655545492,-0.19628065788255203,2057441562,1928463987.6,53.365888147524345,45.47649775050282,NaN,NaN,-6.111350082651834,-11.072602459823857
2005-10-25T09:30:00-04:00,39.08,39.19009,38.77,39.00999,86963936,105876091.2,55.278786150201775,43.201010697642104,NaN,NaN,63.756215563400076,18.622500428917732,0.11374583451919754,-0.054098364733555115,-0.16784419925275265,1970477626,1955491888.4,56.000149132377224,44.95208102819271,NaN,NaN,-3.269074332430894,-9.957812727339148
2005-10-26T09:30:00-04:00,38.96001,39.274,38.75999,38.81,90028064,106774519.2,52.53995079335539,44.21640145893923,NaN,NaN,55.08213310547094,35.38668962327404,0.11114074444716737,-0.028918268693793436,-0.1400590131409608,1880449562,1937925725.2,53.87027677556678,44.647038852958794,NaN,NaN,-1.8805739666250358,-8.803921475808561
2005-10-27T09:30:00-04:00,38.78,38.8,38.03,38.03,135443120,107657972,43.48962701596185,44.4637800236447,NaN,NaN,-30.328181100972014,31.947445512458057,0.05518085649382387,-0.07108294252368097,-0.12626379901750484,1745006442,1919806326.8,51.68657323868953,44.50424443251013,NaN,NaN,-3.8454817491623356,-8.095572943430529
2005-10-28T09:30:00-04:00,38.17,38.392,37.92,38.32201,95367504,108463340.8,47.15932731649627,45.15866393263441,NaN,NaN,-36.22756975570618,22.534535966840345,0.03700013013380818,-0.08001363635024461,-0.11701376648405279,1840373946,1898749827.6,49.191071752235736,44.680304837650546,NaN,NaN,-4.1507022370848645,-7.532019985381148
2005-10-31T09:30:00-05:00,38.42999,39.05,38.42,38.87,115431008,110150181.6,53.289547710841234,46.450300901436876,NaN,NaN,64.94144366028598,23.44480829449576,0.05970342887763677,-0.04238448038700682,-0.10208790926464359,1955804954,1878422506,46.83994964062416,45.12920961005206,NaN,NaN,-2.245429295396852,-6.77679274395482
2005-11-01T09:30:00-05:00,38.75999,39.00999,38.71001,38.84,73633504,109562875.2,52.92753590731061,48.04898593218754,NaN,NaN,92.45798755120173,29.18516269205609,0.06981985036464697,-0.014813096308834872,-0.08463294667348184,1882171450,1860761270.8,44.834875356039106,45.83047861997311,NaN,NaN,-0.9065092752957773,-5.938180819860671
2005-11-02T09:30:00-05:00,38.72501,39.46001,38.71001,39.347,101555808,109329296.8,58.10709255375368,49.59880458006387,NaN,NaN,146.07879744555748,47.384495560073404,0.10562769341247102,0.04740167009210694,-0.058226023320364084,1983727258,1881416810,47.656979112668516,46.8187305566379,NaN,NaN,1.979620259597387,-4.8070663799380915
2005-11-03T09:30:00-05:00,39.74001,40.0901,39.67999,39.94,137054000,108068328,63.20658724659042,51.14977168841632,NaN,NaN,215.69426003332654,96.58898378693311,0.1609088876755993,0.14291008627413504,-0.01799880140146426,2120781258,1956571773.2,56.39730321735955,48.481416412044645,NaN,NaN,6.232279120604828,-3.230017022717675
2005-11-04T09:30:00-05:00,39.994,40.23,39.84,40.08,100944432,108558921.6,64.31111750287386,52.6309437964863,NaN,NaN,189.76739323868827,141.787976385812,0.19622152405492238,0.2272781036671887,0.031056579612266336,2221725690,2032842122,63.12653455155083,50.486118517123835,NaN,NaN,9.936811143557197,-1.3490415703926935
2005-11-07T09:30:00-05:00,40.2,40.28999,39.95,40.13,65366512,108625656.8,64.71848040752789,54.388260374567494,NaN,NaN,165.4692273188465,161.8935331175241,0.21097629016911326,0.2947769423236579,0.08380065215454466,2287092202,2099099571.6,67.77873445145323,52.633530554060165,NaN,NaN,12.98737563545733,0.699018030443024
2005-11-08T09:30:00-05:00,40.064,40.35001,39.99001,40.14,78859632,106830156.8,64.80500590501492,55.32215668629839,NaN,NaN,146.79802767296272,172.7615411418763,0.20903874805833242,0.3450990872274602,0.13606033916912777,2365951834,2195855648.4,73.11341353326115,54.526053418726164,NaN,NaN,15.455161043177663,2.8070384608336862
2005-11-09T09:30:00-05:00,40.13,40.33,40.03,40.159,72458752,103146904,64.98073438056677,56.60462901545096,NaN,NaN,131.73680312402934,169.8931422775707,0.19683827707831314,0.3821081855170192,0.18526990843870605,2438410586,2286792314,76.97229790568419,56.53422247844132,NaN,NaN,17.52271114182678,4.90927741526127
2005-11-10T09:30:00-05:00,40.17999,40.69,39.92,40.60001,120763056,102255875.2,68.86643723628517,57.93155016348255,NaN,NaN,134.50741873790702,153.65577401848677,0.20532782801606642,0.4419296934587891,0.23660186544272266,2559173642,2374470790.8,79.95895351725503,58.62807145230638,NaN,NaN,20.52948775166513,7.140736034747535
2005-11-11T09:30:00-05:00,40.77,40.918,40.67999,40.71001,80107120,99687200,69.76752115895152,58.81769652040936,NaN,NaN,143.33999397795222,144.37029416633956,0.204748179017184,0.4925370892142027,0.2877889101970187,2639280762,2457981805.2,82.31208710041089,60.695657091798275,NaN,NaN,23.29182789494079,9.448034871918
2005-11-14T09:30:00-05:00,40.75999,40.86,40.603,40.714,53652320,99159108,69.80166279616243,59.855044852263696,NaN,NaN,119.82051512539815,135.24055172764992,0.19128254429838049,0.5268920905699943,0.3356095462716138,2692933082,2539149981.2,84.24801106409487,62.713361515492394,NaN,NaN,25.5740837635674,11.75175614215363
2005-11-15T09:30:00-05:00,40.73,40.89999,40.38,40.52,79543440,98731476.8,65.9045794310777,60.80966118352958,NaN,NaN,96.78579151292153,125.23810449564166,0.1573748833260301,0.5323281504291515,0.3749532671031214,2613389642,2588637542.8,85.30410533630982,64.9586349841169,NaN,NaN,26.522235297687153,13.861824592944133
2005-11-16T09:30:00-05:00,40.64999,40.78,40.46001,40.76801,65912624,95379995.2,68.33824583118772,62.58456252747429,NaN,NaN,91.99805436663394,117.29035474416257,0.14028140833501235,0.5503050275218868,0.41002361918687447,2679302266,2636815878.8,86.26926984899823,67.42882759913896,NaN,NaN,28.022884820523487,15.88483319688404
2005-11-17T09:30:00-05:00,40.91,41.32001,40.85001,41.30701,94448320,93468564,72.87047123468471,64.42107280734488,NaN,NaN,119.00992356821008,114.19085571022318,0.15287337986553562,0.601115344018794,0.44824196415325834,2773750586,2679731267.6,87.08305729672112,70.13539799517362,NaN,NaN,30.77760891913756,18.0123725857774
2005-11-18T09:30:00-05:00,41.5,41.651,41.0253,41.45,108820128,93406920,73.93636305623119,65.89584533201561,NaN,NaN,124.8051116320581,110.48387924104436,0.157790659813966,0.6454802889207159,0.48768962910674984,2882570714,2728389258,87.95474169461737,73.07216885617314,NaN,NaN,33.38611394535916,20.208621351431937
2005-11-21T09:30:00-05:00,41.397,41.58099,41.24001,41.549,69731376,91304232.8,74.67815222083598,67.4494607829817,NaN,NaN,120.6313951966494,110.6460552552946,0.15447284395908445,0.6807806840556054,0.526307840096521,2952302090,2780263059.6,88.82087722975558,76.21402613286716,NaN,NaN,35.76877730420892,22.43150077325722
2005-11-22T09:30:00-05:00,41.45,41.87,41.36,41.7,88819184,91396995.2,75.80905367302928,68.71388657721567,NaN,NaN,124.90783675491917,116.27046430369413,0.14913379864503917,0.71272508840282,0.5635912897577808,3041121274,2865809386,90.08683713624913,79.24473027740864,NaN,NaN,38.11494560269919,24.67199289174893
2005-11-23T09:30:00-05:00,41.73,42.02,41.71001,41.8,64101104,90100647.2,76.55579904456499,69.66740170564243,NaN,NaN,127.99337011165491,123.46952745269832,0.13921316049294907,0.7376077403739671,0.5983945798810181,3105222378,2950993408.4,91.1603092353798,81.72780213583864,NaN,NaN,40.30252611491329,26.904926209343838
2005-11-25T09:30:00-05:00,41.84,41.94,41.73,41.89,22930176,84475000,77.236849433687,70.59066827212908,NaN,NaN,119.33667769749617,123.53487827855551,0.12598545336431832,0.7558763965864159,0.6298909432220976,3128152554,3021873802,91.94220259345062,83.78606413883149,NaN,NaN,42.34365525213131,29.110458929742048
2005-11-28T09:30:00-05:00,41.96001,42,41.5,41.53999,74716192,83442434.4,68.8590929216104,70.88642630884927,NaN,NaN,98.57850885062251,118.28955772226841,0.08301080114633508,0.7336544446550164,0.6506436435086813,3053436362,3056046931.6,92.29601199255781,85.53729824891039,NaN,NaN,41.83939504339197,30.92887837454918
2005-11-29T09:30:00-05:00,41.75999,41.85001,41.34,41.343,77444752,81543121.6,64.61132994409431,70.87259231164066,NaN,NaN,77.14347795522907,109.59197427398435,0.0332203228321577,0.6921690470488784,0.6589487242167207,2975991610,3060784835.6,92.34619039876306,86.91106802501767,NaN,NaN,40.18617176882861,32.25134885944624
2005-11-30T09:30:00-05:00,41.28999,41.49001,41.189,41.24001,88044368,82263664.8,62.44255153910719,70.69129353725069,NaN,NaN,49.98019262314391,94.60644544762928,-0.012308939523182794,0.6435625498127422,0.655871489335925,2887947242,3030150029.2,88.3396413545439,87.72302112850764,NaN,NaN,38.18114792549073,33.09846301173831
2005-12-01T09:30:00-05:00,41.50999,42.05,41.5,42.007,91914064,81781577.6,70.40872132612405,70.80145668652489,NaN,NaN,97.98066146997098,88.6039037192925,0.002767510628317593,0.659330877621322,0.6565633669930044,2979861306,3005077814.8,85.08598453275555,88.08923762961481,NaN,NaN,38.707501209734204,33.89975418288058
2005-12-02T09:30:00-05:00,41.94,42.133,41.87,42.10699,72929184,78575336.8,71.26442791570044,70.90837859772124,NaN,NaN,108.31837467873429,86.40024311554014,0.012467425338832605,0.6721476486665452,0.6596802233277126,3052790490,2990005402,83.10438976230826,88.1458306768932,NaN,NaN,39.394517468107644,34.68472036648444
2005-12-05T09:30:00-05:00,42.05,42.06,41.629,41.8,61585504,76607390.4,65.04530104774844,70.56863847283452,NaN,NaN,79.26505305141512,82.53755195569866,-0.00771198236649373,0.6500402453695955,0.6577522277360892,2991204986,2977559126.8,81.41814990141185,87.94369773670155,NaN,NaN,38.024200119247524,35.16178890259345
2005-12-06T09:30:00-05:00,42.03999,42.31,41.89999,41.936,81509376,77414533.6,66.44246084878782,70.60705857409953,NaN,NaN,98.38953675028802,86.78676371471046,-0.01727316854422667,0.6361607670558058,0.6534339356000325,3072714362,2996903677.2,82.02850627834083,87.70972637541806,NaN,NaN,37.31858451147752,35.46990256100546
2005-12-07T09:30:00-05:00,42.00999,42.03,41.629,41.86,83885440,77665824,64.88175003930857,70.36016601753673,NaN,NaN,68.0828300576323,90.40729120160813,-0.0331678216832797,0.6119741584959328,0.6451419801792125,2988828922,3017080013.2,82.66796488775863,87.4524903067581,NaN,NaN,36.282063781203554,35.58592559246233
2005-12-08T09:30:00-05:00,41.96001,42,41.27,41.561,112043184,79645045.6,59.00905230530605,69.37006466543826,NaN,NaN,31.122154698804408,77.03558984737481,-0.06635468808838241,0.5621986200687346,0.628553308157117,2876785738,2996464899.6,79.55327756958268,86.91464889767677,NaN,NaN,33.59921674735332,35.30211004316104
2005-12-09T09:30:00-05:00,41.571,41.77,41.3799,41.715,56531744,76433480,60.96863264969612,68.4437982078286,NaN,NaN,26.955777882778687,60.763070488183686,-0.07957963092143328,0.5290787695053254,0.6086584004267587,2933317482,2972570298,75.97993328990515,86.05930544019733,NaN,NaN,31.917062511742927,34.81853182438703
2005-12-12T09:30:00-05:00,41.87,41.94,41.67999,41.867,44869984,74671623.2,62.85606161724738,67.59936316471514,NaN,NaN,59.81260448874947,56.872580775650576,-0.0795458106812107,0.5092261370752453,0.588771947756456,2978187466,2969966794,75.58157317416895,85.11364086479828,NaN,NaN,31.04020638529051,34.27877104737324
2005-12-13T09:30:00-05:00,41.83,42.211,41.75999,42.045,76611632,75819588.8,64.9910570304991,66.82664911882013,NaN,NaN,91.33558409091727,55.461790243776434,-0.06936286727220142,0.5020683636662042,0.5714312309384056,3054799098,2966383741.2,74.9987848917801,84.03592284733621,NaN,NaN,30.905570001223392,33.79688518363755
2005-12-14T09:30:00-05:00,41.97,42.09599,41.70799,41.899,73581568,75521495.2,61.850754185879126,65.77628877177114,NaN,NaN,65.20533664101163,54.8862915604523,-0.07387128787394548,0.47909212109597377,0.5529634089699192,2981217530,2964861462.8,74.73512431017883,82.862695352679,NaN,NaN,29.89058859929341,33.238842814445526
2005-12-15T09:30:00-05:00,42,42.07001,41.608,41.97,72678256,75859776.8,62.79229889270773,64.74453516170118,NaN,NaN,54.374757344206635,59.536812089532745,-0.07333483130473428,0.46129486983900136,0.5346297011437356,3053895786,3000283472.4,76.78064953718456,81.77972727723143,NaN,NaN,29.30227556641959,32.67647606472754
2005-12-16T09:30:00-05:00,41.87,41.94,41.549,41.58,63742944,74324508,54.79269323087665,63.739792326648775,NaN,NaN,-19.229748355136277,50.29970684194975,-0.09891726350537611,0.41098312176201546,0.5099003852673916,2990152842,3011650544.4,77.4126438522062,80.71662955292061,NaN,NaN,26.374641686936183,31.776214010757343
2005-12-19T09:30:00-05:00,41.69,41.71001,40.89999,40.92,75415008,72654252,44.468064673395524,62.300987664456,NaN,NaN,-196.3004562532007,-0.9229053064402905,-0.1565347525894184,0.31423194453061853,0.47076669712003694,2914737834,2998960618,74.9597081312432,79.47473796238346,NaN,NaN,20.088685388877863,30.10656706477456
2005-12-20T09:30:00-05:00,40.94,41.14999,40.75,40.95,70257632,72680564.8,44.97560327724068,61.05334850289411,NaN,NaN,-233.10219321251992,-65.81046076712774,-0.18681982832055394,0.2372419117193445,0.42406174003989844,2984995466,2984999891.6,72.24745381039803,78.32529599494447,NaN,NaN,15.319907459480984,27.99418712116119
2005-12-21T09:30:00-05:00,41.02,41.41,40.95,41.13,68934944,71686352.8,48.043909293088056,59.45586192910583,NaN,NaN,-141.99461156235944,-107.25045040780194,-0.1883874334142282,0.1885774482721132,0.3769648816863414,3053930410,2999542467.6,73.32999308295247,77.48558231995855,NaN,NaN,12.28343200092159,25.749793532555532
2005-12-22T09:30:00-05:00,41.11,41.46201,40.98,41.397,59156976,71439146.4,52.29347550269663,58.10079389960556,NaN,NaN,-95.52802453692183,-137.23100678402764,-0.16589179799309517,0.16960013419497244,0.3354919321880676,3113087386,3011380787.6,74.2118427450738,76.85040039015608,NaN,NaN,10.9999694637565,23.642675808441385
2005-12-23T09:30:00-05:00,41.50999,41.59,41.299,41.403,38000400,72192657.6,52.38771908665705,57.19668090238474,NaN,NaN,-50.890381894269204,-143.56313349185422,-0.14577135727309187,0.15327773559670277,0.29904909286979464,3151087786,3043567776.4,76.48816099808118,76.49825832563248,NaN,NaN,10.002032508948213,21.694012479942362
2005-12-27T09:30:00-05:00,41.5,41.67999,40.97,41.03799,55669200,71240308,46.38448902295182,55.76396862911075,NaN,NaN,-89.586473299318,-122.22033690107769,-0.15153913836983934,0.10962516990749549,0.26116430827733483,3095418586,3079703926.8,78.75544785634033,76.26446843834673,NaN,NaN,7.270670598973078,19.633535068375323
2005-12-28T09:30:00-05:00,41.06,41.23,40.87,40.99001,50315392,69883840,45.64406587966338,54.38984833199323,NaN,NaN,-118.76022437353981,-99.35194313328167,-0.15265329643755027,0.07034768773039701,0.22300098416794728,3045103194,3091725472.4,79.46489478089603,76.03567771642795,NaN,NaN,4.836524470286165,17.519676411505444
2005-12-29T09:30:00-05:00,41.03,41.12,40.64999,40.72,47308160,67847029.6,41.61790004110956,53.14762317026491,NaN,NaN,-143.28913625710405,-99.6108480722306,-0.16461375589561933,0.01723378929842312,0.18184754519404245,2997795034,3080498397.2,76.88268294524943,75.84492095754702,NaN,NaN,1.4979604894867746,15.230859851217062
2005-12-30T09:30:00-05:00,40.55,40.58,40.36,40.412,60052832,66253968,37.549133203364924,51.47480178124125,NaN,NaN,-178.63533687633054,-116.23231054011235,-0.18479472488968743,-0.04914586091806683,0.1356488639716206,2937742202,3045429360.4,69.30678371221481,75.36826741628343,NaN,NaN,-2.687048308393896,12.671158685558353
2006-01-03T09:30:00-05:00,40.64,41.49001,40.16,41.31,109422192,68078618.4,52.21698448273895,50.714867700204934,NaN,NaN,-78.05508280846979,-121.66525072295246,-0.13168494313879037,-0.028957314951867374,0.10272762818692299,3047164394,3024644682,65.20572895333183,74.62713568622364,NaN,NaN,-1.5285931077372592,10.642622715087551
2006-01-04T09:30:00-05:00,41.39999,41.74001,41.3158,41.74001,92780128,69638349.6,57.379204183966664,50.17116392545262,NaN,NaN,30.364914549283064,-97.67497315323224,-0.06498793308535675,0.02149271183022705,0.0864806449155838,3139944522,3033549869.2,66.13045608308298,73.99368362845955,NaN,NaN,1.327504049166239,9.311891477098792
2006-01-05T09:30:00-05:00,41.75,42,41.7065,41.92,77692064,69447484,59.35839768770807,49.99313846129754,NaN,NaN,82.81167140352743,-57.360593997818796,-0.009078650701321925,0.0751323315389314,0.08421098224025332,3217636586,3068056547.6,69.51175152020652,73.62058557203295,NaN,NaN,4.255808824013914,8.589593955229523
2006-01-06T09:30:00-05:00,42.25999,42.7,42.06,42.67999,110120944,70759259.2,66.44405790808489,50.25397839096735,NaN,NaN,172.20959331285985,5.7391519161740066,0.07417317309988002,0.17692744861510334,0.10275427551522333,3327757530,3134049046.8,74.71140670911961,73.47278251288546,NaN,NaN,9.55436694652883,8.72741866827228
2006-01-09T09:30:00-05:00,42.64999,42.9201,42.52,42.8499,80775248,69195862.4,67.79587146529065,51.18277683628263,NaN,NaN,183.43337893653862,78.15289507874783,0.13237199124682258,0.26821926457375156,0.13584727332692897,3408532778,3228207162,79.96234417397142,73.65490396444012,NaN,NaN,14.114569480064674,9.497011641385479
2006-01-10T09:30:00-05:00,42.64,42.92,42.55,42.88,84420432,70590296.8,68.04149279911621,52.866593130976966,NaN,NaN,157.76821793164237,125.31755522677027,0.16259314246830897,0.3390887014123152,0.1764955589440062,3492953210,3317364925.2,83.46370239430632,74.26233212608749,NaN,NaN,17.69235319664429,10.667774720708167
2006-01-11T09:30:00-05:00,43.00999,43.31,42.87,43.21001,100777632,73385679.2,70.68170331957288,54.70274313400069,NaN,NaN,171.48241902834317,153.54105612258232,0.19246316428793658,0.41707451430392695,0.22461135001599036,3593730842,3408122189.2,86.1221018660332,75.25337841577571,NaN,NaN,21.56767696837539,12.224903613232055
2006-01-12T09:30:00-05:00,43.14999,43.28999,42.85001,43,82429120,73676553.6,66.89432320476791,56.049201270549254,NaN,NaN,142.01891236079217,165.38250431403526,0.1856457918018069,0.456668589768249,0.2710227979664421,3511301722,3466855216.4,87.5203088693166,76.26697240051601,NaN,NaN,23.542721014155585,13.841734670506845
2006-01-13T09:30:00-05:00,42.94,43.05,42.73,42.98,64586064,73226778.4,66.52871517269207,57.06600410412035,NaN,NaN,112.8274736563108,153.50608038272543,0.16789371923885849,0.4808899470150152,0.3129962277761567,3446715658,3490646842,88.04571808466801,77.25510635334417,NaN,NaN,25.001897425488913,15.436043635504284
2006-01-17T09:30:00-05:00,42.67,42.78999,42.5,42.7,78109632,73498347.2,61.46394638157526,57.714306053757376,NaN,NaN,79.36784129733522,132.69297285488477,0.12724332514561953,0.47205038420818113,0.3448070590625616,3368606026,3482661491.6,86.72595048688525,77.9863770311159,NaN,NaN,24.7345052495175,16.764395294649027
2006-01-18T09:30:00-05:00,42.03999,42.46001,42.02,42.21001,122426496,76432524.8,53.75207790067309,58.24056240216605,NaN,NaN,37.229602183121266,108.58524970518053,0.06068058305959789,0.420657787887059,0.3599772048274611,3246179530,3433306755.6,78.85811694984059,77.99371053779448,NaN,NaN,22.039230338355868,17.51794315803572
2006-01-19T09:30:00-05:00,42.39999,42.82001,42.28999,42.52,111105184,78217033.6,57.39418877517504,59.079856894702594,NaN,NaN,58.03837160664965,85.89644022084184,0.0322803635648124,0.4003276592834766,0.3680472957186642,3357284714,3386017530,72.10805259081874,77.46822180993182,NaN,NaN,20.909783935115858,18.00249184047574
2006-01-20T09:30:00-05:00,42.45,42.49001,41.14999,41.25,188671120,84137708,42.59443424644778,59.149609337941044,NaN,NaN,-24.511911875759196,52.59027537353156,-0.07161638379912721,0.27852681596975515,0.35014319976888236,3168613594,3317479904.4,63.609671536210705,76.52014956642905,NaN,NaN,14.129276579359479,17.44917537460199
2006-01-23T09:30:00-05:00,41.36,41.45,41.08,41.25999,111432064,86262564,42.719557895732926,59.518925387395896,NaN,NaN,-58.208460540869744,18.38308853409547,-0.13553725330745786,0.18072163313456002,0.3162588864420179,3280045658,3284145904.4,59.911350541757855,75.84904719711069,NaN,NaN,9.149374757492742,16.26348957215781
2006-01-24T09:30:00-05:00,41.36,41.7,41.31,41.44,77967248,87203077.6,45.04398772338547,59.006568476013506,NaN,NaN,-39.76332602258102,-5.443144929887789,-0.15989198341455046,0.1163939071738298,0.27628589058838027,3358012906,3282027280.4,59.67387612031558,75.45391485189525,NaN,NaN,5.963057351489234,14.79199925491944
2006-01-25T09:30:00-05:00,41.64,41.67,41.08,41.25999,99830944,90294604.8,43.15792838636365,57.99076306189901,NaN,NaN,-52.43455902759067,-23.37597717203018,-0.18078191782655945,0.050308493305180946,0.2310904111317404,3258181962,3284427766.8,59.8679775883816,75.00659495941659,NaN,NaN,2.789235691257691,13.077318745824906
2006-01-26T09:30:00-05:00,41.52,41.69,41.23,41.55,112779808,93150135.2,47.00767808982451,57.10856880490733,NaN,NaN,-40.330347748191755,-43.049721042998456,-0.16799748363355477,0.021093556589796947,0.18909104022335171,3370961770,3287163178,60.10363641321929,74.33458673748892,NaN,NaN,1.343998804752087,11.401130182814503
2006-01-27T09:30:00-05:00,41.81,42.39,41.74001,42.11,110836128,96176172,53.54968498391601,56.187542167466695,NaN,NaN,9.810188714395046,-36.1853009249676,-0.11716375744380128,0.04263634341860012,0.1598001008624014,3481797898,3349800038.8,65.15009086828435,73.65163560600068,NaN,NaN,2.2254253507914377,10.090315206811209
2006-01-30T09:30:00-05:00,42.14,42.32001,42.07001,42.19,53942768,96507902.4,54.41545456011192,55.23179810281107,NaN,NaN,15.413697014236371,-21.46086941394638,-0.07551169882285341,0.06541047733383465,0.14092217615668806,3535740666,3400939040.4,68.63798972173129,72.8427531451264,NaN,NaN,3.194755814097678,9.105235293566418
2006-01-31T09:30:00-05:00,42.14,42.27,41.81,42,101424256,98576473.6,51.93940722566196,54.081649133278624,NaN,NaN,-12.08450197802979,-15.925104605036134,-0.05885666408995216,0.06735134604424786,0.12620801013420002,3434316410,3416199741.2,69.6152817622919,71.85358024283964,NaN,NaN,3.250497852798733,8.268844230599605
2006-02-01T09:30:00-05:00,41.75999,42.17,41.7,42.14999,89240256,97567376.8,53.72933620270914,52.87076576778836,NaN,NaN,-22.824371963563063,-10.003067192230638,-0.036910850334783696,0.0800694472157204,0.1169802975505041,3523556666,3469274682,72.79093982691316,70.9013543829025,NaN,NaN,3.8250138868351464,7.634011324347539
2006-02-02T09:30:00-05:00,42.03,42.08,41.41,41.42999,94051504,97630945.6,45.05486108699214,51.31080418794723,NaN,NaN,-72.47497723166379,-16.431993088925044,-0.06823591665918727,0.03168540172652001,0.09992131838570728,3429505162,3480983360.4,73.45017922892455,69.89634512287451,NaN,NaN,1.5741473616786308,6.768316472537695
2006-02-03T09:30:00-05:00,41.11,41.23,40.78,40.92,121104000,99801542.4,40.1146188148695,49.42408301953133,NaN,NaN,-142.65736621147877,-46.925504074099806,-0.11775015581495438,-0.0472663763829857,0.07048377943196868,3308401162,3446304013.2,68.18102555608658,68.47743851369012,NaN,NaN,-2.01046198678828,5.514205264062555
2006-02-06T09:30:00-05:00,40.89,41.00999,40.59,40.81,58171408,97204065.6,39.118291181707235,47.827964790969325,NaN,NaN,-142.167733919251,-78.44179026079728,-0.15027459410969868,-0.11735946320515467,0.03291513090454401,3250229754,3389201830.8,60.48664004156949,66.60320205331041,NaN,NaN,-5.174639583644478,3.9872274286758365
2006-02-07T09:30:00-05:00,40.74001,40.92999,40.44,40.63,87377376,97534172,37.47792956008231,46.66552562378427,NaN,NaN,-137.06264250029665,-103.43741836525064,-0.1745698998422333,-0.18529724389824764,-0.010727344056014325,3162852378,3334909024.4,54.221171202929966,64.84342021424537,NaN,NaN,-8.275502705185595,2.2354088381242034
2006-02-08T09:30:00-05:00,40.925,41.14999,40.69,41.10001,89928256,97809563.2,44.07274308623337,45.71399378885986,NaN,NaN,-92.86637431343252,-117.44581883522453,-0.15055374486526082,-0.19891952513759037,-0.04836578027232954,3252780634,3280753818,48.79209218819644,63.177994471200925,NaN,NaN,-8.920666320497194,0.6416838154640039
2006-02-09T09:30:00-05:00,41.2,41.37,40.63,40.71001,78220256,96681694.4,40.27642754184395,45.54842188138816,NaN,NaN,-93.23112682981217,-121.5970487548542,-0.15205655541418917,-0.238436474540066,-0.08637991912587684,3174560378,3229764861.2,44.29499268345865,61.798374553147205,NaN,NaN,-10.672431324915452,-0.9746183474473469
2006-02-10T09:30:00-05:00,40.69,41.06,40.25999,40.96001,102575872,97689032,43.62848907109341,45.61334553677106,NaN,NaN,-102.90823783657751,-113.64722307987395,-0.12828550686701154,-0.24673680270964127,-0.11845129584262973,3277136250,3223511878.8,43.76229730207899,60.644870750313,NaN,NaN,-11.076597926838506,-2.4177582873603694
2006-02-13T09:30:00-05:00,40.72,40.74001,40.3,40.49001,70656000,97992528.8,39.17668151173051,45.194252235938556,NaN,NaN,-122.70700912991109,-109.75507812200597,-0.13557574004812173,-0.2879209709027819,-0.15234523085466017,3206480250,3214761978,42.9833198992782,59.45268816309605,NaN,NaN,-12.844522074417226,-3.9072959712256345
2006-02-14T09:30:00-05:00,40.55,41.02,40.41,40.89999,94758496,98824972,44.496938885472694,45.28989584301777,NaN,NaN,-82.25976869667392,-98.79450336128143,-0.10548514444762139,-0.2842016614141869,-0.17871651696656551,3301238746,3242439251.6,46.24292676635698,58.479470247237145,NaN,NaN,-12.627620436297123,-5.15305660909299
2006-02-15T09:30:00-05:00,40.77,41.25999,40.73,41.16,92268320,97317063.2,47.625838825140576,45.334050181254625,NaN,NaN,-41.72383469096548,-88.56599543678803,-0.06287268135861954,-0.25730736866483994,-0.1944346873062204,3393507066,3270584538,49.41025338648833,57.715657173899224,NaN,NaN,-11.456237540542345,-6.053511027871469
2006-02-16T09:30:00-05:00,41.31,41.55,41.14999,41.53999,103879184,96955763.2,51.89399977047022,45.21578695172279,NaN,NaN,17.627151890571984,-66.3943396927112,-0.006845427182099489,-0.20299147128384476,-0.19614604410174527,3497386250,3335149712.4,55.838317317406386,57.050530491693664,NaN,NaN,-9.099469028305103,-6.488647885076274
2006-02-17T09:30:00-05:00,41.46001,41.46001,41.2,41.21001,81770128,91610713.6,48.21912010733985,44.773191633667636,NaN,NaN,1.2103174443281148,-45.570628636530074,0.009359892248414936,-0.1844461787912266,-0.19380607103964154,3415616122,3362845686.8,58.28678486709825,56.311158716362726,NaN,NaN,-8.270802661330185,-6.743241424541118
2006-02-21T09:30:00-05:00,41.22,41.27,40.61,40.75,85106064,90294413.6,43.58538501903302,44.176475761765566,NaN,NaN,-59.53017859189172,-32.9352625289262,-0.0085634590773144,-0.20451039488628453,-0.19594693580897013,3330510058,3387651648.4,60.40427382018664,55.653229577640914,NaN,NaN,-9.03983070544359,-7.071325607527186
2006-02-22T09:30:00-05:00,40.81,41.53999,40.67999,41.25999,90997680,90945935.2,49.39184570577944,43.86665501198488,NaN,NaN,-13.636738594570833,-19.210656508505583,0.014984223401177915,-0.17721665655749774,-0.19220087995867566,3421507738,3411705446.8,62.39758677262002,54.91084721661998,NaN,NaN,-7.79335570866256,-7.174472764832239
2006-02-23T09:30:00-05:00,41.22,41.53999,41.08,41.14999,66530560,89280916,48.23857816706524,44.09406337484724,NaN,NaN,2.1634048320671813,-10.433208603899057,0.023690272548059915,-0.16258803927360077,-0.18627831182166069,3354977178,3403999469.2,61.33235146913095,54.045288090920444,NaN,NaN,-7.157378326906838,-7.172030702271467
2006-02-24T09:30:00-05:00,41.14999,41.28999,41.00999,41.25999,57087920,86496321.6,49.50821701653028,44.76503467496587,NaN,NaN,-6.721393959837841,-15.302917773981022,0.03662337908725208,-0.14049908796259558,-0.17712246704984766,3412065098,3386935238.8,58.93307387221019,53.38472011350069,NaN,NaN,-6.26147600255115,-7.041951459454279
2006-02-27T09:30:00-05:00,41.37,41.87,41.33,41.72,64960240,84202527.2,54.53104441971915,45.86594562053814,NaN,NaN,75.77095296667886,-0.3907906695108679,0.07378129691625135,-0.08489584590453347,-0.15867714282078482,3477025338,3399217082,60.14164382411826,53.36007752653989,NaN,NaN,-3.9259506198865957,-6.596808482373182
2006-02-28T09:30:00-05:00,41.59,41.72,40.97,41.10001,117638944,87387336,47.650855748742934,46.59258320544247,NaN,NaN,21.075060081303082,15.730257065128091,0.055083738272792976,-0.0898224699797936,-0.14490620825258657,3359386394,3404992349.2,60.726929200172414,53.82477452634292,NaN,NaN,-4.054874689067869,-6.233675083329565
2006-03-01T09:30:00-05:00,41.22,41.7701,41.14999,41.66,80979376,86365092,53.37318160074264,47.25690024219313,NaN,NaN,86.04458001942544,35.66652078792735,0.07753522596689286,-0.047987175793970493,-0.12552240176086335,3440365770,3408763955.6,61.12836862527604,54.705937128991465,NaN,NaN,-2.266590580478006,-5.666948725779343
2006-03-02T09:30:00-05:00,41.55,41.84,41.41,41.69,69878128,85396985.6,53.66539099028685,48.21325477422477,NaN,NaN,123.62067954078361,59.95797572967062,0.09060175252115703,-0.012270211109417062,-0.10287196363057409,3510243898,3439817299.6,64.35868851520473,56.13905825983046,NaN,NaN,-0.7757806629916474,-4.968210431095386
2006-03-03T09:30:00-05:00,41.44,42.00999,41.39,41.45,112081680,86298494.4,50.916295331485536,48.733812364252785,NaN,NaN,117.37766641974568,84.77778780558734,0.07966372938487692,-0.003292301899477934,-0.08295603128435486,3398162218,3437036723.6,63.84704830678402,57.5736833315951,NaN,NaN,-0.36767989185602407,-4.3109917826326205
2006-03-06T09:30:00-05:00,41.53,41.63,40.96001,41.09,99593632,85222976,47.02494945602797,49.29440293170261,NaN,NaN,23.38561405952562,74.30072002415669,0.046413819383298666,-0.02493875705523152,-0.07135257643853019,3298568586,3401345373.2,57.52540404904697,58.61240362800716,NaN,NaN,-1.2071118138997603,-3.8675803585279263
2006-03-07T09:30:00-05:00,41.03,41.07001,40.64999,40.85001,96498128,87139312,44.57899354383938,49.3002639787288,NaN,NaN,-65.32133166749438,57.021441674397195,0.008475237524619914,-0.06075852953275529,-0.0692337670573752,3202070458,3369882186,52.58278404403812,59.06525057641295,NaN,NaN,-2.6462641400500972,-3.6931066130310937
2006-03-08T09:30:00-05:00,40.77,41.09,40.5,40.87,104013376,87971112,44.83637509610432,49.10101656951191,NaN,NaN,-78.2674735254992,24.159030965412263,-0.013841310409220375,-0.08653540506890067,-0.0726940946596803,3306083834,3343025798.8,48.73370743189048,59.016925865370254,NaN,NaN,-3.7371522614372132,-3.6993988485176823
2006-03-09T09:30:00-05:00,41,41.1501,40.47,40.52,108641568,88906777.6,41.22629186658987,48.33903743352045,NaN,NaN,-96.03200332602988,-19.771505607950434,-0.048776750098694116,-0.13366503228304794,-0.08488828218435382,3197442266,3280465472.4,41.173012387518376,57.969404084663964,NaN,NaN,-5.744196463897013,-3.9915127935718724
2006-03-10T09:30:00-05:00,40.48,40.78999,40.19,40.56,124486256,91220077.6,41.80301035159428,47.880743879538635,NaN,NaN,-128.52850270311913,-68.95273943252339,-0.06479003222654971,-0.16587582246754096,-0.10108579024099125,3321928522,3265218733.2,39.562091681282716,56.63192599996286,NaN,NaN,-7.234030959316931,-4.4547296743925955
2006-03-13T09:30:00-05:00,40.75999,40.94,40.62,40.67999,69171056,89549836.8,43.5911353859787,47.881154620034756,NaN,NaN,-77.52587767946349,-89.13503778032121,-0.06285138535016793,-0.17965002192870116,-0.11679863657853323,3391099578,3283724931.6,42.50267884741797,55.353240644765094,NaN,NaN,-8.014011286092828,-4.963198476064057
2006-03-14T09:30:00-05:00,40.64999,41.42,40.64,41.37,118215312,91927802.4,52.60873030181928,48.11093209118046,NaN,NaN,1.7459055426630852,-75.72159033828972,-0.01324184848321859,-0.13335094718255647,-0.12010909869933788,3509314890,3345173818,51.02370747786754,54.54082069513992,NaN,NaN,-6.051612787031284,-5.11868623477366
2006-03-15T09:30:00-05:00,41.53,41.72,41.32001,41.72,84396128,91409684,56.414824284026245,48.69494967096339,NaN,NaN,100.86138381681927,-39.89581886982603,0.04197780176937162,-0.06763684648762336,-0.10961464825699498,3593711018,3402699254.8,57.38999935329804,54.25922411543757,NaN,NaN,-3.193457823575882,-4.843653604602549
2006-03-16T09:30:00-05:00,41.85001,41.9201,41.33,41.37,101385936,91865564.8,51.92392456733404,48.8675002103065,NaN,NaN,80.8590849756228,-4.51760120949549,0.053051016519897326,-0.04330087760712331,-0.09635189412702064,3492325082,3461675818,62.737779992368154,54.530988838305994,NaN,NaN,-2.1091603185215253,-4.453011706590974
2006-03-17T09:30:00-05:00,41.32001,41.59,41.23,41.45,78228432,90583027.2,52.84787362308707,48.74727372483279,NaN,NaN,52.80776823436005,31.74965297800035,0.06319430598529927,-0.01735901164539655,-0.08055331763069581,3570553514,3511400816.4,66.54968646920861,54.988706170098155,NaN,NaN,-0.9556830580150916,-3.953393328222991
2006-03-20T09:30:00-05:00,41.58,41.67999,41.39999,41.55,60240176,89506529.6,54.03698417040448,49.20342575495147,NaN,NaN,75.30908566497747,62.31664564688854,0.073355328972986,0.011140843585536686,-0.06221448538744931,3630793690,3559339638.8,69.76137096655657,55.63402343912559,NaN,NaN,0.3389809553818778,-3.340197001993724
2006-03-21T09:30:00-05:00,41.50999,42.00999,41.08,41.11,136566000,92079526.4,48.26896974373238,48.838839193736455,NaN,NaN,38.00384473999084,69.5682334863541,0.048366079279048055,-0.0017568862886392367,-0.05012296556768729,3494227690,3556322198.8,69.31027775978272,56.21844552016178,NaN,NaN,-0.20303802412213762,-2.8920314337263546
2006-03-22T09:30:00-05:00,40.88,41.28,40.86,41.21001,112323504,93145817.6,49.586195287475135,48.547468072107044,NaN,NaN,-28.745854436587678,43.6467858356727,0.03700723796399016,-0.0038639181126995936,-0.04087115607668975,3606551194,3558890234,69.49108882345496,56.58504554217966,NaN,NaN,-0.2751996717369929,-2.5181983248707316
2006-03-23T09:30:00-05:00,41.09,41.22,40.82001,41.09,75220688,93580324,48.006519615974206,48.339626949570516,NaN,NaN,-42.22989432655637,19.02898997523686,0.020661612412981853,-0.015044140560462438,-0.03570575297344429,3531330506,3566691318.8,70.06799679007761,57.029399005272055,NaN,NaN,-0.7776378299123632,-2.2695468255909645
2006-03-24T09:30:00-05:00,41.23,41.50011,41.02,41.3,81809184,94816387.2,50.95109707699369,48.62006606535378,NaN,NaN,9.48258799993529,10.363953928351913,0.023060607056557582,-0.006879994152747315,-0.029940601209304897,3613139690,3575208554,70.71901602368693,57.971799860603475,NaN,NaN,-0.3910507756556274,-2.0011902470287737
2006-03-27T09:30:00-05:00,41.28,41.50999,41.24001,41.31,54405616,94288656,51.09313662868733,49.08536199998578,NaN,NaN,32.4388304708893,1.7899028895342781,0.024266514679391477,0.00039254213993444864,-0.023873972539457028,3667545306,3582558877.2,71.29917222379844,59.308684730586364,NaN,NaN,-0.03349716895171571,-1.7200912358749083
2006-03-28T09:30:00-05:00,41.37,41.67,40.99001,41.14,100534368,93433427.2,48.52072265415924,49.34852968270399,NaN,NaN,11.670580362214878,-3.4767499860209186,0.013118915018561973,-0.007475328766254563,-0.020594243784816536,3567010938,3597115526.8,72.4628119434293,61.00362076712485,NaN,NaN,-0.40910303128959113,-1.5328072066484344
2006-03-29T09:30:00-05:00,41.2,42.10001,41.17,41.92,130733504,95921133.6,58.77621517910996,50.602095633598275,NaN,NaN,116.52660206146751,25.57774131359012,0.055409631880066874,0.048667796065267055,-0.0067418358147998195,3697744442,3615354176.4,73.89113997471274,63.340629880495875,NaN,NaN,2.3849126501175775,-0.973132941396147
2006-03-30T09:30:00-05:00,42,42.30009,41.78999,42.05,115943440,98224399.2,60.19935516777323,51.91612026332535,NaN,NaN,174.46077606889588,68.91587539268058,0.08736972976481026,0.102470326391213,0.015100596626402746,3813687882,3671825651.6,77.74092605345021,66.06768947850784,NaN,NaN,5.111542842612742,-0.10389354368059145
2006-03-31T09:30:00-05:00,42.14,42.19,41.84,41.92999,71090432,96174836.8,58.20181707528893,52.959740383990365,NaN,NaN,149.1693214410544,96.85322208090439,0.0950252072513259,0.13388210569056014,0.038856898439234226,3742597450,3697717203.6,79.25152281616229,68.69260690484671,NaN,NaN,6.796820719289223,0.8819227796008106
2006-04-03T09:30:00-04:00,42.14999,42.37,41.89999,41.98,80733312,95231820.8,58.81510622745922,53.4030529501075,NaN,NaN,143.33207406941673,119.03187080060988,0.09767940428437845,0.1609561537947073,0.06327674951032884,3823330762,3728874294.8,80.92879341081121,70.82868447148554,NaN,NaN,8.359127490988044,1.950094881227558
2006-04-04T09:30:00-04:00,42.035,42.31,41.92999,42.21001,90039808,94908904.8,61.60541584302707,53.77380949003613,NaN,NaN,137.95488845225194,144.2887324186173,0.10832430659209585,0.19868213275044866,0.0903578261583528,3913370570,3798146221.2,84.02149544167725,72.73093419208406,NaN,NaN,10.513307274086348,3.1734109373502424
2006-04-05T09:30:00-04:00,42.3,42.67,42.21001,42.61,91662256,94291348.8,65.92849212612151,54.77413574423524,NaN,NaN,171.30402258900872,155.24421652412553,0.13402043828068638,0.2578833740092108,0.12386293572852441,4005032826,3859603898,86.16507785690985,74.4043126109799,NaN,NaN,13.755031497610052,4.685071017387358
2006-04-06T09:30:00-04:00,42.58,42.94,42.4404,42.73,91713008,93444920.8,67.12444168615721,55.79389060588311,NaN,NaN,176.67685250857593,155.68743181206156,0.1496295878897857,0.31089992059075655,0.16127033270097085,4096745834,3916215488.4,87.79000350598663,75.92147811360691,NaN,NaN,16.805988638079317,6.416630677486209
2006-04-07T09:30:00-04:00,42.895,43.05,42.3,42.32001,116609376,93051076.8,59.44681796737666,56.18030730566683,NaN,NaN,133.58313089705726,152.5701937032621,0.12393439538889334,0.31618832693708754,0.1922539315481942,3980136458,3963723290,88.9616709734058,77.29292811409614,NaN,NaN,17.221366728115242,7.9601643990046425
2006-04-10T09:30:00-04:00,42.39999,42.5,42.09,42.25999,58988048,92541926.4,58.393836906367255,56.9035121029979,NaN,NaN,82.57505364884614,140.418789619148,0.09574922215155648,0.3119404592376398,0.21619123708608332,3921148410,3983286819.6,89.41223855483591,78.72878245659993,NaN,NaN,17.252529269217703,9.287645094749365
2006-04-11T09:30:00-04:00,42.39999,42.42999,41.71001,41.92,91488624,91205592,52.69938026071002,57.12588245822896,NaN,NaN,37.136586052616316,120.25512913922088,0.0493956273980552,0.2779357713336523,0.22854014393559713,3829659786,3966544662.8,86.17059992748845,79.92017610688804,NaN,NaN,15.558081975946964,10.183421792063308
2006-04-12T09:30:00-04:00,41.95,42.08,41.8,41.92999,58884688,89930020,52.844892006154346,57.471480486098976,NaN,NaN,21.614935682306772,90.3173117578805,0.01630667340805822,0.2489234856956699,0.2326168122876117,3888544474,3943246992.4,81.73006539062663,80.75318100692725,NaN,NaN,14.227897759660976,10.76120407314869
2006-04-13T09:30:00-04:00,41.89999,42.33,41.78999,42.10001,63482400,88034843.2,55.36174382232191,57.786526682193845,NaN,NaN,38.88304709589213,62.75855067534375,0.003441891448436152,0.23691917659815687,0.23347728514972071,3952026874,3914303200.4,76.45861438998881,81.16315231880597,NaN,NaN,13.79161335084319,11.194119684247905
2006-04-17T09:30:00-04:00,42.03999,42.21001,41.39,41.66,104085120,89327677.6,48.19275540696234,57.57935659492778,NaN,NaN,-14.272054323064127,33.18751363131946,-0.035010912387027776,0.189713644665936,0.22472455705296376,3847941754,3887864259.6,71.89686336069073,81.20584454286971,NaN,NaN,11.206579686442316,11.195899684561393
2006-04-18T09:30:00-04:00,41.785,42.56,41.77,42.46001,124333376,92532337.6,58.67161659472385,58.30442044782525,NaN,NaN,63.18291712229717,29.309086326009673,-0.008271056656114578,0.21438573623282053,0.2226567928889351,3972275130,3898089603.6,72.57828868299698,81.21409288141025,NaN,NaN,12.298421366962451,11.353402782047258
2006-04-19T09:30:00-04:00,42.53999,42.64999,42.3,42.64999,79128320,89660453.6,60.70428234032265,58.44213953076901,NaN,NaN,100.02314993634243,41.88639910275491,0.019016709628867923,0.24642767992502002,0.2274109702961521,4051403450,3942438336.4,75.36795300860292,81.31957952668813,NaN,NaN,13.84912776685055,11.709934922733442
2006-04-20T09:30:00-04:00,42.62,42.82001,42.38,42.5,81413008,88114928.8,58.26768147928076,58.30416283873384,NaN,NaN,100.89150306238788,57.74171257877113,0.023477991738772352,0.25675845996961755,0.2332804682308452,3969990442,3958727530,76.32080908246165,81.21814260018894,NaN,NaN,14.320844265176824,12.082921971653926
2006-04-21T09:30:00-04:00,42.67,42.86,41.82001,42,130187008,90863244.8,50.92893269198607,57.78467109706934,NaN,NaN,33.4369110495927,56.65248536951125,-0.00899212359499893,0.22204031373709654,0.23103243733209547,3839803434,3936282842,72.17768065393369,80.71286816002976,NaN,NaN,12.279175274459044,12.110958157768943
2006-04-24T09:30:00-04:00,41.96001,42.07001,41.72,41.96001,78556496,90700610.4,50.38237127417865,57.18233288612073,NaN,NaN,-41.47493330988158,51.21190957214776,-0.03353072786492153,0.18911902750094356,0.2226497553658651,3761246938,3918943878.8,69.05880043556931,79.86501151894105,NaN,NaN,10.504401966156243,11.8814501303957
2006-04-25T09:30:00-04:00,42.08,42.10001,41.64999,41.87,77660816,91863370.4,49.10497991209014,56.28944460533952,NaN,NaN,-62.42268698046032,26.090788751596257,-0.05492739670776853,0.15399050948115445,0.20891790618892297,3683586122,3861206077.2,59.79327750355072,78.13442452336058,NaN,NaN,8.677320975153831,11.423717393932577
2006-04-26T09:30:00-04:00,41.87,42.06,41.7,41.86,82566688,90964986.4,48.95647206348959,55.07715745800867,NaN,NaN,-77.84877135962122,-9.483595507596508,-0.06800187062744983,0.12391556790461067,0.1919174385320605,3601019434,3771129274,48.79419485391776,75.46507573743257,NaN,NaN,7.156466528550396,10.814110127449409
2006-04-27T09:30:00-04:00,41.67,42.49001,41.5,42.25999,174122000,93134411.2,54.83968597243735,54.19967490702867,NaN,NaN,-25.967977827009026,-34.85549168547588,-0.048855174462455825,0.13084847045399073,0.17970364491644655,3775141434,3732159472.4,44.94242343274166,72.40453430362936,NaN,NaN,7.527729444153739,10.344627172692885
2006-04-28T09:30:00-04:00,42,42.22,41.78,41.85001,88883248,91781401.6,48.65017188955135,53.42848590146973,NaN,NaN,-62.80709174758389,-54.1042922449112,-0.06209561690497706,0.10208412378522524,0.1641797406902023,3686258186,3701450422.8,42.12072222483079,69.05875225015971,NaN,NaN,5.928408639071639,9.713738810746992
2006-05-01T09:30:00-04:00,41.92999,42.3,41.31,41.44,92933680,92873564,43.37737194609822,52.35588126145051,NaN,NaN,-128.9588317321133,-71.60107192935754,-0.09480199057025013,0.04567725247738963,0.14047924304763976,3593324506,3667865936.4,39.22054100777938,65.47363099679855,NaN,NaN,2.8259506396350336,8.729769072016712
2006-05-02T09:30:00-04:00,41.61,41.73,41.39999,41.55,85173568,93095576.8,45.09662143758494,51.81282705979872,NaN,NaN,-141.99147598253086,-87.51482972977165,-0.10459281438113802,0.009738225071217244,0.11433103945235526,3678498074,3666848326.8,39.13261944206449,62.11377524783969,NaN,NaN,0.8477340850969308,7.603764073885315
2006-05-03T09:30:00-04:00,41.58,41.64,41.28,41.49001,74982432,92342708,44.30651190239831,51.20294276667328,NaN,NaN,-142.76113583015643,-100.4973026238787,-0.1101173408199679,-0.023315636572604603,0.08680170424736329,3603515642,3667347568.4,39.20462510093799,59.076243798576215,NaN,NaN,-0.9897347421043758,6.376121385886788
2006-05-04T09:30:00-04:00,41.53,41.99001,41.53,41.83,88713504,92195270.4,49.68670677364018,50.79758297748174,NaN,NaN,-65.02158211650396,-108.30802348177767,-0.08690146104517518,-0.021825122059105695,0.06507633898606949,3692229146,3650765110.8,37.61299288576371,56.30155654827441,NaN,NaN,-0.9810012376701858,5.325103868235791
2006-05-05T09:30:00-04:00,42.11,42.2101,41.94,42.16,80394368,91629338.4,54.301266112945804,51.23390517076627,NaN,NaN,21.096990680933683,-91.52720699607417,-0.04732813868354999,0.005916165631631998,0.05324430431518199,3772623514,3668038176.4,40.33045412649337,54.04681303154604,NaN,NaN,0.4599351708609656,4.630079768610816
2006-05-08T09:30:00-04:00,42.08,42.28,42.07001,42.2,45093328,88053536,54.84191306677989,50.96035491877027,NaN,NaN,51.87360045418436,-55.360720558814634,-0.01797603926039225,0.030774255239691684,0.04875029450008393,3817716842,3712916643.6,46.81276555770962,52.20641852259694,NaN,NaN,1.7816398349570846,4.223159778088855
2006-05-09T09:30:00-04:00,42.10001,42.1801,41.97,42.03999,48566784,87532472.8,52.18238059153494,50.35164765099972,NaN,NaN,20.857126457295855,-22.7910000708493,-0.009292289821407694,0.03713493222332431,0.04642722204473201,3769150058,3731047040.4,49.2131584988438,50.33821891475701,NaN,NaN,2.1333495372413043,3.924615457967776
2006-05-10T09:30:00-04:00,41.92999,41.98,41.55,41.67,92440496,87580066.4,46.55985009683724,49.51537398082519,NaN,NaN,-73.10325342063165,-8.859423588944342,-0.02739753227511811,0.012180306700834365,0.039577838975952476,3676709562,3745685824.4,51.130906726080354,48.538940175015476,NaN,NaN,0.7517195757426217,3.4713446176498968
2006-05-11T09:30:00-04:00,41.63,41.64999,40.63,40.74001,141027568,91687210.4,36.04644596434394,48.452339214565036,NaN,NaN,-229.49996023940975,-41.7550992135255,-0.0970199363511208,-0.08169708146294852,0.015322854888172276,3535681994,3714376394,47.0396276186455,46.74336495820918,NaN,NaN,-4.332636993468727,2.3564901017758078
2006-05-12T09:30:00-04:00,40.57001,40.75999,39.96001,40.19,153954432,96210812,31.5141854767775,47.10461165760781,NaN,NaN,-295.73755826417835,-105.12200900254791,-0.17081201385397848,-0.19819216242930082,-0.027380148575322345,3381727562,3636197203.6,38.71041219106125,44.57562294074431,NaN,NaN,-10.303981781906359,0.5478512612497841
2006-05-15T09:30:00-04:00,40.03,40.34,39.78999,40.16,127902496,97401680.8,31.283139666704898,45.83162306865172,NaN,NaN,-247.3837955472096,-164.9734882028267,-0.20977412074934376,-0.28959779951200204,-0.07982367876265828,3253825066,3523418848.4,30.35919554329162,42.47318851501152,NaN,NaN,-14.913291936670259,-1.660883481310222
2006-05-16T09:30:00-04:00,40.16,40.25999,39.77,39.86,132405504,97805287.2,28.993938751081288,44.40572783205113,NaN,NaN,-204.58018164426394,-210.06094982313866,-0.24161567038795476,-0.3818432667476017,-0.14022759635964696,3121419562,3393872749.2,23.96387557406065,40.699594280736015,NaN,NaN,-19.4825744045669,-4.206839327489748
2006-05-17T09:30:00-04:00,39.67999,39.81,39.23,39.32001,207927808,104245261.6,25.392121232013224,42.302330350592264,NaN,NaN,-203.88798650290687,-236.21789643959374,-0.2820899161913903,-0.4928399915988848,-0.21075007540749452,2913491754,3241229187.6,18.909285214517695,38.84008440800574,NaN,NaN,-24.688506733187733,-7.132791814018031
2006-05-18T09:30:00-04:00,39.49001,39.66,39,39.05,139722880,107160755.2,23.800020180252588,40.52731951421377,NaN,NaN,-176.29677345068603,-225.57725908184898,-0.30798080900486435,-0.595726086663575,-0.2877452776587106,2773768874,3088846563.6,15.413978455872197,36.932459853080125,NaN,NaN,-29.445489129383624,-10.320320001927401
2006-05-19T09:30:00-04:00,39.17999,39.47,38.75,39.35001,194311808,110366995.2,29.118016971028197,39.50879415885163,NaN,NaN,-147.39196449652658,-195.9081403283186,-0.28629460001559776,-0.6456135276782078,-0.35931892766261003,2968080682,3006117187.6,13.910610281821917,35.12460765836888,NaN,NaN,-31.61350315574974,-13.362203309616307
2006-05-22T09:30:00-04:00,39.02,39.24001,38.62,38.97,169606624,114919501.6,26.586938960614646,38.186673981925175,NaN,NaN,-138.56722191711134,-174.14482560229897,-0.2786695766923883,-0.7076558985280954,-0.4289863218357071,2798474058,2915046986,12.468894098152177,33.22005584808943,NaN,NaN,-34.26434687095674,-16.348223818379225
2006-05-23T09:30:00-04:00,39.25999,39.3801,38.57001,38.59,142649440,118168932.8,24.311195485839193,36.7584370950281,NaN,NaN,-123.26215720693274,-157.88122071483275,-0.27962176594560434,-0.7785135292677126,-0.4988917633221082,2655824618,2821927997.2,11.191648833663663,31.21912897185555,NaN,NaN,-37.23380216844378,-19.331877868388446
2006-05-24T09:30:00-04:00,38.53,39.03999,38.23,38.85001,234998192,125790508,28.80190029366169,35.26666520360106,NaN,NaN,-114.39100907400895,-139.98182522905316,-0.2444188129532321,-0.8044152795136483,-0.5599964665604162,2890822810,2817394208.4,11.131859762208421,29.32761946303017,NaN,NaN,-38.212201727338964,-22.02906699109566
2006-05-25T09:30:00-04:00,39.08,39.38,38.82001,39.36,123529872,123260901.6,36.73110133844509,34.01165343399386,NaN,NaN,-78.30019699254726,-120.3825099374254,-0.17188969469210968,-0.7748585849255534,-0.6029688902334437,3014352682,2865510970,16.245783007014623,27.60728581163883,NaN,NaN,-36.40798640200497,-24.083198335511277
2006-05-26T09:30:00-04:00,39.45,39.58,39.23,39.49001,91329312,123383204.8,38.60813321412257,32.85209773023262,NaN,NaN,-58.47419209113748,-102.59895545634757,-0.1036250199099793,-0.7325001651209178,-0.6288751452109385,3105681994,2893031232.4,19.11279051478148,25.628716165715392,NaN,NaN,-34.37021752882241,-25.552772505984297
2006-05-30T09:30:00-04:00,39.31,39.33,38.61,38.64,105610192,124017030.4,31.936900397632087,31.405992002096706,NaN,NaN,-84.17260659791278,-91.72003239250783,-0.10391816725160852,-0.758772854275449,-0.6548546870238405,3000071802,2933350781.2,23.257606587788956,23.77474817206862,NaN,NaN,-34.77118903409555,-26.869689152857333
2006-05-31T09:30:00-04:00,38.72,39.06,38.53999,38.82001,137104496,126613576.8,34.517438259413225,30.545819727994992,NaN,NaN,-80.35380457214582,-83.13836186555045,-0.08119634143751164,-0.75635011382073,-0.6751537723832184,3137176298,3029621117.2,32.19205054876562,22.421972730831857,NaN,NaN,-34.23353306682859,-27.92166685485323
2006-06-01T09:30:00-04:00,38.91,39.74001,38.84,39.74001,119438752,128836392.8,45.822939649327616,31.244140705493827,NaN,NaN,-38.929497568175115,-68.04605956438368,0.0021692039561512777,-0.6724422674380293,-0.6746114713941805,3256615050,3102779565.2,38.0906029670122,21.782756684286618,NaN,NaN,-29.668350637923368,-28.171193109577533
2006-06-02T09:30:00-04:00,39.97,40,39.31,39.642,128865504,130843992.8,44.932927114809175,32.20262225106752,NaN,NaN,-21.132237480532396,-56.6124676619807,0.05420293427602685,-0.606857803549147,-0.6610607378251738,3127749546,3125458938,39.83779177858971,21.863283797681508,NaN,NaN,-26.4544894508338,-27.925949729757
2006-06-05T09:30:00-04:00,39.55,39.56,38.78,38.78,103300560,131989302.4,37.95123559035232,32.678914817042326,NaN,NaN,-58.792331960943166,-56.67609563594184,0.03499119934934325,-0.6173217386384948,-0.6523129379878381,3024448986,3109212336.4,38.98892277388806,22.479692885581247,NaN,NaN,-26.06521147434176,-27.660129978983395
2006-06-06T09:30:00-04:00,38.85001,38.95,38.35001,38.75,127304192,136099845.6,37.73150086361769,33.30302639650922,NaN,NaN,-85.57694110016502,-56.956962536392304,0.025147842225875072,-0.6208781352054942,-0.6460259774313692,2897144794,3088626934.8,37.887330399886885,23.474225373140264,NaN,NaN,-25.840676594678865,-27.40020806693989
2006-06-07T09:30:00-04:00,38.8,39.17,38.45,38.46001,130867568,140214884.8,35.58660698064142,34.031203949982654,NaN,NaN,-86.00081665645529,-58.086364953254204,0.005043136424340622,-0.6397220569009434,-0.644765193325284,2766277226,3014447120.4,34.14363487915931,24.562393206328952,NaN,NaN,-26.342815196966352,-27.249151942657956
2006-06-08T09:30:00-04:00,38.27,38.56,37.49001,38.39999,280562176,149620968.8,35.14134282499835,34.84129842460735,NaN,NaN,-149.1520799420753,-80.13088142803423,-0.00577460821356246,-0.6519834535922371,-0.6462088453786746,2485715050,2860267120.4,27.959687214042972,25.45851526048401,NaN,NaN,-26.876808114485666,-27.19595996720477
2006-06-09T09:30:00-04:00,38.53999,38.74001,38.11,38.14999,144146192,149776900,33.273833849065824,35.13814248732432,NaN,NaN,-122.60638849625073,-100.42571163117789,-0.022315299734923633,-0.6741029700473291,-0.6517876703124055,2341568858,2703030982.8,23.320847290583984,26.13067504682416,NaN,NaN,-27.881011995624355,-27.293824542693283
2006-06-12T09:30:00-04:00,38.2,38.25999,37.39,37.39999,145634496,149360903.2,28.398104057742046,35.26751142283343,NaN,NaN,-198.35954791593701,-128.33915482217668,-0.07343390393599791,-0.7435800502324028,-0.6701461462964049,2195934362,2537328058,19.62546392343596,26.641858605773,NaN,NaN,-30.369576006737205,-27.73321760898527
2006-06-13T09:30:00-04:00,37.52499,37.8,37.16,37.25,207140256,153322791.2,27.529308069838237,35.49737660740478,NaN,NaN,-210.85260894387685,-153.39428839091903,-0.10508694502906213,-0.8015048275827326,-0.6964178825536704,1988794106,2355657920.4,16.5323985728339,27.023340729999443,NaN,NaN,-32.64742045055483,-28.435246586352353
2006-06-14T09:30:00-04:00,37.36,37.71001,37.2,37.63,201888256,156796928.8,33.11246252587041,35.80527390970541,NaN,NaN,-168.77781940071975,-169.94968893977193,-0.08881780550703766,-0.8074401394374675,-0.7186223339304298,2190682362,2240538947.6,14.926977075788386,27.2944205381123,NaN,NaN,-32.86763054334716,-29.06844429449447
2006-06-15T09:30:00-04:00,37.84,38.78999,37.8,38.64999,200727632,156436920,45.2950803408182,36.41698669558921,NaN,NaN,-41.16220782889033,-148.35171451713495,-0.0023197263481933295,-0.7215219918656715,-0.7192022655174781,2391409994,2221677936.4,14.67552819963882,27.182259480442603,NaN,NaN,-28.88631872790709,-29.04242635641056
2006-06-16T09:30:00-04:00,38.55,38.67999,38.2,38.34,120017376,155451644.8,42.74686494486504,36.71261039064223,NaN,NaN,-36.60793596262683,-131.15202401041017,0.03879118997490194,-0.6707132780488507,-0.7095044680237527,2271392618,2207642688.4,14.480054722888624,26.851349781021685,NaN,NaN,-26.516660740265625,-28.68160269696128
2006-06-19T09:30:00-04:00,38.5,38.53999,37.91,38.03,129464816,152209295.2,40.304888247058,37.31032380845837,NaN,NaN,-62.54985513397272,-103.9900854540173,0.0492101586165522,-0.6479917697530624,-0.6972019283696146,2141927802,2196841376.4,14.32195269708265,26.21308878882838,NaN,NaN,-25.369750635737148,-28.208480973929262
2006-06-20T09:30:00-04:00,38.09,38.48,37.94,38.08,102888560,148873392,40.89140560849007,37.765607190535285,NaN,NaN,-55.18282266934079,-72.8561281991101,0.06270802856926061,-0.6188168926580389,-0.6815249212272995,2244816362,2248045827.6,18.845663678311055,25.259775440938768,NaN,NaN,-24.283286801121424,-27.647738949242427
2006-06-21T09:30:00-04:00,38.14,38.99001,38.13,38.67999,129566320,148219236,47.55086702510811,37.88903057451961,NaN,NaN,4.582426214390669,-38.184079076088025,0.11238426620985753,-0.5410445884649775,-0.653428854674835,2374382682,2284785891.6,22.026836905089326,24.112363579372847,NaN,NaN,-21.212301053094755,-26.72839067836419
2006-06-22T09:30:00-04:00,38.60001,38.67999,37.99001,38.19,143831504,143660901.6,43.26397286948957,37.76981955699678,NaN,NaN,-34.94409724225317,-36.9404569587606,0.11231616967888791,-0.5130336425762252,-0.6253498122551131,2230551178,2252614128.4,21.241631819934213,22.784066439468884,NaN,NaN,-19.954173662343347,-25.760645390361212
2006-06-23T09:30:00-04:00,38.16,38.53,37.92999,38.14999,88050192,141886917.6,42.923684323659344,38.124994466518714,NaN,NaN,-41.214682151812504,-37.861806196597726,0.1095335390245028,-0.4884328884744846,-0.5979664274989874,2142500986,2226835802,20.60772481341496,21.471123728006518,NaN,NaN,-19.05825006231731,-24.803160343497797
2006-06-26T09:30:00-04:00,38.17,38.39,38.07001,38.25,65157616,140578332.8,44.10709951489493,38.580394370181374,NaN,NaN,-31.118589535983237,-31.575553076999824,0.11388146126376353,-0.45561460091928296,-0.5694960621830465,2207658602,2239981962,21.887944844645062,20.328310474060675,NaN,NaN,-17.983500227461775,-23.82892318406408
2006-06-27T09:30:00-04:00,38.28,38.33,37.49001,37.53,128227504,141709198.4,37.99874524443484,38.75268996045234,NaN,NaN,-93.14753811019796,-39.16849616517124,0.06988006925342716,-0.4821459756162625,-0.5520260448696896,2079431098,2206904909.2,20.971617039701258,19.387452056956526,NaN,NaN,-18.886890941973718,-23.122918578051173
2006-06-28T09:30:00-04:00,37.63499,37.84,37.38,37.81,91578368,139432892,41.39766459468336,39.1995700868584,NaN,NaN,-100.123694105381,-60.10972022912557,0.06153928243589191,-0.4751019418248248,-0.5366412242607167,2171009466,2166230266,19.870012664727014,18.80961816057681,NaN,NaN,-18.607121730261746,-22.477804742652683
2006-06-29T09:30:00-04:00,37.96001,38.96001,37.89999,38.96001,182431056,142582507.2,52.83422916816312,40.59674118107964,NaN,NaN,55.51210105799569,-42.018480569075805,0.13136885514516383,-0.37243015532926194,-0.5037990104744258,2353440522,2190808134.8,22.518494137356754,18.752307221060583,NaN,NaN,-14.407531582548753,-21.32490857692355
2006-06-30T09:30:00-04:00,39.12,39.14,38.67999,38.77,82721248,140275294.4,51.06113953749428,42.21552942963337,NaN,NaN,118.5925250555544,-10.057039127602419,0.16071715114199642,-0.30290257154693023,-0.46361972268892665,2270719274,2216451792.4,25.2929873500388,19.15713032296079,NaN,NaN,-11.66559857142086,-19.945007147566024
2006-07-03T09:30:00-04:00,38.88,39,38.81,39,21598544,136190193.6,53.11234827731906,44.04288944445343,NaN,NaN,135.67026825531633,23.300732430657494,0.1895918310590799,-0.2266299338650768,-0.4162217649241567,2292317818,2233383635.6,27.147954887693885,19.915384345450786,NaN,NaN,-8.795102212590011,-18.352163585426595
2006-07-05T09:30:00-04:00,38.64,38.67999,38.09,38.14999,93732128,134511590.4,45.519055729691814,44.92907467329781,NaN,NaN,17.534596119877076,45.437159276672496,0.14730016592525075,-0.23209655751759328,-0.37939672344284403,2198585690,2257214554,29.79032196635238,20.97705183763393,NaN,NaN,-8.761656833670035,-16.982091192318514
2006-07-06T09:30:00-04:00,38.25999,38.48,38.00999,38.11,70634560,131499940,45.19171091570526,44.92169114293261,NaN,NaN,0.7682865036698203,65.61555539848266,0.11397767057639985,-0.2369246352223442,-0.35090230579874404,2127951130,2248602886.8,29.37568262002131,22.027062867661247,NaN,NaN,-8.838335691041827,-15.818697549278987
2006-07-07T09:30:00-04:00,37.89,38.17,37.57001,37.69,108071632,122875412.8,41.79239121672634,44.85351444806555,NaN,NaN,-76.04374657591873,39.304385871699786,0.06351256876215805,-0.2715115948460465,-0.33502416360820453,2019879498,2181890682,26.31952278284747,22.87273915765831,NaN,NaN,-9.971221926287281,-14.9833438888516
2006-07-10T09:30:00-04:00,37.78999,37.92999,37.17,37.36,105125936,120924400,39.29157380272227,44.781134844898716,NaN,NaN,-120.3466416637341,-8.483447472157916,0.010547109101726071,-0.3218402772310469,-0.332387386332773,1914753562,2110697539.6,23.5086953889046,23.52893506421702,NaN,NaN,-11.694601826514186,-14.51352359423197
2006-07-11T09:30:00-04:00,37.28,37.74001,37.08,37.64,136121568,120448753.6,42.43890595773885,44.89167058413078,NaN,NaN,-114.4658242921665,-58.51066598165448,-0.0023042535663674313,-0.3352677032907323,-0.33296344972436487,2050875130,2062409002,21.807505723028527,23.740495210268268,NaN,NaN,-12.18250437919502,-14.18052084922669
2006-07-12T09:30:00-04:00,37.56,37.64,36.84,36.92999,154458880,117814684.8,37.17576887887962,44.15059214511445,NaN,NaN,-166.86684094874624,-95.39095339537914,-0.05251406120808244,-0.39860602623446795,-0.3460919650263855,1896416250,2001975114,19.869592471235563,23.586406322135854,NaN,NaN,-14.302922385941638,-14.19800678304311
2006-07-13T09:30:00-04:00,36.66,37.03999,36.31,36.31,177745440,116607544,33.29302566016223,43.438381630162496,NaN,NaN,-222.68096337406854,-140.08080337092684,-0.11764278105669906,-0.49314544134725935,-0.3755026602905603,1718670810,1920119050,17.589572608218248,23.325544949870427,NaN,NaN,-17.411254607412424,-14.657042186524441
2006-07-14T09:30:00-04:00,36.31,36.38,35.78999,35.94,172448496,115193587.2,31.198823287169745,42.60089155612753,NaN,NaN,-227.14352763741798,-170.3007595832267,-0.1724863214621768,-0.5911105621182813,-0.4186242406561045,1546222314,1825387613.2,15.38876806207898,22.952762324775,NaN,NaN,-20.655063509508178,-15.513902375522118
2006-07-17T09:30:00-04:00,35.955,36.25,35.87,36.03,134358064,115910621.6,32.31411623074709,41.75853560725982,NaN,NaN,-184.0817192248996,-183.04777509545977,-0.18825906506388873,-0.6539480719859654,-0.46568900692207665,1680580378,1778552976.4,14.42764426846567,22.41988371219076,NaN,NaN,-22.907877665407025,-16.57018455979139
2006-07-18T09:30:00-04:00,36.22,36.33,35.53999,36.14999,207274688,119801115.2,33.853639540266386,41.46245662839065,NaN,NaN,-155.7678280248698,-191.30817584200042,-0.17637318464522866,-0.6861554877286125,-0.5097823030833838,1887855066,1745948963.6,13.782308093719038,21.906361644620603,NaN,NaN,-24.303306441910618,-17.674916257236994
2006-07-19T09:30:00-04:00,36.10001,36.83,36.09,36.62,193014688,124307421.6,39.64460518405305,41.33723809905991,NaN,NaN,-95.69535385114739,-177.07387842248067,-0.12503504316533154,-0.6660761070400483,-0.5410410638747167,2080869754,1782839664.4,18.238559195968975,21.78982925399503,NaN,NaN,-23.802901767789756,-18.55034275874453
2006-07-20T09:30:00-04:00,36.745,36.8,36.03999,36.08,152346624,125446436.8,35.76993668735008,40.11836006471612,NaN,NaN,-99.69848694352706,-152.47738313637237,-0.1158317174553064,-0.6858307106938497,-0.5699989932385433,1928523130,1824810128.4,23.107861629317725,21.83192693199224,NaN,NaN,-24.546483628906778,-19.406934311624852
2006-07-21T09:30:00-04:00,35.88,35.96001,35.62,35.7,119379872,124223855.2,33.30326267906615,38.84994028911411,NaN,NaN,-123.79972324109876,-131.80862225710854,-0.12304530139904746,-0.7238056199873526,-0.6007603185883051,1809143258,1877394317.2,28.826987479703078,22.084355512682546,NaN,NaN,-25.931498827411957,-20.339014956737294
2006-07-24T09:30:00-04:00,35.85001,36.4301,35.8,36.41,130301504,126336420.8,41.43019757457532,38.01550095320385,NaN,NaN,-79.41127781859723,-110.87453397584804,-0.07032883958251701,-0.6886713680664514,-0.6183425284839343,1939444762,1929167194,34.02967942070214,22.57590726504028,NaN,NaN,-24.556673290722085,-20.94153757587798
2006-07-25T09:30:00-04:00,36.47,36.74001,36.24001,36.62,108869568,128522018.4,43.61848595606774,37.87974596937356,NaN,NaN,-50.239773781216044,-89.76892312711728,-0.014561408416979171,-0.6365442890051582,-0.6219828805881791,2048314330,1961259046.8,37.09903530295189,23.09795821765453,NaN,NaN,-22.75957983950522,-21.2012578992533
2006-07-26T09:30:00-04:00,36.5,36.87,36.23,36.59,107193120,127470299.2,43.369199407896964,37.74956657595868,NaN,NaN,-43.6184515292617,-79.35354266274013,0.024911839415416415,-0.5908430813189085,-0.6157549207343249,1941121210,1933309338,35.547796989977954,23.538823529794293,NaN,NaN,-21.390611077386126,-21.228308353272276
2006-07-27T09:30:00-04:00,36.73,37.03999,36.25,36.35001,99707248,127876743.2,41.334065657053905,37.71682903598207,NaN,NaN,-40.81141263721552,-67.57612780147782,0.03864510558132661,-0.5674485387576667,-0.6060936443389933,1841413962,1915887504.4,34.57726946334367,24.128662578401165,NaN,NaN,-20.814448034007007,-21.169185450520093
2006-07-28T09:30:00-04:00,36.55499,37.14,36.5,37.11,93570320,123433706.4,49.42738019215574,38.4408152066559,NaN,NaN,-7.7570919806506575,-44.3676015493882,0.09925343685109378,-0.482026848275126,-0.5812802851262198,1934984282,1941055709.2,37.242906708099056,25.10967767262934,NaN,NaN,-17.7771598697741,-20.68461036755638
2006-07-31T09:30:00-04:00,37.08,37.32001,36.89,37.10001,78096496,123202468.8,49.33104099982548,38.93311056680494,NaN,NaN,16.949700757474012,-25.095405834173942,0.13670041848554937,-0.410404762019283,-0.5471051805048324,1856887786,1924544314,36.20081265398325,26.13777102484039,NaN,NaN,-15.375750325613954,-19.926201790136034
2006-08-01T09:30:00-04:00,36.78999,36.8,36.25999,36.48,98573504,127051216.8,43.64525704183698,39.395216864159046,NaN,NaN,-31.936997965014733,-21.434850670933677,0.11842566303558022,-0.39907310171035704,-0.5174987647459373,1758314282,1866544304.4,32.73572453944675,27.056780458284045,NaN,NaN,-14.943190238995035,-19.214342997115892
2006-08-02T09:30:00-04:00,36.61,37.13,36.61,36.89,87399008,126734560.8,47.92000809161506,40.44000132354853,NaN,NaN,18.821564226368086,-8.946847519807715,0.1316465110365469,-0.35294062595025366,-0.48458713698680056,1845713290,1847462720.4,31.661970180367163,28.061951713437537,NaN,NaN,-13.262370569061726,-18.364061221679584
2006-08-03T09:30:00-04:00,36.53999,37.34,36.48,37.12,99296000,128167632.8,50.20203425446087,41.797373535497904,NaN,NaN,46.60342486271105,8.536119980177551,0.15212790589551206,-0.2944272546174105,-0.44655516051292254,1945009290,1868181786,34.18626427117506,29.404630014087257,NaN,NaN,-11.182406982716005,-17.338110616113358
2006-08-04T09:30:00-04:00,37.425,37.63,36.62,36.95,123504688,128939285.6,48.510084314655664,42.954228398634235,NaN,NaN,72.48182481360168,24.58390333902802,0.15021260650559076,-0.25878940238093406,-0.4090020088865248,1821504602,1845485850,32.758791022180844,30.71399763935263,NaN,NaN,-9.947273853013174,-16.28227679281333
2006-08-07T09:30:00-04:00,36.92,36.94,36.53,36.71001,69670944,127166536,46.14565717013879,43.83222965791083,NaN,NaN,24.90924573683046,26.17581233489931,0.1295509330097221,-0.24706334262437224,-0.37661427563409433,1751833658,1824475024.4,31.44957643193598,31.975945377796695,NaN,NaN,-9.578501271846136,-15.324594575532304
2006-08-08T09:30:00-04:00,36.81,36.89999,36.25999,36.48,124510752,126585995.2,43.935380911869004,44.13871363846912,NaN,NaN,-0.18718635412827284,32.5257746570766,0.09856414197142638,-0.2534090981698114,-0.35197324014123776,1627322906,1798276749.2,29.847773176298716,32.80517494782025,NaN,NaN,-9.894121853711898,-14.548812758129388
2006-08-09T09:30:00-04:00,37.00999,37.31,36.42999,36.53,145388256,126132464,44.557065217960385,44.76636567636985,NaN,NaN,53.786663661794016,39.51879454416179,0.08037508250633618,-0.25150438700831756,-0.33187946951465375,1772711162,1783676323.6,28.962439448949496,33.223359077793944,NaN,NaN,-9.986770209488839,-13.897092394037882
2006-08-10T09:30:00-04:00,36.455,36.88,36.31,36.78999,102511936,122370788.8,47.79848626783086,45.80173878985305,NaN,NaN,29.294218854477627,36.0569533425151,0.08437877396505666,-0.22640600205833294,-0.3107847760233896,1875223098,1769719085.2,28.104245077254532,33.171734620476194,NaN,NaN,-9.182082898591585,-13.223519608974126
2006-08-11T09:30:00-04:00,36.64999,36.69,36.37,36.53,86930496,118094888.8,44.967285960727544,46.054387960292495,NaN,NaN,-7.24259640099995,20.112069099594777,0.06870634650989027,-0.22490184288602677,-0.29360818939591704,1788292602,1763076685.2,27.68382177467859,32.718459074331655,NaN,NaN,-9.261532504457627,-12.657521451186055
2006-08-14T09:30:00-04:00,36.86,37.27,36.7,36.77,109350752,116844523.2,48.02761671903101,46.36932587193273,NaN,NaN,80.37817620881592,31.20585519399187,0.07327448152455995,-0.20201508749021713,-0.2752895690147771,1897643354,1792238624.4,32.46073389006904,32.38715183055431,NaN,NaN,-8.487496818052682,-12.061803646452717
2006-08-15T09:30:00-04:00,37.22,37.75,37.09,37.7,133719808,113166779.2,57.8167430729289,47.40129327657786,NaN,NaN,201.98869497051652,71.64103145892082,0.13415672045339563,-0.10759366844803253,-0.24175038890142816,2031363162,1873046675.6,43.58196053715163,32.96102065535243,NaN,NaN,-4.64796110052551,-11.00268328274883
2006-08-16T09:30:00-04:00,37.99001,38.61,37.84,38.58,135470064,110289548,64.60945188125726,49.063820864020954,NaN,NaN,294.47169248012057,119.77803722258614,0.22364734766845662,0.03780879568414264,-0.18583855198431398,2166833226,1951871088.4,51.90181675997693,34.19848831939766,NaN,NaN,1.1991445052212641,-9.25956502732453
2006-08-17T09:30:00-04:00,38.47,38.98,38.44,38.73,129697872,109157110.4,65.62554152472258,50.22083238777573,NaN,NaN,274.34225839695637,168.7876451310819,0.2792812797384352,0.16326304768873,-0.11601823204970518,2296531098,2036132688.4,58.882228501307395,35.744154161769686,NaN,NaN,6.1528702782024745,-7.057788555106387
2006-08-18T09:30:00-04:00,38.64999,38.83,38.28,38.78999,97774816,108076857.6,66.04541214383286,51.41471604091912,NaN,NaN,205.9790997498123,211.43198436124436,0.3043973021052985,0.2644783955819179,-0.039918906523380565,2394305914,2157335350.8,66.42932046251944,37.90333329095085,NaN,NaN,10.218962955990046,-4.589681196378326
2006-08-21T09:30:00-04:00,38.47,38.56,38.25999,38.42,66671680,104895366.4,61.08930578476083,52.66071952255653,NaN,NaN,143.4158851338506,224.03952614625126,0.28093456439261044,0.3112492989673825,0.03031473457477206,2327634234,2243333526.8,70.55856673313893,40.604964876214574,NaN,NaN,12.178403011423134,-2.1942405952638318
2006-08-22T09:30:00-04:00,38.36501,38.81,38.2,38.42999,102133248,104558550.4,61.174024726504946,53.60743499647724,NaN,NaN,124.12396706004442,208.46658056415686,0.25186268566823833,0.34514309166006996,0.09328040599183164,2429767482,2323014390.8,73.77698678007621,43.61318034762236,NaN,NaN,13.775975553478725,0.08721885455653355
2006-08-23T09:30:00-04:00,38.47,38.67,37.92,38.14,96067504,104002269.6,57.27564828713629,54.11269314166834,NaN,NaN,86.62345312949469,166.8969326940317,0.20108103314735404,0.3446316974260242,0.14355066427867014,2333699978,2356387741.2,75.00922306040255,46.52910597542432,NaN,NaN,14.02015499669416,2.0776383034333374
2006-08-24T09:30:00-04:00,38.25999,38.35001,37.92,38.25,79002000,102967007.2,58.359638976840436,54.816232760395835,NaN,NaN,70.38806166036024,126.10609334671244,0.16442229613824147,0.34907853445147197,0.1846562383132305,2412701978,2379621917.2,75.8597069386109,49.60774282659789,NaN,NaN,14.524422420549268,3.8557503201641845
2006-08-25T09:30:00-04:00,38.17,38.64,38.06,38.32001,73588192,101967900.8,59.07139167823775,55.739499510974326,NaN,NaN,76.06454229077472,100.12318185490493,0.13561042048709765,0.3541692639221026,0.21855884343500492,2486290170,2398018768.4,76.5404860801401,52.828522087183906,NaN,NaN,15.136834176699452,5.467333728240652
2006-08-28T09:30:00-04:00,38.28,38.78999,38.24001,38.61,80085872,102067369.6,61.97098656071535,57.0277570573205,NaN,NaN,83.6687047622398,88.17374578058278,0.1269566977543209,0.377254715627906,0.25029801787358513,2566376042,2445767130,78.25456738000125,56.286150244591234,NaN,NaN,16.470834685354028,7.039262436399706
2006-08-29T09:30:00-04:00,38.58,38.75999,38.17999,38.73,104869184,102382153.6,63.13486879268475,58.354743026943666,NaN,NaN,76.07202743369459,78.56335785531283,0.12025363252045412,0.4006150585241528,0.2803614260036987,2671245226,2494062678.8,79.85764984535345,59.921522415762944,NaN,NaN,17.91683962983102,8.593202035461323
2006-08-30T09:30:00-04:00,38.74001,39.03,38.60001,38.91,75714752,101797940.8,64.87158354925029,59.574249975616496,NaN,NaN,90.86925796955401,79.41251882332469,0.11867956484798187,0.428710882063676,0.31003131721569416,2746959978,2576714678.8,82.26700512455729,63.790290990570284,NaN,NaN,19.635499955125287,10.170673166841889
2006-08-31T09:30:00-04:00,38.94,39.03,38.75999,38.87,61215488,99893915.2,64.14836349286156,60.9443269421975,NaN,NaN,86.35814748817027,82.6065359888867,0.10609238793562237,0.4426468021352221,0.33655441419959975,2685744490,2631323181.2,83.65788773091046,67.78843855887257,NaN,NaN,20.89378759473326,11.702546656540656
2006-09-01T09:30:00-04:00,39.07001,39.21001,38.89999,39.08,69390560,97188208.8,66.27416476610456,62.24765180270275,NaN,NaN,93.64781953321301,86.12319143737436,0.10297485806618506,0.4652729867823311,0.36229812871614603,2755135050,2685092157.2,84.91269290385937,71.53500705985759,NaN,NaN,22.56473947516211,13.254288487772293
2006-09-05T09:30:00-04:00,39.11,39.48,38.85001,39.46001,85588624,97984092.8,69.76755688815084,63.10128136093289,NaN,NaN,105.84320519978262,90.55809152488293,0.11657108606736571,0.5080119863003532,0.39144090023298744,2840723674,2739961683.6,86.08672908649773,74.57106195623945,NaN,NaN,25.064266785143573,14.941428244539619
2006-09-06T09:30:00-04:00,39.08,39.19,38.61,38.67,97898560,96653483.2,56.63395713287925,62.53160316462017,NaN,NaN,64.81157104158001,88.30600024646,0.06499680485903137,0.4726869063067767,0.4076901014477453,2742825114,2754277661.2,86.38442992837594,77.03410575398223,NaN,NaN,23.336562586705956,16.14073315056338
2006-09-07T09:30:00-04:00,38.57001,38.89999,38.36,38.4799,115901248,95179132.8,53.99971355708909,61.70118688121778,NaN,NaN,35.98825037781196,77.32979872811161,0.013415233919223835,0.4244591438467751,0.41104390992755124,2626923866,2730270438.8,83.17057610404375,78.76898772560627,NaN,NaN,21.088768530030258,16.84759534763008
2006-09-08T09:30:00-04:00,38.53999,38.82001,38.46001,38.72,96630000,94885036,56.73682296341576,61.036287654045125,NaN,NaN,42.21390017694918,68.50094926586739,-0.008043131957243932,0.4009899949809963,0.40903312693824023,2723553866,2737832314,83.38031821068932,79.97977327904697,NaN,NaN,20.023431627818653,17.301286244799876
2006-09-11T09:30:00-04:00,38.41,39.14999,38.3199,38.96001,142377744,97657398.4,59.34122356182247,60.911424638120955,NaN,NaN,60.727607918922544,61.916906943009295,-0.009483385151008772,0.39717889549947927,0.40666228065048804,2865931610,2759991626,84.00924040436085,80.94053568413425,NaN,NaN,19.905390438338223,17.673301129591067
2006-09-12T09:30:00-04:00,38.95,39.8,38.95,39.67999,124108432,98395282.4,65.9609824763896,61.25335019168414,NaN,NaN,190.73510079184095,78.89528606142096,0.03235100597739127,0.4471010381222271,0.41475003214483586,2990040042,2789854899.6,84.84174974203547,81.73087589570277,NaN,NaN,21.97627032423637,18.288011014540395
2006-09-13T09:30:00-04:00,39.73,39.98199,39.63,39.96001,116096192,97514101.6,68.1340257319173,62.02894858059707,NaN,NaN,238.13961993351785,113.56089583980852,0.07096512402696503,0.5034564371785422,0.43249131315157713,3106136234,2862517123.6,86.66139373760153,82.56317380121698,NaN,NaN,24.388371272181484,19.159491051346265
2006-09-14T09:30:00-04:00,39.85001,40.22,39.75999,39.99001,98116000,95646398.4,68.3670216570142,62.7437616291809,NaN,NaN,213.38775436363542,149.0407966369732,0.08941918524270931,0.5442652947049638,0.45484610946225446,3204252234,2977982797.2,88.93457620602601,83.49709303460376,NaN,NaN,26.3660832370967,20.189004220739186
2006-09-15T09:30:00-04:00,40.35001,40.46001,40,40.11,137846000,96053804.8,69.33285663617609,63.47672341189078,NaN,NaN,192.7853048437143,179.15507757032623,0.09980906817352614,0.5796074446791621,0.479798376505636,3342098234,3101691670.8,90.7528678803476,84.51226316319003,NaN,NaN,28.27834798143109,21.344624757980885
2006-09-18T09:30:00-04:00,40.12,40.39999,39.94,40.11011,117821632,97056145.6,69.3337810265059,64.0026373023044,NaN,NaN,151.10523818863595,197.2306036242689,0.09672187895862283,0.6007007252039145,0.5039788462452917,3459919866,3220489322,92.0960406573957,85.50093982586107,NaN,NaN,29.831127256479135,22.55698225776635
2006-09-19T09:30:00-04:00,40.24001,40.25,39.52,39.85001,159077184,101676420.8,64.39133590404239,64.09238495311565,NaN,NaN,100.22915244698785,179.12941395529828,0.06852291454807546,0.5896324894303859,0.5211095748823105,3300842682,3282649850,92.69403099648007,86.41782419379867,NaN,NaN,29.791361285724722,23.590464976046118
2006-09-20T09:30:00-04:00,40.2,40.53999,40.19,40.42999,116644064,102401961.6,69.59592160131547,64.42983767112032,NaN,NaN,136.71218012907897,158.84392599441054,0.07951837768873649,0.6205075469932311,0.5409891693044946,3417486746,3344919952.4,93.24534874018093,87.20199159491465,NaN,NaN,31.339263161358765,24.697436145376496
2006-09-21T09:30:00-04:00,40.52,40.67,40.08,40.17999,126895936,103943383.2,65.1739476028866,64.50309367897924,NaN,NaN,112.53397472973818,138.67317006763108,0.061355125266226884,0.6176830758872782,0.5563279506210513,3290590810,3362187667.6,93.39421241303698,87.89744335792368,NaN,NaN,31.290728317830634,25.63933502715566
2006-09-22T09:30:00-04:00,40.14999,40.16,39.7,39.87,101036320,105045099.2,60.076753101082176,64.06042141719193,NaN,NaN,62.688286527156606,112.65376640431955,0.02189964013848167,0.5837025007941534,0.5618028606556718,3189554490,3331678918.8,89.63549211726901,88.23478615888152,NaN,NaN,29.669759575776748,26.21510996267296
2006-09-25T09:30:00-04:00,40.05,40.66,39.67999,40.57001,136551744,108193276.8,66.45654133078534,63.82392030595154,NaN,NaN,94.4636630158174,101.32545136975583,0.0355728445238096,0.6062689163104338,0.5706960717866242,3326106234,3304916192.4,86.35238521935203,88.25376159694255,NaN,NaN,30.291134900097894,26.797399239447948
2006-09-26T09:30:00-04:00,40.52,40.8,40.39999,40.77,113548944,109866430.4,68.02846901057572,64.63781401150128,NaN,NaN,118.71067807308329,105.02175649497492,0.049838124283965834,0.6329937271415815,0.5831556028576157,3439655178,3332678691.6,86.8888707381296,88.28979308335352,NaN,NaN,31.299466954402956,27.440551770155807
2006-09-27T09:30:00-04:00,40.705,40.95,40.5,40.72,113144192,110280180.8,67.18081928862483,65.57932156375384,NaN,NaN,114.29119701226578,100.53755987161227,0.04765932693714503,0.642729761529047,0.595070434591902,3326510986,3314483539.6,84.54322789313609,88.38783963971726,NaN,NaN,31.84216216360497,28.06935325493426
2006-09-28T09:30:00-04:00,40.77,40.89,40.42999,40.83,86020000,110795443.2,68.12189715312918,66.39254114873337,NaN,NaN,104.46053524499945,98.92287197466455,0.04539011775584201,0.6518080817867045,0.6064179640308625,3412530986,3338871574.8,85.1229506452024,88.51231338503963,NaN,NaN,32.563360430790254,28.711354280056543
2006-09-29T09:30:00-04:00,40.89,40.92999,40.62,40.64999,85447808,112007059.2,64.84499901818936,66.78566796704528,NaN,NaN,99.58507807307028,106.30223028384728,0.024571981939623067,0.6371329414553912,0.6125609595157682,3327083178,3366377312.4,85.77114131210915,88.63816344987879,NaN,NaN,32.22058297766407,29.212672665429047
2006-10-02T09:30:00-04:00,40.60001,40.7,40.08,40.14,97139184,113394490.4,56.545965099159936,66.1131667258146,NaN,NaN,48.8129804307436,97.17209376683252,-0.02789549788290613,0.5776915871621355,0.6055870850450417,3229943994,3347144864.4,83.04653692693594,88.50993396308597,NaN,NaN,29.33447504421704,29.230073005255903
2006-10-03T09:30:00-04:00,40.05,40.48,39.88,40.31,116268368,114928477.6,58.45469697753785,65.42178610050178,NaN,NaN,35.16952444472472,80.4638630411608,-0.05399078868648288,0.538098599186938,0.5920893878734209,3346212362,3328456301.2,80.37471363900494,88.06088538461479,NaN,NaN,27.508830450126894,28.984181211666044
2006-10-04T09:30:00-04:00,40.22,41.31,40.14,41.3,149487184,117507908.8,67.4276414693015,65.35468751566516,NaN,NaN,113.64711051890515,80.33504574248869,-0.009735003803716946,0.5799206331187747,0.5896556369224917,3495699546,3362294013.2,81.5331916768587,87.53221506110285,NaN,NaN,28.818429102162135,28.96050233887977
2006-10-05T09:30:00-04:00,41.28,41.56,41.17999,41.5,92177184,116321705.6,68.88948128641192,65.32301784782486,NaN,NaN,174.41128584190574,94.32519586186993,0.025901744646548153,0.6220328177306769,0.5961310730841287,3587876730,3397363162,82.67465660500713,86.95519997000711,NaN,NaN,30.34765864762304,29.158667525843093
2006-10-06T09:30:00-04:00,41.38,41.56,41.24001,41.41,85451568,115762784,67.4230683262828,65.1865383692375,NaN,NaN,164.15312915214173,107.23880607768425,0.03570195297615586,0.6407585143043235,0.6050565613281677,3502425162,3432431558.8,83.75594269053735,86.35947868666007,NaN,NaN,31.097306182908007,29.435615905423795
2006-10-09T09:30:00-04:00,41.375,41.74001,41.32001,41.55,62817040,111784748.8,68.54474277306673,65.48321028845352,NaN,NaN,161.5265260830501,129.78151520814555,0.043391266085855085,0.6592956439354865,0.6159043778496314,3565242202,3499491200.4,85.60594367790586,85.85318673533335,NaN,NaN,32.049616234979474,29.80904452393175
2006-10-10T09:30:00-04:00,41.61,41.75,41.31,41.62,98189568,110488805.6,69.1173099651126,65.44902374301047,NaN,NaN,144.03248863828432,151.55410804685744,0.04478829052754896,0.6718897410090676,0.6271014504815187,3663431770,3562935082,87.10250963082636,85.4144125132366,NaN,NaN,32.99226426105799,30.26379020066407
2006-10-11T09:30:00-04:00,41.42999,41.83,41.17,41.53999,136568064,111512399.2,67.60260665595385,65.62249938965813,NaN,NaN,122.07056016558717,153.23879797619387,0.03249282668118081,0.6677174838329947,0.6352246571518139,3526863706,3569167914,87.24283851583445,84.97502866343642,NaN,NaN,33.350114402015535,30.704693657999993
2006-10-12T09:30:00-04:00,41.75999,42.25,41.7,42.23,95322560,111372727.2,73.08144291807153,66.55140580515736,NaN,NaN,168.90257341689858,152.13705549119237,0.06132654474380028,0.7118828380815643,0.650556293337764,3622186266,3576029821.2,87.40530863332316,84.81572984315457,NaN,NaN,35.396895925135205,31.375008267590736
2006-10-13T09:30:00-04:00,42.22,42.52,42.14,42.42999,80470128,108503933.6,74.4311131018321,67.12101807451783,NaN,NaN,169.43355270381846,153.19314020152768,0.08301601885151566,0.7543263169021586,0.6713102980506429,3702656394,3616076067.6,88.33870853350788,84.95761007987998,NaN,NaN,37.509691336598046,32.25139156316321
2006-10-16T09:30:00-04:00,42.42999,42.62,42.39999,42.45,62026736,105714188.8,74.56850818944845,67.5881637301516,NaN,NaN,154.00166639497752,151.68816826391318,0.0874155077491473,0.780579682737077,0.6931641749879297,3764683130,3655964253.2,89.19747055459938,85.12251006677069,NaN,NaN,39.251353456932684,33.25138611941599
2006-10-17T09:30:00-04:00,42.17,42.2,41.75999,42,146149120,105067785.6,65.98167846730657,67.50251081434315,NaN,NaN,91.3875939152221,141.15918931930076,0.05055316260650611,0.7563556282460624,0.7058024656395563,3618534010,3646984701.2,87.63292377876266,85.34320263002974,NaN,NaN,38.21386931630827,33.9603122904006
2006-10-18T09:30:00-04:00,42.22,42.31,41.64999,41.8,121156320,105293398.4,62.53498537307092,67.10344568719614,NaN,NaN,76.11941359143842,131.968960004471,0.0056002793774846404,0.7128028148614121,0.7072025354839274,3497377690,3641087498,86.5591199419258,85.44578615122427,NaN,NaN,36.306607702016905,34.29549734920293
2006-10-19T09:30:00-04:00,41.69,42.11011,41.59,41.89999,108220432,104359623.2,63.559859555847844,67.0116500113146,NaN,NaN,64.47680200348826,111.08380572178893,-0.022935195165193045,0.6785335415274361,0.7014687366926291,3605598122,3637769869.2,85.92126096052917,85.45650898325425,NaN,NaN,35.023836500886546,34.39954579944345
2006-10-20T09:30:00-04:00,42.05,42.084,41.64,42,105456128,104580613.6,64.60285969456052,67.58714248241465,NaN,NaN,63.57319272565334,89.91173372615592,-0.039631128970794016,0.6519298254791366,0.6915609544499306,3711054250,3639449440.4,85.97759742444967,85.6658704473624,NaN,NaN,34.241478500981984,34.376964756806096
2006-10-23T09:30:00-04:00,41.92,42.58,41.82001,42.42999,126988944,104102473.6,68.74498849162123,68.32216330484917,NaN,NaN,98.05041807660841,78.7214840624821,-0.026882159507571446,0.6579582550654663,0.6848404145730378,3838043194,3654121453.2,86.4863136857422,86.1024133078436,NaN,NaN,34.75119346012449,34.430426000137295
2006-10-24T09:30:00-04:00,42.28999,42.45,41.92,42.13,103668368,103608444.8,63.189368376462404,68.01942951250352,NaN,NaN,78.90026584251586,76.22401844794088,-0.04287036551835344,0.631252457675096,0.6741228231934494,3734374826,3677289616.4,87.27157541587684,86.51229786063062,NaN,NaN,33.51789942875942,34.300065061369025
2006-10-25T09:30:00-04:00,42.14,42.52,42.05,42.42999,125404000,104221435.2,66.13655301353046,67.82279177872627,NaN,NaN,90.34450707673847,79.06903714500088,-0.037645316034177756,0.6270661781507272,0.6647114941849049,3859778826,3749769843.6,89.35548592613156,86.98949995499665,NaN,NaN,33.34728022235184,34.16395294150943
2006-10-26T09:30:00-04:00,42.57001,42.92,42.22,42.82001,130818368,106461353.6,69.54995047994552,67.97471193255932,NaN,NaN,117.20536500721119,89.61474974574546,-0.013566809139147873,0.64775298276097,0.6613197919001179,3990597194,3826769658,91.03475858060459,87.50941537571575,NaN,NaN,34.26657515888768,34.17861325827775
2006-10-27T09:30:00-04:00,42.73,42.82001,42.08,42.21001,129374944,108657710.4,59.45564519026832,67.32549067664515,NaN,NaN,77.2665412698929,92.35341945459336,-0.04272157417907341,0.6079178241762762,0.6506393983553496,3861222250,3856803258,91.59193632967373,87.93698627941345,NaN,NaN,31.711987509017998,33.826238151240645
2006-10-30T09:30:00-05:00,42.17,42.64999,42.06,42.48,103951248,108998313.6,62.07902760321611,66.82275622222397,NaN,NaN,78.1641805231608,88.37617194390384,-0.04745730471646892,0.5913177674597634,0.6387750721762323,3965173498,3882229318.8,92.04280312391737,88.28986438606282,NaN,NaN,30.474209483660168,33.34737691301486
2006-10-31T09:30:00-05:00,42.56,42.75999,42.31,42.58,135825504,109976170.4,63.033099818134694,66.49636287666546,NaN,NaN,98.73485830835357,92.34309043707138,-0.0473796025580856,0.5795505689786253,0.6269301715367109,4100999002,3955554154,93.17878341511525,88.71386045029715,NaN,NaN,29.78277224265958,32.83814767439268
2006-11-01T09:30:00-05:00,42.73,42.77,41.82001,42,148966624,109950142.4,54.47271170482402,65.16716779000492,NaN,NaN,29.751788707833676,80.22454676329042,-0.08757703101108882,0.5174588827728499,0.6050359137839387,3952032378,3974004864.4,93.43284254273718,89.14439858668388,NaN,NaN,26.32664088764673,31.907932419143258
2006-11-02T09:30:00-05:00,41.815,42.14,41.74001,42.03999,100228064,110352686.4,54.92722561095755,63.774032969228166,NaN,NaN,-22.608397611967963,52.2617942394546,-0.11114499629076313,0.4661046684204848,0.577249664711248,4052260442,3986337514,93.60431255479449,89.52051315963293,NaN,NaN,23.74756494562155,30.742165637211585
2006-11-03T09:30:00-05:00,42.10001,42.19,41.61,41.92999,119295808,112044898.4,53.349499173634264,62.258389468098585,NaN,NaN,-45.9240560848316,27.623674768509698,-0.13237315400259742,0.4117832222080011,0.5441563762105985,3932964634,4000685990.8,93.80691825168128,89.84975942371021,NaN,NaN,21.1685047834072,29.374499800953817
2006-11-06T09:30:00-05:00,42.06,42.71001,42.06,42.53999,101354944,113971793.6,60.18019574301269,61.843997844934734,NaN,NaN,73.78595504518088,26.748029672913713,-0.10477152741236517,0.41319196694514204,0.5179634943575072,4034319578,4014515206.8,94.0040685873098,90.30484119574929,NaN,NaN,20.989859685526884,28.17669407017854
2006-11-07T09:30:00-05:00,42.53,43.09,42.47,42.83,139877120,116056171.2,62.95722240224027,61.87415763273254,NaN,NaN,151.85060660093927,37.371179331430845,-0.06819347962805111,0.43272164482244335,0.5009151244504945,4174196698,4029154746,94.21404956211718,90.8516218829058,NaN,NaN,21.72935568712317,27.25564572974206
2006-11-08T09:30:00-05:00,42.58,43.2,42.47,43.03,180439312,118249733.6,64.78135049711915,61.961406985680505,NaN,NaN,165.10209451289305,64.44124049244272,-0.03349546783471247,0.45904578965710385,0.4925412574918163,4354636010,4109675472.4,95.20807645105674,91.51496584651491,NaN,NaN,22.908568685437807,26.63463472341288
2006-11-09T09:30:00-05:00,43.27,43.35001,42.67,42.8,124279936,119697602.4,61.0576527945165,61.70817792139163,NaN,NaN,153.17425126572613,99.59777026798153,-0.02916000578707728,0.4560912502579697,0.485251256045047,4230356074,4145294598.8,95.5705941086542,92.20017989538665,NaN,NaN,22.757656063016444,26.08078062907053
2006-11-10T09:30:00-05:00,42.825,43.03999,42.67,43.03,82421680,119795180,63.32776085502988,61.32123309020654,NaN,NaN,127.29272878772873,134.24112724249363,-0.014659886876484562,0.4669263974494413,0.4815862843259259,4312777754,4221257222.8,96.22627292179259,92.89589126939025,NaN,NaN,23.320101776893754,25.68639793590242
2006-11-13T09:30:00-05:00,43.06,43.53999,43,43.46001,89165312,121152108.8,67.17988208152863,61.60626978342556,NaN,NaN,184.83472679084045,156.45088159162552,0.01824870562783376,0.5043971663607181,0.4861484607328843,4401943066,4294781920.4,96.73072015138202,93.57154446478349,NaN,NaN,25.02676348846007,25.592164443410656
2006-11-14T09:30:00-05:00,43.5,43.97,43.24001,43.92999,121965248,119942915.2,70.79117051020687,61.938742461759595,NaN,NaN,207.0656634907565,167.49389296958898,0.06347944948268525,0.5654977725862409,0.5020183231035557,4523908314,4364724243.6,97.12449731043381,94.1264738493765,NaN,NaN,27.695266091541136,25.892607536000725
2006-11-15T09:30:00-05:00,43.985,44.39999,43.92,44.11,116575808,119713889.6,72.05929345808853,62.11798124591267,NaN,NaN,221.32823839679932,178.73912174637022,0.09541251826802322,0.6212839709385847,0.5258714526705615,4640484122,4421893866,97.40014680630081,94.58114443692624,NaN,NaN,30.270941437812997,26.518083807688193
2006-11-16T09:30:00-05:00,44.25,44.42,44.02,44.3,113541056,119979920.8,73.3733250225396,63.11210123393204,NaN,NaN,192.70242591803745,186.6447566768325,0.11775695173838263,0.6730676423435398,0.5553106906051571,4754025178,4526627686.8,97.81364243353433,95.02555201577341,NaN,NaN,32.805216909303105,27.416245679347465
2006-11-17T09:30:00-05:00,44.06,44.3,43.95,44.3,95171632,119465696,73.3733250225396,63.918836763883725,NaN,NaN,156.51348308895183,192.4889075370771,0.12052633419295689,0.7059686083463532,0.5854422741533963,4754025178,4614877171.6,98.08938576577083,95.45745077590581,NaN,NaN,34.83672415923034,28.476314033616447
2006-11-20T09:30:00-05:00,44.16,44.48,44.00999,44.39,107197504,118476124,74.04392827339083,64.70532451068773,NaN,NaN,142.8878746752043,184.09953711394988,0.11635016414613597,0.7308799793360663,0.6145298151899303,4861222682,4706733094.8,98.32603727759556,95.82511176608298,NaN,NaN,36.719961227405456,29.65397791844345
2006-11-21T09:30:00-05:00,44.42,44.50999,44.25,44.45,68135312,116699471.2,74.5049256192869,66.13619693314936,NaN,NaN,128.97436753185337,168.48127792216923,0.10585986260995983,0.7468546434523802,0.6409947808424203,4929357994,4787823030.8,98.50238902343577,96.18722222899002,NaN,NaN,38.42176604283759,30.906519079071185
2006-11-22T09:30:00-05:00,44.58,44.75,44.25999,44.73,69867632,113922652.8,76.59410696655328,67.6838313156919,NaN,NaN,123.72311023941518,148.96025229069238,0.10576051472198655,0.7731954242449035,0.667434909522917,4999225626,4859571331.6,98.63901025037829,96.54684349296029,NaN,NaN,40.52351685919858,32.28037590480367
2006-11-24T09:30:00-05:00,44.39999,44.86,44.38,44.64999,51794512,109971460,74.71015250166064,69.2095922676938,NaN,NaN,110.9752139878778,132.6148099046605,0.08896317649774277,0.7786388801450954,0.6896757036473526,4947431114,4898252518.8,98.70746960333581,96.89688287522134,NaN,NaN,41.78894227665311,33.63874252935359
2006-11-27T09:30:00-05:00,44.52,44.61,43.64,43.66,159521248,111478775.2,56.268123602072905,68.93015854334097,NaN,NaN,52.13359414913516,111.73883211669713,0.00430484285510635,0.6950567572162356,0.6907519143611293,4787909866,4905029456.4,98.71962123990399,97.23370806469235,NaN,NaN,37.04809239534262,34.125792510209166
2006-11-28T09:30:00-05:00,43.52,43.84,43.34,43.77,118270432,112194734.4,57.52279940787572,68.54198547231492,NaN,NaN,22.007527077845527,87.56276259722537,-0.04826053787386375,0.6304262420187996,0.6786867798926633,4906180298,4914020979.6,98.73659280207805,97.5567468675467,NaN,NaN,33.635918359872974,34.05581048873257
2006-11-29T09:30:00-05:00,44,44.17999,43.66,44.07001,139546192,112380768.8,60.82406532038688,68.25932224540547,NaN,NaN,44.04221680281584,70.57633245141787,-0.06571912351246723,0.5965378755020794,0.6622569990145466,5045726490,4937294678.8,98.78161080534161,97.8119993214242,NaN,NaN,31.764493444013166,33.728479482344085
2006-11-30T09:30:00-05:00,44.05,44.28,43.78999,44.03999,124969936,111180934.4,60.31889521872438,68.2065538471346,NaN,NaN,44.91582576934093,54.814875557403,-0.08117019862560382,0.5607942507325419,0.6419644493581457,4920756554,4921600864.4,96.29004674590485,97.86338879551353,NaN,NaN,30.116721566985472,33.21251406586428
2006-12-01T09:30:00-05:00,44,44.35001,43.25999,43.66,144574944,113398278.4,54.184351850693425,67.55345320396772,NaN,NaN,12.404412038858565,35.10071516759915,-0.11670229864875281,0.49608657604720463,0.6127888746959574,4776181610,4887350963.6,90.90137305147785,97.48303880477677,NaN,NaN,26.773908601996066,32.29271328531168
2006-12-04T09:30:00-05:00,43.78999,44.48,43.78999,44.25999,89957504,111931363.2,60.93934498662105,67.10770055433146,NaN,NaN,52.749193517754954,35.22383504132316,-0.10015212232107085,0.48759872179461894,0.5877508441156898,4866139114,4902996813.2,91.14515741714332,97.08407003804543,NaN,NaN,25.940162180167675,31.38520598457682
2006-12-05T09:30:00-05:00,44.39,44.55,44.19,44.42,84708496,111099040.8,62.52616270275746,66.51734285379936,NaN,NaN,74.28254086361201,45.67883779847646,-0.07967560055004752,0.4881563434281304,0.5678319439781779,4950847610,4911930275.6,91.28867969540191,96.66722592268601,NaN,NaN,25.769907984680856,30.583020556020255
2006-12-06T09:30:00-05:00,44.28999,44.39999,44.07001,44.25999,78243936,108017381.6,59.905339436839824,65.64920328085303,NaN,NaN,50.07751094424468,46.88589662676223,-0.07805286659274246,0.47026586073724985,0.5483187273299923,4872603674,4877305712.4,85.50406533201216,95.81750581737968,NaN,NaN,24.825067565500973,29.76045584308893
2006-12-07T09:30:00-05:00,44.34,44.48,43.7,43.7,124961632,105243497.6,51.732755328476706,64.10344830270569,NaN,NaN,-3.070755651252881,37.28858034264347,-0.11368027887633647,0.4062183787345717,0.5198986576109081,4747642042,4842682810,80.04220746201959,94.54811760512861,NaN,NaN,21.3012672995307,28.552000336866325
2006-12-08T09:30:00-05:00,43.57001,44.25999,43.47,43.89999,133805504,105719776,54.1390541854937,62.729571814345256,NaN,NaN,-31.885135006474954,28.43067093357676,-0.1220284648461975,0.36736307655316125,0.48939154139935875,4881447546,4863735997.2,80.84353145333068,93.31627086852575,NaN,NaN,19.184306556385526,27.21375836822621
2006-12-11T09:30:00-05:00,43.83501,44.37,43.75,44.06,72938752,105245629.6,56.027905353949,61.44271303438513,NaN,NaN,-5.5550328540142715,16.769825659222917,-0.11511423719000657,0.3454987449118505,0.4606129821018571,4954386298,4881385434,81.5136393650105,92.1153853033411,NaN,NaN,18.03134152944568,25.901984534114703
2006-12-12T09:30:00-05:00,44.03,44.13,43.56,43.8,111239632,106349345.6,52.26133456526306,59.85388510195486,NaN,NaN,-82.29987244172032,-14.546657001843553,-0.12553796794233574,0.30369052217393744,0.4292284901162732,4843146666,4859845245.2,77.93068619072113,90.6459779581472,NaN,NaN,15.902400170753648,24.47347248220598
2006-12-13T09:30:00-05:00,44.105,44.11,43.62,43.88,79035312,104202848.8,53.30160211481717,58.190134755402276,NaN,NaN,-75.33501135708556,-39.6291614621096,-0.12429823382195204,0.2738556978388331,0.39815393166078517,4922181978,4869760906,78.40133248909834,89.20042954662722,NaN,NaN,14.471461795192738,23.04461381263266
2006-12-14T09:30:00-05:00,43.97,44.57001,43.94,44.37,109111120,103829614.4,59.17029987720647,57.08014528222698,NaN,NaN,51.60965087459052,-28.69308015694092,-0.08936451180630234,0.2864482919029072,0.37581280370920955,5031293098,4926491117.2,80.90972463414361,87.92916204882776,NaN,NaN,15.003474223738877,21.895879585647837
2006-12-15T09:30:00-05:00,44.66,44.75999,44.35001,44.42999,99944432,103149783.2,59.835797300436035,57.334979117824346,NaN,NaN,107.03344231970289,-0.9093646917053491,-0.06238188819145901,0.2978354434698858,0.3602173316613448,5131237530,4976449114,82.80371751660722,86.79231178287799,NaN,NaN,15.631413832099195,21.00095590656946
2006-12-18T09:30:00-05:00,44.58,44.75,43.8,43.99001,121593056,104470854.4,53.01120626258387,57.01272246458922,NaN,NaN,12.995781067505716,2.800798092598648,-0.07356206916960467,0.26826474519933896,0.34182681436894363,5009644474,4987500749.2,83.20078234126116,85.6826110356768,NaN,NaN,14.089771093512205,20.013643790418424
2006-12-19T09:30:00-05:00,43.64999,44.06,43.38,43.85001,136540256,105937992,51.017264360202425,56.31223668171889,NaN,NaN,-94.0656394832714,0.4476446842884343,-0.08876418754126159,0.23087157994236662,0.3196357674836282,4873104218,4993492259.6,83.4242397514021,84.58565596039541,NaN,NaN,12.221858151537061,18.900531556292513
2006-12-20T09:30:00-05:00,43.89,44.11,43.67,43.69,67318560,105897154.4,48.75985166990344,55.48659071394597,NaN,NaN,-71.6154728298583,1.1915523897338858,-0.10676493810238102,0.18617959485565194,0.29294453295803297,4805785658,4970212995.6,79.02586169902244,83.35249988561809,NaN,NaN,9.995210778692506,17.628342873778227
2006-12-21T09:30:00-05:00,43.75999,43.78999,43.21001,43.38,102955376,107551541.6,44.638821732013994,54.80476713404029,NaN,NaN,-161.81254537050674,-41.49288685928557,-0.13490486051784478,0.12431345731072696,0.25921831782857174,4702830282,4904520432.4,68.11249534371146,81.72472290649192,NaN,NaN,6.817618699921317,16.083953706084383
2006-12-22T09:30:00-05:00,43.39,43.41,42.92999,42.92999,92861872,109604909.6,39.429196578460406,53.26832796202882,NaN,NaN,-238.68471200765734,-110.63651772475762,-0.1765523138367219,0.03852792553266937,0.21508023936939127,4609968410,4800266608.4,55.1062771372568,79.15051717221431,NaN,NaN,2.3435642177768603,14.121040922040452
2006-12-26T09:30:00-05:00,42.92999,43.12,42.88,43.11,50857344,104171714.4,42.32863019971035,51.82564706895403,NaN,NaN,-202.9819911606615,-153.83207217039106,-0.18387399452486683,-0.01476225378669227,0.16911174073817456,4660825754,4730502864.4,48.44043872017438,76.08992853112663,NaN,NaN,-0.4710877370543607,12.036451113598336
2006-12-27T09:30:00-05:00,43.19,43.39999,43.10001,43.33,54128640,100964624.8,45.746742950955856,50.81431874853375,NaN,NaN,-133.29633717815815,-161.6782117093684,-0.1663259769251402,-0.038795730418250685,0.12753024650688952,4714954394,4698872899.6,45.73900665401923,73.24956719698427,NaN,NaN,-1.803319924654236,10.05934096527654
2006-12-28T09:30:00-05:00,43.2,43.38,43.05,43.12,69024256,97438528,43.11960893121628,50.19909400587228,NaN,NaN,-130.9435381580856,-173.54382477501386,-0.16117251521989984,-0.07393539751798528,0.08723711770191456,4645930138,4666901795.6,43.121297390918535,70.61235933476277,NaN,NaN,-3.7113819035161733,8.092094841163295
2006-12-29T09:30:00-05:00,43.21001,43.61,43.12,43.16,75163504,94948206.4,43.78186186017184,49.45929455406358,NaN,NaN,-94.77972476768461,-160.13726065444945,-0.14773611328670072,-0.09743302390646136,0.05030308938023937,4721093642,4670554467.6,43.5190148626769,67.94632243543036,NaN,NaN,-5.075501496293613,6.211009650098022
2007-01-03T09:30:00-05:00,43.46001,44.06,42.52,43.24001,167740256,96106472,45.15732484487693,48.682824517701285,NaN,NaN,-87.50951147759041,-129.90222054843605,-0.12692241806230675,-0.10834993319764408,0.018572484864662682,4888833898,4726327565.2,49.34351684273854,65.64845654098237,NaN,NaN,-5.833174316203462,4.490411940626382
2007-01-04T09:30:00-05:00,43.3,44.21001,43.14999,44.06,136881936,98452693.6,56.818010029694165,49.00830133658922,NaN,NaN,8.172853935807494,-87.67125152914227,-0.05506278988524951,-0.05025600249189921,0.004806787393350304,5025715834,4799305581.2,55.77067278803136,64.06559844079024,NaN,NaN,-2.7969956585938016,3.4493537121663556
2007-01-05T09:30:00-05:00,43.92999,43.95,43.48,43.85001,138981632,101166350.4,53.67085118549317,49.03467627020893,NaN,NaN,5.759585347793922,-59.860067023951856,-0.02058097845168263,-0.020919435671252984,-0.0003384572195703544,4886734202,4833661542.8,58.443769595758575,62.64005823412311,NaN,NaN,-1.2805692541971527,2.773650431257283
2007-01-08T09:30:00-05:00,43.88,44.12,43.64,43.88,106445680,102576437.6,54.06220120606791,48.66981207941331,NaN,NaN,33.349810120719795,-27.001397368190784,0.004027419217829103,0.004695816802716024,0.0006683975848869213,4993179882,4903111491.6,63.27561853793901,61.380479227251364,NaN,NaN,0.04776923039600667,2.384238831134244
2007-01-09T09:30:00-05:00,44,44.28999,43.63,44.10001,121616368,102409174.4,56.93612212549007,48.46269242406003,NaN,NaN,57.70236162360279,3.495019910066695,0.033274792726128044,0.04226188849254697,0.008987095766418932,5114796250,4981852013.2,67.84112619310127,60.3117227041438,NaN,NaN,2.040989956300665,2.3352032775865896
2007-01-10T09:30:00-05:00,43.96001,44.66,43.82001,44.62,121114816,101774640,62.85150794519696,49.165571115675256,NaN,NaN,117.87180031225384,44.57128226803553,0.08296477357858634,0.11269306273965185,0.029728289161065517,5235911066,5051267446.8,71.23601864653581,59.45709672594912,NaN,NaN,5.75879326392633,2.8242875613494096
2007-01-11T09:30:00-05:00,44.71001,45.24001,44.64999,45.08,174062256,106830815.2,67.15032130667134,50.31793232613732,NaN,NaN,204.67076718916485,83.87086491870704,0.13884543861670248,0.20328508743194362,0.06443964881524114,5409973322,5128118944.4,74.45166821393526,58.81619875898722,NaN,NaN,10.443433124151976,3.9127369274640618
2007-01-12T09:30:00-05:00,45.02,45.35001,44.97,45.31,104220432,106479855.2,69.07714372350219,51.769167472822936,NaN,NaN,195.50194545200145,121.81933693954855,0.18068242825097272,0.29029268412895703,0.10961025587798431,5514193754,5253610854.8,78.64910270178021,58.78928740204134,NaN,NaN,14.917768043151176,5.484884229705078
2007-01-16T09:30:00-05:00,45.33,45.39999,45.13,45.28,95896432,107322911.2,68.51264959416463,53.474440891547985,NaN,NaN,165.0110955770971,148.15159403082401,0.19451954568947177,0.35275968798982404,0.15824014230035227,5418297322,5338634342.8,80.9345739582803,59.705150160224825,NaN,NaN,18.295535958597995,7.314977333832638
2007-01-17T09:30:00-05:00,45.09,45.28999,44.83,44.91,127569936,108245852,61.804394532442466,55.072669316832425,NaN,NaN,119.30963477460014,160.47304866102348,0.1679401660325523,0.36816534984104266,0.20022518380849036,5290727386,5373820570,81.80270433366304,61.61203781711099,NaN,NaN,19.169330350117022,9.008456336158979
2007-01-18T09:30:00-05:00,44.78999,44.84,43.95,44.08,189062560,112701758.4,49.98182306206639,55.619325949857846,NaN,NaN,39.68526454072944,144.8357415067186,0.08768294903053503,0.30982887009665916,0.22214592106612413,5101664826,5346971322,78.85219932781034,63.78430643194213,NaN,NaN,15.870033727794135,9.988681677821145
2007-01-19T09:30:00-05:00,43.98,44.28011,43.91,44.17,127558064,113000008.8,51.07470966908358,55.99989500115269,NaN,NaN,20.401002406575618,107.98178855020073,0.03650112296211172,0.2677723247687638,0.23127120180665206,5229222890,5310821235.6,74.93328848388289,65.86961227693239,NaN,NaN,13.652590565392005,10.51209723318841
2007-01-22T09:30:00-05:00,44.21001,44.23,43.50999,43.69,123465248,112346258.4,45.3797254999907,56.16133189892229,NaN,NaN,-16.199604767433403,65.64147850631377,-0.03023303727531701,0.1934799052125058,0.2237129424878228,5105757642,5229134013.2,66.84843274957534,67.56440765969359,NaN,NaN,9.818674854553443,10.413036893383415
2007-01-23T09:30:00-05:00,43.64,43.9801,43.5,43.58,133213744,115641017.6,44.16439327303942,56.188655571269976,NaN,NaN,-29.58604304258744,26.72205078237687,-0.07953534149847385,0.12429376561473049,0.20382910711320434,4972543898,5139983328.4,59.32539318861341,68.69343468297477,NaN,NaN,6.388102036951645,9.838046199607447
2007-01-24T09:30:00-05:00,43.87,44.32001,43.77,44.3,117660688,116376283.2,53.03119771326514,56.75107506186913,NaN,NaN,18.421837261423143,6.544491279741474,-0.06217724972720759,0.12610754495419485,0.18828479468140244,5090204586,5099878768.4,56.25819616094634,69.18734034856104,NaN,NaN,6.306668314399734,9.333563644577774
2007-01-25T09:30:00-05:00,44.37,44.47,43.58,43.73,158405312,119653455.2,46.70751982701778,56.02889719024939,NaN,NaN,-11.397742590485159,-3.6721101465014483,-0.08613072482214193,0.08062138865372503,0.16675211347586696,4931799274,5065905658,53.72424852053292,69.04116718659687,NaN,NaN,4.009339286282424,8.572960164821296
2007-01-26T09:30:00-05:00,43.81,43.83,43.28999,43.57001,146284256,124424800.8,45.082535041580925,55.41544603711281,NaN,NaN,-63.37601719125563,-20.427514066067697,-0.10835961925884113,0.03130258940231556,0.1396622086611567,4785515018,4977164083.6,47.68268879622161,68.27251855805851,NaN,NaN,1.6650466005560698,7.586115369926264
2007-01-29T09:30:00-05:00,43.45,43.91,43.39999,43.61,104197008,126928219.2,45.59206297797471,54.81043616367758,NaN,NaN,-57.29532978697246,-28.64665906997551,-0.11533307467030869,-0.004504134676729166,0.11082893999357953,4889712026,4933954960.4,45.02753372006061,66.96908392821004,NaN,NaN,-0.011909135951664639,6.5006832976579885
2007-01-30T09:30:00-05:00,43.67999,43.78999,43.52,43.63,69951248,126974568.8,45.86259472100855,54.01946992050033,NaN,NaN,-61.88199709438996,-35.10584988033601,-0.11339200408503838,-0.03091106511271846,0.08248093897231992,4959663274,4931378835.6,44.86712295707898,65.3280836970656,NaN,NaN,-1.2719351558339242,5.390309232873429
2007-01-31T09:30:00-05:00,43.60001,44.19,43.33,44.07001,157934880,131113137.6,51.56822459717678,53.213521109927456,NaN,NaN,-37.023240360786126,-46.19486540477787,-0.07890273514140855,-0.01614747995444077,0.06275525518696778,5117598154,4936857549.2,45.31332672412955,63.47646284546515,NaN,NaN,-0.6505323311966926,4.527331866577698
2007-02-01T09:30:00-05:00,44.27,44.39999,43.85001,44.02,147389440,130095596.8,50.91147348557426,52.05360340842052,NaN,NaN,-10.013778461231992,-45.91807257892724,-0.05691296682915388,-0.008385953349474562,0.04852701347967932,4970208714,4944539437.2,45.9735683723461,61.44231285678021,NaN,NaN,-0.3365983406541248,3.832484694116009
2007-02-02T09:30:00-05:00,44.11,44.25,43.94,44.16,98188880,128160944,52.72653737041029,50.885702954628236,NaN,NaN,-8.434311267870696,-34.92973139425025,-0.03165467288266207,0.008958672376351728,0.0406133452590138,5068397594,5001115952.4,50.694916419641494,59.44558526519887,NaN,NaN,0.44332040485024604,3.348318367078043
2007-02-05T09:30:00-05:00,44.14,44.36,43.96001,44.12,96371504,126030437.6,52.13341442151865,49.715757585153526,NaN,NaN,-6.903498981423765,-24.85136523314051,-0.017086843981129335,0.01925479028260213,0.036341634263731465,4972026090,5017578765.2,52.009144535002,57.379483163536136,NaN,NaN,0.928787240506677,3.0026710632821336
2007-02-06T09:30:00-05:00,44.2,44.23,43.64,44.05,121128496,126764578.4,51.05112472710104,48.947666884772,NaN,NaN,-36.77102911255021,-19.82917163677256,-0.011858846665043624,0.02151807593242694,0.03337692259747056,4850897594,4995825629.2,50.10853341858821,55.11561381245936,NaN,NaN,1.0542578216473333,2.724326314477162
2007-02-07T09:30:00-05:00,44.28999,44.64999,44.12,44.46001,117932944,126580407.2,56.71883207800499,49.42888181448189,NaN,NaN,32.38229473977179,-5.948064616660977,0.017901210417192046,0.05575343561896062,0.03785222520176858,4968830538,4966072106,47.5490260296213,52.87967286258872,NaN,NaN,2.7713992034626367,2.7310510129036585
2007-02-08T09:30:00-05:00,44.39,44.60001,44.23,44.45,89539008,125001616.8,56.54668638055892,49.81973729387299,NaN,NaN,34.29953769262235,2.9145986141098916,0.034631920291183414,0.08114212556574785,0.04651020527456443,4879291530,4947888669.2,46.00253048517685,50.813190148395435,NaN,NaN,4.1412780828033995,2.9325120228893358
2007-02-09T09:30:00-05:00,44.57001,44.72,43.73,43.84,133482752,122972641.6,47.154395835122564,49.94649946066812,NaN,NaN,-13.87155928306329,1.82714901107137,0.003950143032040346,0.05144788406461487,0.04749774103257452,4745808778,4883370906,40.91738968949567,48.96097278696117,NaN,NaN,2.657666441311823,2.8932483683782624
2007-02-12T09:30:00-05:00,43.88,43.89,43.59,43.7,126940000,124108620,45.29489449890907,50.027249548230245,NaN,NaN,-81.10373048263942,-13.012897289171761,-0.024855174347177024,0.016428773098603244,0.04128394744578027,4618868778,4812739443.6,36.1996957743439,47.30913725737049,NaN,NaN,0.8747082347860172,2.6048854921507987
2007-02-13T09:30:00-05:00,43.78999,44,43.7,43.86,93679632,123997780,47.82708314964519,49.655527079400244,NaN,NaN,-44.8194144448865,-14.622574355639017,-0.03177239157585333,0.0015684579759636108,0.03334084955181694,4712548410,4785069606.8,34.520534409399446,45.75644713226,NaN,NaN,0.09678311131532413,2.2465851520314453
2007-02-14T09:30:00-05:00,44.05,44.71001,44.03999,44.60001,133439008,124291233.6,57.6020509579842,50.43370787446927,NaN,NaN,131.29763632502556,5.160493961411743,0.012479339182325591,0.04894002352972393,0.03646068434739834,4845987418,4760500982.8,33.05439378088229,44.280028936570666,NaN,NaN,2.534197288623472,2.2876726001160206
2007-02-15T09:30:00-05:00,44.63,44.86,44.55,44.86,110463568,120361284,60.40861315937783,51.52842774002619,NaN,NaN,193.9294915305068,37.08648472898863,0.05582082845848922,0.10623671992050987,0.05041589146202065,4956450986,4775932874,34.92396579878658,43.368691579611024,NaN,NaN,5.465161486489297,2.7415995838836316
2007-02-16T09:30:00-05:00,44.67999,44.83,44.57001,44.71001,72352432,117601002.4,58.02236506268608,52.41630646036271,NaN,NaN,154.34774809512527,70.73034620462634,0.07002857075034051,0.1379516048999463,0.06792303414960578,4884098554,4803590829.2,38.25229693053116,42.88474609464463,NaN,NaN,7.114888354841247,3.3663551225918624
2007-02-20T09:30:00-05:00,44.64999,45.12,44.42999,45.05,93673936,116111436.8,61.71420544425088,53.54856436916574,NaN,NaN,165.49081640249796,120.04925558165382,0.09634082115810151,0.18834906059723266,0.09200823943913115,4977772490,4875371571.6,45.975053635313195,42.96388400023279,NaN,NaN,9.699410301375638,4.2710772909895445
2007-02-21T09:30:00-05:00,44.92,45.21001,44.83,45.19,95875568,114244528,63.15132659911098,54.37592879787532,NaN,NaN,173.19222726555063,163.65158392374124,0.11587813629824978,0.23685590981194338,0.1209777735136936,5073648058,4947591501.2,52.42248985977846,43.47168136706485,NaN,NaN,12.25616065587089,5.411803485972594
2007-02-22T09:30:00-05:00,45.36,45.55,45.07001,45.42,116330064,114177996.8,65.44608744606221,55.41411550933875,NaN,NaN,178.11213302141292,173.01448326301872,0.13562435495267117,0.29050821720453257,0.1548838622518614,5189978122,5016389642,57.61214474364856,44.30300825072931,NaN,NaN,15.116268047987482,6.7981555662604345
2007-02-23T09:30:00-05:00,45.41499,45.46001,45.06,45.25999,113475808,111931521.6,62.528668959286506,56.114267765687046,NaN,NaN,139.31608835374172,162.0918026276657,0.12926773846730516,0.31646853533599284,0.18720079686868768,5076502314,5040399907.6,59.28144356167975,44.91633161801776,NaN,NaN,16.642790365316674,8.20453196612561
2007-02-26T09:30:00-05:00,45.48,45.5,44.75999,45.03999,102242624,109729440,58.65702582420283,56.58024000873592,NaN,NaN,104.21811059467367,152.06587512757537,0.10276054597568388,0.3156514793382925,0.21289093336260864,4974259690,5058432134.8,60.538355672870736,45.52556098500838,NaN,NaN,16.80191604182778,9.432729691225921
2007-02-27T09:30:00-05:00,44.36,44.48,43.06,43.19,317927936,120415986.4,37.58326566263885,55.61825007556005,NaN,NaN,-114.27890572188308,96.11193070269918,-0.03924345226041079,0.16383661803709515,0.20308007029750594,4656331754,4994143987.6,54.123793899801825,45.81236530509507,NaN,NaN,8.450077262236821,9.292350772798907
2007-02-28T09:30:00-05:00,43.16,43.75999,42.92999,43.33,217497056,127793276.8,39.35881606252399,54.37824893159711,NaN,NaN,-141.33233102276395,33.207019045036276,-0.11910856996782077,0.05419435783772997,0.17330292780555073,4873828810,4954180138,50.53884651165861,46.02592391095488,NaN,NaN,2.9344685831463075,8.384081888562822
2007-03-01T09:30:00-05:00,42.55,43.53999,42.24001,43.13,231931936,131493129.6,37.708533727913206,53.032666599265276,NaN,NaN,-170.60050262202697,-36.53550808365169,-0.17726611292280806,-0.04827971334795933,0.12898639957484873,4641896874,4844563888.4,42.268818668427976,45.759230209758535,NaN,NaN,-1.913344133878846,6.913021028214012
2007-03-02T09:30:00-05:00,42.78,43.14,42.47,42.48,183383248,133292820,32.882899752947566,52.013274021967064,NaN,NaN,-173.44522116314363,-99.08776998702876,-0.24708297745544858,-0.179867322244462,0.06721565521098657,4458513626,4720966150.8,35.26216185331073,45.35528536431675,NaN,NaN,-7.79776510521373,4.8114801520100485
2007-03-05T09:30:00-05:00,42.16,42.8,42.06,42.14999,172004192,136983585.6,30.732537725821103,50.97310568103221,NaN,NaN,-177.2905734763905,-155.3895068012416,-0.2995635971382851,-0.30723884121186984,-0.007675244073584719,4286509434,4583416099.6,29.417814054130844,44.87086524144439,NaN,NaN,-13.243187915884228,2.2322418565965805
2007-03-06T09:30:00-05:00,42.56,42.99001,42.5,42.85001,155643568,139947188.8,39.735240879029824,50.39511694741683,NaN,NaN,-115.70279678054357,-155.6742850129737,-0.272010199308787,-0.34768799320956845,-0.07567779390078147,4442153002,4540580349.2,27.868731286064317,44.39573644692045,NaN,NaN,-14.646830473623446,-0.179054190577709
2007-03-07T09:30:00-05:00,42.86,42.98,42.64999,42.67999,116592880,139720408,38.42884374786169,49.02560214669379,NaN,NaN,-102.27769025304885,-147.8633568590307,-0.2506413784248699,-0.38897951693186883,-0.13833813850699894,4325560122,4430926611.6,24.335967608539022,43.7729917203245,NaN,NaN,-16.17696561173053,-2.464470107885255
2007-03-08T09:30:00-05:00,43.13,43.24001,42.84,42.97,121036816,139875601.6,41.93561047397972,47.706101954879635,NaN,NaN,-73.71825623415505,-128.48690758145628,-0.20433981716930977,-0.39376290996863617,-0.1894230927993264,4446596938,4391866624.4,23.207425684019412,42.93609599784113,NaN,NaN,-16.25490928191899,-4.434532847032932
2007-03-09T09:30:00-05:00,43.33,43.34,42.64999,42.92999,128609312,141829116.8,41.583731523918395,46.53191384496766,NaN,NaN,-69.9020548517787,-107.77827431918331,-0.16543347526304947,-0.39621493687813825,-0.23078146161508878,4317987626,4363761424.4,22.402412245321457,41.80396137746901,NaN,NaN,-16.424034371667545,-6.147318779123591
2007-03-12T09:30:00-04:00,42.88,43.28,42.83,43.21001,81347808,139222369.6,45.05842580788276,45.342215299512795,NaN,NaN,-54.61009500809067,-83.24217862552334,-0.11240122500269006,-0.37128299286845134,-0.2588817678657613,4399335434,4386326624.4,24.661991042198977,40.28159976367514,NaN,NaN,-15.50208145949237,-7.483713447747702
2007-03-13T09:30:00-04:00,43,43.24001,42.36,42.37,171185376,141434638.4,37.795621146717096,43.53109348148466,NaN,NaN,-79.99591428336785,-76.10080212608818,-0.12451668011807837,-0.41452761801335924,-0.2900109378952809,4228150058,4343526035.6,23.277437728400372,38.199810325719554,NaN,NaN,-17.046366862691478,-8.84980679273967
2007-03-14T09:30:00-04:00,42.42999,43,42.10001,42.99001,192476944,146374504,44.86028910751136,42.060679314445316,NaN,NaN,-70.11510915296925,-69.66828590607227,-0.08337147843701675,-0.3942252859415518,-0.31085380750453506,4420627002,4362539411.6,25.284165115982077,35.89066892374338,NaN,NaN,-15.95842567828784,-9.86532377638941
2007-03-15T09:30:00-04:00,42.89999,43.06,42.72,42.89,111608432,145282975.2,43.99237328602891,40.73665819492691,NaN,NaN,-52.56570684383731,-65.43777602800871,-0.05676040220599887,-0.38180431026203365,-0.3250439080560348,4309018570,4335023738,24.29386355576962,33.391556066178374,NaN,NaN,-15.382595247488798,-10.653505415117893
2007-03-16T09:30:00-04:00,42.94,43.03999,42.61,42.83,108331312,145176362.4,43.4492599988262,39.65038920740001,NaN,NaN,-53.051239530315506,-62.06761296371608,-0.03797131765558959,-0.37250805512552176,-0.3345367374699322,4200687258,4311563664.4,23.450518694035964,30.742424853404458,NaN,NaN,-15.08725284405856,-11.28689790496656
2007-03-19T09:30:00-04:00,43.06,43.39,42.95,43.27,95920064,146354744,48.47307218349672,40.42823253031843,NaN,NaN,-21.573362224432262,-55.460266406984395,0.006925515409528793,-0.3258798432080212,-0.33280535861755,4296607322,4291018042,22.707081062039165,28.498373936421412,NaN,NaN,-13.281782685452221,-11.57188144503594
2007-03-20T09:30:00-04:00,43.25999,43.59,43.21001,43.58,81025056,145722300,51.72689596401317,41.31166680899623,NaN,NaN,5.033729231289968,-38.45433770405284,0.05752053232795451,-0.2609046932076069,-0.3184252255355614,4377632378,4320914506,26.365220734895388,26.77168638093832,NaN,NaN,-10.76229075952583,-11.45622563282021
2007-03-21T09:30:00-04:00,43.63,44.44,43.35001,44.42,173902320,149623637.6,59.238200986550396,42.84950018461317,NaN,NaN,71.36362345493285,-10.15859118247242,0.14272704699728117,-0.14001641678895993,-0.2827434637862411,4551534698,4347096045.2,29.511511155637407,25.860450130024706,NaN,NaN,-5.946920094836987,-10.669181984536893
2007-03-22T09:30:00-04:00,44.44,44.45,44.09,44.25999,114877056,149550987.2,57.40580837360287,44.60113651465997,NaN,NaN,107.88423845813281,21.931397877921604,0.18101710581955338,-0.05647208151179939,-0.23748918733135277,4436657642,4372623859.6,32.538260760905686,25.665885766281495,NaN,NaN,-2.6687345389088346,-9.526260920875742
2007-03-23T09:30:00-04:00,44.25999,44.37,44.07001,44.12,68602688,147307331.2,55.780144051248385,46.39025125219049,NaN,NaN,118.82182878370025,56.306011540724754,0.1887586659143697,-0.0015408549383906234,-0.19029952085276033,4368054954,4406097398.8,36.395016392620725,26.164257361887913,NaN,NaN,-0.49752244686916647,-8.236441138874802
2007-03-26T09:30:00-04:00,44.14,44.32001,43.63,44.3,114239440,147907172,57.44872688431065,47.6555002525677,NaN,NaN,128.02809572837344,86.22630313128589,0.19693798852053337,0.05587296479790638,-0.141065023722627,4482294394,4443234813.2,40.4618345264458,27.06376473620088,NaN,NaN,1.7948738747832598,-6.80339613692365
2007-03-27T09:30:00-04:00,44.23,44.24001,43.95,43.99001,76552064,135838378.4,53.69127015452223,48.74567356732916,NaN,NaN,113.65472306714652,107.95050189845719,0.1732440399749196,0.07549002624602252,-0.09775401372889708,4405742330,4448856803.6,41.07604695539104,28.259484689547453,NaN,NaN,2.657913634734338,-5.451780455258223
2007-03-28T09:30:00-04:00,43.785,44.03,43.50999,43.52,144630256,132195038.4,48.51050967421766,49.21530922448902,NaN,NaN,58.168106847127014,105.31139857689604,0.12020765771953976,0.05250555842052762,-0.06770209929901214,4261112074,4390772278.8,36.84666977126958,29.23371641006532,NaN,NaN,1.8478301759032427,-4.408978936520871
2007-03-29T09:30:00-04:00,43.84,43.85001,43.10001,43.57001,124430560,126819969.6,49.07358613357153,49.750298839464236,NaN,NaN,31.091104904778025,89.95277186622508,0.0844727452395772,0.03788883225045936,-0.046583912989117834,4385542634,4380549277.2,36.141336044151714,30.215068109981768,NaN,NaN,1.352290993990513,-3.585940375019245
2007-03-30T09:30:00-04:00,43.56,43.87,43.2215,43.53,120431744,123672394.4,48.615528453407215,50.00437759985884,NaN,NaN,30.6251825508239,72.3134426196498,0.0555179454206756,0.02281351878672666,-0.03270442663394894,4265110890,4359960464.4,34.700642899868754,30.9321146712439,NaN,NaN,0.8181806892413539,-2.9567802229820166
2007-04-02T09:30:00-04:00,43.67,43.75999,43.3,43.59,89618064,119553088,49.37861496899467,50.83173430145009,NaN,NaN,25.775962007449685,51.86301587546505,0.038586515247823555,0.015528717425830507,-0.023057797821993048,4354728954,4334447376.4,32.9479260016268,31.622863833617213,NaN,NaN,0.5722066358903573,-2.452639243143106
2007-04-03T09:30:00-04:00,43.82001,44.31,43.78999,44.16,105852944,117063556.8,56.0552437914867,51.63137392173405,NaN,NaN,91.96560183476846,47.52519162898943,0.06253773585877556,0.0551143720014764,-0.0074233638572991575,4460581898,4345415290,34.480048524104774,32.27971264848312,NaN,NaN,2.2538617478211216,-1.780281958719645
2007-04-04T09:30:00-04:00,44.2,44.38,44.13,44.34,85167056,115492265.6,57.941743770504324,52.62775752776802,NaN,NaN,109.14774542511603,57.72111934458724,0.0858264223515164,0.09985966408209634,0.014033241730579946,4545748954,4402342666,41.9005784127796,33.53733513826955,NaN,NaN,4.213710239085729,-0.923997359033163
2007-04-05T09:30:00-04:00,44.28999,44.58,44.23,44.56,54245328,112152691.2,60.19113206996717,53.82360553284951,NaN,NaN,117.79378042043268,75.06165444771818,0.10983610464096502,0.15132837253178621,0.041492267890821194,4599994282,4445232995.6,46.79020648840928,35.2044556950105,NaN,NaN,6.533329978351868,0.14133511773612717
2007-04-09T09:30:00-04:00,44.71001,44.75,44.38,44.45,63054144,108874932.8,58.50624769641955,54.540260926629706,NaN,NaN,112.88765055659724,91.51414804887284,0.11172889814818292,0.18115339057604984,0.06942449242786693,4536940138,4499598845.2,52.27320091937198,37.316321399105696,NaN,NaN,8.024778694714787,1.2675413430187925
2007-04-10T09:30:00-04:00,44.44,44.67999,44.41,44.67999,76420192,108628552,60.966480761790784,55.200231269328114,NaN,NaN,108.07747089985433,107.97444982735378,0.12110274564075507,0.22080292447881078,0.09970017883805571,4613360330,4551325120.4,56.83112106180099,39.49245713674181,NaN,NaN,10.004067192141386,2.51561646432202
2007-04-11T09:30:00-04:00,44.64,44.66,44.07001,44.21001,116874432,105913004.8,53.929662274807036,54.821049932775004,NaN,NaN,66.992124552652,102.97975437093048,0.08972771246780561,0.21185981942281273,0.12213210695500712,4496485898,4558505920.4,57.43878674526474,41.487262536000905,NaN,NaN,9.75748347925701,3.5501688950270185
2007-04-12T09:30:00-04:00,44.13499,44.62,43.95,44.56,114810496,102029682.4,57.832858011315814,54.85155347832593,NaN,NaN,70.5448720169787,95.25917968930301,0.08658086360821932,0.23035818646528128,0.14377732285706196,4611296394,4571615408.4,58.584958301117744,43.34774093173034,NaN,NaN,10.700794301130856,4.571686810184709
2007-04-13T09:30:00-04:00,44.57001,44.72,44.28999,44.64999,94573440,101177932.8,58.799410980187595,55.06721540182159,NaN,NaN,93.1011599067757,90.32065558657162,0.08450192892833006,0.24940473401747454,0.16490280508914448,4705869834,4592790518.8,60.43821729541938,45.06511242478739,NaN,NaN,11.75502806331809,5.597878417775192
2007-04-16T09:30:00-04:00,44.83,45.14999,44.83,45.06,73009632,99411848.8,62.96476120292755,55.46121785315137,NaN,NaN,168.0700159665498,101.35712866856213,0.10343165514444538,0.2941923740197012,0.19076071887525584,4778879466,4641178384.4,64.36266624269606,46.772314690233834,NaN,NaN,13.936487456888935,6.789108280505727
2007-04-17T09:30:00-04:00,45.14,45.2,44.96001,45.16,81867808,98709236,63.92277434095392,56.19203958075362,NaN,NaN,169.16354238578072,113.5743429657474,0.11451701985238677,0.3339069936907393,0.21938997383835251,4860747274,4690655773.2,67.8721226543704,48.68632009730379,NaN,NaN,16.014527609589376,8.107025327517677
2007-04-18T09:30:00-04:00,44.92999,45.23,44.83,45.00999,82028560,98759411.2,61.35866176234699,57.10976472990573,NaN,NaN,140.3893395809645,128.2537859714099,0.10388851601814592,0.3492506188610349,0.245362102842889,4778718714,4747102336.4,71.3397330494113,51.15011033145678,NaN,NaN,17.045771847344756,9.383989116064402
2007-04-19T09:30:00-04:00,44.81,45.25,44.72,45.14999,95458496,94837220,62.85614164244916,58.094232980539836,NaN,NaN,125.16489643961164,139.1777908559365,0.09847832152422664,0.3684600047481723,0.26998168322394567,4874177210,4799678499.6,74.13949631462653,53.86426463649069,NaN,NaN,18.33637000866455,10.662900672150137
2007-04-20T09:30:00-04:00,45.52,45.67,45.2,45.39999,122425312,95214632.8,65.4323188920832,59.29543229758813,NaN,NaN,159.30964478269973,152.4194878311213,0.10341796456974689,0.39925413893612927,0.2958361743663824,4996602522,4857825037.2,76.83473930139832,56.87384295088566,NaN,NaN,20.191255422087416,12.024094207855462
2007-04-23T09:30:00-04:00,45.44,45.60001,45.34,45.47,85394192,96054208,66.14054741105696,60.49271318630686,NaN,NaN,142.09752236745217,147.2249891113018,0.10286348925338573,0.42441553593311454,0.3215520466797288,5081996714,4918448486.8,79.2615640441373,60.181959953922124,NaN,NaN,21.937211445947437,13.440253813297172
2007-04-24T09:30:00-04:00,45.63,45.83,45.33,45.7,108180320,95751252,68.42900994774723,61.37655362603975,NaN,NaN,140.69775115488972,141.53183086512357,0.10887021483390968,0.45763981522211594,0.34876960038820626,5190177034,4984334438.8,81.5266456199096,63.542431175051036,NaN,NaN,24.105856939252224,14.963911402719322
2007-04-25T09:30:00-04:00,45.85001,46.32001,45.7,46.31,106889872,97268142.4,73.53739032535881,62.49052837995793,NaN,NaN,169.1764002423986,147.28924299741038,0.14267706655336054,0.5271159335799069,0.3844388670265464,5297066906,5088004077.2,84.41167780754579,66.5789382746772,NaN,NaN,27.74353948348665,16.789572557114656
2007-04-26T09:30:00-04:00,46.42,46.64999,46.33,46.55,99400752,95006667.2,75.23522538188823,63.565106473666575,NaN,NaN,179.4053972967923,158.1373431688465,0.16819856222063512,0.5946870698023403,0.4264885075817052,5396467658,5192462166.8,86.67055289388037,69.42753444649655,NaN,NaN,31.339724879646113,18.868165746047723
2007-04-27T09:30:00-04:00,46.37,46.7,46.28999,46.57001,96556880,93612983.2,75.37707332014766,64.77016544679002,NaN,NaN,158.73825629186072,158.0230654706787,0.172766471843656,0.6424465973862752,0.4696801255426192,5493024538,5291746570,88.39227683315602,72.00746844033827,NaN,NaN,34.282224195793766,21.070174096011442
2007-04-30T09:30:00-04:00,46.5,46.53,45.92,45.96001,93433808,92263086.4,63.446443741458296,64.94730565962341,NaN,NaN,110.94063728665797,151.79168845451986,0.12336208618383826,0.6238827332724171,0.5005206470885788,5399590730,5355265373.2,89.34086821470355,74.32959323697416,NaN,NaN,33.256771826456,22.811116628932094
2007-05-01T09:30:00-04:00,45.97,46.14,45.66,46.11,135060560,94535211.2,64.91685806606793,65.73210535899918,NaN,NaN,83.33329065088756,140.31879635371942,0.09093839016780925,0.6141936347983403,0.5232552446305311,5534651290,5424160224.4,90.26968133038194,76.67465713591112,NaN,NaN,32.86072479352671,24.246774938159895
2007-05-02T09:30:00-04:00,46.09,46.58,46.05,46.42,91980944,93841611.2,67.79990257574691,66.44403711360141,NaN,NaN,107.7692221103346,128.03736072730663,0.08086176257399036,0.624332447848019,0.5434706852740286,5626632234,5490073290,91.07129380681192,78.99510967203214,NaN,NaN,33.40387846390748,25.554932584695266
2007-05-03T09:30:00-04:00,46.53,46.72,46.42999,46.59,98013808,94483948.8,69.29029430602137,67.19338592258953,NaN,NaN,116.43498115252868,115.44327749845391,0.07620130475381903,0.6387223162163025,0.5625210114624835,5724646042,5555708966.8,91.79608314273486,81.23495723255466,NaN,NaN,34.302104472531134,26.804528568671817
2007-05-04T09:30:00-04:00,46.77,46.89,46.42,46.63,93601568,96451760.8,69.6462948899666,67.6706383288066,NaN,NaN,109.81958317046175,105.6595428741741,0.06670993163533812,0.6459084260066561,0.579198494371318,5818247610,5620753581.2,92.45014376505628,83.24120562700897,NaN,NaN,35.13355179500875,27.994389029577093
2007-05-07T09:30:00-04:00,46.64999,46.78,46.57001,46.63,47671504,95682628.8,69.6462948899666,68.07946122516465,NaN,NaN,99.51488236079848,103.37439188900221,0.05198343587994214,0.6441777892212457,0.5921943533413035,5818247610,5704484957.2,93.20153977117981,85.05044970678107,NaN,NaN,35.81331249220494,29.111378095666787
2007-05-08T09:30:00-04:00,46.47,46.77,46.3,46.73,95182560,96620747.2,70.63334436507509,68.74193855393095,NaN,NaN,84.735598819993,103.65485352282329,0.041010939535012225,0.6434580277600688,0.6024470882250565,5913430170,5780240733.2,93.80251666472387,86.65493425073196,NaN,NaN,36.655932420749856,30.189171570678653
2007-05-09T09:30:00-04:00,46.49001,46.97,46.46001,46.83,116026560,96578353.6,71.62695855948967,69.36842547657669,NaN,NaN,91.43731204001365,100.3884715087591,0.03287310145623701,0.6435384650453528,0.6106653635891158,6029456730,5860805632.4,94.3722799956799,88.10013308509292,NaN,NaN,37.640366909375736,31.253628047635377
2007-05-10T09:30:00-04:00,46.67,46.78,46.07001,46.19,171249008,99400279.2,58.082206478969695,68.84341744706859,NaN,NaN,46.271384552545385,86.35575218876244,-0.020361424491365687,0.5852135829749088,0.6055750074662745,5858207722,5887517968.4,94.55114886223535,89.36559091086698,NaN,NaN,34.48125668180768,31.714717852517136
2007-05-11T09:30:00-04:00,46.24001,46.78,46.17999,46.78,102189248,99781069.6,64.70786697266995,68.74108313004095,NaN,NaN,67.30256085562017,77.85234772579413,-0.020528904610236376,0.579913876703479,0.6004427813137154,5960396970,5915947840.4,94.74266936911239,90.47138414836522,NaN,NaN,33.72227127985792,32.0015111992801
2007-05-14T09:30:00-04:00,46.77,46.88,46.19,46.46001,118943632,102077769.6,59.23888239215488,68.08464544749863,NaN,NaN,54.611839075966394,68.87173906882771,-0.045452855269859205,0.5436267122263914,0.5890795674962506,5841453338,5920588986,94.7749569261535,91.4176920988112,NaN,NaN,31.263689585994825,31.89610811166792
2007-05-15T09:30:00-04:00,46.41,46.7,45.99001,46.10001,179469632,106957860.8,53.73628162903083,66.67028054061807,NaN,NaN,16.12350053794401,55.14931941241791,-0.08703687585145425,0.4802834726819327,0.567320348533387,5661983706,5870299693.2,88.43714117279846,91.70522519632925,NaN,NaN,27.33514556997909,31.244542034283803
2007-05-16T09:30:00-04:00,46.21001,46.56,45.91,46.55,144717440,110092304.8,58.878127718155376,65.50191642178001,NaN,NaN,20.89658185252863,41.0411733749209,-0.08499315826624165,0.4610789007005849,0.5460720589668265,5806701146,5825748576.4,83.13331981174434,91.4525656904624,NaN,NaN,25.716874801403794,30.454875286729518
2007-05-17T09:30:00-04:00,46.5,46.57001,46.28999,46.33,110221872,110830473.6,55.62321656644931,64.09092665365868,NaN,NaN,23.599992414242998,36.50689494726042,-0.09827503464187959,0.423228265664477,0.5215033003063566,5696479274,5793402886.8,79.40965971664872,90.81095018214045,NaN,NaN,23.326587471991004,29.436548456052588
2007-05-18T09:30:00-04:00,46.48,46.71001,46.38,46.71001,104965936,109957504.8,59.761186590317166,63.827694000005756,NaN,NaN,66.39588616112025,36.325560008360455,-0.08195121334903199,0.41906428362006665,0.5010154969690986,5801445210,5761612534.8,75.81534873883516,89.84484164814982,NaN,NaN,22.686275616115672,28.47222376463303
2007-05-21T09:30:00-04:00,46.74001,47.24001,46.67,47.00999,112880752,111331832.8,62.716667781535214,63.670537551110556,NaN,NaN,161.05426737492135,57.61404566815145,-0.05284738024433516,0.43495627166367967,0.48780365190801483,5914325962,5776187059.6,76.34399774189299,88.85014996325776,NaN,NaN,23.133109642799386,27.70949317579965
2007-05-22T09:30:00-04:00,47.03999,47.28,46.87,47.05,98131008,110829367.2,63.10589300020005,63.33525115285721,NaN,NaN,185.5103554084698,91.49141664225661,-0.03372918254227508,0.445642173730171,0.4793713562724461,6012456970,5846281712.4,78.74982911383871,87.9700453423311,NaN,NaN,23.60576968060023,27.123246962199733
2007-05-23T09:30:00-04:00,47.19,47.37,46.8,46.83,119406368,111455192,59.43184938073848,62.631076515337,NaN,NaN,148.93379044610714,117.0988583609723,-0.03838835031105059,0.4313859183836328,0.4697742686946834,5893050602,5863551603.6,79.30818589488808,87.07805268177063,NaN,NaN,22.87911346754192,26.516942177248616
2007-05-24T09:30:00-04:00,46.855,47.03999,45.97,46.16,206285184,116799413.6,49.90304810146025,61.220844601872265,NaN,NaN,-45.37253402442375,103.30435307323896,-0.08633692274190558,0.36185311526730146,0.44819003800920704,5686765418,5861608832.4,79.05653187910423,86.12136611848834,NaN,NaN,19.03037943363489,25.447433213875225
2007-05-25T09:30:00-04:00,46.25999,46.56,46.17999,46.45,87143120,116328725.6,53.38671494129412,60.059446034109946,NaN,NaN,-40.16440379539438,81.99229508193602,-0.09744317538568786,0.3263860687770972,0.42382924416278506,5773908538,5856101498,78.29805681567302,85.05683162166643,NaN,NaN,16.99248378299376,24.239583295177873
2007-05-29T09:30:00-04:00,46.49001,46.86,46.41,46.81,99706000,116642335.2,57.35148840184513,59.110742036736376,NaN,NaN,44.95280042049569,58.7720016910509,-0.08018583845080474,0.32359694609927914,0.4037827845500839,5873614538,5847959213.2,77.12001640889731,83.86522446053597,NaN,NaN,16.581782967227674,23.145611819756414
2007-05-30T09:30:00-04:00,46.48,47.2,46.35001,47.19,134470560,116612835.2,61.11155094663177,58.35964149296081,NaN,NaN,109.89209768871278,43.64835014709951,-0.04459629815847477,0.34803741185199044,0.3926337100104652,6008085098,5847084838.8,76.98606196180901,82.62335174383091,NaN,NaN,17.480596256863052,22.33632388220022
2007-05-31T09:30:00-04:00,47.32001,47.52,47.21001,47.41,110695248,117548550.4,63.137814963814996,58.72075638473548,NaN,NaN,219.44966053725014,57.7515241653281,-0.00949133269296043,0.38076954414426467,0.3902608768372251,6118780346,5892230787.6,79.01302531019519,81.51348577582803,NaN,NaN,18.866501597610185,21.840634984401643
2007-06-01T09:30:00-04:00,47.58,47.77,47.37,47.44,125090688,118902394.4,63.41773197596204,58.62860388497063,NaN,NaN,203.62441688567174,107.55091434734723,0.011365926902720591,0.40446828546562585,0.39310235856290526,6243871034,6003651910.8,82.99400850807437,80.67429571432532,NaN,NaN,20.050551108912913,21.584908716474683
2007-06-04T09:30:00-04:00,47.27,47.64,47.24001,47.58009,65379888,117491310.4,64.76332493080315,59.023206923445514,NaN,NaN,157.25210806902675,147.03421672023143,0.029199409833319978,0.4296016208545552,0.40040221102123524,6309250922,6110720387.6,85.78450385814226,80.03212049518164,NaN,NaN,21.42926061470916,21.562673273365323
2007-06-05T09:30:00-04:00,47.42999,47.58,47,47.58,151167632,122666116.8,64.76167683968083,59.81073515277766,NaN,NaN,115.78734083388188,161.20112480290868,0.03519027601147012,0.4443900560355729,0.4091997800241028,6158083290,6167614138,87.00476069423105,79.92980760385542,NaN,NaN,22.548535456947945,21.70351072816284
2007-06-06T09:30:00-04:00,47.37,47.38,46.9614,47.07001,183196944,127066836,56.056425438841075,59.60918498996949,NaN,NaN,61.008294951413134,151.42436425544875,0.0008235357963772838,0.4102291997695744,0.4094056639731971,5974886346,6160974387.6,86.07612830779979,80.14000821071652,NaN,NaN,20.99455275943922,21.60223101834518
2007-06-07T09:30:00-04:00,46.91,47.21001,46.32001,46.3399,221448496,132337932.8,46.43352106894784,58.952778168719384,NaN,NaN,-32.22917782842071,101.08859658231458,-0.07108643010301507,0.32054762634442824,0.3916340564474433,5753437850,6087905888.4,76.4107592655968,79.92580103564138,NaN,NaN,16.344559520541925,20.85113509008757
2007-06-08T09:30:00-04:00,46.33,46.92999,46.16,46.91,177603376,132655651.2,53.19063098883561,58.48345276861356,NaN,NaN,-28.368331151195044,54.69004697494121,-0.07961973826427837,0.2921093836170954,0.37172912188137375,5931041226,6025339926.8,69.2411930678257,79.45621848771214,NaN,NaN,14.60484349607159,19.95880771951386
2007-06-11T09:30:00-04:00,46.89,47.19,46.75999,46.82001,97135184,132402948,52.07398227781006,57.723260946918906,NaN,NaN,17.287424284585374,26.697110218052934,-0.08992638727121482,0.2593211377923552,0.34924752506357004,5833906042,5930270950.8,60.024920081995376,78.29057008343374,NaN,NaN,12.881736426828608,18.94779753484454
2007-06-12T09:30:00-04:00,46.57001,47.03999,46.45,46.53999,154028000,134157166.4,48.65138266530474,56.69079592299782,NaN,NaN,-32.678016878082566,-2.9959613243399517,-0.1127265506214673,0.20833933678673588,0.3210658874082032,5679878042,5834629901.2,52.45992494171904,76.41271978542518,NaN,NaN,10.357909292456418,17.720670643074808
2007-06-13T09:30:00-04:00,46.74001,47.09,46.53999,47.05,147994432,132583406.4,54.51514601239532,56.33960282525902,NaN,NaN,4.28932877739359,-14.339754559143866,-0.09148738892724306,0.20670665124914933,0.2981940401763924,5827872474,5805227126.8,50.35866429572973,74.34489681405672,NaN,NaN,10.088158929622585,16.63031182686735
2007-06-14T09:30:00-04:00,47.10001,47.49001,47.09,47.36,101547440,130424906.4,57.67869400576199,56.89500610413772,NaN,NaN,87.74208840765951,9.654498688072174,-0.056314276105514594,0.22780119504449914,0.28411547115001373,5929419914,5840423539.6,52.79605596833167,72.46914853471584,NaN,NaN,10.89732114503676,15.811313158034407
2007-06-15T09:30:00-04:00,47.75,47.87,47.64999,47.73,100395248,129933575.2,61.151691353272376,57.44964727642188,NaN,NaN,161.46759648522251,47.62168421535568,-0.01029405390197885,0.27124790377254016,0.281541957674519,6029815162,5860178326.8,54.15661435819404,70.74475978775305,NaN,NaN,12.713912657889587,15.368827372299434
2007-06-18T09:30:00-04:00,47.85001,47.87,47.67,47.77,75748192,128472688,61.519338223669926,57.74735083512365,NaN,NaN,142.25330255505375,72.61485986944936,0.019076103397214494,0.3053870869210371,0.2863109835238226,6105563354,5914509789.2,57.762414903705206,69.36207396595363,NaN,NaN,14.2628312723841,15.210827929454386
2007-06-19T09:30:00-04:00,47.63,47.86,47.50999,47.75999,109648624,128311081.6,61.362835123703114,57.76529970491446,NaN,NaN,112.76639479779743,101.70374220462536,0.03323569073635613,0.3278555969442678,0.2946199062079117,5995914730,5977717126.8,61.55126845493155,68.25958871546237,NaN,NaN,15.461634627421514,15.246657457735404
2007-06-20T09:30:00-04:00,47.83,47.92,47.24001,47.31,161910128,131500037.6,54.634167338178614,57.15789630308329,NaN,NaN,65.80103286047704,114.00608302124206,0.00896507194774021,0.3058262461425869,0.2968611741948467,5834004602,5978943552.4,61.623202728189504,67.0174585310334,NaN,NaN,14.518680712036543,15.142660779778424
2007-06-21T09:30:00-04:00,47.30499,47.78999,47.08,47.74001,143186256,132689032,59.234381792564875,56.85908557569778,NaN,NaN,66.87694462846068,109.83305426540228,0.0180185613643844,0.3193843759003272,0.3013658145359428,5977190858,5988497741.2,62.216259257320154,65.53333358455095,NaN,NaN,15.11703865341624,15.139000476012399
2007-06-22T09:30:00-04:00,47.64,47.71001,47.14,47.28999,153411744,130045360,53.15912099184352,56.03021386577209,NaN,NaN,35.356013922655606,84.6107377528889,-0.008718169302160184,0.29046810290824254,0.2991862722104027,5823779114,5947290531.6,58.04957600921475,63.552267309627545,NaN,NaN,13.702920459214779,14.933846187898453
2007-06-25T09:30:00-04:00,47.31,47.58,46.82001,47.09,136607440,132518576,50.67187254660023,55.02379927340919,NaN,NaN,-11.658233990461875,53.82843044378577,-0.04050973198750141,0.24854910722602597,0.2890588392135274,5687171674,5863612195.6,50.63387415497036,60.95434684253748,NaN,NaN,11.768627287538406,14.481672059275589
2007-06-26T09:30:00-04:00,47.32001,47.32001,46.74001,46.82001,128146496,133940600.8,47.44448446578728,54.408660632476774,NaN,NaN,-58.02419577138786,19.67031232994872,-0.07817790579857975,0.19133645696530266,0.2695143627638824,5559025178,5776234285.2,44.273657465882145,57.9684560681148,NaN,NaN,9.146425739362401,13.719494013573705
2007-06-27T09:30:00-04:00,46.74001,47.56,46.7,47.53999,141226256,134278385.6,55.57106078440197,55.0613420407235,NaN,NaN,3.2834531649203145,7.166796390837376,-0.05419904178885726,0.2017655605278108,0.25596460231666807,5700251434,5749483651.6,42.513020491590915,55.54718901282866,NaN,NaN,9.440940619472766,13.108272100130714
2007-06-28T09:30:00-04:00,47.52,47.85001,47.47,47.52,116577568,134572501.6,55.315313083928665,55.21310504751587,NaN,NaN,76.03289886232763,8.997987237610763,-0.039937646564807416,0.2060425441106588,0.24598019067546623,5583673866,5670780253.2,37.755810611092144,53.29823312306198,NaN,NaN,9.59202276400192,12.60595076639803
2007-06-29T09:30:00-04:00,47.78999,47.88,47.21001,47.60001,124789248,134557429.6,56.18448783664609,55.50671258743272,NaN,NaN,64.45364618581758,14.817513690243151,-0.026041786063608408,0.21342795809595572,0.23946974415956412,5708463114,5647717053.2,36.467996963872295,51.61559575748175,NaN,NaN,9.972016554360144,12.229674450392617
2007-07-02T09:30:00-04:00,47.71001,48.048,47.67999,48.00999,80904816,135333676,60.43165498614343,56.34816061034977,NaN,NaN,127.55447588546413,42.66005566542835,0.008013789413672423,0.24948698092665467,0.24147319151298224,5789367930,5668156304.4,38.470989158367686,50.61638605867093,NaN,NaN,11.603331763673141,12.140196923718406
2007-07-03T09:30:00-04:00,48.10001,48.32001,48.03999,48.31,34793232,129514956,63.23972514189126,56.9713448338852,NaN,NaN,162.84148728697767,86.83319227710146,0.04588354060156108,0.29882761726493356,0.2529440766633725,5824161162,5721183501.2,43.45205104692564,50.12305654089921,NaN,NaN,13.853948018001946,12.385018508616055
2007-07-05T09:30:00-04:00,48.35001,48.77,48.28999,48.66,73578192,124034018.4,66.24901178871187,57.58351038981023,NaN,NaN,188.95797738527457,123.9680971211723,0.08724441544185552,0.36199959596569187,0.27475518052383635,5897739354,5760681085.2,46.90024038617234,49.70192685645926,NaN,NaN,16.722822254859935,13.004704758079466
2007-07-06T09:30:00-04:00,48.71001,48.91,48.5,48.86,65805504,116251868.8,67.86773566900607,58.06322784093407,NaN,NaN,192.02944320902958,147.1674059905127,0.1188537563052679,0.4233223759054212,0.3044686196001533,5963544858,5836655283.6,52.85531569477717,49.608976951929485,NaN,NaN,19.60174718301235,13.947139390212735
2007-07-09T09:30:00-04:00,48.89999,48.98,48.72,48.89,66769120,110710156,68.11476687551568,58.534329887494486,NaN,NaN,179.71160499154493,170.21899775165815,0.13157411610929237,0.46893626473676875,0.3373621486274764,6030313978,5901025456.4,57.23174086941264,49.57107166376573,NaN,NaN,22.00510862221987,15.098277851928039
2007-07-10T09:30:00-04:00,48.62,48.89999,48.42999,48.48,104391312,111072962.4,61.19095864020414,58.52205299581599,NaN,NaN,123.93501134318986,169.4951048432033,0.1034087501402502,0.46662308630278915,0.36321433616253895,5925922666,5928336403.6,58.97196145415255,49.38683544942437,NaN,NaN,22.100236183883645,16.098557613635982
2007-07-11T09:30:00-04:00,48.37,48.81,48.32001,48.81,99583568,108350740.8,64.33348679445938,59.21486152840747,NaN,NaN,113.34460709945188,159.59572880569817,0.09808286013600587,0.48581791133254626,0.3877350511965404,6025506234,5968605418,61.46191788271924,49.375315103319345,NaN,NaN,23.126738482789072,17.102583452086424
2007-07-12T09:30:00-04:00,49.05,49.67,48.92,49.56,107659248,106333981.6,70.23296778941382,60.00047481389668,NaN,NaN,174.28729813943772,156.6615929565308,0.13393137127200927,0.555149265286552,0.4212178940145427,6133165482,6015690643.6,64.19792679448429,49.51686278454536,NaN,NaN,26.033567889162068,18.378438371668658
2007-07-13T09:30:00-04:00,49.62,49.97,49.5699,49.89999,74212688,104967244,72.45706105422445,61.378899104066754,NaN,NaN,181.7520292427105,154.606110163267,0.167236824142853,0.630263924193109,0.46302710005025594,6207378170,6064457306,66.82493961946102,50.14367447099151,NaN,NaN,29.18100134136466,19.9216616530538
2007-07-16T09:30:00-04:00,49.89999,50.08,49.75999,49.85001,77664624,103830712.8,71.6100169465482,62.87448084692018,NaN,NaN,157.78630358716975,150.22104988239195,0.1719342695764613,0.6779449370208326,0.5060106674443713,6129713546,6084337219.6,67.86025481549743,51.37413023245773,NaN,NaN,31.407931412696655,21.56255733300278
2007-07-17T09:30:00-04:00,49.97,50.3,49.92,50.23,124721504,106279378.4,74.09002402653624,64.77773367268796,NaN,NaN,152.24881225336944,155.88381006442788,0.18550233025841323,0.7378885802673878,0.5523862500089746,6254435050,6150039696.4,71.0732657571268,53.28838796754663,NaN,NaN,34.100175866806026,23.35364569497467
2007-07-18T09:30:00-04:00,49.94,50.17,49.64,50.17,144849440,108039419.2,73.0055788479798,66.02305639151496,NaN,NaN,121.70841378651428,157.55657140184036,0.17541712932749443,0.7716576616683426,0.5962405323408482,6109585610,6166855571.6,71.84895316607104,55.3838117300095,NaN,NaN,35.947052922686524,25.152703870362078
2007-07-19T09:30:00-04:00,50.41,50.66,50.31,50.32001,116498624,105768844,74.02908115469494,67.3597541108554,NaN,NaN,137.0811615677775,150.11534408750833,0.16403774161262452,0.8012877093566289,0.6372499677440043,6226084234,6185439322,72.7195895418611,57.881224510778715,NaN,NaN,37.78495352821818,26.95731096434152
2007-07-20T09:30:00-04:00,50.28999,50.36,49.74001,50.05,163696368,106794349.6,68.96079217203659,68.27234727766901,NaN,NaN,98.66730550435904,133.49839933983804,0.12526513865044564,0.7938313910570614,0.6685662524066157,6062387866,6156441261.2,69.1269792164428,60.214008957390895,NaN,NaN,37.896540978647614,28.52005810924239
2007-07-23T09:30:00-04:00,50.21001,50.31,49.92,50.07001,107449872,104496256,69.12946884860739,68.89361969641644,NaN,NaN,91.3903224836161,120.21920311912729,0.08957841725287286,0.7805392739727068,0.690960856719834,6169837738,6164466099.6,69.57494220116699,62.43571988901942,NaN,NaN,38.03402688619706,29.8791965059502
2007-07-24T09:30:00-04:00,49.71001,50.10001,49.05,49.33,175521568,106441962.4,56.82974647860118,68.43576407761,NaN,NaN,42.49732857663889,98.26890638378117,0.008989755354235185,0.702198050912628,0.6932082955583928,5994316170,6112442323.6,63.175234670077636,63.84451871924456,NaN,NaN,34.31508869662878,30.512895390332854
2007-07-25T09:30:00-04:00,49.57001,49.67,49.06,49.39999,170786432,108573959.2,57.59816848342967,67.81784669866128,NaN,NaN,27.300267469787677,79.38727712043587,-0.04384616391074059,0.638400590669967,0.6822467545807076,6165102602,6123545722,63.93766446200091,65.06147758180374,NaN,NaN,31.53354716343631,30.65870278649049
2007-07-26T09:30:00-04:00,49.07001,49.47,48.05,48.98,318571264,117441209.6,51.65626203148626,66.6598842959813,NaN,NaN,-24.769548717982698,47.01713506328384,-0.10768690019847704,0.5476381293326114,0.6553250295310884,5846531338,6047635142.8,55.48038972962263,65.24898287000698,NaN,NaN,27.232064314460082,30.16918300477186
2007-07-27T09:30:00-04:00,48.89,49.12,47.99001,47.99001,246373056,123930984,40.93612361694814,64.71855263465504,NaN,NaN,-72.94975450781197,12.693723060849601,-0.21120923385702517,0.39131348720980696,0.6025227210668321,5600158282,5955189226,47.27860387108133,64.53804451298332,NaN,NaN,19.28012253116032,28.61360293711307
2007-07-30T09:30:00-04:00,48.21001,48.73,47.95,48.55,165934496,125988246.4,47.56490400634508,63.74526301795082,NaN,NaN,-77.42759011628196,-21.06985945913002,-0.23477892106307552,0.30904906973798774,0.5438279908010633,5766092778,5874440234,41.50667551210159,63.290524088551116,NaN,NaN,14.940583615263172,26.660314462563083
2007-07-31T09:30:00-04:00,48.97,48.99001,47.42999,47.53,260235008,134954756,38.98287248346265,61.93450485287963,NaN,NaN,-120.55621427913613,-53.68056803028503,-0.30729643846573856,0.15970744271889004,0.4670038811846286,5505857770,5776748554,35.81063055225552,61.45828927923228,NaN,NaN,7.764283512373654,23.960881469678878
2007-08-01T09:30:00-04:00,47.39,47.92999,46.98,47.89999,301155840,148272886.4,43.000321592279256,59.98931583879859,NaN,NaN,-148.3632867061455,-88.81327886547167,-0.31728571419396673,0.0703967384421702,0.38768245263613693,5807013610,5705130755.6,32.31004211258413,59.18058323052512,NaN,NaN,3.6670384837417926,21.061761043116437
2007-08-02T09:30:00-04:00,47.94,48.42999,47.78999,48.34,177369936,153462473.6,47.43302670941962,58.20188481416967,NaN,NaN,-88.71494462849225,-101.60235804757357,-0.2823681739303613,0.034722235223185294,0.3170904091535466,5984383546,5732701197.2,34.94642038900902,56.90354614263568,NaN,NaN,1.9902516248758149,18.33725969765349
2007-08-03T09:30:00-04:00,48.25,48.31,47.14999,47.42,166029056,158473651.2,40.3648175355404,55.97008485624054,NaN,NaN,-125.40894587758144,-112.09419632152746,-0.30728343333485925,-0.06701388251502749,0.24026955081983176,5818354490,5776340438.8,38.99643728761486,54.841844890644076,NaN,NaN,-2.1017489523469792,15.417401319081995
2007-08-06T09:30:00-04:00,47.46001,48.02,47.03,47.97,190869056,164678648,45.58523088679076,53.93402820340158,NaN,NaN,-108.05139253327012,-118.2189568049251,-0.2738823064352969,-0.10208333222428934,0.17179897421100754,6009223546,5824966592.4,43.23704445706914,52.85354336921138,NaN,NaN,-3.442048511421126,12.72319420043869
2007-08-07T09:30:00-04:00,47.88,48.62,47.48,48.31,167364128,167827288.8,48.58177275137232,52.18947062507248,NaN,NaN,-67.44090940355633,-107.59589582980914,-0.21845801686595773,-0.10127354687143963,0.11718446999451809,6176587674,5959112573.2,52.95321678864419,51.50384791368089,NaN,NaN,-3.431165660788126,10.415428505977717
2007-08-08T09:30:00-04:00,48.50999,49.06,48.39999,48.84,164838432,171090032,52.93290780257069,50.682601099920745,NaN,NaN,-19.259378239927987,-81.77511413656563,-0.1395122023029772,-0.057205782884203416,0.08230641941877379,6341426106,6065995072.4,58.97823264926351,50.5223224213525,NaN,NaN,-1.8978433653240085,8.656389667220328
2007-08-09T09:30:00-04:00,48.19,48.97,47.69,47.71001,242420688,177828104,44.32134772507821,48.92264078228085,NaN,NaN,-63.053816647918495,-76.64288854045088,-0.15558072884403157,-0.11216949163626566,0.04341123720776589,6099005418,6088919446.8,60.15680959884664,49.88159602009563,NaN,NaN,-3.7255917549880504,6.887535178333417
2007-08-10T09:30:00-04:00,47.21001,47.83,46.63,47.28,246994496,186467194.4,41.55104832694421,46.952753602162055,NaN,NaN,-117.73190127306806,-75.1074796195482,-0.18533437667128586,-0.18825673363134143,-0.0029223569600555777,5852010922,6095650733.2,60.51552924021051,49.23449509431303,NaN,NaN,-6.146806065969856,5.025486429147235
2007-08-13T09:30:00-04:00,47.67999,47.88,47.48,47.60001,116937312,188430828.8,44.339300733017055,46.06057890604891,NaN,NaN,-80.04616813230793,-69.50643473935575,-0.1738189192609472,-0.22019600603623957,-0.04637708677529238,5968948234,6087595670.8,59.82144296343823,48.99493854383878,NaN,NaN,-7.103257482292499,3.2928087275129876
2007-08-14T09:30:00-04:00,47.69,47.74001,46.73,46.78999,153528064,189871156.8,39.23697944635862,44.74906540340097,NaN,NaN,-114.14739436540803,-78.8477317317261,-0.20876015167588807,-0.30732727637015245,-0.09856712469426439,5815420170,6015362170,53.85609328580689,48.27482631696778,NaN,NaN,-9.687295132308135,1.4385081761099703
2007-08-15T09:30:00-04:00,46.67999,47.09,45.813,45.89999,214791008,193368235.2,34.534650794168826,43.52609317216402,NaN,NaN,-165.05656229046133,-108.00716854183277,-0.27561619025545836,-0.4430873625135874,-0.167471172258129,5600629162,5867202781.2,44.13459204408841,47.46441219657248,NaN,NaN,-13.54844177408282,-0.7024846739175707
2007-08-16T09:30:00-04:00,45.53999,45.91,40.55,45.45,362401280,205663368,32.419134531075244,42.917736808887376,NaN,NaN,-291.7304044082652,-153.7424860939021,-0.33026251172434196,-0.5802993119135564,-0.2500368001892145,5238227882,5695047274,36.00241921654279,46.65897043553401,NaN,NaN,-17.35444160497398,-3.0813356640684866
2007-08-17T09:30:00-04:00,46.31,46.58949,45.589,46.31,223226560,208639877.6,39.98566166316702,42.37636235580323,NaN,NaN,-120.02667759917077,-154.20144135912264,-0.2900381320856522,-0.6125844652962797,-0.32254633321062753,5461454442,5616935978,33.02872128860301,46.05340227671268,NaN,NaN,-17.914915027291865,-5.200418430243255
2007-08-20T09:30:00-04:00,46.48,46.72,46.08,46.53,144675632,210501165.6,41.781401847672186,42.57625731038962,NaN,NaN,-91.16404645492734,-156.42501702364652,-0.23264151266354566,-0.6133482240400596,-0.38070671137651396,5606130074,5544372346,30.50776449273029,45.67462612960373,NaN,NaN,-17.757092432073822,-6.994229001933336
2007-08-21T09:30:00-04:00,46.48,47.1272,46.39,47.02,115016816,207475928,45.67998199355969,42.767661624766795,NaN,NaN,-52.79061154045016,-144.15366045865497,-0.14972948536360292,-0.5678685680810176,-0.4181390827174147,5721146890,5525517690,29.86980901225492,45.5003237652945,NaN,NaN,-16.354094494150626,-8.331352643678663
2007-08-22T09:30:00-04:00,47.375,47.7,47.27,47.66,115399680,204706590.4,50.35603830074914,42.97644816700462,NaN,NaN,7.969249028138889,-109.54849819493491,-0.04525736684117487,-0.47471079126888327,-0.4294534244277084,5836546570,5572701171.6,33.61118176734642,45.404949578032884,NaN,NaN,-13.63724489679901,-9.089337251267285
2007-08-23T09:30:00-04:00,47.82001,47.85001,47.23,47.53,118647680,194710411.2,49.42532184087156,43.623627045956844,NaN,NaN,13.512288243614602,-48.49995966455896,0.018215147640252893,-0.40668448987739225,-0.42489963751764515,5717898890,5668635373.2,40.55515906419197,45.5162868477884,NaN,NaN,-11.763513072581446,-9.471362368597879
2007-08-24T09:30:00-04:00,47.38,48.24001,47.32001,48.2,88181936,186800855.2,54.130793876886116,44.23402440239223,NaN,NaN,49.8909222373641,-14.516439697251986,0.10367518555873784,-0.29530565556922284,-0.3989808411279607,5806080826,5737560650,45.005775555098914,45.64262478336195,NaN,NaN,-8.659080915584557,-9.355322161024548
2007-08-27T09:30:00-04:00,48.05,48.2,47.84,47.88,72472256,182127743.2,51.65865414039401,44.45380164446521,NaN,NaN,57.756859169474446,15.26774142762837,0.1350208368960485,-0.23020479500790003,-0.3652256319039485,5733608570,5763056349.2,46.598471173242686,45.18871438226184,NaN,NaN,-6.851697731439439,-8.997661528226676
2007-08-28T09:30:00-04:00,47.60001,47.7,46.71001,46.74001,105748624,174403424,43.95687326358038,43.81265632025161,NaN,NaN,-22.132007914911227,21.399462152736152,0.07816786230178685,-0.26751580402671493,-0.3456836663285018,5627859946,5744398960.4,45.5586581647051,44.230173347650535,NaN,NaN,-7.723587954816198,-8.815651017739464
2007-08-29T09:30:00-04:00,47.05,48.12,47.05,48.08,113164000,165003832,52.85448850906247,44.422166376250495,NaN,NaN,41.19608720525004,28.04482978815837,0.12710239408287183,-0.18680567372491197,-0.3139080678077838,5741023946,5725294435.6,44.46453209591927,43.10929638315572,NaN,NaN,-5.3684213940642485,-8.32318964292872
2007-08-30T09:30:00-04:00,47.83,48.74001,47.75,48.33,138910432,163080856.8,54.31188474008712,45.33365469147498,NaN,NaN,88.09642507164384,42.96165715376424,0.169926948948111,-0.10149938162264505,-0.27142633057075605,5879934378,5757701533.2,46.798572179979644,42.129513735996376,NaN,NaN,-3.0438985713192706,-7.56900520412737
2007-08-31T09:30:00-04:00,48.86,49.06,48.61,48.87,94645184,159511663.2,57.376821760743134,46.264906193455424,NaN,NaN,126.20294578128916,58.22406186254925,0.2247967793399436,0.00956964360417345,-0.21522713573577015,5974579562,5791401280.4,49.19000516395587,41.370125321747636,NaN,NaN,-0.12685561318193692,-6.505840976849451
2007-09-04T09:30:00-04:00,48.92,50,48.91,49.67999,98453632,154890892,61.54409458423583,47.85827156044665,NaN,NaN,161.17054154032533,78.90679833671943,0.30105776162114667,0.16109506629066317,-0.1399626953304835,6073033194,5859286205.2,53.70446142194813,41.35929447432915,NaN,NaN,3.7394622367185217,-5.042226232054027
2007-09-05T09:30:00-04:00,49.55,49.64999,48.87,49.17999,113989680,152222169.6,57.788143912942814,49.519235354644785,NaN,NaN,127.33889099455146,108.80097811861197,0.3024419038236956,0.23808968444913603,-0.0643522193745596,5959043514,5925522918.8,57.65759874054291,42.3252235240759,NaN,NaN,5.693240601096046,-3.508588113032588
2007-09-06T09:30:00-04:00,49.23,49.36,48.81,49.14,99211056,148940800.8,57.48596690499591,51.309723381353415,NaN,NaN,114.76825380821202,123.51541143920437,0.2854895715051816,0.2925097450069174,0.00702017350173581,5859832458,5949284621.2,59.00981483039075,43.96860892506504,NaN,NaN,7.140913998661008,-1.9872306685049317
2007-09-07T09:30:00-04:00,48.53,48.60001,47.95,48.23,152405808,144440056.8,50.956244011883314,52.09333640626172,NaN,NaN,52.518132204978706,116.39975286587135,0.20176026728588609,0.25922050760909343,0.057460240323207346,5707426650,5914783075.6,56.20323369574609,45.62393123986097,NaN,NaN,6.361005229864791,-0.7946255401664
2007-09-10T09:30:00-04:00,48.62,48.75,47.81,48.2,125186320,138349648,50.75157739940529,52.73406323138552,NaN,NaN,47.59135569642143,100.6774348488978,0.13626537094588262,0.22779195400556063,0.09152658305967801,5582240330,5836315229.2,50.339187088634304,47.04046142528269,NaN,NaN,5.680660072252607,0.13041526160774386
2007-09-11T09:30:00-04:00,48.50999,48.98849,48.42999,48.92999,103033056,137654435.2,55.441449382118584,53.43131090199687,NaN,NaN,77.09525533089194,83.86237760701113,0.1338230088775197,0.25880534415657763,0.12498233527905794,5685273386,5758763267.6,45.307726061207745,48.14316978592218,NaN,NaN,6.504390813995851,1.0409831976631878
2007-09-12T09:30:00-04:00,48.84,49.37,48.78,48.94,93994816,134677772.8,55.50402299922221,53.799024094744944,NaN,NaN,85.30697803388298,75.45599501487743,0.12477633511319303,0.2809527541705492,0.1561764190573562,5779268202,5722808205.2,43.15413956324244,48.82480962848619,NaN,NaN,7.183424550321423,1.9184748194715069
2007-09-13T09:30:00-04:00,49.28999,49.35001,48.94,49.17999,80732688,127974856.8,57.0609089617643,54.34442317480871,NaN,NaN,86.94740809423632,69.8918258720823,0.12645684412966324,0.3142474742194352,0.18779063008977198,5860000890,5722841891.6,43.1568656979263,49.010645816610065,NaN,NaN,8.189821352571888,2.8143814670572755
2007-09-14T09:30:00-04:00,48.8,49.31,48.73,49.22,99782624,114843924,57.328967286172286,54.57286413261487,NaN,NaN,78.70682035426496,75.12956350193953,0.1217223712959083,0.33994359420965736,0.21822122291374907,5959783514,5773313264.4,47.239430945742086,49.17019263022744,NaN,NaN,9.094075102019548,3.711480557766172
2007-09-17T09:30:00-04:00,48.99001,49.10001,48.59,48.81,84877184,107926455.2,53.63395199938921,54.71395683682881,NaN,NaN,52.28211176688527,76.0677147160323,0.084219284205891,0.3234953281711128,0.2392760439652218,5874906330,5831846464.4,51.58252365576105,49.52619637897875,NaN,NaN,8.888704629305222,4.451083996557465
2007-09-18T09:30:00-04:00,49.09,52.77,48.83,50.03999,151412192,108263283.2,61.624835183034584,55.97595411678982,NaN,NaN,187.0989621120161,98.06845607225712,0.13261181602959282,0.4050408140022128,0.27242899797262,6026318522,5900055491.6,56.11589359023614,50.28028462365955,NaN,NaN,11.113918539137305,5.402917502640299
2007-09-19T09:30:00-04:00,50.28999,50.59,49.98,50.17,126863120,108855598.4,62.363193762677,56.65514734919087,NaN,NaN,146.61187444359214,110.32943535419895,0.16180483823118108,0.4746850457615963,0.31288020753041523,6153181642,5974838179.6,60.484386535874734,51.42455994079922,NaN,NaN,13.143136572152436,6.508663083999175
2007-09-20T09:30:00-04:00,50.06,50.25999,49.92,50.03,109953008,108583264.8,61.00207003373587,57.13301772730864,NaN,NaN,120.38042986010426,117.01603970737253,0.15983343993146137,0.512672007444742,0.3528385675132806,6043228634,6011483728.4,62.456638410323805,52.54299324296666,NaN,NaN,14.442968981893934,7.642135355126998
2007-09-21T09:30:00-04:00,50.28,50.52,50.0143,50.36,86835632,106992662.4,63.04928161960547,57.53819343151309,NaN,NaN,128.69311575673294,127.01329878786615,0.1680621398268446,0.5629162422968363,0.39485410246999175,6130064266,6045539878.8,64.24278204056276,53.61819159129573,NaN,NaN,16.132961441502395,8.855110510323483
2007-09-24T09:30:00-04:00,50.49001,50.96001,50.33,50.59,107181184,107942624.8,64.45002647732056,57.74575999530486,NaN,NaN,141.8297903361835,144.9228345017258,0.17548788762247824,0.6142139619980895,0.4387260743756113,6237245450,6118007702.8,67.75790721875,54.62200914821015,NaN,NaN,17.955821062298998,10.155212017748557
2007-09-25T09:30:00-04:00,50.42,51.07001,50.36,51.07001,101038064,109370915.2,67.24110779647941,58.42097170127175,NaN,NaN,139.33100265918873,135.3692426111603,0.197576172365448,0.6856962898324213,0.48812011746697326,6338283514,6180400701.2,70.45124930183263,55.53584133115941,NaN,NaN,20.355830928219998,11.612443290673049
2007-09-26T09:30:00-04:00,51.36,51.50999,51.12,51.32001,96099936,108888480.8,68.62283197937235,59.216462063727214,NaN,NaN,154.81141578462726,137.00915087936733,0.21256772990401207,0.7538297798469884,0.5412620499429763,6434383450,6236641062.8,72.66762129604216,56.511398935848796,NaN,NaN,22.78569169327173,13.208621633901432
2007-09-27T09:30:00-04:00,51.62,51.64999,51.36,51.58,73419680,106901264.8,70.0381750805009,60.579457140057045,NaN,NaN,148.01168730045742,142.53540236743797,0.2224783677058122,0.8193600095752416,0.5968816418694294,6507803130,6329555962,75.88572266701057,57.91729100522483,NaN,NaN,25.26041383538721,14.930306234113687
2007-09-28T09:30:00-04:00,51.53999,51.67999,51.17999,51.41,75434560,103727471.2,67.88202138077605,61.80306028158352,NaN,NaN,122.050397496342,141.20685871535977,0.20073682097255485,0.847802668085123,0.6470658471125681,6432368570,6390016822.8,77.72369549289428,59.87332731981483,NaN,NaN,26.78155075077811,16.623341165065746
2007-10-01T09:30:00-04:00,51.45,52.16,51.38,52,100370624,104013743.2,71.19624478255959,62.92840281018645,NaN,NaN,133.29409066881985,139.49971878188705,0.20833993066494538,0.9074907604437499,0.6991508297788045,6532739194,6449115571.6,79.37824265385504,62.30693564786106,NaN,NaN,29.102338041297454,18.406055004527417
2007-10-02T09:30:00-04:00,52.03999,52.06,51.72,52.00999,71035936,102642858.4,71.25034069336671,64.05313978833962,NaN,NaN,121.8965984561218,136.01283794127366,0.19644740289514062,0.9447100833977302,0.7482626805025896,6603775130,6502213894.8,80.76088038203645,64.99313142063207,NaN,NaN,31.026628796758526,20.20899411770329
2007-10-03T09:30:00-04:00,51.84,52.07001,51.5,51.64999,106743440,102280546.4,66.41005639765547,64.72093603376042,NaN,NaN,99.00634137042717,124.85182305843364,0.1488991724101384,0.9343866460152626,0.7854874736051242,6497031690,6514743542.8,81.08319008364381,67.70215459104045,NaN,NaN,31.394602597484493,21.806938186243464
2007-10-04T09:30:00-04:00,51.75,51.83,51.34,51.77,84114320,101525709.6,67.20975835865794,65.42670682465226,NaN,NaN,85.30386901341393,112.31025940102495,0.11178894051673649,0.9252236492510448,0.8134347087343083,6581146010,6529412118.8,81.4744744435952,70.1475148408871,NaN,NaN,31.91748322208459,23.251301762792195
2007-10-05T09:30:00-04:00,52.17,52.89999,52.06,52.81799,115667680,99688803.2,73.20827591763017,66.82487281881232,NaN,NaN,131.67693349505777,114.23556660076811,0.1421331496620193,0.9911011458118324,0.8489679961498131,6696813690,6582301142.8,82.85176713323378,72.38103223213515,NaN,NaN,34.24076410078008,24.82122495393332
2007-10-08T09:30:00-04:00,52.8,53.16,52.71001,53.14999,63004256,96579700,74.78216029888131,67.76468175565851,NaN,NaN,143.44252464805754,116.26525339661563,0.16714904274037123,1.0579042995752772,0.890755256834906,6759817946,6627716893.2,83.95489033632369,74.36953199971285,NaN,NaN,36.67521935932888,26.514652726132685
2007-10-09T09:30:00-04:00,53.27,53.45,53.03,53.3801,94197056,96137900,75.84147423169091,68.72741607487379,NaN,NaN,144.15274178067108,120.7164820615255,0.18063052783707134,1.1165434166312451,0.9359128887941738,6854015002,6677764867.6,85.09294030621629,76.12728584045153,NaN,NaN,39.01837298666269,28.30089847763697
2007-10-10T09:30:00-04:00,53.39,53.57001,53.21001,53.50999,91766560,96026487.2,76.44301007252412,69.83034036335867,NaN,NaN,138.6761718184774,128.65044815113552,0.17936824796508166,1.1601231987505258,0.9807549507854442,6945781562,6767514842,86.88887707849015,77.87244574532055,NaN,NaN,41.13085851526159,30.133749911583344
2007-10-11T09:30:00-04:00,53.78999,53.94,52.28,52.66,239746880,103977196.8,65.0316225769059,69.971936146023,NaN,NaN,102.35457709991755,132.06058976843624,0.1059885637003859,1.1132406554109266,1.0072520917105408,6706034682,6792492576.4,87.34579410518548,79.5226608927936,NaN,NaN,39.549581862828546,31.47886876176123
2007-10-12T09:30:00-04:00,52.89999,53.53999,52.8,53.53,131652880,105570709.6,69.97255752869962,70.36640264969292,NaN,NaN,114.45975685362306,128.6171544401493,0.10077794602576096,1.133224524242742,1.032446578216981,6837687562,6820667350.8,87.85974014391115,80.95850610173368,NaN,NaN,39.73294506803077,32.65802251979974
2007-10-15T09:30:00-04:00,53.61,53.71001,52.7,53.12,121523440,107403022.4,65.29053830864417,70.2270762577047,NaN,NaN,98.24461676721624,119.57757286398105,0.05665122481326201,1.1032606092335584,1.0466093844202964,6716164122,6811936586,86.684836406343,82.11804803777014,NaN,NaN,38.347565505929865,33.470814374961186
2007-10-16T09:30:00-04:00,52.78999,53.28,52.67999,52.87,193617376,109513281.6,62.542507672248476,69.7927673786244,NaN,NaN,73.08376636251045,105.36377778034891,0.0005275460854621272,1.047268817027124,1.046741270941662,6522546746,6745642934.8,78.14024193257437,82.50894951180815,NaN,NaN,36.348999693343444,33.88198370615865
2007-10-17T09:30:00-04:00,53.62,53.66,52.67999,53.55,183967872,112368519.2,66.65374017372893,69.55102202814071,NaN,NaN,87.33798780533958,95.09614097772138,-0.0008242722481632825,1.0457109306314578,1.046535202879621,6706514618,6697789546,72.57884589858601,82.27274402834927,NaN,NaN,35.92736605302155,34.17418118428192
2007-10-18T09:30:00-04:00,53.33,53.89,53.12,53.78,144491120,114095424.8,67.93565541917732,69.55485303088365,NaN,NaN,98.47964249972503,94.32115405768285,0.0035086449220755878,1.0509210090322156,1.04741236411014,6851005738,6726783757.2,73.79577070858274,81.992177972327,NaN,NaN,35.98424914864618,34.43276232204824
2007-10-19T09:30:00-04:00,53.77,53.77,52.39,52.44,245090256,122008156,54.733935750339526,68.37897381429649,NaN,NaN,39.61441940798346,79.35208656855494,-0.08902422360859763,0.936132084599393,1.0251563082079906,6605915482,6680429341.2,68.55739299938847,81.21926013986511,NaN,NaN,31.376995072387277,33.99622414352525
2007-10-22T09:30:00-04:00,52.16,53.1185,52.02,53.07001,206904944,126994344,58.788791551707725,67.48886316132085,NaN,NaN,23.40223602922707,64.38361042095711,-0.11149562403200053,0.88578677816799,0.9972824021999905,6812820426,6699760602,69.52881607328368,80.41696983209705,NaN,NaN,28.99028890687499,33.2810905382895
2007-10-23T09:30:00-04:00,53.61,54.21001,53.34,54.17999,162288688,130056875.2,64.7756390512896,67.37211906515184,NaN,NaN,122.5355972032741,74.27397658910984,-0.057991180436560485,0.9247934266542899,0.9827846070908504,6975109114,6790273075.6,73.63591781513719,79.88502181291801,NaN,NaN,29.106404282534797,32.6847067874674
2007-10-24T09:30:00-04:00,53.74001,53.94,52,53.77,298323712,140168064,61.23697473143832,66.94549166320758,NaN,NaN,54.03309658601195,67.61299834524432,-0.05654010189428027,0.912109479723,0.9686495816172803,6676785402,6784327232.4,72.94040679519816,79.27544555231823,NaN,NaN,27.954470259840974,32.008958712092195
2007-10-25T09:30:00-04:00,53.88,53.98,52.75,53.05,233618128,148177986.4,55.50261394610737,65.68080152238453,NaN,NaN,52.352773084051485,58.3876244621096,-0.10744637969205728,0.8343416070022087,0.941787986694266,6443167274,6702759539.6,64.00855075156565,77.92950152505621,NaN,NaN,24.989594124518124,31.006192342438755
2007-10-26T09:30:00-04:00,54.08,54.2,53.44,53.92999,146681056,151740311.2,60.38528779637172,64.65245348649098,NaN,NaN,119.79973979728982,74.42468853997089,-0.08614812694732488,0.8341028280101099,0.9202509549574348,6589848330,6699546109.2,63.67772714599855,76.48113272574726,NaN,NaN,24.230824429500895,30.038282640590488
2007-10-29T09:30:00-04:00,54.19,54.33,53.84,54.16,101883568,151815958.4,61.572210092225966,63.633220333672064,NaN,NaN,143.03426382872598,98.35109409987066,-0.061993819016245455,0.8427586811871279,0.9047525002033734,6691731898,6675328403.6,61.11413492022843,74.76836091246243,NaN,NaN,24.036746964266772,29.18092040111567
2007-10-30T09:30:00-04:00,53.94,54.56,53.89999,54.25999,114600944,153994208.8,62.103774956956244,62.608989253988646,NaN,NaN,150.7284361562077,103.98966189045737,-0.045471875956173746,0.8479126552581562,0.8933845312143299,6806332842,6641573149.2,57.63145131106339,72.67854478621766,NaN,NaN,24.05107570075227,28.4480854439209
2007-10-31T09:30:00-04:00,54.47,55.07001,54.03999,55.03,148405680,156077320.8,66.00378646394475,62.67842953163428,NaN,NaN,199.2753436978158,133.03811131281813,0.008262891824234009,0.9037131459946224,0.8954502541703884,6954738522,6697163773.2,61.520526351618166,70.83388280381999,NaN,NaN,25.31931670489892,28.001118481203473
2007-11-01T09:30:00-04:00,54.67999,54.77,53.97,54,181936816,160968445.6,57.48205633827259,61.786250875175206,NaN,NaN,117.00436830661769,145.96843035733139,-0.032386193962722354,0.8549675117169855,0.8873537056797078,6772801706,6763090659.6,65.55822548115688,69.24091747076604,NaN,NaN,23.57110559333957,27.368259497222915
2007-11-02T09:30:00-04:00,54.42,54.55009,53.60001,54.42,217867184,166078420.8,59.76333158916765,61.3914503952126,NaN,NaN,94.92591566183374,140.99366553024018,-0.03745293117751225,0.8405375417078176,0.8779904728853298,6990668890,6843254771.6,69.71902499749832,68.0290737987057,NaN,NaN,22.898383125306783,26.729705729806327
2007-11-05T09:30:00-05:00,53.86,54.39999,53.59,54.07001,150572944,170456855.2,57.01791774917983,60.99683682927912,NaN,NaN,63.14823153260987,125.01645907101695,-0.06900533507159157,0.7917338040458404,0.8607391391174319,6840095946,6872927581.2,71.11025320243046,67.52693174655256,NaN,NaN,21.483294405329307,25.98021839773818
2007-11-06T09:30:00-05:00,54.33,54.69,53.78,54.67999,131861248,172340064.8,60.42974122033299,60.55226547546512,NaN,NaN,100.12208371902221,114.89518858357985,-0.054084092725592114,0.7931340232104418,0.8472181159360339,6971957194,6906052451.6,72.62243345895683,67.53004514372192,NaN,NaN,21.364123800149052,25.320776312368306
2007-11-07T09:30:00-05:00,54.22,54.58,53.31,53.35001,197763744,177639924,50.93598623863561,59.33800339114072,NaN,NaN,14.282275663282585,77.89657497667322,-0.13449671195272972,0.6790972259951218,0.8135939379478515,6774193450,6869943437.2,68.41828410472648,67.14593895773217,NaN,NaN,18.014303495273563,24.27699448135477
2007-11-08T09:30:00-05:00,53.14,53.33,50.8,51.73,380564736,184680816.8,42.23253162137515,58.44504595335754,NaN,NaN,-196.84898175299716,15.125904964750248,-0.2886498781392629,0.45278159027377285,0.7414314684130358,6393628714,6794108838.8,60.49728984600757,66.57021730391926,NaN,NaN,11.797500101829991,22.494209569994087
2007-11-09T09:30:00-05:00,50.73,51.12,50,50,309385728,193567459.2,35.29649173516363,56.76702453789011,NaN,NaN,-286.50068585610154,-61.1594153388368,-0.487302640253781,0.13230316809580955,0.6196058083495906,6084242986,6612823658,46.606335751205464,64.93289728091368,NaN,NaN,3.71746423643837,19.81181737948613
2007-11-12T09:30:00-05:00,49.92,50.24001,48.64999,48.73,283136768,201648125.6,31.2402711736125,54.371641118056026,NaN,NaN,-286.5405748170962,-131.09717660877803,-0.67296639430291,-0.221602184529047,0.45136420977386305,5801106218,6405025712.4,36.31363198775273,62.26701972181478,NaN,NaN,-4.3795843304528,16.355902849494854
2007-11-13T09:30:00-05:00,49.39,50.78999,49.35001,50.74001,255280688,204731291.2,42.50236590895853,53.033454773593185,NaN,NaN,-167.14912151427063,-184.55141765543658,-0.6298996869151885,-0.33601039887012263,0.29388928804506587,6056386906,6221911654.8,30.02168927680684,59.20139704192969,NaN,NaN,-6.641449338321478,13.070566822663949
2007-11-14T09:30:00-05:00,51.39,51.44,49.89999,50.09,263213632,208693579.2,40.20879294684918,51.94103898793189,NaN,NaN,-129.00147586994234,-213.20816796208155,-0.6140473788160596,-0.4736699354750087,0.14037744334105096,5793173274,6025707619.6,25.019456716347605,56.416461753699835,NaN,NaN,-9.208724491088843,9.887810920699264
2007-11-15T09:30:00-05:00,50,50.53999,49.37,49.82001,251009008,214019473.6,39.261085951097,50.432167427555115,NaN,NaN,-131.74451454464162,-200.18727452041045,-0.5904320063564221,-0.5976625646044766,-0.007230558248054575,5542164266,5855414730,21.6479851750224,53.414337327201544,NaN,NaN,-11.472055797587908,6.836401389515383
2007-11-16T09:30:00-05:00,50.14,50.49001,49.34,50.28,263611376,214945529.6,41.778873322847645,49.01835765831381,NaN,NaN,-106.90986431225711,-164.2691102116416,-0.5152575201898395,-0.651302458485354,-0.13604493829551448,5805775642,5799721261.2,20.667109853805258,50.525264108171314,NaN,NaN,-12.408459686198663,4.087135521556234
2007-11-19T09:30:00-05:00,50.17,50.45,49.41,49.7,197784816,214489523.2,39.55253754276522,47.40755498587159,NaN,NaN,-98.58500275175027,-126.67799579857237,-0.4769029072819007,-0.7321735723978904,-0.25527066511598967,5607990826,5761098182.8,19.99063717110056,47.8366345267454,NaN,NaN,-13.88541674072716,1.5196280555157489
2007-11-20T09:30:00-05:00,49.95,50.78,48.92999,49.89999,300708096,221410493.6,40.725454181899956,45.60195982286839,NaN,NaN,-86.51484543577511,-110.55114058287329,-0.4127727920052483,-0.77123665512255,-0.3584638631173017,5908698922,5731560586,19.465881022553162,44.83273128895504,NaN,NaN,-14.69970426493126,-0.7974194188338237
2007-11-21T09:30:00-05:00,49.42999,50.17,48.85001,49.31,212547680,217121692,38.36064538679657,44.236144754905816,NaN,NaN,-90.32882967935943,-102.81661134475671,-0.3853227831854887,-0.8401173420991626,-0.4547945589136739,5696151242,5712156179.6,19.11096676703498,41.51506995223205,NaN,NaN,-16.094586966079365,-2.9827290684403294
2007-11-23T09:30:00-05:00,49.63,49.97,49.37241,49.84,46464848,207764028,41.63909144330021,42.94155617305814,NaN,NaN,-73.0109773944231,-91.06990391471301,-0.3099487554376724,-0.8422305032107644,-0.532281747773092,5742616090,5752246544.4,22.26446994464537,38.125458877028265,NaN,NaN,-16.28267132085851,-4.882720818785783
2007-11-26T09:30:00-05:00,49.98,50.37,48.89999,48.98,150190880,207939519.2,38.09813234327459,41.5901429297792,NaN,NaN,-75.67374659598357,-84.82268037145829,-0.2964882289492199,-0.9028920339596169,-0.606403805010397,5592425210,5709576458,21.312115974959113,34.56844907506602,NaN,NaN,-17.511927132899128,-6.686893149373404
2007-11-27T09:30:00-05:00,49.39,50.05,49.10001,49.96001,211323440,213411512.8,43.94777408602511,40.41285956304292,NaN,NaN,-60.865737842247775,-77.2788273895578,-0.204438612378963,-0.8619520704841008,-0.6575134581051378,5803748650,5748728022.8,24.503105717980645,31.131354236424862,NaN,NaN,-16.760885957723204,-8.12603497913766
2007-11-28T09:30:00-05:00,50.63,51.7,50.60001,51.48,214679056,218415418.4,51.589021838757446,40.45950496305163,NaN,NaN,-3.0303547936598783,-60.58192926113476,-0.033030050614961004,-0.6988010213738391,-0.6657709707588781,6018427706,5770673779.6,26.307076292843547,28.123410821290367,NaN,NaN,-13.558196043622543,-8.902057988349787
2007-11-29T09:30:00-05:00,51.27,51.89,51.2,51.7,171648256,219577547.2,52.59630198413037,41.199774274677,NaN,NaN,17.230067338071038,-39.07014985764867,0.09624659789166135,-0.5454627233943015,-0.6417093212859628,6190075962,5869458723.6,33.956919982361654,26.22767011674423,NaN,NaN,-10.698944301124499,-9.158756033031889
2007-11-30T09:30:00-05:00,52.21001,52.25,50.95,51.31,171404000,219050906.4,50.5868810205424,42.29194493791834,NaN,NaN,21.26596070219261,-20.214762238325527,0.15319074347105255,-0.4502208919471471,-0.6034116354181996,6018671962,5924669898,37.840693070813735,25.60155278243053,NaN,NaN,-8.950791813435078,-9.129046858803774
2007-12-03T09:30:00-05:00,51.14,51.53,50.82001,50.88,108386256,213576860,48.39167683674274,43.51704534242764,NaN,NaN,9.899680934455324,-3.100076732237746,0.15891131207771025,-0.40477249532106185,-0.5636838073987721,5910285706,5988241997.2,42.06532933063589,26.012388306922187,NaN,NaN,-8.13550299576005,-8.987112021226098
2007-12-04T09:30:00-05:00,50.46001,50.94,50.38,50.67,113341312,211715278.4,47.31187830903034,43.860581942432766,NaN,NaN,-3.916510317449699,8.289768772721873,0.14590374835950481,-0.3813041219493911,-0.5272078703088959,5796944394,5986881146,41.99952472266571,26.867947981626394,NaN,NaN,-7.767544759648367,-8.812888126714993
2007-12-05T09:30:00-05:00,51.2,52,51.16,51.57001,137521680,211998300,52.2314453591682,44.719342829026985,NaN,NaN,76.02325516304003,24.100490764061853,0.19234533296682638,-0.286776204100363,-0.47912153706718935,5934466074,5970088819.6,41.14421057283078,28.019716114232335,NaN,NaN,-5.998003508682523,-8.410761752710355
2007-12-06T09:30:00-05:00,51.63,52.37,51.61,52.32001,99763568,207098291.2,55.92469061780478,45.909600305220394,NaN,NaN,138.10625870603315,48.27572903765427,0.2636022657464162,-0.14961870488416906,-0.41322097063058527,6034229642,5938919555.6,39.53482015220958,29.297347184031416,NaN,NaN,-3.3637408881232935,-7.689758772055061
2007-12-07T09:30:00-05:00,52.28999,52.53999,52.08,52.33,88992320,192519670.4,55.973518617611866,46.923503540560695,NaN,NaN,150.9940793008128,74.22135275737831,0.29885105955779256,-0.039657146183344594,-0.33850820574113716,6123221962,5959829555.6,41.19657691505539,30.76373768840643,NaN,NaN,-1.2171687151509685,-6.7651030496401905
2007-12-10T09:30:00-05:00,52.44,52.69,52.32001,52.53999,75657872,180833277.6,57.050599892315255,48.17336513695712,NaN,NaN,140.5152351104336,100.34446359257397,0.32176524018745606,0.0636983444931829,-0.25806689569427316,6198879834,6017548381.2,45.63784422459175,32.59568104937008,NaN,NaN,0.88077690164597,-5.672834485170739
2007-12-11T09:30:00-05:00,52.61,52.84,51.21001,51.32001,167064688,175029673.6,49.477388985135136,48.798503337188215,NaN,NaN,77.17198073727931,116.56216180351979,0.24375641222534009,0.04662861958740194,-0.19712779263793814,6031815146,6064522531.6,49.012971383247674,34.70618750370541,NaN,NaN,0.6240729738010045,-4.773276276746205
2007-12-12T09:30:00-05:00,52.25,52.42999,50.89,51.78,162975120,170414395.2,52.06135023542936,49.77712511209055,NaN,NaN,63.49101024712703,114.05571282033718,0.21323653986018104,0.06941788218728817,-0.14381865767289287,6194790266,6116587370,52.5308073769363,37.093318975841214,NaN,NaN,1.154504517584002,-3.9264504489847467
2007-12-13T09:30:00-05:00,51.33,51.63,50.98,51.5,153682064,164937816.8,50.37251166070832,50.400940841905424,NaN,NaN,36.04292490593094,93.64304606031673,0.16637128473422913,0.06414544824489354,-0.10222583648933559,6041108202,6117963082,52.62382036702381,39.26184400601111,NaN,NaN,1.1211616274069678,-3.205363009500216
2007-12-14T09:30:00-05:00,51.09,51.60001,50.92,50.97,128407936,158807763.2,47.24815848418984,51.05451413768508,NaN,NaN,17.43845656531771,66.9319215132177,0.09538420470558737,0.01700441939264863,-0.07837978531293874,5912700266,6075858742.8,49.43140958220687,41.27036497795738,NaN,NaN,0.20435810999712145,-2.718259992429168
2007-12-17T09:30:00-05:00,50.78,50.9881,49.71001,49.73,134377504,152346069.6,40.86229324248213,50.83412264886059,NaN,NaN,-61.086713073191724,26.61153187649265,-0.03252864902627366,-0.11904059659578081,-0.08651194756950716,5778322762,5991747328.4,43.72481360310441,42.64334411260908,NaN,NaN,-2.5985072355761094,-2.701152455735874
2007-12-18T09:30:00-05:00,50.24001,50.27,49.17999,49.89,154251632,150169410.4,41.95248150681168,50.14579833943589,NaN,NaN,-88.16617908188734,-6.4561000873406815,-0.099997203005482,-0.21150845132635965,-0.11151124832087765,5932574394,5971899178,42.47859546152219,43.79845262465755,NaN,NaN,-4.565803605110201,-2.9675311913607776
2007-12-19T09:30:00-05:00,49.89,50.2,49.61,49.88,137971808,142032596,41.900491384393916,49.38181186802614,NaN,NaN,-79.51410012742801,-35.05712216225169,-0.13666471681032358,-0.28234214433378213,-0.14567742752345855,5794602586,5891861642,37.799992729968146,44.07295782091516,NaN,NaN,-6.1834522791995665,-3.4269484896234617
2007-12-20T09:30:00-05:00,50.67,50.96001,50.2,50.89999,167342320,139772328,48.86177647166901,49.25859011453519,NaN,NaN,-26.128518545192293,-47.49141085247633,-0.08606152159573591,-0.25325432951812843,-0.16719280792239252,5961944906,5876028982.8,36.933409540385206,44.00815185445597,NaN,NaN,-5.63018600769672,-3.74169670649107
2007-12-21T09:30:00-05:00,51.71001,51.89999,51.48,51.85001,107613120,142829741.6,54.34827955254672,49.68406173709261,NaN,NaN,57.67255601070086,-39.4445909633997,0.012319389885529441,-0.1517935705654807,-0.16411296045101015,6069558026,5907400534.8,39.8747304118098,43.85168050311125,NaN,NaN,-3.4545470701257757,-3.7006753298674564
2007-12-24T09:30:00-05:00,52.00999,52.39999,51.9501,52.24001,34499888,137045192,56.41555366325899,50.33432426239466,NaN,NaN,93.873269086035,-8.452594531554348,0.09972191189529239,-0.03946057058189467,-0.13918248247718706,6104057914,5972547565.2,45.55352456160054,44.105537634463744,NaN,NaN,-1.0208675421625308,-3.31784564590961
2007-12-26T09:30:00-05:00,52.14999,52.63,52,52.5,58492080,129403624,57.78787205216383,50.73121188332292,NaN,NaN,105.96206666470928,30.37305461776498,0.16713738655968063,0.06973925072241371,-0.0973981358372669,6162549994,6018542685.2,49.20149912256353,44.68105824515893,NaN,NaN,1.3970327712630652,-2.6442915863135132
2007-12-27T09:30:00-05:00,52.33,52.5,51.71001,51.92999,65778880,121958615.2,53.789087202463335,50.5786687822271,NaN,NaN,64.90294296265391,59.25646323578136,0.16514173569970583,0.10902903378736539,-0.05611270191234044,6096771114,6078976390.8,53.60043924925803,45.68574532351954,NaN,NaN,2.3250102731605176,-1.934391320674366
2007-12-28T09:30:00-05:00,52.03999,52.16,51.42999,51.86,67559872,116754196,53.30137018326575,50.38780103691666,NaN,NaN,39.71567352462926,72.42530164974566,0.15127886823545397,0.13298588338197703,-0.01829298485347694,6029211242,6092429658,54.54411011257829,46.639140551914025,NaN,NaN,2.950236554864062,-1.2365873384545907
2007-12-31T09:30:00-05:00,51.56,51.67999,51.21001,51.22,70137744,111690883.2,48.932216797673746,49.807916530156554,NaN,NaN,-4.694799989093874,59.951830449786726,0.0939830720356406,0.09918585519107381,0.0052027831554332105,5959073498,6070332752.4,52.6500496538871,47.14001236829227,NaN,NaN,2.2558415646629606,-0.7376689237235119
2008-01-02T09:30:00-05:00,51.27,51.47,50.13,50.45,152344496,113888795.2,44.23421990252683,49.43340445282739,NaN,NaN,-69.79210364967028,27.21875590264566,0.003957395125348295,0.01014952706211858,0.006192131936770285,5806729002,6010866970,47.83589295040694,47.05593533737507,NaN,NaN,0.24387662322335985,-0.5974481313025303
2008-01-03T09:30:00-05:00,50.39999,50.75999,50.14999,50.62,114105504,113927004.8,45.47880915632671,48.9632229471772,NaN,NaN,-84.94713007964556,-10.963083446225308,-0.04188385790247857,-0.046162690441327925,-0.004278832538849357,5920834506,5962523872.4,44.29035136303223,46.467331336381925,NaN,NaN,-1.0661906283415354,-0.6644113451652452
2008-01-04T09:30:00-05:00,49.78999,49.83,48.21001,48.39999,212658560,117683848.8,34.61440660994381,47.83764401497974,NaN,NaN,-195.04847853502085,-62.95336774576026,-0.210057488718981,-0.2668506934375756,-0.05679320471859461,5708175946,5884804838.8,39.25323736754042,45.512289693561684,NaN,NaN,-6.1241762079066575,-1.444377754128304
2008-01-07T09:30:00-05:00,48.41,48.60001,47.42999,48.17,235083568,124449848.8,33.715801349676994,46.87104707680025,NaN,NaN,-202.58902257001753,-111.41430696468963,-0.31861355348280557,-0.4550601465721016,-0.13644659308929602,5473092378,5773581066,33.399106614026465,44.36712519583451,NaN,NaN,-10.411145793727595,-2.7253446169282025
2008-01-08T09:30:00-05:00,48.28999,48.75999,46.92,46.92,261700000,133085232.8,29.26848474552075,46.042917898445864,NaN,NaN,-195.42249183014857,-149.55984533290058,-0.4484802650670589,-0.6970469244231197,-0.24856665935606076,5211392378,5624044842,27.467868403973853,43.205914824468046,NaN,NaN,-15.715517643543372,-4.58108362073037
2008-01-09T09:30:00-05:00,47.09,47.96001,46.46001,47.92,254110752,142007876.8,36.48631318592521,45.65247730409682,NaN,NaN,-169.0602197609404,-169.41346855515457,-0.4402843287746442,-0.798922070324366,-0.35863774154972183,5465503130,5555799667.6,25.262892668172313,41.976221767800205,NaN,NaN,-17.72856948057066,-6.45929588642184
2008-01-10T09:30:00-05:00,47.42,48.41,47.28999,47.99001,249963632,146152824,36.97124101745618,45.30038799217271,NaN,NaN,-123.39112617025964,-177.1022677732774,-0.4043293361628394,-0.8640494117532711,-0.4597200755904317,5715466762,5514726118.8,24.013471749725184,40.991470269211426,NaN,NaN,-19.135247249232254,-8.270146081109042
2008-01-11T09:30:00-05:00,47.72,47.77,46.7,47.05,211685120,148588324,33.29544280929005,44.1885070162885,NaN,NaN,-136.40079858899017,-165.37273178407128,-0.41639589342243033,-0.9802149423684696,-0.5638190489460393,5503781642,5473847258,22.804628637897494,39.982271633319435,NaN,NaN,-21.537018413963487,-10.165413557231105
2008-01-14T09:30:00-05:00,47.69,48.00999,47.31,47.87,168048432,149306642.4,38.99353600895045,43.091739620317334,NaN,NaN,-97.23338934268763,-144.30160513860528,-0.3446601019737425,-0.9946441764132175,-0.6499840744394749,5671830074,5513594797.2,26.670013467288,39.03907756585359,NaN,NaN,-21.70164068550215,-11.813446004126968
2008-01-15T09:30:00-05:00,47.38,47.52,46.35001,46.55,241791936,154975842.4,33.963901997421075,41.48805021561463,NaN,NaN,-118.92719789427335,-129.00254635143023,-0.35994338108133517,-1.099913300791144,-0.7399699197098087,5430038138,5557323949.2,30.77676886500292,37.983595016096615,NaN,NaN,-23.550697346913765,-13.490196195953652
2008-01-16T09:30:00-05:00,46.19,46.91,45.46001,46.05,265725120,161543223.2,32.26615958395938,39.66507075360001,NaN,NaN,-124.28540425611205,-120.04758325046457,-0.3758164849237903,-1.2097405258645466,-0.8339240409407563,5164313018,5497085926.8,28.415944590069998,36.49891254948993,NaN,NaN,-25.594983648249176,-15.219451546281585
2008-01-17T09:30:00-05:00,46.24001,46.58,45.2,45.41,254456000,166553441.6,30.186189150871613,37.97914946420061,NaN,NaN,-120.13558939640745,-119.39647589569412,-0.399305096296247,-1.333055411311065,-0.9337503150148181,4909857018,5335963978,23.27348640371143,34.33270163195088,NaN,NaN,-27.952038016951054,-17.038392470662938
2008-01-18T09:30:00-05:00,45.64,46.14,44.75999,45.35001,273063168,173308009.6,29.99103182300938,36.314125295610864,NaN,NaN,-114.77638596723048,-115.07159337134219,-0.3884106681539161,-1.4192636502072133,-1.0308529820532972,4636793850,5162566419.6,19.238417368755236,31.81086643596353,NaN,NaN,-29.87388691782322,-18.87203453454298
2008-01-22T09:30:00-05:00,42.83,44.77,42.73,44.17999,325732352,181227511.2,26.40538009689618,34.70506553126961,NaN,NaN,-143.64170035200382,-124.35325557320543,-0.4264909757666939,-1.5639667017616645,-1.1374757259949706,4311061498,4890412704.4,14.878295129517625,29.112883969937133,NaN,NaN,-32.72039888302264,-20.850372298611504
2008-01-23T09:30:00-05:00,42.53999,44.14999,41.61,44.02,390156544,195354682.4,25.94853002957973,33.3989448260591,NaN,NaN,-147.0770113580537,-129.9832182659615,-0.42784165211290626,-1.6722777911361035,-1.2444361390231973,3920904954,4588586067.6,11.708917148285522,26.532385698357036,NaN,NaN,-35.14173653830412,-22.891995761424734
2008-01-24T09:30:00-05:00,44.19,44.92999,44.06,44.91,250249056,206142140.8,32.90303174633539,32.50067501105973,NaN,NaN,-101.27393629568083,-125.38092467387526,-0.33811705596594055,-1.667082458980623,-1.3289654030146825,4171154010,4389954266,10.173067526790291,24.095436852911178,NaN,NaN,-35.105127120999974,-24.636728812792626
2008-01-25T09:30:00-05:00,45.86,45.87,43.94,43.99001,199299056,213182489.6,29.78872080091466,32.15598316755764,NaN,NaN,-95.78936300423007,-120.51167939543977,-0.3107504512031105,-1.7174034670185705,-1.40665301581546,3971854954,4202353853.2,8.975596598179024,21.93274822652822,NaN,NaN,-36.04362474866793,-26.266285375060527
2008-01-28T09:30:00-05:00,44.02,44.44,43.57001,44.33,163711184,218079104.8,32.33755430532271,32.05753695010377,NaN,NaN,-102.02263298064668,-117.96092879812302,-0.24278598681402563,-1.710135499332992,-1.4673495125189664,4135566138,4102108310.8,8.406182974136058,20.147539395107476,NaN,NaN,-36.03336652914279,-27.661582682786563
2008-01-29T09:30:00-05:00,44.56,44.67999,44.03999,44.41,138520000,221627111.2,32.95431113287174,32.32081026348598,NaN,NaN,-84.80328960177226,-106.19324664807671,-0.16897697609311857,-1.6785707326353645,-1.509593756542246,4274086138,4094713238.8,8.364028656759942,18.78297941316362,NaN,NaN,-35.8464918817412,-28.830855425494367
2008-01-30T09:30:00-05:00,44.24001,45.32001,44.17999,44.37,220824368,229161442.4,32.79335526431322,32.05702755479941,NaN,NaN,-68.72326066499895,-90.52249650946574,-0.1026468942137786,-1.6379023743094692,-1.5352554800956906,4053261770,4121184602,10.101879180416915,17.70004987832395,NaN,NaN,-35.736978500815795,-29.817444436254572
2008-01-31T09:30:00-05:00,43.87,45.59,43.82001,45.13,246824000,233885417.6,38.89963463281566,32.19476995589652,NaN,NaN,-54.379325628868365,-81.14357437610326,0.0068064915505872126,-1.5267473656574566,-1.5335538572080438,4300085770,4146970954,11.855516787929147,16.831624523909948,NaN,NaN,-33.896418243180776,-30.400154980101174
2008-02-01T09:30:00-05:00,45.52,45.88,44.88,45.5899,161920256,236276155.2,42.31518326751272,32.83903713148385,NaN,NaN,-22.326266895585245,-66.4509551543743,0.11838380712522056,-1.3855740983015181,-1.5039579054267387,4462006026,4245001168.4,18.374360413769452,16.515176793615087,NaN,NaN,-31.3380352904382,-30.53413788157789
2008-02-04T09:30:00-05:00,45.58,45.61,44.94,44.95,100209808,230653717.6,39.04469854639829,32.842691598444404,NaN,NaN,-30.0549372238761,-52.05741600302018,0.154986806192688,-1.3102243976858787,-1.4652112038785667,4361796218,4290247184.4,21.26856141900953,16.129358790166627,NaN,NaN,-30.02607756178141,-30.46155783589268
2008-02-05T09:30:00-05:00,44.12,44.60001,43.64,43.66991,188990368,228349057.6,33.471503996420864,32.807520312658674,NaN,NaN,-86.27839301103673,-52.352436684873076,0.10146988999128959,-1.3383738413894548,-1.4398437313807444,4172805850,4269991126.8,20.911092669289303,15.42466763332994,NaN,NaN,-30.535132840425838,-30.472068550825988
2008-02-06T09:30:00-05:00,43.92,44.17,42.77,42.81,178284944,224178304.8,30.33868005180345,32.66984320321897,NaN,NaN,-116.7581061408156,-61.9594057800364,0.0208566375704069,-1.4137729344177359,-1.4346295719881428,3994520906,4258242954,20.69385187223739,14.873089582056181,NaN,NaN,-31.967115058072377,-30.685646623289756
2008-02-07T09:30:00-05:00,42.35001,43.78999,42.14999,43.11,286342144,225789874.4,32.7051212415391,32.84976692398093,NaN,NaN,-120.33211710000907,-75.14996407426455,0.0014610163922692543,-1.432803301497806,-1.4342643178900754,4280863050,4254398410,20.618363848905616,14.683437970998625,NaN,NaN,-32.41010868850122,-30.931998346891394
2008-02-08T09:30:00-05:00,43.17999,43.77,42.94,43.60001,173781248,221980755.2,36.49957298677413,33.3146627213927,NaN,NaN,-91.22435539489095,-88.9295817741257,0.033574835356483534,-1.392295773694471,-1.4258706090509545,4454644298,4252926064.4,20.587390538069386,14.779793197378206,NaN,NaN,-31.635468635141827,-31.03249410235574
2008-02-11T09:30:00-05:00,43.78,44.22,43.53999,44.07001,119562320,217374615.2,39.99448148887654,34.28531282081986,NaN,NaN,-54.36940089585359,-93.79247450852118,0.09493679874831384,-1.3071996106155623,-1.4021364093638762,4574206618,4295408144.4,24.12891635211615,15.440551856135244,NaN,NaN,-29.93620603840117,-30.875881521790802
2008-02-12T09:30:00-05:00,44.33,44.67999,43.50999,43.82001,145412368,216242812,38.77210393395567,35.201282385418146,NaN,NaN,-43.797675379552025,-85.29633098222425,0.1252491388030077,-1.2455749858601166,-1.3708241246631243,4428794250,4346605824.4,28.28008071495576,16.62420639661169,NaN,NaN,-28.87824748463644,-30.590505230768752
2008-02-13T09:30:00-05:00,44.39,44.88,44.16,44.78,148685808,211587505.6,45.6424210757936,36.11123876609373,NaN,NaN,17.47542316755971,-58.449625120549186,0.2114444204468222,-1.1065185991045965,-1.3179630195514187,4577480058,4463197654.8,36.76510287551352,18.523637492949064,NaN,NaN,-25.837460044046008,-29.911498775522645
2008-02-14T09:30:00-05:00,44.84,44.85001,43.89,43.97,170868880,206844693.6,41.41930296442704,36.94199463491604,NaN,NaN,-9.95058859308636,-36.373319419164645,0.21470899676586286,-1.0495767735940902,-1.264285770359953,4406611178,4488347280.4,38.4564919606769,20.62941573312748,NaN,NaN,-24.49006420890107,-29.137008123148135
2008-02-15T09:30:00-05:00,43.77,43.98,43.45,43.82001,100053248,199124556,40.66890948527133,37.537091433483795,NaN,NaN,-56.49705535923993,-29.42785941203444,0.20745401019847676,-1.004968257611857,-1.2124222678103338,4306557930,4458730006.8,37.19476112281474,22.685742743747387,NaN,NaN,-23.61897297725869,-28.348717388021072
2008-02-19T09:30:00-05:00,44.39,44.5,43.27,43.74001,110507568,190996776,40.25005314975802,38.05821586326139,NaN,NaN,-40.37986017926041,-26.629951268715807,0.19797965243356663,-0.9649477022683755,-1.162927354701942,4196050362,4383098755.6,34.11651978161103,24.525206395522467,NaN,NaN,-23.024240886265655,-27.588077887770297
2008-02-20T09:30:00-05:00,43.25,44.09,43.24001,43.94,137338752,181577096,41.862053841409455,38.705980047339686,NaN,NaN,-49.20548764521061,-27.711513721847524,0.2050279693053254,-0.9066423930702854,-1.1116703623756108,4333389114,4364017728.4,33.366256781759276,26.186947652761205,NaN,NaN,-22.081868160626854,-26.801476498178378
2008-02-21T09:30:00-05:00,44.36,44.47,43.34,43.52,127857008,168462119.2,39.454636208222226,38.74562301701159,NaN,NaN,-52.263855978092465,-41.65936955097796,0.1820292805194912,-0.8841337617262468,-1.066163042245738,4205532106,4289628138,30.545942915078044,27.521978090414695,NaN,NaN,-21.922861004989443,-26.104531427722815
2008-02-22T09:30:00-05:00,43.67,43.69,42.60001,43.67999,157364624,163817897.6,40.850082983224475,38.64097299670528,NaN,NaN,-102.42091798183723,-60.15343542872813,0.1780020652509542,-0.8436604606820453,-1.0216625259329994,4362896730,4280885248.4,30.22261035761916,28.368281657832533,NaN,NaN,-21.41506706506549,-25.434607947343196
2008-02-25T09:30:00-05:00,43.62,44.07001,43.34,43.89999,121444256,159925157.6,42.802288614018245,38.909372287249575,NaN,NaN,-39.66718835367321,-56.78746202761479,0.1895009106164508,-0.7847863876624359,-0.9742872982788867,4484340986,4316441859.6,33.314182824602156,29.228683186803437,NaN,NaN,-20.463611134333775,-24.72446554548471
2008-02-26T09:30:00-05:00,43.64999,44.48,43.37,44.07001,148375808,159158388.8,44.33141580818078,39.68508027380385,NaN,NaN,-11.162304779878943,-50.9439509477385,0.2065068837775914,-0.7161536935568975,-0.9226605773344889,4632716794,4403775146,40.30959576493509,30.614290550778133,NaN,NaN,-19.250507021422074,-23.942471470618617
2008-02-27T09:30:00-05:00,43.77,44.46001,43.67,44.28999,125682560,158516516.8,46.330630001920554,40.82736241309793,NaN,NaN,13.460122276071067,-38.41082896348216,0.22879079626024945,-0.6366720820091771,-0.8654628782694266,4758399354,4488777194,46.22267065061737,32.437777606376706,NaN,NaN,-17.68079648090089,-23.047946472087514
2008-02-28T09:30:00-05:00,44.11,44.53,43.95,44.12,129196624,153935129.6,44.986154538678264,41.7045790771793,NaN,NaN,26.34225712592188,-22.68960634267929,0.22780622448092958,-0.5807050976682646,-0.8085113221491942,4629202730,4573511318.8,51.391957506572595,34.6358914390672,NaN,NaN,-16.66253255415596,-22.135744483811578
2008-02-29T09:30:00-05:00,43.64999,43.77,42.85001,42.95,188724560,151030157.6,37.02272370779537,41.741946985823674,NaN,NaN,-116.47898883356105,-25.50122051302405,0.14795151197089962,-0.6235719321855697,-0.7715234441564693,4440478170,4589027606.8,52.29622785706008,36.90080839042368,NaN,NaN,-17.961783164578055,-21.539464295349646
2008-03-03T09:30:00-05:00,42.92999,42.99001,42.24001,42.67,133641936,149616241.6,35.40735495027441,41.41429509020923,NaN,NaN,-190.1573279934458,-55.59924844097857,0.07930914857724736,-0.6723870084349102,-0.7516961570121575,4306836234,4553526656.4,50.00413145832461,38.74903804086714,NaN,NaN,-19.528090347444447,-21.252125159934618
2008-03-04T09:30:00-05:00,42.41,43.03999,42.02,42.91,183850944,153798298.4,37.90813729877849,41.352583187696574,NaN,NaN,-161.1023595620488,-85.58725939741254,0.054297238098657385,-0.6838246093888358,-0.7381218474874932,4490687178,4525120733.2,48.18433830745281,40.1707707260455,NaN,NaN,-20.156789856327322,-21.095648687990717
2008-03-05T09:30:00-05:00,42.99001,43.53999,42.75,43.1199,183208192,153509189.6,40.092670583124395,40.95617243822021,NaN,NaN,-74.83746252224365,-103.24677635707549,0.0558985498526583,-0.6682486601716704,-0.7241472100243287,4673895370,4508219936.4,47.08635888392404,40.908003298074824,NaN,NaN,-20.090118972469465,-20.952001585773395
2008-03-06T09:30:00-05:00,43.09,43.27,42.10001,42.17,152752192,152232552,34.2244020474092,40.442250944147496,NaN,NaN,-148.5792994126976,-138.23108766479936,-0.00004656028788629918,-0.7242054103841866,-0.7241588500963003,4521143178,4486608026,45.65372511739309,41.42209138069741,NaN,NaN,-21.79929107333447,-21.073042941139263
2008-03-07T09:30:00-05:00,41.91,42.64,41.38,42.07001,242552368,150043063.2,33.66580661269367,39.94202931039195,NaN,NaN,-185.5605013989814,-152.04739017788341,-0.03488854091840621,-0.767769526244308,-0.7328809853259018,4278590810,4454230554,43.517540054942906,41.873718447277994,NaN,NaN,-23.359910082249456,-21.39973824701215
2008-03-10T09:30:00-04:00,42.00999,42.14,41.17,41.25999,146964128,148702207.2,29.4695767646172,39.171995282881895,NaN,NaN,-194.80921126779452,-152.97776683275316,-0.09990995240779388,-0.8577684258356442,-0.7578584734278503,4131626682,4419188643.6,41.266959079660104,42.38446411142435,NaN,NaN,-26.076864364166614,-22.067899120891358
2008-03-11T09:30:00-04:00,41.86,42.85001,41.50999,42.83009,196888192,152568500.8,44.03180411047382,39.326977444957926,NaN,NaN,-93.60926992857591,-139.47914890605858,-0.02831730365677043,-0.7932551029988133,-0.7649377993420429,4328514874,4386754182.8,39.243911113131205,42.80429656366521,NaN,NaN,-23.62361751595462,-22.290144605900394
2008-03-12T09:30:00-04:00,43.02,43.44,42.60001,42.71001,155566000,153076182.4,43.2955585103102,39.601329037964206,NaN,NaN,-38.98677179062961,-132.3090107597358,0.01735058828169822,-0.7432495639899201,-0.7606001522716184,4172948874,4286564883.6,33.741343108931645,43.032539434654744,NaN,NaN,-21.957503321750508,-22.24262442245041
2008-03-13T09:30:00-04:00,42.21001,43.33,41.81,43.03999,208991744,156091479.2,45.96917700860424,39.96697861120562,NaN,NaN,-50.88658333509521,-112.77046754421531,0.07305759081545826,-0.6692781637522955,-0.7423357545677538,4381940618,4258724371.6,32.38257580328859,43.186822680774,NaN,NaN,-19.747181984025154,-21.886132645532516
2008-03-14T09:30:00-04:00,43.36,43.38,41.74001,42.25,309589760,163027523.2,40.986713616938516,39.837294682842774,NaN,NaN,-71.0870431587732,-89.87577589617368,0.060496278282806015,-0.6667154067142462,-0.7272116849970522,4072350858,4217476381.2,30.427518388746492,42.980632363927164,NaN,NaN,-19.446960853561322,-21.537679532393774
2008-03-17T09:30:00-04:00,41.25999,42.00999,41.05,41.48,193130560,167681388.8,36.79995008968792,39.29933284580758,NaN,NaN,-146.5836249507853,-80.23065863277186,0.006942025047488309,-0.7185341536876919,-0.7254761787351802,3879220298,4166995104.4,28.184797330435742,42.1145753328915,NaN,NaN,-20.58620521139937,-21.401754629394574
2008-03-18T09:30:00-04:00,42.24001,43.34,42.11,43.33,216300368,172971028.8,50.0119176366431,39.56228196257347,NaN,NaN,-5.293828957158562,-62.5675704384884,0.09768805011674586,-0.6033661160892478,-0.7010541662059937,4095520666,4120396262.8,26.260627916543598,40.68871513760052,NaN,NaN,-16.704493744327127,-20.730717360099224
2008-03-19T09:30:00-04:00,43.50999,43.60001,42.23,42.25999,216157184,176911950.4,44.25003407174851,39.50970192922134,NaN,NaN,-24.907021791291736,-59.751620438620805,0.08755077013083912,-0.5916157035424447,-0.6791664736732839,3879363482,4061679184.4,24.03409009702392,38.73458175120418,NaN,NaN,-15.690542721901037,-20.010692411785197
2008-03-20T09:30:00-04:00,42.35001,43.10001,42.10001,43.09,128397008,176938950.4,49.144538667620445,40.37554585492313,NaN,NaN,-12.964406502413018,-52.167185072084365,0.1357684936306951,-0.509455856634915,-0.6452243502656101,4007760490,3986843158.8,21.528708372968723,36.53690178805479,NaN,NaN,-13.06890530795258,-19.019008539809107
2008-03-24T09:30:00-04:00,43.28,44.75999,43.28,44.5799,125075632,175324500.8,56.52323786726685,41.883823206136874,NaN,NaN,138.6143546823718,-10.22690550385536,0.2598375443657709,-0.3204274198083965,-0.5802649641741674,4132836122,3998940211.6,22.92732977775141,34.602844525156705,NaN,NaN,-8.012294512542802,-17.446620821628205
2008-03-25T09:30:00-04:00,44.67999,45.07001,44.28,44.83,118219632,175163269.6,57.63444834735605,43.292845423892416,NaN,NaN,172.35544775615094,53.560909037531886,0.34523147094908896,-0.1487256254878062,-0.49395709643689517,4251055754,4073307302.8,31.061899470833964,33.37981317968393,NaN,NaN,-3.812638885115653,-15.498909116412126
2008-03-26T09:30:00-04:00,44.69,44.85001,44.28,44.7,124824560,173985707.2,56.82149405536927,44.48776138619563,NaN,NaN,148.77359593167395,84.37439401529839,0.37686414186494044,-0.02287691910571965,-0.3997410609706601,4126231194,4079449408.4,31.703045101276587,32.28100505235197,NaN,NaN,-0.854476422304575,-13.40684730296819
2008-03-27T09:30:00-04:00,44.44,44.50999,43.71001,43.71001,143868560,174895007.2,50.92994700036085,45.68101459712074,NaN,NaN,92.42888414652249,107.84157520286124,0.31740056005946676,-0.0029903608963266493,-0.3203909209557934,3982362634,4100049238.8,33.922676533142706,31.4430730106198,NaN,NaN,-0.31396320258415017,-11.536435288627613
2008-03-28T09:30:00-04:00,44.03,44.34,43.33,43.49001,111838128,174027082.4,49.696781068714444,46.82608420112222,NaN,NaN,73.87182566978548,125.20882163730093,0.2523723339761647,-0.004925503485587512,-0.2572978374617522,3870524506,4072602042,32.41122572918451,30.649764844494193,NaN,NaN,-0.27988420660430785,-9.928356562624284
2008-03-31T09:30:00-04:00,43.64999,44.02,43.45,43.72,113644752,170273092,51.03163831641641,48.36623145482216,NaN,NaN,68.6641231461279,111.21877533005213,0.2154072866724302,0.011961270878785513,-0.20344601579364469,3984169258,4042868669.2,30.809740952418778,29.90282069254838,NaN,NaN,0.15073368509658772,-8.488486527235588
2008-04-01T09:30:00-04:00,44.45,45.61,44.41,45.59,137494368,170465713.6,60.26447820421985,49.52570817580402,NaN,NaN,166.45457078355784,110.03859993553351,0.3021401150739845,0.17422912804883595,-0.12791098702514855,4121663626,4016990243.6,29.445999570951415,29.20296986810697,NaN,NaN,3.688850183916258,-6.748866997071039
2008-04-02T09:30:00-04:00,45.69,46.02,45.17,45.49001,132486752,167897504,59.6172000487487,50.69153971426392,NaN,NaN,159.25978035059583,112.13583681931792,0.3354488993744403,0.2914001371929018,-0.04404876218153847,3989176874,3989579379.6,28.030702799092964,28.79506698883278,NaN,NaN,6.237686291573462,-4.893645098693253
2008-04-03T09:30:00-04:00,45.28999,45.91,45.14,45.59,140033744,165738781.6,60.078959807152955,51.69938134273168,NaN,NaN,133.35833970805388,120.32172793162417,0.3455241268291211,0.3878563963548629,0.04233226952574182,4129210618,4018948976.4,31.812398434715035,28.754340033934664,NaN,NaN,8.41003066437851,-2.9931199896830014
2008-04-04T09:30:00-04:00,45.78,46.35001,45.39999,45.86,139275808,165064962.4,61.36367638658532,53.15487868342074,NaN,NaN,133.0462636253982,132.15661552274673,0.3505709725382093,0.48054598519850344,0.12997501266029415,4268486426,4098541360.4,40.87890520982066,29.50086766401139,NaN,NaN,10.580192217254659,-1.054075388691907
2008-04-07T09:30:00-04:00,46.14999,46.41,45.64999,45.75999,102610752,158067881.6,60.585923629205276,54.853876793386256,NaN,NaN,122.81066222344718,142.98592333821057,0.3277893660447162,0.5397117202161894,0.2119223541714732,4165875674,4134882643.6,44.50705945695231,30.666743530191148,NaN,NaN,12.149476333845598,0.8321462859563078
2008-04-08T09:30:00-04:00,45.41,45.72,45.17999,45.41,97565936,155597972,57.82385708228841,55.41187246807522,NaN,NaN,85.55035648226351,126.80508047795172,0.27205943642323743,0.55199664970052,0.27993721327728255,4068309738,4124211866,43.65982088760052,31.909543028123785,NaN,NaN,12.733221387588593,2.532299871903777
2008-04-09T09:30:00-04:00,45.47,45.49001,44.63,44.89999,127256944,152116409.6,53.96314514993941,56.10566611651742,NaN,NaN,54.67390869820158,105.88790614747288,0.18776741012864862,0.5146464759380933,0.3268790658094447,3941052794,4114587050,42.86716869170042,33.254762927743535,NaN,NaN,12.16431007773103,3.908301329879099
2008-04-10T09:30:00-04:00,44.92999,45.84,44.92999,45.53999,112800432,149978131.2,57.773226149111856,56.72200093662394,NaN,NaN,72.71213992724671,93.75866619131143,0.1629549339412778,0.5305727332360419,0.3676177992947641,4053853226,4099515571.6,41.5937338475949,34.68797903307397,NaN,NaN,12.738040773958273,5.1696926790332665
2008-04-11T09:30:00-04:00,45.02,45.10001,44.12,44.28,120135376,145535312.8,49.14908581775153,56.195275790229985,NaN,NaN,13.084468955193024,69.76630725727038,0.055099468119384654,0.43649213444399493,0.3813926663246103,3933717850,4032561856.4,36.41800424030388,35.65159863754201,NaN,NaN,10.580577933342036,5.942676286791662
2008-04-14T09:30:00-04:00,44.21001,44.48,43.95,44.08,89274560,134519552.8,47.92613447696663,55.50182479948789,NaN,NaN,-14.241853433096493,42.355804125961654,-0.0316312704175194,0.341853578302711,0.3734848487202304,3844443290,3968275379.6,32.26633338178128,35.7376296311811,NaN,NaN,8.457438710343721,6.301928061584813
2008-04-15T09:30:00-04:00,44.24001,44.35001,43.67999,44.14,124232256,131074637.6,48.34141558295719,54.896104908601316,NaN,NaN,-35.965304963918356,18.05267183672528,-0.08391018386008608,0.26859711889512283,0.3525073027552089,3968675546,3948348541.2,31.08345651755232,35.693373303772226,NaN,NaN,6.846392828105473,6.3797087425163355
2008-04-16T09:30:00-04:00,44.69,45.48,44.64999,45.37,134027872,126961012.8,56.07487643768841,55.26359986841043,NaN,NaN,47.466958223697524,16.61128174182447,-0.03699689879784557,0.30626117925790197,0.34325807805574754,4102703418,3980678666,35.232075648205736,35.78690181199101,NaN,NaN,7.706268014935988,6.569217210004857
2008-04-17T09:30:00-04:00,45.42,45.75,44.98,45.27,125056816,122405994.4,55.34939906362698,55.66735829661847,NaN,NaN,55.587366790295796,13.186327114434288,-0.015164306769941294,0.32430269459332095,0.33946700136326224,3977646602,3965437341.2,34.18724896873377,35.913760614815956,NaN,NaN,8.188085526116993,6.800484112306591
2008-04-18T09:30:00-04:00,46.50999,46.92999,46.22,46.71001,133022432,122637265.6,62.810831441503744,56.508729234124694,NaN,NaN,165.33342838149417,43.63611899969453,0.08811809518545466,0.4496146203450806,0.36149652515962594,4110669034,4000827578,38.73078302527159,36.479549334305446,NaN,NaN,11.051331494145982,7.407748023997932
2008-04-21T09:30:00-04:00,46.61,47.08,46.49001,47.03999,83303184,120548643.2,64.28371356095104,56.795817473891205,NaN,NaN,167.00801331601073,79.88609234951598,0.16599706555087784,0.5689928570982232,0.4029957915473454,4193972218,4070733363.6,46.576464995756716,37.70315400750582,NaN,NaN,13.839690433822534,8.32659693968716
2008-04-22T09:30:00-04:00,46.73,46.77,45.92999,46.34,104689504,119872136.8,58.95006146335956,56.74816471779199,NaN,NaN,106.35129130724619,108.34941160374888,0.15776249273408377,0.6001989074649501,0.4424364147308663,4089282714,4094854797.2,49.003112624420055,39.20118328074347,NaN,NaN,14.545018387371586,9.214942860784936
2008-04-23T09:30:00-04:00,46.67999,47.06,46.27361,46.85001,131086192,120185218.4,61.459153083432085,56.84674995181193,NaN,NaN,125.09373185307494,123.87476632962436,0.17284508984764463,0.6584927770404221,0.48564768719277746,4220368906,4118387894.8,51.32601860116653,40.59501329263286,NaN,NaN,15.911184754300278,10.171548845572842
2008-04-24T09:30:00-04:00,46.87,47.78999,46.39,47.27,166694560,121326518.4,63.44088379074538,56.99512190925193,NaN,NaN,146.22529248743894,142.002351469053,0.19561296766180192,0.7301638967700299,0.534550929108228,4387063466,4200271267.6,58.42256386973081,41.848131768340735,NaN,NaN,17.650748993008378,11.240006009492204
2008-04-25T09:30:00-04:00,47.31,47.35001,46.57001,47.14999,121945376,121831880.8,62.45269989413236,57.12846307103244,NaN,NaN,121.86367039752383,133.30839987225892,0.1870969207700398,0.7684220800707777,0.5813251593007379,4265118090,4231161078.8,60.74755365137016,43.008167067942004,NaN,NaN,18.777653334573678,12.316812770218128
2008-04-28T09:30:00-04:00,47.25,47.62,47.13,47.24001,71243936,119711840,62.91927654658932,57.49242160419679,NaN,NaN,130.51594412054982,126.00998603316675,0.17239633339647864,0.7968205760463363,0.6244242426498576,4336362026,4259639040.4,62.812184178240884,44.376193017273465,NaN,NaN,19.83456918117338,13.390777971783164
2008-04-29T09:30:00-04:00,47.14999,47.75999,47.06,47.60001,91270624,117400652.8,64.80292164372997,58.26669135375329,NaN,NaN,123.9809324676131,129.53591426524014,0.1714265917065697,0.8387074822830698,0.6672808905765001,4427632650,4327309027.6,67.22387528454784,46.11595777390543,NaN,NaN,21.26489745574492,14.5156521837777
2008-04-30T09:30:00-04:00,47.69,48.06,47.03,47.21001,132152688,117383949.6,61.1772566881307,58.509836392254634,NaN,NaN,105.58603186846727,125.63437426831861,0.13085994980051463,0.8308558278271434,0.6999958780266288,4295479962,4342331238.8,68.12781347714821,48.01124917601637,NaN,NaN,21.498067400258964,15.513140071846452
2008-05-01T09:30:00-04:00,47.24001,48.72,47.22,48.7,143596880,117562106.4,68.44180569913797,59.88788781235367,NaN,NaN,138.66005148841862,124.12132606851453,0.18727962186505198,0.9340954053579438,0.7468157834928918,4439076842,4352733914,68.77012720895766,50.32211510234878,NaN,NaN,24.00145214915181,16.725756082890076
2008-05-02T09:30:00-04:00,49.19,49.19,48.34,48.77,124989936,116847812.8,68.73777164152793,61.374433324108054,NaN,NaN,149.74606580734255,129.69780515047827,0.21048353156506316,1.0099201979492207,0.7994366663841576,4564066778,4412523651.6,72.23366690631549,53.17692463981551,NaN,NaN,26.09248194530793,18.0638597775212
2008-05-05T09:30:00-04:00,48.73,49.03,48.39999,48.63,75624624,115498506.4,67.376782870397,62.73410241606804,NaN,NaN,127.38460435816101,129.0715371980005,0.19777061367553528,1.0466499334785766,0.8488793198030413,4488442154,4442939677.2,73.82408851879207,56.22982692561835,NaN,NaN,27.42323840207429,19.400913866743068
2008-05-06T09:30:00-04:00,48.49001,49.13,48.14,48.92999,139582496,117599334.4,68.80221417108166,63.64319796845327,NaN,NaN,117.25270435824639,127.72589157612717,0.1908405309100244,1.0874299834405718,0.8965894525305474,4628024650,4483018077.2,75.7917472551475,59.126946326114194,NaN,NaN,28.953753954748123,20.76560530788665
2008-05-07T09:30:00-04:00,48.92999,49.23,47.87199,48.03999,140008256,118236900,60.37396928073176,64.00209584110361,NaN,NaN,91.16346661793779,124.84137852602127,0.11152095761870084,1.0359906495539235,0.9244696919352227,4488016394,4521525363.6,77.53877061075221,62.22348358625836,NaN,NaN,27.823463362073248,21.77387074419902
2008-05-08T09:30:00-04:00,48.24001,48.7,48.06,48.39999,128058688,118999812.8,62.3813735478956,63.971420277274454,NaN,NaN,84.16269335342325,113.9419068990222,0.07050501813588395,1.0126009646050775,0.9420959464691936,4616075082,4556925011.6,79.03652066079553,65.10246484593866,NaN,NaN,27.45749715801721,22.585817374744476
2008-05-09T09:30:00-04:00,48.03,48.46001,47.89999,48.21001,97062000,117846144,60.63566209496738,63.710845172561335,NaN,NaN,67.91479068744272,97.57565187504224,0.020388043638389197,0.9675810010171801,0.947192957378791,4519013082,4547914272.4,77.6177473386838,67.31969929900487,NaN,NaN,26.651819978618242,23.166674889583586
2008-05-12T09:30:00-04:00,48.28,49.19,48.2,49.09,89636000,117864216,65.45762884541006,64.17567141413636,NaN,NaN,99.95533523692735,92.08979805079551,0.03543044860702893,0.991481018137577,0.9560505695305481,4608649082,4571955658,78.71556709275275,69.44201747531434,NaN,NaN,27.367379789876782,23.76677558962547
2008-05-13T09:30:00-04:00,49.13,49.33,48.75999,49.22,85448000,115925003.2,66.11792916137429,64.5084411339894,NaN,NaN,110.48689981270563,90.73663714168734,0.04258157970740961,1.00927754416481,0.9666959644574005,4694097082,4585170144.4,79.31609777455415,71.44130884484203,NaN,NaN,28.14298403295542,24.391948224386894
2008-05-14T09:30:00-04:00,49.42,49.92999,49.03999,49.11,143598128,116403516,64.98593868916171,64.61880219816199,NaN,NaN,117.21438139673843,95.94682009744746,0.028998447767816238,1.0029440241671708,0.9739455763993545,4550498954,4597666656.4,79.89382881088783,72.97497062635325,NaN,NaN,28.467855787717607,24.974220733434137
2008-05-15T09:30:00-04:00,49.11,50.02,48.98,49.97,157248816,118013116,69.3973097036887,65.11484575598743,NaN,NaN,129.7001411723583,105.05430966123447,0.06496857224042074,1.0551562916998805,0.9901877194594597,4707747770,4616001194,80.74366025618198,74.40326395526837,NaN,NaN,30.075680084777307,25.703000640768877
2008-05-16T09:30:00-04:00,50.09,50.11,49.45,50.0099,146563184,118690153.6,69.58874611839745,65.591236439688,NaN,NaN,133.3774155138019,118.14683462650632,0.07762716184862772,1.0872216717702443,1.0095945099216166,4854310954,4683060768.4,83.49201615311745,75.8803948106167,NaN,NaN,31.437022687461447,26.522146647439243
2008-05-19T09:30:00-04:00,50.05,50.47,49.34,49.64999,140179632,121533976,65.60226699993066,65.64833253655948,NaN,NaN,120.30180987080301,122.21612955328143,0.04931908066355617,1.0712433607510619,1.0219242800875057,4714131322,4704157216.4,84.25342608458588,77.0967912963337,NaN,NaN,31.481422966636746,27.230614693038888
2008-05-20T09:30:00-04:00,49.45,49.47,48.89,49.27,137163632,123157682.4,61.590574167613106,65.67785521366538,NaN,NaN,67.3460315385906,113.58795589845845,-0.004576026576343484,1.0162042468670762,1.0207802734434197,4576967690,4680731338,79.84923176331453,77.9340354596313,NaN,NaN,30.375406661834347,27.679870688581097
2008-05-21T09:30:00-04:00,49.31,49.60001,48.02,48.17999,192807632,126243754.4,51.80429518191351,64.48946160529219,NaN,NaN,8.55676154024227,91.8564319271592,-0.1169847034389978,0.8745493941446725,0.9915340975836703,4384160058,4647463558.8,73.93823664664586,78.30318613375188,NaN,NaN,26.24796034156408,27.475312067578667
2008-05-22T09:30:00-04:00,48.3,48.69,48.11,48.35001,153198192,125568936,53.057223782512295,63.36942247250538,NaN,NaN,-19.833928061952115,61.949618080297135,-0.17949710081442416,0.76716272156564,0.9466598223800642,4537358250,4613385654.8,68.35609501471657,78.0262167129234,NaN,NaN,23.259871882663276,26.873106326876467
2008-05-23T09:30:00-04:00,48.17999,48.35049,47.82001,48.2,121708064,125557070.4,51.77822529580781,62.25523978860615,NaN,NaN,-58.31341338780042,23.611452299976666,-0.2274729304418438,0.6623186593277595,0.8897915897696033,4415650186,4525653501.2,56.52459473601985,76.79053858558252,NaN,NaN,20.42567493146397,25.952044698960396
2008-05-27T09:30:00-04:00,48.32001,49.11,48.28999,49.05,106987744,127344260.8,57.96196641525137,61.48093637747541,NaN,NaN,14.997981344058697,2.550686594627802,-0.19948578994373822,0.6404343523399305,0.8399201422836687,4522637930,4487354822.8,52.27120873589198,75.11050011992141,NaN,NaN,19.72555346427712,25.0625459511485
2008-05-28T09:30:00-04:00,49.28,49.36,48.75,49.25,121369120,128849185.6,59.284962923452774,61.403150209098335,NaN,NaN,47.55032879490414,-1.4084539541094911,-0.1663804765840795,0.6319445465535694,0.7983250231376489,4644007050,4500762694.8,53.58791579063937,73.39972477562763,NaN,NaN,19.542773742510867,24.274007064200266
2008-05-29T09:30:00-04:00,49.27,49.97,49.25,49.69,143993008,129441201.6,62.11014603076066,61.38377681501727,NaN,NaN,107.3501841684823,18.35023057153851,-0.11610717278285176,0.6531910571590842,0.769298229941936,4788000058,4581530694.8,60.63326164350929,72.0852062743929,NaN,NaN,20.229146730628702,23.696169873690042
2008-05-30T09:30:00-04:00,49.89,50.24001,49.75,50.00999,94163568,126969536,64.0631374623052,61.628596484112826,NaN,NaN,137.8940093203076,49.895818047990446,-0.0651028409319716,0.6879196787769715,0.7530225197089431,4882163626,4650491770,65.45502124815039,71.2164401250691,NaN,NaN,21.385859015840484,23.36612546542582
2008-06-02T09:30:00-04:00,49.92,49.92,48.96001,49.39999,144359872,127938032.8,57.932855456992286,61.09111267065441,NaN,NaN,54.43259991476244,72.44502070850302,-0.07551545284856687,0.6586282036482345,0.7341436564968014,4737803754,4714922483.6,69.24522280903354,70.5399869619463,NaN,NaN,20.549276447400192,22.963718462850732
2008-06-03T09:30:00-04:00,49.59,49.89999,48.67,49.13,167679872,132540795.2,55.40571522410228,60.325954532277834,NaN,NaN,25.616238057923624,74.56867205127601,-0.10200641008511013,0.6066356438904137,0.7086420539755238,4570123882,4724419674,69.77169812477428,69.85824412981917,NaN,NaN,19.100212188663697,22.411788995109728
2008-06-04T09:30:00-04:00,48.97,50.10001,48.94,49.75999,174967376,134310039.2,59.811075683170095,59.95632146042129,NaN,NaN,68.67000765614299,78.7926078235238,-0.07951914860133802,0.6092431182238514,0.6887622668251894,4745091258,4744636515.6,70.91316861633575,69.21676840163688,NaN,NaN,19.16742451333498,21.94830835485619
2008-06-05T09:30:00-04:00,49.87,50.61,49.7,50.55,126653632,133642308,64.54155885194538,59.60948211386822,NaN,NaN,144.80835864735676,86.28424271929869,-0.017118765106030276,0.6673638104426516,0.6844825755486819,4871744890,4761385482,71.86118560369948,68.58230592645955,NaN,NaN,20.743337499720056,21.776169661265314
2008-06-06T09:30:00-04:00,50.11,50.21001,49.02,49.03,189135936,136696170.4,51.88685116597245,58.34506104583785,NaN,NaN,26.295548359230718,63.96455052708332,-0.08035316566112294,0.5840411184722782,0.6643942841334012,4682608954,4721474547.6,66.31469772514569,67.35535461017587,NaN,NaN,17.69781096930137,21.19354699098475
2008-06-09T09:30:00-04:00,49.11,49.19,47.95,48.77,208897248,142287932.8,50.07811555770383,57.23619308567879,NaN,NaN,-91.62950959571656,34.752128624987506,-0.13842476561320627,0.49136332711689334,0.6297880927300996,4473711706,4668656138,59.74284669372127,65.60459893939982,NaN,NaN,14.706767920939864,20.26686426669262
2008-06-10T09:30:00-04:00,48.28,48.94,48.16,48.53999,162798496,145946057.6,48.46845248889401,56.298898680056006,NaN,NaN,-99.77618232079992,9.6736445492428,-0.18798682315996085,0.3948045637801485,0.5827913869401093,4310913210,4616814003.6,54.07808721512994,63.76380290024378,NaN,NaN,11.80865150917898,19.058548158476388
2008-06-11T09:30:00-04:00,48.45,48.52,47.35001,47.38,170367248,150192020,41.26471239754281,55.546071338315244,NaN,NaN,-175.28619696868896,-39.117596375723586,-0.2885378304316196,0.2221190989005848,0.5106569293322044,4140545962,4495904944.4,43.676414343607455,61.602244164312474,NaN,NaN,6.7246712991564745,17.296565750002113
2008-06-12T09:30:00-04:00,47.71001,48.11,47,47.42,189917120,152507969.6,41.587114578152544,54.726777823718116,NaN,NaN,-166.67039596762476,-101.4133472987199,-0.33853847913158386,0.08748383041772456,0.4260223095493084,4330463082,4387648582.8,36.84328710153725,59.35132931337109,NaN,NaN,2.896815213305275,15.239458530473993
2008-06-13T09:30:00-04:00,47.7,48.47,47.46001,48.37,167855008,153038279.2,48.77830971983795,54.512498139720265,NaN,NaN,-91.74530460495565,-125.02151789155717,-0.2953883540276748,0.056786867014714915,0.35217522104238974,4498318090,4350790410,34.8444769836908,57.802749473919015,NaN,NaN,1.923389424609812,13.337162943921967
2008-06-16T09:30:00-04:00,48.12,49.02,48.07001,48.8,136343808,152527310.4,51.67809597180443,54.063650250902626,NaN,NaN,-32.92173071329189,-113.27996211507225,-0.22862706476945727,0.06639139008056816,0.2950184548500254,4634661898,4382980448.4,38.00765483573027,56.78392419533604,NaN,NaN,2.0728058035019044,11.727969066719101
2008-06-17T09:30:00-04:00,48.95,49.06,48.47,48.53999,122952560,151665956.8,49.84070108889363,53.389060119862684,NaN,NaN,-21.92799525346573,-97.7103247016054,-0.19408023122801588,0.05241816581500558,0.24649839704302146,4511709338,4423139674,41.803576075562766,55.94218564425915,NaN,NaN,1.6242809833941865,10.284585054815542
2008-06-18T09:30:00-04:00,48.25999,48.45,47.83,48.02,169338064,153274678.4,46.2956249031333,52.2594514678893,NaN,NaN,-80.10929610134488,-78.67494452813659,-0.1976847646662648,-0.0006075587898095591,0.19707720587645525,4342371274,4463504736.4,45.421080277558545,54.85560126097695,NaN,NaN,0.14781440201758606,8.836474961558691
2008-06-19T09:30:00-04:00,47.92,49.00999,47.61,48.77,221366496,154702621.6,51.638689735811646,51.3719909159969,NaN,NaN,-39.16410351160771,-53.17368603693318,-0.14351452177555302,0.017684053657013976,0.161198575432567,4563737770,4510159674,49.340739069408315,53.70458110535252,NaN,NaN,0.5710113211289326,7.655694441497297
2008-06-20T09:30:00-04:00,48.34,48.35001,47.21001,47.42,197434128,156914418.4,43.28988349732279,50.32606434744908,NaN,NaN,-116.49394637565497,-58.12341439107304,-0.18966185740164496,-0.07587874631948921,0.11378311108215575,4366303642,4483756784.4,47.27172561840441,52.13504559173616,NaN,NaN,-1.9071018015148478,6.289580692495562
2008-06-23T09:30:00-04:00,47.62,47.74001,46.98,47.05,131548496,157406440,41.318174005749356,49.31981140328103,NaN,NaN,-144.92737808403845,-80.52454386522234,-0.233293599900258,-0.17783388879316675,0.05545971110709124,4234755146,4403775434,41.583225251025944,50.121583243611276,NaN,NaN,-4.536377777092601,4.74301519684011
2008-06-24T09:30:00-04:00,46.83,47.37,46.41,46.81,178293680,160971736.8,40.044115372561336,47.907885666808966,NaN,NaN,-156.5247432098452,-107.44389345649824,-0.26423334972097395,-0.27483197604412624,-0.010598626323152262,4056461466,4312725859.6,36.2372661593113,47.644733068109524,NaN,NaN,-7.0415344810934535,3.0595080999924584
2008-06-25T09:30:00-04:00,47.00999,48,46.94,47.57001,179023376,163854449.6,45.749022881085885,46.56556166889043,NaN,NaN,-89.61042284022318,-109.3441188042739,-0.2211755483576092,-0.28706806177016375,-0.06589251341255456,4235484842,4291348573.2,35.096413554730276,45.01867792175459,NaN,NaN,-7.363104993703811,1.570563372321563
2008-06-26T09:30:00-04:00,46.7,46.7,45.64,45.64999,190028256,166156212,36.34123350027371,45.45516040705481,NaN,NaN,-182.6395169290676,-138.03920148776587,-0.3045238263272967,-0.44654729632167545,-0.14202346999437876,4045456586,4187692336.4,30.14120175717366,42.43485678118515,NaN,NaN,-11.062645012648275,-0.23418068267412817
2008-06-27T09:30:00-04:00,45.58,45.89999,44.97,45.64999,181351744,170515620.8,36.341233500273695,44.47395454580981,NaN,NaN,-189.25026987477625,-152.59046618759015,-0.33950646919033056,-0.566406556482292,-0.22690008729196143,4045456586,4123522925.2,27.548160714134198,40.135236354071786,NaN,NaN,-13.851035792473313,-2.179445698359726
2008-06-30T09:30:00-04:00,45.53,45.83,45.14999,45.17,132929376,169944096,34.296434876250444,43.46166757347812,NaN,NaN,-168.50851550202816,-157.30669367118807,-0.3721986575590829,-0.692148409240815,-0.3199497516817321,3912527210,4059077338,25.203107348490988,38.07273779216901,NaN,NaN,-16.78648897378618,-4.266166166277791
2008-07-01T09:30:00-04:00,44.86,45.86,44.67999,45.81,245494256,173834815.2,39.208103307272125,43.314766924173064,NaN,NaN,-143.11021920345516,-154.62378886991007,-0.3294179935609585,-0.7317222436329303,-0.40230425007197174,4158021466,4079389338,27.30358141600557,36.903249725911735,NaN,NaN,-17.661907767826953,-6.17984353792767
2008-07-02T09:30:00-04:00,45.96001,46.13,44.64,44.71001,199725504,175072721.6,34.4424004127122,42.804430198070186,NaN,NaN,-140.98406009781695,-164.89851632142884,-0.35186632757423647,-0.8421371595397673,-0.49027083196553084,3958295962,4023951562,25.22174459074725,36.073139546569585,NaN,NaN,-20.01024397116338,-8.155615028389914
2008-07-03T09:30:00-04:00,44.98,45.08,44.28,44.63,123118192,174895949.6,34.11756055032055,41.75723382881894,NaN,NaN,-146.5114533422644,-157.67290360406818,-0.3481274398057629,-0.9254301317227345,-0.5773026919169716,3835177770,3981895798.8,23.742763124983583,35.280159985233354,NaN,NaN,-21.9492405193072,-10.126132955663811
2008-07-07T09:30:00-04:00,45.05,45.46001,44.24001,44.89999,181011248,174489715.2,36.30078350466958,40.65885436688074,NaN,NaN,-116.63145683157828,-143.1491409954286,-0.3050412722398772,-0.9586042822168181,-0.653563009976941,4016189018,3976042285.2,23.5358947429919,34.24646283575204,NaN,NaN,-22.87498873597832,-11.947398067137312
2008-07-08T09:30:00-04:00,44.95,46.00999,44.77,45.97,206255312,174357618.4,44.19368375255653,40.25549598571381,NaN,NaN,-69.46587156260233,-123.34061220754344,-0.1878009819104316,-0.8883142373649804,-0.7005132554545488,4222444330,4038025709.2,30.446635705798826,33.435252809340334,NaN,NaN,-21.191936970565166,-13.26804648191272
2008-07-09T09:30:00-04:00,45.96001,46.03,44.73,44.75,168576320,174646509.6,38.35772699827153,39.68850327822367,NaN,NaN,-81.38893395987651,-110.99635515882771,-0.1759433056794224,-0.9204423875538268,-0.7444990818744044,4053868010,4017195018,29.482272223764923,32.296766519783645,NaN,NaN,-21.626259927730256,-14.462076974172367
2008-07-10T09:30:00-04:00,44.82001,45.42,44.38,45.28,238811440,178068719.2,41.94443825178823,38.99605674365058,NaN,NaN,-79.70727279448055,-98.74099769816044,-0.11867708728249582,-0.8928454409775242,-0.7741683536950283,4292679450,4084071715.6,36.44250897200372,31.375464369969027,NaN,NaN,-20.80925243519359,-15.368816325746828
2008-07-11T09:30:00-04:00,44.81,45.27,43.85001,44.56,265514624,181848594.4,38.6540015491925,38.66492231878413,NaN,NaN,-93.24507883421676,-88.08772279655092,-0.1154532548461844,-0.9184849222527589,-0.8030316674065745,4027164826,4122469126.8,40.09826268036661,30.863074160109186,NaN,NaN,-21.184431683013948,-16.19961851964213
2008-07-14T09:30:00-04:00,45.13,45.17999,44.07001,44.23,177389808,182325334.4,37.21307819388659,38.37170118936535,NaN,NaN,-89.08476050109233,-82.57838353045372,-0.12111911136795239,-0.954430556616515,-0.8333114452485626,3849775018,4089186326.8,38.054998652375666,30.611057974491306,NaN,NaN,-21.9354040236055,-17.019016448779755
2008-07-15T09:30:00-04:00,44.00999,44.92999,43.3,44.24001,283890944,189702691.2,37.289442762338275,38.17493886006371,NaN,NaN,-101.05585600081064,-88.89638041809538,-0.11008514031616345,-0.9709178706437669,-0.8608327303276034,4133665962,4071430653.2,36.97261534442664,30.66358291628526,NaN,NaN,-22.510958277905488,-17.80357956722629
2008-07-16T09:30:00-04:00,44.3,45.38,43.92,45.34,186047808,192857453.6,45.17989532734267,38.134286891939205,NaN,NaN,-58.09897483584752,-84.23838859328957,-0.01935157635531204,-0.8850222007717434,-0.8656706244164314,4319713770,4124599805.2,42.26795230815306,31.175835684386886,NaN,NaN,-20.57998847667494,-18.20020941143324
2008-07-17T09:30:00-04:00,45.56,45.82001,44.9799,45.64,197555056,194268303.2,47.133596863232185,38.90516998929338,NaN,NaN,-15.862743707152948,-71.46948277582405,0.06557035832975111,-0.7837076765042426,-0.8492780348339937,4517268826,4169517680.4,46.36750497245988,32.33485734262161,NaN,NaN,-18.40477301975779,-18.22943278405103
2008-07-18T09:30:00-04:00,45.17,45.17,44.59,44.59,160661008,191233028.8,41.551948429687194,39.277363912822906,NaN,NaN,-63.71701075639096,-65.56386916025889,0.0560946339676891,-0.7791597423743823,-0.8352543763420714,4356607818,4235406278.8,51.77691886507412,34.06548292483161,NaN,NaN,-18.20277000444722,-18.225623815536203
2008-07-21T09:30:00-04:00,45,45.19,44.49001,44.78,128107744,187766709.6,42.87033437026512,39.88978530525253,NaN,NaN,-56.56654612973417,-59.060226285987255,0.06695507094670483,-0.7515605376586905,-0.8185156086053953,4484715562,4362394387.6,60.12458222337537,36.55987398732335,NaN,NaN,-17.643243864389433,-18.142426679658094
2008-07-22T09:30:00-04:00,44.02,44.81,43.86,44.78,152524432,188815506.4,42.87033437026512,40.15137323832346,NaN,NaN,-86.62812287546984,-56.1746796609191,0.0777145375492696,-0.7213724366688083,-0.799086974218078,4484715562,4432604307.6,63.85049304232552,39.170367674917635,NaN,NaN,-17.192258658671783,-18.006688390945765
2008-07-23T09:30:00-04:00,44.84,45.89,44.72,45.37,169259056,188363775.2,47.16255567254954,41.05995575688326,NaN,NaN,21.960513730664942,-40.16278194761661,0.12532198335882772,-0.6424344950195433,-0.767756478378371,4653974618,4499456477.2,67.01127442800959,42.15533409186494,NaN,NaN,-15.562519943547015,-17.6575214698888
2008-07-24T09:30:00-04:00,45.59,45.61,44.64999,44.69,145560944,186690653.6,43.139660374422256,41.704391458604825,NaN,NaN,-9.946988025724103,-38.979630811330836,0.11219530049590176,-0.6275123527584938,-0.7397076532543956,4508413674,4497685446.8,66.84452930391949,45.23403167607465,NaN,NaN,-15.30475636802629,-17.321412169622725
2008-07-25T09:30:00-04:00,44.98,45.48,44.75999,45.27,111616688,182770075.2,47.27103351709741,42.48798074520681,NaN,NaN,35.05923567569779,-19.224381524913085,0.14184430542879622,-0.5624022714684003,-0.7042465768971965,4620030362,4550369955.6,69.29242229049501,48.50235507232487,NaN,NaN,-13.857602945256694,-16.826582280427576
2008-07-28T09:30:00-04:00,45.27,45.52,44.21001,44.42,124028432,179903909.6,42.40798878476887,42.360431104650544,NaN,NaN,-50.95911232869755,-18.102894764705763,0.10516748181460567,-0.5727872246289394,-0.677954706443545,4496001930,4552627229.2,69.39667606317131,51.28450081213719,NaN,NaN,-14.06282575329742,-16.431759919408982
2008-07-29T09:30:00-04:00,44.63,45.53999,44.57001,45.34,142291440,180372012.8,48.574572889557565,43.090205811170975,NaN,NaN,44.72549768220074,8.167829346828352,0.14155914050437124,-0.501005780813081,-0.6425649213174522,4638293370,4583342790.8,70.84707444122142,54.23912954195551,NaN,NaN,-12.288220982935998,-15.839825785627127
2008-07-30T09:30:00-04:00,45.46001,45.82001,44.88,45.57001,165679872,176381293.6,50.01556233096379,43.66671467396923,NaN,NaN,105.45695368618199,24.867117337931763,0.17748480567440872,-0.42070891422444134,-0.5981937198988501,4803973242,4613342515.6,72.23133304555932,56.79547411863806,NaN,NaN,-10.41114729444239,-15.06430028688645
2008-07-31T09:30:00-04:00,45.11,46.14999,45.02,45.46001,180730816,175431559.2,49.30402786457568,44.42743083935375,NaN,NaN,120.07016285784,50.87054751464459,0.18913194475325523,-0.361778788957281,-0.5509107337105362,4623242426,4636308266,73.27740549162354,59.1654128908707,NaN,NaN,-9.090556185604884,-14.210908272417655
2008-08-01T09:30:00-04:00,45.52,45.55,44.39999,44.88,180377376,178294518.4,45.618817459459834,45.02784078689469,NaN,NaN,-7.512259475993682,42.35624848430629,0.15452520162436822,-0.3577542316800759,-0.5122794333044441,4442865050,4600875203.6,68.96099273135748,61.37298389651225,NaN,NaN,-9.019426890743931,-13.469268075035695
2008-08-04T09:30:00-04:00,44.87,44.92,44.3,44.42999,116306816,175059296.8,42.93726886359527,45.43125693698448,NaN,NaN,-84.93989404369633,35.56009214130654,0.10068566597858669,-0.3864223508312108,-0.4871080168097975,4326558234,4566986464.4,65.01635685663149,63.37610829024117,NaN,NaN,-9.741697963701238,-12.936758059130772
2008-08-05T09:30:00-04:00,44.89999,45.97,44.84,45.92999,151727008,172332881.6,52.87990571045512,45.981257678635366,NaN,NaN,127.42302490719604,52.09959758630559,0.16182934563019435,-0.2848213347720545,-0.44665068040224887,4478285242,4534984838.8,61.442216515136764,64.74569859074,NaN,NaN,-7.209486007610686,-12.118576337485045
2008-08-06T09:30:00-04:00,45.92999,46.81,45.58,46.63,133463680,170577249.6,56.67389691969942,46.66270768266874,NaN,NaN,228.16014299288557,76.64023544764632,0.24041468962177437,-0.14613231837503093,-0.3865470079968053,4611748922,4496539974.8,57.36251729954306,65.5310566141031,NaN,NaN,-3.8446340660729406,-10.936584584426173
2008-08-07T09:30:00-04:00,46.35001,46.85001,46.08,46.27,152805744,166276964.8,54.25449065918114,47.5700321276326,NaN,NaN,189.5307673489163,90.53235634586159,0.2576172418003993,-0.06452545574630619,-0.3221426975467055,4458943178,4463680125.2,54.05853674630615,65.69402931990537,NaN,NaN,-1.8620131674182119,-9.640217239139321
2008-08-08T09:30:00-04:00,46.25,47.44,46.14999,47.32001,143121440,160157305.6,59.663300374906065,48.76952969939266,NaN,NaN,217.89064704473526,135.61293765000738,0.3248408453967523,0.0839083591992349,-0.2409324861975174,4602064618,4495520038.8,56.66323128607807,65.44678996724129,NaN,NaN,1.6504270888923378,-8.027268049420513
2008-08-11T09:30:00-04:00,47.3,48.28,47.14,47.75,157291120,159152371.2,61.66237079038479,50.111818015115496,NaN,NaN,241.5953444728448,200.91998535331558,0.37958409665523807,0.23354763462153016,-0.14603646203370788,4759355738,4582079539.6,62.83261190183242,65.37408417149177,NaN,NaN,5.155604774076824,-6.144000503206608
2008-08-12T09:30:00-04:00,47.75999,48.16,47.50999,47.8,140596944,151987671.2,61.8988333232753,51.164409275881624,NaN,NaN,201.41414643573256,215.71820965902288,0.3985199501507296,0.3521134756547042,-0.046406474496025446,4899952682,4666413027.6,67.6627362392608,65.42061715800972,NaN,NaN,8.015352868338,-4.121235735843093
2008-08-13T09:30:00-04:00,47.74001,48.12,47.25,47.7,169664496,151168505.6,61.08730675652645,52.446384017460495,NaN,NaN,151.53812332661622,200.39380572576903,0.38353881455136163,0.4330170436931766,0.04947822914181496,4730288186,4690120880.4,68.886837289863,65.56649629986283,NaN,NaN,10.120423223852526,-2.086713027315147
2008-08-14T09:30:00-04:00,47.53999,48.46001,47.49001,48.25,158069120,149194208.8,63.89131522628444,53.633546996688146,NaN,NaN,145.942831156566,191.67621848729897,0.38869182209307707,0.5353430067581613,0.14665118466508423,4888357306,4776003706,72.89031374704106,65.82348854675897,NaN,NaN,12.760725932128954,0.0343496811768671
2008-08-15T09:30:00-04:00,48.35001,48.57001,47.96001,48.16,123116000,147316958.4,63.09016456731713,55.110845266870164,NaN,NaN,132.11107071547346,174.5203032214466,0.364465179192039,0.602232658655133,0.23776747946309398,4765241306,4808639043.6,74.24643031552453,66.16989956478419,NaN,NaN,14.719262212369868,2.132194328490153
2008-08-18T09:30:00-04:00,48.28999,48.31,47.25999,47.60001,151399008,148481521.6,58.200058982524084,55.798379987796345,NaN,NaN,90.1896618940118,144.23916670568002,0.29226958754063687,0.60310446388889,0.3108348763482532,4613842298,4779536355.6,70.84313243204639,66.16961799270027,NaN,NaN,15.069266094727313,3.9803474379526045
2008-08-19T09:30:00-04:00,47.36,47.59,46.75,47.00999,155418560,148626228,53.49524057138705,56.04692843354086,NaN,NaN,49.532239536714286,113.86278532587635,0.19121001438288032,0.5498473943268536,0.35863737994397327,4458423738,4691230566.8,61.614301884842305,65.41125862407762,NaN,NaN,14.013589861544173,5.413667784179971
2008-08-20T09:30:00-04:00,47.36,47.56,46.74001,47.09,155466688,147936609.6,54.03784340783808,56.38505811520246,NaN,NaN,45.466369109335844,92.64843448242026,0.11968070961030841,0.5082382669568588,0.3885575573465504,4613890426,4667951014.8,59.4168046572224,64.42121570733468,NaN,NaN,13.290687475891144,6.538956311567281
2008-08-21T09:30:00-04:00,46.73,47.08,46.38,46.87,118920944,146604609.6,52.233188010011744,56.8575131545276,NaN,NaN,20.114008241264504,67.48266989935996,0.05099137544990057,0.4522967766589261,0.4013054012090255,4494969482,4589273450,52.59009081361822,63.25186557035331,NaN,NaN,12.182325645376189,7.345151930682839
2008-08-22T09:30:00-04:00,47.12,47.67999,47.08,47.49001,96525440,145850047.2,56.629158990468966,57.835505306447146,NaN,NaN,54.319670382963515,51.92438983285799,0.04117414437457989,0.4527730816772504,0.4115989373026705,4591494922,4554524173.2,49.86501907055746,62.1696271570623,NaN,NaN,12.409156856986995,8.068581205869148
2008-08-25T09:30:00-04:00,47.14999,47.21001,46.37,46.49001,128076432,146052447.2,48.82452445962215,57.54583521710193,NaN,NaN,1.823718246989123,34.25120110345346,-0.034707655318953645,0.36821436815397846,0.4029220234729321,4463418490,4524439411.6,47.56694124464352,61.17853606631279,NaN,NaN,10.236835044149059,8.37833175419485
2008-08-26T09:30:00-04:00,46.50999,46.77,46.12,46.42999,107233872,144299568.8,48.39342301731606,56.95437279550312,NaN,NaN,-22.262346130519866,19.892283970006623,-0.08795316400791064,0.29298056846304377,0.3809337324709544,4356184618,4503991587.6,46.01472998959511,60.367979829887936,NaN,NaN,8.352137553287479,8.374589725493797
2008-08-27T09:30:00-04:00,46.45,47.09,46.28999,46.73,108489872,141440068.8,50.73497901954669,56.702979106957805,NaN,NaN,-7.494528475473018,9.300104453044847,-0.10104272992736912,0.254630320061743,0.35567304998911214,4464674490,4474148400.4,43.769799255140164,59.63307000909037,NaN,NaN,7.412632601317777,8.237167279182938
2008-08-28T09:30:00-04:00,46.92,47.28,46.83,47.11,112808560,138043956,53.60635796587795,56.270340363455794,NaN,NaN,18.376687525354527,8.952640309862852,-0.0829420804446992,0.25199544943323815,0.33493752987793735,4577483050,4490651114,45.35736793085337,58.82550834086003,NaN,NaN,7.415430284109875,8.119776279886786
2008-08-29T09:30:00-04:00,46.61,47.1217,45.92,46.12,133272128,135688693.6,46.07231405768081,55.156764882548366,NaN,NaN,-55.93410369594866,-13.098114505919586,-0.13348203181004992,0.16808499011537492,0.30156702192542484,4444210922,4461194314,43.02244340993406,57.410496305724436,NaN,NaN,5.095451388332731,7.687729866807635
2008-09-02T09:30:00-04:00,46.86,47.08,45.34,45.55,162403184,137993512,42.37922954457074,53.762507469783756,NaN,NaN,-116.48107700516992,-36.759073556351396,-0.19728754287909522,0.05495759332655581,0.25224513620565103,4281807738,4424872163.6,40.26965055696432,55.453847328417545,NaN,NaN,1.9528788694078936,6.868465438607672
2008-09-03T09:30:00-04:00,45.44501,45.63811,44.78999,45.12,161682816,138491302.4,39.78814717503683,52.24113892824879,NaN,NaN,-199.3344013877682,-72.17348460780106,-0.2566787282981064,-0.06860327416698198,0.18807545413112442,4120124922,4377660224.4,36.959347706562085,53.17331235818176,NaN,NaN,-1.4912901230163507,5.674214644089954
2008-09-04T09:30:00-04:00,44.85001,44.91,43.66,43.66,219363680,142786302.4,32.51830276473086,50.000209466709244,NaN,NaN,-256.8361017094465,-122.04179925459576,-0.3753368868300649,-0.2810956544064567,0.0942412324236082,3900761242,4264877574.8,30.507653073659938,50.14597945294025,NaN,NaN,-7.244105132693352,3.8287403902637673
2008-09-05T09:30:00-04:00,43.3,43.78,42.81,43.45,247977440,147544887.2,31.623289310144102,47.75257551976831,NaN,NaN,-250.2884976158417,-175.774836282835,-0.444294630713576,-0.4611270559683618,-0.0168324252547858,3652783802,4079937725.2,23.319192394167587,46.508319601414755,NaN,NaN,-12.078747829889688,1.5562420730989883
2008-09-08T09:30:00-04:00,44.03999,44.22,42.67999,43.31,311074048,155942517.6,31.0105100921175,45.81046488473927,NaN,NaN,-190.33270671863949,-202.65455688737316,-0.47300636486864195,-0.6080903813405882,-0.1350840164719463,3341709754,3859437491.6,17.902788701049616,42.72686647777213,NaN,NaN,-16.133954620846293,-0.9709288831789089
2008-09-09T09:30:00-04:00,43.35001,43.78999,42.35001,42.45,214180560,158786989.6,27.486971893005318,43.952731407712,NaN,NaN,-176.89518883712262,-214.73737925376372,-0.5198582040362255,-0.7849067715172282,-0.2650485674810027,3127529194,3628581782.8,14.18731643796059,39.339224660137724,NaN,NaN,-20.84560059910642,-3.8101676997399814
2008-09-10T09:30:00-04:00,42.87,43.17999,42.45,42.8,160658064,159790045.6,30.92677876965132,42.301941076412945,NaN,NaN,-147.02212362266332,-204.2749237007427,-0.4972196235423838,-0.8865730969089824,-0.38935347336659865,3288187258,3462194250,12.219004177319832,35.96795319728754,NaN,NaN,-23.652469673079967,-6.644782267359979
2008-09-11T09:30:00-04:00,42.17,43.69,42.17,43.60001,203440944,161478868,38.14908952062422,41.29593404145669,NaN,NaN,-111.71661764126397,-175.2510268871062,-0.4023606950620479,-0.8923043421941586,-0.48994364713211064,3491628202,3380367642,11.382640413379008,33.02456388298474,NaN,NaN,-23.78544296515144,-9.093448081330187
2008-09-12T09:30:00-04:00,43.23,43.71001,42.89999,43.42999,172094256,162180124.8,37.257490987065836,39.91224346978504,NaN,NaN,-90.42510938499427,-143.27834924093673,-0.3281961004021108,-0.9001887726347491,-0.5719926722326383,3319533946,3313717670.8,10.737922466285795,30.229771268393904,NaN,NaN,-24.16158873684816,-11.24603960354704
2008-09-15T09:30:00-04:00,42.39999,43.28999,42.03,42.08,616795136,186864081.6,31.051835425265423,38.6427656816167,NaN,NaN,-110.68788646578275,-127.34938519036541,-0.3454450473430548,-1.0037989814114567,-0.6583539340684019,2702738810,3185923482,9.613558915113956,27.518815387713214,NaN,NaN,-26.566683887955662,-13.43470307274827
2008-09-16T09:30:00-04:00,41.47,42.84,41.42999,42.41,349551360,196771699.2,33.94803110446475,37.61095197355589,NaN,NaN,-106.327945451043,-113.23593651314948,-0.31108563670737177,-1.0472109799526166,-0.7361253432452448,3052290170,3170875677.2,9.487582631324031,24.909733433551,NaN,NaN,-27.570362955314963,-15.454083055972083
2008-09-17T09:30:00-04:00,41.84,42.42191,40.19,40.21001,340088064,206005174.4,26.08225224112745,35.850042917954525,NaN,NaN,-135.66430571854303,-110.9643729323254,-0.40692930863429255,-1.2447869790381105,-0.837857670403818,2712202106,3055678646.8,8.562543298224469,22.394929436628445,NaN,NaN,-31.46073798448165,-17.740748045759165
2008-09-18T09:30:00-04:00,41.12,41.97,39.5,41.57001,423934464,219428563.2,35.9604614549408,34.58962173860187,NaN,NaN,-119.86338293073106,-112.59372599021883,-0.3512397473800457,-1.2769073546288752,-0.9256676072488295,3136136570,2984580320.4,8.041420381516062,19.729504611675786,NaN,NaN,-30.928458961404857,-19.624706747994264
2008-09-19T09:30:00-04:00,43.82001,43.83,42.10001,42.89999,263401440,226652588,43.86145220768893,34.43170303503102,NaN,NaN,-47.17520219367462,-103.94374455195491,-0.20460668991302966,-1.1814259696401166,-0.9768192797270869,3399538010,3000581133.2,9.378132085860884,17.326339517099125,NaN,NaN,-27.426196611093673,-20.739205299865606
2008-09-22T09:30:00-04:00,42.75,42.84,40.8,40.88,164698192,230061225.6,36.49645149882544,34.01150460319207,NaN,NaN,-94.3088941060967,-100.66794608001769,-0.22197967728548185,-1.2542938763339393,-1.0323141990484574,3234839818,3107001334.8,17.92350490844676,15.730186256490734,NaN,NaN,-27.411450849460095,-21.692383235521962
2008-09-23T09:30:00-04:00,41.17999,41.75,40.44,40.57001,185954496,232955128.8,35.51099871434448,33.70599399885691,NaN,NaN,-110.72266025965565,-101.54688904174022,-0.23160361381804906,-1.3218187163210189,-1.0902151025029698,3048885322,3106320365.2,17.911865600521367,14.369651820344968,NaN,NaN,-27.76547657173221,-22.559967997837713
2008-09-24T09:30:00-04:00,40.85001,41.25999,40.52,40.85001,159305184,235558694.4,37.16146353748832,34.037648339768154,NaN,NaN,-108.37273230638179,-96.08857435930796,-0.1976864377921319,-1.3373231497431348,-1.139636711951003,3208190506,3205518045.2,25.501331335140463,14.01205741045072,NaN,NaN,-27.462428002909885,-23.260319427133737
2008-09-25T09:30:00-04:00,41.2112,42.02,41.03,41.5,148587008,237563551.2,40.9401944069758,34.70314156097042,NaN,NaN,-75.28530726211403,-87.17295922558455,-0.11419406554335554,-1.2823792938801972,-1.1681852283368417,3356777514,3249646234,28.66110843219873,14.393622841738656,NaN,NaN,-25.945554126819616,-23.64392438423172
2008-09-26T09:30:00-04:00,40.3,41.4902,40.22,41.08,182678560,241057051.2,39.295846000817384,35.29495126873469,NaN,NaN,-97.4540373444056,-97.22872625573075,-0.0720297195849331,-1.258222377818008,-1.1861926582330748,3174098954,3204558422.8,27.383143403487068,15.070791034769899,NaN,NaN,-25.25658621942892,-23.87430464640275
2008-09-29T09:30:00-04:00,40.25999,40.38,37.17999,37.82001,307954432,249791166.4,29.418911023497785,35.43294692091273,NaN,NaN,-198.9631228158409,-118.15957199767959,-0.23905666130128256,-1.485013484859678,-1.2459568235583955,2866144522,3130819363.6,25.38926257593326,15.870930044625089,NaN,NaN,-28.322359630240427,-24.509741072665275
2008-09-30T09:30:00-04:00,37.74001,39.3,37.60001,38.91,195512752,251446644.8,35.27661849651436,35.74364975854581,NaN,NaN,-169.22720981583944,-129.86048190891634,-0.2502944013989057,-1.5588248253070276,-1.308530423908122,3061657274,3133373754,25.59138452830294,16.82610006969531,NaN,NaN,-28.57366568659533,-25.09030173179814
2008-10-01T09:30:00-04:00,38.83,38.97,38.03,38.5,174122944,252068651.2,34.129226548620906,35.456516689117,NaN,NaN,-155.65885064201711,-139.3177055760434,-0.2584527731346058,-1.6315963903263793,-1.3731436171917735,2887534330,3069242518.8,23.84486279319512,17.716258811110748,NaN,NaN,-29.163512658240897,-25.672189007004246
2008-10-02T09:30:00-04:00,38.25,38.25,36.64,36.75,192185808,250709757.6,29.690296871541378,34.916002823722394,NaN,NaN,-187.55673241772305,-161.7719906071652,-0.349179984476955,-1.809618597787967,-1.460438613311012,2695348522,2936956720.4,20.70579670365555,18.428249828065734,NaN,NaN,-31.257856054683568,-26.470141442387007
2008-10-03T09:30:00-04:00,37.25999,38.17999,36.10001,36.17999,272144128,251918092,28.39484743144574,34.726217967020986,NaN,NaN,-175.46101903443127,-177.37338694517035,-0.41080361757765926,-1.9739431352830863,-1.563139517705427,2423204394,2786777808.4,17.835246413640746,19.015513220817645,NaN,NaN,-33.33977707724855,-27.451517961652943
2008-10-06T09:30:00-04:00,35.25999,35.53,32.91,34.86,394158080,256072293.6,25.6083400068198,34.130525745760636,NaN,NaN,-210.76868528485846,-179.73449943897384,-0.49788094595961896,-2.1854907001549506,-1.6876097541953317,2029046314,2619358166.8,15.290336593322365,19.429995646674673,NaN,NaN,-36.03853708476622,-28.678234979240553
2008-10-07T09:30:00-04:00,35.14,35.2,32.27,32.64999,329540096,261840270.4,21.758385383293344,33.821678113058205,NaN,NaN,-192.41414783966178,-184.37188704373833,-0.6520116457457934,-2.5026243113775735,-1.85061266563178,1699506218,2346927955.6,12.23178018773838,19.692083995925664,NaN,NaN,-39.79781716140262,-30.26674671954942
2008-10-08T09:30:00-04:00,31.95,34.12,31.84,32.39,452568320,276435783.2,21.35170444099259,32.77819546920476,NaN,NaN,-170.7222122466437,-187.38455936466363,-0.714158526489995,-2.743310823744274,-2.029152297254279,1246937898,2018808669.2,9.71196941185984,19.81140892666451,NaN,NaN,-42.80719108577024,-32.058238771866684
2008-10-09T09:30:00-04:00,33.14999,33.67999,30.97,31.52,352617216,283894596.8,20.004300485536703,31.07411320333674,NaN,NaN,-159.72019113008542,-181.81725110713612,-0.7526955906640516,-2.9700217855843434,-2.217326194920292,894320682,1658603101.2,7.809897466792904,19.69939216815965,NaN,NaN,-45.70440091726879,-34.00769050692413
2008-10-10T09:30:00-04:00,30.52,32.48,29.38,31.32001,472453120,298912540,19.696598560327956,29.87412370772978,NaN,NaN,-157.09551217620535,-178.14414973549094,-0.7299402841863563,-3.1297515501532374,-2.399811265966881,421867562,1258335734.8,6.327025474904289,18.871072208620905,NaN,NaN,-48.08781565106935,-36.01913695608773
2008-10-13T09:30:00-04:00,32.86,35.25,32.39999,35.13,277347072,281940136.8,38.9596167434008,30.12045356694809,NaN,NaN,-77.94616408063543,-151.57964549464631,-0.4123897408666499,-2.9152984420501937,-2.502908701183544,699214634,992369398.8,5.570208365807986,17.989525263284232,NaN,NaN,-43.425042518743886,-37.07712346503861
2008-10-14T09:30:00-04:00,36.10001,36.14999,33.19,33.61,342311680,281578152.8,35.31954510885137,29.98888796490259,NaN,NaN,-68.26809523471394,-126.75043497365678,-0.2659213687695905,-2.8353104121455317,-2.569389043375941,356902954,723848746,4.929148004096348,16.520083596781085,NaN,NaN,-40.93767011961584,-37.62863012997821
2008-10-15T09:30:00-04:00,33.23,33.35001,30.53999,30.60001,312088320,280178165.6,29.451326739477622,29.16825456008129,NaN,NaN,-111.62892198327144,-114.93177692098232,-0.3288436935971797,-2.9804436603724156,-2.651599966775236,44814634,483424093.2,4.436788632047225,14.789775039627404,NaN,NaN,-41.00501484719809,-38.11097080386676
2008-10-16T09:30:00-04:00,30.82001,32.27,29.25,32.25999,494913280,283727106.4,35.78758213945517,28.9176642842697,NaN,NaN,-103.10321497594562,-103.60838169015435,-0.22093348164903626,-2.927766818836531,-2.706833337187495,539727914,412505539.6,4.300337102882054,13.14100316101276,NaN,NaN,-38.678517033595725,-38.19204883668519
2008-10-17T09:30:00-04:00,31.62,33.64999,31.41,32.3,326593024,286886685.6,35.93693101006352,29.38323714045297,NaN,NaN,-72.48316571301756,-86.68591239751679,-0.11448472560933443,-2.849939244199163,-2.7354545185898287,866320938,501396214.8,8.114824089243484,11.907114697677775,NaN,NaN,-36.89737947788853,-38.00709607114281
2008-10-20T09:30:00-04:00,32.78999,33.25999,31.7,33.2,232783312,290290941.6,39.353925333364124,29.6744733430851,NaN,NaN,-61.15283649323288,-83.32724688003628,0.04061128504432299,-2.684690412284425,-2.725301697328748,1099104250,581374138,11.53156975243617,10.902842213687293,NaN,NaN,-34.334507549404634,-37.482440568037354
2008-10-21T09:30:00-04:00,32.66,33.2572,31.48,31.48,239932368,292989835.2,35.46114504062331,29.769610378228123,NaN,NaN,-68.91745392318157,-83.45711861772982,0.050773222737884094,-2.661835168906393,-2.712608391644277,859171882,681827923.6,15.768233328235794,10.325940109047341,NaN,NaN,-33.45694462022566,-36.90736971834997
2008-10-22T09:30:00-04:00,31.39,31.60001,29.71001,30.61,289993472,299524249.6,33.648102861625134,30.05231080609125,NaN,NaN,-95.0891079619555,-80.14915581346663,0.02368987757397134,-2.6829960446768126,-2.706685922250784,569178410,786700678.8,20.07168912280696,10.280646710415299,NaN,NaN,-33.332334466804106,-36.39665039670056
2008-10-23T09:30:00-04:00,30.46001,31.09,28.89999,30.49001,377966848,310993241.6,33.394507862771476,30.409429408328805,NaN,NaN,-103.44651645836285,-80.21781610995008,0.02249155639956335,-2.67857147675133,-2.701063033150893,191211562,716997408.4,19.36357675684728,10.389813163501477,NaN,NaN,-33.31082447142211,-35.955818121660776
2008-10-24T09:30:00-04:00,28.13,30.25,28.09,29.50999,322129408,317965784,31.318380615389984,30.8172894517981,NaN,NaN,-120.76374513938447,-89.87393199522346,-0.017356083458095473,-2.7227581374735124,-2.705402054015417,-130917846,517549651.6,17.464923617449244,10.54514080808197,NaN,NaN,-33.917243458204524,-35.66459316973845
2008-10-27T09:30:00-04:00,29.14,30.2,28.66,28.69,239493680,314542746.4,29.65701702740249,31.381477426377323,NaN,NaN,-117.36037643453815,-101.1154399834845,-0.06908718961253602,-2.791761041031087,-2.722673851418551,-370411526,223646496.4,15.113246975653851,10.750959864361647,NaN,NaN,-34.920482695729355,-35.558291673451436
2008-10-28T09:30:00-04:00,29.67999,31.88,28.85001,31.86,327367680,321135492.8,42.3820419730331,32.883644392951645,NaN,NaN,-63.69442513370588,-100.07083422558938,0.1292345119812941,-2.5611307114419333,-2.6903652234232274,-43043846,43203350.8,13.877726196156203,11.048513920382817,NaN,NaN,-31.666404769791225,-35.0023078300714
2008-10-29T09:30:00-04:00,31.95,33.08,31.25,31.78,341390848,329498888,42.174691427100186,34.46724374592047,NaN,NaN,-15.60960179956227,-84.17493299311073,0.2661861588335448,-2.3576325248812964,-2.623818683714841,-384434694,-147519270,12.69627672066646,11.397541009945213,NaN,NaN,-29.186183532179438,-34.171432930372546
2008-10-30T09:30:00-04:00,32.67,33.06,31.98,32.84,255292064,332654200.8,45.94810812460896,36.34235157194054,NaN,NaN,20.510821185885213,-59.38346546426111,0.4296384573316798,-2.086770612050241,-2.516409069381921,-129142630,-211590108.4,12.316925032032387,11.825390978311503,NaN,NaN,-25.93670920582525,-32.99504382686579
2008-10-31T09:30:00-04:00,32.36,33.42999,32.09,32.89,224280320,330261010.4,46.12669078301925,36.85428543191329,NaN,NaN,44.932640888190754,-26.24418825874607,0.5356973378921048,-1.84678739701679,-2.382484734908895,95137690,-166379001.2,14.263630070495353,12.446349671503457,NaN,NaN,-23.27986247564947,-31.60716077669203
2008-11-03T09:30:00-05:00,32.81,33.2941,32.50999,32.82001,128502432,316978228,45.89809211786149,37.60989593255687,NaN,NaN,56.1379306925012,8.455473166661799,0.5913449101365091,-1.6433035972382584,-2.2346485073747675,-33364742,-98969644.4,17.21481699564437,13.32389745661403,NaN,NaN,-21.167943671187174,-30.115844047334193
2008-11-04T09:30:00-05:00,33.49001,34.00999,32.98,33.75,182533008,309627873.6,49.48074935572602,39.04056897657461,NaN,NaN,96.14216077302997,40.42279034800897,0.67494710606488,-1.3909646247936678,-2.0659117308585477,149168266,-60527222,18.928672321583193,14.359032005866599,NaN,NaN,-18.323738946094092,-28.431257604299894
2008-11-05T09:30:00-05:00,33.49001,33.60001,31.92,31.99001,184147872,296206851.2,43.596860024436296,39.59837453978754,NaN,NaN,34.69232564980612,50.48317583788265,0.5984815729919339,-1.3178097646186302,-1.9162913376105641,-34979606,9363795.6,22.086787447766568,15.629492744786921,NaN,NaN,-17.447445290324215,-26.862141559446226
2008-11-06T09:30:00-05:00,31.5,31.87,30.3999,30.56,220780432,289615012,39.48812359729867,39.852031153161484,NaN,NaN,-51.518423745653344,36.07732685157494,0.44539163014650107,-1.3595517999274378,-1.8049434300739389,-255760038,-15959686,21.756091942635962,16.60386902002924,NaN,NaN,-17.92413626040775,-25.585283659583585
2008-11-07T09:30:00-05:00,30.92,31.48,30.59,31.19,176977632,274841237.6,42.0780213499357,40.046609440059456,NaN,NaN,-43.562702856307986,18.378258102675186,0.3827501075127302,-1.3265057956830262,-1.7092559031957564,-78782406,-50743705.2,21.284676478728187,17.300519500478668,NaN,NaN,-17.55919831471216,-24.438700038887667
2008-11-10T09:30:00-05:00,31.94,31.97,30.39999,30.77,142737872,268110777.6,40.82359079155429,40.42964127941167,NaN,NaN,-39.40323512840193,-0.7299750615054392,0.3122027625912547,-1.3190024499566881,-1.6312052125479428,-221520278,-88374812.4,20.760576353936244,17.657115430885845,NaN,NaN,-17.616705747283003,-23.464129425801286
2008-11-11T09:30:00-05:00,30.47,30.75999,29.72,30.10001,162921184,259141252.8,38.834682371141156,40.8001112443771,NaN,NaN,-84.39470131174345,-36.837347478460124,0.2237330587899744,-1.3515388890604747,-1.575271947850449,-384441462,-195096758,19.308507109232636,17.60260242991625,NaN,NaN,-18.232060023545717,-22.716690939764774
2008-11-12T09:30:00-05:00,29.64999,29.8,28.64999,28.71001,184936256,252783649.6,35.0224349075979,40.916391747578984,NaN,NaN,-136.05358289979833,-70.98652918838101,0.08220840669625273,-1.472511439480133,-1.5547198461763858,-569377718,-301976380.4,17.95413422982716,17.501927963700528,NaN,NaN,-19.909832750439723,-22.315711198432624
2008-11-13T09:30:00-05:00,28.63,30.53,27.28,30.46001,318269184,243951444.8,42.65491157427277,41.72614395892776,NaN,NaN,-101.52670181189328,-80.98818480162899,0.11504899177868677,-1.4109086064530274,-1.5259575982317142,-251108534,-301046079.6,18.008044804594206,17.54072233421088,NaN,NaN,-19.069669288364704,-21.85199092556578
2008-11-14T09:30:00-05:00,29.8,30.42,28.87,28.98,259407120,240592149.6,38.53259282079355,42.36011365845569,NaN,NaN,-92.95564867814564,-90.86677396599653,0.04906285953865486,-1.4646290238083957,-1.5136918833470505,-510515654,-387392729.2,16.898194646942727,17.6682185964458,NaN,NaN,-19.645133228077892,-21.536725540210366
2008-11-17T09:30:00-05:00,28.49001,29.23,28.25999,28.37,202894880,239097728,36.947665345988845,41.971943899381095,NaN,NaN,-124.05017110975979,-107.79616116226809,-0.01999666092176522,-1.538687709499257,-1.5186910485774918,-713410534,-485770780.4,15.710193836772874,17.799109142204134,NaN,NaN,-20.60465214248126,-21.403572197677637
2008-11-18T09:30:00-05:00,28.56,28.75,27.39,28.34,252794192,239740819.2,36.86734987983911,41.592848074576736,NaN,NaN,-130.4234601550008,-117.00191293091957,-0.05030248594992415,-1.581569156014897,-1.5312666700649729,-966204726,-602123433.2,14.419046705430333,17.92216414111584,NaN,NaN,-21.397824537610006,-21.40275110338226
2008-11-19T09:30:00-05:00,28.39999,28.78,26.78999,26.86,244288944,237455592.8,33.05041899005877,40.67158456496601,NaN,NaN,-140.21152846705436,-117.83350204437079,-0.14715052703399456,-1.7152048288574662,-1.5680543018234716,-1210493670,-730346623.6,13.137641267653436,17.980786729374486,NaN,NaN,-23.255898247711336,-21.667486409714986
2008-11-20T09:30:00-05:00,26.53999,27.45,25.47,25.56,342471424,235680821.6,30.10234100566761,39.52698815229804,NaN,NaN,-168.007088107419,-131.12957930347594,-0.268806440353752,-1.9040623522656617,-1.6352559119119097,-1552965094,-990717935.6,10.999921240626009,17.747664670098107,NaN,NaN,-25.781742377844957,-22.25523726230498
2008-11-21T09:30:00-05:00,25.96001,26.67999,25.05,26.67,282766336,233712668,35.400843635469556,38.777184689270044,NaN,NaN,-148.74872149870313,-142.2881938675874,-0.24522080932730916,-1.941781923571046,-1.696561114243737,-1270198758,-1142654556.4,9.979464327897318,17.23085376525903,NaN,NaN,-26.315892776511994,-22.835330907191697
2008-11-24T09:30:00-05:00,27.22,28.64,26.98,28.3,225212496,232998608.8,42.315903259436425,38.2654099681065,NaN,NaN,-76.67131514189994,-132.81242267401547,-0.09809289684007627,-1.8191772352938322,-1.721084338453756,-1044986262,-1208969702,9.562488416851181,16.561840629206745,NaN,NaN,-24.586700974403218,-23.085526631079055
2008-11-25T09:30:00-05:00,28.62,28.64,27.52,28.17,203052496,226782849.6,41.93039079514656,38.14637645172866,NaN,NaN,-64.73730339984102,-119.67519132298351,0.006660721200099529,-1.7127584369536315,-1.719419158153731,-1248038758,-1265336508.4,9.210223579648215,15.64208606719829,NaN,NaN,-23.32302389198877,-23.119454811209014
2008-11-26T09:30:00-05:00,27.88,29.36,27.81,29.35001,165061312,217966372.8,46.67893657832682,38.66000595037353,NaN,NaN,-35.504838141101594,-98.73385325779296,0.16295019129938226,-1.5157314190295033,-1.6786816103288855,-1082977446,-1239833263.6,10.811129207050811,14.860303014656495,NaN,NaN,-20.785573295437956,-22.786043166098864
2008-11-28T09:30:00-05:00,29.03999,29.19,28.83,29.12,41242832,207263911.2,45.89118958286186,38.932375109868254,NaN,NaN,-23.64008771299268,-69.8604531789077,0.25299280399165003,-1.362440605339323,-1.615433409330973,-1124220278,-1154084300.4,16.163892189845953,14.494532708307762,NaN,NaN,-18.945172037654537,-22.237347290606817
2008-12-01T09:30:00-05:00,28.5,28.50999,26.89,26.92999,149331056,203516448,39.12154506933791,38.81080041542423,NaN,NaN,-79.56230094675922,-56.023169068518925,0.17113374447230933,-1.4015162287405865,-1.5726499732128958,-1273551334,-1154754815.6,16.155727150327067,14.165614908049964,NaN,NaN,-19.358436552380763,-21.826074328003095
2008-12-02T09:30:00-05:00,27.28,27.89,26.84039,27.83,181779312,206180292,42.85249759639072,39.097787217227776,NaN,NaN,-71.35292558480172,-54.95949115709927,0.18262904339463448,-1.3443636689696028,-1.5269927123642373,-1091772022,-1164111967.6,16.034003752423516,13.931721811135025,NaN,NaN,-18.54819187544814,-21.35780540620953
2008-12-03T09:30:00-05:00,27.13,28.71001,27.07001,28.62,231010688,208604176,45.981889332768425,39.88060539045424,NaN,NaN,-37.67115155000949,-49.54626078713298,0.24459761332060492,-1.2212456957134812,-1.465843309034086,-860761334,-1086656482.8,21.318611398888805,14.172041608925145,NaN,NaN,-16.915979230968357,-20.723258809746504
2008-12-04T09:30:00-05:00,28.14999,28.78,27.32001,27.81,188924192,208842992,43.360112690081365,39.930976898726286,NaN,NaN,-39.34423705579037,-50.314140570070734,0.2322876073021527,-1.1754837999063952,-1.4077714072085479,-1049685526,-1079998098.8,21.774395922074632,14.441066688745176,NaN,NaN,-16.333032192256912,-20.096083578676563
2008-12-05T09:30:00-05:00,27.5,29.07001,26.95,28.94,212310880,208419514.4,47.829158704222145,40.59501731897119,NaN,NaN,-12.232693758335294,-48.032661779139254,0.29734337711596615,-1.0360921858135903,-1.3334355629295565,-837374646,-1022628972.4,25.764578942455742,15.074379852710392,NaN,NaN,-14.470565233591406,-19.292438100807253
2008-12-08T09:30:00-05:00,29.55,30.46001,29.44,30.08,185853312,208863298.4,51.94834895903247,41.66649471990287,NaN,NaN,107.35054497815457,-10.650092594156463,0.4074406563794395,-0.8241347424552572,-1.2315753988346967,-651521334,-898222972.4,33.666368150434025,16.356963732257615,NaN,NaN,-11.605009471882497,-18.19423401096086
2008-12-09T09:30:00-05:00,29.67999,30.83,29.57001,30.00999,178390064,210645908,51.67849191893569,42.7244334369812,NaN,NaN,127.15062128438545,29.05061677968097,0.4618489487921298,-0.6542642128445344,-1.1161131616366642,-829911398,-845850847.6,36.72005103590841,17.94989261300605,NaN,NaN,-9.379756170614998,-16.93502289091145
2008-12-10T09:30:00-05:00,30.09,30.46001,29.62,29.91,162457568,210622727.2,51.26885714771455,44.02575044824233,NaN,NaN,119.00377791994794,60.38560267367245,0.47553438979000384,-0.5216951743991594,-0.9972295641891632,-992368966,-872172374,35.82736129814019,19.570586900897958,NaN,NaN,-7.666673298446729,-15.610972949130776
2008-12-11T09:30:00-05:00,29.8,30.27,28.94,29.09,167448880,209748358.4,47.914596659727906,45.29805442353235,NaN,NaN,73.96631514981556,83.04771311479365,0.41594492783217263,-0.47729840439894744,-0.8932433322311201,-1159817846,-894198838,35.05926015837264,21.289111109308436,NaN,NaN,-7.106188761503909,-14.396003779469796
2008-12-12T09:30:00-05:00,28.69,29.86,28.47,29.67999,158613808,201765589.6,50.427630350494894,46.37139633174844,NaN,NaN,67.60642068233425,99.01553600292755,0.4025861995139516,-0.3900105828386806,-0.7925967823526322,-1001204038,-926964716.4,33.89512724092853,22.997372745953523,NaN,NaN,-5.9300365487867746,-13.186579889372222
2008-12-15T09:30:00-05:00,29.73,29.75999,28.74001,29.16,107938944,194192180.8,48.21942561638923,46.79307650010221,NaN,NaN,60.567843255606284,89.6589956584179,0.34715038014775257,-0.3586588071679415,-0.7058091873156941,-1109142982,-1018489046,30.816980428209135,24.515550746764802,NaN,NaN,-5.5296771624183805,-12.09273664266453
2008-12-16T09:30:00-05:00,29.42,30.66,29.0993,30.56,172053680,192650120.8,54.0531302020787,47.65898645774023,NaN,NaN,110.60600889528361,86.35007318059753,0.38998554295153565,-0.21832725862627456,-0.6083128015778102,-937089302,-1039924626.8,30.126915255663135,26.00960015219444,NaN,NaN,-3.4754894625949246,-10.861701331226016
2008-12-17T09:30:00-05:00,30.23,30.60001,29.82001,30.19,159965376,188008680,52.373747815880215,48.06575868899404,NaN,NaN,102.86016033694638,83.12134966399722,0.37832344264262485,-0.13540849827452917,-0.513731940917154,-1097054678,-1060861769.2,29.433631990401338,27.339778922433762,NaN,NaN,-2.2318135302077877,-9.628860216794841
2008-12-18T09:30:00-05:00,30.19,30.39999,29.36,29.66,142773808,182932923.2,49.97839295501985,48.357701787005325,NaN,NaN,70.74284160957828,82.47665495594977,0.32204175830744086,-0.11117974303285294,-0.4332215013402938,-1239828486,-1076863897.2,28.886495198177954,28.24853628017176,NaN,NaN,-1.8414086399463694,-8.516367134387917
2008-12-19T09:30:00-05:00,29.98,30.37,29.66,29.86,118332944,171725999.2,50.89114915097298,49.1983877928364,NaN,NaN,75.59635616573819,84.07464205263055,0.2865966583008646,-0.07497567846421305,-0.36157233676507766,-1121495542,-1100922198,28.042498658543252,29.097591387901492,NaN,NaN,-1.2686147848768496,-7.480973941600621
2008-12-22T09:30:00-05:00,29.86,29.92,28.74001,29.21001,95416320,162358498.4,47.83612594835627,49.554361246548225,NaN,NaN,20.58378129852938,76.07782966121518,0.21117202856714729,-0.09760730105614357,-0.30877932962329085,-1216911862,-1122475974,27.273664955623374,29.900424330987196,NaN,NaN,-1.6046526812932462,-6.641499475842425
2008-12-23T09:30:00-05:00,29.28,29.62,28.89,29.06,68804624,154538104.8,47.13290040010777,49.636576322786745,NaN,NaN,7.795539042119346,55.515735690582325,0.14606913964333262,-0.12619290506912506,-0.2722620447124577,-1285716486,-1192201410.8,24.895764179293778,30.155935243873266,NaN,NaN,-2.0745263718794917,-5.989074746704863
2008-12-24T09:30:00-05:00,29.2,29.21001,28.98,29.14,27210320,145745996,47.575516552793815,49.93767659869478,NaN,NaN,-4.190032836164624,34.10569705596012,0.1051942986473296,-0.1407691714032957,-0.2459634700506253,-1258506166,-1224491708.4,23.858340978797827,30.304788462210638,NaN,NaN,-2.359300175153447,-5.470535522197518
2008-12-26T09:30:00-05:00,29.19,29.23,28.97,29.13,20946304,138540245.6,47.521957758160475,49.915733673976085,NaN,NaN,-5.639594231912217,18.829209887662024,0.07566450659585056,-0.1513828368058121,-0.22704734340166266,-1279452470,-1232416505.2,23.598436066677337,30.150063971083604,NaN,NaN,-2.6140959639960144,-5.062472728168732
2008-12-29T09:30:00-05:00,29.23,29.24001,28.46001,28.89,52742528,139115230.4,46.178322596120886,49.50358893376812,NaN,NaN,-28.871382570130667,-2.064337859511757,0.0399430545337319,-0.17711852523449778,-0.21706157976822968,-1332194998,-1274556396.4,22.212744944831314,29.331948027826268,NaN,NaN,-3.1679880470655952,-4.791832059439712
2008-12-30T09:30:00-05:00,28.98,29.59,28.94,29.49001,77131120,135505233.6,49.98559599714297,49.38266779649721,NaN,NaN,10.04001162917045,-4.173091793383541,0.055729804955872875,-0.14739932357338859,-0.20312912852926146,-1255063878,-1282186799.6,21.96127875727943,28.2777500079242,NaN,NaN,-2.7168322908909848,-4.495403521075608
2008-12-31T09:30:00-05:00,29.48,30.08,29.45,29.74001,89221184,130877327.2,51.52427268233946,49.40091176325613,NaN,NaN,51.124829375647174,4.492766273322028,0.08050949126064982,-0.10249226445344917,-0.183001755714099,-1165842694,-1258212041.2,24.840357282150336,27.492964006782067,NaN,NaN,-1.9384868549011405,-4.1301297116221125
2009-01-02T09:30:00-05:00,29.77,31.13,29.69,31.03,107920256,124722805.6,58.60156616051498,50.164266727598054,NaN,NaN,145.0610169502811,34.34297623061117,0.1758130182297099,0.036764517073038405,-0.1390485011566715,-1057922438,-1218095295.6,29.525587830389867,27.097701697640442,NaN,NaN,0.7796316761630621,-3.428735227652802
2009-01-05T09:30:00-05:00,30.82001,31.33,30.59,31.02,91816624,119867427.2,58.530228078720135,50.74302370818557,NaN,NaN,172.85753191869787,70.04240146073319,0.2269605156697899,0.14465214343056587,-0.08230837223922402,-1149739062,-1192152614,32.457799510671165,26.995035431193486,NaN,NaN,3.0153704216456014,-2.5081487063244587
2009-01-06T09:30:00-05:00,31.28,31.63,31.11,31.33,136820000,116092883.2,60.14976003779964,51.59519045257203,NaN,NaN,198.69496925661133,115.55567182608158,0.26765499640955737,0.25226037327272266,-0.015394623136834679,-1012919062,-1128297426.8,39.16697665244072,27.591463732924314,NaN,NaN,5.382524452503222,-1.3809096836347903
2009-01-07T09:30:00-05:00,30.81,30.89999,30.19,30.44,134061872,113503311.2,53.66942027899035,51.56778260092286,NaN,NaN,83.73353050947863,130.29437560214325,0.22247322040628564,0.2626969023710224,0.040223681964736746,-1146980934,-1106680838,41.2929601923193,28.3890383712569,NaN,NaN,5.7576580464602864,-0.36111429362120795
2009-01-08T09:30:00-05:00,30.34,30.8,30.08,30.75999,131926064,111180111.2,55.52471824419637,51.792851917231154,NaN,NaN,82.32376141517845,136.53416201004947,0.2025460473051933,0.29340624109622837,0.09086019379103508,-1015054870,-1076523273.2,44.22169213191427,29.445328381364963,NaN,NaN,6.587231859467832,0.631506585391512
2009-01-09T09:30:00-05:00,30.78999,30.78999,29.92,30.07001,117168320,108915648.8,50.800811028110154,51.85159606530904,NaN,NaN,46.382385038949444,116.79843562778315,0.13457701604369193,0.25908146384565,0.12450444780195807,-1132223190,-1091383423.6,43.08120880582748,30.45923649619707,NaN,NaN,5.977587244180083,1.3952323937898794
2009-01-12T09:30:00-05:00,30.12,30.14999,29.2,29.52,102778880,105682148.8,47.34308694851603,51.59816305084782,NaN,NaN,-27.108728144024035,76.80518361523878,0.04868515790779432,0.18536089518670096,0.13667573727890664,-1235002070,-1108436025.2,41.75054644748597,31.438382766835836,NaN,NaN,4.4435748999358875,1.8307098946678806
2009-01-13T09:30:00-05:00,29.52,29.98,29.17999,29.53,186387376,107070827.2,47.413169641405965,51.567951886065664,NaN,NaN,-35.92809380390992,29.880571003134527,-0.008310221165407888,0.12628796082214677,0.13459818198755466,-1048614694,-1115575151.6,41.177123452678735,32.43148694519693,NaN,NaN,3.2025208628227686,2.026682890118579
2009-01-14T09:30:00-05:00,29.17,29.28,28.47,28.63,137103248,108529042.4,41.99580035991053,51.201016168908716,NaN,NaN,-119.38618396390963,-10.743371891543124,-0.10226118842757496,0.006771696453085951,0.10903288488066092,-1185717942,-1123322553.2,40.52662088487962,33.54797670988163,NaN,NaN,0.47509101778212515,1.8050269083562285
2009-01-15T09:30:00-05:00,28.55,29.34,28.07001,29.099,192790752,109565896,45.491005261253434,51.05212250522726,NaN,NaN,-102.61790344852335,-47.731704864283486,-0.12685068176725642,-0.0495304673284096,0.07732021443884682,-992927190,-1118897017.2,41.0990344501185,34.77945481497597,NaN,NaN,-0.8665784698566122,1.4233689971829655
2009-01-16T09:30:00-05:00,29.53,29.60001,28.7,29.42,175490368,110342145.6,47.809067700728,51.07263035826781,NaN,NaN,-53.90831901738218,-67.78984567554981,-0.11583262101630491,-0.06747056183153433,0.04836205918477059,-817436822,-1055939743.6,48.668055856628584,36.57014194282963,NaN,NaN,-1.3445791883723226,1.0279478278179244
2009-01-20T09:30:00-05:00,29.28999,29.42999,27.96001,27.96001,135251008,109966005.6,39.567260175936816,50.600411613968944,NaN,NaN,-122.6705431161991,-86.90220866998483,-0.1964686352541482,-0.19722373488291467,-0.0007550996287664716,-952687830,-999476895.6,54.33561990814071,38.864633011637444,NaN,NaN,-4.440280951579729,0.24677228790397387
2009-01-21T09:30:00-05:00,28.42999,29.19,28.10001,29.14999,149242688,111511492.8,47.509887114421275,50.42357526520311,NaN,NaN,-78.92710626914298,-95.50201116303144,-0.16076188860125948,-0.20170746038034082,-0.04094557177908135,-803445142,-950442985.2,58.609549019612075,41.48236660180406,NaN,NaN,-4.53517450003597,-0.436362967516018
2009-01-22T09:30:00-05:00,28.52,29.23,28.25999,28.75999,200602624,116770808,45.403719454579935,49.98639289179171,NaN,NaN,-79.95745633519394,-87.61626563728831,-0.15446978363376213,-0.234032801321284,-0.07956301768752189,-1004047766,-914108950,61.486081252724404,44.09991831398792,NaN,NaN,-5.293969438946951,-1.1303067491490084
2009-01-23T09:30:00-05:00,28.31,29.35001,28.14,28.89999,170164064,121838780,46.323618741888794,49.10939664760413,NaN,NaN,-71.98286799437265,-81.48925854645816,-0.1327686190516808,-0.2455237915021229,-0.11275517245044209,-833883702,-882300252.4,63.85440670488437,46.551976805023244,NaN,NaN,-5.618821638618203,-1.7715231619303218
2009-01-26T09:30:00-05:00,28.96001,29.59,28.75,29.11,140481008,127502314.4,47.74592784266904,48.33908948788619,NaN,NaN,-39.19045732364137,-78.54568620771,-0.09777648415011075,-0.23497577763808053,-0.13719929348796978,-693402694,-857493426.8,65.62949350299968,48.921383518761,NaN,NaN,-5.465839173843888,-2.299282592203688
2009-01-27T09:30:00-05:00,29.14,29.57001,29.12,29.32001,110914816,132000740,49.195687537749535,47.556655737882615,NaN,NaN,-23.03780785843307,-58.619139156156805,-0.056065319688946846,-0.20728094309915335,-0.1512156234102065,-582487878,-783453436.4,70.31522912456253,51.14625869534113,NaN,NaN,-4.923875874575683,-2.6742244896854017
2009-01-28T09:30:00-05:00,29.83,30.64999,29.81,30.35001,139797248,136353476,55.68903994971562,47.70091428579156,NaN,NaN,58.25793411123221,-31.182131080081756,0.0401282645237194,-0.10105529275555725,-0.14118355727927664,-442690630,-711302534,74.03068748617575,53.48466778775945,NaN,NaN,-2.4418068400487476,-2.641021968308737
2009-01-29T09:30:00-05:00,29.97,30.4008,29.48,29.58,130772816,139035560.8,50.49331553071787,47.341528377685954,NaN,NaN,13.868219317617328,-12.416995949519503,0.050463853819567694,-0.07810374000481701,-0.1285675938243847,-573463446,-625185670,77.6296876613674,55.870953182720385,NaN,NaN,-1.8952151643899529,-2.534478139177482
2009-01-30T09:30:00-05:00,29.82001,29.92999,28.94,29.06,140355184,141592260.8,47.284900665712726,47.09039192322899,NaN,NaN,-31.806128050881032,-4.3816479608211845,0.022283543378099374,-0.1007131646017605,-0.12299670797985987,-713818630,-601172655.6,78.52346391023757,58.40254283303539,NaN,NaN,-2.4278469099900604,-2.5192451064364216
2009-02-02T09:30:00-05:00,28.77,29.61,28.74001,29.41,126883376,142540416.8,49.60595463028773,47.25202532906983,NaN,NaN,-32.78753064031641,-3.101062624156197,0.02691005041586554,-0.08935914496002795,-0.11626919537589349,-586935254,-579879167.6,79.31276730485983,61.085558608562096,NaN,NaN,-2.17032890823141,-2.4693999352642773
2009-02-03T09:30:00-05:00,29.46001,30.42709,29.03,29.87,120609312,143980051.2,52.56225601211397,47.61981721269183,NaN,NaN,28.004072173417374,7.107313382213891,0.058815315503785354,-0.042750050996161804,-0.10156536649994716,-466325942,-556646780.4,80.16912144682416,63.870701322429625,NaN,NaN,-1.0666656082953327,-2.2690093171258567
2009-02-04T09:30:00-05:00,29.92999,30.8667,29.78999,29.91,175780816,145928092,52.821435750373865,48.39307688343921,NaN,NaN,89.80005195650345,13.415736951268139,0.07920838013874876,-0.0025548913265112105,-0.08176327146525997,-290545126,-526217679.6,81.2631473611657,66.78045321359292,NaN,NaN,-0.09673464281287769,-1.9586843636525741
2009-02-05T09:30:00-05:00,29.47,30.77,29.46001,30.57001,217569568,150103476.8,56.99643750698083,49.21489347241974,NaN,NaN,103.52400835957705,31.346894759660085,0.13070384023512274,0.08161652882864345,-0.04908731140647928,-72975558,-426120102,84.32634530074718,69.86811827435211,NaN,NaN,1.9843070914705805,-1.3953998700635522
2009-02-06T09:30:00-05:00,30.71001,31.50999,30.58,31.37,164509632,151732655.2,61.44951740540848,50.18921130846834,NaN,NaN,199.66836864261379,77.64179409835904,0.20762949823334645,0.21044956138520376,0.002820063151857323,91534074,-265049561.2,87.78650169795542,72.66229297730402,NaN,NaN,5.1945236005946205,-0.453982231398099
2009-02-09T09:30:00-05:00,31.39,31.67,31.19,31.5,98853872,150816932.8,62.13568411630818,51.80124158992344,NaN,NaN,204.34780671622846,125.06886156966803,0.2532313152989598,0.3193592072755571,0.06612789197659727,190387946,-109584921.2,90.06604495011678,75.21446619458803,NaN,NaN,8.016783155708533,0.756127109617134
2009-02-10T09:30:00-05:00,31.3,31.67999,30.10001,30.34,232790560,157317516.8,53.060231632308565,52.19769476977253,NaN,NaN,107.83986152753951,141.03601944049245,0.1939074813918623,0.30851224371642516,0.11460476232456285,-42402614,-24800255.6,91.04740234018342,77.53145571748598,NaN,NaN,7.785126516991703,1.760269882099215
2009-02-11T09:30:00-05:00,30.34,30.53,29.73,30.2,169172560,156456776,52.0717153720523,52.67398019244913,NaN,NaN,49.14310171737503,132.90462939266678,0.13658019832459845,0.2853300102303109,0.14874981190571246,-211575174,-9006265.2,91.22137882686881,79.65540554421058,NaN,NaN,7.300655134869238,2.5517534896377896
2009-02-12T09:30:00-05:00,29.83,30.61,29.64,30.57001,201151376,159659182.4,54.48516246149666,53.25694760099255,NaN,NaN,54.129568837265275,123.0257414882044,0.11574585837568385,0.2934321348753173,0.17768627649963342,-10423798,3504086.8,91.36452834656747,81.62041423290223,NaN,NaN,7.601104194461046,3.27308930461254
2009-02-13T09:30:00-05:00,30.46001,30.78,30.28999,30.42999,145060560,157272672.8,53.38953395996661,53.66006232365667,NaN,NaN,68.71892052424823,96.8358518645313,0.08606402741365429,0.2852663107667013,0.199202283353047,-155484358,-45899599.6,85.43941882050592,83.03540889843839,NaN,NaN,7.537128541711234,3.882237767055211
2009-02-17T09:30:00-05:00,29.47,29.67,29.06,29.22,157782496,156387279.2,44.973325816945255,53.35846505788493,NaN,NaN,-45.32421663185935,46.901447194913736,-0.016086411967507958,0.17909426839366205,0.19518068036117,-313266854,-146630559.6,74.78946997829303,83.35499753084771,NaN,NaN,4.837531348896874,4.018708278746877
2009-02-18T09:30:00-05:00,29.41,29.66991,28.87,29.24001,161268256,157688141.6,45.12737735774851,52.60406058703013,NaN,NaN,-58.029832796132666,13.727508330179296,-0.07977148564502931,0.09546632330488336,0.17523780894991267,-151998598,-168549756.4,72.66685156933806,83.25758067964502,NaN,NaN,2.72516266983183,3.8339160489018704
2009-02-19T09:30:00-05:00,29.42999,29.61,28.72,28.78999,155322368,157992125.6,42.26181207945079,52.016096054796776,NaN,NaN,-82.98359008587528,-12.697830030470758,-0.14582313767301985,-0.007041113141362132,0.13878202453165772,-307320966,-187698914.8,70.77697599039351,82.76810127457544,NaN,NaN,0.06502776883579332,3.2955034374638594
2009-02-20T09:30:00-05:00,28.46001,29.14999,28.39,28.87,210752368,158499612.8,42.95536902470321,51.70684379472467,NaN,NaN,-108.25345073114583,-45.17443394415297,-0.17573794163733977,-0.080890402515017,0.09484753912232277,-96568598,-204927874.8,69.03727518084594,82.0905163653332,NaN,NaN,-1.9259859657458498,2.549576379862472
2009-02-23T09:30:00-05:00,29.03,29.05,27.73,27.86,169469872,158464903.2,36.925508736896745,50.801097659482465,NaN,NaN,-159.96889815563304,-90.91199768012923,-0.250596035287523,-0.218397504987081,0.03219853030044201,-266038470,-227038697.2,66.76903934723062,81.1945357969311,NaN,NaN,-5.626374411639609,1.3815834096478892
2009-02-24T09:30:00-05:00,28,28.98,27.96001,28.78,181335808,160507643.2,44.5597535763384,50.22949034264135,NaN,NaN,-116.04490031719426,-105.0561344171962,-0.22596027702744342,-0.25025181598386226,-0.02429153895641885,-84702662,-181325858.8,69.03422836463189,80.39918629106023,NaN,NaN,-6.503509535021015,0.25514156040947444
2009-02-25T09:30:00-05:00,28.62,29.17,28.14,28.59,220223008,165973052.8,43.39168248737729,49.5559365381416,NaN,NaN,-101.38934317657821,-113.72803649328532,-0.21057774472207885,-0.2875137198590174,-0.07693597513693856,-304925670,-211911273.2,65.80228749431262,79.29483915771358,NaN,NaN,-7.5689009728800025,-0.8625788014890221
2009-02-26T09:30:00-05:00,28.78,28.95,27.7,27.78999,211282816,169547331.2,38.78188443296193,48.25489703285454,NaN,NaN,-126.66354400566229,-122.4640272772427,-0.240250796771922,-0.37724947110184104,-0.13699867432991905,-516208486,-253688777.2,61.562647103112326,77.66886071502537,NaN,NaN,-9.960966826452927,-2.162348519341008
2009-02-27T09:30:00-05:00,27.49001,27.98,27.39,27.53,204492560,173233318.4,37.3916255829481,46.53647618839308,NaN,NaN,-145.93819581241056,-130.00097629349565,-0.2615979108246458,-0.46399606286072625,-0.20239815203608047,-720701046,-378515266.8,50.99124491030988,75.0406280873364,NaN,NaN,-12.342260000804973,-3.6166215881215744
2009-03-02T09:30:00-05:00,27.12,27.50999,26.47,26.64,188175936,175624356,33.026938403184715,44.45728006602712,NaN,NaN,-173.0966718172555,-132.62653102582016,-0.3162169690751041,-0.5976693633799606,-0.28145239430485647,-908876982,-507082969.2,42.83289153376704,71.66683141474,NaN,NaN,-15.849876067696849,-5.364229370918042
2009-03-03T09:30:00-05:00,26.85001,27.16,26.42,26.62,158739936,177217184,32.93390334028763,43.01968518802562,NaN,NaN,-155.50266282657716,-140.51808352769675,-0.3325849261188186,-0.6971835519533798,-0.36459862583456115,-1067616918,-703665820.4,33.9014167599786,67.58497530186823,NaN,NaN,-18.660742913824482,-7.263731305618961
2009-03-04T09:30:00-05:00,27.00999,27.71001,26.92,27.33,164906128,179432024.8,39.45430899899741,42.11844187566455,NaN,NaN,-105.40382221257107,-141.3209793348953,-0.2767748757095879,-0.7105672204715461,-0.43379234476195816,-902710790,-823222844.4,29.82779186369359,63.19971909021285,NaN,NaN,-19.127382601964417,-8.958538633668311
2009-03-05T09:30:00-05:00,27.03,27.24001,26.42,26.50999,199616432,180623805.6,35.197983334831406,40.74078622375989,NaN,NaN,-123.44371623526249,-140.67701378081534,-0.2756615415035326,-0.7783692716413739,-0.5027077301378413,-1102327222,-940446591.6,26.469392428236276,58.56435223890348,NaN,NaN,-20.882130963793948,-10.661908966543402
2009-03-06T09:30:00-05:00,26.63,26.81,25.71001,26.3,218421568,180666405.6,34.18105574755592,39.36875206573056,NaN,NaN,-131.3579133689518,-137.7609572921236,-0.26933107248518806,-0.8393715707443263,-0.5700404982591383,-1320748790,-1060456140.4,23.546442163799156,54.143425334852985,NaN,NaN,-22.614025384520335,-12.369354169111535
2009-03-09T09:30:00-04:00,26.05,26.81,25.6301,25.74001,181154000,181498624,31.562231851977444,38.410816782518566,NaN,NaN,-128.5389026623437,-128.84940346114124,-0.28178478042766053,-0.9222714737937139,-0.6404866933660534,-1501902790,-1179061302,21.070070062166238,50.30632534084394,NaN,NaN,-24.89801041946828,-14.159162204876784
2009-03-10T09:30:00-04:00,26.25999,27.39,26.16,27.33,175068128,185309336.8,44.55209967858163,38.36972551972093,NaN,NaN,-73.99410084639126,-112.54769106510405,-0.16751025726157442,-0.8498745149430214,-0.6823642576814469,-1326834662,-1230904850.8,20.0761600338424,46.54984737402282,NaN,NaN,-22.589377844628913,-15.363478724841373
2009-03-11T09:30:00-04:00,27.63,27.99001,27.25999,27.75,173147936,182327205.6,47.39260291895506,38.736210579685526,NaN,NaN,-29.266698634590135,-97.32026634950788,-0.05407963203441468,-0.7499637977244653,-0.6958841656900506,-1153686726,-1281100038,19.13500387884602,42.86113508034085,NaN,NaN,-19.78413042176879,-15.995000395831005
2009-03-12T09:30:00-04:00,27.72,28.75999,27.44,28.67,184511056,183094130.4,53.06457586856533,39.45829678281853,NaN,NaN,14.529976257324082,-69.72552785099056,0.08490792383343626,-0.5897492608982553,-0.6746571847316916,-969175670,-1254469727.6,21.24441500947215,39.44735935381415,NaN,NaN,-15.446262605209254,-15.916609282885041
2009-03-13T09:30:00-04:00,28.67999,28.84,28.32001,28.74001,156783504,180875736.8,53.475654162846226,40.64045002752921,NaN,NaN,45.182680089330056,-34.41740915933419,0.1781902129603129,-0.45191941853130047,-0.6301096314916134,-812392166,-1152798402.8,28.872969904335505,36.74049725075021,NaN,NaN,-11.93469926208383,-15.347764994199153
2009-03-16T09:30:00-04:00,28.89999,28.98,28.19,28.25999,190329440,183139180.8,50.22741101959393,41.045282702047466,NaN,NaN,45.65816029826066,0.42200343278667984,0.2024275534452582,-0.3770751896850406,-0.5795027431302988,-1002721606,-1052962166,35.48170300194785,34.34388829627279,NaN,NaN,-10.011002221449331,-14.58537031237775
2009-03-17T09:30:00-04:00,28.41,29.33,28.3,29.33,169852368,183742674.4,56.5614525430015,41.98598056316348,NaN,NaN,87.5450686505092,32.729837332166774,0.28057621641196173,-0.22878247261534668,-0.5093586890273084,-832869238,-954169081.2,41.2945024351793,32.59333222062041,NaN,NaN,-6.216438558859318,-13.389808633303687
2009-03-18T09:30:00-04:00,29.23,30.2,29.08,29.7,208146880,186086605.6,58.52687539772354,43.396337060646445,NaN,NaN,135.6776931967768,65.71871569844015,0.3431062770261545,-0.08047584274461528,-0.42358211977076976,-624722358,-848376207.6,46.819930095302105,31.54028100577682,NaN,NaN,-2.504956198087799,-11.834829713987132
2009-03-19T09:30:00-04:00,30.12,30.13,29.46001,29.67999,146766496,185658812,58.37305173289807,44.89501035707145,NaN,NaN,135.32378292920674,89.8774770328167,0.36689743549084913,0.03503967459279167,-0.33185776089805746,-771488854,-808838844.4,48.760924920695544,31.380972435090083,NaN,NaN,0.39508853958222545,-10.087698534905796
2009-03-20T09:30:00-04:00,29.66,30.03,28.98,29.17999,149437376,182593062.4,54.51729427089318,46.430035776193485,NaN,NaN,103.54342634512585,101.54962628397585,0.33369255481869736,0.08525793262531423,-0.24843462219338314,-920926230,-830545657.2,47.73089905549637,31.73083011521361,NaN,NaN,1.7330971982990533,-8.399013430162245
2009-03-23T09:30:00-04:00,29.86,30.94,29.19839,30.89999,179642560,183101696.8,63.45900810666501,48.61040040236329,NaN,NaN,148.57413530934568,122.13282128619285,0.4074189765693579,0.2608390985183142,-0.14657987805104367,-741283670,-778258070,50.44633285371732,32.91260983619494,NaN,NaN,6.0377838413580855,-6.336613819945056
2009-03-24T09:30:00-04:00,30.64999,30.88,30.31,30.33099,120849440,180077378.4,59.305295439755284,50.02832800527458,NaN,NaN,140.7204994325199,132.767907442595,0.39729578348113337,0.3500398513003731,-0.04725593218076031,-862133110,-784110844.4,50.13238291468598,34.362937768408685,NaN,NaN,8.190885690868225,-4.26125674697173
2009-03-25T09:30:00-04:00,30.58,31.05,29.66,30.47,190601568,178596306.4,59.99423981515517,51.79948918244055,NaN,NaN,119.24795301784874,129.48195940680938,0.37942597746265916,0.42702653964756365,0.04760056218490448,-671531542,-793472681.2,49.60063959342188,36.01516970877909,NaN,NaN,10.109014531069468,-2.208360850108702
2009-03-26T09:30:00-04:00,30.88,31.46001,30.41701,31.41,182459440,177155137.6,64.38505385826979,53.95691761892012,NaN,NaN,135.05608460539054,129.42841974204615,0.40789003128496937,0.5574631012911162,0.14957307000614684,-489072102,-736989330.8,52.85008102395001,38.108286770218434,NaN,NaN,13.198315236041827,-0.007407123515769332
2009-03-27T09:30:00-04:00,31.07001,31.17999,30.71001,30.82001,156108000,174735909.6,59.938439846910754,55.98378961855822,NaN,NaN,110.73671674107653,130.86707782123628,0.36533306673011195,0.6062394034187868,0.24090633668867484,-645180102,-681840105.2,55.84359344091366,40.59210986870039,NaN,NaN,14.357525848218703,2.0447261581605836
2009-03-30T09:30:00-04:00,30.28999,30.32001,29.62,30.06,162919632,173473094.4,54.697918350532355,56.70849095226898,NaN,NaN,61.6721370723913,113.48667817384539,0.2688094630055923,0.5769181654456652,0.30810870244007293,-808099734,-695203318,54.93348443986499,43.08191875484486,NaN,NaN,13.651797329167312,3.702879182590116
2009-03-31T09:30:00-04:00,30.31,30.95,30.27,30.32001,150243808,173048288,56.11167136090478,57.33128155526539,NaN,NaN,78.71707530462322,101.08599334826607,0.20800316446853923,0.568112658025747,0.3601094935572077,-657855926,-654347881.2,57.22856297848817,45.802887261962155,NaN,NaN,13.51387878130979,5.104450553835784
2009-04-01T09:30:00-04:00,29.94,30.88,29.78999,30.77,137949936,171700478.4,58.52406966938203,57.721245398180876,NaN,NaN,70.65597672774328,91.36759809024498,0.184421345996301,0.590636176052584,0.406214830056283,-519905990,-624022770.8,58.90160055716798,48.492686229654716,NaN,NaN,14.126005403630732,6.393244103806491
2009-04-02T09:30:00-04:00,31.34,32.27,31.23,31.75999,212272320,172333272.8,63.30312135183494,58.4232073402515,NaN,NaN,124.32979574955206,89.22234031907729,0.2194485132715006,0.6805254716456588,0.4610769583741582,-307633670,-587735084.4,60.87384438012027,50.77846297792505,NaN,NaN,16.17566984782312,7.790733495808866
2009-04-03T09:30:00-04:00,32.05,32.39999,31.83,32.35001,134577248,168141056.8,65.83014515970387,59.53768835025936,NaN,NaN,139.69630358852697,95.01425768856738,0.26334915683147453,0.7902634044135013,0.5269142475820268,-173056422,-493310348.4,65.5117135709094,52.92346373285092,NaN,NaN,18.68899693042447,9.347628272182524
2009-04-06T09:30:00-04:00,31.97,32.33,31.64999,32.27,160413632,167104038.4,65.17472225039337,60.15292190078734,NaN,NaN,128.34337603056824,108.34850548020276,0.26715020385493116,0.8608520024006907,0.5937017985457596,-333470054,-398384412.4,69.43427546047907,54.93344752037233,NaN,NaN,20.505780705376964,10.941650048353157
2009-04-07T09:30:00-04:00,31.89999,31.92,31.21001,31.42,147531184,165727191.2,58.50994232480535,60.1517123955789,NaN,NaN,89.35098285041852,110.47528698936182,0.19587049114519672,0.8385399124772555,0.6426694213320587,-481001238,-363013474.8,70.76840226176063,56.644052675119376,NaN,NaN,20.060561394090204,12.244351669172735
2009-04-08T09:30:00-04:00,31.72,32.14999,31.49001,31.95,126126000,163376094.4,61.175879310991405,60.35191436544272,NaN,NaN,106.28722846813149,117.60153733743948,0.1688901607136415,0.8537821222241107,0.6848919615104692,-354875238,-330007324.4,71.99670260203952,58.30375108092966,NaN,NaN,20.49128541954562,13.422485062083148
2009-04-09T09:30:00-04:00,32.53,33.00999,32.42999,32.94,131871440,160744113.6,65.61972704910478,61.14494527817207,NaN,NaN,153.58031543904835,123.45164127533872,0.200061368893393,0.9349686726272104,0.7349073037338174,-223003798,-313081350,72.63180201342662,60.082387006496106,NaN,NaN,22.276971865460858,14.687411748279963
2009-04-13T09:30:00-04:00,32.8,33.07001,32.53,32.89,119310432,158870460,65.21373631861528,61.27028300759708,NaN,NaN,136.35514846551823,122.78341025073696,0.19922043795310673,0.9839328511752008,0.7847124132220941,-342314230,-346932911.6,69.24915465190045,61.42544570636632,NaN,NaN,23.57532983644225,15.957114332303147
2009-04-14T09:30:00-04:00,32.69,32.88,32.27,32.49001,124068944,155557435.2,61.91360224616241,61.45659063662616,NaN,NaN,106.00159355885883,118.31505375639509,0.1555693935442446,0.9791741551523998,0.8236047616081552,-466383174,-373515535.6,66.62510739505271,62.60349745496394,NaN,NaN,23.69575585285505,17.062634549524848
2009-04-15T09:30:00-04:00,32.24001,32.42999,31.85001,32.39999,124808128,153305223.2,61.16343358566508,61.54010447737687,NaN,NaN,75.88939484215392,115.62273615474217,0.10680104639806165,0.9571060696057323,0.8503050232076707,-591191302,-395553548.4,64.4448650982707,63.663799276738864,NaN,NaN,23.582743990253924,17.99407875534329
2009-04-16T09:30:00-04:00,32.83,33.42999,32.50999,33.24001,171168000,151456279.2,65.37892919475837,61.61109557284034,NaN,NaN,119.61317438606935,118.28792533832973,0.11649134924663573,0.9959192097659653,0.8794278605193295,-420023302,-408583161.2,63.12950997918775,64.39804420211298,NaN,NaN,24.714147457029608,18.954088569869906
2009-04-17T09:30:00-04:00,33.16,33.5,32.92999,33.31,129835376,150609723.2,65.71287038793436,62.02355489719917,NaN,NaN,120.27047361185554,111.62595697289116,0.11290739667366467,1.0205621063614103,0.9076547096877456,-290187926,-422019986.8,61.73023684005413,64.81851873062303,NaN,NaN,25.732419579922254,19.922421571305957
2009-04-20T09:30:00-04:00,32.7,32.82001,32.06,32.24001,123080496,149291879.2,56.707556748101574,62.16710049702555,NaN,NaN,54.7741278978701,95.30975285936154,0.028183075488910192,0.9428835540488834,0.9147004785599732,-413268422,-436210825.2,60.21230800483975,65.19557755669265,NaN,NaN,23.942084078709733,20.496659072363638
2009-04-21T09:30:00-04:00,32.09,32.74001,32.08,32.69,145490128,147584257.6,59.237534360684236,62.390376425581216,NaN,NaN,59.240608933623925,85.95755593431457,-0.006019730155063963,0.9071758158661432,0.9131955460212071,-267778294,-396489849.2,62.957956549107074,65.60481995459399,NaN,NaN,23.182341320980417,20.880327965023177
2009-04-22T09:30:00-04:00,32.5,33.53,32.39,32.78999,165040496,149793810.4,59.79971017170423,62.48149360431852,NaN,NaN,83.9237508390163,87.56442713368703,-0.029086123186653046,0.8768378920378908,0.9059240152245438,-102737798,-298799148.4,68.68205897884431,66.30342412757088,NaN,NaN,22.72244328256207,21.14348729610016
2009-04-23T09:30:00-04:00,33.00999,33.14,32.49001,33.11,181848816,149356172.8,61.62387666959358,62.361547555586995,NaN,NaN,78.98342064636316,79.4384763857458,-0.029855794551424508,0.8686042720352631,0.8984600665866876,79111018,-198972284.4,73.23380466543264,67.18627843366463,NaN,NaN,22.84404029573097,21.38642343890456
2009-04-24T09:30:00-04:00,33.35001,33.92999,33.07001,33.69,141169936,147291697.6,64.74628242794348,62.28412878903267,NaN,NaN,124.0376565822335,80.19191297982138,0.00005003652099344613,0.8985226122379295,0.8984725757169361,220280954,-96878508.4,76.92716931749376,68.00166812984922,NaN,NaN,23.84995141389924,21.738356006760945
2009-04-27T09:30:00-04:00,33.42,34.06,33.35001,33.73,120749056,145523750.4,64.95803726646886,62.26865129018092,NaN,NaN,127.11496462500779,94.66008032524891,0.013153312651057014,0.9149142165307573,0.9017609038797003,341030010,53981178,81.0813415560859,68.83360142239256,NaN,NaN,24.733579538954793,22.166245082788638
2009-04-28T09:30:00-04:00,33.52,33.91,33.36,33.48,108967936,142826165.6,62.433896547655195,62.5489337346702,NaN,NaN,111.24542655900083,105.06104385032431,-0.0034989240913396724,0.8973872487655257,0.9008861728568653,232062074,153949251.6,83.23536545157842,69.72409879309383,NaN,NaN,24.80338414317135,22.542979234271883
2009-04-29T09:30:00-04:00,33.75,34.39999,33.64,33.94,141413568,142384653.6,65.11963775003619,62.830630766030545,NaN,NaN,141.5346348830726,116.58322065913558,0.007390113990748626,0.9101238153453011,0.9027337013545524,373475642,249191939.6,84.98894835738017,70.65211634704674,NaN,NaN,25.60508973921502,22.980423592120903
2009-04-30T09:30:00-04:00,34.37,34.89999,34.03999,34.28,144120368,142693175.2,66.99773275309104,62.929059744886715,NaN,NaN,172.958841840128,135.37830489788854,0.027295704977339796,0.9368533325762272,0.9095576275988874,517596010,336888938,86.3996055437716,71.63553088492853,NaN,NaN,26.818092370481374,23.52866198902954
2009-05-01T09:30:00-04:00,34.28,34.53999,34.00999,34.37,100112000,137085159.2,67.49663241052812,63.092123751451915,NaN,NaN,142.7333271217965,139.11743900580115,0.035792584285461726,0.9542983579557145,0.9185057736702528,617708010,416374349.2,87.54231324109449,72.94218506987096,NaN,NaN,27.967973149272567,24.162849297635688
2009-05-04T09:30:00-04:00,34.67,35.09,34.52,35.05,119317312,136322162.4,71.05677531971655,63.74520754242007,NaN,NaN,169.2067964302376,147.5358053668471,0.07426412679597127,1.0113359321652169,0.9370718053692456,737025322,495573411.6,88.57257879976956,74.5098615987793,NaN,NaN,30.03161249092841,25.001244039534647
2009-05-05T09:30:00-04:00,34.99001,35.06,34.63,35.02,113638128,133983387.2,70.68891123398616,64.42559880301442,NaN,NaN,146.07574968136976,154.5018699913209,0.08402666138880821,1.042105132105256,0.9580784707164477,623387194,573838435.6,89.49697576043107,76.29929807464791,NaN,NaN,31.636650451109855,25.949159241188248
2009-05-06T09:30:00-04:00,35.32001,35.34,34.46001,35.03,178840496,135548852.8,70.7432826845571,64.80876690942863,NaN,NaN,132.12950592851328,152.620844200409,0.07764437060413054,1.0551339339716108,0.9774895633674803,802227690,659588845.2,90.4121132231358,78.24805544921561,NaN,NaN,32.99095423957217,26.955129955243095
2009-05-07T09:30:00-04:00,35.25,35.27,33.88,34.21001,216484624,140066784,60.78609973576315,64.45685471998782,NaN,NaN,82.1217634563769,134.4534285236588,0.008332396260764208,0.9879050586934355,0.9795726624326713,585743066,673218256.4,90.55300678374941,80.30682473090815,NaN,NaN,31.451312989418444,27.597441817268145
2009-05-08T09:30:00-04:00,34.35001,34.74001,33.88,34.23,183507312,142648577.6,60.930470210360205,64.75849139586344,NaN,NaN,61.09206952879135,118.12517700505778,-0.043202666321927374,0.925569329530262,0.9687719958521894,769250378,703526730,90.87416034012531,82.49695704057139,NaN,NaN,30.220518302297307,27.972167029415168
2009-05-11T09:30:00-04:00,33.78,34.72,33.67999,34.35001,142775872,143821849.6,61.838812532208685,64.94429697954375,NaN,NaN,52.299628690157846,94.74374345704182,-0.07441244152020299,0.8757564439519356,0.9501688854721386,912026250,738526915.6,91.24432890644027,84.51741220895234,NaN,NaN,29.412122400512086,28.177874939571872
2009-05-12T09:30:00-04:00,34.42,34.48,33.52,33.92999,147842128,145010508.8,56.85652385596822,64.73406938556262,NaN,NaN,23.484414576095062,70.22547643598688,-0.12554050434972108,0.7932432550349873,0.9187837593847084,764184122,766686301.2,91.54159983616219,86.1502365559036,NaN,NaN,27.317665044956644,28.054987811769696
2009-05-13T09:30:00-04:00,33.63,33.64999,32.96001,33.02,175548192,147547512,47.85970291874654,63.75091411764497,NaN,NaN,-56.366720458399485,32.52623115860433,-0.2174553549835927,0.6469645656552174,0.8644199206388101,588635930,723967949.2,86.73085178484345,87.11431135014725,NaN,NaN,22.568979068673762,27.271272277041707
2009-05-14T09:30:00-04:00,33.10001,33.7,33.08,33.39,140021632,145990193.6,51.2383072480095,62.78605874764968,NaN,NaN,-41.032277072628816,7.8954230528031815,-0.24793464943886134,0.5545016088402335,0.8024362582790948,728657562,752550848.4,87.21499246273446,87.84915586052158,NaN,NaN,19.53345840024005,26.16587029464147
2009-05-15T09:30:00-04:00,33.36,33.82001,33.23,33.37,121326320,145564740.8,51.04576037708617,61.79232468412234,NaN,NaN,-34.2462146194577,-11.172233776846635,-0.26263334817668393,0.47414457305823987,0.7367779212349238,607331242,720167021.2,83.49784021071483,88.02176290728077,NaN,NaN,17.020801650212324,24.859431916865876
2009-05-18T09:30:00-04:00,33.59,34.28,33.39011,34.24001,114333376,145127384.8,58.37379399590073,61.50231735899702,NaN,NaN,10.413775733900327,-19.549404368098145,-0.20927359166335502,0.4751859316557301,0.6844595233190851,721664618,682094694.8,79.22284566108273,87.73515435081681,NaN,NaN,16.93984665400382,23.72806259359987
2009-05-19T09:30:00-04:00,34.14,34.74001,33.95,34.39999,129086368,144307196.8,59.57219841193337,61.106071691989676,NaN,NaN,51.36337107799844,-13.973613067717448,-0.1608887995125945,0.48334852392834193,0.6442373234409364,850750986,699408067.6,79.73106159264586,87.35959101047864,NaN,NaN,17.233651031198594,22.80028951325683
2009-05-20T09:30:00-04:00,34.53999,35.03999,34.17999,34.28,131873680,142648856,58.21837903718135,60.478974997996126,NaN,NaN,62.50648443874986,9.80102791171242,-0.13565896262032007,0.4746636201655363,0.6103225827858564,718877306,725456342.8,80.5037343793842,86.93845735587955,NaN,NaN,17.086487430592758,21.984032072876246
2009-05-21T09:30:00-04:00,34.02,34.25999,33.31,33.64999,139253120,140519071.2,51.58915650414028,59.34272671896843,NaN,NaN,-54.5888072889925,7.089721868439684,-0.15850388352174705,0.4121927283836726,0.5706966119054196,579624186,695649667.6,76.89160905479235,86.17769277114368,NaN,NaN,14.946590589587306,20.978683289549256
2009-05-22T09:30:00-04:00,33.78,33.97,33.32001,33.53999,83520320,137636590.4,50.507746443228655,57.87493894207643,NaN,NaN,-75.3125353388482,-1.1235422754384161,-0.1767364769679326,0.3497760156955039,0.5265124926634365,496103866,673404192.4,74.21520005627282,85.15216571803676,NaN,NaN,12.877590496871136,19.82138431916667
2009-05-26T09:30:00-04:00,33.19,34.83,33.17999,34.78999,144857120,138841993.6,60.61188303856434,57.15515121383201,NaN,NaN,22.498329405617046,1.2933684589049292,-0.10392752927127791,0.39660308107433906,0.500530610345617,640960986,657263466,72.25012912350533,83.9202481011135,NaN,NaN,14.220169327305547,19.021210748900792
2009-05-27T09:30:00-04:00,34.67999,35.19,34.42999,34.55,121393120,139463252.8,58.156994652861066,56.25613064013943,NaN,NaN,88.01186858631087,8.623067960567415,-0.0727230817534717,0.40962675815377736,0.48234983990724906,519567866,591026842,64.68137481264756,82.08233821465005,NaN,NaN,14.516310327767679,18.377653545881778
2009-05-28T09:30:00-04:00,34.77,35.07001,34.21001,34.95,118931248,138339136.8,60.99276264744342,56.27089227668803,NaN,NaN,83.66783451310526,12.855337975438497,-0.028222900356097314,0.4470712144621274,0.4752941148182247,638499114,574951203.6,62.95756856413763,80.11123548467779,NaN,NaN,15.669761215171848,17.990811784351788
2009-05-29T09:30:00-04:00,34.98,35.5,34.75999,35.38,111535632,136709900,63.83056836063943,56.478042144565116,NaN,NaN,142.36639157306647,52.24637774785028,0.024256872027252574,0.5056152048522904,0.4813583328250378,750034746,609033315.6,65.08227116810511,78.26895768667636,NaN,NaN,17.54609225942322,17.927280423647705
2009-06-01T09:30:00-04:00,35.73,36.5,35.61,36.39,119192192,137663909.6,69.45211933124634,57.02184977306781,NaN,NaN,225.39924236373977,112.38873328836789,0.11594597975943166,0.6262908075243274,0.5103448277648958,869226938,683657930,69.24227017030759,76.69738206266688,NaN,NaN,21.18550721938213,18.39274139446691
2009-06-02T09:30:00-04:00,36.19,36.78999,36.11,36.44,126858560,138040972,69.70316059193601,57.9394666827798,NaN,NaN,216.30714196961827,151.15049580116812,0.16587502313453295,0.7176886066830619,0.5518135835485289,996085498,754682832.4,72.58944430952158,75.34365666790684,NaN,NaN,24.09542983610761,19.207411171844154
2009-06-03T09:30:00-04:00,36.28,36.37,35.92999,36.33,93329680,137025549.6,68.37194221908973,59.40462663280431,NaN,NaN,163.79862174888808,166.30784643368355,0.17642341529831973,0.7723428526714287,0.5959194373731089,902755818,831320422.8,75.66655744114169,74.553349929071,NaN,NaN,26.034274685091148,20.182677388022295
2009-06-04T09:30:00-04:00,36.39999,36.78999,36.34,36.74001,89280560,132547552.8,70.6239827084161,60.78931773711906,NaN,NaN,168.91334899448768,183.35694932996006,0.19451953277681167,0.8390688533441235,0.6445493205673118,992036378,902027875.6,78.10836713730231,73.90287669154011,NaN,NaN,28.376937032471396,21.35328590865788
2009-06-05T09:30:00-04:00,36.96001,37.08,36.42,36.78,121963056,127821474.4,70.84205586439991,62.20333884335576,NaN,NaN,147.66076118771593,184.41582325288994,0.19234062854991618,0.8849751062547071,0.6926344777047909,1113999434,974820813.2,80.30007001918685,73.67446453500243,NaN,NaN,30.33570905994018,22.636489215983925
2009-06-08T09:30:00-04:00,36.53,36.95,36.12,36.67,89194128,123105815.2,69.31772391623456,62.985048123379606,NaN,NaN,114.24124712615681,162.18422420537334,0.16755756067558591,0.9020814285492733,0.7345238678736874,1024805306,1005936486.8,81.16798074728148,73.81340275544518,NaN,NaN,31.54435916251368,23.909042065488176
2009-06-09T09:30:00-04:00,36.84,37.17,36.67,36.95,109187744,121426408.8,71.02670150016196,63.80322691539594,NaN,NaN,116.38439800909674,142.19967541326903,0.15441280162720794,0.9275398699076973,0.7731270682804894,1133993050,1033517997.2,81.92802606333728,73.97032878906599,NaN,NaN,33.06560406198673,25.217122350702255
2009-06-10T09:30:00-04:00,37.17,37.17999,36.28999,36.82001,133404624,120704533.6,69.1023767157912,64.58065532101092,NaN,NaN,93.78847372938122,128.19764580936766,0.12273523707142286,0.926546114619768,0.8038108775483451,1000588426,1053084518.8,82.46858111348304,74.11067498435877,NaN,NaN,33.82964758250064,26.447483098102023
2009-06-11T09:30:00-04:00,36.75999,37.23,36.75,36.82001,147909744,119322611.2,69.1023767157912,65.83159962184313,NaN,NaN,92.5408011180563,112.92313623408135,0.0891181790299913,0.9152086013358343,0.826090422305843,1000588426,1054794928.4,82.5178078911203,74.51254632981077,NaN,NaN,34.46581462237777,27.592959030141415
2009-06-12T09:30:00-04:00,36.67,36.71899,36.2,36.64999,109452432,117794151.2,66.37454412921944,66.96494231369961,NaN,NaN,62.630107420275706,95.91700548059332,0.04499434821903736,0.8823333575796397,0.8373390093606023,891135994,1010222240.4,76.49021893260328,74.6750476781201,NaN,NaN,34.31456559836084,28.55318853988705
2009-06-15T09:30:00-04:00,36.28,36.33,35.58,35.89999,112152880,117335479.2,55.89294275537573,66.62787515061471,NaN,NaN,23.811805824861203,77.8311172203342,-0.040517399973536206,0.786692259393682,0.8272096593672182,778983114,961057802,70.38316598437511,74.5416931681822,NaN,NaN,31.13312302288827,28.921750608887223
2009-06-16T09:30:00-04:00,36.06,36.19,35.52,35.55,110550192,117146320,51.78338069304418,66.17261701062779,NaN,NaN,7.635947368195957,56.08142709215404,-0.12186757476792265,0.674875190907315,0.7967427656752376,668432922,867945776.4,60.526877107192924,74.2449433320783,NaN,NaN,27.150541339643752,28.66872071328101
2009-06-17T09:30:00-04:00,35.67,36.21001,35.45,35.88901,153421744,118363088.8,55.21803674921048,65.76013658932544,NaN,NaN,9.859391259240251,39.29561059812585,-0.15209671416734283,0.6066218729660591,0.7587185871334019,821854666,832199024.4,57.21430927168859,73.83471052547479,NaN,NaN,24.70212074835821,28.102063575434897
2009-06-18T09:30:00-04:00,35.83,36.06,35.57001,35.82001,126266688,118082739.2,54.369129693660945,65.08431954168411,NaN,NaN,2.9507721861326393,21.37760481174111,-0.174391103358278,0.5407297079355544,0.7151208112938324,695587978,771198934.8,51.985778868933316,72.89924678981966,NaN,NaN,22.44552050588757,27.293985994070994
2009-06-19T09:30:00-04:00,36.03999,36.36,35.9101,36.16,122050128,117222589.6,57.81089483654105,64.25280350634803,NaN,NaN,22.502984614188396,13.352180250523691,-0.164045177194046,0.510064339801275,0.674109516995321,817638106,756499357.2,50.78146613185968,71.58061792993053,NaN,NaN,21.44694355748412,26.458694217415726
2009-06-22T09:30:00-04:00,35.8,35.89,35.02,35.08,137714816,119932314.4,45.95362830172109,62.55640834276125,NaN,NaN,-70.07216834454806,-5.424614583358162,-0.2240298365612362,0.3940722212937757,0.6181020578550119,679923290,736687392.4,49.12948783645913,69.9049067532832,NaN,NaN,16.532151244362836,25.040616649836743
2009-06-23T09:30:00-04:00,35.2,35.25999,34.77,35,114903008,118434608.8,45.213857197195374,60.90225941262594,NaN,NaN,-115.83769743290088,-30.119343543577532,-0.26062357631391264,0.2923225874626212,0.5529461637765338,565020282,716004864.4,47.39607412228745,67.88558651622218,NaN,NaN,12.406555308231146,23.235750743893085
2009-06-24T09:30:00-04:00,35.3,35.87,35.28,35.59,103314560,117530680.8,51.42456329839782,59.53087231191034,NaN,NaN,-60.42823302102262,-44.17686839963011,-0.23728618789653078,0.25633842890587033,0.4936246168024011,668334842,685300899.6,44.86534024316814,65.51108459521261,NaN,NaN,10.784345935699863,21.45697862843691
2009-06-25T09:30:00-04:00,35.38,36.36,35.28,36.28999,112538128,117211024.8,57.57018593233774,58.582881602477336,NaN,NaN,-21.461220099613218,-49.059266856779274,-0.17004838580151144,0.2810641345505118,0.45111252035202326,780872970,702357898,46.57207201634863,63.101941880724155,NaN,NaN,11.443852175074085,20.026531992242223
2009-06-26T09:30:00-04:00,36.13,36.5,36.05,36.37,87677312,116018108.8,58.2208338755245,57.79024659956947,NaN,NaN,19.530080769203224,-49.653847625776315,-0.11799747214189177,0.30361568017465856,0.42161315231655033,868550282,712540333.2,47.61459258023868,60.70527129736395,NaN,NaN,12.169463701472274,18.90409366498937
2009-06-29T09:30:00-04:00,36.44,36.75,36.12,36.45,93817568,114749377.6,58.89949425943337,56.924017510946,NaN,NaN,37.32759470379059,-28.17389501610858,-0.07792569890794787,0.3242060286816155,0.4021317275895634,962367850,769029245.2,53.083923744282004,58.644978274574285,NaN,NaN,12.957848856961164,18.05463012098534
2009-06-30T09:30:00-04:00,36.55,36.73,36.11,36.38,97843008,113298600,58.01152133824957,56.131813555407305,NaN,NaN,32.6760603130948,1.5288565330905541,-0.05685788852878265,0.33105936692858506,0.3879172554573677,864524842,828930157.2,58.08175813880673,56.90306234781169,NaN,NaN,13.347628467286118,17.382201313314024
2009-07-01T09:30:00-04:00,36.53999,36.84,36.39,36.39999,85975872,112930909.6,58.205301267469196,55.35345102338431,NaN,NaN,49.37771884592376,23.49004690647983,-0.04293326113595464,0.33425067903742445,0.3771839401733791,950500714,885363331.6,62.17038798133689,55.4496752113986,NaN,NaN,13.721064046585262,16.859181703781342
2009-07-02T09:30:00-04:00,36.09,36.10001,35.5,35.60001,113309744,114132368.8,48.549015685746845,54.0801989917077,NaN,NaN,-63.66790038758592,15.048710848885287,-0.08644651064374032,0.2691258018687037,0.35557231251244403,837190970,896626931.6,62.94721270743002,54.48231762388622,NaN,NaN,11.144175144444485,16.042752195304647
2009-07-06T09:30:00-04:00,35.38,35.53999,35.03999,35.41,107632496,113415840.8,46.572679610981616,53.414465909965266,NaN,NaN,-110.13059770043631,-10.883424845042619,-0.1245557827118497,0.1998775841226319,0.3244333668344816,729558474,868828570,59.689478827581205,53.71848282697237,NaN,NaN,8.414497238147002,14.95300148713927
2009-07-07T09:30:00-04:00,35.42,35.49001,34.50999,34.53,149773008,116444784.8,38.71265021927102,52.48084230469575,NaN,NaN,-157.66241672949602,-49.88142713169994,-0.2010298574325231,0.07314604504382771,0.2741759024763508,579785466,792312093.2,51.750350152368334,53.0915880444849,NaN,NaN,3.2613036110589495,13.28275893341351
2009-07-08T09:30:00-04:00,34.73,34.87,34.3,34.71001,152776368,118624216,40.909543360764275,51.45880706266388,NaN,NaN,-167.08001086468258,-89.83264136725542,-0.22943580030920413,-0.01261884791015433,0.2168169523990498,732561834,765919491.6,49.31390644533535,52.52727355688824,NaN,NaN,-0.20683224172863493,11.355674479821774
2009-07-09T09:30:00-04:00,34.84,35.00999,34.64999,34.77,97851440,116846556.8,41.66007818405849,50.551017669120846,NaN,NaN,-127.83269878387814,-125.2747248932158,-0.2333609483287374,-0.07488423301187197,0.15847671531686544,830413274,741902003.6,47.13893806633634,52.18107064241702,NaN,NaN,-2.7672268443742007,9.338117147793778
2009-07-10T09:30:00-04:00,34.66,35.14,34.56261,34.92,108481936,114875166.4,43.58942846089637,49.53519864228908,NaN,NaN,-106.25038965099003,-133.79122274589662,-0.21546014093290738,-0.1108484608492688,0.10461168008363858,938895210,762242851.6,49.183111616948906,52.06690246278054,NaN,NaN,-4.3362760650176915,7.3846324031064245
2009-07-13T09:30:00-04:00,34.95,35.60001,34.48,35.59,127140320,115759560.8,51.33156532132327,49.9193370008321,NaN,NaN,-53.64455608170147,-122.49401442214965,-0.1511413749956397,-0.08431503866091106,0.06682633633472865,1066035530,829538262.8,55.336766337474,52.51027949856731,NaN,NaN,-3.362243855590209,5.8493643661497625
2009-07-14T09:30:00-04:00,35.52,35.78999,35.39999,35.72,115631632,115933498.4,52.68838262082821,50.45323167394873,NaN,NaN,3.412107480360786,-90.2791095801783,-0.0952174845972144,-0.05219551941178935,0.043021965185425046,1181667162,949914602,63.78481059665676,53.680903532450834,NaN,NaN,-2.157805821788649,4.705482910729989
2009-07-15T09:30:00-04:00,36.31,36.92999,36.14,36.92,160869680,118449472.8,62.95497766494181,51.27683270013045,NaN,NaN,126.37281398488639,-31.58854461026449,0.021014957897511496,0.06929066255731442,0.04827570465980292,1342536842,1071909603.6,69.9817467675216,55.47493256990465,NaN,NaN,2.6191423374585105,4.407434257405492
2009-07-16T09:30:00-04:00,36.74001,37.44,36.72,37.36,119842432,116770507.2,65.87872601004274,51.87029984853795,NaN,NaN,161.92682079036683,26.363359304584502,0.12040521393345063,0.19878222207661622,0.07837700814316559,1462379274,1198302803.6,74.79407514858804,57.49078993649318,NaN,NaN,7.554507598175587,4.857016163229791
2009-07-17T09:30:00-04:00,37.36,37.57001,37.17,37.56,104906368,115702491.2,67.14793968328866,52.50795026337824,NaN,NaN,158.58028799197066,79.32949483317665,0.1884382451741134,0.31392481461080735,0.12548656943669395,1567285642,1323980890,78.48715152648035,59.69597271836759,NaN,NaN,11.900012571357053,5.863158507247971
2009-07-20T09:30:00-04:00,37.75,38,37.61,37.92,97168752,114458422.4,69.35742894078663,53.254945597760624,NaN,NaN,167.3672692191202,123.531859893341,0.24303210881954115,0.4292767054611204,0.18624459664157925,1664454394,1443664662.8,81.29741863380912,61.71122235333382,NaN,NaN,16.225997424365293,7.34356406683616
2009-07-21T09:30:00-04:00,38.07001,38.17999,37.64,38.17999,130587632,114102063.2,70.88060617342629,54.17416594313038,NaN,NaN,153.1779512124647,153.48502863976177,0.27940433813708965,0.5355000193129413,0.2560956811758517,1795042026,1566339635.6,83.65439896828647,63.53783955543951,NaN,NaN,20.260517031792915,9.188843061829981
2009-07-22T09:30:00-04:00,38.2,38.69,38.13,38.5,113808560,114047340.8,72.68066598095872,55.2081205655225,NaN,NaN,160.85198132505914,160.3808621077963,0.30564242488460297,0.6381487122816054,0.33250628739700244,1908850586,1679602384.4,85.47452164351543,65.2024205313094,NaN,NaN,24.200781733830013,11.333405729258557
2009-07-23T09:30:00-04:00,38.45,39.49001,38.39,39.35001,160566432,116909934.4,76.78560848081531,57.22502005088453,NaN,NaN,174.7495095390396,162.94539985753087,0.35727992444843737,0.7791061929575491,0.42182626850911176,2069417018,1801009933.2,87.12898056570576,66.92968966404338,NaN,NaN,29.165807878343518,13.880891750556408
2009-07-24T09:30:00-04:00,38.92999,39.37,38.77991,39.05,109312256,116748640.8,72.63710122938016,59.086764452198715,NaN,NaN,147.06654025663116,160.64265031046298,0.3479244578813815,0.8567318408608386,0.5088073829794572,1960104762,1879573757.2,88.07549554600708,68.9572622867881,NaN,NaN,31.864167810233447,16.449931187653128
2009-07-27T09:30:00-04:00,39.28999,39.41,38.87,39.35001,94718560,117100703.2,74.1416213411235,61.61740524661675,NaN,NaN,131.39782316505872,153.44876109965065,0.3383290952166973,0.9317187520003287,0.5933896567836314,2054823322,1957647542.8,88.94549903586518,71.61405863560928,NaN,NaN,34.55958708251842,19.037024886919596
2009-07-28T09:30:00-04:00,39.17999,39.59,38.92999,39.08,111564256,117988037.6,70.39035540804997,63.72317753570859,NaN,NaN,112.49617042661819,145.31240494248135,0.29193790991776947,0.9583120441808433,0.6663741342630738,1943259066,1987290950.8,89.26572815543088,74.46776018633041,NaN,NaN,35.62421268891116,21.406623144346963
2009-07-29T09:30:00-04:00,39.32001,39.42999,39,39.34,126538192,119422796.8,71.86646389944883,65.88077651537932,NaN,NaN,101.15167558126456,133.37234379372245,0.2580743328867292,0.9889670503714854,0.7308927174847561,2069797258,2019480285.2,89.61744601834091,77.5019393257593,NaN,NaN,36.95403534145282,23.6276820296478
2009-07-30T09:30:00-04:00,39.74001,40.17999,39.50999,39.57001,108969808,120572493.6,73.14206744105894,67.99167929967665,NaN,NaN,108.47957190236686,120.1183562663879,0.23133590733716625,1.020062601656214,0.7887266943190477,2178767066,2041350294.8,89.86053131722484,80.40746930435044,NaN,NaN,38.4395428157184,25.7436621419436
2009-07-31T09:30:00-04:00,39.56,39.8522,39.41,39.45,78208320,118817422.4,71.32492847921392,69.41977666809741,NaN,NaN,91.49814411092777,109.0046770372472,0.18760034113281943,1.023227120735072,0.8356267796022526,2100558746,2069441091.6,90.17860479107071,82.89617205103592,NaN,NaN,39.14513645695515,27.658158472659533
2009-08-03T09:30:00-04:00,39.85001,40.06,39.64,40.03999,111722688,119021932,74.65819711024754,70.98904913162737,NaN,NaN,96.30983563108273,101.98707953045201,0.18038694929085597,1.0611104662158226,0.8807235169249666,2212281434,2100932714,90.53699567393447,84.80704241369861,NaN,NaN,40.779500282780305,29.532635874105356
2009-08-04T09:30:00-04:00,39.86,40.19,39.77,40.03999,100690752,116567819.2,74.65819711024756,71.82499337772063,NaN,NaN,92.91037418980902,98.06992028309017,0.15838016488531814,1.0786987230316143,0.9203185581462962,2212281434,2154737187.6,91.13238189811264,86.3178020658837,NaN,NaN,42.09526132201432,31.327296652378067
2009-08-05T09:30:00-04:00,40.13,40.14,39.46001,39.73,118093008,114833651.2,69.71971156023699,72.0993494884488,NaN,NaN,78.18081099526009,93.47574736588926,0.10811098257997509,1.055457286371265,0.9473463037912899,2094188426,2159615421.2,91.18652533168253,87.48869136467614,NaN,NaN,41.81994462091328,32.82624636216881
2009-08-06T09:30:00-04:00,39.78999,39.92999,39.24001,39.38,116937440,115787951.2,64.5295600374485,71.91232237088879,NaN,NaN,61.43823149643302,84.0674792847025,0.03996291887974801,0.9972999523909749,0.9573370335112269,1977250986,2119312205.2,86.48805247272055,88.0601842894076,NaN,NaN,40.06590661099268,33.86048354057222
2009-08-07T09:30:00-04:00,39.91,40.07001,39.59,39.88,107512256,115739467.2,68.17446953827425,71.82782527070933,NaN,NaN,74.2166485883765,80.61118018019224,0.018335083470426783,0.9802558878492604,0.9619208043788336,2084763242,2116153104.4,86.11350593139018,88.4041905249491,NaN,NaN,39.58585934507969,34.67839436978757
2009-08-10T09:30:00-04:00,39.73,39.85001,39.34,39.60001,87163120,113740607.2,64.19626477043582,71.35037231335286,NaN,NaN,56.24503428040359,72.59821991005643,-0.022819936187464918,0.9333958841445025,0.9562158203319674,1997600122,2073216842,80.98045779416002,88.2131947267972,NaN,NaN,37.98553108125044,35.15084247142512
2009-08-11T09:30:00-04:00,39.42,39.5,39.05,39.25999,91922688,112555160,59.64447483702573,70.41921580307194,NaN,NaN,28.200545392018903,59.6562541504984,-0.07783576560042704,0.8589211133314336,0.9367568789318607,1905677434,2011896042,74.17969871212364,87.40642166026922,NaN,NaN,35.23850479747885,35.163365660861366
2009-08-12T09:30:00-04:00,39.21001,40.22,39.2,39.87,147239936,111873672.8,64.50670925245531,69.5421515724748,NaN,NaN,68.85401734986108,57.7908954214186,-0.07784916274112641,0.8394454255054526,0.9172945882465791,2052917370,2003641830.8,73.28750420945667,86.41774477768,NaN,NaN,34.29470473113355,35.03927124232882
2009-08-13T09:30:00-04:00,40.10001,40.16,39.64,40.09,110107008,111386901.6,66.0933834320689,69.07474315838114,NaN,NaN,89.04180586265879,63.31161029466375,-0.06809949168387741,0.8321702236417323,0.9002697153256097,2163024378,2040796509.2,74.75914287341662,85.46657672963784,NaN,NaN,34.00125218811811,34.89098280601301
2009-08-14T09:30:00-04:00,39.89,39.96001,39.28,39.63,124480128,112365589.6,60.04880912321726,68.06811371424497,NaN,NaN,41.46461947112182,56.76120447121282,-0.0959824113689618,0.7802917011144075,0.8762741124833693,2038544250,2031552710.8,73.67169357258503,84.37559062511782,NaN,NaN,31.85334546776427,34.45703461483462
2009-08-17T09:30:00-04:00,38.97,39.00999,38.46001,38.48,131797184,114097011.2,48.1845584988157,66.48198536358538,NaN,NaN,-114.96762323257357,22.518672968617388,-0.1898064658460985,0.6390160301757462,0.8288224960218447,1906747066,2013382099.6,71.47090786202311,83.10453203273154,NaN,NaN,25.61308072707973,33.19361263086964
2009-08-18T09:30:00-04:00,38.72,39.98,38.61,39.03,84607808,111798020,52.97038419056532,65.13226538437942,NaN,NaN,-43.023321405005404,8.273899609212524,-0.21112009832664425,0.5649223731135393,0.7760424714401836,1991354874,2030517587.6,72.31094195142268,81.86835317080882,NaN,NaN,22.13565789876685,31.61390481199781
2009-08-19T09:30:00-04:00,38.59,39.39999,38.53999,39.3,88036256,110509404.8,55.15990922406253,63.84782551173682,NaN,NaN,-80.9705908908455,-21.691022038928793,-0.20325606768596338,0.5219723868327293,0.7252284545186927,2079391130,2035812339.6,72.57961024181523,80.63400166542242,NaN,NaN,20.11025932021538,29.970526884600318
2009-08-20T09:30:00-04:00,39.28,39.84,39.2,39.75999,81473504,106554758.4,58.6886307247201,62.945232814987264,NaN,NaN,23.687652966343048,-34.76185261819194,-0.16492830890558152,0.5190680683867157,0.6839963772922972,2160864634,2035380390.8,72.51779093540526,79.37251496144631,NaN,NaN,19.608305333014968,28.490209520088126
2009-08-21T09:30:00-04:00,40.00999,40.36,39.74001,40.28999,114660192,106822155.2,62.363734343518786,62.06705690307807,NaN,NaN,130.52365069617468,-16.950046373181348,-0.10467190033517804,0.5531565018733247,0.6578284022085027,2275524826,2082776506,75.03088005549388,78.26493527441482,NaN,NaN,20.419870746994846,27.3373039810748
2009-08-24T09:30:00-04:00,40.36,40.57001,40.10001,40.25,109904880,107581471.2,61.91616097525032,61.15691146486398,NaN,NaN,153.4643690637948,36.73635208609233,-0.06996664117680873,0.5703701007374917,0.6403367419143005,2165619946,2134551082,77.45606297804494,77.28805535155286,NaN,NaN,20.914928221071964,26.419821729645825
2009-08-25T09:30:00-04:00,40.34,40.75999,40.25,40.37,92900320,106648274.4,62.779397967504664,60.66117477966882,NaN,NaN,162.17667915574492,77.77635219824239,-0.04272599833245483,0.5869292439987319,0.6296552423311867,2258520266,2187984160.4,79.65255430087888,76.46420027792401,NaN,NaN,21.574615927439584,25.727649472187792
2009-08-26T09:30:00-04:00,40.28999,40.601,40.08,40.3,96407504,105141740,61.89800926179595,60.4732068671222,NaN,NaN,121.41595513315778,118.25366140304304,-0.03362000682358046,0.5876302338017112,0.6212502406252917,2162112762,2204528486.8,80.29280222902943,76.02168240337463,NaN,NaN,21.863686898484126,25.175654818801554
2009-08-27T09:30:00-04:00,40.32001,40.47,39.67,40.39999,121957744,105791136.8,62.7035019488319,60.08242346787632,NaN,NaN,83.10088567024134,130.13630794382271,-0.02543282309849082,0.5894592117521782,0.614892034850669,2284070506,2229169661.2,81.23964181282432,75.67354925204849,NaN,NaN,22.32696855974929,24.768699638936944
2009-08-28T09:30:00-04:00,40.89,41.08,40.16,40.44,114310192,107596230.4,63.040199701074776,59.99984739149339,NaN,NaN,135.28277378579654,131.08813256174707,-0.0220205329189751,0.5873663687019501,0.6093869016209252,2398380698,2253740835.6,82.16007798531025,75.75780783713064,NaN,NaN,22.802713579862036,24.48784448764053
2009-08-31T09:30:00-04:00,40.16,40.2,39.78999,40.03,96415312,106830861.6,57.32877073631722,59.83443995572849,NaN,NaN,36.98068669497231,107.79139608798258,-0.05044832904428842,0.5463264903155647,0.5967748193598531,2301965386,2281009923.6,83.14823794541661,76.39841778236587,NaN,NaN,21.666394618234744,24.08478022058256
2009-09-01T09:30:00-04:00,39.87,40.59,39.16,39.28,162958880,109944268,48.64637167405674,58.70155870012859,NaN,NaN,-17.66484326521965,71.82309160378966,-0.11892566612436495,0.4481177367043969,0.5670434028287619,2139006506,2257107171.6,79.01666909332253,76.80764384549914,NaN,NaN,17.964230063234297,23.21041591238995
2009-09-02T09:30:00-04:00,39.09,39.47,39.03999,39.25,92757120,108677473.6,48.33106140071893,57.432821412175024,NaN,NaN,-82.19722534063396,31.100455509031313,-0.16269581082516105,0.36367363929731056,0.5263694501224716,2046249386,2233934496.4,75.11968481515885,76.83339684133787,NaN,NaN,14.876989138111881,22.01992637320737
2009-09-03T09:30:00-04:00,39.44,39.57021,39.02,39.50999,76783056,106669754.4,51.27839520171286,56.806363274924706,NaN,NaN,-61.08793895201264,2.26269058458053,-0.1698081616952024,0.3141092480034686,0.48391740969867103,2123032442,2201726883.6,69.95553245009943,76.56795676116033,NaN,NaN,13.06199911496898,20.740222479173312
2009-09-04T09:30:00-04:00,39.58,40.38,39.52,40.36,74866560,105037469.6,59.42708944571669,57.60940119970335,NaN,NaN,52.21485576439131,-14.350893019700504,-0.11553055123153627,0.3395042206592507,0.45503477189078695,2197899002,2161630544.4,64.0520385747069,76.03803752635203,NaN,NaN,13.915848247232642,19.765311874610358
2009-09-08T09:30:00-04:00,40.64999,40.78,40.46001,40.74001,71024320,104230529.6,62.450687783409776,58.286565742049376,NaN,NaN,123.5344092281069,2.9598514869264134,-0.0553512088537102,0.3858457608236492,0.4411969696773594,2268923322,2155022131.6,63.106802366637794,75.38059898458168,NaN,NaN,15.599103890095298,19.17013930539392
2009-09-09T09:30:00-04:00,40.75999,41.28999,40.59,41.09,99290000,104598895.2,65.03512068789198,58.99193798946577,NaN,NaN,151.18520759112977,36.7298616581963,0.003582874516835255,0.4456755628234035,0.4420926883065682,2368213322,2200863494.8,66.77017039353846,74.96563899541907,NaN,NaN,17.83235523668115,18.97902729557781
2009-09-10T09:30:00-04:00,41.11,41.53,41,41.48,99289056,102201351.2,67.7027329460243,59.63580243384464,NaN,NaN,170.26632325283484,87.22257137689006,0.06119221026564048,0.5185829511386189,0.4573907408729784,2467502378,2285114093.2,72.22822676102201,74.94495584010598,NaN,NaN,20.572200323438842,19.2066234424151
2009-09-11T09:30:00-04:00,41.5,41.62,41.22,41.52,93869376,101389469.6,67.97262622323314,60.036437568109946,NaN,NaN,157.07865921689512,130.85589101067163,0.09247559153360135,0.57298523028998,0.4805096387563787,2561371754,2372781955.6,76.54532077448813,75.053130177177,NaN,NaN,22.844494947285835,19.726319371682347
2009-09-14T09:30:00-04:00,41.23,41.71001,41.21001,41.67999,90560496,99693488,69.08540141379788,60.54852617086335,NaN,NaN,145.3719091879486,149.48730169538308,0.11306515891455027,0.6218410873995666,0.5087759284850163,2651932250,2463588605.2,80.01135719206803,75.23565119246436,NaN,NaN,25.062020722734196,20.48856242183261
2009-09-15T09:30:00-04:00,41.66,41.95,41.57001,41.81,91594560,97683356.8,69.99764344323553,61.06411513341555,NaN,NaN,153.66613872063863,155.51364759388943,0.12370175985081933,0.6634031282985404,0.5397013684477211,2743526810,2558509302.8,82.8622752763074,75.46491697642354,NaN,NaN,27.175796220231152,21.443881535889545
2009-09-16T09:30:00-04:00,41.98,42.48,41.84,42.42,96888432,98297388,73.89061217178151,61.92072962698595,NaN,NaN,172.12214839367445,159.70103575439836,0.15789234516617667,0.7370667999054419,0.5791744547392652,2840415242,2652949686.8,85.13409692974355,75.81072374076027,NaN,NaN,30.3038773974477,22.709595230397852
2009-09-17T09:30:00-04:00,42.32001,42.66,42.21001,42.41,102169568,99004053.6,73.7217330617698,62.70774613505294,NaN,NaN,161.28577977010553,157.9049270578525,0.16512696443442232,0.7855831602822931,0.6204561958478708,2738245674,2707098346,86.2588538577655,76.16923888682747,NaN,NaN,32.78336109148696,24.14870463912487
2009-09-18T09:30:00-04:00,42.56,42.62,42.21001,42.44,87453056,99303031.2,73.91434990875912,63.48447114988754,NaN,NaN,136.78846750021975,153.84688871451743,0.1572632045105148,0.8170352014860143,0.6597719969754995,2825698730,2759963741.2,87.2714035739999,76.53433357173388,NaN,NaN,34.88377390303738,25.68228596254094
2009-09-21T09:30:00-04:00,42.22,42.7,42.16,42.57001,71351312,97137587.2,74.77719170743893,64.73078693353908,NaN,NaN,121.6141356597333,149.09533400887435,0.14637227420688048,0.8427373397341,0.6963650655272196,2897050042,2808987299.6,88.14388058854124,76.89116518909994,NaN,NaN,36.91130430250381,27.286431439678495
2009-09-22T09:30:00-04:00,42.82001,42.83,42.4398,42.64999,75638368,95424261.6,75.31806805039308,66.6359081032774,NaN,NaN,117.14106883923391,141.7903200325934,0.13062848297641794,0.8596506692477419,0.729022186271324,2972688410,2854819619.6,88.90927470430643,77.59777987559879,NaN,NaN,38.77807114957736,28.928094255378333
2009-09-23T09:30:00-04:00,42.83,43.17,42.377,42.45,143924064,97975448.8,71.20624697909331,68.26984993030415,NaN,NaN,104.76216036748329,128.31832242735516,0.09450356800908133,0.8471516462826756,0.7526480782735943,2828764346,2852489440.4,88.59611965508014,78.5603823641646,NaN,NaN,39.342467163618764,30.415861813698395
2009-09-24T09:30:00-04:00,42.61,42.69,41.77,42.07001,111016320,98705889.6,64.0512238912307,69.18219483669827,NaN,NaN,65.38462656990242,109.13809178731454,0.03579531503284572,0.7973922220646514,0.7615969070318057,2717748026,2848389910.8,88.0088089951317,79.84990211738118,NaN,NaN,37.87295572413115,31.48116094376022
2009-09-25T09:30:00-04:00,41.78,42.09,41.58,41.7,109215936,98068799.2,57.94548125127302,69.0763656799523,NaN,NaN,35.53787181299832,88.88797264987025,-0.03343483754230525,0.7198033601039242,0.7532381976462295,2608532090,2804956582.8,81.82027366293778,81.11906176654053,NaN,NaN,34.78216991682401,31.952733654197903
2009-09-28T09:30:00-04:00,41.92,42.66,41.89,42.41,84484128,96577496,64.86639379966343,69.2489161096847,NaN,NaN,66.6779668805958,77.90073889404275,-0.03663083408994494,0.7074496550337983,0.7440804891237432,2693016218,2764149818,76.38567599691504,82.06755274013176,NaN,NaN,34.02494198684144,32.248763416004124
2009-09-29T09:30:00-04:00,42.41,42.6201,42.03,42.22,106686368,97091048.8,61.92924199021802,69.02706763127942,NaN,NaN,59.96161014957763,66.46484715611152,-0.05562276986892456,0.6745520267875875,0.7301747966565121,2586329850,2686878106,67.27347326406937,82.10350294516968,NaN,NaN,32.49014018843177,32.28324581206522
2009-09-30T09:30:00-04:00,42.39,42.6024,41.60001,42.25,173102624,97598236,62.220125756573914,68.63545283203295,NaN,NaN,44.82342862348467,54.477100807311786,-0.06935304409994303,0.6434834915315832,0.7128365356315263,2759432474,2673011731.6,65.75752637476529,81.64131006043706,NaN,NaN,31.339185381698865,32.1483800362986
2009-10-01T09:30:00-04:00,42.11,42.13,41,41,140119056,99966332.8,46.334457603755915,67.08986935921317,NaN,NaN,-32.275718059642,34.945031881402905,-0.16059418721506113,0.5120938016126999,0.672687988827761,2619313418,2653324810,63.5673757129276,80.71431398461131,NaN,NaN,24.496461991773785,31.05524888708077
2009-10-02T09:30:00-04:00,40.72,41.25,40.72,40.88,145291248,103391742.4,45.142886820465186,65.37968974540368,NaN,NaN,-94.21660928155357,8.99413566249252,-0.22315464306924482,0.39374468499120496,0.6168993280604498,2474022170,2626422826,60.59726441345308,79.3275930718531,NaN,NaN,18.771054336212163,29.300363951242396
2009-10-05T09:30:00-04:00,41.09,41.39999,40.83,41.21001,97054128,104501120.8,49.02529356933575,63.88166475441084,NaN,NaN,-85.75595510466921,-21.49264873456049,-0.23523187584770666,0.3228594832508165,0.5580913590985231,2571076298,2602034842,57.953665143452376,77.54840663379203,NaN,NaN,15.306077426566421,27.30118016200297
2009-10-06T09:30:00-04:00,41.42999,42.14,41.2206,41.94,124627936,107181301.6,56.37946234007212,62.63086833786017,NaN,NaN,-17.87164078092608,-37.05929892066124,-0.18897216372456327,0.32187615444281903,0.5108483181673823,2695704234,2623909718.8,59.653861108904756,75.7283897894464,NaN,NaN,14.791012772483384,25.5140133920716
2009-10-07T09:30:00-04:00,41.88,42.08,41.77,42.06,93787504,106906176.8,57.465803197524956,61.469730490414115,NaN,NaN,3.676517382373224,-45.28868116888353,-0.14707042622745153,0.32701028538306787,0.4740807116105194,2789491738,2629921571.6,60.13100951962232,73.86211519386472,NaN,NaN,14.745811976235117,23.97569890409496
2009-10-08T09:30:00-04:00,42.31,42.62,42.14,42.24001,107850368,107334242.4,59.11086818080494,60.412338938417385,NaN,NaN,53.630983500995576,-28.107340856756014,-0.10593183986050625,0.3416659117848866,0.44759775164539284,2897342106,2685527309.2,64.33264487814836,72.22363242987534,NaN,NaN,15.230544013057514,22.726391062518182
2009-10-09T09:30:00-04:00,42.14999,42.55,42.06,42.48,62828000,105782173.6,61.261982119462836,59.44696682499051,NaN,NaN,53.43905347612631,1.4237916947799634,-0.06335891094627455,0.3683991129625497,0.43175802390882423,2960170106,2782756896.4,70.23871181416294,70.94469180313402,NaN,NaN,16.30087150671879,21.808459697403983
2009-10-12T09:30:00-04:00,42.63,42.87,42.28,42.57001,53221872,103915242.4,62.067997982682044,58.50053324872544,NaN,NaN,82.60372903400571,35.095728522514946,-0.031545672638484235,0.39232593311071895,0.4238716057492032,3013391978,2871220032.4,74.39331368741816,69.90783744478487,NaN,NaN,17.410462930195898,21.180174444945685
2009-10-13T09:30:00-04:00,42.53999,42.75,42.37,42.58,70939184,102882473.6,62.162098637292175,57.85452265288251,NaN,NaN,76.22479653221144,53.91501598514245,-0.013178892963660815,0.40739798954462714,0.42057688250828795,3084331162,2948945418,77.3810080707718,69.1067580459057,NaN,NaN,18.338457978921024,20.774214949799305
2009-10-14T09:30:00-04:00,43.10001,43.293,42.85001,43.16,91004880,102588296,67.24297392142327,58.08250479789626,NaN,NaN,151.36848198117562,83.45340890490293,0.03220383391658671,0.4608316749040213,0.4286278409874346,3175336042,3026114278.8,79.88979189732734,68.5268282532054,NaN,NaN,20.73787712712325,20.769023832274154
2009-10-15T09:30:00-04:00,42.92999,43.12,42.87,43.06,85772688,101768452,65.60721320385669,58.62977136593795,NaN,NaN,125.52554614275985,97.83232143325579,0.04867118513718388,0.4894668224089145,0.4407956372717306,3089563354,3064558528.4,81.01926772691294,68.46961354348933,NaN,NaN,22.240081948484093,20.979174991732716
2009-10-16T09:30:00-04:00,42.92,42.99001,42.48,42.78,111859632,102988780.8,61.1236349893408,58.362431450914904,NaN,NaN,79.36077228725954,103.01666519548243,0.03455358235296119,0.4839876152129321,0.4494340328599709,2977703722,3068065251.6,81.12341277807994,68.80802331357253,NaN,NaN,22.23643800730946,21.158783993957964
2009-10-19T09:30:00-04:00,42.81,43.27,42.59,43.21001,83511936,103596812,65.07146739598332,58.58687612275528,NaN,NaN,110.82509593412586,108.66093857550645,0.04723841587724986,0.5084820527065332,0.4612436368292834,3061215658,3077629987.6,81.42281957659192,69.81869090732415,NaN,NaN,23.426826504161337,21.48279006684416
2009-10-20T09:30:00-04:00,43.45,43.46001,42.94,43.22,89847808,104307284,65.1599836493169,58.79686597223692,NaN,NaN,126.82685670204864,118.7813506094739,0.04914517623436493,0.5226751071222395,0.4735299308878746,3151063466,3090976448.4,81.855299346475,70.96853183387485,NaN,NaN,24.412551024164785,21.901327346461393
2009-10-21T09:30:00-04:00,43.2,43.82001,43.06,43.14,110397312,102630946.4,63.766366331979654,60.042002309967195,NaN,NaN,132.54222607319383,115.01609942787755,0.03834153024294823,0.5214568436915599,0.48311531344861164,3040666154,3064042470.8,77.91329903042791,71.99324064226772,NaN,NaN,24.85134555692664,22.322758519385
2009-10-22T09:30:00-04:00,43.07001,43.49001,42.78999,43.31,85871744,101373717.6,65.45706206911768,61.49301482772809,NaN,NaN,100.822840810055,110.07555836133659,0.03600462062010695,0.5281210892237453,0.4921164686036384,3126537898,3071437379.6,78.22338156577143,73.25224901029047,NaN,NaN,25.692977802272154,22.80421841694031
2009-10-23T09:30:00-04:00,43.69,43.73,43.02,43.13,117029872,101764414.4,62.15028469111933,62.43051419356977,NaN,NaN,100.18306075000895,114.24001605388646,0.01667875783957301,0.5129649159031047,0.49628615806353166,3009508026,3077798240.4,78.50295313934251,74.72005529571119,NaN,NaN,25.51777997597021,23.191870068230294
2009-10-26T09:30:00-04:00,43.17,43.75999,42.78999,42.99001,107068496,102893632.8,59.627365934637254,62.66250730746729,NaN,NaN,78.19112232615969,107.71322133229323,-0.009767027521591864,0.4840773736615418,0.49384440118313366,2902439530,3046043014.8,73.43437696184223,75.7043778566353,NaN,NaN,24.68321266479327,23.404919010596434
2009-10-27T09:30:00-04:00,42.95,43.11,42.17999,42.34,121438192,103631224,49.566100547712324,62.098242832480665,NaN,NaN,5.768716507331768,83.50159329334984,-0.07181513452115496,0.40407548303168994,0.4758906175528449,2781001338,2972030589.2,63.19330999798864,75.92311360509004,NaN,NaN,20.81328836003197,23.034686060515796
2009-10-28T09:30:00-04:00,42.19,42.32001,41.3,41.39,143553504,102153768,39.16473380169314,60.6735189482584,NaN,NaN,-86.26197703356947,39.740752671997186,-0.1719064024438942,0.26100761449797716,0.43291401694187137,2637447834,2891386925.2,54.30646469680514,75.20695787785122,NaN,NaN,13.39690492183587,21.65786018356152
2009-10-29T09:30:00-04:00,41.67999,42.19,41.53999,42.09,85207504,99408190.4,47.84890207385333,59.71544180214344,NaN,NaN,-63.6187847145811,6.852427567069968,-0.184904482193894,0.20178341419950385,0.38668789639339785,2722655338,2810610413.2,47.15344427278919,73.55801019632453,NaN,NaN,10.110893156209729,20.008293465368407
2009-10-30T09:30:00-04:00,42.06,42.14999,40.92,40.96001,162796432,100283449.6,38.335511569175864,58.02026420117871,NaN,NaN,-139.72299075477537,-41.128782733886894,-0.25899710994629066,0.06294150896053452,0.3219386189068252,2559858906,2720680589.2,40.722487849637844,71.15295120791166,NaN,NaN,3.3563211891259352,17.629440283048055
2009-11-02T09:30:00-05:00,41.00999,41.57001,40.64,41.13,142520624,102556774.4,40.25977127203932,56.455812246517795,NaN,NaN,-166.32883933560322,-90.03277506623948,-0.28394656539648333,-0.032994587838778955,0.2509519775577044,2702379530,2680668589.2,38.224581860184514,68.35606362144114,NaN,NaN,-0.9568369655648051,14.974257818960504
2009-11-03T09:30:00-05:00,40.97,41.32001,40.84,41.25999,95107008,101080728,41.756514030907645,54.63535082576668,NaN,NaN,-149.43565936801386,-121.07365024130861,-0.27869167572107445,-0.09741261709363869,0.18127905862743576,2797486538,2683965629.2,38.55902211489053,65.40386577983851,NaN,NaN,-3.7380194047195996,12.301075358434776
2009-11-04T09:30:00-05:00,41.50999,41.87,41.28,41.33,107970624,101789884,42.59076526867162,52.99131883039632,NaN,NaN,-102.57929778726914,-124.33711439204853,-0.25797334644970854,-0.1411876244346999,0.11678572201500863,2905457162,2737567494.8,43.878539013871496,62.75095658604983,NaN,NaN,-5.633424348494125,9.739003971730648
2009-11-05T09:30:00-05:00,41.81,42.39999,41.78,42.35001,135204816,103157606.4,53.12533320503703,52.4200115600889,NaN,NaN,-28.757770267382256,-117.36491150260876,-0.16743416780603781,-0.09250698774253863,0.07492718006349917,3040661978,2801168822.8,49.468945610707294,60.48992321695179,NaN,NaN,-3.63667193320067,7.828193128169032
2009-11-06T09:30:00-05:00,42.16,42.64999,42.08,42.60001,96312192,104831816,55.29080286880649,51.721392665290566,NaN,NaN,-1.2878685261999747,-89.6778870568937,-0.08663746976320272,-0.033369657140504216,0.053267812622698495,3136974170,2916591875.6,57.70333831856971,58.79567455566449,NaN,NaN,-1.3194543281014466,6.521386348701821
2009-11-09T09:30:00-05:00,42.92,43.52,42.88,43.50999,101620752,107251760,62.14576294693484,51.50609118654898,NaN,NaN,81.74429380082923,-40.063260429607205,0.026133179845551108,0.08593428742963738,0.05980110758408627,3238594922,3023834954,63.633142924303066,57.49409195408077,NaN,NaN,3.219057224633394,6.0496250452634746
2009-11-10T09:30:00-05:00,43.45,43.77139,43.39999,43.62,72846432,107347122.4,62.886601850504505,51.44325086644361,NaN,NaN,99.92686705711178,9.809244855417925,0.10192107973301712,0.18720245725035767,0.08528137751734055,3311441354,3126625917.2,68.2305627166508,56.802467931668126,NaN,NaN,6.954524742212002,6.178896430541836
2009-11-11T09:30:00-05:00,43.94,44.14,43.61,43.89999,84676128,107030684.8,64.77608055420568,51.394609329664185,NaN,NaN,117.4784053197914,53.82078547683002,0.16117140936292432,0.28674563922099594,0.12557422985807162,3396117482,3224757981.2,71.88475164007424,56.349708651261174,NaN,NaN,10.596861996857056,6.810034368586868
2009-11-12T09:30:00-05:00,43.92,44.16,43.55,43.64999,92426064,107363353.6,61.75298810051394,51.3662310017638,NaN,NaN,100.54935583044114,79.68221069639472,0.17276024426536402,0.34152453518977666,0.16876429092441264,3303691418,3277363869.2,73.63544477774512,56.00202948257566,NaN,NaN,12.622202702765142,7.640344130612335
2009-11-13T09:30:00-05:00,43.78,44.14,43.63,44.00999,87959504,106168347.2,64.33426789259258,51.702438284474894,NaN,NaN,100.65481358851139,100.07074711933697,0.19240329114028493,0.4092684048497688,0.21686511370948386,3391650922,3328299219.6,75.24289519541732,56.13120935640245,NaN,NaN,15.131653891801838,8.710531239353692
2009-11-16T09:30:00-05:00,44.19,44.64999,44.12,44.46001,87776064,106381553.6,67.30480825104826,52.969488834713175,NaN,NaN,124.66078379653185,108.65404511847751,0.22137118114493226,0.49357909014064916,0.2722079089957169,3479426986,3376465632.4,76.69021684596113,57.09527413125762,NaN,NaN,18.212636340167496,10.067974825184235
2009-11-17T09:30:00-05:00,44.34,44.60001,44.25,44.60001,81884000,105983363.2,68.19236592678166,55.04289112936235,NaN,NaN,117.75675613680706,112.22002293441656,0.23437585567247715,0.5651777285863133,0.33080187291383617,3561310986,3426439558.8,78.11946300190387,58.79620258162181,NaN,NaN,20.980338004188578,11.626883850756284
2009-11-18T09:30:00-05:00,44.47,44.49001,44.05,44.353,100240816,105475538.4,64.84751170269149,56.257077531422226,NaN,NaN,96.87441747511944,108.09922536548217,0.21146110541140095,0.5951282546780874,0.38366714926668644,3461070170,3439430096.4,78.48869881291573,61.034435048773716,NaN,NaN,22.312524610186614,13.153403959246331
2009-11-19T09:30:00-05:00,44.06,44.08,43.35001,43.66,114557936,106909848,56.47759705320792,57.55294078028165,NaN,NaN,53.44485144510778,98.6783244884155,0.1382899821217724,0.556529626918902,0.41823964479712955,3346512234,3447994259.6,78.74337169963647,63.75021246663075,NaN,NaN,20.8887235728257,14.258449618329099
2009-11-20T09:30:00-05:00,43.41,43.55,43.28,43.44,70912064,104603957.6,54.090748656410526,58.540867736308165,NaN,NaN,34.793168212233816,85.50599541315998,0.06732545318128846,0.5023964612737402,0.4350710080924517,3275600170,3424784109.2,76.11337787033419,66.4565550387843,NaN,NaN,18.987084600365254,14.93396890147712
2009-11-23T09:30:00-05:00,43.87,44.39999,43.86,44.14,91621440,103831604.8,59.89804761748236,59.836691563920645,NaN,NaN,75.04547714445042,75.58293408274369,0.060022855086309446,0.5100995769503385,0.45007672186402903,3367221610,3402343034,73.55534939165503,68.95629270141033,NaN,NaN,19.140364359894757,15.534882538393926
2009-11-24T09:30:00-05:00,44.14,44.14999,43.73,43.99001,60669936,100793192,58.19925506697837,60.95158369237113,NaN,NaN,58.557853216297204,63.74315349864173,0.038623955871355586,0.49835666670322354,0.45973271083186795,3306551674,3351391171.6,67.96985276836888,70.67710082673158,NaN,NaN,18.741817783971555,15.993016144905017
2009-11-25T09:30:00-05:00,44.14,44.22,44.00999,44.17999,37630048,95497019.2,59.75614364633452,61.42521300960667,NaN,NaN,64.94671694468737,57.35761339255531,0.03111959322182889,0.49863220235915406,0.4675126091373252,3344181722,3328013482,65.51178871044289,71.8230181909984,NaN,NaN,18.875397489402584,16.404784908404668
2009-11-27T09:30:00-05:00,43,43.83,42.89999,43.50999,61229936,94298140.8,52.350751897334966,61.21520936878728,NaN,NaN,14.358933566036193,49.540429816740996,-0.022235394377652873,0.43971836616525906,0.46195376054291193,3282951786,3315301392.4,64.15317784896348,72.28372101459796,NaN,NaN,16.66663482197724,16.442192038915035
2009-11-30T09:30:00-05:00,43.41,43.62,43.11,43.56,84819376,90399288,52.820736218604175,60.54913603104937,NaN,NaN,9.570057287391933,44.49580763177262,-0.05553167371974749,0.39253916839322756,0.44807084211297504,3367771162,3333735590.8,65.27772029213318,72.40119082658582,NaN,NaN,15.037665920637485,16.24154545058967
2009-12-01T09:30:00-05:00,43.88,44.3,43.88,44.00999,81817808,87364147.2,56.93664612878199,60.12413919378348,NaN,NaN,58.70438013648593,41.22758823017972,-0.04885774025416273,0.3869986667952716,0.43585640704943435,3449588970,3350209062.8,66.29528359370737,72.26295660351843,NaN,NaN,14.858271165941906,16.04393483849713
2009-12-02T09:30:00-05:00,44.16,44.49001,43.98,44.07001,81653504,86691472,57.469602858638474,59.60224792981439,NaN,NaN,67.48867474494637,43.01375253590955,-0.042256728058867266,0.38303549697585026,0.42529222503471753,3531242474,3395147222.8,68.96700813417841,72.05454635309731,NaN,NaN,14.86586096083928,15.875638570260294
2009-12-03T09:30:00-05:00,44.24001,44.5,43.88,43.89,72460368,84915959.2,55.26065505983785,59.13850985548038,NaN,NaN,52.21307516987042,40.46702418094617,-0.05126929968525984,0.36120560042814276,0.4124749001134026,3458782106,3418067299.6,70.26180338119767,71.81357196762963,NaN,NaN,14.2496183555439,15.643349968157953
2009-12-04T09:30:00-05:00,44.45,44.73,43.66,44.12,125062496,84408843.2,57.50800285415322,58.65091949559186,NaN,NaN,60.276744882332636,49.65058644420545,-0.04331297582190291,0.358333680336024,0.4016466561579269,3583844602,3478245862.8,73.39993126045896,71.68193168656117,NaN,NaN,14.350013512395076,15.458587617334684
2009-12-07T09:30:00-05:00,44.08,44.28999,43.82001,43.91,67471808,82966824,54.80125789648972,57.757808755980534,NaN,NaN,20.618364263680025,51.86024783946307,-0.05311901369837907,0.33524788903495306,0.38836690273333213,3516372794,3507966189.2,74.8135102952759,71.54788121865508,NaN,NaN,13.68464259333998,15.205166899621155
2009-12-08T09:30:00-05:00,43.67999,44,43.36,43.642,86621376,82216855.2,51.47169154138158,56.5634748713091,NaN,NaN,-68.92932845405502,26.33350612135488,-0.0771244626143876,0.2919613244653476,0.3690857870797352,3429751418,3503998678.8,74.24627766717056,71.271225123317,NaN,NaN,12.175372636355569,14.77233914772607
2009-12-09T09:30:00-05:00,43.61,44.12,43.32001,44.08,78820432,82515555.2,56.15976121886834,55.94292126532173,NaN,NaN,-29.496663495607528,6.9364384732441025,-0.06354036907613536,0.289660325734566,0.3532006948107014,3508571850,3499464554,73.55986987786798,70.91916591367071,NaN,NaN,12.17876077705657,14.401827951916141
2009-12-10T09:30:00-05:00,44.25,44.53999,44.24001,44.3,76722320,82117864.8,58.33688868654868,56.07572781056035,NaN,NaN,98.26531594192875,16.14688662765577,-0.04087540854615579,0.30210643412800664,0.34298184267416243,3585294170,3524766966.8,74.95155637886639,70.64832196218714,NaN,NaN,12.807327562739584,14.174042182033777
2009-12-11T09:30:00-05:00,44.52,44.59,43.95,44.13,66643632,80828743.2,56.02174217243875,56.21365591884808,NaN,NaN,58.23106170449046,15.737749992087336,-0.03850259675901313,0.294853596725396,0.33335619348440915,3518650538,3511728154,72.8243232843671,70.41338949176092,NaN,NaN,12.687858793072365,13.961730269325004
2009-12-14T09:30:00-05:00,44.42999,44.60001,44.19,44.55,47965472,78829041.6,60.221888586444855,56.23678741663112,NaN,NaN,103.56857908565492,32.32779295648231,-0.01123272053568769,0.31931529281479953,0.3305480133504872,3566616010,3521776797.2,73.44972280527192,70.40584473559069,NaN,NaN,13.808916022191243,13.93989966259161
2009-12-15T09:30:00-05:00,44.41,44.67,44.17,44.3,61171040,77498790.4,56.74772498577491,56.133106696545156,NaN,NaN,88.08283944927831,63.73022653714899,-0.01251961174860411,0.3148984986647321,0.3274181104133362,3505444970,3536915507.6,74.40535850655327,70.86552371688958,NaN,NaN,13.758920944399769,13.914045559992775
2009-12-16T09:30:00-05:00,44.47,44.7,44.28999,44.36,61629616,76486071.2,57.383162770676385,55.96360806256957,NaN,NaN,106.13250875082537,90.85606098643557,-0.011825860079059114,0.3126357853145123,0.3244616453935714,3567074586,3548616054.8,75.14984093952371,71.55395601896677,NaN,NaN,13.894944281219395,13.911316805882292
2009-12-17T09:30:00-05:00,44.17,44.21001,43.75999,43.82001,90440880,75996074.4,50.23074534520756,55.81217902313191,NaN,NaN,-17.631559178165656,67.67668596241668,-0.04819005401781917,0.2642240778712974,0.3124141318891166,3476633706,3526883962,71.01790731936096,72.04429383828088,NaN,NaN,11.891526281493688,13.622775302398205
2009-12-18T09:30:00-05:00,44.14,44.48,44,44.46001,96442560,75090305.6,57.06184594434803,56.115115432113605,NaN,NaN,73.08191019733154,70.6468556609849,-0.030461139187744124,0.27433770790443646,0.3047988470921806,3573076266,3537769107.6,71.85270140877455,72.5139353466124,NaN,NaN,12.232101593525533,13.424107629702108
2009-12-21T09:30:00-05:00,44.67,45.13,44.67,44.96001,82381376,75663771.2,61.50699266677476,56.44156875625595,NaN,NaN,212.72727985050366,92.47859581395464,0.011377863413325917,0.319021176358838,0.30764331294551206,3655457642,3555537434,73.20923842280123,73.00778926297626,NaN,NaN,13.980501260477537,13.503592434098598
2009-12-22T09:30:00-05:00,45.08,45.28999,45.03,45.23,51569040,73661151.2,63.69273338528271,56.886078079587676,NaN,NaN,224.37756888131207,119.7375417003614,0.05143069898028596,0.3719316866708695,0.32050098769058355,3707026682,3595853776.4,76.03183609365522,73.51241983151031,NaN,NaN,16.12017814665053,13.877390393034588
2009-12-23T09:30:00-05:00,45.34,45.57001,45.21001,45.56,73932192,74324264,66.2177071348012,57.66872465637078,NaN,NaN,222.38574628608015,142.98818920741235,0.09197684086884905,0.43547203877664487,0.3434951979077958,3780958874,3638630634,78.60722848652262,74.10852162474781,NaN,NaN,18.718061537295945,14.568914842214783
2009-12-24T09:30:00-05:00,45.61,45.98,45.60001,45.98,31770352,74031279.2,69.15760004926246,58.50083874173572,NaN,NaN,227.7535800194047,192.06521704692642,0.13624063776398143,0.5137959951127726,0.3775553573487912,3812729226,3705849738,81.89867968793908,74.71557508385352,NaN,NaN,21.880631347589645,15.613445771554048
2009-12-28T09:30:00-05:00,46.08,46.3,45.94,46.22,49381392,73438852,70.72536349759673,59.6382748561005,NaN,NaN,214.3961817006739,220.3280713475949,0.16871650795929327,0.5884509922979078,0.4197344843386145,3862110618,3763656608.4,84.15628860936644,75.38291639200284,NaN,NaN,24.978914275397457,16.951369843531676
2009-12-29T09:30:00-05:00,46.22,46.25,45.99001,46.03,32410160,70818391.2,67.78764641701518,60.80370020436004,NaN,NaN,163.67118532092314,210.5168524416788,0.1642753607987097,0.6250786853370016,0.4608033245382919,3829700458,3798505171.6,85.34307214271021,76.17554456882712,NaN,NaN,26.642756281913005,18.335853620443295
2009-12-30T09:30:00-05:00,46,46.25999,45.96001,46.17,57612656,69608133.6,68.81550327469832,61.70768177977647,NaN,NaN,138.26929167100428,193.29519699961725,0.15761356691681216,0.6578202831843072,0.500206716267495,3887313114,3834562458,86.47217957147285,77.0978524040846,NaN,NaN,28.317523392830264,19.761806445070004
2009-12-31T09:30:00-05:00,46.25,46.27499,45.75,45.75,50079168,68029416.8,62.384310902564984,61.99678336663478,NaN,NaN,102.27890512623432,169.2738287676481,0.1138120119956032,0.642471731261999,0.5286597192663958,3837233946,3845817472.4,86.8136511593864,77.94514488840746,NaN,NaN,27.849225428620073,20.917152014148584
2010-01-04T09:30:00-05:00,46.32001,46.485,46.27,46.42,62822800,67547538.4,67.58810216065027,62.82295193722132,NaN,NaN,124.07323172709701,148.53775910918654,0.11832997722341732,0.6765721907956674,0.5582422135722501,3900056746,3863282976.4,87.34738741644216,78.9825066121271,NaN,NaN,29.08986320262249,22.08468218393057
2010-01-05T09:30:00-05:00,46.38,46.5,46.16,46.42,62935584,64441192.8,67.58810216065027,63.34911004966456,NaN,NaN,106.37030488325637,126.93258374570306,0.10986930966153019,0.6955788506491629,0.5857095409876327,3900056746,3870872202,87.58258580216963,79.99199682619123,NaN,NaN,30.067268054862232,23.225051594063665
2010-01-06T09:30:00-05:00,46.39,46.55,46.07001,46.14,96033008,65869252.8,63.34103988365746,63.820061113799035,NaN,NaN,87.88974293445544,111.77629526840951,0.07559804842919982,0.6802071015241324,0.6046090530949326,3804023738,3865736858,86.41204868590025,80.84961755328744,NaN,NaN,29.624053877584156,24.139194777423736
2010-01-07T09:30:00-05:00,46.2,46.27,45.92,46.17,77094064,65392887.2,63.60492138483881,64.26447244338206,NaN,NaN,70.47760600754307,98.21795813571725,0.046556935802095856,0.6628052228475525,0.6162482870454566,3881117802,3864497795.6,86.112998237959,81.6327002174614,NaN,NaN,29.338571879703494,24.88196293489227
2010-01-08T09:30:00-05:00,46.03999,46.55,45.92999,46.55,88886624,65896196.8,66.85909141249294,65.45221144818815,NaN,NaN,80.96718036208489,93.95561318288738,0.04454643176999418,0.6719313267579494,0.6273848949879552,3970004426,3891051891.6,87.14013788650664,82.78428811511466,NaN,NaN,30.030941227399683,25.61753126239333
2010-01-11T09:30:00-05:00,46.60001,46.64,46.12,46.36,104673312,67293746.4,63.78801006226109,65.93265174232481,NaN,NaN,76.84827654301903,84.51062214607178,0.02310598477400827,0.6562673759554656,0.6331613911814573,3865331114,3884106765.2,85.36178554731787,83.74922269643919,NaN,NaN,29.730519798532274,26.205101053270322
2010-01-12T09:30:00-05:00,46.08,46.14,45.53,45.78,90673808,68495255.2,55.41942655932761,65.49782559179287,NaN,NaN,24.962563669228025,68.22907390326611,-0.03433038249305942,0.5902484130651331,0.6245787955581925,3774657306,3859026877.2,79.08518052630825,84.16893284668969,NaN,NaN,26.870099614091902,26.300100847673406
2010-01-13T09:30:00-05:00,45.92999,46.49001,45.61,46.35001,100660944,71130028.8,60.85481310908546,65.29511700063593,NaN,NaN,51.207003114810924,60.89252593933721,-0.03784818849496163,0.5772685599394904,0.6151167484344521,3875318250,3873285779.6,79.98620372068785,84.451387677192,NaN,NaN,26.064608714087782,26.26645911430403
2010-01-14T09:30:00-05:00,46.25999,46.52,46.22,46.39,75812688,71862111.2,61.21211433338239,64.93757465767743,NaN,NaN,70.42910931288905,60.8828266004064,-0.04112485016761369,0.563710685724935,0.6048355358925487,3951130938,3887288406.8,80.85831159236206,84.61217932760913,NaN,NaN,25.53331359240758,26.161724039747394
2010-01-15T09:30:00-05:00,46.46001,46.55,45.64999,45.85001,126866064,75123933.6,54.03936918027047,63.85770102417801,NaN,NaN,26.615698168250727,50.01253016163958,-0.08099783603586352,0.5035882408477192,0.5845860768835828,3824264874,3858140496.4,73.66265117251761,84.02389157650758,NaN,NaN,22.780168508344204,25.678644678118367
2010-01-19T09:30:00-05:00,45.96001,46.64,45.95,46.59,84388128,74821296,60.81557135992419,63.149858728629965,NaN,NaN,76.0893799244677,49.860750837929324,-0.05984853732926532,0.5097754052220012,0.5696239425512665,3908653002,3866804874,74.39216492552033,83.32645417051857,NaN,NaN,22.58472474932598,25.23665611686231
2010-01-20T09:30:00-05:00,46.27,46.604,45.42999,45.92,145679936,77283164.8,53.171681750067854,62.105861252419444,NaN,NaN,-6.602889336706285,43.54766023674246,-0.09140619491859003,0.4553661989030289,0.5467723938216189,3762973066,3864468026,73.79843850155414,82.50183748186457,NaN,NaN,19.73215747539839,24.45029916808175
2010-01-21T09:30:00-05:00,46.06,46.35001,45.3,45.49001,204939568,83411074.4,48.92185912561833,60.684886670342294,NaN,NaN,-91.129003471381,15.080458919504043,-0.138820036352717,0.3732473483807226,0.5120673847334396,3558033498,3801011075.6,59.83355275687257,80.59907842367885,NaN,NaN,15.926553353693718,23.232621194597744
2010-01-22T09:30:00-05:00,45.34,45.48,44.03999,44.16,171098624,89387553.6,38.63556554338605,58.988547716115235,NaN,NaN,-340.42567635716694,-67.09049821450716,-0.2508074895657201,0.19855802277628953,0.4493655123420096,3386934874,3688171862.8,43.91863007215137,77.5351483460192,NaN,NaN,8.398738085152424,21.113495036105554
2010-01-25T09:30:00-05:00,44.39,44.60001,44.12,44.31,154218624,93401875.2,40.16363193435412,57.029656985665504,NaN,NaN,-301.3611188221448,-132.68586161258628,-0.302375442666423,0.0713962090089808,0.3737716516754038,3541153498,3631549587.6,38.39920405392431,74.03884953441077,NaN,NaN,3.3058272910283555,18.569542501094524
2010-01-26T09:30:00-05:00,44.28,44.89,44.05,44.35001,140816432,98854179.2,40.5886009266232,55.10112118323501,NaN,NaN,-211.67687348834073,-190.23911229514798,-0.3197004763486283,-0.025853943760381526,0.2938465325882468,3681969930,3586212973.2,34.64488866276517,70.25758545302475,NaN,NaN,-0.4338671869743736,15.854769688513253
2010-01-27T09:30:00-05:00,44.28999,44.85001,44.00999,44.7,161632624,104466740.8,44.31429755087464,53.7420681594648,NaN,NaN,-156.74170181921164,-220.26687479164903,-0.29414364315646757,-0.07383302135733771,0.22031062179912986,3843602554,3602338870.8,37.004170510261815,66.72845129762199,NaN,NaN,-2.3020783182722346,13.260934258972469
2010-01-28T09:30:00-05:00,44.39999,44.42999,43.32001,43.55,221439808,113918223.2,36.266603145530375,51.78933114237134,NaN,NaN,-187.40144233460356,-239.52136256429353,-0.3381044626818329,-0.20231995655316126,0.13578450612867163,3622162746,3615164720.4,38.89361352613921,63.355638103920576,NaN,NaN,-6.884675204272169,10.38299004993752
2010-01-29T09:30:00-05:00,43.89999,44.02,42.63,42.78999,212126000,121643890.4,32.11562763975515,49.307655158604355,NaN,NaN,-187.80200029135187,-208.9966273511305,-0.3976742421742693,-0.36130829658916497,0.036365945585104295,3410036746,3619785094.8,39.59645940840723,59.959661069770625,NaN,NaN,-12.215441477841207,7.154642688826273
2010-02-01T09:30:00-05:00,42.91,43.2807,42.88,43.25999,136827056,125981284.8,36.923717903132825,47.38877714723805,NaN,NaN,-151.87856630902974,-179.10011684850753,-0.38450192439137315,-0.44426145990411214,-0.05975953551273901,3546863802,3620927155.6,39.78083565364261,56.7038789345081,NaN,NaN,-14.78804620127706,4.01997284738294
2010-02-02T09:30:00-05:00,43.31,43.78,43.03,43.64999,110727632,128376526.4,40.6783505805416,46.335843148753334,NaN,NaN,-110.53184714418393,-158.87111157967615,-0.33065583939228466,-0.4730793347530948,-0.14242349536081017,3657591434,3616051456.4,39.2302861075538,53.85710076173992,NaN,NaN,-15.566436365642497,1.221914388379306
2010-02-03T09:30:00-05:00,43.45,43.97,43.42,43.89,93581632,129908828.8,42.92978993514507,45.055484350614734,NaN,NaN,-82.87228836129177,-144.0972288880922,-0.26295730568922904,-0.47112012747234644,-0.20816282178311743,3751173066,3597565558.8,37.13202530983394,50.796088018107504,NaN,NaN,-15.451049244066011,-1.159937559112882
2010-02-04T09:30:00-05:00,43.58,43.66,42.62,42.62,151652368,132689796.8,35.29612445219064,43.20434221624389,NaN,NaN,-115.31791134066307,-129.68052268930407,-0.2858911721591442,-0.5655267869820477,-0.2796356148229035,3599520698,3593037149.2,36.61538130385378,47.63587871178548,NaN,NaN,-18.038749785823885,-3.571196448643025
2010-02-05T09:30:00-05:00,42.75,43.02,42.12,42.98,213618496,139516018.4,38.62755853706571,42.10349859887212,NaN,NaN,-116.57062573796578,-115.43424777862688,-0.25975504420535817,-0.6043294200796012,-0.34457437587424306,3813139194,3673657638.8,49.96335523245037,45.943071858923524,NaN,NaN,-18.947600121393346,-5.767825544750213
2010-02-08T09:30:00-05:00,42.92,43.17999,42.64,42.67,94354368,139789405.6,36.867262550486224,40.39290511248369,NaN,NaN,-101.08598632058205,-105.27573178093732,-0.24639869387484797,-0.652572743217803,-0.40617404934295503,3718784826,3708041843.6,54.37622324625456,44.513361738975966,NaN,NaN,-20.24758823952974,-7.83636307257586
2010-02-09T09:30:00-05:00,43.17,43.50999,42.75999,43.11,118955936,140503536.8,40.978515818887246,39.521964688827936,NaN,NaN,-78.24233194168461,-98.81782874043745,-0.1933277821998925,-0.6478337770928206,-0.45450599489292814,3837740762,3744071709.2,58.505825528901745,43.421032240929364,NaN,NaN,-19.991361886261252,-9.572791474530916
2010-02-10T09:30:00-05:00,43.10001,43.31,42.75,43.02,94102816,140674987.2,40.39900072739034,38.913189088954496,NaN,NaN,-76.66890554403115,-97.57715217698534,-0.15152934646022664,-0.6439176779682114,-0.4923883315079848,3743637946,3742564685.2,58.26825573475601,43.309225310778174,NaN,NaN,-19.962275598877888,-11.057003492294768
2010-02-11T09:30:00-05:00,43.00999,43.78999,42.75999,43.67,93050816,140294480.8,46.30505529700512,39.46100978564158,NaN,NaN,-48.625354442662434,-84.23864079738522,-0.07141698606586488,-0.5816595640903159,-0.510242578024451,3836688762,3789998298,63.31724833499709,44.69484090098143,NaN,NaN,-18.08462924783814,-12.060950028800963
2010-02-12T09:30:00-05:00,43.27,43.88,43.16,43.75999,93944000,141201046.4,47.086815206096176,39.955522876480295,NaN,NaN,-31.017207285830843,-67.12795710695823,-0.007065578430395347,-0.5190745510624453,-0.5120089726320499,3930632762,3813497011.6,65.54146732565434,46.63357399181929,NaN,NaN,-16.341192668854134,-12.672413263094274
2010-02-16T09:30:00-05:00,44.08,44.35001,43.85001,44.32001,83861376,139050812,51.79078006258065,40.75567852904869,NaN,NaN,17.226906392550756,-43.465378564331665,0.07404608263896406,-0.4194513693333448,-0.4934974519723089,4014494138,3872638874,70.40517059740446,49.18787984429353,NaN,NaN,-13.387457277039433,-12.774562407943582
2010-02-17T09:30:00-05:00,44.5,44.57001,44.25999,44.57001,82691632,138965987.2,53.76672998019831,41.43085227400037,NaN,NaN,55.38659113036886,-16.739593949920963,0.1414572204196296,-0.31667592644777187,-0.4581331468674015,4097185770,3924527875.6,73.887598311228,51.8224104015054,NaN,NaN,-10.344131027409677,-12.427357925010167
2010-02-18T09:30:00-05:00,44.53999,44.92999,44.45,44.85001,65752560,134969618.4,55.944675151567765,42.83642884586019,NaN,NaN,95.9466461420086,17.783516387286983,0.1983394526874388,-0.21020883100810295,-0.40854828369554175,4162938330,4008387952.4,78.32636781038116,54.63903570752268,NaN,NaN,-7.142379972984367,-11.672361074720767
2010-02-19T09:30:00-05:00,44.75999,45.05,44.62,44.83,80416432,128743461.6,55.742581278432894,44.52406839148002,NaN,NaN,118.60441571106189,51.22947041803185,0.22604251729511332,-0.1259951370766501,-0.35203765437176343,4082521898,4057554579.6,80.42710046665616,57.55551006882617,NaN,NaN,-4.5829508800193075,-10.659588189763415
2010-02-22T09:30:00-05:00,45.00999,45.03,44.56,44.74001,72054880,123791274.4,54.78410621567955,45.799810413804785,NaN,NaN,109.21217431183314,79.27534673756465,0.22902324774938754,-0.06575859468502898,-0.2947818424344165,4010467018,4073521430.8,81.0688272286818,60.50465232418612,NaN,NaN,-2.6891477307459404,-9.520953838475204
2010-02-23T09:30:00-05:00,44.69,44.74001,43.95,44.16,95814320,120871059.2,48.94281810685419,46.39012952282712,NaN,NaN,56.70722476954732,87.17141041296395,0.18455832135947406,-0.06408394073507395,-0.248642262094548,3914652698,4053553142.8,77.6404449841668,63.24823510108705,NaN,NaN,-2.58894780873583,-8.53066726279815
2010-02-24T09:30:00-05:00,44.4099,44.78999,44.32001,44.61,86591008,118159788,53.119293354320014,47.117951195625324,NaN,NaN,86.228163306148,93.33972484811979,0.17799848751305866,-0.026144152703224677,-0.20414264021628334,4001243706,4034364730,74.38504841627396,65.90916532297562,NaN,NaN,-1.3010009709660513,-7.497857792536422
2010-02-25T09:30:00-05:00,44.11,44.7,43.83,44.60001,97961312,114976222.4,53.01561346602017,48.38362898232744,NaN,NaN,66.81111622921426,87.51261886556092,0.16577952692114814,0.0030817684351518437,-0.1626977584859963,3903282394,3982433542.8,66.2847105913783,68.02840312922737,NaN,NaN,-0.27522672352440036,-6.466053354106133
2010-02-26T09:30:00-05:00,44.60001,44.86,44.39999,44.75999,66222368,107215350.4,54.54565262440983,49.52063570285202,NaN,NaN,86.98195504191858,81.18812673173225,0.16112331666925497,0.03870638735057241,-0.12241692931868256,3969504762,3959830115.6,63.0655658534253,68.96427531643987,NaN,NaN,1.0101913979787362,-5.398018389522581
2010-03-01T09:30:00-05:00,44.95,45.49001,44.95,45.41,77290000,100473550.4,60.21470645491834,51.18831026745431,NaN,NaN,129.40347010872622,85.22638589111088,0.19235671522107564,0.118028964707662,-0.07432775051341364,4046794762,3967095664.4,63.67622232283157,69.6285609647668,NaN,NaN,3.840546227020319,-4.078223444302167
2010-03-02T09:30:00-05:00,45.53999,45.85001,45.45,45.55,76368432,97450619.2,61.333281564411294,52.64222210642032,NaN,NaN,142.26466209927233,102.33787335705588,0.21146165232357406,0.18999931489105393,-0.021462337432520122,4123163194,4008797763.6,67.04421648657242,70.23844603317185,NaN,NaN,6.5228597318874995,-2.563782990560786
2010-03-03T09:30:00-05:00,45.67,45.82001,45.42999,45.60001,65744944,95201484.8,61.74701575145899,54.16708032242523,NaN,NaN,127.46696627105406,110.58563395003709,0.2157382769377615,0.24821050873968176,0.03247223180192026,4188908138,4046330650,69.76175457438302,71.05941023600235,NaN,NaN,8.865801260179932,-0.9309852404549694
2010-03-04T09:30:00-05:00,45.64,45.81,45.39999,45.75,54470832,93245944.8,63.02487743641548,55.3613533323831,NaN,NaN,117.22475580023469,120.66836186424118,0.21638539368334328,0.30295397390609935,0.08656858022275607,4243378970,4114349965.2,73.95352865628286,71.81914454466562,NaN,NaN,11.215146412779022,0.8041764242927436
2010-03-05T09:30:00-05:00,46.10001,46.53999,45.99001,46.44,68136256,89070139.2,68.27523011062728,56.87481153984963,NaN,NaN,157.72410440514736,134.81679173688696,0.2486926728387379,0.39743442127117845,0.14874174843244056,4311515226,4182752058,77.35342466938192,72.6628557835033,NaN,NaN,14.970138434567454,2.8278852829034165
2010-03-08T09:30:00-05:00,46.46001,46.64,46.44,46.53,58712352,81324832,68.8956393197609,58.09658720107679,NaN,NaN,159.79136274364862,140.8943702638714,0.26029290827739415,0.4741078837791832,0.21381497550178907,4370227578,4247438621.2,80.01073856481842,73.34896778117573,NaN,NaN,18.25928168071374,5.032370482590606
2010-03-09T09:30:00-05:00,46.39999,47.05,46.39999,46.78999,98002752,81507251.2,70.67945745606133,59.30463916363844,NaN,NaN,157.48220951153573,143.93787974632409,0.2685613708488871,0.549516689062898,0.2809553182140109,4468230330,4316452048.4,82.38547521027067,73.9559589882502,NaN,NaN,21.60875202197743,7.400424988217295
2010-03-10T09:30:00-05:00,46.8,47.28,46.8,47.17,102578880,80688398.4,73.1071269562448,60.53052857825822,NaN,NaN,156.0807333872295,149.6606331695592,0.2813553865862796,0.6326495514468604,0.3512941648605808,4570809210,4392832262.8,84.57026269643494,74.4019514801112,NaN,NaN,25.271187700873117,9.953391090025269
2010-03-11T09:30:00-05:00,47.07001,47.35001,46.98,47.35001,67510320,79358773.6,74.19699552435384,61.84870102439543,NaN,NaN,145.46670885452014,155.30902378041628,0.28291044932555753,0.7049322265175277,0.4220217771919702,4638319530,4471820374.8,86.44296418394435,74.83165603134606,NaN,NaN,28.6809390304912,12.628755081520403
2010-03-12T09:30:00-05:00,47.5,47.53,47.10001,47.36,64068256,77909645.6,74.25934174246102,63.23978927630839,NaN,NaN,134.72665967865157,150.70953483511713,0.2658445457587065,0.7543274593903533,0.4884829136316468,4702387786,4549994886.8,87.9958184746842,75.32644112034623,NaN,NaN,31.510345314088717,15.326125114744448
2010-03-15T09:30:00-04:00,47.25999,47.38,46.91,47.24001,60150416,76219966.4,72.00878700343392,64.88735848320695,NaN,NaN,111.67672854017506,141.08660799442242,0.22910107068666097,0.7748592519899731,0.5457581813033121,4642237370,4604396845.2,88.94481780487008,76.13389632182505,NaN,NaN,33.33660397335416,17.899050665974407
2010-03-16T09:30:00-04:00,47.39,47.61,47.23,47.53999,74950624,75774428.8,74.12046135965922,66.38744191215974,NaN,NaN,115.06294100742622,132.6027542936005,0.20822956528308578,0.8060451379071694,0.5978155726240836,4717187994,4654188378,89.74398499337444,77.23096322018935,NaN,NaN,35.53627056005116,20.418653507985372
2010-03-17T09:30:00-04:00,47.60001,47.89999,47.53,47.67,75643440,75422019.2,75.00070349872867,67.95780548592464,NaN,NaN,114.49034568655192,124.28467675346499,0.1870787361594597,0.8316639928234082,0.6445852566639485,4792831434,4698592822.8,90.40980208874693,78.95418404142997,NaN,NaN,37.65371600961478,22.88080529393243
2010-03-18T09:30:00-04:00,47.72,47.88,47.60001,47.83,77829376,76025860,76.07903484900861,69.49590421625312,NaN,NaN,105.72327355588023,116.33598969373699,0.16834909520830155,0.8550216256743255,0.686672530466024,4870660810,4745061078.8,91.06361399668775,80.95404462309158,NaN,NaN,39.773405814900244,25.294033939784974
2010-03-19T09:30:00-04:00,47.95,47.95,47.32001,47.49001,86337056,76321891.2,69.24404722921838,70.14085712870312,NaN,NaN,85.8085313951952,106.55236403704573,0.11982695145166156,0.8364562197806009,0.7166292683289394,4784323754,4761448272.4,91.28915142056297,82.92639670150096,NaN,NaN,39.78814757014282,27.364621601264666
2010-03-22T09:30:00-04:00,47.31,48.11,47.25,47.92,71902752,76314284.8,72.59713969670915,70.94541842386725,NaN,NaN,88.96603734922137,102.01022579885499,0.1040402699934797,0.846679605820789,0.7426393358273093,4856226506,4804246099.6,91.86649737473986,84.69941676494149,NaN,NaN,40.75812065303908,29.277978608661012
2010-03-23T09:30:00-04:00,48,48.3,47.77,48.2525,59182592,74482698.4,74.87795111506014,71.88334237841019,NaN,NaN,103.87918442126492,99.77347448162273,0.10314039317488288,0.8715648272959129,0.76842443412103,4915409098,4843890320.4,92.37091577515922,86.31435685071122,NaN,NaN,42.27378384721551,31.134522214168797
2010-03-24T09:30:00-04:00,48.14,48.17,47.91,48.02,63030096,73304652.8,70.46161550796754,72.41453795494962,NaN,NaN,92.92010765478221,95.45942687526879,0.07532639225267435,0.8625824244368729,0.7872560321841986,4852379002,4855799834,92.52097310903969,87.640602883051,NaN,NaN,42.24869020023512,32.722260497892556
2010-03-25T09:30:00-04:00,48.42,48.60001,47.89999,47.95,76350064,72224090.4,69.13942616144925,72.47626624429405,NaN,NaN,96.60202073120804,93.63517631033434,0.04229988192981082,0.8401308845964621,0.7978310026666513,4776028938,4836873459.6,89.50793624010555,88.50878228095984,NaN,NaN,41.84856128925344,34.026017753801256
2010-03-26T09:30:00-04:00,48.14,48.33,47.74001,48,78067808,72816362.4,69.57854063197412,72.52504490945213,NaN,NaN,84.15403228166969,93.30427648762925,0.015299285613363578,0.8169551096833558,0.8016558240699923,4854096746,4850828058,89.77240381051074,89.20604408422356,NaN,NaN,41.63359511119599,35.11281451914336
2010-03-29T09:30:00-04:00,48.23,48.39999,48.10001,48.23,57993216,71851523.2,71.58169508357729,72.5894904542747,NaN,NaN,100.04568784915755,95.52020658761649,0.004943340650604533,0.8078349998832479,0.8028916592326434,4912089962,4862000749.2,89.98996049532168,89.74922160458435,NaN,NaN,41.98966358640826,36.09522152875263
2010-03-30T09:30:00-04:00,48.36,48.55,48.06,48.39,49455024,70505852.8,72.91766690437117,72.5759575934266,NaN,NaN,103.25144927910354,95.3946595591842,0.0010843131026767594,0.8042470506109893,0.8031627375083126,4961544986,4871227926.8,90.1758225884943,90.14961873973144,NaN,NaN,42.65883814060189,37.0328810447311
2010-03-31T09:30:00-04:00,48.23,48.45,48.07001,48.16,59947392,70215975.2,67.97097178853119,72.13124161229639,NaN,NaN,87.697172870522,94.35007260233218,-0.023391636132819804,0.7739231923422878,0.7973148284751076,4901597594,4881071645.2,90.38101406059714,90.43090801663523,NaN,NaN,41.85508184122311,37.72176687280139
2010-04-01T09:30:00-04:00,48.34,48.7,47.78999,48.16,83728560,71678861.6,67.97097178853119,71.68207232987284,NaN,NaN,82.8996561745452,91.6095996909996,-0.04477542581397986,0.7413455462076328,0.7861209720216127,4901597594,4906185376.4,90.9030446104642,90.63856702633379,NaN,NaN,41.19081393067561,38.21734502392628
2010-04-05T09:30:00-04:00,48.25999,48.72,48.14,48.61,56220256,71083061.6,72.24363800615835,71.69884740149601,NaN,NaN,114.43777107237321,97.6663474491403,-0.034280135230919995,0.7432708029829627,0.7775509382138827,4957817850,4926929597.2,91.32198993405174,90.80836503556107,NaN,NaN,41.77918449958502,38.72617923473467
2010-04-06T09:30:00-04:00,48.49001,48.89999,48.39,48.75,54097056,70852296.8,73.43112425169977,71.64960903664176,NaN,NaN,132.7750434388651,104.2122185670818,-0.024059179634802308,0.7474769636703797,0.771536143305182,5011914906,4946894586,91.71734515100763,90.94931933253486,NaN,NaN,42.61248844532346,39.281366264818786
2010-04-07T09:30:00-04:00,48.69,48.87,48.37,48.63,77211440,69812731.2,70.64138789632241,71.3382293507556,NaN,NaN,115.64948780984172,106.69182627322945,-0.03108372813095872,0.7326814831414836,0.7637652112724423,4934703466,4941526282,90.52313807801372,90.95741476033962,NaN,NaN,42.53571880449215,39.74627377048641
2010-04-08T09:30:00-04:00,48.50999,48.82001,48.24001,48.74001,68323872,68099980.8,71.70274821328547,71.02563744820395,NaN,NaN,105.21400490651594,110.19519268042825,-0.03379963909282524,0.7215156624064107,0.755315301499236,5003027338,4961812230.8,91.00002183127587,90.9528724628102,NaN,NaN,42.75853396612829,40.17659665557811
2010-04-09T09:30:00-04:00,48.77,49.05,48.63499,49.03,54227216,67435825.6,74.336521492283,71.38938560985143,NaN,NaN,146.46264357284585,122.90779016008837,-0.02210966763156974,0.7276782169597737,0.7497878845913435,5057254554,4992943622.8,91.6910298263913,90.98157806322651,NaN,NaN,43.70295877313795,40.680362672372375
2010-04-12T09:30:00-04:00,49.05,49.2,48.94,49.07001,44280592,66446442.4,74.68659155121715,71.53863217088771,NaN,NaN,159.59955951138326,131.9401478478904,-0.017905922972870636,0.7274054808752553,0.7453114038481259,5101535146,5021687082,92.28036650936261,91.01114014427098,NaN,NaN,44.58270952049999,41.237840793533465
2010-04-13T09:30:00-04:00,49.02,49.35001,48.86,49.32001,59375920,66407717.6,76.81476530627879,71.67697604168904,NaN,NaN,160.53098924157626,137.4913370084326,-0.005172885037545649,0.7388452975511939,0.7440181825887395,5160911066,5051486314,92.8468222869311,91.0451334665404,NaN,NaN,45.964905595644304,41.91313576526358
2010-04-14T09:30:00-04:00,49.57001,49.92,49.5,49.91,69004752,66110424,80.89660804080063,72.42233265117713,NaN,NaN,215.88539847478467,157.5385191414212,0.033947819367523224,0.7864529567981435,0.7525051374306203,5229915818,5110528784.4,93.81518908081331,91.13757746452426,NaN,NaN,48.583567178425724,42.86605453857246
2010-04-15T09:30:00-04:00,49.88,50.19,49.87,50.13,72254128,65940958.4,82.15800260984975,73.35223096892003,NaN,NaN,211.20003877613192,178.7357259153444,0.06386775854979065,0.8323398356178586,0.768472077068068,5302169946,5170357306,94.61126763209785,91.50210113538084,NaN,NaN,51.17597677308547,44.05318628636004
2010-04-16T09:30:00-04:00,49.95,50.12,49.2,49.53,127387936,68418886.4,68.81285710640216,73.29753928852202,NaN,NaN,131.00285540132873,175.643768281041,0.033976331815216865,0.8109424918370891,0.7769661600218722,5174782010,5193862797.2,94.88957959094002,91.8676136911258,NaN,NaN,48.97465047370353,44.756252598837676
2010-04-19T09:30:00-04:00,49.36,49.66,48.89999,49.5,98251680,69014617.6,68.2162124829539,73.05714767419178,NaN,NaN,86.2627252124433,160.976401421253,0.0044618870885008155,0.7825435188824983,0.7780816317939975,5076530330,5188861834,93.77983325357158,92.13831888814364,NaN,NaN,47.06975623197863,45.08675311785781
2010-04-20T09:30:00-04:00,49.755,49.88,49.42999,49.75,69543632,68896661.6,70.51083893696006,72.88523139080527,NaN,NaN,111.2976639326621,151.12973635947017,-0.0054103003304381,0.7713187563809498,0.7767290567113879,5146073962,5185894413.2,93.08418251903309,92.34605888318212,NaN,NaN,46.185744963430665,45.24375195293965
2010-04-21T09:30:00-04:00,50.09,50.19,49.72501,50.03,74748624,69674963.2,72.87300657634546,73.235376732792,NaN,NaN,127.16032858680909,133.38472238187506,-0.0005267239417257041,0.7760706517842308,0.7765973757259566,5220822586,5184075766.8,92.63066882452398,92.5067485091769,NaN,NaN,46.18140634120204,45.37770257983428
2010-04-22T09:30:00-04:00,49.5697,50.36,49.25999,50.31,110477120,72047314.4,75.02727089206658,73.73939809733024,NaN,NaN,111.79469740655178,113.50365410795901,0.01335067470135931,0.7932857191026557,0.7799350444012964,5331299706,5189901718.8,92.75248555102633,92.63885143350277,NaN,NaN,46.86141845537122,45.58966199062527
2010-04-23T09:30:00-04:00,50.28999,50.57001,50.09,50.52,77205120,72090067.2,76.53252439772317,74.04574712529916,NaN,NaN,138.1205841654539,114.92719986078403,0.027640085370560064,0.8144851511144964,0.7868450657439363,5408504826,5236646282,93.65828939187236,92.80572996620425,NaN,NaN,47.89851280076901,45.9194978206458
2010-04-26T09:30:00-04:00,50.53,50.64999,50.3,50.41,67360944,71554724,74.01585327926935,74.08751348441128,NaN,NaN,128.01607209208942,123.27786923671324,0.02095401290909238,0.8130375818803017,0.7920835689712094,5341143882,5289568992.4,94.49687951832625,93.00426813529842,NaN,NaN,47.98124304403931,46.21403285255916
2010-04-27T09:30:00-04:00,50.22,50.42999,49.21001,49.34,112608000,74285463.2,55.05191175528855,72.97397947433743,NaN,NaN,41.75460193238743,109.3692568366583,-0.05984130674833765,0.7172819355357873,0.777123242284125,5228535882,5306061376.4,94.73072048874289,93.3048097360648,NaN,NaN,41.10791087197577,45.48458685533296
2010-04-28T09:30:00-04:00,49.60001,49.63,48.98,49.37,130082064,78316815.2,55.39696840060704,71.80928091628897,NaN,NaN,1.465919150326685,84.23037494936182,-0.1125156220069572,0.6364787147754285,0.7489943367823857,5358617946,5333620448.4,95.105027269746,93.59802441024122,NaN,NaN,36.017406284792756,44.13213248811293
2010-04-29T09:30:00-04:00,49.61,50.33,49.61,50.23,84180128,79528452,63.94246148242097,71.06684805844168,NaN,NaN,77.37852652279462,77.34714077261039,-0.09157785502596671,0.6345220179999274,0.7260998730258941,5442798074,5355920122,95.39036648173872,93.86226274276605,NaN,NaN,34.48759768709441,42.754341802253144
2010-04-30T09:30:00-04:00,50.21001,50.28999,49.2,49.2375,110896944,80886871.2,51.64494723272623,69.42101632140661,NaN,NaN,13.577752700285963,52.438574479576786,-0.1436125511096913,0.54658418413878,0.6901967352484712,5331901130,5340599382.8,91.44630880167023,93.8026871922166,NaN,NaN,28.170277823080465,40.67090409094276
2010-05-03T09:30:00-04:00,49.42999,50.17,49.42999,49.92999,74169632,81784340,57.75040471597971,68.0592762792424,NaN,NaN,43.8916019969856,35.61368046055603,-0.1307977811689348,0.5266995087873028,0.6574972899562376,5406070762,5353584758.8,91.75738256050798,93.72487006890064,NaN,NaN,25.5590545085128,38.51206843630991
2010-05-04T09:30:00-04:00,49.31,49.32001,48.08,48.42999,141136432,86136308.8,44.61088187032783,65.46743869563718,NaN,NaN,-133.40923497094627,0.5809130798892965,-0.2176298688253081,0.3854599539246024,0.6030898227499105,5264934330,5360864448.4,91.93446919306065,93.59053293406119,NaN,NaN,17.402753587559243,35.49645202934553
2010-05-05T09:30:00-04:00,47.98,48.5,47.64,48.17999,128560192,88703746.4,42.86056806585081,62.660479085351554,NaN,NaN,-189.42493194335202,-37.59725713884645,-0.282098692559824,0.2504664570501305,0.5325651496099545,5136374138,5316415686.8,80.55448064497207,92.58647672069505,NaN,NaN,10.895594525604224,31.98204381452534
2010-05-06T09:30:00-04:00,47.85001,48.3201,41.55,46.57001,274356736,99005389.6,33.69257179874512,60.15188727766177,NaN,NaN,-379.0322777822375,-128.87941799985288,-0.41531887990240357,0.013416549731950056,0.4287354296343536,4862017402,5200259552.4,59.7424786937895,90.07596951375574,NaN,NaN,1.2097170886087754,27.585997139394404
2010-05-07T09:30:00-04:00,46.22,46.8,44.28329,45.41,288200448,110704051.2,28.89648098330443,57.343335027686805,NaN,NaN,-268.07135040539555,-185.20923862098917,-0.5549848377371427,-0.2649956175370747,0.28998922020006795,4573816954,5048642717.2,43.82602801419086,86.50784056808568,NaN,NaN,-8.446601105754613,22.438483104373116
2010-05-10T09:30:00-04:00,47.42,47.8,47.31,47.77,136041568,115292100,45.800307036156624,55.57829703477228,NaN,NaN,-96.73168077063517,-213.33389517451332,-0.46546562182237894,-0.2918428070779058,0.1736228147444732,4709858522,4909400269.2,34.686356618063826,82.33656728944501,NaN,NaN,-8.56706079651652,18.00911968996031
2010-05-11T09:30:00-04:00,47.31,48.39,47.2,47.72,113196944,117983151.2,45.55321675993011,53.6268834764569,NaN,NaN,-75.99416318703483,-201.85088081773102,-0.3897300037722435,-0.31353968997083115,0.07619031380141232,4596661578,4775745718.8,28.534974088898664,77.75830337975749,NaN,NaN,-8.749817123872218,14.18641443084138
2010-05-12T09:30:00-04:00,47.98,48.66,47.89999,48.62,85462320,118806029.6,50.70811267861799,51.889800746924855,NaN,NaN,-34.14123481010663,-170.79414139108195,-0.2650888099367083,-0.25517069861947306,0.009918111317235245,4682123898,4684895670.8,25.256222326343533,72.93714172085159,NaN,NaN,-6.800202793491848,11.188326255936634
2010-05-13T09:30:00-04:00,48.42999,48.78999,47.7301,47.85001,102844256,120335536,46.63965103641652,49.75459550683153,NaN,NaN,-44.02949257689687,-103.79358435001384,-0.22229911537705357,-0.26795578290408173,-0.045656667527028155,4579279642,4628348118.8,23.45009257344266,67.92227051953516,NaN,NaN,-6.867461894724634,8.60892794869931
2010-05-14T09:30:00-04:00,47.49001,47.52,46.38,46.92999,147386000,121335439.2,42.27514815808912,47.487402283890084,NaN,NaN,-98.863765651604,-69.95206739925553,-0.24212336078403945,-0.3483108685070775,-0.10618750772303803,4431893642,4599963456.4,22.577307498491763,62.78515823240413,NaN,NaN,-8.567066663801121,6.155214432627821
2010-05-17T09:30:00-04:00,47.03999,47.27,46.07001,47.08,120969504,122471330.4,43.20834158041097,46.641432985684546,NaN,NaN,-94.22857290199718,-69.45144582552793,-0.23131492809571133,-0.3953311678426772,-0.16401623974696586,4552863146,4568564381.2,21.618764863645083,57.562875687754286,NaN,NaN,-9.512422612944498,3.9169805689746324
2010-05-18T09:30:00-04:00,47.47,47.58,46.22,46.42999,153072064,126647752,40.17741547364554,45.554322062330144,NaN,NaN,-87.17150713542819,-71.68691461520659,-0.2524013160285205,-0.4795178847826165,-0.22711656875409597,4399791082,4529190282,20.446471987292355,52.23012173900759,NaN,NaN,-11.304593956670654,1.742469922453877
2010-05-19T09:30:00-04:00,46.25999,46.63,45.55,46.06,159000256,130860333.6,38.521034167172786,43.73850582552671,NaN,NaN,-107.86877037151025,-86.43242172748732,-0.2739278804452759,-0.5695264193106908,-0.29559853886541493,4240790826,4440923667.6,18.079649071012184,46.707927638241415,NaN,NaN,-13.268939822521608,-0.4020171839711919
2010-05-20T09:30:00-04:00,45.17,45.28,44.25,44.35001,189289744,134800964.8,31.962493134706094,42.33261624709669,NaN,NaN,-155.59875339574802,-108.74627389125756,-0.3794932133430603,-0.7699650555442403,-0.39047184220118003,4051501082,4335367955.6,15.734030810065235,41.29990778169821,NaN,NaN,-17.367764903592807,-2.8256954296314225
2010-05-21T09:30:00-04:00,43.64,45.64,43.49001,44.84,190631120,140472264.8,35.358726582424126,40.73321066612844,NaN,NaN,-136.01353067798973,-116.1762268965347,-0.39093598319194,-0.8791418211911051,-0.48820583799916506,4242132202,4297415667.6,14.981435226754414,35.815911543572945,NaN,NaN,-19.46086883569417,-5.202148773354672
2010-05-24T09:30:00-04:00,44.81,45.325,44.64,44.66,113386000,142773517.6,34.67399092143532,40.02343274120755,NaN,NaN,-112.12502007827068,-119.75551633178938,-0.3846508794723511,-0.9690194373396039,-0.5843685578672528,4128746202,4212592278.8,13.434712759778748,30.208786084052804,NaN,NaN,-21.3179524167876,-7.504406436702233
2010-05-25T09:30:00-04:00,43.67,44.75999,43.23,44.7,155642944,144925264.8,34.975344643083886,39.4602024967242,NaN,NaN,-124.4127408004833,-127.20376306480043,-0.35266718036757927,-1.025202533326727,-0.6725353529591477,4284389146,4189511891.6,13.040205003107644,25.38633782391963,NaN,NaN,-22.697741915725366,-9.674882933705538
2010-05-26T09:30:00-04:00,44.92999,45.57001,44.12,44.2,140203120,145431317.6,32.93039743447426,39.40576147070485,NaN,NaN,-97.75259031448083,-125.18052705339453,-0.33991047651776707,-1.0974234486063565,-0.7575129720885895,4144186026,4170190931.6,12.7038990993793,22.026439281461762,NaN,NaN,-24.466739947444676,-11.7880053642397
2010-05-27T09:30:00-04:00,45.22,45.89,45.09,45.87,110736064,146759114.4,44.58458134085932,40.52634006767306,NaN,NaN,-49.62019226027525,-103.98481482629998,-0.2006145530831034,-1.0082811634424687,-0.8076666103593653,4254922090,4210875133.2,17.527181483225093,20.14795024353564,NaN,NaN,-22.316041256282297,-13.292010491674356
2010-05-28T09:30:00-04:00,45.94,45.99001,45.2,45.60001,128535248,147641029.6,43.2753610567204,40.34598678342762,NaN,NaN,-44.1342680616855,-85.60896230303914,-0.11265680924974841,-0.9484876219215508,-0.8358308126718024,4126386842,4187726061.2,16.953207520161868,18.88129673654264,NaN,NaN,-20.999559479186424,-14.393088918461794
2010-06-01T09:30:00-04:00,45.45,46.25,45.13,45.17999,104242624,149144679.2,41.24618916955449,40.038341955543636,NaN,NaN,-41.57545573569278,-71.49904943452356,-0.07080552852586308,-0.9243377233291312,-0.8535321948032681,4022144218,4166405664.4,16.419877057286385,18.015932662856045,NaN,NaN,-20.524618162396003,-15.269021667595252
2010-06-02T09:30:00-04:00,45.45,46.28,45.13,46.25,97249312,146950323.2,47.942887850325974,39.84082589637992,NaN,NaN,-16.255217753228923,-49.867544825072684,0.03520481480034332,-0.809526176302839,-0.8447309911031823,4119393530,4133406541.2,15.601769918737105,17.326328919455587,NaN,NaN,-17.9773339210136,-15.655923418083587
2010-06-03T09:30:00-04:00,46.36,46.77,46.08,46.69,98928368,145468732,50.444204604729755,40.112579722688004,NaN,NaN,28.067186672565207,-24.703589427663474,0.13558557295125295,-0.6752490249141161,-0.810834597865369,4218321898,4148233715.6,17.58863361534884,16.90765327959174,NaN,NaN,-15.105093665553632,-15.57723345343645
2010-06-04T09:30:00-04:00,45.71001,46.28999,44.9375,45.0925,112849872,137393388.8,42.46603588886289,40.126214560600424,NaN,NaN,-41.38400703668406,-23.05635238294523,0.09683817398847872,-0.6897868803797707,-0.7866250543682494,4105472026,4118343702.8,16.733425190713106,16.490233114750414,NaN,NaN,-15.118279983540067,-15.511668672022681
2010-06-07T09:30:00-04:00,45.34,45.46001,44.22,44.27,88436560,127405194.4,39.042250716133026,39.82863664172343,NaN,NaN,-86.60553278720033,-31.550605328048174,0.0221571198596493,-0.7589286545436877,-0.781085774403337,4017035466,4096473427.6,16.115964929866493,16.097175976623365,NaN,NaN,-16.265117043632753,-15.619304153681263
2010-06-08T09:30:00-04:00,44.37,44.48,43.59,44.19,133990000,127302616,38.71529710042721,39.72419961506497,NaN,NaN,-112.28554323991065,-45.69262282889176,-0.0237974340881294,-0.8108325670134988,-0.7870351329253694,3883045466,4068653677.2,15.340525182701882,15.732465490581186,NaN,NaN,-17.26449983416611,-15.85433210803624
2010-06-09T09:30:00-04:00,44.48,44.91,43.69,43.82001,102077312,126746634.4,37.16515356773172,39.62735100081919,NaN,NaN,-101.84858965270884,-62.81129720878774,-0.06779000575743788,-0.8717726401221668,-0.8039826343647289,3780968154,4000968602,13.623050018378294,15.414136986821626,NaN,NaN,-18.553658372970446,-16.239950145883984
2010-06-10T09:30:00-04:00,44.39,45.12,44.24001,45.07001,76892320,126318134.4,45.15488173756834,40.569664472452196,NaN,NaN,-51.92688223521366,-78.81011099034352,-0.004708197299732042,-0.809867880989394,-0.805159683689662,3857860474,3928876317.2,12.072682774173131,15.152612127115045,NaN,NaN,-17.173451048144628,-16.373307417635505
2010-06-11T09:30:00-04:00,44.63,45.53999,44.61,45.5,74347744,124893308.8,47.62212703428243,41.445621647584936,NaN,NaN,-11.97628283693389,-72.92856615039348,0.06985851403593057,-0.7178365411447487,-0.7876950551806793,3932208218,3894223555.6,11.40103985397407,14.896869600487877,NaN,NaN,-15.277633409534433,-16.216782559335353
2010-06-14T09:30:00-04:00,45.91,46.24001,45.41,45.49001,68084944,120928256,47.56858604260535,42.36666415623994,NaN,NaN,40.14981234157522,-47.57749712463836,0.11947711236118319,-0.6383486647292003,-0.7578257770903835,3864123274,3863641117.2,10.828479750050874,14.71071009979303,NaN,NaN,-13.779323324231171,-15.868574097177612
2010-06-15T09:30:00-04:00,45.71001,46.77,45.4532,46.71001,76332560,118696408.8,54.32254674411085,43.74860716345615,NaN,NaN,103.10907052507953,-4.498574371640328,0.22908040367399984,-0.4714752724978837,-0.7005556761718835,3940455834,3875123190.8,12.603100459574293,14.679488346683504,NaN,NaN,-10.32442123708912,-15.076552260022114
2010-06-16T09:30:00-04:00,46.58,47.14,46.5,46.89999,78399632,114962787.2,55.28841906733025,45.34560870866015,NaN,NaN,154.31800380495653,46.73474431989275,0.30427976214969243,-0.320205973484768,-0.6244857356344604,4018855466,3922700653.2,19.73147165900366,15.181457815228104,NaN,NaN,-7.231714774193502,-13.955861190618027
2010-06-17T09:30:00-04:00,47.16,47.17999,46.64,47.05,77111808,110868364.8,56.078179164227066,46.16657998175784,NaN,NaN,151.0676940889445,87.33365958472437,0.35072902025547315,-0.18607446031511898,-0.5368034805705921,4095967274,3970322013.2,26.21824145344513,15.802247813100964,NaN,NaN,-4.46520180011666,-12.600052706260689
2010-06-18T09:30:00-04:00,47.06,47.34,46.86,47,75921376,105199946.4,55.72486692883195,47.055830401194385,NaN,NaN,141.95270528848633,118.11945720980842,0.36315977224520707,-0.08285376526408328,-0.44601353750929035,4020045898,3987889549.2,28.51334304707406,16.62797177930898,NaN,NaN,-2.2776844427824945,-11.125428668620946
2010-06-21T09:30:00-04:00,47.60001,47.67999,46.33,46.60001,95488064,100442793.6,52.85592182626947,47.88509701953118,NaN,NaN,111.63884066616815,132.417262874727,0.33045348434907507,-0.03294668207294649,-0.36340016642202155,3924557834,3999976461.2,30.123880695185477,17.606829182016057,NaN,NaN,-1.1487382641674844,-9.700187182270453
2010-06-22T09:30:00-04:00,46.78999,47.14,46.14999,46.24001,94493376,99498162.4,50.343708844983325,48.05658423343527,NaN,NaN,73.29250480410025,126.45394973053115,0.27296958999973253,-0.022188178922355917,-0.29515776892208845,3830064458,3977898186,28.845504998559562,18.552810259146234,NaN,NaN,-0.847016391222263,-8.435448497834997
2010-06-23T09:30:00-04:00,46.28999,46.47,45.69,46.05,92397504,96335890.4,49.01939953696514,47.95481244288066,NaN,NaN,30.76889243462856,101.74412745646556,0.21319518443762614,-0.028663788375055788,-0.24185897281268193,3737666954,3921660483.6,25.837707000781364,19.142029786677124,NaN,NaN,-0.9397492001544581,-7.364634312452063
2010-06-24T09:30:00-04:00,45.84,45.99001,45.2,45.35001,114714320,95061450.4,44.387057281196874,48.092028256618796,NaN,NaN,-23.689629862913904,66.79266266609388,0.12208695678999909,-0.08925027682518305,-0.21133723361518214,3622952634,3827057555.6,21.732445623528008,19.499102674735333,NaN,NaN,-2.304281431826335,-6.641726758076959
2010-06-25T09:30:00-04:00,45.50999,45.66,44.95,45.27,89040256,93976660,43.876665833490286,48.43734362214432,NaN,NaN,-41.892645131946054,30.023592582007392,0.05540275468217676,-0.1420837902624612,-0.19748654494463797,3533912378,3729830851.6,18.48226367053313,19.66812401335438,NaN,NaN,-3.5816198776765265,-6.2045686323054685
2010-06-28T09:30:00-04:00,45.28999,45.55,44.81,45.11,71378688,91118832,42.81639329871324,48.730279064879035,NaN,NaN,-51.01074088728756,-2.5063237286837436,0.002291705662093746,-0.1946219128670208,-0.19691361852911454,3462533690,3637426022.8,16.028730241583006,19.717281517560174,NaN,NaN,-4.950147888153596,-6.025365668855201
2010-06-29T09:30:00-04:00,44.42,44.46001,43.07001,43.37,136384128,92725907.2,33.3718980840853,48.45933224461857,NaN,NaN,-158.7586704394904,-48.91655877740187,-0.1403649170994711,-0.3723697649034534,-0.2320048478039823,3326149562,3536643043.6,13.866590682448376,19.73467727927947,NaN,NaN,-9.303597016007496,-6.4936844327341
2010-06-30T09:30:00-04:00,43.23,43.67,42.64,42.71001,101313184,92929100.8,30.613514551994655,47.42066315993474,NaN,NaN,-174.8574069139108,-90.04181864710975,-0.26242503966340336,-0.5600361473832365,-0.2976111077198331,3224836378,3434076928.4,12.080616780060325,19.735243993985694,NaN,NaN,-13.909840597282624,-7.553135313383889
2010-07-01T09:30:00-04:00,42.82001,42.96001,41.77,42.59,158694880,95917426.4,30.12589792404897,46.17093250920378,NaN,NaN,-181.79005876074459,-121.66190442667587,-0.330118699747605,-0.7102594824043393,-0.38014078265673434,3066141498,3322714701.2,10.499408972906977,19.670841788195187,NaN,NaN,-17.775343132250207,-9.013450716079078
2010-07-02T09:30:00-04:00,42.67,42.8215,42.09,42.47,78565248,94203195.2,29.617892945638943,44.88874014513475,NaN,NaN,-150.31187237404131,-143.3457498750949,-0.3594348554133238,-0.8294343519233891,-0.4699994965100653,2987576250,3213447475.6,9.22372556667527,19.556216489382646,NaN,NaN,-21.09641467097353,-10.739588423921141
2010-07-06T09:30:00-04:00,43.09,43.37,42.25,42.60001,88591808,94210957.6,30.975921130206117,43.22112402985584,NaN,NaN,-117.87887896242637,-156.71937749012267,-0.3463856546099615,-0.9029815647725172,-0.5565959101625557,3076168058,3136174349.2,8.44250670719596,19.25903122135562,NaN,NaN,-23.494878247638226,-12.561772684452153
2010-07-07T09:30:00-04:00,42.74001,44.00999,42.7,43.96001,72448368,91133876,43.30051149866124,42.36484491780805,NaN,NaN,-72.92316986876114,-139.55227737597684,-0.2281821585014605,-0.8418236082893813,-0.6136414497879208,3148616426,3100667722,8.102902862188728,18.428419164440268,NaN,NaN,-22.010972893616408,-13.911658428618475
2010-07-08T09:30:00-04:00,44.30969,44.38,43.67999,44.2,78264560,89943238.4,45.16130386162158,41.58506811047908,NaN,NaN,-46.18737098281424,-113.8182701897575,-0.12122275821765194,-0.7651698975599857,-0.6439471393423337,3226880986,3101076643.6,8.148727777906458,17.137739616187506,NaN,NaN,-20.23203362304906,-14.814569170679986
2010-07-09T09:30:00-04:00,44.17999,44.63,44.08,44.62,47861056,88491675.2,48.35565307076079,41.058695692045426,NaN,NaN,-27.0428315445767,-82.86882474652393,-0.01515381901668622,-0.6628894131131915,-0.6477355940965053,3274742042,3142796752.4,12.919730981611409,16.023910182940174,NaN,NaN,-17.7665764298195,-15.236284493414203
2010-07-12T09:30:00-04:00,44.58,45.03,44.46001,44.75,60934832,87821029.6,49.33931324783049,40.80750936501407,NaN,NaN,-10.979590835903485,-55.00236843889636,0.06632410347684403,-0.5648304647504503,-0.6311545682272943,3335676874,3212416877.2,20.354380113200634,15.326088712798398,NaN,NaN,-15.45545890966877,-15.267595124307713
2010-07-13T09:30:00-04:00,45.13,45.5,44.8,45.33,93310496,89082307.2,53.586809888388,41.03915943954297,NaN,NaN,13.139296926498073,-28.798733261111465,0.1566844284424571,-0.435299032674223,-0.5919834611166801,3428987370,3282980739.6,27.14389714870596,15.204545294951714,NaN,NaN,-12.170083568978567,-14.825093473546406
2010-07-14T09:30:00-04:00,45.42,45.81,45.24001,45.56,87694688,89650413.6,55.191199407835995,41.48000228746232,NaN,NaN,32.15502915783798,-7.783093455791642,0.22518193580617396,-0.31050604135896265,-0.5356879771651366,3516682058,3356593866,33.51156896554812,15.752678292435053,NaN,NaN,-8.955346840145658,-13.986558240203442
2010-07-15T09:30:00-04:00,45.46001,45.74001,44.99001,45.60001,95992432,90530053.6,55.47950547051494,42.27232001527075,NaN,NaN,32.54677654144972,7.963736049061143,0.26374754699738573,-0.20600354341840443,-0.46975109041579016,3612674490,3433752566.8,39.48209939513073,17.02051070469239,NaN,NaN,-6.22396237153533,-12.877615973250855
2010-07-16T09:30:00-04:00,45.44,45.6281,44.3,44.34,98831872,91616056.8,45.54171264953205,42.39125193070231,NaN,NaN,1.6909029191974765,13.710482941815982,0.19796537915307166,-0.22229436647445056,-0.4202597456275222,3513842618,3481572682,42.90411536955924,18.764928683194256,NaN,NaN,-6.599725134609925,-11.980774424873578
2010-07-19T09:30:00-04:00,44.48,44.81,44.10001,44.72,81800752,91910025.6,48.53575051875632,42.799777446419675,NaN,NaN,-3.6513493581484044,15.176131237366969,0.17443885859421193,-0.20221117238475728,-0.3766500309789692,3595643370,3533565981.2,46.44965154987871,20.937851633786806,NaN,NaN,-6.008891680572713,-11.127648318544884
2010-07-20T09:30:00-04:00,43.99001,45.25999,43.86,45.25999,89061184,91588681.6,52.52969595407449,44.16819157999033,NaN,NaN,20.559784326881672,16.660228717443687,0.18844326479948342,-0.14109594997961494,-0.32953921477909837,3684704554,3584709418,49.75485669846876,23.501299206359686,NaN,NaN,-4.280189452583313,-10.149439909121803
2010-07-21T09:30:00-04:00,45.75,45.75999,44.56,44.64,83576816,91042853.6,47.93040162853467,45.405112085457475,NaN,NaN,41.81173953952116,18.591570793780324,0.1507804806973257,-0.14106361390744127,-0.29184409460476696,3601127738,3601598554,50.83405856134006,26.26940219073681,NaN,NaN,-4.215285821345395,-9.30170361086803
2010-07-22T09:30:00-04:00,45.25999,45.98,45.24001,45.77,82890256,90567491.2,55.56655651815331,47.22230198503636,NaN,NaN,94.81200799859302,31.044617085208984,0.19404466233672585,-0.04928826668385966,-0.2433329290205855,3684017994,3615867254.8,51.77644600928774,29.217761979049722,NaN,NaN,-1.6160839147052408,-8.203757939987632
2010-07-23T09:30:00-04:00,45.46001,46.10001,45.38,46.06,81056064,88884578.4,57.29736652591645,49.19940724077047,NaN,NaN,105.9332591459112,51.893088330551734,0.23171521375136597,0.04631108816862195,-0.18540412558274402,3765074058,3666113542.8,55.04424030134785,32.490655888669195,NaN,NaN,1.0299436435207765,-6.884657713772145
2010-07-26T09:30:00-04:00,46.12,46.46001,45.91,46.44,64850816,87675106.4,59.52234130576921,51.238437253310686,NaN,NaN,128.47991537267487,78.31934127671639,0.2691204974552375,0.15099649623630285,-0.11812400121893465,3829924874,3712969843.6,57.90866182327831,36.02395268267507,NaN,NaN,3.9102085548634555,-5.3425339611099165
2010-07-27T09:30:00-04:00,46.69,46.72,46.21001,46.42,67655568,87488950.4,59.347074033302384,52.38462029149934,NaN,NaN,129.5349409455471,100.11437260044947,0.2782582241377927,0.22969877895330626,-0.048559445184486474,3762269306,3728482794,58.84363612362871,39.64829077277793,NaN,NaN,6.157867357939117,-3.6996194869600547
2010-07-28T09:30:00-04:00,46.38,46.58,45.88,46.05,51988112,83269149.6,56.05842072155703,53.162985781494726,NaN,NaN,101.00759265080457,111.95354322270616,0.246228989866045,0.25922679214806976,0.012997802282024774,3710281194,3750313485.2,60.18399886330799,43.36509585030661,NaN,NaN,7.111517846045889,-2.155171296530634
2010-07-29T09:30:00-04:00,46.3,46.41,45.25,45.71001,85693936,82488187.2,53.14419163135568,53.50502425010865,NaN,NaN,70.44918833714266,107.08097929041608,0.19143008980729337,0.2522854145411415,0.06085532473384812,3624587258,3738427338,59.05625734424102,46.660562019065864,NaN,NaN,7.077866434338397,-0.8361659064064868
2010-07-30T09:30:00-04:00,45.36,46.09,45.07001,45.81,98958064,79501346.4,53.90316931399349,53.831013969120285,NaN,NaN,54.89590864458404,96.87350919015066,0.15287444107644516,0.25194837607940457,0.09907393500295941,3723545322,3730121590.8,58.23508273318794,49.3663264919221,NaN,NaN,7.259423926635229,0.32034692688518684
2010-08-02T09:30:00-04:00,46.38,46.78999,46.2101,46.67,68706688,79008418.4,59.917013957865656,54.28317140265441,NaN,NaN,119.05600274862,94.98872666533967,0.1746745293140434,0.31741709664551365,0.14274256733147025,3792252010,3722587018,57.454607610926345,51.53137723922356,NaN,NaN,9.211427004326813,1.590501223662562
2010-08-03T09:30:00-04:00,46.63,46.7,46.25,46.47,60863376,77621996.8,58.021249222028274,54.48531781795385,NaN,NaN,106.80674552003796,90.44308758023784,0.1651167853181254,0.349138548979127,0.1840217636610016,3731388634,3716410883.6,56.782816755254885,53.19360922420261,NaN,NaN,10.283115275217343,2.832303231027531
2010-08-04T09:30:00-04:00,46.69,46.99001,46.5,46.938,43817792,76190468,61.12115288856862,54.88829263352911,NaN,NaN,131.1819896229605,96.47796697466902,0.1786594571908601,0.4073460851495767,0.2286866279587166,3775206426,3729395930,57.897442709727194,54.50899088953093,NaN,NaN,12.11881990154743,4.158948469673231
2010-08-05T09:30:00-04:00,46.72,46.92,46.52,46.83,39150160,74234748,60.01967716902317,55.9224329563499,NaN,NaN,116.7625334582699,105.74063599889446,0.16880491756186244,0.43969277491104464,0.2708878573491822,3736056266,3751689731.6,59.813793520238235,55.716825043150855,NaN,NaN,13.324355461365403,5.468292325629255
2010-08-06T09:30:00-04:00,46.32001,46.85001,46.05,46.75999,71339440,75408667.2,59.27396984063678,56.689448622198505,NaN,NaN,86.73459933403869,112.10837413678539,0.14684174278968226,0.454440035836285,0.30759829304660274,3664716826,3739924032.4,58.305471255877904,56.56366930786509,NaN,NaN,14.125105991485768,6.704979992180185
2010-08-09T09:30:00-04:00,47.00999,47.19,46.78999,47.08,26937008,73708776,61.62119300282627,57.33884126853792,NaN,NaN,122.67032557309867,112.83123870168113,0.14299593921429604,0.4863432170644728,0.34334727785017677,3691653834,3719804397.2,55.71800100245366,56.98960818672115,NaN,NaN,15.461169092568506,7.955864149378517
2010-08-10T09:30:00-04:00,46.72,46.95,46.28,46.6725,86694432,73377972.8,57.10757530848604,57.99435367424873,NaN,NaN,73.48326670163966,106.16654293800147,0.10395345101700959,0.47328909162143873,0.36933564060442914,3604959402,3694518550.8,52.56102035199099,57.112962600339074,NaN,NaN,15.385707678813294,9.017270367869198
2010-08-11T09:30:00-04:00,45.91,45.92,45.21001,45.39999,92219632,73604220,45.82068048589214,57.29821967194436,NaN,NaN,-44.51520578834103,71.02710385574116,-0.010542813803644191,0.3561571233498739,0.3666999371535181,3512739770,3642025219.6,46.65148678112868,56.74689408404199,NaN,NaN,11.679500923552622,9.397589018681115
2010-08-12T09:30:00-04:00,44.56,45.24001,44.45,45.03999,66000432,72104620,43.21827952163068,56.292570600209665,NaN,NaN,-100.47003684063236,27.580589795960712,-0.1080716750157465,0.23161034338383502,0.3396820183995815,3446739338,3584161834,41.15822334602603,55.755035730090434,NaN,NaN,7.77775818323882,9.166184613617931
2010-08-13T09:30:00-04:00,44.87,45.06,44.71001,44.72,46387264,69482389.6,40.98980770242779,54.96881819997099,NaN,NaN,-109.51209123795931,-11.668748318438883,-0.1870534103583419,0.10586525545165415,0.29291866580999604,3400352074,3531288883.6,36.88435165876442,54.253299289768016,NaN,NaN,3.841990743863679,8.405585489367324
2010-08-16T09:30:00-04:00,44.48,45.11,44.3,44.8,55472848,68165994.4,41.79781856411869,53.71529995217215,NaN,NaN,-121.73314942452933,-60.54944331796448,-0.2243170535360351,0.012522348889952184,0.23683940242598728,3455824922,3484123101.2,33.53864014750313,52.44579957718762,NaN,NaN,0.8873393696414048,7.331550329406478
2010-08-17T09:30:00-04:00,45.11,45.78,45.03,45.37199,56927056,66559288,47.34893644464097,53.09319393239243,NaN,NaN,-60.02715993623572,-87.25152864553957,-0.2015702666465542,-0.015123430882205469,0.18644683576434873,3512751978,3465681616.4,32.30477805014306,50.45442666196154,NaN,NaN,-0.05878884785821295,6.275787589797236
2010-08-18T09:30:00-04:00,45.28999,45.82001,45.11,45.55,61836480,65472271.2,48.9798231573342,52.7957390413909,NaN,NaN,-54.27298360296824,-89.203084208465,-0.16708599272194977,-0.022410655138088487,0.14467533758386128,3574588458,3478051354,34.05719669285281,48.668779472576674,NaN,NaN,-0.3660800391188089,5.326949357094944
2010-08-19T09:30:00-04:00,45.28999,45.46001,44.56,44.86,82969504,65476233.6,43.37175805723321,52.04349538019374,NaN,NaN,-104.09320674317335,-89.9277181889732,-0.18206615953326277,-0.08290736183271719,0.09915879770054559,3491618954,3487027277.2,35.36472993890858,47.03518284441386,NaN,NaN,-2.360076677060201,4.228802780787066
2010-08-20T09:30:00-04:00,44.78999,45.03,44.53999,44.92,66806624,64763761.6,43.97249447947531,50.90460113173729,NaN,NaN,-104.07371250728038,-88.84004244283742,-0.1789861809455707,-0.1245739284814178,0.054412252464152905,3558425578,3518641978,39.885952985812615,45.78027894262003,NaN,NaN,-3.799225125943046,3.081941651254193
2010-08-23T09:30:00-04:00,45.25,45.34,44.46001,44.48,69612128,65001827.2,40.57329051256851,49.65831836677587,NaN,NaN,-99.15732683908969,-84.32487792574948,-0.19624879686920102,-0.19089874362234838,0.005350053246852643,3488813450,3525239683.6,40.81636759638526,44.63981828841505,NaN,NaN,-6.056463462432817,1.776455206441763
2010-08-24T09:30:00-04:00,44.00999,44.12,43.465,43.64999,79095744,65573836,35.066441709530494,47.79726756827315,NaN,NaN,-168.6161908897213,-106.0426841164466,-0.24979905843955696,-0.30689876980259356,-0.057099711363036605,3409717706,3504632829.2,38.79661646679259,43.27547355677687,NaN,NaN,-9.862472686906615,0.11375122167770879
2010-08-25T09:30:00-04:00,43.35001,44.25999,43.27,44.07001,87347872,67341824,39.53855477638595,46.334330254513354,NaN,NaN,-138.49880404317565,-122.88784820448807,-0.24294318320830283,-0.36077869037341515,-0.11783550716511232,3497065578,3489128253.2,37.30101119472101,41.66741767638278,NaN,NaN,-11.665493580890983,-1.568998035832104
2010-08-26T09:30:00-04:00,44.24001,44.32001,43.5,43.53999,91223008,67618277.6,36.15467442765265,44.682952010728776,NaN,NaN,-126.75955157161141,-127.42111717017569,-0.25866092467600105,-0.4411616630101136,-0.18250073833411257,3405842570,3471972976.4,35.66283172390719,40.05008628124201,NaN,NaN,-14.279470111930099,-3.3847797609889603
2010-08-27T09:30:00-04:00,43.86,44.16,42.97,44.07001,109595936,68150171.2,41.54256363311264,43.24876419860636,NaN,NaN,-114.45426437707582,-129.49722754413477,-0.21946460486456698,-0.4568314944148213,-0.2373668895502543,3515438506,3463375562,34.83710239033316,38.558593523233405,NaN,NaN,-14.783215423367588,-5.013127712757336
2010-08-30T09:30:00-04:00,43.87,44.25,43.60001,43.61,49373120,67183492.8,38.505382516854624,41.92003614206126,NaN,NaN,-98.3630756256222,-129.33837730144126,-0.21058514864068145,-0.5005983253511062,-0.2900131767104247,3466065386,3458825949.2,34.38340938183873,37.260192739651096,NaN,NaN,-16.168292897864447,-6.606722739201208
2010-08-31T09:30:00-04:00,43.39,43.85001,43.17999,43.46001,72066816,67743664.8,37.54161980341394,41.32867466474139,NaN,NaN,-111.12558719845994,-117.840256563189,-0.2009084726585793,-0.5411487675336488,-0.3402402948750695,3393998570,3455682122,34.053382563526455,36.360328152679514,NaN,NaN,-17.57947746927962,-8.174259129212409
2010-09-01T09:30:00-04:00,44.10001,44.91,44.07001,44.75999,83523120,69728931.2,49.36978758841195,41.76806809808291,NaN,NaN,-30.417803652149416,-96.22405648498376,-0.09824777306718341,-0.46305001120904876,-0.36480223814186535,3477521690,3451773344.4,33.62128523369066,35.82197543036985,NaN,NaN,-14.877016871057801,-9.131795949476036
2010-09-02T09:30:00-04:00,44.84,45.28,44.73,45.25999,41816720,69862259.2,53.052416979735234,42.62968304646201,NaN,NaN,17.816543336506072,-67.30883750336027,0.006482939458734127,-0.35669856381844767,-0.3631815032771818,3519338410,3474472512.4,38.50150598962991,35.93748645400309,NaN,NaN,-11.41109561798976,-9.457410187835139
2010-09-03T09:30:00-04:00,45.73,46.02,45.55,46.00999,64041072,69497340.8,57.98860110394602,43.78616751359254,NaN,NaN,93.30759180229249,-25.756466267486605,0.12296057900331842,-0.2094807795230338,-0.3324413585263522,3583379482,3488060707.6,41.28442439095598,36.490756757106865,NaN,NaN,-6.766666807532371,-9.073018276363316
2010-09-07T09:30:00-04:00,45.82001,46.03,45.625,45.7,51195136,70710247.2,55.396046070323585,44.360961058284154,NaN,NaN,100.47760470192897,14.011669798023632,0.17276867699030113,-0.11648051228847578,-0.2892491892787769,3532184346,3501284499.6,43.9429751226225,37.32205654799826,NaN,NaN,-3.893535667157034,-8.333092189333847
2010-09-08T09:30:00-04:00,45.84,46.45,45.82001,46.25,66883936,69719722.4,58.90646198634104,45.0700066889275,NaN,NaN,146.676899829117,65.57216720353901,0.2326673530763624,0.001585002066676111,-0.2310823510096863,3599068282,3542298442,51.30704574592925,38.55418862321801,NaN,NaN,-0.3371188254951571,-7.190810280214034
2010-09-09T09:30:00-04:00,46.67,46.7,46.32001,46.42999,61476384,68182560,60.01550204853077,46.258845545448764,NaN,NaN,162.78983354572756,104.21369464311442,0.2716071506990405,0.10842658736411437,-0.16318056333492614,3660544666,3578903037.2,56.76591783845009,40.082844901756694,NaN,NaN,2.8593195328988448,-5.755077449769337
2010-09-10T09:30:00-04:00,46.49001,46.67,46.25,46.60001,66995680,68232322.4,61.08391504315177,47.481089871425645,NaN,NaN,139.8258455536035,128.6155550865339,0.2941137310602871,0.20446160049043272,-0.08965213056985437,3727540346,3620543424.4,61.98670664431305,41.66147016307815,NaN,NaN,5.783053223579593,-4.106773067862347
2010-09-13T09:30:00-04:00,46.95,47.37,46.94,47.25,64523296,69139124,64.94083342524829,49.22162865090278,NaN,NaN,163.76738038077764,142.70751280223092,0.3351006764898854,0.32922371504250236,-0.0058769614473830195,3792063642,3662280256.4,66.37022874393946,43.486745959332026,NaN,NaN,9.544515710315936,-2.156588956694021
2010-09-14T09:30:00-04:00,47.17,47.7,47.08,47.45,91405808,70935772,66.05560871805372,51.43514058008301,NaN,NaN,151.40286890751463,152.89256564334806,0.3560410805460991,0.4391743892352409,0.08313330868914177,3883469450,3732537277.2,72.1848789027381,45.87162184761384,NaN,NaN,12.965698948579933,0.0037378869165434203
2010-09-15T09:30:00-04:00,47.35001,47.8,47.19,47.75,67108128,71444825.6,67.71395977827382,53.44766950878928,NaN,NaN,138.7204504004288,151.30127575761043,0.3688892469920007,0.5442448674291427,0.17535562043714198,3950577578,3802839136.4,76.55345831914329,48.67536807078687,NaN,NaN,16.335438873219164,2.336838027816918
2010-09-16T09:30:00-04:00,47.67999,47.98,47.53999,47.94,66885744,71697288.8,68.75508930901886,55.776270571744014,NaN,NaN,131.07915429046187,144.95913990655728,0.36813111732832005,0.6355195170975421,0.267388399769222,4017463322,3874222867.6,79.99001263188734,51.84159527849973,NaN,NaN,19.445932528787253,4.780994385098394
2010-09-17T09:30:00-04:00,48.14,48.14,47.75,47.995,76372560,71367441.6,69.06605966940366,57.74223457433623,NaN,NaN,120.1314099330358,141.02025278244375,0.34943013737358414,0.7041760714862022,0.35474593411261807,4093835882,3947481974.8,82.77957095519412,55.26605731884695,NaN,NaN,22.10209687447336,7.255437597866246
2010-09-20T09:30:00-04:00,48.17999,48.92999,48.11011,48.8299,84536560,72253938.4,73.39480992534436,60.23433653208549,NaN,NaN,133.39905985493837,134.94658867727588,0.369438236784188,0.8165437300928531,0.44710549330866506,4178372442,4024743734.8,85.13346096505737,58.89106100336256,NaN,NaN,25.876769906318252,9.915627927645104
2010-09-21T09:30:00-04:00,48.84,49.17,48.61,48.82001,82352624,72890963.2,73.26402292993109,62.78593675540815,NaN,NaN,127.41559369339124,130.14913363445123,0.35790503090076164,0.8944867819346172,0.5365817510338555,4096019818,4067253808.4,86.2473466854198,62.61920129778351,NaN,NaN,28.902722079473953,12.62806994933494
2010-09-22T09:30:00-04:00,48.61,49.021,48.42,48.69,88315872,73351969.6,71.46127452322247,64.36390010789461,NaN,NaN,109.49719456571287,124.30448246750802,0.3187254198858469,0.9349885258911641,0.6162631060053172,4007703946,4078679082,86.53926343935393,66.39905688390232,NaN,NaN,30.95651473009286,15.246419203728928
2010-09-23T09:30:00-04:00,48.39,49.16,48.32001,48.67,85039936,73236572.8,71.17114878738661,65.65809523701257,NaN,NaN,100.13260145455158,118.11517190032596,0.27056557917815327,0.9544700799780088,0.6839045007998555,3922664010,4059719219.6,83.37648083124253,69.60441222973178,NaN,NaN,32.59323791341963,17.72453616225617
2010-09-24T09:30:00-04:00,49.22,49.69,49.14999,49.66,79495872,72650216,76.30032646194431,66.96607561972674,NaN,NaN,121.23550610430614,118.33599113458004,0.2831408896763601,1.0378306128953056,0.7546897232189456,4002159882,4041384019.6,80.3193672134321,72.39262243133723,NaN,NaN,35.713926305606954,20.294449039877712
2010-09-27T09:30:00-04:00,49.64999,49.75,49.35001,49.39,43883408,69364589.6,72.51120288716689,68.18858682092983,NaN,NaN,111.29391433962182,113.91496203151674,0.25206900598764115,1.069775980703497,0.8177069747158558,3958276474,3997364826,73.36440853718753,74.49415338952043,NaN,NaN,37.23719514030458,22.714841339938694
2010-09-28T09:30:00-04:00,49.50999,49.53999,48.59,49.37,104922880,72142077.6,72.22508083947758,69.13991673901101,NaN,NaN,90.62553233255903,106.5569497593503,0.21064864575749742,1.0810177819127276,0.8703691361552301,3853353594,3948831581.2,66.52467809230683,75.58112712854742,NaN,NaN,38.40071682414392,24.955680694825155
2010-09-29T09:30:00-04:00,49.3,49.53,49.11,49.28999,81679184,72622696,71.01778884938321,69.92579436764332,NaN,NaN,92.13754836781868,103.08502051977148,0.16060357576243633,1.0711236058582756,0.9105200300958393,3771674410,3901625674,60.60617169619504,75.85543097552919,NaN,NaN,39.049569925574026,26.969093442074993
2010-09-30T09:30:00-04:00,49.53999,49.84,48.75,49.07001,122458560,74569468,67.66863344737749,70.3961313965166,NaN,NaN,81.14626702696792,99.28775363425474,0.09847754359933514,1.0336169595950082,0.9351394159956731,3649215850,3846936042,54.55101343080736,75.32431003170736,NaN,NaN,38.708544561760924,28.646157887744412
2010-10-01T09:30:00-04:00,49.46001,49.53,48.78101,49.00999,77682368,76362750.4,66.74377262914695,70.52491276822364,NaN,NaN,68.80882350187136,88.80241711376777,0.04201997092327325,0.9876643796497646,0.9456444087264914,3571533482,3760810762,46.64707742495657,73.91551350892287,NaN,NaN,38.17778418054827,30.007818786716392
2010-10-04T09:30:00-04:00,48.86,49.05,48.2,48.48,71359504,76728672,59.066818876010245,70.02571349379197,NaN,NaN,30.850851738325034,72.71380459350841,-0.03801328138911009,0.8981278069901037,0.9361410883792138,3500173978,3669190262.8,40.00634268311941,71.61704663609295,NaN,NaN,35.52991811326849,30.796690119080978
2010-10-05T09:30:00-04:00,49.03,49.75999,49,49.66,99301248,79133977.6,67.91540289208406,70.04010228763556,NaN,NaN,85.11216517842496,71.61113116268162,-0.01941363071668256,0.9118740499833606,0.9312876807000432,3599475226,3618414589.2,36.87339898809749,68.7827566838754,NaN,NaN,35.68719907180835,31.49533425518489
2010-10-06T09:30:00-04:00,49.59,49.71001,48.91,49.23,81831120,79881336.8,62.60442555521416,69.60076916236379,NaN,NaN,67.74411275001093,66.73244403912005,-0.04267000286801448,0.8779501771150251,0.9206201799830396,3517644106,3567608528.4,34.00395540404651,65.4980383104582,NaN,NaN,34.08377322031056,31.865111250202844
2010-10-07T09:30:00-04:00,49.52,49.53999,49,49.41,75693248,80592180,63.877836713842804,69.23018180839516,NaN,NaN,68.08285541462763,64.11976171665201,-0.05191575328530573,0.8557254883764074,0.9076412416617131,3593337354,3556432829.2,33.388460061970534,61.970101818085084,NaN,NaN,33.179494183426236,32.05288024066333
2010-10-08T09:30:00-04:00,49.45,49.87,49.08,49.75,83223808,81403586.4,66.21789283336909,68.71754487325407,NaN,NaN,89.60336245710154,68.27866950769805,-0.04156608720174859,0.8556836326595274,0.897249719861276,3676561162,3577438365.2,35.742756634830116,58.44219436592599,NaN,NaN,33.136008675567155,32.20761287422102
2010-10-11T09:30:00-04:00,49.78,50.02,49.62,49.77,46879920,80521417.6,66.35596190333061,68.22411194278261,NaN,NaN,110.1925104753202,84.14700125509708,-0.03980385518083629,0.8474949008852306,0.8872987560660669,3723441082,3622091786,40.55279752976616,55.17829799766501,NaN,NaN,33.141131696004955,32.34097270590444
2010-10-12T09:30:00-04:00,49.69,50.21001,49.25999,50.11,88571632,80379708.8,68.69810737722388,68.02674286092557,NaN,NaN,112.06527886272534,89.53762399195716,-0.023004066119540978,0.8585436734166407,0.8815477395361817,3812012714,3664599283.6,44.789643878024286,52.19618231471289,NaN,NaN,33.82897559793479,32.55354454762306
2010-10-13T09:30:00-04:00,50.39999,50.75,50.28,50.52,71122752,80580440,71.29334957402722,68.03547148854275,NaN,NaN,191.49971949609218,114.28874534117342,0.006859967053025606,0.8901226983524637,0.8832627312994381,3883135466,3737697555.6,51.227124155515426,49.8997996950181,NaN,NaN,35.201985833144136,32.9318933026975
2010-10-14T09:30:00-04:00,50.53999,50.64,50.17,50.42,68463744,80659340,69.77384921984529,67.56929454267853,NaN,NaN,167.52675848027258,134.1775259543024,0.010784249571629045,0.8967430432639745,0.8859587936923454,3814671722,3781964429.2,54.67380484252429,48.06797381138183,NaN,NaN,35.89429608295587,33.35509369987727
2010-10-15T09:30:00-04:00,51.03999,51.5,50.63,51.49001,104653936,82073408.8,75.73361717355672,67.79946699170638,NaN,NaN,240.61236425862495,164.37932631460708,0.07288700689972016,0.9770675523169956,0.9041805454172754,3919325658,3830517328.4,58.16581130013604,46.98235972302101,NaN,NaN,38.51960458034304,34.09288096851524
2010-10-18T09:30:00-04:00,51.52,51.72,51.3,51.3,72505184,81471840,72.98170959965094,67.85351190314734,NaN,NaN,215.11686670720647,185.36419756098434,0.08762171897917637,1.013707694141246,0.9260859751620696,3846820474,3855193206.8,59.85844170800915,46.50619998128546,NaN,NaN,39.77075886688264,34.90400638256772
2010-10-19T09:30:00-04:00,50.81,51.3,50.42,50.82001,105739680,82641192.8,66.41632187012982,67.52483569034352,NaN,NaN,122.89023619519371,187.52918902747803,0.05318908623770913,0.992572332959206,0.9393832467214969,3741080794,3841006822.8,58.395608702656965,46.34830262460417,NaN,NaN,38.740127932109594,35.45202374678799
2010-10-20T09:30:00-04:00,50.96001,51.57001,50.87,51.19,80861056,82268452,68.74998946078539,67.60207540558693,NaN,NaN,136.4469961722509,176.51864436270975,0.043866839002937086,0.9942167954751682,0.9503499564722311,3821941850,3828768099.6,57.09918098553411,46.530314592798945,NaN,NaN,38.609853291038604,35.9031422531095
2010-10-21T09:30:00-04:00,51.50999,51.7101,50.78999,51.28999,85885312,82310720.8,69.36945440440726,67.78962410381982,NaN,NaN,120.36175541302214,167.08564374925965,0.033441231908875046,0.9921514963583249,0.9587102644494498,3907827162,3847399187.6,58.6057697245305,47.384506899911365,NaN,NaN,38.69059237347092,36.301349413161134
2010-10-22T09:30:00-04:00,51.3,51.69,51.21001,51.64,47409152,80706384.8,71.49922032937648,68.67765277906027,NaN,NaN,121.06415775223714,143.17600244798209,0.03875006075772447,1.0071478403966054,0.968397779638881,3955236314,3854581318.8,59.20058602209348,48.75552428126666,NaN,NaN,39.39933054648585,36.743918146493236
2010-10-25T09:30:00-04:00,51.85001,52.23,51.85001,51.89,51413632,81082896,72.94615960329585,69.03699254414683,NaN,NaN,135.8397402874657,127.32057716403395,0.047171907863022944,1.0273626644676597,0.9801907566046367,4006649946,3886547213.2,61.829572098732555,50.53810807488345,NaN,NaN,40.42351322760583,37.269574586652176
2010-10-26T09:30:00-04:00,51.62,52.14999,51.42,52.03,60498256,78861664.8,73.74986667185016,69.8330954810494,NaN,NaN,112.20976094995436,125.18448211498608,0.04997599002071407,1.0426607441305293,0.9926847541098153,4067148202,3951760694.8,66.56320154720206,52.86376851368028,NaN,NaN,41.503800093045264,37.87446394470833
2010-10-27T09:30:00-04:00,51.77,52.23,51.66,52.19,57483184,77651864.8,74.67580311202347,70.60437879520516,NaN,NaN,110.87309629679021,120.06970213989393,0.05027441920920084,1.0555277781213164,1.0052533589121155,4124631386,4012298602,70.2513560282167,55.49683251126929,NaN,NaN,42.67310941863456,38.55998472669779
2010-10-28T09:30:00-04:00,52.42,52.45,51.84,52.3,61220000,74589936.8,75.32033774784917,71.25455343195374,NaN,NaN,110.14628142628042,118.02660734254557,0.04568124074623814,1.0623549098449132,1.016673669098675,4185851386,4067903446.8,73.17785171435398,58.17076787409242,NaN,NaN,43.832004449773784,39.31313040142293
2010-10-29T09:30:00-04:00,52.28999,52.49001,52.1698,52.17999,46668688,73039252.8,73.13340314639537,71.73865637788694,NaN,NaN,105.44769584556165,114.90331496121048,0.02348006173569739,1.0460237462682969,1.0225436845325995,4139182698,4104692723.6,74.9347478706375,60.626621469868944,NaN,NaN,44.229845310991436,40.015518245647
2010-11-01T09:30:00-04:00,52.38,52.75,51.98,52.22,60555552,72499055.2,73.4105870995654,72.0752620723399,NaN,NaN,101.28565412930175,107.99249772957769,0.0015649383489182433,1.0244998574687472,1.022934919119829,4199738250,4143310384.4,76.66277717385572,62.90327384814261,NaN,NaN,44.636215863881894,40.675617905394844
2010-11-02T09:30:00-04:00,52.66,52.92999,52.575,52.78,48137408,69940863.2,76.98903298937127,72.48209660200733,NaN,NaN,123.37629933737,110.22580540706083,0.014158916263748322,1.0406335644495144,1.026474648185766,4247875658,4179455875.6,78.17914199112076,64.82841797925728,NaN,NaN,46.0248409397586,41.439792624589664
2010-11-03T09:30:00-04:00,52.84,53.03999,52.36,53.02,126225808,72160597.6,78.33476040693306,73.09359025822789,NaN,NaN,119.86730074405757,112.0246462965143,0.027268409733308907,1.0605601603524022,1.0332917506190933,4374101466,4229349891.6,80.10117553073445,66.64465874270086,NaN,NaN,47.60495238764081,42.32052973359697
2010-11-04T09:30:00-04:00,53.63,53.8614,53.5,53.67,84201008,72585985.6,81.49175767595734,73.50488600839935,NaN,NaN,169.3770496348612,123.87079993823042,0.06611688899891921,1.1159378618677422,1.049820972868823,4458302474,4283840109.2,81.9691077777767,68.34489420538948,NaN,NaN,50.051045946837135,43.42488919263128
2010-11-05T09:30:00-04:00,53.7,53.81,53.50999,53.67,77937056,72321648,81.49175767595734,74.11274658527839,NaN,NaN,150.7674506456734,132.9347508982528,0.07742938919172326,1.1466077093584772,1.069178320166754,4458302474,4347664064.4,83.87808277732717,70.06058285319791,NaN,NaN,52.01123706224503,44.65151031686181
2010-11-08T09:30:00-05:00,53.57001,53.83,53.44991,53.7375,39623424,71958823.2,81.81097027599787,75.21236432855468,NaN,NaN,138.77696972787567,140.43301401796757,0.07502106627649319,1.1629546530123704,1.0879335867358773,4497925898,4407301594,85.43030565029773,71.99163263517225,NaN,NaN,53.724556476937025,45.94765976830113
2010-11-09T09:30:00-05:00,53.97,54.0401,53.21001,53.45,66969744,70878728.8,75.81334578224792,75.71688978008773,NaN,NaN,119.63843959257126,139.68544206900782,0.041312786679931435,1.1395745700857915,1.0982617834058601,4430956154,4443917693.2,86.3023160179923,74.0775708517764,NaN,NaN,53.530602607350275,47.03093731673672
2010-11-10T09:30:00-05:00,53.53,53.77,53.10001,53.715,83553632,71500272.8,77.45404535619063,76.29436056235795,NaN,NaN,104.91441374639021,136.69486466947433,0.024918443394887024,1.1294098376494688,1.1044913942545818,4514509786,4471999357.2,86.94752375269886,76.10198185378843,NaN,NaN,53.82343590828401,48.00129425838633
2010-11-11T09:30:00-05:00,52.89999,53.48,52.66,53.38499,85163504,72335260.8,70.9952916101549,76.25836565384213,NaN,NaN,68.30577645595358,116.4806100336928,-0.017793383792554796,1.0822496645138884,1.1000430483064432,4429346282,4466208118.8,86.04735643085148,78.01960831155687,NaN,NaN,52.183625826339686,48.598770196665384
2010-11-12T09:30:00-05:00,53.10001,53.3672,52.11,52.50999,99164256,72060776.8,57.34185456641417,75.14377243692202,NaN,NaN,20.697565052024864,90.46663291496311,-0.10950090935960799,0.9631669116069332,1.0726678209665412,4330182026,4440584029.2,82.00204117518481,79.46049895987487,NaN,NaN,46.03209707135403,48.23210260733519
2010-11-15T09:30:00-05:00,52.78,52.88,52.28999,52.315,56723376,71271686.4,54.812102966338,73.79107502938542,NaN,NaN,1.7531356024712146,63.06186608988223,-0.1834643051420224,0.8433374395390132,1.0268017446810356,4273458650,4395690579.6,75.32091541873467,80.08604995069864,NaN,NaN,40.22908995237446,47.08881508519794
2010-11-16T09:30:00-05:00,51.92999,52.2462,50.85001,51.45,101096624,71039533.6,45.27070784298933,71.69071108159729,NaN,NaN,-95.62840097435634,20.008497976496706,-0.2847690613827508,0.6708404179525971,0.9556094793353479,4172362026,4343971754,68.40625063104704,79.95425670804366,NaN,NaN,31.494741223955774,44.861090247877634
2010-11-17T09:30:00-05:00,51.49001,51.87,51.35001,51.60001,77836128,70888287.2,46.99396281406762,69.66739858632717,NaN,NaN,-91.102385260645,-19.194861824910348,-0.3324756767029531,0.5400148834566565,0.8724905601596096,4250198154,4291109427.6,62.12817637423074,79.16499418374914,NaN,NaN,25.207843140691754,42.05348351827965
2010-11-18T09:30:00-05:00,52.14999,52.78999,52.13,52.42999,71488256,70168434.4,55.36756605597302,68.39841022272557,NaN,NaN,-14.856487896831675,-35.82731469546739,-0.2999352798699627,0.49757146032215616,0.7975067401921189,4321686410,4269577453.2,59.72381113486625,78.07849870262262,NaN,NaN,22.54298759104576,39.26626981438909
2010-11-19T09:30:00-05:00,52.34,52.59,52.14,52.47,54512704,70523612,55.73062408813526,67.13555572190913,NaN,NaN,-26.6841697928481,-45.30366166444198,-0.2685338585473114,0.4618394170079796,0.730373275555291,4376199114,4278780870.8,60.42873422091219,76.9189242059838,NaN,NaN,20.62288486167449,36.60292910685843
2010-11-22T09:30:00-05:00,52.25,52.91,52.17,52.91,69918816,71448871.2,59.6206591211338,65.8949575884636,NaN,NaN,-0.386682935249621,-45.73162537198615,-0.21335396907017257,0.46368081421757523,0.6770347832877478,4446117930,4313312726.8,63.042414335024226,75.83772937340548,NaN,NaN,20.295380070224475,34.273279244482154
2010-11-23T09:30:00-05:00,52.39,52.45,51.77,52.07001,76900944,72269005.6,50.49784047112456,63.90660616447728,NaN,NaN,-71.41611757240167,-40.889168691595216,-0.2273625120635041,0.3928316432083676,0.6201941552718717,4369216986,4352683718.8,65.81478872978246,74.81727317333763,NaN,NaN,16.800154986433338,31.777118636189467
2010-11-24T09:30:00-05:00,52.58,53.25,52.56,53.12,53455536,72067623.2,58.952800056836594,62.29668062025436,NaN,NaN,31.599941015052977,-16.348703436455626,-0.16287035973710162,0.41660620560049466,0.5794765653375963,4422672522,4387178592.4,68.07448020679767,73.82479977541054,NaN,NaN,16.910054257773655,29.65325229641578
2010-11-26T09:30:00-05:00,52.8,53.13,52.67,52.968,23640288,70188637.6,57.423748813303334,60.57753713006479,NaN,NaN,20.890833046196466,-9.199239247849993,-0.12889325682573616,0.41835999430542614,0.5472532511311623,4399032234,4402647757.2,69.0621196512539,72.76651669497674,NaN,NaN,16.458534501585042,27.76829261143996
2010-11-29T09:30:00-05:00,52.7,52.89999,52.10001,52.73,89265936,72318500,55.017521367370854,58.66371935087715,NaN,NaN,-26.673055598181143,-9.197016408916605,-0.1210180768756649,0.3959806550365812,0.5169987319122461,4309766298,4389361194,67.14089542948875,71.46013025063324,NaN,NaN,15.299391552996436,25.987021031662316
2010-11-30T09:30:00-05:00,52.17999,52.7355,51.88,52.08501,118861504,75233797.6,49.02237008295425,56.750078229499024,NaN,NaN,-71.34933787983415,-23.389547397833503,-0.15561323282606782,0.32248219087966135,0.47809542370572916,4190904794,4338318566.8,60.21110940979401,69.59647263576194,NaN,NaN,12.269414515476363,24.027362957921465
2010-12-01T09:30:00-05:00,52.87,53.46001,52.84,53.19,81758064,76914830.4,57.55553664234423,55.32875617851,NaN,NaN,47.2912388120025,0.35192387904733236,-0.10298012792847921,0.34937026379513014,0.45235039172360936,4272662858,4319007741.2,57.781298389662,67.51317082411646,NaN,NaN,12.703877642471944,22.409722198571533
2010-12-02T09:30:00-05:00,53.27,53.81,53.21001,53.73,56883984,73447739.2,60.991946510716005,54.61423152855008,NaN,NaN,89.27874063243061,11.88768380252286,-0.03425478269248022,0.4095319133580091,0.4437866960504893,4329546842,4300382605.2,55.456775758915235,65.32812934754958,NaN,NaN,14.295433659991435,21.250538121631518
2010-12-03T09:30:00-05:00,53.5,53.94,53.5,53.87,38014160,71138396.8,61.8542284179537,54.93654394651718,NaN,NaN,109.98162313471784,29.705841820227135,0.015505178920345641,0.46316816970092134,0.4476629907805757,4367561002,4294088358.8,54.65654066395637,63.37487931103326,NaN,NaN,15.811678267802801,20.47355814251313
2010-12-06T09:30:00-05:00,53.86,53.95,53.67999,53.845,39311536,69207120.8,61.592398801722695,55.4208507919018,NaN,NaN,113.88019876375711,57.816492692614794,0.040204252117464534,0.4979183059274064,0.45771405380994185,4328249466,4297784992.4,55.066630789051,61.928144694627285,NaN,NaN,16.91007464590743,19.96448907156946
2010-12-07T09:30:00-05:00,54.49001,54.52,53.82001,53.88,59067232,70179311.2,61.8359646447043,56.60408342059572,NaN,NaN,135.65137591006467,99.21663545059455,0.05163830594143143,0.5222619362367311,0.4706236302952997,4387316698,4337067373.2,59.28104628117998,61.2763443839225,NaN,NaN,17.859942143622096,19.663839510434123
2010-12-08T09:30:00-05:00,54.02,54.14999,53.6899,54.08,48066848,69234166.4,63.2693864858446,57.76661368286551,NaN,NaN,118.10666955940415,113.37972160007489,0.06457093099842875,0.5513372940433356,0.4867663630449069,4435383546,4369611510.8,62.425339775365806,61.29757034114643,NaN,NaN,19.067858156816293,19.578699317060146
2010-12-09T09:30:00-05:00,54.41,54.44,53.95,54.13499,51679728,67640471.2,63.673388034893705,58.35988668135985,NaN,NaN,129.65775046345348,121.45552356627945,0.06836351225319426,0.5722207533613997,0.5038572411082054,4487063274,4401114797.2,65.22473783350483,61.690493676763474,NaN,NaN,20.17522898157379,19.663917840562096
2010-12-10T09:30:00-05:00,54.28999,54.55,54.09,54.495,44696144,65617103.2,66.28770753222881,59.11396407022367,NaN,NaN,131.10887248184213,125.6809734357043,0.08553832729320587,0.6107801502247128,0.5252418229315069,4531759418,4433954480.4,67.90874731616748,62.22478032642456,NaN,NaN,21.883756772892383,19.98103768803785
2010-12-13T09:30:00-05:00,54.71001,54.74001,54.27,54.3,53110160,63314398.4,63.617086452279715,59.39942316530552,NaN,NaN,117.37468740760484,126.37987116447387,0.07458613428245708,0.6184744907845783,0.5438883565021212,4478649258,4464034438.8,70.17911947106413,62.73454497899884,NaN,NaN,22.60901168056552,20.35646254411323
2010-12-14T09:30:00-05:00,54.42,54.62,54.23,54.395,69944000,63975429.6,64.37020997628915,60.39030670138872,NaN,NaN,102.19153206654413,119.68790239576974,0.06491573521132199,0.6250330255162737,0.5601172903049517,4548593258,4496289750.8,72.43145422767806,63.20716394313424,NaN,NaN,23.421434908923423,20.794315739086116
2010-12-15T09:30:00-05:00,54.37,54.7,54.03,54.16,76951808,62768188.8,61.00609444712609,60.53697058640939,NaN,NaN,83.84178355623229,112.83492519513538,0.035347892896470445,0.6043021564255397,0.5689542635290693,4471641450,4503541331.6,72.92653095335311,63.55373899645963,NaN,NaN,23.23191589672112,21.142544333033975
2010-12-16T09:30:00-05:00,54.21001,54.66,54.06,54.58,65519392,62152352,64.56997803051502,61.04741553049594,NaN,NaN,88.14807846884474,104.53299079621362,0.036578718589188375,0.6146776617655547,0.5780989431763663,4537160842,4513560845.2,73.63114066946575,63.88009764061762,NaN,NaN,24.052034536975107,21.558185790739852
2010-12-17T09:30:00-05:00,54.53999,54.67999,54.41,54.52,36849552,60420416.8,63.67465446837887,61.66578218056794,NaN,NaN,89.94839919035542,96.30089613791628,0.02633318187178424,0.6110154205160967,0.5846822386443125,4500311290,4507271219.6,72.35806417968348,64.25275255134581,NaN,NaN,24.497088511086886,21.978029036503713
2010-12-20T09:30:00-05:00,54.59,54.75999,54.16,54.56,48159600,60102761.6,64.03271010501342,62.737949325000734,NaN,NaN,80.28951797616074,88.88386225162745,0.015753319228104856,0.6043738876794436,0.5886205684513387,4548470890,4521235546,73.45542300105333,65.19877495072149,NaN,NaN,24.964342567028016,22.404645255150044
2010-12-21T09:30:00-05:00,54.76019,54.89,54.62,54.89,35775344,58395588,66.92890612797582,63.40747571683156,NaN,NaN,102.87096732555226,89.01974930342908,0.023989738959017903,0.618607742150111,0.5946180031910931,4584246234,4528366141.2,74.02253322564755,66.35886315329188,NaN,NaN,26.162836849790754,22.941529768670144
2010-12-22T09:30:00-05:00,54.86,54.96001,54.78999,54.88499,35766432,56338862.4,66.84090848272206,63.82525871483199,NaN,NaN,106.80041985573149,93.61147656332892,0.02215384019475064,0.6223103034345314,0.6001564632397808,4548479802,4543733811.6,75.24979553746434,67.77265028033109,NaN,NaN,27.14262352120695,23.541686019032543
2010-12-23T09:30:00-05:00,54.78,54.87,54.61,54.742,21668240,54749497.6,64.24465582346636,63.99600352951147,NaN,NaN,86.3190457847799,93.24567002651597,0.005244993841225343,0.6067127055413124,0.6014677117000871,4526811562,4541663955.6,74.73764599040172,69.20701494650577,NaN,NaN,27.335478461757724,24.08365636799328
2010-12-27T09:30:00-05:00,54.62,54.86,54.21001,54.77,29263424,55030654.4,64.53515156281253,64.2062001553036,NaN,NaN,67.56253400107286,88.76849698865945,-0.009324666449070818,0.5898118786387485,0.5991365450878193,4556074986,4552816694.8,75.69742204592927,70.68064289342564,NaN,NaN,27.57181029373274,24.581964071670345
2010-12-28T09:30:00-05:00,54.88,54.92,54.55,54.67,24168608,51775788,62.57964817181686,64.25932040724021,NaN,NaN,77.51136400562119,88.21286619455154,-0.029811812732500664,0.5618717791721934,0.5916835919046941,4531906378,4549503792.4,74.78846679570661,71.7883157873204,NaN,NaN,27.296491385255745,24.96975368789683
2010-12-29T09:30:00-05:00,54.82001,54.89999,54.73,54.78999,24132688,47039347.2,63.989648882991254,64.31076772132211,NaN,NaN,93.30714146759315,86.30010102295972,-0.038826759519312914,0.5431501425055529,0.5819769020248658,4556039066,4543862358.8,73.17707197308007,72.55629665858571,NaN,NaN,27.399970907351996,25.316927576390427
2010-12-30T09:30:00-05:00,54.78999,54.8,54.55,54.66,27562160,44329552,61.29509566009017,64.14088969455044,NaN,NaN,64.95856535173087,77.9317301221596,-0.05604322107037896,0.5119228756868921,0.567966096757271,4528476906,4539861779.6,71.99246991556558,73.03970609301862,NaN,NaN,26.822865699166638,25.532061593929885
2010-12-31T09:30:00-05:00,54.60001,54.62,54.21001,54.46001,38565920,43413648.8,57.29752695435591,63.49873393898808,NaN,NaN,1.8998677767819723,61.04789452056001,-0.08183722045261299,0.46566957119150487,0.5475067916441179,4489910986,4532481664.4,69.74929956002103,73.17117411043672,NaN,NaN,25.281084602260318,25.49620773797709
2011-01-03T09:30:00-05:00,54.959,55.69,54.95,55.31,90994320,46062656.8,67.11427856744844,63.74853337578585,NaN,NaN,211.51586231975773,89.838560184297,-0.04446149606806693,0.49192992155903426,0.5363914176271012,4580905306,4537447728.4,70.41725502513376,73.18818379287028,NaN,NaN,26.659155990133492,25.662343202570863
2011-01-04T09:30:00-05:00,55.53,55.55,54.92,55.265,43851456,46289652.8,66.2460024958587,63.882518555755105,NaN,NaN,169.9725071137507,108.33078880592288,-0.026466344057110014,0.5033084875557137,0.5297748316128237,4537053850,4538477222.8,70.56236968203875,73.05467775389604,NaN,NaN,27.52392534428545,25.92828350853009
2011-01-05T09:30:00-05:00,55.11,55.75999,55.07001,55.74001,43787168,45525649.6,70.5736703759266,64.5659168363837,NaN,NaN,202.19932434349218,130.1092253811027,0.01168425056368605,0.5443801448174312,0.5326958942537452,4580841018,4543437613.2,71.29306477731303,72.93800159846461,NaN,NaN,29.661732369442067,26.46163334580323
2011-01-06T09:30:00-05:00,55.78999,55.96001,55.67999,55.92,46139536,45429284,72.03668181676125,65.09925282111558,NaN,NaN,228.00801020537165,162.71911435183085,0.04161385097563364,0.5847132079732873,0.5430993569976537,4626980554,4563138342.8,74.04825188564558,72.96779525676318,NaN,NaN,31.891312669363735,27.237301820597587
2011-01-07T09:30:00-05:00,56.02,56.05,55.32001,55.87,72261632,46458379.2,70.98093530471614,65.6211300237111,NaN,NaN,169.21668596109598,196.18247798869365,0.05004946148926359,0.6056611838592332,0.5556117223699696,4554718922,4576099930,75.70066707638546,73.2065526065276,NaN,NaN,33.40002483959051,28.117690823310863
2011-01-10T09:30:00-05:00,55.72,56.17999,55.58,56.08,55551760,47001160,72.78498504070494,66.24629251911763,NaN,NaN,164.4987727648478,186.77906007771168,0.06104936664599259,0.6319234306774604,0.5708740640314678,4610270682,4581973005.2,76.4329024739327,73.41922971173327,NaN,NaN,35.223909683945884,29.132864946258724
2011-01-11T09:30:00-05:00,56.28999,56.36,55.95,56.16,56663776,47178840.8,73.46183341069246,66.71293018216883,NaN,NaN,159.24141843586082,184.6328423421337,0.06464444864967922,0.6516796248435668,0.5870351761938876,4666934458,4607949126.8,79.39096563011653,73.80268916919535,NaN,NaN,36.93470118945192,30.24741298100061
2011-01-12T09:30:00-05:00,56.42,56.56,56.2,56.55499,51978976,46280589.6,76.56136409343029,67.40724844007654,NaN,NaN,162.31238590860255,176.65545465515578,0.08336445896830369,0.6912407499042672,0.6078762909359635,4718913434,4635563610,81.98034200774421,74.28344248850104,NaN,NaN,39.41982740842091,31.557757899203512
2011-01-13T09:30:00-05:00,56.59,56.73,56.41,56.575,47430384,44804518.4,76.70976772036562,68.29761357556936,NaN,NaN,151.9472937852706,161.44331137113556,0.08646279541868496,0.7159547852093198,0.6294919897906348,4766343818,4663436262.8,84.145616526091,74.95544038390743,NaN,NaN,41.48544981566648,32.975999601555365
2011-01-14T09:30:00-05:00,56.59,57.02,56.46001,57,43867392,43721918.4,79.65604782611152,69.37767759437642,NaN,NaN,154.01729248509994,158.40343267593636,0.10525579888321368,0.7610617383946519,0.6558059395114382,4810211210,4714534720.4,87.18564324903762,75.77602761270087,NaN,NaN,44.27308085180643,34.58986835159123
2011-01-18T09:30:00-05:00,56.52,57.23,56.49001,57.16,65803008,45169591.2,80.64854564115697,70.66831312790072,NaN,NaN,143.15893212159943,154.13546454728666,0.11574917511201777,0.8004924084014604,0.6847432332894426,4876014218,4767683427.6,89.45131059457523,76.82337359833436,NaN,NaN,46.90947040257389,36.34981150173161
2011-01-19T09:30:00-05:00,57.24001,57.25999,56.32001,56.50999,67767184,46149970.4,66.46265364016398,70.84495632484162,NaN,NaN,105.36058781424985,143.35929842296449,0.06853366400589167,0.7704103132968072,0.7018766492909155,4808247034,4795945942.8,90.42118177348495,78.05509572693471,NaN,NaN,44.70648770580107,37.543622388027245
2011-01-20T09:30:00-05:00,56.3,56.35001,55.67999,56.11,92357744,48979090.4,59.524131824241394,70.71845890799528,NaN,NaN,40.787852988146554,119.05439183887329,0.003421945661768566,0.7061540813681262,0.7027321357063576,4715889290,4795341114,90.22998842143213,79.35777562021089,NaN,NaN,40.463506502295935,37.96074869006563
2011-01-21T09:30:00-05:00,56.39,56.49001,55.64999,55.67999,59673280,50174432.8,53.10549442453991,70.41902801300843,NaN,NaN,26.848118627765494,94.03455680737225,-0.07141711037852638,0.6134607477331997,0.6848778581117261,4656216010,4773315552.4,83.32067931985537,80.32715988877048,NaN,NaN,34.623605828312684,37.484013995529494
2011-01-24T09:30:00-05:00,55.78999,56.46001,55.67999,56.45,64103248,52296183.2,61.178335730902134,69.99503209611227,NaN,NaN,46.91868197762566,72.61483470587741,-0.07168463927840796,0.5952720590137162,0.6669566982921241,4720319258,4755337162,78.06591010199965,80.87349239426091,NaN,NaN,32.35783249170801,36.75170235212642
2011-01-25T09:30:00-05:00,56.17999,56.55,56.05,56.5325,55305024,53598263.2,61.93443531189413,69.68706301154336,NaN,NaN,60.25821767197834,56.034691815953195,-0.06891005360828228,0.5808191312817712,0.6497291848900535,4775624282,4735259174.8,72.56208472690875,81.0163291831802,NaN,NaN,30.895416906561568,35.91509014561716
2011-01-26T09:30:00-05:00,56.63,56.98,56.45,56.83,60547616,55417213.6,64.6110750571375,69.26116334591556,NaN,NaN,95.04352579396537,53.971279411896305,-0.050496320154801766,0.5866087846965513,0.6371051048513531,4836171898,4740844147.6,73.12958127718264,81.14750893317088,NaN,NaN,30.604249365568432,35.15639860561019
2011-01-27T09:30:00-05:00,57.00999,57.35001,56.92,57.17999,53656080,56893383.2,67.50585839080978,68.93753310120475,NaN,NaN,129.3532779848104,71.68436441122908,-0.019780669684464125,0.6123792677457729,0.632159937430237,4889827978,4775631885.2,76.40337831561925,81.31573224959756,NaN,NaN,31.335699859863265,34.61058449907492
2011-01-28T09:30:00-05:00,57.16,57.22,55.47,55.73,123359808,61683265.6,49.45636729025951,67.40006395731498,NaN,NaN,3.231748457619174,66.96109037719982,-0.09779001547964217,0.5099224180806843,0.6077124335603264,4766468170,4797682317.2,78.21516549648166,81.49533927960444,NaN,NaN,24.81091972739823,33.21063238883539
2011-01-31T09:30:00-05:00,55.81,56.16,55.39,56,70570560,63283497.6,52.02848237279826,65.91745662389307,NaN,NaN,-52.34103587720808,47.10914680623305,-0.1298680769540197,0.44537733736780183,0.5752454143218215,4837038730,4821026211.6,79.96867424658649,81.74789440622257,NaN,NaN,20.8604457307972,31.446320009115652
2011-02-01T09:30:00-05:00,56.4194,57.17999,56.36,57.05,76952816,62581422.4,60.456241376104195,64.98848576427963,NaN,NaN,93.76411302103935,53.81032587604525,-0.08140194086922858,0.47349298823528585,0.5548949291045144,4913991546,4848699664.4,81.83529754930801,81.92248954330766,NaN,NaN,20.820515344637695,29.92834791419023
2011-02-02T09:30:00-05:00,56.92,57.17,56.84,56.955,48660944,62821896.8,59.4387809336774,63.76544411001157,NaN,NaN,103.25877280604635,55.45337527846144,-0.0578786306768857,0.48254664075840736,0.5404252714352931,4865330602,4854531405.2,82.21148663486333,81.93899987381619,NaN,NaN,20.420013553912906,28.57001443415061
2011-02-03T09:30:00-05:00,56.85001,57.14,56.39999,57.0575,45341872,62899632,60.21674870642711,62.587371323301674,NaN,NaN,75.89720493237931,44.76216066797522,-0.03848622561085069,0.4923174894217297,0.5308037150325804,4910672474,4858700304.4,82.4906483340901,81.82078786010183,NaN,NaN,20.379237237034754,27.399903405991203
2011-02-04T09:30:00-05:00,57.05,57.42,56.89999,57.375,47647712,62975040.8,62.6090799221547,61.369730758733326,NaN,NaN,123.00444811678658,68.71670059980872,-0.008891058153123077,0.5196898923411766,0.5285809504942997,4958320186,4897070707.6,84.84763090579327,81.65378697844152,NaN,NaN,21.13902673219237,26.50549245259137
2011-02-07T09:30:00-05:00,57.49001,57.97,57.39999,57.64999,45626800,61643299.2,64.59492085537097,60.22304327403435,NaN,NaN,174.10211334882973,114.00533044501626,0.02285495116065195,0.5571496394451145,0.5342946882844626,5003946986,4930452358.8,86.54461777033461,81.44616606242434,NaN,NaN,22.3985966554502,25.918793052999774
2011-02-08T09:30:00-05:00,57.64999,58.07001,57.56,58.02499,38099824,60770702.4,67.15660401363354,60.27261115785361,NaN,NaN,182.16675994938484,131.68585983068536,0.06061520171667689,0.6100636904303087,0.5494484887136318,5042046810,4956063411.6,87.68424611254746,81.25067065807164,NaN,NaN,24.27405297837423,25.683830185196125
2011-02-09T09:30:00-05:00,57.94,58.12,57.75,57.92999,62540768,61064552,65.85662501911457,60.72493210034455,NaN,NaN,165.68183832094493,144.17047293366508,0.07003315113791286,0.6369899276360229,0.56695677649811,4979506042,4978898499.6,88.61050346904698,81.13499316147272,NaN,NaN,25.385477045397053,25.64120830808197
2011-02-10T09:30:00-05:00,57.61,58.10001,57.49001,58.021,70194688,61975337.6,66.52514818921894,61.68347879782163,NaN,NaN,136.9420188532058,156.37943571783038,0.07290409474742854,0.6580868949323957,0.5851828001849672,5049700730,5006704150.8,89.63295068660264,81.58586968766895,NaN,NaN,26.48670565585051,25.761993643477478
2011-02-11T09:30:00-05:00,57.87,58.48,57.77,58.44,47853472,61996492,69.48725607554857,62.27697310815352,NaN,NaN,155.30109895824862,162.8387658861228,0.09228639471936595,0.7005407935841745,0.6082543988648086,5097554202,5034550954,90.5480817278447,82.47745337522929,NaN,NaN,28.33622202063948,26.12974055450062
2011-02-14T09:30:00-05:00,58.42999,58.66,58.38,58.58,48506032,62228424,70.42881947436678,62.883714834044426,NaN,NaN,158.5037060819818,159.7190844327532,0.10298617322256387,0.7369871153930134,0.6340009421704496,5146060234,5062973603.6,91.38407701582418,83.82188139586613,NaN,NaN,30.14238218801406,26.70297507357397
2011-02-15T09:30:00-05:00,58.44,58.57001,58.23,58.5,39723760,60924461.6,69.11633065647122,63.2055188054254,NaN,NaN,125.04816899913948,148.29536624270412,0.09340840304724551,0.7507614459795064,0.6573530429322609,5106336474,5075831536.4,91.73999933932411,85.15119697173336,NaN,NaN,31.27761943280166,27.356495696320785
2011-02-16T09:30:00-05:00,58.64,59.03999,58.63,58.881,53061312,60189168,71.81065491533688,63.513004271463046,NaN,NaN,139.52377383908419,143.063753346332,0.10083018711555669,0.7833907768267068,0.6825605897111501,5159397786,5111809885.2,92.65439798421939,86.31198409091907,NaN,NaN,33.058232060037625,28.171029462566047
2011-02-17T09:30:00-05:00,58.60001,58.97501,58.55,58.86,38361840,57489372.8,71.44070265324876,65.08331394024799,NaN,NaN,118.43901683205692,139.3631529421022,0.09263338701591806,0.7983523234810477,0.7057189364651296,5121035946,5126076928.4,92.98598652927716,87.36704273611875,NaN,NaN,34.42195159419005,29.064018338512334
2011-02-18T09:30:00-05:00,58.88,58.97,58.50999,58.73,44341728,56722795.2,69.0685328593602,66.30046040357385,NaN,NaN,102.31194454269168,128.76532205899082,0.0679095951649138,0.7906059304212718,0.722696335256358,5076694218,5121904931.6,91.68265772780187,88.20375584191986,NaN,NaN,34.953467360540905,29.90536819880213
2011-02-22T09:30:00-05:00,58,58.13,56.94,57.03,92596880,58147476.8,47.06168713585742,65.34370652927052,NaN,NaN,-13.891115594902455,94.28635772361397,-0.06622544480966275,0.6399145292442796,0.7061399740539424,4984097338,5089512352.4,82.06477418129325,88.2201470299188,NaN,NaN,27.759337676309226,29.598792409874573
2011-02-23T09:30:00-05:00,57,57.23,56.13,56.56,97842880,60274369.6,42.983964716206906,64.16836251373691,NaN,NaN,-79.46430016993786,53.3838638897985,-0.18325908733638885,0.4770661148834563,0.6603252022198451,4886254458,5045495949.2,71.14332685486191,87.42956418849012,NaN,NaN,20.423959573737662,28.288102004712158
2011-02-24T09:30:00-05:00,56.7,57.03,56.14,56.855,98715936,62182785.6,46.13851415340118,63.16277433137792,NaN,NaN,-75.6351190758566,10.352085306810343,-0.23420061097169798,0.36757443850522264,0.6017750494769206,4984970394,5010610470.8,63.886491494231265,86.10069584278592,NaN,NaN,15.618469247981325,26.478154468036326
2011-02-25T09:30:00-05:00,57.16,57.72,57.12,57.64999,54094576,62204710.4,53.59049297283546,62.518589549283675,NaN,NaN,-5.086814807886231,-14.353081021178292,-0.20860445175863473,0.3410194847786272,0.5496239365372619,5039064970,4994216275.6,60.75037514681644,84.37946328857326,NaN,NaN,14.060409792378408,24.704190942942336
2011-02-28T09:30:00-05:00,57.87,58.05,57.42999,57.76891,51402736,58606856.8,54.60231677190829,61.80483211475063,NaN,NaN,11.488805676897316,-32.517708794337175,-0.17904750491443588,0.3258145553942171,0.504862060308653,5090467706,4996970973.2,61.09595340943423,82.56170154850896,NaN,NaN,13.190414078045748,23.05936567652854
2011-03-01T09:30:00-05:00,57.99001,58.02,56.69501,56.84,91992496,59677953.6,46.14017012132876,60.303658265300285,NaN,NaN,-57.09442776552656,-41.15837122846199,-0.21501941430714144,0.23608779242472622,0.45110720673186766,4998475210,4999846547.6,61.47725054633566,80.68977329377954,NaN,NaN,9.425248349520496,21.111634629813103
2011-03-02T09:30:00-05:00,56.82001,57.511,56.78999,57.14,61552880,58907956.8,48.89482175986064,59.0921008896393,NaN,NaN,-64.39248235469967,-38.14400766541436,-0.21126159637176878,0.1870302112671567,0.39829180763892547,5060028090,5034601274,65.8355507392739,79.06299095593862,NaN,NaN,7.373536942979343,19.149049245979707
2011-03-03T09:30:00-05:00,57.67999,58.36501,57.67,58.265,64249920,59687405.6,57.64342119987365,58.45769181897178,NaN,NaN,38.76191962288659,-15.26459992566572,-0.12966786550402853,0.23620697575888983,0.36587484126291836,5124278010,5062462797.2,68.87557383289806,77.58032118067399,NaN,NaN,8.748711274619577,17.663286678642546
2011-03-04T09:30:00-05:00,58.25,58.25999,57.59,57.9675,62328320,60536728,54.963822933892565,57.42030373742492,NaN,NaN,14.635267113894729,-11.320183541309527,-0.09405045802785394,0.2483117687281009,0.34236222675595485,5061949690,5067039741.2,69.35793891147848,76.06673955093355,NaN,NaN,8.890797790297668,16.410073980307562
2011-03-07T09:30:00-05:00,58.21001,58.2599,56.67,57.19,98469936,63077839.2,48.6047116997156,55.86143889637841,NaN,NaN,-58.992172795273184,-25.41637923574362,-0.11953536131317921,0.1929430251144808,0.31247838642766,4963479754,5041642150.8,63.47891037016248,74.07351336195772,NaN,NaN,6.759459782303234,15.031414809164087
2011-03-08T09:30:00-05:00,57.10001,57.67999,56.77,57.42,62399104,63916454.4,50.43169947227263,54.52682238322137,NaN,NaN,-64.62466929757875,-26.92242754215406,-0.11741330692907176,0.16571175276632033,0.2831250596953921,5025878858,5047122880.4,64.18443430125971,72.1052587163817,NaN,NaN,5.708063783585723,13.699507519795748
2011-03-09T09:30:00-05:00,57.21001,57.27,56.72,57.03,84764128,66249669.6,47.3575630615621,52.7801729650946,NaN,NaN,-88.27298160231037,-31.698527391676198,-0.13739833080094166,0.11137714619421502,0.24877547699515667,4941114730,5023340208.4,58.869865651959174,69.69207783550597,NaN,NaN,3.845311201770285,12.291765188649254
2011-03-10T09:30:00-05:00,56.39,56.52,55.91,56.14,102991504,68272206.4,41.18743273938443,50.61922511410428,NaN,NaN,-154.3905018503015,-70.3290116863138,-0.20178766838344603,-0.0034591084841508746,0.19832855989929515,4838123226,4966109251.6,48.469238186798705,66.51231009675752,NaN,NaN,0.10535060525467875,10.550848819592886
2011-03-11T09:30:00-05:00,55.83,56.66,55.82001,56.49001,81679376,68846440.8,44.262989801246746,48.84740060995332,NaN,NaN,-122.89890610502204,-97.83584633009716,-0.21103891784661655,-0.06547008740897553,0.14556883043764102,4919802602,4937679834,44.283869699418716,63.12668238044443,NaN,NaN,-1.8835208051849521,8.774510301767481
2011-03-14T09:30:00-04:00,56.17999,56.59,55.86,56.28999,73621744,70134854.4,42.8828750435085,48.5489140319284,NaN,NaN,-117.90851010353423,-109.61911379174937,-0.219866345342116,-0.12926410124000398,0.09060224410211201,4846180858,4914220054.8,41.1278199756107,60.20261422289567,NaN,NaN,-3.907448772405157,6.962801862599962
2011-03-15T09:30:00-04:00,54.64,55.82001,54.47,55.49001,101275312,72773318.4,37.8057000893375,48.179037987152014,NaN,NaN,-186.43566868401248,-133.98131366903613,-0.265752306811746,-0.2415881394125705,0.0241641673991755,4744905546,4858025392.4,34.74085412783187,57.60243759953638,NaN,NaN,-7.343247592590144,4.919080511858518
2011-03-16T09:30:00-04:00,55.03,55.34,53.77,54.14999,176506624,79612461.6,31.152280490206067,47.108592725495214,NaN,NaN,-217.00654721494502,-159.72802679156305,-0.36631880941476797,-0.4337343443692845,-0.0674155349545165,4568398922,4783482230.8,28.43303122708774,55.07004758045469,NaN,NaN,-12.86218633691674,2.3788995334620533
2011-03-17T09:30:00-04:00,55.00999,55.24001,54.12939,54.64999,94434320,81681112,35.69949478004796,45.83066428315325,NaN,NaN,-166.90393576148938,-162.23071357380064,-0.37762546117425316,-0.539447361422333,-0.1618219002480798,4662833242,4748424234,26.038507932962546,52.590628493750835,NaN,NaN,-15.697399072628407,-0.20342883883658391
2011-03-18T09:30:00-04:00,55.2,55.22,54.41,54.45,94887120,84507376,34.71194771188506,44.409923636008735,NaN,NaN,-143.99483390002442,-166.4498991328011,-0.3762040959910213,-0.6320770202368564,-0.25587292424583513,4567946122,4678052938,22.02827554487868,49.800080074854016,NaN,NaN,-18.239413500045004,-2.7799980761520726
2011-03-21T09:30:00-04:00,55.28999,55.78,54.49561,55.5,57419952,85161287.2,43.54241582698643,44.22436975784142,NaN,NaN,-92.21799502482354,-161.31179611705895,-0.2862506798538905,-0.6136862740631983,-0.3274355942093078,4625366074,4633889981.2,19.951557543817785,46.833959146102735,NaN,NaN,-17.433435189398768,-4.873346235187315
2011-03-22T09:30:00-04:00,55.57001,55.61,55.28,55.395,36251280,82344007.2,42.91729064396393,43.79740324956308,NaN,NaN,-71.2834164344128,-138.28134566713902,-0.21857957455204452,-0.6006600623993634,-0.3820804878473189,4589114794,4602731830.8,18.617952712672476,43.46127357277407,NaN,NaN,-17.00570339238691,-6.606540114787257
2011-03-23T09:30:00-04:00,55.19,55.87,54.82001,55.71001,60365088,80470117.6,45.44768039896775,42.92627890664123,NaN,NaN,-61.95576844838579,-107.27118991382717,-0.14111977711821122,-0.5584802092450829,-0.4173604321268717,4649479882,4618948022.8,21.556738228639503,40.081356743898446,NaN,NaN,-15.86548129613233,-7.929245997836553
2011-03-24T09:30:00-04:00,56.12,56.82001,55.82001,56.7,69502320,79009436.8,52.56437914093995,42.75489006428747,NaN,NaN,4.178375312515778,-73.05472769902615,-0.018187900430960635,-0.4400953076655725,-0.42190740723461184,4718982202,4630177814.8,23.61386628026409,36.813922984525995,NaN,NaN,-12.50201118203999,-8.582498167008472
2011-03-25T09:30:00-04:00,56.89,57.22,56.7299,56.84,74133872,80011401.6,53.48845586114933,43.10372893296131,NaN,NaN,39.81771830761167,-36.29221725749893,0.07259778031626529,-0.3311601818392802,-0.4037579621555455,4793116074,4675211805.2,31.384899866605863,34.521493662843376,NaN,NaN,-9.541632505115246,-8.719517358166582
2011-03-28T09:30:00-04:00,57.09,57.10001,56.5,56.53,37823728,79332451.2,51.11401280301788,43.15246559944312,NaN,NaN,29.706070917427404,-11.907404069048749,0.10959229907828127,-0.26676758830769387,-0.37635988738597514,4755292346,4701197059.6,35.46464635187748,32.47008023788751,NaN,NaN,-7.803917461827028,-8.588717372975218
2011-03-29T09:30:00-04:00,56.39999,57.08,56.23,57.08,47994656,77132559.2,54.93622624463,43.69379868394797,NaN,NaN,38.208604345496674,9.991000086933159,0.16556565367724962,-0.16940282028941311,-0.33496847396666274,4803287002,4744031501.2,41.62609768587111,31.238382526024076,NaN,NaN,-5.142283892148728,-8.096369732857148
2011-03-30T09:30:00-04:00,57.36,57.42999,57.08,57.35001,44935856,76301708,56.725055575607584,44.80362888653532,NaN,NaN,73.75659640030266,37.133473056670844,0.2122546938504808,-0.06965010665356175,-0.28190480050404254,4848222858,4783780096.4,46.710504531517145,31.112758693503963,NaN,NaN,-2.4036887351285534,-7.283129590324492
2011-03-31T09:30:00-04:00,57.25,57.48,57.14999,57.42999,50143328,75596378.4,57.266182661735876,45.73242837657027,NaN,NaN,84.63037726279825,53.22387344672734,0.23806594693559618,0.015677633165452676,-0.2223883137701435,4898366186,4819656893.2,50.87003740638811,31.58319924400178,NaN,NaN,-0.011874067305886254,-6.244378801321834
2011-04-01T09:30:00-04:00,57.72,57.89999,57.28999,57.46001,68031744,75881549.6,57.48109374344858,46.77515828370885,NaN,NaN,103.22979442515891,65.90628867023679,0.24570740807284666,0.08474594632091481,-0.16096146175193185,4966397930,4854313264.4,54.559791138480186,32.54262575563532,NaN,NaN,2.017690070457642,-5.06408324821048
2011-04-04T09:30:00-04:00,57.62,57.67999,57.02,57.27,48659040,73391004.8,55.57596390951549,48.04446284229299,NaN,NaN,85.83200814188314,77.13147611512792,0.22695800015051806,0.12273603843621572,-0.10422196171430234,4917738890,4886802573.2,57.76232013123658,34.187016184449945,NaN,NaN,3.2518296026447886,-3.8760956980882986
2011-04-05T09:30:00-04:00,57.16,57.49001,57,57.12,55384928,73040296,54.05290030233977,49.68022140030253,NaN,NaN,77.04515318470652,84.8987858829699,0.19468624326107184,0.13913584236203747,-0.055550400899034375,4862353962,4898615965.2,58.89667396667392,36.362990665848955,NaN,NaN,3.9126053024778793,-2.763424126578845
2011-04-06T09:30:00-04:00,57.53999,57.73,56.92999,57.25999,49532048,71278692,55.284527578664836,51.079152314489455,NaN,NaN,82.84616815202227,86.71670023331383,0.1736934338342772,0.16156639139381213,-0.012127042440465072,4911886010,4911348595.6,60.13924773458336,38.79875779453615,NaN,NaN,4.795711636801709,-1.6835475889530516
2011-04-07T09:30:00-04:00,57.23,57.60001,56.81,57.22,60705856,69164409.6,54.83236228338315,52.51632478388217,NaN,NaN,68.52812538105573,83.49624985696532,0.14898874232249296,0.17410888546265113,0.025120143140158174,4851180154,4901911389.2,58.72228583743832,41.41975852971898,NaN,NaN,5.435180540208903,-0.6665864276442008
2011-04-08T09:30:00-04:00,57.48,57.57001,56.64999,56.95,42782112,67219546.4,51.75456956533105,53.10290719376393,NaN,NaN,52.57713656183854,73.36571828430127,0.1082342994467741,0.1604130174486258,0.0521787180018517,4808398042,4870311411.6,54.12378426286145,43.86063186679353,NaN,NaN,5.231004069991545,0.17592650058947712
2011-04-11T09:30:00-04:00,57.16,57.28999,56.56,56.75999,42451616,65661040,49.64275554643089,53.58329754394015,NaN,NaN,36.266412811179634,63.45259921816055,0.0644146856573653,0.13269707507355832,0.06828238941619302,4765946426,4839952918.8,50.067335614637535,46.10701635979104,NaN,NaN,4.517359663624833,0.7961312381659565
2011-04-12T09:30:00-04:00,56.52,56.64,56.14999,56.37,50642848,63129416.8,45.535785835423056,53.58959078940124,NaN,NaN,-2.4669822828796035,47.55017212464332,0.008061908176174276,0.07835977463641086,0.07029786646023659,4715303578,4810542842,46.436411946361616,47.8841359110569,NaN,NaN,2.7840995823051147,1.080126715900122
2011-04-13T09:30:00-04:00,56.77,57,56.39999,56.85001,49979728,56803072,50.9180937409151,53.47199897511375,NaN,NaN,19.39144965882233,34.85922842600333,0.0023106850166928483,0.07318622273110265,0.0708755377144098,4765283306,4781222301.2,43.081981370016884,49.274715560324964,NaN,NaN,2.670441364855833,1.307314522893795
2011-04-14T09:30:00-04:00,56.45,56.83,56.23,56.75,53544096,54758560.8,49.813550754587084,53.20950575321644,NaN,NaN,-3.0606469097976494,20.541473967832648,-0.008443763473555688,0.06032083337246519,0.06876459684602088,4711739210,4753334112.4,40.11382201959796,49.8982099998244,NaN,NaN,2.278103714456126,1.445998693116985
2011-04-15T09:30:00-04:00,56.53,56.87,56.28,56.64999,68529936,53440701.6,48.6764113172315,53.03539136137456,NaN,NaN,-17.20679883201225,6.584686889062492,-0.021751125666859744,0.04157568976244619,0.06332681542930593,4643209274,4720296358.8,36.872864729252385,49.99879702677975,NaN,NaN,1.6454871217858393,1.4744970400696784
2011-04-18T09:30:00-04:00,56.09,56.27,55.32001,56.25,69073440,54023376,44.318835497431174,52.277006308003216,NaN,NaN,-120.33365793473128,-24.735327260119693,-0.05505545837235644,-0.0054925075361396125,0.049562950836216826,4574135834,4681934240.4,33.489387739274235,49.41760345916568,NaN,NaN,-0.1217124520238765,1.246467112627742
2011-04-19T09:30:00-04:00,56.39,56.60001,56.10001,56.60001,38608384,54141231.2,48.650719005069874,51.700267981536236,NaN,NaN,-63.42286179978398,-36.92650316350056,-0.051158906246529114,-0.014385681971944564,0.03677322427458455,4612744218,4661422368.4,31.80869031397029,48.353188157912335,NaN,NaN,-0.48696209165665516,0.9988343691585424
2011-04-20T09:30:00-04:00,57.59,57.94,56.6051,57.875,67397440,54492848.8,60.65781420554068,51.942527377522296,NaN,NaN,104.71521352284067,-19.861750390696898,0.03499684026326572,0.0805192746036667,0.04552243434040098,4680141658,4644394038.8,30.442792385625765,46.894099227857886,NaN,NaN,3.147868837121571,1.3058392931532607
2011-04-21T09:30:00-04:00,58.47,58.47,58.16,58.34,43666768,53201071.2,63.967095716741845,52.40581323275753,NaN,NaN,217.97501945466294,24.34538288219522,0.11642319519609506,0.1910514283355198,0.07462823313942474,4723808426,4646807882,30.895792840539244,45.20381363514782,NaN,NaN,7.3019272155949615,2.1624232820735036
2011-04-25T09:30:00-04:00,58.39999,58.52,58.28,58.49001,25376720,50763213.6,64.99019289615106,53.078258160374375,NaN,NaN,193.31410223808194,66.44956309621406,0.17024947709799965,0.2874400795119243,0.11719060241392465,4749185146,4668003056.4,34.9046370087261,43.571121983539925,NaN,NaN,10.943604267955815,3.4168777086281192
2011-04-26T09:30:00-04:00,58.64999,59.03,58.50999,58.82001,49392736,51341664,67.196739213575,54.01710379689117,NaN,NaN,204.7295499485161,131.46220467286352,0.2150534135996816,0.38600736941352665,0.17095395581384504,4798577882,4712891466,42.511066525795464,42.40072145204861,NaN,NaN,14.683605974555352,5.026410318046295
2011-04-27T09:30:00-04:00,58.89999,59.28999,58.66,59.22,56465488,51765205.6,69.6903259197448,55.046089392682596,NaN,NaN,197.90871010285096,183.72851905339053,0.2558300704701408,0.490741543901521,0.23491147343138025,4855043370,4761351296.4,49.38691024683584,41.63269734578092,NaN,NaN,18.64448798468944,6.971849984709602
2011-04-28T09:30:00-04:00,59.06,59.23,58.88,59.13,48138336,51925329.6,68.42985982897339,56.01733921736762,NaN,NaN,161.45609223855266,195.07669479653293,0.2600918211820225,0.5600262499089084,0.29993442872688586,4806905034,4786703971.6,52.58219645286062,41.1941195325968,NaN,NaN,21.46580875024789,9.042415522643642
2011-04-29T09:30:00-04:00,59.03999,59.28999,58.98,59.08,44831152,51659720.8,67.69730150602247,57.15610578455986,NaN,NaN,136.5046465869697,178.78262022299427,0.24320323279153483,0.6039384697163044,0.36073523692476955,4762073882,4794357062.8,53.53578988756737,41.15211993436151,NaN,NaN,23.55808547832402,11.116082659169411
2011-05-02T09:30:00-04:00,59.19,59.34,58.82001,58.97,48149392,50665603.2,66.02275368395624,58.32610565152596,NaN,NaN,110.78166999094822,162.27613377356755,0.2095599801207968,0.6226852120757655,0.41312523195496875,4713924490,4787304931.6,52.48829369694718,41.32504551166933,NaN,NaN,24.847440041299198,13.077705142330808
2011-05-03T09:30:00-04:00,58.95,59,58.33,58.69,38143408,50139821.6,61.83021585956562,59.489993510393276,NaN,NaN,73.55159440603008,136.04054266507032,0.15585223093549078,0.6079405206243322,0.45208828968884146,4675781082,4762745571.6,48.89991948735189,41.50101033602578,NaN,NaN,24.8006498204248,14.752411524915663
2011-05-04T09:30:00-04:00,58.72,58.87,58.11,58.60001,53105008,50025825.6,60.5004868941507,60.174450164195825,NaN,NaN,56.86166818966433,107.831134282433,0.10415466855091904,0.5822816253774903,0.47812695682657125,4622676074,4716272112.4,42.92033492283426,41.48946416122702,NaN,NaN,24.398926412305748,16.130485080257102
2011-05-05T09:30:00-04:00,58.32001,58.97,58.08,58.28,72153312,51156888.8,55.89682433783994,60.60896970585674,NaN,NaN,46.506699487234016,84.84125573216927,0.0415103953663391,0.5300149510344951,0.48850455566815604,4550522762,4664995658,37.475245399142736,41.300994402623076,NaN,NaN,22.755794037832374,17.07695778848214
2011-05-06T09:30:00-04:00,58.86,59.2,58.31,58.47,72506752,51746933.6,57.94306615123123,61.27087362257101,NaN,NaN,55.375735667614606,68.61547354829824,0.007741888376348316,0.4981819161385914,0.4904400277622431,4623029514,4637186784.4,34.89004870508133,41.15936468661086,NaN,NaN,21.89763647508841,17.765626172283035
2011-05-09T09:30:00-04:00,58.56,58.92,58.34,58.69,40028976,51609276.8,60.24319583442552,62.40832793235632,NaN,NaN,50.098095041785236,56.47875855846566,-0.004260762258300188,0.48511407493936787,0.48937483719766806,4663058490,4627013584.4,33.966916095257275,41.193473854895366,NaN,NaN,21.78030815668383,18.33915217005458
2011-05-10T09:30:00-04:00,58.87,59.28,58.77499,59.19,38053600,51389376,64.93672194105594,63.57161385635532,NaN,NaN,73.14195897482797,56.396831472225244,0.01588685998357653,0.5092334121771387,0.49334655219356216,4701112090,4632079786,34.8907937987063,41.413624103805084,NaN,NaN,23.038828354667338,19.010534482142116
2011-05-11T09:30:00-04:00,59.10001,59.31,58.36,58.755,61908944,51952680.8,58.46945545676277,63.41530251715691,NaN,NaN,51.01052683364258,55.22660320102089,-0.004576246277120333,0.48762624434716173,0.49220249062428206,4639203146,4635385200.4,35.52462687699544,41.77661228176005,NaN,NaN,22.188061113881385,19.46446685810487
2011-05-12T09:30:00-04:00,58.56,59.19,58.24001,59.11,66128192,52760104,61.81202749498334,63.26136907274559,NaN,NaN,50.891391147920615,56.10354153315821,0.0010057240480856877,0.49345964568438916,0.49245392163630347,4705331338,4666346915.6,41.29001137526332,42.519056462811776,NaN,NaN,22.472811030728685,19.894230311336845
2011-05-13T09:30:00-04:00,58.98,59.07001,58.39,58.41,63506560,53258227.2,52.78973322500631,62.38990766766381,NaN,NaN,28.43193744474386,50.714781888584056,-0.04471029988404135,0.43656604678125177,0.4812763466652931,4641824778,4670105968.4,41.968490325892574,43.02361741403796,NaN,NaN,19.747893004696206,19.873324981816754
2011-05-16T09:30:00-04:00,58.16,58.32001,57.27,57.399,73140256,53488743.2,43.0223921727829,60.66316859332153,NaN,NaN,-79.02257604652745,24.89064767092152,-0.13992779292259167,0.3063666055120535,0.4462943984346452,4568684522,4651231174.8,39.500114922571875,42.808549442379125,NaN,NaN,13.657677682769915,18.985375367667206
2011-05-17T09:30:00-04:00,57.12,57.57001,56.98,57.56,63176064,53193874.4,44.77475464154618,58.88348493059305,NaN,NaN,-143.30747095783593,-18.39923831561126,-0.1860671637308371,0.21371044377109882,0.3997776075019359,4631860586,4637380874,37.745759015869616,41.97703864016726,NaN,NaN,9.538601265119619,17.63583621016041
2011-05-18T09:30:00-04:00,57.48,58.14,57.41,58.03999,42351088,53381009.6,49.737841373091854,57.548340755172944,NaN,NaN,-107.3423962782245,-50.069822937984675,-0.17824533498204342,0.17697093877438164,0.35521627375642506,4674211674,4644382579.6,39.21550235292898,41.02227477588643,NaN,NaN,7.794793603374009,16.229972980619493
2011-05-19T09:30:00-04:00,58.23,58.34,57.85001,58.21001,35024240,51762349.6,51.403817859637705,56.38452049471688,NaN,NaN,-76.3037683923756,-75.50885484604392,-0.1563870090208347,0.15973251248038167,0.31611952150121636,4709235914,4645163494.8,39.387380366304356,40.01167409579621,NaN,NaN,6.952132559193104,14.90456720613001
2011-05-20T09:30:00-04:00,58.14999,58.21001,57.69,57.765,44703168,51814169.6,47.011569184602415,55.02657874476305,NaN,NaN,-108.69704566542995,-102.93465146807868,-0.1657700682554622,0.10890693618188863,0.2746770044373508,4664532746,4649705088.4,40.44214513967011,39.151234913133564,NaN,NaN,4.808168740039693,13.462224568117106
2011-05-23T09:30:00-04:00,56.99001,57.14999,56.64999,56.92,43678432,52729255.2,40.019101058654755,53.46864197326941,NaN,NaN,-208.9482954042184,-128.91979533961688,-0.2193913508478206,0.00043781587757507623,0.21982916672539568,4620854314,4660139046.8,42.90053153091918,38.7227072019598,NaN,NaN,0.46038631138485536,11.604819102869643
2011-05-24T09:30:00-04:00,57.07001,57.07001,56.56,56.57001,39314208,52225328.8,37.529218415130956,51.82783708191086,NaN,NaN,-182.0553966364791,-136.6693804753455,-0.26583895953226505,-0.11246953268993565,0.1533694268423294,4581540106,4650074950.8,41.136724156907334,38.595306432965025,NaN,NaN,-3.8946945166813998,9.390602871505209
2011-05-25T09:30:00-04:00,56.49001,57.06,56.47,56.78999,41368976,51470503.2,40.053777924686166,50.69619090954273,NaN,NaN,-148.07071886088332,-144.81504499187727,-0.2683753333814915,-0.18209973988453498,0.08627559349695653,4622909082,4639814432.4,39.359989119807246,38.72993098444106,NaN,NaN,-6.565664101677631,7.111136161050517
2011-05-26T09:30:00-04:00,56.62,57.3,56.61,57.14149,40564080,51091790.4,43.951404453002894,49.69678650252642,NaN,NaN,-108.25760561333723,-151.2058124360696,-0.2342510542128362,-0.20653822426908874,0.027712829943747477,4663473162,4630661882,37.79197468602673,38.93721141165145,NaN,NaN,-7.5370710042566635,5.018535137435206
2011-05-27T09:30:00-04:00,57.24001,57.49001,57.19,57.42999,30132080,50356836.8,46.997476180628276,48.750663670112324,NaN,NaN,-66.07646397972809,-142.68169609892922,-0.18242404635300513,-0.20031722799750895,-0.017893181644503806,4693605242,4636476381.2,39.4424841071239,39.32832341249907,NaN,NaN,-7.384304556792714,3.246700895402646
2011-05-31T09:30:00-04:00,57.97,58.36,57.67,58.36,47588064,50328770.4,55.41021251564576,48.070198711154454,NaN,NaN,12.527124339681208,-98.38661215014929,-0.08086271768257733,-0.11897157874772546,-0.03810886106514814,4741193306,4660544179.6,45.84721810213796,40.11092514845847,NaN,NaN,-4.380120415912606,2.1571549937861816
2011-06-01T09:30:00-04:00,58.22,58.36,57.03999,57.09,51792336,51011216.8,44.92397499114577,47.10266439218181,NaN,NaN,-47.06624671288188,-71.38878216542986,-0.09366808899806586,-0.15519397231273047,-0.0615258833146646,4689400970,4682116352.4,50.86347419801967,41.2065570999602,NaN,NaN,-5.510811181123022,1.0617312545134383
2011-06-02T09:30:00-04:00,57.21001,57.41,56.89,57.21001,50198048,50865868.8,45.964629115470395,45.97070736507374,NaN,NaN,-73.52336267096864,-56.47931092744693,-0.08856433408420868,-0.17223130091992545,-0.08366696683571677,4739599018,4705454339.6,55.64986410292783,42.23226086622195,NaN,NaN,-6.007541488495784,0.05183514836926384
2011-06-03T09:30:00-04:00,56.56,56.99001,56.27,56.35001,57773680,50146887.2,40.11514123208292,45.065379365579226,NaN,NaN,-122.0597502978202,-59.23973986434353,-0.1348431257592193,-0.2522208740347409,-0.1173777482755216,4681825338,4709124774.8,56.369695391039734,43.26091837087531,NaN,NaN,-8.510735389355736,-1.171389214162879
2011-06-06T09:30:00-04:00,56.24001,56.53,55.86,55.89,50175536,49030326.4,37.375259556689244,44.66201275014396,NaN,NaN,-146.67914287627227,-75.36027564365236,-0.1850677293491126,-0.34871240996191233,-0.16364468061279974,4631649802,4696733686.8,53.228762224168555,44.241536035275075,NaN,NaN,-11.470397982273253,-2.6426761810357897
2011-06-07T09:30:00-04:00,56.05,56.25999,55.75,55.78999,46311056,49344430.4,36.78698706635788,44.0914579233448,NaN,NaN,-144.27346456194746,-106.7203934239781,-0.21173646892686251,-0.4283152667713779,-0.21657879784451536,4585338746,4665562774.8,46.24761077090264,44.848811160634575,NaN,NaN,-13.95850133353128,-4.259222631392289
2011-06-08T09:30:00-04:00,55.67,55.77,55.23,55.39,46426384,49763069.6,34.45142253445708,42.999570863442315,NaN,NaN,-168.20715222162085,-130.94857452572586,-0.24090426244751817,-0.517709125903913,-0.2768048634563949,4538912362,4635465053.2,40.697324914619166,44.95465562932674,NaN,NaN,-16.762757439824558,-6.045441889739756
2011-06-09T09:30:00-04:00,55.37,55.75999,55.23,55.485,45307504,48932997.6,35.49885072775545,41.86350178259358,NaN,NaN,-147.0394317136612,-145.65178833426438,-0.23797121567386326,-0.5742688830487239,-0.33629766737486066,4584219866,4604389222.8,35.90589040902874,44.70597777523562,NaN,NaN,-18.69045788706579,-7.851872746500618
2011-06-10T09:30:00-04:00,55.23,55.34,54.59,54.64,53740544,48313615.2,30.786486002245553,40.704567269568095,NaN,NaN,-176.74420052991744,-156.58867838068383,-0.2745179587103256,-0.6794451157627677,-0.4049271570524421,4530479322,4574120019.6,31.95899404412856,44.100038411268365,NaN,NaN,-21.935275032336744,-9.863787358762922
2011-06-13T09:30:00-04:00,54.71001,54.92999,54.45,54.64,37745776,47025576,30.786486002245553,40.04509476553886,NaN,NaN,-166.09066574711576,-160.47098295485256,-0.27934242060543885,-0.7541051828092407,-0.4747627622038018,4530479322,4553885923.6,29.615436304301554,43.15110303793853,NaN,NaN,-24.4934652220028,-11.953741339225761
2011-06-14T09:30:00-04:00,55.05,55.47,55.03,55.34,40565264,45396826.4,38.615291429921236,40.12267140945245,NaN,NaN,-102.79103825377587,-152.17449769321826,-0.21872202242518646,-0.7481652902352849,-0.5294432678100984,4571044586,4551027091.6,29.288644361918628,42.30481162401077,NaN,NaN,-24.32594754781904,-13.7211993690248
2011-06-15T09:30:00-04:00,54.83,55.14999,54.17999,54.28999,59022336,45189140,32.64957958412633,39.59380009941246,NaN,NaN,-134.40886890631995,-145.41484103015804,-0.2314429133959235,-0.8187469095550028,-0.5873039961590794,4512022250,4545649069.2,28.64821760727378,41.53968508740123,NaN,NaN,-26.162080456591248,-15.498468095820007
2011-06-16T09:30:00-04:00,54.33,54.5,53.61501,54.08,66316192,46387395.2,31.59821025884969,38.711429085544374,NaN,NaN,-142.95187484413128,-144.59732965625207,-0.23533023424882327,-0.8814667889701084,-0.6461365547212852,4445706058,4517946307.6,25.549145272224166,40.66519727212962,NaN,NaN,-27.95842469390135,-17.278461895545913
2011-06-17T09:30:00-04:00,54.45,54.59801,53.631,53.78999,70353120,48153839.2,30.154027746692805,37.508325625977555,NaN,NaN,-130.43499265647097,-135.3354880815628,-0.23804738895638233,-0.9436957909167631,-0.7056484019603808,4375352938,4486921030.8,22.60045851081145,39.46219544382159,NaN,NaN,-29.876304343509407,-19.078153673826414
2011-06-20T09:30:00-04:00,53.66,54.23,53.64,54.07001,37402832,47788822.4,33.32284656994929,35.93065662985638,NaN,NaN,-118.18477981197545,-125.75431089453473,-0.20296812739681003,-0.9593585612063933,-0.7563904338095833,4412755770,4463376320.4,20.6524689973093,37.662570507762396,NaN,NaN,-30.50097376458109,-20.709985115362795
2011-06-21T09:30:00-04:00,54.25999,55.28999,54.03,55.23,55892704,48399536,44.54651362429463,35.90369510365273,NaN,NaN,-58.84327998289623,-116.96475924035879,-0.0894174821677568,-0.8681622865192793,-0.7787448043515225,4468648474,4442897098,19.10961084261926,35.39443741094808,NaN,NaN,-27.331997682685593,-21.655986910694622
2011-06-22T09:30:00-04:00,55,55.32001,54.82001,54.83099,36833216,48275486.4,41.93184920019788,35.61563939541897,NaN,NaN,-45.60691066599469,-99.20436759229375,-0.03192294371703741,-0.8186484839978192,-0.7867255402807818,4431815258,4426855699.6,17.976744894647297,32.703500324642334,NaN,NaN,-25.58303091439069,-22.21699319693692
2011-06-23T09:30:00-04:00,54.28,55.37,54.06,55.34,80743312,50244203.2,46.26484216823803,36.05490374800148,NaN,NaN,-45.28325912056151,-79.67064444757979,0.04544322822726854,-0.7299215049966961,-0.7753647332239646,4512558570,4440226202,22.120916190276986,30.257158953159283,NaN,NaN,-22.71464701361837,-22.288086599319982
2011-06-24T09:30:00-04:00,55.07001,55.13,54.27,54.38,56298240,51030911.2,40.175859149453395,36.254946576056064,NaN,NaN,-61.462225059580184,-65.87609092820165,0.03735653185884025,-0.7286690684004142,-0.7660256002592545,4456260330,4456407680.4,26.93241732458108,28.378848603188743,NaN,NaN,-22.232090528503193,-22.28008716063187
2011-06-27T09:30:00-04:00,54.42999,55.53,54.32001,55.245,49968848,52022749.6,46.950752508358654,36.980929821913264,NaN,NaN,-27.449920578755975,-47.72911908155775,0.09251564449010041,-0.6503810446466289,-0.7428966891367293,4506229178,4475102362,32.148046130803394,27.371736843181655,NaN,NaN,-19.469548123534295,-21.878581583903642
2011-06-28T09:30:00-04:00,55.38,56.08,55.28999,56.07001,47028640,51994778.4,52.47845127079115,38.26857473165141,NaN,NaN,45.46115193380834,-26.868232698216804,0.18166154285334057,-0.5158197605700536,-0.6974813034233942,4553257818,4492024230.8,36.56217638880309,27.07636909133765,NaN,NaN,-15.21302730958147,-20.92635954471476
2011-06-29T09:30:00-04:00,56.23,56.41,55.89999,56.3,65417184,52676020.8,53.91994434070226,39.58436713257618,NaN,NaN,93.70346082421315,0.9938415998247649,0.24904969505381547,-0.3861691846061248,-0.6352188796599403,4618675002,4529396179.6,45.06247159581083,27.730410604679232,NaN,NaN,-11.401258721633683,-19.565630855703176
2011-06-30T09:30:00-04:00,56.5,57.09,56.47,57.05,50483920,52690314.4,58.356133092251866,41.5536276390052,NaN,NaN,162.8355613633552,42.617605696608095,0.33188610391428797,-0.22036124976708038,-0.5522473536813683,4669158922,4560716250,50.98949422861417,29.089732046428203,NaN,NaN,-6.687039476159705,-17.725832087196967
2011-07-01T09:30:00-04:00,57.10001,57.985,56.92,57.91,53203808,52461820.8,62.7808486638733,43.8389392576929,NaN,NaN,211.40951197272875,97.19195310306989,0.4263262667891029,-0.019339520194989746,-0.44566578698409265,4722362730,4613936730,59.0701772870012,31.19364211662103,NaN,NaN,-1.1649462949371807,-15.359991259731283
2011-07-05T09:30:00-04:00,57.95,58.25999,57.83,58.2,43128656,52109476.8,64.16359640592447,45.66381818455027,NaN,NaN,212.62806411239606,145.2075500413003,0.48574097631015906,0.16151043340360616,-0.3242305429065529,4765491386,4665789171.6,65.10657204169132,33.752065522319086,NaN,NaN,3.680380327653658,-12.639938175819148
2011-07-06T09:30:00-04:00,58.14,58.49001,57.94,58.39,49282640,52258056,65.07898117908728,47.98020401276176,NaN,NaN,186.36804581333624,173.38892881720588,0.5125989246515454,0.3165181129078789,-0.19608081174366654,4814774026,4718092413.2,69.92482896096536,36.70039490472563,NaN,NaN,7.84682568656607,-9.713257624049831
2011-07-07T09:30:00-04:00,58.82001,59.36,58.74001,59.19,54799760,52676724.8,68.70384217810471,50.63060629270855,NaN,NaN,185.79339967308223,191.8069165869797,0.55540344607347,0.49817349584817094,-0.05722995022529903,4869573786,4768272170,73.67990245024797,40.138306131727326,NaN,NaN,12.634967254468766,-6.5206540699757465
2011-07-08T09:30:00-04:00,58.7,59.03999,58.37,59.03,69533568,53888028,67.20140106759628,53.276847244201655,NaN,NaN,140.53099420605903,187.34600315552046,0.5434282527566383,0.6220553657204988,0.07862711296386055,4800040218,4794448429.2,75.40502678934695,43.91006100876558,NaN,NaN,16.034899154486045,-3.2984321807669197
2011-07-11T09:30:00-04:00,58.41,58.71001,57.75999,57.96001,52080768,53805039.2,58.057724365403,55.0436242295912,NaN,NaN,94.57295392181292,163.9786915453373,0.4384339361130265,0.6266695331051437,0.1882355969921172,4747959450,4799567773.2,75.73992776439398,47.84487949212877,NaN,NaN,16.16677172759935,-0.517688765286024
2011-07-12T09:30:00-04:00,57.94,58.07001,57.46001,57.52,84000624,56117781.6,54.75814360904636,55.77302637135919,NaN,NaN,66.26008056862952,134.70509483658398,0.31984558284678255,0.5880425755505954,0.2681969927038128,4663958826,4779261261.2,71.57654362887038,51.592517548289564,NaN,NaN,15.229351431249796,1.7318884056476644
2011-07-13T09:30:00-04:00,57.94,58.34,57.55,57.75999,82374496,58208243.2,56.219625724923795,56.79358183741103,NaN,NaN,67.0631945008354,110.84412457408382,0.2416203668365151,0.5702224512494567,0.3286020844129416,4746333322,4765573120.4,68.82995938220138,55.224890011686284,NaN,NaN,14.904910428991677,3.6137486946968087
2011-07-14T09:30:00-04:00,57.92999,58.17999,56.87,57.09,98773872,60195820,51.24286929358093,57.14915520350696,NaN,NaN,40.9881775948086,81.88308015842908,0.13417117896707464,0.4963160581217849,0.3621448791547103,4647559450,4721170253.2,60.69382779214466,57.98009798324826,NaN,NaN,13.07980714668815,4.966042759267
2011-07-15T09:30:00-04:00,57.72,57.85001,57.31,57.85001,68287680,60294394.4,56.0010053760612,58.2795227911218,NaN,NaN,47.870664165527735,63.35101415032284,0.10499109168055892,0.49338374375540894,0.38839265207485,4715847130,4704331635.6,57.89877552733308,60.19198071201627,NaN,NaN,12.9835063613704,6.111394702424629
2011-07-18T09:30:00-04:00,57.535,57.78999,56.98,57.53999,59512192,59752348,53.69893050881049,58.76153550543978,NaN,NaN,32.47688148599963,50.93179966316017,0.057872117958065905,0.4607327995224324,0.4028606815643665,4656334938,4686006733.2,54.93390458862428,61.81954203043204,NaN,NaN,12.197642155445239,6.980858624284716
2011-07-19T09:30:00-04:00,58.13,58.89999,58.09,58.85001,73904256,61577419.2,60.99539398060506,59.36988855614078,NaN,NaN,84.68191275125304,54.61616609968487,0.10523471804244461,0.5344040791174223,0.42916936107497766,4730239194,4699262806.8,56.66274816888735,63.25529715758091,NaN,NaN,13.881634571831466,7.966683759648538
2011-07-20T09:30:00-04:00,59.17999,59.19,58.5,58.60001,57084224,61636995.2,59.08191916765868,59.73860104378053,NaN,NaN,87.65763844152933,58.735054887823665,0.10953702929926279,0.5660906476990561,0.45655361839979336,4673154970,4684627136.4,54.190939520263626,63.90733058075612,NaN,NaN,14.62128895657645,8.917341644923953
2011-07-21T09:30:00-04:00,58.64999,59.32001,58.34,58.99001,70148752,63302772,61.13045895589132,59.936767176897625,NaN,NaN,91.34975955764061,68.80737128039007,0.12721809926653815,0.615576242482966,0.4883581432164279,4743303722,4703775990.8,56.84357477181415,64.32547919098468,NaN,NaN,15.862482160383548,9.909504575703895
2011-07-22T09:30:00-04:00,58.97,59.7,58.92,59.60001,43620352,61446624,64.15338299808764,60.03480534362722,NaN,NaN,119.92953787297597,83.21914602187972,0.16610777535771815,0.6959928624135756,0.5298850870558575,4786924074,4717991379.6,58.75306929876497,64.30282862039638,NaN,NaN,17.856417489517217,11.044777849105799
2011-07-25T09:30:00-04:00,59.13,59.81,59.02,59.48,48916064,61077515.2,63.11343429205182,59.95979376406489,NaN,NaN,117.1068279493511,100.14513531455002,0.16928580782181535,0.7414923468331267,0.5722065390113114,4738008010,4734325994,60.89422700832754,64.00194683229897,NaN,NaN,19.1598225698541,12.204069952069842
2011-07-26T09:30:00-04:00,59.44,59.83,59.32001,59.625,40918832,60625014.4,63.875391797558784,59.873823093955714,NaN,NaN,122.58999271958149,107.72675130821571,0.16644035868604323,0.7802569873688654,0.6138166286828222,4778926842,4744063523.6,62.155430534192575,63.4469898018152,NaN,NaN,20.44930117779362,13.381960127173238
2011-07-27T09:30:00-04:00,59.25,59.28999,57.94,58.09,83969504,62472057.6,51.70010920244124,58.65927073855118,NaN,NaN,20.956848108483747,94.3865932416066,0.0523756446647361,0.6792861845137423,0.6269105398490062,4694957338,4748423997.2,62.735012462723276,62.665211945563435,NaN,NaN,17.774112185801595,14.009410421263004
2011-07-28T09:30:00-04:00,58.10001,58.92999,57.89,58.19,61031808,62252788.8,52.33748958125897,57.59756277524137,NaN,NaN,1.674337291012372,76.45150878828095,-0.02119718346641497,0.6004140605159876,0.6216112439824025,4755989146,4750961082,63.08921409994899,61.78551103917787,NaN,NaN,15.837535807542055,14.27057119073144
2011-07-29T09:30:00-04:00,57.73,58.61,57.44,58,82860432,63871614.4,50.961444830853246,57.09068566563068,NaN,NaN,-42.78129873851813,43.909341465982116,-0.0839924825940973,0.5166206407397809,0.6006131233338782,4673128714,4728202010,57.78334520965942,60.50289799955397,NaN,NaN,13.843930011005703,14.20962245077062
2011-08-01T09:30:00-04:00,58.67,58.82001,57.03,57.73,85421008,65482474.4,48.99027346976274,56.67869494139614,NaN,NaN,-64.1167007894831,7.664635718215277,-0.1416547792408941,0.4235446492827606,0.5651994285236547,4587707706,4698141949.2,51.60955967561371,59.07668486003564,NaN,NaN,11.603287004715776,13.837288815619928
2011-08-02T09:30:00-04:00,57.46001,57.72,56.21001,56.27,90851312,67868607.2,39.98404176800954,55.51901037304511,NaN,NaN,-172.30708728909863,-51.31478028352075,-0.2686972165501225,0.22932790783600154,0.49802512438612406,4496856394,4641727859.6,42.4441980798506,57.19198762415344,NaN,NaN,6.516741395249722,12.791496326995613
2011-08-03T09:30:00-04:00,56.37,56.88,55.35001,56.81,103612320,70585091.2,44.078861998189964,55.007295566231484,NaN,NaN,-176.18194748708285,-90.74253940263407,-0.30431826447474986,0.11762729379268677,0.4219455582674366,4600468714,4622830134.8,39.88869782611426,55.70590691229412,NaN,NaN,3.5731650344645822,11.474591856634037
2011-08-04T09:30:00-04:00,55.98,56.09,54.17,54.17,132829936,74486600,32.42947912350171,53.323615119620094,NaN,NaN,-256.96175983063694,-142.46975882696393,-0.4830174105247109,-0.18182620488845203,0.3011912056362589,4467638778,4565160061.2,33.29964653547401,53.94882627001848,NaN,NaN,-3.894841726590296,9.27895848760199
2011-08-05T09:30:00-04:00,54.78999,55.03,52.32001,53.83,214111680,81715505.6,31.282810362336022,51.722463680586195,NaN,NaN,-261.4915815419969,-186.21181538765967,-0.5941459109103914,-0.4414911830017303,0.15265472790866105,4253527098,4481239738,26.452106033922746,51.9144120875398,NaN,NaN,-9.97117993096751,6.528938713520633
2011-08-08T09:30:00-04:00,52.21001,53.12,50.59,50.59,204804064,89351670.4,22.953659625524693,49.0051969409376,NaN,NaN,-283.0693003973377,-230.0023353092306,-0.8408139463901816,-0.8983627050790659,-0.057548758688884344,4048723034,4373442803.6,20.593974670158488,49.33807112334488,NaN,NaN,-19.378628936972884,2.8278576205929875
2011-08-09T09:30:00-04:00,51.31,53.08,49.92999,53.03,193707056,94836992,36.63617241858155,47.401929316003525,NaN,NaN,-192.2873106867569,-233.99837998876228,-0.7951040750630316,-1.0514288525176738,-0.2563247774546422,4242430090,4322557542.8,18.510072836727062,46.78943778880655,NaN,NaN,-21.103751643145973,-0.5909437027982922
2011-08-10T09:30:00-04:00,51.82001,53.04379,50.8,50.86,205917872,101014160.8,31.310667762879163,45.27194423078836,NaN,NaN,-165.7960094002448,-231.92119237139462,-0.8609208102169148,-1.3324757902257858,-0.47155498000887097,4036512218,4209766243.6,14.908853272112964,43.7941005388279,NaN,NaN,-24.7830887689216,-4.046964426530193
2011-08-11T09:30:00-04:00,51.58,53.69,51.34,53.10001,143824496,103266692,40.866322879426804,43.608582793741164,NaN,NaN,-109.96839657601116,-202.5225197204695,-0.7097912913845311,-1.358794094239535,-0.6490028028550038,4180336714,4152305830.8,13.470986343394273,40.55966604201571,NaN,NaN,-23.458291193937075,-6.82001110758832
2011-08-12T09:30:00-04:00,53.42,53.89999,52.88,53.57001,90483248,104376470.4,42.66849834782885,42.14823022629666,NaN,NaN,-78.18747728674987,-165.86169886942008,-0.5419466678126337,-1.3264361376207958,-0.7844894698081621,4270819962,4155764403.6,14.0085656106654,37.21069022789698,NaN,NaN,-21.799047292683447,-8.959873419744767
2011-08-15T09:30:00-04:00,53.77,54.36,53.53,54.36,73554256,105078573.6,45.665887851476754,40.84755137300509,NaN,NaN,-54.78145680860315,-120.20413015167318,-0.35076781260763334,-1.2229492355677039,-0.8721814229600705,4344374218,4214894640.4,22.83524075673597,34.40210524379294,NaN,NaN,-19.421288810923308,-10.454361332770272
2011-08-16T09:30:00-04:00,53.82001,54.35001,53.17999,53.89999,89219184,105844320,44.21624155156676,40.31298939794262,NaN,NaN,-55.125253936059266,-92.77171880153367,-0.23395803354622824,-1.1646289648928558,-0.9306709313466276,4255155034,4217439629.2,23.200634010964635,31.578221068667318,NaN,NaN,-18.107584991865036,-11.547678998355238
2011-08-17T09:30:00-04:00,53.98,54.42,53.02,53.58,84416496,107210933.6,43.189174341514274,39.659538309389426,NaN,NaN,-52.617325750082514,-70.13598207150122,-0.1604157253095635,-1.131190587983582,-0.9707748626740185,4170738538,4244284893.2,27.120861221683953,29.009053005934106,NaN,NaN,-17.418894109680707,-12.386424014258877
2011-08-18T09:30:00-04:00,52.13,52.14,50.48,50.95,130016432,110204317.6,35.82382964419649,38.57828008177109,NaN,NaN,-105.46203371462911,-69.2347094992248,-0.26490166058500897,-1.3019019384052797,-1.0370002778202707,4040722106,4216361971.6,25.65400789792092,26.714100340809924,NaN,NaN,-19.394336287951575,-13.38755433907212
2011-08-19T09:30:00-04:00,50.42999,51.67,49.99001,50.03,96674496,112857024.8,33.661282444536866,37.48335215139781,NaN,NaN,-112.46884083549261,-76.09098220897336,-0.36576295493489264,-1.4942039714888864,-1.1284410165539938,3944047610,4151007501.2,22.576251932308807,24.640292644859578,NaN,NaN,-21.71018414250226,-14.576501453847854
2011-08-22T09:30:00-04:00,51.21001,51.24001,50.06,50.21001,77107680,114266605.6,34.494512174363535,37.091242894708806,NaN,NaN,-106.80370379868887,-86.49543160699051,-0.38803136272178906,-1.6134802199562301,-1.225448857234441,4021155290,4086363715.6,20.018039190589477,23.038424152769498,NaN,NaN,-23.241376510919036,-15.814340747715166
2011-08-23T09:30:00-04:00,50.56,52.28,50.34,52.28,75688368,116005082.4,43.31200440751301,37.0364673525176,NaN,NaN,-72.20914524429689,-89.91220986863803,-0.2383734148468184,-1.523415625792964,-1.2850422109461457,4096843658,4054701440.4,18.889037321000686,21.538448402404242,NaN,NaN,-21.63098351141347,-16.64528971395778
2011-08-24T09:30:00-04:00,52.17999,53.42,51.71001,52.69,80197632,115816488.8,44.89421712140654,37.926805780939375,NaN,NaN,-38.28265018285341,-87.0452747551922,-0.09419405746589793,-1.402784782778518,-1.30859072531262,4177041290,4055961990.8,19.084699351728418,20.5230950321367,NaN,NaN,-19.850185153790257,-17.103131919648135
2011-08-25T09:30:00-04:00,52.64,52.905,51.64999,51.83,93623632,117446080,42.23158926197857,38.70886141662812,NaN,NaN,-48.47478501883664,-75.6478250160337,-0.04184044036568313,-1.360891275769724,-1.3190508354040409,4083417658,4064501101.2,20.48402402512339,20.096803460079606,NaN,NaN,-19.203216818866796,-17.403144048107944
2011-08-26T09:30:00-04:00,51.67999,53.31,51.14999,53.13,91573248,117881720.8,47.31800512866889,40.44917180970985,NaN,NaN,-26.651225260963912,-58.48430190112797,0.08815563524135461,-1.2088562913523475,-1.2970119265937021,4174990906,4110689760.4,27.761244085325416,20.608751275448675,NaN,NaN,-17.03650857171061,-17.350767551479752
2011-08-29T09:30:00-04:00,53.64,54.67,53.64,54.61,45985744,115909957.6,52.45094718862508,41.57879857899867,NaN,NaN,62.557072626612545,-24.61214661606768,0.2712881455268399,-0.9579017446851523,-1.2291898902119922,4220976650,4150654032.4,33.437500072141205,21.674996077978257,NaN,NaN,-13.513598990592316,-16.802600614210117
2011-08-30T09:30:00-04:00,54.39,55.3,54.11,54.97,61617824,114448283.2,53.63433239678575,43.17334605284914,NaN,NaN,97.74723685720991,9.3791298042337,0.406031330808299,-0.7216507267016183,-1.1276820575099173,4282594474,4187804195.6,38.29160820168792,23.345192858662184,NaN,NaN,-10.323722105095216,-15.877046541479418
2011-08-31T09:30:00-04:00,55.28999,55.74001,54.60001,55.06,60899248,112312629.6,53.94293897549556,44.1073900597112,NaN,NaN,124.79609691444372,41.994879223693125,0.485225367443856,-0.5211503482050972,-1.0063757156489532,4343493722,4221094682,42.348858759226495,25.407898031221627,NaN,NaN,-7.671950529013809,-14.704889968270045
2011-09-01T09:30:00-04:00,55.21001,55.64,54.46001,54.56,57158368,108529051.2,51.87709970576941,44.7651472995641,NaN,NaN,110.82379134550621,73.8545944965617,0.48669244319579796,-0.3980101616542058,-0.8847026048500037,4286335354,4261678221.2,46.929781206247476,27.759413430906058,NaN,NaN,-6.026362111079981,-13.465100274385751
2011-09-02T09:30:00-04:00,53.58,54.6143,52.99001,53.28,58185104,100732722.4,46.92292157548137,44.854935422707285,NaN,NaN,43.22590271196222,87.83002009114692,0.38847781084863153,-0.39910534128921427,-0.7875831521378458,4228150250,4272310090,48.09340330185723,29.56356789841472,NaN,NaN,-6.011026710591062,-12.400232622415082
2011-09-06T09:30:00-04:00,52.03999,53.366,51.91,53.28999,52992176,93142128,46.96549069688521,45.051310361658594,NaN,NaN,-2.7497044108091004,74.76866468366259,0.31437191697640743,-0.39461825591733657,-0.708990172893744,4281142426,4284343245.2,49.44449288363345,31.43812924646249,NaN,NaN,-5.98681939045292,-11.484030732134773
2011-09-07T09:30:00-04:00,54.03,54.64999,53.89999,54.64,48952112,85904380.8,52.508661579470335,45.7169880215126,NaN,NaN,76.74863223935887,70.56894376009238,0.34406209540662347,-0.27891255363546463,-0.6229746490420881,4330094538,4293843258,50.539086914366095,33.11085965308264,NaN,NaN,-4.36153680305848,-10.466531599409588
2011-09-08T09:30:00-04:00,54.37,55.1684,54.21001,54.39,61422784,78679626.4,51.43650341559488,46.832179005183924,NaN,NaN,79.71294412733316,61.55231320267027,0.33436014548098236,-0.2050244671908601,-0.5393846126718425,4268671754,4278878864.4,48.74861902283665,34.76047473343377,NaN,NaN,-3.3147621583600144,-9.444850250688221
2011-09-09T09:30:00-04:00,54.00999,54.2399,52.85001,53.17999,63663488,74671576,46.48873595280017,47.748425684345584,NaN,NaN,12.236074830570823,41.834769899683195,0.23844889505379874,-0.24132349385459406,-0.4797723889083928,4205008266,4262613446.8,46.807529162194506,36.49128024985418,NaN,NaN,-3.8121248333079847,-8.640175191062474
2011-09-12T09:30:00-04:00,52.61,53.89999,52.57001,53.86,65973008,73446064,49.432611145542964,48.81543275371554,NaN,NaN,13.403266701622927,35.870242697615346,0.2136043391607349,-0.21276696495747416,-0.42637130411820906,4270981274,4271179651.6,47.982271513368765,38.488725415766986,NaN,NaN,-3.391883407643477,-7.890419222002617
2011-09-13T09:30:00-04:00,54.08,54.69,53.8,54.58,59019984,72719350.4,52.41746867434905,49.46582305848955,NaN,NaN,64.23630532105406,49.26744464398797,0.23667062416400575,-0.13053302391320187,-0.3672036480772076,4330001258,4280951418,49.35627369209814,40.664956585131094,NaN,NaN,-2.174635628547302,-7.073878708651858
2011-09-14T09:30:00-04:00,54.85001,55.98,54.32001,55.36,90757312,72796256.8,55.48313207200294,50.22217412638929,NaN,NaN,104.15215749227535,54.74814969457127,0.2918469628818114,-0.0023949444749433724,-0.29424190735675476,4420758570,4299084224.4,51.895483147987534,43.0085839991496,NaN,NaN,-0.24004562482779637,-6.097616839534135
2011-09-15T09:30:00-04:00,55.97,56.28,55.39,56.17999,83536064,72752235.2,58.509516275145174,51.38488319875834,NaN,NaN,128.00493892209727,64.40654865352408,0.3661437164556945,0.16343773821286334,-0.20270597824283115,4504294634,4346208800.4,57.81514080875208,45.67509234083736,NaN,NaN,2.3124589258045893,-4.896177444485746
2011-09-16T09:30:00-04:00,56.25,56.64999,56.09,56.59,91901936,70846510.4,59.974740834297336,52.288935749160366,NaN,NaN,138.19926687018977,89.59918706144788,0.421531535640445,0.3242084413077251,-0.0973230943327199,4596196570,4424446461.2,65.42283722701269,48.365206136672164,NaN,NaN,4.870441709181588,-3.5009461368189836
2011-09-19T09:30:00-04:00,55.89999,56.91,55.42999,56.61,73042816,69664926.4,60.048855669041345,52.83164349776153,NaN,NaN,122.28254613002741,111.37504294712878,0.436313797369011,0.44806915237854383,0.011755355009532842,4669239386,4504098083.6,71.13094967699692,51.05759539416186,NaN,NaN,6.99320312153491,-2.001781957054142
2011-09-20T09:30:00-04:00,56.89999,57.35001,56.23,56.36,66570064,69138045.6,58.58843626357482,53.18550805967504,NaN,NaN,133.83482793894314,125.29474747070658,0.4066451551258815,0.5200617989168848,0.11341664379100323,4602669322,4558631696.4,74.2635573712147,53.62702033484235,NaN,NaN,8.413237954715365,-0.5139219696584982
2011-09-21T09:30:00-04:00,56.64999,56.92999,55.37,55.38,79938000,69350527.2,53.133245361817025,53.12767280155515,NaN,NaN,85.04987117062842,121.47429020637722,0.30315710553062614,0.4923630257042859,0.18920592017365978,4522731322,4579026246.8,75.34121245115523,55.98361702712297,NaN,NaN,8.201349701265709,0.7311168404735311
2011-09-22T09:30:00-04:00,53.92999,54.46001,52.75,53.58,151885440,72934917.6,44.8694443582966,52.62712599102138,NaN,NaN,-58.48322219733467,84.17665798249081,0.10580405539593835,0.3214609894185827,0.21565693402264435,4370845882,4552336496.4,71.14287142195154,57.713123471101824,NaN,NaN,5.478142020100826,1.4092632947060018
2011-09-23T09:30:00-04:00,53.14,54.38,53.091,54.14999,85940560,72550764,47.64622106067002,52.67879023996342,NaN,NaN,-50.601628358528444,46.41647893674717,0.010969890615913025,0.22936929729253563,0.2183994066766226,4456786442,4524454470.8,66.94592206722913,59.05973195434268,NaN,NaN,4.014108522985052,1.781384041603009
2011-09-26T09:30:00-04:00,54.42,54.88,53.21001,54.78,96260944,72785148.8,50.607468914956705,52.93893154125425,NaN,NaN,-30.65310527548008,15.82934865564568,-0.01083072573822913,0.20486099950383618,0.2156917252420653,4553047386,4501216070.8,63.579371414655064,60.06936613512993,NaN,NaN,3.6431068443800028,2.0473444419997224
2011-09-27T09:30:00-04:00,55.7,56.2,54.98,55.35001,81148496,74543286.4,53.18740617567196,52.987413298125794,NaN,NaN,54.35627960189085,-0.0663610117647778,0.010483121084844393,0.2287956265981208,0.2183125055132764,4634195882,4507521382.8,64.10679351587032,61.03848803523738,NaN,NaN,4.080773774150156,2.3378343465926417
2011-09-28T09:30:00-04:00,55.57001,55.97,54.39999,54.53,76757056,75300248,49.20556915733551,52.828060851107274,NaN,NaN,14.092069780065506,-14.257921289877354,-0.03102875112178491,0.17952656661104527,0.21055531773283018,4557438826,4514462883.6,64.7126385516902,62.178775144441204,NaN,NaN,3.280398252267428,2.4724863331176112
2011-09-29T09:30:00-04:00,55.36,55.42999,52.97,53.88,116900128,78100292,46.24984538143678,52.810997238867024,NaN,NaN,-44.55150159437345,-11.471577169285109,-0.09882208411769725,0.08702771258570863,0.18584979670340587,4440538698,4528401446.8,65.95528701608197,63.546472134004595,NaN,NaN,1.7231233000466046,2.3654344712503246
2011-09-30T09:30:00-04:00,53.17999,53.61,52.46001,52.49001,104957936,80490270.4,40.62937424826391,52.1821946033471,NaN,NaN,-117.50453235236162,-24.852157968051745,-0.2265334865700746,-0.0973170615091874,0.1292164250608872,4335580762,4504160310.8,61.874354390271286,64.53876376806906,NaN,NaN,-1.4396936862305774,1.8218447344673385
2011-10-03T09:30:00-04:00,52.03999,52.85001,51.11,51.14,99147936,82538412,36.047458679667265,51.01290817515554,NaN,NaN,-173.36287388836433,-53.3941116906286,-0.38203778556389084,-0.34833080689397633,0.0337069786699145,4236432826,4440837398.8,52.701124349535625,64.77768167217174,NaN,NaN,-5.711253119448472,0.7456878981936514
2011-10-04T09:30:00-04:00,50.595,52.28999,50.095,52.19,137011440,86739375.2,41.56699001949067,50.018898028547525,NaN,NaN,-170.6146927948379,-98.38830616997436,-0.39277656862944,-0.45726373211688554,-0.06448716348744551,4373444266,4388687075.6,46.576751670379245,64.397772280914,NaN,NaN,-7.548048415055734,-0.4391315751276894
2011-10-05T09:30:00-04:00,52.07001,53.6787,51.66,53.53,108825680,89733053.6,47.76313644219711,49.25129946905123,NaN,NaN,-78.61033906587602,-116.92878793916266,-0.29281384637439206,-0.4305044714554356,-0.13769062508104352,4482269946,4373653299.6,44.95488779063512,63.47918277961994,NaN,NaN,-7.070266492586931,-1.3864365633361526
2011-10-06T09:30:00-04:00,53.47,54.44,53.21001,54.42999,71939120,90258870.4,51.48417685850341,48.64483061363738,NaN,NaN,-18.025751624023226,-111.62363794509261,-0.1561188045804943,-0.3328391308066614,-0.1767203262261671,4554209066,4396387373.2,47.908837674786305,62.228182811603766,NaN,NaN,-5.449624984029287,-1.9668920520066004
2011-10-07T09:30:00-04:00,54.41,54.66,53.72,54.07001,72525184,90701955.2,49.951463702872275,47.92358833033959,NaN,NaN,-13.566487084828214,-90.83602889158593,-0.08361895203672726,-0.2812440162720762,-0.19762506423534892,4481683882,4425607997.2,51.510700580345045,60.8267364475572,NaN,NaN,-4.62796412710384,-2.3470452055919204
2011-10-10T09:30:00-04:00,54.98,55.94,54.89,55.94,48229040,89814756.8,57.09679602972841,47.81704259935056,NaN,NaN,60.39248359904471,-44.08495739410412,0.08734609777141808,-0.08844244202107632,-0.1757885397924944,4529912922,4484304016.4,57.81990412512771,59.65218978712242,NaN,NaN,-1.4945688668142088,-2.225262871480819
2011-10-11T09:30:00-04:00,55.81,56.46001,55.7,56.32001,66449056,90186210.4,58.396665131968454,48.19300115436137,NaN,NaN,81.76980630061446,6.391942424986357,0.21577883305954682,0.09393500153193912,-0.1218438315276077,4596361978,4528887558.8,61.87743092497662,58.69049110668108,NaN,NaN,1.4199635059180378,-1.7045162461381251
2011-10-12T09:30:00-04:00,56.87,57.23,56.56,56.60001,85627568,89929723.2,59.373381048121374,49.228996632206,NaN,NaN,104.36757309756479,42.987524857674515,0.3039462732190386,0.25808900999619055,-0.04585726322284804,4681989546,4568831478.8,65.11523407858914,58.2599455821552,NaN,NaN,4.068573202994619,-0.8797891819763046
2011-10-13T09:30:00-04:00,56.49001,57.19,56.42999,57.12,63443632,88925101.6,61.195368284016844,50.19679286244506,NaN,NaN,104.04042567297962,67.40076031707508,0.3768771696582734,0.4252391988499937,0.04836202919172032,4745433178,4607076301.2,67.92423542642354,58.329825107811935,NaN,NaN,6.821298936381018,0.2203662635033128
2011-10-14T09:30:00-04:00,57.84,58.19,57.50999,58.17999,65643504,87612180,64.67335926023739,51.201499315679385,NaN,NaN,142.3262597934755,98.57930969273582,0.47003749672808925,0.6359089001018319,0.16587140337374265,4811076682,4672954861.2,72.09281668821161,58.9379283416374,NaN,NaN,10.285624143104782,1.6582602463035223
2011-10-17T09:30:00-04:00,57.89999,58.09,56.9716,57.28,65161280,87218103.2,59.77464102222552,51.67201609043321,NaN,NaN,112.47454804242037,108.99572258141094,0.44484096545961604,0.7219226101982628,0.2770816447386467,4745915402,4716155357.2,74.43878463066298,59.675927706979735,NaN,NaN,11.762929569330002,3.101784435307305
2011-10-18T09:30:00-04:00,57.19,58.28999,56.66,57.99001,91434320,88461316,62.2067485026465,52.600671757955425,NaN,NaN,115.2029513646285,115.68235159421377,0.44851404834655895,0.8377242051718454,0.3892101568252865,4837349722,4764352906,76.78366471064949,60.53814386119111,NaN,NaN,13.744140895240406,4.622121072440605
2011-10-19T09:30:00-04:00,57.71001,57.85001,56.67999,56.87,67639312,87846381.6,56.41246149511982,53.32657290893279,NaN,NaN,87.67747963814702,112.34433290233021,0.35227964163347486,0.82955970886713,0.4772800672336552,4769710410,4781897078.8,77.58956632629827,61.36916381192085,NaN,NaN,13.675401770858809,5.915446886500349
2011-10-20T09:30:00-04:00,56.81,56.92,55.78999,56.59,80378256,84271022.4,55.03238967643478,54.355359725230706,NaN,NaN,53.56790251174888,102.24982827008407,0.25127448180987977,0.7913731694960049,0.5400986876861251,4689332154,4770676874,75.77787847216894,62.362272674913534,NaN,NaN,13.208390866813055,6.957296026545021
2011-10-21T09:30:00-04:00,57.17,57.66,56.78,57.3,60455680,82996778.4,57.848348093673636,55.91256611194545,NaN,NaN,78.12575566065757,89.40972744352048,0.21518074555037303,0.8090746196240914,0.5938938740737184,4749787834,4758419104.4,73.75183739604202,63.86589503537828,NaN,NaN,13.637723421107578,7.911642797196815
2011-10-24T09:30:00-04:00,57.52,58.64999,57.3105,58.49001,61449360,81256199.2,62.12900207004333,57.3812812584135,NaN,NaN,102.76904351780865,87.46862653859814,0.25180700169779824,0.9086526261959662,0.656845624498168,4811237194,4771483462.8,74.53335515441762,65.86279528423816,NaN,NaN,15.322355928805234,8.970316101712303
2011-10-25T09:30:00-04:00,58.27,58.32001,57.22,57.34,65299184,80463733.6,56.1902873115251,57.983220606222645,NaN,NaN,75.05592887263369,79.43922204019917,0.18218420261745183,0.8845758777699828,0.702391675152531,4745938010,4753201120.4,71.33257193304837,67.74691558012482,NaN,NaN,14.925928742150862,9.82111790748924
2011-10-26T09:30:00-04:00,57.64999,57.78,56.2126,57.27,98193744,81535568,55.840400382563146,58.29437942936976,NaN,NaN,50.89837481796185,72.08340107616213,0.11812477673048727,0.8500476460656401,0.7319228693351528,4647744266,4728807891.6,67.18674358621021,69.12390885951224,NaN,NaN,14.505358930898652,10.490295196547727
2011-10-27T09:30:00-04:00,58.64,59.2,58.03,58.85001,104455440,80913333.6,61.64572747600229,59.129683984593335,NaN,NaN,100.31181892582842,81.43218435897805,0.16594101955428564,0.9393491437780099,0.7734081242237243,4752199706,4741381402,68.21228838734315,70.31687941715496,NaN,NaN,15.936691829272554,11.268351858365559
2011-10-28T09:30:00-04:00,58.5,59.00999,58.5,58.94,42949952,77812934.4,61.95252125574186,59.47652150073715,NaN,NaN,100.64515107149724,85.93606344114599,0.18590434908112763,1.0057885605751338,0.8198842114940061,4795149658,4750453766.8,68.96597712204874,71.11302748836361,NaN,NaN,17.172372088682035,12.111783319839342
2011-10-31T09:30:00-04:00,58.41,58.64,57.91,57.95,60520128,75881544,56.589671846999124,59.34745055181077,NaN,NaN,73.67647808504883,80.11755035459402,0.11801734906982253,0.9674058978312843,0.8493885487614617,4734629530,4735132234,66.11496586919074,71.41570855580747,NaN,NaN,16.62843082011423,12.757018677021469
2011-11-01T09:30:00-04:00,56.56,57.9064,56.12,56.44,99932816,74027612.8,49.54496992564201,58.64542118591938,NaN,NaN,1.8062307207897481,65.46761072422524,-0.034827957429917955,0.8058536019740643,0.8406815594039823,4634696714,4712883974.8,62.100414318081654,71.20036428719979,NaN,NaN,13.888031864612332,12.918591989534448
2011-11-02T09:30:00-04:00,57.00999,57.16,56.38499,56.92,65178768,71845267.2,51.60728222930012,57.96055789629677,NaN,NaN,-11.864544015999046,52.91502695743306,-0.10583455003198272,0.7083883718640038,0.8142229218959866,4699875482,4723310218,63.22729853384956,70.86486879487309,NaN,NaN,12.275953700494014,12.82678651967153
2011-11-03T09:30:00-04:00,57.36,58.175,56.71001,58.10001,78994192,72198020.8,56.33265313550415,57.36479317310153,NaN,NaN,42.601460349809166,41.37295524222919,-0.07690971812865854,0.7180857742351634,0.7949954923638219,4778869674,4728644211.6,63.81998216474244,70.27395204319672,NaN,NaN,12.358567816057896,12.75989813344101
2011-11-04T09:30:00-04:00,57.78999,58.05,57.22,57.8,61527712,71648147.2,54.86578125223394,57.014160332387846,NaN,NaN,35.97374105287351,28.438673238504443,-0.08114221882172301,0.6935677188366682,0.7747099376583912,4717341962,4713082672.4,60.74398843971273,69.2957523152717,NaN,NaN,11.982095410223208,12.648783458695611
2011-11-07T09:30:00-05:00,57.75,58.25,57.17,58.21001,65558624,72514626.4,56.53167864626878,56.60879819978944,NaN,NaN,48.90925455291327,23.485228532077326,-0.06043846134782438,0.6991618609736108,0.7596003223214352,4782900586,4722736883.6,61.96865915152064,68.23753763247679,NaN,NaN,12.1576104239725,12.578615882306595
2011-11-08T09:30:00-05:00,58.63,58.98,57.97,58.88,62906880,72337517.6,59.18288297898135,56.8066854486367,NaN,NaN,124.43212987402248,48.01040836272388,-0.008461397810420879,0.7490235750584091,0.75748497286883,4845807466,4764959034,66.84085482123379,67.46977252497217,NaN,NaN,13.083528672690687,12.650746280932895
2011-11-09T09:30:00-05:00,57.72,57.83,56.63,56.81,69538752,71533076.8,49.19873563037867,56.3899958739184,NaN,NaN,-62.807209248939266,37.821875316135824,-0.11444803090226918,0.6144249342409935,0.7288729651432627,4776268714,4780237680.4,68.41758588121333,66.94403733990393,NaN,NaN,10.724437141673159,12.375559261038646
2011-11-10T09:30:00-05:00,57.39999,57.42,56.23,56.78,66052368,71663513.6,49.06953566251466,55.762937843121335,NaN,NaN,-95.99143096008449,10.103297054157093,-0.1834383699337896,0.49957500272602573,0.6830133726598153,4710216346,4766507014.8,65.40753741284678,66.34801591253283,NaN,NaN,8.825971636509038,11.868475314677273
2011-11-11T09:30:00-05:00,57.28,58.02,57.2,57.85001,54470944,71104885.6,53.736145989188536,55.16344812306027,NaN,NaN,14.358507692471619,5.780250382076716,-0.15500539948553782,0.489256623302893,0.6442620227884308,4764687290,4775976080.4,66.50205837227708,65.77435185666566,NaN,NaN,8.61166609144268,11.403216854215188
2011-11-14T09:30:00-05:00,57.69,58.00999,57.28,57.49001,44617600,70077701.6,52.009489902061794,54.864819736670036,NaN,NaN,1.2776638142647503,-3.746067765652988,-0.15790649812876634,0.4468789001274729,0.6047853982562392,4720069690,4763409901.2,63.62498395606979,65.22380985831003,NaN,NaN,7.9208118953714335,10.905730431523223
2011-11-15T09:30:00-05:00,57.34,58.36,57.25999,58.13,52203872,68116179.2,54.790631737202425,54.789836262001415,NaN,NaN,39.97899039918807,-20.636695660619864,-0.11611817736056129,0.45963767655553767,0.575755853916099,4772273562,4748703120.4,60.33506753738567,64.73440442625115,NaN,NaN,8.157161583652053,10.513077738970198
2011-11-16T09:30:00-05:00,57.73,58.15739,57.06,57.17,68342560,68151341.6,50.100425750821614,53.96517185305994,NaN,NaN,-19.51428649338792,-11.978111109509596,-0.15035297422692173,0.3878146361324468,0.5381676103593686,4703931002,4734235578,57.20158643166738,63.947925715131454,NaN,NaN,6.949290309252213,10.003965249010486
2011-11-17T09:30:00-05:00,57.02,57.03999,55.48,55.83,101706816,69217769.6,44.38859586151862,52.71060575347257,NaN,NaN,-185.33282932010607,-29.84639078151391,-0.2543509712012072,0.22022889635785958,0.4745798675590668,4602224186,4712637146,52.79350211983344,62.79274892925893,NaN,NaN,4.073958414666725,9.156821415532805
2011-11-18T09:30:00-05:00,55.85001,55.89999,55.3,55.39999,60416976,69215834.4,42.70599490120418,51.718914543058645,NaN,NaN,-207.69646432743795,-74.25738518549583,-0.337970290404708,0.0521170045531818,0.3900872949578898,4541807210,4668061130,45.073357452315285,61.289776899482106,NaN,NaN,1.2030777299157882,8.020572317587517
2011-11-21T09:30:00-05:00,54.67999,54.73,53.78,54.34,52289440,68757838.4,38.801489574398616,50.9515230893984,NaN,NaN,-253.46842879640425,-125.20660370762963,-0.4438667354907148,-0.16474612440550374,0.2791206110852111,4489517770,4621950746,38.75936833948795,59.62255932958255,NaN,NaN,-2.506746044961414,6.516669694366241
2011-11-22T09:30:00-05:00,54.2,54.67999,53.87,54.52,51940096,68089884,39.80789308129826,50.10870957882684,NaN,NaN,-196.92706686406567,-172.58781516028037,-0.4780298578307902,-0.31841671120327675,0.1596131466275135,4541457866,4575787606.8,33.67361858885833,57.51158219065461,NaN,NaN,-5.209388834478199,4.841518475959893
2011-11-23T09:30:00-05:00,54.11,54.17,53.25999,53.28999,48467328,65603563.2,35.510466302970286,48.62141051936013,NaN,NaN,-197.15691702818955,-208.1163412672407,-0.5543350532722112,-0.5333056699627505,0.021029383309460692,4492990538,4533599514,29.822384611820496,55.0831823654459,NaN,NaN,-8.937963156361475,2.8730210999139834
2011-11-25T09:30:00-05:00,53.09,53.67,52.87,52.88,25447856,61653184,34.185718198047226,47.1442631583468,NaN,NaN,-179.79433449688543,-207.00864230259657,-0.5994588368719062,-0.728294162780422,-0.12883532590851585,4467542682,4506663213.2,27.648138248534295,52.71919306607601,NaN,NaN,-12.412011343476966,0.6894450365724194
2011-11-28T09:30:00-05:00,54.16,54.78999,54.14,54.72,46710688,61841220.8,44.23956625290617,46.266255130249476,NaN,NaN,-93.20020060805463,-184.1093895587199,-0.47771785895333985,-0.7259826496001907,-0.2482647906468508,4514253370,4501152445.2,27.21104859987618,50.23650659810141,NaN,NaN,-12.368143334539248,-1.175924730729247
2011-11-29T09:30:00-05:00,54.64999,55.10001,54.22,54.38,52056608,61418044.8,42.93440726065588,45.105649721797654,NaN,NaN,-80.93205872575604,-149.60211554459028,-0.39580483594224286,-0.7430208355746544,-0.3472159996324115,4462196762,4495688243.6,26.759318584088007,47.373539724019565,NaN,NaN,-12.734092904329847,-2.8270916126721897
2011-11-30T09:30:00-05:00,55.84,56.44,55.67,56.39,66918496,59767328.8,51.95792961471355,45.302735006393,NaN,NaN,-5.1101875505392735,-111.23873968188498,-0.19227559023681756,-0.5875604874284335,-0.3952848971916159,4529115258,4493219722,26.54492583748977,44.382635435182166,NaN,NaN,-10.024701837977378,-3.855321644858645
2011-12-01T09:30:00-05:00,56.37,56.925,56.35001,56.78,45361472,58776464,53.49452348914301,45.61880556543788,NaN,NaN,19.643889935142468,-67.87857828921858,-0.02613537204148275,-0.42795411224346935,-0.4018187402019866,4574476730,4509516960.4,30.503680719378778,41.889502814220165,NaN,NaN,-7.368965253614,-4.357270731823696
2011-12-02T09:30:00-05:00,57.33,57.34,56.57001,56.62,36938336,56673671.2,52.7491179032383,45.54830355929858,NaN,NaN,29.82119974682901,-25.955471440475684,0.07282063598467892,-0.310792945221138,-0.3836135812058169,4537538394,4523516102.8,33.803889233821494,39.55391930433047,NaN,NaN,-5.471303898001898,-4.51641832699201
2011-12-05T09:30:00-05:00,57.49001,57.62,56.91499,57.24001,40501888,55622380,55.34574487466556,45.78660748591314,NaN,NaN,51.698860124246345,3.024340705984507,0.1740918881883734,-0.16599872097035018,-0.3400906091587236,4578040282,4536273485.2,36.751529172937964,37.63438681982105,NaN,NaN,-3.0918931351032573,-4.312914728150759
2011-12-06T09:30:00-05:00,57.28999,57.45,56.89,57.08,38669472,54277922.4,54.51314942829683,45.76678732099132,NaN,NaN,48.88892610232646,28.988537671601005,0.22132963944607847,-0.0634285598511255,-0.284758199297204,4539370810,4551708294.8,40.2198808060832,36.19758776758516,NaN,NaN,-1.381853139506746,-3.8941916440587576
2011-12-07T09:30:00-05:00,56.89999,57.34,56.35001,57.08,44576160,53361386.4,54.51314942829683,46.0819818693824,NaN,NaN,44.38914968763107,38.88840511923509,0.24193096750487605,0.0176555100838911,-0.22427545742098495,4539370810,4553759405.2,40.68536761463391,35.01785785208277,NaN,NaN,0.019280637291245545,-3.3351241752944714
2011-12-08T09:30:00-05:00,56.74001,57.14999,56.00999,56.12,51692560,52469076.8,49.34767770238573,46.43620200087291,NaN,NaN,20.220877721411632,39.00380267648892,0.18294077899944755,0.0044005163283245,-0.17854026267112305,4487678250,4536399709.2,37.98919058675816,33.96040702829168,NaN,NaN,-0.16601050860955863,-2.882393651482341
2011-12-09T09:30:00-05:00,56.25999,57.19,56.24001,57.02,55757856,51954351.2,53.77035482645491,47.2265134241051,NaN,NaN,41.23258906033332,41.28608053918978,0.19544042867398378,0.06576027317135669,-0.1296801555026271,4543436106,4537579251.6,38.28843965824496,33.47577004300094,NaN,NaN,0.9512067286139052,-2.3347364543257343
2011-12-12T09:30:00-05:00,56.42,57.0087,55.89999,56.38,55411696,52001388.8,50.40026962202633,48.05499771322137,NaN,NaN,24.633587231230493,35.87302596058661,0.15336862109109634,0.062030620861243335,-0.091338000229853,4488024410,4519576077.2,35.47457726329942,33.24114210898747,NaN,NaN,0.9360228475006638,-1.8674851254933917
2011-12-13T09:30:00-05:00,56.75999,56.98,55.53,55.75999,68557680,53198392.8,47.30693973967837,48.59064390310566,NaN,NaN,10.301305717695017,28.15550188366032,0.08022411198688748,0.00894213975375635,-0.07128197223313112,4419466730,4495595261.2,32.09140951906963,33.12812717543114,NaN,NaN,0.02479133128581675,-1.5971599173820763
2011-12-14T09:30:00-05:00,55.52,55.59,54.58,54.89,63682704,53772334.4,43.29181179548251,49.146454295427965,NaN,NaN,-44.87181829459132,10.303308287215827,-0.02469779499982619,-0.10215421598291385,-0.07745642098308766,4355784026,4458877904.4,27.730681661225844,32.97871982181723,NaN,NaN,-1.9678490789270884,-1.6501155118885067
2011-12-15T09:30:00-05:00,55.36,55.42,54.66,54.74001,58732816,53291847.2,42.62019325503147,49.74891679949826,NaN,NaN,-43.29934112621401,-2.4007354823092997,-0.09803197038995856,-0.19999638397053587,-0.10196441358057731,4297051210,4420752496.4,24.072837129812754,32.723341170479976,NaN,NaN,-3.7944970383591716,-1.9564557299557446
2011-12-16T09:30:00-05:00,54.88,55.61,54.77,54.86,60978704,51255441.6,43.37698663489856,49.687303969640574,NaN,NaN,-31.354345036157437,-16.918122301607447,-0.1302703413506245,-0.26480234026885796,-0.13453199891823345,4358029914,4383671258,21.150621589779078,32.290453526901615,NaN,NaN,-5.105285446202804,-2.4062885465624673
2011-12-19T09:30:00-05:00,55.06,55.2,54.17,54.32001,46733808,50571283.2,40.77087157383307,49.53276570629608,NaN,NaN,-57.505972539210184,-33.346034255695585,-0.1768821388832698,-0.3556346725223207,-0.17875253363905091,4311296106,4348325597.2,18.80707887663533,31.722436404940705,NaN,NaN,-6.969093165814817,-3.0581177778842314
2011-12-20T09:30:00-05:00,55.2,56,55.17,55.92999,81758752,52044748.8,50.34901846169869,49.41784348108074,NaN,NaN,5.374845773140458,-34.3313262446065,-0.09245024143051919,-0.2943153354271999,-0.2018650939966807,4393054858,4343043222.8,18.477566098918984,31.146196423614217,NaN,NaN,-5.83777280587901,-3.4552113533120568
2011-12-21T09:30:00-05:00,55.64,55.64,54.4875,55.13,78552000,53375344,46.339040815431694,48.90673757581563,NaN,NaN,-36.40457365410176,-32.63787731650858,-0.0838966967504175,-0.30673596493470257,-0.22283926818428507,4314502858,4334786989.2,17.94825544893648,30.249380332868334,NaN,NaN,-6.095074286379144,-3.8323346294644978
2011-12-22T09:30:00-05:00,55.22,55.6261,55.17,55.60001,40334016,52968678.4,48.91337756715012,48.63275612323792,NaN,NaN,-19.938810312679248,-27.965771153801633,-0.04211097393554364,-0.2754779856037146,-0.23336701166817098,4354836874,4346344122,21.34486602584029,29.359450103726825,NaN,NaN,-5.531879795336597,-4.0751267960176545
2011-12-23T09:30:00-05:00,55.67999,56.08,55.58099,56.08,26594528,53026012,51.47369561820335,48.35618117634776,NaN,NaN,2.543854094599826,-21.18613132765018,0.019046437395007304,-0.20955896492441184,-0.22860540231941914,4381431402,4351024419.6,22.739699558652646,28.35860513127787,NaN,NaN,-4.29595272751269,-4.106673357659802
2011-12-27T09:30:00-05:00,56.00999,56.42,55.92999,56.24001,21443440,51762649.6,52.3313633635397,48.20033931457939,NaN,NaN,20.94787365339014,-5.495362089130116,0.06867588848354172,-0.14276054171499197,-0.2114364301985337,4402874842,4369340166.8,28.11231387049591,27.493778921593066,NaN,NaN,-3.034825030163001,-3.953552168017402
2011-12-28T09:30:00-05:00,56.17,56.25999,55.44,55.59,38189536,51069296,48.575444200191114,47.77621751257184,NaN,NaN,-26.087286183088715,-11.787788480375948,0.056628069304100886,-0.14065134356840758,-0.19727941287250847,4364685306,4363666256.4,27.474919509666037,26.55017548552393,NaN,NaN,-3.013625031441871,-3.819276862792326
2011-12-29T09:30:00-05:00,55.67999,56.03,55.5,55.99001,28077808,49127261.6,50.91040262044783,47.88784072100485,NaN,NaN,-16.773473823494403,-7.861568514254477,0.07343445513463737,-0.10548634395421175,-0.17892079908884911,4392763114,4379318307.6,32.05173560218559,26.12607155805446,NaN,NaN,-2.3310903402510714,-3.6066787881435753
2011-12-30T09:30:00-05:00,55.86,56.12,55.82001,55.83,21832336,47950804.8,49.93369788879793,47.61379379688649,NaN,NaN,-4.97301732989871,-4.8684099176983695,0.07153853908143265,-0.08949762523705829,-0.16103616431849094,4370930778,4382537088.4,32.98828523764614,25.74748909944026,NaN,NaN,-2.029596103914242,-3.381381261825099
2012-01-03T09:30:00-05:00,56.91,57.19,56.75,56.89999,39512880,48079532,56.011089754011465,48.01456666345685,NaN,NaN,100.42717348807508,14.708253960996682,0.13635244527805698,0.009404392279080298,-0.12694805299897668,4410443658,4388339539.6,34.734669271163625,25.694638528573414,NaN,NaN,0.031460597023739184,-2.8938324248466936
2012-01-04T09:30:00-05:00,56.8,57.22,56.56,57.14,29403360,47524605.6,57.26422406073738,48.72580125781821,NaN,NaN,107.27137772278701,31.972954774876058,0.18630296419469256,0.10593065224438902,-0.08037231195030353,4439847018,4395733974.8,36.9883283366534,26.044418444115113,NaN,NaN,2.106695225102007,-2.1794713319968793
2012-01-05T09:30:00-05:00,57.02,57.66,56.8,57.61,41260528,47654158.4,59.68615545984755,49.896825805272854,NaN,NaN,144.04699643131394,65.99981129775658,0.23857171353576878,0.21784232996940744,-0.020729383566361337,4481107546,4419018422.8,43.59345016490893,27.177473337235334,NaN,NaN,4.585552669036279,-1.2130393318492854
2012-01-06T09:30:00-05:00,57.64999,57.94,57.39999,57.81,46325168,47741608.8,60.70663954763426,51.188714826173054,NaN,NaN,166.07490526357577,102.56948711517062,0.2717789481608174,0.31899430163466036,0.04721535347384301,4527432714,4445952342.8,50.108326881781316,29.03715117666166,NaN,NaN,6.948649849980895,-0.047083734444973935
2012-01-09T09:30:00-05:00,57.95,57.98,57.431,57.62,39195456,47116753.6,59.174167829637334,52.31708491151154,NaN,NaN,141.85842999245313,131.935776579641,0.26578968844638284,0.37945246403182153,0.11366277558543872,4488237258,4469413638.8,54.98548014975987,31.45392678808886,NaN,NaN,8.53742712111527,1.1792749592064893
2012-01-10T09:30:00-05:00,58.25999,58.405,57.6398,58.03999,35949856,46126353.6,61.48845500949796,53.796912299773325,NaN,NaN,153.11990417064322,142.47432271615463,0.27386914062170753,0.4559992013625731,0.1821300607408656,4524187114,4492162330,59.154828303059304,34.33590888997629,NaN,NaN,10.556403941380688,2.5188648138028036
2012-01-11T09:30:00-05:00,58.02,58.28999,57.81,58.16,37144048,45212971.2,62.14873146571387,54.639748942917265,NaN,NaN,134.5539369971069,147.93083457101858,0.2705748246580597,0.5203485915634403,0.24977376690538056,4561331162,4516459158.8,63.08732952842295,37.52232056351228,NaN,NaN,12.437225327821114,3.9357734586625623
2012-01-12T09:30:00-05:00,58.28999,58.47,57.86,58.39,26188208,43094497.6,63.44235573899229,55.86141429460016,NaN,NaN,122.48428079424536,143.61829144360487,0.2667269547440787,0.5831824603354789,0.31645550559140023,4587519370,4537741523.6,66.16063233532701,40.96606176968307,NaN,NaN,14.40096154790644,5.430800328554545
2012-01-13T09:30:00-05:00,58.10001,58.2,57.67999,58.17999,35985088,41709616.8,61.37959637346346,56.75185849505112,NaN,NaN,95.6485548628865,129.53302136346701,0.23404550469775742,0.609012386463597,0.3749668817658396,4551534282,4542561837.2,66.83416842560544,44.21529765538059,NaN,NaN,15.570804552653266,6.879372360568648
2012-01-17T09:30:00-05:00,58.71001,58.96001,58.49001,58.71001,41790752,40862513.6,64.51538201462063,57.68340752336663,NaN,NaN,123.24645228559181,125.81062582209476,0.23169848954596262,0.6645899936982929,0.43289150415233024,4593325034,4563579392.4,69.6689384364576,47.567386146652375,NaN,NaN,17.465179304636244,8.391630495435447
2012-01-18T09:30:00-05:00,58.84,59.49001,58.68221,59.49001,48692624,40248209.6,68.56100362705904,58.84266754218944,NaN,NaN,137.4166072845299,122.6699664448721,0.2639125967985933,0.7627822501505719,0.4988696533519786,4642017658,4587145501.2,72.50651208997624,50.73840030518668,NaN,NaN,20.3640179532689,10.101971560840225
2012-01-19T09:30:00-05:00,59.75999,59.97,59.64999,59.86,47774416,40300240,70.29125611832491,60.393796964913285,NaN,NaN,155.4649896180845,126.85217696906761,0.2893328387466192,0.8605357017852526,0.5712028630386334,4689792074,4612837683.6,75.22750315632152,54.149299137090644,NaN,NaN,23.35220421062371,11.994861939380723
2012-01-20T09:30:00-05:00,59.61,59.8,59.56,59.77,41050560,38264830.4,69.2922623996707,61.7067869491435,NaN,NaN,132.89223536804178,128.93376788382687,0.27914731120788083,0.9201370020484845,0.6409896908406036,4648741514,4625082112.4,76.42499164918533,57.318817426162056,NaN,NaN,25.567639097114448,13.933830104771255
2012-01-23T09:30:00-05:00,59.8,60.21001,59.44,59.78999,40964624,36385461.6,69.39630000736611,63.096972814755496,NaN,NaN,126.97546317848429,135.19914954694644,0.2535617909929627,0.957941929581807,0.7043801385888443,4689706138,4652716483.6,78.90358850880578,60.5984819455306,NaN,NaN,27.444053896142705,15.863862074967177
2012-01-24T09:30:00-05:00,59.53999,59.84,59.41,59.67999,38440192,36290770.4,68.03042704594108,63.95549690703619,NaN,NaN,107.96395199460811,132.14264948874973,0.2107915122321754,0.9678695288790635,0.7570780166468881,4651265946,4664304666,79.85983001473474,63.821707712928536,NaN,NaN,28.69980095183935,17.69756762880606
2012-01-25T09:30:00-05:00,60.28,60.58,59.8335,60.42999,61591776,38040632.8,72.067260114558,65.01285662516624,NaN,NaN,131.15845952556947,130.89101993695763,0.21389500281418217,1.0244467701646158,0.8105517673504337,4712857722,4678472678.8,80.99412293101699,66.96497875538309,NaN,NaN,30.99566790075663,19.597296239084713
2012-01-26T09:30:00-05:00,60.67,60.8,59.92999,60.22,37852656,38861093.6,69.42402509781357,65.7084187421638,NaN,NaN,118.03992754811878,123.4060075229645,0.18383676412682814,1.0403477225089688,0.8565109583821406,4675005066,4675515277.2,79.9815232056026,69.56412682971835,NaN,NaN,32.232238732846604,21.40228802390784
2012-01-27T09:30:00-05:00,60.09,60.50999,60.06,60.39999,45540384,39228636,70.42529828794846,66.40260865218625,NaN,NaN,105.38944790385297,117.90545003012673,0.1590377098875857,1.0553080957416228,0.8962703858540371,4720545450,4689876064.4,81.2099913656954,71.78567429285506,NaN,NaN,33.555975750119835,23.13852912765241
2012-01-30T09:30:00-05:00,59.88,60.53999,59.66,60.45,42797536,39964622.4,70.71227789107172,67.22675937086014,NaN,NaN,90.2981207794098,110.56998155031184,0.13017751892092022,1.0589922845051873,0.9288147655842671,4763342986,4704603434,82.40263871916758,73.74404276209847,NaN,NaN,34.74583711363734,24.796715982793117
2012-01-31T09:30:00-05:00,60.75,60.86,60.14,60.53,51449600,41445485.6,71.19381986159466,67.91999971743847,NaN,NaN,98.2739801398612,108.63198717936245,0.1019019758705525,1.0561922354224578,0.9542902595519053,4814792586,4737308762,84.72182000387832,75.57025645501412,NaN,NaN,35.88514704458785,26.38077756304951
2012-02-01T09:30:00-05:00,60.85001,61.24001,60.66,61.02,46146672,41777175.2,74.01225429051131,68.767394204924,NaN,NaN,115.36462689253813,105.47322065275617,0.1014081164470031,1.081050405110659,0.979642288663656,4860939258,4766925069.2,86.46180318866791,77.23986171646018,NaN,NaN,37.682286334103146,27.995278816057173
2012-02-02T09:30:00-05:00,61.2,61.41,60.97,61.21001,46373504,42625682.4,75.03240432193661,69.59525481799145,NaN,NaN,119.91451472249622,105.84813808763165,0.09897737644834503,1.1033640092240873,1.0043866327757422,4907312762,4813386608.4,88.64632868038727,78.84598288396448,NaN,NaN,39.505947762294454,29.63966009409107
2012-02-03T09:30:00-05:00,61.78,62.12,61.6799,62.05,36453760,42385344,78.96378715090101,70.85126844495127,NaN,NaN,154.37096214233034,115.64444093532714,0.136714676302369,1.1752799781537036,1.0385653018513346,4943766522,4858030822.8,90.27085658021375,80.52003203786509,NaN,NaN,42.41183805938191,31.464256946275476
2012-02-06T09:30:00-05:00,61.82001,62.02,61.66,62,28541040,41496137.6,78.17471720123248,71.82693524399498,NaN,NaN,140.61718070647035,125.70825292073923,0.14054159071262173,1.2142422902421117,1.07370069952949,4915225482,4888407322,91.19411078399142,82.05754434840321,NaN,NaN,44.57185833186526,33.33677142993116
2012-02-07T09:30:00-05:00,61.95,62.25,61.67,62.13,37935696,41433149.6,78.76876424547305,72.55606100245312,NaN,NaN,135.32645887273338,133.1187486673137,0.13408037607629164,1.2413011696248546,1.107220793548563,4953161178,4916081040.4,91.94413193780352,83.44594576610517,NaN,NaN,46.555659898717394,35.22518406832919
2012-02-08T09:30:00-05:00,62.14,62.46001,61.91,62.46001,41171072,41694210.4,80.239161740871,73.26662568977784,NaN,NaN,138.56785292816937,137.75939387443992,0.13396804365705228,1.2746808481198784,1.140712804462826,4994332250,4942759638.8,92.59860815279956,84.68673898013931,NaN,NaN,48.7073240166484,37.15120406094622
2012-02-09T09:30:00-05:00,62.67,62.98,62.32001,62.91,46856288,42179822.4,82.06331799346964,74.17884394647776,NaN,NaN,150.16552608052802,143.80959614604632,0.14519245929864422,1.3222033785861314,1.1770109192874871,5041188538,4969534794,93.19605084520818,85.88467177985522,NaN,NaN,51.15081472960779,39.15114844218359
2012-02-10T09:30:00-05:00,62.47,62.64,62.25,62.47501,58093568,43775090.4,74.86854403743409,74.56971852005404,NaN,NaN,115.71601112563324,136.07860594270687,0.1061258474705391,1.309668228625661,1.2035423811551218,4983094970,4977400483.6,93.36547760719543,86.91766385831163,NaN,NaN,51.152555491713045,40.865635163544944
2012-02-13T09:30:00-05:00,62.92999,63.13,62.64999,63.05,36810176,43816344.8,77.65706552468855,75.25733555425029,NaN,NaN,129.37217867979362,133.82960553737152,0.10179841209920992,1.3307903962791343,1.2289919841799244,5019905146,4998336416.4,93.80748374638404,87.91392483914373,NaN,NaN,51.9968081272071,42.4558027297824
2012-02-14T09:30:00-05:00,62.89999,63.22,62.69,63.21001,51685264,44311070.4,78.37611950575399,75.70796836790714,NaN,NaN,120.62095443378743,130.88850464958233,0.09275659753027665,1.3449377310927702,1.2521811335624935,5071590410,5022022262.8,94.27239788550908,88.86237305017887,NaN,NaN,52.90126493929207,43.94801161685521
2012-02-15T09:30:00-05:00,63.52,63.86,62.67,62.77,105708880,47161883.2,71.55635184802517,75.86027742149369,NaN,NaN,110.82757058215293,125.34044818037906,0.04273060258121375,1.3055943867890107,1.262863784207797,4965881530,5016332118.8,92.47619827226748,89.75484984065494,NaN,NaN,51.585830685919795,45.03912862672158
2012-02-16T09:30:00-05:00,62.78999,63.7,62.63,63.63,83642256,48955275.2,75.95938523706766,76.25556934643078,NaN,NaN,110.44270044163295,117.39588305260004,0.052505172137470746,1.3284952493796354,1.2759900772421646,5049523786,5017999168.4,92.52115704076112,90.56279024601677,NaN,NaN,51.80042569251949,46.00502820754985
2012-02-17T09:30:00-05:00,63.64,63.69,63.14999,63.42999,76112256,50708360,73.12429859102264,76.42785653928442,NaN,NaN,106.12776321118892,115.47823346971117,0.0314821461769883,1.3153427599634,1.2838606137864117,4973411530,5016062480.4,91.83459591851631,91.23650147454168,NaN,NaN,51.06383977315616,46.72771557406504
2012-02-21T09:30:00-05:00,63.50999,63.89,63.21001,63.61,38141232,50567190.4,74.06259702204113,76.63276919360202,NaN,NaN,106.58004694284743,110.91980712232194,0.016438080179617787,1.3044082140109339,1.287970133831316,5011552762,5014392003.6,91.20592025093083,91.6996514921883,NaN,NaN,50.7455274593346,47.30168870053212
2012-02-22T09:30:00-05:00,63.49001,63.67999,63.23,63.32001,43174688,50803915.2,69.83287176819555,76.33424187057946,NaN,NaN,91.25862479489476,105.0473411945434,-0.024101622449973714,1.257843105768849,1.2819447282188228,4968378074,4993749536.4,83.59067326242914,91.49457078317123,NaN,NaN,49.184623571183295,47.57067939633943
2012-02-23T09:30:00-05:00,63.39999,63.81,63.09,63.74001,54249248,50436788.8,72.30027240024022,76.1390895904583,NaN,NaN,91.90928835268967,101.26368474865076,-0.0331315023808354,1.2405303502427785,1.2736618526236139,5022627322,5005098694.8,84.36367825656143,91.1886671814694,NaN,NaN,48.58269905719036,47.71525363360385
2012-02-24T09:30:00-05:00,63.92,64.07001,63.8,63.96001,41369696,50612640.8,73.52193161614125,75.75038562368975,NaN,NaN,109.77346338225921,101.12983733677599,-0.03462629403148498,1.2303789850842577,1.2650052791157427,5063997018,5007993341.2,84.56341561127238,90.78099282654502,NaN,NaN,48.44389205810391,47.81934483710386
2012-02-27T09:30:00-05:00,63.60001,64.25999,63.33,64.05,42678416,50469542.4,74.02654704029027,75.454087755051,NaN,NaN,98.62563735410141,99.6294121653585,-0.039537893023318116,1.2155829128365951,1.2551208058599133,5106675434,5034646122,86.29886847570573,90.43133266166747,NaN,NaN,48.47357749416292,47.91280664525516
2012-02-28T09:30:00-05:00,64.10001,64.7,64.03,64.7,43727280,50516029.6,77.37985469421555,75.35487992996119,NaN,NaN,135.27144289351554,105.36769135549211,-0.010504961756438558,1.241989603664365,1.2524945654208035,5150402714,5062416112.4,87.83362878676562,90.13772529373618,NaN,NaN,49.52036470772608,48.14245779703672
2012-02-29T09:30:00-05:00,64.74001,64.96001,64.2,64.41,59784400,50932769.6,72.86021823688064,74.82781253681902,NaN,NaN,132.9362218708339,113.70321077067993,-0.02168287182571449,1.2253909756386605,1.247073847464375,5090618314,5086864160.4,89.00168421688821,89.8808021554568,NaN,NaN,49.02369599556508,48.268348968255054
2012-03-01T09:30:00-05:00,64.66,64.98,64.46001,64.92,67558816,52003376.8,75.56338871309265,74.36353187393495,NaN,NaN,145.12720847954412,124.34679479605083,-0.006374643009567915,1.239105543702415,1.245480186711983,5158177130,5113974122,90.13293706110646,89.66200831373524,NaN,NaN,49.42520084482614,48.433613522050926
2012-03-02T09:30:00-05:00,64.83,65.0784,64.66,64.87,33358160,51352609.6,74.77703160448111,74.35699527158117,NaN,NaN,141.41560881721026,130.67522388304104,-0.010991260749025455,1.231741110775701,1.2427323715247265,5124818970,5126138512.4,90.60013533624212,89.46448386581002,NaN,NaN,49.51446038554043,48.58802021683514
2012-03-05T09:30:00-05:00,64.83,64.91,63.99001,64.2,45788688,51819356,65.01360782856109,73.45389115042921,NaN,NaN,88.01964771880543,128.55402595598184,-0.06739627583101737,1.1584870267359548,1.2258833025669722,5079030282,5120609482,88.54786421448979,89.08879675638899,NaN,NaN,46.50927137885271,48.291056097123366
2012-03-06T09:30:00-05:00,63.59,63.72,63.23,63.57001,54638576,53124232.8,57.42166025081191,71.9571440607905,NaN,NaN,-0.3019454116798602,101.43934829494275,-0.15059745648902823,1.037636481955687,1.1882339384447151,5024391706,5095407280.4,79.68715661543231,88.04699380852637,NaN,NaN,41.362504198565055,47.3012629687579
2012-03-07T09:30:00-05:00,63.86,64.21001,63.77,64.06,42741792,53364537.6,61.21523258294512,71.21849268471335,NaN,NaN,45.00015317732524,83.85213455624101,-0.17441466203998535,0.9702156108947335,1.1446302729347189,5067133498,5090710317.2,78.11821782288115,87.02142377642734,NaN,NaN,38.246747574840555,46.00776076962685
2012-03-08T09:30:00-05:00,64.42,64.94,64.3,64.75,43711008,53491534.4,65.83188542497945,70.49509984099276,NaN,NaN,104.46707938941158,75.72010873821452,-0.14660090794616232,0.961379138002016,1.1079800459481783,5110844506,5081243792.4,74.91671068674394,85.76396332256897,NaN,NaN,37.11231541003214,44.73698286111332
2012-03-09T09:30:00-05:00,64.85001,65.14,64.82001,65.02,43117168,53304578.4,67.46392449322693,70.09078740543592,NaN,NaN,125.865619916242,72.61011095802088,-0.11435319723442783,0.9650385494051434,1.0793917466395713,5153961674,5087072333.2,75.58029559035457,84.6029418705574,NaN,NaN,36.73602305372693,43.59398860291526
2012-03-12T09:30:00-04:00,64.97,65.11,64.72,65.05,32687296,52034264.8,67.6488265525624,69.6326609433303,NaN,NaN,111.25312524997366,77.25680646425454,-0.09607245194539926,0.9593011817078221,1.0553736336532213,5186648970,5108596070.8,77.90490704900837,83.65286949899152,NaN,NaN,36.49687093543091,42.5801146504175
2012-03-13T09:30:00-04:00,65.42,66.25999,65.27,66.25999,61558512,53271681.6,74.05354236721605,69.9341374146889,NaN,NaN,185.34595593684213,114.38638673395891,-0.011981063194147268,1.0403973046605373,1.0523783678546845,5248207482,5153359226,81.78783427109778,83.52409528532498,NaN,NaN,38.495143975255466,41.99654741110864
2012-03-14T09:30:00-04:00,66.31,66.74001,66.08,66.49001,59926896,53683763.2,75.06419457280812,70.13156042701519,NaN,NaN,200.6323306608996,145.51282223067378,0.0464388636175741,1.1104269473766522,1.063988083759078,5308134378,5201559402,84.8709374126422,83.5603280821879,NaN,NaN,40.414980662947066,41.770609304228415
2012-03-15T09:30:00-04:00,66.69,66.82001,66.35001,66.67999,65531136,51674876,75.89918658792487,70.30136435357116,NaN,NaN,188.0809279835279,162.23559194949706,0.08304484350357488,1.1677941381385466,1.0847492946349717,5373665514,5254123603.6,87.38000217773089,83.76151283693494,NaN,NaN,42.22115655719188,41.83497319750891
2012-03-16T09:30:00-04:00,66.64999,66.67,66.36,66.52,53023024,50143914.4,73.66215068152543,70.2753360422308,NaN,NaN,154.4808451883304,167.95863700391473,0.08153577430591907,1.1866690125173704,1.1051332382114514,5320642490,5287459766.8,88.664014943513,83.93045187034974,NaN,NaN,43.010437293374494,42.00289663977542
2012-03-19T09:30:00-04:00,66.62,67.14999,66.45,66.99001,60966112,49386607.2,75.90860089857028,70.170246485399,NaN,NaN,156.13821472480356,176.93565489888073,0.09623533033727627,1.2254274011330466,1.1291920707957703,5381608602,5326451693.2,89.95179661714658,84.0817495725198,NaN,NaN,44.38489846067845,42.34318261419014
2012-03-20T09:30:00-04:00,66.66,67.185,66.46001,67.11,47290544,49844072.8,76.46059521459108,70.42741626952117,NaN,NaN,136.66806259606835,167.20007623072598,0.09776676515822125,1.251400527243547,1.1536337620853256,5428899146,5362590026,90.97509802876793,84.22270770193977,NaN,NaN,45.668283944141855,42.81819708989753
2012-03-21T09:30:00-04:00,67.13,67.49001,67.03,67.12,39648096,49667743.2,76.50890282053577,70.49495299148141,NaN,NaN,131.7251679984078,153.4186436982276,0.08372226129218485,1.2582865887005568,1.174564327408372,5468547242,5394672598.8,91.77583978683212,84.34005789663446,NaN,NaN,46.7242826255767,43.37620930928027
2012-03-22T09:30:00-04:00,66.71001,67.14,66.67999,66.98,56960464,49803304,74.21269618847771,70.45464331890973,NaN,NaN,98.96848548163459,135.59615519784893,0.05088782737192665,1.2381741116232803,1.1872862842513536,5411586778,5402256851.6,91.95750389809687,84.43701279390982,NaN,NaN,46.99123192602316,43.89264111167211
2012-03-23T09:30:00-04:00,67.06,67.08,66.56,66.939,45547680,50012203.2,73.51682915137737,71.06201627053947,NaN,NaN,83.75186332739217,121.45035882566128,0.014199429663360963,1.205035571330555,1.190836141667194,5366039098,5411336173.2,92.18019296480614,84.69646484750385,NaN,NaN,47.03174652734406,44.341084742482394
2012-03-26T09:30:00-04:00,67.37,68.11,67.33,68.11,40855232,49921044,79.44502697419598,72.63511389363833,NaN,NaN,126.79234539233035,115.58118495916665,0.054333353723118094,1.2587528338210916,1.2044194800979735,5406894330,5416393318.8,92.30795059356383,85.5979501316561,NaN,NaN,48.921283112771114,44.99539879538078
2012-03-27T09:30:00-04:00,68.145,68.49001,68.13,68.21001,37278176,49598588.8,79.85968509722984,73.96686050180153,NaN,NaN,134.420516950615,115.13167583007598,0.0720422176784794,1.2944722521960728,1.2224300345175934,5444172506,5419447990.8,92.38883886088949,86.61728020579956,NaN,NaN,50.57455501222704,45.7924211120731
2012-03-28T09:30:00-04:00,68.25,68.50999,67.53999,67.938,44421856,48830461.6,75.40420063787255,74.65059730272246,NaN,NaN,107.80363971605091,110.3473701736046,0.050861514414765496,1.2860069275360502,1.2351454131212847,5399750650,5405688672.4,87.90476355397237,87.54499826774443,NaN,NaN,50.6576801258958,46.48745811404777
2012-03-29T09:30:00-04:00,67.61,67.92999,67.2,67.67999,53975296,48151285.6,71.33856848919731,74.92735758814891,NaN,NaN,79.32269484283937,106.41821204584554,0.007193434912667218,1.2441372067621188,1.2369437718494516,5345775354,5392526387.6,83.7188001191897,88.12632001980408,NaN,NaN,49.53471440189504,46.922780440883095
2012-03-30T09:30:00-04:00,67.99001,68.02,67.28,67.55,39480224,48457388.8,69.31092170102177,75.04607867018173,NaN,NaN,74.5554996722642,104.57893931481995,-0.040126601448512655,1.1867855200388107,1.2269121214873233,5306295130,5380577594,79.99469717122176,88.27559074281932,NaN,NaN,48.02155895669767,47.079748800285174
2012-04-02T09:30:00-04:00,67.46001,68.34,67.36,68.25,40031536,48169531.2,73.65363705057642,75.01751400470746,NaN,NaN,91.40743403074606,97.5019570425031,-0.034195539686589616,1.1841676968790864,1.218363236565676,5346326666,5368464061.2,76.28963366946763,87.88286212841717,NaN,NaN,47.936799428361894,47.202184604296136
2012-04-03T09:30:00-04:00,68.31,68.55,67.85001,68.23,45539664,47714585.6,73.33433514051484,74.89395261668652,NaN,NaN,102.73279441947864,91.16441253627582,-0.04106941672122022,1.1670264656641507,1.208095882385371,5300787002,5339786960.4,68.23259492824795,86.6944090938176,NaN,NaN,47.7760006039455,47.28415831853176
2012-04-04T09:30:00-04:00,67.73,67.75999,66.91,67.3,54087968,48281894.4,60.25370385632257,73.77641813585778,NaN,NaN,35.57542261126887,76.7187691153194,-0.11358930989381877,1.0661092450180973,1.179698554911916,5246699034,5309176637.2,60.845772072494114,84.79910694344355,NaN,NaN,43.37172207270299,46.72523885484193
2012-04-05T09:30:00-04:00,67.19,67.78,67.13,67.72,42938464,48243267.2,63.426477980910754,73.04529865724245,NaN,NaN,46.717257750315156,70.19768169681456,-0.13704050240562005,1.008397926904891,1.145438429310511,5289637498,5297949066,58.35052722910906,82.63385782098612,NaN,NaN,40.68556597943406,45.86242844406938
2012-04-09T09:30:00-04:00,66.88,67.48,66.75999,67.21001,36908144,47932816,57.43147360917829,71.72550385085731,NaN,NaN,1.0672726205225553,55.50003628646624,-0.18754447984757272,0.9110078295010453,1.098552309348618,5252729354,5287235910.8,55.99104038646174,80.20808951879432,NaN,NaN,36.42062525396123,44.51359941691107
2012-04-10T09:30:00-04:00,67.19,67.44,65.92,66.13,69254192,49761160.8,47.246896626863915,69.63881109459109,NaN,NaN,-88.0839598399646,19.60175751232412,-0.2883070097562712,0.7381685471532791,1.0264755569095503,5183475162,5254665610,49.44492635789939,77.24164868516087,NaN,NaN,28.838170554739424,42.27425243660083
2012-04-11T09:30:00-04:00,66.705,66.89,66.28,66.45,62949952,49830732.8,50.072060005438836,67.750465179227,NaN,NaN,-91.10229452874593,-19.16526027732079,-0.32528601084602915,0.6198680433520138,0.945154054198043,5246425114,5243793232.4,47.45060903829082,74.07556077455078,NaN,NaN,23.80766303252262,39.63616823601823
2012-04-12T09:30:00-04:00,66.58,67.28,66.4807,67.205,57407344,49704755.2,56.05223635846317,66.45328947708312,NaN,NaN,-38.74387302771516,-34.02911940511759,-0.2918461550443687,0.580346360392582,0.8721925154369508,5303832458,5255219917.2,49.74482208559325,71.06036921651481,NaN,NaN,21.637728145175807,37.06496250875502
2012-04-13T09:30:00-04:00,66.96001,67.20219,66.16,66.19,55227424,49189569.6,47.76867143604807,64.6141353545596,NaN,NaN,-100.89819252768082,-63.55220946071679,-0.3283141850164958,0.46179978416633105,0.7901139691828268,5248605034,5247013424.4,48.11997143874068,67.91321053608156,NaN,NaN,16.69530109309459,34.15501087794639
2012-04-16T09:30:00-04:00,66.53,66.56,65.24001,65.45,57587264,49417781.6,42.80227329938188,61.99679580635859,NaN,NaN,-185.75299443907335,-100.91626287263597,-0.38838925707048066,0.30462739784472603,0.6930166549152067,5191017770,5234671107.6,45.70214073033377,64.58422411727942,NaN,NaN,10.827613027770429,30.822525470778395
2012-04-17T09:30:00-04:00,65.75,66.99001,65.63,66.78,47362400,48737596,52.384222322207926,60.03426275099989,NaN,NaN,-90.36074206654096,-101.37161931795124,-0.3271237494280471,0.28411196813014783,0.611235717558195,5238380170,5245652109.2,48.1961195963615,61.42760131267027,NaN,NaN,9.513325969030321,27.778354113385813
2012-04-18T09:30:00-04:00,66.59,67,66.41,66.61,42536000,48499868.8,51.20347628032982,58.30563958260399,NaN,NaN,-62.42362470092856,-95.63588535238776,-0.2879968708678746,0.2512396289733516,0.5392364998412262,5195844170,5235535920.4,46.095588663271,58.44123167762017,NaN,NaN,8.112778310805513,24.968986141588626
2012-04-19T09:30:00-04:00,66.38,67.17,65.62,65.86,81110256,50572976.8,46.2504669647978,56.51363233086117,NaN,NaN,-102.7309216608169,-108.43329507900812,-0.30115499363791065,0.16279275779383795,0.4639477514317486,5114733914,5197716211.6,39.21460144072366,55.26236034344402,NaN,NaN,5.196708141145718,22.144374998668212
2012-04-20T09:30:00-04:00,66.22,66.50999,65.58,65.67999,59906832,50720295.2,45.122280738956846,54.785872262142234,NaN,NaN,-119.50087425592794,-112.15383142465755,-0.30933274842723407,0.077281815897706,0.38661456432494007,5054827082,5158960621.2,33.66819074218445,51.953324169941354,NaN,NaN,2.570618668070383,19.348124094297095
2012-04-23T09:30:00-04:00,65.08,65.17999,64.49001,65.08,70514128,51968617.6,41.489532691885344,52.48843623652145,NaN,NaN,-184.59190204459105,-111.92161294576108,-0.3400573241777435,-0.038457090897239254,0.3016002332805042,4984312954,5117619658,28.96242728356539,48.5728094280912,NaN,NaN,-0.8137624715973563,16.467854584883604
2012-04-24T09:30:00-04:00,64.97,65.23,64.45,64.73,49661440,52408928,39.49213929196314,50.07113653305347,NaN,NaN,-166.50684644965537,-127.15083382238394,-0.3665743402653173,-0.1566176920511424,0.2099566482141749,4934651514,5056873926.8,23.7169104579295,45.3931176802113,NaN,NaN,-4.191254378158063,13.51655330444908
2012-04-25T09:30:00-04:00,66.06,66.49001,65.97,66.45,57526768,53421357.6,51.778220599457576,49.46574487184883,NaN,NaN,-38.99673850700347,-122.46545658359894,-0.2561260124951453,-0.11020086740475676,0.14592514509038856,4992178282,5016140749.2,20.97377562046924,42.5451179336381,NaN,NaN,-2.9121064166269837,11.169601915723927
2012-04-26T09:30:00-04:00,66.42,66.99001,66.35001,66.84,41799488,53290239.2,54.05619775292625,48.796439141278505,NaN,NaN,3.7414787522032653,-101.17097650099491,-0.14991407438956292,-0.04146744789656509,0.10844662649299783,5033977770,4999989520.4,19.986653060348118,39.80484120729803,NaN,NaN,-1.1177774487659438,9.414262006511088
2012-04-27T09:30:00-04:00,67.12,67.45,66.77,67.24001,46012480,52892098.4,56.334620441167324,48.71809248642058,NaN,NaN,48.45277820579086,-67.58024600865114,-0.05094472924078494,0.04476571494201664,0.09571044418280159,5079990250,5005022154,21.23066927826038,37.32195755671223,NaN,NaN,1.0794853266088864,8.223579623667916
2012-04-30T09:30:00-04:00,67.02,67.17,66.71001,66.75999,37787616,52807468,52.94166522401945,49.12486167193169,NaN,NaN,26.42980754650753,-25.37590409043143,-0.01774838300324466,0.07352496542874576,0.09127334843199042,5042202634,5016600090,24.152307859337583,35.51534194967209,NaN,NaN,1.784271606236109,7.303678478320515
2012-05-01T09:30:00-04:00,66.67999,67.63,66.59,66.87,37643728,52688077.6,53.63093402064496,49.37906695873213,NaN,NaN,51.01593094230882,18.128651387961405,0.010177302764651314,0.10399497688780457,0.09381767412315326,5079846362,5045639059.6,31.059167056459216,34.34452466525555,NaN,NaN,2.5555444283672535,6.625373614041478
2012-05-02T09:30:00-04:00,66.5,67.11,66.38,67.06,38299216,52326055.2,54.8606738916711,49.293955353961266,NaN,NaN,43.05041779073484,34.538082647509064,0.03841710886401166,0.14183906020316783,0.10342195133915617,5118145578,5070832518.8,36.46476976714982,33.395949499652446,NaN,NaN,3.5495577038307107,6.185971341154225
2012-05-03T09:30:00-04:00,67.10001,67.14999,66.175,66.35001,51307360,52187024.8,49.570262562335984,49.422640434410404,NaN,NaN,11.327901615913639,36.05536722025114,0.00785060258045979,0.1132352045647309,0.10538460198427112,5066838218,5077404608.4,37.83413696719513,32.661247037399185,NaN,NaN,2.833330882354392,5.707022704182821
2012-05-04T09:30:00-04:00,65.75,66.3524,64.69,64.7,107553936,55417798.4,39.93254277811648,49.217659682891444,NaN,NaN,-138.41863891816772,-1.3189162045405758,-0.11797998772212981,-0.04209038266839116,0.07588960505373865,4959284282,5053263414.8,34.86181876871957,31.886938325855315,NaN,NaN,-1.1350264011336295,4.729587117709042
2012-05-07T09:30:00-04:00,64.31,65.07001,64.28999,64.75999,50266736,56085728,40.386354516631606,48.36066912535028,NaN,NaN,-167.35563701502863,-40.07600511684781,-0.18752690746188697,-0.15851902927362005,0.02900787818826691,5009551018,5046733091.6,34.081818330958114,30.878773949755075,NaN,NaN,-4.067864941128942,3.4728082521607586
2012-05-08T09:30:00-04:00,64.34,64.74001,63.48,64.52,72659680,56256002.4,39.11326337249192,47.49708248907614,NaN,NaN,-171.99343194780502,-84.67787769487057,-0.23686715947228543,-0.26707607115208987,-0.030208911679804447,4936891338,5018142086.8,30.82951581251679,29.788340174701208,NaN,NaN,-6.835482388170198,2.0001953035420508
2012-05-09T09:30:00-04:00,63.77,64.67999,63.50999,64.321,85715248,57394267.2,38.04239208272508,46.91079142607094,NaN,NaN,-147.7093004880762,-122.82982135063278,-0.26780001186721386,-0.3649589265138218,-0.09715891464660792,4851176090,4964748189.2,25.865473251560303,28.83483101833239,NaN,NaN,-9.418059876563575,0.3690159920983902
2012-05-10T09:30:00-04:00,64.61,64.63,63.95,64.19,49448864,56996343.2,37.3180641517979,46.35334738413103,NaN,NaN,-121.36972450988021,-149.36934657579155,-0.280623940020102,-0.4479388396717354,-0.16731489965163343,4801727226,4911725990.8,22.065852187866014,28.00609255016679,NaN,NaN,-11.750417870883366,-1.362331702613289
2012-05-11T09:30:00-04:00,63.94,64.86,63.91,64.17999,47106688,56590306.4,37.25968549946453,46.05121544181526,NaN,NaN,-102.09209804202477,-142.10403840056296,-0.2730643959129075,-0.5086453945427678,-0.23558099862986032,4754620538,4870793242,19.664279384584987,27.341939128811052,NaN,NaN,-13.684504901938729,-3.1226421596597804
2012-05-14T09:30:00-04:00,63.63,64.08,63.48,63.58,46359984,56028942.4,33.84233234161535,45.647657802504696,NaN,NaN,-122.95432049470685,-133.2237750964986,-0.2901539463858597,-0.5982734316121849,-0.30811948522632526,4708260554,4810535149.2,16.770586376600406,26.845773123001837,NaN,NaN,-16.378034343412853,-5.016269614481648
2012-05-15T09:30:00-04:00,63.78999,64.27,63.25999,63.37,66908432,57006244,32.71146757766499,44.285746872376656,NaN,NaN,-112.56491519315043,-121.33807174556769,-0.29624763908621154,-0.6784290340840897,-0.3821813949978782,4641352122,4751427306,14.514341782879242,26.38438499174541,NaN,NaN,-18.970285008694926,-7.009700385083545
2012-05-16T09:30:00-04:00,63.62,63.78,62.81,62.94,52825904,57520739.2,30.46651577939396,42.60076958855292,NaN,NaN,-124.75382806406265,-116.74697726076496,-0.3084945774648481,-0.7677996168289383,-0.4593050393640902,4588526218,4698897331.6,12.858648065438516,25.875241777823295,NaN,NaN,-21.870506465508154,-9.13267268228706
2012-05-17T09:30:00-04:00,62.94,63.06,61.60001,61.61,62253440,56577898.4,24.797764613165683,40.348137029409955,NaN,NaN,-162.97816207916875,-125.0686647746227,-0.3806890221713439,-0.93516631707827,-0.5544772949069261,4526272778,4643806442,11.391060290790833,25.172412564432612,NaN,NaN,-26.483481638771423,-11.61135967607054
2012-05-18T09:30:00-04:00,61.78999,61.96001,60.75999,60.81,79496432,57557378.4,22.130430083552028,38.147334519376564,NaN,NaN,-182.60282258275984,-141.1708096827697,-0.4519818212704122,-1.1194545714949413,-0.6674727502245291,4446776346,4582237603.6,10.015311625581944,24.16262711916435,NaN,NaN,-31.364260331488463,-14.43320262684453
2012-05-21T09:30:00-04:00,60.92,62.57001,60.85001,62.50999,61471328,57105238.4,37.512056212783406,36.995986104529315,NaN,NaN,-125.00152357796487,-141.58025029942132,-0.3583985206712701,-1.1154709010636168,-0.7570723803923467,4508247674,4542235027.6,9.234908121103018,22.603751480924622,NaN,NaN,-30.35630962879124,-16.7079321985512
2012-05-22T09:30:00-04:00,62.66,62.95,61.989,62.44,62954720,57769902.4,37.18637505714385,35.73353618777737,NaN,NaN,-92.0006692398127,-137.46740110875376,-0.2785189920974327,-1.1052211205141376,-0.8267021284167049,4445292954,4503023194,8.533014787351462,20.60862612522474,NaN,NaN,-29.698367108424467,-18.563708614247382
2012-05-23T09:30:00-04:00,61.92999,62.71001,61.37,62.56,56951072,57741117.6,38.17743228835264,34.91976259677856,NaN,NaN,-93.97199891124167,-131.31103527818956,-0.19865662015506091,-1.075022903610531,-0.8763662834554701,4502244026,4485766755.6,8.236332837153924,18.49449725879322,NaN,NaN,-28.86691375135259,-20.035595062405267
2012-05-24T09:30:00-04:00,62.66,62.71001,61.69,62.14999,83129568,59807621.6,36.0826395303895,34.6447695076552,NaN,NaN,-88.38357192009512,-116.39211724637485,-0.156362740539019,-1.0718197091292438,-0.9154569685902249,4419114458,4464335091.6,7.870340849479291,16.56653455027606,NaN,NaN,-28.814165289057293,-21.289676523355556
2012-05-25T09:30:00-04:00,62.21001,62.3201,61.88989,62.07001,32082832,59111139.2,35.671464323243285,34.307991636698894,NaN,NaN,-83.7381215754205,-96.61917704490696,-0.11841505324290647,-1.0634757851438579,-0.9450607319009514,4387031626,4452386147.6,7.665812185559545,14.679676968461877,NaN,NaN,-28.890610217900885,-22.37552419400489
2012-05-29T09:30:00-04:00,62.63,63.14999,62.28,62.86,44221456,59432831.2,42.626006959711376,34.55890189292885,NaN,NaN,-47.697002795411045,-81.1582728883962,-0.029391410716130495,-0.9817999952961145,-0.952408584579984,4431253082,4436987229.2,7.398956482708982,13.006065587761322,NaN,NaN,-26.829061843619602,-23.011743858235562
2012-05-30T09:30:00-04:00,62.28999,62.55,61.67731,62.33,56431792,60372234.4,39.537734237798546,34.66571204686267,NaN,NaN,-69.08885933300719,-76.5759109070351,0.002807195505300397,-0.9488995901983586,-0.951706785703659,4374821290,4422892896.4,7.153499248004863,11.66949601607879,NaN,NaN,-26.003032610386047,-23.439070822828487
2012-05-31T09:30:00-04:00,62.25,62.41,61.59,62.06,55260016,61220274.4,38.026271930023846,34.71629831673595,NaN,NaN,-71.7579057550466,-72.13309227579607,0.014287260136838675,-0.9338477105326106,-0.9481349706694493,4319561274,4386356346,6.547146787101866,10.561017058881351,NaN,NaN,-25.764213401394777,-23.771234048337956
2012-06-01T09:30:00-04:00,60.97,61.32001,60.39,60.409,71430752,62226444,30.378711948882398,34.22480020598009,NaN,NaN,-139.9698973155686,-82.45035735489077,-0.07598521696127203,-1.0431164918710394,-0.9671312749097674,4248130522,4352159558.8,6.031803917003586,9.587268811196966,NaN,NaN,-28.1042471538144,-24.390235920548875
2012-06-04T09:30:00-04:00,60.57001,60.96001,60.03999,60.87,74119312,60554712.8,34.34897419713377,34.26098890994569,NaN,NaN,-135.88278057908352,-92.87928915562338,-0.09034589186094932,-1.080063639735954,-0.9897177478750047,4322249834,4339203200.4,5.844112215716137,8.806806371133804,NaN,NaN,-28.696501339205728,-25.00541669464271
2012-06-05T09:30:00-04:00,60.64999,61.24001,60.63,61.12,47916880,60437220,36.464966908894276,34.529096005033495,NaN,NaN,-104.86112348660673,-104.31211329386251,-0.06963331999339228,-1.076759397866745,-1.0071260778733526,4370166714,4326985926.8,5.66510048009701,8.17471770664936,NaN,NaN,-28.505146358007206,-25.505378075123353
2012-06-06T09:30:00-04:00,61.60001,62.57001,61.52,62.52,58781184,59743295.2,46.80488530224128,35.69612239952259,NaN,NaN,-18.308928988052685,-94.15612722487163,0.0455257180349129,-0.9502189303297115,-0.9957446483646244,4428947898,4337811248.4,8.34411161651073,7.852250817440232,NaN,NaN,-24.78616094423498,-25.402632770710728
2012-06-07T09:30:00-04:00,63.16,63.17999,62.22,62.27,38414784,57378272,45.38449399807993,37.1666030698736,NaN,NaN,15.906714365809242,-76.62320320070044,0.10844223663648622,-0.8601918525690166,-0.9686340892055029,4390533114,4352005616.4,11.877949783613616,7.887028638356145,NaN,NaN,-22.301774811993287,-24.959653062322523
2012-06-08T09:30:00-04:00,62.16,62.95,61.96001,62.87,39737104,56892684,49.356725261737914,39.111338439744024,NaN,NaN,29.7055984084761,-42.688104055891515,0.1893138207495736,-0.7319918132685359,-0.9213056340181095,4430270218,4388433555.6,20.363882614408652,8.626212280415194,NaN,NaN,-18.942714768751653,-24.100090448955257
2012-06-11T09:30:00-04:00,63.35001,63.38,61.77,61.80499,51008832,57087791.2,43.33227804865772,39.52706857087791,NaN,NaN,15.443841953513898,-12.422779549372029,0.17051133707989696,-0.7081664626682382,-0.8786777997481352,4379261386,4399835866,22.867652915779573,9.599979765749234,NaN,NaN,-18.00538880582163,-23.229418785650452
2012-06-12T09:30:00-04:00,62.09,62.59,61.67999,62.56,48802592,57209921.6,48.16282078322597,40.311100408455204,NaN,NaN,21.00383892420472,12.750212932790253,0.20598153066848912,-0.6212008864125238,-0.8271824170810129,4428063978,4411415318.8,25.431657264684645,10.807025656987317,NaN,NaN,-15.6075373717817,-22.140578583669203
2012-06-13T09:30:00-04:00,62.38,62.85001,61.92,62.13,50841088,56406554.4,45.76983584987866,40.8534149485642,NaN,NaN,35.51344014234628,23.514686758870045,0.19751533739170168,-0.5802882453413858,-0.7778035827330875,4377222890,4401070317.2,24.643501890273797,11.978966303638739,NaN,NaN,-14.436775289768075,-21.04003525596904
2012-06-14T09:30:00-04:00,62.14,62.61,61.8,62.36,65170496,57023784,47.278727304721215,41.65313550387361,NaN,NaN,37.91576815998821,27.916497517705842,0.20362396057074816,-0.5232736320196523,-0.7268975925904004,4442393386,4411442371.6,27.08345874247358,13.351331867424042,NaN,NaN,-13.0295009720727,-19.895673215412423
2012-06-15T09:30:00-04:00,62.37,63.08,62.36,62.99001,41536032,55987913.6,51.277706068092456,42.767867057077126,NaN,NaN,109.49964322940559,43.87530648189174,0.24361117573080515,-0.422383622926894,-0.6659947986576992,4483929418,4422174211.6,29.62261061469681,14.919674612362419,NaN,NaN,-10.592770240109752,-18.56668707608347
2012-06-18T09:30:00-04:00,62.75,63.74001,62.63,63.58,32191120,53622648,54.73996829106907,43.633150009316964,NaN,NaN,176.28807839902072,76.0441537709931,0.29962741805977633,-0.2914605260829788,-0.5910879441427551,4516120538,4449546042,35.76643739126622,16.945923248687937,NaN,NaN,-7.4566002118703745,-16.979531809767312
2012-06-19T09:30:00-04:00,63.89999,64.50999,63.85001,64.239,36476480,52372905.6,58.30407947248308,44.973603240365854,NaN,NaN,256.4225389434846,123.12789377484907,0.36647502558493994,-0.13299416216158022,-0.49946918774652016,4552597018,4474452650,40.828352950281015,19.351269941707663,NaN,NaN,-3.6697028690933933,-15.078127675385325
2012-06-20T09:30:00-04:00,64.36,64.57001,63.81,64.28999,51389680,51794653.6,58.57589471508335,46.44143343929868,NaN,NaN,206.66107812224547,157.35742137082892,0.39697021243839015,-0.003256422198532505,-0.40022663463692265,4603986698,4519805411.6,48.74850089283888,22.365652377831733,NaN,NaN,-0.5564033465928373,-13.00359562841497
2012-06-21T09:30:00-04:00,64.21001,64.31,62.62,62.69,42492624,51071731.2,48.001570396318954,47.700209042687,NaN,NaN,83.12505178354156,166.3992780955396,0.2968153361698172,-0.029207464424651164,-0.32602280059446836,4561494074,4543625549.2,52.35558946259039,25.674494202516506,NaN,NaN,-1.0440358379702055,-11.295087086922862
2012-06-22T09:30:00-04:00,62.88,63.42999,62.731,63.35001,29513104,48390908,51.86203317419874,48.95114182676308,NaN,NaN,70.76427318751547,158.65220408716158,0.2635732335979947,0.003443741403025058,-0.26012949219496967,4591007178,4565041101.2,55.39509240283018,29.21384993016751,NaN,NaN,-0.20155193562262202,-9.710296351022828
2012-06-25T09:30:00-04:00,62.84,62.85001,61.95,62.13,33136336,48443583.2,45.18423038562895,49.573946360815555,NaN,NaN,-13.961927228724388,120.60220296161253,0.15343414616500542,-0.0683368094887129,-0.22177095565371832,4557870842,4573391162,56.558783302676034,32.84911298892315,NaN,NaN,-1.7380819807593126,-8.571408583842326
2012-06-26T09:30:00-04:00,62.33,62.7,62.0575,62.52,30610736,47763047.2,47.51092235945618,49.62437757918804,NaN,NaN,-0.9244514044576996,69.13280489202407,0.10326856079007113,-0.09268525466612942,-0.19595381545620055,4588481578,4580568074,57.58308234561502,36.36618232671632,NaN,NaN,-2.213306942662474,-7.663108349388061
2012-06-27T09:30:00-04:00,62.75999,63.17999,62.6899,62.89999,35705776,46726746.4,49.74897621981046,49.93612630931165,NaN,NaN,44.56481662716959,36.71355259300889,0.09244878275143331,-0.08039283701690891,-0.17284161976834223,4624187354,4584608205.2,58.180863715940326,39.673533321882516,NaN,NaN,-1.897967549247304,-6.83951680651081
2012-06-28T09:30:00-04:00,62.42,62.47,61.53999,62.2,49793376,46453414.4,45.86903169324834,49.68700534013383,NaN,NaN,-40.051020867173726,12.078338062865823,0.03772487509368769,-0.1256855259012326,-0.1634104009949203,4574393978,4587188186,58.5822801467348,42.403418859905806,NaN,NaN,-2.8565843589432722,-6.270526456858304
2012-06-29T09:30:00-04:00,63.37,64.16,63.21001,64.16,44765808,45120167.2,56.1754497614265,50.60437474818874,NaN,NaN,121.63295309040853,22.252074043444434,0.1280197921784638,-0.0033856607718405485,-0.13140545295030434,4619159786,4592818707.6,59.49604480840174,45.019732566521675,NaN,NaN,-0.14581219779946583,-5.395567276992756
2012-07-02T09:30:00-04:00,64.23,64.38,63.87,64.35001,33432704,43085836.8,57.02960416368071,51.23771641822122,NaN,NaN,140.3369361177767,53.11184671274466,0.1912278805887414,0.10762939778562242,-0.08359848280311899,4652592490,4611763037.2,62.4942498108251,47.66706060553171,NaN,NaN,2.2352236004965182,-4.305454294494288
2012-07-03T09:30:00-04:00,64.38,64.89,64.28999,64.89,15895086,41484747.1,59.44851374463377,52.21476483927516,NaN,NaN,163.97787318789682,86.09231163121557,0.25604405606565617,0.23645658727895125,-0.019587468786704934,4668487576,4627764236.8,64.86027944048658,50.539687573404045,NaN,NaN,4.961355677540518,-2.981624298489315
2012-07-05T09:30:00-04:00,64.78,65.25,64.48,64.92999,37025568,40396966.3,59.62975706650738,53.09698125083131,NaN,NaN,154.66401811780898,108.11215192934344,0.28597797023497395,0.33788499400701255,0.05190702377203857,4705513144,4644029394.8,67.13019585683566,53.400168795858484,NaN,NaN,7.171587994750568,-1.5311653994550463
2012-07-06T09:30:00-04:00,64.64999,64.69,63.64999,64.12,40684064,40510430.3,54.33275768659315,53.31519922358137,NaN,NaN,80.29084008513945,132.18052411980608,0.23758363402089339,0.3488865662981553,0.1113029322772619,4664829080,4662116415.2,69.49035930766445,56.24786513107046,NaN,NaN,7.469894145874391,-0.2452997501222698
2012-07-09T09:30:00-04:00,64.03,64.25999,63.67999,64,35636976,40305423.9,53.57347590557821,53.23187833890345,NaN,NaN,58.564692236985884,119.56687194912156,0.18612362770645058,0.34395746691032514,0.15783383920387456,4629192104,4664122878.8,69.74984979412133,58.67525173127439,NaN,NaN,7.489665380330458,0.8596952685138342
2012-07-10T09:30:00-04:00,64.33,64.50999,63.12,63.37,47365648,40123264.7,49.65055690046693,52.61376958375944,NaN,NaN,27.68832053080534,97.03714883172728,0.10246851538614118,0.28591948343655105,0.18345096805040986,4581826456,4649969672,65.51687418044753,60.43871753342915,NaN,NaN,6.349368756743153,1.6439343382608795
2012-07-11T09:30:00-04:00,63.28999,63.46001,62.5,63.02,43431952,39854732.7,47.566668624665525,51.82739629158674,NaN,NaN,-34.897056279074995,57.262162938332914,0.02065487296068677,0.20926955925126833,0.18861468629058156,4538394504,4623951057.6,58.48948099348809,61.13450182633266,NaN,NaN,4.7873147343630285,2.0929886805611866
2012-07-12T09:30:00-04:00,62.55,62.69,61.86,62.42999,57680384,40196697.5,44.19893218612917,51.555779276573176,NaN,NaN,-95.13940832660718,7.301477649449701,-0.0710797196097051,0.09976503677845017,0.17084475638815527,4480714120,4578991252.8,48.75738423574594,60.87748716727234,NaN,NaN,2.4473712210292873,2.1436147577709153
2012-07-13T09:30:00-04:00,62.56,63.52,62.56,63.38,32358944,38556119.9,50.30049279788895,51.44424067826533,NaN,NaN,-26.122285514465183,-13.981147470471225,-0.06578120891201053,0.0886182452481421,0.15439945416015263,4513073064,4548640049.6,43.49584728974963,60.027541087766586,NaN,NaN,2.1930832066057158,2.1506816790330294
2012-07-16T09:30:00-04:00,63.24001,63.52,62.95,63.2,27623184,37860477.5,49.20270991529621,51.73127493038442,NaN,NaN,-22.0061664452247,-30.09531920691334,-0.07190665522494147,0.0645161351289758,0.13642279035391727,4485449880,4519891604.8,39.18274095093411,58.78639520549931,NaN,NaN,1.664994833374552,2.081297843938961
2012-07-17T09:30:00-04:00,63.58,63.74001,62.63,63.53,42476976,38374770.3,51.30111509633603,52.002002983018706,NaN,NaN,-14.402966468513233,-38.51357660677706,-0.052160412096275116,0.07122227523357338,0.1233826873298485,4527926856,4509111684.8,37.674149331006255,57.36432856159869,NaN,NaN,1.8175566358099415,2.0436205284919584
2012-07-18T09:30:00-04:00,63.39999,64.58,63.39,64.39,44489600,38775426.3,56.360500477541216,52.474254715713755,NaN,NaN,66.60145402618865,-18.21387454572432,0.01670882001603996,0.14426871234989846,0.1275598923338585,4572416456,4515916075.2,39.26373282160278,56.01310492628886,NaN,NaN,3.4583983300199366,2.2457316429959553
2012-07-19T09:30:00-04:00,64.84,65.31,64.72,65.10001,53017696,38856827.1,60.05061263169023,53.48722478274532,NaN,NaN,143.86376956511668,29.58676103262045,0.10314705682784903,0.2564937133686698,0.15334665654082075,4625434152,4544860081.6,45.617462091428656,55.08704649376699,NaN,NaN,6.00392297298873,2.7826161187092087
2012-07-20T09:30:00-04:00,65.09,65.10001,64.21001,64.235,40572544,38760823.1,54.05371421935034,53.335672244025595,NaN,NaN,84.66175217330813,51.743568570175114,0.0953167803379174,0.2724926319632175,0.17717585162530008,4584861608,4559217790.4,48.49575390198945,54.30131142902326,NaN,NaN,6.369886635165043,3.2950833353457565
2012-07-23T09:30:00-04:00,63,63.67999,62.50999,63.46001,48657616,39718048.7,49.30316618847879,52.783783817225455,NaN,NaN,-29.50462244807166,50.24387736960572,0.034338921901445524,0.22009950400210698,0.18576058210066146,4536203992,4569368612.8,50.49084016860106,53.44392502600726,NaN,NaN,5.181647257486559,3.564592467080157
2012-07-24T09:30:00-04:00,63.58,63.66,62.55,62.96001,57269680,40924715.9,46.46583207384315,51.85644941216898,NaN,NaN,-49.29283236646437,43.2659041900155,-0.039283297134834305,0.13665646068211856,0.17593975781695287,4478934312,4559570104,48.53636856307084,52.27793139190613,NaN,NaN,3.3076888604360506,3.5278919518452847
2012-07-25T09:30:00-04:00,62.49001,62.95,62.14999,62.53999,46267408,41707549.5,44.16644158951402,50.751926878098025,NaN,NaN,-97.86548335829653,10.372516713118458,-0.11177768672376165,0.03621764941225081,0.14799533613601246,4432666904,4531620193.6,43.37822249450713,50.58136186602552,NaN,NaN,1.0472558899668047,3.1735153715769306
2012-07-26T09:30:00-04:00,63.44,63.73,62.97,63.37,41934256,42018973.5,49.486146577089684,50.405740370276355,NaN,NaN,-25.061095057266545,-23.412456211358187,-0.09973614071089347,0.023325160247395615,0.12306130095828909,4474601160,4501453595.2,38.609020220943705,48.37555193125975,NaN,NaN,0.7266053358567383,2.8239567950454747
2012-07-27T09:30:00-04:00,63.83,64.99001,63.64,64.87,42623488,41660479.1,57.38781286803175,50.67819301045161,NaN,NaN,77.54750707172262,-24.835305231675296,0.007644169684677279,0.1326165130641357,0.12497234337945841,4517224648,4487926203.2,36.6624592960812,46.01216689568547,NaN,NaN,3.0930280471287595,2.862395545343087
2012-07-30T09:30:00-04:00,65.00999,65.31,64.60001,64.82001,37821200,41313248.7,57.06742723023926,51.2079694625782,NaN,NaN,105.29383845195741,2.124386948330513,0.0702177539183334,0.21274453577737518,0.14252678185904177,4479403448,4476566094.4,35.063675430367,43.836938413536856,NaN,NaN,4.836417481434103,3.144398679070375
2012-07-31T09:30:00-04:00,64.91,65.17999,64.74001,64.8,34595376,41371382.3,56.93041908661016,51.876808781288524,NaN,NaN,96.81947367977563,31.346848157578506,0.10318035265724879,0.27150222268060276,0.16832187002335397,4444808072,4469740846.4,34.10148273711883,42.094938538081905,NaN,NaN,6.1848304401249585,3.578746073506744
2012-08-01T09:30:00-04:00,65.25,65.27991,64.35001,64.61,30919776,42122616.8,55.56627400933002,52.68876176866002,NaN,NaN,81.89959289588292,67.2998634084144,0.10477187188685769,0.29928670988192607,0.19451483799506838,4413888296,4465985124.8,33.55581033821316,41.00911183111527,NaN,NaN,6.914425903352043,4.055271763484644
2012-08-02T09:30:00-04:00,64.10001,65.02,63.91,64.38,40544544,42298565.6,53.88310505506854,52.944662644172844,NaN,NaN,57.96014600494809,83.90411162085732,0.08382567332905949,0.29929692965639276,0.21547125632733327,4373343752,4445733643.2,30.702911462802817,40.09533070061907,NaN,NaN,7.062632505123913,4.484894726575968
2012-08-03T09:30:00-04:00,65.38,65.88,65.19,65.60001,42122944,42370509.6,60.68586837081152,53.76488824813823,NaN,NaN,141.01175314333364,96.59696083517953,0.1421964992771566,0.393216880423779,0.2510203811466224,4415466696,4425382052.8,28.11590808018498,39.304842638422706,NaN,NaN,9.25469979659662,5.166295450864633
2012-08-06T09:30:00-04:00,65.94,66.39,65.8,66.10001,23529616,41765141.6,63.08897325361511,54.606878116515304,NaN,NaN,156.59740376197018,106.85767389718208,0.20094835369940955,0.5022058232708844,0.3012574695714748,4438996312,4417300625.6,27.13806164680649,38.55226494669416,NaN,NaN,11.835579793838962,6.119050357003823
2012-08-07T09:30:00-04:00,66.38,66.92,66.28,66.64999,28222368,40807977.6,65.58116675051593,55.2654971360135,NaN,NaN,165.41587776946537,120.57695471512002,0.25959076498772327,0.6257459258061289,0.3661551608184056,4467218680,4421782747.2,28.620819898070465,37.79205688072756,NaN,NaN,14.79004029046133,7.35776320464061
2012-08-08T09:30:00-04:00,66.48,66.76199,66.37,66.62,20723504,39672555.2,65.3221663330933,55.64203668611373,NaN,NaN,144.40281975147715,133.07760008623887,0.2774864569906776,0.7130132320567526,0.435526775066075,4446495176,4428304123.2,30.826535158789454,36.73556209982477,NaN,NaN,17.106934464126255,8.750501955995702
2012-08-09T09:30:00-04:00,66.62,66.91,66.49001,66.82001,20726176,37824844.8,66.2786685190859,56.515247707523415,NaN,NaN,141.32517963910473,149.7506068130702,0.2829503879075146,0.7892147599504682,0.5062643720429536,4467221352,4447079643.2,36.87463830082608,35.90548241402738,NaN,NaN,19.316884193985572,10.259985132851398
2012-08-10T09:30:00-04:00,66.59,66.88,66.41,66.86,20320928,37222944,66.47775942552349,57.74200436731231,NaN,NaN,123.64096763604901,146.27644971161328,0.2694788997983061,0.8431129967908362,0.5736340969925301,4487542280,4461494760,41.13043945633884,35.23688236315151,NaN,NaN,21.20721706755323,11.823875409237374
2012-08-13T09:30:00-04:00,66.84,67.03,66.5,67.02,19890256,36836297.6,67.30937608500852,59.23082893953841,NaN,NaN,117.53459820519782,138.46388860025883,0.2518898164630099,0.8884963675712925,0.6366065511082826,4507432536,4475182004.8,44.927068743048636,34.97907523314992,NaN,NaN,23.039493183074608,13.42610651978555
2012-08-14T09:30:00-04:00,67.28,67.41,66.86,67.05,24218672,35923382.4,67.47231665501178,60.89553430135969,NaN,NaN,116.22648592822065,128.62601023200986,0.22377154888399997,0.9163209872132825,0.6925494383292825,4531651208,4488068510.4,48.30725630149584,35.331149076506264,NaN,NaN,24.63087279820956,15.026787416703266
2012-08-15T09:30:00-04:00,67,67.3199,66.99001,67.22,29110352,35154420,68.43250942470902,62.2488459333325,NaN,NaN,104.9667003504653,120.73878635180749,0.19895225096518998,0.94123975203577,0.7422875010705801,4560761560,4510921787.2,53.73090562953211,36.41128374854829,NaN,NaN,26.25656385981432,16.63104119429056
2012-08-16T09:30:00-04:00,67.47,68.17,67.39,68.02,35706448,34288857.6,72.54045255225512,63.33117733934845,NaN,NaN,122.21838906075781,116.91742823613811,0.21725342770786094,1.0138542857054063,0.7966008579975453,4596468008,4536771118.4,58.97420375266676,38.004979781161545,NaN,NaN,28.92005832534254,18.38661507015513
2012-08-17T09:30:00-04:00,68.17,68.33,68.00999,68.32001,22584720,33389466.4,73.91153423757905,64.53432783987272,NaN,NaN,123.42960103701115,116.87515491633056,0.22921894642002016,1.0831245410225705,0.8539055946025503,4619052728,4563073208,63.505909683799665,40.03656794212102,NaN,NaN,31.605597337365676,20.275041108328065
2012-08-20T09:30:00-04:00,68.27,68.42999,68,68.42,26923936,32302782.4,74.37084826322679,65.78007278105962,NaN,NaN,115.12069963348688,116.39237520198836,0.22329889969586325,1.1330292192223794,0.9097303195265162,4645976664,4590782033.6,67.57000705998117,42.42717682232548,NaN,NaN,33.99747844945914,22.235389299918218
2012-08-21T09:30:00-04:00,68.63,68.88,67.88,68.14999,41390944,31508845.6,70.74853042240825,66.86451966770805,NaN,NaN,108.83278049736641,114.91363411581752,0.18235738671521695,1.1376770529205373,0.9553196662053204,4604585720,4605368936,69.49588864937469,44.99432527312273,NaN,NaN,35.133950718232256,24.07804093110594
2012-08-22T09:30:00-04:00,67.99001,68.5601,67.81,68.42999,44555648,31423257.6,72.25753887311964,68.17697922614028,NaN,NaN,102.55482989469554,114.43126002466356,0.15629604283158693,1.150689719744804,0.9943936769132171,4649141368,4623044897.6,71.68985272321702,47.921963934580894,NaN,NaN,36.52608827336681,25.85633340857178
2012-08-23T09:30:00-04:00,68.14,68.34,67.69051,67.87,28802208,30766655.2,65.03188358419597,68.48740888423917,NaN,NaN,83.30826340419395,106.64923489335078,0.08696504964463148,1.1030999889690065,1.016134939324375,4620339160,4627819128,72.26998397611287,51.07582649857574,NaN,NaN,35.774729914344974,27.273247195110805
2012-08-24T09:30:00-04:00,67.72,68.45,67.60001,68.28999,38384752,30554718.4,67.64511180107318,68.81284735191475,NaN,NaN,85.77767972894239,99.11885063173702,0.05648974702231646,1.0867471231022705,1.030257376079954,4658723912,4635753364.8,73.25100446876728,54.3696081287158,NaN,NaN,35.84166515300669,28.497306903381645
2012-08-27T09:30:00-04:00,68.60001,68.67,68.25,68.39999,20671328,29697224.8,68.31303143678237,69.00798054379092,NaN,NaN,97.01649274454614,95.49800925394888,0.03205441504061746,1.0703253948807259,1.0382709798401084,4679395240,4642437080,74.0827942798326,57.61689201312738,NaN,NaN,36.07873864361807,29.580368580558275
2012-08-28T09:30:00-04:00,68.34,68.58501,68.11,68.39999,27337856,29334348.8,68.31303143678237,69.221613765483,NaN,NaN,84.77807525636389,90.68706820574837,0.005592758606972836,1.0452619280988245,1.0396691694918516,4679395240,4657398984,75.89019103636893,60.835724575811625,NaN,NaN,36.2756714875906,30.536840424420035
2012-08-29T09:30:00-04:00,68.41,68.57001,68.11,68.39999,26674512,29122085.6,68.31303143678237,69.36692540246132,NaN,NaN,77.0247093591726,85.58104409864377,-0.020764542008811393,1.0137134919808375,1.0344780339896489,4679395240,4663449758.4,76.60087056032289,63.67331259434711,NaN,NaN,36.441442863556134,31.380355058582335
2012-08-30T09:30:00-04:00,68.11,68.13,67.60001,67.71001,24430944,28316405.6,58.80300554547162,68.81872869674332,NaN,NaN,29.184087431619034,74.75620890412878,-0.08966032625747178,0.9224026261678091,1.0120629524252809,4654964296,4670374785.6,77.42117776153029,66.26550818757507,NaN,NaN,33.943470483432854,31.74651440498955
2012-08-31T09:30:00-04:00,68.2,68.45,67.47,68.16,42127920,28316654.4,62.47228898511133,68.4732224753221,NaN,NaN,41.83011650603934,65.96669625954817,-0.10865220084245863,0.8762477013722076,0.9848999022146663,4697092216,4678048446.4,78.32783858183647,68.6512774617742,NaN,NaN,32.74353091030831,31.888945334320802
2012-09-04T09:30:00-04:00,68.03,68.35001,67.42,68.09,32017184,28741032.8,61.553848957410224,68.05047478263627,NaN,NaN,29.339634886188733,52.43132468787669,-0.1283065928660465,0.8245166611321082,0.9528232539981547,4665075032,4675184404.8,77.08370347921978,70.70673797446877,NaN,NaN,31.49131640869221,31.832141202088145
2012-09-05T09:30:00-04:00,68.03999,68.35001,67.84,68.02,26133792,28636604,60.5944898537247,67.49061624185168,NaN,NaN,38.239510891621364,43.123611814928196,-0.14705348559895715,0.7690063969994583,0.9160598825984154,4638941240,4667093604.8,73.53053380143908,72.12099712960499,NaN,NaN,30.180014082821266,31.596123042192875
2012-09-06T09:30:00-04:00,68.42,69.55,68.42,69.53,43099504,29755404,71.06934177008466,67.38553690026804,NaN,NaN,171.39201163286094,61.997072269665864,-0.06308175879135902,0.8372076841092166,0.9002894429005757,4682040744,4667622705.6,73.61618286895799,73.16685278076864,NaN,NaN,32.22402076691195,31.685822717152742
2012-09-07T09:30:00-04:00,69.37,69.55,69.23,69.42999,32966128,30367401.6,69.74692853141924,67.08806506411376,NaN,NaN,194.0750896938603,94.97527272211411,-0.02173322875674155,0.8731229069546487,0.8948561357113902,4649074616,4666444769.6,73.04947076321616,73.84853571501267,NaN,NaN,33.42892542805219,31.934837390138377
2012-09-10T09:30:00-04:00,69.25999,69.39999,68.49001,68.53999,25489968,30625853.6,59.191507546679794,66.00382644150328,NaN,NaN,104.78008604222929,107.5652666293521,-0.05963343279530364,0.8203143447172607,0.8799477775125644,4623584648,4651743256,66.19978265057637,73.75066254291232,NaN,NaN,30.944880316510016,31.79341495104861
2012-09-11T09:30:00-04:00,68.53999,68.82001,68.32001,68.42999,29810080,31121844.8,58.022719097612914,65.0948399183036,NaN,NaN,54.49178349147389,112.59569635040911,-0.09530472229128739,0.7608168746484552,0.8561215969397425,4593774568,4637483163.2,60.294057648874116,73.09338890001943,NaN,NaN,28.610036421472664,31.338646589680618
2012-09-12T09:30:00-04:00,68.67999,68.81,68.21001,68.632,42212160,32021519.2,59.600397459145604,64.19075838873404,NaN,NaN,52.832551331352406,115.51430443835534,-0.10758005536582593,0.7216465277324602,0.8292265830982861,4635986728,4636892260.8,60.05497737209647,72.26232637493939,NaN,NaN,27.18417761607203,30.74515102202225
2012-09-13T09:30:00-04:00,68.71001,69.86,68.62,69.56,45417792,32836891.2,65.93442171608608,64.25522539815476,NaN,NaN,182.03682956442552,117.64326802466826,-0.05797158050424667,0.7567621074679778,0.8147336879722245,4681404520,4636765016,59.99980418853096,71.38588496154068,NaN,NaN,27.980272043450093,30.350168310797656
2012-09-14T09:30:00-04:00,69.84,70.42999,69.78999,70.17999,38888048,32995971.2,69.38761714836701,64.37969006581861,NaN,NaN,246.9637616961033,128.22100242511686,0.008299558382689254,0.8251081359505861,0.8168085775678968,4720292568,4651008606.4,63.9881150940792,70.72425000620582,NaN,NaN,29.82883248876255,30.27569176479264
2012-09-17T09:30:00-04:00,70.2,70.24001,69.96001,70.21001,31798336,33456652,69.54857925175288,64.46794348117365,NaN,NaN,189.9732212457835,145.2596294658277,0.043871066168072126,0.871647410277987,0.8277763441099149,4752090904,4676709857.6,69.83302843054237,70.42069530268508,NaN,NaN,31.318069715342094,30.42460290058542
2012-09-18T09:30:00-04:00,70.03999,70.3,70.02,70.27,27169760,33468943.2,69.88930126521593,64.5805341832046,NaN,NaN,158.35536845615349,166.03234645876358,0.06014854706305006,0.9029620279387274,0.8428134808756773,4779260664,4713807076.8,75.91059885123346,70.42215300374684,NaN,NaN,32.61376297742881,30.73734005442019
2012-09-19T09:30:00-04:00,70.28999,70.58,70.06,70.39999,36484576,33223624.8,70.65548913756574,64.74785259040343,NaN,NaN,144.3763010941879,184.3410964113307,0.06780975900645614,0.9275756796337475,0.8597659206272914,4815745240,4749758779.2,80.09571610749003,70.67178482854449,NaN,NaN,33.904951366137546,31.1898559560941
2012-09-20T09:30:00-04:00,70.07001,70.39999,69.87,70.33,42523440,33122014.4,69.62815886802616,65.52107782772875,NaN,NaN,112.0021871215053,170.33416792274664,0.056752038538711025,0.9307059688006802,0.8739539302619692,4773221800,4768122235.2,81.83195494549365,70.98684034168473,NaN,NaN,34.69026201689102,31.689913964779375
2012-09-21T09:30:00-04:00,70.47,70.53999,70.08,70.14999,23681200,32865964,66.93260970336392,65.8396721647468,NaN,NaN,102.66780940354441,141.47497746423488,0.027390749111776636,0.90819236665169,0.8808016175399134,4749540600,4773971841.6,82.35981990475867,71.27483900760774,NaN,NaN,34.62631075485528,32.10939922050451
2012-09-24T09:30:00-04:00,69.56,69.86,69.42,69.735,32341552,32563804,61.06353088419697,65.80464944523156,NaN,NaN,48.75911175886137,113.23215556685048,-0.026961999132411263,0.8470991186243992,0.8740611177568105,4717199048,4766993470.4,79.39617398165171,71.44001547206717,NaN,NaN,32.90926733163669,32.22366609352339
2012-09-25T09:30:00-04:00,69.92,70.08,68.73,68.75999,41308848,33595680,49.97568750977916,65.04616356352116,NaN,NaN,5.5654685402009205,82.67417558365995,-0.12980736496291512,0.7118019115531666,0.8416092765160818,4675890200,4746319377.6,71.21966477235466,71.27495339856112,NaN,NaN,27.695661449199026,31.57680828719134
2012-09-26T09:30:00-04:00,68.67,68.71001,67.85001,68.2,32770368,33867305.6,44.92961223234847,63.17904002511143,NaN,NaN,-74.84738924163896,38.82943751649461,-0.23087417593797044,0.5530165565936187,0.7838907325315891,4643119832,4711794296,60.09040191358171,70.30882618746283,NaN,NaN,21.533506828807994,30.14205093599372
2012-09-27T09:30:00-04:00,68.35001,69.3,68.25,69.14,25334736,33800316.8,53.429912495521464,62.01353887969017,NaN,NaN,-22.492394536972494,11.930521184799053,-0.22927606745179252,0.49729564821684846,0.726571715668641,4668454568,4690840849.6,54.52184743103067,68.98542452087814,NaN,NaN,18.933050581316373,28.540765171039812
2012-09-28T09:30:00-04:00,68.92,69.12,68.50999,68.57001,30116096,34084574.4,48.53755592214673,61.25254233508066,NaN,NaN,-44.10655141070276,-17.42435097805039,-0.259254819537455,0.4025031912468222,0.6617580107842772,4638338472,4668600424,49.29964755035245,67.7782720137193,NaN,NaN,15.07480738361526,26.617056915693446
2012-10-01T09:30:00-04:00,68.89999,69.33,68.25,68.47,37715200,33863938.4,47.71204552027414,60.516065650985034,NaN,NaN,-54.360388622392584,-38.04825105430118,-0.2768698805456281,0.3156706601022421,0.5925405406478702,4600623272,4645285268.8,44.48888072603943,66.6493308049454,NaN,NaN,11.805999151832223,24.50119152085613
2012-10-02T09:30:00-04:00,68.78999,68.98,68.13,68.67,33254272,33925792.8,49.55958837075981,59.798865001814626,NaN,NaN,-69.58962062270277,-53.07926888688191,-0.2660352291206516,0.2599965042470558,0.5260317333677074,4633877544,4636882737.6,42.86544774839735,65.42150726039546,NaN,NaN,9.740392181233101,22.39250590090998
2012-10-03T09:30:00-04:00,68.88,69.24001,68.59,69.11,38235968,34530901.6,53.45599258775248,58.90754863550507,NaN,NaN,-36.20377093665656,-45.35054522588543,-0.22201423201940268,0.248513943343454,0.4705281753628567,4672113512,4642681473.6,44.37402788288927,64.30538038142105,NaN,NaN,9.208983676216441,20.50914558309662
2012-10-04T09:30:00-04:00,69.24001,69.53999,69,69.35001,26128544,33682353.6,55.476391303051976,57.913889646554004,NaN,NaN,-1.5195810401737364,-41.155982526525676,-0.17175720902717884,0.25583166407888314,0.427588873106062,4698242056,4648638971.2,45.952936098670165,63.0171533103204,NaN,NaN,9.390028250930065,18.92070024992997
2012-10-05T09:30:00-04:00,69.67999,69.8,68.8,68.98,25207824,33294438.4,51.74708537052115,56.642354369323165,NaN,NaN,-12.026952637375404,-34.74006277186021,-0.15876470386920244,0.22913299326955894,0.3878976971387614,4673034232,4655578123.2,47.811102492322064,61.44415860044752,NaN,NaN,8.415305783077844,17.419929611808236
2012-10-08T09:30:00-04:00,68.58,68.72,68.19,68.35001,30911408,33565510.4,46.068632708376676,54.940878043834644,NaN,NaN,-94.56054265751007,-42.78009357888371,-0.1860394245099256,0.15534841650135434,0.34138784101127995,4642122824,4663878033.6,50.02431413001923,59.595138263217926,NaN,NaN,5.767300098804723,15.755268252807735
2012-10-09T09:30:00-04:00,68.17,68.33949,67.10001,67.2592,67973936,35473703.2,38.24334781407969,52.625725092157076,NaN,NaN,-171.01594248308842,-63.06535795096083,-0.266107510610252,0.008753452748464952,0.27486096335871696,4574148888,4651932302.4,46.93897810152522,57.22679983422045,NaN,NaN,0.6251931042521252,13.59382894587122
2012-10-10T09:30:00-04:00,67.25,67.42999,66.8,66.92,45134288,35619809.6,36.18501764306235,50.23692929037394,NaN,NaN,-194.06796802873941,-94.63819736937742,-0.32649564687688815,-0.13325859523739325,0.1932370516394949,4529014600,4623312520,40.4949110615981,54.27415384251362,NaN,NaN,-4.195334117601221,11.052519936803728
2012-10-11T09:30:00-04:00,67.44,67.47,66.67,66.71001,30476080,34872724,34.93157418647546,47.951141039167624,NaN,NaN,-168.72510543845866,-128.07930224903438,-0.362393095997614,-0.2597543183575226,0.10263877764009138,4498538520,4583371812.8,33.5687088980476,50.78907448489141,NaN,NaN,-8.454216883683253,8.265843248162732
2012-10-12T09:30:00-04:00,66.73,67.06,66.55,66.67999,24894928,34173068,34.746271835423826,46.07133682139811,NaN,NaN,-159.38301694360595,-157.55051511028051,-0.36874722115046243,-0.3582952487979867,0.01045197235247576,4473643592,4543493684.8,28.354175702495894,47.14321746495171,NaN,NaN,-11.890100164858,5.386422760588342
2012-10-15T09:30:00-04:00,66.94,67.25999,66.53,67.17,22220000,33694151.2,40.312079085096165,45.381079076777894,NaN,NaN,-125.85171643104687,-163.80874986498787,-0.3222235202273439,-0.39232742793170416,-0.07010390770436023,4495863592,4514241838.4,25.2550942122553,43.86003385351604,NaN,NaN,-13.175239691408514,2.734756696017363
2012-10-16T09:30:00-04:00,67.28999,68.2,67.25,68.12,33960304,34033678.4,49.33477205546554,45.69573334985768,NaN,NaN,-55.19861188871391,-140.64528374611297,-0.2149059718514912,-0.33873637251872424,-0.12383040066723303,4529823896,4505376840,24.385227247677307,41.30966423452288,NaN,NaN,-11.369803245616458,0.7198195614982459
2012-10-17T09:30:00-04:00,67.75,68.3,67.67999,68.08,33439360,33881417.6,48.99891286141212,45.37923337599273,NaN,NaN,-36.197825105472745,-109.07125516145963,-0.1377994538831427,-0.2960797180211614,-0.1582802641380187,4496384536,4498850827.2,23.737063438248228,39.11075109218127,NaN,NaN,-10.051822492035908,-0.8189864461494905
2012-10-18T09:30:00-04:00,67.87,68.08,67.03999,67.28999,61706320,34840561.6,42.8013758894021,44.96950623079669,NaN,NaN,-71.22548763026896,-89.5713315998217,-0.13122048878420486,-0.3223058751182748,-0.19108538633406993,4434678216,4486078766.4,22.477819442206368,37.194906227313695,NaN,NaN,-10.859435858429734,-2.253336362189525
2012-10-19T09:30:00-04:00,67.21001,67.27,65.60001,65.67999,75362624,37424632.8,33.501537671215544,43.954469955863935,NaN,NaN,-155.21935060654033,-88.73859833240856,-0.2212224758165091,-0.46761348110470635,-0.24639100528819724,4359315592,4463213166.4,20.392120612146485,35.47370907632135,NaN,NaN,-15.049241661188509,-4.0813228334750935
2012-10-22T09:30:00-04:00,65.62,66.19,65.5,66.02,38621408,37738625.6,36.63289086581746,43.03113441979662,NaN,NaN,-154.73404426809446,-94.51506389981809,-0.2420921862870431,-0.5490062381470011,-0.306914051859958,4397937000,4443627848,18.784342420755195,33.753630124346905,NaN,NaN,-17.208701134938163,-5.95666259082696
2012-10-23T09:30:00-04:00,65.49001,65.95,65.19,65.39,52598736,38303120,33.48642661945874,41.60473685063278,NaN,NaN,-158.17233111835046,-115.10980774574539,-0.2798890954320122,-0.6567754211499732,-0.37688632571796105,4345338264,4406730721.6,16.19396251246708,31.740768312173888,NaN,NaN,-20.06923467163219,-7.972744316656279
2012-10-24T09:30:00-04:00,65.75999,65.87,65.06,65.164,39872368,38658220,32.41096205710896,39.95720619020828,NaN,NaN,-143.77018675259632,-136.6242800751701,-0.29989400829141516,-0.75175383608223,-0.45185982779081485,4305465896,4368546993.6,14.03670019402935,29.461037176128116,NaN,NaN,-22.670650353025252,-10.072445178994704
2012-10-25T09:30:00-04:00,65.61,65.72,64.97,65.16,52688672,40025916.8,32.39113356535161,38.57463820412475,NaN,NaN,-131.10253330057517,-148.59968920923134,-0.2928475115038718,-0.8179192171706546,-0.5250717056667829,4252777224,4332166795.2,12.348802596436983,26.928015754993464,NaN,NaN,-24.70924942177044,-12.16341721367695
2012-10-26T09:30:00-04:00,65.17999,65.623,64.64999,65.35001,54222192,41231221.6,34.44285749632415,37.74422568897814,NaN,NaN,-119.85292707019957,-141.5264045019632,-0.25616638055496954,-0.8452796813604948,-0.5891133008055253,4306999416,4321703560,11.905387756334761,24.205235299730283,NaN,NaN,-25.77546643391412,-14.107995673710832
2012-10-31T09:30:00-04:00,65.31,65.39,64.73,64.95,38524480,41271685.6,32.22569924071854,37.31439364802378,NaN,NaN,-117.58924675626677,-134.09744499959766,-0.23990356353631082,-0.8889927552259138,-0.649089191689603,4268474936,4295811147.2,10.865631448702416,21.628567681671516,NaN,NaN,-27.335211045829393,-15.99759786972777
2012-11-01T09:30:00-04:00,65.32001,66,65.17,65.87289,26944928,40956218.4,41.570934404074684,37.699101988096096,NaN,NaN,-72.72964721906497,-117.00890821974056,-0.1523198976486312,-0.839489063750392,-0.6871691661017608,4295419864,4285827467.2,10.485376511066633,19.485029499490704,NaN,NaN,-25.798088938523495,-17.397668022412873
2012-11-02T09:30:00-04:00,66.21001,66.21001,65.11,65.17,44082992,41248569.6,37.34712360952537,37.87164123259965,NaN,NaN,-75.28634133770657,-103.31213913676262,-0.12803129951885794,-0.8472082905003333,-0.7191769909814754,4251336872,4275001662.4,10.073693588655075,17.806814120248372,NaN,NaN,-25.818991210625292,-18.600714192157504
2012-11-05T09:30:00-05:00,65.19501,65.73,65.03999,65.60001,28104128,41347348.8,41.27801692251716,38.33819445310632,NaN,NaN,-70.08909570307286,-91.10945161726217,-0.07209723151077463,-0.8092985303699436,-0.737201298859169,4279441000,4280334417.6,11.908494691206215,16.63212261944197,NaN,NaN,-24.57935284816238,-19.454805428729628
2012-11-06T09:30:00-05:00,65.71001,66.17,65.46001,65.72,29608304,41567372.8,42.3646682659958,38.484807966027724,NaN,NaN,-43.220187473522174,-75.78290369792668,-0.018880980291607008,-0.7608025242236778,-0.7419215439320708,4309049304,4280744395.2,12.057052818707973,15.68940537704573,NaN,NaN,-23.254271894974227,-19.997586352478855
2012-11-07T09:30:00-05:00,65.03999,65.10001,63.89999,64.17,70737632,43558684,33.691445830045936,37.3674275213549,NaN,NaN,-132.63085502856026,-78.79122535238538,-0.07668971463301211,-0.837783687223336,-0.7610939725903239,4238311672,4274711742.4,11.743231183061255,14.786405658144586,NaN,NaN,-24.933887363925113,-20.702772211256892
2012-11-08T09:30:00-05:00,64.33,64.495,63.16,63.16,58585728,43089273.6,29.459190655606903,35.97173307808309,NaN,NaN,-171.88937834722526,-98.62317157801742,-0.16641999979989897,-0.9691189723401976,-0.8026989725402986,4179725944,4251572958.4,10.603250187122512,13.84827614020703,NaN,NaN,-27.871864428784438,-21.726928242332257
2012-11-09T09:30:00-05:00,63.19,64.11,63.16,63.42999,51549536,43410036,31.921120010819195,35.1945719438986,NaN,NaN,-157.94226191541657,-115.15435569355941,-0.18938900842742878,-1.0394352330745846,-0.8500462246471558,4231275480,4247560680,10.414458910671186,12.986607530811659,NaN,NaN,-29.340237774624576,-22.81454388980259
2012-11-12T09:30:00-05:00,63.78999,63.87,63.25,63.42,32663664,43519415.2,31.876788533651677,35.078518434072606,NaN,NaN,-146.04346940972815,-130.34523043489048,-0.18674528257023648,-1.0834778278599515,-0.896732545289715,4198611816,4231394843.2,9.6675763192045,12.220568652744374,NaN,NaN,-30.4936060679506,-23.91155277239516
2012-11-13T09:30:00-05:00,62.92,63.58,62.78011,62.98,43287632,44439050.4,29.906748073503607,34.59807966319305,NaN,NaN,-154.3273186246226,-152.56665666511057,-0.19520318276168547,-1.1407365237418219,-0.9455333409801364,4155324184,4200649819.2,8.429422061980631,11.480931484260477,NaN,NaN,-32.06423919215626,-25.07622226093246
2012-11-14T09:30:00-05:00,63.27,63.36,62.14,62.24001,82655184,47460809.6,26.896176303836356,34.12734749779145,NaN,NaN,-161.78495022469113,-158.39747570433673,-0.22887574341172967,-1.2316280202447984,-1.0027522768330688,4072669000,4167521284.8,7.338756294818168,10.848416754428412,NaN,NaN,-34.38011694128725,-26.405350072411718
2012-11-15T09:30:00-05:00,62.28999,62.49001,61.8,62.02991,55124160,48519002.4,26.093039820712946,33.676067338048874,NaN,NaN,-160.48207895441064,-156.11601582577381,-0.24224919748114848,-1.3055637736845043,-1.0633145762033558,4017544840,4135085064,6.457734278063214,10.307062046145116,NaN,NaN,-36.50267649583386,-27.84782527575774
2012-11-16T09:30:00-05:00,62.08,62.48,61.31,62.3,70868000,50390434.4,29.027031758979973,33.435774351879466,NaN,NaN,-141.55506875267517,-152.83857719322555,-0.21100176733234943,-1.3270667853687925,-1.116065018036443,4088412840,4106512536,5.797486233032089,9.839110877330482,NaN,NaN,-37.3966908243378,-29.21194892555489
2012-11-19T09:30:00-05:00,62.97,63.83,62.96001,63.78059,55306384,50070437.6,42.502240175245944,34.01144454323103,NaN,NaN,-53.40449634312298,-134.3107825799045,-0.07569267556776915,-1.2106808624961545,-1.1349881869283853,4143719224,4095534017.6,5.56217048112687,9.386023929101347,NaN,NaN,-33.752165236249205,-29.860551255654077
2012-11-20T09:30:00-05:00,63.77,63.89,63.19,63.8,52012656,48902939.2,42.655951646365104,34.756462572205784,NaN,NaN,-41.689941506804914,-111.78330715634097,0.02467054841178795,-1.1041500014136503,-1.1288205498254382,4195731880,4103615556.8,8.50617249474682,9.217491146675949,NaN,NaN,-30.862961448465636,-30.003752711770012
2012-11-21T09:30:00-05:00,63.83,64.02,63.60001,63.92999,19620064,47952872,43.74067493414844,34.91144403863962,NaN,NaN,-23.71260521806329,-84.16883815501541,0.10486990152907394,-0.9977331729140957,-1.1026030744431696,4215351944,4132152145.6,18.202849653236157,9.768739228259486,NaN,NaN,-28.199943061956787,-29.74606561893955
2012-11-23T09:30:00-05:00,64.32001,64.92,64.25011,64.89999,16462832,46146076.8,51.16427738383833,35.89838359394769,NaN,NaN,31.665366555258245,-45.739349053081625,0.2215952044803171,-0.8256090688427733,-1.0472042733230904,4231814776,4175006132.8,30.17132438538212,11.20428428516856,NaN,NaN,-23.42917558374378,-28.843652756768726
2012-11-26T09:30:00-05:00,64.77,65.22,64.53999,65.181,26430880,45474002.4,53.09523131000029,36.74247033591077,NaN,NaN,52.41314548794032,-6.945706204958524,0.3106205394132766,-0.6589285990564946,-0.9695491384697712,4258245656,4208972696,37.924282465155486,13.062554840450654,NaN,NaN,-18.922562781982926,-27.426354188942184
2012-11-27T09:30:00-05:00,65.16,65.39999,64.85001,64.96001,25828576,44130997.6,51.37486657961269,37.38605592974055,NaN,NaN,59.567173284548524,15.64862772057577,0.34487278158750156,-0.5384581614853943,-0.8833309430728958,4232417080,4226712267.2,41.572866909914225,15.170827275536812,NaN,NaN,-15.711063272531511,-25.752741200883516
2012-11-28T09:30:00-05:00,64.66,65.57001,64.25,65.52,37295776,43284676.8,55.325084761203755,38.93131585339468,NaN,NaN,63.02216932230697,36.59104988639815,0.39205303547625237,-0.3932646487275804,-0.7853176842038327,4269712856,4241508462.4,44.50284896601043,17.510799974318896,NaN,NaN,-11.73380808766102,-23.75003647042316
2012-11-29T09:30:00-05:00,65.82001,66.13499,65.58,65.91,41135808,43415243.2,57.89078793511855,40.96214423050265,NaN,NaN,106.0786360219426,62.54929813439933,0.43312111693554733,-0.24391628803439858,-0.6770374049699459,4310848664,4260607806.4,48.11950788343572,20.1905326669127,NaN,NaN,-7.600495884220812,-21.442959243822827
2012-11-30T09:30:00-05:00,65.92,65.97,65.61,65.8,33502048,43743099.2,56.89823375909531,42.746223783950946,NaN,NaN,100.0079021471312,76.21780525277391,0.435309347890923,-0.13290072010629217,-0.5682100679972152,4277346616,4269714174.4,49.79930945891781,23.00373627750174,NaN,NaN,-4.488265879279652,-19.020860191745232
2012-12-03T09:30:00-05:00,66.32001,66.37,65.64,65.67,28239968,42950948,55.68315632478195,44.446678626174545,NaN,NaN,103.13001750929021,86.36117965704389,0.41074521976152145,-0.0547785432953134,-0.46552376305683485,4249106648,4267886372.8,49.4531973347691,25.84556635004207,NaN,NaN,-2.2230777033795532,-16.621176979121564
2012-12-04T09:30:00-05:00,65.69,65.77,65.2,65.63,49671696,44029326.4,55.291894064066305,46.259903339786156,NaN,NaN,80.31233338599449,90.51021167733309,0.37550834172648007,0.0038616641012652053,-0.37164667762521486,4199434952,4261289947.2,48.15249889102643,28.682928980688196,NaN,NaN,-0.4386734233089943,-14.309390756862626
2012-12-05T09:30:00-05:00,65.53,65.53999,64.55,64.9032,54076128,45252717.6,48.60851519562869,47.810784689199906,NaN,NaN,51.55945072703354,88.21766795827841,0.2907433352106012,-0.008217508611963353,-0.29896084382256455,4145358824,4236419140.8,43.50627602640374,31.266323247230023,NaN,NaN,-0.6677897831829139,-12.360590617765524
2012-12-06T09:30:00-05:00,64.71001,65.4801,64.53,65.32001,47519072,44091789.6,52.178494916022416,49.674031481722004,NaN,NaN,54.559047442348515,77.9137502423596,0.25169843463756486,0.015662199474391514,-0.23603623516317335,4192877896,4212824987.2,39.6023515995064,33.63379591304739,NaN,NaN,0.1444755655490209,-10.574152591577732
2012-12-07T09:30:00-05:00,65.64999,65.71001,64.71001,64.92999,30092672,42667136.8,48.76487524496116,51.08387744500637,NaN,NaN,50.028044346849484,67.91777868230324,0.19129313158663633,0.003080179320122056,-0.18821295226651427,4162785224,4189912708.8,36.20481329452663,35.80574784601129,NaN,NaN,-0.1374265925175017,-9.083191734569128
2012-12-10T09:30:00-05:00,64.75,65.455,64.75,65.12,33219552,41750637.6,50.46511061134555,51.652653904727785,NaN,NaN,45.27375684088744,56.34652654862269,0.1572462516859358,0.008344862340905479,-0.14890138934503033,4196004776,4179292334.4,34.71800695125367,37.888307593877485,NaN,NaN,0.0991012587597006,-7.77143559266501
2012-12-11T09:30:00-05:00,65.58,66.34,65.515,65.97,40750800,42154994.4,57.29274228564648,52.698138950390735,NaN,NaN,89.7540761319089,58.23487509780557,0.1832657384002594,0.08018078365529391,-0.10308495474496548,4236755576,4186756459.2,36.6859474084059,39.901148659138855,NaN,NaN,2.3765864419312637,-6.321718159151256
2012-12-12T09:30:00-05:00,66.28999,66.32001,65.64999,65.83,45917680,42286496.8,55.92544752893135,53.568479850018086,NaN,NaN,84.74772555812108,64.87253006402308,0.18197248867310858,0.12438065609642024,-0.05759183257668834,4190837896,4195852273.6,39.095387405552096,41.39347278430428,NaN,NaN,3.8469956437592425,-4.869044758735471
2012-12-13T09:30:00-05:00,65.71001,66.16,65.03,65.3111,45467648,40427120,51.061422855904674,53.56113309802283,NaN,NaN,53.167584416303654,64.5942374588141,0.13903267423631674,0.1161990102187076,-0.022833664017609147,4145370248,4186350744,37.49039621826092,41.916263629509906,NaN,NaN,3.683595030544403,-3.6472390745526315
2012-12-14T09:30:00-05:00,64.89999,65.08,64.47,64.69,39630256,39652424.8,45.91395602296237,53.0481848632344,NaN,NaN,-16.519257317949908,51.28477712585423,0.06540152706485139,0.05891824481345509,-0.0064832822513962995,4105739992,4174941697.6,35.600476128487955,41.750277462605084,NaN,NaN,1.9442940894073069,-2.8484486225583545
2012-12-17T09:30:00-05:00,64.73,65.57001,64.66,65.55,42302832,38224166.4,52.98181832067835,53.162967130453374,NaN,NaN,22.75421807775305,46.78086937322735,0.07076479210043199,0.08197270787414368,0.011207915773711698,4148042824,4165349307.2,34.04645303690546,41.212676471675884,NaN,NaN,2.6674052376484,-2.0604694996716755
2012-12-18T09:30:00-05:00,65.85001,66.64999,65.7,66.5472,55596000,38238647.2,59.57795499624747,53.466743575813645,NaN,NaN,142.70667522429193,57.37138919170396,0.13395356931610963,0.17864987741884875,0.04469630810273911,4203638824,4158725956.8,32.97607737890715,40.38933564402565,NaN,NaN,5.571718031117796,-0.9701569952731797
2012-12-19T09:30:00-05:00,66.72,66.75999,66.22,66.2605,34832448,37379636.8,57.09783023881527,53.41010374036341,NaN,NaN,142.2499940289465,68.87184288586904,0.14783299132779235,0.22948754726247955,0.0816545559346872,4168806376,4154319652.8,32.24968507060251,39.255776871680425,NaN,NaN,7.06905155653139,0.17830136927033036
2012-12-20T09:30:00-05:00,66.38,66.41,65.92999,66.25999,40754272,38436347.2,57.09327721339777,53.42403541567072,NaN,NaN,104.63665165965386,79.1656563345391,0.14800571845927651,0.26666170400878286,0.11865598554950635,4128052104,4150856024,31.659327018722237,37.96006384023788,NaN,NaN,8.23877361556666,1.3297974044555203
2012-12-21T09:30:00-05:00,64.89,65.28,64.60001,65.2,51144544,40170432.8,48.446417506370096,52.907125500069874,NaN,NaN,-70.62880287375181,68.34374722337871,0.07162742670860997,0.20819026893526882,0.13656284222665885,4076907560,4145089537.6,30.65325016869835,36.61721047123283,NaN,NaN,6.443807058459747,2.06037021217041
2012-12-24T09:30:00-05:00,65.06,65.14,64.92,65.07001,11418230,39419800.3,47.496409899034106,52.35030520256758,NaN,NaN,-69.08483340594874,49.97593692663836,0.010459489581234632,0.14963720420320215,0.1391777146219675,4065489330,4128578838.8,27.91768109599704,35.17186634301644,NaN,NaN,4.720497281994575,2.4403883650024336
2012-12-26T09:30:00-05:00,65.08,65.17999,64.28999,64.5,21760848,39216413.9,43.47089692384707,51.98333246886889,NaN,NaN,-119.0069546207503,-2.366789042370087,-0.06607325532791217,0.0565861454620773,0.12265940078998946,4043728482,4096596770.4,23.53609508113344,33.7454248469257,NaN,NaN,1.967431917192222,2.3728231581724035
2012-12-27T09:30:00-05:00,64.56,64.64,63.60001,64.39999,52943136,39998781.9,42.785716584516734,51.3124197309042,NaN,NaN,-160.97224618719997,-63.01123708559938,-0.11807949482793363,-0.02493996774492757,0.09313952708300606,3990785346,4060992564.4,19.808830110426698,32.331601883420014,NaN,NaN,-0.4523130956711528,1.9692322647661813
2012-12-28T09:30:00-05:00,63.92999,64.42999,63.75,63.78,33082048,39596093.9,38.71211006992766,50.594365075544665,NaN,NaN,-165.0957922092304,-116.95772585937625,-0.18490152466221912,-0.13798737874476785,0.04691414591745128,3957703298,4026922803.2,17.029664551614474,30.961948401783427,NaN,NaN,-3.832214167223124,1.1404542030534235
2012-12-31T09:30:00-05:00,63.67999,65.25211,63.58,65.1301,57553104,40798646.7,49.898646914903054,50.553903382941634,NaN,NaN,-76.62875850443099,-118.15771698551207,-0.1313589143394066,-0.11728449700680699,0.014074417332599627,4015256402,4014592571.6,16.146732909503243,29.63542882737268,NaN,NaN,-3.215770751139012,0.5181363524545042
2013-01-02T09:30:00-05:00,66.69,67.23,66.48,67.2,70695872,42921441.9,61.50084541552844,50.85448217793321,NaN,NaN,178.4306096432362,-68.65462837567509,0.041054476428116875,0.06539251286774572,0.024338036439628848,4085952274,4018685160.4,17.67246286129371,28.277322788293237,NaN,NaN,1.9259257808646943,0.7192491279416742
2013-01-03T09:30:00-05:00,67.2,67.34,66.64999,66.8521,47366432,42806178.7,59.02667885820323,51.075998701452626,NaN,NaN,147.7180152963991,-15.30963439224521,0.12454365559042449,0.18001760592765947,0.05547395033723498,4038585842,4017656632.4,17.585861637992252,26.74092809061039,NaN,NaN,4.9042756386657445,1.3171100580451127
2013-01-04T09:30:00-05:00,66.87,66.88,66.47,66.63,33973328,41801038.7,57.43803611921725,51.531471077403516,NaN,NaN,104.60117529447258,37.8050499040893,0.15566462286040716,0.25005472891274394,0.09439010605233678,4004612514,4020422066,18.738893949630736,25.40153507142252,NaN,NaN,6.64765103018981,2.078615911208641
2013-01-07T09:30:00-05:00,66.46001,66.75999,66.25,66.65041,26766192,40763394.7,57.5510998899054,52.36269563932802,NaN,NaN,84.08469567969657,87.6411474818747,0.16745242741710104,0.30370564032371306,0.13625321290661202,4031378706,4035157147.6,24.777819391220262,24.628488161617685,NaN,NaN,8.029302129428133,2.928713942382854
2013-01-08T09:30:00-05:00,66.64,66.815,66.17,66.52,28743936,40695957.9,56.518002687228694,52.61528023693876,NaN,NaN,71.56984408232844,117.28086799922657,0.1564980059261965,0.33187572031435764,0.17537771438816113,4002634770,4032632821.2,24.442696799188454,23.94250557320933,NaN,NaN,8.828497469297442,3.7715401605135095
2013-01-09T09:30:00-05:00,66.62,66.95,66.55,66.77,25609168,40315438.7,58.07184556332904,52.507700991730296,NaN,NaN,83.49627075390737,98.29400022136083,0.15578363349576496,0.37010725625786733,0.21432362276210237,4028243938,4021091154,22.91654581036144,23.22396760402749,NaN,NaN,9.944095749241086,4.65333381604602
2013-01-10T09:30:00-05:00,67.21001,67.27,66.55,67.17,37534256,40154611.5,60.503811402008516,52.75098536052981,NaN,NaN,93.1707527511141,87.38454771230383,0.1707425611770811,0.4277518242334537,0.2570092630563726,4065778194,4026529624.4,25.28385901120751,22.726408599784996,NaN,NaN,11.601737216560252,5.645962873262339
2013-01-11T09:30:00-05:00,67.14,67.28999,67,67.25999,21160464,38916750.7,61.05116147334781,53.033691379097675,NaN,NaN,96.41196528355405,85.74670571012012,0.17456776722396128,0.47521897208632424,0.30065120486236296,4086938658,4042994853.2,32.08434756023702,22.756767209893194,NaN,NaN,13.118840826329272,6.713516866557615
2013-01-14T09:30:00-05:00,66.89999,67.14999,66.67,66.96001,36777296,38482233.1,58.15781270134056,53.72736246445271,NaN,NaN,71.23000902978707,83.17576838013824,0.14592919901265222,0.48306270362817827,0.33713350461552605,4050161362,4046751384.4,33.569921793221084,22.965100897359104,NaN,NaN,13.621830288255218,7.700418783942987
2013-01-15T09:30:00-05:00,66.63,66.729,66.33211,66.63,31675280,38084484.3,55.06602228892824,54.268049063730864,NaN,NaN,42.01145860356944,77.26409128438644,0.09619520048532582,0.45737750522218334,0.36118230473685753,4018486082,4049921646.8,34.8648122882184,23.461324553946344,NaN,NaN,13.201514044910901,8.486289535509831
2013-01-16T09:30:00-05:00,66.75,67.13,66.60001,66.89999,33828112,37660748.3,57.07651374570895,55.239878836721,NaN,NaN,60.66776641180258,72.69839041596548,0.07391748327707992,0.45357915883320743,0.3796616755561275,4052314194,4054735698,36.876944306654885,24.414242355769307,NaN,NaN,13.387125633161043,9.186408978031434
2013-01-17T09:30:00-05:00,67.17999,67.48,67.06,67.22,32030736,36482485.1,59.39551976718362,56.426293349768635,NaN,NaN,82.77477579392558,70.61919502452774,0.07304035267909048,0.47096211640499064,0.39792176372590016,4084344930,4058449045.2,38.45624324038941,25.74620043648093,NaN,NaN,14.180820884670615,9.899896393265603
2013-01-18T09:30:00-05:00,67.00999,67.14,66.77,67.07001,31991952,36340460.3,57.81878272392627,57.79105568219711,NaN,NaN,60.5304371312365,63.44288939406424,0.05546190007288798,0.46724913881701013,0.41178723874412215,4052352978,4051531909.2,36.618348956986054,27.145392179721757,NaN,NaN,14.431276403050802,10.54723639466349
2013-01-22T09:30:00-05:00,67.14999,67.23,66.73,67.17999,32123008,35908897.1,58.68484879262045,58.4186415306055,NaN,NaN,59.68901025692325,61.13468963949148,0.04480114309657457,0.4677886676148404,0.4229875245182658,4084475986,4058394834,39.69767271864555,28.827602166089065,NaN,NaN,14.868966558748994,11.164626418104275
2013-01-23T09:30:00-05:00,67.56,67.78999,67.46001,67.59,31977408,34950540.3,61.831190898588616,58.442237636538366,NaN,NaN,95.33541283539275,71.79948048585614,0.05808022102756666,0.49558780080272413,0.4375075797751575,4116453394,4077988296.4,47.53468803930168,30.960618250232493,NaN,NaN,16.103340160836765,11.870156952780345
2013-01-24T09:30:00-05:00,66.69,67.28,66.56,66.66,42603376,36509797.6,52.13315500883646,57.9498430758693,NaN,NaN,34.78160953862773,66.62224911122117,0.00001952821453438114,0.43753199004332544,0.43751246182879105,4073850018,4082295461.2,49.10069419926755,33.21167771889502,NaN,NaN,14.401043154292696,12.231712124424966
2013-01-25T09:30:00-05:00,66.89,67.19,66.74001,67,39248720,37384191.2,54.9171484361583,57.76977966993652,NaN,NaN,44.60388760010352,58.98807147245675,-0.01866352482211575,0.41418305580114634,0.4328465806232621,4113098738,4088046222.8,51.195295887115854,35.529992143001095,NaN,NaN,13.770415624658211,12.451526910172573
2013-01-28T09:30:00-05:00,67.00999,67.38,66.92999,67.14999,32933920,36383730.4,56.129351909685866,57.66822624277798,NaN,NaN,62.6949316261917,59.4209703714478,-0.023769495959810982,0.4031347106734984,0.42690420663330936,4146032658,4106782158.8,57.35292532835602,37.85678542422507,NaN,NaN,13.592184614577171,12.614478010801802
2013-01-29T09:30:00-05:00,67.06,67.31,66.63,67.16,35554608,36507358.4,56.213968629472255,57.64650952436681,NaN,NaN,42.68904257447176,56.0209768349575,-0.02897697284259898,0.3906829905800606,0.4196599634226596,4181587266,4126204414.8,62.61820007443152,40.58360708674244,NaN,NaN,13.468771345579295,12.736519915770016
2013-01-30T09:30:00-05:00,67.28,67.48,66.87,67.02,34444960,35351951.2,54.62700076065238,57.400449181318486,NaN,NaN,61.02862674747575,49.159619617374105,-0.043482330383528334,0.3653070504432492,0.4087893808267775,4147142306,4132342197.2,64.12554818727187,43.52710725652175,NaN,NaN,12.939909168703448,12.765575523331934
2013-01-31T09:30:00-05:00,66.99001,67.35001,66.81,66.87,34870432,33560679.2,52.90371244795607,56.85758497031473,NaN,NaN,20.658373568799018,46.33497242340836,-0.06359409619148176,0.3292967605874253,0.39289085677890706,4112271874,4140026568.4,65.97536353339174,46.43364329382063,NaN,NaN,12.031485887625568,12.660705575373882
2013-02-01T09:30:00-05:00,67.34,67.78,67.07001,67.66,53124512,33848583.2,60.05149919944088,56.786180522178526,NaN,NaN,162.7137593383637,69.95694677106039,-0.02603201029267138,0.3603508439130678,0.3863828542057392,4165396386,4150486098,68.36636941408466,49.02521628338118,NaN,NaN,13.223847200290445,12.741154378933391
2013-02-04T09:30:00-05:00,67.25,67.4599,66.46001,66.48,48483696,34574101.6,48.267791955458016,56.079750468901196,NaN,NaN,-59.40951284183223,45.536057877455605,-0.07995160358706593,0.28644334972190677,0.3663949533089727,4116912690,4144662104.4,65.60199040826483,51.31322118445572,NaN,NaN,10.485175399957928,12.418871667651182
2013-02-05T09:30:00-05:00,66.75999,67.67,66.61,67.46001,35129984,34992291.2,55.991530115236216,56.145858170780336,NaN,NaN,76.44463955599764,52.287177273760776,-0.050354569026822504,0.30345174202544456,0.35380631105226706,4152042674,4138753186,62.826316436382875,53.310471480753186,NaN,NaN,10.755703594670157,12.181276228653893
2013-02-06T09:30:00-05:00,67.22,67.55,67.03999,67.24001,43595136,35734851.2,54.0409388749668,55.929031394298754,NaN,NaN,77.14941459648762,55.51133484356315,-0.04642952208101858,0.29576940845099386,0.34219893053201245,4108447538,4131014232.4,59.288149916842094,54.91127188148085,NaN,NaN,10.316826522784538,11.914926270672556
2013-02-07T09:30:00-05:00,67.33,67.371,66.56,67.3,46011200,36754952.8,54.50634874819666,55.57980489294254,NaN,NaN,0.9967687354636109,51.57901387689607,-0.04082680710476322,0.2911654216510584,0.33199222875582163,4154458738,4139451605.2,61.81314339520567,56.57962189253915,NaN,NaN,10.1174992153257,11.658150977051577
2013-02-08T09:30:00-05:00,67.64,68.13,67.63,67.99001,39845728,36870526.4,59.576900928524985,55.705384764699595,NaN,NaN,242.7724229537103,67.5907465999654,0.005833191224258849,0.3392837177861452,0.33345052656188634,4194304466,4145233221.2,63.484405206830836,58.49862591038521,NaN,NaN,11.583041070334735,11.647420990377743
2013-02-11T09:30:00-05:00,68.02,68.06,67.78,68.00999,17650352,36695020.8,59.7169086654523,55.779103327044716,NaN,NaN,199.1356567873537,119.29978052580259,0.0330080608221609,0.37471060258958744,0.34170254176742654,4211954818,4164241646.8,68.3835987926315,60.54762062995563,NaN,NaN,12.782337486231665,11.809551918356874
2013-02-12T09:30:00-05:00,67.92,68.05,67.66,67.73,22061312,35959221.6,56.750546340434106,55.416200144319404,NaN,NaN,137.96434067381537,131.60372074936612,0.02732686098954007,0.3758611180043516,0.34853425701481155,4189893506,4171811813.2,70.10390084866944,62.15970725919619,NaN,NaN,12.906847908635902,11.966308488396734
2013-02-13T09:30:00-05:00,67.92999,68.23,67.765,67.97,23497136,35550314.4,58.64677066497079,55.881458405471854,NaN,NaN,151.51934551841848,146.4777069337523,0.03447219481337849,0.39162450053153464,0.35715230571815615,4213390642,4192800434,74.28211489598827,63.95838016610481,NaN,NaN,13.564120512410083,12.19456734897007
2013-02-14T09:30:00-05:00,67.64,68.05,67.62,67.95,24482416,35083029.6,58.41691714492111,56.131441884669194,NaN,NaN,108.02203515029387,167.88276021671837,0.032611219538116853,0.3979163301408022,0.36530511060268533,4188908226,4199690331.6,75.49293868904324,65.6939260805282,NaN,NaN,14.037295380729203,12.457814210649946
2013-02-15T09:30:00-05:00,67.95,68.11,67.56,67.75,25334048,34748195.2,56.051127678087305,56.12585443955502,NaN,NaN,83.06695915024147,135.9416674560246,0.01364131254669454,0.3823567512860535,0.36871543873935897,4163574178,4193544274,72.22623881120175,66.75630561501717,NaN,NaN,13.794495367089965,12.64876866156995
2013-02-19T09:30:00-05:00,67.89,68.25999,67.86,68.24001,23433248,34320260,60.293940561710606,56.41728100614347,NaN,NaN,121.3156690052189,120.37766989959762,0.028946027381629214,0.4048979729663955,0.3759519455847663,4187007426,4188554795.6,69.59345904198962,67.25453839841418,NaN,NaN,14.782472802817557,12.953583538891037
2013-02-20T09:30:00-05:00,68.24001,68.25,67.17999,67.19,38200240,34624121.6,49.30883861013638,56.037412281106604,NaN,NaN,18.82565955410012,96.54993367565457,-0.033415339757987994,0.3341827708872813,0.3675981106452693,4148807186,4180337531.6,65.36738208576482,67.3432408197351,NaN,NaN,12.208267343422046,12.847109796681181
2013-02-21T09:30:00-05:00,66.96001,67.00999,66.23,66.47,45855568,35318029.6,43.461492459931804,55.36296799624773,NaN,NaN,-132.24771679398611,39.79652121317365,-0.12005058896947485,0.21753487443342578,0.33758546340290063,4102951618,4158249726.8,55.59472684669269,66.60176677068517,NaN,NaN,7.996855336832071,12.154216302417023
2013-02-22T09:30:00-05:00,66.84,67.14999,66.59,67.13901,21969536,34286337.6,49.4588994475151,54.60635372825304,NaN,NaN,-70.68799347599905,4.05451548791506,-0.1284416814833761,0.17703336154868055,0.30547504303205664,4124921154,4145452312.4,50.85114315430099,65.35067918070062,NaN,NaN,6.4347775351410545,11.337153621377599
2013-02-25T09:30:00-05:00,67.60001,67.81,66.25,66.31,40927520,34370277.6,43.325829587780504,54.25335641627607,NaN,NaN,-95.22976017455878,-31.60482837704499,-0.18265836966420118,0.07715208095180515,0.2598104506160063,4083993634,4129536203.6,45.635852860736144,63.92452649873429,NaN,NaN,2.934681062479513,10.136800398677872
2013-02-26T09:30:00-05:00,66.42,66.67999,65.96001,66.56,42088736,34828018.4,45.519830657243325,53.505377883562296,NaN,NaN,-140.73447754780935,-84.01485768765063,-0.1934793122281048,0.017961310330875335,0.21144062255898013,4126082370,4117351192.4,42.07785958091194,62.44249386620066,NaN,NaN,0.905498744725927,8.81804301954188
2013-02-27T09:30:00-05:00,66.57001,67.64999,66.47,67.239,36339456,34867260.8,51.0612267125433,53.292541300532044,NaN,NaN,-33.92083698037939,-94.56415699454654,-0.1487146341974822,0.025547329812127373,0.17426196400960958,4162421826,4120074120.4,43.144616465304864,61.289384333948,NaN,NaN,1.0623049638118383,7.7100804401518745
2013-02-28T09:30:00-05:00,67.24001,67.74001,67.09,67.10001,28557152,34572870.4,49.941427498809446,52.96647549700439,NaN,NaN,-6.707172803338903,-69.4560481964171,-0.1233198645361143,0.02011213333946671,0.143431997875581,4133864674,4126256731.6,45.59470880852395,60.130924720613585,NaN,NaN,0.829144684192076,6.727089617871903
2013-03-01T09:30:00-05:00,66.86,67.5,66.53999,67.38,31617696,34410233.6,52.214876796590275,52.440616630437624,NaN,NaN,-34.35017082524861,-62.188483666267004,-0.08437761826897947,0.037959975039356664,0.12233759330833613,4165482370,4134368974.8,48.71743772459401,59.07614132902524,NaN,NaN,1.3450020476346558,5.958219964980868
2013-03-04T09:30:00-05:00,67.19,67.69,67.07001,67.67999,19380448,32723030.4,54.594271034113085,52.07471394248483,NaN,NaN,18.9595583261297,-39.350619966129315,-0.037516826085702684,0.07544156070120778,0.11295838678691046,4184862818,4154542811.6,55.55018459518684,58.15946888635062,NaN,NaN,2.4996028556778422,5.464131806509007
2013-03-05T09:30:00-05:00,68.10001,68.77,68.08,68.67999,35589440,32078317.6,61.47983799040385,52.41252048891124,NaN,NaN,155.98298761837563,19.992873067107684,0.056609148394582864,0.18371982228013906,0.1271106738855562,4220452258,4173416789.2,60.8109610149045,57.49568746965313,NaN,NaN,5.8317743388717505,5.5166521682751135
2013-03-06T09:30:00-05:00,68.88989,68.908,68.42,68.50999,29070976,31775367.2,59.81909474566399,52.49625792324647,NaN,NaN,146.5447285802882,56.085986179241196,0.1006300939751193,0.2528982913544553,0.152268197379336,4191381282,4179208680.4,62.28606741324194,56.638826935171245,NaN,NaN,7.980866841699102,5.868682835907112
2013-03-07T09:30:00-05:00,68.57001,68.8,68.45,68.69,21775872,30684404,61.0198263547467,52.68218000966259,NaN,NaN,130.91691753189562,83.6108042462881,0.1330459916017896,0.318575686881573,0.1855296952797834,4213157154,4195067176.4,66.05376964501896,55.9646005748838,NaN,NaN,10.095979799936936,6.472582402197087
2013-03-08T09:30:00-05:00,68.92999,69.02,68.5,68.77,26162112,29691949.6,61.569469285963315,53.076347267368014,NaN,NaN,128.8446013266544,116.24975867666872,0.14980313179410093,0.37278361002240956,0.22298047822830863,4239319266,4209834555.6,69.14496795361003,55.744509799341536,NaN,NaN,11.978743771687016,7.259176883552791
2013-03-11T09:30:00-04:00,68.67999,68.99001,68.47,68.97,23194128,28859369.6,62.975050813040475,53.267855142463006,NaN,NaN,120.54842547584666,136.5675321066121,0.1631839172270585,0.4269603747621318,0.2637764575350733,4262513394,4225364670.8,72.0295969900443,55.918519652774016,NaN,NaN,13.962453118788606,8.216787774300764
2013-03-12T09:30:00-04:00,68.78999,68.9299,68.39,68.72,27579248,29355814.4,60.01996502529951,54.03293560068895,NaN,NaN,97.05340383341931,124.78161534962085,0.14465714815058817,0.4445978927233085,0.29994074457272035,4234934146,4228261048.4,72.54512075796876,56.43121527221716,NaN,NaN,14.841689508599076,9.163202307771952
2013-03-13T09:30:00-04:00,68.8,68.89,68.39,68.63,34297264,29967612,58.94757032274586,55.13908401946138,NaN,NaN,83.44696479173412,112.16206259191003,0.11698366921774755,0.4461703310949048,0.3291866618771572,4200636882,4230112168.4,72.88904192892022,57.666523492376264,NaN,NaN,15.289964090574188,10.038453991029414
2013-03-14T09:30:00-04:00,68.87,69.00999,68.711,68.86,31537680,30369639.2,60.8716390801302,55.95427970750531,NaN,NaN,95.28695473660704,105.03607003285231,0.10518292221820669,0.46066531464991556,0.35548239243170887,4232174562,4233915650,73.6202508220335,59.292888325785725,NaN,NaN,16.193767672152596,10.917784516904154
2013-03-15T09:30:00-04:00,68.75,68.78999,68.34,68.50999,30743664,30682701.6,56.52958880020371,56.89740536553553,NaN,NaN,60.29929079018253,91.32700792555794,0.06669489439913284,0.4388510104306249,0.37215611603149207,4201430898,4226337976.4,69.593063663308,61.00411766882657,NaN,NaN,15.806699256680723,11.616200908300806
2013-03-18T09:30:00-04:00,67.88499,68.6367,67.73,68.36,36164496,31224224,54.72799882695926,57.55513166337239,NaN,NaN,30.87490273420609,73.39230337722982,0.02611019995913344,0.4047938659804089,0.37868366602127546,4165266402,4206888578,60.45248592592656,62.31659097918475,NaN,NaN,14.990982149228332,12.098312514147596
2013-03-19T09:30:00-04:00,68.53999,68.7,67.62,68.23,33134576,31709290.4,53.14702450803344,57.70411722019311,NaN,NaN,25.38774635234148,59.05917188101425,-0.012444923081660453,0.3631275121691999,0.37557243525086037,4132131826,4186328114,52.58901713768704,62.991191027212054,NaN,NaN,13.874688881551513,12.35208056663387
2013-03-20T09:30:00-04:00,68.74001,68.86,68.39,68.709,28035344,31201045.6,57.96538377154744,58.27725695396011,NaN,NaN,60.480561471197795,54.465891216906996,-0.00881350506762224,0.36455555391633254,0.3733690589839548,4160167170,4178234171.6,49.84052503898404,63.29446361510206,NaN,NaN,14.182405602020332,12.613555571689078
2013-03-21T09:30:00-04:00,68.09,68.25,67.77,67.92999,30050784,30410806.4,49.118345018869114,58.05607611269432,NaN,NaN,-3.1706198871718416,34.77437629215122,-0.05919391684088915,0.2993766629328434,0.3585705797737325,4130116386,4157822536.4,43.64552226478053,62.932183939401106,NaN,NaN,11.770427326456037,12.493108679512929
2013-03-22T09:30:00-04:00,68.21001,68.64,68.13,68.59,28838416,30754250.4,55.3379151947854,58.10919355274234,NaN,NaN,37.65207224367765,30.244932582850247,-0.04881706320989504,0.29754925076136374,0.3463663139712588,4158954802,4149327317.2,41.34230424364064,61.91733534286209,NaN,NaN,11.600628032698758,12.365611444253762
2013-03-25T09:30:00-04:00,68.81,68.96001,68.00999,68.34,24909760,29953362.4,52.70968303837539,57.48275391331174,NaN,NaN,31.30103351300744,30.330158738610514,-0.05886615279060786,0.27278362298299896,0.3316497757736068,4134045042,4143083045.2,39.68459186630371,60.40830897510489,NaN,NaN,10.640300214641272,12.119138411451978
2013-03-26T09:30:00-04:00,68.60001,68.73,68.45,68.71001,19734752,28835663.2,56.03765684399778,57.21265120604987,NaN,NaN,50.72525117360717,35.397659702863656,-0.04148928036577859,0.27978817531638356,0.32127745568216215,4153779794,4147412638.8,41.43798976324994,58.91916057153403,NaN,NaN,10.86184836377247,11.939525547497762
2013-03-27T09:30:00-04:00,68.25,68.85001,68.14,68.80099,22539424,28145661.6,56.8418995852924,56.91422786537456,NaN,NaN,41.64690217290137,31.63092784320437,-0.02554575092415068,0.28934526702697383,0.3148910179511245,4176319218,4150643048.4,42.77469445761768,57.256369486719656,NaN,NaN,11.279935815083823,11.8452984428672
2013-03-28T09:30:00-04:00,68.81,69.06,68.64,68.97,23669808,27901294.4,58.36563450685354,56.685382524009576,NaN,NaN,95.37942606327724,51.340937033294175,-0.006298483013277789,0.3070179141845273,0.3133163971978051,4199989026,4164617576.4,48.274970470961804,55.765655380816206,NaN,NaN,12.069358781344022,11.877307062649603
2013-04-01T09:30:00-04:00,69.00999,69.09,68.31,68.5,28118832,27726351.2,52.78448649254484,55.9574850725456,NaN,NaN,35.074751491554146,50.825472882869484,-0.026755239261702923,0.2798723481206764,0.30662758738237933,4171870194,4167200654.8,49.24604239773457,54.13825862422266,NaN,NaN,11.106461704916853,11.76718629725921
2013-04-02T09:30:00-04:00,68.81,69.27,68.77,69.03999,29431872,28228922.4,57.77976305770499,55.79747064628885,NaN,NaN,164.3027299383466,77.42581216793731,-0.006509148811152998,0.29849115136843807,0.30500030017959107,4201302066,4180652059.6,54.08064890159164,52.81936777733858,NaN,NaN,11.796512520642883,11.771375757742591
2013-04-03T09:30:00-04:00,69.08,69.17999,68.24001,68.41,35131104,28206005.6,51.00050840127336,55.229823366183666,NaN,NaN,5.8969520462793374,68.46015234247173,-0.03646319075797205,0.259421311732126,0.29588450249009807,4166170962,4183130293.2,54.93240429254655,51.53675080331188,NaN,NaN,10.21907004783916,11.549617799184958
2013-04-04T09:30:00-04:00,68.41,68.60001,68.06,68.42999,32287360,28366824.8,51.19617822135683,54.53871901912843,NaN,NaN,-78.1791667719268,44.49493855350611,-0.054748150662011275,0.22744931416258396,0.28219746482459523,4198458322,4187558114,56.485456513380086,50.31283692412236,NaN,NaN,9.031158022149038,11.18983783103697
2013-04-05T09:30:00-04:00,67.35001,67.96001,67.19,67.86099,55613280,30058695.2,45.61272999283052,53.758943390030346,NaN,NaN,-239.58522068575482,-22.497990796300304,-0.10222381189890117,0.15441769995096877,0.25664151184986994,4142845042,4176129317.2,51.547736838428015,49.0238850080595,NaN,NaN,6.223961601838141,10.480426941151423
2013-04-08T09:30:00-04:00,67.88,68.24001,67.69,68.22,17898512,29645515.2,49.36500519981125,53.37587241666263,NaN,NaN,-114.82608205854875,-52.47815750632088,-0.10605046765701243,0.12407842727860441,0.23012889493561683,4160743554,4173903989.2,50.61986294215264,48.321554794932794,NaN,NaN,5.026071853554223,9.701233357208967
2013-04-09T09:30:00-04:00,68.42,68.96001,68.09,68.67999,30931360,30032376.8,53.76631983898038,53.420107797444565,NaN,NaN,24.07635843566022,-80.52343180685816,-0.0756321546247925,0.13558870165462622,0.21122085627941872,4191674914,4171978558.8,49.784846547440154,48.12125689562945,NaN,NaN,5.390355333684125,9.085393639562561
2013-04-10T09:30:00-04:00,68.89,70.17,68.88,70.015,55271264,31416977.6,63.64352772956232,53.825689508731344,NaN,NaN,263.8723426937952,-28.928353677354995,0.030669776349821515,0.2495580767166956,0.2188883003668741,4246946178,4188133602,56.2986398620842,48.58255081156517,NaN,NaN,9.323023015481304,9.119340693265238
2013-04-11T09:30:00-04:00,69.84,70.14999,69.77,69.99001,37238272,31564028,63.370611070593185,54.84370851242592,NaN,NaN,257.9341375444913,38.29430718592863,0.0920996406472882,0.33401285117598434,0.24191321052869613,4209707906,4190383518.8,57.132645300528786,49.54591674269005,NaN,NaN,12.214718906154538,9.561537580820852
2013-04-12T09:30:00-04:00,69.85001,69.99001,69.41,69.94,32791328,31626710.4,62.79032279078591,55.37602334071166,NaN,NaN,183.29942372166306,122.8712360674122,0.12037767621377282,0.39238530579591213,0.2720076295821393,4176916578,4197197826,59.64462022929483,50.853225027379644,NaN,NaN,14.305436520407028,10.239237429333164
2013-04-15T09:30:00-04:00,69.67999,69.78999,68.48,68.56,48795792,32529316.8,49.358747517690816,55.13667080351991,NaN,NaN,42.683031205599264,154.3730587202418,0.041243186662866804,0.32356161291072283,0.282318426247856,4128120786,4190673272.4,56.246063474094186,52.03618728507895,NaN,NaN,11.548884040657386,10.426329802379481
2013-04-16T09:30:00-04:00,68.99001,69.55,68.81,69.47,27682576,32105220.8,56.037076229877954,55.13662933108278,NaN,NaN,81.81683713680961,165.92115446047168,0.0449814165780017,0.3385451969703581,0.2935637803923564,4155803362,4183498962,52.69079774891904,52.83995928405532,NaN,NaN,11.651847361039202,10.60140373933087
2013-04-17T09:30:00-04:00,68.84,68.88901,67.71001,68.11501,60204800,33458732,46.25555074778937,54.380461556975426,NaN,NaN,-71.75719403041053,98.79524711563054,-0.044182194763773885,0.23833603693763905,0.28251823170141294,4095598562,4153229438.8,40.93431183582077,52.70850338249839,NaN,NaN,7.898799920790305,10.21531747953936
2013-04-18T09:30:00-04:00,68.33,68.33,66.88,67.16901,56798112,34896870.4,40.88919550656634,53.13214448552634,NaN,NaN,-162.895729277114,14.629273751309489,-0.1606992900714173,0.08164411911214131,0.24234340918355862,4038800450,4119047947.6,32.197784315173195,51.56013294279921,NaN,NaN,2.769524452069495,9.15163276132938
2013-04-19T09:30:00-04:00,67.31,68.231,67.2,68.09,43066864,35547674.4,47.29950132105596,52.74035983042,NaN,NaN,-109.32326322052518,-43.89526363712817,-0.16873979417327728,0.03141866646696201,0.2001584606402393,4081867314,4100038094.8,28.548504607431724,50.081737386349005,NaN,NaN,1.149723451770439,8.008502859963816
2013-04-22T09:30:00-04:00,68.33,69.03999,68.08,68.78999,34412096,35826358.4,51.59600047945581,52.29866250340219,NaN,NaN,-3.960147005898773,-53.22389927942778,-0.12208688751707117,0.04754985124390032,0.1696367387609715,4116279410,4097669819.6,28.120894082078678,48.22746918495522,NaN,NaN,1.4970125859514511,7.078289963676335
2013-04-23T09:30:00-04:00,69.2,69.7,68.82001,69.45,53078208,37234780.8,55.29669315131052,52.60553284269056,NaN,NaN,78.35524433678196,-53.916217839433294,-0.045872002529472655,0.11229673559913067,0.15816873812860333,4169357618,4100380670.8,29.424001594337014,46.4054404207974,NaN,NaN,3.1254762285451934,6.513602287229029
2013-04-24T09:30:00-04:00,69.25999,69.67,69.12,69.42,44500624,38473074.4,55.09051907433279,52.88370004647455,NaN,NaN,78.44676994843513,-23.875425043664162,0.0009461729172628996,0.15935145427518194,0.15840528135791904,4124856994,4106232357.2,32.278086256833944,44.67634254532982,NaN,NaN,4.283125379733431,6.194962729015372
2013-04-25T09:30:00-04:00,69.63,70.05,69.59,69.78999,26437040,38667955.2,57.20954010749118,53.71204362609318,NaN,NaN,110.85844231775664,30.87540927530996,0.05240904504334715,0.22391658766210298,0.17150754261875584,4151294034,4128731074,41.99132676571138,43.99374182585006,NaN,NaN,5.902618085012415,6.153199208443521
2013-04-26T09:30:00-04:00,69.62,69.77,69.27,69.57001,24083904,38688660,55.53182928214062,54.152531060545265,NaN,NaN,73.06379754418055,67.3528214282511,0.06631539633269729,0.25440178803462743,0.18808639170193014,4127210130,4137799637.2,45.39120182143007,43.620266031512735,NaN,NaN,6.690608106626114,6.229971908183892
2013-04-29T09:30:00-04:00,69.78,70.48,69.75999,70.21001,31663920,38865914.4,59.273828525447676,54.545924538150075,NaN,NaN,120.56881205616172,92.25861324066321,0.11068382236600169,0.32644116965943226,0.21575734729343057,4158874050,4146318565.2,48.44786661084967,43.52476746461341,NaN,NaN,8.533169902875478,6.559000193139832
2013-04-30T09:30:00-04:00,70.28999,70.73,70.03999,70.72,30146320,38901636.8,62.01674733884134,54.429725938812865,NaN,NaN,133.40686753955194,103.2689378812172,0.1632702151992041,0.4198451162924357,0.2565749010932316,4189020370,4150251115.6,49.84354721377199,43.06368941830539,NaN,NaN,10.935676580452638,7.184239677041662
2013-05-01T09:30:00-04:00,70.71001,70.85001,70.25,70.39,28539536,38572058.4,59.23660830813906,54.134440027209,NaN,NaN,117.72744497555873,111.12507288664192,0.16427247953008578,0.46191550050583885,0.29764302097575307,4160480834,4157375883.6,52.360019151709565,42.72278755053259,NaN,NaN,12.087871619501051,7.884758525964432
2013-05-02T09:30:00-04:00,70.50999,71.42999,70.45,71.28,31744160,38544898.4,63.93265546092475,54.216035217933204,NaN,NaN,146.46136096228938,118.24565661554848,0.21037341076176008,0.5606097844279532,0.3502363736661931,4192224994,4165562075.6,55.14469696793073,42.40136446043515,NaN,NaN,14.590877917697659,8.842775581926322
2013-05-03T09:30:00-04:00,71.94,72.34,71.91,72.12,34061648,37467316.8,67.71325255594752,55.5270712920944,NaN,NaN,205.92532332955233,144.81796177262282,0.2786542589589763,0.6985541973649134,0.41989993840593715,4226286642,4185377378,61.07569411404326,42.746338077574364,NaN,NaN,17.987763554123653,10.149202435097369
2013-05-06T09:30:00-04:00,72.25,72.50999,72.19,72.39999,19244272,37534604.8,68.88403816546145,56.44471143035037,NaN,NaN,193.09314009117904,159.3228273796263,0.32088401518586507,0.8210049573882685,0.5001209422024034,4245530914,4202708750.8,65.38665810459865,43.653185245837186,NaN,NaN,21.10300903496778,11.71403194936457
2013-05-07T09:30:00-04:00,72.5,72.57001,72.09,72.36,25838016,37279937.6,68.5019622535812,58.03374082362121,NaN,NaN,162.5903227705266,165.1595184258212,0.3234199624093639,0.9043958952141082,0.5809759328047444,4219692898,4208843256.4,66.78873001350345,45.499929401385955,NaN,NaN,23.483174003277675,13.395337957066442
2013-05-08T09:30:00-04:00,72.31,72.77,72.2,72.71001,24257984,35729273.6,70.06689802105976,60.11786243179931,NaN,NaN,146.86755529311534,170.98754048933253,0.32509540997592956,0.9873451952746564,0.6622497852987268,4243950882,4225537266,70.31292508424684,48.2224394563198,NaN,NaN,25.95026124713897,15.188898427076802
2013-05-09T09:30:00-04:00,72.55,73.099,72.47,72.60651,29344432,35334581.6,68.9755759618832,61.66615347757268,NaN,NaN,131.57025391805956,168.0093190804866,0.29646077638086565,1.0328257557748088,0.7363649793939432,4214606450,4230013557.2,71.19555042605027,51.268657014792545,NaN,NaN,27.685338179158613,16.97410410594563
2013-05-10T09:30:00-04:00,72.73,73.08,72.63,73.05,20663680,34728199.2,71.05588780270209,63.05614542923313,NaN,NaN,121.00871085563928,151.02599658570398,0.28456137578147933,1.0920666991207924,0.807505323339313,4235270130,4231810254.8,71.56103089496797,54.37152392999892,NaN,NaN,29.78317625197466,18.80397155537835
2013-05-13T09:30:00-04:00,72.92999,73.32001,72.86,73.14,29730016,33774910.4,71.47392041501355,64.21166166235477,NaN,NaN,114.20007629328327,135.2473838261248,0.2605676023315485,1.1332148262537487,0.8726472239222002,4265000146,4235704101.2,72.37899195447358,57.43973752715153,NaN,NaN,31.64314713868666,20.638139495850965
2013-05-14T09:30:00-04:00,73.13,73.74001,73.13,73.52,36017632,34191663.2,73.23182183078292,65.50746900210122,NaN,NaN,112.6686105241493,125.26304137684936,0.2481643397718929,1.1828526486370663,0.9346883088651734,4301017778,4251969077.2,75.54328177077274,60.53010863529001,NaN,NaN,33.751959771385216,22.511542392355857
2013-05-15T09:30:00-04:00,73.38,73.74001,73.2,73.67,27214320,32542139.2,73.91515581355245,66.70072726681988,NaN,NaN,103.6763990063922,116.62481011950472,0.22843230500467615,1.2202286901210186,0.9917963851163425,4328232098,4268825320.4,78.31578736805582,63.12471296402891,NaN,NaN,35.72164097657234,24.398699332958213
2013-05-16T09:30:00-04:00,73.77,74.095,73.55,73.59,27253360,31064901.6,72.84706137616087,67.9375295592499,NaN,NaN,102.19121514348387,110.74900236458957,0.18994241755952057,1.2292244070657432,1.0392819895062226,4300978738,4286099778,80.72708081841616,65.6487043209565,NaN,NaN,37.11251455456097,26.214958650330036
2013-05-17T09:30:00-04:00,73.95,74.33,73.7301,74.3,31117104,30467413.6,76.14210603892624,69.14240652449836,NaN,NaN,108.89459498269761,108.32617919000127,0.1916962121821819,1.27890225473395,1.087206042551768,4332095842,4305464920.4,83.00819434494626,68.11729915910624,NaN,NaN,39.324932937476696,28.087812119922415
2013-05-20T09:30:00-04:00,74.09,74.425,73.89,74.19,25135776,30003597.6,74.6310415817391,70.0434275418482,NaN,NaN,104.07303713706554,106.30077135875771,0.16581463148892395,1.294474331912923,1.128659700423999,4306960066,4313856904.4,83.89763640793527,70.54973410154648,NaN,NaN,40.776540941639134,29.900487665881947
2013-05-21T09:30:00-04:00,74.17999,74.53999,73.89,74.27,25899968,28644685.6,75.01932096400131,71.17076416012408,NaN,NaN,101.62951674902797,104.09295260373344,0.13571591920039872,1.2983045994244975,1.1625886802240988,4332860034,4320225355.6,84.55822229272067,72.84960575447583,NaN,NaN,42.103096748406806,31.64371753481407
2013-05-22T09:30:00-04:00,74.36,74.95,73.24001,73.619,59843168,29411812.8,66.1471749763534,71.32894412551184,NaN,NaN,83.24699717327249,100.0070722371095,0.05759177847823338,1.2345784033218905,1.1769866248436571,4273016866,4309182309.2,78.54126012662226,74.52078883723951,NaN,NaN,40.85256858934399,32.9592676854612
2013-05-23T09:30:00-04:00,72.95,73.7,72.83,73.45,48229440,30501432.8,64.03012882572216,71.06586385906716,NaN,NaN,46.351636522953704,88.83915651300347,-0.01590952318095451,1.157099720867464,1.1730092440484186,4224787426,4293944046.8,71.03028649637758,75.23183115026339,NaN,NaN,39.20809855441711,33.85195780959776
2013-05-24T09:30:00-04:00,72.96001,73.42999,72.75999,73.41,26435952,30619035.2,63.512005882626646,70.68214726743611,NaN,NaN,32.97162031704158,73.65456157987225,-0.07439151953265322,1.0800198446326021,1.1544113641652554,4198351474,4267195173.2,60.155336536143466,74.85816532394517,NaN,NaN,37.695538634460995,34.40104078457822
2013-05-28T09:30:00-04:00,74.25,74.53999,73.66,73.89,27065808,30389129.6,66.96638846288492,70.57246342524347,NaN,NaN,83.73299068891576,69.5865522902423,-0.08703924489818715,1.0456123080425215,1.1326515529407086,4225417282,4250886616.4,54.66053174172354,73.99186544738946,NaN,NaN,37.25364529319285,34.80855571438031
2013-05-29T09:30:00-04:00,73.59,73.8,73.12,73.53999,32095600,30486593.6,62.33236777059811,70.01999697878193,NaN,NaN,37.63347229871117,56.78734340017894,-0.12306684160387915,0.9788180009358598,1.101884842539739,4193321682,4222978946,46.78503735490687,72.31130203815088,NaN,NaN,35.5630830229844,34.91634532989518
2013-05-30T09:30:00-04:00,73.57001,74.27499,73.55,73.92999,32390464,30679140,65.22035380298041,69.75176682457459,NaN,NaN,71.098739285064,54.35769182253724,-0.12435365894254424,0.9464427688615586,1.070796427804103,4225712146,4213518002,44.447048323089504,70.40069474508226,NaN,NaN,34.886685980947945,34.91210828004557
2013-05-31T09:30:00-04:00,73.64999,74.21001,73.17,73.25,38354672,31009665.6,57.012667812772364,68.74867968243674,NaN,NaN,24.731656384107115,50.03369579476792,-0.17179900668879067,0.8560476694431145,1.0278466761319052,4187357474,4206032011.6,42.631669333090656,68.33431177637674,NaN,NaN,31.76209577468307,34.462106493565216
2013-06-03T09:30:00-04:00,73.31,73.39999,72.42999,73.38,47613024,31687234.4,58.098329299191725,67.7932803170209,NaN,NaN,-43.574470492998245,34.72447763275996,-0.19360522932334212,0.7858401394777275,0.9794453688010696,4234970498,4213355816.4,44.998520397006054,66.3785638079862,NaN,NaN,29.508643937060615,33.75446898549313
2013-06-04T09:30:00-04:00,73.52,73.82001,72.7,73,35256032,32487822.4,53.81955874316708,66.40669009647691,NaN,NaN,-38.478835691466166,10.282112356683573,-0.23030396989373947,0.6915654064338952,0.9218693763276347,4199714466,4208215253.2,43.63764413201239,64.09958969093188,NaN,NaN,26.283176377158846,32.687141470016805
2013-06-05T09:30:00-04:00,72.77,73.03999,71.99001,72.05,48654176,33628630.4,44.91398958221166,64.33517822280972,NaN,NaN,-160.8853522089263,-29.42165254484392,-0.3102644026108121,0.5340388730641195,0.8443032756749316,4151060290,4199762974.8,41.41958110845306,61.46414638667454,NaN,NaN,20.331411858684348,30.922037239826455
2013-06-06T09:30:00-04:00,72.14999,72.41,71.47,72.39999,62524016,35541932,48.307621805505626,62.582361110620056,NaN,NaN,-186.6409708605508,-80.96959457396687,-0.3294792877158782,0.4324541660300838,0.761933453745962,4213584306,4197337406.8,40.77900090743423,58.61071210731869,NaN,NaN,16.483816176069176,28.85943423071827
2013-06-07T09:30:00-04:00,72.73,73.47,72.52,73.39,31971152,35673268,56.47576322362513,61.17762233809855,NaN,NaN,-44.8821160508948,-94.89234906096726,-0.2680172332461619,0.42691191218825963,0.6949291454344215,4245555458,4208977003.6,45.161880390005045,55.90740396768003,NaN,NaN,15.804733482615637,26.994476980989322
2013-06-10T09:30:00-04:00,73.55,73.75999,73.25999,73.42,25393168,35909742.4,56.69904872777557,59.89676570567258,NaN,NaN,3.8328579514095673,-85.41088337208569,-0.21986510843226448,0.4200977598940909,0.6399628683263554,4270948626,4216172629.2,47.73697758534237,53.32449976606626,NaN,NaN,15.351821389253919,25.331240467884264
2013-06-11T09:30:00-04:00,72.67,73.34,72.44,72.69,40281424,36437312.8,49.979943881325696,58.10823877119575,NaN,NaN,-94.54471040812565,-96.6240583154176,-0.2305799110659834,0.3517379794938762,0.5823178905598596,4230667202,4222363176.4,49.9159689630952,50.850053099664436,NaN,NaN,12.727629329414391,23.530724590959995
2013-06-12T09:30:00-04:00,73.12,73.14,71.74001,71.85001,42081840,36740523.2,43.58022300330759,56.496313630263906,NaN,NaN,-151.35146499915035,-94.71728087346241,-0.2841234423069944,0.22716358767611666,0.511287029983111,4188585362,4229868190.8,52.50149042103485,48.99006954926534,NaN,NaN,8.227773944783985,21.344588784363424
2013-06-13T09:30:00-04:00,71.75999,72.92,71.55,72.75999,28230368,36791325.6,50.91308368135939,55.559381834238,NaN,NaN,-112.48080710641412,-79.88524812263508,-0.24937777857628773,0.19956480676275135,0.4489425853390391,4216815730,4230514475.6,52.72780458643551,47.682749412840906,NaN,NaN,6.989437361735424,19.29385286684514
2013-06-14T09:30:00-04:00,72.75999,72.84,72.17101,72.28,27697008,36813508,47.41265398075073,54.40942812696115,NaN,NaN,-97.6284744536107,-90.43451980317825,-0.24925183876581436,0.13737778688177116,0.3866296256475855,4189118722,4219227128.4,48.391191308815586,46.84245332517463,NaN,NaN,4.779148392486405,17.22032365622246
2013-06-17T09:30:00-04:00,72.88,73.39999,72.60001,72.98,32443504,36879828,52.53763079930712,53.37880257956274,NaN,NaN,-26.27927529442732,-96.45694645234563,-0.19495917269880403,0.14293065977408048,0.3378898324728845,4221562226,4209349848.4,44.910324814286156,46.14600997321482,NaN,NaN,4.739015847397084,15.437279683533122
2013-06-18T09:30:00-04:00,73.07001,73.72,73.06,73.58,24861264,36866102.4,56.45493657717937,52.95898606574712,NaN,NaN,38.62819565491506,-69.82236523973748,-0.11549937825866613,0.19351560964955183,0.30901498790821796,4246423490,4212501106,46.239002362032856,46.10700747372381,NaN,NaN,6.068844990644311,14.098931870263291
2013-06-19T09:30:00-04:00,73.57001,73.67999,72.67999,72.75999,43145072,37728357.6,50.339850647592556,51.89609298321942,NaN,NaN,-9.917962194927565,-41.53566467889293,-0.11478920339973597,0.165528483658548,0.28031768705828397,4203278418,4215439717.2,47.51035470946895,46.32581507275091,NaN,NaN,5.0542616051919715,12.806836118110246
2013-06-20T09:30:00-04:00,71.92,72.16,70.78999,71.02499,60908384,37781618.4,40.37486389845363,50.707678417910934,NaN,NaN,-213.80470922739502,-61.80044510308911,-0.22160588940276807,0.003310325304823891,0.22491621470759196,4142370034,4200550578,42.080461944875296,46.286443116449824,NaN,NaN,0.28524551385219843,11.018037460359096
2013-06-21T09:30:00-04:00,70.78,70.97,69.84,70.42999,51565552,37948424,37.6242193612209,49.24524199377016,NaN,NaN,-246.16149419059636,-91.50704905048624,-0.31696160006580487,-0.1712857853746641,0.14567581469114074,4090804482,4180887730,36.19695194081146,45.657759655293056,NaN,NaN,-4.43912876360582,8.809870856935538
2013-06-24T09:30:00-04:00,69.84,70.27,69.14999,69.73,41492208,38701236.8,34.63474427746742,47.874898103363044,NaN,NaN,-237.27247895801287,-133.70568978320335,-0.40611288642382615,-0.3619652933386419,0.044147593085184206,4049312274,4146437739.6,28.641242912988517,44.58658813964849,NaN,NaN,-9.289768072960031,6.224208152664742
2013-06-25T09:30:00-04:00,70.41,70.52,69.81,70.24001,28897392,38792816,38.47076126135888,47.41466750901642,NaN,NaN,-168.50777787140905,-175.13288448846816,-0.40855691544501194,-0.46654855122108074,-0.05799163577606879,4078209666,4112794974.8,23.48550936144592,43.30558301486228,NaN,NaN,-11.792593820704464,3.6503792993262842
2013-06-26T09:30:00-04:00,70.82001,71,70.59,70.87,23746656,38375368.8,42.92638572872003,47.03029350353173,NaN,NaN,-105.86272376519831,-194.32183680252234,-0.34793836816863344,-0.4929145959868606,-0.14497622781822717,4101956322,4092530555.6,21.029881285158993,41.89493161327118,NaN,NaN,-12.302328105971014,1.3714210985695274
2013-06-27T09:30:00-04:00,71.22,71.62,71.13,71.17,23546416,37933166.4,44.969999575675836,46.20845324296392,NaN,NaN,-62.474259371232655,-164.05574683128984,-0.2712373131711324,-0.48402286928214266,-0.21278555611101027,4125502738,4089157096.4,20.642926818731524,40.14357778675164,NaN,NaN,-12.039650893627432,-0.5444463288871808
2013-06-28T09:30:00-04:00,70.92,71.69,70.78999,71.27,28301072,37430486.4,45.668360133031655,45.42054691476793,NaN,NaN,-58.17303785934449,-126.45805556503947,-0.20062217801056875,-0.4635632786242212,-0.26294110061365245,4153803810,4101756962,26.111511707903446,38.59890165264886,NaN,NaN,-11.616926208031435,-2.1262291687649313
2013-07-01T09:30:00-04:00,71.75999,72.3,71.64,71.71001,24951296,36297400,48.75026374324526,45.33271261919076,NaN,NaN,-10.261093029503337,-81.05577837933757,-0.11536743917102377,-0.40715039957743215,-0.2917829604064084,4178755106,4127645528.4,35.887463434118004,37.5968655434362,NaN,NaN,-10.326971388590927,-3.297763771597216
2013-07-02T09:30:00-04:00,71.67999,72.1796,71.35001,71.74001,23069568,35688076.8,48.962830921078755,45.717184613317265,NaN,NaN,-14.855512750017928,-50.32532535505935,-0.0513090092600576,-0.3559192219814804,-0.3046102127214228,4201824674,4152368530,43.5663505279018,36.95864126535527,NaN,NaN,-9.225719433776229,-4.144614580479932
2013-07-03T09:30:00-04:00,71.48,72.37,71.42,72.03101,18847424,34197739.2,51.082299690409364,45.72927147110655,NaN,NaN,0.4235994511472236,-29.068060711790242,0.012879289974996655,-0.288511100252677,-0.30139039022767367,4220672098,4176111685.2,49.78646065638704,36.74854527035181,NaN,NaN,-7.6945594913771425,-4.651749567750962
2013-07-05T09:30:00-04:00,72.45,72.61,71.86,72.58,28796000,32511338.4,54.888436963213834,46.263255969853915,NaN,NaN,30.229144806396345,-10.527379876264437,0.09021909665562466,-0.18861651940814284,-0.2788356160637675,4249468098,4200904757.2,55.32393180626196,37.24374102016941,NaN,NaN,-5.25285309323769,-4.737621499963352
2013-07-08T09:30:00-04:00,72.94,72.99001,72.38,72.64999,20563728,31940967.2,55.365249613438465,46.46522874229187,NaN,NaN,57.59316205653197,12.625860106910867,0.1409734444125501,-0.10261881054807986,-0.24359225496062997,4270031826,4224150360.4,59.800140622960626,38.307299292217586,NaN,NaN,-3.1063512690093216,-4.504582895541348
2013-07-09T09:30:00-04:00,72.98,73.25,72.64999,73.09,26115184,31977068,58.346014312015264,46.60030572335158,NaN,NaN,86.50702186197282,31.979483085206095,0.1956964197550164,0.0010282697331405188,-0.19466815002187587,4296147010,4247628741.2,63.75060509241611,39.55812805867354,NaN,NaN,-0.3907114944484798,-3.9168869810995095
2013-07-10T09:30:00-04:00,73,73.62,72.98,73.50999,25598896,31242941.6,61.02171999757208,47.36329639120726,NaN,NaN,110.5980593366829,57.070197502546264,0.24831452383455713,0.11572500477132053,-0.1325895190632366,4321745906,4271612987.6,67.28719004805228,40.97075915428663,NaN,NaN,2.732720034539586,-2.9669431217224957
2013-07-11T09:30:00-04:00,74.28999,75.03,74.25,74.97,47777680,31527733.6,68.5781279677566,49.377815253300334,NaN,NaN,180.99113437541837,93.18370448740049,0.36266069511645355,0.32073634983233035,-0.04192434528412321,4369523586,4301383285.2,71.06121993502256,43.04081329644002,NaN,NaN,8.23794921889684,-1.3662442159197334
2013-07-12T09:30:00-04:00,75.02,75.35001,74.82001,75.3,31417856,31687108,69.99406108640135,51.689946805098934,NaN,NaN,174.887912472815,122.11545802068422,0.43676143242922216,0.5040274452524045,0.06726601282318234,4400941442,4331677954,74.30932929603217,45.76312596467007,NaN,NaN,13.197365667701643,0.714271481740463
2013-07-15T09:30:00-04:00,75.36,75.52,75.17,75.47,19790960,31291805.6,70.72589737468257,54.26788631204287,NaN,NaN,158.95176941461648,142.38717949230113,0.4705463344550823,0.6554489308920353,0.18490259643695295,4420732402,4361818069.2,77.06718292873691,49.22212168008067,NaN,NaN,17.453728070175455,3.105622422945461
2013-07-16T09:30:00-04:00,75.53999,75.59,75.17999,75.37,31747088,31256984.8,69.64977368728411,56.49495862818038,NaN,NaN,138.30336856481725,152.74644883287002,0.4589877520708138,0.7586372865254702,0.2996495344546564,4388985314,4380385730,78.59183970312174,53.15828813305752,NaN,NaN,20.635893823333955,5.609946908715246
2013-07-17T09:30:00-04:00,75.60001,75.74001,75.35001,75.56,24631504,31245496.8,70.5661402320435,58.4692268069892,NaN,NaN,130.6886734553693,156.7645716566073,0.43707566867224346,0.8459941202949608,0.40891845162271734,4413616818,4398759912.4,80.00828633736529,57.37103135107225,NaN,NaN,23.566956079676178,8.175233933138236
2013-07-18T09:30:00-04:00,75.53999,75.74001,75.25,75.37,36278800,30902183.2,68.34389639785651,60.13879086571639,NaN,NaN,111.40292658463373,142.84693009845037,0.38457598292738493,0.8896384302819484,0.5050624473545635,4377338018,4400322798.8,80.12872079645919,61.620016635195654,NaN,NaN,25.452172728883525,10.643368046816134
2013-07-19T09:30:00-04:00,74.72,74.74001,74.37,74.59,37734064,29743467.2,59.99150582156546,61.16187270061166,NaN,NaN,67.49480016702388,121.36830763729213,0.2771277527813121,0.8514721383312036,0.5743443855498915,4339603954,4388055301.2,76.24604339016535,65.20105461250007,NaN,NaN,24.770468356776075,12.661525233953268
2013-07-22T09:30:00-04:00,74.87,74.98,74.58,74.81,21135856,28221982.4,61.42351713909382,62.067105086029414,NaN,NaN,68.37970611847719,103.25389497806427,0.20405748692070413,0.8294162442007718,0.6253587572800676,4360739810,4376056782.8,72.54351808128435,67.81934423015481,NaN,NaN,24.598639202224916,14.366827229420647
2013-07-23T09:30:00-04:00,74.95,74.96001,74.2,74.25999,24748784,27384811.2,56.02461207559455,62.57151802563768,NaN,NaN,49.244728838328285,85.44216703276649,0.10675979953617853,0.7588085067002908,0.6520487071641122,4335991026,4365457925.2,69.3403278350076,69.6603426092338,NaN,NaN,22.864274545559425,15.580748274583328
2013-07-24T09:30:00-04:00,74.99001,75.02,74.33,74.5,24426800,27161281.6,57.76901056267927,63.049140230799814,NaN,NaN,48.949401973938436,69.09431273648032,0.049551242843904664,0.7139877607189931,0.6644365178750884,4360417826,4354818126.8,66.1811265262505,70.8313901713669,NaN,NaN,21.896176507298843,16.482952307828402
2013-07-25T09:30:00-04:00,74.89,75.06,74.46001,74.97,23167344,27132316,61.029101020917544,63.487759092064366,NaN,NaN,52.70683838622414,57.3550950967984,0.03503323088428978,0.7082280564804506,0.6731948255961608,4383585170,4356067557.2,66.37486629754169,71.62074263502974,NaN,NaN,21.98675224379908,17.2692094415385
2013-07-26T09:30:00-04:00,74.67,75.38,74.55,75.37,20885520,26999271.2,63.60421414252979,64.07625655842803,NaN,NaN,60.422354023084026,55.94060586801044,0.043486799199691006,0.7275533245957746,0.6840665253960836,4404470690,4369040904.4,68.39920119743729,72.23496124749236,NaN,NaN,22.81141599392329,18.060953234736328
2013-07-29T09:30:00-04:00,75.22,75.53999,75.02991,75.23,20970304,26632732.8,62.05856698941361,64.3414388925279,NaN,NaN,64.91919606243668,55.24850385680234,0.03133470530466975,0.7232349070269208,0.6919002017222511,4383500386,4373593019.6,69.10210061539165,72.6172109277049,NaN,NaN,23.0602577577801,18.77513959517115
2013-07-30T09:30:00-04:00,75.5,75.95,75.35001,75.63,24104512,26590393.6,64.69816836251167,64.60404234716644,NaN,NaN,83.32112251077942,62.06378259129256,0.04129453470630773,0.7435183701051358,0.702223835398828,4407604898,4387915794,71.26763502013513,72.90152842571082,NaN,NaN,24.0263838628185,19.5253173476922
2013-07-31T09:30:00-04:00,75.77,76.2099,75.63,75.77,25007600,26687295.2,65.6002232575307,64.3913348678646,NaN,NaN,98.19530635243882,71.91296346699264,0.04790486734587873,0.7621049195811764,0.7142000522352977,4432612498,4402354728.4,73.29929722289756,73.06139108913047,NaN,NaN,25.084834967505664,20.319534150522696
2013-08-01T09:30:00-04:00,76.3,76.64999,76.21001,76.53999,16879936,26588920.8,70.12217967289723,64.40048619547144,NaN,NaN,142.65636773221362,89.90286933619053,0.09216458089114288,0.8294057783492264,0.7372411974580835,4449492434,4415536181.2,75.03481002140171,73.11321114094257,NaN,NaN,27.410861497421052,21.33258091436532
2013-08-02T09:30:00-04:00,76.56,76.99001,76.3801,76.97,18105232,26054382.4,72.31121514294601,64.51372317891884,NaN,NaN,161.33374447237446,110.08514742604862,0.1357952386110748,0.906985245721927,0.7711900071108522,4467597666,4428161576.4,76.60345019262085,73.08008737407714,NaN,NaN,30.07096005990525,22.580920792299594
2013-08-05T09:30:00-04:00,76.89,77.08,76.78,77.02,15462781,25799335.05,72.56293511228765,64.72180613784766,NaN,NaN,169.15607807294884,130.93252382815103,0.15218356990790838,0.9614194694957376,0.8092358995878293,4483060447,4448073588.6,78.85954637746327,73.09920927938725,NaN,NaN,32.30699072637655,23.970359354310588
2013-08-06T09:30:00-04:00,76.92,76.99001,76.25,76.56,23680560,25677603.85,66.56714761713116,64.43616380821106,NaN,NaN,126.49965624832586,139.56823057566035,0.11774396968088752,0.9564158616889387,0.8386718920080511,4459379887,4458428586.4,79.94271834126809,73.0945258510946,NaN,NaN,32.52524332819661,25.192485636294304
2013-08-07T09:30:00-04:00,76.36,76.56799,75.87,76.42,20281120,25411715.05,64.81188961442334,64.1838776093944,NaN,NaN,85.11115917964116,136.9514011411008,0.07340507752562642,0.9304282389150842,0.8570231613894578,4439098767,4459725840.2,80.08041487926822,73.0910754284381,NaN,NaN,32.208828288301696,26.194820300866787
2013-08-08T09:30:00-04:00,76.84,76.98,76.3,76.8,19993952,24022528.65,67.32997646670083,64.70805408404694,NaN,NaN,111.9183034745076,130.8037882895596,0.05820369912939216,0.9297777853011979,0.8715740861718058,4459092719,4461645897.2,80.29602966859298,73.38036016261151,NaN,NaN,32.64570996074807,27.116375966564114
2013-08-09T09:30:00-04:00,76.7,76.94,76.27,76.49001,18569824,23380127.05,63.34750178880532,64.84548155902633,NaN,NaN,87.07968706244134,115.95297680757298,0.017895823383229592,0.8939438654008427,0.8760480420176131,4440522895,4456230943,77.7403290302584,73.75156094468107,NaN,NaN,31.877125448193006,27.79648303536824
2013-08-12T09:30:00-04:00,76.2,76.80991,76.19,76.67,20515856,23416371.85,64.65475852874631,65.4619205913943,NaN,NaN,76.41955973295124,97.40567313957347,-0.004806722340025105,0.8700396390925818,0.8748463614326069,4461038751,4451826603.8,75.63174607706739,74.20094796197107,NaN,NaN,31.591097941130673,28.33857087904859
2013-08-13T09:30:00-04:00,76.77,77.27,76.22,77.10001,23916976,23024866.25,67.62556504214895,66.16596019707072,NaN,NaN,92.64022419283432,90.63378672847516,0.0006821644843479913,0.8756990670380418,0.8750169025536938,4484955727,4456941771.8,76.43129290125728,74.93310270304298,NaN,NaN,32.185894897188874,28.888188595925772
2013-08-14T09:30:00-04:00,77.07001,77.17999,76.7,76.81,29920960,23289339.05,63.73476506176565,66.35922191427416,NaN,NaN,85.67593186355215,90.74674126525736,-0.02239839053936321,0.8470189143794897,0.8694173049188529,4455034767,4460128971.8,76.9390211494823,75.6876851924673,NaN,NaN,31.575757772801637,29.27212704976518
2013-08-15T09:30:00-04:00,75.98,75.99001,75.28999,75.50999,39406560,23445727.05,49.88065711080109,65.37896784057925,NaN,NaN,-22.99289467107197,63.76450163614146,-0.12658058739130928,0.7111915706797163,0.8377721580710256,4415628207,4451436069.4,72.36038030230104,75.97062655710043,NaN,NaN,26.293612362151723,28.846624951534686
2013-08-16T09:30:00-04:00,75.53999,75.87,75.35001,75.485,23824928,22750270.25,49.657202831127215,64.49315611498736,NaN,NaN,-31.546901726591802,40.03918387833483,-0.1944770187453001,0.5946758846394005,0.7891529033847006,4391803279,4441692146.2,67.51066713439516,75.85695273702926,NaN,NaN,22.099083448037742,27.882690451035124
2013-08-19T09:30:00-04:00,75.5,76.13,75.33,75.35001,29586816,23172818.25,48.39599698176649,63.328715302076986,NaN,NaN,-33.90232903633476,17.97480612447763,-0.24264768268774095,0.4858433000250244,0.7284909827127654,4362216463,4421927688.6,58.889106113524555,74.97277210084279,NaN,NaN,18.30395561705755,26.514299760466898
2013-08-20T09:30:00-04:00,75.49001,76.03,75.42999,75.67999,18842752,22877516.65,51.63007046096131,62.330847245179164,NaN,NaN,-32.19574870346985,-6.9923884547832085,-0.2457030896694008,0.4213621206260143,0.6670652102954151,4381059215,4401148386.2,51.44986712942194,73.41209852273737,NaN,NaN,16.02956456178091,25.0164804463689
2013-08-21T09:30:00-04:00,75.46001,76.09,75.14,75.42,30705088,23191431.05,49.02318628865573,60.82377628916192,NaN,NaN,-58.18898490846599,-35.76537180918684,-0.25741145821353606,0.3453008875284951,0.6027123457420311,4350354127,4380212258.2,45.247741739868985,71.28445078834218,NaN,NaN,13.340911217017137,23.348541985032934
2013-08-22T09:30:00-04:00,75.73,76.21001,75.71001,76.16,17269472,22896537.45,55.855330793554025,59.64835597849106,NaN,NaN,-12.885619737497867,-33.74391682247202,-0.20952584497980253,0.3408050395172779,0.5503308844970805,4367623599,4370611336.6,42.70536467905376,68.86315896594454,NaN,NaN,13.029603900624585,21.8744079729746
2013-08-23T09:30:00-04:00,76.73,76.77,76.39999,76.67,20697264,22887124.65,59.84926575449576,58.74023673864878,NaN,NaN,54.1295267760725,-16.608631121939162,-0.14099863236253452,0.3740825940439123,0.5150812264064468,4388320863,4369914853.4,42.5187242676385,66.26738595809991,NaN,NaN,14.041602146715382,20.755435712080423
2013-08-26T09:30:00-04:00,76.72,77.28,76.55,76.71001,27525408,23214879.85,60.15383935804724,58.28214329157136,NaN,NaN,79.51448706579203,6.074732098486197,-0.09279827428058168,0.3990833835557197,0.4918816578363014,4415846271,4380640815,46.403533380095894,63.87172988944475,NaN,NaN,14.939243890834536,19.924551166188152
2013-08-27T09:30:00-04:00,75.82001,76.17999,74.96001,75.14,40068864,24013097.45,45.551561969980824,56.90640560268262,NaN,NaN,-116.77232518030803,-10.840583196881438,-0.16240134630417002,0.28887997495608886,0.4512813212602589,4375777407,4379584453.4,46.07327532129517,61.44264849244667,NaN,NaN,10.645171134078796,18.598925447315388
2013-08-28T09:30:00-04:00,75.08,75.75,75.05,75.42999,20490384,23787236.65,48.059565302151185,55.529947662357635,NaN,NaN,-109.64662800885992,-21.132111816960226,-0.18312161781764597,0.2223792989882014,0.4055009168058474,4396267791,4388767186.2,49.44178740519606,59.23877404506118,NaN,NaN,8.112178677972324,17.100818765980666
2013-08-29T09:30:00-04:00,75.39999,76.34,75.3,75.96001,27287904,24307635.05,52.37725135457299,54.74635834562675,NaN,NaN,-45.20022215056998,-27.595032299574644,-0.15638138106236155,0.21002419047789544,0.366405571540257,4423555695,4399953605.4,53.27112143177354,57.49097350231226,NaN,NaN,7.478756713021564,15.726238472700794
2013-08-30T09:30:00-04:00,76.03999,76.03999,75.2,75.47,26228464,24713796.65,48.37364250826126,53.58342148702068,NaN,NaN,-74.6495004778855,-53.350837750366246,-0.16603509140771971,0.15886170728060733,0.32489679868832705,4397327231,4401754879,53.87691294323251,55.937056849895484,NaN,NaN,5.616939421233032,14.282052893919685
2013-09-03T09:30:00-04:00,76.10001,76.44,75.53999,75.89999,27241424,25302728.8,51.85163452375178,52.456712164278024,NaN,NaN,-20.397265463188248,-73.33318825616229,-0.13890308100851467,0.15126794742768368,0.29017102843619835,4424568655,4403499355.8,54.49222248329467,54.36998039146959,NaN,NaN,5.234828709997634,12.989592296216536
2013-09-04T09:30:00-04:00,76.14,76.84,75.92999,76.71001,27142880,25475844.8,57.64092843815587,52.02143811973447,NaN,NaN,53.134589859900395,-39.35180524812061,-0.06556758332365586,0.20821154928162855,0.2737791326052844,4451711535,4418686181.4,59.55124829954905,53.127996616474356,NaN,NaN,6.8852395047622235,12.117541897437349
2013-09-05T09:30:00-04:00,76.75,77.05499,76.73,76.84,17815360,25352556.8,58.50322621919688,52.63733591319131,NaN,NaN,95.04858472510345,1.587237298672059,-0.010365487028821119,0.26082227381925804,0.27118776084807916,4469526895,4433338002.2,63.73942703738628,52.512214240409016,NaN,NaN,8.458925059677156,11.594882349185893
2013-09-06T09:30:00-04:00,77.09,77.34,76.05,76.92999,27724528,25739085.6,59.12359863938286,53.31350704235242,NaN,NaN,80.79464233833058,26.786210196452167,0.028048077961159268,0.3062478582995283,0.278199780338369,4497251423,4448077147.8,67.39662173281532,52.50406814029617,NaN,NaN,9.904551961315365,11.353406579490104
2013-09-09T09:30:00-04:00,77.23,77.96001,77.23,77.83,25161872,26068688,64.79263719893859,54.48469562929329,NaN,NaN,168.73530653496155,75.46317159902158,0.10555487102732275,0.41014336912252247,0.3045884980951997,4522413295,4473094360.6,72.4717134612533,53.474254379419655,NaN,NaN,13.061536828144483,11.597425186440729
2013-09-10T09:30:00-04:00,78.27,78.32001,77.92,78.21001,27619376,26423864,66.88118273644335,55.57406079182772,NaN,NaN,186.11434175741718,116.76549304314267,0.17007574183572832,0.5171831753898601,0.3471074335541318,4550032671,4498187163.8,76.4341267547332,55.258844352656176,NaN,NaN,16.33892016600256,12.274781612092418
2013-09-11T09:30:00-04:00,77.69,78.11,77.59,78.06,28138592,26634944.8,65.23602400678666,56.73212062883707,NaN,NaN,145.47665026448664,135.2339051240599,0.18886272229355872,0.5831858364210802,0.3943231141275215,4521894079,4512223672.6,78.31450228625243,57.62075582025499,NaN,NaN,18.48918361300155,13.162553326508009
2013-09-12T09:30:00-04:00,78.06,78.25,77.85001,78.00999,18332688,26055531.2,64.66494773002728,57.36137898144231,NaN,NaN,138.98925073527872,144.022038326095,0.1839510517673788,0.624261928836745,0.4403108770693662,4503561391,4519030571.8,79.18201269384707,60.226230678454506,NaN,NaN,20.065983283857495,14.148757606129363
2013-09-13T09:30:00-04:00,78.11,78.145,77.64,78.06,16932448,24931825.6,64.99495383455698,57.728928130018105,NaN,NaN,115.87670318401597,151.03845049523204,0.17040678488732403,0.6533193581785213,0.48291257329119724,4520493839,4523679055,79.77698643970773,62.8875351193166,NaN,NaN,21.45535890811643,15.192557792127516
2013-09-16T09:30:00-04:00,78.69,78.72,77.67,77.85001,25909888,25036073.6,62.36130496371896,57.88660424470894,NaN,NaN,111.84455348804144,139.66029988584802,0.13518080257943355,0.6518885765154891,0.5167077739360556,4494583951,4518113186.2,76.94150932310123,65.06881911524555,NaN,NaN,21.93258391730815,16.15541866715332
2013-09-17T09:30:00-04:00,77.99001,78.47,77.98,78.37,27182208,24915843.2,66.03185482065464,59.34948230547135,NaN,NaN,112.40699848025578,124.91883123041575,0.13448925912703613,0.6848193478448508,0.5503300887178146,4521766159,4512459883.8,74.06213145743631,67.06802312496993,NaN,NaN,23.401873130550126,17.19062644763858
2013-09-18T09:30:00-04:00,78.49001,79.47,78.33,79.31,31714656,25559438.4,71.45177851727186,61.020354677979974,NaN,NaN,144.93381580352357,124.8102643382231,0.1819770135106179,0.777801355606087,0.5958243420954691,4553480815,4518777231,75.1799167895162,68.90646093813565,NaN,NaN,26.485819637548367,18.518511189054262
2013-09-19T09:30:00-04:00,79.53999,79.685,79.36,79.5,26435616,25345964.8,72.41003746021639,62.45126797124021,NaN,NaN,151.60891116257253,127.33419642368185,0.2088952215479023,0.856943369030347,0.6480481474824447,4579916431,4534048239,77.68353014608768,70.65020441772951,NaN,NaN,29.30128256944592,20.058907100538786
2013-09-20T09:30:00-04:00,79.47,79.53999,78.95,78.985,26328832,25798932.8,65.9483483604378,63.70660410353854,NaN,NaN,113.98176531742762,126.95520885036419,0.1760421720315979,0.868100862521942,0.6920586904903441,4553587599,4540666991,78.6869941941936,72.42235307851244,NaN,NaN,29.76701806277363,21.445780095143764
2013-09-23T09:30:00-04:00,79.34,79.41,78.455,78.83,30319392,26280039.2,64.09448757276616,64.58109360703956,NaN,NaN,88.35604673404987,122.25750749956588,0.13002099063976202,0.8545849287900467,0.7245639381502846,4523268207,4546403842.2,79.5455078016811,74.21187345839719,NaN,NaN,29.599234759673475,22.610559332933722
2013-09-24T09:30:00-04:00,79,79.25,78.57001,78.83,21875696,25997553.6,64.09448757276616,65.04206211665458,NaN,NaN,79.62073566712303,115.70025493693932,0.08775417942591568,0.8342566624326793,0.7465024830067636,4523268207,4546704251.8,79.59186644016918,75.64334618272721,NaN,NaN,29.46323211631822,23.589512587702934
2013-09-25T09:30:00-04:00,78.88,79,78.39999,78.56,22746400,25131430.4,60.650144011760325,65.19541338755197,NaN,NaN,62.183048502853005,99.15010147680519,0.03262545203530276,0.7872842980508921,0.7546588460155893,4500521807,4536112450.2,73.28521203883264,76.32518796854481,NaN,NaN,28.38232716766427,24.274200384840267
2013-09-26T09:30:00-04:00,78.87,79.36,78.85001,79.17,22421664,25227994.4,65.20016799787375,65.62945405601563,NaN,NaN,88.11204638879786,86.45072852205027,0.028410247902443952,0.7901716558936442,0.7617614079912003,4522943471,4524717858.2,67.1232769429491,76.30566334069722,NaN,NaN,28.726659691412316,24.910266000064844
2013-09-27T09:30:00-04:00,78.74001,79.21001,78.59,79.07001,25151520,25121175.2,63.895934996233116,65.56540389867952,NaN,NaN,72.71533401139159,78.19744226084306,0.010952965918944457,0.7754526153898809,0.7644996494709364,4497791951,4513558728.6,61.65575405284572,75.53309481152526,NaN,NaN,28.640162435894283,25.44310834804048
2013-09-30T09:30:00-04:00,78.27,79.09,78,78.88,28031856,25211344.8,61.38312285008957,65.17268533536854,NaN,NaN,44.00476088253587,69.32718509054027,-0.01965888447302999,0.7399260438796489,0.7595849283526789,4469760095,4502857106.2,56.87148075385417,74.1357629543196,NaN,NaN,27.863997715660183,25.788949686271867
2013-10-01T09:30:00-04:00,78.87,79.72,78.8456,79.67999,33129744,25505760.8,67.22693944260052,65.31489358078382,NaN,NaN,103.14982575427433,74.03300310797053,0.006313254037901284,0.7674764959000555,0.7611632418621542,4502889839,4498781432.6,55.11733751444721,72.47882261347637,NaN,NaN,28.906619119577815,26.234331033887003
2013-10-02T09:30:00-04:00,79.13,79.75999,79.06,79.64999,25503760,25423804.8,66.81858425594987,65.46872476120687,NaN,NaN,103.1400714161974,82.22440769063942,0.013407226186480825,0.7779222745952552,0.7645150484087744,4477386079,4494154287,53.11433844720074,70.61684588157307,NaN,NaN,29.629499052566015,26.719355036555434
2013-10-03T09:30:00-04:00,79.55,79.72,78.3,78.72,42998192,26682946.4,55.55321048401375,64.79431452188234,NaN,NaN,38.76360683042104,72.35471977896405,-0.04916896539200999,0.703053841668762,0.7522228070607719,4434387887,4476443170.2,46.194440453522226,68.21809259684554,NaN,NaN,26.702310048589478,26.716920038274584
2013-10-04T09:30:00-04:00,78.72,79.50999,78.64999,79.39999,22854272,26439433.6,60.76228928877483,64.68009911652919,NaN,NaN,66.46199573001604,71.10405212268894,-0.04927549008332066,0.6906284444566211,0.7399039345399417,4457242159,4468333211.8,43.40579685943482,65.8226845637265,NaN,NaN,25.862148740839636,26.594809852926733
2013-10-07T09:30:00-04:00,78.72,79.35001,78.67,78.74001,20234688,26193074.4,54.13125111085552,63.83005599440069,NaN,NaN,24.273611763005754,67.15782229878292,-0.09562309978440697,0.6203750598094331,0.7159981595938401,4437007471,4461782687,41.240253993517335,63.47826474487515,NaN,NaN,22.88452329937497,26.064768916705052
2013-10-08T09:30:00-04:00,78.75999,78.81,77.19,77.22,43660688,26995140,42.60039861212816,61.769243144033275,NaN,NaN,-144.5156297805134,17.62473119182537,-0.2231912684707501,0.43700907400540245,0.6602003424761526,4393346783,4439874075.8,34.95832401765567,60.60529383259939,NaN,NaN,15.659304110097425,24.578273944332533
2013-10-09T09:30:00-04:00,77.39999,77.44,76.35001,76.98,64526688,28814544.8,41.11129807091314,59.53361890194019,NaN,NaN,-226.00302785579257,-48.203888662572616,-0.31278362991536757,0.2692208050819431,0.5820044349973107,4328820095,4410160879,28.59623391924697,57.09905838782505,NaN,NaN,9.635731429654928,22.443625013664303
2013-10-10T09:30:00-04:00,77.8,78.78999,77.78999,78.61,48062720,30301046.4,53.10158487083371,58.615992938397035,NaN,NaN,-41.61536449080475,-64.27968292681778,-0.2538249829619944,0.2647232062948177,0.5185481892568121,4376882815,4398659864.6,26.57985015785846,53.37711952808683,NaN,NaN,8.890413691075434,20.507451967580177
2013-10-11T09:30:00-04:00,78.41,79.28999,78.39999,79.23,25214128,30715130.4,56.71197497666247,58.08867061010392,NaN,NaN,30.969544139121073,-71.37817324499677,-0.16872547353000877,0.30764134734430115,0.4763668208743099,4402096943,4387630821.4,24.775684598979325,49.46498929932242,NaN,NaN,9.690178909144638,18.96212724494653
2013-10-14T09:30:00-04:00,78.74001,79.78999,78.67999,79.78999,31471888,30993230.4,59.72759614180988,57.77674979360704,NaN,NaN,91.58340780670667,-57.91621403625659,-0.07514757335568911,0.38243235417969856,0.4575799275353877,4433568831,4386943093.4,24.66326604379617,45.54151784243863,NaN,NaN,11.42627007254315,17.885576220317475
2013-10-15T09:30:00-04:00,79.73,80.11,79.38,79.48,38684000,31568320,57.34602043473024,57.54074096667632,NaN,NaN,123.00255349095791,-4.412577381962327,-0.03650990492268108,0.4119425463820363,0.4484524513047174,4394884831,4387250703,24.827566514270714,42.080257447827066,NaN,NaN,11.951534989205278,17.037856044444304
2013-10-16T09:30:00-04:00,79.83,80.42,79.78999,80.38,46735856,32319380,62.07429344554911,57.31746421293884,NaN,NaN,180.05289756253853,76.7986077017039,0.0429687887002958,0.5021634371800872,0.45919464847979136,4441620687,4409810821.4,35.87335473448442,39.848120147222446,NaN,NaN,14.062102846263699,16.612748444704216
2013-10-17T09:30:00-04:00,80,80.87,79.95,80.84,32193536,32607276,64.25528901704027,57.34313235728221,NaN,NaN,200.30498864640032,125.18267832914489,0.11570173459726008,0.6038218167263665,0.4881200821291064,4473814223,4429197103,43.54950834911743,38.55481688267042,NaN,NaN,16.493679632426865,16.59573861437888
2013-10-18T09:30:00-04:00,81.56,82.17999,81.35001,82.14999,39628224,33272245.6,69.61430560177126,57.93107398240233,NaN,NaN,274.91035142203606,173.97083978572792,0.23437446370816784,0.7810881617643162,0.5467136980561483,4513442447,4451466203.8,50.83054735700642,38.12332164003844,NaN,NaN,20.568224275777965,17.16323656600732
2013-10-21T09:30:00-04:00,82.31,82.53999,82.07001,82.33,31176944,33315123.2,70.27382218084726,58.14870846370567,NaN,NaN,237.2095589733501,203.09607001905658,0.30297346780613743,0.9254305328138202,0.6224570650076827,4544619391,4473676315.8,56.81338896226431,38.24446817202538,NaN,NaN,23.925172641236454,18.129227433897196
2013-10-22T09:30:00-04:00,82.62,82.89999,81.92999,82.45,43944816,34418579.2,70.72991148234459,58.428088979876726,NaN,NaN,193.8682713513137,217.26921359112777,0.3320709221819107,1.037545717735071,0.7054747955531604,4588564207,4512412191,64.84716611796345,39.08252729136557,NaN,NaN,26.7052702951838,19.354376414080996
2013-10-23T09:30:00-04:00,82.03999,82.2,81.55,81.95,38021280,35182323.2,66.17403567623133,59.1867193507494,NaN,NaN,131.76027267581424,207.61068861378288,0.29456042545470884,1.0736753273715465,0.7791149019168376,4550542927,4534196639,68.40662918334247,40.669112200638445,NaN,NaN,27.617885252683422,20.534877676738486
2013-10-24T09:30:00-04:00,81.99001,82.48,81.88,82.31,23155088,35218994.4,67.78308689133459,59.68820489378938,NaN,NaN,125.2987889129796,192.60944866709875,0.271479545698347,1.1184643340397713,0.8469847883414243,4573698015,4554173397.4,71.27867738942703,42.660032238495035,NaN,NaN,28.861317864971426,21.724369132200334
2013-10-25T09:30:00-04:00,83.10001,83.28,82.5,82.89999,35832384,35753037.6,70.27836634841906,60.84157026790107,NaN,NaN,134.08004575873974,164.4433875344395,0.2727114758694531,1.1878741331782408,0.9151626573087877,4609530399,4573390987.8,73.75080220619375,44.98221425368621,NaN,NaN,30.688644180286,23.00497985335543
2013-10-28T09:30:00-04:00,82.9,83.05,82.55,82.92,28618375,35782363.55,70.36220961857583,62.82455676836161,NaN,NaN,114.18500262392936,139.83847626455534,0.2521212678302929,1.2303142420966537,0.9781929742663609,4638148774,4592096864.4,75.92315038893032,47.908273280205826,NaN,NaN,32.17858416343765,24.315494754795747
2013-10-29T09:30:00-04:00,83.1601,83.26,82.7,83.06,36878062,35969779.45,70.9790499866566,64.95796761948614,NaN,NaN,105.52531609633091,122.16988521355877,0.22601558516834297,1.2607124557267895,1.0346968705584465,4675026836,4609389390.2,77.7558616086438,51.419675258019886,NaN,NaN,33.58638320394153,25.639907390388
2013-10-30T09:30:00-04:00,83.36,83.485,82.58,82.98,33535470,36371364.95,70.08146256695514,66.17081602635196,NaN,NaN,93.77276971628048,114.57238462165203,0.18326639161132507,1.263779860072603,1.0805134684612778,4641491366,4627579078,79.52165815493464,55.201232972096754,NaN,NaN,34.52010895179051,26.9085076134455
2013-10-31T09:30:00-04:00,82.77,83.3,82.48,82.79,31309909,35786950.8,67.88575977034981,66.96894351161534,NaN,NaN,78.71259844793606,105.25514652864331,0.12488870703220889,1.236624352251539,1.11173564521933,4610181457,4634875766.4,80.20064499357949,59.1601587145682,NaN,NaN,34.74233098368534,28.027625237765477
2013-11-01T09:30:00-04:00,83.04,83.169,82.4,82.81,30873163,36187895.35,67.99941499222695,67.55978771521657,NaN,NaN,69.35588057639464,92.31031349217429,0.07289270452081076,1.2028515258703436,1.1299588213495328,4641054620,4641180610.6,80.79323461521835,63.169442183955496,NaN,NaN,34.95773904909002,29.017641496526128
2013-11-04T09:30:00-05:00,83.05,83.07,82.64,82.93,16843634,36018342.65,68.71484312376714,68.3718464787192,NaN,NaN,66.85475197508173,82.84426336240477,0.03383796223019986,1.1722562741372826,1.1384183119070828,4657898254,4645130506.6,81.1733985486836,67.19414447212785,NaN,NaN,35.32041204347717,29.918037288947705
2013-11-05T09:30:00-05:00,82.59,83.22,82.37,83.02,27975601,35234088.3,69.2697500364245,68.88580766378172,NaN,NaN,62.38979047509405,74.2171582381574,0.0029502117826880614,1.142106076635443,1.1391558648527549,4685873855,4647299910.4,81.39125636836897,70.44542316026245,NaN,NaN,35.76848537289575,30.753815586654568
2013-11-06T09:30:00-05:00,83.35,83.4,82.73,83,25576806,33286594.2,68.97695884278436,69.22306979419201,NaN,NaN,68.24504883108155,69.1116140611176,-0.028226106629791747,1.1038732315655153,1.132099338195307,4660297049,4651061047,81.78480503171754,73.17651578044817,NaN,NaN,36.08405376340726,31.515278183333525
2013-11-07T09:30:00-05:00,82.99,83.13,81.37,81.44,52173216,33492119,50.903498595783226,67.88658357947858,NaN,NaN,5.8473546913703025,54.53856530980446,-0.15616384899725833,0.9368945269487341,1.0930583759459924,4608123833,4650649522.2,81.58150628667647,75.37301284685317,NaN,NaN,31.002891974566293,31.442080153509636
2013-11-08T09:30:00-05:00,81.73,82.56,81.51,82.54,31480519,33805438.55,59.0511391381891,67.08496336214586,NaN,NaN,11.833959856394596,43.03418116580444,-0.16793215470187794,0.8831431825686451,1.051075337270523,4639604352,4650359468.6,81.42786707681012,77.13118985503502,NaN,NaN,28.897121458019914,31.07851462558253
2013-11-11T09:30:00-05:00,82.39,82.64,82.14,82.41,24822945,33472991.4,57.8297116423948,66.16352051643516,NaN,NaN,19.003083307217388,33.463847432231574,-0.18438376919694233,0.8205956257743452,1.0049793949712875,4614781407,4641736099.2,76.79724438026854,77.98476687377111,NaN,NaN,26.838889034687035,30.472853826883174
2013-11-12T09:30:00-05:00,82.16,82.66,82.1199,82.54,20108526,32544217.7,58.74860008085714,65.63313225962271,NaN,NaN,12.74430430962845,23.534750199138454,-0.18589552959465527,0.7726099829779685,0.9585055125726237,4634889933,4631539314.8,71.61140054653441,78.21367911399909,NaN,NaN,25.44081647698382,29.753991348326124
2013-11-13T09:30:00-05:00,82.01,83.55,82,83.54,31345887,31774719.25,65.05624354881297,65.43835773515688,NaN,NaN,82.73017928044412,26.431776289010976,-0.1220189688630019,0.8059818014938713,0.9280007703568732,4666235820,4632727069,71.84985337592641,78.25447739874905,NaN,NaN,26.182485347342404,29.24377620532845
2013-11-14T09:30:00-05:00,83.29,83.86,83.14,83.8,31101157,31720100.3,66.4909041980663,65.1678247244174,NaN,NaN,165.9658643272224,58.45547821618139,-0.06745375540744969,0.8436835760975612,0.9111373315050109,4697336977,4650569697.8,75.21745947108614,78.35923863195565,NaN,NaN,27.236289056744816,28.956992326959362
2013-11-15T09:30:00-05:00,83.83,83.96,83.61,83.96,20515761,30764477.15,67.378499208208,64.95470255224828,NaN,NaN,188.83437934557523,93.85556211401752,-0.027813138316554964,0.8763709086093172,0.9041840469258722,4717852738,4666219375,77.73353215267258,78.48855161508008,NaN,NaN,28.361003254705548,28.871851030923104
2013-11-18T09:30:00-05:00,83.94,84.105,82.98,83.14,31679608,30789610.35,58.78453081209733,64.08366546835119,NaN,NaN,106.78044370617883,111.41103419380981,-0.062082914513537646,0.8265804037839501,0.8886633182974878,4686173130,4680497719.6,79.7532463343081,78.63122195262754,NaN,NaN,26.653488441327905,28.554942089552362
2013-11-19T09:30:00-05:00,83.09,83.49,82.76,82.9,25545292,29869634.15,56.51257647002373,63.11445931857036,NaN,NaN,41.914857164664866,117.24514476481708,-0.1037260705102303,0.7590057301597,0.8627318006699303,4660627838,4685645300.6,80.44201396690492,78.69696165348257,NaN,NaN,24.557791281179238,27.98392054549906
2013-11-20T09:30:00-05:00,83.14,83.4301,82.455,82.7,32177418,29577441.05,54.61815331773004,62.16677314338324,NaN,NaN,-0.0069951242928159504,100.6977098838697,-0.1450185958208492,0.6814585558938688,0.826477151714718,4628450420,4678088220.6,76.33634251586577,78.42094004793158,NaN,NaN,22.267553530483,27.167296686211053
2013-11-21T09:30:00-05:00,83.03,83.61,82.98,83.54,28125025,29825937.9,60.593148937711774,61.637754139489296,NaN,NaN,98.37710289902347,87.17995759822992,-0.11722583311634927,0.6799448603192815,0.7971706934356307,4656575445,4669935914.2,72.06339894484218,77.79738035719042,NaN,NaN,22.067603540434998,26.43876909395733
2013-11-22T09:30:00-05:00,83.69,84.02,83.62,83.99,25361273,29302382.35,63.37510178408396,61.25634404379764,NaN,NaN,169.84943420931208,83.38296857097728,-0.07221040033760928,0.7069076930136191,0.7791180933512284,4681936718,4662752710.2,68.4287950151062,76.88705153336346,NaN,NaN,22.775519940638077,25.915447786340295
2013-11-25T09:30:00-05:00,84.29,84.38,83.98,84.19,21699975,28956462.35,64.57218559664098,60.92080372667027,NaN,NaN,186.79297491742,99.38547481322553,-0.03454974883103357,0.7359309073124365,0.77048065614347,4703636693,4666245422.8,69.24114257908292,76.01918626270017,NaN,NaN,23.71737575884479,25.60143749669808
2013-11-26T09:30:00-05:00,84.22,84.84,84.025,84.63,26629288,28444023.65,67.11847328340366,60.788054758143076,NaN,NaN,184.53558105964902,127.90961959222236,0.01192181985922447,0.7853829309675007,0.7734611111082762,4730265981,4680173051.4,72.30171470314912,75.34182266780242,NaN,NaN,25.29931089027226,25.558276552922962
2013-11-27T09:30:00-05:00,84.79,85.24,84.73,85.22,21638074,27849153.85,70.21028782017282,62.16711113131377,NaN,NaN,200.66795341677295,168.04460930043552,0.0710252616566659,0.8622426881791085,0.7912174265224426,4751904055,4704863778.4,76.72344720498961,74.99481844768194,NaN,NaN,27.643562432937944,25.856174535782245
2013-11-29T09:30:00-05:00,85.54,85.84,85.4737,85.73,16708898,27119103.3,72.60795432248506,63.13545507304919,NaN,NaN,211.21746635032744,190.61268199069633,0.12968052267114638,0.9533180798613756,0.8236375571902292,4768612953,4727271280,79.86494427728428,74.88318110485866,NaN,NaN,30.401190131699668,26.505462478056163
2013-12-02T09:30:00-05:00,85.83,85.96,85.35,85.48,26354619,26893176.1,69.64864961447512,63.979664928197785,NaN,NaN,167.07086406863826,190.05696796256154,0.13618307430370646,0.9938664000698623,0.8576833257661558,4742258334,4739335603.2,81.32625830824239,75.20668209971394,NaN,NaN,31.775297300352044,27.25829602409843
2013-12-03T09:30:00-05:00,85.42,85.64,85.08,85.41,37154262,27908707.5,68.8030670929702,64.69784114334871,NaN,NaN,127.81691258939551,178.26175549695665,0.12083323427384962,1.0087248686084678,0.8878916343346182,4705104072,4739629079,81.36169483524493,75.90313169176468,NaN,NaN,32.646744735389824,28.028074411425774
2013-12-04T09:30:00-05:00,85.06,85.77,84.78,85.49,37193220,28369588.45,69.26236073822787,64.99827808544977,NaN,NaN,109.31852583182621,163.21834445139208,0.10188864866964042,1.0152524451716687,0.9133637965020283,4742297292,4742035341.2,81.66885489048421,76.60448894280454,NaN,NaN,33.494248133347604,28.808956371700322
2013-12-05T09:30:00-05:00,85.57,85.66,85.17,85.38,39829338,29082215.05,67.78462386654758,65.09068663319843,NaN,NaN,100.0442599101522,143.09360575006795,0.0693264716973978,1.0000218861237755,0.9306954144263777,4702467954,4732148121,76.11797910019902,76.66881177345545,NaN,NaN,33.80988471289885,29.523374706157256
2013-12-06T09:30:00-05:00,86.105,86.18,85.59,86,36842888,28315698.65,71.47830076632988,65.38352960163571,NaN,NaN,117.86170061022695,124.42245260204785,0.07636490093019854,1.026151540589126,0.9497866396589274,4739310842,4726287698.8,72.95288311612899,76.32733684227377,NaN,NaN,35.153648268350715,30.32769950075632
2013-12-09T09:30:00-05:00,86.35,86.53,86.2,86.35,22599903,27871667.85,73.3368264802383,66.4229792922172,NaN,NaN,128.58910454759854,116.72610069783988,0.09045043656321694,1.0628496853629485,0.9723992487997316,4761910745,4730218181,73.74150897435136,75.8979270308483,NaN,NaN,36.85191296108341,31.25972999508876
2013-12-10T09:30:00-05:00,86.19,86.45,86.12,86.29,26965928,27978817,72.46508071161654,67.5624438809024,NaN,NaN,111.36531669073267,113.43578151810735,0.08184317790322715,1.0747032211787655,0.9928600432755383,4734944817,4736186330,74.9365147502143,75.50467708679896,NaN,NaN,38.01495363180044,32.22476194319043
2013-12-11T09:30:00-05:00,86.27,86.401,85.06,85.18,36830565,28814918.95,58.58968674162281,67.8461248397519,NaN,NaN,59.53924376481647,103.4799251047054,-0.007731362031526801,0.9831958407361299,0.9909272027676567,4698114252,4727349722,69.86660209540292,75.04255277105162,NaN,NaN,34.784838397686805,32.590487150975626
2013-12-12T09:30:00-05:00,85.24,85.4201,84.9,84.96,33662597,28930754.45,56.28916809147283,67.5386976364491,NaN,NaN,25.553881498728206,88.58184942242059,-0.08654363773842322,0.8827476555946276,0.9692912933330509,4664451655,4719746462.2,65.74497697309207,74.5912369159266,NaN,NaN,31.425803274012885,32.42410373998095
2013-12-13T09:30:00-05:00,85.36,85.4,84.709,84.85,34075415,29079467.35,55.12370724587488,66.94931231229131,NaN,NaN,14.350593726540142,67.87962804568323,-0.14726167152702518,0.7852142039242693,0.9324758754512945,4630376240,4697959541.8,55.619674438530176,73.67629973188546,NaN,NaN,28.339239717104682,31.84055173671291
2013-12-16T09:30:00-05:00,85.27,85.81,85.21,85.32,24908324,29299095.5,59.02724086691157,66.55324483159636,NaN,NaN,43.69945325154084,50.901697786471665,-0.1561057612103175,0.7373436739383976,0.8934494351487151,4655284564,4676634305.6,47.85142760441335,72.14846294798049,NaN,NaN,26.790980105279793,31.119184360793895
2013-12-17T09:30:00-05:00,85.32,85.53,84.99,85.15,24454893,28937859.75,57.092788873070944,65.83712451657259,NaN,NaN,22.27943797606246,33.08452204353763,-0.172460154134914,0.6778742424800726,0.8503343966149866,4630829671,4655811276.4,41.72354401965283,69.96430789915932,NaN,NaN,24.942585088299296,30.23681303615181
2013-12-18T09:30:00-05:00,85.22,86.22,84.05,86.14,68387235,31079956.9,64.40802735226971,65.4226773402938,NaN,NaN,38.71808855658114,28.920291001890554,-0.11824297372607206,0.7025306794573964,0.8207736531834685,4699216906,4656031807.2,41.808537362073466,67.47038576752246,NaN,NaN,25.537489961168337,29.565481168297026
2013-12-19T09:30:00-05:00,85.99,86.01,85.52,85.9,46489555,31795563.75,61.66338177510966,64.64092215833841,NaN,NaN,70.37211982541889,37.88393866722869,-0.10086127937759337,0.6946970539614767,0.7955583333390701,4652727351,4653686946.4,41.121791114185086,64.70301768444395,NaN,NaN,25.169233615591747,28.937445803624843
2013-12-20T09:30:00-05:00,85.75,86.68,85.73,86.5,40475437,32413084.35,65.60900577092363,64.3523761695133,NaN,NaN,131.3120610958862,61.2762321410979,-0.05364181034474047,0.7285060704081445,0.782147880752885,4693202788,4666252256,46.21973520047347,62.19540889103189,NaN,NaN,26.11491135367887,28.534226596489706
2013-12-23T09:30:00-05:00,87.19,87.41,86.95,87.41,28181764,32554108.9,70.55826421231116,64.47774739232338,NaN,NaN,234.15312155737683,99.3669658022651,0.02970981153321406,0.8192851451694025,0.7895753336361885,4721384552,4679472253.6,51.024400148980114,60.0284592705844,NaN,NaN,28.65633537547988,28.551670707774015
2013-12-24T09:30:00-05:00,87.43,87.51,87.27,87.45,13852475,32161733.9,70.75747531926221,64.58454129096869,NaN,NaN,209.78438476405108,136.86795515986282,0.07574985487595254,0.8842626522311292,0.8085127973551767,4735237027,4700353724.8,57.48530880426791,58.30106312156895,NaN,NaN,30.69438382521791,28.857772581694572
2013-12-26T09:30:00-05:00,87.6,87.81,87.44,87.74,15241096,31592324.3,72.22481219453397,64.90169760011057,NaN,NaN,194.69932887092554,168.0642032227317,0.11177199520117342,0.9482277913566435,0.83645579615547,4750478123,4710605968.2,60.25743041500331,57.16816678691212,NaN,NaN,32.8352125454459,29.425978290801904
2013-12-27T09:30:00-05:00,87.83,87.9,87.412,87.52,15831962,31302018.7,69.38059754552627,64.75186165576746,NaN,NaN,155.20712993157463,185.03120524396286,0.10682500834118924,0.9699870565819566,0.8631620482407674,4734646161,4726989730.2,64.26720237805513,56.54776101990684,NaN,NaN,33.74831481008567,30.04345493641387
2013-12-30T09:30:00-05:00,87.4,87.51,87.14,87.39,18985622,31415854.9,67.68442493539787,64.34811868827886,NaN,NaN,110.9475840289263,180.95830983057087,0.08195880943222811,0.9656105600310525,0.8836517505988244,4715660539,4731481280.4,65.30079769589241,55.944853071445486,NaN,NaN,34.00887245144086,30.609943152846295
2013-12-31T09:30:00-05:00,87.54,87.96,87.52,87.96,24896065,31342927.2,71.02879795845146,64.24552706305278,NaN,NaN,129.386516476099,160.0049888143153,0.09039672551358957,0.9966476574908114,0.9062509319772218,4740556604,4735315690.8,66.19965684322246,55.320791792374635,NaN,NaN,35.245831133709515,31.272212864398185
2014-01-02T09:30:00-05:00,87.55,87.58,87.02,87.27,29190009,30944714.55,62.58509996321685,64.53091372173807,NaN,NaN,78.83187476961672,133.81448681542844,0.038650397325901586,0.9545639286345988,0.9159135313086972,4711366595,4730541604.4,63.97749469888317,54.9001412640518,NaN,NaN,33.68619527948372,31.61706749512469
2014-01-03T09:30:00-05:00,87.27,87.35,86.62,86.64,35727317,30871419.4,56.03519152127398,64.51277253815245,NaN,NaN,40.72351044713598,103.01932313067054,-0.04436465342130946,0.8604577145320604,0.9048223679533699,4675639278,4715573835.4,57.464629376583005,54.30868786430115,NaN,NaN,30.200939043947027,31.41476343067074
2014-01-06T09:30:00-05:00,86.65,86.76,86,86.32,32092437,30484574.35,53.001003538233284,64.36115084474947,NaN,NaN,-3.6132888688892164,71.25523937057775,-0.12274195575432545,0.7513949232604631,0.8741368790147885,4643546841,4697353971.4,50.69887904421559,53.95720247899296,NaN,NaN,26.367665576576833,30.693749451514467
2014-01-07T09:30:00-05:00,86.7,87.25,86.56,87.12,25913225,29938091.2,58.98088531687228,64.35783973403238,NaN,NaN,42.670587760267935,57.599840116846096,-0.12234820230768584,0.7212016261301812,0.8435498284378671,4669460066,4688113876.8,47.63575635113102,53.941797389472804,NaN,NaN,24.94962091765554,29.873159660963193
2014-01-08T09:30:00-05:00,87.11,87.55,86.945,87.31,27209991,30168595.6,60.2736831421103,64.5850464675352,NaN,NaN,60.20900368888368,43.76433755940304,-0.11125283698084587,0.7044837822118097,0.8157366191926556,4696670057,4679336567.4,44.8629259696436,54.16603895732929,NaN,NaN,24.224279558775113,29.066176789222038
2014-01-09T09:30:00-05:00,87.62,87.64,86.72,87.02,23695690,30005083.7,57.30498647568969,64.07768640492233,NaN,NaN,44.92313970792767,36.98259054706523,-0.12441045694968689,0.660223548005547,0.7846340049552338,4672974367,4671658121.8,42.53060464420499,54.21761519176725,NaN,NaN,22.708420122725702,28.157925836865417
2014-01-10T09:30:00-05:00,87.24,87.4,86.58,87.3,38012069,30064158.9,59.385014168170486,63.914945861569535,NaN,NaN,38.06081964259598,36.450052386157225,-0.11542000908965289,0.6403589935931677,0.7557790026828206,4710986436,4678727553.4,45.3477219155292,54.519467391863266,NaN,NaN,22.076255386632436,27.28911577254642
2014-01-13T09:30:00-05:00,87.18,87.48,85.675,86.01,48855231,30823790.6,47.82489418543711,62.64465217689192,NaN,NaN,-26.44004196972319,31.884701765990428,-0.19294954217264648,0.5145920749670125,0.707541617139659,4662131205,4682444426.2,46.82364838365981,54.56260404780515,NaN,NaN,17.52300666564947,25.893957328703998
2014-01-14T09:30:00-05:00,86.3,87.72,86.3,87.65,37194076,30979723.65,58.80424705642611,61.80507952290014,NaN,NaN,43.1338384861684,31.97735191117051,-0.1332183708824044,0.5410186535366535,0.6742370244190579,4699325281,4688417469.2,49.197973121582166,54.432144974419586,NaN,NaN,17.48382450251885,24.692509782106118
2014-01-15T09:30:00-05:00,88,88.54,87.94,88.37,39859705,31727292.7,62.5320009859733,61.217545641950935,NaN,NaN,145.67402100258542,49.07035537391086,-0.04899467507058353,0.6129936805808285,0.661988355651412,4739184986,4696920455,52.45265360703761,54.07266960318884,NaN,NaN,18.85896698328795,23.859146525132093
2014-01-16T09:30:00-05:00,88.28,88.51,88.16,88.38,34260219,32217559,62.582644061689905,60.528819346747774,NaN,NaN,152.20424953585876,70.52657733949707,0.0009664427693375499,0.663196409113084,0.6622299663437464,4773445205,4717014622.6,59.11826365467457,53.99130054887964,NaN,NaN,19.89947105379823,23.293478600655828
2014-01-17T09:30:00-05:00,88.12,88.3701,87.67,87.88,36908236,30643609.05,58.336865390742496,59.7399813356918,NaN,NaN,103.67961252444141,83.65033591586617,-0.005715815106647537,0.655085197460437,0.6608010125670846,4736536969,4722124729.2,60.629824362302834,53.73148783346877,NaN,NaN,19.328776505010087,22.72709258699215
2014-01-21T09:30:00-05:00,88.43,88.59,87.81,88.55,26432336,29640748.1,62.05205658968807,59.33766931099824,NaN,NaN,139.08835438785218,116.75601518738122,0.027128945648422498,0.6947121946276127,0.6675832489791902,4762969305,4742292349.2,65.97650833937392,53.77975287943171,NaN,NaN,20.10012998385598,22.351812215115554
2014-01-22T09:30:00-05:00,88.75,89,88.52,88.78,29425432,29088247.85,63.26312629187691,58.782978477671485,NaN,NaN,172.20096199753235,142.569439889654,0.054885094849141725,0.7361896175406173,0.6813045226914756,4792394737,4760906240.4,70.02294980880583,54.05284523411624,NaN,NaN,21.102545921066167,22.173345601679927
2014-01-23T09:30:00-05:00,88.5,88.52,87.86,88.48,35077428,29433031.05,60.548785140436834,58.637527418901485,NaN,NaN,94.96121447615451,132.42687858436784,0.044048321647768285,0.7363649247511859,0.6923166031034176,4757317309,4764532705,70.7527604947683,54.53679279096517,NaN,NaN,21.084157593388852,22.0177473147812
2014-01-24T09:30:00-05:00,88.06,88.18,86.71,86.74,64334902,31957152.4,47.751601556040974,58.04584242138485,NaN,NaN,-36.69426954018613,94.64717476915885,-0.0824074970204689,0.5893072318278314,0.6717147288483003,4692982407,4748440145.4,63.37893847141545,54.95924344059607,NaN,NaN,16.539430883648727,21.235130681762275
2014-01-27T09:30:00-05:00,86.77,86.89,85.25,85.9,63676475,34378921.35,43.0240627163772,57.33320379125227,NaN,NaN,-157.91690986012847,42.32787029224488,-0.21707834971034556,0.4003667917103684,0.6174451414207139,4629305932,4726993938,55.13249035256806,55.27592996262124,NaN,NaN,11.099327587747894,19.787158811188792
2014-01-28T09:30:00-05:00,85.42,85.94,85.31,85.85,44439554,35809300.95,42.75273977506703,56.17405053826617,NaN,NaN,-168.14230828243208,-19.11826224181197,-0.29892783805692935,0.2437853438495523,0.5427131819064817,4584866378,4691373352.6,44.72380365284604,55.06793334131517,NaN,NaN,6.855231796486525,17.939740666231327
2014-01-29T09:30:00-05:00,85.1,85.74,84.76,84.93,52064566,37463248.15,38.003722560840906,54.583339068175505,NaN,NaN,-188.72977370143633,-91.30440938160571,-0.39821928363556064,0.044939077362030844,0.4431583609975915,4532801812,4639454767.6,34.4999745838836,54.32772252804661,NaN,NaN,1.6046114149047608,15.606150773184675
2014-01-30T09:30:00-05:00,85.99,86.8,85.88,86.5,66863622,39561626,48.51422656719943,53.955427646140485,NaN,NaN,-67.84462571096054,-123.86557741902871,-0.34342438324694496,0.013877881938910264,0.35730226518585523,4599665434,4607924392.6,30.012805692944752,53.43359403152802,NaN,NaN,0.686186149890831,13.474727255571269
2014-01-31T09:30:00-05:00,85.54,86.68,85.45,86.27,45196915,40361971.3,47.25043172962866,53.08867175767322,NaN,NaN,-81.39827387370578,-132.80637828573265,-0.3090126468120651,-0.028963543329226127,0.28004910348283896,4554468519,4580221615,26.72402864794391,52.1033302267005,NaN,NaN,-0.44702972341247027,11.485904830002163
2014-02-03T09:30:00-05:00,86.14,86.5,84.07,84.29,65617206,41856465.75,38.05893675896213,52.39110337006786,NaN,NaN,-152.80930422060953,-131.78485715782887,-0.40015721209448485,-0.22014741163526708,0.18000980045921774,4488851313,4552130691.2,23.867948928484154,50.463637408473666,NaN,NaN,-4.92091776891344,9.142073030157077
2014-02-04T09:30:00-05:00,84.7,85.25,84.46,84.91,37801215,42141904.65,41.872024122838816,51.18165887481162,NaN,NaN,-139.6065916227844,-126.07771382589931,-0.39838212098641224,-0.3179678507737975,0.08041427021261469,4526652528,4540487921.2,22.781222085849862,48.57672662020707,NaN,NaN,-7.048196960074224,6.8291773172668915
2014-02-05T09:30:00-05:00,84.64,84.9901,83.74,84.69,41969204,42944703.6,40.90965952237929,49.63720591312633,NaN,NaN,-139.46152222850262,-116.2240635313126,-0.391158686783422,-0.4085340882666628,-0.01737540148324082,4484683324,4530864223.6,21.893865703103458,46.393956055640345,NaN,NaN,-9.007350177785092,4.56681624654518
2014-02-06T09:30:00-05:00,84.94,85.88,84.92,85.77,32338053,43201106.7,47.311663362258855,48.54642157745269,NaN,NaN,-68.76029230879905,-116.40719685088027,-0.2970445083041753,-0.3886810368634599,-0.09163652855928464,4517021377,4514335412.2,20.422519987108743,43.62997436509993,NaN,NaN,-8.479025736039857,2.703124534747318
2014-02-07T09:30:00-05:00,86.27,87.359,86,87.3,38467242,43939684.3,54.78529219195908,48.292737777539585,NaN,NaN,10.943885509287274,-97.93876497428167,-0.12400754217989626,-0.24664595628415498,-0.12263841410425871,4555488619,4514539432.2,20.49354486114585,40.763097257874435,NaN,NaN,-5.32622627100058,1.5560744196404754
2014-02-10T09:30:00-05:00,87.23,87.84,87.21,87.8,30225157,43550338.7,56.93511933597588,47.92724225941729,NaN,NaN,50.96282318857847,-57.184339492444074,0.023976259098128616,-0.09266809023159794,-0.11664434932972656,4585713776,4533911924.8,27.143041501626456,37.98927819803533,NaN,NaN,-2.105854287127463,1.0329417472450557
2014-02-11T09:30:00-05:00,87.94,88.97,87.89,88.8,38682035,43041678.9,60.93566246037332,47.76099484288132,NaN,NaN,93.23654446611907,-10.615712274663386,0.18035385178079197,0.10879796539626341,-0.07155588638452856,4624395811,4553460581.4,33.21311136355193,35.36000402337434,NaN,NaN,1.9558986467007715,1.1647927328815866
2014-02-12T09:30:00-05:00,88.97,89.1695,88.7,88.97,32533008,42808625.5,61.58892207128681,47.83529033794203,NaN,NaN,103.0993486412243,37.89646189928199,0.2804152146122633,0.2789631318808006,-0.001452082731462731,4656928819,4587909680.4,42.331297724564365,33.32989953978834,NaN,NaN,5.3340812330459535,1.7604053757622102
2014-02-13T09:30:00-05:00,88.31,89.7,88.3,89.63,40492842,42840282.35,64.09902367360067,49.00296334633915,NaN,NaN,110.24892366464229,73.69830509397025,0.37056480589090035,0.4617539246321627,0.09118911874126236,4697421661,4623989737.2,50.026669022971895,32.37616600775666,NaN,NaN,8.944191643201858,2.7866605568250167
2014-02-14T09:30:00-05:00,89.56,90.01,89.33,89.81,34086390,42831590.9,64.7751032059306,50.55660909559297,NaN,NaN,125.46708688796929,96.60294536970665,0.41829902946051883,0.6140629055669109,0.19576387610639207,4731508051,4659193623.6,56.17204786712938,32.450420115939615,NaN,NaN,12.048427214460059,4.109770079344308
2014-02-18T09:30:00-05:00,89.93,90.4172,89.74,90.25,29614391,42466898.65,66.43887184853405,52.24847567226918,NaN,NaN,130.13977176216687,112.43833508442432,0.45258501988702604,0.7614951509651746,0.3089101310781486,4761122442,4694275356.8,61.28180833345681,33.63313473598324,NaN,NaN,15.140043842897754,5.685523474137657
2014-02-19T09:30:00-05:00,90.07,90.285,89.45,89.63,41775267,43234045.2,61.99536242934485,53.96216423430518,NaN,NaN,106.67337966630782,115.12570212446208,0.4079663335863314,0.8188680480610628,0.41090171447473145,4719347175,4713265629.6,63.74581753308332,35.72212351806893,NaN,NaN,16.48254542842305,7.227955181892713
2014-02-20T09:30:00-05:00,89.7,90.22,89.31,90.05,41833212,43854434.2,63.763408122446194,55.05139148825136,NaN,NaN,103.50643082403879,115.20711856102498,0.3816712423884392,0.8879907674602805,0.5063195250718413,4761180387,4734115943.2,66.28294868464192,38.312848017475865,NaN,NaN,18.12501894761716,8.784678576996205
2014-02-21T09:30:00-05:00,90.33,90.465,89.82,89.93,31221745,43661650.05,62.863553288929374,56.16661445677284,NaN,NaN,102.37344331918243,113.632022491933,0.3329080133180271,0.9224545417193752,0.5895465284013481,4729958642,4740623339.4,67.05779715485039,41.1938314822549,NaN,NaN,19.22753924657927,10.276515815508072
2014-02-24T09:30:00-05:00,90.1,90.82,90.04,90.41,31517522,42020781.05,64.9917695899264,58.090388230413154,NaN,NaN,101.2339607769311,108.78539726972538,0.3101502733424537,0.9772343700794153,0.6670840967369616,4761476164,4746616962,67.79196977715083,44.33126154287395,NaN,NaN,20.77313016507319,11.776032151160232
2014-02-25T09:30:00-05:00,90.52,90.72,90.02,90.31,27464711,40210192.85,64.16674128547362,59.68286802774421,NaN,NaN,88.49784661386894,100.45701224006578,0.2671641282322377,1.0010392570272586,0.7338751287950209,4734011453,4741194764.2,66.35129615049229,47.44340969034841,NaN,NaN,21.840099202972883,13.213756015704895
2014-02-26T09:30:00-05:00,90.57,90.84,89.87,90.23,42968334,40136631.85,63.472562735217885,61.294503971518395,NaN,NaN,79.28693253424713,94.97972281365364,0.2144200476172381,1.0019001883165686,0.7874801406993305,4691043119,4735533953,64.80294279869254,50.50834376860478,NaN,NaN,22.558285068848676,14.548688737582578
2014-02-27T09:30:00-05:00,89.87,90.53,89.73,90.44,28750313,38970919.2,64.55651852975265,62.526279340625095,NaN,NaN,70.81065070627076,88.44056679010005,0.1763432297776485,1.0079091779213911,0.8315659481437426,4719793432,4727256562,62.506042451231515,53.51430965889926,NaN,NaN,23.453924797864044,15.820865317622788
2014-02-28T09:30:00-05:00,90.41,90.96,89.54,90.34,48623159,38058896.05,63.58882342126468,63.15510299986121,NaN,NaN,67.27720072356267,81.42131827097609,0.12927022012900546,0.9931537233049994,0.8638835031759939,4671170273,4715498888.2,59.29126606752373,56.285575459354824,NaN,NaN,23.979822064450772,16.98643056716964
2014-03-03T09:30:00-05:00,89.48,89.91,88.87,89.67,38946845,37746392.55,57.38246141127727,63.18705600523988,NaN,NaN,34.809504139410485,68.13642694347197,0.04235551533344384,0.9168278973427988,0.874472382009355,4632223428,4689648341,52.854816734906294,58.12213083316052,NaN,NaN,22.831819480863604,17.82148612626878
2014-03-04T09:30:00-05:00,90.63,90.98,90.56,90.81,33213909,36126227.7,63.847983163106115,63.395078912577944,NaN,NaN,82.94020986299523,67.02489959329725,0.05043845504972333,0.9375204508215091,0.8870819957717858,4665437337,4675933517.8,49.767999135189626,59.30462281684893,NaN,NaN,23.591085485254474,18.645714606123878
2014-03-05T09:30:00-05:00,90.9698,91.22,90.77,91.06,27220604,35597197.15,65.09847110092623,63.64576098612361,NaN,NaN,93.30263624167156,69.82804033478214,0.0607276766400171,0.9629915915718072,0.9022639149317901,4692657941,4676256482.2,49.84228620913917,59.841121994318556,NaN,NaN,24.581913224775008,19.493742980216897
2014-03-06T09:30:00-05:00,91.25,91.335,90.65,90.98,24086220,34703047.95,64.33162858410861,63.66237562258847,NaN,NaN,95.34554627462099,74.73501944845218,0.05066213524944785,0.9655915839936,0.9149294487441522,4668571721,4666012140,47.44543373812387,59.65674804540084,NaN,NaN,25.194607192348446,20.308152153378547
2014-03-07T09:30:00-05:00,91.27,91.36,90.071,90.53,31174837,34644887.15,60.04680901845807,63.32464032348329,NaN,NaN,74.51576665627583,76.18273263499482,0.0046382702052893965,0.9207272865007639,0.9160890162954745,4637396884,4659257462.2,45.87882383128277,58.92151775712608,NaN,NaN,24.548088201520553,20.91385730311312
2014-03-10T09:30:00-04:00,90.48,90.655,90.03,90.61,18138198,33628434.95,60.54986765983845,62.90399716714789,NaN,NaN,51.18383659869646,79.457599126852,-0.027698138152642438,0.8814663436046715,0.9091644817573139,4655535082,4663919793,47.17536433145812,57.91391461412617,NaN,NaN,24.139973738951102,21.3747310796614
2014-03-11T09:30:00-04:00,90.83,91.055,89.95,90.22,27505046,33492429.4,56.79547102963866,62.53257635288316,NaN,NaN,43.20838729605486,71.51123461346393,-0.07969155820495522,0.8095500340011199,0.8892415922060751,4628030036,4656438332.8,45.30000256800339,56.59635640233474,NaN,NaN,22.763191737518213,21.573082602212374
2014-03-12T09:30:00-04:00,89.82,90.61,89.48,90.56,27997215,32958188.4,59.17221171505561,62.20463375235527,NaN,NaN,8.28795265171087,54.5082978954718,-0.09451150360551897,0.7711022126991764,0.8656137163046954,4656027251,4649112194.8,43.47734042860649,54.967384384046504,NaN,NaN,22.198970469787845,21.662495154723157
2014-03-13T09:30:00-04:00,90.9,90.93,88.87,89.28,48541951,33758635.55,48.38155077423055,61.170205001305355,NaN,NaN,-92.71281383199218,16.89662587414917,-0.18842415378773159,0.6300835240700309,0.8185076778577625,4607485300,4636894910.6,40.547422450727574,53.07378619089487,NaN,NaN,18.309615529632655,21.1835123511388
2014-03-14T09:30:00-04:00,88.99,89.38,88.63,88.67,38738769,33670931.9,44.24098593632023,59.68800616890491,NaN,NaN,-223.7867234960862,-42.76387215632324,-0.28380023122230913,0.46375738882987605,0.7475576200521852,4568746531,4623164840,37.48977047956446,50.909343383924416,NaN,NaN,13.653995542514332,20.107867092763875
2014-03-17T09:30:00-04:00,89.24,89.91,89.19,89.45,28476800,33390452.4,50.11940909707561,58.68462529830505,NaN,NaN,-110.7838005895838,-75.15739959397929,-0.285740394086367,0.3903821274442265,0.6761225215305935,4597223331,4611502489.8,35.07060253904234,48.67500812596371,NaN,NaN,11.468467884464326,18.87366720586394
2014-03-18T09:30:00-04:00,89.55,90.64,89.53,90.53,31250235,33472244.6,56.895540236227426,58.21483797694858,NaN,NaN,8.638219921703195,-82.07143306884961,-0.20921847000602667,0.4145994340230601,0.6238179040290868,4628473566,4611591195.8,35.10490432361412,46.553719663458104,NaN,NaN,11.824611462077156,17.866659242465825
2014-03-19T09:30:00-04:00,90.56,90.66,89.45,90.04,40869371,33426949.8,53.35413745567518,57.41466790022877,NaN,NaN,-25.463074737220982,-88.821638546636,-0.18724631657898227,0.38976000830535895,0.5770063248843412,4587604195,4597906584.6,32.272398951300715,44.39417369917734,NaN,NaN,10.943414797738589,16.877624321790506
2014-03-20T09:30:00-04:00,89.78,90.56,89.58,90.29,31634538,32917016.1,54.89666993865943,56.79379979432839,NaN,NaN,-12.151856687422677,-72.70944711772209,-0.1529648757260621,0.3858002302267636,0.5387651059528257,4619238733,4600257271.2,33.26844890628692,42.53540104480328,NaN,NaN,10.725696817636297,15.998777535482763
2014-03-21T09:30:00-04:00,90.61,90.65,88.825,89,62812715,34496564.6,46.37475486168655,56.007535040786195,NaN,NaN,-115.05143212029603,-50.96238884256407,-0.21069586614785785,0.2753952732680034,0.48609113941586124,4556426018,4597793168.6,32.72514140928806,41.0975670929734,NaN,NaN,7.622615909939627,14.802183017548028
2014-03-24T09:30:00-04:00,89.32,89.39,87.41,88.22,77735313,36807454.15,42.117377927707615,54.45534895254344,NaN,NaN,-228.55331049135924,-74.51629082291916,-0.2900448849564207,0.12353503322033532,0.41357991817675605,4478690705,4574086643.4,27.989282938137094,39.541944507469644,NaN,NaN,3.573740926519004,13.19811986168674
2014-03-25T09:30:00-04:00,88.69,89.25,87.7701,88.51,41723335,37520385.35,44.1695769355675,52.96042794073211,NaN,NaN,-164.88187307264496,-109.22030942178878,-0.30983808721525014,0.026282309157693362,0.3361203963729435,4520414040,4552474738.2,24.507329152143512,37.732304717684244,NaN,NaN,1.0251969788931752,11.459130878430516
2014-03-26T09:30:00-04:00,88.96,89.15,87.36,87.37,40930442,37418490.75,38.40519454056989,51.10853979476506,NaN,NaN,-180.46300827899034,-140.22029613014266,-0.3818183406641843,-0.14115252945728685,0.24066581120689742,4479483598,4530850618.8,21.610481040460954,35.88695095356546,NaN,NaN,-3.1791941369871424,9.367941590513707
2014-03-27T09:30:00-04:00,87.27,87.64,86.4,86.879,64784488,39220199.5,36.213112892047555,49.40613292859287,NaN,NaN,-214.93670083910214,-180.77726496047853,-0.4404471978904115,-0.30989318615611694,0.13055401173429454,4414699110,4489942694.2,17.416360982732044,33.8539178929547,NaN,NaN,-7.309541842910228,6.985443957167431
2014-03-28T09:30:00-04:00,87.15,88.01,86.81,87.05,39895065,38783794.8,37.550011349998066,47.76328604931856,NaN,NaN,-158.4240001861389,-189.45177857364712,-0.44438307534380006,-0.42492483244545554,0.019458242898344524,4454594175,4469576325.6,15.77488866583765,31.611026773981802,NaN,NaN,-10.168648854237778,4.53485926982383
2014-03-31T09:30:00-04:00,87.73,88.26,87.62,87.67,33924297,38532667.4,42.274099499966134,46.72604522577053,NaN,NaN,-103.1046785778681,-164.36205219094887,-0.38416515748252156,-0.4607482039548074,-0.07658304647228587,4488518472,4471541879,16.591922771813813,29.560449645682546,NaN,NaN,-11.109162289978144,2.2999990469949765
2014-04-01T09:30:00-04:00,88.1,89.27,87.7106,89.21,38683837,38806163.8,51.98903234662805,46.21296098516855,NaN,NaN,-40.94401132978651,-139.5744798423772,-0.2273057655284738,-0.36071525338287813,-0.13340948785440432,4527202309,4472899532.8,17.189471087251732,27.68274469272864,NaN,NaN,-8.63198938200851,0.7382864142801928
2014-04-02T09:30:00-04:00,89.59,89.68,89.035,89.44,34631615,39176714.35,53.254357150904426,46.5610185835024,NaN,NaN,6.632712209102913,-102.15533574475856,-0.10117926217591561,-0.2598835655742988,-0.1587043033983832,4561833924,4489369598,24.276833566256073,26.520559772409246,NaN,NaN,-6.268320276067013,-0.2626573986265508
2014-04-03T09:30:00-04:00,89.55,89.679,88.22,88.73,30319074,39488357.05,48.96436147959778,46.89840255087937,NaN,NaN,-22.130120363416676,-63.594019649621465,-0.06068529370732906,-0.23456092053254451,-0.17387562682521546,4531514850,4512732746,33.03240532928508,26.202176547389293,NaN,NaN,-5.656090287783006,-1.0331478113631873
2014-04-04T09:30:00-04:00,89.29,89.41,86.14,86.37,131213229,44490276.65,38.00508754983459,46.033093868933584,NaN,NaN,-120.89684183955836,-56.08858798030535,-0.18114773110576654,-0.40031029070742363,-0.2191625596016571,4400301621,4501874235.2,31.22529020715517,25.927511380825926,NaN,NaN,-9.12481533619656,-2.189100314910812
2014-04-07T09:30:00-04:00,85.84,86.63,84.951,85.55,83995771,47783155.3,35.068110292961975,44.47399173012891,NaN,NaN,-197.8456957946672,-75.03679142366516,-0.29748761083393394,-0.5910220731440745,-0.2935344623101406,4316305850,4467431710.8,26.308791676682645,25.299217620330825,NaN,NaN,-12.949014965004544,-3.7262309792099164
2014-04-08T09:30:00-04:00,85.65,86.46,85.35,86.34,51495650,48982685.5,39.88780320510179,43.512110712230815,NaN,NaN,-151.37069572635482,-97.12212830297884,-0.3017203493566122,-0.6706848990059058,-0.3689645496492936,4367801500,4435551549,22.73979459195482,24.618317308948974,NaN,NaN,-14.31329646923617,-5.238668906356524
2014-04-09T09:30:00-04:00,86.67,87.87,86.43,87.82,45685231,49867086.3,47.71737510623383,42.99930393848613,NaN,NaN,-63.85021053722183,-111.21871285224378,-0.19074274675818803,-0.6073929830970286,-0.4166502363388406,4413486731,4405882110.4,20.01808758444028,23.671862928817074,NaN,NaN,-12.614973622407607,-6.29242672293525
2014-04-10T09:30:00-04:00,87.87,87.88,84.86,85.1,73659615,51122969.5,37.93745185777807,42.396639438206954,NaN,NaN,-131.04699840871885,-133.00208846130423,-0.28097061038130144,-0.7678634993154674,-0.48689288893416593,4339827116,4367544563.6,17.160021110053194,22.56006862172887,NaN,NaN,-14.985659886386898,-7.534317174856914
2014-04-11T09:30:00-04:00,84.34,85.44,83.91,84.11,93657425,53868902.3,35.11634713204248,41.89656580994516,NaN,NaN,-178.47871304739323,-144.5184627028712,-0.38153532126869893,-0.9638120405200397,-0.5822767192513407,4246169691,4336718177.6,15.271915705905343,21.651685247998035,NaN,NaN,-17.88773130165834,-9.013376335828546
2014-04-14T09:30:00-04:00,84.85,85.22,83.99,84.77,46500747,54770099.65,38.4047980124173,41.484795886863004,NaN,NaN,-146.7755042228675,-134.30442438851125,-0.37713845797033996,-1.0536997917142656,-0.6765613337439257,4292670438,4331991095.2,14.999371642089159,20.97254542585129,NaN,NaN,-18.918859429214514,-10.4284453491694
2014-04-15T09:30:00-04:00,85.06,85.54,83.28,85.0501,84631517,57439163.75,39.799275921162554,41.5843731283339,NaN,NaN,-132.07960997322235,-130.44620723788475,-0.3305689599068903,-1.0897725336275386,-0.7592035737206483,4377301955,4333891186.2,15.650983745176163,20.54686704761667,NaN,NaN,-19.2365175664414,-11.686741380208256
2014-04-16T09:30:00-04:00,85.83,86.18,85.091,86.18,46970899,57744240.15,45.18987610540947,42.2255705007169,NaN,NaN,-69.77178975795594,-131.6305230820316,-0.20502203719420808,-1.0154811202134084,-0.8104590830192003,4424272854,4336048410.8,16.43423490477403,20.47671518490538,NaN,NaN,-17.67304738460454,-12.541927952264867
2014-04-17T09:30:00-04:00,85.89,86.63,85.63,86.2,53719454,58848485.95,45.28327251742557,42.7779462983903,NaN,NaN,-46.38853707235941,-114.69883081475969,-0.10691891028017997,-0.9441077208694253,-0.8371888105892453,4477992308,4363681449.2,25.92324548757172,21.20159781502924,NaN,NaN,-16.434287123987392,-13.097979262510941
2014-04-21T09:30:00-04:00,86.41,86.84,86,86.84,25947923,57005246.35,48.31815632435618,43.20966464298959,NaN,NaN,-19.956407537484953,-82.99436971277802,0.008650890472317818,-0.826375197498848,-0.8350260879711658,4503940231,4415235557.2,39.68405527158317,22.85103585072705,NaN,NaN,-14.46728127317348,-13.293593835462733
2014-04-22T09:30:00-04:00,87.1,87.745,86.9898,87.53,38593408,55048151.1,51.445023961638825,43.170806901204635,NaN,NaN,29.981215599787504,-47.64302574824701,0.1322812701371905,-0.6696745002996778,-0.8019557704368683,4542533639,4465208197.4,49.4806189841168,25.15754641478884,NaN,NaN,-11.858582592841179,-13.08859222937394
2014-04-23T09:30:00-04:00,87.55,87.56,86.71,86.76,34376729,54680820.8,47.957970442109854,42.79249356486218,NaN,NaN,11.874133885186987,-18.852276976565143,0.161007670767224,-0.6006961819778383,-0.7617038527450622,4508156910,4491379188.4,53.72004550523656,27.260632981858873,NaN,NaN,-10.696007819484272,-12.746794456532559
2014-04-24T09:30:00-04:00,88.2,88.21,86.65,87.59,48926264,55080611.9,51.754154098546856,42.99176446621568,NaN,NaN,42.07034158702889,3.516149292431817,0.23048550360276,-0.4735969732416123,-0.7040824768443723,4557083174,4517941252.4,57.608312924629,29.016054952954867,NaN,NaN,-8.546138642238585,-12.146700768776277
2014-04-25T09:30:00-04:00,87.08,87.17,85.98,86.19,44341588,54058466.9,45.698887800460746,43.54132162697469,NaN,NaN,-18.6992490467738,9.05400689754895,0.17902468845583908,-0.48030161627457346,-0.6593263047304125,4512741586,4524891108,58.588662811568625,30.97058156755583,NaN,NaN,-8.554386673389844,-11.63351304086393
2014-04-28T09:30:00-04:00,86.58,87.11,85.11,86.47,58623796,54994903.45,47.03364657875606,44.396002790245696,NaN,NaN,-28.635903235577285,7.318107757930489,0.1612651744251472,-0.4577448366989785,-0.6190100111241257,4571365382,4538376138.2,60.49757095089071,33.41263722999926,NaN,NaN,-8.156739344787182,-11.136831084281537
2014-04-29T09:30:00-04:00,86.75,87.32,86.31,87.16,36742661,55135821.65,50.27723032484524,45.13810472737023,NaN,NaN,17.017702413196567,4.7254051206122965,0.19135765231523627,-0.3798129457300803,-0.5711705980453166,4608108043,4551491019,62.31689301466862,36.23957283162168,NaN,NaN,-6.844982003554116,-10.523709787034763
2014-04-30T09:30:00-04:00,86.79,87.48,86.54,87.39,38689408,55136100.2,51.346777826950444,45.39734777884998,NaN,NaN,38.23573193418014,9.997724730410926,0.22007306612426003,-0.2960792653899915,-0.5161523315142516,4646797451,4579219127.2,65.89344256583848,39.51638390172155,NaN,NaN,-5.461337801154518,-9.800513789051871
2014-05-01T09:30:00-04:00,87.53,88.15,87.31,87.65,37127219,55260880.4,52.588316738860236,46.4438381274987,NaN,NaN,91.04504161348072,19.792664735701294,0.24783299228421568,-0.20636109115898194,-0.4541940834431976,4683924670,4604587426.4,68.81011164626591,43.2056760828796,NaN,NaN,-3.9614517619367176,-8.966362070892563
2014-05-02T09:30:00-04:00,87.94,88.11,87.28,87.49,40074150,55748634.2,51.71376362196767,47.62936787677908,NaN,NaN,96.66813276578017,42.86614109821208,0.2461705357718978,-0.1464809137283254,-0.3926514495002232,4643850520,4630809213.2,71.52110253487166,47.22347514209148,NaN,NaN,-2.944121274947405,-8.106041957186111
2014-05-05T09:30:00-04:00,86.98,87.97,86.76,87.95,27924376,50584191.55,54.078255529368526,48.7489005565613,NaN,NaN,89.00579043659562,66.39447983264668,0.26515972764508616,-0.06120178994386549,-0.32636151758895166,4671774896,4650891116,73.4261097991918,51.39681358188453,NaN,NaN,-1.4250164473441467,-7.151609741494402
2014-05-06T09:30:00-04:00,87.83,87.86,86.77,86.81,33698549,48069330.45,47.82761016378503,49.32235300246292,NaN,NaN,50.77571673679021,73.1460826973654,0.19338491305739047,-0.08463037626721359,-0.27801528932460406,4638076347,4656884776.8,73.98543201080174,55.563559886572065,NaN,NaN,-1.809641528439454,-6.388471425343695
2014-05-07T09:30:00-04:00,87,87.08,85.53,86.56,67489143,48869005.1,46.55673029966867,49.419985444910004,NaN,NaN,-12.009811064455203,63.09697409763832,0.12484048945707746,-0.12196467750325724,-0.2468051669603347,4570587204,4641642727.4,69.95315707295266,59.386340041441976,NaN,NaN,-2.4853878301043464,-5.830888054595217
2014-05-08T09:30:00-04:00,86.26,87.53,86.05,86.48,46556871,48912587.1,46.13427170616202,49.48077110124831,NaN,NaN,15.967551658563135,48.08147610665481,0.07247849041488558,-0.15620705394172774,-0.2286855443566133,4524030333,4609663860,62.28341536361573,61.983495032587975,NaN,NaN,-3.160629347803501,-5.449422525053543
2014-05-09T09:30:00-04:00,86.41,86.86,85.85,86.8,35081529,46983682.8,48.16058432538839,49.469515958464896,NaN,NaN,-2.276217052258593,28.29260614304706,0.05836609648048757,-0.15572792375600386,-0.21409402023649143,4559111862,4592716128.4,58.6155018292537,63.33574121527872,NaN,NaN,-3.210288111043459,-5.12954618019496
2014-05-12T09:30:00-04:00,87.31,88.26,87.24,88.23,38951060,44248364.55,56.106824028031326,49.80250167749294,NaN,NaN,116.42633042846037,33.77671414141999,0.13967218771681797,-0.039503785590468965,-0.17917597330728693,4598062922,4577973733.6,55.550867524338756,63.76933039672315,NaN,NaN,-0.9405373893878836,-4.531116352936806
2014-05-13T09:30:00-04:00,88.32,88.61,88.12,88.29,30311862,43438920.3,56.40875021408327,50.40612880406247,NaN,NaN,148.3131402823572,53.28419885053338,0.18877399664156005,0.05679152249466313,-0.13198247414689693,4628374784,4576033421,55.14222943776772,63.87091496333251,NaN,NaN,1.0014475526837212,-3.7407500807053022
2014-05-14T09:30:00-04:00,88.03,88.35,87.62,87.83,26483571,40531523,53.37729206520243,50.522067230252155,NaN,NaN,102.17413501793467,76.12098806701135,0.1815013480447208,0.09489421090900407,-0.08660713713571672,4601891213,4582294222.8,56.26029377010334,63.77462788086639,NaN,NaN,1.8401048081410476,-2.943485096584395
2014-05-15T09:30:00-04:00,87.81,87.96,86.58,87.135,59680284,41166992.25,49.08521552777705,50.76394778220332,NaN,NaN,13.565587752930611,75.64059528588486,0.12386469660172125,0.06822373361643486,-0.055640962985286396,4542210929,4585930342,56.93169133940663,63.65627277571196,NaN,NaN,1.360616553308169,-2.328613432314029
2014-05-16T09:30:00-04:00,87.24,87.76,86.64,87.71,66807315,41821385.3,52.48907871353837,51.15362150611633,NaN,NaN,26.480837861348114,81.3920062686062,0.1184483927459438,0.09241952794714337,-0.02602886479880044,4609018244,4595911618.4,58.801173816887434,63.535101551854595,NaN,NaN,1.916299038481443,-1.722197365057533
2014-05-19T09:30:00-04:00,87.47,88.46,87.3,88.32,32017036,42124840.95,55.86042243138994,51.5524209422981,NaN,NaN,106.53916952203348,79.41457408732082,0.14801037306661774,0.15898410153447173,0.010973728467854,4641035280,4604506090,60.39531904366077,63.397846268211175,NaN,NaN,3.3752453988837585,-0.9939912559230629
2014-05-20T09:30:00-04:00,88.28,88.6,87.64,88,33715953,41880968.2,53.70740009065528,51.721036818277014,NaN,NaN,102.3828734333917,70.22852071752772,0.13825860347979452,0.18379698281759715,0.04553837933780264,4607319327,4600294998.6,59.18686933965252,62.918805323483596,NaN,NaN,3.993859256113436,-0.28144118277499175
2014-05-21T09:30:00-04:00,88.16,88.89,88.11,88.84,36837678,42004015.65,58.2557604490469,52.125854226147496,NaN,NaN,148.13163955130423,79.42002162420162,0.17809031166494543,0.26815126891898444,0.09006095725403901,4644157005,4608748157,60.87903875023103,62.352300116623965,NaN,NaN,5.885501392463046,0.599550613687585
2014-05-22T09:30:00-04:00,88.94,89.48,88.8,89.23,30617089,41088556.9,60.21046944991762,52.73276178528677,NaN,NaN,177.65430503511155,112.23776508063781,0.21778808660194496,0.3622960655064702,0.14450797890452524,4674774094,4635260790,65.68467197580443,61.935412219547736,NaN,NaN,8.05113797637617,1.6640630940716685
2014-05-23T09:30:00-04:00,89.33,89.9,89.12,89.88,22691254,40006040.2,63.29536131364164,53.391126484163415,NaN,NaN,194.5961114451857,145.86081979740533,0.2714171013032819,0.4837793555336276,0.21236225423034572,4697465348,4652950210.8,68.46784492303358,61.58125044267929,NaN,NaN,10.848759055775608,2.9761625171722312
2014-05-27T09:30:00-04:00,90.28,91.02,90.2,91.001,29725231,38561111.95,67.91539150351088,54.82596800842955,NaN,NaN,244.4315385759306,173.43929360818476,0.36040613080977846,0.6628699177425688,0.3024637869327903,4727190579,4670181270.6,70.94028854426188,61.3637401950693,NaN,NaN,14.829712124080736,4.669526746730589
2014-05-28T09:30:00-04:00,90.97,91.1,90.645,90.72,30478074,38247882.6,65.68353748306816,56.19216852152952,NaN,NaN,202.61372663259283,193.48546424802498,0.37659937743752614,0.773213008729698,0.39661363129217186,4696712505,4688059906.2,73.28125834243772,61.60146171431824,NaN,NaN,17.418231844637965,6.490770332145928
2014-05-29T09:30:00-04:00,91.05,91.31,90.86,91.3,33036099,37965217.15,68.01961686337935,57.755407461330755,NaN,NaN,179.67277029265853,199.79369039629586,0.4004054232868703,0.8971204104007597,0.49671498711388945,4729748604,4705178226,75.33042650746786,62.53339108173624,NaN,NaN,20.331971246026438,8.468084748414572
2014-05-30T09:30:00-04:00,91.33,91.45,90.83,91.31,29916899,37604701.15,68.05998854510928,59.17679347702511,NaN,NaN,148.97027828982414,194.05688504723838,0.3904463986134038,0.9847729853806442,0.5943265867672404,4759665503,4722156507.8,77.19829464664907,63.86073342583591,NaN,NaN,22.694935896804054,10.500492055327355
2014-06-02T09:30:00-04:00,91.43,91.44,90.64,91.22,30415405,37121763.9,67.23730900834454,59.97182811847605,NaN,NaN,121.8138368671629,179.5004301316338,0.3525744777008508,1.0350446838933038,0.682470206192453,4729250098,4728513457.8,77.87380355149509,65.45522885634708,NaN,NaN,24.429263145136368,12.490316496728642
2014-06-03T09:30:00-04:00,90.91,91.33,90.8,91.18,21783686,36814729.4,66.85054509905832,60.71767061025998,NaN,NaN,105.22558324512582,151.65923906547286,0.3015798975006495,1.059445078068265,0.7578651805676154,4707466412,4724568624.4,76.36196505658901,66.97092425769145,NaN,NaN,25.77575510176389,14.388236297447964
2014-06-04T09:30:00-04:00,90.96,91.67,90.81,91.52,20128261,36136215,68.50871710917998,61.798486684829804,NaN,NaN,101.43028422466223,131.42255058388673,0.26859685950670764,1.093611254951,0.8250143954442923,4727594673,4730745058,77.11122139247568,68.46027623071805,NaN,NaN,27.389183756948775,16.24551450594808
2014-06-05T09:30:00-04:00,91.61,92.46,91.29,92.29,35583055,34540910.6,71.93283162023916,63.43045926286281,NaN,NaN,116.1868930619736,118.72537513774975,0.2754615414468443,1.1693413222528477,0.8938797808060034,4763177728,4737430882.8,77.92683699044026,69.95992949150617,NaN,NaN,29.826088975100173,18.185596572969807
2014-06-06T09:30:00-04:00,92.66,92.82,92.45,92.82,22680643,33347099.2,74.02627845044108,64.96883067264157,NaN,NaN,128.67209558160167,114.66573859610526,0.29099807240305586,1.2576273713098232,0.9666292989067673,4785858371,4742669456.4,78.57116096082865,71.37207143035911,NaN,NaN,32.56234481400981,20.239417750261236
2014-06-09T09:30:00-04:00,92.85,92.98,92.495,92.75,23402469,32763146.2,73.24918546549175,66.21088517507742,NaN,NaN,117.84144122037858,113.8712594667484,0.27220165793480633,1.3068813713252752,1.0346797133904688,4762455902,4749310617.2,79.39242396244697,72.72900749598669,NaN,NaN,34.61828980801644,22.29354232994055
2014-06-10T09:30:00-04:00,92.67,92.96,92.56,92.91,20635286,31847357.5,73.92301656182076,67.65485778016067,NaN,NaN,108.91426669244073,114.6089961562114,0.24692901755912988,1.3433409853393812,1.0964119677802513,4783091188,4764435572.4,81.16305796977963,74.29873525528149,NaN,NaN,36.5427550900523,24.329144152813658
2014-06-11T09:30:00-04:00,92.59,93.02,92.5,92.89,22884331,31475980.95,73.67320169570027,68.75610358349306,NaN,NaN,99.53868491013216,114.23067629330538,0.2068720571527627,1.3550020392212048,1.148129982068442,4760206857,4770958009.2,81.88586114029025,75.79922256885713,NaN,NaN,38.095306848371344,26.295738823607614
2014-06-12T09:30:00-04:00,92.69,92.79,91.73,92.05,35275853,31915595.05,63.90514061054732,69.02000866639517,NaN,NaN,70.14155371582275,105.0216084240752,0.1068464358318788,1.2816880268582906,1.1748415910264118,4724931004,4763308664.4,78.10087254931584,76.68609403839366,NaN,NaN,36.83010569656948,27.80064837688788
2014-06-13T09:30:00-04:00,92.47,92.55,91.92,92.32,39449997,30904080.7,65.48903105012519,69.17669936185828,NaN,NaN,70.41648056500102,93.37048542075506,0.04507121018748039,1.2311806037607624,1.186109393573282,4764381001,4759013190.4,75.97709094040502,77.2224687539202,NaN,NaN,36.173631584728454,28.99678883515082
2014-06-16T09:30:00-04:00,92.16,92.67,91.96,92.4,25218557,28824642.8,65.9655816517329,69.03742722958843,NaN,NaN,71.0749345467861,84.01718408603656,-0.0017191316035503057,1.183960479068844,1.1856796106723944,4789599558,4764441921.6,76.83446098682359,77.64348107124603,NaN,NaN,35.74796711053853,29.961242874491923
2014-06-17T09:30:00-04:00,92.34,92.7,92.18,92.45,19984787,28223030.35,66.27899470710696,69.07995988844836,NaN,NaN,71.47981655542559,76.53029405863353,-0.03857502313253436,1.1374608317567265,1.1760358548892609,4809584345,4769740553,77.67206978286987,77.95711045984832,NaN,NaN,35.468170230166656,30.747946782445457
2014-06-18T09:30:00-04:00,92.55,93.1,91.98,92.97,34514013,28262933.35,69.43173082462266,69.1808251713943,NaN,NaN,78.89350939103846,72.40125895481481,-0.037189924689184695,1.12954844902778,1.1667383737169648,4844098358,4786518853.2,80.12293793573464,78.29943270472452,NaN,NaN,36.051004975656724,31.50552652433278
2014-06-19T09:30:00-04:00,93.1,93.17,92.49,92.91,38427402,28342419.55,68.63435828286376,69.2218515812339,NaN,NaN,84.46448314873105,75.26584484139646,-0.04883820538454797,1.10569061698628,1.1545288223708279,4805670956,4802666843.6,82.15334667973468,78.65336499280207,NaN,NaN,36.33244843976106,32.19508679796539
2014-06-20T09:30:00-04:00,92.7,92.87,92.53,92.77,25897494,28106439.8,66.7092687472227,69.18413441972521,NaN,NaN,70.26378696445161,75.23530612128658,-0.07303903446002624,1.063230029295795,1.1362690637558213,4779773462,4805745335.8,82.51993496605914,78.98523152241378,NaN,NaN,36.07582244385782,32.74947760452145
2014-06-23T09:30:00-04:00,92.735,92.82,92.51,92.79,20837926,28013773.4,66.85230605243433,69.1842602021092,NaN,NaN,65.47212075040024,74.1147433620094,-0.09346161328213798,1.0194420471531487,1.1129036604352867,4800611388,4807947701.8,82.79225641056595,79.44453804769786,NaN,NaN,35.89292909275091,33.198542102839944
2014-06-24T09:30:00-04:00,92.79,93.57,92.43,92.7,31945762,28124799.95,65.48869805890797,68.96854455566121,NaN,NaN,80.1513223023679,75.84904451139786,-0.11725239781166619,0.966338163170704,1.0835905609823702,4768665626,4799763958,77.9336572621801,79.50328346696246,NaN,NaN,35.39673156854024,33.51256916936856
2014-06-25T09:30:00-04:00,92.49,93.45,92.48,93.29,32818591,28241825.8,69.8328203351642,68.81854374958444,NaN,NaN,95.40224848211163,79.1507923296125,-0.09824390285982454,0.9607856824075895,1.059029585267414,4801484217,4791241129.8,73.12105269856025,79.1600131603996,NaN,NaN,36.066461089864724,33.877410872296586
2014-06-26T09:30:00-04:00,93.35,93.36,92.62,93.34,22572172,27718629.45,70.17544400359341,68.54348414623817,NaN,NaN,94.76568405140928,81.21103251014816,-0.08764372613855209,0.949474927594224,1.0371186537327761,4824056389,4794918216.4,73.87075155261223,78.82426963124128,NaN,NaN,36.72131771642563,34.28368327860073
2014-06-27T09:30:00-04:00,93.21,93.765,93.19,93.75,22881506,27366859.8,72.89404743454703,68.51811714402784,NaN,NaN,146.21990833445204,96.40225678414822,-0.059695282412951745,0.9624995507165863,1.022194833129538,4846937895,4808351103,76.45440593461782,78.61441120068207,NaN,NaN,38.050928210643306,34.82186112603539
2014-06-30T09:30:00-04:00,93.71,94.14,93.67,93.91,19764915,26834335.3,73.89411890604146,68.51605302575788,NaN,NaN,187.30388607289743,120.76860984864766,-0.03815674295421334,0.9744989044367713,1.0126556473909847,4866702810,4821569387.4,78.6876177755383,78.43759404395054,NaN,NaN,39.462992841020245,35.484879942461795
2014-07-01T09:30:00-04:00,94.21,95.19,94.2,94.94,31862487,27338275.35,79.21143815427101,68.91164134422722,NaN,NaN,285.1313073119394,161.76460685056196,0.03384344131823225,1.0549599490387749,1.0211165077205426,4898565297,4847549321.6,82.25085915843465,78.46366533096086,NaN,NaN,42.53732664141568,36.49237232802663
2014-07-02T09:30:00-04:00,94.98,95.24,94.91,95.1,18784391,27271081.85,79.89644465268171,70.05387734723682,NaN,NaN,249.50467585991092,192.5850923261218,0.07809913475120389,1.1187404261595475,1.0406412914083436,4917349688,4870722415.8,84.70691878309233,78.93552577623062,NaN,NaN,45.26904187437203,37.746182263218834
2014-07-03T09:30:00-04:00,95.41,95.7,95.15,95.7,15291700,26256514.1,82.2574752558192,71.25162336192925,NaN,NaN,222.77882797733668,218.1877211113073,0.13054693060113753,1.2038249546597655,1.073278024058628,4932641388,4892439415.6,86.58097651963446,79.69294617474701,NaN,NaN,48.45465037967778,39.27596342271297
2014-07-07T09:30:00-04:00,95.59,95.71,95.23,95.41,23266428,26285803.35,77.51869438380439,72.07684569993435,NaN,NaN,168.4864138587915,222.64102221617517,0.12828471375481398,1.2336339162521455,1.1053492024973315,4909374960,4904926828.6,87.5274340119861,80.4567299622586,NaN,NaN,49.63172245544685,40.75535757024638
2014-07-08T09:30:00-04:00,95.24,95.3,93.87,94.26,40612448,27146302.3,62.21289014580782,71.78640965984155,NaN,NaN,80.13299473461639,201.20684394851895,0.036674332309591495,1.151192117884321,1.1145177855747295,4868762512,4905338769,87.55860824378934,81.16291128089573,NaN,NaN,45.33589251319158,41.40971970495284
2014-07-09T09:30:00-04:00,94.51,95.065,94.24,94.96,29928322,27610954.1,66.54320013121404,71.5800860388838,NaN,NaN,87.6939318828683,161.71936886270473,0.011843709670600777,1.1293224226629803,1.1174787129923796,4898690834,4905363876.4,87.56064899334848,81.69417635643957,NaN,NaN,43.23896464185428,41.67104041022448
2014-07-10T09:30:00-04:00,93.78,95.05,93.63,94.66,44250020,28679238.55,63.200453915591545,71.19195001265007,NaN,NaN,59.42148435967601,123.70273056265776,-0.03367364964590225,1.0753866509350019,1.109060300580904,4854440814,4892782101.6,80.44002893456734,81.57179651749904,NaN,NaN,40.42270622049157,41.492706954548346
2014-07-11T09:30:00-04:00,94.87,95.27,94.61,95.27,19570393,27893965.55,66.84725806143649,71.20180639223678,NaN,NaN,88.65207278246766,96.87737952368397,-0.03162013642083572,1.0695351300548595,1.1011552664756952,4874011207,4881056065.4,74.36987248210016,80.98964919721627,NaN,NaN,39.310330304279155,41.18093886165275
2014-07-14T09:30:00-04:00,95.7,96.055,95.535,95.84,19579041,26900417.75,69.85357963145864,71.4161830764528,NaN,NaN,123.07774227902695,87.79564520773104,-0.00233840830992027,1.098232256088295,1.1005706643982152,4893590248,4877899123,72.7775708754388,80.27431451613575,NaN,NaN,39.421007456778554,40.92952008952786
2014-07-15T09:30:00-04:00,95.98,96.13,94.83,95.51,39480119,27613495.85,66.11554492692521,71.46095785273974,NaN,NaN,92.48856261304992,90.26675878341773,-0.014956126910405043,1.081875505760209,1.096831632670614,4854110129,4874968646.4,71.25251836184282,79.79709030896879,NaN,NaN,38.257696654451266,40.547831027374066
2014-07-16T09:30:00-04:00,96.19,96.3,95.785,95.89,22061998,27717356.4,68.224199777558,71.34605638433929,NaN,NaN,113.19931581369873,95.36783556958383,-0.007829535974507973,1.087044712702479,1.094874248676987,4876172127,4870464905,68.86415533834317,79.49302621181042,NaN,NaN,37.9905576086507,40.18250625327073
2014-07-17T09:30:00-04:00,95.63,95.97,94.32,94.619,43111514,28147231.45,55.73159258823925,70.314352711814,NaN,NaN,43.22248845507821,92.12803638866427,-0.09404629987176305,0.977316373837283,1.071362673709046,4833060613,4866188864.8,66.58217897896742,78.97241388512153,NaN,NaN,33.23113014631669,39.18945252370587
2014-07-18T09:30:00-04:00,95.14,96.17,95,96.12,36690832,28060402.95,64.09353402716943,69.68574461128703,NaN,NaN,91.1829086148791,92.63420355514657,-0.0571323303436313,0.999947260779507,1.0570795911231383,4869751445,4865336912.4,66.11211475380509,78.23367880077775,NaN,NaN,32.238210107061704,38.1964178927567
2014-07-21T09:30:00-04:00,95.92,96.16,95.55,96,29754810,28253268.75,63.06786651283518,68.91244086891516,NaN,NaN,94.70204124374938,86.95906334809106,-0.04829571073417793,0.996709952705416,1.045005663439594,4839996635,4854618189.8,60.340219198008775,76.92315033095421,NaN,NaN,31.134797397309487,37.18761496483567
2014-07-22T09:30:00-04:00,96.44,96.76,96.345,96.61,25770404,28499892.65,66.0426757149126,67.97181498038955,NaN,NaN,137.1385740061482,95.8890656267107,-0.010823690025970611,1.0314760509071306,1.0422997409331012,4865767039,4856949571.8,61.13500683148531,75.41487516474355,NaN,NaN,31.28946090470836,36.345021527674625
2014-07-23T09:30:00-04:00,96.94,97.34,96.77,97.227,28947464,28349977.75,68.78174695889301,67.17790800226179,NaN,NaN,166.56011558447457,106.56122558086588,0.04310349311163164,1.0961791073226408,1.0530756142110091,4894714503,4860658047,62.42493967711818,73.82330522860254,NaN,NaN,32.36904728194593,35.77702520685624
2014-07-24T09:30:00-04:00,97.4,97.51,96.98,97.12,24707180,27944407.2,67.76096555593354,66.14244302369853,NaN,NaN,156.4023618164206,129.19720025313435,0.058215271036262006,1.1258447030063365,1.0676294319700745,4870007323,4868047389,64.92312403339469,72.2763157652997,NaN,NaN,32.87541063680743,35.36250883970641
2014-07-25T09:30:00-04:00,96.65,96.87,96.23,96.74,29903633,28310980.25,64.12141983217037,65.18549484143897,NaN,NaN,102.09174878432296,131.37896828702313,0.030651213982254122,1.1059434494478921,1.075292235465638,4840103690,4862117838,61.39565538548548,70.40976014912108,NaN,NaN,32.14068660168802,34.90224851998949
2014-07-28T09:30:00-04:00,96.8,97.02,96.02,96.77,25603360,28447072.95,64.28451701628119,65.33346818932992,NaN,NaN,92.66887532066653,130.97233510240656,0.0038791055986515666,1.0801411174639526,1.076262011865301,4865707050,4867259921,63.259912856073775,68.67413904999854,NaN,NaN,31.60516094664121,34.43123600951117
2014-07-29T09:30:00-04:00,96.97,97.2,96.52,96.6,27022232,28809938.8,62.549330243143956,65.04819176875348,NaN,NaN,98.18497584879113,123.18161547093516,-0.03376556057051339,1.0340550611521593,1.0678206217226727,4838684818,4861843476.8,59.974455056995744,66.70369662597335,NaN,NaN,30.664863421614125,33.89318278266873
2014-07-30T09:30:00-04:00,97.13,97.32,96.6,96.98,35348519,28984240.4,64.83429018040253,65.16489435909713,NaN,NaN,104.1553804622467,110.70066844648957,-0.041074866075437866,1.0164770391283753,1.0575519052038131,4874033337,4857707243.6,57.517795575422774,65.0663942431773,NaN,NaN,30.50973934136586,33.40983371962547
2014-07-31T09:30:00-04:00,96.2,96.34,94.88,95.02,50047926,30547417.15,48.42341976793556,63.84890590956134,NaN,NaN,-40.197151308252614,71.38076582155493,-0.17822710474196457,0.8347680242763573,1.012995129018322,4823985411,4848502861.2,52.37631809029461,63.495426072334055,NaN,NaN,24.64111456839165,32.157159555163496
2014-08-01T09:30:00-04:00,94.83,95.34,94.04,94.67,60707990,32818231.65,46.175725491852646,62.1576306138752,NaN,NaN,-99.13110239997968,31.1361955846944,-0.2864199770845406,0.6549701576626461,0.9413901347471867,4763277421,4833137607.4,45.124773688836285,61.52022627329102,NaN,NaN,19.21638526111991,30.308477513157268
2014-08-04T09:30:00-04:00,94.9,95.69,94.52,95.32,33230537,33316437.1,50.74803229794993,61.059951140376974,NaN,NaN,-53.25009607087448,1.95240130638619,-0.3063195576207184,0.5584906877212887,0.8648102453420071,4796507958,4819297789,39.782100687557424,59.27233929655635,NaN,NaN,16.200765344331973,28.29309006046794
2014-08-05T09:30:00-04:00,94.94,95.21,94.15,94.59,50331066,33802368,46.01982677463696,59.47392449731118,NaN,NaN,-100.97023298791215,-37.878640460954465,-0.3572056563182462,0.41830317494419944,0.7755088312624456,4746176892,4800796203.8,33.988611370568634,56.78122901314388,NaN,NaN,12.076292147809417,25.976404644373865
2014-08-06T09:30:00-04:00,93.99,95.11,93.92,94.52,34431913,34027547.55,45.58127240152602,58.74890162683166,NaN,NaN,-109.92606711718794,-80.6949299768414,-0.3819121688459999,0.29811862020494573,0.6800307890509456,4711744979,4768338532.2,26.65491526419379,53.92928160494576,NaN,NaN,8.713498151536417,23.510275145397088
2014-08-07T09:30:00-04:00,94.95,95.139,93.885,94.22,33274669,33478780,43.66092713967754,57.289429706296524,NaN,NaN,-118.3785808980255,-96.33121589479597,-0.4027222753254931,0.1766279448940793,0.5793502202195724,4678470310,4739235512,22.058923997092236,50.78262512232341,NaN,NaN,5.362847371053779,20.917785463348043
2014-08-08T09:30:00-04:00,94.38,95.01,93.97,94.9,40238383,34512179.5,48.91458889025435,56.27848130468361,NaN,NaN,-95.58668854389202,-95.62233312357844,-0.35654009374202805,0.13367510304203734,0.4902151967840654,4718708693,4730321766.4,20.871870950044226,47.96345739032595,NaN,NaN,4.0847442855225955,18.513065295087266
2014-08-11T09:30:00-04:00,95.25,95.76,95.2,95.46,28283279,34947391.4,52.81674058501856,55.333771652548315,NaN,NaN,-22.58412066964158,-89.48913804333186,-0.2776348827918595,0.143171593294241,0.4208064760861005,4746991972,4720418569.2,19.609321914829522,44.997337039136255,NaN,NaN,4.219611390092832,16.47114330865949
2014-08-12T09:30:00-04:00,95.38,95.67,94.93,95.42,28158723,34381321.6,52.50821501853238,54.17137651395113,NaN,NaN,-32.707914220406025,-75.83667428983064,-0.220013664760712,0.1457893951352105,0.3658030598959225,4718833249,4714949840.6,18.928401371363506,41.89044144586806,NaN,NaN,4.2376131693559635,14.723496145901843
2014-08-13T09:30:00-04:00,95.81,96.47,95.76,96.43,27996489,34678046.15,59.017898237529174,53.54687170549367,NaN,NaN,38.07769388045171,-46.2359220903027,-0.11124343796077335,0.2267487624449558,0.33799220040572914,4746829738,4721966792.4,22.640294588376065,38.87023934265245,NaN,NaN,6.314023574762833,13.522142921453412
2014-08-14T09:30:00-04:00,96.54,96.95,96.43,96.93,25006602,33772800.55,61.80876065836886,53.381681764507846,NaN,NaN,74.36215143158697,-7.687775624380191,-0.008409380658298438,0.3274804745828561,0.33588985524115456,4771836340,4740639998.4,31.613583712205298,36.74294850884672,NaN,NaN,8.940541516835571,12.867628435079435
2014-08-15T09:30:00-04:00,97.46,97.63,96.48,97.4,55205490,34698533.45,64.27178156599712,53.380772089487564,NaN,NaN,94.34273091468079,30.298108267334374,0.08341790616188521,0.44016223794351106,0.35674433178162585,4827041830,4762306625.8,40.270841678710916,35.10087199617794,NaN,NaN,11.917805941359319,12.731939507405134
2014-08-18T09:30:00-04:00,97.89,98.24,97.77,98.15,38938349,35157710.4,67.83642984487375,53.758422061039695,NaN,NaN,137.59045481990748,62.33302336524419,0.18121144395494276,0.5832586367253043,0.40204719277036155,4865980179,4786104267.2,48.0498557234567,34.24911490092515,NaN,NaN,15.64973465066109,13.148767385013127
2014-08-19T09:30:00-04:00,98.38,98.76,98.32,98.7,21363394,34937359.9,70.18561520490721,54.14065956279002,NaN,NaN,153.13215007836095,99.50103622499759,0.26444146312541605,0.7325990216771316,0.4681575585517156,4887343573,4819806332,56.65874165820459,34.18775390683814,NaN,NaN,19.54259697158283,14.062171611665942
2014-08-20T09:30:00-04:00,98.61,98.9,98.53,98.7,23435596,34661766.5,70.18561520490721,55.69510209400228,NaN,NaN,145.68619545807977,121.0227365405232,0.2984778651443045,0.8412548899820962,0.5427770248377917,4887343573,4847909099,62.27296997119017,34.8946576126164,NaN,NaN,22.627068128368965,15.28572825690923
2014-08-21T09:30:00-04:00,98.76,98.95,98.6,98.9,19339477,34393381.35,71.07653782680151,57.473731546498634,NaN,NaN,137.78043240211025,133.70639273462785,0.31197965786801496,0.9327515971728104,0.6207719393047955,4906683050,4874878441,66.72730142874329,36.437695308324045,NaN,NaN,25.44533398962235,16.737100504439677
2014-08-22T09:30:00-04:00,98.94,99.25,98.72,99.05,24699453,34133172.35,71.7581743437522,58.97445597834165,NaN,NaN,129.02390553233496,140.6426276581587,0.30800102108359495,1.0057732156592891,0.6977721945756942,4931382503,4895746575.6,69.70761114193908,38.575231769351305,NaN,NaN,27.986279980140992,18.34412614382558
2014-08-25T09:30:00-04:00,99.52,99.68,99.16,99.4,24124718,34059240.25,73.33713343862713,60.92569216862666,NaN,NaN,128.76622309841235,138.87778131385966,0.30533609258457983,1.079442310306419,0.7741062177218392,4955507221,4913651984,72.02317658456597,41.29198642749397,NaN,NaN,30.627366638732383,20.098874785955122
2014-08-26T09:30:00-04:00,99.53,99.61,99.27,99.5,20100350,33713146.15,73.78804785126438,62.94046184360797,NaN,NaN,114.5009725760987,131.1515458134072,0.28698393227104846,1.1328361330606498,0.8458522007896013,4975607571,4931304783.6,74.12330739489744,44.68258586540137,NaN,NaN,32.96119632844836,21.936349292025586
2014-08-27T09:30:00-04:00,99.53,99.64,99.31,99.52,15595925,32725516.45,73.88317889704456,65.09919411199134,NaN,NaN,102.3967173365716,122.49365018910558,0.25400186199955743,1.163354528289048,0.9093526662894906,4991203496,4952076768.2,76.37102577813819,48.56202170690465,NaN,NaN,34.93872463258203,23.793831483533648
2014-08-28T09:30:00-04:00,99.2,99.53,99.08,99.41,23563850,31401312.65,72.32836320716191,66.77160656319901,NaN,NaN,86.3695268979709,112.21146908827772,0.20470380429972201,1.1652324216641432,0.9605286173644212,4967639646,4964268087.4,77.6007936834024,52.61408761643023,NaN,NaN,36.24544006689606,25.57263270972828
2014-08-29T09:30:00-04:00,99.65,99.9141,99.2701,99.78,17912339,29261530.1,74.2883662132362,68.3052941080717,NaN,NaN,88.81243999919376,104.16917598164949,0.17792940467395213,1.1829403732068613,1.0050109685329092,4985551985,4975101983.8,78.66351599795613,56.83224433665356,NaN,NaN,37.930358721793425,27.3380221400233
2014-09-02T09:30:00-04:00,100.04,100.1,99.6601,100.07,18331922,28516599.35,75.73885425520865,69.96462548212001,NaN,NaN,90.28239099283482,96.47240956053398,0.16116500563413627,1.2064672255755795,1.0453022199414432,5003883907,4984777321,79.59461954512092,61.16554563477909,NaN,NaN,39.799321390315235,29.11820774720786
2014-09-03T09:30:00-04:00,100.32,100.34,99.3,99.48,25950656,27297578.85,67.40723031924114,70.56386348795658,NaN,NaN,75.69505420850838,88.71122588701591,0.09502662672746642,1.1640855033507762,1.0690588766233098,4977933251,4985242457,79.64061747177702,65.23699726930774,NaN,NaN,39.20393622323274,30.559026100925703
2014-09-04T09:30:00-04:00,99.73,100.22,99.14,99.39,24663511,26809158.75,66.2107254902026,70.87828954737327,NaN,NaN,66.79159489788373,81.59020139927834,0.03310092388858776,1.1104350314840445,1.0773341075954568,4953269740,4977655705.8,76.60725686105916,68.45083106565444,NaN,NaN,38.380050734305115,31.67631533426562
2014-09-05T09:30:00-04:00,99.58,99.95,99.03,99.89,30805767,26685713.65,69.45461298308587,71.24849179145106,NaN,NaN,64.96918906819789,77.31013383332375,0.014638870417335914,1.0956326956171267,1.0809938251997908,4984075507,4980942878,77.01573733126594,71.07546646940837,NaN,NaN,38.534417730022,32.656044247945104
2014-09-08T09:30:00-04:00,99.89,100.33,99.62,100.08,25581202,25952854.6,70.6093021571391,71.44655409947,NaN,NaN,82.24396440293502,75.996438714072,0.004569960958661801,1.0867062763981181,1.0821363154394563,5009656709,4985763822.8,77.63261596252661,73.18852077219906,NaN,NaN,38.98265284773454,33.55984547648645
2014-09-09T09:30:00-04:00,100.06,100.46,99.0645,99.25,36449189,26361150.1,59.94814415704132,70.71530616747958,NaN,NaN,56.551786538467184,69.25031782319846,-0.06481489252269079,1.0011176997860929,1.0659325923087837,4973207520,4979628545.4,74.87831165123742,74.48991862884428,NaN,NaN,36.15708398509083,33.93087954914422
2014-09-10T09:30:00-04:00,99.38,100.11,99.1,100.07,31080115,26507219.7,65.4916784661212,70.38002497185201,NaN,NaN,65.49626311770608,67.210559605038,-0.0622936903542155,0.9880654793660142,1.0503591697202297,5004287635,4984899422.2,75.67671664620929,75.44732910563134,NaN,NaN,35.36783883314002,34.13615944685791
2014-09-11T09:30:00-04:00,99.65,100.04,99.24,99.99,28761940,26545492.25,64.55294782786255,69.91405425764208,NaN,NaN,62.72587776359371,66.39741617818,-0.07212924865486237,0.9601976089016517,1.032326857556514,4975525695,4989350613.2,76.35999862641086,76.13537890546475,NaN,NaN,34.45066500921206,34.181088812908506
2014-09-12T09:30:00-04:00,99.9,99.93,99.17,99.48,30445999,26817462.1,58.76968285163045,68.98630486534766,NaN,NaN,34.042175875494856,60.212013539639386,-0.11647138710235505,0.8867376236785702,1.0032090107809253,4945079696,4981551451,72.51612784243991,76.3359872412148,NaN,NaN,31.846239474293554,33.847538907392085
2014-09-15T09:30:00-04:00,99.59,99.6,98.215,98.52,32972159,25705795.55,49.73690184082425,67.30057403693317,NaN,NaN,-91.74349829265412,25.41452100052154,-0.20856958018004312,0.7424970355558713,0.9510666157359144,4912107537,4962041616.6,63.85651641876207,75.7526543722288,NaN,NaN,26.411281099762146,32.78521636344495
2014-09-16T09:30:00-04:00,98.16,99.57,98.05,99.38,38166920,25667224.1,56.22745659473643,66.04624609003832,NaN,NaN,-74.53183628449243,-0.8022035640703848,-0.20914888323453895,0.6896305116927408,0.8987793949272798,4950274457,4957455004,61.98257264170238,74.88545903271488,NaN,NaN,23.948640638624138,31.522848402756264
2014-09-17T09:30:00-04:00,99.37,100,98.93,99.53,37206375,26459373.15,57.26403829171041,64.85916461822875,NaN,NaN,12.08881015040115,-11.483694157531373,-0.19716939971386171,0.6523176452849526,0.8494870449988143,4987480832,4954093643.4,60.579485503514285,73.75749187024174,NaN,NaN,22.36728393994028,30.21491062235398
2014-09-18T09:30:00-04:00,99.83,100.29,99.73,100.28,30196722,26797429.45,62.09716456301218,64.1283647150752,NaN,NaN,145.9400475312133,5.159139795992552,-0.13920630915749044,0.6754791585519513,0.8146854677094417,5017677554,4962524015.2,62.85081747259493,72.70392214089834,NaN,NaN,22.638545051467126,29.13257268365586
2014-09-19T09:30:00-04:00,100.46,100.5646,99.58,99.98,46923054,28176608.3,59.212516383690655,63.05151829867908,NaN,NaN,123.91442637462184,23.13358989581794,-0.12215137321951774,0.6619962511850446,0.7841476244045623,4970754500,4967658976,64.203734412315,71.67108059906683,NaN,NaN,21.91859251091311,28.10200408754975
2014-09-22T09:30:00-04:00,99.74,99.75,98.62,99.05,48658049,29374538.1,51.26251238560618,61.30320816513604,NaN,NaN,-114.85135125513828,18.51201930332111,-0.17155764451438926,0.5697005687615757,0.741258213275965,4922096451,4969656758.8,64.74172997428158,70.61015991543545,NaN,NaN,18.56361320594334,26.739376818748834
2014-09-23T09:30:00-04:00,98.67,99.22,98.58,98.78,33989583,29867781.35,49.19731882054409,60.0025002009434,NaN,NaN,-162.4119110950039,0.936004341218819,-0.21751988185994464,0.4693583609510341,0.6868782428109788,4888106868,4957223241,58.81692919307327,69.12275360981376,NaN,NaN,15.21190091738446,25.09259454712535
2014-09-24T09:30:00-04:00,98.87,99.8868,98.54,99.84,35958950,30660711.35,56.59109778583191,59.31538393634549,NaN,NaN,-27.98278491134618,-7.078314671130647,-0.17354078432944264,0.4699522623991754,0.6434930467286181,4924065818,4944540238.2,53.44411195046323,67.46824325905689,NaN,NaN,14.79686842913989,23.621776530270285
2014-09-25T09:30:00-04:00,99.53,99.65,97.7,97.74,68642547,33313042.45,43.18244437802341,57.43880046455532,NaN,NaN,-214.33601439753608,-79.13352705688052,-0.27676194062904313,0.29754062094231415,0.5743025615713573,4855423271,4912089381.6,42.697117221102104,65.01691325118806,NaN,NaN,9.057540824450928,21.541171429438947
2014-09-26T09:30:00-04:00,98.05,98.96,97.89,98.78,56109106,34940305.25,49.556827558611324,55.935052278946195,NaN,NaN,-150.02735578835626,-133.92188348947616,-0.26581607987510514,0.24203246172747583,0.507848541602581,4911532377,4900244957,39.56945579495319,62.298116096361376,NaN,NaN,7.01138442854684,19.465487572168648
2014-09-29T09:30:00-04:00,97.8,98.92,97.75,98.65,33342673,35711821.95,48.81952813479353,55.140151134499924,NaN,NaN,-137.93078252353263,-138.53776974315502,-0.25794716277413016,0.1854145881349183,0.44336175090904845,4878189704,4891463607.6,37.383063720042315,59.619884101276014,NaN,NaN,5.240084157470541,17.43328708435463
2014-09-30T09:30:00-04:00,98.92,99.3,98.32,98.79,41834324,36886942.05,49.687657216820845,54.01129247383561,NaN,NaN,-74.4720954580961,-120.94980661577347,-0.234600632989657,0.15011095967197718,0.3847115926616342,4920024028,4897847039.6,39.97931415895223,57.07006963790051,NaN,NaN,4.176943197104741,15.539523671890361
2014-10-01T09:30:00-04:00,98.54,98.61,96.9,97.21,58164861,38497652.3,41.195086476513005,52.34287380588207,NaN,NaN,-200.3476702977578,-155.42278369305578,-0.31200857856494185,-0.005299130544543118,0.30670944802039873,4861859167,4885405709.4,36.77859773245255,54.24282671690349,NaN,NaN,0.1472630563764552,13.340629298245517
2014-10-02T09:30:00-04:00,97.19,97.51,95.97,97.21,54501347,39989544.1,41.195086476513005,51.08754549337368,NaN,NaN,-224.03851082186173,-157.3632829779209,-0.346966585444238,-0.1269987837848987,0.21996780165933924,4861859167,4886692888.6,37.33755177040217,51.73007128318651,NaN,NaN,-2.8866336389848377,11.022448878641182
2014-10-03T09:30:00-04:00,97.76,98.57,97.44,98.17,41627772,40530644.35,47.51627596207419,50.928929359177246,NaN,NaN,-93.48070367528906,-146.0539525553075,-0.2914294723575742,-0.14431903878762853,0.1471104335699457,4903486939,4885083801,36.898369792019324,49.80448938127631,NaN,NaN,-3.3324906923017,8.971743225649341
2014-10-06T09:30:00-04:00,98.47,98.72,97.6587,97.96,36038687,41053518.6,46.34273145208611,50.222877563273656,NaN,NaN,-79.62995223423235,-134.39378649744742,-0.2560855584458266,-0.17299651448733755,0.08308904395848904,4867448252,4882935510.6,36.28472022132058,47.96892849410619,NaN,NaN,-4.057188157593151,7.110467313757557
2014-10-07T09:30:00-04:00,97.485,97.7799,96.56,96.57,45153968,41488757.55,39.40539110810054,48.94725990730152,NaN,NaN,-165.50765480705203,-152.60089836723859,-0.3099723094563114,-0.3043763428619002,0.005595966594411195,4822294284,4863389561.8,31.20051098881362,45.870430314484715,NaN,NaN,-7.067565781969056,5.085034014368041
2014-10-08T09:30:00-04:00,96.66,98.76,96.06,98.45,64931636,43181333.6,50.2524255013275,48.10120711718118,NaN,NaN,-83.12307292496551,-129.15597889268014,-0.20757202974524347,-0.25386907058714314,-0.04629704084189967,4887225920,4868462912.4,33.79362865652432,43.794916827622515,NaN,NaN,-5.7486283413707575,3.537367963548213
2014-10-09T09:30:00-04:00,98.33,98.57,96.71,96.86,62497086,44868090.9,43.20772702361802,46.958007877176,NaN,NaN,-104.69640035584018,-105.28755679947585,-0.23355625363571447,-0.3382423578865428,-0.1046861042508283,4824728834,4861036845.8,31.898429063959355,41.48739501702568,NaN,NaN,-7.3207204329313464,1.9862124783368476
2014-10-10T09:30:00-04:00,96.29,96.83,94.42,94.44,77579425,47224762.2,35.13457681441862,45.806012479234035,NaN,NaN,-236.10385414377657,-133.81218689317333,-0.3910836002323117,-0.5935406045412179,-0.20245700430890623,4747149409,4829769339.8,25.431344578447778,38.6795103458947,NaN,NaN,-11.985585800678557,-0.009758704379638772
2014-10-13T09:30:00-04:00,94.29,94.99,92.88,92.96,80835922,49617950.35,31.28471731342917,44.52654094301154,NaN,NaN,-265.7029903820091,-171.02679452272872,-0.5619218212955202,-0.9048592809283065,-0.3429374596327863,4666313487,4789542386.8,19.854317217156066,35.89646663332918,NaN,NaN,-17.19090801903528,-2.4642086064733015
2014-10-14T09:30:00-04:00,93.6,94.1699,92.71,92.97,71814456,51300327.15,31.339461792158346,42.72285265774914,NaN,NaN,-219.49827329017828,-181.82491821935395,-0.6357783661708536,-1.1376604173463534,-0.5018820511754998,4738127943,4772709118.6,18.068670127265733,33.36964936024365,NaN,NaN,-20.923235498646825,-5.101212448212376
2014-10-15T09:30:00-04:00,91.55,92.76,90.24,92.37,108847755,54882396.15,29.805147950241576,41.76733148433616,NaN,NaN,-223.74072435160778,-209.94844850468243,-0.6824567005619313,-1.354952926877914,-0.6724962263159826,4629280188,4721119972.2,13.932897176871379,31.31506221422717,NaN,NaN,-24.376335007020845,-7.854801385185015
2014-10-16T09:30:00-04:00,90.43,92.58,90.39,91.79,93165782,58030849.15,28.359752978740048,40.25325472863107,NaN,NaN,-184.0301294613348,-225.81519432578133,-0.7068214935861213,-1.5560230932986343,-0.849201599712513,4536114406,4663397086.6,10.920852466171667,29.268733405028488,NaN,NaN,-27.608940827170326,-10.67682130546863
2014-10-17T09:30:00-04:00,92.99,93.89,92.46,93,69546720,59162032.45,35.39827439544226,39.29459374724883,NaN,NaN,-110.67551233495415,-200.7295259640169,-0.6000787410626361,-1.5993000260408081,-0.999221284978172,4605661126,4635099430,9.802117971899705,27.298665851589735,NaN,NaN,-27.981084855662736,-13.14885895549636
2014-10-20T09:30:00-04:00,92.96,94.47,92.8,94.39,41479253,58803092.65,42.39936569203107,38.774001495478124,NaN,NaN,-75.0483408655671,-162.59859606072848,-0.4039010701149133,-1.5040976226218135,-1.1001965525069002,4647140379,4631264808.4,9.65773941465828,25.132839084140166,NaN,NaN,-25.89662093328699,-14.96996780946645
2014-10-21T09:30:00-04:00,95.54,96.87,95.32,96.87,53609758,59784101.4,52.32643048997534,39.569097496439724,NaN,NaN,2.953712662792072,-118.1081988701344,-0.09146945681965302,-1.2145333735314665,-1.1230639167118135,4700750137,4623789247.2,9.368046559932097,23.17494257181728,NaN,NaN,-20.345064289275285,-15.737838735153426
2014-10-22T09:30:00-04:00,97.16,97.3,96.305,96.37,39178048,59945056.3,50.43903309930472,40.22937939806771,NaN,NaN,17.619187880882457,-69.83621642363637,0.0874815331060399,-1.0137120003292637,-1.1011935334353036,4661572089,4630247627.4,11.828719749111485,21.352883141725094,NaN,NaN,-16.719341098262692,-15.87805335845475
2014-10-23T09:30:00-04:00,97.32,98.36,97.17,97.82,48123778,58919117.85,55.456756937869706,40.796556610624535,NaN,NaN,55.99838564604661,-21.830513402160072,0.2976336039934808,-0.7291515284434524,-1.0267851324369333,4709695867,4664963919.6,23.804321563177538,20.41759398252211,NaN,NaN,-11.934013816334401,-15.314619138151842
2014-10-24T09:30:00-04:00,97.965,98.69,97.64,98.62,43161724,58271748.75,57.9842269494989,41.62809200329688,NaN,NaN,74.3216099816696,15.168911061164673,0.474165540476547,-0.4340782068412494,-0.9082437473177964,4752857591,4694403212.6,32.212441828385224,20.126716954455297,NaN,NaN,-7.246208269419382,-14.161989014047204
2014-10-27T09:30:00-04:00,98.4,98.87,98.02,98.69,29545673,58081898.75,58.20768363727316,42.97111289823778,NaN,NaN,81.03431278404844,46.38544179108779,0.5727033184620828,-0.192364599240193,-0.7650679177022758,4782403264,4721455789.6,38.88624636759047,20.67569805293936,NaN,NaN,-3.535189559281044,-12.643874806223467
2014-10-28T09:30:00-04:00,99.1,100.2,99.08,100.18,34495077,57714936.4,62.74909403358208,43.863732079113106,NaN,NaN,120.13799757867264,69.82229877426391,0.7065061316636905,0.11806474687733726,-0.5884413847863532,4816898341,4744685430.4,43.9858861296174,21.403716443874576,NaN,NaN,1.170929253258359,-10.670331369154635
2014-10-29T09:30:00-04:00,99.84,100.12,99.1,99.81,40552803,56834333.5,60.97710413645685,45.13297330145873,NaN,NaN,108.14144602035549,87.92675040215852,0.7350870960883553,0.3304174853240909,-0.4046696107642644,4776345538,4767640120.2,48.554278709382686,22.59341998997624,NaN,NaN,4.410600462193746,-8.515912536104867
2014-10-30T09:30:00-04:00,99.37,100.26,99.14,100.02,35935794,55906055.85,61.63923419535305,47.02616311438262,NaN,NaN,102.5627378516107,97.23962084327134,0.7315576156320774,0.5097774087758324,-0.221780206856245,4812281332,4788157213.2,52.299024092122394,24.51253995523871,NaN,NaN,7.226079560386631,-6.2670565223203685
2014-10-31T09:30:00-04:00,101.67,101.75,101.07,101.4,54254141,56537374.3,65.75174230021548,49.488093470581646,NaN,NaN,137.25727268656544,109.82675338425051,0.7810862504865725,0.7545776062519707,-0.026508644234601864,4866535473,4810892789.6,56.111431256464684,27.102333815189326,NaN,NaN,10.986132392757234,-3.802315248737854
2014-11-03T09:30:00-05:00,101.53,101.9701,101.43,101.7,33480951,56409487.5,66.59027358312835,52.00600859850807,NaN,NaN,132.0273033330362,120.02535149404807,0.7905709807446601,0.9617050816962234,0.1711341009515632,4900016424,4834415421.6,59.70015491686505,30.076011300160708,NaN,NaN,14.304475032226929,-1.215630922885742
2014-11-04T09:30:00-05:00,101.36,101.6244,100.67,101.36,22773298,55290454,64.65810029859898,54.495505194819316,NaN,NaN,105.52906234876701,117.10356444806693,0.7318145861236636,1.0859023336061426,0.35408774748247906,4877243126,4846484378.6,61.442238244167655,33.46953566211044,NaN,NaN,16.516278357726833,1.317498974344626
2014-11-05T09:30:00-05:00,102.01,102.03,101.015,101.37,25818604,53334802.4,64.69055158918793,57.09056223842274,NaN,NaN,100.95098019150684,115.6654712822972,0.6540343126386476,1.1716306382807886,0.517596325642141,4903061730,4871827617,64.87583009323632,37.3234626354722,NaN,NaN,18.338763486732308,3.7491081904000088
2014-11-06T09:30:00-05:00,101.32,101.72,100.921,101.69,24671900,51443543.1,65.77357606201406,59.260226643177866,NaN,NaN,89.84277770787995,113.12147925355107,0.5867004101847819,1.2509718383731183,0.6642714281883364,4927733630,4894918076.6,67.69822866672023,41.458899113673674,NaN,NaN,20.179881881195914,6.096361574799424
2014-11-07T09:30:00-05:00,101.87,101.91,101.07,101.6,20931734,48611158.55,65.16815161363854,60.88656849472126,NaN,NaN,83.63762591321137,102.39754989888024,0.501941394066676,1.2916981707716815,0.7897567767050054,4906801896,4902971361.2,68.64457503339547,45.67224451501204,NaN,NaN,21.577417972172615,8.30794106013845
2014-11-10T09:30:00-05:00,101.65,102.09,101.38,101.96,20360007,45587362.8,66.49659226643146,61.89872290732527,NaN,NaN,83.31350952864364,92.65479113800173,0.4382777847155007,1.3376040075993814,0.8993262228838806,4927161903,4908400457,69.29760804173561,49.952927477998,NaN,NaN,23.132500007291735,10.425735195446062
2014-11-11T09:30:00-05:00,101.98,102.28,101.7,102.28,15454012,42769340.6,67.67667859114553,63.12998329959961,NaN,NaN,83.90891839127914,88.33076234650414,0.38762208896264805,1.3838538340871906,0.9962317451245426,4942615915,4921475014.8,70.87098377476869,54.17023205125923,NaN,NaN,24.784519742191886,12.476990130695466
2014-11-12T09:30:00-05:00,101.87,102.57,101.87,102.46,22050317,38429468.7,68.35195091213777,64.0510685834759,NaN,NaN,84.07843147322096,84.95625260284699,0.337957014640873,1.4186780134256338,1.0807209987847608,4964666232,4933795915.2,72.31100076418478,57.63499485133117,NaN,NaN,26.376741206839483,14.462668855858897
2014-11-13T09:30:00-05:00,102.65,103.28,102.42,102.9,28027776,35172568.4,70.0017236557739,64.90946120535268,NaN,NaN,97.21116798149994,86.42993065757096,0.3073386880987259,1.4648943589081682,1.1575556708094423,4992694008,4946787990.8,73.78280098873662,60.60430621992771,NaN,NaN,28.207020481220606,16.426147659481998
2014-11-14T09:30:00-05:00,102.87,103.22,102.53,103.22,19251346,32657799.7,71.1784526620294,65.83594470712099,NaN,NaN,97.34020360568206,89.17044619606511,0.2819049506432305,1.5099368591134805,1.22803190847025,5011945354,4967816682.4,76.00592651955189,63.2557119450678,NaN,NaN,30.108480055656656,18.380766573221234
2014-11-17T09:30:00-05:00,102.98,103.21,102.42,102.91,23361634,31751918.75,68.38007621542187,66.23815772010956,NaN,NaN,89.2489256054001,90.35752941141641,0.22020644511858878,1.503289964868486,1.2830835197498973,4988583720,4980101045.8,77.22109268818552,65.62965527067982,NaN,NaN,31.076125061735755,20.194389214437592
2014-11-18T09:30:00-05:00,103,103.82,102.991,103.68,26336812,30388271.45,71.38895711299529,66.981861504148,NaN,NaN,111.33457885042444,95.84266150324547,0.20743340503653118,1.5423752760455613,1.3349418710090302,5014920532,4994561969.2,78.59534944530297,67.77544603753127,NaN,NaN,32.75574256123256,21.98886826397973
2014-11-19T09:30:00-05:00,103.57,103.57,102.73,103.21,23760243,29617381.2,67.18636592604713,67.37808519919759,NaN,NaN,97.72449098923201,98.57187340644768,0.14638879689420525,1.5179278671267866,1.3715390702325814,4991160289,4999860780.6,79.0930776141794,69.68930700339249,NaN,NaN,33.10976614032204,23.57756796060006
2014-11-20T09:30:00-05:00,102.77,103.76,102.69,103.67,22874018,28354893.2,69.10344830899797,67.61749277125348,NaN,NaN,106.72646227672455,100.47493226549258,0.11730534196854414,1.5181707476932615,1.4008654057247174,5014034307,5004128840.4,79.50644676206275,71.36037953950662,NaN,NaN,33.93079900377366,25.056600966767718
2014-11-21T09:30:00-05:00,104.59,104.69,103.54,103.87,34049128,27899263.4,69.92613143621642,67.85576833218833,NaN,NaN,134.35373389642155,107.87763832364048,0.09291916625861485,1.517014363547986,1.4240951972893712,5048083435,5011356456.6,80.21967835505363,72.82605978509152,NaN,NaN,34.84612984786807,26.455105092639197
2014-11-24T09:30:00-05:00,104.15,104.73,104.06,104.68,17928289,27318394.2,73.0553431197409,68.45557139084133,NaN,NaN,147.78260015360704,119.58437323328187,0.11147251113989443,1.5634358362142393,1.451963325074345,5066011724,5026842057.4,81.69002181771985,74.27233004034527,NaN,NaN,36.549110169859695,27.89710581795641
2014-11-25T09:30:00-05:00,104.84,105.15,104.57,104.84,17525991,26469939.9,73.63882852705613,69.09473402926048,NaN,NaN,150.76581582654194,127.47062062850537,0.11423136877143669,1.5947525360386408,1.480521167267204,5083537715,5040565494,82.90292664587446,75.55997979410513,NaN,NaN,38.13923549008763,29.360267199689442
2014-11-26T09:30:00-05:00,104.94,105.58,104.834,105.52,18973804,25390989.95,76.01596046120531,69.826332914917,NaN,NaN,158.93279595594487,139.71228162184792,0.1398707526981824,1.655359608139932,1.5154888554417496,5102511519,5062835740,84.67684603555387,76.77273817759324,NaN,NaN,40.23304413933781,30.913521048210637
2014-11-28T09:30:00-05:00,105.795,106.245,105.73,106.01,17360420,24462221.25,77.58454520186814,70.71321817121911,NaN,NaN,179.259581993661,154.21890556523525,0.16606299850110084,1.7230676035681256,1.5570046050670248,5119871939,5084003266.4,86.14798849008324,78.02298199592806,NaN,NaN,42.49919299915152,32.56861704120219
2014-12-01T09:30:00-05:00,105.72,105.9199,104.42,104.81,35969494,23547988.9,66.17094085813267,70.68995735634063,NaN,NaN,109.53246200298541,149.25465118654802,0.08299838359514267,1.660752584560953,1.5777542009658103,5083902445,5091167068.4,86.61630632618689,79.26003187338888,NaN,NaN,41.08066427540793,33.784623788945865
2014-12-02T09:30:00-05:00,104.92,105.4168,104.7,105.23,26031291,23175505.9,67.94820771535394,70.7093522937841,NaN,NaN,100.16973046067851,139.7320772479623,0.03900351470469121,1.6265085943466744,1.5875050796419832,5109933736,5099951470.8,87.18829586608659,80.42555416562587,NaN,NaN,40.42423363658521,34.73313948146577
2014-12-03T09:30:00-05:00,105.39,105.565,104.7626,105.42,32974322,23685557.1,68.74809395687296,70.73764822555088,NaN,NaN,95.99237985339136,128.7773900533322,0.007036129857626472,1.5963002419640162,1.5892641121063897,5142908058,5111825539.4,87.93867237302703,81.5418164234003,NaN,NaN,40.115150591319285,35.50199821144484
2014-12-04T09:30:00-05:00,105.32,105.78,104.93,105.37,31008791,23945066.45,68.26528325222637,70.61361676815464,NaN,NaN,90.63827816858237,115.11848649585968,-0.031049153944296304,1.5504526696760195,1.5815018236203158,5111899267,5113703089,88.05777847164927,82.56145767217978,NaN,NaN,39.72639352337708,36.10548325600659
2014-12-05T09:30:00-05:00,105.54,105.7,105.145,105.38,25622236,23992583.25,68.31321343732985,70.40895682353325,NaN,NaN,84.24782517024079,96.11613513117564,-0.06707269764639356,1.4976609515623238,1.5647336492087174,5137521503,5117233001.8,88.29186892477878,83.43902498683885,NaN,NaN,39.41703605536414,36.57856222734338
2014-12-08T09:30:00-05:00,105.11,105.57,104.075,104.63,32685756,24580284.35,60.885817614673726,69.87365263776552,NaN,NaN,43.02086815127543,82.81381636083364,-0.14826412116558307,1.3794034977517384,1.5276676189173215,5104835747,5121419662.2,88.5778484483535,84.25022182685085,NaN,NaN,37.02634292132622,36.64253089791236
2014-12-09T09:30:00-05:00,103.41,105.04,103.0401,104.96,46035139,25864040.95,62.80221803933413,69.260314132504,NaN,NaN,12.485456836154682,65.27696163592888,-0.1842487072775736,1.2973567348203545,1.481605442097928,5150870886,5129607092.2,89.13667212546136,85.00317344686216,NaN,NaN,35.50044537446029,36.479375823133495
2014-12-10T09:30:00-05:00,104.77,105.03,103.12,103.31,39330116,27057846.15,49.69240004265082,68.01074514083284,NaN,NaN,-30.301789266979288,40.01812781185476,-0.315951186324422,1.0866664591924007,1.4026176455168227,5111540770,5123333634.6,85.67776378305665,85.47350817321053,NaN,NaN,29.677301873680996,35.50765097321171
2014-12-11T09:30:00-05:00,103.61,105.04,103.59,103.8,47576022,28334131.4,52.8407662293879,66.84912499228925,NaN,NaN,-15.372238767117512,18.816024424714787,-0.3634538074856517,0.9483003861597581,1.3117541936454098,5159116792,5132777139.6,86.52539990096737,85.97486196884657,NaN,NaN,25.845535206931242,34.12734872088593
2014-12-12T09:30:00-05:00,102.81,103.99,102.66,102.67,46889391,29277212.15,45.73278408266613,65.12102875274995,NaN,NaN,-101.58337732513748,-18.350216074360826,-0.4582476536890767,0.7389446265340638,1.1971922802231405,5112227401,5127718319.2,83.66871429252512,86.22122167866597,NaN,NaN,20.021163646181837,32.11217942449963
2014-12-15T09:30:00-05:00,103.2,103.58,101.315,101.61,52968448,30963067.25,40.26161076403214,62.77861929877076,NaN,NaN,-165.91371592160843,-60.13713288893759,-0.5722017979443126,0.48194003279274966,1.0541418307370622,5059258953,5118602960.4,78.63112768111692,86.00272924033719,NaN,NaN,13.093355129552558,29.395204525221477
2014-12-16T09:30:00-05:00,100.97,102.47,99.96,99.98,65348626,33062416.85,33.6041045339517,59.91899615640615,NaN,NaN,-233.42407783998752,-109.31903982416603,-0.7272634860136431,0.14506247322000831,0.8723259592336514,4993910327,5087210848.6,64.27781938189838,84.67236443576746,NaN,NaN,4.453717539589936,25.832134955845543
2014-12-17T09:30:00-05:00,100.05,102.09,99.92,101.8,79715318,35731342.15,44.61623564211218,57.676158669328075,NaN,NaN,-171.2147012999337,-137.5016222307569,-0.6781334754784571,0.024659114885579925,0.7027925903640371,5073625645,5079627823.6,61.36390275873574,83.00715420170903,NaN,NaN,1.3329265751342887,22.332248044315364
2014-12-18T09:30:00-05:00,103.26,104.26,102.98,104.25,49840942,37035377.1,55.35157273852786,56.088089207660914,NaN,NaN,-18.528288313692983,-138.13283214007203,-0.461844808876239,0.1254865792687383,0.5873313881449773,5123466587,5072497782.6,58.67068560405102,81.04448970984959,NaN,NaN,3.194213691243475,19.598243136733664
2014-12-19T09:30:00-05:00,103.97,104.74,103.71,104.32,51419912,38462671.8,55.6162846647585,55.33418519384848,NaN,NaN,5.7796902149005405,-116.6602186320644,-0.30295594650088087,0.20863645501887618,0.511592401519757,5174886499,5085029602.2,61.840729346735955,79.2748056398888,NaN,NaN,4.617235373999173,17.45809917062874
2014-12-22T09:30:00-05:00,104.15,104.61,104.0999,104.58,33869167,38453673.75,56.644470990747436,54.526775427805156,NaN,NaN,15.831403636377726,-80.31119472046717,-0.17555753210393216,0.29214548638984184,0.467703018493774,5208755666,5114928944.8,68.12300051026759,77.91299882875887,NaN,NaN,6.054906493114966,15.829071645269629
2014-12-23T09:30:00-05:00,104.96,104.97,104.09,104.21,30156929,39065105.75,54.70238916456753,53.523510799783345,NaN,NaN,15.651104587680232,-30.49615823493362,-0.11438015290489872,0.3247278273626506,0.4391079802675493,5178598737,5151866626.8,73.85058248782859,76.90670669410186,NaN,NaN,6.542783247742795,14.50245901705151
2014-12-24T09:30:00-05:00,104.34,104.7,104.2699,104.3,14291333,38903372.85,55.10559580876458,52.583533125250355,NaN,NaN,17.317457053771072,7.210273435807328,-0.06829903410039051,0.3537341876420612,0.4220332217424517,5192890070,5175719511.8,76.75512093187731,76.09937401268955,NaN,NaN,7.05117513817513,13.437989891497741
2014-12-26T09:30:00-05:00,104.6,105.26,104.57,105.04,13924332,38650899.25,58.385568608881904,51.874415637504065,NaN,NaN,54.726987626655635,21.86132862387705,0.007541541554497488,0.4314601486855736,0.4239186071310761,5206814402,5192389074.8,78.54838058354414,75.40341055974422,NaN,NaN,8.504720044005541,12.733237056141713
2014-12-29T09:30:00-05:00,104.94,105.25,104.875,105.02,17073772,38636566.85,58.26167640856622,51.68697697992496,NaN,NaN,66.02178323382175,33.909747227661285,0.049540466730134736,0.4858441905437445,0.43630372381360977,5189740630,5195359901,78.86137055718815,74.70937642466097,NaN,NaN,9.629122764022286,12.28979215726751
2014-12-30T09:30:00-05:00,104.72,104.96,104.175,104.32,18603989,37768291.6,53.946905725439265,51.05445467178961,NaN,NaN,29.351074137742625,36.61368132793426,0.024617523808773578,0.46707562857457674,0.44245810476580316,5171136641,5187836096,75.84327898765423,73.75984834338904,NaN,NaN,9.339111378370193,11.86826633171075
2014-12-31T09:30:00-05:00,104.5,104.91,103.1,103.25,24367121,37685083.1,48.084808052679016,50.939626672505916,NaN,NaN,-17.900493170726328,29.90336177625295,-0.06461289162151457,0.36169199023890997,0.42630488186042453,5146769520,5181470252.6,73.28762620149499,72.87483851613463,NaN,NaN,7.286821760341976,11.213774250086638
2015-01-02T09:30:00-05:00,103.76,104.2,102.44,102.94,31314599,37602096.95,46.508007217125495,50.48728674305859,NaN,NaN,-50.88233089317824,16.263404186863088,-0.1408236888032262,0.2502752708563918,0.391098959659618,5115454921,5165983222.8,67.34237707605695,71.5046226000696,NaN,NaN,5.131453069057418,10.34487122422532
2015-01-05T09:30:00-05:00,102.49,102.61,101.14,101.43,36521270,37877720.9,39.68205765008833,50.05509199787446,NaN,NaN,-132.2363205781606,-21.12925745410016,-0.28113917648672887,0.03967498905120692,0.3208141655379358,5078933651,5140407072.6,58.85156648543681,69.73196918527756,NaN,NaN,0.960441928217131,9.004238467652723
2015-01-06T09:30:00-05:00,101.58,101.75,99.62,100.07,66205451,39906881.65,34.736970714526706,49.66047485148122,NaN,NaN,-172.652882230639,-68.86419054699232,-0.4440652499133279,-0.2342673968537241,0.2097978530596038,5012728200,5105004586.6,49.540410883805315,67.65406084261245,NaN,NaN,-4.36317993022754,7.094607267955542
2015-01-07T09:30:00-05:00,100.73,101.6,100.485,101.36,37577361,40151461.9,42.10657962290621,50.26779450069226,NaN,NaN,-114.91358498837356,-97.71712237221554,-0.4424934228057441,-0.34331892544757636,0.09917449735816775,5050305561,5080838370.6,44.37884868707828,66.23270579298244,NaN,NaN,-6.405132798166006,5.166072972795321
2015-01-08T09:30:00-05:00,102.22,103.5,102.111,103.3,40212640,39860336.95,51.05736708416637,50.72787531798184,NaN,NaN,-13.82364456227804,-96.90175265052588,-0.29540988277226826,-0.27008785610716757,0.02532202666510068,5090518201,5069588106.8,42.17580226002497,64.86212718593167,NaN,NaN,-4.945416777386398,3.721574437055076
2015-01-09T09:30:00-05:00,103.62,103.65,102.02,102.62,41410071,39964334.7,48.24191315712368,50.220042490738685,NaN,NaN,-22.380887754612502,-91.20146402281274,-0.23136176264392197,-0.2638801766398018,-0.03251841399587982,5049108130,5056318748.6,39.674148896516,63.50523170682203,NaN,NaN,-4.769384591907934,2.5085802900603604
2015-01-12T09:30:00-05:00,102.82,102.93,101.285,101.55,34129751,39292021.15,44.119251504821534,49.39882583645747,NaN,NaN,-61.73983577712767,-77.10216706260616,-0.24707771197250356,-0.34136555396150925,-0.0942878419890057,5014978379,5043527694.2,37.37290949834765,61.757530289080016,NaN,NaN,-6.042313666921636,1.2870240104915038
2015-01-13T09:30:00-05:00,102.54,103.62,100.7,101.52,56162334,39755668.3,44.005702250272925,48.496056640709284,NaN,NaN,-54.85475111040078,-53.54254083855851,-0.24503086826204767,-0.4005764273165653,-0.1555455590545176,4958816045,5032745263.2,35.503434856146754,59.42756131378567,NaN,NaN,-7.057258177663546,0.09498369789792527
2015-01-14T09:30:00-05:00,100.5,101.4829,100.07,100.96,51354217,39674956.75,41.84094552586171,47.577382095087444,NaN,NaN,-103.47200990534094,-51.25422582195198,-0.2652228358366974,-0.4870741038503894,-0.22185126801369198,4907461828,5004176516.6,31.068903068768194,56.37172706956708,NaN,NaN,-8.562537962913794,-1.1418051107894631
2015-01-15T09:30:00-05:00,101.43,101.59,99.525,99.65,51005416,38957796.25,37.22743791418803,46.30037081690341,NaN,NaN,-128.0247925506062,-74.09445541961762,-0.3455539145528989,-0.6537936612048156,-0.3082397466519167,4856456412,4957364158.8,25.457757263673315,52.70762966469537,NaN,NaN,-11.3602489750958,-2.6015828056903683
2015-01-16T09:30:00-05:00,99.52,100.95,99.36,100.82,35362210,36740140.85,43.24641012483423,45.21900235375714,NaN,NaN,-115.86798628924538,-92.79187512654418,-0.3003125416198521,-0.6836304236767319,-0.3833178820568798,4891818622,4925906257.2,22.515017606834277,48.70524659493037,NaN,NaN,-11.786110526692772,-3.9136581944049973
2015-01-20T09:30:00-05:00,101.43,101.88,100.29,101.62,30964056,35796296.55,46.98928214267863,44.41383133476517,NaN,NaN,-66.91989290685687,-93.82788655249003,-0.2016644788459126,-0.6353984806142705,-0.4337340017683579,4922782678,4907467117,20.98388370843894,44.57114039144829,NaN,NaN,-10.931147955278078,-4.91615673167258
2015-01-21T09:30:00-05:00,101.32,102.619,100.9648,102.14,40128772,35231739.55,49.328514260773375,44.083946230146175,NaN,NaN,-33.008315344802696,-89.45859939937041,-0.09212274372713358,-0.5488874314272749,-0.45676468770014134,4962911450,4908286198,21.24010597729334,40.67091374785108,NaN,NaN,-9.500699875516199,-5.571091466507383
2015-01-22T09:30:00-05:00,102.54,104.14,101.64,104.03,40887168,35582639.6,56.79163708116307,44.70586258932361,NaN,NaN,34.640262293386485,-61.836144959624924,0.10614474120548989,-0.324083761193279,-0.43022850239876886,5003798618,4927553556,27.218724629261985,37.38027792126301,NaN,NaN,-5.700328290273156,-5.589553869902494
2015-01-23T09:30:00-05:00,104.02,104.58,103.72,104.26,34782992,35813942.75,57.60986161987824,45.498852189520235,NaN,NaN,80.47929193355343,-20.135328062793,0.24345105076295648,-0.1259146889450733,-0.36936573970802977,5038581610,4963978595.6,36.96113975656415,35.210189541299236,NaN,NaN,-2.441146786079586,-5.139781429356364
2015-01-26T09:30:00-05:00,104.14,104.33,103.61,104.14,19960870,36097419.6,57.00334442451087,46.73608695912185,NaN,NaN,74.69460768395061,17.9771907318462,0.31245919644862824,0.021208255852755542,-0.2912509405958727,5018620740,4989339019.2,42.71102498232361,34.057293719648285,NaN,NaN,-0.012126335190314039,-4.407259273046928
2015-01-27T09:30:00-05:00,102.5,102.56,101.1,101.44,45253205,37663863.25,45.41730827870584,47.49896821370607,NaN,NaN,-35.56270337045932,24.24862863912571,0.1696801247850997,-0.0791507846144981,-0.2488309093995978,4973367535,4999455990.6,44.87129154555325,33.72378519548742,NaN,NaN,-1.561605957856178,-4.000737370876821
2015-01-28T09:30:00-05:00,103.07,103.18,100.9,100.92,43591675,38989758.4,43.58014613693426,47.60422296470808,NaN,NaN,-31.678007096223578,24.514690288841535,0.04037741495049868,-0.19835914071147442,-0.2387365556619731,4929775860,4992828872.6,43.70860642116822,33.675910747922416,NaN,NaN,-3.3973447169845366,-3.9145384203207803
2015-01-29T09:30:00-05:00,100.84,102.0779,99.96,101.89,46539734,40386545.65,47.82029215763802,47.37300332709891,NaN,NaN,-48.794675412654904,7.827702747633252,0.021295980134027864,-0.21211658049443827,-0.23341256062846613,4976315594,4987332267.8,42.71987572133881,33.71477313801627,NaN,NaN,-3.566350859509567,-3.8647973402048925
2015-01-30T09:30:00-05:00,101.8,102.58,100.96,101.1,42927638,41314571.5,44.863108750066466,47.131660155166244,NaN,NaN,-28.38174425409275,-13.944504489895985,-0.04006824066391321,-0.28349786145835765,-0.24342962079444444,4933387956,4966293537,39.07625086985655,33.672066136112015,NaN,NaN,-4.644247074552191,-3.9761473022545064
2015-02-02T09:30:00-05:00,101.33,102.07,99.75,101.98,43624654,41930074.25,48.67087402595609,47.456776049533005,NaN,NaN,-44.77631368522909,-37.83868876373192,-0.0180508565066132,-0.26599319142771094,-0.24794233492109774,4977012610,4957971911,37.70634279244446,33.695882799976076,NaN,NaN,-4.349166282483714,-4.029435728001536
2015-02-03T09:30:00-05:00,102.35,103.03,101.68,102.96,30750360,41641528.75,52.596979776050006,48.07043872994565,NaN,NaN,52.49763024540476,-20.22662204055911,0.06149722254203213,-0.17107080674355757,-0.2325680292855897,5007762970,4964850998,39.59165284170562,33.98789837037314,NaN,NaN,-2.8606192383291895,-3.862461943762629
2015-02-04T09:30:00-05:00,102.54,103.55,102.31,102.87,34073211,40034916.75,52.20207985422426,48.81051975340012,NaN,NaN,70.03544510737059,0.11606840015972467,0.10450931994842144,-0.10193137935006291,-0.20644069929848435,4973689759,4973633777.8,42.004976435080295,34.76904646796686,NaN,NaN,-1.7900958334328008,-3.5664096422869394
2015-02-05T09:30:00-05:00,103.13,103.83,102.87,103.76,23605516,39336324.5,55.74091893054882,50.13291125456875,NaN,NaN,98.76755541988503,29.62851456666771,0.1846697193219496,0.024396449853952618,-0.16027326946799697,4997295275,4977829714,43.173008684324834,36.03442156944197,NaN,NaN,0.19160904429036332,-3.029549829918753
2015-02-06T09:30:00-05:00,103.92,104.17,102.76,103.13,34169256,39034155.3,52.76297630187389,50.81266598150015,NaN,NaN,85.72276444825889,52.44941630713804,0.18648806544431734,0.07283681233739969,-0.11365125310691764,4963126019,4983777326.6,44.867995663566106,37.631062859208534,NaN,NaN,0.9879592926733228,-2.4556199552627422
2015-02-09T09:30:00-05:00,102.73,103.285,102.55,102.8,22604655,38093884.5,51.21937701889733,51.114815615515774,NaN,NaN,51.72730626504303,71.75014029719246,0.15782806473972216,0.0836338278177351,-0.07419423692198708,4940521364,4976479077.4,43.16654375152383,39.215538576571745,NaN,NaN,1.2081207210069056,-1.9322284300813641
2015-02-10T09:30:00-05:00,103.37,104.54,103.21,104.4,23686531,37571723.5,57.6834501383922,51.711596749631404,NaN,NaN,114.27691852527869,84.10599795316725,0.23437560038624158,0.2187752635608149,-0.015600336825426685,4964207895,4967768062.4,41.16024449417348,40.63840561349175,NaN,NaN,3.3881601939062893,-1.1721729123688422
2015-02-11T09:30:00-05:00,104.52,105.02,104.32,104.78,20303617,35778787.65,59.070659349150446,51.87438405448764,NaN,NaN,133.29956376201235,96.7588216840956,0.29446069404142283,0.35247553072635185,0.05801483668492902,4984511512,4969932413,41.88300616278486,41.68585429445768,NaN,NaN,5.594026287681393,-0.20557302664738009
2015-02-12T09:30:00-05:00,105.46,106.04,105.3,106,22520295,34337091.55,63.23742049852472,52.276352545819535,NaN,NaN,169.63496925781658,110.93230445168192,0.39401339021345927,0.5505315744517532,0.15651818423829386,5007031807,4971879719.4,42.56657200460908,42.086242312175166,NaN,NaN,8.822925026662213,1.0842124095397048
2015-02-13T09:30:00-05:00,106.3,106.93,106.101,106.91,29030249,33238333.2,66.01648365712168,52.92014820529174,NaN,NaN,189.77383745935137,131.74251905390042,0.49240338619168844,0.7720224169779044,0.27961903078621597,5036062056,4986466926.8,47.54389475080945,42.43144729563845,NaN,NaN,12.438685404609432,2.7062799802639512
2015-02-17T09:30:00-05:00,106.91,107.08,106.6432,107.01,17675344,32353989.9,66.31780927926786,54.41304113390331,NaN,NaN,177.02732787652783,156.80252337619737,0.5320922634303362,0.9447343600741362,0.4126420966438,5053737400,5009110134,54.18164654323616,43.096472652615795,NaN,NaN,15.440088487044768,4.525395481232639
2015-02-18T09:30:00-05:00,106.88,107.2199,106.74,107.16,15149619,31563268.05,66.79343749517216,56.07113337377745,NaN,NaN,156.03849419638917,165.15483851041947,0.5348859974363964,1.0812495934392956,0.5463635960028992,5068887019,5030045958.8,59.30865286091135,44.21076168402602,NaN,NaN,18.045198921622788,6.456795972716946
2015-02-19T09:30:00-05:00,107.09,107.76,107.06,107.69,19828113,30548235.1,68.48672281517129,57.547306992172686,NaN,NaN,149.89990783542635,168.47490732510227,0.5374397171551826,1.2181632424468773,0.6807235252916948,5088715132,5050886682.8,63.66710058335452,45.70699203131285,NaN,NaN,20.758681097632753,8.49992241913349
2015-02-20T09:30:00-05:00,107.62,108.47,107.28,108.41,28336710,29920712.2,70.67445251126848,59.39097440368711,NaN,NaN,145.61034244196136,163.66998196193123,0.5506095526581605,1.3689854661143954,0.818375913456235,5117051842,5072890689.8,67.61160831466759,47.74523184879936,NaN,NaN,23.751800350592195,10.67876212362759
2015-02-23T09:30:00-05:00,108.35,108.55,108.11,108.52,17867968,29074961,71.00562836590804,60.986313999397964,NaN,NaN,132.04517923531586,152.1242503171241,0.5295592538509949,1.4803249807699785,0.9507657269189836,5134919810,5092662240.6,70.69069502250113,50.10125700808912,NaN,NaN,26.327521664600965,12.9142992009095
2015-02-24T09:30:00-05:00,108.38,108.73,108.05,108.6,19745011,29064168.05,71.2598332007826,62.319374958307435,NaN,NaN,114.98439694010034,139.71566412983861,0.48504242668696285,1.5570687602776871,1.0720263335907243,5154664821,5112847724.8,73.46430923241661,52.520732464568475,NaN,NaN,28.554450132086846,15.148606476791977
2015-02-25T09:30:00-05:00,108.44,108.86,108.09,108.33,19472341,27775124.85,69.05918797863873,63.523454110051325,NaN,NaN,101.15903097634406,128.7397714858296,0.40470918767096276,1.5779128181794277,1.173203630508465,5135192480,5126108817,75.12944919478443,54.88676623311877,NaN,NaN,29.911933817271013,17.257653239717555
2015-02-26T09:30:00-05:00,108.44,108.94,108.135,108.88,22255476,26708314.9,71.02233247040606,64.61498364861255,NaN,NaN,96.37333206886234,118.03445633251681,0.35754618694646956,1.620136364191552,1.2625901772450825,5157447956,5139855381.8,76.75762193720345,57.28566717975296,NaN,NaN,31.631630346911503,19.311078540745264
2015-02-27T09:30:00-05:00,108.84,108.91,108.23,108.4,27757584,25769207.4,67.02543132362177,65.63373043588027,NaN,NaN,84.75654398112438,105.86369664034942,0.26709889758355243,1.596463799224523,1.3293649016409705,5129690372,5142383087.8,77.05507522490083,59.58474429127687,NaN,NaN,32.08786185047443,21.136333299278004
2015-03-02T09:30:00-05:00,108.61,109.42,108.59,109.38,22988645,24772257.75,70.65631733827229,67.02208331583562,NaN,NaN,94.91507073825379,98.43767494093699,0.24682826778117795,1.637900236367443,1.3910719685862651,5152679017,5145934929.2,77.49099463386872,62.03649078287293,NaN,NaN,33.513690266722904,22.904527151770132
2015-03-03T09:30:00-05:00,109.05,109.16,108.18,108.87,20788924,23630471.25,66.54948498758363,67.65537151934929,NaN,NaN,77.97109056380039,91.03501366567698,0.1759547379146018,1.6110153909795173,1.4350606530649155,5131890093,5141379983.6,75.5097552906552,64.49002726833591,NaN,NaN,33.58897756343097,24.430877210578824
2015-03-04T09:30:00-05:00,108.51,108.67,107.86,108.45,21007420,23143324.25,63.2871017166315,67.95654597416936,NaN,NaN,60.593644320762415,82.92193633456066,0.08242215148130216,1.5380883424165432,1.455666190935241,5110882673,5136518022.2,73.35388887685511,66.73794746219808,NaN,NaN,32.735541634122626,25.617257842513652
2015-03-05T09:30:00-05:00,108.73,108.965,108.19,108.64,15381039,22208715.65,64.14344488853237,68.02126200202706,NaN,NaN,66.22640258798144,76.89255043838448,0.018331358280231802,1.4785803887855309,1.460249030505299,5126263712,5130281173.4,70.57046002456428,68.73822517790916,NaN,NaN,32.24599608542527,26.564220448643884
2015-03-06T09:30:00-05:00,108.5,108.71,107.14,107.41,30990366,22577958.15,55.17161449416006,67.24662849038694,NaN,NaN,28.473200229573642,65.63588168807433,-0.11460900751522174,1.3169877711112719,1.4315967786264936,5095273346,5123397768.2,67.52505720269897,70.16545106732984,NaN,NaN,29.111739419235672,26.928151730156998
2015-03-09T09:30:00-04:00,107.63,107.9857,107.19,107.72,26237101,22181350.4,56.81122585060411,66.56758681691096,NaN,NaN,16.335682254969743,49.92000399141752,-0.18519357853609342,1.2001048054563768,1.3852983839924702,5121510447,5117164054.2,64.79789531962145,70.92375455135736,NaN,NaN,26.954163573020747,26.93186770770896
2015-03-10T09:30:00-04:00,106.95,106.98,105.72,105.72,34234496,22762842.45,45.299631570704605,65.03231496516328,NaN,NaN,-80.51901259436391,18.221983359784666,-0.35999129536886,0.9353092647813952,1.2953005601502552,5087275951,5108241225.8,61.00022100681699,71.04458084749346,NaN,NaN,20.98192593550386,26.081876025965375
2015-03-11T09:30:00-04:00,105.875,106.01,105.07,105.11,25459733,22851502.55,42.47281954946875,63.17417901761309,NaN,NaN,-140.15187429991192,-21.92712036435021,-0.5014175622090442,0.66852860738895,1.1699461695979942,5061816218,5098427934.8,57.040735532018864,70.57126905811235,NaN,NaN,15.133886841958692,24.517877571107277
2015-03-12T09:30:00-04:00,105.03,105.92,104.96,105.8,21473171,22909980.25,46.53688295068656,61.45006690614296,NaN,NaN,-139.2547928581455,-63.023359453575594,-0.5304076570891216,0.5069365982365923,1.037344255325714,5083289389,5089833070.2,53.74998658416614,69.5811532202194,NaN,NaN,11.553781715187974,22.66586387740452
2015-03-13T09:30:00-04:00,105.7,106.12,104.68,105.34,42021103,23885020.65,44.29046259162933,59.54184077940876,NaN,NaN,-146.63597786840458,-98.04519507317124,-0.5595866360071173,0.3378609603168172,0.8974475963239346,5041268286,5079032058.2,49.85730794753413,68.09305414343604,NaN,NaN,7.906742197115577,20.557417923077526
2015-03-16T09:30:00-04:00,105.73,106.74,105.62,106.7,25674085,23717212.45,51.71207158653729,58.14557209267695,NaN,NaN,-78.85867755919617,-117.08406703600443,-0.46993083420559767,0.3100340535669375,0.7799648877725351,5066942371,5068118443,46.215269289515675,66.14669414751454,NaN,NaN,7.102557502188872,18.63529500580772
2015-03-17T09:30:00-04:00,106.405,107.04,106.16,106.87,19603813,23813635.9,52.562783301961645,56.9672574729143,NaN,NaN,-55.180954254908585,-112.01645536811334,-0.3853635518556182,0.29826044795301243,0.6836239998086306,5086546184,5067972489.6,46.16669853975962,64.0779262435842,NaN,NaN,6.732273817673698,16.93486340750286
2015-03-18T09:30:00-04:00,106.58,108.41,106.03,107.92,40622188,25087264.35,57.538588067912166,56.00413287273617,NaN,NaN,-6.961851763309615,-85.37845086079288,-0.2513809459531894,0.36939781736714394,0.6207787633203333,5127168372,5081042920.4,51.12089198700531,62.24673124714148,NaN,NaN,8.016600847455367,15.660825898924646
2015-03-19T09:30:00-04:00,108.03,108.38,107.87,108.08,31314035,25661560.45,58.257113226132006,55.377824437201184,NaN,NaN,34.31691140676798,-50.664110007810194,-0.1496741349519216,0.4336860946304313,0.5833602295823529,5158482407,5096081524,56.12411776104751,60.75166285686624,NaN,NaN,9.264060940454637,14.74700233342893
2015-03-20T09:30:00-04:00,108.72,109.07,108.51,108.53,31761404,25832795.15,60.29227870389971,54.63753596331743,NaN,NaN,69.62005683565575,-7.412903066998135,-0.05468054586721027,0.51500954724834,0.5696900931155503,5190243811,5125876629,63.98887928254321,59.78722604605728,NaN,NaN,10.92007660925364,14.200298658546746
2015-03-23T09:30:00-04:00,108.47,108.77,108.28,108.32,17268507,25802822.1,58.850304711518795,54.08759451502709,NaN,NaN,53.44400572736579,19.047633590314256,-0.010869425227255536,0.5561033115814809,0.5669727368087364,5172975304,5147083215.6,68.33894318410981,59.27502518130404,NaN,NaN,11.871560995562273,13.867621849548964
2015-03-24T09:30:00-04:00,108.31,108.81,107.91,107.93,22445280,25937835.55,56.16383186292979,53.578789525476964,NaN,NaN,39.148669547546845,37.913558350805346,-0.012897541446113658,0.5508508100010943,0.5637483514472079,5150530024,5159879983.6,70.64345111911268,59.08142248432244,NaN,NaN,11.918848170276565,13.589225609652907
2015-03-25T09:30:00-04:00,108.1,108.2,105.42,105.46,41581435,27043290.25,42.82897284830995,52.05632723688965,NaN,NaN,-71.32291823267322,25.041345056932624,-0.17626183070586188,0.3434210630648806,0.5196828937707425,5108948589,5156236027,69.10105799559216,58.976465196538705,NaN,NaN,7.4434160218504015,12.711252811395406
2015-03-26T09:30:00-04:00,104.59,105.7,104.24,105.1,47846276,28322830.25,41.2902191263972,51.06479899633516,NaN,NaN,-131.60501737210961,-8.143040698842901,-0.29712767461532524,0.14827330050158594,0.4454009751169112,5061102313,5136760008.2,61.38655255415254,58.538000578785386,NaN,NaN,3.3744808268599655,11.377428242176057
2015-03-27T09:30:00-04:00,105.08,105.77,104.92,105.52,33878385,28628870.3,43.825924908130084,50.137277500444156,NaN,NaN,-96.26503830581025,-41.3200597271361,-0.33456533720088844,0.027194303615800663,0.3617596408166891,5094980698,5117707385.6,54.92638645680244,57.83289280286975,NaN,NaN,0.8495571199938436,9.873446653292884
2015-03-30T09:30:00-04:00,106.16,106.82,106.16,106.73,30570196,29007947.85,50.463837429537364,50.50614934750364,NaN,NaN,-27.25914434734642,-57.46068974207854,-0.26657079137451334,0.028546151598547453,0.2951169429730608,5125550894,5108222503.6,51.992949584434534,57.18951627269957,NaN,NaN,0.7927836148161777,8.57620907636764
2015-03-31T09:30:00-04:00,106.43,106.65,105.57,105.6,30488101,29492906.7,45.10359414490127,50.69406181860597,NaN,NaN,-57.70050445130503,-76.83052454184892,-0.2847835309027752,-0.060862470655408174,0.223921060247367,5095062793,5097129057.4,48.71588113225414,56.59488381557352,NaN,NaN,-1.0389297364886318,7.202617817388172
2015-04-01T09:30:00-04:00,105.6,105.62,104.37,105.05,32970452,30091058.3,42.72481901176747,50.42177153725459,NaN,NaN,-104.22777145945453,-83.41149518720519,-0.31841126059051994,-0.17409301549078293,0.144318245099737,5062092341,5087757807.8,46.07400339922009,56.046599302363084,NaN,NaN,-3.2980288196275,5.702525440671648
2015-04-02T09:30:00-04:00,105.15,105.46,104.78,105.12,19164241,30280218.4,43.13587467541896,50.339300971811,NaN,NaN,-91.49729712966253,-75.38995113871576,-0.31964531107700855,-0.2552383937465237,0.06440691733048487,5081256582,5091788661.6,47.39545020353638,55.870752320648954,NaN,NaN,-4.959238646021838,4.179416285429721
2015-04-06T09:30:00-04:00,104.5,106.27,104.34,105.98,24451142,29953257.2,48.06717246796456,50.07895103477009,NaN,NaN,-60.178323547199064,-68.17260818699353,-0.24936644930684046,-0.2473011443030657,0.002065305003774748,5105707724,5093934066.8,48.12409216962968,56.00709681208567,NaN,NaN,-4.870283484342125,2.886602032605172
2015-04-07T09:30:00-04:00,105.92,106.7,105.8,105.8,19379381,29610371.2,47.14561398833154,49.6920103695108,NaN,NaN,-19.18891152552912,-66.55856162263008,-0.20375082742457917,-0.25262322927694925,-0.04887240185237006,5086328343,5086089556.6,45.63505904730043,55.96912256262431,NaN,NaN,-5.068049860649968,1.7502231907115804
2015-04-08T09:30:00-04:00,105.84,106.79,105.83,106.64,25866907,29191991.75,51.790727839978054,49.28144892465836,NaN,NaN,2.139450056125,-54.59057072114406,-0.1104264863287492,-0.18690550976330655,-0.07647902343455736,5112195250,5089516048,46.9263252444383,55.669510652440955,NaN,NaN,-3.836272970092945,0.9521523105966482
2015-04-09T09:30:00-04:00,106.59,107.35,106.23,107.31,23114727,29074741.45,55.17464170938688,49.06127238774799,NaN,NaN,35.064751256112075,-26.73206617803074,-0.002688779022424384,-0.07983999721258783,-0.07715121819016345,5135309977,5104159575.2,52.156329993594525,55.38609724048002,NaN,NaN,-1.7547259763125687,0.5654554124667601
2015-04-10T09:30:00-04:00,107.27,107.76,107.03,107.75,17164343,28859300.05,57.29463143977311,48.84715472602467,NaN,NaN,65.90986793689218,4.749366835280204,0.09376322393944461,0.040052811734142324,-0.05371041220530229,5152474320,5118403122.8,56.63285404857119,54.860666866624875,NaN,NaN,0.6220230858017018,0.5735365086574661
2015-04-13T09:30:00-04:00,107.83,108.38,107.36,107.48,17783465,27647418.15,55.55821440392895,48.61200541833968,NaN,NaN,72.64788296574761,31.314608137869534,0.1325611460197342,0.11199102031936548,-0.020570125700368737,5134690855,5124199749,58.34115910341244,54.146539432289345,NaN,NaN,2.101073457401299,0.7917560727637278
2015-04-14T09:30:00-04:00,107.37,107.68,106.56,107.17,23755747,27551501.25,53.551460837464006,48.425407487949265,NaN,NaN,28.193952601479168,40.79118096327119,0.13033391574378628,0.14234726897936412,0.012013353235577832,5110935108,5129121102,59.78939432140079,53.37124966102421,NaN,NaN,2.7865448148762484,1.0767258930655164
2015-04-15T09:30:00-04:00,107.45,108.07,107.321,107.84,21128576,27627739.4,57.15358016239736,49.4485937246698,NaN,NaN,62.774779447126015,52.91824684147139,0.1647539230351039,0.2179557570294577,0.053201833994353805,5132063684,5133094788.8,60.96925984001452,52.79040693562581,NaN,NaN,4.424417168388013,1.554967503825873
2015-04-16T09:30:00-04:00,107.55,107.88,107.4,107.69,16195279,26406393.95,56.104556441924295,50.50676067577887,NaN,NaN,55.922710275882444,57.08983864542546,0.1676333633526584,0.2627435381851768,0.09511017483251841,5115868405,5129206474.4,59.14061177622845,52.62998259434552,NaN,NaN,5.497265740592348,2.118152966221084
2015-04-17T09:30:00-04:00,106.66,106.95,105.55,106.01,46513964,27166390.4,45.935262957833935,50.65742767932915,NaN,NaN,-34.798550162934674,36.94815502546009,0.052569746329034106,0.16082235774381104,0.10825261141477693,5069354441,5112582498.6,51.96457297716086,52.41842448865684,NaN,NaN,3.3731603118357647,2.297439729880324
2015-04-20T09:30:00-04:00,106.54,107.79,106.5,107.6,28945909,27025615.65,54.3658061350329,50.93613972972169,NaN,NaN,49.38006541716183,32.29459151574294,0.0781774744367964,0.20597445446077245,0.12779698002397605,5098300350,5105304397.6,49.152586639551,52.215541421165156,NaN,NaN,4.269982013309816,2.5792314846559656
2015-04-21T09:30:00-04:00,108.22,108.41,107.93,108.06,22759772,27300178.9,56.480143604763555,51.748750405426144,NaN,NaN,113.65586070697513,49.38697313684212,0.11832073460202303,0.2756978982765048,0.1573771636744818,5121060122,5107329400.4,49.96388694950404,52.30468469382587,NaN,NaN,5.681876786556654,3.022466527784635
2015-04-22T09:30:00-04:00,108.34,108.83,107.64,108.65,21429190,27249374.4,59.097781962906,52.918247759078895,NaN,NaN,129.64382225604746,62.76078169862641,0.1734968280376624,0.3742481987215598,0.2007513706838974,5142489312,5109414526,50.83378986332954,52.64466944126225,NaN,NaN,7.68601905872906,3.688688317919553
2015-04-23T09:30:00-04:00,108.28,109.55,108.26,109.06,29473221,26643963.7,60.859611369147125,54.184228951488045,NaN,NaN,146.09204680868058,80.79464900518603,0.22332017428769207,0.4799015885435125,0.25658141425582043,5171962533,5120633351.6,55.333353778133954,53.211662553733504,NaN,NaN,9.874945393431615,4.57243932870699
2015-04-24T09:30:00-04:00,110.21,110.69,110.03,110.54,32508127,25877056.25,66.47354386685663,55.49896976569459,NaN,NaN,209.1340723591129,129.58117350959554,0.33495260859679027,0.6752721750018083,0.340319566405018,5204470660,5147656595.4,63.90278750079647,54.33871222024543,NaN,NaN,13.720952583082557,5.879369793617785
2015-04-27T09:30:00-04:00,110.95,111.16,110.02,110.26,31121321,25739203.05,64.58615038183459,56.74472236523052,NaN,NaN,183.64620062526433,156.43440055121604,0.3663913121219452,0.7983087065574495,0.43191739443550425,5173349339,5162666393.2,67.61885064444519,55.908983048612946,NaN,NaN,16.200702946379526,7.353845958298034
2015-04-28T09:30:00-04:00,110.34,110.55,109.11,110.04,36849221,26053154.3,63.070874180800054,57.55044710386066,NaN,NaN,130.5294591773411,159.80912024528925,0.34891204992905844,0.8680574568468273,0.5191454069177689,5136500118,5165754392.4,68.34094570987824,57.438598796144376,NaN,NaN,17.752207374433887,8.839326160603155
2015-04-29T09:30:00-04:00,109.43,110.07,108.75,109.35,34043905,26230944.5,58.439894066649764,57.78367941509373,NaN,NaN,93.33472601219904,152.54730099651957,0.27089870319610143,0.8577687859128957,0.5868700827167943,5102456213,5157747772.6,64.33499067546842,58.30850313056394,NaN,NaN,17.68160595464948,10.10250898832406
2015-04-30T09:30:00-04:00,108.73,109.17,107.06,107.63,44080546,26786449.2,48.8174907188022,57.178169363595806,NaN,NaN,11.686519103908957,125.66619545556526,0.09268372688625726,0.7027247413246158,0.6100410144383586,5058375667,5135030399.4,54.562353587309424,58.160610240473815,NaN,NaN,14.415707686773144,10.718680230959643
2015-05-01T09:30:00-04:00,108.05,109.12,108.03,109.05,32874307,27471952.5,55.35341436435667,57.163540789340644,NaN,NaN,48.8093048658901,93.60124195692069,0.06118285335613238,0.6865195811335241,0.6253367277773917,5091249974,5112386262.2,46.912767581647834,57.344296560347765,NaN,NaN,13.80924321709045,11.16018922897833
2015-05-04T09:30:00-04:00,109.4,109.91,109.17,109.23,23507259,27424758.35,56.118371286161526,57.34689153567617,NaN,NaN,81.74199445727872,73.22040072332356,0.04401751373428864,0.6803586199452525,0.6363411062109638,5114757233,5100667841,43.5129081895387,56.18169040807191,NaN,NaN,13.582760720241078,11.506270870587294
2015-05-05T09:30:00-04:00,108.8,109,107.4,107.45,47843265,28847952.55,47.45877860473911,56.654405710129154,NaN,NaN,-17.992195671407224,43.5160697535739,-0.08844570139218644,0.5257839794707309,0.6142296808629173,5066913968,5086750611,39.82178135090287,54.671156230278214,NaN,NaN,10.373934370139178,11.34450851338042
2015-05-06T09:30:00-04:00,107.64,107.95,105.995,106.71,42687150,29688964.7,44.39192671786973,55.81778930126812,NaN,NaN,-92.69052597056144,6.311019357021806,-0.21965949455734324,0.3396553126662383,0.5593148072235815,5024226818,5071104732,36.11296095071085,53.026324028455534,NaN,NaN,6.734457940648607,10.685929860133019
2015-05-07T09:30:00-04:00,106.68,107.65,106.6,107.35,29335806,30000018.65,47.54885116185875,55.933045601555605,NaN,NaN,-72.68165238469243,-10.562614940698465,-0.2546427058952152,0.2410114248545625,0.4956541307497777,5053562624,5070142123.4,35.891477688183414,51.87824579352857,NaN,NaN,4.811366282960307,9.846706491965488
2015-05-08T09:30:00-04:00,108.46,108.92,108.3,108.69,33023337,30792968.35,53.50106899273015,55.87127866281969,NaN,NaN,22.85517292785465,-15.75344132830555,-0.18222382818656263,0.2678743455165744,0.45009817370313704,5086585961,5069209320.8,35.66322122927862,50.91471969279483,NaN,NaN,5.159266795859255,9.177072249664597
2015-05-11T09:30:00-04:00,108.76,108.98,108.19,108.27,19679255,30887757.85,51.527326038543045,55.51750597951822,NaN,NaN,9.521090571701418,-30.19762210542101,-0.15818748237833036,0.2523638207302241,0.4105513031085545,5066906706,5059639215.4,33.321838815337415,49.726001968925786,NaN,NaN,4.801620617618499,8.552007730800868
2015-05-12T09:30:00-04:00,107.63,108.33,106.8,107.78,33665017,31383221.35,49.24477868553183,54.81372003113436,NaN,NaN,-53.89654835239411,-37.378492641618394,-0.16984309040220136,0.19824744010580275,0.3680905305080041,5033241689,5052904759.6,31.74254131737281,48.3623413585003,NaN,NaN,3.797414349453929,7.872780104894163
2015-05-13T09:30:00-04:00,108.25,108.81,107.84,108,20738434,31363714.25,50.30909418801935,54.060111661053796,NaN,NaN,-13.41307320858401,-21.523002089222903,-0.15756106931808478,0.1711391938603981,0.3287002631784829,5053980123,5058855420.6,34.688145513751024,46.8876836253301,NaN,NaN,3.3015698039269217,7.219750061898843
2015-05-14T09:30:00-04:00,108.88,109.67,108.48,109.58,23904233,31749161.95,57.2435226026166,53.400824427893795,NaN,NaN,57.38546234954636,4.490420857624855,-0.04376811355800203,0.2739901212309803,0.31775823478898235,5077884356,5063719767,37.07852650850774,44.97166498302376,NaN,NaN,5.0622597190153185,6.911537155772625
2015-05-15T09:30:00-04:00,109.86,110.01,109.31,109.58,23937442,30620335.85,57.2435226026166,52.87635101509251,NaN,NaN,78.561488463552,15.631683964764326,0.026952562240751488,0.3514489375899217,0.3244963753491702,5077884356,5061979446,36.56293505182226,42.75338529783641,NaN,NaN,6.452737201601157,6.845994305176701
2015-05-18T09:30:00-04:00,109.4,110.28,109.32,110.06,17631135,30054597.15,59.247274435997255,52.603236747606594,NaN,NaN,88.56115562563429,31.439696975550895,0.09754012101390125,0.44642152661654677,0.3488814056026455,5095515491,5067701203,39.539659055835656,40.696150536833365,NaN,NaN,8.209492732721712,7.040779794825988
2015-05-19T09:30:00-04:00,110.18,110.35,109.76,109.94,14212896,29627253.35,58.50904775539641,52.608176296802775,NaN,NaN,88.27440023124308,59.87388669227833,0.12583101618628922,0.506170175835507,0.38033915964921783,5081302595,5077313384.2,44.27069591026297,39.26298662503297,NaN,NaN,9.44556373486558,7.384320357688787
2015-05-20T09:30:00-04:00,110.02,110.67,109.425,110.01,21131892,29612388.45,58.83129561241428,53.32344807491792,NaN,NaN,80.946940610199,78.74588945603493,0.1379666883493142,0.5527975200858606,0.4148308317365464,5102434487,5087004257,48.63466338656606,38.83958018212273,NaN,NaN,10.556829111465095,7.837535893942545
2015-05-21T09:30:00-04:00,109.82,110.73,109.66,110.58,16771801,28977317.45,61.45642168829054,53.75937716948464,NaN,NaN,91.1304591559709,85.49488881731983,0.17093478563900122,0.6284993137852979,0.45756452814629667,5119206288,5095268643.4,52.08085447581395,39.208729245991734,NaN,NaN,12.249468108128593,8.467811924540552
2015-05-22T09:30:00-04:00,110.45,110.87,110.38,110.47,13543774,28029099.8,60.65264533314607,54.08325388712638,NaN,NaN,107.33313622160502,91.24921836893046,0.17144639492077784,0.671872521797269,0.5004261268764911,5105662514,5100824275,54.30052217818959,39.979273102323944,NaN,NaN,13.461985998081257,9.181265363617795
2015-05-26T09:30:00-04:00,110.23,110.38,108.76,109.2,25488437,27747455.6,52.16910612735928,54.41970585302782,NaN,NaN,34.20646961693571,80.37828116719074,0.07716883585937884,0.5968871717007147,0.5197183358413359,5080174077,5097755992.2,52.844639214247515,40.90947723542,NaN,NaN,12.185829573197408,9.610488822129168
2015-05-27T09:30:00-04:00,109.53,111.08,109.29,110.96,30572695,27433629.3,60.42936996846973,55.565237513784965,NaN,NaN,102.34865477504984,83.1931320759521,0.12161308586504194,0.6717346931726382,0.5501216073075963,5110746772,5103644827.6,55.320625613909215,42.281453282791304,NaN,NaN,13.592798961258381,10.1793902705762
2015-05-28T09:30:00-04:00,110.75,111.01,110.37,110.71,17302408,26596554.45,58.874044379276356,56.37417988645765,NaN,NaN,108.89640771387226,88.78302549668675,0.12212495218396291,0.70277779753755,0.5806528453535871,5093444364,5101846803,54.38172194727149,43.6021850155833,NaN,NaN,14.25461082781497,10.761564635896024
2015-05-29T09:30:00-04:00,110.64,110.79,109.79,110.05,30382987,25911676.5,54.859694290197986,56.471224550562496,NaN,NaN,70.25052787765055,84.60703924102268,0.06863042900689309,0.6664408816122034,0.5978104526053103,5063061377,5090617820.8,48.810198373579894,44.54125481160482,NaN,NaN,13.593639394364923,11.166146744248724
2015-06-01T09:30:00-04:00,110.64,110.72,109.52,110.42,24570186,25496470.45,56.64444907365006,56.83673333878443,NaN,NaN,65.27716487321928,76.19584497134551,0.049665789573775654,0.6598926895725299,0.6102268999987542,5087631563,5087011630.6,47.13986829783871,45.52825691749778,NaN,NaN,13.572542214877052,11.509917525767056
2015-06-02T09:30:00-04:00,110.01,110.61,109.47,110.07,19449634,25293589.2,54.45127493975366,57.208625928371696,NaN,NaN,50.39465695203742,79.43348243836587,0.007276053723532128,0.6193219671531693,0.6120459134296372,5068181929,5084613201,46.012082432107434,46.54750985426453,NaN,NaN,12.918854543584008,11.711194242598049
2015-06-03T09:30:00-04:00,110.57,110.81,110.13,110.4,20507208,23926786.35,56.174237413788,57.62756473021232,NaN,NaN,71.715453082866,73.3068420999291,-0.004194510944680929,0.6068027747487861,0.610997285693467,5088689137,5080201674,43.93023701595369,47.20765924727901,NaN,NaN,12.855351038272362,11.874645213408666
2015-06-04T09:30:00-04:00,109.78,110.48,109.21,109.56,31374588,23361158.25,50.89661272147558,57.17421402441653,NaN,NaN,15.981096290774643,54.723779815309584,-0.07034133869352288,0.5230706123265634,0.5934119510200863,5057314549,5072975711,40.68322817504286,47.4651379377458,NaN,NaN,11.24952318525458,11.78534206652951
2015-06-05T09:30:00-04:00,109.43,109.69,108.63,109.3,22641732,23026454.55,49.35108510747312,56.61046848904914,NaN,NaN,-44.46471419648853,31.780731400481763,-0.13011609571931249,0.4307668313709456,0.5608829270902581,5034672817,5067297999,38.28852925468864,47.58839466652198,NaN,NaN,9.46870418619817,11.454393797910749
2015-06-08T09:30:00-04:00,109.25,109.33,107.97,108.19,24549204,22602747.9,43.305171146625284,55.47174682552257,NaN,NaN,-112.39083146650253,-3.7528678674626006,-0.2367119240700929,0.26499302200264196,0.5017049460727349,5010123613,5051796409,32.63958032866191,47.09553190029528,NaN,NaN,6.007131492397896,10.67621346855177
2015-06-09T09:30:00-04:00,107.93,108.4,107.2,108.01,27554599,22996515.1,42.39809078109685,54.32096418450117,NaN,NaN,-161.5082615232474,-46.13345156251957,-0.3071764216818109,0.11773441897047121,0.42491084065228213,4982569014,5034673826,27.766554881317447,45.916664683942024,NaN,NaN,2.9062695016317743,9.566221473277485
2015-06-10T09:30:00-04:00,108.38,109.81,108.26,109.49,30297862,22828157.35,51.41017489609971,53.790884133335844,NaN,NaN,-54.231680996347755,-71.32287837836233,-0.2446631966268864,0.11908184486867412,0.36374504149556053,5012866876,5019509373.8,24.305553598219134,44.17887112763153,NaN,NaN,2.850423201945861,8.60682172023011
2015-06-11T09:30:00-04:00,109.86,110.15,109.46,109.65,17593463,22670908.8,52.27940971778727,53.1353832782999,NaN,NaN,-2.6110603691521983,-75.04130971034769,-0.18576083709060498,0.1315439951323043,0.3173048322229093,5030460339,5014138531.8,23.20245572327856,42.11612835959329,NaN,NaN,3.068219809578337,7.815592875851285
2015-06-12T09:30:00-04:00,109.07,109.3,108.6,108.75,27201768,22835785.55,47.16793885964959,52.172189958764434,NaN,NaN,-104.29078384820644,-87.00652364069126,-0.19943279424920207,0.0680138394114067,0.2674466336606088,5003258571,5007855682.6,21.947598047837957,39.80520520742532,NaN,NaN,1.679358703341351,6.938987994064152
2015-06-15T09:30:00-04:00,107.94,108.38,107.31,108.21,31238798,23200853.35,44.36513349447822,51.614763342130075,NaN,NaN,-170.94295362241047,-98.71694807187285,-0.2344473138743274,-0.025612508682300472,0.20883480519202693,4972019773,5000234914.6,20.499398446253338,37.49483086685431,NaN,NaN,-0.3453853502280699,5.8983632305938345
2015-06-16T09:30:00-04:00,108.1,108.9799,108.05,108.8,16456867,23142139.95,48.000812514394774,50.72700923826757,NaN,NaN,-92.43168011434145,-84.90163179009167,-0.2083551062357292,-0.05160907760263456,0.15674602863309464,4988476640,5001416439.8,21.36572622001644,35.06948091014768,NaN,NaN,-0.9525486958819527,4.919661526811579
2015-06-17T09:30:00-04:00,108.98,109.45,108.43,109.1,23296738,23596332.05,49.797281185767005,50.078669010159764,NaN,NaN,-51.135506625177364,-84.28239691585757,-0.1633624214961291,-0.04745699823706673,0.11590542325906236,5011773378,5001197740.2,21.31941600363899,32.707887628459645,NaN,NaN,-0.9221473758159737,4.085117397864786
2015-06-18T09:30:00-04:00,109.5,110.88,109.44,110.69,43032384,24691356.65,58.06618624107207,50.30770414950791,NaN,NaN,67.88022493036918,-70.1841398559533,-0.026184752425442936,0.08317448272725869,0.10935923515270163,5054805762,5006066824.8,25.20635619335212,31.02189890130052,NaN,NaN,1.80531166473876,3.759430864561068
2015-06-19T09:30:00-04:00,110.49,110.575,109.81,109.89,27877574,25246645.3,53.308510276388134,50.069422806846354,NaN,NaN,47.792423005124135,-39.767498485287184,0.009117062639206086,0.12075556345170924,0.11163850081250315,5026928188,5010800748.2,28.884777307497686,29.717963830561878,NaN,NaN,2.561745783380536,3.588332995820992
2015-06-22T09:30:00-04:00,110.7,111.03,110.45,110.7,19120898,25525501.5,57.13786074316976,50.261321792804644,NaN,NaN,103.38797799565006,15.098687838324917,0.0814401457134526,0.2134386829543189,0.1319985372408663,5046049086,5025606610.8,38.99097943009793,29.21645647327549,NaN,NaN,4.449984755998616,3.7114261044177956
2015-06-23T09:30:00-04:00,110.82,110.89,110.33,110.79,18127916,25157475.45,57.55440598169955,50.35990526194117,NaN,NaN,88.51275816239604,51.28757549367242,0.12704181031753733,0.290800800137788,0.16375898982025064,5064177002,5040746683.2,47.246683123545935,29.45334548096065,NaN,NaN,6.0719892547970025,4.048649411614825
2015-06-24T09:30:00-04:00,110.66,111.13,110.19,110.22,15815914,24419636.4,53.976645583182915,50.57990760920599,NaN,NaN,74.60898405564497,76.43647362983688,0.11109528078942615,0.30262809080703335,0.1915328100176072,5048361088,5048064225.2,50.717821274486546,30.170102130920913,NaN,NaN,6.358866418955433,4.378680412663483
2015-06-25T09:30:00-04:00,110.65,110.76,109.815,110,18326654,24470848.7,52.61710512631534,50.813194753409,NaN,NaN,50.766296036039435,73.01368785097092,0.07949045271317207,0.2908958759090723,0.21140542319590022,5030034434,5043109959.6,48.39599206910061,30.892063760521772,NaN,NaN,6.197445467012183,4.638503991856155
2015-06-26T09:30:00-04:00,109.98,110.23,108.86,109.27,32311679,24567283.3,48.27231104535967,51.16799046046146,NaN,NaN,-10.485045844457684,61.35819408105457,0.006999900402842096,0.22015529869945283,0.21315539829661073,4997722755,5037268873,45.73746657806344,31.82762706405045,NaN,NaN,4.763782387103924,4.656400905462979
2015-06-29T09:30:00-04:00,108.06,108.66,106.64,106.69,50874901,25882519.05,36.728949789745776,50.763051818222095,NaN,NaN,-168.50826194199013,6.978946093526526,-0.20539558948385409,-0.04358908855820687,0.16180650092564722,4946847854,5017428626.6,38.08467646861131,32.56463574885715,NaN,NaN,-0.771960452270651,3.880920711501032
2015-06-30T09:30:00-04:00,107.49,107.72,106.74,107.07,34809920,26650533.35,39.041119731946836,49.87954787792547,NaN,NaN,-154.17236303251624,-41.55807814545593,-0.3049782382916399,-0.21941629693890263,0.08556194135273724,4981657774,5000924781,33.12029975576698,33.19426047439628,NaN,NaN,-4.349480471385489,2.705149113945815
2015-07-01T09:30:00-04:00,108.13,108.3464,107.42,107.92,21292958,26689820.85,43.97320420265429,49.286247483987395,NaN,NaN,-91.53837773461507,-74.78755050350794,-0.29794228776593235,-0.28686591835467823,0.011076369411254144,5002950732,4991842709.8,30.745228630729187,33.73302996778561,NaN,NaN,-5.685211382016817,1.5065261859511534
2015-07-02T09:30:00-04:00,108.23,108.32,107.62,107.95,20499447,26146063.8,44.14497241982675,49.07032130971434,NaN,NaN,-77.59046715826882,-100.45890314236959,-0.27610011446555344,-0.33404877367068764,-0.057948659205134215,5023450179,4990525858.8,30.40477298134769,34.337113891607736,NaN,NaN,-6.674190225923373,0.33785241282622125
2015-07-06T09:30:00-04:00,107.27,108.32,107.04,107.7,24311020,26229528.2,42.962900095807484,48.970161781237856,NaN,NaN,-86.7093524437773,-115.70376446223352,-0.2633623482498624,-0.38715159451746217,-0.12378924626759981,4999139159,4990809139.6,30.582852824891887,35.05736063293906,NaN,NaN,-7.831763817658365,-0.8292356201001481
2015-07-07T09:30:00-04:00,107.82,108.07,105.83,107.97,44230772,27213606.6,44.685599287043026,48.73336083642702,NaN,NaN,-102.89302728906165,-102.58071753164782,-0.22321334151680983,-0.4028059231636121,-0.17959258164680225,5043369931,5010113555,41.55745161256184,36.49962673240659,NaN,NaN,-8.294439407324939,-1.895693303989404
2015-07-08T09:30:00-04:00,107.2,107.33,105.8942,106.09,39691475,27820450.4,36.43400763323603,47.77884129696052,NaN,NaN,-141.95881784827804,-100.13800849480018,-0.3046874063987154,-0.5604518396451965,-0.2557644332464811,5003678456,5014517691.4,43.74264554474256,38.10128598534256,NaN,NaN,-11.41084243884339,-3.255000323254259
2015-07-09T09:30:00-04:00,107.5,107.5955,106.02,106.03,28381041,27724609.35,36.20423011085668,46.21727300194514,NaN,NaN,-117.5022035148245,-105.33077365084208,-0.3412788588485472,-0.6823630068071651,-0.3410841479586179,4975297415,5008987028,41.637202333728894,39.274917852512324,NaN,NaN,-13.94145184934065,-4.781636255552314
2015-07-10T09:30:00-04:00,107.44,108.05,107.05,107.65,26415825,28165727.45,46.090151566422335,45.70167595123329,NaN,NaN,-56.034657931735616,-101.01961180553543,-0.23982905617812683,-0.6408704681812765,-0.40104141200314963,5001713240,5004639640.2,40.00711252594969,40.06937036811604,NaN,NaN,-13.010046727163683,-5.95712346578251
2015-07-13T09:30:00-04:00,108.58,109.63,108.57,109.54,25780733,28094675.7,54.875671999084005,45.54009104094145,NaN,NaN,32.58257617768589,-77.1612260812428,-0.03939844723346614,-0.4502894710449823,-0.41089102381151615,5027493973,5010310603,43.134570034481186,40.365341125571994,NaN,NaN,-9.030242594298981,-6.3961404841420055
2015-07-14T09:30:00-04:00,109.69,110.56,109.63,110.26,21977167,27631594.15,57.703537833080425,45.55074331604008,NaN,NaN,72.47767147192624,-42.08708632904522,0.13798764015433596,-0.23840647361859624,-0.3763941137729322,5049471140,5011530844.8,43.81330299196316,40.120099687601794,NaN,NaN,-4.861537346569124,-6.176911464488737
2015-07-15T09:30:00-04:00,110.47,110.81,110.07,110.38,28631537,28240327.65,58.17400333687954,45.850554584161266,NaN,NaN,77.65219702481741,1.8351166455738734,0.25302589602484915,-0.06011174374187078,-0.31313763976671993,5078102677,5026415689,51.42901632841255,40.17089933431079,NaN,NaN,-1.4750460904456,-5.505216411054003
2015-07-16T09:30:00-04:00,111.29,111.96,111.07,111.94,29838948,28567438.15,63.80965903306328,46.65002272035754,NaN,NaN,121.05976559376478,49.54751046729173,0.4142759822126302,0.20470733799906782,-0.20956864421356236,5107941625,5052944531,61.45640755827278,41.10378615496595,NaN,NaN,3.4439703652536386,-4.226761157295769
2015-07-17T09:30:00-04:00,112.84,113.59,112.65,113.59,35926804,28212159.15,68.62498917161534,48.10378544366152,NaN,NaN,172.02051219725433,95.15854449308972,0.6008371233809618,0.5414777600126399,-0.0593593633683219,5143868429,5081375568.8,68.8730415830862,42.756327226753285,NaN,NaN,9.42468151424001,-2.276555061362086
2015-07-20T09:30:00-04:00,113.83,114.39,113.48,113.98,26539045,28145232.7,69.65280956169252,50.45548971308627,NaN,NaN,172.63396774242912,123.16882280603836,0.7117032144054684,0.8302696546385135,0.11856644023304522,5170407474,5109958269,74.23966774677375,45.33882660376489,NaN,NaN,14.451993269148192,0.11323755728223928
2015-07-21T09:30:00-04:00,114.02,114.2,113.58,113.91,35468865,28962631.05,69.21453249046608,52.61073348155195,NaN,NaN,151.26565210298725,138.92641893225056,0.738335089823085,1.0414853025119015,0.3031502126888165,5134938609,5127051762.8,76.81420359933416,48.459819735448264,NaN,NaN,18.247168212593582,2.7037990794695737
2015-07-22T09:30:00-04:00,112.17,113.169,112.165,112.62,35574962,29834983.35,61.530693194907684,53.864839838141464,NaN,NaN,99.78831390216267,143.3536423077196,0.6312341389926842,1.0921928864296717,0.4609587474369875,5099363647,5131303956.8,77.41879438519736,51.79364586076741,NaN,NaN,19.107767040922752,5.0472230739628845
2015-07-23T09:30:00-04:00,112.73,113.1,111.91,112.2,25698255,30329100.4,59.22536382022876,54.9420106524559,NaN,NaN,84.45233710150607,136.03215660926787,0.5000091095569155,1.0859701343831318,0.5859610248262164,5073665392,5124448710.2,74.06565897134067,54.91228057433834,NaN,NaN,19.0910568147392,7.05348503693093
2015-07-24T09:30:00-04:00,112.8,113.003,110.93,111.1,30844714,30955003.4,53.56492906869428,55.69929843623352,NaN,NaN,57.646038226552754,113.15726181512755,0.3160069745963501,0.980969743071654,0.6649627684753039,5042820678,5104239160,65.11230042235462,57.37866968844282,NaN,NaN,17.279686371669246,8.514370941893546
2015-07-27T09:30:00-04:00,110.47,110.946,109.94,110.18,35994837,31139161.3,49.31932940920147,56.03027915924484,NaN,NaN,16.947235986690192,82.01991546397977,0.11933780398944838,0.8141350234621143,0.6947972194726659,5006825841,5071522833.4,53.77861251125623,58.251609752635275,NaN,NaN,14.390696677774525,9.3538460470194
2015-07-28T09:30:00-04:00,110.67,111.35,109.785,111.13,33553494,30273090.95,53.42454590001542,57.243889035443374,NaN,NaN,24.663224923777594,56.699430028137854,0.044105940088498996,0.7499296445832897,0.7058237044947907,5040379335,5052610978.6,48.52096011953194,58.5929179365488,NaN,NaN,13.236036446266958,9.908444675483338
2015-07-29T09:30:00-04:00,111.37,111.79,110.94,111.55,26714068,29868298.35,55.15407190667885,58.597449163716384,NaN,NaN,40.7383758388126,44.88944241546784,0.015008517837156399,0.7245843517912363,0.7095758339540799,5067093403,5046156929.8,46.83803891421135,58.96440626372612,NaN,NaN,12.822454993942284,10.324731863834616
2015-07-30T09:30:00-04:00,111.29,112.2663,110.621,112.08,25438057,30075553.3,57.30845595117268,59.39875661976998,NaN,NaN,43.677845261281284,36.73454404742287,0.0233383403666354,0.7387487594123741,0.7154104190457387,5092531460,5049930143.4,47.97414132971233,59.533479749709166,NaN,NaN,13.122639921484321,10.724433014927431
2015-07-31T09:30:00-04:00,112.43,112.49,111.72,111.95,22081731,30154667.5,56.59033999435647,59.52123290514658,NaN,NaN,51.75553137781966,35.55644267767626,0.012517320858933312,0.7310570701194052,0.7185397492604719,5070449729,5055455953.6,49.67046477965594,60.000329374364505,NaN,NaN,13.161439197857728,11.072576755346045
2015-08-03T09:30:00-04:00,111.97,112.28,110.861,111.6,25001780,30189205.5,54.60639886060644,59.300008692827014,NaN,NaN,30.76873623415481,38.32074272716918,-0.02380823524686071,0.688779455201896,0.7125876904487567,5045447949,5063180375.2,52.02527851510771,60.58689905458912,NaN,NaN,12.638559706023758,11.29628860544286
2015-08-04T09:30:00-04:00,111.55,111.745,110.93,111.39,22132319,29084282.85,53.396810146354284,58.9587806077895,NaN,NaN,16.567608084726555,36.70161935935897,-0.06522655839263491,0.6310544924579631,0.696281050850598,5023315630,5059767634.2,50.892335500942075,60.5485647097698,NaN,NaN,11.870943000899606,11.37838209050811
2015-08-05T09:30:00-04:00,112.01,113,111.88,112.25,28989897,28549203.95,57.54437571355812,58.51126037068199,NaN,NaN,54.78838683992727,39.511621559581904,-0.03923214751050397,0.647240866462468,0.686473013972972,5052305527,5056810059,49.87859908337443,59.7215783901342,NaN,NaN,12.341642342043711,11.515990697870338
2015-08-06T09:30:00-04:00,112.35,112.5,109.95,110.45,42125401,29236421.95,47.92958155206948,57.033016969285846,NaN,NaN,-30.650833070795837,24.64588589316648,-0.1420129786684814,0.5089567906373702,0.6509697693058516,5010180126,5040339792.2,44.55594932106523,57.98464322856127,NaN,NaN,9.789578999496335,11.269360455245481
2015-08-07T09:30:00-04:00,110.18,110.57,109.4,110.31,30006846,29415973,47.268058343954834,55.434106168018864,NaN,NaN,-104.17953162600432,-6.541126707598304,-0.21385869749763542,0.38364639743380735,0.5975050949314428,4980173280,5022284502.4,39.57081208547235,55.508296395611175,NaN,NaN,7.5374825534181875,10.736235040698725
2015-08-10T09:30:00-04:00,111.01,111.81,111,111.57,21500780,29201975.35,53.489861580454146,54.310915388732305,NaN,NaN,-19.111266333771432,-16.51712722118355,-0.17271645935586022,0.38160952073661747,0.5543259800924777,5001674060,5013529724.6,37.38651479664341,52.692032909704686,NaN,NaN,7.442850067623903,10.265751473116607
2015-08-11T09:30:00-04:00,110.98,111.4101,109.53,110.14,36123270,29909280.5,46.748327108638456,53.25503209685593,NaN,NaN,-105.57524555070725,-40.94569794827031,-0.23418816275459936,0.2615907766492285,0.49577893940382783,4965550790,5001976756.6,34.66703051964416,49.63833549073661,NaN,NaN,5.157095265992076,9.535943443527389
2015-08-12T09:30:00-04:00,109.38,110.735,108.22,110.52,41888960,30572151.65,48.60213450906808,52.496230003201596,NaN,NaN,-141.4104933681719,-80.18547398989014,-0.24071011477491927,0.19489129593517873,0.435601410710098,5007439750,4993003601.2,32.678768768732596,46.682129047693174,NaN,NaN,3.891930206448689,8.729655838230432
2015-08-13T09:30:00-04:00,110.63,111.16,110.1,110.34,22510520,30205730.25,47.75409599596031,52.08117049800631,NaN,NaN,-79.24426925490184,-89.90416122671134,-0.24763800037857703,0.12605391023687673,0.37369191061545376,4984929230,4987953422,31.58095552848286,44.28703298384519,NaN,NaN,2.6186039463327586,7.856648425102193
2015-08-14T09:30:00-04:00,110.08,110.67,109.86,110.51,17924931,29305636.6,48.665128375606535,52.034441852749524,NaN,NaN,-85.6386332872543,-86.19598155896134,-0.23155654664583775,0.08424622730815656,0.3158027739539943,5002854161,4992489598.2,33.73432818660898,42.85529838922753,NaN,NaN,1.8339030109180205,6.996256223075883
2015-08-17T09:30:00-04:00,110.24,111.46,109.96,111.43,21224913,29039930,53.40082013884983,52.03274715552341,NaN,NaN,-32.833902665576986,-88.94050882532244,-0.15350528908790328,0.12392116259411523,0.2774264516820185,5024079074,4996970601,35.88115907785814,41.9524554576794,NaN,NaN,2.5310591965915625,6.358370933578123
2015-08-18T09:30:00-04:00,111.275,111.37,110.71,110.86,13984363,27965704.9,50.304475567310156,51.68634741699707,NaN,NaN,-20.80667850774735,-71.98679541673047,-0.13544258442528898,0.10812322115040729,0.24356580557569626,5010094711,5005879385.2,40.04023689323131,41.46689817046654,NaN,NaN,2.222799142907346,5.767574963482298
2015-08-19T09:30:00-04:00,110.52,111.105,109.49,110.13,42511384,28312526,46.57945680285119,50.91999033497411,NaN,NaN,-86.79641916775259,-61.0639805766466,-0.1658285445353706,0.036280124906483024,0.20210866944185363,4967583327,4997908100.6,37.68479650834215,40.73194496894009,NaN,NaN,0.8565870319694416,5.066005258980462
2015-08-20T09:30:00-04:00,109.11,109.46,107.07,107.08,57747349,29914980.7,34.93851850415564,49.37343165710262,NaN,NaN,-274.9934522578926,-100.21381717724475,-0.3726673301393118,-0.2637254932322861,0.10894183690702568,4909835978,4982889450.2,33.666345061170546,39.58879356047686,NaN,NaN,-4.682214108513296,3.673402492195639
2015-08-21T09:30:00-04:00,105.57,106.47,102.4,102.4,97763445,33260917.25,24.726910722331255,47.23918250436868,NaN,NaN,-415.76419006827854,-166.2389285334496,-0.7824339051718002,-0.8691005445577247,-0.08666663938592441,4812072533,4944733124.6,26.062558476297852,37.73431355770473,NaN,NaN,-14.647788810981089,1.056089448884678
2015-08-24T09:30:00-04:00,94.23,102.53,84.74,98.46,150829863,39002668.55,19.547164711950202,44.82135068762553,NaN,NaN,-433.7917105392969,-246.4304901081936,-1.2489026499181026,-1.6477949517835526,-0.39889230186545005,4661242670,4872165843.8,17.819499106248287,35.37196810094088,NaN,NaN,-25.4103892193195,-2.7248360751444904
2015-08-25T09:30:00-04:00,102.07,102.74,98.01,98.09,75088278,41079407.75,19.141648586862615,42.07829875000443,NaN,NaN,-211.1972862090248,-284.5086116484491,-1.4957825921395353,-2.2686205420398693,-0.7728379499003339,4586154392,4787377780,12.746699719501223,32.71968957494994,NaN,NaN,-32.98950647658225,-7.048360418207027
2015-08-26T09:30:00-04:00,100.96,103.23,98.93,103.03,104103817,44948895.2,37.71919916409723,41.34898572229212,NaN,NaN,-131.6714770112738,-293.4836232171533,-1.249805686594426,-2.3350950581433665,-1.0852893715489405,4690258209,4731912756.4,10.617388787814406,30.295506679717736,NaN,NaN,-31.22380273173197,-10.501995034424876
2015-08-27T09:30:00-04:00,104.52,105.71,103.2799,105.64,69377690,47145876.85,44.919632603100894,41.181241026516844,NaN,NaN,-62.254145255640935,-250.93576181670295,-0.8536567696650295,-2.1523603336302273,-1.2987035639651978,4759635899,4701872740.6,9.674747207374978,28.16007347413935,NaN,NaN,-26.728677774269315,-12.820092568688366
2015-08-28T09:30:00-04:00,105.08,106,104.85,105.62,49919628,48537771.7,44.87681713753872,40.5660235663086,NaN,NaN,-44.5510162252826,-176.6931270481038,-0.550044525531149,-1.986259220879134,-1.436214695347985,4709716271,4681401488.2,9.082934873554862,26.138389193918737,NaN,NaN,-23.623156056775443,-14.363387352700805
2015-08-31T09:30:00-04:00,105.03,105.61,104.05,104.31,39549380,49265151.7,42.049641705138704,40.23040318034433,NaN,NaN,-52.15382687729846,-100.3655503157041,-0.40141945429371617,-1.9379890132151303,-1.5365695589214141,4670166891,4683186332.4,9.602144928527252,24.348040223124674,NaN,NaN,-22.261694087085495,-15.491716886184332
2015-09-01T09:30:00-04:00,101.71,103.29,100.63,101.05,73155538,51816312.65,35.97569602338122,39.32851471708098,NaN,NaN,-91.15081218171386,-76.35625551024191,-0.48125804056212473,-2.13814210962407,-1.6568840690619453,4597011353,4685357724.6,10.273482791280571,22.74766265330667,NaN,NaN,-23.417387411604672,-16.62395553267295
2015-09-02T09:30:00-04:00,102.88,103.92,101.7,103.9,43963563,52564995.95,43.64029223250368,39.03467159111979,NaN,NaN,-58.595593518088165,-61.74107881160478,-0.309085140310583,-2.043240494450174,-1.734155354139591,4640974916,4675501066,9.91357644877246,21.19999271904165,NaN,NaN,-21.412552833008323,-17.30804086129229
2015-09-03T09:30:00-04:00,104.31,105.02,103.1,103.39,45131794,52715315.6,42.656198286303706,38.60546229902673,NaN,NaN,-42.36048638249306,-57.762347036975214,-0.20170479338665692,-1.9862863458729123,-1.7845815524862554,4595843122,4642742510.6,8.809039901937766,19.419614984422275,NaN,NaN,-20.259149802857156,-17.729627852944414
2015-09-04T09:30:00-04:00,101.97,102.845,101.59,102.16,49379643,53683955.45,40.2960925313654,37.66941032706357,NaN,NaN,-63.78295922871066,-61.608735637660835,-0.1860532107953785,-2.0171480659804786,-1.8310948551851,4546463479,4610091952.2,7.868083995720937,17.418681049983896,NaN,NaN,-20.143573437801262,-18.07447722220968
2015-09-08T09:30:00-04:00,104.12,105.165,103.69,105.04,37343527,54476092.8,47.60586784964302,37.47665263294448,NaN,NaN,-17.74720889116343,-54.72741204043382,0.033998728763902086,-1.7885964442302225,-1.8225951729941245,4583807006,4592819975.2,7.416757435338397,15.088432517277258,NaN,NaN,-17.479100508477956,-17.98942340596229
2015-09-09T09:30:00-04:00,106.28,106.31,103.59,103.86,47146743,55027266.45,45.16588912438251,37.375683513053865,NaN,NaN,-14.281349889862284,-39.353519582063505,0.11145216080768483,-1.6832799719845184,-1.7947321327922032,4536660263,4580749757.2,7.109827861037104,12.904506185326897,NaN,NaN,-16.179032753252805,-17.730796169860938
2015-09-10T09:30:00-04:00,103.74,105.68,103.62,104.99,47686714,55317154.15,47.91877292682132,38.30284454324427,NaN,NaN,-6.3070645022889495,-28.895813778903666,0.24263215543931937,-1.491441938493054,-1.7340740939323733,4584346977,4569424169.4,6.824448511646011,10.98722786036086,NaN,NaN,-14.234625403551341,-17.23134320324528
2015-09-11T09:30:00-04:00,104.51,105.57,104.21,105.57,29106088,55646932.55,49.32503027866583,40.05985308298246,NaN,NaN,7.993713979629731,-18.824973706479106,0.3649575236998961,-1.2778771893075032,-1.6428347130073992,4613453065,4572946158,8.0603340687084,9.701354688390184,NaN,NaN,-12.24229534157603,-16.518622080149672
2015-09-14T09:30:00-04:00,105.96,105.98,104.85,105.25,19718804,55736626.2,48.54619527057089,42.131212408598216,NaN,NaN,21.884011827133516,-1.6915794953102683,0.4170527763006673,-1.1215187426315651,-1.5385715189322324,4593734261,4582400314.4,11.45547282504532,9.246781382589973,NaN,NaN,-10.863627348218177,-15.710765689873744
2015-09-15T09:30:00-04:00,105.5,106.82,105.11,106.49,30020216,56176391.35,51.72701219878731,44.45873838087855,NaN,NaN,53.07693887169685,12.47325005726179,0.5210032416819239,-0.8873174668298276,-1.4083207085117515,4623754477,4590389808.6,14.334474238624068,9.360193848241606,NaN,NaN,-8.75472097571014,-14.717045016421801
2015-09-16T09:30:00-04:00,106.51,107.19,106.14,107.09,31329146,57043630.5,53.23351572032819,45.56690384918077,NaN,NaN,84.35324410936673,32.20016885710759,0.6099755180470647,-0.6458513109529207,-1.2558268289999854,4655083623,4614074480.6,22.390617073182966,10.20113872576793,NaN,NaN,-6.5711163496714,-13.553340921171744
2015-09-17T09:30:00-04:00,106.98,108.725,106.64,107.13,56139806,57725051.6,53.33806526304568,46.16822046774825,NaN,NaN,115.98657490827436,56.65889673922025,0.6477675326369987,-0.4461174132037371,-1.0938849458407358,4711223429,4639449771,29.987335172661446,11.652037866145536,NaN,NaN,-4.753048177201335,-12.296156243461684
2015-09-18T09:30:00-04:00,105.23,106.6,105.17,105.35,48383995,57256883.9,48.176651015986856,46.4039228876374,NaN,NaN,63.65405045936919,67.79096403516814,0.5338750894345887,-0.4265410840474999,-0.9604161734820886,4662839434,4649327044.8,32.74686485646154,13.3423185792103,NaN,NaN,-4.560463302280314,-11.191057251864345
2015-09-21T09:30:00-04:00,105.93,106.55,104.73,105.68,35772624,54157342.85,49.15890760821737,46.91172759500016,NaN,NaN,56.91021934631418,74.79620553900428,0.46431865810984685,-0.38001785084478,-0.8443365089546269,4698612058,4670302604.2,38.30782387252228,15.392724218067087,NaN,NaN,-4.133428136948983,-10.18282452116215
2015-09-22T09:30:00-04:00,104.06,104.4225,103.13,104.1,47359654,48983832.4,44.78233587988404,47.540773299036076,NaN,NaN,-22.30427514325874,59.719962736013166,0.3032474291297609,-0.46527722254242576,-0.7685246516721866,4651252404,4675802189.6,39.715313643409985,17.495712136076328,NaN,NaN,-4.983544098383994,-9.440070175050984
2015-09-23T09:30:00-04:00,104.38,104.66,103.64,104.18,21775134,46318175.2,45.049098046252155,47.6414022857324,NaN,NaN,-25.19471054869446,37.81037180440093,0.1985062776019667,-0.5203918046697282,-0.7188980822716949,4673027538,4679390972.6,40.666610902013794,19.692357454165,NaN,NaN,-5.6135813503121685,-8.89342891437401
2015-09-24T09:30:00-04:00,103.17,104.19,102.27,103.8,38284331,43027200.9,43.962651470060706,47.73472037028647,NaN,NaN,-79.26705059852615,-1.2403532969591793,0.10475387024948923,-0.5879557444598333,-0.6927096147093226,4634743207,4664094928.2,37.92001740527202,21.771712990117443,NaN,NaN,-6.435135365956151,-8.542244121742886
2015-09-25T09:30:00-04:00,104.91,105.01,102.28,102.92,44700006,41793316.7,41.468491679013745,47.81846316654706,NaN,NaN,-72.00814518771502,-28.37279242637602,-0.009343936197995895,-0.7043895349568174,-0.6950455987588215,4590043201,4649535681.6,35.464755492709386,23.742903811330905,NaN,NaN,-7.821257276181835,-8.439246000948451
2015-09-28T09:30:00-04:00,102.48,102.55,99.69,99.99,44077490,41501209.8,34.45864896574541,46.879376103411516,NaN,NaN,-188.10955676948552,-77.37674764953597,-0.26101756319621006,-1.021317552754084,-0.760299989557874,4545965711,4619006412.2,30.940757228371666,25.423189510833282,NaN,NaN,-11.269118777224053,-8.843513540416394
2015-09-29T09:30:00-04:00,100.24,101.26,98.75,99.47,49315527,41989517.15,33.38020053637416,46.03754120426807,NaN,NaN,-191.02891829104348,-111.12167627909291,-0.431332420205369,-1.2994655148145853,-0.8681330946092163,4496650184,4588085968.2,27.16160120891331,26.855459035681584,NaN,NaN,-14.445206193931412,-9.643755348061397
2015-09-30T09:30:00-04:00,100.89,101.87,100.5,101.76,41411432,40402311.85,41.99047970340551,45.61409168830979,NaN,NaN,-120.33946267311276,-130.15062670397657,-0.36141426096743634,-1.3199009208185117,-0.9584866598510754,4538061616,4561092783.8,24.363885873093494,28.108275990070688,NaN,NaN,-14.71321772477167,-10.367964259020008
2015-10-01T09:30:00-04:00,101.94,102.23,100.59,102.22,39339134,40171090.4,43.56825242766077,45.20289327038086,NaN,NaN,-98.39483553514233,-133.9761836912998,-0.26055051525327166,-1.284174803917665,-1.0236242886643934,4577400750,4549624292.4,23.267328084977876,29.19448984837565,NaN,NaN,-14.465670382638631,-10.953350848108382
2015-10-02T09:30:00-04:00,100.8,104.01,100.48,104.01,59370859,40883043.65,49.342182591471634,45.25974950758806,NaN,NaN,-46.60114928339543,-128.8947845104359,-0.06010677946552523,-1.0987577629963,-1.0386509835307747,4636771609,4558969974,26.18294882169242,30.24645241956473,NaN,NaN,-12.47572864890504,-11.170833391079332
2015-10-05T09:30:00-04:00,104.78,105.78,104.55,105.5,32853533,40056738.15,53.598176482022936,45.393404099247746,NaN,NaN,47.28106497561355,-81.81666016141608,0.17323586943125735,-0.822106146741703,-0.9953420161729604,4669625142,4583701860.2,33.395444794700964,31.607950316427367,NaN,NaN,-9.43728277395711,-10.923183302919014
2015-10-06T09:30:00-04:00,105.25,105.6,104.18,105,33051534,39842138.5,52.01880845839647,45.30663929482405,NaN,NaN,31.82861382892701,-37.24515373742197,0.28757472188570266,-0.6358736138158321,-0.9234483357015347,4636573608,4611686545,40.481852868716956,32.900181444679795,NaN,NaN,-7.42046119311352,-10.422794430089658
2015-10-07T09:30:00-04:00,105.66,105.86,104.29,105.63,37389334,39354268.05,53.86353857073699,45.34417310251629,NaN,NaN,43.42674394279596,-4.491912414240242,0.3927889877874905,-0.43246210096717164,-0.8252510887546621,4673962942,4638866810.2,46.442093227466266,34.075521305737276,NaN,NaN,-5.198912694095725,-9.676525610661953
2015-10-08T09:30:00-04:00,105.23,106.23,104.21,106.05,50188873,39479376,55.102832091887656,45.83890032222349,NaN,NaN,50.5404492133853,25.29514453546529,0.47247167897585896,-0.2346614900348385,-0.7071331690106974,4724151815,4668217023.2,52.028584856240876,35.45278702000723,NaN,NaN,-2.9979261289220815,-8.722439970413399
2015-10-09T09:30:00-04:00,106.1,106.73,105.81,106.53,23916227,39219882.95,56.53964364258825,46.36609575324997,NaN,NaN,79.68427742386294,50.55222987691697,0.5347267767226255,-0.038724698107415634,-0.5734514748300411,4748068042,4690476309.8,55.79454795887902,36.70183874046129,NaN,NaN,-0.7414154648951083,-7.582293612482214
2015-10-12T09:30:00-04:00,106.73,106.9899,106.35,106.79,16161955,39042040.5,57.33609320820718,47.26279270527306,NaN,NaN,87.62697148205312,58.62141117820488,0.5675364449051163,0.13596908130135432,-0.431567363603762,4764229997,4709397280.8,58.75833237702553,38.06205436429097,NaN,NaN,1.369213700826283,-6.303506853438144
2015-10-13T09:30:00-04:00,106.18,107.26,106,106.1,26999613,38891010.35,54.48256001504051,47.93661141732937,NaN,NaN,76.87634471502416,67.63095735542431,0.5182500402823965,0.21624518674923365,-0.30200485353316286,4737230384,4729528636,61.70056757993425,39.564479841285284,NaN,NaN,2.4474053165768126,-5.053376543436007
2015-10-14T09:30:00-04:00,106.1,106.63,105.49,105.93,30902637,38869684.9,53.77249271228099,48.63731436320224,NaN,NaN,63.44571829104899,71.63475222507492,0.45209507097501983,0.2631139851856119,-0.18898108578940792,4706327747,4736001597,62.623882841388436,41.32904165815074,NaN,NaN,3.1742232274468494,-3.8780051475955992
2015-10-15T09:30:00-04:00,106.32,107.675,106.18,107.67,38393838,37982386.5,59.57922326125746,49.93093804764823,NaN,NaN,108.62801451317543,83.25226528503292,0.49969648670424954,0.435639522590904,-0.06405696411334555,4744721585,4740115551,63.230598716563165,43.31231617414029,NaN,NaN,5.477491328568841,-2.541505651000679
2015-10-16T09:30:00-04:00,107.9,108.18,107.3794,108.12,27091100,36917741.75,60.94553512222687,51.82285848739691,NaN,NaN,124.77407891820678,92.27022558390169,0.532639160180711,0.6017419861125433,0.0691028259318322,4771812685,4744864479.6,63.957912806980076,45.670684429755184,NaN,NaN,7.8079375836861,-1.0630137603311391
2015-10-19T09:30:00-04:00,107.98,108.81,107.74,108.74,23776270,36317924.05,62.810740151285046,53.92503988846197,NaN,NaN,130.310956783881,100.80702264426728,0.5643021190824613,0.7744804747849088,0.2101783557024475,4795588955,4751136271.2,64.94413946601387,48.36943716240523,NaN,NaN,10.331463879121035,0.5647687595905997
2015-10-20T09:30:00-04:00,108.545,108.78,107.81,108.18,23404691,35120175.9,60.02237232101062,55.213032218290905,NaN,NaN,111.09509428665633,107.65077255859372,0.516912151073966,0.8563185445449051,0.33940639347093904,4772184264,4758127047.2,66.05897352509228,51.34765770897656,NaN,NaN,11.751690740237224,2.162900471111546
2015-10-21T09:30:00-04:00,108.73,108.84,107.48,107.52,30195241,35541181.25,56.82079461400732,56.15964237445852,NaN,NaN,91.82083940562104,113.32579678150812,0.4148976866844,0.8580285018264391,0.44313081514203906,4741989023,4765259302.4,67.20486933798837,54.48605351276303,NaN,NaN,12.11486154757656,3.5846091963208337
2015-10-22T09:30:00-04:00,108.48,109.8,108.171,109.71,42778702,35765899.8,63.733411101109766,57.187587268004094,NaN,NaN,119.72237446343952,115.54466877156094,0.4649281191369612,1.0242909640632405,0.5593628449262793,4784767725,4773268530.4,68.49133622439601,57.508081184384714,NaN,NaN,14.53618885982467,5.149120576821382
2015-10-23T09:30:00-04:00,112.66,113.24,112.07,112.78,53170910,36189445,70.79240175850944,58.415746216324564,NaN,NaN,192.4070775276763,129.07126849345485,0.6627345483212288,1.3877810303278153,0.7250464820065865,4837938635,4786493720.4,70.54595007513268,60.16168870441555,NaN,NaN,19.267247302227172,7.165995823307924
2015-10-26T09:30:00-04:00,112.7,113.07,112.27,112.85,25918004,35281470.7,70.93133473386249,59.76664095028642,NaN,NaN,175.89801676027724,138.1886804887341,0.7498312719366396,1.662335571927386,0.9125042999907464,4863856639,4800147257.2,72.53697427118128,62.45134023316301,NaN,NaN,22.98250767213491,9.425497515997494
2015-10-27T09:30:00-04:00,112.55,113.24,112.52,113.08,31390511,34385219.9,71.41250640462393,61.02013865270692,NaN,NaN,162.62291084549207,148.49424380050124,0.7714733517992705,1.8768459897398344,1.105372637940564,4895247150,4824759834.4,75.72283054015314,64.54282146978349,NaN,NaN,26.113677846456675,11.809523277491662
2015-10-28T09:30:00-04:00,113.25,114.02,112.34,114.02,42221867,34425741.65,73.35381550627416,62.3237803251631,NaN,NaN,154.77861051232668,161.08579802184235,0.7945074129253822,2.0985069040972917,1.3039994911719095,4937469017,4863855833.2,79.74275645217475,66.52240515520734,NaN,NaN,29.370172005957322,14.318187381558184
2015-10-29T09:30:00-04:00,113.5,114.03,113.38,113.84,24913340,33704451.95,72.34076512785617,63.45243185982509,NaN,NaN,142.72852763519919,165.6870286561943,0.7439198308118975,2.2338992796867814,1.4899794488748839,4912555677,4889413423.6,81.85763824332813,68.38405446123942,NaN,NaN,31.734891485596638,16.806287967849393
2015-10-30T09:30:00-04:00,113.89,114.08,113.3,113.33,27199231,32095870.55,69.41561691163254,64.31525498149833,NaN,NaN,118.31510947199007,150.86863504505703,0.6270841408167314,2.273834624895798,1.6467504840790668,4885356446,4898896985.8,82.5842207450815,70.08590363038627,NaN,NaN,32.90729374519218,19.106431650326932
2015-11-02T09:30:00-05:00,113.63,114.745,113.39,114.61,22176916,31562039.7,72.42892135904619,65.5971379346416,NaN,NaN,115.73814341912366,138.83666037682633,0.5876545068024348,2.38131861758211,1.7936641107796754,4907533362,4907632330.4,83.24965933782963,71.62512447023595,NaN,NaN,34.82870128925858,21.35247017017431
2015-11-03T09:30:00-05:00,114.38,115.42,114.21,115.01,20418387,30930382.35,73.3137625640808,66.99294292405587,NaN,NaN,112.365692841723,128.78521677607253,0.5413095279910276,2.47030102076846,1.9289914927774323,4927951749,4914173250.2,83.75033105191426,73.1341564852735,NaN,NaN,36.682992884335846,23.542544843625958
2015-11-04T09:30:00-05:00,115.39,115.47,114.54,115.02,28633048,30492568.05,73.3368007634073,67.97562703135229,NaN,NaN,101.53294694987298,118.13608406358178,0.46693698260517813,2.512662721033905,2.045725738428727,4956584797,4917996406.2,84.05041765396048,74.6212864093733,NaN,NaN,38.21128536295651,25.63807920353032
2015-11-05T09:30:00-05:00,115.12,115.395,114.11,114.71,25004080,29233328.4,71.2823783499542,68.71397297618995,NaN,NaN,86.28615967477734,106.8476104714974,0.3574101369419411,2.4924884096061533,2.135078272664212,4931580717,4921801414.2,84.35998664112398,76.07857739752644,NaN,NaN,38.96449446293164,27.541852812016224
2015-11-06T09:30:00-05:00,114.49,114.92,113.76,114.79,29924901,29533762.1,71.50422923673982,69.33493648229386,NaN,NaN,73.96202409989847,97.9769933970791,0.2556651140411681,2.4546596652156722,2.198994551174504,4961505618,4937031248.6,85.56745392901394,77.55167128774073,NaN,NaN,39.65542574254153,29.272363230662695
2015-11-09T09:30:00-05:00,114.36,114.51,112.865,113.57,33479755,30399652.1,63.453704177327516,69.58003161488793,NaN,NaN,51.07722253698872,85.04480922065213,0.08058555364150655,2.2997264932263874,2.219140939584881,4928025863,4941129748.8,85.88330741497694,78.9676951370182,NaN,NaN,38.07508519510779,30.529894939869138
2015-11-10T09:30:00-05:00,112.97,113.39,112.63,113.28,35452127,30822277.8,61.67611126324086,69.92683994697605,NaN,NaN,34.2668209338743,69.4250348390824,-0.07211395770208817,2.1289984924572707,2.201112450159359,4892573736,4934054146.2,82.52551294211301,80.0620268230271,NaN,NaN,36.247769926241574,31.346734223636627
2015-11-11T09:30:00-05:00,113.59,114.14,112.95,113.14,22748808,30414586.35,60.79073586032452,69.71664885834852,NaN,NaN,37.635053817738736,56.64545621265555,-0.1930443152929242,1.9598070560432035,2.1528513713361277,4869824928,4916702172.4,74.80177732179973,80.51277261569881,NaN,NaN,34.46814880199826,31.792650591974002
2015-11-12T09:30:00-05:00,112.65,113.23,111.96,112.04,31196876,30054738.25,54.20642173982959,68.53193599987141,NaN,NaN,2.268545930876651,39.84193346387541,-0.34854798383102104,1.7171663915473516,2.0657143753783727,4838628052,4898111639.4,67.51149216639769,80.29602562221773,NaN,NaN,30.975704593507487,31.6759440207645
2015-11-13T09:30:00-05:00,111.57,111.69,109.78,109.84,52836036,31341985.05,43.95285599343471,66.60490180412656,NaN,NaN,-74.83000710527456,10.08352722284077,-0.5869747934523808,1.3319958835628967,1.9189706770152775,4785792016,4862968919,56.33427846978972,79.13869020783262,NaN,NaN,24.25498874409588,30.615807552668983
2015-11-16T09:30:00-05:00,109.74,111.44,109.48,111.42,33980633,31852203.2,51.10602687171245,65.15443898034717,NaN,NaN,-73.16207336858304,-14.764331958273587,-0.6223088905567209,1.1410845638193763,1.7633934543760972,4819772649,4841318276.2,50.75874041010692,77.35554091282931,NaN,NaN,20.62526289175378,29.188586886823956
2015-11-17T09:30:00-05:00,111.61,112.29,111.2099,111.49,30579457,32210941.5,51.401957235440356,63.58644910385903,NaN,NaN,-51.47351676154057,-31.912399497356567,-0.6234424427809904,0.9840904008998592,1.6075328436808496,4850352106,4832873950.2,48.7328554185218,75.1405479818541,NaN,NaN,17.86457489681203,27.570870888250823
2015-11-18T09:30:00-05:00,111.94,113.74,111.83,113.63,32966463,32349502.6,59.47686625927213,62.66759918467447,NaN,NaN,3.184472306560003,-38.802515799592314,-0.46955681782927106,1.0205868213942608,1.4901436392235319,4883318569,4835572678.4,49.42755453204868,72.82411343104843,NaN,NaN,18.032544562406848,26.208252841701682
2015-11-19T09:30:00-05:00,113.68,114.23,113.49,113.71,26188119,31519973.45,59.746135863884724,61.976921966978196,NaN,NaN,40.48024052548651,-31.160176880670342,-0.35696928708306297,1.043932030369703,1.400901317452766,4909506688,4849748405.6,53.02808711454582,70.71296102886731,NaN,NaN,18.248634187217665,25.07116446248968
2015-11-20T09:30:00-05:00,114.24,114.57,114.14,114.48,22727591,29997807.5,62.34001577146683,61.256285853579676,NaN,NaN,75.16806623261547,-1.1605622130923279,-0.2313208328646983,1.1117502763718932,1.3430711092365915,4932234279,4879036858.2,59.45146819088701,69.01309023265712,NaN,NaN,19.24242953943005,24.238488044909733
2015-11-23T09:30:00-05:00,114.53,114.94,113.66,114.15,20696175,29736716.05,60.53953185987446,60.343840803279214,NaN,NaN,59.92938125764029,25.45772871215234,-0.17374494767041293,1.1258899246485754,1.2996348723189883,4911538104,4897389949.2,62.877274243810064,67.52215760350683,NaN,NaN,19.513412044511142,23.563477187709935
2015-11-24T09:30:00-05:00,113.42,114.32,112.8377,114.05,26374412,29485911.1,59.97425921000975,59.38937354946511,NaN,NaN,21.17123833945251,39.98667973235096,-0.146779790438335,1.1161601342710696,1.2629399247094046,4885163692,4904352266.4,64.11584172457901,66.09825932283673,NaN,NaN,19.572498872038448,22.993337428328296
2015-11-25T09:30:00-05:00,114.19,114.36,113.91,114.15,14159935,28082814.5,60.37273114571584,58.61011303487665,NaN,NaN,46.69246183082249,48.688277637203456,-0.12731632896809897,1.103794513499281,1.23111084246738,4899323627,4907553278,64.69899802793083,64.69390299332292,NaN,NaN,19.73039671877045,22.527203041248605
2015-11-27T09:30:00-05:00,114.395,114.541,113.92,114.31,8827991,27278547.05,61.041029662510496,57.862741636717416,NaN,NaN,52.16671457633765,51.025572447373676,-0.10945585238528643,1.094291026985772,1.2037468793710584,4908151618,4907282264,64.60327291376827,63.196461492233944,NaN,NaN,20.040714639149698,22.171990412377333
2015-11-30T09:30:00-05:00,114.6,114.65,113.65,114.02,25041649,27170667.95,59.09569251170483,57.55145508917293,NaN,NaN,39.16196662968776,43.82435252678814,-0.12200484806015055,1.0512408192958702,1.1732456673560208,4883109969,4897457402,61.075391228060134,61.42446747888274,NaN,NaN,19.799647869487064,21.83308433482158
2015-12-01T09:30:00-05:00,114.475,115.16,114.34,115.16,28639445,27493794.4,63.95830611242083,57.714469006971505,NaN,NaN,87.87167934018433,49.41281214329695,-0.06141873974021905,1.096472242680747,1.157890982420966,4911749414,4897499664,61.08523546749347,59.89301908783848,NaN,NaN,20.93648864933015,21.704999236894235
2015-12-02T09:30:00-05:00,115.23,115.75,114.28,114.45,22395483,27592649.2,59.235290114682,57.603365739425605,NaN,NaN,84.22819300705771,62.02420307681799,-0.07609168134176802,1.062776380743756,1.138868062085524,4889353931,4898337711.8,61.29427888800833,58.92819777113909,NaN,NaN,20.5915617512976,21.54593673895186
2015-12-03T09:30:00-05:00,114.76,114.96,111.8432,112.51,42754345,28298714.05,48.66139330723548,57.20729227995461,NaN,NaN,-24.555966499989477,47.7745174106556,-0.21548865574154896,0.8695072424085879,1.0849958981501369,4846599586,4887792903.6,57.13534936269704,58.18704471373189,NaN,NaN,16.86864408057633,20.87775207346964
2015-12-04T09:30:00-05:00,112.84,115.33,112.62,115.14,40037322,29050376.15,59.2748323639975,58.30171916356623,NaN,NaN,63.95548260918367,50.1322710172248,-0.13361495197058004,0.9179772081869118,1.0515921601574918,4886636908,4883489961.6,55.48103638382698,58.12609885044885,NaN,NaN,17.15413692443969,20.345807052179648
2015-12-07T09:30:00-05:00,115.22,115.29,114.07,114.62,25892101,28848736.15,56.775603156084635,58.706688898164245,NaN,NaN,83.41295441299513,58.982468573886266,-0.11806613421169465,0.9040094923928734,1.022075626604568,4860744807,4879016929.2,53.739130601073,58.33898386408929,NaN,NaN,16.517177111249097,19.798859917760996
2015-12-08T09:30:00-05:00,113.44,114.995,113.38,114.63,30792648,28714380.8,56.81331406252319,59.09321438581302,NaN,NaN,56.96676006030908,52.801484717911215,-0.11081110637319946,0.8835617436380687,0.9943728500112682,4891537455,4874974537.4,52.145748105100616,58.58276191313064,NaN,NaN,16.03824273087667,19.261628891063236
2015-12-09T09:30:00-05:00,114.11,114.76,112.2,112.89,48509199,29367234.4,48.83038753290832,58.33275161964418,NaN,NaN,-14.453385826869297,33.06516895112581,-0.22056313668173955,0.7186689291590938,0.9392320658408333,4843028256,4865709402.4,48.58966927501101,58.52291296619938,NaN,NaN,12.912394669077932,18.35459543077962
2015-12-10T09:30:00-05:00,113.15,114.16,112.811,113.4,30154621,29737525.05,51.003502273538224,57.708277791762285,NaN,NaN,-2.8245720281679003,37.41144784549013,-0.25380708985446143,0.6219732035227565,0.875780293377218,4873182877,4871026060.6,50.668634785241004,58.35438065696332,NaN,NaN,11.106098110712448,17.319095813627168
2015-12-11T09:30:00-05:00,112.09,112.39,110.72,110.79,56022221,30978792.3,41.32986983218556,56.20755308181362,NaN,NaN,-136.49826178834448,-2.6793010340154924,-0.43588719294131095,0.33092130220057925,0.7668084951418902,4817160656,4857130810.2,45.49096492496895,57.35720185225489,NaN,NaN,5.93630314482057,15.692982575226226
2015-12-14T09:30:00-05:00,110.98,111.68,109.38,111.63,53098514,30991916.2,44.94879712506783,55.09392917218457,NaN,NaN,-168.31831920359627,-53.02555575733377,-0.48054555622747075,0.1661265498575517,0.6466721060850225,4870259170,4859033682.8,46.300238808924895,56.17312789262023,NaN,NaN,3.0774557894228396,13.8907644629686
2015-12-15T09:30:00-05:00,112.6,113.28,112.17,112.31,48428014,31714285.25,47.75808475204565,54.22134528233,NaN,NaN,-71.09500964547249,-78.63790969849008,-0.44584513579396956,0.08936568634256048,0.53521082213653,4918687184,4864463628.6,48.643356632017145,55.06795038600867,NaN,NaN,1.7345367957784605,12.154160510512865
2015-12-16T09:30:00-05:00,113.07,114.17,111.89,113.98,44944106,32432517.7,53.97046743011165,53.76404073121541,NaN,NaN,-24.233828350703888,-80.593998203257,-0.29902756210979886,0.16142636949928146,0.4604539316090803,4963631290,4888584235.4,57.51214002775434,54.55460338599607,NaN,NaN,2.730248816553931,10.807887411375875
2015-12-17T09:30:00-05:00,114.46,114.48,112.3,112.32,45668795,33067634.3,47.876031022170984,52.823683685476865,NaN,NaN,-49.81824135966414,-89.99273206955624,-0.30146482486709336,0.0836229005252136,0.38508772539230696,4917962495,4897540159,60.2564957787136,54.24411930492074,NaN,NaN,1.439020841104394,9.469477901337092
2015-12-18T09:30:00-05:00,111.58,111.88,109.83,109.83,53746061,34445531.4,40.490144375795666,51.49471596148336,NaN,NaN,-202.5550817165498,-103.20409605519731,-0.4496059238708173,-0.17691967944621467,0.27268624442460265,4864216434,4906951314.6,62.96369641661686,54.3789982469605,NaN,NaN,-2.425042251262614,7.770260736679991
2015-12-21T09:30:00-05:00,110.87,111.07,110.05,111.05,26432807,34630792.2,44.969667684762776,50.13838464522207,NaN,NaN,-157.27044145378412,-100.99452050523489,-0.4435172878701203,-0.2817103654130477,0.16180692245707257,4890649241,4911029328.8,64.10468810685796,54.594673435486534,NaN,NaN,-3.878677391842242,6.106126718319672
2015-12-22T09:30:00-05:00,111.65,111.94,111.05,111.78,26540310,34922998.95,47.51545463821772,49.30125353976034,NaN,NaN,-90.77378366783665,-104.93027530970771,-0.37133940791255615,-0.30236733743362265,0.06897207047893351,4917189551,4910729802.2,63.94885527341756,54.784286034444335,NaN,NaN,-4.141041913810323,4.642245485158244
2015-12-23T09:30:00-05:00,112.34,112.69,112.16,112.61,25656928,34887124.75,50.32905406909977,49.42037216560778,NaN,NaN,-34.86605545821484,-107.05672073120991,-0.25429362993330507,-0.24889496693769786,0.005398662995607234,4942846479,4906572840,61.70689341130331,55.11082489505907,NaN,NaN,-3.413758224081772,3.4913878124096707
2015-12-24T09:30:00-05:00,112.57,112.9,112.54,112.59,11480244,34753140.2,50.25913712425849,48.776393934197856,NaN,NaN,-20.175586333904292,-101.12818972605794,-0.16892668342440295,-0.20575969128489646,-0.03683300786049351,4931366235,4909253588,62.61708579780926,55.620542710343514,NaN,NaN,-2.8686043660721046,2.5828175011979884
2015-12-28T09:30:00-05:00,112.32,112.55,111.51,112.53,19183637,35270922.5,50.034573290906714,48.29489180097085,NaN,NaN,-42.60307636869508,-69.137788656487,-0.11005817962918678,-0.174405732396977,-0.06434755276779021,4912182598,4918846820.8,65.75408923746326,56.47875404151425,NaN,NaN,-2.4968362314852515,1.8571526822432398
2015-12-29T09:30:00-05:00,113.215,114.545,113.13,114.3,27725673,35405123.7,56.24547251481092,48.25433169041998,NaN,NaN,63.948714407146,-24.89395748430097,0.046152799028884195,-0.006656553981684965,-0.05280935301056916,4939908271,4928698626.8,68.66241418115843,57.65851590408981,NaN,NaN,-0.240057111941333,1.5575512830740152
2015-12-30T09:30:00-05:00,114.16,114.24,113.25,113.27,19520081,34949155.5,52.18063766237964,48.4936352710965,NaN,NaN,46.19668730134163,2.500136709534688,0.07639266721200433,0.04268148100443625,-0.03371118620756808,4920388190,4929338354.6,68.8474229200026,59.10549830730349,NaN,NaN,0.43355240935015454,1.396980015399178
2015-12-31T09:30:00-05:00,112.87,113.08,111.84,111.86,29886849,35323723.8,47.156479712179184,48.218847945285155,NaN,NaN,-30.743450033607594,3.3246577944561353,0.0016662333642779373,-0.03162839450222066,-0.033294627866498595,4890501341,4918869327,62.35923676653964,59.94054130596768,NaN,NaN,-0.5579958928869946,1.1176977427868677
2016-01-04T09:30:00-05:00,109.43,109.6,108.12,109.5,50807643,35726388.7,40.18266762227814,48.136904930291756,NaN,NaN,-197.5930060750779,-32.15882615377859,-0.19556434022896196,-0.27775005315270107,-0.0821857129237391,4839693698,4900534819.6,52.94825651264446,60.473204990801655,NaN,NaN,-3.801498475389453,0.41495542590453616
2016-01-05T09:30:00-05:00,110.04,110.18,108.8,109.31,38795182,35664281.7,39.673968729802546,47.76013147348709,NaN,NaN,-152.0395864240648,-54.04612816485253,-0.3203089215649751,-0.48257186487995796,-0.16226294331498287,4800898516,4878278003.2,44.22329282377315,60.32485170614796,NaN,NaN,-6.501086642021344,-0.573050583799161
2016-01-06T09:30:00-05:00,107.43,108.89,107.41,108.26,41891091,36464231.2,36.89424856292142,46.98414317426393,NaN,NaN,-180.79898600467766,-102.99566824721728,-0.4472345122160297,-0.72130608358502,-0.2740715713689903,4759007425,4842097834,34.32226753215001,59.301916770443164,NaN,NaN,-9.644116500622737,-1.868917143345386
2016-01-07T09:30:00-05:00,105.96,107.29,104.81,104.87,61386300,37993913.8,29.667118373136518,45.248189670194286,NaN,NaN,-239.11215258498999,-160.05743622448358,-0.7171874634698059,-1.1705559007062476,-0.45336843723644177,4697621125,4797544421,26.46465794215436,57.0842394786146,NaN,NaN,-15.170932388822242,-3.7692050355563653
2016-01-08T09:30:00-05:00,105.67,106.29,103.9,104.01,69344012,39035654.45,28.160079279402908,43.83990740285371,NaN,NaN,-217.45301532535052,-197.3993492828322,-0.8995425089080699,-1.5777965733715291,-0.6782540644634593,4628277113,4745099575.4,20.51180802024679,54.24533321015269,NaN,NaN,-20.07492017658922,-6.098592912846773
2016-01-11T09:30:00-05:00,104.79,105.06,102.73,104.33,50024094,40029128.1,29.5932556110655,43.06155820537298,NaN,NaN,-193.3270855154704,-196.54616517091068,-0.9400784485839269,-1.8533521251933678,-0.9132736766094409,4678301207,4712821077.2,17.850451557477513,51.02295857735702,NaN,NaN,-23.47493663068376,-8.580927729680628
2016-01-12T09:30:00-05:00,105.31,106.08,104.08,105.54,46734241,39564729.1,34.8831527074673,42.341092849851876,NaN,NaN,-131.07508670053696,-192.3532652262051,-0.8306596095799206,-1.9515981885843416,-1.120938579004421,4725035448,4697648463.6,16.750297771609624,47.64050212483928,NaN,NaN,-24.65721416695072,-10.877540077862069
2016-01-13T09:30:00-05:00,106,106.23,101.74,101.9,69870673,40403337.05,28.05448527285492,40.95102360946881,NaN,NaN,-148.53184542445405,-185.89983711016038,-0.9406103649931274,-2.2967015352458304,-1.356091170252703,4655164775,4676879933.6,15.355243973856275,44.16952988915633,NaN,NaN,-28.182582162316915,-13.349688947069904
2016-01-14T09:30:00-05:00,102.3,104.98,100.67,104.07,78445735,41904223.1,36.087015440053335,39.9337351359655,NaN,NaN,-128.48518626507257,-163.77444384617692,-0.8093694639396352,-2.367803000177247,-1.5584335362376118,4733610510,4684077810.6,17.90710683593346,41.04097370520134,NaN,NaN,-28.228718916372113,-15.47526465697022
2016-01-15T09:30:00-05:00,100.57,101.94,99.51,100.84,91443918,44229213.7,30.60897857608822,38.53015238252477,NaN,NaN,-151.42036217203008,-150.56791321551282,-0.876604838058668,-2.654189583810947,-1.7775847457522789,4642166592,4686855706.4,18.92300720833896,37.91996809166775,NaN,NaN,-30.318826550466245,-17.59577349889822
2016-01-19T09:30:00-05:00,102.2,102.37,99.88,101.06,56563845,44773966.2,31.373118848924122,37.19719135095458,NaN,NaN,-125.5061470528939,-137.0037255229975,-0.8425478070031089,-2.830769504506165,-1.988221697503056,4698730437,4690941552.4,20.481710009550454,34.6862267182454,NaN,NaN,-31.616853153157017,-19.59878487807805
2016-01-20T09:30:00-05:00,99.48,101.83,97.25,100.75,86674981,46420412.2,30.85747027089114,35.383762619246035,NaN,NaN,-125.10461402374776,-135.80963098763968,-0.7786910095299344,-2.961585459415474,-2.1828944498855396,4612055456,4668345554,18.377511919303657,31.09444798525578,NaN,NaN,-32.79069018429767,-21.483342778966566
2016-01-21T09:30:00-05:00,101.19,102.349,99.82,100.85,61660101,48181776.9,31.25001731585951,33.888718308780305,NaN,NaN,-95.88161671922144,-125.27958524659316,-0.6715637381365225,-3.022349122556193,-2.3507853844196704,4673715557,4672055710.4,19.833832202172744,27.593477219696503,NaN,NaN,-33.59753895047746,-23.21394223203955
2016-01-22T09:30:00-05:00,102.84,103.81,102.5305,103.77,42229803,48966251.55,41.664687291266006,33.49644742157223,NaN,NaN,-53.92578624995405,-110.36770524356946,-0.3614347189957776,-2.8025787831643925,-2.441144064168615,4715945360,4668522680.4,19.477447621808523,24.530492280787136,NaN,NaN,-30.92149712803608,-24.315021502896197
2016-01-25T09:30:00-05:00,103.46,103.99,102.14,102.23,38881485,49627479.4,38.363895214567584,33.36653510673576,NaN,NaN,-57.90793024817217,-91.66521885879789,-0.2241286106031084,-2.7213048274225002,-2.497176216819392,4677063875,4675502137,22.442254542583186,22.35149214006847,NaN,NaN,-29.746443489124786,-25.090938929500282
2016-01-26T09:30:00-05:00,102.65,103.59,101.76,103.15,36143916,50860663,41.35304252138119,33.48646894899138,NaN,NaN,-52.8616247230838,-77.13631439283589,-0.04484008018912844,-2.5532263170558025,-2.508386236866674,4713207791,4678397607.8,23.697418263150837,20.885358242881157,NaN,NaN,-27.838905482822646,-25.483505579974906
2016-01-27T09:30:00-05:00,102.55,102.99,100.15,100.58,54524736,52627717.95,36.087967800744956,33.42887746597877,NaN,NaN,-76.74822317647512,-67.46503622338132,-0.07125782912209733,-2.597458523269296,-2.5262006941471986,4658683055,4687723127.6,27.752826732515445,20.41611247147869,NaN,NaN,-27.882709611444557,-25.826249013042
2016-01-28T09:30:00-05:00,102.19,102.29,100.26,102,47641532,53623510.9,40.58892021150168,34.20900616871914,NaN,NaN,-68.04394047796505,-61.897500975130036,0.029571462934500747,-2.489236365479073,-2.5188078284135735,4706324587,4694244933.6,30.533502081268978,20.706744195701162,NaN,NaN,-26.444802953494097,-25.914613861678014
2016-01-29T09:30:00-05:00,102,104.17,101.94,104.13,54245067,55359760.2,46.65729971867571,35.53023620009578,NaN,NaN,-19.430083020276484,-54.99836032919452,0.2501142389612272,-2.2061650297120394,-2.4562792686732666,4760569654,4703169792.4,34.26224512438131,21.688918274567918,NaN,NaN,-23.190629326439854,-25.52547321378685
2016-02-01T09:30:00-05:00,103.62,104.8,103.23,104.41,32750348,55502935.15,47.417640817508904,36.80340657198459,NaN,NaN,12.89079482167547,-40.838615315225,0.4154971517496815,-1.9369078289861648,-2.3524049807358463,4793320002,4726421017.8,42.866393073250414,23.475771239980272,NaN,NaN,-20.391763016385138,-24.792086042729462
2016-02-02T09:30:00-05:00,103.97,103.97,101.84,102.15,44928088,55208957.4,42.19029616928248,37.32534539068568,NaN,NaN,-29.69497429803897,-36.205285230216035,0.37459341716170647,-1.884163209283713,-2.2587566264454195,4748391914,4733457842.4,45.20392740030875,25.508173356315922,NaN,NaN,-19.62281258434533,-24.053618405817442
2016-02-03T09:30:00-05:00,102.8,102.83,99.88,101.66,61572882,56347842.4,41.13155774731227,38.25942199600406,NaN,NaN,-69.93847765996402,-34.84333612691381,0.31864094057907666,-1.8604554507215738,-2.1790963913006505,4686819032,4739085037.8,47.06891979518093,27.773435914981967,NaN,NaN,-19.33046910094121,-23.378882790835124
2016-02-04T09:30:00-05:00,101.35,102.455,100.44,101.65,49321638,56719369.75,41.108885195505955,38.618126978536395,NaN,NaN,-60.26839914574008,-33.28822786046881,0.28609555681078147,-1.8214769452871735,-2.107572502097955,4637497394,4725319599.2,43.19587393989596,29.57977642240786,NaN,NaN,-19.103285474785583,-22.768083174256617
2016-02-05T09:30:00-05:00,101.29,101.33,97.72,98.12,70749932,57187551.35,33.98696614545217,38.85941180491954,NaN,NaN,-161.06290023825773,-61.61479130406506,0.044637121860264806,-2.051776099772624,-2.096413221632889,4566747462,4686555160.8,34.56931955308235,30.697370161318105,NaN,NaN,-21.172859777434397,-22.54019411756773
2016-02-08T09:30:00-05:00,96.33,97.05,94.84,96.62,91673063,58304003.9,31.490412406514537,38.867789916175994,NaN,NaN,-246.25435090770748,-113.44382044994165,-0.18565819558166163,-2.328485966109966,-2.1428277705283043,4475074399,4622906040.2,25.54760799362431,31.05922001732338,NaN,NaN,-23.70816588771813,-22.707047227589214
2016-02-09T09:30:00-05:00,95.36,97.78,95.18,96.32,73778426,59491720.5,30.999951703693952,38.8779671613762,NaN,NaN,-201.9193170689948,-147.8886890041328,-0.31987987698574516,-2.5426776167604856,-2.2227977397747405,4401295973,4553486852,19.5538184305168,31.14324191098146,NaN,NaN,-25.88345781205539,-23.16082016822724
2016-02-10T09:30:00-05:00,97.5,98.69,96.62,96.69,59421699,60126093.4,32.39840498880068,38.95999485230056,NaN,NaN,-145.8768181079465,-163.0763570937293,-0.3433614365443818,-2.651999535455218,-2.308638098910836,4460717672,4508266580,16.79037834555912,30.925852349794773,NaN,NaN,-27.25796518957564,-23.746126599848438
2016-02-11T09:30:00-05:00,95.45,97.32,95.19,96.55,76839183,60474518.9,32.13302923978323,38.279162134337504,NaN,NaN,-151.2789474375474,-181.27846675209076,-0.3279667093477068,-2.7185964855954694,-2.3906297762477626,4383878489,4457542799,14.341938384491996,30.55903026141502,NaN,NaN,-28.45892047464717,-24.419382867676827
2016-02-12T09:30:00-05:00,97.68,98.12,96.73,98.02,49186494,59011556.85,37.88610810292301,38.245034483505755,NaN,NaN,-93.15138015544844,-167.6961627355289,-0.1855181545919784,-2.6225274694877356,-2.4370093148957572,4433064983,4430806303.2,13.245521793032523,29.90212077930426,NaN,NaN,-27.896108651160368,-24.916057979603046
2016-02-16T09:30:00-05:00,99.44,100.23,98.85,100.23,40565911,56467656.5,45.382211922036966,38.532832297838304,NaN,NaN,-22.501589875920548,-122.94561052917152,0.07674579383655944,-2.341077072600058,-2.4178228664366173,4473630894,4430517602.2,13.233757132720342,29.15471641284494,NaN,NaN,-25.123120191224235,-24.94563829554893
2016-02-17T09:30:00-05:00,101.01,102.64,100.7,102.5,41766451,55727786.8,51.814709082406736,39.65617096081415,NaN,NaN,43.889488757365626,-73.78384936389946,0.40401354090289043,-1.9128059403080044,-2.316819481210895,4515397345,4453337876.6,19.33283753401831,28.553288612952283,NaN,NaN,-20.610138970594903,-24.32628124912693
2016-02-18T09:30:00-05:00,102.81,102.84,101.2,101.33,38991469,53343611.2,48.63533180418334,40.230914646005694,NaN,NaN,36.08259680755627,-37.3919663807989,0.5344149014209925,-1.6488008544346542,-2.1832157558556466,4476405876,4456475517.4,20.16379822219774,27.812595480161484,NaN,NaN,-17.820607011737852,-23.396899215214205
2016-02-19T09:30:00-05:00,100.91,101.94,100.615,101.63,28257915,51673501.9,49.491140394511774,40.43333183713684,NaN,NaN,23.15134342249556,-2.5059082087903044,0.6271822961405897,-1.3992378856799093,-2.026420181820499,4504663791,4480632577.8,26.446048732844602,27.25429573790886,NaN,NaN,-15.313013755447328,-22.242058435247507
2016-02-22T09:30:00-05:00,102.54,103.38,102.48,103.28,23979113,50760967.4,54.027977040300016,40.90549871019335,NaN,NaN,74.67217282771222,31.058802387841837,0.77622280090169,-1.0561416806933863,-1.8323644815950764,4528642904,4499748162,31.068389726168476,26.411581213117294,NaN,NaN,-11.743289256929183,-20.74223426691632
2016-02-23T09:30:00-05:00,102.67,102.96,101.51,101.58,29869660,50310376.15,49.131381673972676,41.40129053195694,NaN,NaN,44.67260116869711,44.49364059676536,0.7371629087420142,-0.9109108456675585,-1.6480737544095727,4498773244,4504776632,32.274102094668535,25.48802226271442,NaN,NaN,-10.146956787411872,-19.228623198415683
2016-02-24T09:30:00-05:00,100.44,102.68,99.77,102.55,40739103,50540135.5,51.81484852887496,42.164382730639986,NaN,NaN,36.26375665794509,42.96849417688125,0.7509659350044953,-0.7093663356539537,-1.460332270658449,4539512347,4509599632.4,33.476005943863186,24.517099844763152,NaN,NaN,-8.000684512749032,-17.624631957606162
2016-02-25T09:30:00-05:00,102.76,103.56,101.84,103.56,29389315,49283364.45,54.50598009237378,43.12131808041626,NaN,NaN,73.34131921635405,50.420238658640805,0.7980199402460082,-0.4628073453509387,-1.260827285596947,4568901662,4528098789.6,38.01949409259468,24.147358427098773,NaN,NaN,-5.386847030343655,-15.876376967997233
2016-02-26T09:30:00-05:00,104.28,104.3659,103.1835,103.43,30925045,48447540.1,54.08726043687723,44.55705338694662,NaN,NaN,87.78412750194431,63.346795474530566,0.78887738060646,-0.27473055983887207,-1.063607940445332,4537976617,4534761354.8,39.6189990992643,24.508049823254627,NaN,NaN,-3.3839217032689017,-14.091740501607472
2016-02-29T09:30:00-05:00,103.31,104.1,102.5,102.5,27553937,47112983.6,51.06503334628494,45.95524059693022,NaN,NaN,70.05416627409862,62.42319416380784,0.6921390287134802,-0.1984341545534818,-0.890573183266962,4510422680,4531117310,39.0257882440529,25.470776983999524,NaN,NaN,-2.5198550485019835,-12.438614008306688
2016-03-01T09:30:00-05:00,103.45,105.79,103.16,105.79,37699779,47360455.15,59.65382569224816,48.00194588182695,NaN,NaN,123.90324781030682,78.26932349212979,0.8133015319660981,0.1260537316906607,-0.6872478002754374,4548122459,4540987153,41.57730484360439,27.043883156362927,NaN,NaN,1.0262177135032318,-10.5150666194767
2016-03-02T09:30:00-05:00,105.63,105.85,105.01,105.83,29209756,46574538.55,59.7463310853546,49.95536917443794,NaN,NaN,132.85680530698934,97.58793322193864,0.8554274450381352,0.3820365060222315,-0.4733909390159036,4577332215,4548551126.6,43.52765447641333,28.953688594281083,NaN,NaN,3.8667863903077637,-8.46051618950749
2016-03-03T09:30:00-05:00,105.71,105.75,104.87,105.63,25474625,44769625.7,59.01771000116157,51.8757035145364,NaN,NaN,116.20403530824359,106.16047644031656,0.8285405131065007,0.5622847023672222,-0.26625581073927845,4551857590,4545142312.2,42.83366300205375,30.988811781249776,NaN,NaN,5.981040118972644,-6.397436716867471
2016-03-04T09:30:00-05:00,105.76,106.35,104.97,105.67,31655424,43886315,59.125074856302874,53.392772568349244,NaN,NaN,110.78539296002852,110.76072953193338,0.7732349522183177,0.7002878795336187,-0.072947072684699,4583513014,4554249591.6,45.34104322571109,33.281349026441106,NaN,NaN,7.749310542062685,-4.376472822734591
2016-03-07T09:30:00-05:00,105.12,105.74,104.27,105.02,25861160,41641876.4,56.53323703818028,54.18927436235948,NaN,NaN,87.53331668352145,114.25655961381794,0.6572198072507154,0.7485776863786953,0.09135787912797988,4557651854,4563695426.4,47.893778508475194,35.75706483899502,NaN,NaN,8.579991432902837,-2.52554935764353
2016-03-08T09:30:00-05:00,104.3,105.2138,103.97,104.15,28898525,38503149.5,53.17337878439043,54.28632219821545,NaN,NaN,68.61866033098562,103.1996421179537,0.49369695380485423,0.7084790713840476,0.21478211757919344,4528753329,4559821600.4,46.92585489914938,37.727994650790095,NaN,NaN,8.3940672331195,-0.9656041303916687
2016-03-09T09:30:00-05:00,104.57,104.84,103.96,104.82,31047351,36366595.75,55.37303440982363,54.7675866700469,NaN,NaN,65.23098293413719,89.67447764338327,0.40612329430528904,0.7224362354608047,0.31631294115551567,4559800680,4556315293.4,46.01929510073015,39.57481585639955,NaN,NaN,8.820887763471335,0.4324661401601888
2016-03-10T09:30:00-05:00,105.31,105.86,103.31,104.66,44997649,35645393.25,54.712074803114774,55.140510556375695,NaN,NaN,62.443377100188734,78.9223460017723,0.3168495760237423,0.7123749111851936,0.3955253351614513,4514803031,4548904381.6,44.08090512352741,40.83444845573404,NaN,NaN,9.006746433337575,1.6573633248998154
2016-03-11T09:30:00-05:00,105.8,106.49,105.46,106.49,31453958,33376132,60.5170687828781,55.604017109416986,NaN,NaN,110.86010326850493,78.93728806346758,0.35746515638472853,0.842356780642362,0.48489162425763344,4546256989,4541453176.6,42.158157148590746,41.62657470019277,NaN,NaN,10.806229963234024,2.964344273233274
2016-03-14T09:30:00-04:00,106.08,106.92,106.06,106.67,25374912,32185552.9,61.04597393601903,56.455059413848865,NaN,NaN,120.09923985148043,85.45047269705938,0.3712498162260842,0.9489538945402387,0.5777040783141545,4571631901,4544249186,43.16005241899771,42.404142580502004,NaN,NaN,12.447084264790128,4.319021414884253
2016-03-15T09:30:00-04:00,106.27,106.75,105.95,106.63,26524632,31483488.95,60.85089626590667,57.10049139506542,NaN,NaN,107.88673075689081,93.30408678224042,0.3526087207728903,1.0184649792802674,0.6658562585073771,4545107269,4547519974,44.37388116001939,43.18256223879887,NaN,NaN,13.766028160592136,5.668593807128237
2016-03-16T09:30:00-04:00,106.37,107.86,106.34,107.58,31693050,30979818.9,63.8089119371859,57.76498652683771,NaN,NaN,132.3769526392327,106.73328072325953,0.37699680769840005,1.137102268130377,0.760105460431977,4576800319,4550919901.8,45.6726277761065,43.729214644764006,NaN,NaN,15.739182104697619,7.1072492782095775
2016-03-17T09:30:00-04:00,107.26,107.77,106.87,107.52,29623740,30511432.45,63.482665237667206,58.43608686975127,NaN,NaN,128.69698117085576,119.98400153739291,0.3617611962698527,1.212306955769293,0.8505457594994402,4547176579,4557394611.4,48.15511416197918,44.33893714924364,NaN,NaN,17.311876410413287,8.56505315423868
2016-03-18T09:30:00-04:00,107.46,107.635,106.8,107.37,37682293,30982651.35,62.62066545139049,59.2614891629731,NaN,NaN,114.26119244200959,120.66421937209387,0.3159207775916679,1.2454467314890252,0.9295259538973573,4509494286,4550042070.8,45.6065408557541,44.8089909072223,NaN,NaN,18.439271925283784,9.975655835816552
2016-03-21T09:30:00-04:00,107.16,107.89,107.12,107.79,17288559,30648123.65,64.09094103540559,59.578425973198634,NaN,NaN,116.87870520036337,120.02011244187045,0.28895691015759173,1.290722091594347,1.0017651814367552,4526782845,4541072259.6,42.641582608248655,44.88501074755403,NaN,NaN,19.79764130563778,11.378796617219583
2016-03-22T09:30:00-04:00,107.18,108.37,107.16,108.12,18840278,30096654.55,65.247589655765,59.971373013942234,NaN,NaN,120.23701088880796,122.49016846825387,0.26883580883852365,1.3378099424849097,1.068974133646386,4545623123,4541175430.4,42.687735317297026,44.82501652190287,NaN,NaN,21.27266073357333,12.79220577669869
2016-03-23T09:30:00-04:00,107.91,107.99,106.99,107.23,20912873,29105343.05,59.665680450477815,60.017656617464816,NaN,NaN,89.70551898640927,113.95588173768917,0.17558812108783806,1.2884592850061836,1.1128711639183455,4524710250,4530757416.6,39.253055049163436,44.569258810982134,NaN,NaN,21.16327569563703,13.988072907975596
2016-03-24T09:30:00-04:00,106.67,107.29,106.53,107.26,19017258,28586740.2,59.790551666605374,60.06519067534357,NaN,NaN,62.786936459975486,100.77387279551313,0.09970635340206124,1.2375041056709222,1.137797752268861,4543727508,4530067602.4,39.02912934507628,44.118407819508214,NaN,NaN,21.101759819045643,15.004313895271316
2016-03-28T09:30:00-04:00,107.56,107.58,106.92,107.11,13892303,27735103.1,58.81017100373422,60.22782881574028,NaN,NaN,66.25791797356226,91.17321790182368,0.026972625194848776,1.1715135337624218,1.144540908567573,4529835205,4534135786.2,41.16094332413828,43.63749102062701,NaN,NaN,20.80449418313389,15.832911079251684
2016-03-29T09:30:00-04:00,106.93,108.9,106.73,108.83,29963923,27855602.4,65.74595967418574,61.125870307868524,NaN,NaN,114.91468196500392,90.78041325475178,0.0793024046347719,1.243668914361038,1.164366509726266,4559799128,4540739042.8,44.54994057337477,43.46778285450025,NaN,NaN,22.426454289784186,16.774845823613468
2016-03-30T09:30:00-04:00,109.48,110.04,109.13,109.36,23807235,27160975.2,67.55870245926815,61.996275168543136,NaN,NaN,176.67664855581805,102.0683407881538,0.13115258811164798,1.328307244865826,1.197154656754178,4583606363,4548335690.8,48.24329231266373,43.626639798209794,NaN,NaN,24.332838145984,17.854559012523545
2016-03-31T09:30:00-04:00,109.3,109.69,109.03,109.2,21447236,26772849.2,66.41601880229942,62.832271168484894,NaN,NaN,144.3575417317823,112.99874533722841,0.13565098652202434,1.3667183899067084,1.231067403384684,4562159127,4555825466.2,51.66182971514803,44.16813441189698,NaN,NaN,25.62123240048921,18.964083782232926
2016-04-01T09:30:00-04:00,108.58,110.4,108.39,110.36,26389045,26818570.2,70.33371353063967,63.53346007903929,NaN,NaN,150.31444006507286,130.50424605824787,0.19416453013298085,1.47377306605091,1.2796085359179292,4588548172,4564789599,55.45415084808639,45.11784824757524,NaN,NaN,27.932028448597805,20.245218734570766
2016-04-04T09:30:00-04:00,110.31,110.435,109.68,109.94,17162988,26093948.4,67.27372449074745,63.97829940437703,NaN,NaN,150.23721916388757,147.30010629631295,0.18219189459175666,1.507348404157625,1.3251565095658684,4571385184,4573099594.8,58.689716940551776,46.227109999114816,NaN,NaN,29.022064818698446,21.49905388944615
2016-04-05T09:30:00-04:00,109.08,109.5,108.74,108.88,20107915,25806286.15,60.1598774360039,63.928940916526834,NaN,NaN,90.4877754853733,142.41472500038682,0.08540895581634511,1.4319177043362998,1.3465087485199547,4551277269,4571395223,57.76301282933955,47.18347654692341,NaN,NaN,27.871839474945688,22.4094518302318
2016-04-06T09:30:00-04:00,109,110.71,108.99,110.67,25056031,25614161.45,66.58563222933776,64.12727808025197,NaN,NaN,131.66074402615328,133.41154409445386,0.12222776119276424,1.49929345001091,1.3770656888181458,4576333300,4569940610.4,56.9367102023409,47.988053863083,NaN,NaN,28.864828157044524,23.331648448347902
2016-04-07T09:30:00-04:00,110.04,110.225,108.61,109.08,28567202,25490154,57.6854562882421,63.71319172672161,NaN,NaN,78.23706009896357,120.18744776789012,0.02487316339404777,1.4081571430607056,1.3832839796666578,4547766098,4567062004.6,55.25225736183459,48.49499266307267,NaN,NaN,26.66834787026982,23.808319794336747
2016-04-08T09:30:00-04:00,109.77,110.02,108.615,109,22897951,24385169.1,57.270666697473295,63.33104895858467,NaN,NaN,64.31577333709507,102.98771442229456,-0.05516725386265775,1.3143249123383356,1.3694921662009933,4524868147,4554325999.6,48.42602569960463,48.69638443763343,NaN,NaN,24.82779016142412,23.953958418206373
2016-04-11T09:30:00-04:00,109.48,110.02,108.585,108.6,25772058,24101074.1,55.13589880008155,62.691403084632945,NaN,NaN,48.880787384217285,82.7164280663605,-0.14045554234484836,1.193922738269933,1.3343782806147813,4499096089,4539868180.6,42.07162586235277,48.655673241498,NaN,NaN,22.660071155663637,23.76911738070027
2016-04-12T09:30:00-04:00,108.66,109.72,108.015,109.51,28564087,24260532.85,58.89020602396026,62.23730425378975,NaN,NaN,43.762715494167956,73.37141606811943,-0.1406408756351616,1.1585771860708292,1.2992180617059907,4527660176,4535144762,40.21500930515188,48.47904995491621,NaN,NaN,21.956386722484016,23.510155858097946
2016-04-13T09:30:00-04:00,110.32,111.08,110.21,110.91,25356728,24202137.65,63.89584323508415,62.539458738404484,NaN,NaN,136.4465915190581,74.3285855667004,-0.05588440557716412,1.2293625547345357,1.2852469603116998,4553016904,4530481482.8,38.41270753451012,48.41902513244098,NaN,NaN,22.959248856816984,23.43145485791495
2016-04-14T09:30:00-04:00,110,111.33,110,110.92,17199671,23477468.7,63.929628034027736,62.83510705036322,NaN,NaN,125.78192666731061,83.8375588803698,-0.010910313832485752,1.2716090680210925,1.2825193818535783,4570216575,4534971578.2,41.14767277046001,48.57034966282553,NaN,NaN,23.75796102975689,23.47809859674951
2016-04-15T09:30:00-04:00,110.83,111.055,110.36,110.64,21353343,23063948.85,62.17524526045948,63.07546949727216,NaN,NaN,113.75033207078116,93.72447062710701,-0.011710918002247883,1.2678807343507685,1.2795916523530164,4548863232,4539770595.2,44.009581726700816,48.77382383443713,NaN,NaN,23.89899949489415,23.53822729648446
2016-04-18T09:30:00-04:00,110.33,111.265,110.25,111.23,17126086,22036138.5,64.39262847881639,62.97880298331721,NaN,NaN,121.33152521557057,108.21461819337767,0.014387813297937813,1.2975764189754386,1.2831886056775008,4565989318,4553149241,51.14251026558725,49.244721669595165,NaN,NaN,24.665344620694267,23.699244057085863
2016-04-19T09:30:00-04:00,111.44,111.44,109.88,110.55,42481435,23295782.3,60.02506843730381,62.44068626746262,NaN,NaN,93.52066646241373,118.16620838702684,-0.02510283746219577,1.251810058849756,1.2769128963119518,4523507883,4552318782.4,50.71064940316803,49.42096146177404,NaN,NaN,24.040001578477327,23.74792370299893
2016-04-20T09:30:00-04:00,110.54,111.15,110.17,110.64,18078307,23257683.75,60.407831743641324,62.01153004898704,NaN,NaN,86.42540577030698,108.16197123727662,-0.0544366614682501,1.2088670694766392,1.2633037309448893,4541586190,4550032639.6,49.47215878975824,49.26455639567478,NaN,NaN,23.634140859820675,23.73166901111632
2016-04-21T09:30:00-04:00,110.58,111.05,110.15,110.65,20215983,23222839.25,60.4531420216287,61.30577494120054,NaN,NaN,76.57029531158524,98.31964496613152,-0.08084799665155495,1.1622437351304455,1.2430917317820005,4561802173,4548349759.2,48.532519927988204,48.77015418709634,NaN,NaN,23.31101257241717,23.6715752341593
2016-04-22T09:30:00-04:00,109.21,109.72,108.12,108.98,39073996,24225676.15,50.13444607481776,60.081540768634135,NaN,NaN,-61.83786033926045,63.202006484123196,-0.21107245290124754,0.979251165655441,1.1903236185566886,4522728177,4543122748.2,45.63338995719429,47.8375594025708,NaN,NaN,19.881940645075527,23.13019886429019
2016-04-25T09:30:00-04:00,108.62,108.99,108.45,108.98,14351890,24248655.5,50.13444607481776,59.36543852854941,NaN,NaN,-87.90577420281043,21.354546600447016,-0.29248180566743165,0.8247213614723989,1.1172031671398306,4522728177,4534470520,41.24170945774438,46.657466304599716,NaN,NaN,17.112490077111143,22.27052618040747
2016-04-26T09:30:00-04:00,109.2,109.39,108.12,108.45,19118334,23706376.05,47.17091809548772,57.978673233274414,NaN,NaN,-107.63909477220788,-18.877405646477307,-0.3721839211065314,0.6519732657566664,1.0241571868631978,4503609843,4530490912,39.365172273766426,45.402356452558685,NaN,NaN,13.870358235842534,21.070502188326763
2016-04-27T09:30:00-04:00,107.34,107.83,106.69,107.58,33059790,24169003.8,42.708081922939726,56.908860778609956,NaN,NaN,-192.17966019585003,-74.59841883970871,-0.4674875799276309,0.43979771195365913,0.90728529188129,4470550053,4516283684.6,33.50415610418287,43.848920648440696,NaN,NaN,9.657961779426774,19.44013927276962
2016-04-28T09:30:00-04:00,107.69,108.3335,106.0705,106.28,29818155,24587549.75,37.06507839816959,55.46560447151683,NaN,NaN,-192.45019644650995,-128.40251719132775,-0.5939501052951381,0.1648476602623674,0.7587977655575056,4440731898,4492069629.6,26.31332134934179,42.269441766279066,NaN,NaN,4.028417594516171,17.238464747304842
2016-04-29T09:30:00-04:00,106.22,106.495,104.88,105.72,67502786,26643236.8,34.92436684043791,54.021923617256576,NaN,NaN,-224.21200586727284,-160.87734629693023,-0.6847342263583889,-0.09712001739048048,0.5876142089679084,4373229112,4462169816.6,20.470792009209305,40.726525062483105,NaN,NaN,-1.3445992545276877,14.583741318471624
2016-05-02T09:30:00-04:00,105.97,106.87,105.5525,106.72,24813813,27025778.05,41.429670239668006,52.774742489807124,NaN,NaN,-157.4209981916269,-174.7803910946935,-0.6472805578046079,-0.22148648828785156,0.42579406951675636,4398042925,4437232766.2,17.06712610545742,39.07310483393349,NaN,NaN,-3.9665399114637743,11.933701142766568
2016-05-03T09:30:00-04:00,105.96,106.4399,105.45,105.73,38569433,27948853.95,37.43943650803097,50.88499915216047,NaN,NaN,-154.90389959479378,-184.23335205921072,-0.6569351779670354,-0.3953749029420379,0.26156027502499746,4359473492,4408405496,14.1402045140549,37.3393546181867,NaN,NaN,-7.510007043926735,9.156028544667524
2016-05-04T09:30:00-04:00,105.12,105.4811,104.7902,105.05,27474504,28069777.6,34.94951094717031,48.81499078881351,NaN,NaN,-158.45625924430138,-177.48867186890098,-0.674329485776792,-0.5813515821959925,0.09297790358079946,4331998988,4380695283,12.008360447902405,35.257975166575434,NaN,NaN,-11.255700963101196,6.2400671864148505
2016-05-05T09:30:00-04:00,105.43,105.66,104.81,105.02,20788119,27680823.45,34.83942672314767,46.86243232186266,NaN,NaN,-129.85784046337736,-164.97020067227444,-0.6526446267206982,-0.7228278798200733,-0.07018325309937512,4311210869,4354791077.2,10.42591412138195,32.85914176619551,NaN,NaN,-14.258379190695097,3.3117177039705727
2016-05-06T09:30:00-04:00,104.51,105.6,104.4,105.58,30758516,28073851.7,38.71964965214905,45.02864811995784,NaN,NaN,-109.93742432905056,-142.11528436462999,-0.568462528333462,-0.7807614135162027,-0.21229888518274062,4341969385,4348539131.8,10.080640824040358,29.92615109179931,NaN,NaN,-15.649970539719742,0.6029050977290993
2016-05-09T09:30:00-04:00,105.61,106.37,105.54,105.88,19289615,27749729.55,40.755010059937035,43.652215378717365,NaN,NaN,-74.94428740585654,-125.61994220747593,-0.46481828731035035,-0.7933217443206786,-0.32850345701032824,4361259000,4341182346.8,9.67462715328982,26.99500664537943,NaN,NaN,-16.215487937508446,-1.7997224787334072
2016-05-10T09:30:00-04:00,106.26,107.38,106.07,107.33,21178851,27380467.75,49.487710577743755,42.87220672401039,NaN,NaN,-38.15895178734152,-102.27095264598545,-0.2799590264156901,-0.6784522400299409,-0.3984932136142508,4382437851,4345775218.6,12.056065538992854,24.322428556039046,NaN,NaN,-13.976616123346913,-3.5392787136781934
2016-05-11T09:30:00-04:00,107.16,107.49,106.33,106.36,20966257,27160944.2,44.73706292917059,41.74962964597767,NaN,NaN,-39.77396933948199,-78.53449466502157,-0.20768705557113176,-0.6581020330781655,-0.45041497750703374,4361471594,4351669739.8,15.148070645966158,21.937825035894612,NaN,NaN,-13.545683779570773,-4.968765151662847
2016-05-12T09:30:00-04:00,106.68,106.735,105.14,105.89,29196323,27760776.8,42.6030036262866,41.21166947108259,NaN,NaN,-61.873968397078094,-64.93772025176172,-0.17738904036789627,-0.6721512779669041,-0.49476223759900784,4332275271,4355882620.2,17.383777831227604,19.919995598325563,NaN,NaN,-13.850695865366086,-6.237612396477595
2016-05-13T09:30:00-04:00,105.85,106.449,105.29,105.5,21059255,27746072.4,40.86119086755825,40.54929409913548,NaN,NaN,-63.76726108477882,-55.70368760290737,-0.1694780408015254,-0.7066097886009146,-0.5371317477993892,4311216016,4349731946.4,16.692270386570698,18.16646423609887,NaN,NaN,-14.625790932011176,-7.435923615839535
2016-05-16T09:30:00-04:00,105.67,107.21,105.56,106.82,18311860,27805361.1,48.53125252919335,40.64646084440017,NaN,NaN,-28.56687457575384,-46.42820503688683,-0.06649901673227121,-0.6202555187147283,-0.5537565019824571,4329527876,4343385721.6,15.985690083932212,16.49650122253928,NaN,NaN,-12.851888428111996,-8.2096328747356
2016-05-17T09:30:00-04:00,106.74,107.04,105.2,105.48,29932711,27177924.9,42.50458041088748,40.631925022110714,NaN,NaN,-52.28435279845828,-49.25328523911021,-0.07893494832926984,-0.6524251873940443,-0.5734902390647745,4299595165,4326817184.4,14.28550881333507,15.123740701764438,NaN,NaN,-13.292122977137252,-8.935702889364407
2016-05-18T09:30:00-04:00,105.29,106.43,105.04,105.86,28177911,27682905.1,44.605391695925206,41.17051882909326,NaN,NaN,-55.099814653310915,-52.318454301876,-0.05311253561438334,-0.6398809085827537,-0.5867683729683704,4327773076,4320077480.8,13.649557701353856,14.219186155479589,NaN,NaN,-12.969433338528882,-9.511950096387903
2016-05-19T09:30:00-04:00,105.45,105.705,104.54,105.31,27334610,28038836.45,42.20186361815821,41.69034002750185,NaN,NaN,-89.18765522552991,-57.78119166756636,-0.06389356055432938,-0.6666353236612821,-0.6027417631069527,4300438466,4313710119.8,13.058116056892686,13.689709301742692,NaN,NaN,-13.451671815692043,-10.074767484859922
2016-05-20T09:30:00-04:00,105.74,106.9,105.67,106.47,29549578,27562615.55,48.50435586985358,42.19567471537225,NaN,NaN,3.3851723578987447,-44.350704979030844,0.012222079529298213,-0.5874641636953299,-0.5996862432246282,4329988044,4317464525.4,15.386211922940106,13.569644002991453,NaN,NaN,-11.826683360799944,-10.325041181422783
2016-05-23T09:30:00-04:00,106.55,106.97,106.23,106.33,15729764,27631509.25,47.82652392576644,42.937609530924775,NaN,NaN,32.09266240750204,-32.218797582379665,0.05582193859875417,-0.5299088199761854,-0.5857307585749396,4314258280,4314410606.2,15.033569180560463,13.63345576488471,NaN,NaN,-10.738984186095859,-10.38417589637608
2016-05-24T09:30:00-04:00,106.92,108.59,106.885,108.46,29931309,28172158,57.54697070563895,44.551713799386825,NaN,NaN,194.54622586650513,17.147318150613017,0.22149482678252075,-0.30886222509678873,-0.5303570518793095,4344189589,4323329491,20.746505169859432,14.257608959310213,NaN,NaN,-6.372140456652666,-9.811027976415593
2016-05-25T09:30:00-04:00,108.86,109.57,108.684,109.24,38464750,28442406,60.452686433563066,46.38123235013078,NaN,NaN,269.0742294971064,81.98212698069648,0.3683372004396256,-0.06993555132977747,-0.43827275176940306,4382654339,4334305743.6,27.23114344671461,15.45798248254826,NaN,NaN,-1.8211660715260565,-8.669619132859944
2016-05-26T09:30:00-04:00,109.35,109.7,109.09,109.56,21885871,28045791.8,61.61350139727393,48.01650747478256,NaN,NaN,236.63495083803906,147.14664819341027,0.4654836121836065,0.1435817634601051,-0.3219018487235014,4404540210,4355126092.4,37.65210348054306,17.427372672298453,NaN,NaN,2.174580047159151,-7.120447821428645
2016-05-27T09:30:00-04:00,109.65,110.14,109.61,110.13,19870010,25664153,63.65968347704497,49.65255557600455,NaN,NaN,210.56789682368526,188.58319308656758,0.5412824669853554,0.35470123500819284,-0.18658123197716256,4424410220,4374010527.6,45.30321701203677,19.97227194792324,NaN,NaN,6.120288006894714,-5.228914131668165
2016-05-31T09:30:00-04:00,110.28,110.51,109.7837,110.34,24366106,25641767.65,64.41233576068669,50.718600231929045,NaN,NaN,175.82466108558523,217.32959282218422,0.5755195342394283,0.5328181858221228,-0.04270134841730547,4448776326,4400914136.8,53.96961579365261,22.96609696611322,NaN,NaN,9.542447344574164,-3.118719635062118
2016-06-01T09:30:00-04:00,110,110.6,109.91,110.35,19571528,24691872.4,64.45009380794482,52.12667386612721,NaN,NaN,145.5945064083603,207.53924893055523,0.5678364564070268,0.6670942220914782,0.09925776568445127,4468347854,4425745789.8,60.2326315787272,26.186422747024725,NaN,NaN,12.323302244897542,-0.9127165093535949
2016-06-02T09:30:00-04:00,110.13,110.59,109.53,110.58,15696618,24102978.1,65.36041620056906,53.75220333571882,NaN,NaN,120.36747077230784,177.79789718559553,0.54702707529248,0.7830416098000512,0.23601453450757126,4484044472,4446023816.4,64.48259222750019,29.550623775329907,NaN,NaN,14.910777036913172,1.3477825686845146
2016-06-03T09:30:00-04:00,110.37,110.42,109.34,110.06,20269923,24077068.3,61.524533757418936,55.228156399280294,NaN,NaN,94.42098971448011,149.35510496088375,0.4699712105032775,0.8234785476366682,0.35350733713339066,4463774549,4457870684.2,66.72028370836867,33.124053298315474,NaN,NaN,16.115776034736154,3.457495920977606
2016-06-06T09:30:00-04:00,110.25,110.75,110.07,110.46,12502365,23164260.75,63.30838501457402,56.28366586252177,NaN,NaN,99.78625150459298,127.1987758970653,0.4193416264414192,0.8776843701851647,0.45834274374374545,4476276914,4468244023,68.58655273577013,36.881257773446755,NaN,NaN,17.63881687728602,5.48339891473595
2016-06-07T09:30:00-04:00,110.53,110.63,110.13,110.18,12184296,22808994.8,61.17042790021092,57.616940683187735,NaN,NaN,85.60739513226663,109.15532270640158,0.3435778338485167,0.8878150360543913,0.5442372022058746,4464092618,4471307281.4,69.13695867010617,40.79921847750183,NaN,NaN,18.364860747852678,7.32360774803834
2016-06-08T09:30:00-04:00,110.37,110.6,109.96,110.37,14568699,22478487.2,62.10560315441456,58.86695578736555,NaN,NaN,76.59235936522626,95.35489329777477,0.2852432880926383,0.9007913123216724,0.6155480242290341,4478661317,4473369974,69.52417929417976,44.7902628769894,NaN,NaN,19.22681899424265,9.024066497496097
2016-06-09T09:30:00-04:00,109.93,110.31,109.71,110.19,17571631,22308755.9,60.6161650976365,60.18226303589971,NaN,NaN,61.90057989856823,83.66151512302685,0.2166283871105017,0.8863335081171613,0.6697051210066596,4461089686,4468779016.8,67.49443584423064,48.67857143322782,NaN,NaN,19.58108078047916,10.532211395065106
2016-06-10T09:30:00-04:00,109.2,109.4,108.56,108.94,32965003,22497189.9,51.39771938138132,60.38893185815169,NaN,NaN,18.824029297645776,68.54212303965997,0.07638822492782382,0.7651904021664393,0.6888021772386155,4428124683,4461649043.6,64.35220527891188,52.17614238722581,NaN,NaN,17.27716305527431,11.495775917952136
2016-06-13T09:30:00-04:00,108.34,108.93,107.89,108.03,25412177,22714836,45.92239517655462,60.252922661779415,NaN,NaN,-12.703274166401977,46.04421790546099,-0.0798697408443344,0.5889650011831975,0.6688347420275319,4402712506,4446936162,58.31866549600881,55.2679349811864,NaN,NaN,13.551924276377298,11.789511397727159
2016-06-14T09:30:00-04:00,107.78,108.415,107.24,108.03,24588506,23028668.3,45.92239517655462,59.4225958382734,NaN,NaN,-33.1390262748015,22.29493362404736,-0.17971994145067682,0.44418481521418585,0.6239047566648627,4402712506,4434660139.6,53.7872613848393,57.62798899654211,NaN,NaN,10.538241846984372,11.610758604763904
2016-06-15T09:30:00-04:00,108.32,108.44,107.54,107.72,24605701,22762317.8,44.06768565343019,58.252238639692486,NaN,NaN,-40.37052920946347,-1.0976440908905858,-0.2583543928239854,0.30096176563488086,0.5593161584588663,4378106805,4414549237.2,47.302842980964044,59.06168182041707,NaN,NaN,7.450157157467803,11.016386969435889
2016-06-16T09:30:00-04:00,107.17,108.14,106.5,108.04,32079929,22957418.7,46.47101530281417,57.17063249008822,NaN,NaN,-65.43575290860217,-26.564910652324663,-0.2787751055910319,0.2108472764700764,0.4896223820611083,4410186734,4404368646.8,44.38568081291968,59.542651629872545,NaN,NaN,5.4575246877259405,10.222263786334468
2016-06-17T09:30:00-04:00,107.53,107.6819,106.24,106.49,29208832,23051129.8,37.962212261281806,55.33509883181942,NaN,NaN,-116.52220067576049,-53.63415664700591,-0.38034173376331176,0.014195214856968619,0.3945369486202804,4380977902,4394939290.6,41.8135997740199,59.293393255728475,NaN,NaN,0.8383461709276859,8.881704126990641
2016-06-20T09:30:00-04:00,107.73,108.24,107.08,107.16,20562769,22601789.35,42.83465688777974,53.793836055183206,NaN,NaN,-86.63875122151492,-68.4212520580285,-0.3849026697525991,-0.08659138857046855,0.29831128118213057,4401540671,4394704923.6,41.74884298460656,58.42048091222519,NaN,NaN,-1.5798758183152657,7.387192706232654
2016-06-21T09:30:00-04:00,107.33,107.715,107.1,107.5,22804112,22955506.75,45.187323641954315,52.417923900469596,NaN,NaN,-96.81666917922571,-81.15678063891335,-0.34860578341065934,-0.1374459480811936,0.21115983532946575,4424344783,4399031379,43.4887386463362,57.22448855991155,NaN,NaN,-2.8567420701363115,5.923773452465659
2016-06-22T09:30:00-04:00,107.58,108.19,107.15,107.24,22724174,22595150,43.70600718397148,50.87118039928406,NaN,NaN,-88.09639350927016,-90.70195349887467,-0.3260988035333734,-0.196463669087251,0.1296351344461224,4401620609,4403734139.8,45.39786050934028,55.86129343718584,NaN,NaN,-4.347806216777763,4.456404928288028
2016-06-23T09:30:00-04:00,108.09,108.79,107.62,108.77,18714227,21607623.85,53.38923640087529,50.29008773095951,NaN,NaN,-33.6962997189799,-84.35406286095022,-0.19843805957955585,-0.11841244002832241,0.08002561955123344,4420334836,4405763760.2,46.241950530410655,54.398555353045985,NaN,NaN,-2.588492470822665,3.4499910141293575
2016-06-24T09:30:00-04:00,104.81,106.5,104.06,104.29,68012733,23913966.95,34.61411769211763,48.240497207926914,NaN,NaN,-191.28719486756853,-99.30706169931183,-0.39465303968343973,-0.41329068005306624,-0.018637640369626507,4352322103,4400032600.4,44.165714385299566,52.654209756583796,NaN,NaN,-8.745842082047167,1.707729143246997
2016-06-27T09:30:00-04:00,103.6,103.6,101.75,102.22,50044303,25422681.6,29.459147363288906,45.97540574100391,NaN,NaN,-253.5606006453514,-132.6914315840791,-0.6288810717161875,-0.8047389800148608,-0.17585790829867337,4302277800,4380180026.2,37.82949582610872,50.41796241058398,NaN,NaN,-15.883637968969143,-0.8053233013553087
2016-06-28T09:30:00-04:00,103.33,104.51,103.3,104.46,28260604,25617406.5,39.89127262879807,44.38866784631701,NaN,NaN,-160.60827689961886,-145.44975312815774,-0.5981688495540034,-0.9235689702411776,-0.3254001206871742,4330538404,4361418750.4,33.009815731615646,47.809793584686545,NaN,NaN,-16.927849707627722,-3.108541359394225
2016-06-29T09:30:00-04:00,105.26,106.53,105.231,106.31,31356723,26206666.25,46.87858440006711,43.40741208220492,NaN,NaN,-74.96591781436994,-142.82365798917772,-0.4265327353270123,-0.8585660398459396,-0.4320333045189273,4361895127,4353473654,31.197124979898163,45.21712852294851,NaN,NaN,-14.723869344959528,-4.767873928760697
2016-06-30T09:30:00-04:00,106.52,107.61,106.13,107.54,36300819,27236876.3,50.96026285217663,43.37616518726173,NaN,NaN,-26.098888985673813,-141.30417584251649,-0.21416050161071548,-0.6997339315323217,-0.4855734299216062,4398195946,4349045876,30.20175586251409,42.777810707491525,NaN,NaN,-11.414005214455532,-5.71732125528853
2016-07-01T09:30:00-04:00,107.49,108.48,107.45,108.08,19902803,27218520.3,52.679332005043115,43.85880353215377,NaN,NaN,18.35887329738638,-99.37496220952552,-0.03093463373900973,-0.5242417220953683,-0.4933070883563586,4418098749,4362201205.2,36.667206487635426,41.231277921179135,NaN,NaN,-8.31887313603992,-6.0889715239673
2016-07-05T09:30:00-04:00,107.58,107.66,106.84,107.42,21167903,27651797.2,50.35589760793625,44.175482277252456,NaN,NaN,-7.019474131683497,-50.066736906791945,0.047907163626551785,-0.4334231338231689,-0.48133029744972067,4396930846,4381131814.4,44.61735990932389,40.576284958642326,NaN,NaN,-6.750605926176144,-6.183490724282849
2016-07-06T09:30:00-04:00,106.92,108.35,106.57,108.3,24579270,28271545.9,53.312636184501784,44.83583588661471,NaN,NaN,22.587882993498745,-13.427504928168426,0.15536004271924997,-0.28713024405065823,-0.4424902867699082,4421510116,4399326156.8,50.98569842266314,40.83934606162084,NaN,NaN,-4.485788957362813,-5.940961900437129
2016-07-07T09:30:00-04:00,108.39,108.86,108.11,108.62,19161748,28501198.35,54.37673896679169,45.400530434041684,NaN,NaN,72.89737717578267,16.14515406986209,0.2390209473688839,-0.14371410255880335,-0.38273504992768725,4440671864,4415081504.2,55.732625441027764,41.6498421064857,NaN,NaN,-2.3664524635500066,-5.43031769516754
2016-07-08T09:30:00-04:00,109.17,110.36,109.02,110.3,29457871,29095510.35,59.584766860206656,46.94499861967917,NaN,NaN,150.48539361566654,51.46201059013017,0.38963110620393177,0.10430383282722744,-0.2853272733767043,4470129735,4429468262,59.58195157362373,42.91901009217168,NaN,NaN,1.2053838875330645,-4.482360326210311
2016-07-11T09:30:00-04:00,110.68,111.335,110.66,110.93,20218504,28458185.4,61.36581117910749,48.268652497631145,NaN,NaN,195.54636122730065,86.89950817611303,0.5064119320283306,0.3476876416587089,-0.15872429036962168,4490348239,4443918160,63.05669850096986,44.440999771911926,NaN,NaN,4.659469582571029,-3.1763846249558343
2016-07-12T09:30:00-04:00,111.59,111.79,111.34,111.49,21906145,28282883.8,62.92963789154348,49.535960658316085,NaN,NaN,198.20701410258263,127.94480582296626,0.5902458917469309,0.5790830743140418,-0.011162817432888994,4512254384,4466982867.6,67.81325590089531,46.178465290094735,NaN,NaN,7.959750606870871,-1.5855081632663048
2016-07-13T09:30:00-04:00,111.79,111.82,111.21,111.22,21107762,28108846.6,61.634251366921006,50.81654952852677,NaN,NaN,162.08495712514048,155.8442206492946,0.5947207286293512,0.7322380933538,0.1375173647244488,4491146622,4480910168.8,70.29992650181407,47.957184289557155,NaN,NaN,10.256124819529386,0.10615369141879372
2016-07-14T09:30:00-04:00,111.96,112.19,111.7,111.98,20870986,27922110.85,63.88763231105503,51.566434950682456,NaN,NaN,153.27981362832068,171.92070793980218,0.6135969313080949,0.9045135288595674,0.29091659755147253,4512017608,4495179317.6,72.63278104991218,49.84224361237869,NaN,NaN,12.870246108675149,1.9295954653125587
2016-07-15T09:30:00-04:00,112.22,112.3,111.55,111.8,17999312,27218080,62.94467179133523,53.59004595776944,NaN,NaN,127.08943566362537,167.24151634939398,0.5791229938183164,1.014820339824368,0.43569734600605164,4494018296,4499957029.8,73.38654944817682,51.929446116869926,NaN,NaN,14.753113751760141,3.7615266490907846
2016-07-18T09:30:00-04:00,111.86,112.74,111.85,112.54,20713924,26793334.6,65.21757269167686,56.14421919551143,NaN,NaN,123.21073778317616,152.77439166056905,0.5704097150683878,1.1487094898415364,0.5782997747731486,4514732220,4504833826,74.16863440104082,54.52509887222221,NaN,NaN,17.02290808142056,5.656009710852181
2016-07-19T09:30:00-04:00,112.17,112.48,111.93,112.13,18936702,26712031.25,62.91496159848618,57.78876840763201,NaN,NaN,101.84946004585561,133.5028808492237,0.5036090901068018,1.207811137406651,0.7042020472998491,4495795518,4501542052.8,72.61741401164241,57.354213035081266,NaN,NaN,18.3094729917369,7.463647322407141
2016-07-20T09:30:00-04:00,112.75,113.65,112.6,113.44,24997929,26821722.1,66.93224767980058,59.221172927612976,NaN,NaN,113.60673426359874,123.80723627691532,0.5125207958023074,1.3448530420527334,0.832332246250426,4520793447,4507471417.8,73.68503943946187,60.389064067907235,NaN,NaN,20.638476868264753,9.345765828958228
2016-07-21T09:30:00-04:00,113.52,113.74,112.87,113.18,18885367,26629781.75,65.41758723194694,60.25383895473942,NaN,NaN,100.99393281704893,113.35006011466098,0.4670584864639902,1.4161553543304137,0.9490968678664236,4501908080,4505449512.2,72.64491088979386,63.42071799842722,NaN,NaN,22.14762254165674,11.174602502200873
2016-07-22T09:30:00-04:00,113.28,113.78,112.911,113.65,20003363,26694238.55,66.87680880045454,61.26794444012596,NaN,NaN,94.07461888179462,106.74709675829483,0.4354211811006219,1.493373344242201,1.0579521631415791,4521911443,4511028141.6,73.74607794073499,66.06920881650576,NaN,NaN,23.83654269374343,12.983451100992667
2016-07-25T09:30:00-04:00,113.56,113.69,113.28,113.66,12968085,23942006.15,66.9088025586716,62.450294793749904,NaN,NaN,89.52960316555999,100.0108698347716,0.38375906191473597,1.537650990534999,1.1538919286202631,4534879528,4515057603.2,74.54319688616701,68.206768600566,NaN,NaN,25.242299368661943,14.734715139231135
2016-07-26T09:30:00-04:00,113.63,114.2,113.22,113.79,21223845,22500983.25,67.35031216355628,63.45298593511094,NaN,NaN,90.07301985450286,97.65558179650104,0.32903744615487507,1.565188736313857,1.236151290158982,4556103373,4527119174.2,76.81265181833962,70.05155098597145,NaN,NaN,26.546018073297923,16.422044129812104
2016-07-27T09:30:00-04:00,114.76,114.88,114.1,114.58,27646113,22470258.7,69.97223054483423,64.56694961925683,NaN,NaN,108.99417282795265,96.73306950937183,0.31663650995850845,1.6319469276071175,1.315310417648609,4583749486,4539710382,78.92485842609553,71.70813905633342,NaN,NaN,28.416841407399385,18.13558659803886
2016-07-28T09:30:00-04:00,114.76,115.11,114.4,114.98,16939662,21749405.65,71.23193417830863,65.39889014197841,NaN,NaN,114.81570055048516,99.49742305605908,0.305800865847637,1.6975614999581552,1.3917606341105182,4600689148,4559466595.6,81.73610938119693,73.2905788997315,NaN,NaN,30.370651247176696,19.88345297648712
2016-07-29T09:30:00-04:00,115.24,115.54,114.87,115.23,22385320,21053630.7,72.02193525075128,66.16004186138153,NaN,NaN,121.58699698221938,104.99989867614401,0.28624470725748674,1.7495665181823767,1.46332181092489,4623074468,4579699200.6,84.07843675975253,74.7921316325017,NaN,NaN,32.251691017445474,21.650344125195456
2016-08-01T09:30:00-04:00,115.31,116.13,115.17,115.84,13990077,20757994.4,73.90493357502851,66.94399155305904,NaN,NaN,129.6903048100436,113.03203900504074,0.28456981466966225,1.819034079261968,1.5344642645923057,4637064545,4600136204,86.02770710513443,76.09316386137593,NaN,NaN,34.426698215141016,23.47553756661625
2016-08-02T09:30:00-04:00,115.68,115.77,114.22,114.96,21278383,20763518.4,66.90887392246648,67.32075030702657,NaN,NaN,95.51157575401089,114.11975018494236,0.1984534425729716,1.7825310678085202,1.5840776252355486,4615786162,4612072761.8,87.02674485871022,77.28793660115421,NaN,NaN,34.468490508075554,25.04595941539615
2016-08-03T09:30:00-04:00,114.88,115.35,114.8005,115.34,15011273,20285118.55,68.30417441981048,67.6362176005091,NaN,NaN,96.34078072862394,111.58907176507662,0.14388309042091318,1.76393148826169,1.620048397840777,4630797435,4621482351.6,87.76915992448347,78.36910652076645,NaN,NaN,34.88085590643701,26.450944628401988
2016-08-04T09:30:00-04:00,115.32,115.78,115.03,115.67,12835296,19968795.95,69.50665027295342,68.10493034919611,NaN,NaN,106.24106110968687,109.87414387691697,0.10842701859673909,1.7555821710867008,1.6471551524899617,4643632731,4630071068.2,88.42053136443823,79.44296237192798,NaN,NaN,35.555418085231146,27.751583693663296
2016-08-05T09:30:00-04:00,116.28,117.04,116.13,116.78,23196570,19655730.9,73.19090889558979,68.67445436376131,NaN,NaN,146.5169599255947,114.86013646559202,0.1363407239201906,1.8175810573901998,1.6812403334700092,4666829301,4638822034.8,89.05983716945074,80.50661971252869,NaN,NaN,37.2326075941301,29.10601567944427
2016-08-08T09:30:00-04:00,116.82,116.87,116.28,116.65,12358181,19262714.75,72.0923104628625,69.32997928264534,NaN,NaN,127.51691653452305,114.42545881048791,0.12306544410231934,1.8350721385979085,1.7120066944955892,4654471120,4642303349.8,89.31262891275564,81.6991350626082,NaN,NaN,38.31557197227603,30.421666578420236
2016-08-09T09:30:00-04:00,116.73,117.29,116.67,116.92,13276458,18831230.4,72.9988145402351,69.7633054869621,NaN,NaN,128.41388871384515,121.00592140245476,0.10991619295188815,1.8494019356854494,1.7394857427335613,4667747578,4652695633,90.05162728506225,82.86817705157965,NaN,NaN,39.48069597212929,31.715813634664386
2016-08-10T09:30:00-04:00,116.96,117.02,116.31,116.62,14688405,18510262.55,70.26767653183826,70.10974043695433,NaN,NaN,105.0034319526867,122.73845164726731,0.06090864998847301,1.8156215552191526,1.7547129052306796,4653059173,4657147980.6,90.35920043438668,84.133483447622,NaN,NaN,39.74412010404302,32.862714558861335
2016-08-11T09:30:00-04:00,117.01,117.37,116.78,117.12,12969799,18115203.2,72.13863303999696,70.48558502549307,NaN,NaN,115.70482340789903,124.63120410690973,0.04291018871076324,1.8083506411191337,1.7654404524083704,4666028972,4661627228.8,90.67166533419704,85.34245397572643,NaN,NaN,40.47873082807874,33.95071688303525
2016-08-12T09:30:00-04:00,116.91,117.21,116.79,117.2,19379036,18184189.4,72.4374865274893,70.88049102326576,NaN,NaN,106.88260767533502,116.70433365685781,0.01838990836579324,1.788427837865612,1.7700379294998188,4685408008,4665342970.2,90.93416046363404,86.51323708840265,NaN,NaN,41.17338451151406,34.982526544246504
2016-08-15T09:30:00-04:00,117.33,117.97,117.31,117.7,11777762,17737381.3,74.29342998845536,71.37642801075856,NaN,NaN,125.20892044165518,116.24273443828424,0.017828776273997704,1.7923238998423159,1.7744951235683182,4697185770,4673885900.2,91.52466095263333,87.56409488370934,NaN,NaN,42.283593948137025,36.02553617337372
2016-08-16T09:30:00-04:00,117.47,117.49,117.03,117.05,14161446,17498618.5,67.89313728509964,71.22792134934893,NaN,NaN,92.26265050124796,109.01248679576479,-0.04111675916490465,1.7230991746121873,1.764215933777092,4683024324,4676941249.4,91.73207932595471,88.47889637655643,NaN,NaN,41.49888306317193,36.80744287191632
2016-08-17T09:30:00-04:00,117.08,117.3,116.43,117.26,15980334,17047738.75,68.82749202432501,71.05617548120725,NaN,NaN,74.26764276323833,102.86532895787511,-0.07858958086294243,1.6659789576984139,1.7445685385613563,4699004658,4686130346.4,92.33931129004021,89.2362679414738,NaN,NaN,41.08283091158575,37.4182125918691
2016-08-18T09:30:00-04:00,117.15,117.46,116.945,117.29,10036285,16605284.65,68.96643361058813,70.83792536405274,NaN,NaN,79.29811594306032,95.58398746490738,-0.11194739228484685,1.6046342982052977,1.7165816904901445,4709040943,4694732740.6,92.86743452811842,89.86405349635709,NaN,NaN,40.770459389944314,37.897104991594134
2016-08-19T09:30:00-04:00,117.1,117.52,116.76,117.26,18742961,16542264.55,68.63697313992836,70.4616424758313,NaN,NaN,69.98678880778408,88.20482369139718,-0.1445512324681657,1.5358926499049375,1.6804438823731032,4690297982,4695710735.4,92.92713322194722,90.356869647558,NaN,NaN,40.42246810813658,38.2578711511002
2016-08-22T09:30:00-04:00,117.09,117.55,116.87,117.35,14500622,16618891.4,69.11366513599485,70.61912756251189,NaN,NaN,69.68390565625674,77.09982073431749,-0.16698576975167478,1.4717116701835096,1.6386974399351844,4704798604,4697233302.2,93.02501166251862,90.78531727640146,NaN,NaN,40.238325080597406,38.54079314102837
2016-08-23T09:30:00-04:00,117.79,118.0095,117.51,117.56,11997927,16157595.5,70.2499042274333,70.75810826305637,NaN,NaN,95.9826356820578,77.84381777047948,-0.17383161546886083,1.4214079205991084,1.5952395360679692,4716796531,4703987743.6,93.45755479714096,91.191631195877,NaN,NaN,40.35261230085317,38.799624449574765
2016-08-24T09:30:00-04:00,117.49,117.64,116.41,116.8,17728656,15661722.65,61.440667916664275,70.18196666617857,NaN,NaN,36.13588292459981,70.21746580275178,-0.2320548372596627,1.3051709894933907,1.5372258267530534,4699067875,4704000387,93.45837256656145,91.55147699602865,NaN,NaN,38.08416641565708,38.6974161590151
2016-08-25T09:30:00-04:00,116.48,116.97,116.36,116.61,24266264,16028052.75,59.43410427957631,69.19933776503476,NaN,NaN,2.7736780497758757,54.91257822409489,-0.2825232772425881,1.1840717301998183,1.4665950074424063,4674801611,4697152520.6,87.10764981489487,91.4120350421318,NaN,NaN,35.595171942443095,38.254238413790524
2016-08-26T09:30:00-04:00,116.66,117.54,116.08,116.78,23895963,16103584.9,60.67170936131481,68.38358054349563,NaN,NaN,11.863264887665972,43.28787344007124,-0.30186724453260383,1.0892609517766516,1.3911281963092554,4698697574,4698832439,87.33501666926497,91.2707770247396,NaN,NaN,33.76791508586302,37.61333508122945
2016-08-29T09:30:00-04:00,116.81,117.251,116.79,116.94,11184872,15963324.65,61.85136635369841,67.5873342444573,NaN,NaN,29.87527171100531,35.32614665102096,-0.30063911271662547,1.0153293054134735,1.315968418130099,4709882446,4699849207.4,87.47894769699732,91.0870141970207,NaN,NaN,32.48817054189478,36.88116871846736
2016-08-30T09:30:00-04:00,116.73,117.09,116.16,116.56,19843301,15891570.55,57.44433463345241,66.67138125171546,NaN,NaN,-38.686286025360324,8.392362309537331,-0.32035748953860677,0.9155215562068406,1.2358790457454474,4690039145,4694497730.2,82.18501099834374,90.5031435230176,NaN,NaN,30.16186896618589,35.92126875385572
2016-08-31T09:30:00-04:00,116.38,116.56,115.95,116.44,16169794,15949496.6,56.08530692300273,65.52471510050158,NaN,NaN,-112.95094422231054,-21.425003119844735,-0.3348483101645785,0.8173186580397243,1.1521669682043028,4673869351,4689458025.4,77.43258818490933,89.55749515521133,NaN,NaN,27.811280850860033,34.76269905342777
2016-09-01T09:30:00-04:00,116.48,116.88,115.91,116.74,20944727,16354968.15,58.71496030380073,64.54453465595239,NaN,NaN,-103.68295144067969,-42.71632901793585,-0.31773636124417304,0.7549965166490864,1.0727328778932594,4694814078,4693460518.8,78.49611767923211,88.66906352775405,NaN,NaN,26.41069436875241,33.56955552704557
2016-09-02T09:30:00-04:00,117.32,117.56,116.68,117.12,18088215,16099550.4,61.83261549263222,63.65447647767932,NaN,NaN,35.02934965298276,-38.08311206487249,-0.27588384671390775,0.7278780695008749,1.0037619162147826,4712902293,4696301462.6,79.24382529362352,87.79186098068193,NaN,NaN,25.998905861428778,32.48803414624317
2016-09-06T09:30:00-04:00,117.29,117.85,117.06,117.85,18525231,16407902.9,66.98974667041719,63.58994857663056,NaN,NaN,132.5759140673455,-17.542983593604458,-0.1977534255050596,0.7565701343334581,0.9543235598385177,4731427524,4700610478.2,80.35932982422482,86.97952173055835,NaN,NaN,27.13627864177934,31.723497645605484
2016-09-07T09:30:00-04:00,117.95,118.12,117.47,117.92,17546872,16621423.6,67.44400883235917,63.49112834863301,NaN,NaN,162.19751586694332,22.63377678485627,-0.14264937905560682,0.7760118360190091,0.918661215074616,4748974396,4712397528.4,83.04383051485769,86.31555881804533,NaN,NaN,28.20327722293101,31.220609013794846
2016-09-08T09:30:00-04:00,117.57,117.6,116.92,117.23,20125319,16893269.3,58.84751132656337,62.768348185488385,NaN,NaN,33.398734352119696,51.90371249974231,-0.15304276109189474,0.7273577637097475,0.8804005248016422,4728849077,4723393473.6,85.09105823242876,85.76010336835319,NaN,NaN,26.59596709516326,30.559945882561763
2016-09-09T09:30:00-04:00,116.23,116.51,114.26,114.28,50813287,18785443.7,37.084209050244496,60.51457932193954,NaN,NaN,-319.76722261727457,8.68685826442334,-0.3478229289644206,0.44562186359611644,0.793444792560537,4678035790,4720037816,81.84353303231532,84.96841764052235,NaN,NaN,15.616879055448019,28.425222050116943
2016-09-12T09:30:00-04:00,113.64,116.49,113.63,116.33,39645960,19798789.9,50.722547639749585,59.20092807220773,NaN,NaN,-189.66977044607893,-36.252965755389,-0.3280813858738396,0.3833430602182375,0.7114244460920771,4717681750,4720993707.4,82.05364962268342,84.18474892339125,NaN,NaN,12.309566004781129,26.122985472211827
2016-09-13T09:30:00-04:00,115.73,116.09,114.73,115.29,45863935,21503098.55,45.35151525413721,57.422471716972304,NaN,NaN,-168.44038388378058,-96.45622534561421,-0.3713654919920337,0.24721758110203496,0.6185830730940687,4671817815,4709071765.6,71.01530202894008,82.58173086851977,NaN,NaN,7.5017498682014905,23.462808957353207
2016-09-14T09:30:00-04:00,115.43,116.47,115.38,115.84,28221762,22206114.35,48.45977332594714,56.4952649604925,NaN,NaN,-92.55883206104109,-147.4074949312111,-0.34956732711241045,0.18162391420355561,0.5311912413159661,4700039577,4699284801.8,63.46714706430388,80.43950047550138,NaN,NaN,5.246744807951499,20.860514078867247
2016-09-15T09:30:00-04:00,115.89,117.815,115.86,117.64,39466531,23380424.2,57.06636343574915,56.326140614504844,NaN,NaN,39.66470161469624,-146.1543014786958,-0.2075507370264404,0.27175282003291557,0.47930355705935596,4739506108,4701416208,64.35569716458716,78.81436100047938,NaN,NaN,7.006225151736563,18.881329946420006
2016-09-16T09:30:00-04:00,117.22,117.412,116.71,117.29,27596527,24258436.3,55.13831256040441,55.93089798586839,NaN,NaN,43.989251453622046,-73.40300666451647,-0.13436323845774267,0.3113495089871776,0.4457127474449203,4711909581,4708190966.2,67.09518888188086,77.36865901566624,NaN,NaN,7.547664192922686,17.26223483877753
2016-09-19T09:30:00-04:00,117.57,117.95,116.55,116.78,16222870,24132431.75,52.36216405880567,55.253097821947485,NaN,NaN,39.85186415038429,-27.498679745223818,-0.11805767583406757,0.2981406526523358,0.41619832848640337,4695686711,4703791958.4,63.673173339070615,75.6682465615286,NaN,NaN,6.9560625454397575,15.78992451115785
2016-09-20T09:30:00-04:00,117.19,117.48,116.8,117,18078584,24311329.85,53.45093708621859,54.96785514000221,NaN,NaN,41.20274529550745,14.42994609063378,-0.09140340130017066,0.30194407686119007,0.39334747816136073,4713765295,4712181454.4,67.11762144034319,74.59200445024285,NaN,NaN,6.873613482383706,14.516165792761544
2016-09-21T09:30:00-04:00,117.48,118.32,116.81,118.15,31546776,25288772.3,58.7572492498472,55.158708163348244,NaN,NaN,114.91359014920012,55.92443053268202,-0.00010126155298245676,0.39322090122013265,0.3933221627731151,4745312071,4721235953.2,70.38173341808451,74.08837196689822,NaN,NaN,8.6534195468683,13.678630614776795
2016-09-22T09:30:00-04:00,118.85,119.22,118.7177,119.09,22614422,25533060.6,62.518352228910246,55.43037901514178,NaN,NaN,212.27654078148024,90.44679836603882,0.11353322003129895,0.5352386878122388,0.42170546778093987,4767926493,4726920030.2,72.2443901195849,73.641819998352,NaN,NaN,11.437011629076967,13.35839933110539
2016-09-23T09:30:00-04:00,118.92,119,118.16,118.33,22213394,25430417.1,57.91936881289132,55.150861395160284,NaN,NaN,141.7885397527735,110.00665602586909,0.12645947986910544,0.5797798176173217,0.45332033774821623,4745713099,4733680733.8,74.31354932153975,73.28965742891744,NaN,NaN,12.150235093227577,13.18580443997999
2016-09-26T09:30:00-04:00,117.66,117.8,117.17,117.34,16403881,25055813,52.501456656187685,54.115983537001036,NaN,NaN,42.78324869517418,110.59293293482708,0.0606198720455442,0.5290951778051465,0.4684753057596023,4729309218,4740405235.2,76.21303102154417,72.99349322872597,NaN,NaN,10.902613117773717,12.859634251093379
2016-09-27T09:30:00-04:00,117.31,118.5552,117.15,118.5,20238432,25508491,57.51609942858948,53.40684715101749,NaN,NaN,89.70145377429446,120.2926746305845,0.08593257761462636,0.5758910277778853,0.4899584501632589,4749547650,4747561706.2,78.07153209377705,72.63832905579164,NaN,NaN,11.584920056196669,12.677532223250992
2016-09-28T09:30:00-04:00,118.62,118.77,118.09,118.7,14794330,25256042.45,58.33288827096158,53.370088361331646,NaN,NaN,116.96812312341,120.70358122542648,0.10559003845954629,0.6219459982376918,0.5163559597781455,4764341980,4751367688,79.01076395438275,72.20402232164551,NaN,NaN,12.381642704768339,12.635262292039185
2016-09-29T09:30:00-04:00,118.51,118.72,117.3338,117.84,27207499,25807927.7,53.56405640949965,54.54722031556416,NaN,NaN,64.32427994101698,91.11312905733382,0.05278504018871799,0.5823372600140431,0.5295522198253251,4737134481,4745209285.6,73.5232544147772,71.60971670610705,NaN,NaN,11.510367388598334,12.474563020119064
2016-09-30T09:30:00-04:00,118.145,119.07,118.03,118.72,25543200,26037851.35,57.401659984124116,55.02429976873377,NaN,NaN,104.7936889574664,83.7141588982724,0.0682525288995477,0.6148678809497596,0.546615352050212,4762677681,4748602202,74.5711210699783,71.07525038091383,NaN,NaN,12.02182403542495,12.409886022305619
2016-10-03T09:30:00-04:00,118.53,118.7,118.09,118.55,19216438,26094262.5,56.43142312280083,55.8157217593526,NaN,NaN,82.55339855130454,91.66818886949847,0.058536950147605404,0.6197865397347186,0.5612495895871132,4743461243,4751432607,75.44420408739997,71.3916005279467,NaN,NaN,12.13200730909137,12.370189063275012
2016-10-04T09:30:00-04:00,118.86,119.16,117.92,118.37,21239742,26229988.05,55.36435576129136,56.30890621902004,NaN,NaN,78.33537376107012,89.39497286685359,0.032774825091138604,0.6022181209510364,0.5694432958598978,4722221501,4745967377.2,70.41674223473011,71.88800018297714,NaN,NaN,11.910064134167605,12.304456930545383
2016-10-05T09:30:00-04:00,118.7,119.17,118.67,118.79,14481285,26076708.7,57.38902361711191,56.331953374831656,NaN,NaN,97.91184680253717,85.58371760267903,0.03652142668415781,0.6150950792150951,0.5785736525309373,4736702786,4740439538.4,65.65135474235022,71.98054715281735,NaN,NaN,12.305255581326955,12.304571023514178
2016-10-06T09:30:00-04:00,118.63,118.981,118.15,118.73,11987056,25669795.55,56.99131290761028,56.46431054248922,NaN,NaN,72.45041179440628,87.20894397335687,0.027851405064141188,0.6133879088611138,0.5855365037969726,4724715730,4737955788.2,63.56969544288079,71.72872619288877,NaN,NaN,12.520884270357758,12.335472915920404
2016-10-07T09:30:00-04:00,118.86,119.01,117.89,118.47,19984158,24128339.1,55.205931638986776,56.66743679821645,NaN,NaN,56.61505145141728,77.57321647214704,-0.0009736303254153089,0.5843194658902036,0.5852930962156189,4704731572,4726366566.4,54.83314207234913,71.09729538812296,NaN,NaN,12.225514374953738,12.319764552925166
2016-10-10T09:30:00-04:00,119.06,119.48,119.03,119.22,19687341,23130408.15,59.17860412146693,57.07655587216276,NaN,NaN,110.74312307359526,83.21116137660519,0.02353767766432191,0.6147151932960213,0.5911775156316994,4724418913,4722558100.4,52.28989661085641,70.03817218601675,NaN,NaN,13.065308917703502,12.426270890750644
2016-10-11T09:30:00-04:00,119.1,119.14,117,117.52,27774426,22225932.7,48.647077099754384,56.3544007185847,NaN,NaN,-12.24849759598585,65.094387105194,-0.07621267436218226,0.4959116726789716,0.5721243470411539,4696644487,4717442697.6,49.00231756756018,68.51107105383646,NaN,NaN,10.588202113155793,12.163689636808522
2016-10-12T09:30:00-04:00,117.575,117.82,117.06,117.42,14267824,21528235.8,48.10476352501943,55.32485866830678,NaN,NaN,-73.97039086808688,30.717939571069216,-0.1463367830462291,0.38920336823336754,0.5355401512795966,4682376663,4706577473,42.8411490746111,66.41083955062405,NaN,NaN,8.43982864096771,11.631709494545548
2016-10-13T09:30:00-04:00,116.635,117.32,115.94,117,22821011,20695959.8,45.79561638800444,54.45887635224343,NaN,NaN,-144.62397349283808,-12.696937486379653,-0.21430383599932173,0.2676603562804445,0.4819641922797662,4659555652,4693545457.4,36.85555824569961,63.735268759492605,NaN,NaN,5.954257682460695,10.820644949961999
2016-10-14T09:30:00-04:00,117.58,118.05,117.07,117.14,21313321,20381799.5,46.71382528321508,54.04547411131682,NaN,NaN,-74.65173170707119,-38.95029411807735,-0.24112960945398448,0.1805521804622856,0.4216817899162701,4680868973,4688772937.6,34.930803826867105,60.7865382455871,NaN,NaN,4.159636099398948,9.86907225702442
2016-10-17T09:30:00-04:00,117.1,117.3,116.672,116.82,14182694,20279790.7,44.84392962220425,53.14031912514645,NaN,NaN,-127.0515783933748,-86.50923441147135,-0.2695691167867547,0.08472039393282671,0.3542895107195814,4666686279,4677226410.8,30.74706716712302,57.40621932225467,NaN,NaN,2.114532032869814,8.761280796430906
2016-10-18T09:30:00-04:00,118.18,118.41,117.8,117.86,19276656,20339694.3,51.62175116861564,52.66095218926459,NaN,NaN,-11.849842244733473,-86.4295033412209,-0.2101228099452666,0.09163599828799818,0.3017588082332648,4685962935,4675090100.4,30.030404771431662,53.90762223775816,NaN,NaN,2.2223192881179505,7.827143438100484
2016-10-19T09:30:00-04:00,117.77,118.02,117.64,117.85,13702918,19447501.4,51.55614742631436,52.51753011903707,NaN,NaN,-35.01091838620739,-78.63760884484498,-0.16523728566671003,0.09521220114987727,0.2604494868165873,4672260017,4673066771.2,29.333048048881878,50.7511789259085,NaN,NaN,2.291708229562459,7.03636697973791
2016-10-20T09:30:00-04:00,117.68,117.97,117.03,117.71,18132245,19223392.55,50.58687370026174,52.03075967018976,NaN,NaN,-61.053189609482004,-61.923452068173766,-0.1397508382600484,0.08576093899152681,0.2255117772515752,4654127772,4671981195.2,28.94468226531923,47.49214758271855,NaN,NaN,2.0897667015447974,6.329709797138894
2016-10-21T09:30:00-04:00,117.8,118.22,117.41,118.15,15707804,18898113.05,53.543022296176126,51.82444532543086,NaN,NaN,-12.892139545646156,-49.571533635888755,-0.09042663265820969,0.11247848642881308,0.20290511908702277,4669835576,4669774515.8,28.129400126572108,44.11251872837371,NaN,NaN,2.718985891090382,5.813892096274821
2016-10-24T09:30:00-04:00,118.93,119.65,118.8918,119.57,19142985,19035068.25,61.53981211697368,52.265549350836736,NaN,NaN,150.61322024404905,5.961426091596003,0.03400037273278084,0.2454055850029988,0.21140521227021797,4688978561,4674232972.2,32.27977657680273,41.38844975280747,NaN,NaN,5.786041927069126,5.809913500674008
2016-10-25T09:30:00-04:00,119.62,119.66,119.01,119.19,20341835,19040238.4,58.63127887721905,52.35428186941581,NaN,NaN,120.98053721309488,32.52750198316166,0.08402840022130564,0.31644071254685,0.23241231232554438,4668636726,4670767730.4,30.79144402384668,38.89845613005722,NaN,NaN,7.48198399586936,6.048780714273344
2016-10-26T09:30:00-04:00,118.41,119.03,118.03,118.38,20463696,19323706.7,52.892755398745955,52.06152776163979,NaN,NaN,32.898809687432944,46.109447597889734,0.057168924677028166,0.3038734681718296,0.24670454349480142,4648173030,4665950333,28.80318232296905,36.41513376434924,NaN,NaN,7.21044380618065,6.214732584545817
2016-10-27T09:30:00-04:00,118.9,118.99,117.67,117.84,19099790,18918321.25,49.42005404793074,51.64825079085007,NaN,NaN,-2.711336248194255,57.77781827014728,0.0006263395688158313,0.24748746795582122,0.24686112838700539,4629073240,4660939426.6,26.86031521689921,34.417074703245675,NaN,NaN,5.916273298412324,6.172095543669603
2016-10-28T09:30:00-04:00,117.47,118.11,116.74,117.1,35369254,19409623.95,45.05456696629469,50.63939099405205,NaN,NaN,-87.53828746045862,42.8485886871848,-0.08432194813121499,0.14145869322298665,0.22578064135420164,4593703986,4645713108.6,22.003444138528366,32.25375666950795,NaN,NaN,3.435167423726288,5.7811058122491294
2016-10-31T09:30:00-04:00,117.53,117.53,116.93,116.99,18749357,19386269.9,44.42634128111559,50.337909864149275,NaN,NaN,-94.51253334605852,-6.176562030836715,-0.14222393531277613,0.048000722213231484,0.19022465752600762,4574954629,4622908322.2,17.035150623720355,29.97038760209082,NaN,NaN,1.2480372394412507,5.13352458756229
2016-11-01T09:30:00-04:00,117.19,117.21,115.1047,116.11,23498712,19499218.4,39.66177193742639,49.73483903646406,NaN,NaN,-171.12430163455514,-64.59752980036671,-0.22895395147879044,-0.09596778182248045,0.13298616965631,4551455917,4599472160.4,13.629239158493888,27.88382260808245,NaN,NaN,-2.166545478584726,4.090657435255573
2016-11-02T09:30:00-04:00,116.05,116.3,114.89,115.18,26960093,20123158.8,35.347329565883854,48.988532834884026,NaN,NaN,-198.29400354979737,-110.83609244781277,-0.33187533778139255,-0.2818580025704307,0.050017335210961855,4524495824,4574736719.2,11.105505286055362,26.044533110965006,NaN,NaN,-6.548291073857001,2.5708076482394913
2016-11-03T09:30:00-04:00,115.02,115.37,113.92,114.05,36205193,21334065.65,30.942863757515624,47.862035583048346,NaN,NaN,-230.09462316000327,-156.3127498301746,-0.4515569738043796,-0.5144288820445126,-0.06287190824013306,4488290631,4546580197.4,9.05097966832831,24.19597424249795,NaN,NaN,-11.882459670155308,0.5060551741830914
2016-11-04T09:30:00-04:00,113.72,114.54,113.45,113.65,26997454,21684730.45,29.53969819043614,46.76887619506491,NaN,NaN,-217.10635838513895,-182.22636401511065,-0.5278536162564877,-0.7226889285607427,-0.19483531230425502,4461293177,4520098035.6,7.622622653779899,22.54422820583059,NaN,NaN,-16.650211024526172,-1.9448399970610892
2016-11-07T09:30:00-05:00,115.45,116.47,115.3,116.35,26591245,22029925.65,47.00789393593478,46.43931496415913,NaN,NaN,-71.38353020537942,-177.60056338697484,-0.3739199461737781,-0.6622352450214777,-0.2883152988476996,4487884422,4502683994.2,6.856379112090252,20.888940658734775,NaN,NaN,-14.740288750593422,-3.772761247565708
2016-11-08T09:30:00-05:00,116.21,117.64,115.96,117.11,20777919,21680100.3,50.711967032958114,46.379016364633685,NaN,NaN,-14.231301534500169,-146.22196336696385,-0.20670586245836925,-0.5466976269206612,-0.3399917644622919,4508662341,4494125279,6.510011066955045,19.25872373145429,NaN,NaN,-11.875485244426777,-4.930293247117289
2016-11-09T09:30:00-05:00,115.71,117.84,115.6,117.65,70234393,24478428.75,53.21430685628599,46.56669016149256,NaN,NaN,-4.913562895291778,-107.54587523606271,-0.053502272905943615,-0.4068696055947214,-0.3533673326887778,4578896734,4505005461,12.557535780637664,18.088213268262745,NaN,NaN,-8.75018581422103,-5.475992185274967
2016-11-10T09:30:00-05:00,118.14,118.38,114.195,115.75,72825446,26978650.5,44.62882327977887,45.929961660321325,NaN,NaN,-60.007481067594114,-73.52844681758089,-0.07270453220052003,-0.4442479979394278,-0.3715434657389078,4506071288,4508561592.4,14.504167571795989,17.114982371493024,NaN,NaN,-9.168553950464819,-6.003501008873517
2016-11-11T09:30:00-05:00,115.21,116.05,114.84,115.8,41115166,27968742.75,44.88084616592512,44.74003552096071,NaN,NaN,-83.20504216678403,-46.7481835739099,-0.07435067055365752,-0.4644818039309797,-0.3901311333773222,4547186454,4525740247.8,23.377995159019235,16.47914084165135,NaN,NaN,-9.396106756541101,-6.488158972826029
2016-11-14T09:30:00-05:00,115.84,115.94,114.03,114.63,35905979,29054907,40.26277641746685,43.42799963097841,NaN,NaN,-107.09028426620304,-53.88953438607463,-0.14259476876647004,-0.5683745943354097,-0.4257798255689397,4511280475,4530419458.4,25.641921575227656,16.111317809607133,NaN,NaN,-11.17255762269323,-7.157358779949915
2016-11-15T09:30:00-05:00,115.47,116.62,115.33,116.22,31796602,29680904.3,48.081213266338246,43.08431805009214,NaN,NaN,-38.69769242105867,-58.78281256338632,-0.07254195514735651,-0.5164572695031353,-0.4439153143557788,4543077077,4537302405.6,28.966660570667827,16.1229948272999,NaN,NaN,-9.911049072936438,-7.550743107519418
2016-11-16T09:30:00-05:00,115.7,116.9932,115.67,116.91,16538132,29822665,51.07384083403731,43.202445677671186,NaN,NaN,-10.496082179550461,-59.899316420238065,0.0232498396584912,-0.4148530147826648,-0.438102854441156,4559615209,4533446100.6,28.205724315625133,16.2190954772089,NaN,NaN,-7.875515093103545,-7.597139105460007
2016-11-17T09:30:00-05:00,116.86,117.78,116.61,117.76,20598553,29945980.4,54.549382085194125,43.88064675759257,NaN,NaN,37.800922798184736,-40.337635647082294,0.1403106001763953,-0.26271460422066184,-0.40302520439705714,4580213762,4548274595.4,35.24946829940464,17.16524006012863,NaN,NaN,-5.0377585110826875,-7.231513306263247
2016-11-18T09:30:00-05:00,117.83,118.1,117.21,117.32,16428659,29982023.15,52.47148923711349,44.455300183020995,NaN,NaN,48.561816978084934,-13.984263818108499,0.18192123528968135,-0.17562366028495546,-0.3575448955746368,4563785103,4551594325.2,36.74568417281344,18.57313531363528,NaN,NaN,-3.438224189471513,-6.689614861007286
2016-11-21T09:30:00-05:00,117.6,118.65,117.57,118.54,20268547,30038301.25,57.32542831634734,45.7169899243725,NaN,NaN,96.50893955403791,26.735580945939695,0.2795825819034486,-0.008066668195326088,-0.2876492500987747,4584053650,4566148960.2,42.96800949225874,20.668761766047055,NaN,NaN,-0.4648186233826372,-5.800358255632336
2016-11-22T09:30:00-05:00,118.97,119.19,118.61,118.9,18850641,29963741.55,58.66685194479959,47.38267009429505,NaN,NaN,138.48795224146534,62.17270987844449,0.3517354432946782,0.15202005401957308,-0.19971538927510513,4602904291,4578114403,47.537073124081424,23.271016611620347,NaN,NaN,2.3407354856613365,-4.637344864018954
2016-11-23T09:30:00-05:00,118.51,118.64,117.9,118.42,22925954,30086854.45,56.13323880821447,49.181982597916395,NaN,NaN,104.64752695346074,85.20143170504673,0.34970919427794855,0.2374211035723306,-0.11228809070561797,4579978337,4582187028.6,49.0337289204924,26.12692727248921,NaN,NaN,3.8783251186915613,-3.4208205807745946
2016-11-25T09:30:00-05:00,118.56,118.85,118.42,118.8,7162785,29490004.2,57.691022281405026,51.19279146155703,NaN,NaN,122.66432202519546,102.17411155044888,0.35538126815790705,0.3319384944917658,-0.02344277366614121,4587141122,4583572500.6,49.560891732206365,29.12251792094824,NaN,NaN,5.607611186825455,-2.1310446139745878
2016-11-28T09:30:00-05:00,118.64,119.08,118.4101,118.53,13479045,28395493.75,56.164858846009665,51.846860383705234,NaN,NaN,110.92126870835769,114.64600189650344,0.32328969492489895,0.3806693449899825,0.05737965006508354,4573662077,4585547895.4,50.34943751805067,32.229164949945414,NaN,NaN,6.603422217000111,-0.8832636381210592
2016-11-29T09:30:00-05:00,118.63,119.51,118.3,118.94,18552957,28385673.75,57.982578820411085,52.36618979709474,NaN,NaN,111.33888343395779,117.6119906724874,0.3118700613690891,0.44721722677644493,0.1353471654073558,4592215034,4587180172.2,51.030689980560226,35.409213443774355,NaN,NaN,7.956641891771052,0.379580009006385
2016-11-30T09:30:00-05:00,119.06,119.1335,117.46,117.5,30405342,28731005.25,50.12134669333404,52.1452640711696,NaN,NaN,59.19644746964159,101.75368971812266,0.19523234216461338,0.37938759311312253,0.18415525094850915,4561809692,4578961252.4,47.49679351262285,37.90487471034472,NaN,NaN,6.835391286510683,1.3018387629355703
2016-12-01T09:30:00-05:00,117.46,117.47,115.29,115.47,39796590,29372830.1,41.565804897276735,51.92647704384802,NaN,NaN,-43.979809755923284,72.02822237624585,-0.019337088387660017,0.15998389046393413,0.17932097885159415,4522013102,4567368205.4,42.975988333121336,39.938576193296534,NaN,NaN,2.922332409138529,1.5333378552502788
2016-12-02T09:30:00-05:00,115.57,116.16,115.22,115.7,32876845,29206412.7,42.758023484844045,51.774846852342215,NaN,NaN,-70.99153689004307,33.29705059319814,-0.13976814088764655,0.004610802742035958,0.1443789436296825,4554889947,4560917970.4,40.65724806547866,41.172808543757924,NaN,NaN,0.19911686637245368,1.3427348568391608
2016-12-05T09:30:00-05:00,116.32,117.06,115.77,116.6,21419667,28927523.35,47.28993796988957,52.276786963229554,NaN,NaN,-38.67497144832604,3.3778025618613965,-0.15180549238986601,-0.045377921857649994,0.106427570532216,4576309614,4561447477.8,40.938962101378564,42.265454295625844,NaN,NaN,-0.6890881128836553,1.0524744325930442
2016-12-06T09:30:00-05:00,116.88,117.08,116.39,116.88,27293348,28962628.5,48.65198147518417,52.317556121004266,NaN,NaN,-22.725956224651796,-23.435165369860524,-0.1344937103278062,-0.06168956737754172,0.07280414295026447,4603602962,4563725063.4,42.20977766909605,43.211391231227864,NaN,NaN,-0.9981635852590338,0.7595261443284615
2016-12-07T09:30:00-05:00,116.64,118.51,116.2919,118.36,26622442,29254854.65,55.23631274161638,52.6148755429742,NaN,NaN,33.88296974097926,-28.497860915592998,-0.02280623720460244,0.044296346444511414,0.06710258364911385,4630225404,4577408205.8,49.27176630392191,44.7161085161062,NaN,NaN,0.8234435960295196,0.7686572088571841
2016-12-08T09:30:00-05:00,118.4,118.87,118.18,118.57,18578433,26672056.65,56.09657068345598,52.72538901427862,NaN,NaN,76.73213764298958,-4.3554714358104105,0.061182795798222375,0.14358107839689183,0.08239828259866945,4648803837,4602766352.8,59.21797904642151,46.42814499803598,NaN,NaN,2.546499495390648,1.0226346783619646
2016-12-09T09:30:00-05:00,119.03,119.5402,119,119.5,21863133,24123941,59.782649608271896,53.247614755075645,NaN,NaN,113.41493419317909,32.52582278083402,0.16921740922734177,0.29392004413284667,0.1247026349055049,4670666970,4625921757.4,65.81010265731443,48.50417488978605,NaN,NaN,5.168633932710367,1.6149202861260221
2016-12-12T09:30:00-05:00,118.95,119.21,118.47,118.96,23259310,23231148.2,56.80060169999615,53.21012713962199,NaN,NaN,79.64318065807105,56.18945320211344,0.19246232715590728,0.365280543850389,0.17281821669448172,4647407660,4640141366.6,69.11201917035068,50.371604152506904,NaN,NaN,6.461421955146599,2.307277667414676
2016-12-13T09:30:00-05:00,119.35,121.11,119.32,120.46,54477889,24159743.7,62.40974922698522,53.47747694549239,NaN,NaN,155.90523634052695,91.9156917151492,0.29109354319917785,0.536685145693454,0.2455916024942762,4701885549,4659797884,72.99461561405748,52.19000004464805,NaN,NaN,9.417549497021717,3.3230307859299675
2016-12-14T09:30:00-05:00,120.56,121,119.86,120.21,28745991,24007213.15,60.98840306986536,53.82427439275317,NaN,NaN,146.5614505343308,114.4513878738195,0.3194606463520896,0.6449174104343882,0.3254567640822986,4673139558,4668380714.8,74.50174930830417,54.009144358063175,NaN,NaN,11.366466501902497,4.4720930310689
2016-12-15T09:30:00-05:00,120.37,121.11,120.08,120.4,22762305,24318421.8,61.70227236736197,54.1107922560358,NaN,NaN,143.81649783669494,127.86825991256057,0.3296521710122122,0.7375219778475639,0.4078698068353517,4695901863,4677800320,76.07956858332142,55.90333556171425,NaN,NaN,13.162390520018013,5.713564100918774
2016-12-16T09:30:00-05:00,120.28,120.5817,119.36,119.6,26283907,24602689.5,56.97480145455479,54.16864529950332,NaN,NaN,91.01960228070361,123.38919353006547,0.2639865074701323,0.737852941173017,0.4738664337028847,4669617956,4677590517.2,75.9668140411093,57.73314817050415,NaN,NaN,13.334203407373801,6.8022268589837775
2016-12-19T09:30:00-05:00,119.74,120.83,119.55,120.09,21138658,24838189.45,59.04460715798344,54.24450446647277,NaN,NaN,100.37710368137321,127.53597813472591,0.23594043822637023,0.7687919814858475,0.5328515432594773,4690756614,4686260308,77.45384662051579,59.62051650192955,NaN,NaN,14.076774291451724,7.841447920764913
2016-12-20T09:30:00-05:00,120.43,120.77,120.33,120.55,11461799,24397852.05,60.94410884238212,55.017558905690485,NaN,NaN,111.03111318757006,118.56115350413452,0.2304915372707499,0.8209659648479146,0.5904744275771647,4702218413,4686326880.8,77.46537670070987,61.76112958679291,NaN,NaN,15.24753454957827,8.899460296309678
2016-12-21T09:30:00-05:00,120.57,120.68,120.19,120.46,7079300,23809285,60.35430687773096,56.35959476143722,NaN,NaN,94.67992755490488,108.18484890824934,0.2038666920734148,0.8453077926689332,0.6414411005955184,4695139113,4690726791.8,78.25681099225281,64.28118834815945,NaN,NaN,16.052250016120958,9.92128739913986
2016-12-22T09:30:00-05:00,120.46,120.5,119.65,120.12,16644996,23495237.1,58.0680105338763,57.45316526493952,NaN,NaN,68.2112680330222,93.06380294751479,0.1489458242686592,0.8276233809313425,0.6786775566626833,4678494117,4687245242.6,75.98279683153439,66.80444183144914,NaN,NaN,16.12334762662038,10.807296003065648
2016-12-23T09:30:00-05:00,119.96,120.25,119.81,120.2,9007470,23587471.35,58.46668334787651,58.25150422051002,NaN,NaN,62.13245026548253,87.28637254447058,0.10563254146264378,0.8107182334909879,0.7050856920283441,4687501587,4690821968.8,76.73087822595947,69.36100726891921,NaN,NaN,16.28622402722348,11.590000006516767
2016-12-27T09:30:00-05:00,120.44,121.52,120.41,120.82,16110554,23719046.8,61.52013520405099,59.17065805828622,NaN,NaN,93.46574031345847,85.90409987088762,0.10608600244632116,0.8376931950862456,0.7316071926399245,4703612141,4693393074.2,77.2787482548113,71.86593373932743,NaN,NaN,17.243906153680776,12.397700884683054
2016-12-28T09:30:00-05:00,121.06,121.19,119.795,119.88,17975235,23690160.7,54.9268751813225,59.14855537540809,NaN,NaN,57.704963920209714,75.23887001741556,0.03415049234646639,0.7742953080730075,0.7401448157265411,4685636906,4690076772.8,74.83137574539184,73.69162012800385,NaN,NaN,16.25970467615145,12.949415712035682
2016-12-29T09:30:00-05:00,119.86,120.13,119.33,119.71,13267519,22833269.55,53.80381825527191,58.984787344823516,NaN,NaN,28.15206647103271,61.93329780064113,-0.030324278854291564,0.7022394671586767,0.7325637460129683,4672369387,4685522827.6,71.48353707454226,74.56773141572675,NaN,NaN,15.127501902651764,13.260570882123695
2016-12-30T09:30:00-05:00,119.93,119.95,118.14,118.48,41749028,22930891.45,46.40999194099771,58.02959751144679,NaN,NaN,-23.46447587876497,43.59814901828369,-0.1543205378870287,0.5396630736541823,0.693983611541211,4630620359,4675948076,64.90838235431794,74.50332282265559,NaN,NaN,11.862695213952524,13.060874358099241
2017-01-03T09:30:00-05:00,119.31,119.99,118.89,119.54,22307608,22402429.6,52.4716857530419,57.72038922952148,NaN,NaN,0.3574671933109989,31.243152403849383,-0.16262944571327387,0.4906968043996187,0.6533262501128926,4652927967,4669033352,60.57501515149787,73.89353682130896,NaN,NaN,10.806637045569541,12.738840456309283
2017-01-04T09:30:00-05:00,119.67,120.41,119.6561,120.19,19749074,22318899.95,55.775143669868456,57.24648883258457,NaN,NaN,36.676705944195355,19.885345529996762,-0.12378677312356856,0.49859278370843185,0.6223795568320004,4672677041,4662846332,56.91373352907477,72.74490238666733,NaN,NaN,10.930312210039677,12.480479278270769
2017-01-05T09:30:00-05:00,120.16,120.95,120.1,120.87,20644254,21986445.25,58.98673962600802,57.10351287230903,NaN,NaN,83.85144281843266,25.114641309641353,-0.055229935478700254,0.5533421374836252,0.6085720729623254,4693321295,4664383209.8,57.599308640661484,71.53758519612143,NaN,NaN,12.029078842021326,12.415993501663706
2017-01-06T09:30:00-05:00,120.99,122.25,120.685,121.93,24074305,21859038.4,63.44333016528603,57.227874143589325,NaN,NaN,189.12067001115548,57.3083620176659,0.052733894895089284,0.6744894415811871,0.6217555466860978,4717395600,4673388452.4,61.468116664159325,70.49391005903843,NaN,NaN,14.422710785000866,12.702667399283301
2017-01-09T09:30:00-05:00,122.03,122.55,121.95,122.33,18909234,21875578.45,64.98935804836955,57.800342471718956,NaN,NaN,240.7088291034158,110.14302301410206,0.13749777314798572,0.79362776312108,0.6561299899730942,4736304834,4694525347.4,68.68955812166314,69.97410606479227,NaN,NaN,16.863131826048345,13.297019460249736
2017-01-10T09:30:00-05:00,122.37,122.97,122.1,122.6,16176631,21591253.35,66.03357092308147,58.29955416922595,NaN,NaN,224.0779049885853,154.88711057315692,0.19466722677134485,0.8994640234372753,0.7047967966659304,4752481465,4714436047,73.69141404307706,69.7053608806895,NaN,NaN,19.17359377528205,14.136530076682924
2017-01-11T09:30:00-05:00,122.63,122.93,122.02,122.93,20685983,21462587,67.3166413874242,58.754735065300395,NaN,NaN,190.02255331645952,185.55628004760973,0.23492948624490362,0.99845865447206,0.7635291682271563,4773167448,4734534128.4,77.58411189278858,69.71384196583797,NaN,NaN,21.4755974528723,15.184968273281406
2017-01-12T09:30:00-05:00,122.49,122.819,121.6,122.74,19622511,19719818.1,65.77603168212906,59.1420011227574,NaN,NaN,136.89614995583176,196.16522147508957,0.22876339279460645,1.0494834092204144,0.8207200164258079,4753544937,4746578856.8,79.53811776222369,69.80536387797875,NaN,NaN,22.954643836184143,16.294921925124655
2017-01-13T09:30:00-05:00,122.81,123.37,122.8,123.16,16930803,19129058.7,67.54427442808372,59.81887711520079,NaN,NaN,156.21225147185783,189.58353776723,0.2322275208884903,1.1110044175364209,0.8787768966479306,4770475740,4757194884.8,81.10177199728952,70.17100496124698,NaN,NaN,24.721243645923547,17.498682170953067
2017-01-17T09:30:00-05:00,122.79,123.03,122.4342,122.79,14538484,18717867.65,64.38814676172458,60.24183878761851,NaN,NaN,112.1686105317158,163.87549405289002,0.19060084204813044,1.1170279492080937,0.9264271071599632,4755937256,4761121369.2,81.66001167804548,70.52308592211027,NaN,NaN,25.359596974285843,18.621670000000606
2017-01-18T09:30:00-05:00,122.96,123.16,122.66,123.04,12499663,18028655.45,65.55916239869165,60.53034073009284,NaN,NaN,107.26199853753937,140.51231276268084,0.16202679195844483,1.1289605971080192,0.9669338051495744,4768436919,4764312460,82.12221524473034,70.86904784996163,NaN,NaN,26.219367165437497,19.707055309348732
2017-01-19T09:30:00-05:00,123.19,123.65,122.72,122.98,12710659,17607255.5,65.0066754784959,61.25032646560522,NaN,NaN,101.96677067951062,122.90115623529107,0.12297900800333983,1.1206575651537491,0.9976785571504093,4755726260,4760824222.4,79.7560268014931,71.22080863968316,NaN,NaN,26.794170678301555,20.719500362056277
2017-01-20T09:30:00-05:00,123.51,123.83,122.92,123.25,22091039,18138717.5,66.3797276184044,62.14860570582896,NaN,NaN,100.34873935464913,115.59167411505454,0.10019297495414214,1.122919775843087,1.022726800888945,4777817299,4765678694.8,80.59402817416688,71.87155800394206,NaN,NaN,27.649452249219465,21.709493488793875
2017-01-23T09:30:00-05:00,123.16,123.53,122.57,123.35,17434167,18656460.85,66.89778727044208,63.61201965793213,NaN,NaN,82.23377523590052,100.79597886786306,0.07771661092899795,1.1198725645501924,1.0421559536211944,4795251466,4770633840,81.43864119917518,73.0522907785747,NaN,NaN,28.510118804358616,22.68101139101741
2017-01-24T09:30:00-05:00,123.59,124.37,123.3847,124.18,17640869,18706254.5,70.90514014938164,64.9286949719564,NaN,NaN,112.03532754579803,100.76932227067951,0.10302235230162404,1.1709338939982246,1.0679115416966005,4812892335,4782024855.8,83.24407488504791,74.67150933097113,NaN,NaN,30.41409156681818,23.78573713041752
2017-01-25T09:30:00-05:00,124.94,125.46,124.85,125.43,15036221,19007692.05,75.6801847946226,66.35048362372456,NaN,NaN,156.41844940430377,110.6006124440324,0.1835190328890821,1.2973103328079532,1.113791299918871,4827928556,4793923183.2,84.89662255222215,76.6702871183388,NaN,NaN,33.69983416408402,25.20203670665559
2017-01-26T09:30:00-05:00,125.59,125.82,125.3438,125.56,16052150,19004771.85,76.11914888155576,67.57422714197796,NaN,NaN,154.41477209999854,121.09021272812997,0.2224944954655499,1.3919094192508084,1.1694149237852585,4843980706,4811574072.4,86.95242240285697,78.76693810135278,NaN,NaN,36.50941893007039,26.817377024286277
2017-01-27T09:30:00-05:00,125.8,125.9211,125.39,125.8,15052983,18858659.25,76.94644171183555,68.53873510958864,NaN,NaN,148.1696648622572,130.6543978296516,0.23991493789901264,1.4693085961590242,1.2293936582600116,4859033689,4827817350.4,88.50328175745689,80.6980213223026,NaN,NaN,39.10276641414562,28.57243265140904
2017-01-30T09:30:00-05:00,125.37,125.38,124.13,124.82,25006715,19445619.05,66.77417969214422,68.66622236985826,NaN,NaN,99.25815110641325,134.05927300375413,0.16450753838787202,1.4350280812448517,1.2705205428569797,4834026974,4835572452,89.16542636879831,82.16058333995511,NaN,NaN,38.3813295392828,29.973703635391008
2017-01-31T09:30:00-05:00,124.4,124.6,123.85,124.57,19091133,18312724.3,64.43403379770436,68.55196971804561,NaN,NaN,72.3835497153296,126.12891743766045,0.08108237503762905,1.371873511654016,1.290791136616387,4814935841,4835981153.2,89.20072652317114,83.26839137424754,NaN,NaN,37.08592194654294,30.989734822698427
2017-02-01T09:30:00-05:00,125.42,125.68,124.86,125.43,22861876,18340437.7,68.5209781753268,68.63799377432437,NaN,NaN,113.12575043233866,117.47037764326743,0.06765792126293868,1.3753635381950602,1.3077056169321215,4837797717,4837954985.4,89.38067602544741,84.11100309800888,NaN,NaN,37.17660812198228,31.873573865453263
2017-02-02T09:30:00-05:00,125.21,125.7,124.86,125.32,15101363,18108052.15,67.45328579614295,68.75779763961107,NaN,NaN,98.0695269743336,106.20132861813443,0.03675494816933744,1.3536493021437934,1.316894353974456,4822696354,4833698115,86.05044683993235,84.57616946070236,NaN,NaN,36.93307410463017,32.596359613907104
2017-02-03T09:30:00-05:00,125.49,125.81,125.33,125.68,16957154,17923697.15,69.14764470975439,68.87232408830184,NaN,NaN,103.13830840528709,97.1950573267404,0.026427292728810725,1.3499284698854694,1.3235011771566587,4839653508,4829822078.8,83.01738263406003,84.71299879190026,NaN,NaN,37.21685682260764,33.256430643721465
2017-02-06T09:30:00-05:00,125.42,125.85,125.35,125.83,11630139,17301488.85,69.85190242783413,69.2625923501668,NaN,NaN,96.65458594115461,96.67434429368868,0.016075297999383675,1.3435952996558882,1.3275200016565045,4851283647,4833273413.4,83.57262249359735,84.84961385015397,NaN,NaN,37.64963232387533,33.88403088374345
2017-02-07T09:30:00-05:00,126.06,126.55,125.97,126.29,17541101,17233082.2,71.96534188560086,69.72017659923173,NaN,NaN,116.35912989597007,105.46946032981677,0.02599755347243149,1.360016943497044,1.3340193900246125,4868824748,4844051194.8,85.19992035055849,85.06944992914168,NaN,NaN,38.627255149473044,34.56163435027625
2017-02-08T09:30:00-05:00,126.12,126.68,125.88,126.5,12569147,17052708,72.89936061077104,70.28393982296568,NaN,NaN,109.35042522069071,104.71439528748718,0.03209350552968626,1.3741362719367203,1.342042766407034,4881393895,4852770430.4,86.37575183808843,85.54228743175564,NaN,NaN,39.71137002001981,35.29731087452533
2017-02-09T09:30:00-05:00,126.63,127.24,126.56,126.96,17542726,16895545.15,74.87408051181028,70.89067931535182,NaN,NaN,126.9426636107469,110.48902261476982,0.05135291321728275,1.4062339079286374,1.3548809947113547,4898936621,4868018483.8,88.14895449677141,86.08192502622738,NaN,NaN,41.22184717613101,36.14367320332614
2017-02-10T09:30:00-05:00,127.2,127.56,127.02,127.38,13915697,16610204.45,76.55393647374483,71.58040425844486,NaN,NaN,137.21821757827053,117.30500444936652,0.0751835596702648,1.4488604442991857,1.373676884628921,4912852318,4882658245.8,89.55459826508383,86.66163624522086,NaN,NaN,43.014886863547744,37.125275154786365
2017-02-13T09:30:00-05:00,127.76,128.26,127.7199,128.1,19120150,16719671.8,79.12991473680052,72.16788815754622,NaN,NaN,159.57776995207104,129.8896412515498,0.1196040687611799,1.5231819705803957,1.4035779018192158,4931972468,4898796010,90.84381828636455,87.20447505960064,NaN,NaN,45.40197234947521,38.307660468313344
2017-02-14T09:30:00-05:00,128.15,128.535,127.74,128.53,16333480,16809421.6,80.50732804052143,72.51268410368185,NaN,NaN,160.09662407808736,138.63714008797325,0.15582158400042312,1.5983548818197448,1.4425332978193217,4948305948,4914692250,91.9038441943776,87.70499089118316,NaN,NaN,47.85271281804972,39.67123937541854
2017-02-15T09:30:00-05:00,128.44,129.35,128.37,129.29,17891355,17079006.2,82.68277353453756,72.98151443603768,NaN,NaN,177.1678983410515,152.20063471204543,0.20570371976681545,1.699662947527841,1.4939592277610256,4966197303,4931652931.6,92.85439368920734,88.12656026877961,NaN,NaN,50.71002441846484,41.24820866728229
2017-02-16T09:30:00-05:00,129.36,129.63,128.92,129.25,15098286,17198387.55,82.16303562983015,73.35412828732301,NaN,NaN,160.86526342683464,158.98515467526295,0.21001269952766877,1.7564751021706115,1.5464624026429428,4951099017,4942085410.8,93.37002213273018,88.47418458129914,NaN,NaN,52.844700239196875,42.90485032041295
2017-02-17T09:30:00-05:00,129.09,129.82,129.04,129.81,15563730,16872022.1,83.70714892340078,74.56362608955563,NaN,NaN,151.0144352627288,161.7443982121546,0.22334336103088104,1.825641603931544,1.602298242900663,4966662747,4952847496.6,93.86207625645253,88.80965957327443,NaN,NaN,55.17136288138984,44.657209257695364
2017-02-21T09:30:00-05:00,130.03,130.53,129.99,130.45,18479628,16924295.15,85.27593123691989,76.0523330494996,NaN,NaN,157.8156108621574,161.3919663941719,0.24622619097518417,1.9100809816196431,1.663854790644459,4985142375,4963481478,94.3113337996446,89.1747029501654,NaN,NaN,57.68900185621067,46.51889391462612
2017-02-22T09:30:00-05:00,130.32,130.59,130.111,130.5,12110876,16647795.5,85.39425285175672,77.25756695495888,NaN,NaN,139.19545028118475,157.2117316347914,0.23568295833627384,1.9584584885648013,1.7227755302285275,4997253251,4973270938.6,94.69619901333455,89.55438316358591,NaN,NaN,59.74958566638776,48.40899273630635
2017-02-23T09:30:00-05:00,130.7,130.7,129.49,130.01,17489023,16770435.6,78.7181660061226,78.0622012556717,NaN,NaN,109.6971758927951,143.7175871451401,0.16974290332009678,1.9349541593786483,1.7652112560585516,4979764228,4975984323.6,94.8011870324889,90.1794360344828,NaN,NaN,59.552181038700624,50.00087677950553
2017-02-24T09:30:00-05:00,129.47,130.26,129.38,130.26,18624489,16899052.55,79.59469258261832,78.80841896087627,NaN,NaN,93.83759055924517,130.31205257162222,0.1193760727103137,1.9144313469464436,1.7950552742361299,4998388717,4985442263.6,95.16076960835821,91.04682081836123,NaN,NaN,59.635451235972134,51.37724455900076
2017-02-27T09:30:00-05:00,130.02,130.43,129.8,130.42,12008672,16746837,80.15795039704108,79.54456524439105,NaN,NaN,92.00164687343575,118.5094948937636,0.07539487798217448,1.889298871713848,1.8139039937316734,5010397389,4994189192,95.47264606649755,91.89682250213981,NaN,NaN,59.860342387260914,52.58911567732364
2017-02-28T09:30:00-05:00,130.39,130.45,129.66,130.02,16598581,16326430.3,74.61293329880323,79.73367891676266,NaN,NaN,78.47445686778964,102.64126409489006,0.0018119111018202183,1.8161688826089488,1.8143569715071286,4993798808,4995920478.6,95.53399730785408,92.63497085623236,NaN,NaN,58.46502040257141,53.42853063807332
2017-03-01T09:30:00-05:00,130.81,131.68,130.6,131.44,25813827,16662565,79.92269217668354,80.23534545718498,NaN,NaN,113.47925009034644,97.4980240567224,0.02967648606825901,1.8514525790924523,1.8217760930241933,5019612635,5000392355.4,95.69622824752888,93.3007191711924,NaN,NaN,58.797256617381834,54.19549149226025
2017-03-02T09:30:00-05:00,131.43,131.43,130.62,130.78,19951386,16517040.5,72.34856691586124,80.05495162890291,NaN,NaN,93.72794332761032,94.30417754368543,-0.013142671620376856,1.8053477534987223,1.8184904251190992,4999661249,5004371759.6,95.84101053391039,93.85015174527375,NaN,NaN,56.53657655424734,54.52993221540127
2017-03-03T09:30:00-05:00,130.65,131.06,130.341,131.02,13722749,16448109.8,73.33804539490451,79.82524512327144,NaN,NaN,82.69610098578919,92.07587962899424,-0.04055452032143125,1.76779727471731,1.8083517950387413,5013383998,5007370815.8,95.95154723769355,94.30707667188872,NaN,NaN,55.03500167043074,54.60208499469119
2017-03-06T09:30:00-05:00,130.56,130.95,130.21,130.73,12026151,16201559.65,70.07499900308372,79.17846542800598,NaN,NaN,71.06787037588155,87.88912432948341,-0.09060332170159513,1.6950976429117475,1.7857009646133426,5001357847,5005562907.4,94.3240596854646,94.55566534325303,NaN,NaN,52.784862034453596,54.34248171465725
2017-03-07T09:30:00-05:00,130.45,131.08,130.28,130.51,15500945,16395099.95,67.61712298636306,78.25773649556608,NaN,NaN,66.87357040635817,85.5689470371971,-0.14754314583574502,1.6012720323186613,1.7488151781544063,4985856902,5003974526.2,92.83422929670283,94.62212142199054,NaN,NaN,50.19307670929819,53.74970957103452
2017-03-08T09:30:00-05:00,130.57,131.15,130.46,130.74,15776027,16306846.25,68.84734031744448,77.26949126577372,NaN,NaN,71.52860051321393,77.1788171217706,-0.1767630204688806,1.5278614025683055,1.704624423037186,5001632929,5000378585,89.39187995631951,94.37479901249856,NaN,NaN,48.38981249586835,52.984009988867925
2017-03-09T09:30:00-05:00,130.71,131.02,130.14,130.84,20855253,16721151.55,69.39179423880226,76.35725973784317,NaN,NaN,61.40016853269592,70.71326216278774,-0.19497023128478586,1.4609116339312038,1.6558818652159897,5022488182,5004943971.6,89.90374646532305,94.12720789339804,NaN,NaN,47.05287179332104,52.13670453236123
2017-03-10T09:30:00-05:00,131.42,131.6,130.82,131.39,21922601,16940145.3,72.26305117533535,75.53982418440991,NaN,NaN,103.2150685092101,74.81705566747192,-0.17615814038039246,1.435684189740499,1.6118423301208915,5044410783,5011149328.6,90.5698056596691,93.89204570791351,NaN,NaN,46.689314512825476,51.35850595814183
2017-03-13T09:30:00-04:00,131.34,131.64,131.27,131.61,10731575,16780939.2,73.34034312715872,74.68728217656984,NaN,NaN,122.03044492680637,85.00957057765689,-0.15578755825623447,1.4171078823005985,1.572895440556833,5055142358,5021906230.8,91.60384732516366,93.69865381687916,NaN,NaN,46.68974331418078,50.691539866147394
2017-03-14T09:30:00-04:00,131.31,131.36,130.76,131.29,14019689,16525916.15,69.13424011651085,73.52585269548084,NaN,NaN,84.57239827169711,88.54933615072468,-0.16961447070793723,1.3608773521719115,1.5304918228798488,5041122669,5032959384.2,92.51238802365623,93.54266731761642,NaN,NaN,45.4919150652951,49.9487363231685
2017-03-15T09:30:00-04:00,131.58,132.405,131.14,132.1,22709139,16844699.1,73.30725495874262,73.13935904923942,NaN,NaN,156.7433034881357,105.59227674570903,-0.13165033484343347,1.365928904325557,1.4975792391689904,5063831808,5045399160,93.38054336207365,93.44119276972961,NaN,NaN,45.65794205546385,49.33576571349641
2017-03-16T09:30:00-04:00,132.33,132.35,131.71,132.01,18457291,16872995.9,72.14019692248726,72.60689507351576,NaN,NaN,161.8732344896398,125.68688993709779,-0.12035055568114084,1.3471410445675644,1.4674916002487053,5045374517,5049976427,93.67131111029676,93.33480287701093,NaN,NaN,45.452324937455494,48.780988459776275
2017-03-17T09:30:00-04:00,131.86,132.04,131.62,131.69,21234529,17179808.05,67.99527474133531,71.73813252667962,NaN,NaN,121.06554311125265,129.25698485750632,-0.14075959123829196,1.2915421112008403,1.4323017024391322,5024139988,5045922268,89.9044109814273,92.93707179950593,NaN,NaN,44.0714038130185,48.10819065309659
2017-03-20T09:30:00-04:00,131.65,132.11,131.4601,131.81,10105210,16906882.05,68.72105819172701,71.31728430474561,NaN,NaN,109.01787264271843,126.65447040068872,-0.15157263053056247,1.242835914275929,1.3944085448064916,5034245198,5041742836,86.06211606023878,92.26050885324769,NaN,NaN,43.126721602699256,47.39655221732554
2017-03-21T09:30:00-04:00,132.31,132.43,129.73,129.81,35841897,17774995.5,48.841218405648085,69.09717903538595,NaN,NaN,-33.490495919009525,103.0418915625474,-0.2907522304904515,1.030968256693427,1.3217204871838786,4998403301,5033198962.4,78.66109065709203,91.04371331107362,NaN,NaN,35.005775045400775,45.62644119276486
2017-03-22T09:30:00-04:00,129.89,130.82,129.68,130.69,29177883,18628345.85,55.00846372929171,67.85860023634527,NaN,NaN,-66.2699443114095,58.439242002638366,-0.3186359242486989,0.9234255818730048,1.2420615061217037,5027581184,5025948837.6,72.92970438672826,89.40719144341776,NaN,NaN,30.392467516640565,43.450159239032814
2017-03-23T09:30:00-04:00,130.52,130.88,130.14,130.36,20311655,18769477.45,52.45475228261973,66.36693644261064,NaN,NaN,-62.8654794172506,13.491499221260288,-0.351792928351895,0.8023203456818351,1.15411327403373,5007269529,5018327840,67.37277146845386,87.3658503170435,NaN,NaN,25.89327507427437,40.94203292978161
2017-03-24T09:30:00-04:00,130.78,131.29,130.13,130.63,22967566,18986631.3,54.32316501439383,65.2418054434185,NaN,NaN,-40.68118688003989,-18.857846776998223,-0.34742459073918086,0.7198325356097541,1.067257126348935,5030237095,5019547261.4,67.7956079753871,85.47096090918082,NaN,NaN,22.941938406845797,38.37059085507649
2017-03-27T09:30:00-04:00,129.73,131.07,129.4,130.84,18472445,19309819.95,55.77874793920639,64.39620722576446,NaN,NaN,-77.76342940009552,-56.21410718556102,-0.32280230031159396,0.6637542509594425,0.9865565512710365,5048709540,5022440129.8,68.82770521079092,83.75620918875855,NaN,NaN,21.036046085800027,35.89422731660843
2017-03-28T09:30:00-04:00,130.81,132.03,130.55,131.64,23721947,19665988.25,60.89163275869038,63.82794240013916,NaN,NaN,51.4995258438249,-39.216102832994146,-0.24838781240353025,0.6760717857666236,0.9244595981701539,5072431487,5037245767,73.5073603668486,82.62160064665348,NaN,NaN,21.04729622914404,33.773237161256375
2017-03-29T09:30:00-04:00,131.73,132.3,131.59,132.25,13168901,19033741.95,64.28271230784358,63.46300797649926,NaN,NaN,127.22686184910535,-0.5167416008911516,-0.15822470022728363,0.7266787228860494,0.884903423113333,5085600388,5048849607.8,76.48668775894473,81.66323931048359,NaN,NaN,22.181289082299063,32.11724457854819
2017-03-30T09:30:00-04:00,132.22,132.61,132.08,132.47,16092374,18840791.35,65.44640695401199,62.9761048178333,NaN,NaN,145.54108024322957,41.16457033120488,-0.08744541758059421,0.7755966511375902,0.8630420687181845,5101692762,5067734254.4,80.35809149473211,80.93383115584524,NaN,NaN,23.462100163097794,30.880795376340988
2017-03-31T09:30:00-04:00,132.27,132.74,132.125,132.38,19841411,19146724.45,64.52029935014255,62.34610169090358,NaN,NaN,129.0876824815076,75.11834420351438,-0.052110080697796546,0.7979044678459388,0.8500145485437354,5081851351,5078057105.6,82.09364254289216,80.25453081425442,NaN,NaN,24.217116286121897,29.9288412205954
2017-04-03T09:30:00-04:00,132.48,132.81,131.56,132.3,23700310,19730432.4,63.65799464509629,61.95494130008825,NaN,NaN,96.52771219362832,109.97657252225915,-0.040085713051902006,0.7999074072288579,0.8399931202807599,5058151041,5079945405.8,82.39999582301921,79.5322170856375,NaN,NaN,24.590432537048716,29.16621140866016
2017-04-04T09:30:00-04:00,131.9,132.53,131.87,132.51,13400022,19625386.25,64.9810602112552,61.36021310383915,NaN,NaN,95.22238354087324,118.72114406166881,-0.02470406058080854,0.8091130445547492,0.8338171051355577,5071551063,5079769321,82.25866644034018,78.73779730551368,NaN,NaN,25.277296731609006,28.610652169081423
2017-04-05T09:30:00-04:00,132.68,133.48,131.72,131.97,32011155,20437142.65,59.02987469824208,60.423761516393064,NaN,NaN,94.48502361296649,112.17277641444105,-0.05583140097428929,0.7640278539176961,0.8198592548919854,5039539908,5070557225,75.01018883918587,77.40486000043431,NaN,NaN,24.184554534733525,27.978352507031722
2017-04-06T09:30:00-04:00,132.12,132.39,131.7,132.04,18832193,20335989.65,59.547071259445794,59.82031841054381,NaN,NaN,52.53310238341622,93.57118084247838,-0.07542190446229535,0.7255818743141162,0.8010037787764116,5058372101,5061893092.8,68.86396386976418,75.90197092102981,NaN,NaN,23.425326043065063,27.327920155036484
2017-04-07T09:30:00-04:00,131.99,132.37,131.5,131.97,16743064,20077012.8,58.74839817372335,59.10798555211498,NaN,NaN,38.42053594712423,75.4377515356017,-0.09551694667695165,0.6816075954302221,0.7771245421071737,5041629037,5053848630,63.64916497193812,74.30104584329403,NaN,NaN,22.57774866160929,26.649324227404026
2017-04-10T09:30:00-04:00,132.11,132.565,131.6564,132.02,15619276,20321397.85,59.1696563336374,59.84573111839993,NaN,NaN,49.038317994580275,65.9398726957921,-0.10699898657182971,0.6433758088923867,0.7503747954642164,5057248313,5053668084.4,63.53288132497701,73.22045946242868,NaN,NaN,21.971415397761792,25.981051537455137
2017-04-11T09:30:00-04:00,131.86,132.095,130.5,131.45,33778359,21309331.35,52.57791166807171,59.67212025688422,NaN,NaN,-31.574077767418437,40.58058043413376,-0.15180373520270662,0.560620126460833,0.7124238616635397,5023469954,5044051862.6,57.50664434674368,72.1188123167155,NaN,NaN,19.60348991234483,25.069971305296523
2017-04-12T09:30:00-04:00,131.45,131.54,130.78,130.92,15955195,20971634.15,47.30124567312748,59.30401264192049,NaN,NaN,-54.57654470079041,10.768266771382377,-0.21224707516961538,0.4471150177015204,0.6593620928711358,5007514759,5037646832.8,53.8432767282984,71.15241983527582,NaN,NaN,15.945540742918892,23.766481224956863
2017-04-13T09:30:00-04:00,130.75,131.51,130.38,130.4,23683020,21232920.6,42.76631870058874,58.47852361950583,NaN,NaN,-78.15914347953088,-15.370182401207042,-0.27820191080150025,0.3116097043692605,0.5898116151707608,4983831739,5022738760.4,46.429470530648516,69.62626716065164,NaN,NaN,11.343250128607847,21.99173392547843
2017-04-17T09:30:00-04:00,130.8,131.5,130.72,131.48,13325508,20837469.55,52.87231092161841,58.27092097539241,NaN,NaN,-27.48523943969837,-28.551337478571565,-0.24141144313430307,0.28804731125288185,0.5294587543871849,4997157247,5013844402.4,42.65578679243415,67.75684441648329,NaN,NaN,10.307720223837686,20.322589110958326
2017-04-18T09:30:00-04:00,131.01,131.66,130.95,131.28,12841087,20974263.4,51.07378682137571,57.56964626558421,NaN,NaN,-18.740406142716893,-42.107082306030996,-0.22328721115020989,0.2503497404494226,0.4736369515996325,4984316160,4999257971.8,37.301332421043135,65.17069956321146,NaN,NaN,8.909175214703064,18.69210141149329
2017-04-19T09:30:00-04:00,131.85,132.29,131.31,131.49,17764817,20070409.4,52.88601062692756,56.75559614551879,NaN,NaN,17.682812340752346,-32.25570428439684,-0.19113855737088176,0.2347137548860303,0.42585231225691206,5002080977,4994980176.4,35.8788987250481,62.270143203647415,NaN,NaN,8.32073894994792,17.210478202701093
2017-04-20T09:30:00-04:00,132.04,132.88,131.82,132.59,21977910,19710410.75,61.028782617095274,56.440051550024734,NaN,NaN,88.59520667166761,-3.621354009905235,-0.09465158902941462,0.3075378259701438,0.4021894149995584,5024058887,4998289002,37.85298668551658,59.23406428870344,NaN,NaN,10.532803051021776,16.25652460960405
2017-04-21T09:30:00-04:00,132.7,132.76,132.22,132.56,22454948,19817575.4,60.720555119307505,56.16864124782223,NaN,NaN,91.20260593405374,30.25099587281169,-0.03479484787481246,0.35869585515604285,0.3934907030308553,5001603939,5001843442,39.99030373210607,56.226682945075865,NaN,NaN,12.16050140723265,15.671378437836706
2017-04-24T09:30:00-04:00,134.02,134.285,133.8042,134.16,22469948,19792694.5,69.55274235736869,56.58969465584169,NaN,NaN,242.37164342290623,84.22237244533261,0.10306708376395574,0.5223245577358,0.41925747397184426,5024073887,5007226770,43.177670631544586,53.42508828854197,NaN,NaN,16.991411906687045,15.859954647672469
2017-04-25T09:30:00-04:00,134.58,135.3664,134.48,135.13,19339384,19836041.45,73.45035033529035,57.19464395041563,NaN,NaN,291.74141337846675,146.31873634956932,0.242154168386647,0.721950184455153,0.479796016068506,5043413271,5019046192.2,49.517551905260575,51.086437250322,NaN,NaN,22.52588203901286,16.812229989292526
2017-04-26T09:30:00-04:00,135.17,135.51,134.86,134.94,25398542,19919871.2,71.51910003516066,58.08673147448125,NaN,NaN,239.12184733232542,190.60654334788396,0.3001375719970717,0.8549679810648456,0.5548304090677739,5018014729,5022232942.6,51.1016878431081,49.37868717917359,NaN,NaN,26.08142658565945,18.136400931630657
2017-04-27T09:30:00-04:00,135.28,135.75,135.19,135.75,16136538,20068253.05,74.58684580257295,59.16100108470461,NaN,NaN,209.1378768853325,214.71507739061695,0.36738076333762304,1.0140563632398027,0.6466755999021797,5034151267,5024251418.6,52.12641492677991,48.18314796896043,NaN,NaN,30.156239854248,19.85352077771885
2017-04-28T09:30:00-04:00,136.28,136.34,135.77,135.99,22771946,20402231.65,75.43126737071259,60.352634598775275,NaN,NaN,180.58980011937075,232.59251622768033,0.3996894075821287,1.1462873593798406,0.7465979517977119,5056923213,5035315273.4,57.39660324222496,47.73653641683806,NaN,NaN,33.634355276557976,21.822211420410152
2017-05-01T09:30:00-04:00,136.46,137.38,136.38,137.2,24815525,20650937.35,79.18626435208682,61.782392314378804,NaN,NaN,177.49459980574588,219.61710750424828,0.4694002428770647,1.3333482553940428,0.8639480125169781,5081738738,5046848243.6,62.08246684866646,47.63293538281588,NaN,NaN,38.065186328260154,24.142636407245867
2017-05-02T09:30:00-04:00,137.38,137.49,137.02,137.43,18345071,20383175.4,79.81769372369564,63.72809103263764,NaN,NaN,154.21174085536958,192.11117299962885,0.4952885210989907,1.4830586638907164,0.9877701427917257,5100083809,5058182351.2,66.03607916762786,48.242180727164815,NaN,NaN,41.73169781503396,26.65535946550131
2017-05-03T09:30:00-04:00,137.14,137.17,136.615,136.99,23827550,20904551.8,75.12249200645391,65.71532291358953,NaN,NaN,118.55923740252972,167.9986510136697,0.44846586572482927,1.5483524749477624,1.0998866092229331,5076256259,5069830657.2,69.55006857575945,49.36409443055489,NaN,NaN,43.196898984709854,29.018436539673957
2017-05-04T09:30:00-04:00,137.01,137.43,136.56,137.04,14630063,20035497.2,75.30029897919161,68.03917864777546,NaN,NaN,105.48657540061939,147.26839071672705,0.38877243763032676,1.5858521562608416,1.1970797186305149,5090886322,5081177668.2,72.53147607076913,51.22852339770636,NaN,NaN,44.40614710311537,31.216680905879873
2017-05-05T09:30:00-04:00,137.39,137.54,136.88,137.54,19330652,20060420.15,77.06558191116324,69.76726943274294,NaN,NaN,101.88230302868713,131.52689129859033,0.3519729443744757,1.6370458990986094,1.2850729547241337,5110216974,5091836420.4,75.00697849521309,53.53932280504772,NaN,NaN,45.97078550476972,33.324410134292705
2017-05-08T09:30:00-04:00,137.61,137.84,137.33,137.84,13279931,19887263.5,78.07795284392958,71.69613843435393,NaN,NaN,100.53136632470382,116.13424460238193,0.3178862658904409,1.6824307870871849,1.364544521196744,5123496905,5100188053.8,76.77328309678818,56.35874785331522,NaN,NaN,47.57148890749399,35.35970710189289
2017-05-09T09:30:00-04:00,138.05,138.628,137.93,138.32,28426109,20527605.15,79.6274871914674,73.60624390324963,NaN,NaN,106.27533667636615,106.54696376658126,0.2980494595465566,1.7371063456299396,1.439056886083383,5151923014,5110555894.8,78.77834454143985,59.42299398305749,NaN,NaN,49.40444018995732,37.36609754304495
2017-05-10T09:30:00-04:00,138.4,138.45,137.91,138.4,20499363,19863655.35,79.88271204609947,74.9529531481785,NaN,NaN,97.06001585290437,102.24711945665618,0.26197769462697407,1.7665290043671007,1.5045513097401266,5172422377,5129789118.4,81.8998890525859,62.569201294991004,NaN,NaN,50.970589075287386,39.3095963333653
2017-05-11T09:30:00-04:00,138.03,138.33,137.38,138.29,27232074,20427499.3,78.42780315706406,76.21775657944683,NaN,NaN,83.90585144462298,97.93097466545689,0.20489865743433855,1.7606746315330497,1.5557759740987112,5145190303,5140649914.6,83.38602359666896,65.66889557103123,NaN,NaN,51.87248158338412,41.10429422622513
2017-05-12T09:30:00-04:00,138.37,138.63,138.23,138.6,19738629,20230279.75,79.55776817243799,76.93240128052321,NaN,NaN,92.32249342669805,96.01901274505907,0.16398125972411637,1.7607525487538567,1.5967712890297403,5164928932,5151592306.2,84.74503580138152,68.63799308316243,NaN,NaN,52.959719900159385,42.79792646535859
2017-05-15T09:30:00-04:00,138.63,139.12,138.53,139.04,20481327,20588070.7,81.07315825254904,77.4768875603274,NaN,NaN,99.09954347460554,95.73264817503942,0.14326117197464816,1.7758477539980504,1.6325865820234022,5185410259,5163974977,86.12789769172491,71.2530177821956,NaN,NaN,54.338785481525086,44.44662061052524
2017-05-16T09:30:00-04:00,139.36,139.64,138.99,139.62,21785994,21035316.05,82.87526304086164,78.28804206073461,NaN,NaN,111.26140112368282,96.72986106450274,0.14489449980456293,1.813704706779106,1.668810206974543,5207196253,5175029624.8,87.23997365379552,73.83432391153042,NaN,NaN,56.08996669191224,46.1099557650091
2017-05-17T09:30:00-04:00,138.55,138.77,136.05,136.07,55642178,22929184.1,50.9185112314033,76.59744673422249,NaN,NaN,15.015657277014418,80.32098934932476,-0.103444301722881,1.5395048298209417,1.6429491315438227,5151554075,5170855964.4,84.48615954369707,76.1457342413102,NaN,NaN,45.02143539161178,45.954452854523765
2017-05-18T09:30:00-04:00,136.06,137.72,135.87,137.26,41319882,23896282.7,56.915849388600535,75.27491687835733,NaN,NaN,5.825619927961061,64.70494304599238,-0.1927109638461899,1.4020604267360852,1.5947713905822751,5192873957,5180392695.2,85.60435404077651,78.16057358406388,NaN,NaN,38.66901370428538,44.91367583306114
2017-05-19T09:30:00-04:00,137.71,138.42,137.66,137.84,36730112,24610040.9,59.51257848459068,73.86965360210762,NaN,NaN,54.67801654256661,57.17604766916609,-0.2160843324565076,1.3246659750116407,1.5407503074681483,5229604069,5193327722.6,86.9755797387824,79.93865307621502,NaN,NaN,34.87761577824355,43.4799529680872
2017-05-22T09:30:00-04:00,138.14,139.075,138.0967,139,19509659,24462026.45,64.16454624020577,72.7515716390012,NaN,NaN,95.64831573442322,56.48580212112962,-0.15942504573562566,1.3414690002986163,1.500894046034242,5249113728,5206068416.4,88.17078905991553,81.519703782807,NaN,NaN,33.59315232216744,42.06755287581294
2017-05-23T09:30:00-04:00,139.42,139.42,138.7801,139.14,19687534,24479433.95,64.69183253613632,72.00652453397852,NaN,NaN,111.73742469826405,56.581006836045866,-0.12030366974468754,1.3505144588533824,1.47081812859807,5268801262,5218389418.2,89.20269164539596,82.92346257349531,NaN,NaN,32.823932032537336,40.747035612487856
2017-05-24T09:30:00-04:00,139.56,139.85,139.17,139.78,18323864,24125700.05,67.07674766467767,71.41912801151324,NaN,NaN,135.05423121884036,80.58872162441106,-0.062042495300807854,1.39326500947206,1.4553075047728679,5287125126,5245503628.4,91.0524771129976,84.24639121936879,NaN,NaN,33.02541493922512,39.64394694487889
2017-05-25T09:30:00-04:00,140.315,141.33,140.01,140.97,23928591,24515302.7,70.99921372337586,70.98581599809985,NaN,NaN,197.35706257332433,118.89501015348371,0.04040210947388845,1.5058101416152283,1.4654080321413399,5311053717,5269139580.4,92.2921323806163,85.48104506832615,NaN,NaN,34.58278475844168,38.92092377538786
2017-05-26T09:30:00-04:00,141,141.28,140.81,141.22,13851582,24069284.5,71.76040304712546,70.53456244118527,NaN,NaN,191.34380871330154,146.2281685876307,0.10508902837204959,1.5967693176064017,1.4916802892343521,5324905299,5288199826.4,93.11994170819733,86.64866354056967,NaN,NaN,36.04718838948424,38.510390148830204
2017-05-30T09:30:00-04:00,141.13,141.505,141.06,141.34,20306409,23843828.7,72.13842283434276,69.99962927281923,NaN,NaN,171.222181146638,161.34294167007366,0.1341833506227661,1.6594094775128099,1.5252261268900438,5345211708,5307419422.4,93.83853104646418,87.7243911480714,NaN,NaN,37.31801933877969,38.34005146168013
2017-05-31T09:30:00-04:00,141.8,141.84,140.57,141.29,33229404,24588045.35,71.70770258510504,69.41570002560535,NaN,NaN,142.42337948055334,167.48013262653154,0.12828891654200136,1.6855872725675454,1.557298356025544,5311982304,5316055630.8,94.13496165781483,88.59832490558776,NaN,NaN,38.20852949648885,38.32126260950995
2017-06-01T09:30:00-04:00,141.57,141.9,140.98,141.84,20120741,24402704.9,73.57663717987617,69.06918817009192,NaN,NaN,139.15847543386366,168.3009814695362,0.13877140571173396,1.7307626131652114,1.5919912074534774,5332103045,5325051214.6,94.43527420500395,89.3875570918974,NaN,NaN,39.52195169461765,38.492789621668194
2017-06-02T09:30:00-04:00,142.34,143.49,142.11,143.46,37222881,25532345.8,78.15416982219526,68.96893114507459,NaN,NaN,178.37134618338166,164.50383819154763,0.22693773587809374,1.8756633773010947,1.648725641423001,5369325926,5336705656.4,94.8063176897288,90.1062200839222,NaN,NaN,42.261314269781046,39.03115028568432
2017-06-05T09:30:00-04:00,143.44,143.68,143.23,143.43,15727526,25352189.5,77.88508538182552,68.74121165430861,NaN,NaN,165.56480903159365,159.34803825520606,0.25335658557578267,1.9654213733927293,1.7120647878169466,5353598400,5342444276.6,94.98368221901562,90.73877612158583,NaN,NaN,44.33305556647816,39.78856532579773
2017-06-06T09:30:00-04:00,143.28,143.73,142.65,142.86,22393024,25807844.15,72.75926901999001,68.01864065281778,NaN,NaN,127.8699259729721,150.67758722047287,0.2046494016381153,1.9678765398645908,1.7632271382264755,5331205376,5339643010.2,93.3085676144446,91.17224711877506,NaN,NaN,44.542089145667354,40.467640157207676
2017-06-07T09:30:00-04:00,143.23,143.54,142.6,143.42,18842408,25328659.1,74.53260536618797,69.70536166244527,NaN,NaN,114.57940829938146,145.1087929842385,0.1830555090490924,1.992046524537841,1.8089910154887485,5350047784,5347256106.2,93.63700219273069,91.82587873656315,NaN,NaN,45.25218444675112,41.15114648428531
2017-06-08T09:30:00-04:00,143.74,143.8,142.79,143.57,25417408,25574561.35,75.00202908749617,70.99723164093781,NaN,NaN,107.97157164607982,138.8714122266817,0.15300522703868902,2.00024754928711,1.8472423222484209,5375465192,5355928535.6,93.99838074264956,92.42545207241123,NaN,NaN,45.96719261430026,41.839153074287445
2017-06-09T09:30:00-04:00,143.73,143.9,138.11,139.98,109783737,29702144.5,50.84601372384859,70.37819130088481,NaN,NaN,8.163109027469723,104.82976479549936,-0.11979686313508298,1.6974962433295673,1.8172931064646503,5265681455,5335199641.4,82.00935148253018,92.07072148267893,NaN,NaN,37.629755040520344,41.237810498035
2017-06-12T09:30:00-04:00,138.84,139.48,137.47,139.23,104453977,33937911.9,47.410598615081845,69.1814807562331,NaN,NaN,-64.98991401078513,58.71882018702358,-0.3489351409049877,1.3811241803334156,1.7300593212384032,5161227478,5296725457,65.34910988885079,90.4406015418886,NaN,NaN,29.833952540723725,39.60868793270482
2017-06-13T09:30:00-04:00,140.01,140.56,139.28,140.36,51193010,35473496.05,52.60630654330808,68.31822889960252,NaN,NaN,-17.4762035454482,29.649594283339535,-0.4179214780693452,1.2076574736517216,1.6255789517210668,5212420488,5272968479.4,57.57172473080727,88.18124676227512,NaN,NaN,25.32819372594302,37.56861733173885
2017-06-14T09:30:00-04:00,140.92,140.93,138.62,139.75,60093764,37388884.55,49.7489371779904,67.08052815055342,NaN,NaN,-30.193836243243748,0.694945374814484,-0.4930015111895609,1.0093270627341155,1.5023285739236765,5152326724,5233424267.4,47.44900022588098,85.06671269890967,NaN,NaN,20.78389708480525,35.17080015360548
2017-06-15T09:30:00-04:00,138.35,139.28,137.49,139.13,55145160,37364033.65,46.95718317383276,65.36324025415747,NaN,NaN,-82.6626885219973,-37.431906658800926,-0.5674796619505511,0.7929789964854876,1.3604586584360387,5097181564,5177767541.8,37.46447827289302,81.15045169121514,NaN,NaN,16.200351377464163,32.46073604272814
2017-06-16T09:30:00-04:00,138.72,138.777,137.638,138.15,48087413,37702410.2,42.86276158215371,63.29912300665949,NaN,NaN,-108.31319299268043,-60.72716706283096,-0.6593572548124436,0.5362620899204842,1.1956193447329277,5049094151,5134450081,31.84746883539438,76.77384648601492,NaN,NaN,11.000731972016146,29.395021175483574
2017-06-19T09:30:00-04:00,139.45,140.59,139.28,140.46,39626533,37847231.25,53.2176054857334,61.9476360531874,NaN,NaN,-31.521849751953532,-54.03355421106464,-0.5458611831435252,0.5132928658035212,1.0591540489470463,5088720684,5119948722.2,30.214309603754202,72.22925924010707,NaN,NaN,10.060409479576196,26.63293379035395
2017-06-20T09:30:00-04:00,140.31,140.5,139.31,139.36,40935078,38918502.2,48.692280111882305,60.30367730510006,NaN,NaN,-53.61133680286535,-61.26058086254808,-0.525964634481485,0.40169825584519003,0.927662890326675,5047785606,5087021745.8,26.847729104263564,67.42302834342483,NaN,NaN,7.681163654378064,23.92553805664311
2017-06-21T09:30:00-04:00,139.66,140.81,139.59,140.74,35743366,39721293.8,53.979385628198756,58.90387362283739,NaN,NaN,-26.063548768517013,-60.43452336760273,-0.40631087741294514,0.41977429356049356,0.8260851709734387,5083528972,5073262195.4,25.565775314596166,62.50377842268142,NaN,NaN,7.634091926936964,21.59818860954223
2017-06-22T09:30:00-04:00,140.94,141.22,140.34,140.7,24099115,40010056.35,53.8063107373197,57.16474083106056,NaN,NaN,-10.595587208485048,-46.021103104900284,-0.32009870034068777,0.42596179554757896,0.7460604958882667,5059429857,5065711854,24.864181093702797,57.50791152296528,NaN,NaN,7.541510037650909,19.590091670700613
2017-06-23T09:30:00-04:00,140.53,141.42,140.15,141.24,21654314,39896342.5,55.86371826379997,55.59178603691588,NaN,NaN,-1.4398468845691126,-24.646433883278018,-0.22162262781840336,0.4690322111152625,0.6906548389336659,5081084171,5072109858,26.699850611450614,52.630494979567764,NaN,NaN,8.126733550860529,17.952469082152028
2017-06-26T09:30:00-04:00,142,142.29,140.27,140.58,34411094,40924318.1,52.770142196975044,54.16399126384338,NaN,NaN,4.515030298235479,-17.43905787324021,-0.19669813544754633,0.4447821696242329,0.6414803050717792,5046673077,5063700336.6,25.807362280084376,47.80898031282776,NaN,NaN,7.649204710165196,16.480574171868195
2017-06-27T09:30:00-04:00,140.07,140.22,138.02,138.03,65957819,43206888.6,42.888063170704925,51.903666821308875,NaN,NaN,-103.30915036336113,-27.378620585339366,-0.3393480014372914,0.217295303275165,0.5566433047124564,4980715258,5050286267,24.40595771320696,42.8639057071475,NaN,NaN,3.7757292380023544,14.665596324173075
2017-06-28T09:30:00-04:00,138.54,140.14,137.74,140.02,57427180,44416777.4,50.65424316433631,50.16453925536888,NaN,NaN,-69.45879169007067,-36.05766916965009,-0.28904665062926044,0.19533499142588084,0.4843816420551413,5038142438,5041208960.2,23.476901833431214,37.826657213631904,NaN,NaN,3.251578873371197,13.035022402629949
2017-06-29T09:30:00-04:00,139.4,139.44,136.25,137.59,88769351,47849207.9,42.9702596908263,49.60198539586729,NaN,NaN,-127.23471206767903,-59.38549414148889,-0.40185937343618494,-0.017942574740089867,0.3839167986960951,4949373087,5019197606.2,21.354134556147343,33.494141718890276,NaN,NaN,-0.09716160641856833,11.158996115623017
2017-06-30T09:30:00-04:00,138,138.6687,137.19,137.64,68898255,49432976.6,43.161316717144096,49.298465260300304,NaN,NaN,-114.46136301250745,-81.98979736707656,-0.45181128312885044,-0.18084730521496795,0.2709639779138825,5018271342,5006635040.4,20.22986399769397,30.271338440950508,NaN,NaN,-2.515431245111871,9.20550649266089
2017-07-03T09:30:00-04:00,138.25,138.43,136.1,136.19,32797005,50286450.55,39.073200042525734,48.3318147959587,NaN,NaN,-145.32759522627617,-111.95832247197889,-0.5544414177503335,-0.4220877942740344,0.13235362347629911,4985474337,4994395292.4,19.170833034513905,27.528417605500987,NaN,NaN,-5.933362790577299,7.04281088076972
2017-07-05T09:30:00-04:00,136.57,137.9,136.16,137.53,42116584,51272628.55,44.32170933259325,47.94415566414462,NaN,NaN,-120.22381226468197,-115.34125485224305,-0.5053942357709793,-0.499389171237425,0.0060050645335542885,5027590921,5003770425,22.516735159350006,25.74754152932021,NaN,NaN,-6.950842823399372,5.04371749445985
2017-07-06T09:30:00-04:00,136.47,137.06,135.8,136.29,48430476,52752031.95,40.81760751075392,47.50561454535328,NaN,NaN,-144.51542509194655,-130.35258153261825,-0.5273474615056107,-0.6531792623484591,-0.1258318008428484,4979160445,4991974026.4,21.32080600911418,24.594422081907428,NaN,NaN,-8.968491279664262,3.0419733838706913
2017-07-07T09:30:00-04:00,136.74,138.13,136.74,137.76,36970402,53329681.65,46.243503967106555,47.74709614427848,NaN,NaN,-80.06817421762236,-120.9192739626069,-0.41850374243787014,-0.6489614788901861,-0.23045773645231593,5016130847,5005325578.4,26.104723767389572,24.184226005621376,NaN,NaN,-8.806385812727907,1.3493506414994632
2017-07-10T09:30:00-04:00,137.84,138.985,137.5,138.66,24853545,49083172.05,49.30779509436701,47.467823973466594,NaN,NaN,-30.377449839303974,-104.1024913279662,-0.26880701362758225,-0.5664665034867937,-0.2976594898592115,5040984392,5009868188.4,27.715108776069044,24.00571166078672,NaN,NaN,-7.6610632434006645,0.062148657942302066
2017-07-11T09:30:00-04:00,138.44,139.22,137.94,139.05,31517660,45436356.2,50.62134067089815,47.6056140133963,NaN,NaN,-10.36422599862301,-77.10981748243559,-0.13328610264024038,-0.46426711815951194,-0.33098101551927156,5072502052,5027273731.4,33.679015138876736,24.49366066325909,NaN,NaN,-6.335712487006752,-0.8518315056218485
2017-07-12T09:30:00-04:00,140.21,140.86,139.955,140.7,36045799,44678995.65,55.83546784287652,47.738191314444705,NaN,NaN,86.5190756117407,-35.76123990715104,0.06695949267444867,-0.2472816496762107,-0.31424114235065936,5108547851,5043465117.4,38.74222184967024,25.43483541576438,NaN,NaN,-3.49686433593496,-1.2296933385237216
2017-07-13T09:30:00-04:00,140.85,141.35,140.6,141.01,31073595,43227987.2,56.759309161162925,47.94911977329065,NaN,NaN,104.01067475287549,13.943980061813372,0.2116077774594765,-0.04973142052631374,-0.26133919798579025,5139621446,5075557317.6,47.32587518615153,27.03924213665357,NaN,NaN,-0.9414367614518572,-1.1885138275134552
2017-07-14T09:30:00-04:00,141.57,142.3,141.19,142.12,34544847,42197971.55,59.98685489627886,48.243629532753424,NaN,NaN,129.15848515630847,55.78931193659953,0.36439787712047245,0.19415814841480028,-0.17023972870567214,5174166293,5107164406.8,54.14142883597557,28.999354866976784,NaN,NaN,2.2330946204210456,-0.6997126206656694
2017-07-17T09:30:00-04:00,142.25,142.69,141.92,142.19,25343155,41060758.65,60.188666554047984,48.77352412968721,NaN,NaN,129.74313111629797,87.81342812771992,0.4470806922722018,0.38861113663458013,-0.05846955563762167,5199509448,5138869418,59.765269426594266,31.42491966315606,NaN,NaN,4.8409725839983935,0.09181383714348246
2017-07-18T09:30:00-04:00,142.06,143.17,141.64,143.14,25748527,40366858.35,62.921868081666574,50.20451019475589,NaN,NaN,130.12153646180153,115.91058061980482,0.5366278067269319,0.6123152027710432,0.07568739604411133,5225257975,5169420602.6,64.30754733447938,34.27503320753266,NaN,NaN,7.892822159034433,1.2062435974136183
2017-07-19T09:30:00-04:00,143.53,144.19,143.5,143.98,33752309,40007719.9,65.19707569219398,51.24328394674573,NaN,NaN,152.96200574998159,129.19916664745298,0.6175400969518068,0.8476125172338698,0.23007242028206304,5259010284,5199513089.2,68.12471617303854,37.464162803218905,NaN,NaN,11.172500983464309,2.629994652563717
2017-07-20T09:30:00-04:00,144.31,144.44,143.52,144.17,36139449,40027524.05,65.709623567425,52.86752422364564,NaN,NaN,138.0150041275356,136.00003252238503,0.6459097104009459,1.0374595582832455,0.3915498478822996,5295149733,5230618746.6,71.51577537174666,41.04713714719027,NaN,NaN,14.018211784341968,4.256882814246324
2017-07-21T09:30:00-04:00,143.62,144.11,143.35,144.11,39697094,40807423,65.38216201921846,54.454727459508085,NaN,NaN,117.57552778319713,133.68344104776276,0.6224328351138093,1.1695908917745612,0.5471580566607519,5255452639,5246876015.8,73.12502100940499,44.825362648026776,NaN,NaN,16.287798304359768,5.975585027119672
2017-07-24T09:30:00-04:00,144.07,144.87,143.92,144.77,26712732,41060343.9,67.31190013984796,56.47177746645967,NaN,NaN,122.3632547702589,132.20746577855493,0.6122203493286834,1.3124334933216062,0.7002131439929228,5282165371,5263407200.4,74.6908236197946,48.79107626126112,NaN,NaN,18.7937645408689,7.8067535290838475
2017-07-25T09:30:00-04:00,144.29,144.74,144.01,144.4,28120884,40745833.4,65.1203196249636,57.95739248734327,NaN,NaN,106.1605234608015,127.41526317835493,0.5437295135419187,1.3798750359203211,0.8361455223784025,5254044487,5269164502.8,75.23204967557092,52.55645586956261,NaN,NaN,20.366770168723853,9.601041620460991
2017-07-26T09:30:00-04:00,144.74,144.95,144.53,144.87,18610634,38378474.15,66.60760388204713,59.79953508529278,NaN,NaN,103.56050874711075,117.53496377778076,0.4946689078613755,1.4544816572051218,0.9598127493437463,5272655121,5271893470.2,75.499497863057,56.42636243055852,NaN,NaN,22.12304082524609,11.389898649716006
2017-07-27T09:30:00-04:00,145.86,145.96,142.3,143.96,80665866,39540408.45,61.169072975580605,60.865647157326634,NaN,NaN,77.33546505441085,105.3990559631558,0.3711628054332503,1.423766256135309,1.0526034507020587,5191989255,5251261374.6,69.39813224548116,59.518748750422205,NaN,NaN,22.230731569685204,12.938589066854462
2017-07-28T09:30:00-04:00,143.14,144.0752,142.87,143.84,38013176,37002599.7,60.467928657060156,61.66279955466185,NaN,NaN,59.72357631264018,93.82866566904441,0.25704010116999676,1.3739035771645547,1.116863475994558,5153976079,5230966062.6,63.925524030229965,62.10520698286227,NaN,NaN,22.137059490238723,14.25265627019507
2017-07-31T09:30:00-04:00,144.22,144.43,142.92,143.23,33848645,35250119.2,56.89764219873965,62.11110680665053,NaN,NaN,53.06555405770707,79.96912552653404,0.12292472817105571,1.2705193862083775,1.1475946580373217,5120127434,5198558475.2,56.291940719367865,63.72041595289735,NaN,NaN,21.10464273994929,15.23151148015996
2017-08-01T09:30:00-04:00,143.7,143.76,143.12,143.56,20149421,34617740,58.331016663508535,62.289360293838534,NaN,NaN,47.51188893820546,68.23939862201485,0.043017320866691744,1.2013663091206865,1.1583489882539948,5140276855,5175804948.8,51.63023404373253,64.64098825247324,NaN,NaN,20.586051286375,15.99644573819068
2017-08-02T09:30:00-04:00,144.45,144.52,142.61,143.95,41769667,34600394.15,60.023030293614006,62.52248323187076,NaN,NaN,49.4281733739841,57.412931547389505,0.005006309261792907,1.164606874831236,1.159600565569443,5182046522,5157683229,48.20620790600363,64.70386916103409,NaN,NaN,20.57165643380558,16.650047266135665
2017-08-03T09:30:00-04:00,144.17,144.17,143.13,143.39,27112799,33534510.3,56.47678308095017,62.271763816490136,NaN,NaN,40.23066982435844,49.99197250137903,-0.0653904441664579,1.0778625103613706,1.1432529545278285,5154933723,5150272122.6,46.83816055574901,64.18220714101791,NaN,NaN,19.620416430517707,17.074385718190243
2017-08-04T09:30:00-04:00,143.65,143.97,143.06,143.65,29472909,33159635.65,57.72559936598348,62.095830445914096,NaN,NaN,34.505205304764374,44.94829829980386,-0.09991611663382738,1.0183578087355443,1.1182739253693716,5184406632,5156358233.2,48.139750652623015,63.35181294287711,NaN,NaN,19.12403830238471,17.367193230218025
2017-08-07T09:30:00-04:00,143.89,144.56,143.71,144.56,17933942,32813655.5,61.85140565581651,62.01936884406767,NaN,NaN,66.51583856973565,47.6383552022096,-0.06843938716926279,1.0327246914077932,1.101164078577056,5202340574,5172800861.2,51.58833112524289,62.44329749936021,NaN,NaN,19.787774594365697,17.712990567953405
2017-08-08T09:30:00-04:00,144.27,145.47,143.9,144.31,30810364,32778290.7,60.11559704221025,61.65640608335455,NaN,NaN,88.13861759867378,55.76370093430326,-0.07111619584541073,1.0122688337702925,1.0833850296157033,5171530210,5179051532.2,52.87134370453309,61.35377089446697,NaN,NaN,19.888652539277274,18.023799420999673
2017-08-09T09:30:00-04:00,143.14,144.19,142.795,144.12,36169473,32784474.4,58.765779578697035,61.16041722701683,NaN,NaN,13.887095515951167,48.65548536269667,-0.0910683098054319,0.9695496423589134,1.0606179521643453,5135360737,5169714375.2,50.709411195247164,59.867602024717016,NaN,NaN,19.621300423242687,18.252013849891533
2017-08-10T09:30:00-04:00,143.33,143.4,140.89,141.03,63331663,34397377.8,42.17868076645907,59.50302570896259,NaN,NaN,-198.53694091292888,0.9019632152392092,-0.30566598962796765,0.6785354651293858,0.9842014547573534,5072029074,5153133445.4,47.03159206801762,58.003785671760774,NaN,NaN,13.780326271151322,17.61320133864293
2017-08-11T09:30:00-04:00,141.24,142.41,140.9,142.1,45862488,34963259.85,47.68523809204032,58.101121276976336,NaN,NaN,-193.7644278288886,-44.75196341149139,-0.3648360181380321,0.5281564320848133,0.8929924502228455,5117891562,5139830431.4,44.25813913581834,55.830022494333896,NaN,NaN,10.676408727985592,16.622230965691884
2017-08-14T09:30:00-04:00,143.23,144.15,143.19,143.93,34161024,35404153.3,55.492172953390345,57.41339651472111,NaN,NaN,10.061095573279239,-56.042912010782665,-0.2741522556855758,0.5503021306158757,0.8244543863014515,5152052586,5129772833.8,42.230519739843785,53.47277035606767,NaN,NaN,10.707292392610931,15.777239740966033
2017-08-15T09:30:00-04:00,144.22,144.302,143.64,144.03,25509181,35392186,55.87963484503993,56.64711301207773,NaN,NaN,33.37019105517516,-66.99659731948239,-0.20407654284228793,0.5693587077485915,0.7734352505908795,5177561767,5130979145.2,42.570363433165575,51.12068932536114,NaN,NaN,10.859098138879778,15.07464808352514
2017-08-16T09:30:00-04:00,144.37,144.96,143.8007,144.28,31913002,35300220.65,56.89003854816525,56.34146769583378,NaN,NaN,74.81972652593252,-54.81007111748611,-0.14055325961741172,0.5977436760691148,0.7382969356865265,5209474769,5145801951.6,46.7181441257916,49.50069017395475,NaN,NaN,11.296921547602173,14.534972864107573
2017-08-17T09:30:00-04:00,143.73,143.94,141.33,141.33,70190975,37002796.95,44.065969418153436,55.16989917876901,NaN,NaN,-167.03180628952938,-48.50904419280621,-0.28836308271646016,0.3778430822909513,0.6662061650074115,5139283794,5159252895.6,50.23088902937189,48.522501959607744,NaN,NaN,7.075570133853256,13.46934390264267
2017-08-18T09:30:00-04:00,141.43,142.2,140.65,141.23,60751940,38055539.25,43.70630589775598,54.22766087155589,NaN,NaN,-204.20995568440048,-50.59814976390858,-0.3783463878099741,0.1932731802449439,0.571619568054918,5078531854,5151380954,48.22701049633374,47.94643551510531,NaN,NaN,3.747742931118879,12.080543763853557
2017-08-21T09:30:00-04:00,141.23,141.53,140.18,141.05,37111487,38575477,43.025572731217935,53.13441487639227,NaN,NaN,-185.82492825587474,-89.77535452973937,-0.43161116331608945,0.03210561390980615,0.4637167772258956,5041420367,5129254510.2,43.0307183168129,47.332184391753906,NaN,NaN,0.9119076629698911,10.485024320870176
2017-08-22T09:30:00-04:00,141.8,143.35,141.76,143.2,36294232,38984144.4,52.53504691649809,52.599558920883986,NaN,NaN,-38.73299483861161,-104.19599170849672,-0.30939036244273954,0.07697882417247115,0.3863691866152107,5077714599,5109285076.6,38.951591227061215,46.67114034325802,NaN,NaN,1.5614917189757394,9.21023394917097
2017-08-23T09:30:00-04:00,142.5,143.01,142.38,142.69,25702324,39338728.9,50.38667894307327,52.16455148246422,NaN,NaN,-37.22470732539296,-126.60487847876182,-0.252635440893117,0.07057488549881441,0.3232103263919314,5052012275,5077792577.8,33.55015525199008,45.721997107275236,NaN,NaN,1.3769830102216256,8.091198100749635
2017-08-24T09:30:00-04:00,143.03,143.17,141.47,142.27,38160803,37213475.75,48.62321331564349,51.514381050297075,NaN,NaN,-59.029608596128995,-105.00443894008174,-0.23356905397319117,0.031249008925442467,0.26481806289863363,5013851472,5052706113.4,29.98333675039835,44.42511039997347,NaN,NaN,0.6753821176010806,7.031795817442698
2017-08-25T09:30:00-04:00,142.8,143.18,141.78,141.97,26380436,36631838.75,47.34849538390934,50.478458888018,NaN,NaN,-52.52414344246469,-74.6672764916946,-0.23093413114068523,-0.02384960102722289,0.20708453011346234,4987471036,5034493949.8,27.682437643696048,42.71754657986298,NaN,NaN,-0.2768314261181946,5.987706211219714
2017-08-28T09:30:00-04:00,142.41,142.74,141.9501,142.41,15362141,35707513.55,49.442011603427034,49.71605992810491,NaN,NaN,-43.753994265132874,-46.253089693546215,-0.19098484185356016,-0.03164652220348785,0.1593383196500723,5002833177,5026776511.8,26.745804402585094,40.85143662972384,NaN,NaN,-0.4541321882775095,5.06744358272011
2017-08-29T09:30:00-04:00,141.18,143.21,141.06,142.97,24498333,35924959.15,52.054951040855705,49.236715032544815,NaN,NaN,-36.63496526198453,-45.833483778220796,-0.12164842558462158,0.007277787669295321,0.1289262132539169,5027331510,5016699894,25.531125422336245,39.05298764594449,NaN,NaN,0.15672543372307415,4.365912418577676
2017-08-30T09:30:00-04:00,143.11,144.89,143,144.65,33642716,35518611.6,58.915021279411626,50.432167926327146,NaN,NaN,87.26972786873482,-20.93459673939524,0.03422558788406796,0.17170819810900184,0.13748261022493388,5060974226,5018492284.2,26.173400653076172,37.56311683059153,NaN,NaN,2.8830598554030473,4.154076338124158
2017-08-31T09:30:00-04:00,145.03,146.21,144.98,146.2,38480747,36087009,64.02885041499518,51.59956880653821,NaN,NaN,171.1614807667795,25.10362113318646,0.2277942140758584,0.4222253778197569,0.1944311637438985,5099454973,5035612984.4,32.18952513752153,36.70107297357033,NaN,NaN,6.991724748966324,4.559454682530181
2017-09-01T09:30:00-04:00,146.36,146.585,145.61,146,22293553,35728041.2,62.94023498011346,52.13157323701842,NaN,NaN,159.51711800957415,67.51187342359422,0.3226418052417342,0.5977334202960662,0.27509161505433205,5077161420,5053551061.2,37.89954684424674,36.39171776674196,NaN,NaN,9.916446386806168,5.3247392117124654
2017-09-05T09:30:00-04:00,145.55,145.88,143.6,144.69,45480562,37105372.2,56.200193388173396,52.15447027581367,NaN,NaN,82.43590118657758,92.74985251393632,0.27906792396501356,0.623926520010599,0.34485859604558544,5031680858,5059320597.4,39.65949400135001,36.18379852161228,NaN,NaN,10.327841985234576,6.039468179358481
2017-09-06T09:30:00-04:00,145.06,145.46,144.08,145.13,30722723,37100990.15,57.83350041570022,52.22186040920902,NaN,NaN,89.25492348386278,117.92783026310579,0.2620632197223339,0.6724376206985028,0.4103744009761689,5062403581,5066335011.6,41.818361530835276,35.83381405054398,NaN,NaN,11.166416642557298,6.771889388386883
2017-09-07T09:30:00-04:00,145.4,145.84,144.94,145.47,22721131,36428573.05,59.10261858987517,53.29590677861772,NaN,NaN,104.87302815282861,121.44849031992453,0.2556239141399813,0.7299042936511455,0.4742803795111642,5085124712,5071165108.8,43.32212574853588,35.34033095905569,NaN,NaN,12.230781860343267,7.551731170094938
2017-09-08T09:30:00-04:00,145.28,145.35,144.06,144.21,27890115,34656495.65,52.76460043770777,53.9429278171857,NaN,NaN,55.09341979349155,98.23487812526695,0.1534534740752348,0.6660972221052077,0.5126437480299729,5057234597,5062721033.6,41.31187774395345,34.84639290531425,NaN,NaN,11.219434468585359,8.075688784165
2017-09-11T09:30:00-04:00,145.3,146.12,145.3,145.87,27126332,33719687.85,59.00235013728555,55.08412620333338,NaN,NaN,105.41940565768073,87.41533565488827,0.18263438367373497,0.7409367276221417,0.5583023439484067,5084360929,5064160935.4,41.80775077658083,34.75903808101196,NaN,NaN,12.343479539923626,8.685373177844802
2017-09-12T09:30:00-04:00,146.25,146.41,145.53,146.22,30256661,33524469.7,60.19587927257891,55.631328514482014,NaN,NaN,105.96069949697944,92.12029531696865,0.20859666273766364,0.8190481723704863,0.6104515096328227,5114617590,5080748281.8,47.32880682233179,35.35741062353128,NaN,NaN,13.618283099255068,9.390074595189127
2017-09-13T09:30:00-04:00,145.95,146.44,145.73,146.42,28450864,33671553.85,60.89642606661927,56.38202473759244,NaN,NaN,100.57860985077316,94.38503259035072,0.22113249740679186,0.8868671313913126,0.6657346339845207,5143068454,5096881256.4,52.089896286391294,36.681677840274226,NaN,NaN,14.856341054702908,10.170969803691095
2017-09-14T09:30:00-04:00,145.85,146.2869,145.47,145.56,35296413,33840724.4,56.307329616887024,56.930890187681264,NaN,NaN,76.0385080611799,88.61812857202096,0.15644501833606328,0.8612909069045998,0.7048458885685365,5107772041,5101410722.2,53.36447675047032,38.3517592688508,NaN,NaN,14.552317261230948,10.796876583339646
2017-09-15T09:30:00-04:00,145.56,146.59,145.29,146.06,46422402,32652295.75,58.2760196772618,57.71142763720644,NaN,NaN,77.90079967736001,93.17960454879467,0.13318193977093407,0.871323313282204,0.73814137351127,5154194443,5120802691.4,58.45976446790746,40.55013975629446,NaN,NaN,14.87331025622268,11.379224250894366
2017-09-18T09:30:00-04:00,145.88,146.37,145.11,145.55,24858157,30857606.6,55.52772379957104,58.14612136550244,NaN,NaN,60.240592389391374,84.14384189513679,0.07234297290099123,0.828570089637509,0.7562271167365178,5129336286,5129797762.8,60.60962064750307,42.9689837737886,NaN,NaN,14.349273843023521,11.80351704976996
2017-09-19T09:30:00-04:00,145.81,146.01,145.31,145.8,20871237,30045594.1,56.60800723423285,58.47133966502938,NaN,NaN,57.423101347339944,74.43632226520889,0.03947798661517399,0.8055746000054853,0.7660966133903113,5150207523,5136915749.4,62.27350870083136,45.59343972225254,NaN,NaN,14.214038815707179,12.147877302046705
2017-09-20T09:30:00-04:00,145.75,145.91,144.23,145.35,34236155,29942690.25,54.062346977672306,58.124720072048,NaN,NaN,25.504875851108874,59.421575465276035,-0.01889295668810953,0.7424804175301745,0.761373374218284,5115971368,5131496332.2,60.18887261381407,48.02311629087667,NaN,NaN,13.392109593928156,12.325624772315484
2017-09-21T09:30:00-04:00,145.25,145.26,143.95,144.46,28841835,30099665.8,49.33676381069049,57.07528531459767,NaN,NaN,-14.423042793494629,41.329265294341134,-0.1182273496259002,0.6135891871859087,0.7318165368118089,5087129533,5127367830.6,58.5800750695725,49.90815557173745,NaN,NaN,11.305904895677383,12.179950504224326
2017-09-22T09:30:00-04:00,144,144.53,143.855,144.32,21702401,29276745.7,48.61686708741799,56.05218760797657,NaN,NaN,-44.58839626594277,16.83142610568057,-0.18989685427259484,0.49444546897106534,0.6843423232436602,5065427132,5109614368.4,52.127575320216614,50.92444332002102,NaN,NaN,9.376835435941949,11.779505494469701
2017-09-25T09:30:00-04:00,143.75,143.8299,142.1,142.8,54947712,30705109.5,41.531290459650954,55.00440882736782,NaN,NaN,-141.55849437049048,-23.528391246295815,-0.32810507175988013,0.27421098354381,0.6023160553036901,5010479420,5085842995.2,44.98291534353203,51.30468770160545,NaN,NaN,5.422070367835638,10.87130047637912
2017-09-26T09:30:00-04:00,143.51,143.8,142.67,143.17,29628806,31418442.75,43.682937561827224,53.99365433780547,NaN,NaN,-129.54913895826985,-60.92283930741777,-0.379410159804878,0.12805335554759267,0.5074635153524707,5040108226,5063823135.8,39.57226023469263,51.144251894738126,NaN,NaN,2.754184594609064,9.711712493269113
2017-09-27T09:30:00-04:00,143.93,145,143.57,144.46,33249403,31855996.25,50.519728195911796,53.380590738236656,NaN,NaN,-60.09614980965929,-78.04304443957139,-0.313979549202646,0.1149890788491632,0.4289686280518092,5073357629,5055300388,37.68297631017356,50.74145550628367,NaN,NaN,2.443675519867777,8.673421497068922
2017-09-28T09:30:00-04:00,144.14,144.5566,143.78,144.41,24149422,31381331.55,50.265019880712025,53.202049269879815,NaN,NaN,-68.64401310468982,-88.88723850181043,-0.2636112915728661,0.09945451358572654,0.36306580515859266,5049208207,5047716122.8,36.03427959166983,50.36448420969198,NaN,NaN,2.120310160388175,7.737262734685959
2017-09-29T09:30:00-04:00,144.7,145.555,144.32,145.45,43102366,31612412.5,55.311889949894926,52.93844497078049,NaN,NaN,7.041210603554679,-78.56131712791094,-0.15516213525666683,0.16911313608775913,0.32427527134442596,5092310573,5053092811,38.10184521938547,50.099776669892314,NaN,NaN,3.3597929220395533,7.1119099043079
2017-10-02T09:30:00-04:00,145.67,146.17,144.93,145.58,27351260,31865297.85,55.91410900653733,52.6326042374918,NaN,NaN,50.42511199723229,-40.1645958543664,-0.0737145090174009,0.23213213507267483,0.3058466440900757,5119661833,5074929293.6,45.7686582607362,49.988337486921196,NaN,NaN,4.543842520300028,6.745043135163918
2017-10-03T09:30:00-04:00,145.74,146.06,145.45,145.89,19715152,30577027.35,57.38876149658395,52.382056768203554,NaN,NaN,65.92295177590591,-1.0701777075312406,-0.0018053481129253202,0.30358995894891905,0.30539530706184437,5139376985,5094783045.4,51.63434459251998,49.955798080216105,NaN,NaN,5.956217511924346,6.632353760415408
2017-10-04T09:30:00-04:00,145.6,146.34,145.47,146.03,26381099,30359946.15,58.07087537637106,52.508024322452414,NaN,NaN,72.28036606878983,25.405125468158584,0.04951080237615235,0.3672838100320348,0.31777300765588246,5165758084,5113263136.4,56.36527863701516,50.170141072112166,NaN,NaN,7.321387232977478,6.730787113638561
2017-10-05T09:30:00-04:00,146.54,147.54,146.4063,147.46,31562353,30802007.25,64.34859683357092,52.94177983361736,NaN,NaN,153.22238968838806,69.77840602677416,0.1674415166763577,0.5270749035013296,0.35963338682497187,5197320437,5142885582.4,62.66880039618291,50.47078649556041,NaN,NaN,10.499432414800891,7.269165013804608
2017-10-06T09:30:00-04:00,146.97,147.66,146.96,147.66,23561069,30585554.95,65.13483941030688,53.62800237724134,NaN,NaN,155.62166860929284,99.4944976279218,0.24206546653777739,0.6622152199971936,0.4201497534594162,5220881506,5168599769,67.11046121014624,50.935132250034926,NaN,NaN,13.34672208397126,8.137387452399844
2017-10-09T09:30:00-04:00,147.86,148.0093,147.3,147.49,13704835,29914480.1,63.845946399441566,54.14499803189911,NaN,NaN,149.40627752836272,119.29073073414789,0.26146941290287196,0.7469865195880061,0.48551710668513415,5207176671,5186102736.6,69.74885068180348,51.46908524867579,NaN,NaN,15.362745897136135,9.1695815159336
2017-10-10T09:30:00-04:00,147.98,148.14,146.95,147.6,19223092,29362801.65,64.33769304145157,54.87895132216905,NaN,NaN,133.36641251906775,132.77942288278024,0.26251834812087727,0.8136650418362308,0.5511466937153535,5226399763,5203507292.2,72.14198575222596,52.32287904427664,NaN,NaN,17.182588865529485,10.314296851590155
2017-10-11T09:30:00-04:00,147.53,148.07,147.34,148.04,12439051,28562211,66.31152609731072,56.09143434264193,NaN,NaN,135.62239421284025,145.44782851159033,0.27246922767257,0.8917332283060659,0.619264000633496,5238838814,5218123438.2,74.0020144593807,53.42444614354866,NaN,NaN,19.30973151086863,11.599358945772794
2017-10-12T09:30:00-04:00,147.84,148.355,147.615,147.77,14513477,27523064.2,63.9716944572675,57.18820772620261,NaN,NaN,123.88492269055183,139.58033511202308,0.24154647812891616,0.9211970982946411,0.679650620165725,5224325337,5223524418.2,74.67490580124787,55.0349697493366,NaN,NaN,20.51958210219533,12.873676539547441
2017-10-13T09:30:00-04:00,148.4,148.51,147.7772,148.34,18409888,26122438.5,66.64730154836792,58.98220851825382,NaN,NaN,121.72405430064137,132.80081225029278,0.23968225567390866,0.9792534397581107,0.7395711840842021,5242735225,5227895162,75.23355147600407,57.1957294730846,NaN,NaN,22.326799045462643,14.224122611821041
2017-10-16T09:30:00-04:00,148.7,148.89,148.3928,148.85,21809410,25970001.15,68.87457621871758,60.78161127946027,NaN,NaN,124.76283157121289,127.87212305886283,0.25175373648993093,1.0542633546966158,0.8025096182066849,5264544635,5239368754.8,76.68735490600174,59.84680766389239,NaN,NaN,24.533896496041006,15.696947452423894
2017-10-17T09:30:00-04:00,148.79,149.06,148.57,149.04,13138157,25583347.15,69.6867398830864,62.15068354282989,NaN,NaN,114.04122256613626,124.00708506827652,0.2509315890535957,1.1161741045236795,0.8652425154700838,5277682792,5249625360.6,77.9343033938588,62.7219024555842,NaN,NaN,26.622994316916497,17.25781129020855
2017-10-18T09:30:00-04:00,149.21,149.21,148.64,148.86,17218243,24732451.55,67.8796836008579,63.408873808554596,NaN,NaN,101.18049830428379,117.11870588656525,0.2178866040847105,1.1376007705759719,0.9197141664912614,5260464549,5253950507.6,78.45758237832942,65.75213836891703,NaN,NaN,27.928107414942698,18.782139308027716
2017-10-19T09:30:00-04:00,148.02,148.33,147.27,148.31,27680285,24674374.05,62.542958637222426,63.925378714792274,NaN,NaN,58.926950519358066,104.12711145232649,0.14226809826963005,1.097549289328299,0.9552811910586689,5232784264,5255642293,78.67065237870312,68.64991030886829,NaN,NaN,27.644511183060843,20.048192433032447
2017-10-20T09:30:00-04:00,148.91,149.04,148.53,148.71,30173268,25097917.4,64.71565509295911,64.55406057810812,NaN,NaN,83.26898358134306,96.43609730846683,0.10423190425577056,1.0855710713783822,0.9813391671226116,5262957532,5259686754.4,79.20029764075039,71.03788455029787,NaN,NaN,27.98511106634882,21.182037952077643
2017-10-23T09:30:00-04:00,149.01,149.03,147.53,147.74,29297126,23815388.1,56.20203864045425,64.46929465981313,NaN,NaN,52.347795102244895,81.95309001467322,0.004077730306643046,0.9864363300059154,0.9823585996992723,5233660406,5253509908.6,76.09258671022232,72.78490184441947,NaN,NaN,25.774563962616337,21.838113096440313
2017-10-24T09:30:00-04:00,148,148.3,147.44,147.99,20289467,23348421.15,57.744933994625285,64.44601313254559,NaN,NaN,38.93908689128192,66.93266287970236,-0.05191228685999172,0.9174682411242827,0.9693805279842744,5253949873,5248763324.8,73.69939867791084,74.02305327591202,NaN,NaN,24.363689237284085,22.198909687989424
2017-10-25T09:30:00-04:00,147.7,148.18,146.33,147.43,36179124,23494907.2,53.222132291110874,63.651265665227015,NaN,NaN,-2.003963038681555,46.29577061110929,-0.12885996602804273,0.808305570449221,0.9371655364772637,5217770749,5240224564.8,69.4667723152051,74.50862269869931,NaN,NaN,21.79269243061211,22.140878651221236
2017-10-26T09:30:00-04:00,147.36,147.705,146.92,146.96,28230199,23698946.05,49.703490467091704,62.54902645499735,NaN,NaN,-23.407310832021224,29.828918340833432,-0.2088724895573456,0.6760749245305817,0.8849474140879273,5189540550,5231575822,65.3715487036956,74.38441466252426,NaN,NaN,18.53320406012091,21.62549656677833
2017-10-27T09:30:00-04:00,149.33,151.52,149.2,151.24,60165127,24552084.1,69.48686064457364,62.95194890107835,NaN,NaN,229.49084997038966,59.07329161864275,0.016998356329638087,0.906195359499975,0.8891970031703369,5249705677,5228925451,64.12399445319178,73.98263921762343,NaN,NaN,22.847076214706235,21.800007945053746
2017-10-30T09:30:00-04:00,151.08,152.19,150.9899,151.58,31733386,24771190.4,70.48019564142847,63.390699086790995,NaN,NaN,253.3863915039776,99.28101089898928,0.17127011111175627,1.1032846420600322,0.9320145309482759,5281439063,5238481182.4,66.59897827531157,73.58671011212955,NaN,NaN,26.37653371099107,22.45379734018765
2017-10-31T09:30:00-04:00,152.04,152.37,151.63,152.15,26319327,25101399.15,72.1188955860172,63.80551119312717,NaN,NaN,224.8063500480143,136.45446353033577,0.2868654658370504,1.290596363244589,1.0037308974075385,5307758390,5249242885.8,69.17786774956845,73.2421282042858,NaN,NaN,29.700110272786755,23.48898490198752
2017-11-01T09:30:00-04:00,152.75,152.83,151.5,152.1,29481569,25256422.65,71.74267430510412,64.36058118225836,NaN,NaN,189.22887106725005,174.7010303515221,0.3319387267956224,1.4186543059020664,1.086715579106444,5278276821,5261344100.2,71.81328876296986,73.03772698726596,NaN,NaN,32.08377907722007,24.716812641306458
2017-11-02T09:30:00-04:00,151.92,151.99,150.77,151.81,31017426,25229176.3,69.47876483386078,64.56282855979356,NaN,NaN,129.94985239362083,205.37246299665048,0.3143744959828001,1.4796836990849442,1.1653092031021441,5247259395,5272887869.2,74.08927795705522,72.9559931644839,NaN,NaN,33.25779040937709,25.936952322459405
2017-11-03T09:30:00-04:00,152.39,153.29,151.84,153.27,26199249,25361085.3,73.9377229525065,64.92448189792135,NaN,NaN,153.95396476876923,190.2650859563264,0.3694354334334289,1.6271034948939302,1.2576680614605014,5273458644,5277638462.6,74.98447836160159,72.83435912559817,NaN,NaN,35.82533439130264,27.349578332294154
2017-11-06T09:30:00-05:00,153.13,153.85,153.1,153.79,28693919,26110539.5,75.32065273108691,65.32690424420709,NaN,NaN,152.03998144684056,169.995803944899,0.40629941197272923,1.765542326426413,1.3592429144536837,5302152563,5281781162.6,75.77062449310324,72.67981063268705,NaN,NaN,38.35219785861657,28.921381121768786
2017-11-07T09:30:00-05:00,153.67,154.0823,153.34,153.88,21333062,26216038,75.56234962407642,65.87566610300841,NaN,NaN,134.0237957733524,151.83929308996662,0.4014577845428027,1.8610651451321871,1.4596073605893845,5323485625,5284926609.6,76.37764107255023,72.53124339655997,NaN,NaN,40.416016100937924,30.563471833078662
2017-11-08T09:30:00-05:00,153.81,154.54,153.62,154.5,17373517,26462761.3,77.21762501266092,66.92385655839688,NaN,NaN,128.43201497752597,139.6799218720218,0.4036380556993462,1.9641549302135672,1.560516874514221,5340859142,5297443073.8,78.6678587198252,72.53104384949727,NaN,NaN,42.66807991498846,32.292701559065776
2017-11-09T09:30:00-05:00,153.26,153.77,152.11,153.69,40594482,27766811.55,70.49912178175049,67.33696132188197,NaN,NaN,86.21685856832663,130.93332310696297,0.31792599140054545,1.9579243637649029,1.6399983723643574,5300264660,5308044126.8,80.40102004403498,72.61680973544617,NaN,NaN,42.50597733475807,33.75174095559325
2017-11-10T09:30:00-05:00,153.36,153.8,153.06,153.68,20150762,27853855.25,70.41766310267346,68.35236306918334,NaN,NaN,87.10734518066121,117.56399918934137,0.2319473954487783,1.9299326166753303,1.697985221226552,5280113898,5309375177.6,80.61399239497587,72.93976728435715,NaN,NaN,42.352875693843714,34.98047448962903
2017-11-13T09:30:00-05:00,153.12,154.0693,153.1,153.87,12522399,27389504.7,71.10090760249875,69.30636118403145,NaN,NaN,83.50762998792324,103.8575288975579,0.16254376042434782,1.9011649217569868,1.738621161332639,5292636297,5307471924.4,79.28727065502875,73.33890099700842,NaN,NaN,42.41693008899979,36.04282528953914
2017-11-14T09:30:00-05:00,153.31,153.5,152.57,153.31,25173763,27991285,66.24452634668452,70.236532188001,NaN,NaN,61.46628546943367,89.34602683677416,0.05893352505841487,1.8122880676556576,1.7533545425972428,5267462534,5296267306.2,71.79601009833704,73.50527512437499,NaN,NaN,41.08162773450703,36.76265421024884
2017-11-15T09:30:00-05:00,152.61,153,151.78,152.59,24808004,28370773.05,60.52088933124771,71.0092035354407,NaN,NaN,37.38585051443403,71.13679394415578,-0.07103047259939155,1.6645664518480032,1.7355969244473948,5242654530,5276626383.8,60.9286832799307,73.18792759410607,NaN,NaN,38.21833875444188,36.97060914513356
2017-11-16T09:30:00-05:00,153.38,154.89,153.33,154.54,34790570,28726287.3,68.46728591444757,70.93637676900313,NaN,NaN,90.1506390774402,71.92355004597849,-0.04014451518379647,1.6854162804676491,1.7255607956514456,5277445100,5272062471.8,58.70507574876533,72.80086197236132,NaN,NaN,38.049861683226524,37.12478807914684
2017-11-17T09:30:00-05:00,154.58,154.69,153.8,153.95,28725800,28653913.9,64.25323337690767,70.49159375010879,NaN,NaN,81.32504807745894,70.76709062533803,-0.07206538366034376,1.635479066076016,1.7075444497363597,5248719300,5265783552.2,55.69363546941619,72.02190891479736,NaN,NaN,36.52939779227523,37.03973232387947
2017-11-20T09:30:00-05:00,154.08,154.2,153.61,153.83,21143944,28246254.8,63.39854064255149,69.86871125414696,NaN,NaN,68.58898266738362,67.7833611612301,-0.11152045558242141,1.568143880258333,1.6796643358407544,5227575356,5252771364,49.9725290213242,70.65009900563706,NaN,NaN,35.06092070812245,36.7570449501999
2017-11-21T09:30:00-05:00,154.56,155.57,154.485,155.5,20147763,28239169.6,69.4824717610177,69.70726821528363,NaN,NaN,117.30883077177674,78.95187022169873,-0.03914172428564999,1.6307371804836919,1.6698789047693419,5247723119,5248823481,48.34972133301502,68.97412990349743,NaN,NaN,35.73870401718327,36.61156767405466
2017-11-22T09:30:00-05:00,155.63,155.84,155.341,155.69,17299040,27295165.4,70.09158920479308,69.75104138463594,NaN,NaN,137.97621516089507,99.06994315099092,0.005177125050209286,1.6763503110821034,1.6711731860318941,5265022159,5253297006.8,50.31851695775377,67.27621840354732,NaN,NaN,36.46611881673245,36.59078926586577
2017-11-24T09:30:00-05:00,155.86,156.31,155.76,156.26,8209832,26294147.05,71.90339429990723,69.60573219516456,NaN,NaN,168.23503756735948,114.68682284897477,0.053824229203109475,1.738453472535781,1.6846292433326715,5273231991,5252454385,49.93243620597763,65.48678682100275,NaN,NaN,37.6383691192142,36.74044353062983
2017-11-27T09:30:00-05:00,156.2,156.56,155.83,156.19,22653389,24418560.15,71.33190274637981,69.3208214819712,NaN,NaN,160.70601586591627,130.56301640666624,0.06166805688867005,1.761714314443509,1.700046257554839,5250578602,5252826245.4,50.11434676387029,63.65419555462897,NaN,NaN,38.40837288091022,36.978719152098456
2017-11-28T09:30:00-05:00,156.52,156.69,155.7,156.59,25227320,24093256.85,72.66870529077849,69.11413260102135,NaN,NaN,148.43147568235872,146.53151500966126,0.07337974298523542,1.7917709362863832,1.7183911933011478,5275805922,5262472358.6,54.711091672051076,62.10658488316475,NaN,NaN,39.44508362701961,37.33105693423005
2017-11-29T09:30:00-05:00,156.45,156.45,153.12,153.86,71986338,26376607.4,54.120002532597766,67.46430242387399,NaN,NaN,29.792584377260223,129.02826573075794,-0.11301475316360254,1.5771227518466446,1.6901375050102472,5203819584,5253691651.6,50.17842693510918,60.07162546997075,NaN,NaN,33.98247665708659,36.852688323209556
2017-11-30T09:30:00-05:00,154.46,155.45,154.145,155.15,56595465,27732302.2,59.39430265823189,66.67110105790837,NaN,NaN,51.270870513782924,111.68719680133552,-0.15700266686891817,1.4938841714240993,1.6508868382930175,5260415049,5252770229.6,49.71298890384647,57.87962324567157,NaN,NaN,31.261727329781884,36.05397960986274
2017-12-01T09:30:00-05:00,154.19,155.24,152.26,154.49,59015828,29132222.3,55.856343121123395,65.63100677351194,NaN,NaN,-20.567312057481338,73.92672687636737,-0.23351357805786277,1.358994865720689,1.5925084437785517,5201399221,5238403675.6,43.01367817676487,55.19388651579936,NaN,NaN,27.869939303664992,34.88483099469163
2017-12-04T09:30:00-05:00,155.47,155.625,152.56,152.71,51319146,30388217.15,47.61799840320174,63.95365611641929,NaN,NaN,-52.65116480163432,31.255290742857245,-0.39734200439803224,1.0958309382810114,1.4931729426790437,5150080075,5218303970.2,35.754148958052866,52.08437782315822,NaN,NaN,21.90416558652152,33.0304502220959
2017-12-05T09:30:00-05:00,152.64,154.55,152.1,152.81,40604211,30983731.75,48.081291704601476,62.656282213413355,NaN,NaN,-86.43926043644498,-15.718856480903497,-0.4864283700119514,0.8851374801641043,1.3715658501760557,5190684286,5201279643,30.984263002595682,49.16925303060527,NaN,NaN,17.536172717724156,30.81698200718565
2017-12-06T09:30:00-05:00,152.26,153.735,152.06,153.5,28647769,31349467.1,51.28304483227296,61.9964361777723,NaN,NaN,-85.78732633546865,-38.83483862344928,-0.48523671516123956,0.7650199562245064,1.250256671385746,5219332055,5204382137.2,32.74514753513475,47.15614333454842,NaN,NaN,15.01397721043031,28.55940989336346
2017-12-07T09:30:00-05:00,153.49,154.46,153.33,154.02,32666207,32114101.6,53.60510310185515,60.93485169115856,NaN,NaN,-22.49945943734397,-53.588904613674664,-0.43726606479746444,0.7036740903889154,1.1409401551863798,5251998262,5202698779.8,32.26413890881612,45.26750498883776,NaN,NaN,13.69874862935977,26.436458284220073
2017-12-08T09:30:00-05:00,155.1,155.53,154.46,154.7,28081666,31488460.8,56.523458747103994,60.38272493188687,NaN,NaN,41.573248307956966,-41.160792540586996,-0.3512825030433149,0.7018370263822362,1.053119529425551,5280079928,5218434921.2,40.990522207883394,44.217282613013985,NaN,NaN,13.519104106071806,24.591121973056033
2017-12-11T09:30:00-05:00,154.76,155.95,154.76,155.9,20821528,31521999.1,61.16582215152662,60.223245039670815,NaN,NaN,78.54493342922599,-14.921572894414936,-0.21199475618362262,0.7881260841960227,1.0001208403796453,5300901456,5248599197.4,53.38708387519701,44.46117938829061,NaN,NaN,14.868032465844475,23.202109186311525
2017-12-12T09:30:00-05:00,155.81,156.15,155.36,155.69,20310252,31911391.75,59.95922338127333,59.54301301254621,NaN,NaN,82.30564213759905,18.82740762039387,-0.1360983996773666,0.8299978407829371,0.9660962404603037,5280591204,5266580581,58.92641093647897,45.216657217109464,NaN,NaN,15.5794260801031,22.113154456853177
2017-12-13T09:30:00-05:00,156.28,156.49,155.76,155.99,24418479,31873627.55,61.13861748148777,58.90351503231012,NaN,NaN,95.2791356531731,55.04070001812222,-0.07105594664044568,0.8772763071597467,0.9483322538001924,5305009683,5283716106.6,63.391147678347075,46.150416554294715,NaN,NaN,16.51276290844613,21.313098521366456
2017-12-14T09:30:00-05:00,156.28,156.66,155.71,155.88,24594682,31862961.45,60.43569714442969,58.08439380691886,NaN,NaN,88.51474389541701,77.24354068467441,-0.042229434178480796,0.8955454610770914,0.9377748952555722,5280415001,5289399454.4,64.75940542922535,47.20948578452669,NaN,NaN,17.0796980957081,20.70832703198669
2017-12-15T09:30:00-05:00,156.49,157.82,156.23,157.65,49816151,32614240.5,67.00859105239515,57.775585828777096,NaN,NaN,148.29414284363355,98.58771959180973,0.0824599523334767,1.040849835672418,0.9583898833389414,5330231152,5299429699.2,67.09669895380512,48.4225109409506,NaN,NaN,19.68202156083376,20.56171196467913
2017-12-18T09:30:00-05:00,158.29,158.77,158.07,158.64,26844519,32520176.45,70.00969224151046,57.58565632525796,NaN,NaN,195.66018791866034,122.0107704896966,0.21073218675800032,1.2218051167864417,1.0110729300284413,5357075671,5310664542.2,69.534085482573,49.48129621313074,NaN,NaN,22.880299353462505,20.892938734505325
2017-12-19T09:30:00-05:00,158.34,158.5,157.26,157.7,31414968,33033727.65,64.0518525504832,58.295074183678345,NaN,NaN,138.22329429506226,133.19430092118924,0.21087744590603785,1.2746697374109885,1.0637922915049507,5325660703,5319678442,71.36676194090468,50.9947487135447,NaN,NaN,23.70927627069609,21.295272668246863
2017-12-20T09:30:00-05:00,158.25,158.28,156.91,157.53,38972602,33974969.6,63.00754373154759,58.553162831772326,NaN,NaN,110.18433488560997,136.1753407676766,0.1793665532424389,1.2880004830579992,1.1086339298155603,5286688101,5316014125.6,69.53553032888945,52.410644529619205,NaN,NaN,24.057591331929416,21.689889620201512
2017-12-21T09:30:00-05:00,157.73,158.25,157.37,157.55,18638679,34041951.55,63.08380077950821,59.06940980737124,NaN,NaN,104.5767297541046,139.38773793941414,0.1413825944360103,1.285362172860573,1.1439795784245628,5305326780,5320996481.4,70.63871641909105,54.38386154692822,NaN,NaN,24.35988445971367,22.071317454417535
2017-12-22T09:30:00-05:00,157.31,157.432,156.95,157.37,23330440,34797981.95,61.84808032066827,60.08584423004742,NaN,NaN,74.94053639269993,124.71701664922742,0.08824685276649724,1.2542881443826843,1.166041291616187,5281996340,5311349519,65.67936767656653,56.52137716967919,NaN,NaN,24.271973106394345,22.385696833271364
2017-12-26T09:30:00-05:00,156.53,156.72,155.95,156.52,21918720,34761248.5,56.24511072832395,60.66897416031332,NaN,NaN,32.75266563181257,92.13551219185786,-0.014559236667587072,1.1478422457817032,1.1624014824492903,5260077620,5291949908.8,57.01116829755914,58.38044183360516,NaN,NaN,22.59859497285191,22.416110853211443
2017-12-27T09:30:00-05:00,156.52,156.96,156.39,156.54,22388186,34619291.8,56.34532246283304,61.03056541963904,NaN,NaN,42.85477126883935,73.06180758661327,-0.08755392175207244,1.0529590802591997,1.1405130020112721,5282465806,5283310929.4,53.617564551971384,59.87132876337921,NaN,NaN,21.251283458897856,22.249706939738072
2017-12-28T09:30:00-05:00,157.05,157.0653,156.54,156.73,25393825,32289666.15,57.34479825345738,61.29768650189634,NaN,NaN,45.16257510096304,60.057455629683886,-0.1269883381759518,0.9817775792913324,1.1087659174672841,5307859631,5287545235.4,55.03050445522831,61.49749773098008,NaN,NaN,20.371462701236915,21.981386334237907
2017-12-29T09:30:00-05:00,156.9,156.9,155.7,155.76,33185962,31119191,50.93347572831777,60.89840200055447,NaN,NaN,10.62571666517943,41.26725301189884,-0.2170596690212987,0.8374413311906608,1.0545010002119595,5274673669,5281414613.2,52.53517813385137,62.322116011406365,NaN,NaN,17.758971711238296,21.378184245237964
2018-01-02T09:30:00-05:00,156.5,158.525,156.17,158.49,32573272,29797063.2,63.352202473154186,61.054572023527875,NaN,NaN,85.72006699109231,43.423159131577336,-0.09752746980950855,0.9325916629500739,1.0301191327595824,5307246941,5286464733.4,54.37065913652434,62.39237138721546,NaN,NaN,19.255491784911552,21.074942465191334
2018-01-03T09:30:00-05:00,158.61,160.17,158.61,160.03,29383557,28700283.75,68.23611764649084,61.645778756757686,NaN,NaN,165.84967964007436,70.04256193322969,0.071393350835113,1.1193608213034736,1.0479674704683606,5336630498,5301775309,59.485822952474656,62.43232938835801,NaN,NaN,22.29738543662368,21.249577175395956
2018-01-04T09:30:00-05:00,160.59,160.79,160.0825,160.31,24776125,27908879.45,69.04388931642563,62.210441030681814,NaN,NaN,185.97900837978256,98.66740935541834,0.18184191773239355,1.2752698676338525,1.093427949901459,5361406623,5317563472.4,63.971117066398925,62.473755773218855,NaN,NaN,24.930022005914996,21.775355008327246
2018-01-05T09:30:00-05:00,161.04,162.03,160.77,161.92,26992340,27826108,73.25544831597404,63.126137542934984,NaN,NaN,215.3853192196827,132.71195817916228,0.33431435075643345,1.5113208883470008,1.1770065375905674,5388398963,5333671338.8,67.8783783720872,62.696539554851846,NaN,NaN,28.715738319952628,22.76683833855944
2018-01-08T09:30:00-05:00,161.9,162.63,161.86,162.55,23159061,27350750.7,74.70562149353142,63.67592543158757,NaN,NaN,212.61094855104673,173.10900455633572,0.4418303914717774,1.729294526930289,1.2874641354585117,5411558024,5361048209.8,73.19839444820897,63.132374947309266,NaN,NaN,32.23633579128907,24.11962368894939
2018-01-09T09:30:00-05:00,162.85,163.04,162.07,162.56,24782448,27185789.8,74.72904491514663,64.013022051133,NaN,NaN,178.62318713234762,191.6896285845868,0.4749584955197024,1.8811622548581397,1.4062037593384373,5436340472,5386866916,77.05753738613697,63.6697643689924,NaN,NaN,34.97354729080476,25.670184203500156
2018-01-10T09:30:00-05:00,161.8,162.21,161.12,162.18,34004028,27844914.8,72.00050600648713,64.58078301227614,NaN,NaN,126.0303184732436,183.72575635122067,0.4337536366681447,1.948395805173618,1.5146421685054734,5402336444,5400008105.2,78.7358145329477,64.19612526842404,NaN,NaN,36.39449460478313,27.20222854654058
2018-01-11T09:30:00-05:00,162.48,163.3,162.21,163.29,20473518,27853078.1,74.88516877314116,65.4291848009614,NaN,NaN,138.10074598623453,174.15010387251104,0.442218050339785,2.0674147314302047,1.6251966810904197,5422809962,5412288773,80.19393637900568,64.9574399862895,NaN,NaN,38.540749785650554,28.822017294984864
2018-01-12T09:30:00-05:00,163.03,164.66,162.94,164.49,37762708,28520289.55,77.5749736617637,66.46426857826536,NaN,NaN,145.25552467972554,160.12414496451962,0.48610616857915456,2.232829391814363,1.7467232232352083,5460572670,5426723514.4,81.77578728889713,65.75294504841851,NaN,NaN,41.27810720748192,30.601458711055873
2018-01-16T09:30:00-05:00,165.55,166.415,163.53,164.02,41231849,29352147.9,74.22204195256147,67.34812298054345,NaN,NaN,140.28440364608227,145.65883598352673,0.44221305802774324,2.2994895457698874,1.8572764877421442,5419340821,5428280073.8,81.94326154614974,66.91465175338874,NaN,NaN,42.46983269829293,32.296940709232594
2018-01-17T09:30:00-05:00,164.77,166.04,163.9982,165.79,33849879,28553834.3,78.06677097890285,68.90681299844195,NaN,NaN,134.9471612801471,136.92363081308662,0.4875449972021073,2.4667077342447783,1.979162737042671,5453190700,5431650119.4,82.32204079130858,68.72257121722798,NaN,NaN,44.829517814880134,34.087308867182244
2018-01-18T09:30:00-05:00,165.55,166.1999,165.135,165.82,26432166,28533216.65,78.12631960662668,70.46259850871293,NaN,NaN,126.43454236941584,137.00447559232106,0.4742711450975663,2.5720016684146287,2.0977305233170624,5479622866,5447107403.8,83.98179167313337,70.89144458302526,NaN,NaN,46.6859704100069,35.887117659014336
2018-01-19T09:30:00-05:00,166.32,166.61,165.535,166.34,38937588,28909347.65,79.18140445093488,72.02235609424703,NaN,NaN,120.37925208333036,133.46017681174027,0.45514985105935946,2.6666678371412615,2.211517986081902,5518560454,5466257502.2,85.76495863749452,73.08676273890141,NaN,NaN,48.54507987589997,37.69539797571228
2018-01-22T09:30:00-05:00,166.27,168.12,166.09,168.12,26081388,28264786.95,82.32438318568641,74.26456376977337,NaN,NaN,131.79190121208413,130.76745211821196,0.5127387413631816,2.852441412785879,2.3397026714226974,5544641842,5483071336.6,87.12062635401175,75.5571518974843,NaN,NaN,51.27474256044411,39.635304344959685
2018-01-23T09:30:00-05:00,168.64,169.66,168.555,169.51,37989650,29232335.5,84.31567670989197,75.7619547866832,NaN,NaN,151.08745820965902,132.92806303092732,0.5893316601016427,3.0763672465497507,2.487035586448108,5582631492,5515729470.8,89.26008810328808,78.04925396653884,NaN,NaN,54.29520557662803,41.72957594948373
2018-01-24T09:30:00-05:00,169.81,170.24,167.44,168.41,54287377,30780182.35,76.92955450103344,76.38291456200768,NaN,NaN,126.44789553078938,131.22820988105576,0.5135716193608064,3.129000110649116,2.6154284912883097,5528344115,5530760153.8,90.07708617734663,80.23434419688684,NaN,NaN,54.323272575663836,43.52867546750946
2018-01-25T09:30:00-05:00,169.55,169.63,167.81,168.35,28924956,31130494.15,76.53571835715663,76.91804520777418,NaN,NaN,112.73633919161054,128.48856924549472,0.41149099847376913,3.129792239380521,2.7183012409067517,5499419159,5534719412.4,90.28669387458872,82.1140282546147,NaN,NaN,54.221230621056016,45.05618334658754
2018-01-26T09:30:00-05:00,169.27,170.952,168.96,170.93,32038184,31612994.05,81.0323642869219,77.47353920569903,NaN,NaN,130.5819820444822,130.5291152377251,0.4658051439496398,3.3005576708438014,2.8347525268941616,5531457343,5537298790.2,90.42854466385211,83.72475441831219,NaN,NaN,55.68079255679793,46.57398466233188
2018-01-29T09:30:00-05:00,170.52,170.91,169.74,170.1,37277849,32207195.25,75.98731298743475,77.5650885981207,NaN,NaN,118.61295173202535,127.89332534171335,0.3966173640919597,3.330524232009111,2.9339068679171514,5494179494,5527206320.6,85.18647823572701,84.58104611742063,NaN,NaN,55.13430482937823,47.7968875433385
2018-01-30T09:30:00-05:00,168.55,169.42,167.82,168.7,44987688,32797281.55,68.26671869634473,77.10349386820626,NaN,NaN,79.76494614708945,113.62882292919944,0.21636786823638143,3.204366703212628,2.9879988349762465,5449191806,5500518383.4,73.11630615505379,84.29952960091468,NaN,NaN,52.00940623194346,48.398675927424925
2018-01-31T09:30:00-05:00,169.67,169.9899,168.34,169.4,42449199,33291077.9,69.912781393215,76.95437068154398,NaN,NaN,85.07094621727882,105.35343306649733,0.10947996471587018,3.1248487908710842,3.015368826155214,5491641005,5493177761.4,70.1711786198214,83.68776989283424,NaN,NaN,50.04087863520429,48.63327631425055
2018-02-01T09:30:00-05:00,168.12,169.73,167.42,167.96,38037875,33723793.8,62.706769799574225,76.08448504057492,NaN,NaN,58.920798035701644,94.59032483531554,-0.08264240100772025,2.9120658248955635,2.994708225903284,5453603130,5484014555.6,66.5666708660835,82.71439378476836,NaN,NaN,45.927314625358264,48.24671035869451
2018-02-02T09:30:00-05:00,167.34,167.7,164.47,164.61,68478082,35908891.65,49.83731824662527,74.10322393949359,NaN,NaN,-15.31186411700807,65.41155560301749,-0.4398200836388946,2.4449331213546657,2.8847532049935602,5385125048,5454748096.6,56.57145918535719,80.9140846345155,NaN,NaN,37.21474392364132,46.670715153686906
2018-02-05T09:30:00-05:00,163.13,165.75,158,158.12,105372224,39827885.85,34.89559252889896,71.29419183780341,NaN,NaN,-142.82271508533842,13.124422239544737,-1.0811124223736006,1.5333626770265596,2.61447509940016,5279752824,5411862762.6,45.73460173322192,78.32775179073495,NaN,NaN,21.814296185773557,43.11979815827071
2018-02-06T09:30:00-05:00,155.96,162.51,155.1,162.31,118537891,44596827.35,46.12565361980133,69.01268345501045,NaN,NaN,-149.69870437297178,-32.76830786446751,-1.1828279957868122,1.1359401046666449,2.318768100453457,5398290715,5401682544.4,43.59949114818492,75.56185538765469,NaN,NaN,14.877908404541845,39.08524247916659
2018-02-07T09:30:00-05:00,161.79,163.55,160.2,160.21,91028328,47909121.35,42.197003977479994,66.44630376721426,NaN,NaN,-112.16769002957643,-72.21603511383857,-1.3397324087494464,0.644102589516649,1.9838349982660954,5307262387,5364806820.8,36.882641367470676,72.19763036582165,NaN,NaN,8.15872658500741,34.66716878000099
2018-02-08T09:30:00-05:00,160.69,160.8,153.45,153.45,94184831,50918161.5,32.57787746362918,63.11748041097814,NaN,NaN,-212.89204262936673,-126.57860324685225,-1.817339720787156,-0.2878396527178495,1.5295000680693065,5213077556,5316701706,30.320371071890605,68.23730268256422,NaN,NaN,-2.0761653453360043,29.418121047809993
2018-02-09T09:30:00-05:00,155.66,157.24,150.125,156.1,113836554,55586313.3,38.49671220024867,59.98693248344687,NaN,NaN,-201.13724617828055,-163.74367965910676,-1.8662541310539462,-0.8033175957481262,1.06293653530582,5326914110,5305059518.4,28.97665246152583,64.0841616902438,NaN,NaN,-6.80938026809402,24.242763716966564
2018-02-12T09:30:00-05:00,157.67,159.95,156.46,158.87,63050637,56850709.75,44.02796454847763,57.10923875763156,NaN,NaN,-110.77524830363167,-157.3341863027654,-1.6319962711117086,-0.9770588035838159,0.6549374675278928,5389964747,5327101903,34.86255672766649,60.198623734842265,NaN,NaN,-8.00284729321505,19.63624785836919
2018-02-13T09:30:00-05:00,157.98,160.01,157.7197,159.69,31785595,56378397.05,45.58801441557487,54.87055732295595,NaN,NaN,-86.10079225148087,-144.61460387846722,-1.3532564970955878,-1.036633153841592,0.3166233432539959,5421750342,5331793828.4,36.07691541906493,56.34146868067929,NaN,NaN,-8.267124145461878,15.650051857821897
2018-02-14T09:30:00-05:00,158.79,162.93,158,162.68,52107431,57291274.65,50.9558211083303,53.04342180518264,NaN,NaN,-48.71043380694515,-131.92315263394096,-0.9196796448685419,-0.8329762128316816,0.0867034320368604,5473857773,5365112905.6,44.053480308047455,53.039096283069206,NaN,NaN,-6.447716001415506,12.49322787793084
2018-02-15T09:30:00-05:00,164.14,165.7,162.44,165.7,51633887,58551360.7,55.708545926141696,51.23457763655548,NaN,NaN,3.0569769289409097,-88.73334872227943,-0.40777206089984824,-0.4230116440879499,-0.01523958318810166,5525491660,5427595726.4,55.31448817633342,50.53094939110358,NaN,NaN,-3.2097222809012997,10.249949283811963
2018-02-16T09:30:00-05:00,165.18,166.755,164.6799,164.96,62256291,59717295.85,54.31948808578115,49.686875857865935,NaN,NaN,16.528711369293195,-45.200157212764715,-0.11262835417656157,-0.15602502590880363,-0.043396671732242056,5463235369,5454859978.2,59.17583764560538,48.67304649180918,NaN,NaN,-1.2277429202694783,8.610278968943186
2018-02-20T09:30:00-05:00,164.39,166.68,164.31,165.29,36785626,60252507.75,54.86002668120594,48.72925499964174,NaN,NaN,17.804595826516035,-19.484188386735166,0.09972163598158891,0.08125537324474408,-0.01846626273684483,5500020995,5476871227.8,62.0285950217195,47.881067125142444,NaN,NaN,0.47824104304325865,7.448559265243197
2018-02-21T09:30:00-05:00,166.06,167.72,164.72,164.82,41161779,60411114.2,53.88209432427266,47.58420592328872,NaN,NaN,26.4052409751007,3.017018258581147,0.1977649743676075,0.22873995522266455,0.03097498085505705,5458859216,5484293002.6,62.96825238128009,47.36657239381805,NaN,NaN,1.5425653028413135,6.604845842042928
2018-02-22T09:30:00-05:00,165.54,166.42,164.3769,164.8,37074413,59550466,53.83811389546415,46.950730501566575,NaN,NaN,21.048346486691944,16.968774317308572,0.24729072644118388,0.3400883889065369,0.09279766246535302,5421784803,5473878408.6,60.69834086506807,46.947405965174084,NaN,NaN,2.3823148634970246,6.001627130822085
2018-02-23T09:30:00-05:00,166.06,168.17,165.45,168.17,50096916,60609064,59.79333190720318,47.661874334465,NaN,NaN,57.028916667351815,27.76316226499076,0.4795886283493969,0.6922834479020992,0.21269481955270225,5471881719,5463156420.4,58.36562371049976,47.07556057411285,NaN,NaN,4.968498250549043,5.854037290783078
2018-02-26T09:30:00-05:00,168.93,170.4,168.82,170.4,39266658,60970487.7,63.17846433033309,49.682079463138855,NaN,NaN,101.5076915813891,44.75895830740994,0.7404219167699408,1.1382222155151283,0.39780029874518746,5511148377,5472739022,59.85072396504856,48.08385501924333,NaN,NaN,8.24213232595129,6.195193724378537
2018-02-27T09:30:00-05:00,170.42,170.73,168.21,168.29,42209873,61217088.9,58.18659935676338,50.54357558720757,NaN,NaN,90.16176107699175,59.230391357505084,0.7268110883595862,1.3063141591946703,0.5795030708350841,5468938504,5466522523.8,58.39549896794868,49.140712720655024,NaN,NaN,9.49749264469522,6.666950712995206
2018-02-28T09:30:00-05:00,169.25,169.8,167.1,167.21,42936334,61114521.2,55.758155077150924,51.512229237184066,NaN,NaN,73.43539519954093,68.63642220239313,0.6059731507448676,1.3369695092661686,0.7309963585213011,5426002170,5459951114.6,56.822676138696444,50.56500091859972,NaN,NaN,9.803837771542403,7.115077435644806
2018-03-01T09:30:00-05:00,167.29,168.07,163.001,164.48,76809904,62832556.45,50.069589456064016,52.7616372366437,NaN,NaN,29.264526653936077,70.27965823584195,0.3175815820946879,1.1279733361396609,0.810391754044973,5349192266,5445432607.2,53.400562667563236,52.213586032576345,NaN,NaN,8.31022493052119,7.285812792055718
2018-03-02T09:30:00-05:00,162.59,166.28,161.96,165.99,57445063,63802915.85,52.93005705254365,53.79259044037906,NaN,NaN,25.63195314289772,64.00026553095114,0.20915166805899488,1.0718313391187166,0.8626796710597218,5406637329,5432383729.2,50.45919749796564,53.74805353517919,NaN,NaN,7.933555906871442,7.378347522743678
2018-03-05T09:30:00-05:00,165.26,168.26,164.59,167.83,38540207,62306022.1,56.22130263726841,54.66354316100698,NaN,NaN,63.48785147584215,56.396297509841744,0.2397854380660318,1.1624114686422615,0.9226260305762297,5445177536,5419189561,47.60397560446554,54.65815488352199,NaN,NaN,8.616793418618581,7.555268365011521
2018-03-06T09:30:00-05:00,168.61,169.11,167.48,168.54,29480927,58511457.25,57.45743644125496,55.51135901998413,NaN,NaN,83.78827487957763,55.12160027035892,0.2833152786452239,1.2767701288827595,0.9934548502375357,5474658463,5420333552.8,47.87935717215798,55.501186437314345,NaN,NaN,9.540039354179616,7.838807077749821
2018-03-07T09:30:00-05:00,167.26,169.07,166.96,168.93,34609407,54315033.05,58.15634950105777,56.025682476607514,NaN,NaN,77.95745224960058,56.02601168037086,0.3115788349973325,1.3829283939842014,1.071349558986869,5509267870,5436986692.8,51.84687522951486,56.05785750313345,NaN,NaN,10.495401598734054,8.218320580747568
2018-03-08T09:30:00-05:00,169.54,169.98,168.95,169.86,25828371,51055035.2,59.85024054552375,56.32151780656337,NaN,NaN,96.66650548120195,69.50640744582402,0.36254354509635367,1.524528990357311,1.1619854452609573,5535096241,5474167487.8,59.29669903809612,56.3423011361165,NaN,NaN,11.776994930172162,8.726702630665367
2018-03-09T09:30:00-05:00,171.1,173.16,170.82,173.16,38310546,48261320.95,65.22907121128061,57.10077374409904,NaN,NaN,149.30714115226007,94.24144504769649,0.5754867974244768,1.8813439420415534,1.3058571446170766,5573406787,5507521379.4,64.58929376779253,56.7289765734155,NaN,NaN,14.57562660461976,9.562263198373136
2018-03-12T09:30:00-04:00,173.65,174.48,173.28,174.08,37634971,44451241.8,66.5735493927846,57.937453937783225,NaN,NaN,170.63978425824845,115.67183160417775,0.7255945341105208,2.2128503122552274,1.4872557781447067,5611041758,5540694223.8,68.91809390691866,57.22108363664402,NaN,NaN,17.301612141822204,10.667884476008718
2018-03-13T09:30:00-04:00,174.8,175.21,171.2666,171.71,55638925,44080656.2,60.123984411048504,58.383303229695784,NaN,NaN,132.62063313327735,125.43830325491771,0.6168354006439647,2.2583000289496624,1.6414646283056977,5555402833,5556843097.8,70.79009990447497,57.77978703115794,NaN,NaN,17.782212520965256,11.684217053859651
2018-03-14T09:30:00-04:00,172.58,172.74,170.93,171.68,40536383,44518195.6,60.044686657259874,58.826629855538336,NaN,NaN,101.58045227182053,130.1629032593617,0.49945230222494996,2.265780006086885,1.7663277038619352,5514866450,5557962813.8,70.92087685908507,58.50996817358772,NaN,NaN,18.147372414248427,12.60752496248662
2018-03-15T09:30:00-04:00,171.83,172.53,170.9,171.53,28810366,43353342.35,59.62126893195432,58.81433964302057,NaN,NaN,90.52934600360837,128.93547136384296,0.3740208131495004,2.2338537202988107,1.8598329071493103,5486056084,5548154782.4,68.04699604555044,59.20149476894848,NaN,NaN,18.33410911278505,13.425608412529252
2018-03-16T09:30:00-04:00,171.78,172.2,170.935,171.02,31176742,42330485.1,58.12058905314152,58.45306283750688,NaN,NaN,74.19825690775833,113.91369451494263,0.22629324659272987,2.1426994653902227,1.9164062187974928,5454879342,5524449293.4,61.55457404100386,59.32319834580243,NaN,NaN,18.095643166231596,14.09275623448673
2018-03-19T09:30:00-04:00,169.16,169.22,165.6393,167.1,71395061,42787423.6,48.099250620309604,57.73253792776018,NaN,NaN,-40.14487498957918,71.7567626653771,-0.14579894793702297,1.734157533876214,1.879956481813237,5383484281,5478937798,51.412566328082306,58.82441744295483,NaN,NaN,14.86720338986025,14.203391542397233
2018-03-20T09:30:00-04:00,167.1,168.04,166.61,167.65,34075664,42651925.5,49.41708514114021,57.279604360902276,NaN,NaN,-41.34798683044937,36.963038672631754,-0.3534155943652755,1.4381869888566428,1.7916025832219182,5417559945,5451369220.4,46.42287607769934,58.08157458145503,NaN,NaN,12.5779765476431,13.9711894002895
2018-03-21T09:30:00-04:00,167.23,168.76,166.19,166.92,43863543,42787013.7,47.6863670148631,57.10937418653078,NaN,NaN,-49.280926937076224,6.790762830852389,-0.5279396500467457,1.131678020663486,1.6596176707102317,5373696402,5423135210.8,41.93422537656908,57.26255048924117,NaN,NaN,10.162053502741317,13.427027129211188
2018-03-22T09:30:00-04:00,164.7,165.77,162.59,162.8,66607288,44263657.45,39.317063302602755,56.13701749010643,NaN,NaN,-150.1897047571413,-41.353047321297545,-0.8877116706602568,0.5499780823849107,1.4376897530451676,5307089114,5387341816.8,37.04412160744133,56.304330782775146,NaN,NaN,5.1828944385793,12.249293887692348
2018-03-23T09:30:00-04:00,162.6,163.3,158.43,158.51,80110392,45764331.25,32.85164072656514,54.4677559250562,NaN,NaN,-215.6294808476784,-99.31859487238489,-1.3535594114139977,-0.2542595112223296,1.0992999001916681,5226978722,5341761692.8,31.936749842055946,55.18524322831731,NaN,NaN,-1.624344018428023,10.267345615389438
2018-03-26T09:30:00-04:00,161.68,164.6,159.16,164.4,57481503,46675073.5,45.984929092884144,53.64829111445828,NaN,NaN,-129.28882209536016,-117.14738429354108,-1.2087239968169008,-0.4116050958294579,0.7971189009874429,5284460225,5321956881.6,30.001232134015922,53.90823429702146,NaN,NaN,-2.909155292590181,8.384988342820922
2018-03-27T09:30:00-04:00,165.6,165.62,157.68,159.08,78889105,48509035.1,38.63476022688164,52.25389188058856,NaN,NaN,-148.87025884605953,-138.6518386966631,-1.4013578080145412,-0.9545783590307337,0.4467794489838075,5205571120,5279559116.6,26.323300039539575,52.085121783451804,NaN,NaN,-6.910148666138595,6.199968770112419
2018-03-28T09:30:00-04:00,158.25,159.78,156.04,157.25,89369655,50830701.15,36.47502019821709,50.58423328435237,NaN,NaN,-177.17298900587855,-164.23025111042358,-1.5694949847460662,-1.5150892819487751,0.054405702797290956,5116201465,5228060129.2,22.685394911201698,49.470028631530774,NaN,NaN,-10.762658700388327,3.776736274326599
2018-03-29T09:30:00-04:00,158.13,161.71,156.6338,160.13,68692566,50424834.25,41.97272612391558,48.92306577811201,NaN,NaN,-126.27058803791391,-159.4464277665781,-1.4093057238074673,-1.7072264519620433,-0.29792072815457593,5184894031,5203621112.6,21.188855191525462,46.36999730465455,NaN,NaN,-11.823829988355516,1.548083951086297
2018-04-02T09:30:00-04:00,159,159.74,153.88,155.51,85549443,51830053.25,36.51357083953574,46.775924452879956,NaN,NaN,-151.2325125298474,-146.5670341030119,-1.527145584050655,-2.2068527082178946,-0.6797071241672397,5099344588,5178094285.8,19.725129938859183,42.85621416407887,NaN,NaN,-14.754754126932243,-0.7808929172020656
2018-04-03T09:30:00-04:00,156.92,157.92,154.44,157.26,64090049,53107545.35,39.71223196800794,45.31794213551991,NaN,NaN,-124.78838997150675,-145.66694767824123,-1.4030721587219865,-2.433547322569723,-1.0304751638477363,5163434637,5153889168.2,18.42536946357275,39.11587627544299,NaN,NaN,-15.881417232932643,-2.938110676592148
2018-04-04T09:30:00-04:00,154.27,160.23,154.04,159.74,65768692,54921933.6,44.016926929971476,44.173102154999306,NaN,NaN,-92.52016866298099,-134.39692964162552,-1.0840915267644078,-2.385589572303246,-1.3014980455388383,5229203329,5158615610,19.540264178274327,35.44583251252794,NaN,NaN,-15.28664453016214,-4.702186941387861
2018-04-05T09:30:00-04:00,161.33,161.58,159.48,160.65,43054868,55344206.65,45.5531708039972,43.16823800300238,NaN,NaN,-54.840147199512316,-109.93036128035229,-0.757391193804708,-2.2482370377947234,-1.4908458439900154,5272258197,5189826956.4,26.667753919648348,32.49017236067779,NaN,NaN,-14.315481660954926,-6.07551475846887
2018-04-06T09:30:00-04:00,158.94,160.4601,155.88,156.63,59870865,57046331.35,40.2929728826017,41.894836847963816,NaN,NaN,-81.76527397751973,-101.02929846827344,-0.7558733079987068,-2.435687478988399,-1.679814170989692,5212387332,5195325616.6,27.879868212638385,30.084836230080263,NaN,NaN,-15.240694369903773,-7.384826131530999
2018-04-09T09:30:00-04:00,158.01,160.88,157.46,157.73,41810380,57221323.05,42.25781650319683,41.47759155388434,NaN,NaN,-63.96466413468954,-83.57572878924186,-0.6297838234070654,-2.4670439502485237,-1.8372601268414583,5254197712,5226296241.4,34.45171852618587,28.873347101373373,NaN,NaN,-15.343670258068046,-8.521803863893433
2018-04-10T09:30:00-04:00,160.13,161.73,159.07,161.21,48601323,57769640.65,48.07906682619637,41.38201881710263,NaN,NaN,-33.968072339374714,-65.41166526281545,-0.27890364857301964,-2.185889687557733,-1.9069860389847133,5302799035,5254169121,39.77100435764444,28.39821340708374,NaN,NaN,-13.520356282903853,-9.235882780894922
2018-04-11T09:30:00-04:00,160.2,162,160.1,160.28,41622139,57068801.35,46.72342144685162,41.3132369908161,NaN,NaN,-26.945414793839333,-52.29671448898712,-0.08632296218561253,-2.014889741716729,-1.9285667795311165,5261176896,5260563834.4,40.954863622507524,28.328258996079345,NaN,NaN,-12.481120042809385,-9.69948810402556
2018-04-12T09:30:00-04:00,161.3,162.77,161.16,162.21,30467889,56565376.65,49.88166587957298,42.067851460599684,NaN,NaN,0.009498461519545368,-41.32678535678074,0.17965853981991664,-1.7039936047562207,-1.8836521445761374,5291644785,5264441152,41.703093321237176,28.66104268992191,NaN,NaN,-10.637827794400382,-9.833536631221964
2018-04-13T09:30:00-04:00,163.01,163.26,160.67,161.37,44604892,57355102.95,48.53315456782901,43.18795959211853,NaN,NaN,4.581257929463859,-24.057478975384022,0.3005186542676981,-1.5080038267415148,-1.8085224810092129,5247039893,5271371664.2,43.09128123674656,29.457794932399803,NaN,NaN,-9.528029999907515,-9.78989282674847
2018-04-16T09:30:00-04:00,162.45,163.19,161.48,162.6,28180780,57205304.85,50.6375198381224,43.52028750249269,NaN,NaN,33.979992108497036,-4.468547726746721,0.4555014288523751,-1.239145694943744,-1.6946471237961191,5275220673,5275576256.4,43.96308788274536,30.455070343023333,NaN,NaN,-7.9888053392418,-9.532594614247518
2018-04-17T09:30:00-04:00,164.19,166.4592,163.91,166.1,35536087,55412356.15,56.13382637006223,44.77022079843415,NaN,NaN,120.40221060676326,26.405508862480872,0.7675750895757028,-0.7351782618264906,-1.5027533514021933,5310756760,5277167801.4,44.31085748909989,31.739895875134785,NaN,NaN,-4.937604610211878,-8.876167470813856
2018-04-18T09:30:00-04:00,166.12,167,165.31,166.44,29573880,55187266.95,56.6389173888902,46.21049916919652,NaN,NaN,146.63652703440974,61.121897228130685,0.958337580844729,-0.30483137534628213,-1.263168956191011,5340330640,5292998550.2,47.78224309688431,33.53252788839784,NaN,NaN,-2.3169016126988757,-7.939129491083145
2018-04-19T09:30:00-04:00,165.65,165.99,164.34,164.91,34705692,54729374.4,53.64547969422583,47.04426728136154,NaN,NaN,124.14164223842192,85.94832598351115,0.9415412197377706,-0.08624243151879796,-1.0277836512565686,5305624948,5295794582.8,48.39411013150511,35.475760384110664,NaN,NaN,-0.9295707494431668,-6.937763956563148
2018-04-20T09:30:00-04:00,164.49,164.61,161.73,162.3,49197140,53858867,48.897830410050496,47.928857250684025,NaN,NaN,62.300005372807036,97.49207547217979,0.7244624442315502,-0.12220559596713088,-0.846668040198681,5256427808,5297672165.8,48.827735890658396,37.55451795209632,NaN,NaN,-1.0930752711364635,-6.102808430073622
2018-04-23T09:30:00-04:00,163.08,163.73,161.02,161.89,33040646,51505379.7,48.176541673588225,48.533450801082616,NaN,NaN,38.35068125557666,98.3662133015957,0.5319778235574759,-0.18169576075183613,-0.713673584309312,5223387162,5287305463.6,46.504277673721695,39.56015425282124,NaN,NaN,-1.4301137455973845,-5.435280618005588
2018-04-24T09:30:00-04:00,162.62,162.905,157.39,158.46,70256751,52144142.1,42.525093098074365,48.426891241661394,NaN,NaN,-34.949117989336635,67.29594758237573,0.17105687474846154,-0.4998524908737352,-0.6709093656221967,5153130411,5255780193.8,40.23427991437922,41.038298233971595,NaN,NaN,-3.4186125026359164,-5.147185172952778
2018-04-25T09:30:00-04:00,158.8,159.31,156.47,158.65,52089323,50804153,42.92450226730072,48.23912920332594,NaN,NaN,-70.401983495056,23.888245476482595,-0.045886559050277276,-0.7282675644350434,-0.6823810053847661,5205219734,5228758012.6,35.781061683157745,41.689248788507975,NaN,NaN,-4.924278574023933,-5.1153413731058
2018-04-26T09:30:00-04:00,160.72,162.53,160.18,161.99,43005532,48485946.85,49.56025488149465,48.901077917532575,NaN,NaN,22.45600977115486,3.5511189830291796,0.03991508330879889,-0.6324871512487675,-0.6724022345575664,5248225266,5217278076.2,34.05648945645805,42.13043602020939,NaN,NaN,-4.324584244038317,-5.002376068953303
2018-04-27T09:30:00-04:00,164.35,164.41,161.17,162.09,51043406,47603488.85,49.748631323949816,49.43613611901493,NaN,NaN,46.90332053625555,0.4717820157188825,0.10411340506576627,-0.5422604782253586,-0.6463738832911249,5299268672,5225846249,36.51587557378067,42.2778758093233,NaN,NaN,-3.7851935903391767,-4.828492857722713
2018-04-30T09:30:00-04:00,162.48,163.48,160.54,160.94,35615273,45106780.35,47.54934985725126,49.3982991926617,NaN,NaN,13.864467489917178,-4.425460737413018,0.07139642660379664,-0.5571283500363791,-0.6285247766401757,5263653399,5233899496.4,38.82525006511984,42.210321931285826,NaN,NaN,-3.936594720254679,-4.701078838084422
2018-05-01T09:30:00-04:00,160.52,162.8,160.14,162.78,36513529,43727954.35,51.26190484624022,49.722476578332326,NaN,NaN,15.277569957338665,5.619876851922048,0.17030198151578513,-0.41564729974544434,-0.5859492812612295,5300166928,5263306799.8,46.4812826202179,42.605066145407996,NaN,NaN,-3.021335533696337,-4.461115508886124
2018-05-02T09:30:00-04:00,163.1,163.57,161.63,161.82,38646842,42371861.85,49.30117663754371,49.68101306104453,NaN,NaN,25.921129385094865,24.88449942795222,0.16744358641830726,-0.3766447982383454,-0.5440883846566527,5261520086,5274566870.2,49.1076453145388,43.133962716358106,NaN,NaN,-2.7879151317304127,-4.222086883578165
2018-05-03T09:30:00-04:00,161.08,162.4,159.22,161.8,60337134,43235975.15,49.25890482648288,49.73285236523409,NaN,NaN,-25.44948278406149,15.30340091690895,0.16055832692930427,-0.34339047599502237,-0.5039488029243266,5201182952,5265158407.4,47.03084822979864,43.415360358718964,NaN,NaN,-2.606088599734718,-3.9912299858862443
2018-05-04T09:30:00-04:00,161.11,165.25,160.98,164.87,41543243,42319594.05,55.55802614951338,50.08431710176201,NaN,NaN,75.93456139667131,21.109649088992107,0.3483406798246955,-0.06852295314345724,-0.41686363296815276,5242726195,5253849912,44.58993345459367,43.460135042422415,NaN,NaN,-0.6441051771596173,-3.5130692989252976
2018-05-07T09:30:00-04:00,165.64,166.78,165.51,166.24,32500152,41854082.65,58.0601776293438,50.22191362028213,NaN,NaN,164.76524644066782,51.28980487914223,0.5390090922284066,0.2568977323173556,-0.2821113599110511,5275226347,5256164501.6,45.21665154840084,43.52483461808678,NaN,NaN,1.7578938111915774,-2.7600745689086015
2018-05-08T09:30:00-04:00,165.83,166.43,164.86,166.07,26040170,40726025,57.62661047696296,50.29246312657305,NaN,NaN,124.6794212356765,73.1701751348098,0.6219835645461631,0.49536809577165286,-0.12661546877451027,5249186177,5245968351.4,42.91399372978971,43.17710252043717,NaN,NaN,3.625121840997318,-1.847903653207756
2018-05-09T09:30:00-04:00,166.4,168,165.78,167.88,29122718,40101053.95,60.96860987929367,50.81554385407789,NaN,NaN,150.34334889472262,98.05461903673536,0.7580492506496798,0.8209460945375895,0.0628968438879097,5278308895,5249326113.2,43.926704505221515,42.85800211855976,NaN,NaN,6.2210731596432725,-0.6951926799433235
2018-05-10T09:30:00-04:00,168.43,169.74,168.29,169.62,27067597,39931039.35,63.91503123106701,51.888201055579074,NaN,NaN,176.97589210561222,138.5396940146701,0.9140637088558743,1.2054764799577526,0.29141277110187835,5305376492,5270164821.2,49.870388330341676,42.93247729282285,NaN,NaN,9.348060399209894,0.7395577599357075
2018-05-11T09:30:00-04:00,169.35,169.86,168.72,169.46,24688847,38935237.1,63.44078401182845,52.97850407973909,NaN,NaN,151.5175155676572,153.65628484886727,0.9510662379011565,1.480245568478324,0.5291793305771675,5280687645,5277757111.2,51.8720189866643,43.315887386604466,NaN,NaN,11.80424648971676,2.320227578475858
2018-05-14T09:30:00-04:00,169.8398,170.82,169.47,169.75,21821749,38617285.55,63.96271910829907,54.50976308046943,NaN,NaN,142.7181303037931,149.24686162149231,0.9380849380570886,1.7017855031485283,0.7637005650914397,5302509394,5283213720.6,53.31481021752264,44.25021097968614,NaN,NaN,14.010746289581967,3.9903016800624447
2018-05-15T09:30:00-04:00,168.4,168.5,166.98,167.87,49361638,39308563.1,58.165379669943455,55.598397180658196,NaN,NaN,82.23825288287028,140.75862795093107,0.753832827988038,1.7059916000764872,0.9521587720884492,5253147756,5284006036.4,53.53263836512937,45.518180742684116,NaN,NaN,14.425979512918966,5.481112799041948
2018-05-16T09:30:00-04:00,168.1,169.37,168.01,168.98,22941159,38976927.05,60.44495281226453,56.375875604284616,NaN,NaN,97.77895444195478,130.2457490603775,0.6609869695240518,1.778392483993514,1.1174055144694621,5276088915,5283562040.4,53.38232493738344,46.89859756275022,NaN,NaN,15.40886775476353,6.899363507002174
2018-05-17T09:30:00-04:00,168.4,169.61,167.51,168.33,27480164,38615650.65,58.43687854648235,56.99646469160837,NaN,NaN,82.23807508091822,111.29818565543872,0.5164743007274113,1.7629983903787263,1.246524089651315,5248608751,5272208492.2,49.55083784749579,47.82966629658701,NaN,NaN,15.703516830271539,8.157099696040655
2018-05-18T09:30:00-04:00,167.71,168.26,167.21,167.46,26217939,37466690.6,55.76643624556864,57.583399433631044,NaN,NaN,58.495595440583834,92.69380163002407,0.3319364336176376,1.661444631673362,1.3295081980557244,5222390812,5260549125.6,45.90686174603406,48.33549570236659,NaN,NaN,15.236362716071497,9.16842298461649
2018-05-21T09:30:00-04:00,168.73,169.5,167.68,168.4,22954565,36962386.55,57.99970902564239,58.0646711607312,NaN,NaN,69.40862176704793,78.03189992267502,0.2467387487843289,1.6379316340361356,1.3911928852518067,5245345377,5249116322.2,42.59872410976765,48.0581700944773,NaN,NaN,15.425452223035215,10.062284304390593
2018-05-22T09:30:00-04:00,169.15,169.45,167.88,168.18,19477721,34423435.05,57.270917202692274,58.633938343956096,NaN,NaN,63.665768962226196,74.31740313854621,0.15368091153713226,1.5832940246732221,1.4296131131360899,5225867656,5243660302.2,41.07741666591969,47.48458233386164,NaN,NaN,15.393957050686694,10.82395183957575
2018-05-23T09:30:00-04:00,166.9,169.62,166.88,169.6,26557835,33146860.65,60.703215599611525,59.45138911346528,NaN,NaN,63.557796182932556,67.47317148674178,0.16488542740979328,1.6357198973983316,1.4708344699885383,5252425491,5238927617.4,39.751281346608145,46.96461327077661,NaN,NaN,16.284268513646552,11.603997078728723
2018-05-24T09:30:00-04:00,169.56,169.85,167.84,169.55,27696539,32381411,60.51887598993314,59.805735530638124,NaN,NaN,67.56607555374504,64.5387715813071,0.1466644340299641,1.6541650125259935,1.5075005784960294,5224728952,5234151657.6,38.40387817036881,46.522752179046265,NaN,NaN,16.982015596222695,12.372285438370719
2018-05-25T09:30:00-04:00,169.54,170.33,169.21,169.72,27460536,31202267.5,60.9530439294674,60.012368837789815,NaN,NaN,79.6725686701243,68.7741662272152,0.12466088422682353,1.6633266837795588,1.5386657995527353,5252189488,5240111392.8,41.0874028160831,46.22780584102357,NaN,NaN,17.685748894563663,13.131351646398283
2018-05-29T09:30:00-04:00,168.91,169.92,167.96,168.97,41220468,31482527.25,57.926529311356425,60.033791611675056,NaN,NaN,54.79083144057952,65.85060816192151,0.04244358569395379,1.5917202816701774,1.5492766959762236,5210969020,5233236121.4,38.97772437291911,45.94664374410424,NaN,NaN,17.538976038454194,13.761012273834842
2018-05-30T09:30:00-04:00,169.63,170.48,169.22,170.18,22665836,30790142.6,61.26791808529784,60.05517076924679,NaN,NaN,84.50332987752495,70.01812034498127,0.05178132620358822,1.614003353730709,1.5622220275271208,5233634856,5234789561.4,39.73072076225242,45.64693061960645,NaN,NaN,18.278618716286903,14.406384622756566
2018-05-31T09:30:00-04:00,170.13,171.2,169.63,170.07,35670946,30641347.8,60.79522403965069,59.83232739843134,NaN,NaN,96.41796870987363,76.59015485036949,0.033657155325755195,1.604293471684315,1.5706363163585597,5197963910,5223897245.2,36.34422635253228,44.68077619262006,NaN,NaN,18.78420067225976,15.031786915542737
2018-06-01T09:30:00-04:00,170.88,172.84,170.87,172.74,45543331,29901657.65,67.37486991812227,60.113333534595185,NaN,NaN,190.86007433387576,101.24895460639561,0.17660688335008645,1.7913949205461677,1.6147880371960812,5243507241,5227652903,38.29712531459613,43.71114093032948,NaN,NaN,21.168568282353863,15.908469967944326
2018-06-04T09:30:00-04:00,173.16,174.34,173.07,174.3,20459634,28847477.2,70.49100310014464,60.57963953401271,NaN,NaN,258.7716396515656,137.0687688026839,0.34178082008137123,2.0420140622977954,1.7002332422164241,5263966875,5230008380.4,39.54974073120469,42.72792168130677,NaN,NaN,24.219345730845767,17.095737934073103
2018-06-05T09:30:00-04:00,174.69,175.13,174.065,174.84,24779284,28461433.8,71.5055629804694,61.53250977047885,NaN,NaN,237.8657949448525,173.6837615035385,0.4463527648571497,2.258174198287861,1.8118214334307114,5288746159,5245563808.2,47.176303434369615,42.27389775768107,NaN,NaN,27.060613965430765,18.519291652838483
2018-06-06T09:30:00-04:00,175.0248,175.89,174.14,175.86,25036647,28411257.65,73.36814638122259,62.45559502540443,NaN,NaN,212.32429731254072,199.24795499054164,0.5370738713822649,2.4831637726585427,1.9460899012762778,5313782806,5261593398.2,53.66378806713896,42.29400226694933,NaN,NaN,30.058579452168026,20.167761338456987
2018-06-07T09:30:00-04:00,175.91,175.93,173.55,174.43,39600316,28935137.55,66.77779913861339,63.0513750676995,NaN,NaN,150.67512776782655,210.09938680213222,0.45678041416861337,2.5170654189870447,2.0602850048184314,5274182490,5276837114.2,58.84067748593048,42.95756224112323,NaN,NaN,30.72274585784427,21.675616269798027
2018-06-08T09:30:00-04:00,173.57,174.8803,173.18,174.44,31780348,29170775.1,66.80025781245877,63.83950517962023,NaN,NaN,111.97826102253369,194.3230241398638,0.36436379814832165,2.5157397525038334,2.1513759543555118,5305962838,5289328233.6,62.53449275895155,44.14525017061733,NaN,NaN,31.26715695392076,23.045836367529848
2018-06-11T09:30:00-04:00,174.3,175.34,174.28,174.91,22319709,29052318.2,67.89866005412445,64.54657311022609,NaN,NaN,112.00307377985544,164.96931096552177,0.2977189193325471,2.523524603521196,2.2258056841886487,5328282547,5302191368,65.92576887288911,45.81146765369744,NaN,NaN,32.02913130431669,24.329164215642255
2018-06-12T09:30:00-04:00,175.15,176,174.96,175.83,22511832,29086822.35,69.99154335190136,65.45518926374102,NaN,NaN,113.12808157556873,140.02176829166504,0.2787602878664823,2.5742560440217517,2.2954957561552694,5350794379,5314601012,68.85477454110064,47.7955646447818,NaN,NaN,33.27673628707786,25.607388797275913
2018-06-13T09:30:00-04:00,176.09,177.14,175.43,175.82,37858584,28511669.65,69.93816895689993,66.11482878926162,NaN,NaN,110.67841593487199,119.69259201613129,0.23069853675829632,2.58386892710314,2.3531703903448435,5312935795,5314431609.8,68.76787366601549,49.86817838188232,NaN,NaN,34.29413507569638,26.84835255133598
2018-06-14T09:30:00-04:00,176.62,177.89,176.5,177.6,35915978,29160410.6,73.77218705514923,67.06149386534848,NaN,NaN,122.3468651384312,114.02693949025222,0.2806228000937603,2.703948890462044,2.423326090368284,5348851773,5329365466.4,72.10967946779601,52.27573561741284,NaN,NaN,36.33974873896831,28.204266292426315
2018-06-15T09:30:00-04:00,176.98,177.325,176.11,176.98,49615730,30267188.9,70.40402789284082,67.73656414844659,NaN,NaN,99.34962403012558,111.50121209177061,0.23554369730997626,2.7177557120057543,2.482212014695778,5299236043,5328020107.4,71.36881454337566,54.43869359793373,NaN,NaN,37.11838260658841,29.47771148016376
2018-06-18T09:30:00-04:00,175.53,176.65,174.94,176.5,31633192,30537951.55,67.82232161778883,68.4434064560489,NaN,NaN,75.06389383791478,104.11337610338248,0.14167906742403424,2.659310848975821,2.5176317815517866,5267602851,5315884168.2,64.89206707098043,56.28971807636668,NaN,NaN,37.05206473413691,30.559761945017065
2018-06-19T09:30:00-04:00,174.26,176.04,173.71,176,38235994,31302023,65.14261076911009,68.72017021917834,NaN,NaN,52.17959804966881,91.9236793982025,0.020557884756020606,2.543329137496812,2.5227712527407915,5229366857,5291598663.8,54.27700013601757,57.328738031635616,NaN,NaN,36.24984103733112,31.372630386776216
2018-06-20T09:30:00-04:00,176.79,177.98,176.65,177.25,33038042,31980039.05,68.49405840432757,69.2700869595124,NaN,NaN,96.52212155168363,89.09242052156483,0.00033625149322125125,2.523191567107318,2.522855315614097,5262404899,5281492484.6,50.569792982202024,58.34484993375488,NaN,NaN,36.47449617473389,32.10146835648445
2018-06-21T09:30:00-04:00,177.69,177.88,175.37,175.71,43469439,32825619.25,60.74508583616233,68.79653095365812,NaN,NaN,68.36192518100381,78.29543253007935,-0.13363549595765267,2.355810945667031,2.4894464416246835,5218935460,5255509222,42.5273076391771,58.64700581408209,NaN,NaN,34.318857277484774,32.41823820234164
2018-06-22T09:30:00-04:00,176.31,176.369,174.69,175.32,30073187,32944451.65,58.926919828578335,67.97052500568911,NaN,NaN,39.54838473991928,66.3351846720381,-0.2581856951792054,2.1667143226506766,2.424900017829882,5188862273,5233434468,37.12529181868973,58.4738308917596,NaN,NaN,31.997659553983524,32.35815553829048
2018-06-25T09:30:00-04:00,173.76,173.99,169.81,171.37,77799725,35461411.1,44.42395543775205,66.0361244669236,NaN,NaN,-90.73283336182226,33.17583923209065,-0.5969039490096959,1.6787700815677624,2.2756740305774583,5111062548,5202126407.4,31.092846169336042,57.32501251568577,NaN,NaN,24.469613202789006,31.23122091893313
2018-06-26T09:30:00-04:00,171.99,173.0585,171.37,172.07,39008146,35350795,46.91729656425421,64.14677805142584,NaN,NaN,-90.82972228481351,4.5739751651941845,-0.7539898181800107,1.3331867578524452,2.087176576032456,5150070694,5186267174.8,28.5611589229746,55.53196757681689,NaN,NaN,19.319776983523703,29.529586071017498
2018-06-27T09:30:00-04:00,172.77,173.58,169.61,169.73,52843497,36859678.05,40.39340115443501,62.26217819541311,NaN,NaN,-144.7454523776398,-43.679539620670496,-0.9812845293089432,0.860570914396277,1.8418554437052201,5097227197,5153231634.4,24.150017724954353,53.054063308175735,NaN,NaN,12.477939539419246,27.093636566503463
2018-06-28T09:30:00-04:00,169.52,171.77,169.17,171.19,46407708,37396516.15,45.48668934275352,60.73978044757702,NaN,NaN,-158.79053610656837,-89.11003187818494,-0.9959259496193278,0.5969480066810604,1.5928739563003882,5143634905,5138171523.4,22.447926596753604,50.19073715373303,NaN,NaN,8.644010288621349,24.45797566966316
2018-06-29T09:30:00-04:00,172,172.92,171.395,171.65,36408464,36939772.8,47.022662739628224,59.24863778225586,NaN,NaN,-105.23171863426093,-118.06605255302097,-0.9380606267003664,0.4202981729249302,1.3583587996252966,5180043369,5136407742.6,22.250138932137602,47.0710493008222,NaN,NaN,6.147674826826437,21.84221840640077
2018-07-02T09:30:00-04:00,170.04,172.85,169.67,172.8,31770026,37505292.4,50.758093469327775,57.87481993350061,NaN,NaN,-101.0890903733639,-120.13730395532932,-0.7916106597070354,0.36884547499150244,1.1604561346985378,5211813395,5156557912,29.854165560961405,44.28529151652655,NaN,NaN,5.299852230599936,19.479023238429225
2018-07-03T09:30:00-04:00,173.41,173.45,170.63,170.8,25512707,37541963.55,44.836975555817695,56.08187754770903,NaN,NaN,-92.45438582324797,-120.46223666301621,-0.7965361034503327,0.16478600538562205,0.9613221088359547,5186300688,5163803910.8,32.413960890273614,41.688583461116416,NaN,NaN,2.5740527949158944,17.064027460784462
2018-07-05T09:30:00-04:00,171.91,173.06,171.03,172.92,31626198,37871441.1,51.319497686875756,54.478114021403776,NaN,NaN,-60.81365725938989,-103.67587763936622,-0.631338280283123,0.17214925848205098,0.803487538765174,5217926886,5187943848.6,40.23831923085602,39.412057729906415,NaN,NaN,2.4900117896245764,14.982025222047335
2018-07-06T09:30:00-04:00,173.31,175.74,173,175.61,37005574,37741704,58.05509688761122,53.596047521030236,NaN,NaN,20.575975500285683,-67.8025753179954,-0.33035541609526053,0.39054326864609834,0.7208986847413589,5254932460,5210203359.6,46.40027344471295,37.62859050857337,NaN,NaN,4.869776648696935,13.537418282997278
2018-07-09T09:30:00-04:00,176.49,177.23,175.82,177.19,27362061,37520789.65,61.43070753587898,53.13950365803668,NaN,NaN,77.64427453122345,-31.22737668489854,-0.03012779790061737,0.6832389373655872,0.7133667352662045,5282294521,5230653590,51.362060285601515,36.66216145247487,NaN,NaN,8.001247457119307,12.746536736443282
2018-07-10T09:30:00-04:00,177.41,177.72,176.71,177.32,23902488,37599928.6,61.70379379872899,52.89387387443803,NaN,NaN,85.84566476176191,6.1595743421266205,0.1614210736986148,0.9151430773894731,0.7537220036908583,5306197009,5249530312.8,55.460633011429614,36.74670665786145,NaN,NaN,10.486150601837636,12.423624431499618
2018-07-11T09:30:00-04:00,175.96,177.07,175.8,176.42,30280553,37988364.65,58.60984856466205,52.187858885890485,NaN,NaN,58.8661472119709,36.4236809491704,0.2087107990090734,1.0146105024522,0.8058997034431267,5275916456,5267453466.4,58.99391496510709,37.348429656640384,NaN,NaN,11.532036623939673,12.29625474470534
2018-07-12T09:30:00-04:00,177.21,179.46,177.08,179.46,27930119,37491941.4,64.99469403219491,52.49140232846424,NaN,NaN,116.50368869900656,71.88715014084968,0.4140685819592742,1.3234854308922195,0.9094168489329453,5303846575,5284637404.2,62.0983681326796,38.746362549033414,NaN,NaN,14.674278210604802,12.635972382690978
2018-07-13T09:30:00-04:00,179.42,179.9,178.95,179.61,28067961,37099540.55,65.27930013252231,52.94514377874596,NaN,NaN,131.95051096329982,94.1620572334525,0.5223583723421856,1.5623648143606772,1.0400064420184916,5331914536,5300033819.4,64.67858662667858,40.71445503531832,NaN,NaN,17.20232987096905,13.288309166730702
2018-07-16T09:30:00-04:00,179.64,179.95,178.88,179.18,21405310,35689019.55,63.680914748012434,54.32064087233599,NaN,NaN,119.1907569715876,102.47135372152533,0.5259262903441393,1.6974143049486656,1.1714880146045263,5310509226,5305676760.4,65.60284144133578,43.179454697604015,NaN,NaN,18.75679287238179,14.069521124680858
2018-07-17T09:30:00-04:00,177.3,180.65,177.28,180.27,31034075,35659063.7,65.95645004512393,55.680580406683816,NaN,NaN,109.8277911431757,107.2677789978081,0.5594736879833428,1.870830124583705,1.311356436600362,5341543301,5312746018.8,66.77574402446818,45.909067919139275,NaN,NaN,20.7610155220125,15.025448895728235
2018-07-18T09:30:00-04:00,180.28,180.44,179.38,179.93,23220839,34908305.95,64.59689308501441,57.409401258868066,NaN,NaN,108.38283314369951,117.17111618415382,0.51751861967739,1.9582547111970996,1.4407360915197096,5318322462,5321227220,68.17771470813338,49.05390341793777,NaN,NaN,22.008497388538842,16.023027251844038
2018-07-19T09:30:00-04:00,179.34,179.88,178.82,179.03,31094145,34811111.1,61.011785870615356,58.51833672514391,NaN,NaN,87.9266579612434,111.45571003660118,0.39352200109551694,1.9326385928891057,1.5391165917935887,5287228317,5317903568.4,66.98481794655808,52.23510994292381,NaN,NaN,22.043692967284905,16.883122354049878
2018-07-20T09:30:00-04:00,179.57,180.17,178.79,178.99,35907619,34433020.1,60.8501438420136,59.50601394674287,NaN,NaN,82.45898201321889,101.55740424658501,0.27858971049177894,1.8873537299083125,1.6087640194165336,5251320698,5301784800.8,61.376133934596616,55.02982387167088,NaN,NaN,22.028263566122742,17.618142527203144
2018-07-23T09:30:00-04:00,178.45,179.64,177.74,179.56,22184720,34038596.75,62.37968961070955,60.33612795684156,NaN,NaN,68.03123940125585,91.32550073251866,0.21365751827524337,1.8758359172605878,1.6621783989853445,5273505418,5294384039.2,58.93610332735401,57.10710514069893,NaN,NaN,22.42661905929394,18.30506774607326
2018-07-24T09:30:00-04:00,181.39,182.05,179.56,180.3,36900281,31993624.55,64.32818363095345,61.72835710506555,NaN,NaN,93.73257947879459,88.10645839964245,0.19383030602265494,1.9044662815136633,1.7106359754910083,5310405699,5288156518.8,56.88668871779938,58.85515712837933,NaN,NaN,23.298810137167376,19.018459516229562
2018-07-25T09:30:00-04:00,180.36,182.93,180.29,182.82,36022078,31844321.15,70.02232399779956,63.06427327013153,NaN,NaN,113.0928217778847,89.04845612647948,0.31646705973219613,2.1062198001562535,1.7897527404240574,5346427777,5293777581.8,58.29633644401194,60.14501550074761,NaN,NaN,25.844127029509856,19.993554875269606
2018-07-26T09:30:00-04:00,180.35,180.92,179.81,180.05,40873485,31245820.55,58.89382441279489,63.12418237907322,NaN,NaN,71.5244483501495,85.76801420426071,0.18365191200476172,2.0193176304300096,1.8356657184252478,5305554292,5297442776.8,59.232341721383385,61.061591806224065,NaN,NaN,24.5703638836927,20.647384733615763
2018-07-27T09:30:00-04:00,181.26,181.31,176.6,177.62,59456093,31898239.8,51.20555861114226,62.393814598734885,NaN,NaN,26.995408331973604,74.67529946801164,-0.08103372326556912,1.7343735643432865,1.8154072876088556,5246098199,5296398277,58.827133975629096,61.59481135551176,NaN,NaN,20.8091286729056,20.67049101065717
2018-07-30T09:30:00-04:00,177.66,177.73,174.27,175.11,60192990,33087466.1,44.71262541083448,61.18015971388528,NaN,NaN,-52.57025359835381,50.555000868089714,-0.41941868785739245,1.291133927787115,1.7105526156445074,5185905209,5278878235.2,52.35710903818916,61.37313107170887,NaN,NaN,15.26072152528386,19.897666798460982
2018-07-31T09:30:00-04:00,175.75,177.13,174.82,176.45,47285135,33863221.55,48.46931654066446,60.45583599788546,NaN,NaN,-52.39470369573791,21.329544233183213,-0.539604319548816,1.0360472162084875,1.5756515357573035,5233190344,5263435164.2,47.40762759448481,60.545539116664415,NaN,NaN,12.079882388802686,18.780840454224084
2018-08-01T09:30:00-04:00,176.87,177.65,176.0967,177.12,37101925,34442682.45,50.288154850037316,59.40536891344563,NaN,NaN,-41.423602266353825,-9.573740575664484,-0.5582544745540541,0.8778334425647358,1.43608791711879,5270292269,5248208062.6,43.08291380819468,59.18729237920121,NaN,NaN,10.158504404525715,17.54907816141003
2018-08-02T09:30:00-04:00,175.87,179.74,175.79,179.53,47178229,35220284,56.26757019138474,58.76167391765009,NaN,NaN,-2.362504787750261,-24.35113120324444,-0.3999713779846441,0.9361236946379847,1.3360950726226288,5317470498,5250591303.8,43.944820654666906,57.706309095486084,NaN,NaN,10.520948552546251,16.54505964585806
2018-08-03T09:30:00-04:00,179.8,180.09,179.08,180.08,28934445,34816727.55,57.523254319538616,58.32184102990196,NaN,NaN,55.52739763172896,-18.64473334329336,-0.25687664759206164,1.0149992631325517,1.2718759107246134,5346404943,5270652652.6,50.71101353392342,56.64260710209949,NaN,NaN,11.2131764677253,15.783362048981951
2018-08-06T09:30:00-04:00,179.97,181.19,179.74,181.14,24808763,34689062.65,59.912255051448945,57.890112816068026,NaN,NaN,95.66971742456806,11.003260861291013,-0.09767047070390311,1.1497878223447344,1.2474582930486375,5371213706,5307714352,60.25555285165466,56.17687916118424,NaN,NaN,12.54023961352868,15.320058843917199
2018-08-07T09:30:00-04:00,181.63,182.14,181.26,181.8,29895664,34988721.45,61.36913004400281,57.659558313138625,NaN,NaN,137.61878598663435,49.005958797765466,0.0379837430812473,1.2949379719001968,1.2569542288189495,5401109370,5341298157.2,66.57238982525261,56.06221309812133,NaN,NaN,14.07021525473961,15.141509759748972
2018-08-08T09:30:00-04:00,181.55,182.35,181.06,182.02,22680749,34608731.25,61.8666144308643,57.72061749601355,NaN,NaN,134.1739541790457,84.12547008684537,0.12359847991265727,1.411452328709771,1.2878538487971138,5423790119,5371997727.2,71.09494687540334,56.35579373589599,NaN,NaN,15.45549929390787,15.186365407485958
2018-08-09T09:30:00-04:00,181.94,182.63,181.64,181.91,18852898,34154870.2,61.44057000195858,57.762790793152476,NaN,NaN,128.17502322823447,110.23297569004231,0.15201984104189625,1.477878650099484,1.3258588090575878,5404937221,5389491071.8,73.31079318427294,57.20826939658716,NaN,NaN,16.474398503644704,15.370370135508637
2018-08-10T09:30:00-04:00,180.68,181.22,179.84,180.52,33818464,34442395.35,56.17607485669312,57.319675453579876,NaN,NaN,46.61649268407722,108.45079470051196,0.061070513931580805,1.4021969514720638,1.341126437540483,5371118757,5394433834.6,73.91916482130094,58.278488074726226,NaN,NaN,15.89188464673676,15.444872208541225
2018-08-13T09:30:00-04:00,180.85,182.01,180.241,180.32,26089195,34676589.6,55.43999563312678,56.68480488230654,NaN,NaN,57.074484942921686,100.7317482041827,-0.02412650607052602,1.3109683049523255,1.3350948110228515,5345029562,5389197005.8,72.04536737784173,59.36125083615782,NaN,NaN,15.207984119490042,15.411031052962485
2018-08-14T09:30:00-04:00,181.01,181.66,180.04,181.45,20913021,34170536.9,58.73031079167394,55.87823251044042,NaN,NaN,60.48693694948378,85.30537839675257,-0.016319440782896155,1.3146955100442312,1.3310149508271274,5365942583,5382163648.4,69.49729089353255,60.16131901112359,NaN,NaN,15.515988119906861,15.426024919668825
2018-08-15T09:30:00-04:00,180.09,180.58,178.12,179.23,58528016,35935895.75,50.79486548915456,55.299735444466116,NaN,NaN,-17.38894295846417,54.9927989692506,-0.1643804543696905,1.1255393828650142,1.2899198372347047,5307414567,5358888538,61.71812759987448,60.33887514530152,NaN,NaN,13.425184596387135,15.140190587771441
2018-08-16T09:30:00-04:00,180.57,180.99,179.47,179.82,27711761,35766776.55,52.62686295507083,55.40125718331816,NaN,NaN,16.226399279528486,32.603074179509406,-0.2226726655031248,1.0115790053557987,1.2342516708589235,5335126328,5344926359.4,57.55612200421458,60.24808857591477,NaN,NaN,12.217676686275235,14.722688601843412
2018-08-17T09:30:00-04:00,179.36,180.31,178.2679,179.86,36092641,35776027.65,52.75529112248471,55.97573330557889,NaN,NaN,-12.196743805089213,20.84042688167612,-0.25623595539159316,0.913956726619432,1.170192682011025,5371218969,5344946401.8,57.560546267081925,60.619762663692825,NaN,NaN,11.268330420131898,14.22920886159891
2018-08-20T09:30:00-04:00,180.28,180.3251,179,179.7,24938956,35913739.45,52.14632030191464,56.23837643138247,NaN,NaN,-4.94590400319086,8.43634909245361,-0.28471971259585116,0.814293041266211,1.0990127538620622,5346280013,5345196492,57.619909750091075,61.34921138909327,NaN,NaN,10.313281020426759,13.669790598574316
2018-08-21T09:30:00-04:00,180.26,181.44,180.13,180.36,26258657,35381658.25,54.48051171464451,56.53783049314013,NaN,NaN,40.649842601420005,4.468930222840849,-0.25554713335235957,0.7795788371716128,1.0351259705239724,5372538670,5346515709.4,57.95401133687097,62.41143264114157,NaN,NaN,10.102929208881985,13.160238971475412
2018-08-22T09:30:00-04:00,179.96,181.27,179.75,181.06,18042380,34482673.35,56.882723206709784,56.581769994234776,NaN,NaN,48.00776829543771,17.548272473621225,-0.18863080406010313,0.7993374654488434,0.9879682695089466,5390581050,5363149006,62.019594951594065,63.70248794806495,NaN,NaN,10.563224932150785,12.789236965857608
2018-08-23T09:30:00-04:00,180.77,182.045,180.5,180.8,25776166,33727807.4,55.70679175079406,56.45202266789588,NaN,NaN,64.92203969390921,27.287400556497367,-0.16240031751718176,0.7849678726124694,0.9473681901296511,5364804884,5369084717.2,63.38038527762368,64.60744307261497,NaN,NaN,10.648534984016614,12.48342239702318
2018-08-24T09:30:00-04:00,181.4,182.63,181.36,182.48,23136113,31911808.4,61.27722212444314,56.54952031596689,NaN,NaN,104.42274058016493,50.611297433548195,-0.03886956346207138,0.8987812358020619,0.9376507992641333,5387940997,5372429122.8,64.15956168908252,64.88630084671696,NaN,NaN,12.30208425282051,12.457516947851369
2018-08-27T09:30:00-04:00,183.43,184.34,183.11,184.34,29343552,30369336.5,66.32648933411431,56.90361740811766,NaN,NaN,182.76068896719877,88.15261602762612,0.15074719808262693,1.126084796867417,0.9753375987847901,5417284549,5386630030,67.33755212655156,64.94095529680975,NaN,NaN,15.364799276369858,12.872842994782582
2018-08-28T09:30:00-04:00,184.8,185.02,184.22,184.61,20277036,29018931.55,66.99919014399543,57.2702299590556,NaN,NaN,207.30891028103798,121.48442956354972,0.270031696028491,1.3128772188204039,1.042845522791913,5437561585,5399634613,69.96409792779345,64.86018037198048,NaN,NaN,18.071465374462452,13.615503334736848
2018-08-29T09:30:00-04:00,184.91,186.84,184.86,186.74,29175591,28622614.85,71.78743781384797,58.009291945619125,NaN,NaN,237.09822935132465,159.30252177472713,0.4570656010661833,1.614177524124642,1.1571119230584588,5466737176,5414865838.2,72.7300444016799,64.81869831608097,NaN,NaN,22.096915865682192,14.827133696300468
2018-08-30T09:30:00-04:00,186.41,187.5199,185.79,186.41,29315453,27729476.05,70.09063634710142,59.003189194934,NaN,NaN,207.10192174526443,187.73849818499815,0.5187256976328227,1.8055190450994871,1.2867933474666644,5437421723,5429389206,75.08598330038971,64.90204249315873,NaN,NaN,24.857860062013586,16.260094605688057
2018-08-31T09:30:00-04:00,186.18,187.18,185.98,186.65,28653248,27715416.2,70.63426880927028,60.08849442180139,NaN,NaN,169.33729122746703,200.72140831445859,0.5337653833773219,1.9540000766883168,1.4202346933109948,5466074971,5445016000.8,77.35310823437587,65.28116684005404,NaN,NaN,27.27865232575855,17.83417427998384
2018-09-04T09:30:00-04:00,186.1,186.4,184.85,185.85,29063537,27928154.9,66.30786846155229,60.62974854107842,NaN,NaN,114.58729728631312,187.08672997828143,0.4512089639786099,1.9842458982842572,1.5330369343056474,5437011434,5448961377.8,77.89990891721423,65.88135384174558,NaN,NaN,28.121143708589063,19.303741341213158
2018-09-05T09:30:00-04:00,185.55,185.55,182.82,183.45,42623326,28564538,55.35402785460464,60.95540299575343,NaN,NaN,50.347657752003926,155.69447947247463,0.20867228194242227,1.7938772867336752,1.585205004791253,5394388108,5440326682.4,73.7055660745346,66.73759944707845,NaN,NaN,25.422748511876925,20.177885222736553
2018-09-06T09:30:00-04:00,183.54,183.75,180.58,181.81,46091403,29735070.7,49.35415114451786,60.721637866428225,NaN,NaN,-9.980442750330553,106.27874505214359,-0.07339693757617516,1.4934588328210339,1.566855770397209,5348296705,5416638588.2,63.59013276256884,67.16860021553232,NaN,NaN,21.094115745872205,20.308775297470216
2018-09-07T09:30:00-04:00,180.53,182.67,180.44,181.11,46629495,31123900.55,47.011867544980184,60.311393325177896,NaN,NaN,-28.959750462444138,59.066410610601885,-0.3053019606757954,1.1852283195524649,1.4905302802282603,5301667210,5389487685.6,54.37825247035882,66.94129351576639,NaN,NaN,16.81220207027935,19.80926483644295
2018-09-10T09:30:00-04:00,182.12,182.25,180.725,181.72,26131977,30739576.2,49.27123345565296,60.10602997901634,NaN,NaN,-26.061841416425686,19.986584081823338,-0.40931120826042244,0.9788912699027321,1.3882024781631546,5327799187,5361832528.8,46.92213331401594,66.1771666274753,NaN,NaN,13.989134029422996,18.97781757829724
2018-09-11T09:30:00-04:00,180.97,183.42,180.52,183.12,30116460,30940939.45,54.10772497104175,60.079402354473295,NaN,NaN,-3.330688363669805,-3.5970130481732463,-0.37635666742494567,0.9177566438819724,1.294113311306918,5357915647,5346013371.4,43.267519459663,65.12813149338902,NaN,NaN,13.056904370754129,18.13197283436251
2018-09-12T09:30:00-04:00,182.87,182.98,181.01,182.58,36203973,31705487.05,52.046533466055294,59.73396023014083,NaN,NaN,-10.768805408883681,-15.820305680350762,-0.3822318837547547,0.8163234566134747,1.1985553403682294,5321711674,5331478084.6,40.171479776559764,63.56755183802942,NaN,NaN,11.663924263595655,17.207965895681532
2018-09-13T09:30:00-04:00,183.67,184.88,183.6401,184.53,31133188,30335745.65,58.23393331653928,59.91447034197977,NaN,NaN,53.54382008817621,-3.11545311264942,-0.2523596843833835,0.8831057348889999,1.1354654192723834,5352844862,5332387716,40.45861730525784,61.93028269714615,NaN,NaN,12.406529454006638,16.52204640401369
2018-09-14T09:30:00-04:00,184.66,184.945,183.26,183.99,31224132,30511364.2,56.07613868682374,59.54296438214981,NaN,NaN,38.15760025657127,10.308017031153668,-0.20254255414782096,0.8822872265876072,1.0848297807354281,5321620730,5336378420,41.7787927767428,60.331656346264744,NaN,NaN,12.341676690885468,15.924850730709657
2018-09-17T09:30:00-04:00,183.66,183.81,181.17,181.34,33071197,30360292,46.893218282305014,58.154873592734866,NaN,NaN,-36.399035878857795,8.240578138667246,-0.3397075218122231,0.6601953784701493,0.9999029002823724,5288549533,5328528489.2,39.90450749813795,58.37215315852091,NaN,NaN,9.176316984575793,14.960774481261963
2018-09-18T09:30:00-04:00,181.52,183.73,181.4,182.84,31877347,30707211.55,51.7133596610508,57.06302855823882,NaN,NaN,-23.3490155079242,4.236912709816367,-0.3212612647345229,0.5983263193642188,0.9195875840987416,5320426880,5321030735.8,38.14431705552527,56.099311667644606,NaN,NaN,8.161580252596286,13.98946102002401
2018-09-19T09:30:00-04:00,182.86,183.3,181.51,182.7,31843377,30986447.55,51.245850678623285,55.5957723342942,NaN,NaN,-34.905312657756866,-0.59038873995827,-0.31017663921004934,0.53186678508618,0.8420434242962294,5288583503,5314405101.6,36.60761346363241,53.519138029212634,NaN,NaN,7.222955692865845,13.022817401858557
2018-09-20T09:30:00-04:00,183.95,184.97,183.5199,184.72,33295820,31749119.55,57.2509681420391,54.67865317678975,NaN,NaN,38.8988684996138,-3.519379057670753,-0.16573410696188995,0.6348757905938669,0.8006098975557568,5321879323,5308211993.8,35.18091162858164,50.668775766940634,NaN,NaN,8.382895841931433,12.35997146472611
2018-09-21T09:30:00-04:00,185.27,185.48,183.48,183.71,38605353,32390578.9,53.690077454095814,53.468353794277284,NaN,NaN,25.827443508749464,-5.985410407235114,-0.13826711838492922,0.6277759995745953,0.7660431179595245,5283273970,5300542641.8,33.442718264064766,47.532319340489835,NaN,NaN,8.186928445185925,11.763822461934655
2018-09-24T09:30:00-04:00,182.05,183.96,181.3,183.89,34945602,32981053.35,54.23637846821469,52.60610450903889,NaN,NaN,-32.87995363661536,-5.281593958786626,-0.10929984064207321,0.629418317156933,0.7387181577990062,5318219572,5306476649.6,36.0744382406701,44.544785720736684,NaN,NaN,8.198341421751925,11.254468027622837
2018-09-25T09:30:00-04:00,183.78,184.28,183.18,184.14,25277520,32777751.75,55.02985561136102,52.5829493488072,NaN,NaN,7.278467309404257,0.8439026046790661,-0.07619437036775589,0.6434751948393114,0.7196695652070673,5343497092,5311090692,38.12319378314195,42.003187699922925,NaN,NaN,8.439078807132425,10.852269567552778
2018-09-26T09:30:00-04:00,184.25,185.99,183.905,184.27,36210571,33574428.5,55.46229958798098,53.01924566619743,NaN,NaN,48.80407797181625,17.58578073059369,-0.04971506191630848,0.6575257378116817,0.7072407997279901,5379707663,5329315524,45.54666016432505,40.71436822861979,NaN,NaN,8.75705128712235,10.55295267034843
2018-09-27T09:30:00-04:00,185.04,186.49,184.92,185.83,33113269,33771312.4,60.385279824957216,53.9744894004815,NaN,NaN,101.23878562613251,30.053764155897433,0.06259557751230393,0.78548527161837,0.7228896941060661,5412820932,5347503845.8,51.766020636304546,40.527780240473064,NaN,NaN,10.490445621224072,10.544023091902094
2018-09-28T09:30:00-04:00,185.25,186.28,184.97,185.79,28076843,33709381.9,60.20152958921778,54.75522483859327,NaN,NaN,103.23302878036648,45.53488121022083,0.12056519297364565,0.8735961853231231,0.7530309923494775,5384744089,5367797869.6,57.58681566598542,41.289543265613744,NaN,NaN,11.852672117928847,10.730972952763059
2018-10-01T09:30:00-04:00,186.82,187.53,185.7,186.17,27371297,33645284.35,61.40312229757964,55.276324647631704,NaN,NaN,144.44408805637167,80.99968954881824,0.167964670680944,0.9629868307006575,0.7950221600197135,5412115386,5386577032.4,62.13988147439242,42.6375691238087,NaN,NaN,13.334821240758691,11.102951279619578
2018-10-02T09:30:00-04:00,185.95,187.175,185.32,185.75,25618608,33473037.9,59.27303006110689,55.79250297584967,NaN,NaN,122.09236068023854,103.96246822298511,0.15481727536190337,0.9885437542220927,0.8337264788601894,5386496778,5395176969.6,64.04351778432853,44.34271469579219,NaN,NaN,14.036483927080287,11.522027372113966
2018-10-03T09:30:00-04:00,186.52,186.97,185.66,185.95,29128683,32798305.75,59.98489451744467,55.9175716330572,NaN,NaN,113.31224943273735,116.86410251516932,0.14362357288553929,1.0132559449671135,0.8696323720815742,5415625461,5402360529.2,65.59946997197952,46.138489886272296,NaN,NaN,14.81670600910302,11.992695748826687
2018-10-04T09:30:00-04:00,185.22,185.32,181.06,182.38,80557283,34521599.75,44.89890342289697,55.11919768563386,NaN,NaN,-44.17401886217852,87.7815416175071,-0.10667874015306789,0.7362839468902393,0.8429626870433072,5335068178,5386809978.4,59.58815164963146,47.410586948621486,NaN,NaN,10.823550482982027,11.825674996563164
2018-10-05T09:30:00-04:00,182.39,182.97,178.43,180.15,83325630,36356406.5,38.401990913913146,54.51268144503444,NaN,NaN,-153.50753516933935,36.43342882756595,-0.407969625190739,0.33300065555488345,0.7409702807456224,5251742548,5360209670.2,50.98195175778093,48.20183296716742,NaN,NaN,5.01108458980268,10.852162081311667
2018-10-08T09:30:00-04:00,179.37,180.6427,176.93,179.05,66864481,38393031.7,35.660825861556546,53.36607188792771,NaN,NaN,-203.176960023234,-33.09078078835519,-0.6523811878778198,-0.07450620410165243,0.5778749837761674,5184878067,5314762206.4,40.27833226015897,48.35426262464125,NaN,NaN,-0.6848315424779271,9.20402013505601
2018-10-09T09:30:00-04:00,179.2,181.02,178.75,179.63,49097949,39342106.15,38.16705829586247,52.43187243201622,NaN,NaN,-145.31867737875893,-86.57298840015468,-0.7396288513600991,-0.3466610804239565,0.39296777093614266,5233976016,5284258054,34.97121250567696,48.23737684193015,NaN,NaN,-4.453014708317647,7.253015157431203
2018-10-10T09:30:00-04:00,178.53,178.62,171.5,171.73,114471052,43255460.1,24.288784993974872,50.077430778583064,NaN,NaN,-282.6580730598983,-165.7670528986818,-1.2632835863118803,-1.1861367119537078,0.07714687435817258,5119504964,5225033954.6,27.41778642944645,47.682867899134784,NaN,NaN,-14.733768195331901,4.112046107036473
2018-10-11T09:30:00-04:00,171.04,173.4,167.81,169.6,143084463,48853023.85,21.969258478190085,47.811657994589794,NaN,NaN,-279.8176515562483,-212.89577943749578,-1.6619117734890851,-2.0002428425031837,-0.3383310690140987,4976420501,5153304419.2,21.391402585221087,46.82205963636023,NaN,NaN,-23.470290538756394,0.17171230049463526
2018-10-12T09:30:00-04:00,173.99,174.86,170.9328,174.32,102078388,52395736.65,36.45177558509685,46.54132921722424,NaN,NaN,-164.52721350097804,-215.0997151038235,-1.5203401641612722,-2.238756274215689,-0.7184161100544167,5078498889,5118655687.4,19.196476356832292,45.61649093037181,NaN,NaN,-24.40852757064359,-3.3397505382393966
2018-10-15T09:30:00-04:00,173.69,174.04,171.56,172.21,64885255,53986439.55,33.46189408230548,45.00076053657741,NaN,NaN,-145.1501260258002,-203.49434830433674,-1.4800126865975725,-2.5684319683013825,-1.08841928170381,5013613634,5084402800.8,17.30599751645697,44.12954833989431,NaN,NaN,-26.335150845100365,-6.62480772493382
2018-10-16T09:30:00-04:00,174.02,177.65,173.7,177.22,71979688,55991556.6,44.99787900034958,44.25330192317517,NaN,NaN,-75.6878724727405,-189.56818732313306,-1.047502087740415,-2.397796891379329,-1.350294803638914,5085593322,5054726262,15.849632453335914,42.008332074823656,NaN,NaN,-22.93105116684322,-8.95427107377802
2018-10-17T09:30:00-04:00,178.14,178.2585,175.47,177.29,66987639,57748769.7,45.14099137833709,43.164424176988014,NaN,NaN,-56.67382247687174,-144.37133720652776,-0.7047234167015428,-2.2311990745158425,-1.5264756578142997,5152580961,5061341461.4,17.515950751263716,39.56189851160645,NaN,NaN,-20.49175186495251,-10.602482615374376
2018-10-18T09:30:00-04:00,176.6,176.68,172.44,173.18,82486208,60208289.1,38.7635084597497,41.63313695345459,NaN,NaN,-88.87416015674908,-106.18263892662792,-0.701307631513898,-2.403110197206672,-1.7018025656927742,5070094753,5080076311.8,22.213773467569823,37.035252640291056,NaN,NaN,-20.95213609389385,-12.081004540877156
2018-10-19T09:30:00-04:00,174.39,176.07,172.39,173.02,82923733,62424208.1,38.535264444329506,39.99971853536529,NaN,NaN,-83.0121050383869,-89.8796172341097,-0.6570987956980723,-2.5231760603153646,-1.8660772646172923,4987171020,5061810738,20.960363253995126,34.09385848169124,NaN,NaN,-21.36982478005542,-13.407978860759766
2018-10-22T09:30:00-04:00,174.06,175.2485,172.59,173.91,52909281,63322392.05,40.62938917536308,38.6680299006693,NaN,NaN,-73.40353983807543,-75.53029999656476,-0.5211329581849753,-2.5174934623485115,-1.9963605041635362,5040080301,5067104071.4,22.32813997644817,31.114188638271223,NaN,NaN,-20.990360012851422,-14.49117616820143
2018-10-23T09:30:00-04:00,170.79,174.13,168.82,173.27,77566972,65936864.65,39.58495438979777,37.2108913201231,NaN,NaN,-88.83211533212459,-78.15914856844158,-0.4312364217268372,-2.5354060313220828,-2.1041696095952456,4962513329,5042488072.8,20.547401762472475,27.896183766163574,NaN,NaN,-21.020322340855166,-15.423911335723393
2018-10-24T09:30:00-04:00,173.12,173.36,165.04,165.34,102997449,69276208.55,29.474591808639275,36.10915477624756,NaN,NaN,-129.19237299249858,-92.66285867156695,-0.8391756498428666,-3.153139171898829,-2.3139635220559622,4859515880,4983875056.6,17.05876058948941,24.85837011901057,NaN,NaN,-24.862059570464616,-16.77221822640071
2018-10-25T09:30:00-04:00,167.99,172.08,167.16,171.06,83481070,71794598.6,41.15041503293036,36.305470784748785,NaN,NaN,-93.6252926365704,-93.61308516753121,-0.6647400799221672,-3.144888621958671,-2.480148542036504,4942996950,4958455496,15.805433429359383,22.34576166698046,NaN,NaN,-23.493727238041313,-17.732433799492224
2018-10-26T09:30:00-04:00,165.24,169.96,164.23,166.66,130970908,76939301.85,36.18745000735445,36.343086795162925,NaN,NaN,-126.17108140106694,-102.2448804400672,-0.7787471506126726,-3.4535824803023445,-2.674835329689672,4812026042,4923426500.4,14.251533961051862,20.486704645615674,NaN,NaN,-24.360045409709226,-18.679235458094652
2018-10-29T09:30:00-04:00,169.16,169.86,160.09,163.23,111871933,81164333.65,32.860353816007375,35.96403647517328,NaN,NaN,-150.67264035191815,-117.69870054283577,-1.003889985158616,-3.9296978111379417,-2.9258078259793256,4700154109,4855441262,11.822203655293592,18.833204013445435,NaN,NaN,-26.3205607865923,-19.770853362165745
2018-10-30T09:30:00-04:00,162.8,166.035,162.015,165.92,92583965,84512601.5,37.69818715698036,36.92185091538796,NaN,NaN,-142.08587233839378,-128.3494519440896,-0.8940360331074948,-4.043352867363694,-3.1493168342561995,4792738074,4821486211,10.829315335798,17.648313221041978,NaN,NaN,-26.04719698351791,-20.66747387950177
2018-10-31T09:30:00-04:00,168.55,171.25,168.54,169.82,73828635,86747599.1,43.99858358884249,38.495374137577414,NaN,NaN,-55.39462038738504,-113.58990142306689,-0.5007142486914158,-3.7752096451204693,-3.2744953964290535,4866566709,4822896376.8,11.163007712815286,16.9177135872987,NaN,NaN,-23.495638183867243,-21.07149735155398
2018-11-01T09:30:00-04:00,170.08,172.24,168.78,172.06,52706823,85355076.1,47.29532174175128,39.26991314876701,NaN,NaN,-28.68276738499291,-100.6013963727514,-0.05513498938648187,-3.343414133162156,-3.288279143775674,4919273532,4818151693.2,11.01366711257701,16.33322721270904,NaN,NaN,-20.326048687824397,-20.965004685306898
2018-11-02T09:30:00-04:00,171.53,172.55,168.22,169.38,75966781,84987133.65,43.9608789634956,40.019840640280584,NaN,NaN,-40.10924201323436,-83.38902849518487,0.08598299953626398,-3.1808003943553445,-3.2667833938916084,4843306751,4824407835,12.672608964291726,16.00227088755438,NaN,NaN,-18.917738004356906,-20.672538016599756
2018-11-05T09:30:00-05:00,169.61,169.66,167.08,168.96,39573533,83622586.25,43.44394682013687,39.908845484551115,NaN,NaN,-62.71150173945891,-65.79680077269303,0.1729048719920634,-3.050652303901529,-3.2235571758935926,4803733218,4845123656.8,18.116207268834742,16.164169088661442,NaN,NaN,-17.993670699522102,-20.289842685588663
2018-11-06T09:30:00-05:00,168.93,171.19,168.72,170.24,34410390,82888208.3,45.54552759973188,39.937740928936456,NaN,NaN,-23.979609906516224,-42.175548286317515,0.3293970237256105,-2.8118108962365795,-3.14120791996219,4838143608,4854204763.6,20.456978487209156,16.37424249837183,NaN,NaN,-16.59519618057694,-19.76203604201556
2018-11-07T09:30:00-05:00,172.25,175.58,171.87,175.58,51169614,79723136.4,53.33601744041079,40.9786344275551,NaN,NaN,78.4885725788438,-15.398909693071754,0.779639854177792,-2.16665810223995,-2.946297956417742,4889313222,4858754066.2,21.665090190599543,16.3350508357311,NaN,NaN,-12.760590779134114,-18.76182957588964
2018-11-08T09:30:00-05:00,174.76,175.302,173.63,174.46,40296538,74583740.15,51.66645999672882,41.91657696701219,NaN,NaN,72.94511974155412,4.926667732237652,0.976358380796436,-1.725849980422197,-2.702208361218633,4849016684,4844702696.6,20.623205418241383,16.31096813317726,NaN,NaN,-10.21637376579483,-17.541050174447523
2018-11-09T09:30:00-05:00,172.83,173.25,170.16,171.52,50602710,72009956.25,47.46617277664576,42.4049186528181,NaN,NaN,10.748330574684372,15.0981822498214,0.885487008731896,-1.5953496003037628,-2.480836609035659,4798413974,4835724141.2,19.962590200837766,16.14200029206223,NaN,NaN,-9.377966629970668,-16.3748953823794
2018-11-12T09:30:00-05:00,170.33,170.64,166.18,166.33,62578371,71894612.05,41.11219542375124,42.51400729810049,NaN,NaN,-73.7536363584383,12.889755326025556,0.47351553959813053,-1.8889421845379957,-2.362457724136126,4735835603,4822144618.2,18.97270595264095,16.02952201993141,NaN,NaN,-10.746831955023653,-15.57088632132858
2018-11-13T09:30:00-05:00,167.15,169.48,166,166.47,64128079,71502031.6,41.34030661715548,43.36155835585164,NaN,NaN,-76.02506471321361,2.4806643646860778,0.22094988597761311,-2.0862703666641096,-2.3072202526417227,4799963682,4814508633,18.41959427438998,16.126724425995736,NaN,NaN,-11.74321147856197,-15.024075629504779
2018-11-14T09:30:00-05:00,168.09,168.7,164.25,165.2,75270714,71916185.35,39.832923041279415,43.26745178501943,NaN,NaN,-99.54151170480698,-33.12535249204408,-0.008949877241881232,-2.3184075991940745,-2.3094577219521932,4724692968,4781584582.2,16.223455487263294,16.156583144417443,NaN,NaN,-13.013658209209101,-14.736873140891111
2018-11-15T09:30:00-05:00,164.84,168.54,163.46,168.09,73254349,71454592.4,44.76826841509336,43.88036738557221,NaN,NaN,-74.04555176600678,-62.52348679355625,0.05291050607209602,-2.2433195893620734,-2.2962300954341694,4797947317,4771370708.8,15.60198367910158,16.25304383856385,NaN,NaN,-12.619517609925751,-14.434393779324632
2018-11-16T09:30:00-05:00,166.49,168.31,165.78,167.5,65390675,70577939.5,43.97520958144027,44.67428565453171,NaN,NaN,-54.65925188835841,-75.60500328616482,0.07219160955567139,-2.20599058348958,-2.2781821930452515,4732556642,4758199242.4,14.813893991476888,16.46673600543409,NaN,NaN,-12.528027125489697,-14.162055685919642
2018-11-19T09:30:00-05:00,166.74,166.9,161.54,162.06,67280478,71296499.35,37.39705487223437,44.65277620562127,NaN,NaN,-139.09778769732873,-88.6738335539429,-0.24590611076254332,-2.5855648314984307,-2.3396587207358874,4665276164,4744087354.6,13.998064349124832,16.69307522067172,NaN,NaN,-14.510886117392161,-14.21188860470143
2018-11-20T09:30:00-05:00,158.37,161.38,157.13,159.16,102652794,72550790.45,34.43947507957918,43.9699827406739,NaN,NaN,-216.14492198725006,-116.6978050087502,-0.5961337977301095,-3.0848259678985244,-2.488692170168415,4562623370,4696619292.2,11.669967834902693,16.729286657963677,NaN,NaN,-17.12863887926564,-14.62856721535346
2018-11-21T09:30:00-05:00,161.29,161.97,159.2323,160.37,42965839,69549209.95,36.68929758320456,43.212409586491994,NaN,NaN,-156.38986399659416,-128.0674754671076,-0.6844911034568595,-3.3443060494894894,-2.65981494603263,4605589209,4672798540.4,10.70755389107778,16.70742142785659,NaN,NaN,-18.58184333273609,-15.193320946408122
2018-11-23T09:30:00-05:00,159.09,160.84,159.09,159.21,23503729,66550342.9,35.433897756768445,42.60333950029719,NaN,NaN,-150.86931710995333,-143.43222853589694,-0.7537690610892773,-3.6020262723942267,-2.8482572113049494,4582085480,4629626173,9.222989481977692,16.46102003626273,NaN,NaN,-20.150998571818448,-15.901560607181025
2018-11-26T09:30:00-05:00,161.44,162.97,160.76,162.89,42012633,62102429.15,42.191726459217215,42.51389518880292,NaN,NaN,-88.82285042841217,-150.26494824390767,-0.4968613029095348,-3.469333839941868,-2.972472537032333,4624098113,4607934467.2,8.579359637476216,15.779816634022836,NaN,NaN,-19.484728794541866,-16.413441776804003
2018-11-27T09:30:00-05:00,162,163.85,161.18,163.44,36608063,58339235.65,43.14944278236447,42.34274627327668,NaN,NaN,-74.041844198927,-137.25375954422734,-0.24759102686516465,-3.2819613206137888,-3.034370293748624,4660706176,4607020469.6,8.552277541066744,14.929480852155523,NaN,NaN,-18.664587452488938,-16.735034016187566
2018-11-28T09:30:00-05:00,164.62,168.7,163.4719,168.7,70140986,57217086.7,51.43591761196268,42.20702485695896,NaN,NaN,-0.749041092281303,-94.17458336523359,0.28497057018351013,-2.6781570810192363,-2.9631276512027465,4730847162,4640665228,18.72300645672955,14.719332014021953,NaN,NaN,-15.293087885088921,-16.529041711744902
2018-11-29T09:30:00-05:00,168,169.26,166.82,168.15,44885711,55769940.5,50.60531583072225,42.13122884510135,NaN,NaN,22.58346949951762,-58.37991666601124,0.5957457876854559,-2.2184454165959266,-2.8141912042813826,4685961451,4656739676.4,23.122299752048264,14.897838752151015,NaN,NaN,-12.8288735799804,-16.000446264349975
2018-11-30T09:30:00-05:00,168.38,169.47,167.54,169.37,36722760,54970737.35,52.43995413010868,42.48649894177726,NaN,NaN,39.605210751791105,-20.28501109366234,0.8628176885706669,-1.735669093568049,-2.598486782138716,4722684211,4684859422.6,30.236164986346722,15.63166552254451,NaN,NaN,-10.242142618980917,-15.177831457868681
2018-12-03T09:30:00-05:00,173.1,173.31,169.5101,172.33,50771695,53710983.05,56.64725356471856,43.59614595184637,NaN,NaN,94.04465935254404,16.288490862528896,1.1975730459150853,-1.1015204747448593,-2.2990935206599445,4773455906,4714730981.2,36.91446897291398,16.913220023992587,NaN,NaN,-6.713677385745977,-13.96866659042258
2018-12-04T09:30:00-05:00,171.38,171.91,165.52,165.72,70594743,55262043.55,46.71001727168363,43.97969671288409,NaN,NaN,17.282724317876205,34.55340456588954,0.9437380995818843,-1.1194208961825893,-2.0631589957644736,4702861163,4723161978.6,38.69814194255323,18.361687714575677,NaN,NaN,-6.648444435642342,-12.922920568311119
2018-12-06T09:30:00-05:00,162.46,166.91,161.77,166.89,71715526,57127300.35,48.4343318235421,44.594083054474275,NaN,NaN,-27.915171808341363,29.120178422677526,0.8286430555956759,-1.0273551762698787,-1.8559982318655546,4774576689,4731907884,40.5751413213298,20.101093845580426,NaN,NaN,-6.053521034848787,-11.9415777778165
2018-12-07T09:30:00-05:00,166.13,167.12,160.86,161.38,80432176,58590428.45,41.60650401523566,44.36824274019874,NaN,NaN,-60.75319141804717,12.452846239164566,0.3783503275103377,-1.3830603224776326,-1.7614106499879703,4694144513,4733544496.4,40.939570245303244,21.910921457451973,NaN,NaN,-7.813162355499029,-11.35180414605686
2018-12-10T09:30:00-05:00,161.11,163.78,159.41,163.07,73960758,60273639.45,44.204555643366305,44.38462460176488,NaN,NaN,-73.11542147027825,-10.091280205249305,0.2001921163279614,-1.5111705045780184,-1.7113626209059798,4768105271,4742628708.4,43.02805743547525,23.926218846309002,NaN,NaN,-8.395101679666555,-10.929418079429674
2018-12-11T09:30:00-05:00,165.66,165.77,162.23,163.61,59058296,60696418.75,45.04590258031447,44.93097086662774,NaN,NaN,-27.342204515084788,-34.368652978775074,0.12809530432324978,-1.5512434905019177,-1.6793387948251675,4827163567,4753370240.6,45.48294311535311,26.17513875818245,NaN,NaN,-8.60277852159217,-10.597040999738601
2018-12-12T09:30:00-05:00,166.06,167.6,164.96,165.05,53779992,60256499.8,47.326869180041555,45.85149901666078,NaN,NaN,22.875804834139327,-33.25003687552245,0.18339909891827544,-1.450089921177323,-1.6334890200955985,4880943559,4788986719.8,52.75265339195479,29.109616297971886,NaN,NaN,-8.09910784263336,-10.240193405866425
2018-12-13T09:30:00-05:00,166.06,166.82,164.03,165.1,46377864,59368989.05,47.40849482818267,46.617155962730635,NaN,NaN,12.217625077474768,-25.223477498359223,0.22653145292145171,-1.3503247039437838,-1.5768561568652355,4927321423,4819535666.6,57.93403412215752,32.482936314477584,NaN,NaN,-7.668483599095824,-9.872806290613482
2018-12-14T09:30:00-05:00,163.19,163.81,160.7,161.08,56547419,58432824.3,41.79990663251898,47.071870882427106,NaN,NaN,-67.39300092327989,-26.551439399405762,-0.00048028824973966877,-1.57745651717741,-1.5769762289276703,4870774004,4854861564.8,62.988614213744405,36.32333808103235,NaN,NaN,-8.943049633062248,-9.739983910963305
2018-12-17T09:30:00-05:00,160.41,161.67,156.17,157.43,74834076,58511810.65,37.465940436902294,46.73431473797604,NaN,NaN,-133.24583953981266,-38.57752301331264,-0.3612991538374839,-2.028600171224525,-1.6673010173870413,4795939928,4860428496.2,63.72827028063212,40.262545984114915,NaN,NaN,-11.409854834586788,-9.978536900052374
2018-12-18T09:30:00-05:00,158.67,159.95,157.04,158.42,63642120,58424382.9,39.30415492159607,46.45965131934973,NaN,NaN,-119.64190861272148,-57.037463832839975,-0.49013357760684784,-2.279967989395601,-1.7898344117887532,4859582048,4866912192.4,64.61522686907324,44.267042364686795,NaN,NaN,-12.888596988232512,-10.394259769792393
2018-12-19T09:30:00-05:00,158.24,160.72,153.34,154.53,81856456,59153181.8,34.95604120539262,45.28251729030901,NaN,NaN,-146.40835207239624,-90.89429521414709,-0.7771240200101999,-2.761239436801503,-1.9841154167913033,4777725592,4846268599,59.61662224976853,47.18801492133243,NaN,NaN,-15.55425828674358,-11.131402415071134
2018-12-20T09:30:00-05:00,154.16,155.87,150.39,152.29,99002139,58970649.05,32.711894579408025,44.004415772358,NaN,NaN,-191.02192360389049,-131.54220495042014,-1.0411287095452915,-3.285526303722918,-2.2443975941776264,4678723453,4796549005,49.65359017399276,49.08310709432847,NaN,NaN,-18.493676602990714,-12.183155870488218
2018-12-21T09:30:00-05:00,153.06,154.09,146.72,147.57,141129408,63878827.5,28.55231885459348,42.2981561098212,NaN,NaN,-209.7822741703139,-160.02005959982694,-1.4327816757581795,-4.035374688875351,-2.602593013117171,4537594045,4729913013.2,40.004274099662524,49.78082917385103,NaN,NaN,-22.473866927536186,-13.653257450066498
2018-12-24T09:30:00-05:00,146.14,147.98,143.46,143.5,56163290,65511805.55,25.536894033284383,40.07598757186162,NaN,NaN,-222.40690712729165,-177.85227311732274,-1.8391639324274145,-4.901547928651439,-3.0623839962240247,4481430755,4667011178.6,33.404995994556174,49.53015253253976,NaN,NaN,-26.904932076682165,-15.546353825297308
2018-12-26T09:30:00-05:00,145.12,152.54,144.09,152.46,98982064,68360277.1,40.44777756273259,39.628684735507974,NaN,NaN,-131.6032684100309,-180.24454507678462,-1.3977390074207419,-4.809557755499952,-3.4118187480792104,4580412819,4611177332.8,28.854827920264597,48.827058673804856,NaN,NaN,-25.53185415698106,-16.9728538726807
2018-12-27T09:30:00-05:00,150.57,153.18,147.08,153.05,85824343,70821091.1,41.281584006945174,39.117774177179626,NaN,NaN,-99.53920403899534,-170.87071547010447,-0.9790333059054568,-4.635610380461031,-3.6565770745555746,4666237162,4588879646.8,27.258004096943438,47.87583458634868,NaN,NaN,-24.20708460520549,-18.00631540589853
2018-12-28T09:30:00-05:00,154.01,155.59,151.72,152.97,77856625,71206873.05,41.19735546725145,39.08854928089504,NaN,NaN,-66.92606098992621,-146.0515429473116,-0.6370432380974735,-4.452881122177416,-3.8158378840799427,4588380537,4570811063.6,26.00226702315811,46.80888435619546,NaN,NaN,-23.210286988344876,-18.749739917676578
2018-12-31T09:30:00-05:00,154.47,154.98,152.71,154.26,53015313,71613353.15,43.20951720092744,39.01747510643512,NaN,NaN,-54.85830623895713,-115.06674936104025,-0.2721825779042981,-4.156066106460315,-3.883883528556017,4641395850,4591571424.6,29.99290390450315,45.877801961126025,NaN,NaN,-21.78343983648817,-19.18312562036395
2019-01-02T09:30:00-05:00,150.99,155.75,150.88,154.88,58576672,72706048.75,44.197850925812034,38.956899988256374,NaN,NaN,-50.822365241201005,-80.74984098382212,0.04574885220203395,-3.826697463303475,-3.872446315505509,4699972522,4635279778,37.620378355681254,45.31619019257804,NaN,NaN,-20.334156993588323,-19.347558673681718
2019-01-03T09:30:00-05:00,152.6,153.26,149.49,149.82,74820225,73908475.25,38.33431872699053,38.31457495589559,NaN,NaN,-75.6950655395587,-69.56820040972768,-0.04498914223530992,-3.928682743299646,-3.883693601064336,4625152297,4644227673.6,39.083613019371555,44.33983016596495,NaN,NaN,-20.8176713914386,-19.557574776218416
2019-01-04T09:30:00-05:00,152.18,157,151.74,156.23,74709320,74114204.1,47.784677979264586,38.34144518097287,NaN,NaN,-22.427130624405663,-54.14578572680974,0.34497456421573736,-3.4524753957946643,-3.7974499600104017,4699861617,4650952564.6,40.21858838407895,43.074441184673624,NaN,NaN,-18.095446840059076,-19.34869935676708
2019-01-07T09:30:00-05:00,156.54,158.86,156.11,158.09,52059331,73131394.35,50.170986918567344,38.93937948711918,NaN,NaN,17.42265216515209,-37.27604309579409,0.724633604984096,-2.891657953780282,-3.616291558764378,4751920948,4683660646.8,45.533948628502266,41.82767935715633,NaN,NaN,-15.125845613236145,-18.74543453626266
2019-01-08T09:30:00-05:00,159.56,160.11,157.2,159.52,49388694,71579220.25,51.9877106882232,39.97664879078496,NaN,NaN,39.16663697157762,-18.471054453687135,1.048838344657523,-2.305243627942474,-3.354081972599997,4801309642,4715643405.2,50.19697410629835,40.86115820184677,NaN,NaN,-12.151588090305964,-17.80345647255456
2019-01-09T09:30:00-05:00,160.15,161.5229,159.47,160.82,46491747,70205769.7,53.642411379381805,41.00080996634108,NaN,NaN,64.92680514736321,4.67877962402571,1.310603243514445,-1.7158279182069407,-3.0264311617213857,4847801389,4745209178.6,54.1083834026764,40.11066938281842,NaN,NaN,-9.213895036285367,-16.57637626737325
2019-01-10T09:30:00-05:00,159.59,161.37,158.7,161.28,38943414,69200025.6,54.24333675436334,42.378473934124706,NaN,NaN,67.68305149099096,33.35440303013564,1.4629159437576464,-1.1977862320243275,-2.660702175781974,4886744803,4797527679.8,60.08271425573742,40.14396166895906,NaN,NaN,-6.647878052280968,-15.158019379502923
2019-01-11T09:30:00-05:00,160.32,160.86,159.79,160.69,30176643,68019858.15,53.28918458055153,43.848280362777814,NaN,NaN,76.38527998940464,53.1168851528977,1.468298814557826,-0.8253286575846914,-2.2936274721425174,4856568160,4828868988.4,63.175430704883766,41.10980742116556,NaN,NaN,-4.778472787802307,-13.675227009259977
2019-01-14T09:30:00-05:00,159.32,159.96,158.59,159.27,30710234,67236476.65,50.965544129094454,45.44922502524218,NaN,NaN,67.31576012567373,63.095506745002034,1.3249915248114914,-0.6373880661281532,-1.9623795909396446,4825857926,4843656384,64.57021443977544,42.86451744545934,NaN,NaN,-3.8058195662609595,-12.265311660260117
2019-01-15T09:30:00-05:00,159.97,162.6,159.9096,162.38,40874224,66452816.9,55.538248727251954,47.592178931954145,NaN,NaN,108.55946307949591,76.97407196658568,1.3820746213650044,-0.23478631423338925,-1.6168609355983936,4866732150,4856740885.6,65.80442507561818,45.17876237982091,NaN,NaN,-1.638746976048442,-10.74723099108702
2019-01-16T09:30:00-05:00,162.63,163.78,162.29,162.35,33812190,64401722.6,55.484497424858596,48.66623035067743,NaN,NaN,118.40883706155451,87.67047834942395,1.3582286475831533,0.08092487388054792,-1.2773037737026054,4832919960,4853764599.8,65.24763985488545,47.778248946579545,NaN,NaN,0.12769567206068366,-9.193670039208778
2019-01-17T09:30:00-05:00,161.84,164.36,161.57,163.63,39328959,63186064.55,57.37982983112765,49.81610505240475,NaN,NaN,114.15187233451923,96.9642425181296,1.3654134074928774,0.4294629856634913,-0.935950421829386,4872248919,4850865423,64.67359693194666,50.45079129193692,NaN,NaN,2.1600392885506254,-7.571711563814577
2019-01-18T09:30:00-05:00,164.84,166.02,163.82,165.25,57183243,61952403.9,59.717484821853745,51.138971434876346,NaN,NaN,123.22227980336629,106.33164248092194,1.410256945476144,0.8268707600157938,-0.58338618546035,4929432162,4865438223.4,66.279525544916,53.32773832920534,NaN,NaN,4.566412100918336,-5.8376938974241614
2019-01-22T09:30:00-05:00,164.05,164.14,160.76,161.94,56711694,59837881.65,53.286465523981335,51.85875345795163,NaN,NaN,76.60556464340914,108.18960338446902,1.1585181601571164,0.8647615147360455,-0.2937566454210709,4872720468,4874810731.8,67.30885512094584,55.993163416094106,NaN,NaN,4.945576612871235,-4.297226681667676
2019-01-23T09:30:00-05:00,162.77,163.51,160.32,162.15,38106062,54686714.35,53.62766882024568,52.53231187898259,NaN,NaN,67.13457706937254,99.90462618244433,0.9560815628587545,0.9013453081523721,-0.05473625470638227,4910826530,4883629607.8,68.28970630488476,58.18382969818007,NaN,NaN,5.350868850761391,-2.918927319892095
2019-01-24T09:30:00-05:00,162.66,163.44,162.0626,163.2,32413351,53499217.4,55.38248082321911,53.75003774299893,NaN,NaN,76.51121768842239,91.52510230781792,0.8465864171402799,1.0034967667189676,0.1569103495786877,4943239881,4905693592,70.66144629400108,60.43938921779647,NaN,NaN,6.1667034155398115,-1.6209800719732514
2019-01-25T09:30:00-05:00,164.48,165.65,163.95,165.15,36466069,50373417.65,58.521706537320945,54.51696835428867,NaN,NaN,105.40877466765323,89.7764827744447,0.8565914449120953,1.2276496557188068,0.37105821080671153,4979705950,4927184998.2,72.79580891556778,62.76633354147424,NaN,NaN,7.744354752331486,-0.28307509707257483
2019-01-28T09:30:00-05:00,163.03,163.12,161.75,163.11,33491216,47756761.3,54.223521732593724,54.80643512671912,NaN,NaN,60.51640385562497,77.23530758489645,0.6843875624301609,1.2265426638444126,0.5421551014142517,4946214734,4930541512.6,73.12465443467019,64.73709824191481,NaN,NaN,7.93789287744054,0.8913488992864416
2019-01-29T09:30:00-05:00,163.2,163.24,160.99,161.57,30784175,45403138.8,51.16828942490982,54.74790503648245,NaN,NaN,41.71261099893704,70.25671685600203,0.4373548512641382,1.0888486654944245,0.6514938142302863,4915430559,4939083530.8,73.98646563705925,66.43634763696916,NaN,NaN,7.246992338364418,1.7992979620118668
2019-01-30T09:30:00-05:00,163.39,166.28,162.89,165.68,41346533,44819699.8,57.974092809617325,55.05731085292785,NaN,NaN,104.0676069354218,77.64332282921188,0.5159437232717713,1.2964234683200004,0.7804797450482291,4956777092,4948273643.2,74.9183441467888,67.92277340440576,NaN,NaN,8.644545376514827,2.777190449798004
2019-01-31T09:30:00-05:00,166.65,168.99,166.4701,168.16,37258361,43753784.25,61.46418243797478,55.57308554461438,NaN,NaN,163.55421112250414,95.05192151602823,0.6893074046088798,1.642114000809329,0.952806596200449,4994035453,4958432757.6,75.94422969916161,69.05573879322178,NaN,NaN,10.920577577779465,3.9405314680810695
2019-02-01T09:30:00-05:00,167.37,168.6,166.99,167.45,32143672,41619956.6,59.92973095133173,56.047410285384395,NaN,NaN,160.2370835917295,106.01758330084347,0.7078366711089279,1.837602435086609,1.129765763977681,4961891781,4954869923.8,74.78890441847388,69.88527262990678,NaN,NaN,12.331272463177083,5.139208753094786
2019-02-04T09:30:00-05:00,167.51,169.53,167.33,169.53,26718781,39220429.65,62.855345117555075,56.89668178456015,NaN,NaN,174.346293740141,128.78356127774668,0.8047853703593026,2.1357474769268094,1.3309621065675068,4988610562,4963349089.4,75.73499373810091,70.68275686550146,NaN,NaN,14.416591655804595,6.464549167767616
2019-02-05T09:30:00-05:00,169.75,171.23,169.69,171.03,28156368,38025281.5,64.84854435950074,57.56170290114934,NaN,NaN,186.43794069632372,157.72862721722402,0.9069551261412283,2.464656014244042,1.5577008881028138,5016766930,4983616363.6,77.87246536876708,71.54475974358353,NaN,NaN,16.768621082662296,7.936559441323999
2019-02-06T09:30:00-05:00,171.06,171.37,169.75,170.52,27970006,36954347.1,63.59895317292528,58.141306883154115,NaN,NaN,154.04834813672235,167.72477545748413,0.8767007931187103,2.653576879501202,1.7768760863824915,4988796924,4990020330,78.51643399151678,72.4925307533429,NaN,NaN,18.356638480237535,9.42514216116879
2019-02-07T09:30:00-05:00,169.03,169.4499,166.95,168.23,42036193,36731569.4,58.177990379387445,58.19831835088696,NaN,NaN,87.46907244047144,152.50774772107758,0.6494379688031546,2.588673547386435,1.9392355785832802,4946760731,4980565385.6,75.04393678651891,73.23326931438378,NaN,NaN,18.181513262640724,10.676052318521922
2019-02-08T09:30:00-05:00,166.73,168.59,166.57,168.56,29020747,36235436.05,58.72398375660187,58.127353989083254,NaN,NaN,72.48436011367987,134.95720302546766,0.4763296103220558,2.53464759148585,2.0583179811637944,4975781478,4983343325,75.38834275397659,73.88389911503097,NaN,NaN,18.18748368803773,11.749113942738466
2019-02-11T09:30:00-05:00,169.14,169.58,167.98,168.4,21434088,35798308.3,58.32639114138127,58.487348676040384,NaN,NaN,80.17563815185193,116.12307190780984,0.31388254127506476,2.4506711577576255,2.1367886164825607,4954347390,4976490690.6,72.72221374941698,74.2705675884932,NaN,NaN,18.085682541245614,12.654338028239488
2019-02-12T09:30:00-05:00,169.59,171.14,169.33,170.89,29722073,35748900.25,62.57325997442654,59.12631947276759,NaN,NaN,108.07835582885517,100.45115493431612,0.3350349130057122,2.555582257739701,2.2205473447339887,4984069463,4969951197.2,70.17179905861856,74.40500278518846,NaN,NaN,19.172724818991707,13.585536141204091
2019-02-13T09:30:00-05:00,171.62,172.16,170.82,171.01,26094136,35009895.85,62.77016889205533,59.65401147768447,NaN,NaN,114.21965067249248,92.48541544147014,0.3181435394395846,2.6182267690334697,2.300083229593885,5010163599,4974224532.2,70.89023802957286,74.42134505201501,NaN,NaN,20.126072994886588,14.51989854887302
2019-02-14T09:30:00-05:00,170.38,171.83,169.83,171.22,30326830,34835627.85,63.13568980379103,59.983581711003765,NaN,NaN,96.00795100834438,94.19319115504473,0.28331103332864904,2.6542220212546965,2.3709109879260475,5040490429,4992970471.8,73.86412724525701,74.49765350413567,NaN,NaN,21.023655894689917,15.449006741132576
2019-02-15T09:30:00-05:00,172.51,172.5623,171.1392,171.94,32521685,34495264.15,64.42530525983429,60.71228053437809,NaN,NaN,106.75197902795391,101.04671493789954,0.2709606358385752,2.7096117827242665,2.4386511468856913,5073012114,5012416599,76.54143428128594,74.74170920746538,NaN,NaN,22.133343696001404,16.403912020399552
2019-02-19T09:30:00-05:00,171.39,172.8,171.38,172.28,19487679,32610485.95,65.04713009331553,61.70362629640708,NaN,NaN,103.37139652444502,105.68586661241815,0.24848073037621665,2.749252059855962,2.5007713294797456,5092499793,5040047079.6,79.7202399864789,75.15126451813819,NaN,NaN,23.241542102735732,17.38071631787615
2019-02-20T09:30:00-05:00,172.43,173.08,171.32,172.25,32592995,31404551,64.93926987312022,62.20113894380014,NaN,NaN,99.89970028251578,104.0501355031503,0.19665140588910024,2.746585586841121,2.549934180952021,5059906798,5055214546.6,81.22430898923342,75.60169057831281,NaN,NaN,24.160204333344065,18.34921460580014
2019-02-21T09:30:00-05:00,171.77,172.26,170.71,171.62,25207401,30759617.95,62.59203675392782,62.281699966368215,NaN,NaN,78.01853259972134,96.80991188859605,0.09040460636042624,2.6629399389025536,2.5725353325421274,5034699397,5060121706.2,81.6972671231398,76.01262182288268,NaN,NaN,24.399272124919698,19.213508537102932
2019-02-22T09:30:00-05:00,171.98,173.01,171.9,172.89,27735358,30525718.3,65.3138177618489,62.66627759569087,NaN,NaN,97.3574692142735,97.07981552978188,0.07666713138186498,2.6683692467694584,2.5917021153875934,5062434755,5064510571.4,82.13081616270516,76.53704409032777,NaN,NaN,25.297409307967563,20.082637218655023
2019-02-25T09:30:00-05:00,174.2,174.66,173.4,173.52,32608754,30332852.55,66.6116126858818,62.93458242199993,NaN,NaN,118.50117285422313,99.42965429503572,0.08061480522246489,2.6924706219156747,2.6118558166932098,5095043509,5068916850.4,82.57703588661184,77.02576138664998,NaN,NaN,26.411036840098056,20.9866943074326
2019-02-26T09:30:00-05:00,173.04,174.25,172.81,173.7,21939717,29755277.6,66.9916186707568,63.087659158518214,NaN,NaN,106.70599460046682,100.0965739102401,0.06653855797294295,2.6950290141593882,2.6284904561864453,5116983226,5073813537,83.08261856627365,77.39791518647189,NaN,NaN,27.461666023988133,21.911690266940532
2019-02-27T09:30:00-05:00,172.92,173.8,171.76,173.59,25162014,29474169.55,66.49356120967705,63.29441687542906,NaN,NaN,91.23151619872618,98.36293709348217,0.02324438896610781,2.65754594239408,2.634301553427972,5091821212,5080196419.8,83.7447775958784,77.77136830106915,NaN,NaN,28.248384148699245,22.816932250048918
2019-02-28T09:30:00-05:00,173.04,173.81,172.7,173.19,25085470,28661116.4,64.61239652070071,63.75401731409429,NaN,NaN,93.36741355159307,101.43271328385653,-0.05465355664482363,2.5659846076219424,2.620638164266766,5066735742,5086603688.8,84.40465742648205,78.43999120392365,NaN,NaN,28.491333221809484,23.62756096030043
2019-03-01T09:30:00-05:00,174.41,174.65,173.18,174.39,31431156,28369756.15,67.57599786012656,64.38630403577461,NaN,NaN,116.23836064780473,105.20889157056277,-0.04792411139638997,2.5607330250212783,2.6086571364176683,5098166898,5093750117.4,85.12974607752962,79.13580572703458,NaN,NaN,29.45183163762662,24.459599628489883
2019-03-04T09:30:00-05:00,175.37,175.79,172.47,174.42,38063458,28665745.45,67.64894055926928,65.05220042276662,NaN,NaN,114.0969699527268,104.3280509902635,-0.06306206362483469,2.529829556886625,2.59289162051146,5136230356,5101987486.8,85.94113772284695,80.08001458227957,NaN,NaN,30.291139230800628,25.292676714534274
2019-03-05T09:30:00-05:00,174.52,175.085,173.685,174.55,22319863,28445799.55,67.98504548744408,65.4387565308393,NaN,NaN,112.58873965980584,105.50460000213131,-0.08458702289889919,2.4871578418878357,2.571744864786735,5158550219,5110300885.4,86.72821304168613,81.26261558107012,NaN,NaN,31.099495590065324,26.122222268181567
2019-03-06T09:30:00-05:00,174.68,174.75,173.28,173.56,27194581,28397710.2,62.64721624967757,65.42997419924089,NaN,NaN,80.30518007375825,103.31933277713772,-0.18026985305922194,2.3464075484627074,2.5266774015219293,5131355638,5118207770.6,87.44797897600206,82.44531136295792,NaN,NaN,30.50813485583632,26.7487812092751
2019-03-07T09:30:00-05:00,173.09,173.18,170.79,171.43,39407443,28969582.05,53.004617770469174,64.70632619686077,NaN,NaN,-8.780362233721215,82.88977762007487,-0.3897588132411496,2.0394788849704923,2.429237698211642,5091948195,5123250261.2,87.89871045097068,83.44778159193747,NaN,NaN,27.205529473301336,26.81403096127885
2019-03-08T09:30:00-05:00,169.51,171.26,169.3375,171.17,39303225,28832933.65,51.953418947328274,63.81547717453891,NaN,NaN,-73.01699708269827,45.03870607397427,-0.539370122958148,1.7550250445139568,2.294395167472105,5052644970,5114145875.6,82.16196876568151,83.84924834082287,NaN,NaN,24.13028829450661,26.430639151739957
2019-03-11T09:30:00-04:00,171.86,174.85,171.85,174.73,30518408,28907816.7,62.8248210638291,63.65674081528988,NaN,NaN,73.85135463143993,36.98958300971689,-0.39859559991317717,1.7961506675806334,2.1947462674938105,5083163378,5103532480,75.93981527823176,83.57921800451949,NaN,NaN,24.430165950300093,26.144857265819976
2019-03-12T09:30:00-04:00,175.17,176.14,174.7715,175.69,33953500,29533787.3,65.11697177039144,63.66943380795211,NaN,NaN,153.0820429699711,45.08824367174996,-0.2482099416444825,1.8844838404382074,2.13269378208269,5117116878,5095245811.8,71.39370384175984,82.8770319225571,NaN,NaN,25.408869373807587,26.039716138389636
2019-03-13T09:30:00-04:00,176.6,177.93,176.35,177.01,42426135,30168990.4,68.03538607837615,64.05824447398415,NaN,NaN,208.47794731648932,70.72279712029616,-0.07614359508403945,2.0375142882276407,2.11365788331168,5159543013,5100883286.8,72.59563513966273,82.22691535230875,NaN,NaN,27.180197016925305,26.202641978180445
2019-03-14T09:30:00-04:00,177.115,177.34,176.66,176.71,23751477,30051857.45,66.67018558254972,64.15512788974848,NaN,NaN,172.04208134239173,106.88728583551874,-0.002719284069103267,2.110258778225301,2.1129780622944043,5135791536,5109651955,74.39754598745094,81.67453891121916,NaN,NaN,28.188808790607517,26.486380094241454
2019-03-15T09:30:00-04:00,177.43,178.88,177.28,178.35,38191958,30445113.85,70.19153029626935,64.41083629049045,NaN,NaN,201.75126639209236,161.84093853047688,0.12884155197310587,2.274030002260787,2.145188450287681,5173983494,5133919659.8,78.59275891730556,81.38994769912586,NaN,NaN,30.189255759352,27.01536233211439
2019-03-18T09:30:00-04:00,177.95,178.99,177.5915,178.45,32935125,30465785.85,70.39690812316323,64.65407125137662,NaN,NaN,174.85652212902676,182.04197202999424,0.19137174095333975,2.3844031264793557,2.193031385526016,5206918619,5158670708,81.85794839084045,81.30247125802347,NaN,NaN,31.851511237298634,27.70624074714071
2019-03-19T09:30:00-04:00,179.16,180,178.29,179.05,36893341,31336068.95,71.6586495078862,65.02300612982013,NaN,NaN,167.1843873825569,184.8624409125114,0.2388295788690784,2.491568359112364,2.2527387802432854,5243811960,5184009724.4,84.4695790336711,81.35424278929439,NaN,NaN,33.616728759387065,28.550596177461617
2019-03-20T09:30:00-04:00,179.06,180.86,178.24,179.76,50104996,32211669,73.11872375395032,65.63060093219511,NaN,NaN,151.19373839467912,173.4055991281494,0.28082814295311653,2.6037739589346813,2.322945815981565,5293916956,5210884513,86.66257284255971,81.51552246187136,NaN,NaN,35.54273796661479,29.54947357591207
2019-03-21T09:30:00-04:00,179.24,182.83,179.2,182.57,42428481,33072723,77.95852665404261,66.37221013176054,NaN,NaN,172.93932798209354,173.58504845608974,0.45058033570813105,2.886171235616729,2.435590899908598,5336345437,5250995293.2,89.12972273342456,81.80123508014957,NaN,NaN,38.96284255698176,30.894240573207743
2019-03-22T09:30:00-04:00,181.76,182.27,178.37,178.56,70794543,35225682.25,61.06278879707632,65.90177072017532,NaN,NaN,107.37939415504266,154.7106740086798,0.25524390650404527,2.7546457830386544,2.499401876534609,5265550894,5269308773.2,90.03598194373387,82.09372395307005,NaN,NaN,35.94332466356155,31.615538300401145
2019-03-25T09:30:00-04:00,177.92,178.84,176.93,178.22,46336524,35912070.75,59.87784184939377,65.32268474602888,NaN,NaN,55.43151290455603,130.82567216378567,0.07494593411234707,2.5930842941750427,2.5181383600626956,5219214370,5271767923.4,90.15467916312663,82.33847153317296,NaN,NaN,33.233434685085946,31.846666355356117
2019-03-26T09:30:00-04:00,179.58,180.69,178.14,179.05,33248121,36477490.95,61.825358150424655,65.26398059608223,NaN,NaN,79.52638368771402,113.29407142481708,-0.011978857528790687,2.5031647881517074,2.515143645680498,5252462491,5273498029.6,90.24274472237451,82.53809765791384,NaN,NaN,31.700425892391326,31.82577486064686
2019-03-27T09:30:00-04:00,179.27,179.72,176.6,177.9,37096697,37074225.1,57.64993881437061,65.5957892420752,NaN,NaN,43.98496892733335,91.85231753134791,-0.16215407931995474,2.3124510465305548,2.4746051258505095,5215365794,5257787797.2,82.9839447302401,82.18704296357593,NaN,NaN,29.0604052920317,31.430722065130407
2019-03-28T09:30:00-04:00,178.36,178.98,177.24,178.31,30368235,37338363.35,58.72032483383845,66.07913966254021,NaN,NaN,42.165588940401925,65.69756972300958,-0.24417587458290813,2.1693852826218745,2.4135611572047826,5245734029,5239665515.6,75.44519907092499,81.70727369966475,NaN,NaN,27.27600948090932,30.837191695955966
2019-03-29T09:30:00-04:00,179.63,179.83,178.59,179.66,35205511,37527081.1,62.11564604563786,66.02848430409799,NaN,NaN,69.00099052539794,58.021888997080644,-0.21863557420847446,2.1402666894441893,2.3589022636526638,5280939540,5242743244.8,75.84651557575697,81.70060943520228,NaN,NaN,26.810154285120475,30.26190063726518
2019-04-01T09:30:00-04:00,181.42,182.26,180.77,182.04,30969472,37172381.8,67.23262997390074,66.17960274720579,NaN,NaN,123.03749324629565,71.54308506542858,-0.060785792430360974,2.2829200231147126,2.3437058155450736,5311909012,5261282173.2,78.1618096313754,82.18404556303196,NaN,NaN,28.091715780688336,29.951874229182774
2019-04-02T09:30:00-04:00,182.23,182.905,181.78,182.73,22645151,37188646.2,68.55853892865372,66.2169708079399,NaN,NaN,133.61965008326993,82.36173834453976,0.06400495390056848,2.423712007920784,2.3597070540202156,5334554163,5277700507.6,79.99108488761547,82.71229197360002,NaN,NaN,29.55008029171775,29.8944750952592
2019-04-03T09:30:00-04:00,183.74,184.92,183.2089,183.78,31633476,37410590.95,70.51384671143884,66.49151803143198,NaN,NaN,164.6436419398453,106.49347294704216,0.18436167888112642,2.5901591526216237,2.4057974737404972,5366187639,5307864876.6,82.83578331265662,83.3150232111147,NaN,NaN,31.382445121816037,30.107042241910175
2019-04-04T09:30:00-04:00,183.81,184.5,182.65,183.71,28530828,36866760.2,70.20041314673094,66.49215252075068,NaN,NaN,141.90834131826392,126.44202342261455,0.22373396574249238,2.685464930918613,2.4617309651761206,5337656811,5326249433,84.30077295659542,83.72273849963541,NaN,NaN,32.75027222298732,30.484646524921196
2019-04-05T09:30:00-04:00,184.3,184.77,184.0183,184.66,25674660,36185331.95,72.01825515607656,66.60796302310162,NaN,NaN,155.89328645242657,143.82048260802028,0.27486689751251214,2.8053145870667606,2.5304476895542485,5363331471,5342727819.2,85.49573089855883,83.98258010732957,NaN,NaN,34.45431750649581,31.051742379431854
2019-04-08T09:30:00-04:00,184.37,185.28,183.63,185.13,22697543,35794288.7,72.89907863913267,66.69656510390494,NaN,NaN,138.89747485629434,146.99247893002,0.29943174500138126,2.904737370805975,2.605305625804594,5386029014,5357551819.6,86.49183799597658,84.12702717606568,NaN,NaN,36.12633078467007,31.77668358018017
2019-04-09T09:30:00-04:00,184.5,185.11,184.09,184.48,25631886,35378208,69.63441669629373,66.44768602835804,NaN,NaN,116.99252040175509,143.66705299371705,0.2338982530838587,2.8976784421594175,2.663780189075559,5360397128,5362720412.6,86.83141700104316,84.13908747310022,NaN,NaN,36.62429351655128,32.46919928537604
2019-04-10T09:30:00-04:00,184.75,185.53,184.52,185.47,24562958,34485049.15,71.71229635680817,66.00152672141272,NaN,NaN,117.46613102506588,134.23155081076115,0.21945610868602383,2.938100324933089,2.718644216247065,5384960086,5366474902,87.08539088917239,83.99306376993935,NaN,NaN,37.64937971332864,33.20922506079784
2019-04-11T09:30:00-04:00,185.77,185.78,184.6899,185.03,20654094,34330180,69.43804524517046,66.59975932484802,NaN,NaN,105.26210810468946,126.90230416804627,0.14603466806113863,2.9011875513234884,2.7551528832623498,5364305992,5371804738.2,87.45526933726465,83.80872715519156,NaN,NaN,37.87713097125593,33.87606876229185
2019-04-12T09:30:00-04:00,185.86,185.95,185.0601,185.83,24989136,33670038.9,71.22487818795189,67.4102619204593,NaN,NaN,105.73992681535715,116.87163224063238,0.11829608100634159,2.903022984520277,2.7847269035139353,5389295128,5376997469.6,87.8212410149116,83.64205300174763,NaN,NaN,38.571794807887784,34.54688676880556
2019-04-15T09:30:00-04:00,185.81,186.07,184.62,185.86,21073046,33076934.95,71.29265977445183,68.08649775074697,NaN,NaN,92.75379482193152,107.64289623375983,0.07123550227749398,2.8737712813608027,2.8025357790833088,5410368174,5381865301.6,88.16966464186325,83.49397585313967,NaN,NaN,39.16410104416402,35.20648880814248
2019-04-16T09:30:00-04:00,186.51,186.91,185.93,186.5,27195709,32592053.35,72.76647107613377,69.16625005515861,NaN,NaN,105.81992365382757,105.40837688417432,0.05329768160707271,2.86915788109215,2.815860199485077,5437563883,5397298652.6,89.2224369856803,83.93958244281399,NaN,NaN,40.0742243277912,35.901879596663726
2019-04-17T09:30:00-04:00,187.75,187.93,186.6,187.15,29651575,31569382.3,74.2143904978578,70.27296903116,NaN,NaN,113.64480240985887,104.6441111611329,0.05507047212728011,2.8846982896441773,2.829627817516897,5467215458,5413749727,90.22136535706868,84.99502289182426,NaN,NaN,41.25797030249425,36.66703541178237
2019-04-18T09:30:00-04:00,187.48,187.7905,186.29,187.39,28580864,30877001.45,74.74823500681069,71.1752968141009,NaN,NaN,100.76125327755076,103.74394019570518,0.04281380036445359,2.883145067972464,2.8403312676080104,5495796322,5440047793,91.56695443165054,86.11791138153093,NaN,NaN,42.40337252272081,37.486512141916435
2019-04-22T09:30:00-04:00,186.54,187.99,186.43,187.92,17936033,28234075.95,75.93319874749699,71.79676601221493,NaN,NaN,100.58560734786258,102.71307630220626,0.04081578962122645,2.8913510046345436,2.850535215013317,5513732355,5464935238.4,92.60415600450278,87.14950755104005,NaN,NaN,43.71591405040224,38.37642670027155
2019-04-23T09:30:00-04:00,188.37,190.54,188.13,190.31,33665561,27600527.8,80.39982811580875,72.642572382726,NaN,NaN,149.6700809751281,114.09633353284558,0.16396027514662626,3.0554855589466,2.891525283799974,5547397916,5492341186.8,93.54557976744267,88.11768575674198,NaN,NaN,46.36081121149054,39.51705305901712
2019-04-24T09:30:00-04:00,190.44,190.71,189.65,189.71,24977108,27186977.15,76.55840239020225,73.07432635978053,NaN,NaN,150.4448434933946,123.02131750075895,0.16789770205469212,3.101397411368339,2.933499709313647,5522420808,5509312571.8,94.05062030093312,88.91874554161889,NaN,NaN,47.447837534495804,40.65002226979979
2019-04-25T09:30:00-04:00,191.15,191.22,189.45,190.48,29517497,26808017.15,78.01044047810437,73.63218545487862,NaN,NaN,150.24600109835214,130.34155723845763,0.18395957422610865,3.1634491770962825,2.979489602870174,5551938305,5526257141.2,94.5123161942846,89.6481414871681,NaN,NaN,48.803272016172265,41.81477223356729
2019-04-26T09:30:00-04:00,190.2,190.69,188.59,190.65,26359537,26607582.25,78.32959478787964,74.08299542857885,NaN,NaN,125.95655157539376,135.38061689802623,0.16806894454736065,3.1895757835543748,3.021506839007014,5578297842,5542757445.2,94.92530683080237,90.3216826251855,NaN,NaN,50.00728269195574,42.98513087047993
2019-04-29T09:30:00-04:00,190.62,191.32,190.34,191.02,21716242,25933118.8,79.04254660225756,74.52181456880206,NaN,NaN,136.21285773771515,142.50606697599673,0.14536458843962485,3.203212574556545,3.0578479861169203,5600014084,5560013791,95.32183010866424,90.95239634752033,NaN,NaN,51.221748426850965,44.161790521390074
2019-04-30T09:30:00-04:00,189.48,189.85,188.21,189.54,31495277,25959409.05,69.23098110544235,74.49299774088409,NaN,NaN,76.90295368900985,127.95264151877309,0.001185727110389223,3.059330145004907,3.0581444178945176,5568518807,5564237969.2,95.41624880813733,91.56559861945563,NaN,NaN,49.4321723795086,44.914702215407004
2019-05-01T09:30:00-04:00,190.76,191.32,188.795,188.93,34797109,26567006.95,65.61573249593513,74.05752889367888,NaN,NaN,82.91131763770412,114.44593634763501,-0.15605424157489,2.8630766159259053,3.0191308575007954,5533721698,5566498147.2,95.46894346746643,92.16442380361948,NaN,NaN,46.84739840693112,45.190801671339024
2019-05-02T09:30:00-04:00,188.88,189.85,186.87,188.11,44110122,27190839.25,61.00399420879045,73.4550966767946,NaN,NaN,33.56448358584282,91.10963284513313,-0.3262839105486228,2.6112759693150167,2.9375598798636395,5489611576,5554032801.4,89.36698769626426,92.30097511497661,NaN,NaN,43.24080862630672,44.91223123633441
2019-05-03T09:30:00-04:00,189.69,191.25,189.33,191.11,30386180,27283606.85,69.46080086407447,73.32909115366049,NaN,NaN,97.58498124961625,85.43531877997764,-0.25120440865600635,2.6235543690436316,2.874758777699638,5519997756,5542372784.2,83.96112826255718,92.02525277552272,NaN,NaN,42.529623441417556,44.57185869420343
2019-05-06T09:30:00-04:00,187.1,190.2,186.76,189.94,38371777,27918462.7,63.6622735144614,72.78406356366118,NaN,NaN,39.20389597505762,66.03352642744613,-0.2918527749038491,2.509942809069827,2.801795583973676,5481625979,5518695163.2,74.15192734738805,91.02398582591734,NaN,NaN,39.959479960244806,43.91294744649505
2019-05-07T09:30:00-04:00,187.86,188.67,184.51,186.24,58818134,29724492.25,49.56958754423752,71.12714331138288,NaN,NaN,-52.36102755247617,40.18073017914894,-0.5636997703027453,2.097170871095244,2.6608706413979895,5422807845,5489552970.8,64.20888414468206,89.23730348013176,NaN,NaN,32.04980780834475,42.21821321247358
2019-05-08T09:30:00-04:00,185.68,187.17,184.96,185.77,37165319,30301163.9,48.112614863192455,69.26273076604964,NaN,NaN,-76.14859685178564,8.368747281250993,-0.7587910787547552,1.7123817929545453,2.4711728717093004,5385642526,5459937136.4,55.99196477567812,86.7923462957467,NaN,NaN,25.565671781438233,39.83927872232567
2019-05-09T09:30:00-04:00,183.76,185.4121,182.09,184.77,55351668,31840599.4,45.07679525983975,67.14334221269458,NaN,NaN,-140.40437230289896,-26.42502389649736,-0.9276403243383022,1.3116224662864227,2.239262790624725,5330290858,5428072992.8,48.76167824811466,83.73482656835128,NaN,NaN,19.329844493029512,36.90935954671193
2019-05-10T09:30:00-04:00,184.06,185.89,181.0302,185,58526402,33734214.8,45.92197742144242,64.99968354654781,NaN,NaN,-137.9998544602977,-73.54199103848015,-0.9905801904082552,1.001037552614406,1.9916177430226611,5388817260,5401836893.6,43.75200440273061,80.2453871682247,NaN,NaN,14.763506337956514,33.74566623117544
2019-05-13T09:30:00-04:00,180.3,181.26,178.06,178.58,67185766,35844046.3,31.397937175451474,61.499548479379435,NaN,NaN,-250.18147789784754,-131.4190658130612,-1.405968429181919,0.2341572065452624,1.6401256357271814,5321631494,5369837996.6,38.54994826379048,76.31712777510668,NaN,NaN,3.904348719009957,29.482620872294657
2019-05-14T09:30:00-04:00,179.51,181.63,178.86,180.54,43360636,36958425.8,37.85963155971103,58.73535056291577,NaN,NaN,-187.49244783804335,-158.44534987017462,-1.4824926327932708,-0.21299015526440712,1.2695024775288637,5364992130,5358274853.6,36.84511253166388,72.23102007730175,NaN,NaN,-1.890806199880168,25.000702719126824
2019-05-15T09:30:00-04:00,179.39,183.55,179.31,183.09,40944547,37645867.7,45.10426822955364,56.3849096880193,NaN,NaN,-123.87946638907727,-167.99152377763295,-1.3015805766086175,-0.3574732432319081,0.9441073333767094,5405936677,5362333683.8,37.88353750628589,68.18610731387326,NaN,NaN,-3.622234250982581,20.91171172339691
2019-05-16T09:30:00-04:00,183.11,186.07,182.95,184.93,39281157,38127346.8,49.664428587785345,54.33739781658399,NaN,NaN,-53.209083536309976,-150.55246602431515,-1.0111401449749589,-0.3198178478419891,0.6913222971329697,5445217834,5385319079,43.5447359358046,64.51606653565914,NaN,NaN,-3.2025827171843666,17.466812517599585
2019-05-17T09:30:00-04:00,183.1,185.5813,182.88,183.04,44702276,38933417.4,45.48481058390676,51.94041667241608,NaN,NaN,-64.61083646829329,-135.87466242591427,-0.9030101100002521,-0.43744034036734547,0.46556976963290664,5400515558,5387658738.6,44.10317295829308,60.85759102491834,NaN,NaN,-4.422741312837679,14.339733398965691
2019-05-20T09:30:00-04:00,180.51,181.1799,179.34,179.95,38608294,39967030.45,39.614904884537346,49.824982656637154,NaN,NaN,-124.7131098678707,-110.78098881991889,-0.9893401087022081,-0.7711053662448535,0.2182347424573546,5361907264,5395713892.6,46.080688708687745,57.33362244638623,NaN,NaN,-7.658092106190489,11.197186898229095
2019-05-21T09:30:00-04:00,181.5,182.33,180.92,181.83,31613790,39864441.9,44.32279394993482,48.304058474779985,NaN,NaN,-84.31109476976556,-90.14471820626333,-0.8735996326058509,-0.873764798299959,-0.00016516569410809923,5393521054,5401419677.4,47.497585748013016,53.9070968949967,NaN,NaN,-8.461338230105657,8.388826165609846
2019-05-22T09:30:00-04:00,180.81,182.07,180.75,181.02,24332550,39832214,42.77539482854766,47.002015661905496,NaN,NaN,-83.08212474132793,-81.98524987671347,-0.8069510100663408,-1.0088539282770341,-0.2019029182106933,5369188504,5394070042.8,45.82706808130932,50.797102636785645,NaN,NaN,-9.611692978472156,5.817323430740988
2019-05-23T09:30:00-04:00,179,179.023,177.14,178.25,45351309,40623904.6,37.90214735552271,44.747826125580374,NaN,NaN,-129.25460670372703,-97.19435451019687,-0.897809457695438,-1.3241647403299908,-0.4263552826345528,5323837195,5369793915,40.7313364445076,47.709260364067816,NaN,NaN,-12.291767021354582,3.2303105090130493
2019-05-24T09:30:00-04:00,179.3,179.85,177.94,178.16,25903267,40601091.1,37.75165727148012,42.89706782251029,NaN,NaN,-109.56822915885529,-106.18583304830926,-0.9095497071323907,-1.5632924165500413,-0.6537427094176506,5297933928,5349277589,36.98806793014267,45.05469897712171,NaN,NaN,-14.384413159326614,0.7139214135359544
2019-05-28T09:30:00-04:00,178.67,179.66,177.47,177.49,24763823,40753470.15,36.587026760201574,41.969742052221996,NaN,NaN,-108.50125515350119,-102.94346210543537,-0.9060259566901142,-1.7862751552802933,-0.8802491985901791,5273170105,5331530157.2,34.0711159000126,42.90200124535961,NaN,NaN,-16.42526297211262,-1.7345334986995558
2019-05-29T09:30:00-04:00,176.45,177,175.09,176.03,42178772,41287644.9,34.117084559548516,40.97006131624743,NaN,NaN,-133.42453578626964,-112.7661503087362,-0.941470685647686,-2.0570875556497867,-1.1156168700021007,5230991333,5299024213,29.484673748762646,41.008623314865645,NaN,NaN,-18.902184893615914,-4.18705512654475
2019-05-30T09:30:00-04:00,176.54,177.27,175.77,176.77,30354790,41065528.95,36.45851146303563,40.354469616475704,NaN,NaN,-112.6405646798855,-118.67783829644773,-0.8569373687552109,-2.1867885809461143,-1.3298512121909034,5261346123,5277455736.8,26.897406286915356,39.4468896033514,NaN,NaN,-20.235792755063972,-6.479731930618924
2019-05-31T09:30:00-04:00,174.71,175.29,173.87,173.95,45446206,41132333.15,31.817842453329718,39.34703140446766,NaN,NaN,-142.36869000116135,-121.30065495593458,-0.9268732628280072,-2.4884427907259123,-1.5615695278979052,5215899917,5255868281.2,24.573206253065607,38.0769754498039,NaN,NaN,-22.891117652603633,-8.824215605188169
2019-06-03T09:30:00-04:00,173.52,173.95,169.27,170.12,75842290,43405138.65,26.82395431013235,39.02031834265915,NaN,NaN,-184.37381977580264,-136.26177307932406,-1.1523046194397097,-3.0019503021975424,-1.8496456827578327,5140057627,5224293021,21.62922987741601,36.868352707919996,NaN,NaN,-26.996992987388076,-11.420326659788156
2019-06-04T09:30:00-04:00,171.98,174.97,171.37,174.91,47797848,43876442.2,39.59344497365157,39.14416215794061,NaN,NaN,-122.76978838262657,-139.11547972514913,-0.9106454378786273,-2.9879524801061166,-2.0773070422274893,5187855475,5207230095,20.219505294986917,35.68080933387164,NaN,NaN,-25.97483496912919,-13.499542132551161
2019-06-05T09:30:00-04:00,176.6,176.61,174.38,176.21,34412697,42656170.35,42.52485928098023,38.95991866161393,NaN,NaN,-75.8916686217526,-127.6089062922457,-0.6095392312246979,-2.8392310812583617,-2.2296918500336638,5222268172,5205485462.8,20.075428809184203,34.408801569792956,NaN,NaN,-24.146017769066887,-15.02046722348198
2019-06-06T09:30:00-04:00,176.52,178.04,175.73,177.61,29913205,42293564.65,45.58726720226533,38.66869284836251,NaN,NaN,-41.68694505121254,-113.41818236651113,-0.2791862362431714,-2.578674645337628,-2.2994884090944567,5252181377,5203652513.6,19.91487104634372,32.7209540776886,NaN,NaN,-21.64865479578068,-15.967351162381794
2019-06-07T09:30:00-04:00,178.5,181.7666,178.33,181.04,45888345,41820398.5,52.29394264439387,39.155059424111585,NaN,NaN,34.85746656297648,-77.97295105368356,0.1823666086340543,-2.071530148301889,-2.2538967569359434,5298069722,5220086474.6,25.655896999620907,31.403291509212018,NaN,NaN,-17.14904771042021,-16.136164954958712
2019-06-10T09:30:00-04:00,182.23,184.85,182.21,183.15,41385280,40963342.4,55.89528792513872,40.31794392701168,NaN,NaN,106.25532849105399,-19.84712140031225,0.6173026482246988,-1.4822684466550697,-2.0995710948797686,5339455002,5259965949.6,37.38597993549712,30.78224088255555,NaN,NaN,-12.24140505780914,-15.579770683937344
2019-06-11T09:30:00-04:00,185.07,185.4,182.78,183.4,41260320,39667070.1,56.316068027037694,41.174606361090454,NaN,NaN,103.3510316089957,25.377042598012206,0.8926479117182264,-0.9837612052319855,-1.876409116950212,5380715322,5298537919,46.22391494338189,30.69126439651047,NaN,NaN,-8.301163542671414,-14.539969663756498
2019-06-12T09:30:00-04:00,182.88,183.28,182,182.34,27758120,38886944.3,53.96516740035331,41.97387583050514,NaN,NaN,70.0406498987609,54.5635063021149,0.9678950500863024,-0.6665403043423339,-1.6344353544286363,5352957202,5324675725,51.245867953374265,31.0783215302294,NaN,NaN,-5.8012937807932605,-13.29158739476175
2019-06-13T09:30:00-04:00,183.12,183.87,182.74,183.42,23715829,38025508.4,55.981400505603155,43.26525105551089,NaN,NaN,83.57394172398573,79.61568365715455,1.0481437528030062,-0.32425566342487855,-1.3723994162278847,5376673031,5349574055.8,55.50821742460066,32.133813028807474,NaN,NaN,-3.124752984188029,-11.839182478965505
2019-06-14T09:30:00-04:00,182.44,183.11,181.94,182.64,22844089,37203655,54.137210853518866,44.435647739942226,NaN,NaN,72.10079621769027,87.0643495880973,1.0062307832247535,-0.11461093719694304,-1.1208417204216965,5353828942,5360725899.8,57.308498003568594,33.585272319766474,NaN,NaN,-1.4448930128228037,-10.354283983802262
2019-06-17T09:30:00-04:00,183.01,184.25,182.835,183.74,20379476,35987515,56.32246861762995,45.84532215832997,NaN,NaN,94.6792858520241,84.74914106029132,1.0076301957227447,0.13869602423173433,-0.8689341714910104,5374208418,5367676583,58.43733002711854,35.32571618598833,NaN,NaN,0.6040689638702843,-8.788804991277612
2019-06-18T09:30:00-04:00,185.88,187.72,185.4291,186.41,48177301,36465965.35,61.16000886019944,47.77695960837646,NaN,NaN,135.78493923934303,91.23592258636081,1.134000749845351,0.5485667658156785,-0.5854339840296725,5422385719,5376010662.4,59.80955562728624,37.49177917731144,NaN,NaN,3.9024751646450433,-6.975764969002947
2019-06-19T09:30:00-04:00,186.73,187.53,185.57,187.11,31672855,36468918.6,62.33773523375552,49.62547559199931,NaN,NaN,125.96323676246622,102.42043995910187,1.2037708263658788,0.9192795489276762,-0.28449127743820274,5454058574,5396230936.8,63.00126303629997,40.07062608798177,NaN,NaN,6.968988551202618,-4.983657323259295
2019-06-20T09:30:00-04:00,189.72,189.76,187.1585,188.85,40921964,37298389.3,65.1653041153791,52.007437139288506,NaN,NaN,138.94929381512426,113.49551037732958,1.2980340905174184,1.3380513357085704,0.04001724519115191,5494980538,5419892438.2,66.36718060500317,43.05590997026302,NaN,NaN,10.462330354791886,-2.777087654966269
2019-06-21T09:30:00-04:00,188.57,189.77,188.1736,188.57,39980418,37029844.75,64.32834811545133,54.686322411097,NaN,NaN,124.79330247512232,124.03401162881599,1.2708376109254116,1.6285642588479163,0.3577266479225048,5455000120,5440126673.8,68.96714553060491,46.437189659776514,NaN,NaN,13.091336171914358,-0.5101699654118939
2019-06-24T09:30:00-04:00,188.52,188.72,188.06,188.16,19375205,36703441.65,63.05134757095681,56.36188688233308,NaN,NaN,103.86724058421537,125.87160257525424,1.1577454091458546,1.804908409354823,0.6471630002089686,5435624915,5452409973.2,70.4600332150252,50.0257987969221,NaN,NaN,14.943395039655801,1.697482178169205
2019-06-25T09:30:00-04:00,188.06,188.14,184.65,184.93,33921112,37161306.1,53.96294286371378,57.17889285252834,NaN,NaN,63.4896846708638,111.41255166155838,0.8141393649280596,1.664837206369043,0.8506978414409835,5401703803,5448273590,69.2518653019093,53.53840140354532,NaN,NaN,13.994790499321125,3.4542405097623368
2019-06-26T09:30:00-04:00,186.13,187.33,185.49,185.79,22595721,36182153.55,55.790170831495466,57.90767168318764,NaN,NaN,62.99152616819282,98.8182095427037,0.6032227634032377,1.6047262956950306,1.001503532291793,5424299524,5442321780,67.45944363329684,56.93444230261341,NaN,NaN,13.725582816041124,4.92157512494502
2019-06-27T09:30:00-04:00,186.47,186.94,185.99,186.5,19709228,35649875.45,57.29708086571365,58.26503869899619,NaN,NaN,63.107317909862076,83.64981436165127,0.4755824144419418,1.59598155034422,1.1203991359022782,5444008752,5432127422.8,64.38552462866643,59.700844276116655,NaN,NaN,13.92241317868677,6.207409132622413
2019-06-28T09:30:00-04:00,186.95,187.15,186.07,186.74,21179248,34436527.55,57.820449880895254,58.402550267264516,NaN,NaN,62.02802291468129,71.09675844956305,0.3757508747493692,1.5900877293389897,1.2143368545896205,5465188000,5434164998.8,64.73144487855983,61.65409177204971,NaN,NaN,14.226903497927628,7.353051184808872
2019-07-01T09:30:00-04:00,190.3,190.5699,188.38,189.26,31193393,32204082.7,62.95449774607285,58.876723818624164,NaN,NaN,107.04821876622228,71.73295408596444,0.4432305534888408,1.7683750464506716,1.3251444929618308,5496381393,5446316294.4,66.80230523834759,63.123976793118686,NaN,NaN,15.9883735148279,8.586668660525877
2019-07-02T09:30:00-04:00,189.19,190.03,188.66,190.01,18035768,30715978.7,64.34546884349487,59.61817392170571,NaN,NaN,104.32155881477136,79.89932891474595,0.4980727892752004,1.9477354795558313,1.4496626902806309,5514417161,5468858966,70.28780721324105,64.4841153116806,NaN,NaN,17.86450739308955,9.912074193749259
2019-07-03T09:30:00-04:00,190.45,191.44,190.29,191.44,15792067,29784947.2,66.89759219300703,60.397901899377416,NaN,NaN,132.85179696261702,93.8713830736308,0.5843800027835655,2.180137693760088,1.5957576909765223,5530209228,5490040906.8,73.14136333824943,65.74362573408408,NaN,NaN,20.23304958898013,11.38649925021081
2019-07-05T09:30:00-04:00,190.15,191.4,189.39,191.05,21415620,29360067.95,65.52014476590618,61.210968607405086,NaN,NaN,120.53343786880805,105.35660706541998,0.5684044196197566,2.306263215501218,1.7378587958814615,5508793608,5502997878,74.73950750875007,66.98869784159704,NaN,NaN,21.821779718665223,12.877253602847155
2019-07-08T09:30:00-04:00,189.86,189.87,188.93,189.71,17598826,27945592,60.881662273153545,61.53662529708534,NaN,NaN,83.67078576214136,109.685159634912,0.42723513824123804,2.271902718683009,1.844667580441771,5491194782,5508199234.4,75.37299976166598,68.19838853692185,NaN,NaN,21.908452053680982,14.16742481010913
2019-07-09T09:30:00-04:00,188.79,190.9,188.65,190.66,19193497,26836002.85,62.88762698294047,61.66002659156685,NaN,NaN,89.27269969058071,106.13005581978368,0.3601658940693664,2.294874948028479,1.9347090539591125,5510388279,5511000611.6,75.72608453563927,69.33528345894707,NaN,NaN,22.54013872962689,15.363526798611668
2019-07-10T09:30:00-04:00,191.79,193.09,191.47,192.56,28374513,26191712.5,66.57891643642856,61.9629681060435,NaN,NaN,137.56981950711778,112.77970795825294,0.4028628879686367,2.4382876639199083,2.0354247759512716,5538762792,5515869737.8,76.3604944885223,70.28951427696295,NaN,NaN,24.17717779013489,16.6226197974007
2019-07-11T09:30:00-04:00,192.88,193.34,191.81,192.42,23736122,25990612.6,66.05755251562402,62.02670013463243,NaN,NaN,130.06544805576763,112.22243817688309,0.38101474619133935,2.5116932086904455,2.130678462499106,5515026670,5512833226.2,75.04329770942724,70.90923692727895,NaN,NaN,25.373990186973565,17.87281556733968
2019-07-12T09:30:00-04:00,192.63,193.54,192.45,193.53,20211883,25815415.3,68.18480237204344,62.30216115296042,NaN,NaN,137.7735623806825,115.67046307925798,0.39875994960752825,2.6291283995085166,2.2303684499009884,5535238553,5518122215.2,75.82550479349095,71.39911973177082,NaN,NaN,27.009466925497094,19.17805147564788
2019-07-15T09:30:00-04:00,193.97,194.19,193.44,194.15,15606074,25453514.55,69.3406271728178,62.75139541023621,NaN,NaN,147.98291228911796,128.5328883846533,0.40821175199812787,2.740633139898648,2.3324213879005202,5550844627,5530052184.2,77.53582107782591,71.90453315054229,NaN,NaN,28.71667139441769,20.540711464043568
2019-07-16T09:30:00-04:00,193.86,194.09,192.56,193.15,20190891,25444085.3,65.22474648080245,63.55580995431398,NaN,NaN,118.806420689161,134.43963258436935,0.3076549196559002,2.7169900374703957,2.4093351178144955,5530653736,5534105275.6,78.10263771089367,72.53673117975546,NaN,NaN,29.062828896767762,21.758156811575596
2019-07-17T09:30:00-04:00,193.2,193.49,192.18,192.2,16765069,23873473.7,61.49059447954734,63.96298307203197,NaN,NaN,87.79221798969532,124.48411228088487,0.14590783699502285,2.591719914058274,2.445812077063251,5513888667,5529130450.6,75.58179733799743,73.1168993015198,NaN,NaN,28.32078097932983,22.6956745498262
2019-07-18T09:30:00-04:00,191.3,192.79,190.69,192.42,29066336,23743147.75,62.03268675248783,64.30124063537298,NaN,NaN,60.570488379826486,110.58512034569662,0.028621053426070908,2.48158839384584,2.452967340419769,5542955003,5534716117.2,76.49896456302666,73.98214501111696,NaN,NaN,27.843355145344688,23.431057492043127
2019-07-19T09:30:00-04:00,193.82,193.83,190.81,191.01,29387945,23166446.8,56.5393257195779,64.20973176670745,NaN,NaN,52.309551745659775,93.49231821869209,-0.1587385342022749,2.2545441726669253,2.4132827068692,5513567058,5530381818.2,74.17089011019856,74.65639109909115,NaN,NaN,25.87466328522693,23.78014403392653
2019-07-22T09:30:00-04:00,191.5,192.94,191.44,192.53,18953596,22115105.7,60.590895100206424,64.04090300628842,NaN,NaN,59.549565878186286,75.80564893650576,-0.19284914648402784,2.1722212737641655,2.3650704202481934,5532520654,5526717023.6,72.17094016775765,75.03986502262045,NaN,NaN,25.264656743307974,23.992217278123878
2019-07-23T09:30:00-04:00,193.58,193.81,192.29,193.79,23786726,22335681.75,63.61862783191633,63.988985791175665,NaN,NaN,82.9373031472595,68.63182542812544,-0.14527118566203878,2.183481438170645,2.328752623832684,5556307380,5531847752.4,73.25809663494952,75.25202855274247,NaN,NaN,25.612212072361373,24.22364510587209
2019-07-24T09:30:00-04:00,193.07,195.16,193.03,195.15,20422872,21660769.75,66.60128772278148,63.967821186159554,NaN,NaN,112.38092087533927,73.54956600525425,-0.04227365631513669,2.275910553438763,2.3181842097538996,5576730252,5544416069.4,75.75654710295345,75.43882739307848,NaN,NaN,26.80147085381221,24.591905927006394
2019-07-25T09:30:00-04:00,194.48,194.52,192.93,193.3,23434744,21702720.9,59.46013892975576,63.53496362643453,NaN,NaN,78.93251376372724,77.2219710820344,-0.11469786639691337,2.174811876757758,2.2895097431546714,5553295508,5546484170.4,76.15138684528017,75.53967591711634,NaN,NaN,25.639780311922532,24.7416022677087
2019-07-26T09:30:00-04:00,194.52,195.55,194.43,195.29,20431243,21738821.65,63.93919872069173,63.75335908697297,NaN,NaN,132.69659853921752,93.29938044074596,-0.04795517880254785,2.2295657696514866,2.2775209484540344,5573726751,5558516109,78.35959641112056,75.75300424922024,NaN,NaN,26.048169598094013,24.928254743478032
2019-07-29T09:30:00-04:00,195.18,195.18,193.39,194.62,20451652,21702441.85,61.476451677776794,63.652560850889856,NaN,NaN,102.331436145003,101.8557544941093,-0.0671298240285596,2.193608668418335,2.2607384924468947,5553275099,5562666998,79.07928381553552,75.99251848349854,NaN,NaN,25.615531164858833,25.026437089389574
2019-07-30T09:30:00-04:00,193.16,194.54,192.99,193.78,18705006,21078022.5,58.43743602918223,63.07102653608655,NaN,NaN,67.05401334194971,98.67909653304736,-0.14984662278474525,2.0734302139659633,2.2232768367507085,5534570093,5558319540.6,76.22019593018665,75.98249715790314,NaN,NaN,24.328421090634855,24.9267205181389
2019-07-31T09:30:00-04:00,194.31,194.43,189.32,191.1,41627473,22257607.75,49.95295105402662,61.920697860258166,NaN,NaN,-53.95126074093728,65.41266020979205,-0.3851372317440638,1.7418552970706287,2.1269925288146925,5492942620,5541562014.2,66.27379664907733,75.35610422502101,NaN,NaN,20.368065796186773,24.275484129288596
2019-08-01T09:30:00-04:00,191.51,194.98,189.23,190.15,63251648,24630586.8,47.32969014246953,60.43104698671717,NaN,NaN,-65.36771728747556,36.552613999551475,-0.5924414625109162,1.3864407006760473,1.9788821631869635,5429690972,5516841107,54.89344914351439,73.86095739287984,NaN,NaN,16.278592510725495,23.133071040922438
2019-08-02T09:30:00-04:00,188.82,188.99,186.21,187.35,55214006,26320506.1,40.56762926768915,58.37583285063656,NaN,NaN,-247.37734782334206,-39.46217527296044,-0.8880495274132247,0.8688202539204326,1.7568697813336573,5374476966,5476991150,42.287538704354404,71.34322293763186,NaN,NaN,10.30407507564495,21.300357331597084
2019-08-05T09:30:00-04:00,183.51,183.51,179.2,180.73,75039971,29192563.35,29.746621590517222,55.841681072759044,NaN,NaN,-391.96462898883226,-138.3213882997275,-1.4652678928672755,-0.0747150847504372,1.3905528081168383,5299436995,5426223529.2,32.15628477412342,68.06134058500541,NaN,NaN,-0.02792144465300863,18.253460363561356
2019-08-06T09:30:00-04:00,182.38,183.8,181.07,183.26,41897249,30327750.95,36.696295352589374,54.07065970654776,NaN,NaN,-250.26817779019956,-201.78582652615734,-1.6014641326311003,-0.6112773576720372,0.9901867749590632,5341334244,5387576359.4,26.87728384983025,64.58244676442204,NaN,NaN,-5.381430672146787,14.877047358460192
2019-08-07T09:30:00-04:00,181.32,184.51,179.89,184.25,49990586,31408554.6,39.22960692171419,52.44186829006394,NaN,NaN,-181.5684643669997,-227.30926725136982,-1.5487257576667215,-0.9457204221243387,0.6030053355423828,5391324830,5367252801.4,24.591006538175222,60.87473547693266,NaN,NaN,-8.474566810727254,11.5411024771477
2019-08-08T09:30:00-04:00,185.15,188.32,184.57,188.26,38418084,32142652.7,48.26129438856903,51.85058033784901,NaN,NaN,-77.36831982874106,-229.7093877596229,-1.1840722552180338,-0.8770849834801595,0.3069872717378743,5429742914,5367263189.8,24.59453739366367,57.3335674257516,NaN,NaN,-7.632606978379283,8.802001126358132
2019-08-09T09:30:00-04:00,187.32,188,185.03,186.49,33608926,32812504.85,45.07677930015023,50.74242920927356,NaN,NaN,-76.08895710305521,-195.45170961556556,-1.009199489505312,-0.9545120901437656,0.05468739936154632,5396133988,5371594594.2,26.147240001589324,54.0461602710253,NaN,NaN,-8.14025383752711,6.381678988660241
2019-08-12T09:30:00-04:00,185.34,185.9,183.5,184.35,24642870,33264344.65,41.51040814069148,49.16327065990036,NaN,NaN,-96.01650899646995,-136.26208561709308,-0.9837570980929558,-1.1750089732546485,-0.19125187516169267,5371491118,5386005418.8,31.221611422890675,51.04355418444966,NaN,NaN,-9.820376293458995,4.067099662643207
2019-08-13T09:30:00-04:00,184.27,189.68,184.02,188.39,40473043,34278452.25,49.61493649516146,47.94995985792751,NaN,NaN,-42.121546073396274,-94.63275927373243,-0.656673158730704,-1.0120933235750726,-0.35542016484436867,5411964161,5400131402.2,35.87288382607379,48.19472109324397,NaN,NaN,-8.227150498675723,2.310778211026217
2019-08-14T09:30:00-04:00,185.31,185.95,182.42,182.76,51000548,35990226.2,41.07363572251698,46.6366382002676,NaN,NaN,-92.37270943699995,-76.7936082877325,-0.773292539620041,-1.3220358393694198,-0.5487432997493789,5360963613,5394059158.8,34.783919970843,45.23990203078417,NaN,NaN,-10.202041268079842,0.5232325711539227
2019-08-15T09:30:00-04:00,183.11,183.59,181.16,182.55,36848178,36379318.3,40.791552411613395,44.98323489247628,NaN,NaN,-100.1331730085437,-81.34657892369299,-0.8142489570201947,-1.5665544960246223,-0.7523055390044275,5324115435,5372933663,31.23180745006421,41.873631390708724,NaN,NaN,-11.746389224624815,-1.229570542528754
2019-08-16T09:30:00-04:00,184.11,185.95,184.1,185.48,34785006,36649171.35,46.329893643518766,43.90133789002929,NaN,NaN,-52.34013463026839,-76.59681442913562,-0.6033909891969393,-1.5065442755006018,-0.9031532863036624,5358900441,5365486953.6,30.06626046291278,38.372701151235674,NaN,NaN,-11.03516115509023,-2.6303692014661078
2019-08-19T09:30:00-04:00,188.03,188.83,187.5,188.43,22568634,36829923.25,51.27201667639563,43.3895222219731,NaN,NaN,-1.566375146844497,-57.70678765921053,-0.24310256287641374,-1.2070314898991796,-0.9639289270227659,5381469075,5367482545,30.811436502586275,35.1292183349785,NaN,NaN,-8.697372825226893,-3.4970840048605054
2019-08-20T09:30:00-04:00,188,188.635,186.92,186.97,19939552,36637564.55,48.873356175812376,43.31240830210066,NaN,NaN,-9.643739655450254,-51.21122637562132,-0.08892275229546653,-1.075082367392099,-0.9861596150966325,5361529523,5357395617.4,29.12228155299205,32.47553868525812,NaN,NaN,-7.656520205166747,-4.091289176332825
2019-08-21T09:30:00-04:00,188.66,189.23,187.96,188.63,20745478,36653694.85,51.64338441726387,43.62052932172882,NaN,NaN,16.148440508282313,-29.50699638656487,0.12730359453744922,-0.8270301219248211,-0.9543337164622703,5382275001,5361657895,30.847456774067965,30.757967801726238,NaN,NaN,-5.90495223705019,-4.350383899292449
2019-08-22T09:30:00-04:00,188.98,189.46,186.54,188.02,24270520,36695483.65,50.55934571487578,44.33422335367072,NaN,NaN,11.01446191223968,-7.277469402408201,0.2259283183449592,-0.6719233185310713,-0.8978516368760305,5358004481,5368435704.2,33.614579882591585,30.138470743028897,NaN,NaN,-4.846535144515439,-4.4212626486100195
2019-08-23T09:30:00-04:00,186.76,188.45,181.56,182.07,55442893,38446066.15,41.42522439498917,45.16840926827586,NaN,NaN,-66.31543855549604,-10.072530187453761,-0.09562870895387887,-1.017387523068379,-0.9217588141145002,5302561588,5357167933.6,31.36742728394823,30.082123779444952,NaN,NaN,-6.978680206513221,-4.786608014024763
2019-08-26T09:30:00-04:00,184.19,184.87,183.08,184.82,27689838,38807975.45,46.25782578436346,45.8513757276883,NaN,NaN,-53.76806527166575,-20.51286821241801,-0.10825933446905978,-1.057082982200825,-0.9488236477317652,5330251426,5346924403.8,29.44057889247557,30.265216282491046,NaN,NaN,-7.093430899558576,-5.116154140529593
2019-08-27T09:30:00-04:00,186.08,186.42,183.71,184.43,28080093,39276729.8,45.68220823447009,46.31227582145658,NaN,NaN,-31.315616229508347,-24.84724352722963,-0.12673947745017167,-1.1072479945444798,-0.9805085170943081,5302171333,5335052765.8,27.34415614376111,30.46186982574718,NaN,NaN,-7.365239958237699,-5.437452114487894
2019-08-28T09:30:00-04:00,183.84,185.4,182.91,185.09,21848789,38287795.6,46.88673328296245,46.21409288534182,NaN,NaN,-35.71158026374172,-35.219247681634435,-0.08061981310845501,-1.081283283479877,-1.000663470371422,5324020122,5323401790,25.43025471416823,30.52156392006893,NaN,NaN,-7.219563879825697,-5.692039509536151
2019-08-29T09:30:00-04:00,187.37,188.4562,186.675,187.92,25427207,36396573.55,51.8203412101309,46.695775878911874,NaN,NaN,76.56650207440785,-22.108839649200803,0.14224016928915317,-0.8228632587599805,-0.9651034280491336,5349447329,5321690359.6,25.15176755341139,30.450458745199082,NaN,NaN,-5.567209367504026,-5.67420663210299
2019-08-30T09:30:00-04:00,188.94,188.97,186.41,187.47,26332749,34952510.7,51.008971210087765,47.374244669583035,NaN,NaN,73.90263838952872,5.93477573980415,0.2545487390393195,-0.6469175042499842,-0.9014662432893037,5323114580,5325800958,27.213516103595452,30.164166222392275,NaN,NaN,-4.4694997666889,-5.502105651329549
2019-09-03T09:30:00-04:00,186.26,187.18,185.03,185.65,28026617,32601843,47.752422043383376,47.24120792302745,NaN,NaN,10.189237289789652,18.72623625209523,0.20366805677507305,-0.6468811723204624,-0.8505492290955354,5295087963,5318768265.4,25.89907920493839,29.45175160659689,NaN,NaN,-4.481906647657073,-5.356362936519195
2019-09-04T09:30:00-04:00,187.43,188.49,186.9,188.33,21676335,31590797.3,52.555755123809696,48.06135930883408,NaN,NaN,76.62754990821698,40.31486947964029,0.3398860487702343,-0.4256916681327425,-0.7655777169029768,5316764298,5321686858.4,27.464892329931786,28.928963917960374,NaN,NaN,-3.047590179522171,-5.026538256948192
2019-09-05T09:30:00-04:00,190.39,192.325,190.34,191.78,34060994,30794317.7,57.91904326780658,49.284751512847876,NaN,NaN,190.4069832439758,85.5385821811838,0.6345980249401879,0.02766981427225801,-0.6069282106679299,5350825292,5327047892.4,30.375207008862617,28.867778172160264,NaN,NaN,-0.08809862620618088,-4.321046881127905
2019-09-06T09:30:00-04:00,192.03,192.17,191.17,191.59,19487821,29847804.55,57.533310842845964,50.084995598514105,NaN,NaN,167.61465266742172,103.74821229978656,0.7794589975117665,0.36739553622177823,-0.4120634612899883,5331337471,5323425920.8,29.513627341237665,28.8283043777549,NaN,NaN,2.1609647803498353,-3.3950452152025132
2019-09-09T09:30:00-04:00,192.18,192.27,190.215,191.19,24407580,29387737.25,56.67752185264826,50.471103111103574,NaN,NaN,132.46509386579123,115.46070339503908,0.8076241584452639,0.5974667367665916,-0.2101574216786723,5306929891,5320188983,28.72933888239092,28.679583119169514,NaN,NaN,3.7638567750597547,-2.372344930879332
2019-09-10T09:30:00-04:00,190.19,190.74,188.91,190.64,23744687,29342828.1,55.45604950859934,50.941295492016934,NaN,NaN,90.27441548569941,131.47773903422103,0.749756792745415,0.7270385692530965,-0.0227182234923185,5283185204,5317808431.2,28.137148589570117,28.609216478925088,NaN,NaN,4.77069451210366,-1.3519107247389046
2019-09-11T09:30:00-04:00,190.98,192.53,190.56,192.43,25063617,28572356.8,58.58437564445928,51.43708057967375,NaN,NaN,126.01309069904754,141.35484719238713,0.7886238949525245,0.9630616451983371,0.17443775024581262,5308248821,5316105335.8,27.69728414147245,28.384204148025415,NaN,NaN,6.525087914371529,-0.22662520486598559
2019-09-12T09:30:00-04:00,193.64,194.71,192.97,193.23,28689878,27456823.3,59.93854098366879,52.10702309887325,NaN,NaN,158.80986491411795,135.03542352641557,0.8211078893048029,1.2008226118768164,0.37971472257201344,5336938699,5313328017.2,26.9571935808642,27.908676555044885,NaN,NaN,8.382387778224826,1.003233792718416
2019-09-13T09:30:00-04:00,192.95,193.4,192.29,192.54,27669795,26997904.15,58.17183598144074,53.30320964076265,NaN,NaN,119.66609623548904,125.44571224002902,0.7509284205927239,1.3183752483129183,0.5674468277201944,5309268904,5308914303.8,25.778324765470373,27.509454946582185,NaN,NaN,9.493368343456579,2.216110157109582
2019-09-16T09:30:00-04:00,191.3,192.08,191.11,191.68,20318987,26274603.2,55.95795754680054,53.996076195222436,NaN,NaN,78.97468084408862,114.74762963568851,0.6075198852529486,1.3268466842863802,0.7193267990334316,5288949917,5305318309,24.825763272898698,27.17982525946955,NaN,NaN,9.86727549340902,3.3091337765809303
2019-09-17T09:30:00-04:00,191.7,192.6,191.29,192.6,21113675,26201855.25,57.80785095552668,54.86219353244076,NaN,NaN,82.45866004209,113.18447854696663,0.5379412829158643,1.3917534026782619,0.8538121197623976,5310063592,5310693986.6,29.046708533127102,27.30143614442426,NaN,NaN,10.676063130472572,4.3615522557083075
2019-09-18T09:30:00-04:00,192.2,192.6,190.11,192.52,31173056,26763530.45,57.58136147999422,55.62609554651446,NaN,NaN,64.8100719856133,100.94387480427977,0.453241536753317,1.4203640407040439,0.9671225039507269,5278890536,5304822329.6,27.247119118994746,27.43121217334044,NaN,NaN,11.299879073082094,5.3527418010474195
2019-09-19T09:30:00-04:00,192.86,194.035,192.47,192.84,26214873,27037000.2,58.28539607588708,56.08788517978276,NaN,NaN,87.70804710740002,86.7235112429362,0.38799828762322996,1.4521203634797644,1.0641220758565344,5305105409,5298455671.6,25.40889757223404,27.449578603256345,NaN,NaN,12.010199275078994,6.303807154480501
2019-09-20T09:30:00-04:00,193.11,193.31,190.16,190.8,30131528,27330050.6,52.3233208929275,56.1817672999856,NaN,NaN,44.735564390641905,71.73740487396677,0.18687613963566907,1.2977172504011207,1.1108411107654517,5274973881,5291596667,23.56444011088898,27.188930318063026,NaN,NaN,11.102414445294656,6.989322481739666
2019-09-23T09:30:00-04:00,190.36,191.07,189.72,190.5,22917563,25703784.1,51.48919884413585,56.44867992861077,NaN,NaN,16.387396754970542,59.21994805614315,0.021747692111441896,1.138025725904754,1.116278033793312,5252056318,5284217947.2,21.73644144437742,26.891599049451525,NaN,NaN,10.114676249261608,7.435801591385658
2019-09-24T09:30:00-04:00,191.37,191.79,187.151,187.97,41096614,26374122.9,44.97724778809953,55.90735797606005,NaN,NaN,-31.055388891289077,36.51713826946733,-0.2545272528980074,0.7981189676708027,1.05264622056881,5210959704,5264397169.6,17.752577339010443,26.197862264385716,NaN,NaN,7.3627689697945335,7.4253683597297835
2019-09-25T09:30:00-04:00,187.79,190.58,186.21,190.08,36499191,26795077.8,50.589774799393474,55.38383879974482,NaN,NaN,-42.143710683734554,15.126381735597755,-0.28928980091674783,0.6910339694228753,0.9803237703396231,5247458895,5258110841.4,16.70672937832883,25.2215424336333,NaN,NaN,6.488116460558971,7.29147523127681
2019-09-26T09:30:00-04:00,189.87,190,187.98,189.38,27030029,27054139.8,48.81094807442167,54.760812887714515,NaN,NaN,-51.424446726373766,-12.700117031157003,-0.3495230325188683,0.5434199796910377,0.892943012209906,5220428866,5241175532.8,14.268060529175898,24.13257337562889,NaN,NaN,5.2465654653781275,6.999345264719856
2019-09-27T09:30:00-04:00,189.7,189.83,185.75,187.03,40804222,27822990.55,43.30577226528554,53.80568791718861,NaN,NaN,-111.00483553854139,-43.848197016993666,-0.5270657812174202,0.23411078568813082,0.761176566905551,5179624644,5222105685.4,12.12228339968955,22.94635512686451,NaN,NaN,2.4702826080999345,6.352336313774153
2019-09-30T09:30:00-04:00,187.75,189.11,187.4,188.81,26559841,27834345.15,48.08223870184575,53.27898714527764,NaN,NaN,-80.35240620216359,-63.19615760842049,-0.5040605372099579,0.13110089539310366,0.6351614326030616,5206184485,5212931318.8,11.2460248589434,21.739846288962603,NaN,NaN,1.4997453325206687,5.659109030737941
2019-10-01T09:30:00-04:00,189.54,190.5898,186.955,187.27,32665025,28066265.55,44.582633845935895,52.2788627310974,NaN,NaN,-98.79050307628187,-76.74318044541906,-0.5672874574892309,-0.07394788925847706,0.49333956823075387,5173519460,5205443270,10.57417594022698,20.51676713173078,NaN,NaN,-0.3996879320738257,4.793566607479117
2019-10-02T09:30:00-04:00,186.01,187.204,183.02,184.05,48931982,29429047.9,38.30483047156985,50.733597694518906,NaN,NaN,-216.40939121488998,-111.59631655165012,-0.787169280457819,-0.4906220323415198,0.2965472481162991,5124587478,5180868986.6,8.730766397395982,19.214879475768765,NaN,NaN,-4.18028306644289,3.511588082633116
2019-10-03T09:30:00-04:00,184.07,186.2065,181.82,186.07,39612315,29706613.95,43.664120348951826,49.69733229219827,NaN,NaN,-178.5578297727589,-137.02299316092717,-0.7575141166020797,-0.6503453976363005,0.10716871896577918,5164199793,5169623172,8.040007491512583,17.94785681334321,NaN,NaN,-5.62327826155022,2.206607176321211
2019-10-04T09:30:00-04:00,186.99,189.08,186.88,188.81,32752668,30369856.3,50.00781255491631,49.27232193563511,NaN,NaN,-54.97761222114669,-125.81754849744823,-0.5253333305820079,-0.5494979442617307,-0.024164613679722807,5196952461,5173088735.4,10.392805359416727,16.916931248094496,NaN,NaN,-4.725396821070759,1.216320890979501
2019-10-07T09:30:00-04:00,188.23,189.74,187.91,188.24,21404580,30219706.3,48.77730633712955,48.62728303432103,NaN,NaN,-38.620606655235214,-117.47118858806255,-0.38842383493840205,-0.5096944073527254,-0.12127057241432335,5175547881,5166961414.6,9.91003316110475,15.550025864378615,NaN,NaN,-4.405782685703143,0.41316323716769465
2019-10-08T09:30:00-04:00,187.01,187.8562,185.27,185.42,33201939,30692568.9,43.1237536142021,47.59459675819303,NaN,NaN,-104.03265026728815,-118.51961802626379,-0.4611100074848946,-0.6976580817704416,-0.236548074285547,5142345942,5160726711,9.430021258277819,14.27737601718455,NaN,NaN,-5.991411630389338,-0.5017760296261671
2019-10-09T09:30:00-04:00,186.96,188.08,186.43,187.23,20829012,30480838.65,47.34245144914936,46.812957856283184,NaN,NaN,-66.07142857142277,-88.45202549757035,-0.36482960858117264,-0.6925850850120128,-0.32775547643084013,5163174954,5168444206.2,14.923313518776723,13.528405727651883,NaN,NaN,-5.925232164878862,-1.2765554775194092
2019-10-10T09:30:00-04:00,187.25,189.43,187.12,188.68,26693780,30381033.75,50.50942271905291,46.68339370100643,NaN,NaN,-25.08933476469835,-57.75832649595823,-0.1898342522242027,-0.5650482917110935,-0.3752140394868908,5189868734,5173577994.4,18.466005717583897,13.164231842415806,NaN,NaN,-4.849619550969651,-1.786993202298015
2019-10-11T09:30:00-04:00,190.8,192.63,190.72,191.11,41428907,31068989.35,55.355339645489686,46.959546615388845,NaN,NaN,86.88054955604736,-29.386694140519417,0.0882985499575959,-0.26484085203989594,-0.35313940199749183,5231297641,5180447030.4,23.081279149227427,13.260291678476522,NaN,NaN,-2.3351507777891722,-1.8653014273681803
2019-10-14T09:30:00-04:00,190.82,191.7,190.645,191.09,15372774,30821678.7,55.30733927201885,47.697410292811654,NaN,NaN,76.62998104780718,-6.336576599910939,0.2599411973854416,-0.02821290526568987,-0.28815410265113145,5215924867,5188522427.6,28.225080798950472,14.008327639900811,NaN,NaN,-0.3775345715642248,-1.6527633051104724
2019-10-15T09:30:00-04:00,191.65,193.97,191.56,193.52,23735826,30952786.25,59.86148910011594,48.35967560000612,NaN,NaN,139.5853709137368,42.38702763629405,0.5116009054501524,0.351347029161559,-0.16025387628859336,5239660693,5207985377.8,38.84067493602176,15.58932375116459,NaN,NaN,2.7740792541462462,-1.0203572252166555
2019-10-16T09:30:00-04:00,192.88,193.53,192.43,193.04,20689207,30428593.8,58.59142737232559,49.05828126414212,NaN,NaN,131.23610397128314,81.84853414483523,0.613345895530154,0.6064284931240991,-0.006917402406054873,5218971486,5219144684.2,43.95859850022738,17.710076463382553,NaN,NaN,4.944927726275581,-0.16817366071776463
2019-10-17T09:30:00-04:00,194.18,194.5,192.81,193.55,19161821,30075941.2,59.57286763737663,50.22021664786291,NaN,NaN,149.03000641232705,116.6724023802403,0.6775751520188764,0.8400515376175406,0.16247638559866423,5238133307,5228797598.8,48.01131209682639,20.273578513178045,NaN,NaN,7.015837790825744,0.8581136895027366
2019-10-18T09:30:00-04:00,193.26,193.67,190.705,191.69,27719069,29955318.25,54.49952942865544,50.67859455692074,NaN,NaN,92.56527324266314,117.80934711756348,0.5621310756554988,0.8651402301680378,0.30300915451253896,5210414238,5224620918.2,46.44620296337659,22.787876949208986,NaN,NaN,7.344034940082684,1.7846738681570147
2019-10-21T09:30:00-04:00,192.65,193.52,192.14,193.39,15868946,29602887.4,58.018561950870044,51.63830370727318,NaN,NaN,111.78258256661772,124.83986742132558,0.5660326771186293,1.0105500009108255,0.4445173237921963,5226283184,5226692581.6,47.36277509289246,25.415634031542233,NaN,NaN,8.67588362278267,2.769132404532108
2019-10-22T09:30:00-04:00,194.06,194.42,191.79,191.85,22988988,28697506.1,53.948131988203194,52.75568238703271,NaN,NaN,88.58694992300103,114.64018322317843,0.43647397520061426,0.9901097927929641,0.5536358175923498,5203294196,5219419282.2,44.48419031530709,27.969450025678743,NaN,NaN,8.599961059342496,3.6021079266478777
2019-10-23T09:30:00-04:00,191.43,192.2582,191.15,192.22,15198327,27632462.9,54.76918913641396,53.54890158613714,NaN,NaN,59.20344068654204,100.23365056623021,0.3509535473317793,0.9923277517570739,0.6413742044252946,5218492523,5219323489.6,44.44587622353073,30.56986922082289,NaN,NaN,8.772352835730146,4.340714342231059
2019-10-24T09:30:00-04:00,193.62,194.21,192.74,194.09,19264220,27244172.45,58.77013448599149,54.17478172407108,NaN,NaN,94.90670928803812,89.40899114137244,0.3924451802200982,1.1319306797004174,0.7394854994803192,5237756743,5219248176.8,44.41348784235403,32.999917969604134,NaN,NaN,10.099355010635652,5.163377294860286
2019-10-25T09:30:00-04:00,193.09,195.74,193.05,195.64,21507115,26279317.1,61.78737475872479,55.10407232561359,NaN,NaN,110.35840778847525,92.96761805053487,0.4900543378298987,1.3520534217676925,0.8619990839377938,5259263858,5229018100.8,49.54954589110932,35.83131173603303,NaN,NaN,12.141699996188335,6.16028053790715
2019-10-28T09:30:00-04:00,196.57,197.83,196.55,197.57,18842303,25893440.2,65.20213968680139,56.681099902227835,NaN,NaN,150.92684408901158,100.79647035501364,0.6408538187116013,1.6630663573272955,1.0222125386156942,5278106161,5239382696.2,54.36667678572614,39.041072845136476,NaN,NaN,14.964847516257167,7.418075820528581
2019-10-29T09:30:00-04:00,197.24,197.535,196.01,196.04,18569675,25188672.7,60.58040595128639,57.62666808095191,NaN,NaN,121.60625802532734,107.4003319754789,0.5948170534868693,1.7657338554742807,1.1709168019874114,5259536486,5250631154.2,58.94792480847036,42.185687937257455,NaN,NaN,15.970915986113907,8.639910129897913
2019-10-30T09:30:00-04:00,196.42,197.32,195.29,196.99,21764311,23830289.15,62.36426420690595,58.473442472941414,NaN,NaN,116.51405477415463,118.86245479300142,0.5847325637434027,1.9018325066666648,1.3170999429232622,5281300797,5263192809,63.37046383162096,45.39314923111725,NaN,NaN,17.33986017213382,9.882760135931614
2019-10-31T09:30:00-04:00,197.56,197.65,195.94,197.08,26801803,23189763.55,62.53722660892702,58.986434398901224,NaN,NaN,119.05232749308702,123.69157843401119,0.5414949947012373,1.9939686862998087,1.4524736915985714,5308102600,5277261980.4,67.58276038246157,48.57182646206254,NaN,NaN,18.500287860385654,11.113835525139333
2019-11-01T09:30:00-04:00,197.93,198.88,197.63,198.87,22131875,22658723.9,65.89438890723228,59.742652229987904,NaN,NaN,145.7285290138503,130.76560267908621,0.5870001545163506,2.1862238847440096,1.599223730227659,5330234475,5291456103.8,71.18321826942503,51.64026485281072,NaN,NaN,20.503965651606272,12.455282686063182
2019-11-04T09:30:00-05:00,200.19,200.5251,198.8658,200.1,19015855,22539287.65,68.01543279230316,60.32507677942984,NaN,NaN,158.03077802116474,132.18638946551684,0.648666298047673,2.4100566027872503,1.7613903047395774,5349250330,5305684937.6,74.26848346960446,54.17082260520949,NaN,NaN,22.841622963109177,13.939045582784038
2019-11-05T09:30:00-05:00,200.35,200.55,199.55,200.21,15048864,21631633.9,68.20586617146506,61.0118224079398,NaN,NaN,144.34696773605353,136.73453140766208,0.6442749667589287,2.5667340131882384,1.9224590464293096,5364299194,5326637479.2,78.00320716149156,56.60258036672836,NaN,NaN,24.80928304387784,15.491936648654582
2019-11-06T09:30:00-05:00,199.98,200,198.785,199.76,19725486,21576457.6,66.46251890871179,61.50394035589232,NaN,NaN,115.9025655642326,136.61223356567768,0.5615039661308403,2.6243390040928603,2.06283503796202,5344573708,5339292061.4,79.90065873585944,58.880390840945005,NaN,NaN,26.001525499933713,16.9933064845516
2019-11-07T09:30:00-05:00,200.76,201.72,199.85,200.43,17832355,21133386.35,67.78288918429448,62.45275176700939,NaN,NaN,127.29844009644326,138.26145608634891,0.5041411022092781,2.6930114157236176,2.1888703135143395,5362406063,5350152754,81.38479429186064,61.37600450726529,NaN,NaN,27.37963440159549,18.477067615557868
2019-11-08T09:30:00-05:00,200.02,201.25,199.54,201.23,15272516,19825566.8,69.33529056236974,63.261089524973656,NaN,NaN,113.42790191406425,131.80133066639172,0.47285787899948284,2.779942662263693,2.30708478326421,5377678579,5359641574.8,82.59407795669642,63.892526140394146,NaN,NaN,28.992109514411652,19.979216458251265
2019-11-11T09:30:00-05:00,200.23,201.0363,199.94,200.96,10187222,19566289.2,68.14187966703838,64.27492864489045,NaN,NaN,103.04390025827921,120.8039551138146,0.39019814855447965,2.79483246895731,2.40463432040283,5367491357,5363289780.2,83.049990982515,66.64722618805186,NaN,NaN,30.049414684244418,21.417816204821715
2019-11-12T09:30:00-05:00,201.13,202.21,200.82,201.54,14778283,19118412.05,69.36184416398419,65.31726114685975,NaN,NaN,111.86128428808429,114.30681842422078,0.3330254520969711,2.820916135524044,2.487890683427073,5382269640,5366883869.4,83.50828587513126,69.43739830602333,NaN,NaN,31.282698035177848,22.827085037729734
2019-11-13T09:30:00-05:00,200.84,201.775,200.71,201.59,16110341,18889468.75,69.47038049328344,66.08156443309488,NaN,NaN,97.45224552976917,110.61675441732807,0.26024222780577766,2.813193468184295,2.5529512403785173,5398379981,5377645124,84.83078930133489,72.32434841023624,NaN,NaN,32.354275946848894,24.188112310461044
2019-11-14T09:30:00-05:00,200.83,201.56,200.22,201.43,17055686,18784162,68.63250970244586,66.57050264336068,NaN,NaN,82.29257737325756,101.61558187269092,0.1674951899000705,2.762320227753605,2.5948250378535347,5381324295,5381428770.4,85.27781810454749,74.87636785405326,NaN,NaN,33.072429387298904,25.457300464295024
2019-11-15T09:30:00-05:00,202.61,202.91,202,202.91,18434519,18319934.5,71.99692440396431,67.05584440887232,NaN,NaN,107.74731667839397,100.47946482555687,0.17137638661078336,2.8090455211170138,2.6376691345062304,5399758814,5385844817.4,85.80366181905627,77.12186678500541,NaN,NaN,34.61685210999329,26.76580784225192
2019-11-18T09:30:00-05:00,202.61,203.39,201.77,203.07,18408797,18446927.05,72.34229773360178,67.89597953618055,NaN,NaN,103.44876625690038,100.56043802528112,0.15098891234382172,2.8264052749360076,2.675416362592186,5418167611,5395980068.2,86.95527087059075,79.1223915037283,NaN,NaN,36.01944905059322,28.087756586300678
2019-11-19T09:30:00-05:00,203.84,203.84,202.59,203.37,16997568,18147356.05,73.01434826885347,68.65669982631967,NaN,NaN,109.51213127874952,100.09060742341414,0.12504938902143437,2.831728098868979,2.7066787098475444,5435165179,5406559176,88.04536564237013,80.88488449021038,NaN,NaN,37.40245338785571,29.418427557951397
2019-11-20T09:30:00-05:00,202.85,203.45,200.62,202.15,36706275,19222753.45,65.99173664598274,68.90345054325222,NaN,NaN,76.20212536094921,95.84058338965016,-0.0002981202675242933,2.706306059513139,2.7066041797806633,5398458904,5406574960.6,88.04697064740402,82.34661379484912,NaN,NaN,36.82282151008536,30.476198122541962
2019-11-21T09:30:00-05:00,201.94,202.07,201.07,201.7,17934353,19156260.1,63.563259805878594,68.73694132172696,NaN,NaN,58.46463254370679,91.07499442374001,-0.13224142512778592,2.541302398370931,2.6735438234987168,5380524551,5406415011.8,87.9181602909801,83.54196679638878,NaN,NaN,35.67797047248805,31.219308458248545
2019-11-22T09:30:00-05:00,202.17,202.32,200.74,201.83,17197019,18940755.3,63.975694834565765,68.44838861046,NaN,NaN,54.53154990759999,80.43184106958121,-0.22408651083177222,2.3934356849590017,2.617522195790774,5397721570,5406007563,87.56671948677258,84.49184079761507,NaN,NaN,34.806763443310004,31.73180202754304
2019-11-25T09:30:00-05:00,202.67,204.26,202.67,204.22,17794718,18888376.05,70.57094875426557,68.61732308066003,NaN,NaN,129.82535169242274,85.70715815668565,-0.1412454797266527,2.440965346132458,2.5822108258591108,5415516288,5405477298.4,87.07886463835598,85.14010204596252,NaN,NaN,35.831523916621805,32.31747658312572
2019-11-26T09:30:00-05:00,204.32,204.87,204.05,204.61,14812921,18700538.35,71.48824833894298,68.97630375424798,NaN,NaN,152.92882460359783,94.3904968216553,-0.08057063919291352,2.481497526867969,2.5620681660608824,5430329209,5404510104.4,86.13623074543223,85.58550004664629,NaN,NaN,36.949421667285,32.9791830237199
2019-11-27T09:30:00-05:00,205.13,206.05,204.89,206.04,17060233,18465334.45,74.6129162355634,69.4641628293386,NaN,NaN,187.28099288144975,116.60627032575542,0.029584194274832498,2.599048408904423,2.5694642146295905,5447389442,5414296212,87.59897666121543,86.02937021588592,NaN,NaN,38.888226676458274,33.82333211696824
2019-11-29T09:30:00-05:00,205.59,205.83,205,205.1,9854553,17617971.95,69.2411083048465,69.4574355252298,NaN,NaN,152.8496616111663,135.48327613924732,0.013662338723361422,2.586542138033792,2.5728797993104306,5437534889,5425698279.6,89.04877790407491,86.49042021212725,NaN,NaN,38.93705654619949,34.553864178286986
2019-12-02T09:30:00-05:00,205.11,205.18,201.78,203,28121020,17917429.2,59.01831877059084,68.80575260405497,NaN,NaN,56.865519429703056,135.95007004366795,-0.15450692227840568,2.3797461464624234,2.534253068740829,5409413869,5428036739.4,89.32443723730495,86.93859494461223,NaN,NaN,35.638546912622026,34.70881885462056
2019-12-03T09:30:00-05:00,200.32,201.49,199.23,201.41,31425404,18537906.65,52.67687788125107,67.61396929814548,NaN,NaN,-67.66595129864831,96.45180944545373,-0.3763870358693948,2.063769273904086,2.4401563097734806,5377988465,5420531174.8,82.17475599353564,86.84334281021256,NaN,NaN,30.652813552940355,34.1293895258091
2019-12-04T09:30:00-05:00,202.49,202.91,202.14,202.43,15336754,18552301.15,55.947002548564825,66.64801373066557,NaN,NaN,11.90675507894309,68.24739554052277,-0.4528787843631412,1.874057829319554,2.326936613682695,5393325219,5413130376.8,75.7374119782439,86.1938158585632,NaN,NaN,27.594364110717347,33.19581446651028
2019-12-05T09:30:00-05:00,203.15,203.15,201.84,202.83,15038785,18317966.1,57.19616271749286,65.83113180316893,NaN,NaN,10.812535681418145,32.953704100516454,-0.4727688476113525,1.7359755541685047,2.208744401779857,5408364004,5405325289.2,69.54947259105269,85.07036260759928,NaN,NaN,25.529397577724122,32.10061205382654
2019-12-06T09:30:00-05:00,204.25,205.145,204.1501,205,16562247,18254460.7,63.27942525343927,65.20845329241713,NaN,NaN,115.85284050287751,25.55433987885869,-0.34210460033000656,1.781113651367349,2.1232182516973555,5424926251,5402803561.6,67.62699729234298,83.77202942711976,NaN,NaN,25.695430437815958,31.18558610868217
2019-12-09T09:30:00-05:00,204.63,205.5937,203.98,204.07,14032175,18192443.65,59.384199272327756,64.28287483089757,NaN,NaN,91.82575438427712,32.546386869773514,-0.3209804959353302,1.7219926317781926,2.042973127713523,5410894076,5403099603,67.73973619487607,82.39949123599729,NaN,NaN,24.555465543442686,30.238426027933674
2019-12-10T09:30:00-05:00,204.17,204.88,203.44,203.9,21849714,18775568.25,58.67321389886897,63.258508090184385,NaN,NaN,59.02238833296688,57.88405479609655,-0.3203883874357527,1.642487643418832,1.9628760308545847,5389044362,5405310782.4,68.61879248072458,81.01187886730831,NaN,NaN,23.43285732929742,29.266201928128496
2019-12-11T09:30:00-05:00,204.37,205.19,204.04,204.98,18897759,18981542.05,61.802093423252344,62.95924785998937,NaN,NaN,85.1211983037438,72.52694344105669,-0.2521940657833599,1.6476334486253847,1.8998275144087446,5407942121,5408234162.8,69.79080943104478,79.70786735185409,NaN,NaN,23.441621440662335,28.434119001347614
2019-12-12T09:30:00-05:00,204.77,207.32,204.491,206.51,32704625,19811256.25,65.7573685577076,63.11596991369144,NaN,NaN,139.6842409769598,98.30128450016502,-0.11591009561857635,1.7549398948855242,1.8708499905041005,5440646746,5414690711.2,72.2553879654648,78.58909790003156,NaN,NaN,24.712229237150815,27.902420463605214
2019-12-13T09:30:00-05:00,206.36,207.91,205.96,207.19,32534393,20585191.6,67.37432672659449,63.35872933455063,NaN,NaN,162.8490067332375,107.70051774623703,0.00192608451252263,1.8732575961447537,1.871331511632231,5473181139,5424341688.8,75.47607897970664,77.72548072095542,NaN,NaN,26.262654821795227,27.66816822906093
2019-12-16T09:30:00-05:00,208.5,209.53,208.48,209.27,21366177,20731774.5,71.76611504865566,63.4440983555785,NaN,NaN,214.5766850834253,132.25070388606667,0.19136271937461813,2.110534910850504,1.9191721914758857,5494547316,5441072336.8,79.84421588291929,77.20872009556709,NaN,NaN,29.10685380485854,27.87369473988916
2019-12-17T09:30:00-05:00,209.5,209.71,209.04,209.39,16034647,20613067,72.00028871982356,63.480672668498535,NaN,NaN,188.93510903526763,158.2332480265268,0.290227775273304,2.2819569105675157,1.9917291352942117,5510581963,5465379857,84.23714178812267,77.07307088433069,NaN,NaN,31.421271071592503,28.380491358703924
2019-12-18T09:30:00-05:00,209.6,210.13,209.33,209.55,15490828,20537730,72.32982463598364,63.317594697099985,NaN,NaN,168.31958976761226,174.8729263193005,0.3290328692896729,2.403020221906303,2.07398735261663,5526072791,5489005991,87.16520148198342,77.04208694295697,NaN,NaN,33.38831089012137,29.095894148906417
2019-12-19T09:30:00-05:00,209.64,210.93,209.62,210.86,17892062,19597019.35,74.9312853158227,63.72403591216971,NaN,NaN,162.57337380048753,179.45075288400605,0.40079969652697134,2.574986973275344,2.1741872767483725,5543964853,5509669612.4,89.07641274461467,77.04406086013839,NaN,NaN,35.90905996409847,30.06920355107671
2019-12-20T09:30:00-05:00,211.81,212.5186,211.27,211.71,27690934,20084848.4,76.47666955038436,64.97106096786925,NaN,NaN,169.5752975644723,180.79601105025301,0.4591945349615094,2.7481804454502594,2.28898591048875,5571655787,5529364542,90.52467275356761,77.12979196844286,NaN,NaN,38.5147718802997,31.27571331239428
2019-12-23T09:30:00-05:00,212.03,212.15,211.63,211.81,23798671,20414931,76.65897101820207,66.68406762050861,NaN,NaN,144.1423523869946,166.70914451096687,0.4572370708553519,2.8605322490579397,2.4032951782025878,5595454458,5549545970.4,91.73403636974051,77.81259770960037,NaN,NaN,40.68500455894652,32.61989777618746
2019-12-24T09:30:00-05:00,211.97,212.09,211.44,211.92,7089020,19879646.1,76.87130516938265,68.17866066485273,NaN,NaN,121.6018617066356,153.24249504524045,0.4171506071022426,2.9247334370803912,2.5075828299781486,5602543478,5567938273.4,92.65421056654537,79.02094046590761,NaN,NaN,42.53780284409691,34.03674135731738
2019-12-26T09:30:00-05:00,212.26,213.81,212.23,213.79,17159310,19996965.55,80.17334890573976,69.81988824972751,NaN,NaN,132.12867946636388,146.00431298499078,0.46663534142618257,3.090877006760877,2.6242416653346945,5619702788,5586664272.8,93.45329538927164,80.7283563800661,NaN,NaN,45.26377510408155,35.64060332114084
2019-12-27T09:30:00-05:00,214.55,214.56,213.04,213.61,18142239,20051065.85,79.00412670183104,70.94308121032694,NaN,NaN,121.5829860702555,137.80623543894438,0.4377777287194924,3.17146382623406,2.7336860975145676,5601560549,5598183412,93.89335998577862,82.60452514388294,NaN,NaN,47.16723566611972,37.28726508470925
2019-12-30T09:30:00-05:00,213.51,213.63,211.16,212.21,21829913,20649833.85,70.40400479993774,71.73021017658479,NaN,NaN,84.65375281757466,120.82192648956485,0.2824740805258985,3.0867786981719405,2.804304617646042,5579730636,5599798381.8,93.95471352680681,84.47702352473513,NaN,NaN,46.320517433549014,38.57772970597207
2019-12-31T09:30:00-05:00,211.62,212.76,211.2,212.61,18201585,20153862.1,71.36317640500309,72.63663606988007,NaN,NaN,74.72829868904257,106.93911574997443,0.17028576012494145,3.0171618178022186,2.846876057677277,5597932221,5600293934.4,93.97471789027654,86.28816105398884,NaN,NaN,45.88972303338192,39.622300181316334
2020-01-02T09:30:00-05:00,214.4,216.16,213.98,216.16,31014904,20133337.1,78.13571739992504,73.80332349678527,NaN,NaN,126.31258216573725,107.88125984179479,0.2916399143725932,3.2114259506430187,2.9197860362704255,5628947125,5605574663.8,94.19515627552353,88.03132868573732,NaN,NaN,47.7549136072218,40.78410209930283
2020-01-03T09:30:00-05:00,213.29,215.47,213.28,214.18,27532657,20743132.25,68.41693353539709,73.9932924237631,NaN,NaN,98.39843646114024,101.13521124075005,0.19943599469726037,3.169081029642001,2.9696450349447407,5601414468,5601916999.8,91.69285325559211,89.41971906360357,NaN,NaN,45.89738567805993,41.51457118198241
2020-01-06T09:30:00-05:00,212.49,215.59,212.24,215.56,21726989,21077542.45,71.11375382874705,74.26039435963114,NaN,NaN,94.44530398532763,95.70767482376446,0.1921842888772458,3.209875396041298,3.017691107164052,5623141457,5606233181.4,91.96413740270128,90.5974375223889,NaN,NaN,45.315916820342366,42.057620558890974
2020-01-07T09:30:00-05:00,215.64,216.14,214.85,215.53,23120994,21405479.8,70.97187720093227,74.20366308479375,NaN,NaN,108.32741709173983,100.4424076785975,0.14813819845368448,3.2028638552311577,3.054725656777473,5600020463,5610291146.8,92.22133729815356,91.48151762347707,NaN,NaN,44.824836119189015,42.45293706750498
2020-01-08T09:30:00-05:00,215.47,218.14,215.16,217.15,26464212,22027081.65,73.98962106717384,74.34575825246161,NaN,NaN,128.51918251802473,111.20058444439391,0.18830057780861953,3.290101379038248,3.1018008012296283,5626484675,5616001637.6,92.58118806083881,92.07752092867108,NaN,NaN,45.39441865782746,42.87314872326534
2020-01-09T09:30:00-05:00,218.91,219.41,217.7125,218.99,23641291,22116660.5,76.9239715287869,74.67391160194757,NaN,NaN,164.68327300216544,118.87472261167957,0.2927485272743646,3.467736460322584,3.1749879330482194,5650125966,5620237405.8,92.84557245123001,92.48326171218869,NaN,NaN,46.87715322095165,43.445149365791956
2020-01-10T09:30:00-05:00,219.76,219.87,218.04,218.43,21914631,22267504.1,74.18105131949065,74.62032345935242,NaN,NaN,150.12272344850544,129.2195800091526,0.27818446629105065,3.5227185159120324,3.244534049620982,5628211335,5625596779.2,93.17689428936811,92.77615325109966,NaN,NaN,47.16826055392606,43.97702239266825
2020-01-13T09:30:00-05:00,219.31,220.98,218.98,220.95,22846102,21774577.95,77.98524432632675,74.72807880049116,NaN,NaN,166.12467948892842,143.55545510987275,0.38571382083558703,3.7266763256654656,3.3409625048298786,5651057437,5631179975.2,93.51388162782344,92.98966817068936,NaN,NaN,48.73407370694158,44.656601151850154
2020-01-14T09:30:00-05:00,220.75,221.21,219.74,220.08,24573340,21376525.3,73.93503325616595,74.53351181748859,NaN,NaN,147.92474095123117,151.47491988177103,0.34691109627991334,3.7746013751797705,3.427690278899857,5626484097,5636472702,93.82522109771907,93.13903850840211,NaN,NaN,48.64169594371421,45.225900407830736
2020-01-15T09:30:00-05:00,220.18,221.2,219.45,220.17,25742084,21595320.65,74.08497576690857,74.33448828874043,NaN,NaN,128.51314819773077,151.47371301771224,0.2788986391110506,3.7763135777886703,3.4974149386776197,5652226181,5641621003.2,94.12084100089938,93.24379782514168,NaN,NaN,48.61567657910348,45.71015414658398
2020-01-16T09:30:00-05:00,221.24,222.32,220.8,222.28,18804959,21733836.25,77.3715737454057,74.13436149157371,NaN,NaN,141.12901351550659,146.76286112038048,0.3244194273145711,3.9029392228208337,3.5785197955062626,5671031140,5645802038,94.35711606772435,93.30835644503118,NaN,NaN,49.658142752547576,46.2741525188645
2020-01-17T09:30:00-05:00,223.24,223.56,222.1221,223.38,24325167,22175553.2,78.87566091907496,74.12518536423399,NaN,NaN,144.01040209942153,145.5403968505637,0.3735191213218889,4.045418697158624,3.671899575836735,5695356307,5659231032.4,95.04580092891868,93.39067365525545,NaN,NaN,51.00468842037542,46.949943361937486
2020-01-21T09:30:00-05:00,222.73,223.84,222.66,223.28,21146264,22338263.3,78.36570026005944,74.69387789709982,NaN,NaN,129.54239962821765,138.22394087842153,0.3448555948449874,4.1029690693929695,3.758113474547982,5674210043,5663861553.6,95.26059122409886,93.48395063363346,NaN,NaN,51.91701401972454,47.65952488447849
2020-01-22T09:30:00-05:00,224.38,225.15,223.59,223.87,20736403,21990536.75,79.21936845161386,75.25503447185773,NaN,NaN,129.0171130649458,134.44241530116446,0.31220237009109786,4.1483664371618545,3.8361640670707566,5694946446,5677554023.4,95.83554853941459,93.6168671085719,NaN,NaN,52.925516185891794,48.41180935610897
2020-01-23T09:30:00-05:00,223.71,224.69,222.7,224.59,26496113,22125408.85,80.24387152802247,75.40561690957898,NaN,NaN,111.67987108424609,131.07575987846752,0.2863449396917854,4.194095241685488,3.907750301993703,5721442559,5691397299,96.3214318665901,93.76874393650522,NaN,NaN,54.074272483991315,49.22073266009216
2020-01-24T09:30:00-05:00,225.62,225.88,221.6701,222.7,37436483,23642782,70.42829743856038,75.54928575980493,NaN,NaN,92.77758251563797,121.40547367849379,0.09888573016312296,4.0313574646976065,3.9324717345344835,5684006076,5693992286.2,96.40608119019603,94.10540307469121,NaN,NaN,52.10176889474556,49.63230926504264
2020-01-27T09:30:00-05:00,217.72,219.2845,217.18,218.1,42264418,24898037.4,53.32990285871893,74.27901069051721,NaN,NaN,-7.168363219370741,91.16972061473533,-0.35320667177938603,3.490963394810251,3.844170066589637,5641741658,5683269356.4,87.45094638620483,93.7830322877986,NaN,NaN,43.8777639603211,48.810231364368136
2020-01-28T09:30:00-05:00,219.6,221.96,219.06,221.45,26731876,25327519.25,60.79479494367842,73.5520762435705,NaN,NaN,39.4607469433718,73.15339007776615,-0.43931114437111507,3.2950311361257434,3.7343422804968585,5668473534,5682122054.6,86.52484734311935,93.37614014815331,NaN,NaN,39.59529443906509,47.493811803610555
2020-01-29T09:30:00-05:00,222.66,222.93,220.83,221.81,29063128,25689180,61.50732839926677,72.66048391014857,NaN,NaN,54.81943534734359,58.31385453424572,-0.481321270329361,3.1326906925851574,3.6140119629145184,5697536662,5682640097.8,86.59388228064329,92.94847544956791,NaN,NaN,36.64308288453837,45.94370767231453
2020-01-30T09:30:00-05:00,220.37,222.7,219.6891,222.6,39568093,26757505.4,63.092532022793186,71.67252394543473,NaN,NaN,45.135388202758584,45.004957957948214,-0.4649530498680301,3.032820650579481,3.497773700447511,5737104755,5685772537,87.02668266687576,92.53284046497117,NaN,NaN,34.8491409175557,44.358769564491844
2020-01-31T09:30:00-05:00,223.5,223.56,218.285,219.07,52015832,27807551.8,52.65738469964342,70.13511918687422,NaN,NaN,5.66496748272415,27.582434951365457,-0.6874850476525589,2.6384173908818127,3.3259024385343716,5685088923,5685989106.4,87.05779210085898,92.09576173722053,NaN,NaN,29.468173799082624,42.23154159800481
2020-02-03T09:30:00-05:00,220.14,222.885,219.99,222.38,25468307,27704334.3,59.432769418874706,68.80994240777049,NaN,NaN,40.47137444718474,37.110382484676556,-0.6100098409263417,2.5633901373764445,3.173399978302786,5710557230,5699752220.8,88.88235262088081,91.76493823672463,NaN,NaN,27.414913021137256,40.114880372738014
2020-02-04T09:30:00-05:00,225.39,227.86,224.6523,227.47,30691211,28152545.4,67.20526252307101,68.3292444982637,NaN,NaN,178.83474713272707,64.98518252254762,-0.2335715314612714,2.881435563976197,3.1150070954374685,5741248441,5714307202.2,90.42042191370682,91.52173829500948,NaN,NaN,28.772458528620774,38.49453439500698
2020-02-05T09:30:00-05:00,230.22,230.25,226.85,228.22,38534817,28923236.55,68.17289467539997,67.90695299172738,NaN,NaN,211.98667176375508,96.41862980582991,0.03408123650397776,3.1576086410674407,3.123527404563463,5779783258,5730756521.4,91.8009561253325,91.35603223246899,NaN,NaN,30.13466751166942,37.300267697387326
2020-02-06T09:30:00-05:00,228.77,230.25,227.98,230.19,22467077,28723379.8,70.62465886149906,67.42503050001977,NaN,NaN,201.1627109766658,127.62409436061137,0.2972984060369628,3.495150412109666,3.1978520060727034,5802250335,5743785637.4,92.69851637944663,91.23756082616342,NaN,NaN,32.110094853967006,36.558814434041565
2020-02-07T09:30:00-05:00,229.16,230.44,228.54,229.2,25884933,28835561.9,67.7981331344244,66.63377851540187,NaN,NaN,167.95411106675272,160.0819230774171,0.35435926132682116,3.6408010827312296,3.2864418214044084,5776365402,5762040933.2,93.73360345046125,91.14383243484504,NaN,NaN,32.68009198642819,36.00471122723965
2020-02-10T09:30:00-05:00,228.43,231.98,228.38,231.97,21478925,28813776.6,71.2635747000147,66.12648383254154,NaN,NaN,170.518932854253,186.09143475883073,0.5183608679560741,3.934392906349501,3.416032038393427,5797844327,5779498352.6,94.53192216623852,91.09178464499787,NaN,NaN,34.36973883229142,35.77114374224705
2020-02-11T09:30:00-05:00,233.21,234.02,231.3999,232.01,30197983,29181370.65,71.31158660809609,65.56164227229027,NaN,NaN,170.74821675477787,184.47412868324088,0.5653899590249791,4.122769487174651,3.5573795281496716,5828042310,5796857126.4,95.18833558236749,91.04555514806593,NaN,NaN,35.67859779580955,35.75792289275598
2020-02-12T09:30:00-05:00,233.34,234.38,232.8,234.27,24471275,29176267.4,73.95891838804665,65.11271704800629,NaN,NaN,160.316504331362,174.14009519676227,0.6770241764011038,4.403659748651052,3.726635572249948,5852513585,5811403191.8,95.65864066306693,90.99821291924285,NaN,NaN,37.65537877330753,36.02898801854906
2020-02-13T09:30:00-05:00,232.62,234.93,232.36,233.97,22773159,29027821.15,72.99598047075114,65.29612297887705,NaN,NaN,134.4244240191155,160.7924378052522,0.6583832907765208,4.549614685720599,3.8912313949440778,5829740426,5816901210,95.82475665839401,90.95668973839986,NaN,NaN,38.92865154340934,36.443225664957666
2020-02-14T09:30:00-05:00,234.28,234.86,233.5501,234.64,23438530,29259499.7,73.81592267868491,66.75941010887463,NaN,NaN,124.12813356305625,152.0272423045129,0.6194682256724668,4.665566677034661,4.0460984513621945,5853178956,5832263920.8,96.25586246942112,91.58561231577244,NaN,NaN,40.21560668865285,36.98213723977126
2020-02-18T09:30:00-05:00,233.47,235.17,233.25,234.73,24521242,29269303.45,73.93043205607594,67.6976699026173,NaN,NaN,109.62975352890723,139.84940643944375,0.531459551257595,4.710422890434188,4.178963339176593,5877700198,5848235095,96.64383346742142,92.30839703893687,NaN,NaN,41.293424045733055,37.59803535490866
2020-02-19T09:30:00-05:00,236.07,237.47,235.85,236.98,22230464,29323513.45,76.67656174552694,68.78118657020731,NaN,NaN,124.93472354539635,130.68670779756744,0.5539283637938279,4.8713737939188775,4.3174454301250496,5899930662,5862612765.4,96.95020889004056,93.04813465389384,NaN,NaN,43.06890772147064,38.3795885501318
2020-02-20T09:30:00-05:00,236.46,236.95,231.88,234.78,42604016,30416894.1,69.02074231288202,69.20463016235651,NaN,NaN,85.98275824428691,115.81995858015243,0.35921335378745756,4.766462122359371,4.407248768571914,5857326646,5863575377.6,96.97015135677393,93.75838241745798,NaN,NaN,42.33468970621357,38.94460300100062
2020-02-21T09:30:00-05:00,233.64,234.01,229.3211,230.27,66058611,32395019,56.554518847843624,69.48299688722797,NaN,NaN,39.23963115751498,96.78300000783233,-0.10965850937640997,4.2701756318514015,4.3798341412278115,5791268035,5855880899.4,91.80269622943239,94.0973041409275,NaN,NaN,37.44497930457472,38.730371044368354
2020-02-24T09:30:00-05:00,221.84,224.25,220.26,221.39,84522551,34749322.4,40.89322205291436,68.15874350394508,NaN,NaN,-79.28382165916142,56.10060896338879,-1.0044207959161735,3.124308146332595,4.1287289422487685,5706745484,5826594205,75.34500307730917,93.13035060210098,NaN,NaN,26.142164860220724,36.932055875204405
2020-02-25T09:30:00-05:00,223.19,223.9879,214.74,215.37,97742982,37523250.6,34.01601564105164,65.78808301237227,NaN,NaN,-129.56426365850277,8.261805525906789,-1.9344102346884808,1.7107161488881673,3.645126383576648,5609002502,5772854665.8,55.63556330493271,90.6457178443314,NaN,NaN,13.826892690776827,33.63131827742904
2020-02-26T09:30:00-05:00,216.67,220.28,214.9,216.48,80400053,40206659.45,36.14829640253761,63.50061170716781,NaN,NaN,-132.18158891429863,-43.1614569660322,-2.3782989316659573,0.6722527189942014,3.0505516506601587,5689402555,5730749044.4,45.57585332861799,87.34392478742322,NaN,NaN,5.719950897167205,29.643980080248777
2020-02-27T09:30:00-05:00,211.05,216.4235,205.5,205.64,121822562,44844631.15,26.97920996290044,60.383079642982196,NaN,NaN,-195.86669589550016,-99.53134779398961,-3.2514401803112527,-1.0137485747289077,2.237691605582345,5567579993,5672799713.8,35.943255884937855,83.28997760924402,NaN,NaN,-5.815792182208346,24.578298328469188
2020-02-28T09:30:00-05:00,198.92,207.17,198.17,205.8,149247073,50328580.15,27.272442809677003,57.48838747692882,NaN,NaN,-208.1485687136658,-149.00898776822578,-3.638452113422639,-2.3103735361959536,1.3280785772266852,5716827066,5657911520,33.957514140807675,79.02025694426877,NaN,NaN,-13.699915380639851,19.109982084310754
2020-03-02T09:30:00-05:00,208.88,216.57,205.94,216.42,112933945,53374485.8,43.4927617258532,55.50475797877443,NaN,NaN,-112.46664124500577,-155.64555168539465,-3.0246542725242374,-2.4527392634286116,0.5719150090956258,5829761011,5682514625.4,39.8694922730424,75.11579766618333,NaN,NaN,-13.70253974266628,14.422478966171179
2020-03-03T09:30:00-05:00,217.11,219.61,207.62,209.48,131953546,58698747.75,37.59238307422427,53.09624344064073,NaN,NaN,-106.25676255648092,-150.98405146499027,-2.9294889289829653,-3.0899461521330807,-0.16045722315011557,5697807465,5700275618,43.781929077893544,71.44391148729234,NaN,NaN,-16.218422833804233,10.045207280460406
2020-03-04T09:30:00-05:00,213.32,218.33,211.37,218.22,73086209,60818497.65,47.2905193055506,51.191357791891,NaN,NaN,-67.8965601998726,-138.12704572210507,-2.157043245260879,-2.8567612797262143,-0.6997180344653354,5770893674,5716573841.8,47.17835475871825,67.98103392269601,NaN,NaN,-13.985850220667965,6.612199066013496
2020-03-05T09:30:00-05:00,212.69,216.36,210.1,211.59,78705458,62827029.7,41.96322904755088,48.97473269023384,NaN,NaN,-81.8102747261658,-115.3157614882382,-1.976545399557323,-3.1703997839119893,-1.1938543843546663,5692188216,5741495486.4,51.957926902436775,64.84768894012764,NaN,NaN,-14.523625419762729,3.592795568045464
2020-03-06T09:30:00-05:00,204.67,209.15,202.91,208.02,89828392,66195095.45,39.39011577331618,46.515746482707506,NaN,NaN,-109.0040002122925,-95.48684778796355,-1.9767439880571138,-3.6647843694260587,-1.6880403813689449,5602359824,5718602038,47.68903794465123,61.37863004550121,NaN,NaN,-15.935184599311663,0.8030841155658743
2020-03-09T09:30:00-04:00,193.48,201.16,192.11,193.57,116423986,70722048.1,31.082290784936987,43.455164963340444,NaN,NaN,-156.60716085635386,-104.31495171023315,-2.780019973439793,-5.163065348168686,-2.3830453747288933,5485935838,5649837003.4,37.67594345363285,57.166637901659165,NaN,NaN,-20.73166222290167,-2.273308218500917
2020-03-10T09:30:00-04:00,201.11,204.3,193.6802,204.11,100599233,74678063.5,40.877434263415466,40.89808442890391,NaN,NaN,-112.35587045858094,-105.53477329065315,-2.443400611826599,-5.437296139512142,-2.993895527685543,5586535071,5627582524.6,35.10687116949862,52.74925663590618,NaN,NaN,-20.276269436114614,-4.845159821017159
2020-03-11T09:30:00-04:00,199.35,200.75,192.73,195.22,89168783,77626603.5,36.20355947318992,38.553999940354466,NaN,NaN,-125.72366891487368,-117.10019503365336,-2.644371277065598,-6.299359624017541,-3.6549883469519426,5497366288,5572877047.4,29.73863844759481,47.94700571382195,NaN,NaN,-21.883721053210603,-7.279239997044794
2020-03-12T09:30:00-04:00,182.09,190.78,176.94,177.32,137820698,83294074.65,29.010885392171232,36.586597550663576,NaN,NaN,-182.93012196015806,-137.3241644804518,-3.7407278358813727,-8.330898141803658,-4.590170305922285,5359545590,5506348522.2,24.776765985727735,43.15943926784305,NaN,NaN,-26.430046355917774,-10.015069476883792
2020-03-13T09:30:00-04:00,187.07,194.48,178.13,192.34,134881981,88899515.75,39.8158389812759,36.50964161697512,NaN,NaN,-132.38679230941432,-142.00072289987617,-3.2314187355403305,-8.629443725347699,-5.398024989807368,5494427571,5484762071.6,23.411813310258623,39.44992571305373,NaN,NaN,-25.14011659865556,-12.175790494279758
2020-03-16T09:30:00-04:00,174.15,184.68,169.16,169.3,92054386,92330308.55,31.81610739260276,36.352505313514484,NaN,NaN,-176.34867584238208,-145.9490258970818,-4.163943559539325,-10.602954439231524,-6.4390108796922,5402373185,5468049541,22.383678429030084,37.07479107906068,NaN,NaN,-27.82269162795875,-14.411062084805328
2020-03-17T09:30:00-04:00,175.47,184.39,169.78,182.14,121257108,97167101.85,39.15320782374267,36.56714184360056,NaN,NaN,-135.67187325973745,-150.6122264573131,-3.6520292147223516,-11.004047398095139,-7.352018183372787,5523630293,5455468585.4,21.61417629548025,35.36324271955084,NaN,NaN,-26.505368869324386,-16.13882019687948
2020-03-18T09:30:00-04:00,171.605,179.22,166.8,176.6,114156320,101763394.65,37.28876080085869,37.30353833202614,NaN,NaN,-138.21122005277638,-153.10973668489365,-3.4262487258408143,-11.634829090673804,-8.20858036483299,5409473973,5437890122.4,20.551097762455626,34.26380285365925,NaN,NaN,-26.325013165904476,-17.593990621025906
2020-03-19T09:30:00-04:00,175.69,183.49,171.63,177.66,120896481,105678017.9,37.89811285518797,38.062514763848355,NaN,NaN,-109.22322364289231,-138.36835702144052,-2.962641485735748,-11.911882222002674,-8.949240736266926,5530370454,5472055095.2,27.96667533579773,33.835885796158536,NaN,NaN,-25.97067754941732,-18.79066018222468
2020-03-20T09:30:00-04:00,181.74,182.87,170.1,170.7,118983891,108324281.9,35.46159698517185,37.48886013951397,NaN,NaN,-109.66920469461513,-133.82483949848069,-2.8793373076254873,-12.548412370798786,-9.669075063173299,5411386563,5455446893.6,26.66379292408122,32.89262155694702,NaN,NaN,-26.551475420965904,-19.899348073473426
2020-03-23T09:30:00-04:00,170.92,174.21,164.93,170.46,124639782,110330143.45,35.37713505445326,37.33062813810175,NaN,NaN,-116.83317138542185,-121.92173860708863,-2.6033493707402364,-12.923261776598594,-10.319912405858357,5286746781,5432321612.8,24.92275017381195,31.54553734951262,NaN,NaN,-27.019557806705752,-20.916520892506615
2020-03-24T09:30:00-04:00,179.91,183.83,177.95,183.66,94881785,110187083.6,43.36668105554738,37.05035397738724,NaN,NaN,-56.344608643875226,-106.05628568391617,-1.3574157689307675,-12.016682117021816,-10.659266348091048,5381628566,5403921267.4,22.94153657499936,29.814336050675557,NaN,NaN,-24.72866651946851,-21.461113124929742
2020-03-25T09:30:00-04:00,184.42,189.51,179.98,182.3,88754909,110604826.4,42.77983437394005,37.10868292927218,NaN,NaN,-40.94566759350626,-86.60317519206214,-0.49494427360228066,-11.277946690093898,-10.783002416491618,5292873657,5380601204.2,21.43477333586172,27.63411079592019,NaN,NaN,-23.126416989739447,-21.699013677045414
2020-03-26T09:30:00-04:00,183.87,192.72,183.61,191.9,79887564,108508076.5,48.116998607742204,37.73203170315975,NaN,NaN,-10.83605860665151,-66.925742184814,0.7825380948858243,-9.804829797884338,-10.587367892770162,5372761221,5349079357.6,19.564292463890823,25.625200404437305,NaN,NaN,-20.04411389374285,-21.462599422287905
2020-03-27T09:30:00-04:00,186.93,190.5149,184.66,185.3,58844975,103987971.6,45.00874969037962,38.72677876783422,NaN,NaN,-20.408631829963774,-49.07362761188372,1.217543785422425,-9.06543816099213,-10.282981946414555,5313916246,5329585294.2,18.48970968943057,24.254755135565716,NaN,NaN,-18.45964313319235,-21.033605666702826
2020-03-30T09:30:00-04:00,187.1,192.49,186.3406,192.04,49356936,100809121.15,48.65632962101803,39.28241415052012,NaN,NaN,4.114291559140354,-24.884135022971282,1.9502503053506555,-7.845169064726235,-9.79541937007689,5363273182,5344890574.4,22.107114521580172,23.326201089285828,NaN,NaN,-15.994988713223055,-20.313803244777144
2020-03-31T09:30:00-04:00,191.53,195.25,189.2,190.4,62659265,97344407.1,47.82507228067229,40.112522208197426,NaN,NaN,19.95717912691618,-9.623777468813001,2.291903213470338,-6.9305403532389676,-9.222443566709305,5300613917,5328687644.6,21.042437993945896,22.705043914025193,NaN,NaN,-14.257761127131516,-19.448654370827768
2020-04-01T09:30:00-04:00,184.81,187.66,180.86,182.31,53715375,96375865.4,43.84571728032275,41.17215305735111,NaN,NaN,-24.91023204007652,-6.416690358127053,1.9536936410257137,-6.780326515427163,-8.734020156452877,5246898542,5319492621.6,20.44081048867868,22.39533280709312,NaN,NaN,-13.94594363698329,-18.662552837421416
2020-04-02T09:30:00-04:00,181.59,190.1,180.97,186.01,56465348,95263859.9,46.05644129597038,41.61791036554357,NaN,NaN,0.9146497398414297,-4.066548688828466,1.9550463349515361,-6.2902122377634555,-8.245258572714992,5303363890,5305613155.4,19.53298000904509,22.118273285577864,NaN,NaN,-13.040669408927865,-17.859426633350907
2020-04-03T09:30:00-04:00,185.5,187.0716,181.29,183.37,47487621,93146821.35,44.70410127887701,42.5384813574203,NaN,NaN,-5.570249125343264,-1.0988721479043642,1.7600992339066837,-6.045134530331637,-7.805233764238321,5255876269,5294005160,18.781685260041527,21.86098805922154,NaN,NaN,-12.672101816656106,-17.118380230965936
2020-04-06T09:30:00-04:00,190.38,197.65,189.19,196.48,64763518,90563797.95,52.20870506411859,43.47101687459001,NaN,NaN,104.67644998514845,19.013559537297255,2.4534512564474635,-4.738419693678992,-7.1918709501264555,5320639787,5285478481,18.227101894581125,21.619054173443033,NaN,NaN,-10.047606520704393,-16.108269700928574
2020-04-07T09:30:00-04:00,202.14,202.66,196,196.4,69904478,89029060.2,52.1621826137813,44.53340414694162,NaN,NaN,149.67919270297793,44.9579622525096,2.8198784042558582,-3.6670229448066323,-6.4869013490624905,5250735309,5275502759.4,17.573316663652022,21.406355523528493,NaN,NaN,-7.958549194529793,-14.944023914300177
2020-04-08T09:30:00-04:00,198.0835,201.17,196.1733,200.57,45940439,86867643,54.44107530664509,45.7150443220457,NaN,NaN,154.00988275645324,80.74198521181556,3.22698465552803,-2.4531705296524535,-5.6801551851804835,5296675748,5285458200.6,20.632876825679716,20.882512772805775,NaN,NaN,-5.537227485222012,-13.600195853003296
2020-04-09T09:30:00-04:00,202.27,203.22,199.0281,200.86,68323929,83392804.55,54.603042067585214,47.08229039936094,NaN,NaN,146.18589494187128,109.79623425222152,3.383279111968899,-1.4510562952193595,-4.8343354071882585,5364999677,5297785358,24.37603130250764,20.719101228407663,NaN,NaN,-3.503332237697638,-12.157786765102488
2020-04-13T09:30:00-04:00,199.92,203.42,198.75,203.03,42853948,78791402.9,55.86736696542413,48.54587839300172,NaN,NaN,133.2068127130995,137.55164661991006,3.4864424112844707,-0.47628239308266984,-3.9627248043671406,5407853625,5328180829.2,32.79276803060317,21.28124536103561,NaN,NaN,-1.4380205949118072,-10.62639159793239
2020-04-14T09:30:00-04:00,207.17,212.5,206.42,211.86,63959563,77386661.75,60.667656324008156,49.78166234074892,NaN,NaN,174.25338848615564,151.4670343201115,3.9679754735516206,0.9972445375723851,-2.9707309359792355,5471813188,5358415509.4,39.95196424958461,22.49627590922027,NaN,NaN,1.8043656461319506,-8.850569134494627
2020-04-15T09:30:00-04:00,208.48,211.8338,207.12,209.43,47035953,73675604,58.77306235016879,50.92403576762241,NaN,NaN,145.48307988307099,150.62781175613014,3.9337899008466497,1.9465064400790766,-1.9872834607675731,5424777235,5393223894.6,46.95741548669561,24.319321777136974,NaN,NaN,4.029459268339151,-7.0105650769469445
2020-04-16T09:30:00-04:00,211.78,214.369,209.69,213.25,64657362,71200656.1,60.84323927612377,51.83305295822108,NaN,NaN,145.40120533589504,148.90607627201848,3.9680484390340567,2.9727770880249977,-0.995271351009059,5489434597,5431775664.4,53.436688695320456,26.738778650810524,NaN,NaN,6.518212387769109,-5.077882581987509
2020-04-17T09:30:00-04:00,215.96,216.51,212.0801,215.29,62863223,68298993.2,61.94229686461988,53.04259204209539,NaN,NaN,138.65103418103723,147.39910411985167,3.9207711041230424,3.905692529144744,-0.015078574978298231,5552297820,5469235293,58.713951958845,29.611938812911553,NaN,NaN,8.925836879513009,-3.077351230344578
2020-04-20T09:30:00-04:00,213.27,215.88,212.57,212.74,38249128,64262255.05,59.68707794474632,53.83050263664741,NaN,NaN,118.30483355557274,144.41870828834632,3.523007712224598,4.38868106530245,0.8656733530778515,5514048692,5490474306.4,61.38612077725663,32.41758211688845,NaN,NaN,10.405185680496212,-1.1512745287958936
2020-04-21T09:30:00-04:00,210.63,211.16,203.63,204.89,72932771,61676904.5,53.25863766164528,54.21861444957405,NaN,NaN,65.3729264162708,122.64261587436935,2.580154598684886,4.090866601433959,1.510712002749073,5441115921,5484334853,60.173716484111665,35.21267343761457,NaN,NaN,9.968655296296596,0.4372868747887475
2020-04-22T09:30:00-04:00,209.14,212.35,208.33,210.97,40188772,58942253.85,57.11151031403126,55.166171094838944,NaN,NaN,84.62027323191616,110.4700545441384,2.2281750887038703,4.295930863628911,2.0677557749250406,5481304693,5495640344.6,61.67480425021419,38.15795870629568,NaN,NaN,10.673717705446903,1.899634136311341
2020-04-23T09:30:00-04:00,211.8,214.435,210.095,210.52,43278542,56668435.5,56.738726975264484,55.92919150050282,NaN,NaN,84.16630940006591,98.22307535697259,1.843187247371275,4.3717398341391345,2.5285525867678595,5438026151,5485358655.4,59.479165560775265,41.0112576742764,NaN,NaN,11.152138554697286,3.221420481795047
2020-04-24T09:30:00-04:00,210.94,214.3,209.5,213.84,34303365,54389225.55,58.87169298420431,56.94116233659763,NaN,NaN,82.05249983370001,86.90336848750512,1.6940837182474744,4.646157234577203,2.9520735163297283,5472329516,5469364994.6,56.13160350326013,43.67910897736345,NaN,NaN,12.143030984048451,4.495936267831247
2020-04-27T09:30:00-04:00,216.18,216.63,214.5,215.56,36451698,53269561.7,59.97276389476638,57.49573796735818,NaN,NaN,93.852458749143,82.01289352621917,1.5946747379761104,4.945416938799866,3.3507422008237557,5508781214,5468311499,55.90839521112857,46.3706299285454,NaN,NaN,13.276959866560107,5.750368210506799
2020-04-28T09:30:00-04:00,217.27,217.32,211.21,211.5,46862816,53144855.7,56.15140890433698,57.78068270239787,NaN,NaN,71.15558789468245,83.16942582190151,1.1591238380299762,4.799646998361226,3.6405231603312496,5461918398,5472471994.4,56.64167941765143,49.16122726811678,NaN,NaN,13.243046970138902,6.820750890454242
2020-04-29T09:30:00-04:00,216.21,219.97,215.14,219,48716406,52447712.75,61.08436605106274,58.25520346985627,NaN,NaN,97.0013531787803,85.64564181127433,1.2708083089104258,5.229033546469282,3.958225237558856,5510634804,5478338016.6,57.709606237621195,51.809565083255464,NaN,NaN,14.612668915972751,7.933882036956886
2020-04-30T09:30:00-04:00,220.01,220.04,217.35,218.91,43359476,51929917.8,60.99568787295699,58.711821027382825,NaN,NaN,99.16391603113884,88.64516313748892,1.232362126430525,5.498677895597012,4.2663157691664875,5467275328,5484187852,58.79943151643231,54.26837938425008,NaN,NaN,15.712236779266508,9.045075571572546
2020-05-01T09:30:00-04:00,214.54,216.67,211.68,212.74,48794968,51546398.8,55.09102776234955,58.65636822716322,NaN,NaN,53.71693062645116,82.97804929603915,0.7110121727746179,5.155080985134759,4.4440688123601415,5418480360,5473418020.8,55.94120340281759,55.92183905369397,NaN,NaN,15.024251689244187,9.899243588382781
2020-05-04T09:30:00-04:00,211.61,215.45,211.12,215.22,32841020,50814068.75,56.89717322028098,58.38704800546842,NaN,NaN,53.05220224079515,74.81799799436958,0.46471976826490113,5.0249685226912675,4.560248754426366,5451321380,5461926054,52.98169383981487,56.8525340244247,NaN,NaN,14.939720962096104,10.619311784627541
2020-05-05T09:30:00-04:00,217.4,220.14,216.85,217.66,37783075,49465046.6,58.65884517315697,58.37888963568186,NaN,NaN,103.91644200707825,81.37016881684875,0.40012726472537175,5.060407835333081,4.660280570607709,5489104455,5467363265.4,54.2158486799541,57.37099353822888,NaN,NaN,15.350077791564798,11.295135499904292
2020-05-06T09:30:00-04:00,219.37,221.04,218.11,219,36455218,47792583.6,59.63457256682076,58.292556299303065,NaN,NaN,117.47439044004284,85.46477626910124,0.38169538359834565,5.137399800105641,4.755704416507295,5525559673,5470348239.2,54.91549565183745,57.47662260655152,NaN,NaN,15.95768813088224,11.961214447186856
2020-05-07T09:30:00-04:00,221.75,222.73,220.42,221.82,38624836,47426803.45,61.68410081813671,58.274113724554276,NaN,NaN,148.5252351958929,95.33704010205204,0.48674249744739573,5.3641325383165395,4.877390040869144,5564184509,5489730075.4,59.26799448347634,57.51619707259662,NaN,NaN,17.0363066011853,12.686227612043776
2020-05-08T09:30:00-04:00,223.55,225,222.48,224.86,31964416,45608827.8,63.81694321881544,58.5691041012735,NaN,NaN,176.03081158228085,119.79981629321799,0.6766076113020407,5.723149554996695,5.046541943694654,5596148925,5525263788.4,65.78891071017162,57.83068206780484,NaN,NaN,18.555811301571048,13.52473956769053
2020-05-11T09:30:00-04:00,223.5,227.93,223.25,226.87,35714128,45251836.8,65.1964090783191,59.42180205960733,NaN,NaN,180.1464412019275,145.21866408544446,0.842407642014992,6.099551496213394,5.257143854198402,5631863053,5561372123,70.88903720293246,58.596062119149174,NaN,NaN,20.232496191098818,14.482990513891714
2020-05-12T09:30:00-04:00,227.48,228.095,222.09,222.12,41054123,44106564.8,59.430142575146604,59.587418649686995,NaN,NaN,127.05730797458585,149.846837278946,0.5511052084262031,5.946025364731156,5.394920156304953,5590808930,5581713018,73.30347521095264,59.42668147348763,NaN,NaN,20.1387989058645,15.290963141316398
2020-05-13T09:30:00-04:00,222.65,224.61,216.71,219.34,65521208,45030827.55,56.29213064013806,59.55551891146367,NaN,NaN,59.16250798484044,138.1844607879055,0.1130350781562548,5.536214004000271,5.423178925844017,5525287722,5581658627.8,73.28597208476243,60.412881939486724,NaN,NaN,19.180282101056058,15.84658013556492
2020-05-14T09:30:00-04:00,218.12,221.87,215.99,221.83,51549345,44375426.7,58.41035643222128,59.52256630060775,NaN,NaN,48.543759034234,118.18816555557373,-0.058000382414027385,5.350678447826482,5.408678830240509,5576837067,5584189139.4,73.60179081674823,61.66075246187874,NaN,NaN,18.933714725611324,16.287599362714406
2020-05-15T09:30:00-04:00,218.77,223.33,218.33,223.27,55747208,44019625.95,59.62887266958023,59.49800264166588,NaN,NaN,69.08978496809928,96.7999602327374,-0.11957407627673255,5.259211234894593,5.378785311171326,5632584275,5591476209.4,74.53539905869792,62.991252736705114,NaN,NaN,19.05170047548463,16.68247095025301
2020-05-18T09:30:00-04:00,226.28,228.68,225.47,227.43,42597551,44237047.1,63.001339204822514,59.98728337741484,NaN,NaN,138.41207018376207,88.45308602910431,0.06454511847525879,5.459466709265399,5.39492159079014,5675181826,5600139964,75.63854098364958,64.34817141999069,NaN,NaN,20.093867946794127,17.16981337833031
2020-05-19T09:30:00-04:00,227.66,229.85,226.71,226.86,36237303,42402273.7,62.234203640555045,60.06941463380715,NaN,NaN,138.28999656417926,90.699623747023,0.09100336227857575,5.508675793638361,5.417672431359785,5638944523,5609767082.6,76.83920853797179,65.71457158430145,NaN,NaN,20.757434379408306,17.682330664198595
2020-05-20T09:30:00-04:00,229.48,231.76,229.48,231.39,37417000,42263685.1,65.79851272536564,60.41247355183634,NaN,NaN,164.97520126397004,111.86216240284891,0.3425184619664874,5.845820508817894,5.503302046851407,5676361523,5639981842.8,80.14644518997345,67.23935827526869,NaN,NaN,22.355048938639637,18.3498618462616
2020-05-21T09:30:00-04:00,231.49,232.135,228.34,228.87,43642908,42281903.4,62.27729044064605,60.92577802885752,NaN,NaN,130.63459541453582,128.28032967890925,0.27121480293863787,5.842320550524704,5.571105747586066,5632718615,5651158152.4,81.2149772492632,69.04462783572907,NaN,NaN,22.746283030070686,18.977922015377185
2020-05-22T09:30:00-04:00,228.46,229.87,227.5,229.66,28762389,42004854.6,62.94673570335163,61.35788963479114,NaN,NaN,107.42029494040219,135.94643167336986,0.21193076945583655,5.836019209405862,5.624088439950025,5661481004,5656937498.2,81.76161619316314,71.10033657525396,NaN,NaN,23.254734996416275,19.58889529838277
2020-05-26T09:30:00-04:00,233.44,233.57,228.79,229.04,33055346,41835037,62.01655123073668,61.59772578176112,NaN,NaN,112.64124417173413,130.79226647096428,0.07282223232749896,5.715116230359399,5.6422939980319,5628425658,5647586264.6,77.81584593385344,72.78605066481819,NaN,NaN,23.43860155356677,20.138853334837627
2020-05-27T09:30:00-04:00,228.51,230.41,223.94,230.29,55665565,42275174.45,63.19735547640646,61.85221027530296,NaN,NaN,73.25615050651577,117.78549725943158,0.010146596895108217,5.6549772441507855,5.644830647255677,5684091223,5656615604.6,78.87591001723668,74.49750883377529,NaN,NaN,23.901804178799242,20.67641774111786
2020-05-28T09:30:00-04:00,229.05,233.47,229.05,229.99,43008478,41989778.05,62.69361971716498,61.92431876809069,NaN,NaN,100.54994196114527,104.90044539886662,-0.10027732119381483,5.519483995763409,5.619761316957224,5641082745,5649559849,75.8267251678477,75.68027531123037,NaN,NaN,24.168490860625973,21.17528532961902
2020-05-29T09:30:00-04:00,230.43,233.6,228.76,233.36,50878596,42365734.05,65.97457812166161,62.078435546865414,NaN,NaN,104.40361621464285,99.65424955888803,-0.0004009550509520565,5.619260123143533,5.619661078194485,5691961341,5661408394.2,77.40627520708726,76.51008706101007,NaN,NaN,25.271806754404974,21.760502676017012
2020-06-01T09:30:00-04:00,232.4,234.45,232,234.06,26140125,41232991.9,66.63104532833447,62.180909564723656,NaN,NaN,117.42465607156207,101.65512178512002,0.05565962236824795,5.689235606154796,5.633575983786548,5718101466,5672732486.6,78.83004843226868,77.07730214881981,NaN,NaN,26.38398177278336,22.420999689840777
2020-06-02T09:30:00-04:00,234.42,235.69,232.01,235.63,33383415,41260111.65,68.11683468891661,62.80138757285008,NaN,NaN,123.90521150382247,103.90791525153767,0.13671303214753827,5.804467273970971,5.667754241823433,5751484881,5697344331.2,81.5511662585304,77.6664229379325,NaN,NaN,27.744168985456913,23.18145244635737
2020-06-03T09:30:00-04:00,236.23,237.47,235.35,236.69,37228701,41232392.95,69.11667265327645,63.71742628807425,NaN,NaN,144.20764552334415,118.09821425490335,0.19632390618199747,5.91315912455093,5.716835218368932,5788713582,5718268803,83.49371468239696,78.3955474091921,NaN,NaN,29.181305120738095,24.038574256983186
2020-06-04T09:30:00-04:00,236.32,237.79,233.68,235.03,38716097,41345436.9,65.64486346888009,64.23417679069274,NaN,NaN,118.91593145123902,121.77141215292212,0.06533860622490373,5.798508476150062,5.733169869925158,5749997485,5740051751,85.23648279625775,79.22659683629993,NaN,NaN,29.55664508961735,24.826870090216637
2020-06-05T09:30:00-04:00,236.06,240.297,235.63,239.69,47365569,41782473.55,70.17413705879751,64.98740996135112,NaN,NaN,150.70310756509505,131.03131042301254,0.22493649816546402,6.0143404926319874,5.789403994466523,5797363054,5761132093.6,86.69996891362078,80.09549468308013,NaN,NaN,31.174252062964158,25.733638943466282
2020-06-08T09:30:00-04:00,239.54,241.68,237.91,241.55,32937305,41831118,71.77370420467818,65.61400746134082,NaN,NaN,157.74520333661798,139.09541987602375,0.37909778556826446,6.2632762264268536,5.884178440858589,5830300359,5783571872.2,88.05713467248053,80.98253708942521,NaN,NaN,33.02054387531857,26.774625362302324
2020-06-09T09:30:00-04:00,240.66,244.18,240.47,243.3,35046254,41797724.3,73.22846795420344,66.39931205517283,NaN,NaN,164.95430134370366,147.30523784399998,0.5138861415893654,6.526536117845296,6.012649976255931,5865346613,5806344218.6,89.25537863830532,81.86940638230617,NaN,NaN,35.02044289972759,27.952599296220217
2020-06-10T09:30:00-04:00,245,247.815,244.51,246.22,58084410,42649238.65,75.49768093481333,67.0921097844191,NaN,NaN,179.1254977806844,154.28880829546802,0.7029615073881912,6.89135186049117,6.188390353102979,5923431023,5833287706.8,90.47327682445191,82.60703721334035,NaN,NaN,37.449712617557104,29.309329770696916
2020-06-11T09:30:00-04:00,242.29,243.59,233.96,234.02,72919442,43019150.35,54.65360973499217,66.54756116258667,NaN,NaN,59.361082487332155,142.37783850268664,-0.05037399229878847,6.1254228627294935,6.175796855028282,5850511581,5853390526,91.26851263327549,83.32514688362694,NaN,NaN,32.52246859016255,29.76834960204915
2020-06-12T09:30:00-04:00,239.09,240.4,231.74,235.88,72034787,44043422.45,56.620028438188335,66.09565350078931,NaN,NaN,36.85395027318241,119.60800704430412,-0.45751210742395276,5.603906720748341,6.061418828172294,5922546368,5878427188.8,92.14764899537657,84.06700636949934,NaN,NaN,29.304580099536953,29.702096815975978
2020-06-15T09:30:00-04:00,232.44,239.45,231.47,238.75,45307371,43521430.6,59.53582738920342,65.91845894067978,NaN,NaN,37.60874919817317,95.58071621661516,-0.5608189530110854,5.360395136908437,5.9212140899195225,5967853739,5905937864.8,92.9836189788301,85.1504187298548,NaN,NaN,27.640787476645734,29.407624053214516
2020-06-16T09:30:00-04:00,243.78,244.39,239.1,242.85,48890095,43836057.8,63.328011510466936,65.92779151454125,NaN,NaN,113.08354991802318,85.20656593147905,-0.3885007831578431,5.435588110972219,5.824088894130062,6016743834,5936217309,93.76980278499575,86.21426821326615,NaN,NaN,27.513105672235653,29.136978570217536
2020-06-17T09:30:00-04:00,244.4,245.5,242.73,243.62,34749268,43761656.05,64.01017741397013,66.02183135002733,NaN,NaN,128.1316617107795,75.00779871749808,-0.2640867452188145,5.493980462606544,5.758067207825358,6051493102,5961829724.8,94.34682277316874,87.53713232793196,NaN,NaN,27.629078242227024,28.921564237647463
2020-06-18T09:30:00-04:00,243.29,244.53,242.49,244.28,30578648,43419738.45,64.61772348234916,65.92491316150502,NaN,NaN,111.78948933848379,85.49348008772841,-0.18263811446787148,5.529769564740519,5.712407679208391,6082071750,6008141758.6,95.21059396159455,88.80886938182532,NaN,NaN,27.9054163027593,28.776400246949155
2020-06-19T09:30:00-04:00,246.74,247,242.45,244.24,49422112,43708698.65,64.5466064440121,65.77602466976771,NaN,NaN,109.6105077061997,100.04479157433188,-0.17664513584125618,5.491601259406821,5.668246395248077,6032649638,6030162412.6,95.55812491893349,90.00373198801567,NaN,NaN,28.108155684765094,28.680936738065718
2020-06-22T09:30:00-04:00,243.77,246.87,243.38,246.74,24068676,43474013,66.99177540939229,65.69566329265884,NaN,NaN,111.1417572427934,114.75139318325591,-0.055760983896676386,5.598545165377232,5.654306149273908,6056718314,6047935327.6,95.82165447143119,91.02305257465143,NaN,NaN,28.986939547423145,28.72465142511678
2020-06-23T09:30:00-04:00,248.39,251.15,247.82,248.84,32767370,43459614.2,68.93021924134555,65.68234519180662,NaN,NaN,142.55731234703256,120.6461456690578,0.10539780770966356,5.786053408910988,5.680655601201324,6089485684,6062483697.6,96.02932173471932,91.91845307838875,NaN,NaN,30.300406897334454,28.949759349719304
2020-06-24T09:30:00-04:00,247.99,249.325,242.16,243.71,46032376,42977954.75,59.70596008685637,65.25813780737636,NaN,NaN,76.81111954883035,110.38203723666797,-0.17829017927695112,5.457792877105135,5.636083056382086,6043453308,6060875738.8,95.46457827587567,92.64903132693289,NaN,NaN,28.662347338667317,28.908700490997592
2020-06-25T09:30:00-04:00,243.91,246.34,241.14,246.03,36940811,42674571.4,62.1714159113123,64.68651486827028,NaN,NaN,62.54830977893536,100.53380132475829,-0.2500801610968626,5.323482855011008,5.573563016107871,6080394119,6060540212.6,95.33858358414899,93.26607523197062,NaN,NaN,28.030531155055392,28.783247728720134
2020-06-26T09:30:00-04:00,245.75,245.96,239.68,240.22,52824554,42771869.3,53.36523383508084,63.37162412758475,NaN,NaN,17.472342983333952,82.10616838018514,-0.7035608525149444,4.69411195046419,5.397672802979135,6027569565,6059524198,94.93000866421983,93.75699480280913,NaN,NaN,24.56531895408017,28.18068647520014
2020-06-29T09:30:00-04:00,239.98,242.85,237.35,242.84,34377800,43183753.05,56.36664408492178,62.16720813692177,NaN,NaN,-5.209661719566277,58.8358845877132,-0.8329192154643277,4.356523783648726,5.189442999113053,6061947365,6060570008.2,94.95397985436021,94.16403774681305,NaN,NaN,22.656854369334038,27.391567602933556
2020-06-30T09:30:00-04:00,242.77,248.16,242.58,247.6,38909219,43460043.25,61.24659815347777,61.149273652540664,NaN,NaN,84.85917912932955,47.29625794417259,-0.6138746111380655,4.422099735190471,5.035974346328537,6100856584,6062844188.2,95.00923920540552,94.48803505973831,NaN,NaN,22.61744516703608,26.70955011209106
2020-07-01T09:30:00-04:00,247.66,251.52,247.0802,250.49,34689213,43333068.85,63.887375258794386,61.80882833281225,NaN,NaN,142.32635413053245,60.39930486051302,-0.3058803436495454,4.653623916766605,4.959504260416151,6135545797,6081262686,95.44436952331246,94.78631055188382,NaN,NaN,23.45081538742241,26.244016579995538
2020-07-02T09:30:00-04:00,252.97,254.27,251.71,252.19,31956497,42995088.85,65.3817607799844,62.43466635722625,NaN,NaN,182.0940232921761,84.30844756316117,-0.033525575737039404,4.917597290744851,4.9511228664818905,6167502294,6098684321,95.81596253770101,95.04833294776412,NaN,NaN,24.600417745906235,26.00921674655421
2020-07-06T09:30:00-04:00,255.46,258.928,255.43,258.39,34589049,42356262.85,70.22161411392668,63.197936837563624,NaN,NaN,232.8679971954956,127.38757840559349,0.4894696560622993,5.562959936559764,5.073490280497465,6202091343,6133588676.6,96.4421226777383,95.29536892625757,NaN,NaN,27.260317100407278,26.187945368533217
2020-07-07T09:30:00-04:00,258.1,260.88,256.3,256.61,36578191,42538307.15,67.31201719484156,63.48250867216181,NaN,NaN,195.32901556582078,167.4953138626709,0.6317646430330015,5.863196084288717,5.231431441255715,6165513152,6154301834,96.75269601141447,95.50843272814463,NaN,NaN,28.46378452302696,26.51306524774661
2020-07-08T09:30:00-04:00,258,260.02,256.5,259.99,30426273,42307308.1,69.86536153498592,63.90073610937723,NaN,NaN,170.48903356098242,184.6212847490015,0.8558439794709845,6.301236415594445,5.445392436123461,6195939425,6173318402.2,97.01069278129842,95.69870915729675,NaN,NaN,30.29995460250175,27.05404944128306
2020-07-09T09:30:00-04:00,261.89,262.87,257.63,262.18,40312906,41418732.9,71.42294332211006,64.38682324078871,NaN,NaN,158.12775788835117,187.78156550056522,1.0415438911476214,6.747322300057988,5.7057784089103665,6236252331,6193459709,97.25907927680129,95.84502953695437,NaN,NaN,32.30138274994245,27.80366848537726
2020-07-10T09:30:00-04:00,262,264.23,259.26,263.97,32885298,39417025.7,72.66652228341829,64.96681722931773,NaN,NaN,147.90015929762876,180.94279270165575,1.1655526719545346,7.162719248853534,5.997166576899,6269137629,6213786776,97.48610560060405,95.98274244278798,NaN,NaN,34.33131386363758,28.73618925370016
2020-07-13T09:30:00-04:00,266.87,269.79,257.69,258.54,64108090,39020690.85,63.62183523660872,64.72610721697605,NaN,NaN,125.19361012971281,159.4079152884992,0.7809738388134679,6.973383875415834,6.192410036602366,6205029539,6214374415.2,97.49257150119752,96.10209365919987,NaN,NaN,33.24028819575741,29.379631959708338
2020-07-14T09:30:00-04:00,256.07,260.79,252.76,260.37,72230512,40366847.9,65.19417724038725,64.45924707405045,NaN,NaN,75.09065049411019,135.3602422741571,0.5593186421116698,6.8915583392419535,6.332239697130284,6277260051,6236723795,97.73154590594548,96.22368110000171,NaN,NaN,32.83475023270089,29.87322028442156
2020-07-15T09:30:00-04:00,261.68,262.69,257.49,260.9,54523869,40648536.6,65.65714641133764,64.88433181151339,NaN,NaN,87.44941145417461,118.75231785279554,0.36716259276673213,6.791192938088699,6.424030345321967,6331783920,6263892694,97.98318604442517,96.4035816548981,NaN,NaN,32.64397304505104,30.26904210736863
2020-07-16T09:30:00-04:00,257.97,259.78,255.62,259.12,47594111,41290778.75,62.64341589588356,64.91804609612562,NaN,NaN,59.64590075669692,99.0559464264647,0.05531353388407734,6.493172262677064,6.437858728792986,6284189809,6273480189.6,98.06476920182051,96.5983091990175,NaN,NaN,31.606856506153395,30.46015845005217
2020-07-17T09:30:00-04:00,259.71,260.31,257.17,259.42,35137871,41518739.9,62.95207016857846,65.60282011994688,NaN,NaN,61.177964915618794,81.7115075500627,-0.1825944715569312,6.209615639346822,6.392210110903753,6319327680,6283518199.8,98.14918520245922,96.82825038032031,NaN,NaN,30.84062707007241,30.51451111005506
2020-07-20T09:30:00-04:00,260.12,267.43,258.79,266.78,40610128,41078140.7,69.59037816358497,66.54737255413711,NaN,NaN,103.50158631767535,77.37310278765517,0.08928274988105134,6.503813548255067,6.414530798374016,6359937808,6314499853.6,98.38355167277794,97.07321979592157,NaN,NaN,32.15969384153757,30.74953721455256
2020-07-21T09:30:00-04:00,268.41,268.41,263.125,264,43442967,42046855.25,64.86277877186107,66.80567116973592,NaN,NaN,102.68457199935604,82.89188708870435,0.01911661758404115,6.438426570354068,6.419309952770027,6316494841,6322346811.6,98.43751873169252,97.31809690494208,NaN,NaN,31.804665022929647,30.90026975860643
2020-07-22T09:30:00-04:00,264.46,265.89,262.55,264.93,29865519,41901762.7,65.70220117580759,66.93530159237973,NaN,NaN,88.31620194671365,83.06524518721216,-0.025037475628941763,6.388013108233849,6.413050583862791,6346360360,6325262099.6,98.45811477477716,97.53336442290386,NaN,NaN,31.764666651293517,31.0237550289903
2020-07-23T09:30:00-04:00,264.55,265.24,256.55,258.01,51363538,42168320.8,55.145442406143175,66.2041359942482,NaN,NaN,39.84569420093737,79.10520387606024,-0.5514846916507112,5.723694719299402,6.275179410950114,6294996822,6327423502.2,98.47417357121836,97.72323663958366,NaN,NaN,28.286511325333375,30.632720214182168
2020-07-24T09:30:00-04:00,254.12,256.93,251.32,255.56,54054536,43024007.05,51.962109040841725,64.899885631885,NaN,NaN,-26.40898790871696,61.5878133111931,-1.0661047580708196,4.9425484633615895,6.008653221432409,6240942286,6311746423.4,91.06568113886243,97.33920510109253,NaN,NaN,24.400120576169655,29.742348837323238
2020-07-27T09:30:00-04:00,257.36,260.52,256.445,260.12,36445741,42205066.4,56.94395270898783,64.15930959718116,NaN,NaN,21.44454877890791,45.17640580343961,-1.096542870243205,4.637974633628403,5.734517503871608,6277388027,6295236467.2,83.90642079359992,96.42161401410577,NaN,NaN,22.65918127872722,28.730467757523808
2020-07-28T09:30:00-04:00,259.33,259.85,256.51,256.81,31302390,42051295.9,52.6737523281689,62.93133751097995,NaN,NaN,-14.447350934043236,21.750021216759755,-1.3216552687555296,4.082448417927196,5.404103686682726,6246085637,6281154626.4,78.25541191477332,95.08195109506825,NaN,NaN,19.817754030867835,27.457222939430096
2020-07-29T09:30:00-04:00,258.33,260.66,257.91,259.77,27556884,41483679.15,55.86138142444236,61.81979737543226,NaN,NaN,8.135248788425093,5.71383058510204,-1.253835902729925,3.8368088082703196,5.090644711000245,6273642521,6266611058.6,72.80197646492012,93.33501517993389,NaN,NaN,18.475185124805808,26.174074680198053
2020-07-30T09:30:00-04:00,257.78,261.71,256.55,261.13,41774456,41837941.3,57.28495037201783,60.72111366747508,NaN,NaN,5.106667697538705,-1.2339747155776932,-1.1052183014174997,3.7091218342283696,4.814340135645869,6315416977,6270695089.6,73.3633325532487,91.61195996226566,NaN,NaN,17.8257329777123,24.981454436985803
2020-07-31T09:30:00-04:00,265.83,265.95,260.85,265.79,53756159,42927924.4,61.82789619125027,60.59297516423519,NaN,NaN,119.35862673098865,27.919548212363424,-0.7006314051190241,3.9385508792470887,4.639182284366113,6369173136,6296341259.6,76.62586480650296,90.12148091264463,NaN,NaN,18.70360484041118,24.084618780332285
2020-08-03T09:30:00-04:00,268.05,270.15,267.87,269.38,32081566,42802550.25,64.92298087955183,60.573603995604074,NaN,NaN,210.3085262932917,65.69234371524018,-0.22350504691423634,4.359800975723317,4.5833060226375535,6401254702,6321114594.6,79.26750215480456,88.80262064470598,NaN,NaN,20.440459362341738,23.564024577762208
2020-08-04T09:30:00-04:00,268.74,270.48,268.09,270.38,24911286,42219205,65.75589925128443,60.58065776988599,NaN,NaN,180.80679220322082,104.74317234269299,0.1092975525040778,4.719927963267651,4.610630410763573,6426165988,6357130664.8,82.38445517469502,87.68842558258241,NaN,NaN,22.095282404480937,23.354204267293454
2020-08-05T09:30:00-04:00,270.83,271.52,269.96,271.05,21685921,41782187.4,66.33272836375306,60.844180089019524,NaN,NaN,170.91920576518217,137.29996373804443,0.3128858134485686,5.001737677574283,4.688851864125715,6447851909,6391972542.4,84.76990910118826,86.73879271825153,NaN,NaN,23.611069554079553,23.390899308262895
2020-08-06T09:30:00-04:00,270.78,274.98,270.19,274.64,28048224,41168953.3,69.31527954682858,61.29869504460881,NaN,NaN,176.27129821206867,171.53288984095042,0.610447045571421,5.4519106710899905,4.8414636255185695,6475900133,6424069173.6,86.57365493988132,85.9119691280674,NaN,NaN,25.836037424860574,23.740204753491135
2020-08-07T09:30:00-04:00,274.04,274.8818,269.245,271.47,44969356,41773156.2,63.92970342239811,60.89436113452404,NaN,NaN,129.1975596587371,173.5006764265001,0.5185113242804409,5.48960278086912,4.971091456588679,6430930777,6436420701.8,87.20181063846763,85.11327333990236,NaN,NaN,26.145176161565526,24.08377209750176
2020-08-10T09:30:00-04:00,271.74,271.98,266.67,270.31,35088373,40322170.35,62.03041344652824,60.692049325571695,NaN,NaN,85.92996344602686,148.62496385704713,0.3143575929076192,5.364038447723203,5.049680854815584,6395842404,6435338242.2,86.8184590577648,84.28334050605038,NaN,NaN,25.84880742691113,24.335920001703098
2020-08-11T09:30:00-04:00,269.1,270.44,264.63,265.19,43104323,38865860.9,54.35464437753278,59.88150955426635,NaN,NaN,41.11268877049424,120.68614317050181,-0.20286457047397466,4.796100141723116,4.998964712197091,6352738081,6420652660.8,81.57868468627086,83.07766692829993,NaN,NaN,23.214519829555275,24.175719977110553
2020-08-12T09:30:00-04:00,267.37,272.84,267.37,271.86,38894272,38084381.05,61.10665446756284,60.30731041579632,NaN,NaN,88.22289881515734,104.14688178049683,-0.13632569561999386,4.828557592672098,4.964883288292092,6391632353,6409408749.6,77.71148441588603,81.59461770291905,NaN,NaN,23.038393248133993,24.0132447301139
2020-08-13T09:30:00-04:00,272.64,274.83,271.51,272.48,31895717,37299461.35,61.67417108569281,61.001029133285684,NaN,NaN,106.90607482941421,90.27383710396593,-0.09317094136146586,4.848419611590259,4.941590552951725,6423528070,6398934337,74.18351876788071,80.38874896213464,NaN,NaN,23.075977775438496,23.879349450874557
2020-08-14T09:30:00-04:00,273.01,273.4,270.72,272.16,30799494,37082542.5,61.177988580530005,61.30346026696727,NaN,NaN,85.73210567027255,81.58074630627303,-0.12671139296118206,4.783201311750247,4.909912704711429,6392728576,6391293896.8,71.62904361604525,79.51179344945217,NaN,NaN,22.96048053550527,23.748082462964657
2020-08-17T09:30:00-04:00,273.91,275.84,272.1978,275.32,24802966,36292184.4,64.23773172711955,62.12945879546375,NaN,NaN,104.29568306751919,85.25389023057149,0.015809603117022064,4.929674708607706,4.913865105490684,6417531542,6395631724.4,72.21404668553937,79.08026736164973,NaN,NaN,23.77192817763942,23.75148899363248
2020-08-18T09:30:00-04:00,276.41,278.465,274.91,277.97,23529498,35296510.95,66.61409874932303,62.897510032955225,NaN,NaN,121.81449301552144,101.39425107957693,0.22862827577314526,5.199650450207116,4.971022174433971,6441061040,6413296316.2,74.5182919617683,79.20286132571032,NaN,NaN,25.17605265662106,23.954998088345135
2020-08-19T09:30:00-04:00,277.93,279.02,275.57,276.1,31999359,35403202.95,63.411960652491516,63.33515362441763,NaN,NaN,106.94059318536625,105.13778995361872,0.1853749331860497,5.202740840916533,5.0173659077304835,6409061681,6416782181.8,74.95959455208578,79.31688003991296,NaN,NaN,25.42118517220388,24.16445338603924
2020-08-20T09:30:00-04:00,275.3,280.43,274.86,279.93,27723379,34221195,66.9193924067958,63.69883192552802,NaN,NaN,115.80239522266974,106.91705403226983,0.3472262008654603,5.451398658812309,5.104172457946849,6436785060,6419433579.8,75.30984661220077,79.22287874031996,NaN,NaN,26.697443155719437,24.526309067422126
2020-08-21T09:30:00-04:00,280.07,282.34,279.461,281.87,34748934,33255914.9,68.56329021779425,63.95885402111677,NaN,NaN,145.72646959866128,118.9159268179476,0.5077417704612319,5.738849671023388,5.231107900562156,6471533994,6435194663.4,77.33899728461054,79.08512839244896,NaN,NaN,28.25831497572164,25.05945276860777
2020-08-24T09:30:00-04:00,285.06,286,281.27,283.63,36418533,33254554.5,70.01889858776921,64.26335397372283,NaN,NaN,162.08867549101853,130.47452530264746,0.6463612332896513,6.039059442174221,5.392698208884569,6507952527,6453278860.4,79.42811292338595,78.87396108878401,NaN,NaN,29.997963774209346,25.764954340836567
2020-08-25T09:30:00-04:00,282.78,286.06,282.37,285.86,34866586,33432764.3,71.80055863770126,64.65391327900484,NaN,NaN,160.3976223523835,138.19115117001988,0.7925110932933297,6.383337075501231,5.590825982207901,6542819113,6473630475,81.4955995088938,78.64008183219156,NaN,NaN,32.006916950344355,26.656663285051966
2020-08-26T09:30:00-04:00,287.11,292.22,285.829,291.96,42216690,34165754.6,76.00170079673606,65.13151479685538,NaN,NaN,193.65421618046716,155.53387576904007,1.180887509080084,7.066935368558006,5.886047859477922,6585035803,6508825299.4,84.41299812497218,78.4857492025552,NaN,NaN,35.20615239626791,27.87801887236853
2020-08-27T09:30:00-04:00,293.08,293.851,288.705,291.05,49482715,34551167.55,74.22516371306497,65.86690481761728,NaN,NaN,175.9344726756339,167.5602912596329,1.250674198982316,7.449390608205817,6.198716409223501,6535553088,6528578905,85.7691372409161,78.38341538844438,NaN,NaN,37.25800461752668,29.21801683596255
2020-08-28T09:30:00-04:00,292.27,293.18,290.93,292.53,28021022,33264410.7,75.2389020503065,66.81036828931573,NaN,NaN,160.39816268562654,170.49462987702594,1.2667903642464289,7.7822043645315375,6.515414000285109,6563574110,6546986928.2,86.91191848595004,78.39009106188618,NaN,NaN,39.263874448299816,30.653139352010733
2020-08-31T09:30:00-04:00,293.16,296.745,292.62,294.88,36321027,33476383.75,76.79925456261363,68.41355473110723,NaN,NaN,155.62926676225197,169.2027481312726,1.3010561444602757,8.141734180860453,6.840678036400178,6599895137,6565375450.2,87.95266996306967,78.84537572451465,NaN,NaN,41.44000861597013,32.1941206754335
2020-09-01T09:30:00-04:00,297.6,300.04,295.79,299.92,36395774,34050608.15,79.74699745715759,69.74500780179257,NaN,NaN,158.8021461315143,168.88365288709878,1.5136056284275012,8.732685071934554,7.219079443507053,6636290911,6584069809.8,88.91751312348786,79.64580634648622,NaN,NaN,44.33296457641622,33.92824123271675
2020-09-02T09:30:00-04:00,303.26,303.5,296.89,302.76,50836767,35508150.45,81.1967474906254,71.13947754500204,NaN,NaN,151.7876204962823,160.51033375026182,1.682909015010127,9.322715712269712,7.639806697259585,6687127678,6604488184.8,89.87162831680486,80.76638559998081,NaN,NaN,47.23292481780214,35.82891031630038
2020-09-03T09:30:00-04:00,298.2,298.62,284.41,287.41,110083282,39609903.35,57.315751937971804,70.86360349910503,NaN,NaN,61.57703354283124,137.63884592370124,0.6515524273769655,8.454247231480792,7.802694804103827,6577044396,6612786446.4,90.23941015466741,82.09569749559668,NaN,NaN,40.97156379576091,36.56357509908045
2020-09-04T09:30:00-04:00,285.76,288.93,271.8,283.58,123958978,43559384.45,53.11787623706278,70.06932810695811,NaN,NaN,-7.580434021010174,104.0431265823739,-0.34459468748389455,7.371951444748959,7.716546132232853,6453085418,6590688708,81.72861429741405,82.77530946787344,NaN,NaN,34.508813845374405,36.27003777712245
2020-09-08T09:30:00-04:00,272.27,278.22,269.66,269.95,99568645,46783398.05,41.47576486567026,68.27373282955435,NaN,NaN,-79.4307028348182,57.031132662959884,-1.8910812135318364,5.3526946153180575,7.243775828849894,6353516773,6541413035.2,66.63634596569463,82.21231332529676,NaN,NaN,23.770869405178516,34.48444229541617
2020-09-09T09:30:00-04:00,275.54,280.045,273,277.88,64837872,47870075.5,48.54225578965958,67.21161105363777,NaN,NaN,-51.46612898659494,14.977477639338044,-2.321221453001592,4.342249012597904,6.663470465599496,6418354645,6497825782,56.66786751493228,80.9057613940715,NaN,NaN,18.224927583610683,32.16165447944396
2020-09-10T09:30:00-04:00,280.97,282.195,270.56,272.34,69667462,49408735,44.49978208152186,65.61021031611821,NaN,NaN,-71.51406799013101,-29.682860057944612,-2.8834422035373173,3.0591677111778495,5.942609914715167,6348687183,6430137683,45.32771227622061,78.76418037007292,NaN,NaN,12.381830285180026,29.335965308834826
2020-09-11T09:30:00-04:00,274.33,275.22,266.9,270.45,71809014,51404399.85,43.17868898154024,63.79702451352863,NaN,NaN,-105.5374949759172,-63.105765761694286,-3.2594694978388956,1.868273042416547,5.127742540255443,6276878169,6370104437.6,38.05413337889868,75.95811866252208,NaN,NaN,7.549342653828115,26.223590643833866
2020-09-14T09:30:00-04:00,274.28,277.22,272.96,275.16,38525194,51790684.85,47.37181325025049,62.179375560848726,NaN,NaN,-71.60461405304453,-75.91060176810115,-3.0704567973116372,1.2896715436158956,4.360128340927533,6315403363,6342568026.6,35.259286197575975,72.80320246782136,NaN,NaN,5.183126559991963,23.21781006042788
2020-09-15T09:30:00-04:00,278.9,280.45,275.1332,279.06,41849926,52643032.85,50.62115783276805,60.666561217639206,NaN,NaN,-47.24417127512573,-69.47329545616266,-2.5818904483214298,1.1327652805257458,3.7146557288471755,6357253289,6343315329.8,35.39795433771668,69.51051352702301,NaN,NaN,4.414314920247473,20.531596468973536
2020-09-16T09:30:00-04:00,279.77,280.36,274.25,274.61,42435626,53588339.25,47.05146689095676,58.5986873672264,NaN,NaN,-62.78452425206762,-71.7369745092572,-2.4581739734078942,0.641938262087308,3.100112235495202,6314817663,6322607933.4,33.27136715128171,65.85753988604512,NaN,NaN,2.590001935223905,17.96851153558073
2020-09-17T09:30:00-04:00,267.52,274.3955,266.68,270.32,81570844,56066913.5,43.841738561551594,56.42844271354687,NaN,NaN,-108.5143311942232,-79.13702715007562,-2.553810251362028,-0.0921505787073329,2.461659672654695,6233246819,6299519860.6,31.03278685970733,61.94780057310164,NaN,NaN,0.03730894628435407,15.40691116568125
2020-09-18T09:30:00-04:00,271.62,272.09,262.63,266.87,86251117,58993300.4,41.39605348578663,54.01109638750974,NaN,NaN,-123.6700788532537,-82.76354392554293,-2.7224916857703914,-0.9414549345582941,1.7810367512120973,6146995702,6273543367.2,28.6936016026107,57.78934936714883,NaN,NaN,-2.8310483590137667,12.801488376439105
2020-09-21T09:30:00-04:00,262.52,267.65,260.11,267.51,57168570,60114282.2,42.04196346153077,51.5284327374324,NaN,NaN,-123.32432675089936,-93.10748646511391,-2.660894495330352,-1.5450813679508428,1.1158131273795093,6204164272,6251295549,26.828382258644808,53.42332881683277,NaN,NaN,-4.909619778891753,10.271330068534697
2020-09-22T09:30:00-04:00,270.05,273.08,266.54,272.48,41128886,60349799.85,46.933307875794114,49.184597767335,NaN,NaN,-74.1363601178845,-98.48592423366566,-2.175796949452114,-1.603933059435633,0.5718638900164809,6245293158,6228903522.8,25.06250705220978,48.86225695459863,NaN,NaN,-5.1964054854973325,8.061653560815836
2020-09-23T09:30:00-04:00,272.15,272.34,263.2502,264.16,48837270,61048334.05,40.735485851088704,46.294507650225235,NaN,NaN,-93.2876812330227,-104.58655562985669,-2.2938648710615497,-2.2954671988104565,-0.0016023277489066734,6196455888,6205231167.8,23.31531904216712,44.10823486355308,NaN,NaN,-7.4532201153226065,5.845243035653201
2020-09-24T09:30:00-04:00,261.58,268.7,261.22,265.39,70631704,62469084.75,41.955831891150495,45.19737050402371,NaN,NaN,-95.93402611003572,-102.07049461301918,-2.1691090353856497,-2.712988621980969,-0.5438795865953192,6267087592,6211999322.4,24.92675774387078,39.44304540563902,NaN,NaN,-8.876725879239777,3.7421046192399188
2020-09-25T09:30:00-04:00,265.82,272.395,264.2999,271.56,55242376,62757067.8,47.766211776769545,44.815108756859914,NaN,NaN,-62.03925501987453,-89.74432984634333,-1.5784927824599928,-2.51699556467031,-0.9385027822103174,6322329968,6247066175.6,32.80538985127376,35.948529373771855,NaN,NaN,-8.275954263329524,2.025239064587141
2020-09-28T09:30:00-04:00,276.615,277.2,271.674,277.2,58438286,64277931,52.45174619130365,45.59910742297659,NaN,NaN,-13.816455621971182,-67.84275562055771,-0.7570709826195556,-1.8848415104847618,-1.1277705278652062,6380768254,6282386972,39.672859727867156,34.022566071069896,NaN,NaN,-6.256281313987276,0.8421647247907957
2020-09-29T09:30:00-04:00,276.72,277.71,275.3719,275.95,27178921,63820825.7,51.35227739277269,45.79982325177038,NaN,NaN,1.9957648558002161,-52.61633062582077,-0.2720232112968941,-1.4677995419863237,-1.1957763306894296,6353589333,6304046207,43.48709325907707,33.081082195651675,NaN,NaN,-4.96644338175414,0.012363566712947804
2020-09-30T09:30:00-04:00,276.09,281.09,275.8717,277.84,49380802,64470077.1,52.95790950628031,46.4039752106817,NaN,NaN,36.11093574813394,-26.736607229589453,0.17777229023315866,-0.9735609678979813,-1.15133325813114,6402970135,6345349056.4,49.98159666841314,33.41350250937971,NaN,NaN,-3.428293881161858,-0.4791589258405959
2020-10-01T09:30:00-04:00,281.79,282.8794,279.84,282.25,50020223,64429249.9,56.5606142842165,47.35982701801572,NaN,NaN,101.49514473157642,12.74922693873297,0.7423086623766105,-0.22344743016037683,-0.9657560925369874,6452990358,6382529609.6,54.9954875838494,34.62359923830477,NaN,NaN,-1.0198849874763205,-0.5564055060742709
2020-10-02T09:30:00-04:00,276.01,282.2412,273.44,274.31,75497391,62699955.35,49.2476394715126,47.49381460524872,NaN,NaN,49.162259194802715,34.98952978166842,0.5593284400972569,-0.2665955424154163,-0.8259239825126732,6377492967,6393562209.4,56.39235251990731,36.13310397561414,NaN,NaN,-1.1282499090104972,-0.6380975636365889
2020-10-05T09:30:00-04:00,276.34,280.49,276.23,280.16,28184581,57911235.5,53.96982092927794,47.733004826428,NaN,NaN,88.75594054667131,55.50400901539693,0.796182185239101,0.16930374903620304,-0.626878436202898,6405677548,6398544068.2,57.040767591198225,37.679019208005684,NaN,NaN,0.29205656650876133,-0.5052184021872531
2020-10-06T09:30:00-04:00,279.29,281.19,274.25,275.16,49704236,55418015.05,49.712369421841345,47.92306929291976,NaN,NaN,51.098793716998316,65.32461478763655,0.589527150249521,0.1100305016090033,-0.47949664864051766,6355973312,6399020864,57.106504242187725,39.38152900021326,NaN,NaN,0.13257765797215318,-0.41410467930733796
2020-10-07T09:30:00-04:00,277.83,280.74,277.28,279.92,27539663,53553104.6,53.47512156460479,48.61116807885213,NaN,NaN,85.28843673994649,75.16011498599906,0.7372393497177635,0.4420525385066867,-0.2951868112110768,6383512975,6395129432,56.34863174837688,41.189803635118224,NaN,NaN,1.1993298606539073,-0.18361403074144578
2020-10-08T09:30:00-04:00,282.32,282.47,280.31,281.41,25443287,51341895.85,54.619777741292715,49.55571981138828,NaN,NaN,105.89081755389125,76.03924955046203,0.8889546706410859,0.8160065270902805,-0.07294814355080537,6408956262,6386322612.8,54.58314901371432,43.03905702162564,NaN,NaN,2.4079470508816803,0.1866089809190008
2020-10-09T09:30:00-04:00,283.09,285.79,282.71,285.71,30201144,49261502.35,57.843249068711096,50.68438306904402,NaN,NaN,138.65595038335132,93.93798778817175,1.2125274305348073,1.4427111446177037,0.23018371408289645,6439157406,6398655500.6,56.63231312728936,45.16790922652882,NaN,NaN,4.4215699278905,0.7916034019149293
2020-10-12T09:30:00-04:00,290.6,297.46,289.47,294.53,79370657,51303775.5,63.56080907712725,51.8720617262821,NaN,NaN,220.07094575113882,120.20098882906527,1.912547130163604,2.620867626787401,0.7083204966237974,6518528063,6421225603.6,60.17377304668118,47.675856797562496,NaN,NaN,8.098435838987209,1.8354366072109691
2020-10-13T09:30:00-04:00,296.34,297.0496,293.11,294.52,64240031,52423280.75,63.55028516528436,53.50169024872465,NaN,NaN,198.3316358437363,149.64755725441287,2.2439512359588214,3.5132595415723245,1.2693083056135028,6454288032,6440888547.6,63.00793299401268,50.5110435084086,NaN,NaN,10.984876523352103,3.142499452373988
2020-10-14T09:30:00-04:00,295.32,296.35,290.26,292.06,37181227,52160560.8,60.87985523961523,54.85340620218641,NaN,NaN,147.8513885022461,162.16014760687278,2.165473782840164,3.9761505341637076,1.8106767513235438,6417106805,6447607313.6,63.95191358361363,53.2985546398188,NaN,NaN,12.606214894910241,4.494458801307738
2020-10-15T09:30:00-04:00,287.25,290.71,286.54,290.1,42514177,50207727.45,58.76120143647876,55.63876260645135,NaN,NaN,99.71168908504754,160.92432191310405,1.8611777062173793,4.137148884095268,2.2759711778778886,6374592628,6440734586.8,62.20330669315407,55.39840584281025,NaN,NaN,13.352484914446194,5.7598911031846605
2020-10-16T09:30:00-04:00,291.8,293.269,288.15,288.51,40570702,47923706.7,57.027414198127886,55.965596035510224,NaN,NaN,96.15139434727597,152.42341070588895,1.4506651295204191,4.089302589778413,2.6386374602579936,6334021926,6419707490.8,57.06257532769069,56.6405283856548,NaN,NaN,13.493827847299523,6.864739209486784
2020-10-19T09:30:00-04:00,290.49,291.48,282.79,283.8,36756754,46903115.9,52.121390985503574,56.0205327207053,NaN,NaN,52.85701049997942,118.98062365565707,0.792680385562246,3.629487942210801,2.836807556648555,6297265172,6375454912.6,48.06048177664654,56.967198994052616,NaN,NaN,12.209297477309592,7.6282475334614706
2020-10-20T09:30:00-04:00,284.56,287.62,282.95,284.41,32195361,46456439.65,52.6890676434067,56.00132973050004,NaN,NaN,37.80967537755515,86.87623156242084,0.3517808216123486,3.2765335836639906,2.924752762051642,6329460533,6350489412.8,43.8569269064768,56.529722582485725,NaN,NaN,11.30354709892172,8.15329032852722
2020-10-21T09:30:00-04:00,284.67,287.32,283.69,284.19,29306137,45479883,52.447542590546824,55.70753889523792,NaN,NaN,31.929817178216485,63.69191729761493,0.016288285927974044,2.9451131194616096,2.9288248335336355,6300154396,6327098931,40.30043427785675,55.48007591777197,NaN,NaN,10.486601828688185,8.48662054283593
2020-10-22T09:30:00-04:00,285.05,285.98,280.82,284.18,32196162,43558105.9,52.43577652187921,55.9352629702641,NaN,NaN,8.281021428076677,45.405783766220765,-0.2221855083140527,2.65109294814107,2.8732784564551226,6267958234,6305772052.2,37.328133169772094,54.11834596419088,NaN,NaN,9.79816472694731,8.673983997708984
2020-10-23T09:30:00-04:00,284.79,284.91,281.7818,284.74,24658542,42028914.2,53.070702357468875,55.87104021513488,NaN,NaN,1.6516006923655997,26.50582503523869,-0.3504661705389003,2.435195743281497,2.7856619138203973,6292616776,6297491022.2,36.21134832002143,52.630530301963965,NaN,NaN,9.363048007757376,8.772421713430182
2020-10-26T09:30:00-04:00,282.32,285.3,276.76,280.47,38421094,41028054.6,47.82806377516471,55.736446954657985,NaN,NaN,-45.40606251200872,6.85321043284105,-0.7103957610681553,1.897667212485203,2.6080629735533583,6254195682,6288877124.2,35.03709608030671,51.05414400468675,NaN,NaN,7.587123733458709,8.603093430577115
2020-10-27T09:30:00-04:00,281.42,283.505,280.2,282.66,30559123,41197064.7,50.52742215691115,55.52589699696558,NaN,NaN,-32.87882608580648,-7.284489859831271,-0.7827690642822511,1.6296016432005445,2.4123707074827956,6284754805,6279935978.6,33.811467587607396,49.44434656463178,NaN,NaN,6.729818740410087,8.335482760553253
2020-10-28T09:30:00-04:00,278.13,278.6401,271.38,271.64,53413523,41398700.75,39.462858408850906,54.443259901791166,NaN,NaN,-149.66564684156896,-43.603582663788366,-1.5123609793485135,0.5219194832971539,2.0342804626456674,6231341282,6266173355.8,31.958330484859758,47.82828809828503,NaN,NaN,2.392656292900334,7.48650755088855
2020-10-29T09:30:00-04:00,273.04,279.49,272.52,276.39,43246302,41060004.7,45.04862070156882,53.52935787556671,NaN,NaN,-106.48190461361423,-66.55616787212655,-1.605786839106451,0.027046913762603708,1.6328337528690546,6274587584,6267499225.8,32.3430466079522,46.09334048976094,NaN,NaN,0.4106736926513141,6.475674142568945
2020-10-30T09:30:00-04:00,274.375,275.24,267.07,269.38,65935893,40581929.8,39.28730273870445,51.79553599425079,NaN,NaN,-168.50905753436996,-100.58829951747366,-2.0424144155063635,-0.9201842665138997,1.1222301489924638,6208651691,6250706208.8,30.027284457243297,43.94001987622967,NaN,NaN,-3.265656760573929,5.084055442119963
2020-11-02T09:30:00-05:00,271.73,273.52,266.97,269.98,39987409,41172071.2,39.99467504600258,50.11299241430209,NaN,NaN,-153.49760982504657,-122.20660898008123,-2.1809579426842496,-1.6039672793628483,0.5769906633214014,6248639100,6249594892.4,29.874839771732766,41.573370360352534,NaN,NaN,-5.93940874586427,3.5092748438365016
2020-11-03T09:30:00-05:00,271.86,276.82,270.84,274.65,43604145,40867066.65,45.33343758964317,49.00253401073265,NaN,NaN,-101.95356000043353,-136.02155576300663,-1.8606967459787525,-1.748880269152039,0.11181647682671325,6292243245,6251092580.4,30.387760378121598,39.17593084567453,NaN,NaN,-6.548098117169372,2.0725072779785196
2020-11-04T09:30:00-05:00,283.56,288.77,281.87,286.91,75728206,43276493.8,56.320604157710264,48.82820563367777,NaN,NaN,31.29266131356331,-99.82989413198018,-0.7810372853651948,-0.8644801298797802,-0.08344284451458545,6367971451,6278418614.2,39.13522572395611,37.5282107764461,NaN,NaN,-3.187067363852832,1.3211394720026124
2020-11-05T09:30:00-05:00,293.41,295.39,292,294.39,52054186,44607038.75,61.415886776231076,49.14166796068514,NaN,NaN,113.75864741094325,-55.781783727068685,0.4147324710112964,0.434972744249535,0.02024027323823864,6420025637,6307506224.8,46.79884336230832,36.79508706463308,NaN,NaN,1.4979466770263046,1.346397644148854
2020-11-06T09:30:00-05:00,293.58,295.36,289.83,294.61,40959764,45144969.75,61.55792467756718,49.81570608154682,NaN,NaN,95.3350710517563,-3.0129580098434303,1.1563321862872769,1.4656555060973346,0.30932331981005784,6460985401,6357972966.8,56.93123816873794,37.42871252121103,NaN,NaN,5.08933431531173,1.8811028828864078
2020-11-09T09:30:00-05:00,297.31,299.14,288.12,288.59,86537071,45503290.45,55.53357903658489,50.018885466773845,NaN,NaN,83.51012943722189,44.38858984261026,1.1735332988503648,1.7762399433730138,0.602706644522649,6374448330,6383134812.8,60.9269174259572,38.647997558316774,NaN,NaN,6.104112742632618,2.484390005707295
2020-11-10T09:30:00-05:00,285.26,286.6599,280.62,283.42,69024878,45742532.8,50.924331978989336,49.910084708805456,NaN,NaN,-0.33259503353939707,64.71278283598909,0.7873639848975408,1.586911625644575,0.7995476407470342,6305423452,6385770854.2,61.331659337678175,40.15022791973259,NaN,NaN,5.40117551315614,2.9010736496285583
2020-11-11T09:30:00-05:00,285.92,290.25,283.38,289.76,36102931,45688618,55.77222284036046,50.14840230298269,NaN,NaN,53.453351976938386,69.14492096866408,0.9013602844926156,1.9262479963628039,1.0248877118701882,6341526383,6380481840.6,59.98895938901297,41.76885836396409,NaN,NaN,6.450474502708932,3.408130914354326
2020-11-12T09:30:00-05:00,290.72,292.074,287.25,288.4,34516826,45288750.45,54.52788137891542,50.2524865188003,NaN,NaN,70.65279070374767,60.52374962722497,0.829424432635816,2.0616682526649583,1.2322438200291423,6307009557,6357878624.6,54.49792160329625,43.07504216991229,NaN,NaN,6.878846845029445,3.9039474758793427
2020-11-13T09:30:00-05:00,290.01,291.57,287.8701,290.93,24880582,44504244.45,56.47343116047806,50.8700127606084,NaN,NaN,81.06191196281242,57.669117809436194,0.8910811927694549,2.346095310990961,1.4550141182215062,6331890139,6332059572.2,48.98249906204539,44.071142382893626,NaN,NaN,7.831793351333792,4.465068315229978
2020-11-16T09:30:00-05:00,290.68,293.51,289.99,293.2,30168361,44174824.8,58.20144969900748,51.41815758504385,NaN,NaN,98.58010140526467,60.68311220304476,1.014615517852479,2.723283515537105,1.708667997684626,6362058500,6329581606.2,48.475437933437945,45.118568836167235,NaN,NaN,9.137452689374419,5.132551797250612
2020-11-17T09:30:00-05:00,293.4,293.74,291.61,292.27,21843463,43657229.9,57.19954069374889,52.68506346253656,NaN,NaN,92.00754749053728,79.1511407078601,0.9639285902091292,2.9135787354460376,1.9496501452369084,6340215037,6336539923.2,50.03945014488092,46.4100773833116,NaN,NaN,9.916464010367525,5.815967827695885
2020-11-18T09:30:00-05:00,291.7,293.37,290.02,290.11,28069619,43595404,54.83833290336065,53.38432861980741,NaN,NaN,70.35150642355835,82.53077159718407,0.7260075343511576,2.8571595631758555,2.131152028824698,6312145418,6330663730.2,48.69517464625018,47.578086528904315,NaN,NaN,9.908363812671674,6.400595825549569
2020-11-19T09:30:00-05:00,289.48,292.7,288.85,292.38,22718422,43121517,56.8540895173482,54.63909910399625,NaN,NaN,65.1081585220326,81.42184516084106,0.664261501835349,2.9614789061188844,2.2972174042835354,6334863840,6336234586.8,50.06477351765248,49.00933574750497,NaN,NaN,10.462946705286145,6.980931665511937
2020-11-20T09:30:00-05:00,292.3,293.065,290.29,290.38,25907308,43183955.3,54.54412693649186,55.67834566760263,NaN,NaN,58.988268336222944,77.00711643552316,0.4421599790976254,2.849917378155567,2.4077573990579415,6308956532,6331647865.4,48.90713631373749,50.368785500505304,NaN,NaN,10.29977740488659,7.455052485422602
2020-11-23T09:30:00-05:00,291.41,292.75,288.07,290.39,26875588,42606680,54.55406937525321,56.33696222371763,NaN,NaN,46.93411806928369,66.67791976832697,0.2584594027594682,2.730831652507277,2.4723722497478087,6335832120,6326402589.4,47.552980528365715,51.59487265409417,NaN,NaN,10.167262829376126,7.842511105987391
2020-11-24T09:30:00-05:00,291.49,294.98,289.63,294.47,24516791,42304563.4,58.538721881736734,56.49539920400523,NaN,NaN,67.06545530002037,61.68950133022359,0.3676064939151371,2.93188036714173,2.564273873226593,6360348911,6330429364.2,48.72669216940931,52.27997740019797,NaN,NaN,11.131769426796067,8.312405151817202
2020-11-25T09:30:00-05:00,295.44,296.94,294.59,296.28,23326826,40800228.55,60.20566138445747,56.408954533164255,NaN,NaN,92.18264186782388,66.0557284190767,0.5088792123535573,3.2003728886685394,2.691493676314982,6383675737,6344735428,52.770593807912086,52.70653100345538,NaN,NaN,12.410757971807053,8.897884126101467
2020-11-27T09:30:00-05:00,298.29,300.17,297.9,299.01,17163115,39496069.2,62.64511893974213,56.48661126617675,NaN,NaN,122.06471386342156,77.44703948735449,0.7204343143049146,3.592036569196125,2.8716022548912106,6400838852,6357930430.4,56.20174645775183,52.65442445267066,NaN,NaN,14.199727204694279,9.655290280186154
2020-11-30T09:30:00-05:00,299.3,299.97,294.78,299.62,27836232,37591086.15,63.18813375865818,57.03336517489628,NaN,NaN,116.82867131078474,89.01512008226686,0.828015521799049,3.906621657140022,3.078606135340973,6428675084,6381874140.8,61.64673046066827,52.70583966943574,NaN,NaN,15.848149300712672,10.539984425975657
2020-12-01T09:30:00-05:00,301.87,305.14,300.83,303.46,27642640,36973847.7,66.4904522961546,58.145230911836656,NaN,NaN,199.81795058294446,119.59188658499902,1.0690321611566587,4.414896336786796,3.3458641756301377,6456317724,6405971261.6,66.20084588231603,53.05363870833844,NaN,NaN,18.25068849848331,11.641513579191036
2020-12-02T09:30:00-05:00,302.22,304.195,300.35,303.85,23620003,35974640.6,66.81604698571593,58.934075493647754,NaN,NaN,181.61140343044025,142.501076211083,1.1584415729269515,4.793916141788827,3.6354745688618757,6479937727,6429889024.8,70.00758541206729,53.76925485284232,NaN,NaN,20.34676171218549,12.885120455333102
2020-12-03T09:30:00-05:00,304.07,305.88,303.531,304.28,22828727,33329666.65,67.19452754398338,59.83883593400976,NaN,NaN,174.94980682465876,159.05450920245,1.148051906337916,5.070539451784271,3.9224875454463546,6502766454,6453707168.2,73.23985662032531,55.10796449691583,NaN,NaN,22.219216319846407,14.218562721692145
2020-12-04T09:30:00-05:00,304.33,305.67,303.63,305.52,19332081,31693561.4,68.3167603273752,60.68478801735955,NaN,NaN,146.6087543737682,163.9633173045193,1.1247304195241696,5.328400569851567,4.203670150327397,6522098535,6477959104.8,76.06798331930938,57.04264194386326,NaN,NaN,24.135791538680724,15.635309695547656
2020-12-07T09:30:00-05:00,305.71,307.63,305.52,307.25,20850969,30688121.65,69.86560624290772,61.51794205620957,NaN,NaN,142.14446572010448,169.02647618638326,1.1232332363352384,5.6077116957464455,4.484478459411207,6542949504,6500813988.8,78.38622317999273,59.17912660433145,NaN,NaN,26.22671185325555,17.148367146648784
2020-12-08T09:30:00-05:00,306.76,308.6,304.95,308.29,18341464,27278341.3,70.79005179786185,62.488692849360504,NaN,NaN,126.39917246640103,154.34272056307455,1.0888993248815044,5.845602615513087,4.756703290631583,6561290968,6521808637.6,80.27630905712482,61.3389022409203,NaN,NaN,28.277864890797773,18.738295395812926
2020-12-09T09:30:00-05:00,308.07,308.36,300.21,301.31,48839306,26269062.7,57.942439499429774,62.710414749079725,NaN,NaN,73.6629850549349,132.75303688797348,0.5214843430363274,5.408558719426992,4.8870743763906646,6512451662,6528311424.6,80.83532967419208,63.63462760005901,NaN,NaN,26.58703042564486,19.85954325721749
2020-12-10T09:30:00-05:00,299.21,303.68,298.09,302.52,27519544,25839893.35,59.320721439702154,62.88660274353358,NaN,NaN,46.698406219763655,107.10275676699446,0.17116740308684353,5.101033630249219,4.929866227162376,6539971206,6535752375,81.48209258796138,65.87872181936679,NaN,NaN,25.553842197524684,20.67301453440423
2020-12-11T09:30:00-05:00,300.81,301.98,298.47,301.85,26760416,25452072.85,58.18369798549237,63.14657210417648,NaN,NaN,34.0115147051188,84.58330883326458,-0.14507983033935012,4.748516439238188,4.893596269577538,6513210790,6533974826,80.7807511517025,68.15540859350715,NaN,NaN,24.375605455870254,21.201956094613664
2020-12-14T09:30:00-05:00,303.08,306.05,303.01,304.04,28804832,25648285.35,60.82675506745164,63.594621082190656,NaN,NaN,71.7184484833569,70.49810538591507,-0.24054544440819647,4.592914464067292,4.833459908475488,6542015622,6533788049.6,80.70214844097376,70.52320630155057,NaN,NaN,24.067570145618554,21.611329530471505
2020-12-15T09:30:00-05:00,306.37,307.29,304.11,307.29,25790455,25429390.05,64.42078139574937,64.01476819033442,NaN,NaN,87.31839474195321,62.68194984102551,-0.12442997610381656,4.677922438345718,4.802352414449534,6567806077,6535091071.4,80.84220054053758,72.8171711852026,NaN,NaN,24.816811054251794,22.06925546244012
2020-12-16T09:30:00-05:00,307.7,309.785,306.621,308.98,25461890,25610311.4,66.15945127230535,64.44003889660927,NaN,NaN,106.77708158800453,69.30476914763943,0.018941496434782934,4.826029284993012,4.8070877885582295,6593267967,6551254332.4,82.53537573252508,74.94322703696068,NaN,NaN,25.950201901835,22.623676382353672
2020-12-17T09:30:00-05:00,310.63,311.24,309.39,311,23730524,25393356.65,68.16214211503423,64.83411198055869,NaN,NaN,125.6970009540338,85.10448809449346,0.19289739244815518,5.048209529118424,4.8553121366702685,6616998491,6566659789.4,83.98793512368849,76.92795479881329,NaN,NaN,27.499444986769305,23.320214754413048
2020-12-18T09:30:00-05:00,311.66,311.98,307.61,310.06,41173392,26316105.15,66.19883592595613,65.04916213536569,NaN,NaN,110.34120563458394,100.37042628038648,0.1875640199824682,5.0897671616483535,4.902203141665885,6575825099,6579182651.2,85.07464358301088,78.60137716469491,NaN,NaN,28.256827212015445,24.025445105499106
2020-12-21T09:30:00-05:00,306.46,309.47,303.6,308.92,37095480,26875513.75,63.79879332271996,64.85690078012036,NaN,NaN,70.33104933677215,100.09294645106954,0.05694416253673573,4.9733833448368046,4.916439182300069,6538729619,6578525450.6,84.7495695684605,79.92628599941952,NaN,NaN,28.244396831622254,24.62815249494527
2020-12-22T09:30:00-05:00,309.85,310.7105,306.845,309.76,26378343,26850651.5,64.81114827491359,64.71369372934878,NaN,NaN,94.31933001964593,101.49313350660807,-0.01912634063161356,4.892531256510551,4.911657597142165,6565107962,6577985827.6,84.4641840762447,80.95890018971791,NaN,NaN,28.503111563338095,25.181718076144243
2020-12-23T09:30:00-05:00,309.81,310.18,308.035,308.2,21201280,26684875.95,61.37829994682755,64.2982489009805,NaN,NaN,84.20272965587715,96.9782631201826,-0.2101374242221583,4.648985816864467,4.859123241086626,6543906682,6568113570.6,79.20909450259158,81.3852743241655,NaN,NaN,27.801433800874193,25.555963179677093
2020-12-24T09:30:00-05:00,308.47,310.02,308.39,309.56,16784997,26357784.5,63.207909253489575,63.93333096713152,NaN,NaN,87.26393936840793,89.29165080305742,-0.2763513961757589,4.513683995866927,4.790035392042686,6560691679,6556852208.2,73.58495931386547,81.20791546663379,NaN,NaN,27.678657283288917,25.859205194478783
2020-12-28T09:30:00-05:00,312.25,313.17,310.36,312.68,22497745,26624516,67.06281546331067,63.73313162573174,NaN,NaN,134.63438292689702,94.15028626152005,-0.14792496140276246,4.605129190289233,4.7530541516919955,6583189424,6558325073.2,73.8465166668134,80.88365071569241,NaN,NaN,28.6520943838447,26.2581893643882
2020-12-29T09:30:00-05:00,314.05,314.685,312.03,312.96,25871925,26526300.65,67.39300119081216,63.49048515379962,NaN,NaN,149.9510545946552,110.07428731309665,-0.08513903076329576,4.646630363237875,4.731769394001171,6609061349,6572391419.2,76.26381172835565,80.59704376363746,NaN,NaN,29.55016716883877,26.72847190788114
2020-12-30T09:30:00-05:00,314.16,314.49,312.33,312.97,18138071,26051072.2,67.40556848803462,64.16642293869997,NaN,NaN,134.98694553445506,118.20781041605846,-0.08382335883762426,4.626990195454141,4.710813554291765,6627199420,6584809710.8,78.18114383674533,80.4074590609627,NaN,NaN,30.302471508588656,27.239043279410787
2020-12-31T09:30:00-05:00,312.87,314.24,311.76,313.74,21611412,25950642.65,68.41502362803598,64.81601595215237,NaN,NaN,120.36933188533678,125.44113086195041,-0.07241254900137939,4.620297868040041,4.69271041704142,6648810832,6605790540.8,80.97697780142805,80.37137943335317,NaN,NaN,31.213042280693927,27.806757422451234
2021-01-04T09:30:00-05:00,315.11,315.29,305.18,309.31,45305898,27074501.2,57.40068610457837,64.7600865320871,NaN,NaN,42.929837909030574,116.57431057007493,-0.38695928481027586,4.209011311028576,4.5959705958388515,6603504934,6614353191.8,81.99120292294765,80.4578402741564,NaN,NaN,28.91586011101292,27.96520066367433
2021-01-05T09:30:00-05:00,308.29,312.14,308.29,311.86,29323409,27574067.6,61.26628824846912,64.79148175930263,NaN,NaN,56.597302984041384,100.9668945815038,-0.44299158379642556,4.042231116093319,4.485222699889745,6632828343,6624280975.6,83.11523479427719,80.63020358510664,NaN,NaN,28.017756323810882,27.97270861512241
2021-01-06T09:30:00-05:00,307,311.88,305.98,307.54,52809622,29172000.25,52.56403883618159,63.944571576476356,NaN,NaN,1.8468626378889497,71.34605619015055,-0.7714724193369973,3.520882175718498,4.292354595055495,6580018721,6618472450,79.97023533251861,80.56792035596243,NaN,NaN,24.39388940991967,27.461448728664877
2021-01-07T09:30:00-05:00,310.28,315.84,310.25,314.98,30394826,29774668.35,62.45495386376028,63.67996461872314,NaN,NaN,113.20213290663422,66.98909366458638,-0.5012451430045157,3.665798166299851,4.167043309304367,6610413547,6615115275.4,78.1300947863031,80.2532574312323,NaN,NaN,24.49934086162299,27.03829046194461
2021-01-08T09:30:00-05:00,317.34,319.39,315.0814,319.03,33955847,29030495.4,66.54439889079845,63.56441153127772,NaN,NaN,186.1094042420652,80.13710813593207,-0.08512442267785225,4.060637780957052,4.145762203634904,6644369394,6614226987.8,77.62115421672473,79.79848736644917,NaN,NaN,26.084716157856374,26.902065561360576
2021-01-11T09:30:00-05:00,315.98,317.19,313.75,314.42,32869095,29297972.95,58.70604064566161,63.02921186839954,NaN,NaN,116.2572651560952,94.80259358534501,-0.15184120673053592,3.9559606952217337,4.10780190195227,6611500299,6615826060.8,77.90023869133165,79.28602987418637,NaN,NaN,24.49281803547833,26.5578873433774
2021-01-12T09:30:00-05:00,314.46,315.58,311.2,313.92,29266762,29423290.25,57.90930234052681,62.60853394110003,NaN,NaN,72.1349027337298,97.9101135352827,-0.2550571052319457,3.7889805204123377,4.044037625644283,6582233537,6605707099.6,71.79834352072639,78.3609422993482,NaN,NaN,23.014111422035175,26.05163364032851
2021-01-13T09:30:00-05:00,314.19,316.86,313.57,316.04,22898417,29127969.5,60.365465475100706,62.290985169684824,NaN,NaN,108.45220297253749,119.2311816022124,-0.20795558767102085,3.784093141055507,3.992048728726528,6605131954,6610729746.2,72.93170445271355,77.53719375481026,NaN,NaN,22.632640542760683,25.56320605496168
2021-01-14T09:30:00-05:00,316.5,317.53,313.8616,314.35,23500129,29013453.2,57.4856411809372,62.012938114978375,NaN,NaN,92.51054466651453,115.09286395418846,-0.31177849153247994,3.602325614310928,3.914104105843408,6581631825,6604973401.8,69.4851552456753,76.84262666503052,NaN,NaN,21.394929335874863,24.96773795223499
2021-01-15T09:30:00-05:00,314.13,315.12,310.58,311.86,35118718,29496294.6,53.44039962287046,61.31525885564844,NaN,NaN,15.514478284082255,80.97387876259187,-0.5550988554755696,3.2202305364989456,3.7753293919745152,6546513107,6585402144.4,59.23554902597404,75.817668787324,NaN,NaN,19.064545819567353,24.12442479042533
2021-01-19T09:30:00-05:00,314.25,316.93,313.12,316.41,24537049,29536620.85,59.10365687007723,60.74674752756033,NaN,NaN,89.70921577770116,75.66426888691305,-0.42255673348420775,3.2471334751192558,3.6696902086034635,6571050156,6577312115.8,55.58554748790283,74.51331384597324,NaN,NaN,18.8993673689297,23.377988015925954
2021-01-20T09:30:00-05:00,320.14,324.74,316.509,323.77,30728096,29014356.05,66.25404843814161,60.665393759512426,NaN,NaN,219.23545949555498,105.0843802392781,0.11891136357185639,3.818329413068284,3.6994180494964275,6601778252,6581221058.8,56.965368277707356,73.13485359949837,NaN,NaN,21.34601872033639,23.08770668798459
2021-01-21T09:30:00-05:00,325.15,327.13,323.73,326.36,25316935,28425428.8,68.35110676344233,60.73293220775583,NaN,NaN,262.60809918960155,135.91555948269092,0.5836204077434237,4.428943559175707,3.845323151432283,6627095187,6585613705.4,58.52470347235507,71.73082214489907,NaN,NaN,24.02779313288857,23.2220047515423
2021-01-22T09:30:00-05:00,325.29,326.46,324.71,325.42,21609444,28186983.85,66.73032389876592,60.61259651280797,NaN,NaN,204.90614297320062,158.39467914402812,0.7492510064063129,4.781886909440175,4.032635903033862,6605485743,6590384489,60.210994805563274,70.24753764519444,NaN,NaN,25.586812393560066,23.559834414687696
2021-01-25T09:30:00-05:00,328.91,330.32,321.41,328.11,39080644,29080952.05,68.99604035046333,61.44083610179975,NaN,NaN,184.89313899522546,192.27041128625677,0.948692824919898,5.218501934183735,4.269809109263837,6644566387,6609995145,66.28000298782396,69.12530907839988,NaN,NaN,27.61410751126893,24.13901628562787
2021-01-26T09:30:00-05:00,328.85,329.76,327.22,328.59,25498112,29516607.8,69.39653910421994,62.02156830578196,NaN,NaN,170.10220682272723,208.34900949526195,1.015672491429287,5.539399723550446,4.523727232121159,6670064499,6629798013.6,71.07746613960104,68.26546846020872,NaN,NaN,29.346410309991356,24.882929717679797
2021-01-27T09:30:00-05:00,326.26,326.27,317.36,319.43,55263985,31154919.8,54.838351367207835,62.18401920085527,NaN,NaN,56.768778271671806,175.85567325048532,0.3785990602241567,4.996976057401355,4.618376997177198,6614800514,6632402466,71.64877240993258,67.67107825145258,NaN,NaN,25.937998227937243,25.03365379057372
2021-01-28T09:30:00-05:00,320.67,326.42,320.03,321.32,42836324,32003139.75,56.84977514797358,61.78364929258479,NaN,NaN,68.9483582313315,137.12372505883133,0.037957510468523914,4.665823885262853,4.627866374794329,6657636838,6638510796.2,72.99603116720574,67.30435942151706,NaN,NaN,23.903361822815366,24.872183509465383
2021-01-29T09:30:00-05:00,319.58,320.7193,312.76,314.56,55259018,33859187.1,48.52505890076606,60.49655357901104,NaN,NaN,-19.23770285412836,92.29495589336554,-0.6511385907799134,3.8139431363194376,4.465081727099351,6602377820,6637889211.6,72.61786294268407,66.94698147337131,NaN,NaN,19.15432410674921,24.0553464519345
2021-02-01T09:30:00-05:00,318.11,323.54,316.02,322.42,35646008,34560916.9,56.50097759490917,60.339049075385866,NaN,NaN,37.99204587647499,62.91473726961543,-0.5880173763383976,3.7300600066763536,4.318077383014751,6638023828,6636580699.8,71.77487701598909,66.50945563941828,NaN,NaN,17.983678467403443,23.187965311287208
2021-02-02T09:30:00-05:00,325.48,328.87,325.31,327.68,33930844,33992164.2,60.87052777818014,60.550565178075395,NaN,NaN,111.45416618485123,51.18512914204024,-0.22131555503894873,4.041432939216065,4.262748494255014,6671954672,6636958734.4,71.87645171986175,66.51503479649936,NaN,NaN,18.65516471282531,22.540422368649793
2021-02-03T09:30:00-05:00,329.82,330.195,326.32,326.38,24824518,33767219.65,59.28546041723904,60.473421959656704,NaN,NaN,103.96812173630958,60.62499783496779,-0.10169785783957064,4.1356261719555505,4.237324029795121,6647130154,6643424662.4,73.62480577490352,66.56454203379865,NaN,NaN,18.620935433107995,21.980495663572395
2021-02-04T09:30:00-05:00,327.82,330.33,326.46,330.24,22350947,32244285.9,62.41502259950078,60.825520632411234,NaN,NaN,112.427236884153,69.3207735655321,0.18631267513127092,4.47021487370921,4.283902198577939,6669481101,6645793515,74.25623288819409,66.90533329397856,NaN,NaN,19.659328238221732,21.64890031709373
2021-02-05T09:30:00-05:00,331.22,332.4025,329.53,331.36,22731960,31861142.6,63.29659069690657,61.529534280556675,NaN,NaN,125.43034465424948,98.25438306720767,0.38948554406498026,4.770759128659165,4.381273584594185,6692213061,6663760563.2,78.46695342168049,68.27900503652903,NaN,NaN,20.759395621155416,21.52182821767397
2021-02-08T09:30:00-05:00,333.1,333.74,331.41,333.58,20462812,31186490.85,65.04663943612715,61.95403303527452,NaN,NaN,129.82199360224786,116.62037261236223,0.5981448651017995,5.128954665971435,4.530809800869635,6712675873,6678690972.2,81.21638630996682,70.10977923810502,NaN,NaN,22.208013107905174,21.61985463056414
2021-02-09T09:30:00-05:00,332.62,334.81,332.61,333.51,17597478,30422910,64.94149271046633,61.86027905472629,NaN,NaN,123.47032573801927,119.02360452299584,0.6517989783423657,5.345558523797592,4.693759545455227,6695078395,6683315716.8,81.9837525932011,71.89680668921172,NaN,NaN,23.330706285176273,21.864262009794444
2021-02-10T09:30:00-05:00,334.99,335.46,329.5,332.75,28068700,30363006.9,63.73684057102642,61.53068861241086,NaN,NaN,101.52078729115857,118.53413763396563,0.5599664232596373,5.393717574529774,4.833751151270136,6667009695,6687291625,82.64034802570205,73.61935272873652,NaN,NaN,23.918676023564693,22.15774972604734
2021-02-11T09:30:00-05:00,334.33,335,332.12,334.58,22046071,30320389.6,65.40111036757946,61.43574478875468,NaN,NaN,108.76088452297202,117.80086716172943,0.5457711298401469,5.51596506357032,4.970193933730173,6689055766,6691206558,83.28626930082605,75.26758662125528,NaN,NaN,24.883862940977384,22.547194471037344
2021-02-12T09:30:00-05:00,333.71,336.62,332.63,336.45,20346819,30162724.1,67.06451299097145,61.29777854879098,NaN,NaN,117.22271532800407,116.15934129648035,0.5822902924347995,5.698056799273672,5.115766506838873,6709402585,6694644462.8,83.85439836048012,76.522900576445,NaN,NaN,26.172781699008652,23.065135503604672
2021-02-16T09:30:00-05:00,337.27,338.19,334.34,335.54,27080777,29760827.05,65.41632838051558,61.013477782812096,NaN,NaN,120.38961359048304,114.2728652941274,0.46994163593373717,5.703193551756044,5.233251915822307,6682321808,6688573649.8,78.76303890036954,77.07187005935702,NaN,NaN,26.81824084965666,23.601293410183526
2021-02-17T09:30:00-05:00,332.47,335.657,330.17,333.93,31467456,30107347.4,62.49019494843918,61.56003803861433,NaN,NaN,75.9442610125413,104.7676523490318,0.22443155997350495,5.513791365789189,5.289359805815684,6650854352,6679728841.2,71.91230081315302,77.09069351672993,NaN,NaN,26.594798823775733,24.0289370406967
2021-02-18T09:30:00-05:00,330.23,333.8661,328.36,332.47,32236240,30182754.6,59.87464755148454,61.77610035315083,NaN,NaN,46.03960126026734,93.67141514285356,-0.08261034542072565,5.186096874039777,5.268707219460502,6618618112,6670050524.6,65.22675677508389,76.53574534586407,NaN,NaN,25.706054900048557,24.268525306318395
2021-02-19T09:30:00-05:00,333.86,333.99,329.97,331.02,39157677,30874791.7,57.30913356155986,62.403534257493256,NaN,NaN,43.109071752934895,80.54105258884614,-0.4112971030653565,4.754585840628806,5.165882943694163,6579460435,6648131458.4,53.17052869511017,75.14665004246594,NaN,NaN,24.255350032421276,24.266643124333093
2021-02-22T09:30:00-05:00,326.5,327.8,322.23,322.44,47256944,32157166.7,45.01734092994059,61.58327449570978,NaN,NaN,-69.21237363493127,43.25403479625906,-1.1904026455304164,3.6778796367811424,4.868282282311559,6532203491,6612691639.6,40.22463784816415,72.89306153047845,NaN,NaN,18.927848655190306,23.503958200169837
2021-02-23T09:30:00-05:00,317,323.2,311,321.48,97241936,35065231.3,43.88322220782657,60.36989552639881,NaN,NaN,-133.39347740429625,-7.502583402696788,-1.721976189598676,2.715812045313214,4.43778823491189,6434961555,6563219589,29.446427086029928,69.86234548520474,NaN,NaN,14.250591628227319,22.182048689892333
2021-02-24T09:30:00-05:00,318.74,324.45,315.96,324.13,58206272,36700639.3,47.7931228503441,59.5490142716206,NaN,NaN,-82.242191435662,-39.13987389233745,-1.8362290105619863,2.1425019717094074,3.9787309822713937,6493167827,6531682284,24.871307097693332,66.37995272254686,NaN,NaN,11.40473285880791,20.642432142594558
2021-02-25T09:30:00-05:00,321.39,324.03,311.24,312.83,110182582,39446569.15,36.20811839928035,57.67709254303343,NaN,NaN,-141.06741937637423,-76.56127801966578,-2.568995238370661,0.7674869343080672,3.3364821726787284,6382985245,6484555710.6,19.89653398833019,62.49711708684231,NaN,NaN,4.392208990748642,18.320971692330858
2021-02-26T09:30:00-05:00,315.85,319.11,310.88,314.14,104739841,42541745,38.08192924345639,55.87604529635842,NaN,NaN,-140.59219545080637,-113.30153146041403,-2.8404248699502888,-0.21404891475913246,2.6263759551911563,6487725086,6466208640.8,18.357089520000812,58.20355537957948,NaN,NaN,-0.43783882458968754,15.641141618485065
2021-03-01T09:30:00-05:00,319.27,323.94,317.935,323.59,49164518,42237020,49.58611096110391,54.77172183385676,NaN,NaN,-68.80931372716353,-113.22091947886047,-2.2825191844718393,-0.22677302539864286,2.0557461590731965,6536889604,6467145863.4,18.703125431127205,53.73832245966236,NaN,NaN,-0.6197504755894897,13.318157033617272
2021-03-02T09:30:00-05:00,324.25,324.33,318.14,318.4,48370034,42873221.3,44.67659561497939,53.324229184179124,NaN,NaN,-86.326812571997,-103.80758651240062,-2.163136802447583,-0.6481748439862827,1.5149619584613006,6488519570,6477857466.4,22.733896244033744,49.506189863293265,NaN,NaN,-2.5577726460457995,11.05016707937969
2021-03-03T09:30:00-05:00,317.27,318.24,309.1,309.16,86301073,45491732.75,37.54868006366173,51.45364629079593,NaN,NaN,-149.03835737431265,-117.16681970013076,-2.5784018652871974,-1.7080403731476963,0.8703614921395011,6402218497,6459667600.4,20.843931879425014,45.09216013855919,NaN,NaN,-6.969777813302532,8.475889237567944
2021-03-04T09:30:00-05:00,308.78,312.04,300.11,304.1,139131582,51207085.95,34.31953811222739,49.23353398684221,NaN,NaN,-175.54360616138578,-124.06205705713307,-3.034370173772305,-2.92260122507588,0.11176894869642484,6263086915,6435687934.4,18.64351099329997,40.47482025945019,NaN,NaN,-11.66482927204074,5.598643736195276
2021-03-05T09:30:00-05:00,306.795,309.609,297.45,308.68,121523726,56165724.9,39.39958482595246,47.25746768934086,NaN,NaN,-149.99108218810417,-125.94183440459264,-2.8698296532741683,-3.4755181178962857,-0.6056884646221173,6384610641,6415065045.4,16.983035435936415,35.698294336268496,NaN,NaN,-13.52433664381131,2.8667893961943354
2021-03-08T09:30:00-05:00,308.12,310.06,299.51,299.94,88409781,59449615.95,33.99591419088421,45.01315239008147,NaN,NaN,-143.5382509817166,-140.88762185550326,-3.168502065762415,-4.566316046825136,-1.397813981062721,6296200860,6366927296.6,13.876328354976067,31.06352929731182,NaN,NaN,-17.1188789242244,0.011693921848801914
2021-03-09T09:30:00-05:00,307.47,313.73,306.92,311.77,80391114,62446031.05,44.99290642850657,43.76334606722914,NaN,NaN,-80.66986333186173,-139.75623200747617,-2.4218994674660657,-4.425188315395303,-2.0032888479292374,6376591974,6344541777.4,12.711780216058955,26.83492068323368,NaN,NaN,-15.822442489027768,-2.2503255654192795
2021-03-10T09:30:00-05:00,316.16,316.47,310.17,310.88,76798065,65406060.4,44.393648371984845,42.6575604115506,NaN,NaN,-62.17309959052366,-122.3831804507184,-1.86551756963145,-4.33518580996855,-2.4696682403371,6299793909,6324056859.8,11.740754735203495,23.014491966099367,NaN,NaN,-15.086735389947123,-4.084098397494685
2021-03-11T09:30:00-05:00,315.77,319.86,314.85,318.04,53484804,66676865.6,50.14638138958333,42.145935256409416,NaN,NaN,-20.763639668895753,-91.42718715222038,-0.9395446944920991,-3.644099108452224,-2.7045544139601247,6353278713,6342095219.4,17.702307753271114,20.48104761311086,NaN,NaN,-12.3890381639867,-5.270518364136402
2021-03-12T09:30:00-05:00,313.86,318.2302,311.391,315.46,69315601,69040342.1,48.210911038766255,42.374047407039825,NaN,NaN,-35.264089925914476,-68.48178869978244,-0.4499030163326099,-3.266933184375887,-2.817030168043277,6283963112,6321965713.6,16.37321887375259,18.777374829224325,NaN,NaN,-10.9485736082684,-6.0816691132981155
2021-03-15T09:30:00-04:00,315.79,319,314.095,318.83,43123176,70179159.95,50.87788548750231,42.873666212730946,NaN,NaN,-10.360750917160775,-41.846288686871276,0.12132741453164275,-2.6653708998787238,-2.7866983144103665,6327086288,6328142799.2,18.39791832801704,17.988195632223405,NaN,NaN,-8.907761296511257,-6.48539656804285
2021-03-16T09:30:00-04:00,321.09,324.2,319.1,320.58,54925896,71571415.9,52.25294041387127,43.192224610125756,NaN,NaN,36.93857668460374,-18.324600683578172,0.6100901067506421,-2.024085680972064,-2.634175787722706,6382012184,6329226841.2,18.769608351811797,17.552360007517585,NaN,NaN,-6.84658448201752,-6.536994841467803
2021-03-17T09:30:00-04:00,317.45,323.85,315.68,321.9,78258729,73910979.55,53.314502860884666,44.41410921452606,NaN,NaN,38.8678168776289,1.8835826100523505,0.9927097558807834,-1.393288592871727,-2.3859983487525103,6460270913,6361322242,29.07077182117554,18.207662709863676,NaN,NaN,-4.862690433715914,-6.297808497503247
2021-03-18T09:30:00-04:00,316.87,317.8801,311.57,312.04,82942269,76446281,45.22589545161138,44.92439251510855,NaN,NaN,-29.614590652092694,0.11339241341296216,0.572999379859199,-1.6697491239285114,-2.2427485037877104,6377328644,6366132228.2,30.49336173839623,19.074539296891917,NaN,NaN,-5.639470897768069,-6.20376026896965
2021-03-19T09:30:00-04:00,311.87,314.73,309.6601,313.14,78446204,78410707.35,46.206421825494445,44.68298614827931,NaN,NaN,-38.603410365310374,-0.5544716744662181,0.3705416131867434,-1.7795714873042812,-2.1501131004910246,6455774848,6400494575.4,39.784825105185796,20.580374987896104,NaN,NaN,-5.9580949740953795,-6.168665226844754
2021-03-22T09:30:00-04:00,315.21,320.74,315.21,318.61,56194755,78857597.9,50.91225374086024,45.12839030012794,NaN,NaN,49.51663593458398,11.421005695882732,0.5929053954402761,-1.4089813561906794,-2.0018867516309555,6511969603,6437471238.4,47.861714854018054,22.37521917432355,NaN,NaN,-4.770735757933013,-5.96896101700022
2021-03-23T09:30:00-04:00,319.73,321.09,316.375,317.22,53455411,76668271.65,49.7219272772266,45.997907958239715,NaN,NaN,50.572134174225496,14.147717193807088,0.6307418923773356,-1.2134593861592862,-1.8442012785366217,6458514192,6452771640,50.802357768994156,24.515106737864205,NaN,NaN,-4.159228139836943,-5.710427748834038
2021-03-24T09:30:00-04:00,318.63,318.67,311.72,311.87,64803729,76998144.5,45.329096305982134,46.78430497207934,NaN,NaN,-7.275492580310091,4.91905530221929,0.2967812729976278,-1.473224687289587,-1.770005960287215,6393710463,6439459550,48.25240235490205,26.63002754940721,NaN,NaN,-4.953890180100994,-5.602350953300745
2021-03-25T09:30:00-04:00,309.968,312.885,307.3899,311.33,78729008,75425465.8,44.89792734171617,47.17704372320532,NaN,NaN,-58.673085724957005,-0.8926437123535976,0.05357872993844848,-1.7030325478641544,-1.7566112778026028,6314981455,6426990112.2,45.92697961664893,28.697452133743816,NaN,NaN,-5.720671191137168,-5.619253844420235
2021-03-26T09:30:00-04:00,311.11,316.33,309.67,316,63519634,73364455.45,49.38210031284997,48.27605701763145,NaN,NaN,-3.5471149266871964,6.1186153753710375,0.21237858174780322,-1.4911380506178489,-1.703516632365652,6378501089,6411535360.4,43.15125576098865,30.78851837703043,NaN,NaN,-5.0807081202718924,-5.5423187409704715
2021-03-29T09:30:00-04:00,315.45,316.99,312.47,315.91,54607963,73636627.7,49.29883552214299,48.58362338146262,NaN,NaN,21.18839513550547,0.45296721555533426,0.31056506242432835,-1.3153103043352417,-1.62587536675957,6323893126,6373920065,37.250265818001544,32.541267348597756,NaN,NaN,-4.583456411957205,-5.40533840825429
2021-03-30T09:30:00-04:00,313.89,314.91,311.54,314.32,44635676,73449909.8,47.76649765267142,48.82454118722594,NaN,NaN,0.6543410215874742,-9.53059141497227,0.26917882246382097,-1.2894018386797939,-1.5585806611436148,6279257450,6338068716.6,32.66522884704254,34.035872642300546,NaN,NaN,-4.576476240825925,-5.286929527193095
2021-03-31T09:30:00-04:00,316.16,320.74,315.81,319.13,55032535,71886482.9,52.56945393655486,48.99761779772392,NaN,NaN,83.84561314479632,8.693629730049011,0.5503001757145904,-0.8707054415003768,-1.4210056172149672,6334289985,6326184621,31.290335498160843,35.006446052649814,NaN,NaN,-3.2182575550834427,-4.991404959748859
2021-04-01T09:30:00-04:00,323.07,324.71,322.81,324.57,55685602,67714183.9,57.3464331131045,49.65015508874807,NaN,NaN,162.83829294551504,52.995905464143426,1.057777077301757,-0.09878427058777106,-1.156561347889528,6389975587,6341183447.4,35.008395466075214,36.337530094958574,NaN,NaN,-0.5954616233604316,-4.363413054550513
2021-04-05T09:30:00-04:00,327.13,331.84,324.6375,331.05,42172475,63746621.35,62.22667380775484,50.46078282590896,NaN,NaN,215.11077236179057,96.72748292183897,1.7444859560484072,1.0240460971709808,-0.7204398588774263,6432148062,6351912842,37.60928063365324,37.709770259646874,NaN,NaN,3.265329865908689,-3.2735926373420554
2021-04-06T09:30:00-04:00,330.73,332.83,330.02,330.82,33537210,61002992.8,61.95571406731073,51.15383808686892,NaN,NaN,218.72372396969246,136.23454868867637,2.07534299103811,1.8737388799202108,-0.2016041111178989,6398610852,6366856387.2,41.142179474730575,39.30781105414108,NaN,NaN,6.28760288140569,-1.9077075632352347
2021-04-07T09:30:00-04:00,330.33,332.48,329.37,331.62,32046381,58585756.15,62.56628751639108,51.81467984797653,NaN,NaN,180.774806219902,172.25864172833926,2.2268169791241776,2.5819171127873233,0.35510013366314563,6430657233,6397136343.8,47.61514435712654,40.63240909242329,NaN,NaN,8.955376531381768,-0.35583840686137735
2021-04-08T09:30:00-04:00,334.56,335.27,333.7399,335.08,29940799,56242892.85,65.16988688728813,53.239250664810584,NaN,NaN,182.7121119759146,192.03194149456294,2.422596251304592,3.383345447793886,0.9607491964892937,6460598032,6422397953.2,52.32571689979136,42.19186303252293,NaN,NaN,12.027962082231676,1.4132759487233444
2021-04-09T09:30:00-04:00,333.68,337.32,332.92,337.11,36664892,55401897.25,66.6360857438544,54.69851237326487,NaN,NaN,159.05161701342,191.27460630814394,2.5391012981049315,4.134625819120458,1.5955245210155267,6497262924,6443855420.6,55.94918175795032,43.34645993629183,NaN,NaN,15.054782334031577,3.362062575195949
2021-04-12T09:30:00-04:00,336.04,337.1,334.73,336.67,25833013,53227767.85,65.98768691943343,55.77532902887724,NaN,NaN,136.30111059346945,175.5126739544797,2.4363946540698693,4.641017838602863,2.204623184532994,6471429911,6451711790.4,57.23091595488263,44.01568858635358,NaN,NaN,17.401944424713935,5.367759982269947
2021-04-13T09:30:00-04:00,338.24,341.08,338.02,340.6,30374033,52590310.7,68.89864902521906,57.145094868019555,NaN,NaN,141.96410371899768,160.16074990434075,2.475004575684975,5.298378904139213,2.823374328454238,6501803944,6472350408.8,60.483758278706965,44.707217194190214,NaN,NaN,20.316652569915032,7.503316066219245
2021-04-14T09:30:00-04:00,340.85,340.98,335.67,336.51,42564337,51972232.75,62.86823547407403,58.39789052288326,NaN,NaN,107.12566701956703,145.43092206427374,2.0827062871142044,5.426757187346993,3.344050900232789,6459239607,6478066883.6,61.3603524420792,45.6434993432743,NaN,NaN,21.19862198685952,9.459788340596427
2021-04-15T09:30:00-04:00,339.47,342.01,336.2153,341.61,36342821,49876437.35,66.7735167438411,59.96043262303504,NaN,NaN,107.83469337312184,130.4554383437152,2.022625426575176,5.872332683451759,3.849707256876583,6495582428,6485063762.8,62.45809380197924,46.82429321365503,NaN,NaN,23.14421295595465,11.41470614279046
2021-04-16T09:30:00-04:00,342.15,342.23,340.08,342.01,40860099,47772328.85,67.06608325494742,61.223574261756276,NaN,NaN,105.1106640695613,119.66724775494345,1.8693685593683664,6.186417956087041,4.317049396718675,6536442527,6492899683.4,63.701812448405576,48.2921901198991,NaN,NaN,24.81274784629329,13.328712100433721
2021-04-19T09:30:00-04:00,340.39,341.58,336.9016,338.88,34533129,45576675.1,62.433463119506044,62.161761947282216,NaN,NaN,81.66120816879796,108.73926727000912,1.4362077321678601,6.112309061928499,4.676101329760639,6501909398,6498995580.8,64.68205501241613,50.251603633785855,NaN,NaN,24.93734346295889,14.987088009365888
2021-04-20T09:30:00-04:00,338.2,339.52,334.3816,336.41,38081818,44671028.25,58.97164468687703,62.96212959258262,NaN,NaN,60.2536933275516,92.39718519171991,0.8891617819934154,5.787553557252409,4.898391775258993,6463827580,6491400308,62.42020291005446,52.376958924000995,NaN,NaN,24.050716489335127,16.281892077932923
2021-04-21T09:30:00-04:00,335.09,339.48,333.97,339.29,36598082,43828161.8,61.642310330999905,63.610190763614405,NaN,NaN,61.100937729758726,83.19223933375825,0.6388098175834616,5.69690404723832,5.058094229654858,6500425662,6499637519,63.894794370039136,54.705848843420874,NaN,NaN,24.039515492139465,17.390123994248142
2021-04-22T09:30:00-04:00,338.89,339.9,334.01,335.2,45936143,42884782.5,56.061285353248365,63.51839449505325,NaN,NaN,48.262958723905435,71.27789240391499,0.1412786655930951,5.234692561646227,5.093413896053132,6454489519,6491418937.2,61.30986307518831,56.58452510121467,NaN,NaN,22.372006214548847,18.101821454291102
2021-04-23T09:30:00-04:00,335.85,340.767,335.85,339.42,36414916,40769077.9,60.07758149467209,63.36488790126163,NaN,NaN,62.891223490467816,62.83400428809629,0.044904576270690555,5.149544616391495,5.104640040120804,6490904435,6482311318.8,58.4860965121194,58.075726235390825,NaN,NaN,22.1120022971293,18.674704431839416
2021-04-26T09:30:00-04:00,339.67,341.92,338.9,341.63,30811968,39133694.6,62.0347539917367,63.3705336101492,NaN,NaN,78.39519606292984,62.180801866922685,0.07664420025160545,5.200445290435312,5.123801090183706,6521716403,6486272719.8,59.36279634741233,59.37719886915381,NaN,NaN,22.472645285180224,19.217267410888102
2021-04-27T09:30:00-04:00,341.93,342.15,339.17,340.15,33187183,38062655.6,59.916336105413954,63.18125136650798,NaN,NaN,73.73120959578515,64.8763051205694,-0.04864269290338985,5.062997724054469,5.111640416957859,6488529220,6491213047.8,60.48359209265775,60.29637370740603,NaN,NaN,22.157700888591027,19.637329336274234
2021-04-28T09:30:00-04:00,339.81,340.85,338.3301,339,33615696,37511656.6,58.251749662957316,62.68709870762721,NaN,NaN,59.92139637329035,64.64039684927573,-0.24461232332777527,4.80587501279814,5.050487336125915,6454913524,6482110620.2,57.34534619310904,60.65491865692873,NaN,NaN,21.424506147386328,19.892640309290247
2021-04-29T09:30:00-04:00,342.37,342.8,336.9001,340.22,37708884,36645474.05,59.536077107209834,62.17995523358116,NaN,NaN,68.54970676152406,68.69774645679945,-0.32280608805631594,4.64697972605552,4.969785814111836,6492622408,6489737198,59.25301101478802,60.89090646098856,NaN,NaN,21.154962064731503,20.072971988638997
2021-04-30T09:30:00-04:00,337.7,340.26,337.05,337.99,38263421,35774365,56.136591260152855,61.476305543632556,NaN,NaN,29.87543035020731,62.09458782874735,-0.5425163753075974,4.291640344977338,4.834156720284936,6454358987,6482428108.4,56.638642816153585,60.84860123679363,NaN,NaN,19.978658450523522,20.059498626051074
2021-05-03T09:30:00-04:00,339.23,340,335.73,336.19,29729730,35152227.75,53.482027211534486,60.375118271226505,NaN,NaN,-10.455628621229533,44.324422891915475,-0.810730800933082,3.820743219118583,4.631474020051665,6424629257,6463010679.2,50.29038681909093,60.12050327539248,NaN,NaN,18.231384794647195,19.798339507279092
2021-05-04T09:30:00-04:00,333.56,333.89,326.21,330.14,65146972,36732715.85,45.66566755974105,59.14636342020272,NaN,NaN,-223.4512732439047,-15.112073676022499,-1.3646636891513104,2.925644408612527,4.2903080977638375,6359482285,6437201292.2,43.33734919224802,58.83314590040454,NaN,NaN,14.219302364929002,19.001334201229078
2021-05-05T09:30:00-04:00,332.25,333.14,328.23,329.03,46219307,37441362.15,44.38399997573644,57.54711222248096,NaN,NaN,-214.569614189007,-70.01027578848196,-1.7502716932552147,2.102468481194819,3.852740174450034,6313262978,6408871183,37.24948303912243,57.03253084591476,NaN,NaN,10.52579646162426,17.79054309557125
2021-05-06T09:30:00-04:00,328.76,331.67,326.45,331.51,46814283,38285036.35,47.90218354709208,56.17826224334844,NaN,NaN,-190.9609882710335,-121.9124147949935,-1.7770680758911,1.631405079586159,3.408473155477259,6360077261,6382362153.6,32.630403339209636,54.81314448097219,NaN,NaN,8.35987089495049,16.443304209768282
2021-05-07T09:30:00-04:00,334.37,336.65,331.6914,334.2,53324460,39118014.75,51.486963381431075,55.396369404914516,NaN,NaN,-75.14871470226757,-142.91724380548845,-1.5601115678598307,1.4583336956524704,3.018445263512301,6413401721,6374170700.4,31.337256080503593,52.43137312869273,NaN,NaN,7.533062774935953,15.170412576220807
2021-05-10T09:30:00-04:00,332.78,332.96,325.55,325.76,60700462,40861387.2,41.77450575890235,54.16800233863061,NaN,NaN,-180.62028177575658,-176.95017443639387,-1.908483477340618,0.6328409168365283,2.5413243941771464,6352701259,6359785100.8,29.152265592585252,50.05509189173064,NaN,NaN,3.525326868604703,13.506828903704221
2021-05-11T09:30:00-04:00,319.7,326.1299,319.02,325.31,71963612,42940866.15,41.326875760595264,52.71689986931598,NaN,NaN,-207.84457417091804,-173.82883462179655,-2.078677101739692,-0.05702198299746897,2.021655118742223,6280737647,6344036173.2,26.937849598764927,47.415310122353915,NaN,NaN,0.22437233891147257,11.609335108733829
2021-05-12T09:30:00-04:00,320.23,322.62,316,316.89,91164855,45370892.05,33.988164015745255,51.14024834520861,NaN,NaN,-216.57375875211838,-174.22966353441882,-2.6321592529526745,-1.2685439474486202,1.3636153055040543,6189572792,6319298136,23.870599688729726,44.74107702332116,NaN,NaN,-5.38765444675337,9.18119374366423
2021-05-13T09:30:00-04:00,319.92,322.4,316.9,319.34,69877765,47047639.25,37.46776831996224,49.5252616898722,NaN,NaN,-165.20887501914544,-169.0792408840412,-2.6971675492208527,-2.0078441310220114,0.6893234181988411,6259450557,6299172795.2,21.705314931340965,42.11387833897984,NaN,NaN,-8.756676585841516,6.618640839449123
2021-05-14T09:30:00-04:00,322.6,327.33,322.08,326.39,44370015,47223135.05,46.24807674276972,48.397641886374565,NaN,NaN,-87.2488373976841,-171.4992654231245,-2.152893410222477,-2.001793344579255,0.15110006564322187,6303820572,6277256565.4,19.618322630651562,39.27498735921122,NaN,NaN,-8.6509059396412,4.437277013864791
2021-05-17T09:30:00-04:00,324.63,326.3721,321.45,324.41,39394997,47466228.45,44.364005377282055,47.286761120079426,NaN,NaN,-88.60868393322241,-153.09694585461767,-1.8266312190040495,-2.13218895811184,-0.3055577391077905,6264425575,6259601428.6,18.10785414742857,36.24814893455199,NaN,NaN,-9.191054116788816,2.4903725666285617
2021-05-18T09:30:00-04:00,325.39,326.65,321.94,322.22,36528454,47388560.25,42.31086256442172,46.148126327326885,NaN,NaN,-83.65074655978997,-128.25818033239204,-1.663356343611241,-2.3847531686218417,-0.7213968250106008,6227897121,6249033323.4,17.251624021192626,33.38431163655797,NaN,NaN,-10.285170698067056,0.6652949573863307
2021-05-19T09:30:00-04:00,316.66,322.9,316.3,322.59,66319108,48874611.55,42.79256976930678,44.95216151747667,NaN,NaN,-102.76123445034729,-105.49567547203785,-1.4436335540132177,-2.5259387675271228,-1.082305213513905,6294216229,6269962010.8,24.831925665428273,30.92566268303227,NaN,NaN,-11.00708180788781,-1.0021874376528321
2021-05-20T09:30:00-04:00,324.12,329.71,323.89,328.83,46466135,48901111.15,50.32589468804007,44.53711176232576,NaN,NaN,-30.88605838271425,-78.6311121447516,-0.8221485175783072,-2.109990860486789,-1.287842342908482,6340682364,6286208372.2,30.178950296616804,29.035684645922498,NaN,NaN,-9.229666111927315,-2.177541533977758
2021-05-21T09:30:00-04:00,330.43,330.86,326.64,327.01,50330449,49596887.8,48.32697496711442,44.16889374486717,NaN,NaN,-19.71719814491935,-65.12478429419863,-0.49392248841470066,-1.9052454534268577,-1.411322965012157,6290351915,6283514640.8,29.800434319278523,27.57211661022161,NaN,NaN,-8.394847038698611,-3.0657280346521656
2021-05-24T09:30:00-04:00,329.37,333.67,326.9032,332.51,32475771,49680077.95,54.241882771553044,44.78148054571089,NaN,NaN,18.345860368172918,-43.73387543391958,0.10155937395241743,-1.2843737475716352,-1.3859331215240527,6322827686,6295195063,33.68447892052792,26.882625876527317,NaN,NaN,-5.74166456608812,-3.448004682000159
2021-05-25T09:30:00-04:00,334.07,334.81,331.755,332.97,31280314,49584734.5,54.708840276635,45.518969138632215,NaN,NaN,51.64914718885455,-16.673896684190673,0.5114633717556145,-0.7466039068295345,-1.258067278585149,6354108000,6320437238.8,41.249563844118896,27.168345934027062,NaN,NaN,-3.4913283134387947,-3.4541937722056786
2021-05-26T09:30:00-04:00,333.66,334.61,332.95,334.13,25444932,49176196.3,55.930176848741354,46.09239723160717,NaN,NaN,67.8487717633446,17.448104558547705,0.8270695505814762,-0.2242303403583037,-1.05129989093978,6379552932,6337504579.4,45.755433416938246,28.105848082436246,NaN,NaN,-1.2821075517805047,-3.143895740716368
2021-05-27T09:30:00-04:00,333.67,334.54,332.67,332.88,27931747,48687339.45,54.233018348653815,46.288544014980225,NaN,NaN,69.7702260901595,37.57936145312245,0.9113414573107939,0.08787693069871239,-0.8234645266120815,6351621185,6339692343.6,46.323722418252075,29.176309963703996,NaN,NaN,0.08256321971438528,-2.682973032083403
2021-05-28T09:30:00-04:00,334.12,335.5699,333.6,333.93,29927449,48270540.85,55.45575185546612,47.265775879020495,NaN,NaN,91.1329965854903,59.74940039920439,0.9909033466301338,0.4151646566755858,-0.575738689954548,6381548634,6357931687.4,50.93846539293396,30.732467092300332,NaN,NaN,1.5665919664106651,-2.075892318012822
2021-06-01T09:30:00-04:00,335.3,335.785,331.43,332.82,31145424,48341325.55,53.818814600515076,48.158057224729056,NaN,NaN,82.31391025982634,72.54301037753507,0.9232376995649133,0.5783084345015936,-0.34492926506331967,6350403210,6363446792.2,52.27458124954405,32.54223363878455,NaN,NaN,2.3858394991423717,-1.438502058419223
2021-06-02T09:30:00-04:00,333.25,334.34,331.695,333.47,22047940,46186373.95,54.6627623356543,49.6348142475797,NaN,NaN,74.48986506813081,77.11115395339031,0.8770546728465706,0.7513890759948936,-0.125665596851677,6372451150,6367115422.2,53.18784547685493,34.636322623650635,NaN,NaN,3.3006514751638973,-0.7614801250502058
2021-06-03T09:30:00-04:00,330.55,331.86,328.28,330,37057825,45728299.85,49.465726959140454,50.49181129323529,NaN,NaN,27.13313490365338,68.96802658145207,0.5818297670104257,0.6016216119113551,0.019791844900929417,6335393325,6358283500.8,50.67383856110086,36.70550288291921,NaN,NaN,2.7116198679907026,-0.26532298318721886
2021-06-04T09:30:00-04:00,331.85,336.0582,331.78,335.6,38736545,45324412.95,56.6317646090029,51.23350328368051,NaN,NaN,86.53099665095338,72.32018069361085,0.723486516581289,0.9241499906275408,0.2006634740462517,6374129870,6362785237.8,51.92126994035185,39.012856262183504,NaN,NaN,4.293821840168666,0.385983420149336
2021-06-07T09:30:00-04:00,335.05,336.66,334.34,336.6,32611852,44288782.55,57.78303343220929,52.192005287603884,NaN,NaN,103.47459442756434,74.78850026202566,0.8363361173891234,1.246083620782656,0.4097475033935326,6406741722,6367823855.4,53.34349240863699,41.52968756655554,NaN,NaN,5.93467463684443,1.1786535939629208
2021-06-08T09:30:00-04:00,338.395,339.29,335.03,336.76,27282819,42617900.4,57.97526056486064,53.31089085906381,NaN,NaN,105.64902886227986,79.45552398251637,0.8697011760982604,1.496873973516358,0.6271727974180977,6434024541,6384548121.6,57.8051324689789,44.426366741397416,NaN,NaN,7.334096887719177,2.0580026359281005
2021-06-09T09:30:00-04:00,338.17,338.97,336.651,336.84,21485319,40093985.75,58.07804417957139,54.40271045979699,NaN,NaN,102.35855125320846,85.02926121953189,0.8444101741725261,1.6826855151337554,0.8382753409612294,6455509860,6401159863.6,61.72073567642436,47.06128174218285,NaN,NaN,8.524660600492059,2.9818109165800943
2021-06-10T09:30:00-04:00,337.19,340.46,336.73,340.35,33702067,37220846.35,62.420825007317205,55.26663405403108,NaN,NaN,118.73685510624199,103.35000526004963,1.0006504912109357,2.089088454974899,1.0884379637639632,6489211927,6431923584,67.69886368085598,49.74127555534268,NaN,NaN,10.823913863460252,4.102111337562974
2021-06-11T09:30:00-04:00,340.36,341.25,339.69,341.24,21222830,34788099.6,63.45460149756854,56.34717880620637,NaN,NaN,134.14963880397713,112.87373369065438,1.0929977824534962,2.4546851918308334,1.3616874093773372,6510434757,6459184561.4,71.88847121859058,52.747563905293546,NaN,NaN,13.052147796133776,5.38068797450166
2021-06-14T09:30:00-04:00,341.68,344.52,340.46,344.51,27827716,33960984.65,67.04202284178542,57.26147452550868,NaN,NaN,158.39244627434434,123.85730406001039,1.28985204218625,2.9740024621101497,1.6841504199238997,6538262473,6485488711.6,75.22731539789437,55.71490936796258,NaN,NaN,16.09173240203844,6.910837178435485
2021-06-15T09:30:00-04:00,344.15,344.47,341.52,342.26,35963780,33789423.8,62.496100087614174,57.81770736915005,NaN,NaN,142.86406991893588,131.3003122713416,1.186676481562946,3.1674960218775823,1.9808195403146363,6502298693,6499143542,76.76976841507829,58.252066837316825,NaN,NaN,17.443354909937792,8.4154825686501
2021-06-16T09:30:00-04:00,342.74,343.84,337.45,341.01,55399538,34732978,60.059583154217,58.11266496239831,NaN,NaN,101.99411931784734,131.22742588426937,0.961969663537654,3.1832816197367038,2.2213119561990498,6446899155,6497421401,76.12598633606558,60.42139204582592,NaN,NaN,17.903007482515328,9.770843270630847
2021-06-17T09:30:00-04:00,339.97,346.38,339.92,345.34,59722700,34403157.6,65.13089058402255,58.8910844077818,NaN,NaN,137.437707927612,134.96759644854336,1.02677895118862,3.5047856451848247,2.4780066939962047,6506621855,6500903386.6,76.55409943787271,62.58070469008453,NaN,NaN,19.840895552251794,11.209422168005268
2021-06-18T09:30:00-04:00,343.63,344.8082,341.86,342.63,55414862,34850593.95,59.99638634532507,59.215415442771715,NaN,NaN,110.7362761956281,130.28492392687355,0.8180373248653967,3.5005533500779507,2.682516025212554,6451206993,6489057833.8,71.83476452192866,64.07329748501273,NaN,NaN,19.952256596987727,12.458398515002763
2021-06-21T09:30:00-04:00,342.43,344.69,340.15,344.36,32992649,33983703.95,62.05298979428298,59.80357081375514,NaN,NaN,99.43608965530149,118.49365260306497,0.7302678210212177,3.595350801489076,2.865082980467858,6484199642,6478245267.6,67.73032699907967,65.17727932426526,NaN,NaN,20.657056260201767,13.629635335745478
2021-06-22T09:30:00-04:00,344.15,348.03,343.84,347.57,28941626,33806996.7,65.5881047463368,60.58395241451818,NaN,NaN,137.05136782396613,117.33111218407103,0.8157080367192315,3.8847180263668974,3.069009989647666,6513141268,6480413782.6,68.12370059761518,66.24412611860528,NaN,NaN,22.353310258620933,14.875874610441972
2021-06-23T09:30:00-04:00,347.51,348.92,346.88,347.74,27188454,33602403.7,65.76997503851021,61.74854156304458,NaN,NaN,138.7185795861641,124.67600423773438,0.8093689700840532,4.080721202252732,3.271352232168679,6540329722,6499099896,71.36318967505025,67.72193691245882,NaN,NaN,23.77246149262405,16.14681559361084
2021-06-24T09:30:00-04:00,349.73,351.46,349.17,349.89,32581605,33959237.35,68.06848760728894,62.56545034863644,NaN,NaN,151.8032658867303,127.54911582955802,0.8703509904481068,4.3592909702288125,3.4889399797807057,6572911327,6512357790.4,73.42664588283654,69.25803519406486,NaN,NaN,25.66648739524989,17.506768708130704
2021-06-25T09:30:00-04:00,350.47,350.72,348.84,349.46,28682801,33996790.05,67.09805743029683,63.2308092056427,NaN,NaN,129.7731558244556,131.3564917553235,0.803698507030814,4.493563113569223,3.6898646065384093,6544228526,6530962097,76.03611117869545,70.87893653478332,NaN,NaN,26.957306920598555,18.856845595626112
2021-06-28T09:30:00-04:00,350.78,353.85,350.72,353.71,39130305,34456932.85,71.43304018020098,64.192079178167,NaN,NaN,152.2585722836375,141.9209882809907,0.9573760978511228,4.886584728852313,3.92920863100119,6583358831,6550793934.8,78.4638771879285,72.35456115756544,NaN,NaN,29.448308298508113,20.369911696037825
2021-06-29T09:30:00-04:00,353.53,355.0199,352.67,354.99,29426039,34370963.6,72.60378468359659,65.22963207131167,NaN,NaN,153.3081227745497,145.17233927110743,1.0493757621268731,5.240928333659781,4.191552571532908,6612784870,6570722655.2,80.59171193155582,73.70248803293198,NaN,NaN,31.872788162325428,22.01317976265034
2021-06-30T09:30:00-04:00,354.83,355.23,353.83,354.43,32723964,34904764.8,71.22843153677847,65.85874682341604,NaN,NaN,140.99547071736671,145.62771749734796,0.978077881467688,5.414149923367518,4.43607204189983,6580060906,6578668892,81.38162434296589,74.67982808022553,NaN,NaN,33.487136009419736,23.652316369331682
2021-07-01T09:30:00-04:00,354.07,355.09,352.68,354.57,29289978,34516372.45,71.37442515569144,66.42444851328197,NaN,NaN,119.53080962451406,139.1732262449047,0.8506089432964394,5.499333221020379,4.6487242777239395,6609350884,6585956803.4,82.1011449293932,75.40930477385429,NaN,NaN,34.860879317393085,25.25353964762617
2021-07-02T09:30:00-04:00,356.52,358.97,356.28,358.64,32727244,34215907.4,75.29855799099079,67.01420102393949,NaN,NaN,145.2949972965172,142.27759453931702,0.9434799158234028,5.828074172503193,4.88459425667979,6642078128,6605526723.8,83.90037929778381,76.0288093381321,NaN,NaN,37.29313310213159,26.97348156969837
2021-07-06T09:30:00-04:00,359.26,360.48,356.49,360.19,38842397,34527434.65,76.61341425215102,68.0225806071207,NaN,NaN,139.1638766432983,139.65865541124919,1.0066163314456045,6.142864670986796,5.136248339541192,6680920525,6625039062.6,85.46882070915579,76.6501702162805,NaN,NaN,39.74339419586742,28.797754802008235
2021-07-07T09:30:00-04:00,362.45,362.76,358.94,360.95,35265242,34926555.8,77.25278216313407,69.25066625061478,NaN,NaN,140.8907030314493,137.17517146262907,0.9950957509662928,6.380118028249058,5.385022277282765,6716185767,6645719242,86.92291708035637,77.42137955515841,NaN,NaN,41.968135102477824,30.67923770207532
2021-07-08T09:30:00-04:00,355.74,359.65,354.42,358.77,50890021,36396790.9,71.2366791598206,69.68679400602893,NaN,NaN,94.64142275131907,127.90436186941955,0.7474935834149106,6.319389256551403,5.571895673136493,6665295746,6662766210,87.98980752197373,78.23821584687992,NaN,NaN,42.18963172037093,32.32357970468898
2021-07-09T09:30:00-04:00,358.17,361.5,357.57,361.01,35184534,36470914.25,73.51868566890032,70.65267252914144,NaN,NaN,110.00344762022759,125.99888946856224,0.6452701505084084,6.3784833612720035,5.733213210763595,6700480280,6680992089.2,89.02112594250382,79.46581309120673,NaN,NaN,43.04106599732378,33.85464917506538
2021-07-12T09:30:00-04:00,362.45,362.89,360.83,362.42,25717677,36695656.6,74.87020592962584,71.56818796738023,NaN,NaN,118.2225042617124,120.58439086160129,0.5850866511260042,6.464571524671101,5.879484873545096,6726197957,6697816055,89.88460210119051,81.04826131278607,NaN,NaN,44.15097508325795,35.32555287623575
2021-07-13T09:30:00-04:00,362.03,365.465,361.54,362.42,39723015,37290421.55,74.87020592962584,72.23119519475802,NaN,NaN,117.44638058964549,116.24089165087071,0.4630914493020999,6.458349185172722,5.995257735870622,6726197957,6706871541.4,90.32564677030267,82.63411461083516,NaN,NaN,45.05762959280422,36.715849550031244
2021-07-14T09:30:00-04:00,364.83,365.49,362.22,363.07,35336350,37259050.05,75.53769477983303,72.92888946199535,NaN,NaN,112.24605432738578,110.51196191005799,0.34917506234140916,6.431726563797383,6.082551501455974,6761534307,6715941249.4,90.76018604859094,84.01961435180236,NaN,NaN,46.00364441391867,38.04267738772945
2021-07-15T09:30:00-04:00,362.98,363.19,358.46,360.52,53391557,37158651,67.91620291723908,72.91801198413465,NaN,NaN,75.64525977462839,106.71272931471985,0.041281640452263346,6.134153552021303,6.0928719115690395,6708142750,6724510650.2,91.16402073638399,85.28656969848431,NaN,NaN,44.705441136825534,38.99450078045746
2021-07-16T09:30:00-04:00,361.4,362.41,357.24,357.6,47261961,36535614.05,60.40089173377912,72.43964300581196,NaN,NaN,50.282259766482724,94.76849174397088,-0.3957591718467528,5.598172946760599,5.9939321186073515,6660880789,6716590752,87.36365816930362,86.09568019781348,NaN,NaN,41.27666228826615,39.32052385300155
2021-07-19T09:30:00-04:00,354.05,355.18,352.04,354.67,64404625,36985102.2,53.949804717015915,71.19084047272732,NaN,NaN,-21.687156867480084,66.78655951813239,-0.8905728263292563,4.880716085695781,5.771288912025037,6596476164,6690646393.4,76.16277331647913,85.93131563556709,NaN,NaN,36.21077657016168,38.87627424116729
2021-07-20T09:30:00-04:00,355.63,360.28,353.8,358.79,42183702,37444654.85,60.36084132561417,70.31634451858572,NaN,NaN,21.04577905640732,47.50643921148476,-0.9437141041074781,4.591646281890689,5.5353603859981675,6638659866,6673138775.2,69.67128671508155,85.15128526296179,NaN,NaN,33.70799030071497,38.13794796395981
2021-07-21T09:30:00-04:00,358.35,361.56,358.12,361.56,30259860,37510566.55,63.9906163260169,69.79935771781703,NaN,NaN,59.58727641403096,36.97468362881379,-0.8012408700072742,4.533809298489075,5.335050168496349,6668919726,6654615859,63.50431923418616,83.87433489804894,NaN,NaN,32.784634110884404,37.37318884209189
2021-07-22T09:30:00-04:00,361.77,363.96,361.77,363.95,30252240,37663755.85,66.81425824998419,69.47363151026649,NaN,NaN,104.46199550131657,42.738030774151426,-0.5660534541354858,4.627483350826992,5.193536804962478,6699171966,6652821702.2,62.923333768367264,82.50449124368996,NaN,NaN,32.943623729434954,36.74039382599804
2021-07-23T09:30:00-04:00,365.31,368.485,363.9157,368.2,31960799,37632715.55,71.14698106910608,69.17709030156043,NaN,NaN,159.1397915496787,64.50953713079068,-0.16509249324661912,4.987171188404204,5.152263681650823,6731132765,6666872097.4,65.57914092228262,81.19583135972559,NaN,NaN,34.576785948834896,36.43130698640331
2021-07-26T09:30:00-04:00,367.49,368.89,366.601,368.49,28438126,37620481.8,71.42116853378494,68.80621560739142,NaN,NaN,166.68019231246598,102.1830069667799,0.0664114084343499,5.235277942193761,5.168866533759411,6759570891,6699491042.8,70.80717124612583,80.14857068379489,NaN,NaN,35.931600024060785,36.35992027749723
2021-07-27T09:30:00-04:00,368.22,368.22,360.16,364.43,57933148,38560623.95,62.47070619371325,67.75035303814708,NaN,NaN,86.239478774972,115.22174691049284,-0.09819111137595549,5.046127644539467,5.144318755915423,6701637743,6712086618.2,72.54147955437058,79.12132514622445,NaN,NaN,34.11975977355699,36.03989734836291
2021-07-28T09:30:00-04:00,365.6,367.45,363.24,365.83,42066195,39192631.75,64.13956926736931,67.2434166172577,NaN,NaN,101.75033006149333,123.6543576399853,-0.1537684843898557,4.952108150428103,5.1058766348179585,6743703938,6727043460.6,74.48027795836546,78.15635874882388,NaN,NaN,33.195261309056534,35.63352077131915
2021-07-29T09:30:00-04:00,365.25,367.6794,365.25,366.48,25672533,38840060.2,64.91955280806881,66.62919284148403,NaN,NaN,108.9958785034299,124.56113424040798,-0.18561032821240708,4.87386372455245,5.059474052764857,6769376471,6741084361.6,76.18058135293674,77.23917699242622,NaN,NaN,32.692901441029605,35.2134322955635
2021-07-30T09:30:00-04:00,362.44,365.17,362.41,364.57,36484649,39199793.75,60.73892295823526,65.6198154863847,NaN,NaN,51.80984838817522,103.09514560810729,-0.3638561759921588,4.604653832774659,4.968510008766818,6732891822,6741436173,76.2233279123208,76.26337169322123,NaN,NaN,30.9903835064505,34.6101396114045
2021-08-02T09:30:00-04:00,366.28,366.88,363.87,364.6,27334097,38930136.4,60.78164265563266,64.61348953824232,NaN,NaN,68.77826532461047,83.51476021053618,-0.4998857056256307,4.3436528767347795,4.84353858236041,6760225919,6741567178.6,76.24042701317902,75.2572845677124,NaN,NaN,29.635257075724038,33.89944210630729
2021-08-03T09:30:00-04:00,365.28,366.93,362,366.81,35558511,38765942.1,63.89803746224724,63.78208544412905,NaN,NaN,65.24362816955262,79.3155900894523,-0.4620621244273142,4.265960926826267,4.728023051253581,6795784430,6760396516,78.62029947474517,74.39014981243771,NaN,NaN,29.357340332906933,33.250570424392954
2021-08-04T09:30:00-04:00,366.77,368.32,365.63,367.34,29602236,38482791.8,64.62404237071999,63.5469311193777,NaN,NaN,97.18478019928524,78.4024801170107,-0.4234140982476404,4.198755428444031,4.622169526691671,6825386666,6776733061.6,80.44996793466802,73.62486032660085,NaN,NaN,29.33185003666682,32.69075322614636
2021-08-05T09:30:00-04:00,368.18,369.91,367.45,369.67,21443925,37010487,67.69932528087395,64.06824780131305,NaN,NaN,130.91539495909998,82.7863834081447,-0.2704384780713607,4.28412142910247,4.5545599071738305,6846830591,6792223885.6,82.02116714704476,73.24325382501094,NaN,NaN,30.20032097565344,32.33497719036166
2021-08-06T09:30:00-04:00,368.37,369.37,366.905,368.05,33332107,36917865.65,63.562013115382896,64.75483411548213,NaN,NaN,100.87458455938467,92.5993306423866,-0.3052871597456077,4.172950957491821,4.478238117237429,6813498484,6808345218,83.50676330193303,73.76782453825766,NaN,NaN,29.751120026018768,31.96585473831268
2021-08-09T09:30:00-04:00,368.52,369.27,367.39,368.73,25960245,36929994.05,64.5415752071825,65.05345796416557,NaN,NaN,98.50443981445783,98.54456554035607,-0.3085572116093349,4.09254160272576,4.401098814335095,6839458729,6824191780,84.83338399690929,74.85083148695965,NaN,NaN,29.650964823327097,31.635156179029025
2021-08-10T09:30:00-04:00,369.26,369.56,365.62,366.84,35130796,36700383.1,59.7349150243155,64.74947929975833,NaN,NaN,67.37193109116545,98.97022612467863,-0.45517110027679575,3.8321349389890997,4.2873060392658955,6804327933,6825900480.6,84.97373243864347,76.38436100156373,NaN,NaN,28.190669384524085,31.14308663695689
2021-08-11T09:30:00-04:00,368.14,368.65,364.84,366.21,34249812,36646056.2,58.17953145374181,64.13271310002673,NaN,NaN,46.76362090597325,88.88599426601624,-0.6024967030899422,3.5341851604034673,4.1366818634934095,6770078121,6814838771.6,79.82390346809584,77.59154455154435,NaN,NaN,26.53487816244049,30.484771140597406
2021-08-12T09:30:00-04:00,365.69,367.9,364.295,367.53,26003877,35276672.2,60.500245942400994,63.3722320195478,NaN,NaN,42.90772443143675,71.28446016048358,-0.616727686694527,3.3657722551252505,3.9824999418197775,6796081998,6804689053,75.31367632356057,78.2868685087785,NaN,NaN,25.741797264552567,29.80720344401957
2021-08-13T09:30:00-04:00,367.89,369.16,367.38,368.82,19336190,33880383.65,62.67984551794731,62.747851804130825,NaN,NaN,81.85988714833205,67.48152067827306,-0.5473004125396721,3.2983744261451875,3.8456748386848596,6815418188,6805072993.8,75.37036787280746,78.61281112497004,NaN,NaN,25.660357660047012,29.21479690345206
2021-08-16T09:30:00-04:00,367.67,369.02,363.7,368.98,35044107,32412357.75,62.95290136486732,62.782294316356115,NaN,NaN,46.53518694335495,57.087670104052485,-0.4999438073516349,3.220745079495316,3.720688886846951,6850462295,6807273707,75.71463097649787,78.83946479797915,NaN,NaN,25.665565736809498,28.70776387964598
2021-08-17T09:30:00-04:00,366.15,367.15,363.23,365.73,44793902,32542867.75,54.267396014901486,62.07713908403698,NaN,NaN,-32.974672345363395,37.018349416746716,-0.6853819419421887,2.8639614594192153,3.549343401361404,6805668393,6807541799,75.75908250484773,78.93080797987072,NaN,NaN,23.152893992755615,27.914211038661644
2021-08-18T09:30:00-04:00,365.18,366.62,361.865,362.21,38541940,32956971.75,46.74496570660866,60.77895429107554,NaN,NaN,-129.1010354506791,1.8454181454162524,-1.0226789811516985,2.2709946749217806,3.293673656073479,6767126453,6806951465.4,75.43167091400579,78.87731437708995,NaN,NaN,18.479280024425695,26.566363750913652
2021-08-19T09:30:00-04:00,360.22,365.68,359.96,363.96,48499368,33869328.15,50.42429105246842,60.04219486923506,NaN,NaN,-145.93922338887,-35.9239714186451,-1.098826591044348,1.920140417268044,3.018967008312392,6815625821,6810860230,76.16615132653719,78.87323033524827,NaN,NaN,15.66904297440275,25.009603639983524
2021-08-20T09:30:00-04:00,365.06,368.14,364.74,367.73,39486034,34245589.9,57.27285320104563,59.791567051050265,NaN,NaN,25.43677702557551,-47.20859344319641,-0.8758828854254981,1.9241134015305192,2.7999962869560173,6855111855,6818798963.4,77.62895882945962,78.9724111792683,NaN,NaN,15.405142798388304,23.637537805469922
2021-08-23T09:30:00-04:00,368.8,373.935,368.79,373.23,34034744,34525420.8,64.89252240827435,59.8626016900522,NaN,NaN,228.52702010895823,-10.810226810075756,-0.36476074237786005,2.344045358983692,2.708806101361552,6889146599,6826535824.2,78.98279528671313,78.99830373726601,NaN,NaN,17.9382478992474,22.823353533152417
2021-08-24T09:30:00-04:00,373.84,374.99,373.36,374.37,21732913,32715409.05,66.23654316270402,59.97778031805107,NaN,NaN,257.0029192048623,47.18529149996938,0.02277854424857617,2.737279281672272,2.714500737423696,6910879512,6847578048,82.14723627201289,79.1195371899335,NaN,NaN,20.378128917504625,22.47403573091702
2021-08-25T09:30:00-04:00,374.63,375.39,373.855,374.8,20441880,31634193.3,66.75355425256726,59.91022524460059,NaN,NaN,212.68650139400887,115.54279886890697,0.2671805826642375,3.0484764657539927,2.781295883089755,6931321392,6880417035.8,85.75254295135566,79.38606403309856,NaN,NaN,22.45085560480614,22.47072428432975
2021-08-26T09:30:00-04:00,373.92,374.62,371.97,372.42,29133325,31807232.9,61.17030773217196,59.739389145799805,NaN,NaN,135.93937411405415,171.9185183694918,0.22911841430108026,3.0676939009661055,2.8385754866650252,6902188067,6897729485,87.21804815825854,79.65115580855039,NaN,NaN,22.41442342964712,22.462681305089376
2021-08-27T09:30:00-04:00,373.07,376.56,372.57,376.04,27104749,31338237.9,65.84907248665337,59.832781808619146,NaN,NaN,159.34865535755205,198.7008940358871,0.3983922108242579,3.336565750195348,2.93817353937109,6929292816,6912565677.2,88.32622705057372,79.90064459809786,NaN,NaN,23.951476879951343,22.675366387212513
2021-08-30T09:30:00-04:00,376.85,380.76,376.83,380.26,27295665,31336316.3,70.33632741936799,60.59002555112289,NaN,NaN,201.2264883399875,193.24078768209296,0.7261291431033237,3.8458349682502444,3.1197058251469207,6956588481,6926054053.6,89.23962883949307,80.20535148387282,NaN,NaN,26.8634929518286,23.27367018215767
2021-08-31T09:30:00-04:00,380.51,380.579,378.36,379.95,29628175,31039799.5,69.61272369570113,61.40668213983428,NaN,NaN,166.66116383948273,175.17243660901704,0.845258175091387,4.176278544011154,3.3310203689197673,6926960306,6929270212.4,89.45156312250307,80.89304145918761,NaN,NaN,28.876896634988427,24.074131103990634
2021-09-01T09:30:00-04:00,381.04,382.71,380.37,380.58,28138311,30966603.25,70.28184745575885,62.10536796221698,NaN,NaN,158.3671284055259,164.30856201132048,0.8854529655049297,4.4378365758009295,3.552383610296,6955098617,6934025657.4,89.77232965323405,81.92580241130715,NaN,NaN,30.694583292993272,25.01990998813387
2021-09-02T09:30:00-04:00,381.97,382.31,379.15,380.4,25503535,31169583.75,69.80886839562154,62.61458388205086,NaN,NaN,127.1362178836265,162.54793076523492,0.8203557910682586,4.577828349131323,3.7574725580630646,6929595082,6939507060.4,90.14435393822211,82.98108713026534,NaN,NaN,32.01868371131077,26.019734805730568
2021-09-03T09:30:00-04:00,379.22,381.98,379.2003,381.57,24624937,30734225.25,71.16713368775275,63.20131476225697,NaN,NaN,114.68076929347382,153.6143535524193,0.776960243724937,4.728672862719236,3.951712618994299,6954220019,6944492501,90.48341068697694,84.03599996672813,NaN,NaN,33.5275968142556,27.092286521234143
2021-09-07T09:30:00-04:00,381.68,382.778,380.4882,382.11,23970203,30634723.15,71.79777322359911,64.45348456287823,NaN,NaN,110.77619753100927,135.52429539062365,0.7074657443492871,4.836044799430908,4.128579055081621,6978190222,6948812849.2,90.77944644789126,85.10888310551695,NaN,NaN,34.9597517118877,28.216210119898935
2021-09-08T09:30:00-04:00,381.93,381.93,378.45,380.78,32949159,30525641.3,67.86086465256707,65.96176305901811,NaN,NaN,85.26273940349476,119.24461050342605,0.5043044550759488,4.7589596239265575,4.254655168850609,6945241063,6952469000.6,91.03364261542909,86.22330965561862,NaN,NaN,35.110727459902755,29.201141168470908
2021-09-09T09:30:00-04:00,381.01,382.15,379.22,379.47,29398978,30283099.6,64.13080819585412,66.94079999783138,NaN,NaN,76.4686571383472,102.8649162499903,0.22814040335560648,4.539830673045117,4.31169026968951,6915842085,6944617694.2,85.57763789877403,86.89555869649267,NaN,NaN,34.20622651013603,29.916153360137354
2021-09-10T09:30:00-04:00,381.23,381.97,376.245,376.59,40249405,30995376,56.74603121317931,66.90316985584091,NaN,NaN,48.23875756681404,87.08542418662782,-0.18001709995847115,4.086668894741422,4.266685994699893,6875592680,6933817213.8,78.59892617043928,86.96484207799122,NaN,NaN,31.205304198648854,30.100317765638998
2021-09-13T09:30:00-04:00,378.99,379.43,374.22,376.33,48741781,32465655.55,56.11777519164377,66.27640219751017,NaN,NaN,24.831672310228647,69.11560478997879,-0.48189667623453936,3.6643151494067183,4.146211825641258,6826850899,6908343389.8,65.11203154734483,85.97407323946491,NaN,NaN,28.566420823507173,29.881189631048738
2021-09-14T09:30:00-04:00,377.86,378.61,374.28,375.26,41826624,32804781.4,53.49299353384745,65.36614865259183,NaN,NaN,12.339148783599068,49.42819504049673,-0.7519322482575133,3.206296515319366,3.958228763576879,6785024275,6869710200.4,50.858819925728305,83.73918635758744,NaN,NaN,25.570070269618,29.265315436558634
2021-09-15T09:30:00-04:00,375.73,378.41,373.37,378.05,34097865,32269979.55,58.89211369622456,64.80461718428164,NaN,NaN,13.821214247949877,35.13989000938776,-0.7398029164072875,3.03347511806777,3.7732780344750574,6819122140,6844486415.8,44.074947661316635,80.76221526544181,NaN,NaN,24.406527739724453,28.571202908439464
2021-09-16T09:30:00-04:00,376.68,378.9,374.695,378.31,35193083,32102536.7,59.36554058628623,64.6757052452898,NaN,NaN,16.584076064529228,23.16297379462417,-0.7112264578356888,2.8842449621804462,3.595471420016135,6854315223,6832181043.4,41.188544299240085,77.4743935612262,NaN,NaN,23.585098055399705,27.85890221514807
2021-09-17T09:30:00-04:00,377.82,377.87,372.76,373.83,60912267,32723181.65,48.912612071035575,63.465958072745686,NaN,NaN,-48.30747735101718,3.853726811057919,-0.9747139815796086,2.3770789430416244,3.351792924621233,6793402956,6815743098.6,37.6422242017455,73.85410764345275,NaN,NaN,19.49629426219128,26.664243936154243
2021-09-20T09:30:00-04:00,367.46,369.25,360.93,365.7,76203202,34559040.05,36.39025963477333,61.041238945274635,NaN,NaN,-252.5693487152567,-51.62647739403915,-1.638162002438273,1.3040904215733917,2.9422524240116648,6717199754,6793812869.6,33.498361246690436,69.87258852968114,NaN,NaN,10.630234070462976,24.373671098198347
2021-09-21T09:30:00-04:00,367.58,368.81,364.99,366.15,41927483,34953677,37.346391532427624,58.73650093361224,NaN,NaN,-199.73209212851356,-94.04072557646167,-1.9662292146914822,0.48446590564731196,2.450695120338794,6759127237,6788633462,32.58596743185784,65.81076026606362,NaN,NaN,4.29166138087076,21.50481256715155
2021-09-22T09:30:00-04:00,367.09,371.07,365.9584,369.57,46972920,36215677.35,44.20994820939042,56.8742224160145,NaN,NaN,-136.9172179839413,-124.18841202283991,-1.8728685124990772,0.10960947971494761,1.9824779922140248,6806100157,6786029065.4,32.11233399294814,61.69218914747177,NaN,NaN,1.373648227289949,18.62893194717132
2021-09-23T09:30:00-04:00,370.76,374.04,370.099,372.98,44652002,37426183.45,50.0817990732094,55.4651460358422,NaN,NaN,-68.23235796793685,-141.15169882933313,-1.5166286106836386,0.08669222885947647,1.603320839543115,6850752159,6785316452.6,31.975385044247048,57.53726279790213,NaN,NaN,1.0366860507720543,16.115753961971425
2021-09-24T09:30:00-04:00,370.65,373.76,370.27,373.33,36056800,37772357.2,50.65585241797161,54.00005451657212,NaN,NaN,-65.76423340667522,-144.64305004046474,-1.2061211515684014,0.09566940008261327,1.3017905516510146,6886808959,6803997653.2,39.285363217462006,53.880259407222475,NaN,NaN,0.9687434874804666,13.951895322758432
2021-09-27T09:30:00-04:00,370.2,371.2516,367.73,370.35,43338079,38584023.7,45.82394398652979,52.144780999638606,NaN,NaN,-99.35142391393063,-113.99946508019953,-1.1503190420842924,-0.13610825095435075,1.0142107911299416,6843470880,6829251878.4,47.49893487904027,50.7887942951617,NaN,NaN,-0.688142983834891,11.860461278959386
2021-09-28T09:30:00-04:00,365.67,370.302,359.35,359.87,97701632,42104322.05,33.66291157825205,49.70207006575896,NaN,NaN,-166.95425599699655,-107.44389785389612,-1.7330972189240705,-1.1521607325251466,0.5809364863989239,6745769248,6826580280.6,46.777990234790344,47.62767626797321,NaN,NaN,-7.159852970561334,9.143273529027855
2021-09-29T09:30:00-04:00,361.17,363.37,358.635,359.28,58076621,43526744.35,33.12985545818846,47.48771629878284,NaN,NaN,-168.2362656272586,-113.70770738255958,-2.0504681785623333,-1.9821487368039925,0.0683194417583406,6687692627,6802898774.6,40.85803469205542,44.43341889606474,NaN,NaN,-12.108123562062916,6.1073596588720305
2021-09-30T09:30:00-04:00,360.97,362.68,357.1,357.96,61384577,45189057.65,31.91230752198892,45.71387889226925,NaN,NaN,-154.88006544785725,-131.03724887854364,-2.226763388956914,-2.7151347944378017,-0.488371405480888,6626308050,6758009952.8,32.469807681403864,41.13848186113364,NaN,NaN,-16.36380224719809,2.8971936722905847
2021-10-01T09:30:00-04:00,358.6,361.25,354.38,360.18,56375488,46732655.3,36.16155985126092,44.288434939384764,NaN,NaN,-139.6510169043831,-145.81460557808524,-2.0744035924681743,-3.081375896066106,-1.0069723035979317,6682683538,6717184868.6,27.03386979053441,38.41861316421862,NaN,NaN,-18.392290231139715,-0.14416117105660042
2021-10-04T09:30:00-04:00,358.52,358.86,350.32,352.62,76766005,49339708.7,29.426568649100574,42.56940459047427,NaN,NaN,-159.50300315552298,-157.8449214264037,-2.3434449238059205,-3.936278458355332,-1.5928335345494116,6605917533,6669674199.2,22.345395318779183,36.38193997800796,NaN,NaN,-22.704617111110323,-3.367083448207132
2021-10-05T09:30:00-04:00,353.71,359.69,353.48,357.38,47232904,50502843.75,37.339761680908154,41.02995087509453,NaN,NaN,-116.91976542641568,-147.8380233122875,-2.070933923765234,-4.181500939255955,-2.1105670154907203,6653150437,6651150437,20.828667813269902,34.7214914174332,NaN,NaN,-23.32722447773411,-6.218532166710986
2021-10-06T09:30:00-04:00,354.08,359.95,353.15,359.67,56806536,51695712.6,40.78002705061011,39.702414193974796,NaN,NaN,-98.01469594343679,-133.79370937552318,-1.6261834432643547,-4.143296319571164,-2.517112876306809,6709956973,6655603306.2,22.195823134983613,33.36486847712917,NaN,NaN,-22.593030344373588,-8.557746192091358
2021-10-07T09:30:00-04:00,362.8,365.69,362.25,362.97,39411172,52196322.3,45.42967017920003,39.45363263027226,NaN,NaN,-36.70358703383686,-110.1584136927191,-1.028628906881365,-3.802899009908515,-2.77427010302715,6749368145,6680215325.2,29.447740071834602,32.77954818213554,NaN,NaN,-20.372228148521803,-10.245529328724277
2021-10-08T09:30:00-04:00,364.08,364.3166,360.61,361.16,41822309,52274967.5,43.416167469148,39.95548318987045,NaN,NaN,-46.7812503610894,-91.58446038406035,-0.6903883535464153,-3.637255544960169,-2.946867191413754,6707545836,6685187784.8,30.8500704926945,32.59038455685011,NaN,NaN,-19.270492010922293,-11.534809711895422
2021-10-11T09:30:00-04:00,359.58,363.2,358.3,358.39,34847182,51580237.55,40.46066371807574,40.17793120313103,NaN,NaN,-61.71599685038554,-72.02705912303286,-0.5921033323172007,-3.686996356810255,-3.094893024493054,6672698654,6698544009,34.60973951281734,32.73493970549008,NaN,NaN,-19.320430842533202,-12.647041301986533
2021-10-12T09:30:00-04:00,359.88,360.33,356.48,357.14,43905101,51684161.4,39.164997713617566,39.81757759629011,NaN,NaN,-76.32413597717601,-63.90793323318492,-0.5510176808543688,-3.783665125561015,-3.2326474447066462,6628793553,6693672632.2,33.886083858917246,32.86163612448787,NaN,NaN,-19.762434551943237,-13.663526051980348
2021-10-13T09:30:00-04:00,359.51,360.69,357.43,360,40120795,51985307.9,43.6140894708694,39.35559833898011,NaN,NaN,-55.88770758298273,-55.482535561094096,-0.28439078492104697,-3.588135925857955,-3.303745140936908,6668914348,6685464107.2,32.647345491275146,32.90963329927559,NaN,NaN,-18.745173755467835,-14.389475723907132
2021-10-14T09:30:00-04:00,363.69,366.85,363.01,366.63,43433867,52397347.1,52.31952639477707,39.47443219446621,NaN,NaN,28.434979292385997,-42.45482229584952,0.3508647478393163,-2.865164206137763,-3.216028953977079,6712348215,6678060121.2,31.527811758468985,32.35552248077609,NaN,NaN,-14.877342739122183,-14.459171011794997
2021-10-15T09:30:00-04:00,367.88,369.06,366.82,368.94,40419878,51372727.65,54.93040548953569,40.12489373039521,NaN,NaN,76.65211987778939,-17.76814824807376,0.9073764244767681,-2.081808423381119,-2.9891848478578873,6752768093,6687104572.6,34.48338732851623,31.425840512881518,NaN,NaN,-10.882169757233829,-13.948170832571973
2021-10-18T09:30:00-04:00,367.61,372.87,366.99,372.65,34513514,49288243.25,58.82962460037245,41.9225160891181,NaN,NaN,103.67059118151282,15.309169358305912,1.4726363508671643,-1.148389409273932,-2.6210257601410962,6787281607,6710021163.2,41.38696948583972,31.040767602242187,NaN,NaN,-6.228999138186194,-12.84543201908829
2021-10-19T09:30:00-04:00,373.75,375.52,372.6974,375.47,29090963,48646417.25,61.55246609454361,43.95270256314346,NaN,NaN,137.12305868817444,57.998608291376,1.9535934944066882,-0.17903389213273613,-2.1326273865394243,6816372570,6747536966.6,50.569582269239795,31.73444957204107,NaN,NaN,-1.4974478279572596,-11.224291420355286
2021-10-20T09:30:00-04:00,375.94,376.565,373.46,374.98,31390338,47867288.15,60.8000242474227,46.01611090067444,NaN,NaN,129.70391465735068,95.11693273944269,2.140809616681746,0.5433846343127584,-1.5974249823689877,6784982232,6770750543.4,55.24213246856173,33.3610441996952,NaN,NaN,2.0324540770160993,-9.330470635016516
2021-10-21T09:30:00-04:00,374.16,377.47,373.85,377.27,25469277,46908151.9,63.07201805707791,47.93828648680422,NaN,NaN,136.06395085019497,116.64272705100447,2.3066341463032214,1.285867700510039,-1.0207664457931824,6810451509,6790371202.2,58.78812844937201,35.62920553246932,NaN,NaN,5.691066154197893,-7.184536807985886
2021-10-22T09:30:00-04:00,375.98,376.97,372.385,374.1,36275822,46919103,58.0558104682692,49.98323233103056,NaN,NaN,113.01921018161543,123.9161451117697,2.096656313970741,1.6000539466702435,-0.4966023673004972,6774175687,6794652721,59.54139504644763,38.28606265587421,NaN,NaN,7.32627566264854,-5.111563597895254
2021-10-25T09:30:00-04:00,375.56,378.87,373.56,377.93,32597804,46382089.25,61.989224800065884,51.74390826811326,NaN,NaN,125.945703294238,128.37116753431474,2.104085169483949,2.1335040945544392,0.029418925070490154,6806773491,6798551097.8,60.25374472278467,41.102139577982406,NaN,NaN,9.966596310665656,-2.957540753815124
2021-10-26T09:30:00-04:00,380.23,382.71,377.905,379.12,47191279,43856571.6,63.14565508229926,53.34145312751962,NaN,NaN,133.67309810583734,127.68117541784731,2.0741166239972793,2.622064705067089,0.54794808106981,6853964770,6806069537.8,61.65594165332684,43.92071947214978,NaN,NaN,12.469432566014799,-0.7536874224108492
2021-10-27T09:30:00-04:00,379.58,383.15,379.31,380,45760496,43240765.35,64.0174710251699,54.669153187946044,NaN,NaN,122.24581170953843,126.18955482828486,1.9977683056268307,3.0451584631033484,1.0473901574765176,6899725266,6829018144.6,65.64044005994985,46.50591232844373,NaN,NaN,14.77909127162341,1.4652809624511876
2021-10-28T09:30:00-04:00,381.95,384.48,381.155,384.22,38007005,42071886.75,67.93475563872974,56.420480914344736,NaN,NaN,125.51366037051632,124.07949673234911,2.104950028222353,3.678577692754459,1.573627664532106,6937732271,6854474297,69.43468666147618,49.26195634049956,NaN,NaN,18.02719842299851,3.8312691711008044
2021-10-29T09:30:00-04:00,381.06,386.28,380.7,386.11,37310116,41118618.15,69.53444820984144,58.49717980661371,NaN,NaN,119.17102617366591,125.30985993075922,2.1680534183227493,4.283694437435543,2.1156410191127932,6975042387,6894647637,74.26459444340534,52.0944459783987,NaN,NaN,21.228340906120238,6.316565133246438
2021-11-01T09:30:00-04:00,386.56,387.56,384.42,387.43,30765303,38818583.05,70.6362666978708,60.74512759120323,NaN,NaN,123.62365147298651,124.84544956650893,2.1589038789033053,4.814270867741925,2.6553669888386198,7005807690,6934454476.8,77.97799126317506,55.243867935845685,NaN,NaN,24.216958791934967,8.873764227344799
2021-11-02T09:30:00-04:00,386.8,389.54,386.75,389.05,25135292,37713702.45,71.97581908198646,62.770965420568736,NaN,NaN,126.38919989042353,123.38866992342616,2.1191719575119032,5.304331935728499,3.1851599782165954,7030942982,6969850119.2,80.6514070802942,58.67272947791848,NaN,NaN,27.13181470757005,11.482057153091263
2021-11-03T09:30:00-04:00,389.55,393.61,388.48,393.18,33748901,36560820.7,75.09509020236936,64.39779140682532,NaN,NaN,140.58675483941585,127.05685854940164,2.217706719179689,5.957293377191206,3.7395866580115174,7064691883,7002843442.6,82.7531531246328,62.33168243264446,NaN,NaN,30.691546326002054,14.22626989207852
2021-11-04T09:30:00-04:00,394.48,399.2,393.92,398.22,40265313,36603527.75,78.27327810250813,66.06513945060907,NaN,NaN,161.49150603271238,134.25242768184086,2.4507584759556504,6.80303475295608,4.3522762770004295,7104957196,7036288427.6,84.5815150821779,65.91012012933457,NaN,NaN,34.90566104402403,17.180468628070734
2021-11-05T09:30:00-04:00,400.04,400.99,397.16,398.6,43383802,36681602.4,78.49609578721656,67.4698873925265,NaN,NaN,152.58355933080415,140.9349343132685,2.4529298333537195,7.418438568692579,4.96550873533886,7148340998,7070948149.8,86.21272435851978,69.11195976309745,NaN,NaN,38.34118581341517,20.20342822597708
2021-11-08T09:30:00-05:00,398.57,399.62,397.4,398.06,29256270,36402056.8,77.28316725965132,68.59350890431992,NaN,NaN,132.58625093478668,142.72745420562853,2.245973029196419,7.772975021834384,5.527001992637965,7119084728,7093603557.4,87.16833807943041,71.7261566066825,NaN,NaN,40.80676921458116,23.146762652920522
2021-11-09T09:30:00-05:00,399.16,399.57,393.92,395.32,50490720,36731337.75,71.26575800964115,69.34106131590694,NaN,NaN,107.10344357454238,138.8703029424523,1.7732698752697145,7.743589336725108,5.970319461455394,7068594008,7101133762.6,87.47898221913823,74.02878873172367,NaN,NaN,41.216113969592946,25.728098555302296
2021-11-10T09:30:00-05:00,392.47,395.36,387.53,389.51,54937385,37472167.25,60.50745490826811,69.1578782338491,NaN,NaN,60.68344557159078,122.88964108888732,0.9588200694420799,7.168844548257994,6.210024478815914,7013656623,7090926710.6,84.49305332996954,75.8648547946235,NaN,NaN,38.17947338231954,27.506866387733332
2021-11-11T09:30:00-05:00,392.57,392.75,390.24,390.59,32242983,36912623.05,61.66591292283503,69.41574269488952,NaN,NaN,57.0809805664968,102.00753599564419,0.41038324638788914,6.723003536800775,6.312620290412886,7045899606,7079115192.6,81.04562392763054,77.40087114327942,NaN,NaN,36.05522278981624,28.728060159459464
2021-11-12T09:30:00-05:00,391.77,395.25,390.13,394.7,34730564,36628157.35,65.77978395485476,69.68649692023158,NaN,NaN,67.44511014620157,84.97984615872367,0.2498603468585845,6.624945723986116,6.375085377127531,7080630170,7065573027,77.15852681095143,78.60835557814846,NaN,NaN,35.451929299183185,29.68861289370571
2021-11-15T09:30:00-05:00,395.91,396.24,392.095,394.61,33716861,36588324.7,65.61373136452535,69.86278808324774,NaN,NaN,69.01522361222288,72.26564069421092,0.07228558479180425,6.465442358117286,6.393156773325482,7046913309,7051138743.2,73.1323121259623,79.42809632619387,NaN,NaN,34.92223205706869,30.436272774186136
2021-11-16T09:30:00-05:00,393.86,397.93,393.66,397.42,27872940,36527423.55,68.30406004381234,70.16897301315076,NaN,NaN,79.81017071453162,66.80698612220877,0.0782382796934975,6.490954622942354,6.4127163432488565,7074786249,7052377191.4,73.26123253523672,79.97243864585721,NaN,NaN,35.256572981907404,31.124887089574887
2021-11-17T09:30:00-05:00,397.75,399.7196,396.64,397.63,28703263,36393069.8,68.50239328254276,70.20951855913741,NaN,NaN,88.3254797078487,72.33539294946036,0.032806132210910555,6.453724008512495,6.420917876301584,7103489512,7070343769.2,75.12593819791118,80.37895661274543,NaN,NaN,35.58381300053574,31.76187650542644
2021-11-18T09:30:00-05:00,399.73,402.27,397.45,401.75,45721515,37405681.7,72.18034641523218,70.39851128809389,NaN,NaN,105.17836638715937,81.95487011359288,0.20700088297153574,6.679668980016004,6.472668097044468,7149211027,7091006053.4,77.10352344161097,80.5817372554744,NaN,NaN,36.971990490739756,32.50617850332834
2021-11-19T09:30:00-05:00,403.43,405.3,402.58,403.99,45191721,37851476.65,73.96065074130416,70.63596729119627,NaN,NaN,133.75642129013258,95.21713234237907,0.3892729371314383,6.959259268458766,6.5699863313273275,7194402748,7113760569,79.07639563033848,80.66019471027178,NaN,NaN,38.68402435674405,33.388727910959155
2021-11-22T09:30:00-05:00,405.57,408.71,399.19,399.3,61715370,39307354.95,64.63423726917772,70.11156859028135,NaN,NaN,109.25726248820648,103.26554011757578,0.12390904428732519,6.724872636686484,6.600963592399159,7132687378,7130915382.8,80.4444502048841,80.64541207631392,NaN,NaN,37.281945433652474,33.94490184277249
2021-11-23T09:30:00-05:00,398.11,400.23,392.92,397.48,70098736,40452727.8,61.39862965579308,69.13324997981162,NaN,NaN,40.5681935292765,95.41714468052476,-0.22523929285305666,6.319414476332838,6.544653769185895,7062588642,7128475861.4,79.64693440723698,80.42353931078564,NaN,NaN,35.118280951176644,34.11252742968737
2021-11-24T09:30:00-05:00,394.93,399.05,392.54,398.76,46954382,40512422.1,62.80875338618331,68.02864107150269,NaN,NaN,33.25868696725278,84.40378613240559,-0.4102510399863455,6.031839969202963,6.442091009189308,7109543024,7129686563.8,79.75420864027043,80.07873170779224,NaN,NaN,33.751483947479954,34.060949789372025
2021-11-26T09:30:00-05:00,396.11,397.54,389.77,391.2,51533314,41188737.55,50.96646749076163,66.06223905032735,NaN,NaN,-34.37425430246712,56.49326199448028,-1.045899633897986,5.134716466816826,6.180616100714812,7058009710,7111446300.4,73.47128732390718,79.16862906246277,NaN,NaN,28.4433438484678,33.258434654957135
2021-11-29T09:30:00-05:00,395.89,400.73,395.14,399.69,54447106,42045587.05,60.07128558487269,64.8328189307003,NaN,NaN,52.81652817230192,40.30528337091415,-0.9040196023285239,5.050591597804157,5.954611200132681,7112456816,7095057114,68.26735032552077,77.81855850861209,NaN,NaN,26.917934018888623,32.35264884980449
2021-11-30T09:30:00-05:00,398.78,401.19,391.75,393.82,81332693,44573956.55,52.77471065673521,63.512029834064165,NaN,NaN,-11.51507923068915,16.150815027135017,-1.1965984861242465,4.4588630924773724,5.655461578601619,7031124123,7074744463,62.37090442903331,76.02512438074744,NaN,NaN,22.911853407307937,31.003963786590695
2021-12-01T09:30:00-05:00,398.28,400.48,386.64,387.12,78379245,47236154.2,45.9188153056092,62.46998414815995,NaN,NaN,-112.08744469466438,-14.380312617653193,-1.7963917036225343,3.4099719490734515,5.206363652695986,6952744878,7052775710.2,56.66987832026718,74.03775473719728,NaN,NaN,16.952060969741584,28.996549098469394
2021-12-02T09:30:00-05:00,385.8,391.74,384.34,389.91,84416623,49769540.3,48.896009844494856,61.557848213992806,NaN,NaN,-161.65889643790555,-53.363829298684855,-1.947574792487468,2.7718951620866505,4.7194699545741186,7037161501,7038299405.6,53.21791749798986,72.05006142079436,NaN,NaN,13.42679528878336,26.772298554228534
2021-12-03T09:30:00-05:00,391.31,392.34,378.9,383.13,105349104,53023729.85,42.73868152920494,59.912055183589246,NaN,NaN,-195.0959952063422,-85.50817747945987,-2.4159486022400154,1.6995342017740995,4.115482804014115,6931812397,7013059943,47.75596095123689,69.94987814510047,NaN,NaN,8.184062419761407,24.116836249304658
2021-12-06T09:30:00-05:00,383.63,387.6,379.3,386.2,67588801,54233979.8,46.05145681690639,58.51474985875932,NaN,NaN,-168.46056650812517,-129.7635964155453,-2.4244680576166564,1.0848977319932942,3.5093657896099506,6999401198,6990448819.4,43.45327541389395,67.8299469513813,NaN,NaN,5.252962467548969,21.421997137625276
2021-12-07T09:30:00-05:00,393.03,398.46,392.99,397.83,56005264,55571429.5,56.35316826536913,57.66111473172766,NaN,NaN,29.087115961127946,-121.64315737718186,-1.5925080531991673,1.5187307231109912,3.1112387763101585,7055406462,6995305287.2,44.607645064575486,65.78326213204836,NaN,NaN,6.618199381786996,19.307168886791235
2021-12-08T09:30:00-05:00,398.17,399.82,396.22,399.61,39204041,55007095.55,57.68499886051613,56.88844370158291,NaN,NaN,60.79209227309862,-87.06724998362927,-0.9023388649754671,1.9833151950908245,2.8856540600662917,7094610503,7023678412.2,50.912559221123814,64.05373506227785,NaN,NaN,8.125691733427768,17.709815007739312
2021-12-09T09:30:00-05:00,398.35,400.2,393.5299,393.73,49973714,54758912,52.0363439224754,55.449586380671704,NaN,NaN,13.319881675126744,-52.071494361022815,-0.8240079147403132,1.8556441666409,2.6796520813812132,7044636789,7025173469.8,51.22757992070935,62.205453382213435,NaN,NaN,7.345976511062828,16.229266651071242
2021-12-10T09:30:00-05:00,396.62,398.28,393.36,398.01,52545767,55774051.2,55.45556175539526,54.12779431024965,NaN,NaN,22.26646147227071,-8.599003025300235,-0.4830060115421868,2.0758945669534796,2.5589005784956664,7097182556,7058247501.6,57.69555839987207,60.67825072289441,NaN,NaN,7.917192235500659,15.041827448846874
2021-12-13T09:30:00-05:00,398,398.325,391.88,392.26,50166410,56545843.5,50.27068917613352,53.101826589317916,NaN,NaN,-21.46732778661142,20.799644719002522,-0.6342332267422304,1.7661090450678785,2.400342271810109,7047016146,7067770491.2,59.36645593171369,59.17267970338224,NaN,NaN,6.5876523738178125,13.83408815241415
2021-12-14T09:30:00-05:00,387.3,390.09,383.63,388.2,75199181,58619959.5,46.933944999487714,52.06863482815324,NaN,NaN,-123.72417482298914,-9.762613437820903,-0.9767551391118827,1.1793983479202552,2.156153487032138,6971816965,7051052591.8,55.241472770356616,57.42943244360506,NaN,NaN,4.381974215198023,12.483786161383275
2021-12-15T09:30:00-05:00,387.94,397.4198,383.88,397.05,73858028,60919213.9,54.08777096690208,51.445707512490294,NaN,NaN,-32.07916327357919,-28.336864547156473,-0.5951090346108989,1.412267193768514,2.007376228379413,7045674993,7041265489.8,52.92309920588256,55.51292462686307,NaN,NaN,5.003261228581755,11.415139742411629
2021-12-16T09:30:00-05:00,398.04,398.475,385.21,386.84,82591368,63613619.15,46.32825448009806,51.114406583157184,NaN,NaN,-65.3774757130464,-44.076336024791104,-0.9945832645361741,0.7641471477091955,1.7587304122453695,6963083625,7024954857,49.216066263211665,53.78040883681338,NaN,NaN,2.6812560576767304,10.167442073163787
2021-12-17T09:30:00-05:00,383.33,389.19,381.77,384.91,81642848,65409685.8,45.01364721071507,50.03886098500307,NaN,NaN,-123.1135520457229,-73.15233872838982,-1.3320303751780096,0.09369244327285742,1.425722818450867,6881440777,6981806501.2,41.028655396299136,51.83478777044041,NaN,NaN,0.4528515590517098,8.779643428290633
2021-12-20T09:30:00-05:00,379.565,381.5,377.47,380.69,65336827,66416941.1,42.194329574567476,49.28311947913395,NaN,NaN,-175.41860121597065,-103.94259341426167,-1.7560170374485455,-0.7692984783598149,0.9867185590887306,6816103950,6935624062,34.427212817710284,49.838809798203044,NaN,NaN,-2.2930380733417306,7.197831785200296
2021-12-21T09:30:00-05:00,384.05,389.53,380.201,389.21,48899477,65776146.45,49.122764433511556,49.511972988269825,NaN,NaN,-76.26730907561542,-94.45122026478693,-1.394979577618234,-0.757005912934062,0.637973664684172,6865003427,6914261354.4,31.872555979014038,48.067572488113534,NaN,NaN,-2.258925027967966,5.8468665261762585
2021-12-22T09:30:00-05:00,388.91,394.16,388.23,393.95,37042200,64123319.65,52.53150235907407,49.77165102502549,NaN,NaN,10.429134645839852,-85.9495606809031,-0.7988817153280626,-0.36062847947590626,0.43825323585215636,6902045627,6885535481.2,28.77996429653004,46.32200440229497,NaN,NaN,-1.078013212312211,4.857597992106477
2021-12-23T09:30:00-05:00,394.31,398.425,394.14,396.92,29595536,63255377.35,54.58471957926598,50.61779660002984,NaN,NaN,76.42742470640435,-57.58858059701295,-0.19783743352988764,0.19095644393979683,0.38879387746968447,6931641163,6879246988.8,28.136341667914095,44.920603024914776,NaN,NaN,0.5360629603794578,4.240235844716903
2021-12-27T09:30:00-05:00,398.25,403.48,398.2194,403.48,32820705,62319746.9,58.82146506877032,51.52994004659155,NaN,NaN,136.04736386887492,-5.756397414093385,0.6043557583921679,1.1442385754598945,0.5398828170677266,6964461868,6895851207,32.433013442178364,44.133441455506514,NaN,NaN,3.3005243006706557,4.105991338424582
2021-12-28T09:30:00-05:00,404.4,404.58,400.71,401.61,33113728,61253078,57.18379724178989,51.58927068776446,NaN,NaN,136.54499977867587,56.63632278483592,0.9512125425910719,1.7288984953065665,0.7776859527154946,6931348140,6918900045,37.97663375346131,43.659797790426936,NaN,NaN,5.003817232078042,4.234252180375076
2021-12-29T09:30:00-05:00,401.75,403.05,399.11,401.55,32248484,58798867.55,57.128838130848955,51.54954492135966,NaN,NaN,112.47588987422638,94.38496257480428,1.107832447694778,2.162476512333967,1.054644064639189,6899099656,6925719290.8,39.556713443271256,42.848665949151744,NaN,NaN,6.342674016294435,4.535455299792128
2021-12-30T09:30:00-05:00,401.33,403.5699,399.75,400.35,23850065,56072408.55,55.97022501737521,51.83053642813822,NaN,NaN,99.46961543227792,112.19305873209188,1.0617281772627982,2.3818042862176867,1.3200761089548885,6875249591,6920360083.6,38.7218251646988,41.95539775229385,NaN,NaN,7.123721083029695,4.905207554540351
2021-12-31T09:30:00-05:00,399.66,401.0589,397.34,397.85,34752884,53589221.6,53.53432839765329,51.6933054740138,NaN,NaN,63.8217603896135,109.67192586873371,0.8055943268202934,2.3270690174802553,1.5214746906599619,6840496707,6902131192.4,35.94296644090947,40.40164118379653,NaN,NaN,7.1157244858191495,5.22099568758018
2022-01-03T09:30:00-05:00,399.05,401.94,396.88,401.68,40575854,50350559.1,56.647207979285675,52.14877110281037,NaN,NaN,74.54481238518107,97.37141557199496,0.8333746637976522,2.5631930204070272,1.729818356609375,6881072561,6885453331,33.569310032386085,38.55898790527313,NaN,NaN,7.980271234365707,5.615177908549541
2022-01-04T09:30:00-05:00,402.24,402.28,393.288,396.47,58027206,49872479.35,51.58460527836352,52.48096112273008,NaN,NaN,34.995281422829706,77.06147190082571,0.4588395116038524,2.3033677461141906,1.8445282345103382,6823045355,6863792774,30.730792145457443,36.80822500349461,NaN,NaN,7.290136712954774,5.854457737750288
2022-01-05T09:30:00-05:00,394.74,395.89,384.03,384.29,75739847,50859208.5,42.10975599263111,51.62538862456786,NaN,NaN,-78.94039292946589,38.778215340087264,-0.5940803483579227,1.1019277990629348,1.6960081474208575,6747305508,6833433944.4,27.252573865162148,34.974616050586015,NaN,NaN,3.545041459353773,5.524541126550786
2022-01-06T09:30:00-05:00,382.42,387.35,380.13,384.02,70814324,52439722.65,41.925917717883756,51.31093599869541,NaN,NaN,-115.13015369191433,-4.141738484751192,-1.2555803963737182,0.12653265195370977,1.382113048327428,6676491184,6793682263,23.501662326347045,33.137872912238535,NaN,NaN,0.5393783299571787,4.8123750127516995
2022-01-07T09:30:00-05:00,384.03,385.76,378.04,379.86,72652304,53573652.15,39.094018614144424,50.88810538465465,NaN,NaN,-126.08258438013256,-42.122607438700406,-1.8824581542792673,-0.9709596445216562,0.9114985097576112,6603838880,6746350697.6,19.976157603675475,31.634123069908277,NaN,NaN,-2.8768669904222874,3.71391186944113
2022-01-10T09:30:00-05:00,374.82,380.64,369.31,380.11,91770497,55534888.65,39.35910787951513,50.685589549293766,NaN,NaN,-148.91089419974793,-86.8137487556862,-2.169046963201473,-1.7998101942442304,0.3692367689572428,6695609377,6709258060.8,17.731318256376582,30.441559172670157,NaN,NaN,-5.555424558833257,2.3897209511162174
2022-01-11T09:30:00-05:00,379.355,385.9899,377.2182,385.82,68295698,56441353.05,45.22330797520269,50.40705694512884,NaN,NaN,-77.62349599852628,-109.33750423995741,-1.8739376512375139,-1.9731852950896496,-0.09924764385213569,6763905075,6697430004.8,17.072477864421273,29.384410735913537,NaN,NaN,-6.205137747823815,1.161883994124784
2022-01-12T09:30:00-05:00,388.46,390.2,385.01,387.35,54576366,55410212.3,46.71035942879798,49.991261021537696,NaN,NaN,-35.52711428137478,-100.65484851033918,-1.4921880960375933,-1.9644827638991273,-0.47229466786153407,6818481441,6711665191.4,20.882656724515172,28.820317337912478,NaN,NaN,-6.316906659574957,0.09348532931053555
2022-01-13T09:30:00-05:00,388.77,389.47,376.7,377.66,77993962,55617009,39.41270255418766,48.90754551974639,NaN,NaN,-84.30550465547903,-94.48991870305213,-1.7887792468973307,-2.7082687264831975,-0.9194894795858668,6740487479,6724464450.4,24.252586332527812,28.542906242527742,NaN,NaN,-8.700187467720287,-1.1627536416938675
2022-01-14T09:30:00-05:00,375.07,380.35,374.86,380.01,80121210,55493501.1,41.787965937942644,47.69086701040156,NaN,NaN,-97.72694570659912,-88.81879096834544,-1.7225517503490746,-3.0726791675222103,-1.3501274171731357,6820608689,6767818412.2,34.439041433630436,28.68619395620289,NaN,NaN,-9.936055472047089,-2.4160824746014704
2022-01-18T09:30:00-05:00,374.04,376.22,369.7704,370.55,75812296,55201973.5,35.71753372244925,46.1575624733058,NaN,NaN,-134.22428547455166,-85.88146922330618,-2.182148875186674,-4.077813511156478,-1.8956646359698042,6744796393,6777655815.4,36.524947280402706,28.582502065270138,NaN,NaN,-13.038757682873445,-3.9336075043546095
2022-01-19T09:30:00-05:00,372.15,374.69,366.21,366.48,81791482,56024706.25,33.46511727752396,44.4672966980683,NaN,NaN,-145.53469349458982,-99.46370872251889,-2.5982790783939014,-5.143513483962181,-2.5452344055682796,6663004911,6757475782.6,34.12630877131869,28.194616017273525,NaN,NaN,-16.326286687029768,-5.703990244736775
2022-01-20T09:30:00-05:00,369.79,373.87,361.17,361.72,88610680,58010266.4,31.002687808328474,42.6839011831364,NaN,NaN,-148.41556033833103,-122.04139793391013,-3.0034630087794203,-6.299563166542555,-3.2961001577631346,6574394231,6708658340.6,29.140750750423635,27.510253559111014,NaN,NaN,-19.87094064866801,-7.727840302441237
2022-01-21T09:30:00-05:00,359.47,362.18,351.4,351.69,143388920,63327602.4,26.566722932042595,40.757643649878496,NaN,NaN,-180.79458862402169,-141.33921472761867,-3.71001920484332,-7.933624163817285,-4.223604958973965,6431005311,6646761907,24.294482941129885,26.678219023412474,NaN,NaN,-24.547680899161076,-10.130674673401213
2022-01-24T09:30:00-05:00,345.905,353.98,334.15,353.3,199448109,71820231.05,28.339197631216663,38.735642910730704,NaN,NaN,-192.52483183305588,-160.29879195291002,-3.8171373640918773,-8.995026664088812,-5.177889299996934,6630453420,6608730853.2,21.886065393377578,25.843701549197583,NaN,NaN,-27.6677020027638,-12.635964291881582
2022-01-25T09:30:00-05:00,346.67,351.0295,341.68,345.11,124398394,76399115.5,25.029542410732134,36.83885270589989,NaN,NaN,-170.55352258327696,-167.5646393746551,-4.159637141229768,-10.377435726534145,-6.217798585304377,6506055026,6560982579.8,19.299233646346934,25.027161656403973,NaN,NaN,-31.482341330118036,-15.328303868772503
2022-01-26T09:30:00-05:00,352.91,356.88,340.78,344.57,146559524,82071405.3,24.823689940163916,35.604133702152225,NaN,NaN,-140.60901789965456,-166.57950425566804,-4.1340293694312455,-11.385335297093434,-7.251305927662188,6359495502,6500280698,16.611221508861234,24.267065059525333,NaN,NaN,-34.53791861983401,-18.072534547495575
2022-01-27T09:30:00-05:00,349.4,351.27,340.05,341.1,95255656,85221763.9,23.486940474610336,34.287063899061266,NaN,NaN,-133.58953055588665,-163.61429829917915,-4.056604784924922,-12.322061908818341,-8.26545712389342,6264239846,6438249821,14.403476375649532,23.617194634475513,NaN,NaN,-37.49108911601282,-20.846613771569466
2022-01-28T09:30:00-05:00,343.03,352.02,337.95,351.8,108167897,89437655.5,35.09366675256925,34.00132448037733,NaN,NaN,-106.07677759358135,-148.67073609309108,-3.0372190315617615,-12.061980913345622,-9.02476188178386,6372407743,6426530307.4,14.02423739498245,23.192057476711728,NaN,NaN,-36.367459660928745,-23.063877470049363
2022-01-31T09:30:00-05:00,353.2,363.65,351.52,363.05,94326389,92416330.75,44.607930629605285,34.37624039109805,NaN,NaN,-48.272581991982925,-119.8202861248765,-1.4388460003869792,-10.823319382267584,-9.384473381880605,6466734132,6393786449.8,12.994755534763442,22.853731568025076,NaN,NaN,-32.02197889750838,-24.34360624540065
2022-02-01T09:30:00-05:00,364.43,366.19,359.14,365.52,74433023,94109189.2,46.46345875355368,34.464822589551694,NaN,NaN,-23.78872535028383,-90.46732667827786,-0.11840398304341804,-9.532478360684877,-9.414074377641459,6541167155,6400808875.6,14.445281180860931,22.66607466205648,NaN,NaN,-27.986020277066682,-24.863951107067226
2022-02-02T09:30:00-05:00,369.76,370.1,364.285,368.49,78777135,95146685.65,48.689191367318024,34.606167728017404,NaN,NaN,2.048500636492604,-61.93582297104844,0.9907952053099187,-8.17558037100406,-9.166375576313978,6619944290,6452898633.2,24.5001402079817,22.924466339446948,NaN,NaN,-24.013056068200893,-24.742394672943465
2022-02-03T09:30:00-05:00,358.53,361.93,352.46,353.55,95384771,96128931.85,39.73923339242847,34.62949135932032,NaN,NaN,-51.56919056328641,-45.531754972528375,0.7642128449231418,-8.21110952016005,-8.975322365083192,6524559519,6504962567.8,32.97856327655637,23.547750406877558,NaN,NaN,-23.435636387987767,-24.555714917949793
2022-02-04T09:30:00-05:00,354.08,361.4,351.97,358.01,86318301,96904130.7,43.10169042022814,34.72332882234071,NaN,NaN,-39.860150889341526,-32.2884296316804,0.948587192320808,-7.789588374682182,-8.73817556700299,6610877820,6552656583.2,39.66299196867175,23.92088973080908,NaN,NaN,-21.830143685092224,-24.16634759897014
2022-02-07T09:30:00-05:00,358.62,361.05,353.84,355.13,58198087,96181419.85,41.49169164873103,35.13576867421798,NaN,NaN,-37.2075703996286,-30.075427313209524,0.9102923601361859,-7.600310116832759,-8.510602476968945,6552679733,6569845703.4,41.91160330168498,24.305650875186384,NaN,NaN,-21.071194201053757,-23.72418282783923
2022-02-08T09:30:00-05:00,353.96,360.24,352.8,359.12,64720897,94828939.85,44.580284249211765,35.92970917219568,NaN,NaN,-28.667950469817562,-31.051272337116274,1.1707928883959688,-7.047111366473985,-8.217904254869953,6617400630,6585092398.4,43.908405995125825,25.00437210545832,NaN,NaN,-19.47067209912554,-23.11653843802299
2022-02-09T09:30:00-05:00,363.76,366.81,362.12,366.73,55766422,94202476.05,50.001497898582535,37.28676703578526,NaN,NaN,26.841102726963484,-26.0927519190221,1.8332681610063473,-5.926319053612019,-7.759587214618366,6673167052,6595736950.8,45.32158778939478,26.16014617967055,NaN,NaN,-16.34066225855668,-22.14855612667066
2022-02-10T09:30:00-05:00,359.52,366.4885,356.54,358.43,112468483,97097081.9,44.84851803858216,38.59260954339522,NaN,NaN,4.968406992115404,-14.785232407941734,1.6934479470421158,-5.6427772808157215,-7.336225227857837,6560698569,6602964760.8,46.31071439550249,27.732734140697165,NaN,NaN,-15.338792058599319,-21.175732688374755
2022-02-11T09:30:00-05:00,358.43,360.07,345.8,347.06,101569102,98275838.9,38.92983540131839,39.34908366983107,NaN,NaN,-64.07118363511576,-19.627438957096608,0.8583141334564619,-6.263332561037259,-7.121646694493721,6459129467,6572615090.2,42.80883387472164,29.22721760365031,NaN,NaN,-16.49683023860502,-20.507318052693364
2022-02-14T09:30:00-05:00,346.49,350.98,343.89,347.49,80254439,98282500.35,39.25632600501025,40.36528249799379,NaN,NaN,-89.12445501538528,-30.01081588024794,0.3822424821115318,-6.643843591854306,-7.026086073965838,6539383906,6569955924.8,42.50555539665839,30.884812014386846,NaN,NaN,-17.28660036819317,-20.047215526336192
2022-02-15T09:30:00-05:00,352.91,356.37,351.82,356.13,55390805,97261425.8,45.55474571075273,41.84607219589299,NaN,NaN,-12.123222566065053,-26.701870299497436,0.679252312510263,-6.17702068332801,-6.856272995838273,6594774711,6565430741,41.96076784315693,32.69549389540797,NaN,NaN,-15.914494062473047,-19.456826745784316
2022-02-16T09:30:00-05:00,353.82,357.0896,350.71,356.04,58947086,96119206,45.501819262274346,43.418563537868984,NaN,NaN,-6.78858697173601,-33.427808239237336,0.8865685339467904,-5.748062328404785,-6.6346308623515755,6535827625,6537962855.6,38.71695105190824,34.43217065799787,NaN,NaN,-14.855170816532986,-18.79944732731984
2022-02-17T09:30:00-05:00,352.74,353.46,345.02,345.45,61801353,94778739.65,39.66255714457007,43.74491285158333,NaN,NaN,-75.15605724074464,-49.45270108580935,0.35469254092954916,-6.191265186189639,-6.545957727119188,6474026272,6520628396.2,36.78433510059962,36.05789192268482,NaN,NaN,-15.776474863194807,-18.367594118159122
2022-02-18T09:30:00-05:00,346.41,346.81,339.14,341.51,80001513,91609369.3,37.722924396778865,43.253126692095734,NaN,NaN,-119.67815932008946,-60.57409622280409,-0.18903394479728952,-6.782250158115801,-6.593216213318511,6394024759,6507607454.6,35.35665042700673,37.65517012927362,NaN,NaN,-17.139671485800093,-18.19217659925069
2022-02-22T09:30:00-05:00,338.49,344.04,334.35,338.08,85967095,85935318.6,36.06921909574568,42.510681002252305,NaN,NaN,-143.83277763442334,-71.5157607466117,-0.6787071937802365,-7.441600205543807,-6.762893011763571,6308057664,6461342206.2,30.784700086794743,38.82227147969746,NaN,NaN,-18.7678350388445,-18.274413519192663
2022-02-23T09:30:00-05:00,341.32,342.183,329.1,329.42,86215371,84026167.45,32.2277985016659,41.33486722613429,NaN,NaN,-172.47540124367194,-103.58619648213308,-1.4410509110823764,-8.56420665061654,-7.123155739534164,6221842293,6386755722.6,25.14058684548604,38.86801766809064,NaN,NaN,-21.41142425601706,-18.722557910167577
2022-02-24T09:30:00-05:00,318.84,341.04,318.26,340.49,130614053,83228893.9,40.89351828756934,41.417316147215786,NaN,NaN,-152.7224160613319,-132.77296230005226,-1.0719289244044532,-8.46306689503973,-7.3911379706352776,6352456346,6350081466.8,22.915831436761025,38.149251108105254,NaN,NaN,-20.90388764997549,-19.03417644442585
2022-02-25T09:30:00-05:00,341.31,345.98,337.39,345.77,78842088,82408215.5,44.536297825296906,41.519788104720696,NaN,NaN,-71.75735463339133,-132.0932217785816,-0.3800372697485672,-7.866184557820986,-7.486147288072419,6431298434,6341535899.2,22.4180160413692,36.917467113297924,NaN,NaN,-19.30742420373347,-19.073211838612654
2022-02-28T09:30:00-05:00,342.51,348.54,341.32,346.8,77515544,80875597.85,45.24523489399277,41.78789833652511,NaN,NaN,-50.1495906951982,-118.18750805360335,0.20753116646084457,-7.226733329996364,-7.434264496457208,6508813978,6364493743,27.00573007998642,35.8527618831766,NaN,NaN,-17.823126292688706,-18.894628189194947
2022-03-01T09:30:00-05:00,345.75,348.078,338.9,341.49,67407000,79529628.4,42.24718673954898,41.62124851440633,NaN,NaN,-64.86851019158941,-102.39465456503656,0.2938335279761235,-7.066972586487054,-7.360806114463178,6441406978,6391163605.8,32.033816248229925,35.00457690125547,NaN,NaN,-17.47086207503303,-18.691233030028958
2022-03-02T09:30:00-05:00,343.08,348.59,340.24,347.22,70609015,79338428,46.37639289053171,41.362312442402704,NaN,NaN,-39.125444578063366,-75.72466323191483,0.7653052151124973,-6.404174595572556,-7.169479810685053,6512015993,6449198345.8,41.48025873625728,34.73019625460278,NaN,NaN,-15.915114556239986,-18.294644676630533
2022-03-03T09:30:00-05:00,349.93,350.04,340.35,342.26,71089385,78954040.5,43.478516376010056,41.264455180790414,NaN,NaN,-42.54449875780445,-53.68907977120936,0.7695231370672833,-6.207575889350949,-6.977099026418232,6440926608,6466892398.2,44.03426276474561,34.56759256669158,NaN,NaN,-15.471472113557693,-17.89133431047727
2022-03-04T09:30:00-05:00,339.84,341.31,334.92,337.3,77009763,78035290.1,40.73720232603914,41.393552818270464,NaN,NaN,-92.10477511235011,-57.758563867001115,0.4789004418894036,-6.378473474056477,-6.857373915945881,6363916845,6453416080.4,42.512440830205016,34.54642163494039,NaN,NaN,-15.918287138146345,-17.60947042871571
2022-03-07T09:30:00-05:00,337.29,338.48,324.65,324.86,89933794,78216064.75,34.80928001191239,41.075906675906346,NaN,NaN,-150.99208257729836,-77.92706224342115,-0.459735354517651,-7.432043109092945,-6.972307754575294,6273983051,6406449895,37.63130277722452,34.19826073355225,NaN,NaN,-18.24703671977663,-17.7005513274387
2022-03-08T09:30:00-05:00,324.05,333.21,319.94,323.35,116153921,81113856.45,34.159503360372256,40.26196079373631,NaN,NaN,-163.92559922847573,-97.73848005079842,-1.0567534738105255,-8.29324959683845,-7.2364961230279246,6157829130,6349734325.4,32.74234267368897,33.53980179287597,NaN,NaN,-20.30638299967913,-18.072812994901618
2022-03-09T09:30:00-05:00,331.75,336.38,329.09,334.99,64723366,81113979.9,42.99344585389836,40.08279126456659,NaN,NaN,-88.23165911397527,-107.55972295798078,-0.566744740855059,-7.944927049096748,-7.378182308241689,6222552496,6291841626,28.65060962174509,32.82077740500718,NaN,NaN,-19.29869789392552,-18.24793940904789
2022-03-10T09:30:00-05:00,330.82,332.51,326.71,331.27,69362714,81793794.5,41.095723207663234,40.18516026907324,NaN,NaN,-106.3885528985237,-120.32853378612465,-0.40004329393680216,-7.878236425662692,-7.47819313172589,6153189782,6234294260.8,25.2700405824514,31.998327796568017,NaN,NaN,-19.07258779522196,-18.365746321358472
2022-03-11T09:30:00-05:00,334.32,334.64,323.9,324.4,66228432,79481791.95,37.779209246970126,40.18918061551547,NaN,NaN,-114.71180429525269,-124.84993962270516,-0.644837217150517,-8.284239653164036,-7.639402436013519,6086961350,6178903161.8,22.51613522044947,31.081148138956785,NaN,NaN,-19.92614109393986,-18.58865986029867
2022-03-14T09:30:00-04:00,323.13,326.59,317.45,318.17,79802606,78393467.15,35.019218387708804,40.11418056494141,NaN,NaN,-153.61939540889554,-125.37540218902458,-1.0924029451169357,-9.00490611740969,-7.9125031722927535,6007158744,6125538300.4,20.228878248804705,30.327160864814637,NaN,NaN,-21.515527738466396,-19.00678384289406
2022-03-15T09:30:00-04:00,320.88,328.95,319.23,328.15,76470991,78204294.75,42.292259290494925,40.83307062128633,NaN,NaN,-101.52469112558339,-112.89522056844612,-0.6066258391656945,-8.670785471249872,-8.064159632084177,6083629735,6110698421.4,19.631653696246048,29.933665639868927,NaN,NaN,-20.540039167591814,-19.225820317850882
2022-03-16T09:30:00-04:00,332.17,340.44,328.401,340.32,105242954,80696902.2,49.6874911312516,41.46121153869221,NaN,NaN,-4.762970094894469,-96.20148276462996,0.5798305413829947,-7.339371455355433,-7.919201996738428,6188872689,6103962460,19.352364711940808,29.679132302381767,NaN,NaN,-17.166231091869,-18.931593285567757
2022-03-17T09:30:00-04:00,338.37,344.5,337.0406,344.44,67809951,81140045.45,51.93320394889594,41.98956197609214,NaN,NaN,56.49577135747189,-63.62461791343084,1.628209368017819,-5.883940286716154,-7.512149654733973,6256682640,6124661031.6,22.978423137162793,29.71916138065274,NaN,NaN,-13.725671923152252,-18.187890233794114
2022-03-18T09:30:00-04:00,342.74,351.79,341.55,351.49,85446347,82322295.15,55.58638309645338,42.728215419125036,NaN,NaN,118.25895483016171,-17.03046608834796,2.718360844893299,-4.1141985986173495,-6.8325594435106485,6342128987,6175694559,31.192839135356493,30.01824059889346,NaN,NaN,-9.66073931978281,-16.969725817506784
2022-03-21T09:30:00-04:00,350.2,352.48,345.575,350.08,73799072,82012173.1,54.69110659592272,43.61706683743745,NaN,NaN,119.78074304234505,37.64956160190015,3.231453937730329,-2.793242021347737,-6.024695959078066,6268329915,6227928793.2,38.43073878296449,30.475163637088787,NaN,NaN,-6.701172596670481,-15.502789643101599
2022-03-22T09:30:00-04:00,350.59,357.85,350.2,356.96,63345928,80881114.75,58.22654424272319,44.46350621973683,NaN,NaN,148.16314805139055,87.58712943729495,3.877644123026476,-1.1776408052949705,-5.055284928321447,6331675843,6277538014.8,44.411490985721265,30.684537369193357,NaN,NaN,-3.0778562051604936,-13.727799151967155
2022-03-23T09:30:00-04:00,354.01,357.66,351.77,351.83,70615457,80101119.05,54.79332905915863,45.271707125676016,NaN,NaN,120.23673765573047,112.58707098741993,3.7980945522916993,-0.3076667379568221,-4.105761290248521,6261060386,6291975554.2,46.05384881333952,30.828793515521493,NaN,NaN,-1.0806349311307133,-11.921061406133378
2022-03-24T09:30:00-04:00,353.8,359.7,351.5939,359.65,53555251,76248178.95,58.782944562451995,46.56068871399122,NaN,NaN,128.02284556678396,126.89248582928235,4.085617603018157,1.0012607135241751,-3.084356889493982,6314615637,6303562153.6,47.39704784447342,31.177694016540666,NaN,NaN,1.8804450226886604,-9.949417630587373
2022-03-25T09:30:00-04:00,359.59,360.67,354.9438,359.35,57584158,75185282.45,58.56939512075875,48.257839793194535,NaN,NaN,122.91909092660644,127.82451304857129,4.060630848917498,1.9914316716528901,-2.0691991772646077,6257031479,6286542652,45.60095265372941,31.746954722005302,NaN,NaN,4.1869316875974265,-7.929939156560973
2022-03-28T09:30:00-04:00,359.34,365.01,358.07,364.91,56833866,74151198.55,61.370349904012045,50.201471689168805,NaN,NaN,136.06171088039108,131.08070661618052,4.205795361296464,3.188045024355972,-1.0177503369404917,6313865345,6295649738,46.763484772126965,32.74846487189373,NaN,NaN,6.9920528278990455,-5.798226015923827
2022-03-29T09:30:00-04:00,368.9,371.83,366.06,371.19,68072955,74184496.3,64.30565829675889,51.72377257794456,NaN,NaN,153.60339189247847,132.16875538439808,4.4863604870905505,4.590200271922697,0.10383978483214618,6381938300,6305702229.4,48.08237141290269,34.13644785697642,NaN,NaN,10.291190598325912,-3.4997379281738645
2022-03-30T09:30:00-04:00,369.275,370.98,365.57,367.09,68757710,74091931.05,61.04438224431762,53.14867679484844,NaN,NaN,124.95664766620655,133.11273738649328,4.164431733246591,5.3093794513903845,1.1449477181437937,6313180590,6316126270.2,49.48005164645995,35.86573436154846,NaN,NaN,12.125313987534984,-1.2675876545011722
2022-03-31T09:30:00-04:00,367.24,367.6,361.68,362.54,67011405,73888032.05,57.555870245078154,54.56129543757044,NaN,NaN,92.38968813656993,125.9861059004505,3.443537994114231,5.449370210786583,2.005832216672352,6246169185,6302436979.8,47.66526930585496,37.662101081934566,NaN,NaN,12.673140534773722,0.7239449439666699
2022-04-01T09:30:00-04:00,362.81,363.61,358.59,361.85,54527761,72763931.95,57.02367365446051,56.13304224233842,NaN,NaN,72.3582277514782,115.87393326542485,2.7488588351564722,5.441905760617942,2.69304692546147,6191641424,6289358968.8,45.9320417068079,39.49804132893479,NaN,NaN,12.974341124339169,2.474001541162741
2022-04-04T09:30:00-04:00,362.71,369.31,362.44,369.3,45950171,70564750.8,61.19576193036477,57.483292430900555,NaN,NaN,91.02186062764329,106.8659632148753,2.620237274760271,5.968343518911809,3.3481062441515377,6237591595,6274104218.8,43.925631897835025,41.23332548619114,NaN,NaN,14.437776168484845,4.183112202208756
2022-04-05T09:30:00-04:00,367.81,368.54,359.93,361.1,62738661,67893987.8,54.880589269158115,57.85422801217959,NaN,NaN,67.55206213254397,89.65569726288838,1.8484337160023303,5.65864838915445,3.81021467315212,6174852934,6232687145.6,38.95079128701551,42.63321309869649,NaN,NaN,13.843165749176157,5.563119851775527
2022-04-06T09:30:00-04:00,355.65,356.78,350.56,353.26,90077072,69161673.1,49.60933263089139,57.688237203750695,NaN,NaN,15.245638335014098,67.7134953966499,0.7327167637081038,4.72611062778725,3.993393864079146,6084775862,6187006200,34.3322598218889,43.444201433319776,NaN,NaN,11.686066325048051,6.437826490814459
2022-04-07T09:30:00-04:00,352.24,356.35,348.69,354.1,63777373,68882406.05,50.16167296384382,57.3007579085643,NaN,NaN,7.297339005832377,50.6950255705024,0.012196597548534527,4.008639611014814,3.99644301346628,6148553235,6167483010,32.555563443715286,43.541538883916836,NaN,NaN,10.104817326124934,6.961682324430241
2022-04-08T09:30:00-04:00,352.32,353.09,348.5,349.15,61956094,68668789.15,46.89930003638558,56.74420029716879,NaN,NaN,-18.30953861455665,32.561472297295424,-0.7923830935998608,3.0059641464664537,3.7983472400663145,6086597141,6146474153.4,30.71361255268397,42.99031558175394,NaN,NaN,7.78275972772869,7.078979096330019
2022-04-11T09:30:00-04:00,344.81,345.75,340.535,340.89,66107401,67984028.9,41.991543983981344,55.584557421544375,NaN,NaN,-90.3930671943356,-3.721513267100363,-1.816902735476317,1.5272188207209183,3.3441215561972353,6020489740,6103053782.4,27.278442804860063,41.76652642597814,NaN,NaN,4.209185465533334,6.669008577644778
2022-04-12T09:30:00-04:00,345.76,347.69,338.035,339.45,72790215,67799990.1,41.18245558674689,54.61235217351497,NaN,NaN,-112.58190853916317,-39.748307401441785,-2.4861919088662816,0.23638167011438327,2.722573578980665,5947699525,6057623100.6,24.225426393313427,40.20735339597628,NaN,NaN,1.0544454116804391,5.866928125364158
2022-04-13T09:30:00-04:00,339.8,347.43,339.06,346.35,61367755,65606230.15,46.50164928280044,53.735116796397,NaN,NaN,-98.7618805220162,-62.54981117284784,-2.359838411645177,-0.22722443557580618,2.1326139760693708,6009067280,6042481384.2,23.289834390601456,38.48540957784257,NaN,NaN,-0.14480350211855986,5.008109321438056
2022-04-14T09:30:00-04:00,346.44,346.97,338.21,338.43,73519367,65891700.95,41.825960336771836,52.53915716896937,NaN,NaN,-125.54321791035238,-89.11792255608479,-2.6818143904500675,-1.2196540119932138,1.4621603784568538,5935547913,5999880319.8,20.850046231710266,36.71748769055548,NaN,NaN,-2.6466900832445863,3.9145665493405355
2022-04-18T09:30:00-04:00,337.35,341.04,335.791,338.69,58560555,64547411.35,42.03202249926993,51.15784806863064,NaN,NaN,-136.71649416629947,-112.79931366643336,-2.739775198894116,-1.9625586201607916,0.7772165787333246,5994108468,5981382585.2,19.876389235363547,34.79698086650095,NaN,NaN,-4.594125109378744,2.6990391695234957
2022-04-19T09:30:00-04:00,338.03,346.85,336.98,346.26,56515684,63683241.95,47.826643340215135,49.98077557173466,NaN,NaN,-89.77148250074487,-112.67499672771521,-2.156466387640519,-1.9183664058173235,0.23809998182319503,6050624152,5987409467.6,21.16808401785852,32.874531766854936,NaN,NaN,-4.585236244103073,1.6584283961482715
2022-04-20T09:30:00-04:00,347.09,347.56,339.96,341.21,65500022,63790946.65,44.622093711509386,48.80775496224836,NaN,NaN,-83.60289623917323,-106.87919426771722,-2.002264108248651,-2.264730153487619,-0.2624660452389679,5985124130,5994894388.6,22.831941610914626,30.971095335744558,NaN,NaN,-5.5394986468281555,0.6301531042944963
2022-04-21T09:30:00-04:00,345.19,347.87,333.2,334.15,75801008,64050224.2,40.53319848742265,47.59184983670154,NaN,NaN,-103.44453605015504,-107.815725373345,-2.248810967500093,-3.073479754614084,-0.824668787113991,5909323122,5974945557,21.527788970206686,29.104132454626825,NaN,NaN,-7.629284258436505,-0.5497665189527894
2022-04-22T09:30:00-04:00,334.31,335.56,324.96,325.4,82562145,65500568.9,36.116028972139695,46.098446645107195,NaN,NaN,-146.60101271455002,-112.02728433418451,-2.8363415860600423,-4.370095769689044,-1.5337541836290018,5826760977,5953188169.8,20.17429038122239,27.264293074227858,NaN,NaN,-10.876693507772737,-2.0250418030699247
2022-04-25T09:30:00-04:00,323.73,329.9,322.43,329.58,101755856,67709153.8,39.50749648564305,44.54928482762707,NaN,NaN,-135.58633623683005,-111.80125274829064,-2.775167903758266,-5.0027140633268345,-2.2275461595685684,5928516833,5940069842.8,19.38300020285844,25.511247953158108,NaN,NaN,-12.5074660992546,-3.522530988239164
2022-04-26T09:30:00-04:00,327.47,327.66,316.855,317.14,105819629,70158441.95,33.76284626566587,43.04087461309191,NaN,NaN,-154.49469765211467,-124.74589577856459,-3.3649301623161763,-6.433708862463789,-3.0687787001476123,5822697204,5894484453.2,16.902096105780814,23.93634115449849,NaN,NaN,-15.897593985568841,-5.290397130714832
2022-04-27T09:30:00-04:00,317.24,322.88,315,316.76,111204164,72315002.4,33.602115652213314,41.89750197175777,NaN,NaN,-154.6601945063286,-138.95735543199567,-3.5544597636143456,-7.511853404665544,-3.9573936410511985,5711493040,5839758235.2,14.502271717730096,22.519913432772857,NaN,NaN,-18.597141017492532,-7.191360543111646
2022-04-28T09:30:00-04:00,321.85,329.89,317.52,328.01,99449957,73849614.75,42.35191415202431,41.339662056627795,NaN,NaN,-109.0163587350563,-140.0717199689759,-2.7328950712603035,-7.373512480126578,-4.640617408866275,5810942997,5820082210.2,13.746554417673252,21.17641278805557,NaN,NaN,-18.13816990748159,-8.755190452307351
2022-04-29T09:30:00-04:00,323.7,327.225,312.6,313.25,91977859,75097937.45,35.704080009974675,40.54000348331274,NaN,NaN,-137.094895358595,-138.1704964977849,-2.974332457763275,-8.358532981070368,-5.3842005233070935,5718965138,5798523042.4,12.95024712544253,19.907600971824035,NaN,NaN,-20.051151607617932,-10.368899188780292
2022-05-02T09:30:00-04:00,312.83,318.72,309.645,318.48,115511770,78147137.9,39.337593537529074,40.350435594280434,NaN,NaN,-130.38816354368245,-137.1308619591554,-2.5868882017325463,-8.617810775472776,-6.03092257374023,5834476908,5779715057.4,12.281833925042477,18.836414623265636,NaN,NaN,-20.343671739921252,-11.793866696086143
2022-05-03T09:30:00-04:00,318.5,321.17,315.98,318.82,78185527,79758905.7,39.57665525767459,40.23573557077527,NaN,NaN,-99.2597077576758,-126.08386398026764,-2.131755918329132,-8.695617471651644,-6.563861553322512,5912662435,5797708103.6,16.710803948884546,18.299655877235,NaN,NaN,-20.49480339308801,-13.036857652800695
2022-05-04T09:30:00-04:00,319.31,330.29,313.891,329.6,116083395,82426142.4,46.7429117898882,40.252968606995815,NaN,NaN,-57.62543954044123,-106.67691298709016,-0.9869417638657509,-7.797538758154701,-6.81059699428895,6028745830,5861158661.6,30.111681093408762,18.786930641721234,NaN,NaN,-18.26778693085722,-13.784133263951627
2022-05-05T09:30:00-04:00,325.17,325.25,309.62,313,154607447,85652661.15,39.06047316942957,40.05543380932851,NaN,NaN,-98.13202613405163,-104.50004646688922,-1.2149396190828785,-8.329271518142548,-7.114331899059669,5874138383,5873797738.8,32.44340389161272,19.615027617428552,NaN,NaN,-18.956635909679527,-14.523062213341328
2022-05-06T09:30:00-04:00,310.95,315.09,305.105,309.25,139572805,89442432.75,37.55870861074754,39.73591138871977,NaN,NaN,-123.14116104018406,-101.70929960320701,-1.4686113486545267,-8.950096084877828,-7.481484736223301,5734565578,5876917826.8,33.03734196958928,20.55509566987325,NaN,NaN,-20.001159427204026,-15.305647529607429
2022-05-09T09:30:00-04:00,303.48,309.3487,295.72,297.15,113387342,92013995.15,33.13227104962948,38.68631336796365,NaN,NaN,-161.91041507869727,-108.01374991020998,-2.2546073045935433,-10.29974386696523,-8.045136562371686,5621178236,5834258092.4,29.25076625794304,21.13243011559357,NaN,NaN,-22.424755995728695,-16.32266302476761
2022-05-10T09:30:00-04:00,304.51,305.76,296.57,300.76,124124550,94914852.6,35.57190948142889,38.039871637243614,NaN,NaN,-143.25708589822656,-116.81322553832013,-2.325336361295781,-10.951807013991413,-8.626470652695632,5745302786,5800786162.6,26.66803157314203,21.406436541466956,NaN,NaN,-23.538828078267052,-17.3535437466961
2022-05-11T09:30:00-04:00,298.44,304.09,290.95,291.84,140326148,98291649.25,32.42402917758969,37.46064525796983,NaN,NaN,-154.07435810810887,-136.10300925185365,-2.738377664253118,-12.049442733012029,-9.31106506875891,5604976638,5716032324.2,21.493097094132196,21.40395855031878,NaN,NaN,-25.51403209212863,-18.519327796043605
2022-05-12T09:30:00-04:00,287.45,295.75,284.94,291.15,120910850,101268804,32.186751383108955,37.17998257303906,NaN,NaN,-162.55669219007981,-148.98794246305928,-2.8128606540204224,-12.82714088628444,-10.014280232264017,5484065788,5638017805.2,18.025678603841584,21.250486280505868,NaN,NaN,-27.137003302115243,-19.750424296910982
2022-05-13T09:30:00-04:00,295.72,302.999,294.0825,301.94,83684931,101777082.2,39.62703754825047,37.18852122036816,NaN,NaN,-104.09296617165585,-145.17830348935365,-1.932199471603278,-12.429529571768114,-10.497330100164836,5567750719,5604654833.4,16.77901922571644,21.06448763928144,NaN,NaN,-26.181788369500737,-20.669190592995232
2022-05-16T09:30:00-04:00,300.15,302.26,297.13,298.44,59190432,101808576.05,38.16430887515055,37.50291140675993,NaN,NaN,-95.26025763573561,-131.8482720007613,-1.4065886831992955,-12.255565954163956,-10.84897727096466,5508560287,5582131243.6,15.975725562884776,20.998318314788865,NaN,NaN,-25.85161077055208,-21.409536332646212
2022-05-17T09:30:00-04:00,304.45,306.56,300.55,306.17,62715293,102118556.5,43.15499873198303,38.185260198172045,NaN,NaN,-58.91400787076692,-114.9796563952694,-0.4111917245473755,-11.36296692664888,-10.951775202101505,5571275580,5547325802.4,14.796841722032923,21.019359029381924,NaN,NaN,-24.01563991643469,-21.781836844615995
2022-05-18T09:30:00-04:00,301.54,302.25,289.85,291.14,79477109,102817410.85,36.916180982119535,37.79699354317885,NaN,NaN,-103.57003941277236,-104.87879265620208,-0.6250750884168461,-11.733119062622563,-11.108043974205717,5491798471,5524690169,14.069689830111656,21.042440130270382,NaN,NaN,-24.40966958492526,-22.157241521803034
2022-05-19T09:30:00-04:00,289.29,294.39,287.58,289.58,79920709,103023395.9,36.3291291077998,37.841639907309215,NaN,NaN,-114.38504839022336,-95.24446389623078,-0.7246512072400915,-12.013857983255832,-11.28920677601574,5411877762,5510252563.8,13.61026968528465,21.089584598830534,NaN,NaN,-24.9033669859316,-22.549545159535686
2022-05-20T09:30:00-04:00,293.13,293.8,280.21,288.68,91764174,103483497.35,35.973704518615975,37.60136212024399,NaN,NaN,-117.90061349479481,-98.00599336085858,-0.7035905298743881,-12.168694938358726,-11.465104408484338,5320113588,5460725137.6,12.145178383248322,21.07982348870238,NaN,NaN,-25.403734648765663,-22.95728651513997
2022-05-23T09:30:00-04:00,289.75,293.87,287.29,293.48,63648400,101578124.55,39.38007060771675,37.58732035953272,NaN,NaN,-86.92445615581151,-96.33883306487375,-0.24265677238920347,-11.768425373970842,-11.525768601581639,5383761988,5435765477.8,11.474799026183206,20.70582313708086,NaN,NaN,-24.83327808692073,-23.22528531110865
2022-05-24T09:30:00-04:00,288.125,288.86,282.25,287.24,73491124,99961699.3,36.650227681308166,36.866414351777,NaN,NaN,-109.71831207972089,-106.49969390666453,-0.23417594394542718,-11.818488531513424,-11.584312587567997,5310270864,5383564534.6,10.205990037411922,19.28398806165251,NaN,NaN,-25.138286618247736,-23.498571212128518
2022-05-25T09:30:00-04:00,285.71,293.39,285.5,291.26,67144548,97758718.5,39.557142481153726,36.90189073118587,NaN,NaN,-79.44978880880325,-101.67564378587072,0.14557454011848314,-11.402344412419893,-11.547918952538376,5377415412,5360687922.8,9.699801793535158,17.65944505464697,NaN,NaN,-24.555754468742773,-23.64959739164484
2022-05-26T09:30:00-04:00,290.44,300.92,290.15,299.33,59462231,95759332.2,45.01204482022253,37.434271889005515,NaN,NaN,-32.88871231961472,-85.37637657174899,0.9962522483919951,-10.302603642048382,-11.298855890440377,5436877643,5365687899,10.741797593880463,16.06690617066777,NaN,NaN,-22.420853391376014,-23.474062534463577
2022-05-27T09:30:00-04:00,302.54,309.25,302.42,309.1,66985596,94509719.05,50.80104523013422,38.696327187613,NaN,NaN,44.36916528032952,-52.92242081672413,2.2037234543725255,-8.54420157247472,-10.747925026847245,5503863239,5402437829.2,18.21212213327719,15.278431590334494,NaN,NaN,-18.739061706779754,-22.79763384479446
2022-05-31T09:30:00-04:00,309.07,311.33,304.33,308.28,60968330,91782547.05,50.322195154895816,39.74991902143206,NaN,NaN,58.04544470995039,-23.928440643571744,2.890676485259089,-7.134579420273383,-10.025255905532472,5442894909,5414264413.4,20.51754243460634,14.839110937581948,NaN,NaN,-15.90989947544019,-21.813671792029567
2022-06-01T09:30:00-04:00,310.47,312.65,303.73,306,65341653,91140353.35,48.94084415618768,40.92969151990335,NaN,NaN,62.94227237158053,10.60367624668854,3.115605369486932,-6.130749193673807,-9.24635456316074,5377553256,5427720891.8,23.1711829753081,14.9589742148088,NaN,NaN,-13.941618023147873,-20.689092682189326
2022-06-02T09:30:00-04:00,304.85,314.56,303.4001,314.38,59291333,88300750.25,53.94483665856297,42.48384046815006,NaN,NaN,106.98223829796213,47.89008166804162,3.712350527132756,-4.605916404244795,-8.31826693137755,5436844589,5439606727.2,25.53601372889291,15.495426723741035,NaN,NaN,-10.711582191744437,-19.263734040697198
2022-06-03T09:30:00-04:00,309.03,310.47,304.92,306.2,60914684,83616112.1,48.9063276283952,43.146646902446115,NaN,NaN,82.15826313496733,70.89947675895803,3.445578843837131,-4.011293376581136,-7.456872220418267,5375929905,5427417179.6,24.69645123421948,16.060957581491255,NaN,NaN,-9.379691142648525,-17.85172791240453
2022-06-06T09:30:00-04:00,310.75,312.35,305.62,307.22,51785013,79226722.5,49.53923123852825,43.9591413569731,NaN,NaN,95.69557673166194,81.16475904922451,3.2308254821667832,-3.4183403677097886,-6.649165849876572,5427714918,5412187515.4,23.650231873357697,16.60913660366789,NaN,NaN,-8.114383986778758,-16.460678780172277
2022-06-07T09:30:00-04:00,303.81,310.67,302.6886,309.87,44900292,75802370,51.229508585963536,44.53589206082885,NaN,NaN,81.74863999212725,85.90539810565988,3.1565930100307504,-2.7034245873381337,-5.860017597368884,5472615210,5418131575.6,24.985930509003126,17.33692865988005,NaN,NaN,-6.577030315584128,-15.048728999516827
2022-06-08T09:30:00-04:00,309.05,311.72,306.77,307.64,38342062,71513245.6,49.720191212198245,45.45046422012019,NaN,NaN,82.84647610880121,89.88623885310402,2.855702984552366,-2.290388866678427,-5.146091851230793,5434273148,5429475554,27.589500043613697,18.30262938941591,NaN,NaN,-5.691499068343905,-13.711981866492124
2022-06-09T09:30:00-04:00,305.91,309.05,299.23,299.4,55900475,67291961.95,44.502785511062854,46.03429682035327,NaN,NaN,24.01611780244451,73.2930147540005,2.0384686637629894,-2.5980060215270555,-4.636474685290045,5378372673,5417781170.8,26.565860724715407,19.228028749375248,NaN,NaN,-6.388572080553588,-12.665780468500905
2022-06-10T09:30:00-04:00,293.65,294.87,288.384,288.84,85963456,65544592.25,38.8730065962844,46.24138982590101,NaN,NaN,-84.69399161450038,39.92256380410691,0.7877374529539605,-3.651802869097594,-4.439540322051554,5292409217,5401077033.2,25.13151694718215,20.155624361084808,NaN,NaN,-8.758322890866879,-12.107572243124617
2022-06-13T09:30:00-04:00,279.75,282.34,274.53,275.41,94442009,66082446.15,33.132444692531166,45.79513083195918,NaN,NaN,-169.19361339227845,-13.055274220681166,-0.8540879216379622,-5.507150224099007,-4.653062302461045,5197967208,5355127491.2,21.666124612854475,20.883576188704183,NaN,NaN,-12.830063610870122,-12.210785295659688
2022-06-14T09:30:00-04:00,277.66,278.66,273.3375,275.91,64697521,66357800.6,33.526027915665935,45.57197370584188,NaN,NaN,-151.3861868383068,-59.68223958676797,-1.764049646094401,-6.858124360079046,-5.094074713984645,5262664729,5313137395,19.07730864365456,21.517241803435798,NaN,NaN,-15.911509795100343,-12.73946022415121
2022-06-15T09:30:00-04:00,279.415,286.83,276.61,282.8,86051428,67524607.35,38.865987100173676,45.52260546434331,NaN,NaN,-97.33441972331516,-95.71841875319124,-1.7557762181956562,-7.288794986729215,-5.533018768533559,5348716157,5296025996.8,18.126782684524983,22.11916900993507,NaN,NaN,-16.904064688602464,-13.334403719072819
2022-06-16T09:30:00-04:00,275.59,276.06,269.28,271.39,81910297,67646266.75,33.995632927545955,44.73571890058069,NaN,NaN,-140.35743699256193,-128.59312971219254,-2.336265971438303,-8.453351232831437,-6.117085261393134,5266805860,5273712634.2,16.941395402981897,22.56199742487089,NaN,NaN,-19.376367064372495,-14.197541339829916
2022-06-17T09:30:00-04:00,272.18,277.19,270.5119,274.69,82703402,67785401.4,36.47504211824332,43.712432964017054,NaN,NaN,-115.39724534679351,-134.73378045865115,-2.311268190818505,-9.006170499916266,-6.694902309097761,5349509262,5285132643.2,19.830959467321975,22.677628663016947,NaN,NaN,-20.60345131390255,-15.112671336126008
2022-06-21T09:30:00-04:00,278.75,283.45,278.64,281.08,51633741,65778879.75,41.08968879359414,43.052968223924076,NaN,NaN,-72.56015855750528,-115.40708949169652,-1.7056085502585994,-8.82691299692101,-7.1213044466624105,5401143003,5325767802.2,29.261253947949214,23.302179485398575,NaN,NaN,-20.198192633536213,-15.83917437861318
2022-06-22T09:30:00-04:00,278.52,285.18,277.91,280.67,67472924,65970105.95,40.88446859294309,42.477512826549464,NaN,NaN,-65.87312700443036,-98.30447752492123,-1.1978236714060104,-8.618584035919923,-7.420760364513913,5333670079,5339968872.2,32.260184219638845,23.95139385999363,NaN,NaN,-19.93455347759635,-16.424228535610776
2022-06-23T09:30:00-04:00,283.21,285.72,280.31,284.85,57457796,65168439.55,43.95759972359522,41.764138759766055,NaN,NaN,-52.22366441146056,-89.2823264625503,-0.4823505601014837,-8.023698564640767,-7.541348004539284,5391127875,5348451215.8,34.05842484120923,24.560137510873368,NaN,NaN,-18.814715285645253,-16.76572664275856
2022-06-24T09:30:00-04:00,287.74,295.04,287.5001,294.61,58422262,64732325.25,50.436478694580764,41.873435264493594,NaN,NaN,-7.292619851400452,-62.66936303431802,0.6829931675548977,-6.687606545095662,-7.370599712650559,5449550137,5385000071.2,41.29037912275097,25.745418074339902,NaN,NaN,-15.81718740747802,-16.63022103771848
2022-06-27T09:30:00-04:00,296,296.5799,291.29,292.45,54151452,64466786.3,49.08405675966205,41.84092280171744,NaN,NaN,-0.866564475343121,-39.76322686002793,1.3069546059647452,-5.736906455194628,-7.043861061159373,5395398685,5394177955.8,42.9814659163863,27.126220505984804,NaN,NaN,-13.75569398701993,-16.219574316190116
2022-06-28T09:30:00-04:00,293,295.65,283.35,283.54,61867060,64210859.5,43.859604173347904,41.314501057959184,NaN,NaN,-28.303489569987363,-30.91189306252435,1.1251309794579907,-5.637447336836885,-6.762578316294876,5333531625,5380655680.2,41.10292266029175,28.27743423107685,NaN,NaN,-13.515078465926877,-15.83321776615251
2022-06-29T09:30:00-04:00,283.4,285.34,280.84,283.8,57302726,64027579.3,44.04676109827626,40.9092560498219,NaN,NaN,-46.36787221798043,-27.01084210523437,1.0304319559782913,-5.474538371322012,-6.5049703273003034,5390834351,5392088534.6,43.357034857530095,29.40368671778516,NaN,NaN,-13.267691770162363,-15.466714052439631
2022-06-30T09:30:00-04:00,280.75,283.9441,275.78,280.28,79313580,64726175.65,42.00508745348608,40.73084904570926,NaN,NaN,-59.853170308811194,-28.536743284704492,0.7517258929920709,-5.565312961060215,-6.317038854052286,5311520771,5376167113.8,41.00353120910686,30.434948895241693,NaN,NaN,-13.639577733917928,-15.205694578365103
2022-07-01T09:30:00-04:00,278.95,282.53,277.03,282.13,56675107,64595364.35,43.48770467115821,41.06047033677168,NaN,NaN,-51.47312329331144,-37.37284397308669,0.7132855341457462,-5.425431936370103,-6.138717470515849,5368195878,5359896262,38.6920508672279,31.40355846095925,NaN,NaN,-13.54176503177994,-14.967990357424366
2022-07-05T09:30:00-04:00,278.31,287.08,276.7501,286.96,61829272,64641093.75,47.27733283732372,42.07081948997114,NaN,NaN,-26.874870120201997,-42.57450510205846,1.016005087226068,-4.868711111483265,-5.884716198709333,5430025150,5366821555,40.236305553275244,32.72999995670359,NaN,NaN,-12.396018652870591,-14.600565828202399
2022-07-06T09:30:00-04:00,287.35,290.95,285.59,288.8,63194715,65211578.85,48.68895949014006,43.15388603100501,NaN,NaN,17.39749922553406,-33.43430734295417,1.3235575086180278,-4.230269312936798,-5.553826821554826,5493219865,5398759203,46.88136005219485,34.71600362874218,NaN,NaN,-11.04426110043269,-14.09252229566387
2022-07-07T09:30:00-04:00,289.63,295.7,289.63,294.98,56620114,65797569.95,53.21943013331206,44.17913196194346,NaN,NaN,72.14419939046098,-9.731893021265893,1.8919686777822369,-3.1888659743270296,-5.080834652109266,5549839979,5430560328.6,52.54001197436712,37.174091435159475,NaN,NaN,-8.551669244179747,-13.300971859737565
2022-07-08T09:30:00-04:00,292.08,296.75,291.12,295.35,59895478,66875240.75,53.48423781114523,45.57117516791484,NaN,NaN,99.53431159892844,22.14560336028203,2.218991197530607,-2.307095655196008,-4.526086852726615,5609735457,5490203265.8,60.943515665569194,40.31710002534429,NaN,NaN,-6.419042244791958,-12.317839057602479
2022-07-11T09:30:00-04:00,292.88,293.11,288.14,289.04,55273920,66843913,48.44750619021758,46.42635117305586,NaN,NaN,69.0127556844555,46.24277915583542,1.9462134033391472,-2.093320098552681,-4.039533501891828,5554461537,5527456397.6,65.10017531644488,43.550615443138774,NaN,NaN,-5.90183324032288,-11.401266797991108
2022-07-12T09:30:00-04:00,290.32,292.28,284.61,286.24,55797088,65335594.6,46.36114034537666,46.80288342675461,NaN,NaN,43.846603981817864,60.38707397623939,1.53135604112405,-2.1253384504867654,-3.6566944916108155,5498664449,5541184257.4,66.51444911554657,46.21155795511002,NaN,NaN,-6.040766919574586,-10.635481101074461
2022-07-13T09:30:00-04:00,280.6,288.05,280.02,285.65,73939418,64310465.05,45.91246898429105,47.16202631185089,NaN,NaN,1.0419926664109467,57.11597266441478,1.1867402335147585,-2.1732691997173674,-3.360009433232126,5424725031,5527485290.6,63.73868221955856,48.46002209796142,NaN,NaN,-6.276911345041906,-10.012828278784097
2022-07-14T09:30:00-04:00,282.99,287.56,279.8,286.67,63741837,64262680.85,46.86977056117433,47.37003851453512,NaN,NaN,-3.4915330306626946,41.98882618019001,1.0042574193142775,-2.1046876590892794,-3.108945078403557,5488466868,5515210668.4,61.27134007724287,50.40380175767812,NaN,NaN,-6.229765391408877,-9.47239072344478
2022-07-15T09:30:00-04:00,289.73,291.98,288.08,291.87,63818149,63151016.9,51.57527942340792,47.45138142373706,NaN,NaN,70.67760603173363,36.21748506675105,1.1974314039621214,-1.6121558234509052,-2.8095872274130267,5552285017,5503720580.4,58.97011970549206,51.666640370731045,NaN,NaN,-4.91680208183784,-8.82159234607236
2022-07-18T09:30:00-04:00,294.72,296.16,288.2,289.4,59519581,62031481.1,49.339948189804396,47.46965938303294,NaN,NaN,71.28285476408381,36.67150488267671,1.1237226230999062,-1.4049339485381438,-2.52865657163805,5492765436,5491381360.2,56.515319986252884,52.633344232864374,NaN,NaN,-4.382935322476004,-8.187498485558596
2022-07-19T09:30:00-04:00,293.11,298.6,291.47,298.3,55172640,60654943,56.63340416945523,48.38207366846918,NaN,NaN,132.1260559691822,54.327395280149574,1.6096464777281065,-0.5165984744779166,-2.126244952206023,5547938076,5501236085.6,58.01840814607831,53.841593196134845,NaN,NaN,-1.732609242454811,-7.265371450829484
2022-07-20T09:30:00-04:00,298.73,304.24,297.9329,303.03,67769430,61461727.45,59.934752738646125,49.516930214209886,NaN,NaN,186.34159948165373,91.38731664319813,2.151075926944839,0.5625999564750259,-1.5884759704698133,5615707506,5539432580.6,63.3118447830483,55.26693676224329,NaN,NaN,1.5530305279711225,-6.005599739572254
2022-07-21T09:30:00-04:00,303.5,307.435,300.78,307.38,55049363,60840549.4,62.7437299824863,50.99826182342419,NaN,NaN,198.19914659435426,131.72545256820155,2.669759131723741,1.7487229441848626,-0.9210361875388781,5670756869,5575890580.8,67.52134783224042,57.16106652103854,NaN,NaN,5.220819917839414,-4.401825502799159
2022-07-22T09:30:00-04:00,306.43,308.55,300.115,301.99,57127715,60824045.35,57.37595262016863,51.99027953406779,NaN,NaN,154.24396174273784,148.43872371040237,2.5193262337971905,2.22812160470761,-0.29120462908958034,5613629154,5588159408.2,68.81794361114497,59.31291600274691,NaN,NaN,6.775710565629622,-2.805034635880762
2022-07-25T09:30:00-04:00,302.02,302.5,298.22,300.27,40582381,59932051.3,55.73727230141521,52.594560924360046,NaN,NaN,102.98756091278284,154.77966494014217,2.185859038832407,2.4411191694509284,0.2552601306185215,5573046773,5604215675.6,70.47892581828005,61.47310316453296,NaN,NaN,7.57199687582247,-1.3226015627803003
2022-07-26T09:30:00-04:00,298.53,298.79,293.54,294.37,50074122,59728184.8,50.41793388574471,52.71805909547466,NaN,NaN,48.11965862340242,137.9783854709862,1.4834105441750145,2.1095233108372895,0.6261127666622751,5522972651,5599222590.6,69.24369110369364,63.0704125253543,NaN,NaN,6.653576281327797,-0.18314758505057216
2022-07-27T09:30:00-04:00,299.04,308.54,298.46,306.81,69304364,60100050,59.24883448358114,53.14873083477959,NaN,NaN,125.44257033673104,125.79857964200168,1.7535501917796514,2.8180505063868395,1.064500314607188,5592277015,5594536492.4,68.03845600399313,64.17744424175616,NaN,NaN,8.737860718036773,1.0912821725333341
2022-07-28T09:30:00-04:00,306.59,310.3965,302.745,309.81,55139941,59991910.75,61.05047484001531,53.68917633684174,NaN,NaN,136.53195159830867,113.46514064279256,2.0126926360461304,3.580366109664851,1.5676734736187208,5647416956,5589868509.8,66.79131916367879,64.59514449162113,NaN,NaN,11.000250856594851,2.5068491273992652
2022-07-29T09:30:00-04:00,311.385,316.39,309.931,315.46,57501043,58901283.9,64.25562005791494,54.81832732739155,NaN,NaN,170.120923103031,116.6405329148512,2.4158870466438467,4.587532281923529,2.1716452352796827,5704917999,5608126278.8,69.17152676965574,64.88595530970763,NaN,NaN,13.94808935001256,4.141312016344021
2022-08-01T09:30:00-04:00,313.65,318.81,312.53,315.27,46358833,58385470.2,64.0646988518279,56.082867220709495,NaN,NaN,158.73806117319623,127.79063296693384,2.510032869778764,5.3091863225031375,2.7991534527243735,5658559166,5625228757.4,71.25023503999131,65.22422573288225,NaN,NaN,16.21363411174165,5.8659294585436825
2022-08-02T09:30:00-04:00,312.92,318.545,311.8401,314.33,48676501,57727831.65,63.066310713561805,57.30814162994312,NaN,NaN,133.27321877423248,144.82134499709986,2.3519536254398377,5.739095484524171,3.387141859084333,5609882665,5642610760.2,73.22619045027011,65.90190489221878,NaN,NaN,17.76932189157666,7.566414091834107
2022-08-03T09:30:00-04:00,316.05,323.7291,315.99,322.89,53735729,57254882.35,67.96261381254249,58.81477329075513,NaN,NaN,155.9341237045378,150.91965567066123,2.644978598625782,6.69336510736656,4.048386508740778,5663618394,5656879036,74.75972407556893,66.86536089209922,NaN,NaN,20.702860922528675,9.443049353361904
2022-08-04T09:30:00-04:00,322.97,324.72,320.77,324.4,38973659,56372559.6,68.74963878126442,60.041513244887746,NaN,NaN,149.49647166018204,153.5125596830359,2.7494431315552204,7.485190423184804,4.7357472916295835,5702592053,5667914055.4,75.90899985043387,68.0752809024522,NaN,NaN,23.32769121911377,11.426569619897885
2022-08-05T09:30:00-04:00,319.19,323.83,318.39,321.75,53893972,56072484.3,65.69931536731906,61.21003947185308,NaN,NaN,119.42943690250816,143.37426244293133,2.4584974115855482,7.808869056111519,5.35037164452597,5648698081,5656670071.8,72.29672676607021,69.20252424386773,NaN,NaN,24.642032931704875,13.314492950156026
2022-08-08T09:30:00-04:00,322.69,326.47,319.21,320.71,44066297,55512103.15,64.48999884748427,61.77122480599801,NaN,NaN,111.59047865242601,133.9447459387773,2.032111086716629,7.890510502921757,5.858399416205128,5604631784,5645884595.4,68.90930712250925,69.98044559932708,NaN,NaN,25.388290419773863,15.039321160101432
2022-08-09T09:30:00-04:00,318.77,319.03,315.42,317.08,39764220,54710459.75,60.31674315709041,61.79850983588689,NaN,NaN,72.5045195363705,121.79100609120488,1.3732657488288762,7.574981602241223,6.201715853412347,5564867564,5636881575.2,66.12418480926462,70.1813270297711,NaN,NaN,24.850591858724034,16.440931259904662
2022-08-10T09:30:00-04:00,324.59,326.23,322.0601,325.93,51459564,53586467.05,66.07990724882615,62.036808212054034,NaN,NaN,108.78376487587497,112.36093432547231,1.3965718603824753,7.947430678890441,6.550858818507966,5616327128,5627423322,63.23273440784787,69.87499749945735,NaN,NaN,26.09614498151272,17.82024750584867
2022-08-11T09:30:00-04:00,328.305,330.36,323.36,324.08,45897650,52694257.7,63.98789304627537,62.50908967106165,NaN,NaN,105.70845956698076,103.60333190683207,1.1601834674808593,8.00108815285904,6.840904685378181,5570429478,5600990807,55.87887527027975,68.9507783322527,NaN,NaN,26.49680547267963,19.05975578682452
2022-08-12T09:30:00-04:00,326.175,330.585,325.1001,330.39,40928379,51549769.2,67.73943252163683,63.36638682964891,NaN,NaN,113.62896235042886,102.44323699641623,1.291523304423296,8.455308815907301,7.163785511484005,5611357857,5593522762.2,53.96914516733284,67.77150828575647,NaN,NaN,27.995375160834595,20.33627284025453
2022-08-15T09:30:00-04:00,329.42,333.5652,329.4,333.06,38266614,50487120.85,69.20146697102406,64.70806776431172,NaN,NaN,127.54099995712201,105.63334125735541,1.4112230813155993,8.927814363128505,7.5165912818129055,5649624471,5602521299.6,55.923834908981924,66.8200899861342,NaN,NaN,29.678321224040722,21.670851180795413
2022-08-16T09:30:00-04:00,332.055,334.4209,329.16,332.28,41186864,49787832.05,68.22867370166874,65.349484851318,NaN,NaN,118.1020451782712,114.75284638573555,1.2939648309403777,9.134047320488378,7.840082489548,5608437607,5611235308.2,57.79298499013306,66.08827062800134,NaN,NaN,30.77162928757155,22.97096233890629
2022-08-17T09:30:00-04:00,329.07,331.43,326.36,328.49,47842155,48791468.3,63.55373795970519,65.52828935986726,NaN,NaN,86.92652630408061,110.38139867137667,0.8392923752753827,8.889197958642228,8.049905583366845,5560595452,5600088973,54.603228754306,65.21769274161757,NaN,NaN,30.36093055702329,24.026672084351574
2022-08-18T09:30:00-04:00,328.44,330.49,326.79,329.28,41937172,48135858.75,64.10582212623783,65.51758950760461,NaN,NaN,80.11194734604197,105.26209622718893,0.4873418971610288,8.659082954818132,8.171741057657103,5602532624,5606509602.2,56.10608306032259,64.28444676237947,NaN,NaN,30.172820992647793,24.90469335696532
2022-08-19T09:30:00-04:00,326.17,326.84,322.08,322.86,51770570,47868001.5,56.60208901607098,64.98454594790769,NaN,NaN,38.612611255114786,90.2588260081261,-0.24301071673478525,7.867977661738621,8.110988378473406,5550762054,5594390441.6,52.56857259328052,62.95004230190015,NaN,NaN,27.77418438242168,25.31462064631623
2022-08-22T09:30:00-04:00,318.5,318.74,313.53,314.36,51098890,48393826.95,48.506500442462915,63.94455949997206,NaN,NaN,-38.95127983976997,56.96037004874772,-1.3044390377611865,6.4804395812719235,7.78487861903311,5499663164,5564398180.2,45.00585094716733,60.93430376596422,NaN,NaN,22.96648013612212,24.979172002002784
2022-08-23T09:30:00-04:00,314.12,317,313.33,314.1,39497074,47864974.55,48.279035923167086,62.538589650730955,NaN,NaN,-64.23102248275943,20.493756516541595,-1.9889067412139312,5.298745192515696,7.287651933729627,5460166090,5534743876.8,39.02744681608469,58.381998247429635,NaN,NaN,19.072339611859363,24.135338803410868
2022-08-24T09:30:00-04:00,313.61,316.87,312.99,315.01,38057059,46302609.3,49.17734095379764,61.140568377340465,NaN,NaN,-75.03821084246951,-11.899190912768432,-2.3220221170236357,4.385124287450083,6.707146404473718,5498223149,5522269416.2,36.812177502028746,55.589368079686416,NaN,NaN,16.130320516629006,22.99176476244203
2022-08-25T09:30:00-04:00,316.83,320.6,315.7577,320.58,38098255,45450525,54.39815387512521,60.333342556469475,NaN,NaN,-38.29011711490845,-35.57960380495852,-2.114771530753546,4.063681991031785,6.178453521785332,5536321404,5509027172.2,34.56898030372996,52.894529046662115,NaN,NaN,15.037433715654434,21.85543175575809
2022-08-26T09:30:00-04:00,320.28,321.51,307.35,307.44,69047740,46027859.85,43.13961840741584,58.808315382178876,NaN,NaN,-124.56434846486803,-68.21499574895509,-2.7689029442134503,2.7173248415185185,5.486227785731969,5467273664,5492329494.2,31.92709179060465,50.25294223724035,NaN,NaN,10.11466097636855,20.178178787273872
2022-08-29T09:30:00-04:00,304.62,307.22,303.28,304.41,48321851,46126010.75,41.030797752144046,57.43074785325414,NaN,NaN,-189.76388016991794,-98.37751581498468,-3.2771337866692756,1.3898105523953745,4.66694433906465,5418951813,5476187224,29.574038487518195,47.64221749997275,NaN,NaN,5.455562627409207,18.074947907293208
2022-08-30T09:30:00-04:00,306.1,306.73,298.44,301.02,51184500,46251410.7,38.7485610764237,55.478508840939675,NaN,NaN,-191.7528331922151,-123.88187795687581,-3.68277978538892,0.06346960732849993,3.74624939271742,5367767313,5457707468.6,27.110672272308094,45.06207020457705,NaN,NaN,0.900012949671699,15.621385770490136
2022-08-31T09:30:00-04:00,303.99,304.91,299.16,299.27,50044041,46066826.3,37.586300946887555,53.59268083384054,NaN,NaN,-164.29086766492168,-141.73240932136625,-3.8898081891605356,-1.1160108437332497,2.773797345427286,5317723272,5421607493.2,23.06835542180488,42.71846164397171,NaN,NaN,-3.1431920391767094,12.940731797680586
2022-09-01T09:30:00-04:00,296.72,299.78,292.95,299.4,57990745,47017680.6,37.735709956772354,51.44955779349309,NaN,NaN,-164.22393104526722,-166.919172107438,-3.8326512935895627,-2.0170167715596676,1.815634522029895,5375714017,5389486015.8,20.184454294695016,40.305269438783284,NaN,NaN,-6.342239332334218,10.1860216362499
2022-09-02T09:30:00-04:00,302.34,303.75,293.52,295.17,64666839,47556323.95,34.81526969294464,48.993400845058844,NaN,NaN,-139.41787473377647,-169.8898773612197,-3.8824140561047096,-3.037383048100992,0.8450310080037177,5311047178,5358240718.6,17.847191967894986,37.58550922870565,NaN,NaN,-9.988411850011394,7.303959709641143
2022-09-06T09:30:00-04:00,295.66,296.6,290.87,293.05,57005444,48203281.3,33.41930821232212,46.507017595819796,NaN,NaN,-143.18468480793504,-160.57403828882312,-3.8530792650694723,-3.971318073333123,-0.11823880826365041,5254041734,5325258702.8,15.771171547284354,34.58395112564504,NaN,NaN,-13.452426213993029,4.338761720550547
2022-09-07T09:30:00-04:00,293.54,299.99,293.27,298.97,49260381,48678089.35,40.58370701507205,44.86630109977458,NaN,NaN,-103.2201939045748,-142.86751043129505,-3.253829473925672,-4.185525650670741,-0.9316961767450684,5303302115,5312365663.2,15.03492091844302,31.75764342308339,NaN,NaN,-14.401950592419624,1.6615171044119514
2022-09-08T09:30:00-04:00,296.85,301.87,295.45,300.52,55649821,48887602.2,42.33335550248637,43.311124912363766,NaN,NaN,-81.5917361646366,-126.32768413123802,-2.600248721397323,-4.182007078491722,-1.5817583570943992,5358951936,5320611396,17.68169437154843,29.013044231028093,NaN,NaN,-14.674434431624524,-0.6721902578789734
2022-09-09T09:30:00-04:00,302.83,307.6,300.5209,307.09,56125215,49398980.45,49.16640313849604,42.78000449253699,NaN,NaN,-43.09194189615826,-102.10128630141621,-1.6205849927003115,-3.6074895979697885,-1.986904605269477,5415077151,5328484022.8,20.23648707449712,26.703609551114994,NaN,NaN,-12.808411148176058,-2.405936099349985
2022-09-12T09:30:00-04:00,308.5,311.08,308.18,310.74,45905737,49647848.35,52.53157151574568,43.067509569200034,NaN,NaN,-9.412798483627904,-76.1002710513865,-0.6705483006322277,-2.8250899810597616,-2.154541680427534,5460982888,5358471164.8,29.244326004141982,25.577786340898903,NaN,NaN,-10.18690884287506,-3.5175036341392816
2022-09-13T09:30:00-04:00,301.8,303.02,292.785,293.7,79562172,51712626.25,39.41367276307968,42.43426934347951,NaN,NaN,-86.00924345480053,-64.6651827807596,-1.1077429035838642,-3.539220309907364,-2.4314774063235,5381420716,5383946961.2,35.87034420582445,25.352279011594597,NaN,NaN,-12.277077459070261,-4.768871323415135
2022-09-14T09:30:00-04:00,294.865,296.93,293.06,296.03,54907198,52398642.95,41.56252397374654,41.89035384490443,NaN,NaN,-86.50600856489439,-61.32234571282352,-1.152835825302323,-3.872522187951404,-2.719686362649081,5436327914,5410552121,41.980956160412724,25.721477487193457,NaN,NaN,-13.155406891770893,-5.966947833180243
2022-09-15T09:30:00-04:00,294.07,296.53,289.46,291.1,65299411,53271505.75,38.45469724636716,40.75153551427885,NaN,NaN,-101.04723678944477,-65.21344583778514,-1.41049185730241,-4.482801184277093,-3.0723093269746835,5371028503,5412967434.4,42.516458796805146,26.289154522413117,NaN,NaN,-14.923913726303303,-7.24651438934068
2022-09-16T09:30:00-04:00,287.72,289.72,285.62,289.32,79920391,55170666.7,37.36823354999457,40.339293738748765,NaN,NaN,-125.78737489048582,-81.75253243665067,-1.5836311365597728,-5.0518482476744,-3.468217111114627,5291108112,5388173626.6,38.57998369742953,26.764361087186327,NaN,NaN,-16.67225446807179,-8.593048686302268
2022-09-19T09:30:00-04:00,286.1,291.21,286.04,291.05,52613831,55212829.75,39.1671651963864,40.20617712762322,NaN,NaN,-110.44431259625526,-101.95883525917614,-1.467111289745957,-5.3021062232970735,-3.8349949335511164,5343721943,5364721437.6,35.25495479677477,27.1701408235618,NaN,NaN,-17.529485454800565,-9.869682510373453
2022-09-20T09:30:00-04:00,288.49,291.07,286.38,288.73,51271117,55221441.1,37.60719083625213,40.12465068189668,NaN,NaN,-108.67756321242716,-106.49249921070145,-1.4302645723165366,-5.622825648946787,-4.19256107663025,5292450826,5346927459.6,32.935569452550325,27.58620490786481,NaN,NaN,-18.70190926777624,-11.131429190002422
2022-09-21T09:30:00-04:00,289.59,293.95,283.42,283.56,82930963,57393135.55,34.32617742841357,39.89178471629139,NaN,NaN,-116.0067248640673,-112.39264247053605,-1.6239074742814221,-6.222445419482028,-4.598537945200606,5209519863,5301565849.4,27.896969576669136,27.931105918926544,NaN,NaN,-20.715751100971154,-12.500618034426527
2022-09-22T09:30:00-04:00,282,283.03,278.815,280.07,62757073,58628136.25,32.27890573354392,39.502012986060784,NaN,NaN,-162.88762456782433,-124.76072002621194,-1.8409508346257768,-6.899726488482827,-5.05877565385705,5146762790,5256712706.8,23.989040521201787,28.20286207796274,NaN,NaN,-23.030874133349393,-14.00494033427265
2022-09-23T09:30:00-04:00,277.55,277.85,272.02,275.51,74815189,60463982.95,29.779740094163003,39.14233230043353,NaN,NaN,-193.49249734169297,-138.3017445164534,-2.1253723782904483,-7.71549112672011,-5.590118748429662,5071947601,5212880604.6,20.906832239788386,28.42140781166941,NaN,NaN,-25.779219074124654,-15.686980154251508
2022-09-26T09:30:00-04:00,275.03,279.49,273.56,274.37,71176694,60570430.65,29.171658236088405,38.83892873070255,NaN,NaN,-162.66116818014774,-148.74511563323188,-2.2140148507996162,-8.357637311929182,-6.143622461129565,5000770907,5144290397.4,17.18573010706021,28.522447708796257,NaN,NaN,-28.199913203972176,-17.474542018497317
2022-09-27T09:30:00-04:00,277.81,280.21,272.11,274.48,69780115,61643343.85,29.32162679062128,38.034494428956066,NaN,NaN,-142.2843955970404,-155.46648211015454,-2.0904817420294775,-8.756724638666412,-6.666242896636935,5070551022,5099910436.6,15.289519095068627,28.540633292840944,NaN,NaN,-30.132562306394227,-19.28283063105402
2022-09-28T09:30:00-04:00,274.46,281.25,272.945,279.94,79652140,63066725.85,36.50780694209769,37.61838381749974,NaN,NaN,-106.6536689981622,-153.59587093697354,-1.4942477669525225,-8.534052605327588,-7.0398048383750655,5150203162,5088047096.4,14.81882662792512,28.336142739725,NaN,NaN,-29.798797880424022,-20.785111666678304
2022-09-29T09:30:00-04:00,275.86,276.25,268.84,271.87,81215957,64625321.65,31.4224930020722,36.35096166489803,NaN,NaN,-134.08341772279178,-147.835029567967,-1.493036915352329,-8.906100982565476,-7.413064067213147,5068987205,5072491979.4,14.20148145849457,27.905070910010526,NaN,NaN,-31.052023813125423,-22.251813401885034
2022-09-30T09:30:00-04:00,271.03,275.19,267.1,267.26,78482378,65649903.3,28.942343863810052,34.66601683261691,NaN,NaN,-133.03800221114312,-135.74413054185703,-1.6406264549260943,-9.463847135870765,-7.8232206809446705,4990504827,5056203424.6,13.564240512596754,26.785064803471585,NaN,NaN,-32.88976149062739,-23.77152027170537
2022-10-03T09:30:00-04:00,269.07,275.16,267.53,273.53,61267449,65479933.8,36.305900926294676,34.444033129989414,NaN,NaN,-102.74688200813151,-123.7612733074538,-1.1756688075089432,-9.292806690330849,-8.117137882821906,5051772276,5066403698.4,16.10305023905866,25.373115234416883,NaN,NaN,-32.11661713783647,-24.963676966866956
2022-10-04T09:30:00-04:00,278.99,282.85,278.99,282.13,66696931,65964508.15,44.76132890037087,34.672519196176864,NaN,NaN,-35.336312808411535,-102.37165674972803,-0.19977755475970405,-8.366859826271536,-8.167082271511832,5118469207,5075987335.4,18.52445387816391,23.697650785684825,NaN,NaN,-28.557678181630227,-25.477105711833136
2022-10-05T09:30:00-04:00,278.28,283.81,275.42,281.98,55766318,66289805,44.64999298565917,35.11504032041201,NaN,NaN,-36.7131739266419,-88.38355773542396,0.4872499263834378,-7.558019863532536,-8.045269789915974,5062702889,5058487280.8,17.52954047346269,21.91287090544608,NaN,NaN,-25.8290217082488,-25.527379425606803
2022-10-06T09:30:00-04:00,280.96,284.18,279.43,279.76,53489411,66181784.5,42.94738210351576,35.51355093137781,NaN,NaN,-26.870146582484143,-66.94090350736244,0.8239949706391796,-7.015276076616999,-7.839271047256179,5009213478,5046532535.4,16.86324534404207,20.361675308775546,NaN,NaN,-24.101008511273623,-25.323612152130636
2022-10-07T09:30:00-04:00,275.02,275.15,267.74,269.1,71354674,66943257.45,35.873515554164655,35.27829024264768,NaN,NaN,-98.89032419757072,-60.111367904647935,0.3830379040515046,-7.360473667191798,-7.743511571243302,4937858804,5036003330.8,16.276438193432554,19.00606697996539,NaN,NaN,-24.827473389835138,-25.252735186088422
2022-10-10T09:30:00-04:00,269.3,269.7,263.64,266.41,60392990,67667620.1,34.336575583127626,35.044674867424504,NaN,NaN,-131.59594204034317,-65.88117991109027,-0.014498321178860962,-7.761634472716878,-7.747136151538017,4877465814,5001142038.4,14.47984130597166,17.687800683781198,NaN,NaN,-25.905006640426777,-25.345916822422474
2022-10-11T09:30:00-04:00,264.7,267.63,261.03,262.75,66522509,67015636.95,32.30837206924248,34.900545913197995,NaN,NaN,-142.08848850693815,-87.2316150507956,-0.4258497877203453,-8.279448386188449,-7.853598598468103,4810943305,4939636858,11.969560190025717,16.550128584735237,NaN,NaN,-27.435928915495854,-25.644489978575812
2022-10-12T09:30:00-04:00,263.4,265.36,261.95,262.66,50580179,66799286,32.257913268117434,34.89904645138182,NaN,NaN,-134.14494929354981,-106.71797012417717,-0.5954969986319778,-8.597969846758076,-8.002472848126098,4760363126,4879168905.4,10.11326082701568,15.559001463721943,NaN,NaN,-28.66792748428993,-26.07640962224926
2022-10-13T09:30:00-04:00,255.16,270.17,254.26,268.82,112894068,69179018.85,39.25121597881487,35.57558044314267,NaN,NaN,-114.26050530638551,-124.19604186895745,-0.20453782060272196,-8.258145123879501,-8.05360730327678,4873257194,4851977648.6,9.406781315592212,14.737569254850788,NaN,NaN,-27.622282419251,-26.297248593249506
2022-10-14T09:30:00-04:00,271.2,271.81,260.14,260.74,77244302,69045214.4,34.25578449515892,35.938732318790564,NaN,NaN,-105.90005232862266,-125.59798749516783,-0.39099349457417176,-8.542349171494493,-8.151355676920321,4796012892,4823608466.2,8.722183068784389,14.133030180688227,NaN,NaN,-28.285194227534028,-26.581240826718723
2022-10-17T09:30:00-04:00,266.84,270.24,266.74,269.35,64576452,69643345.45,42.63399001290718,36.8896154060967,NaN,NaN,-54.425567821010965,-110.16391265130139,0.13642066551864573,-7.980829845022015,-8.11725051054066,4860589344,4820233172.2,8.64160099940149,13.658178888140577,NaN,NaN,-26.042010840633907,-26.504207971563748
2022-10-18T09:30:00-04:00,276.53,277.21,268.74,271.48,69780995,70568839.35,44.517679080764,37.46174913028715,NaN,NaN,-8.283921161007932,-83.40299918211535,0.6697772940332047,-7.280028892999155,-7.94980618703236,4930370339,4844118579,14.650823331501627,13.646178652681755,NaN,NaN,-23.64808297034885,-26.096190114247335
2022-10-19T09:30:00-04:00,269.93,273.68,268.07,270.49,53115405,69078061.45,43.79782023715563,38.345701075650254,NaN,NaN,-21.92897844895065,-60.95980501319552,0.978261441786783,-6.726979384798881,-7.705240826585664,4877254934,4867496940.6,20.184611577895396,14.073545089781813,NaN,NaN,-21.952469704433213,-25.50423005570246
2022-10-20T09:30:00-04:00,269.58,274.84,267.92,269.11,60605496,68970482.6,42.759862419220774,39.33266668675102,NaN,NaN,-18.147735641207255,-41.73725108015988,1.1025100817354412,-6.327103224416362,-7.429613306151803,4816649438,4856175389.4,19.524408370437982,14.499271365341901,NaN,NaN,-20.8648197048194,-24.841457148433452
2022-10-21T09:30:00-04:00,267.98,275.969,266.8236,275.42,77897694,69124607.85,48.741598187753794,40.22093077685524,NaN,NaN,14.867990412394015,-17.58364253195653,1.5930151468763674,-5.438344372556344,-7.031359519432711,4894547132,4875882237.4,24.173561055870096,15.075736423685573,NaN,NaN,-18.080659723523127,-23.875628944874833
2022-10-24T09:30:00-04:00,275.69,279.4,271.97,278.45,63963569,68763951.6,51.36963840787508,40.692952884534115,NaN,NaN,71.65774235140125,7.6330195025258885,2.0744168166503067,-4.438338498619828,-6.512755315270135,4958510701,4895466508.8,28.588768270261554,15.794616023121119,NaN,NaN,-14.957362180843441,-22.601590835727492
2022-10-25T09:30:00-04:00,279.41,284.6,277.9,284.21,59014494,68225670.55,55.989103598012385,41.50288935684506,NaN,NaN,139.92487494484214,37.2747787236959,2.694370990247962,-3.1447915774601825,-5.8391625677081445,5017525195,4912897480,32.363700163427026,16.854198858118572,NaN,NaN,-10.79895591662763,-20.91550013299894
2022-10-26T09:30:00-04:00,278.46,283.98,277.43,277.93,63898246,67437975.85,50.37103638928668,42.033150377257265,NaN,NaN,102.71985312362477,62.20454503821098,2.594162477961868,-2.596459470255809,-5.190621948217677,4953626949,4928171883,35.577420277994264,18.19092563911516,NaN,NaN,-8.928190746398066,-19.20302736348453
2022-10-27T09:30:00-04:00,276.79,278.2795,272.34,272.87,57760302,66265193.1,46.3365977451007,42.78051339089556,NaN,NaN,28.895514937993568,71.61319515405116,2.1197679706594688,-2.5409119848933415,-4.66067995555281,4895866647,4944015324.8,38.824377585138095,19.8014927385227,NaN,NaN,-8.61429299390981,-17.690351024973857
2022-10-28T09:30:00-04:00,272.23,281.698,272.06,281.22,62651312,65473639.8,53.02321091616925,44.11527305754139,NaN,NaN,71.10611693570029,82.8608204587124,2.286672966645507,-1.8023387472459262,-4.089011713891433,4958517959,4956809490.2,41.393197195277935,21.723875302044576,NaN,NaN,-6.133168327412088,-16.039324925322177
2022-10-31T09:30:00-04:00,278.92,279.76,275.99,277.95,47741952,64797364.95,50.375947347786266,45.405814148865936,NaN,NaN,59.1128679870591,80.35184558584396,2.100009587771202,-1.4639997291774307,-3.5640093169486327,4910776007,4947262551.4,40.042032809578195,23.729051917726895,NaN,NaN,-4.963433860509045,-14.457054773206016
2022-11-01T09:30:00-04:00,281.495,282.07,274.74,275.11,45895897,63757313.25,48.12850380510397,46.53942775865069,NaN,NaN,56.62692886470211,63.69225636981596,1.7241768528620622,-1.408788250871055,-3.132965103733117,4864880110,4916733534.4,35.995686551396446,25.57779661232552,NaN,NaN,-4.706378391495613,-13.064101004390244
2022-11-02T09:30:00-04:00,275.08,278.21,265.61,265.68,79803142,64959154.45,41.50689069825338,46.70054738146773,NaN,NaN,-32.88552203480772,36.57118133812946,0.8249900510366421,-2.1017275399373148,-2.926717590973957,4785076968,4883023538.2,32.13427573394516,27.2011890707793,NaN,NaN,-6.671148134099473,-12.150822022920133
2022-11-03T09:30:00-04:00,263.01,264.5,260.1,260.49,70038903,65786629.05,38.37737552651333,46.99494674085019,NaN,NaN,-128.64338573287023,5.063401203956711,-0.08638150750908347,-3.034694475360311,-2.9483129678512277,4715038065,4846857821.8,28.590687881912643,28.620367986002748,NaN,NaN,-9.338881182567931,-11.749116188584104
2022-11-04T09:30:00-04:00,265.53,266.61,259.08,264.68,78313213,66134556,42.16837401666542,46.96168845540434,NaN,NaN,-94.20250071662491,-27.998322326508326,-0.35880806490158257,-3.396823048978206,-3.0380149840766233,4793351278,4813824485.6,25.79289926587903,29.845460719322574,NaN,NaN,-10.32525522786036,-11.545707479909284
2022-11-07T09:30:00-05:00,265.75,268.14,263.57,267.59,47333828,65481597.9,44.71230628516082,46.97559039857555,NaN,NaN,-56.70409914516627,-51.16171575295339,-0.29734403721815994,-3.409695030599323,-3.1123509933811633,4840685106,4799806305.4,24.68878530414038,30.562458003082487,NaN,NaN,-10.341395504292803,-11.373662911964072
2022-11-08T09:30:00-05:00,269.14,272.85,265.52,269.54,63213785,65316161.7,46.413378776087036,47.16241600849922,NaN,NaN,-25.379989867936832,-67.56309949948118,-0.09041315529796634,-3.225367437503621,-3.134954282205655,4903898891,4807610061.6,26.573151759895396,31.01878230179677,NaN,NaN,-9.845527495678231,-11.155357852494665
2022-11-09T09:30:00-05:00,267.76,268.56,263.03,263.32,64862129,66030259.2,41.97683755782366,47.10648566125656,NaN,NaN,-84.62257128857135,-77.91050935023391,-0.32433836959146456,-3.5403772441949855,-3.216038874603521,4839036762,4818402020.4,29.211017288135366,31.710682938775154,NaN,NaN,-10.77690124865603,-11.10129262337486
2022-11-10T09:30:00-05:00,276.01,283.05,273.85,282.75,99256693,65348390.45,56.09510434338411,47.631736100944444,NaN,NaN,102.18107936191602,-31.745616331276654,0.8153414117607736,-2.196862109902554,-3.0122035216633276,4938293455,4863053098.4,38.97877814097449,32.768198444854036,NaN,NaN,-6.574232056852132,-10.454569685300184
2022-11-11T09:30:00-05:00,282.56,288.64,281.19,287.96,66961751,64834262.9,58.977488365460054,48.17515395505766,NaN,NaN,157.80212729560859,18.655309271170044,1.8468807883716782,-0.7036025361987299,-2.550483324570408,5005255206,4905433884,46.521533620119826,34.049110255558205,NaN,NaN,-2.215165064595272,-9.27751188234234
2022-11-14T09:30:00-05:00,285.86,289.215,284.44,285.44,55080048,64359442.7,57.02733194768662,48.24931312289153,NaN,NaN,140.81776797015195,58.15968269423369,2.259044899445701,0.273322799736718,-1.9857220997089828,4950175158,4927331894.4,49.963127527811984,35.30621221015713,NaN,NaN,0.5490004894555007,-7.8737244006569345
2022-11-15T09:30:00-05:00,292.21,293.26,285.97,289.39,73985372,64569661.55,59.29912197813316,48.88703352209485,NaN,NaN,150.55571862180236,93.34682439218152,2.6691417342193655,1.3507050680652242,-1.3184366661541413,5024160530,4951384222.2,53.50266020697146,36.586586490798354,NaN,NaN,3.5304992866342166,-6.2445495881867705
2022-11-16T09:30:00-05:00,287.39,289.4838,284.6,285.44,48859804,64356881.5,56.104926073452816,49.58477125983429,NaN,NaN,106.43259594696973,131.55785783928974,2.5462018284423378,1.8643156193987807,-0.6818862090435569,4975300726,4978637015,57.197248433472765,37.89893440853655,NaN,NaN,4.972763908170113,-4.642076231564358
2022-11-17T09:30:00-05:00,280.88,286.3189,280.72,284.81,55462076,64099710.5,55.59059502105138,49.768155838754446,NaN,NaN,74.40500621245542,126.00264320939762,2.3016808681992096,2.195214876205455,-0.1064659919937545,4919838650,4974946054,56.54197578465267,38.98099002206332,NaN,NaN,5.970626177501189,-3.125975887412137
2022-11-18T09:30:00-05:00,287.89,287.99,282.3211,284.82,53588631,62884257.35,55.59755315504671,50.14112768213018,NaN,NaN,77.89334589862153,110.02088693000022,2.029370759783316,2.4302474577353905,0.4008766979520746,4973427281,4968580469,55.36394276492189,40.07541216173072,NaN,NaN,6.7786973577378,-1.7110225666764318
2022-11-21T09:30:00-05:00,283.4,284.58,281.04,281.89,40083527,61690255.25,52.97835356170139,50.48754552188715,NaN,NaN,49.30323996833787,91.7179813296374,1.561668619427289,2.352962472236186,0.7912938528088969,4933343754,4965214188.2,54.71472941611571,41.412486652067805,NaN,NaN,6.739619121875015,-0.503788039740511
2022-11-22T09:30:00-05:00,282.64,286.11,280.46,285.95,41873444,60833202.75,56.06685831148495,51.52754320854655,NaN,NaN,63.46775595130729,74.30038879553838,1.438542369271279,2.589471814397996,1.1509294451267167,4975217198,4955425521.8,52.7766992771743,42.88694547658418,NaN,NaN,7.567334406957654,0.6492294526449411
2022-11-23T09:30:00-05:00,285.97,289.46,285.79,288.82,46389967,59957788.8,58.159008949497604,52.940517024474,NaN,NaN,91.3249666274329,71.27886293163101,1.458622344048141,2.974207375186893,1.515585031138752,5021607165,4964686809.6,54.42162994206815,44.73201276659529,NaN,NaN,8.856495135940822,1.8216959788300668
2022-11-25T09:30:00-05:00,287.19,287.91,286.42,286.92,15498797,57844713.55,56.24927015920215,53.94629532036947,NaN,NaN,75.59470515166203,71.51680271947234,1.2596738290076273,3.090177317398286,1.8305034883906588,5006108368,4981940753.2,57.39887128098404,46.98958219624564,NaN,NaN,9.427867873396478,2.9082919637681255
2022-11-28T09:30:00-05:00,284.9,286.96,281.76,282.71,38877045,56656000.2,52.16207819143298,54.4784218851032,NaN,NaN,43.47175695681119,64.63248493111027,0.7835818548608606,2.8099808069667347,2.026398952105874,4967231323,4980701561.6,57.1103321585746,49.30540697156237,NaN,NaN,8.792451656464104,3.7488862055818366
2022-11-29T09:30:00-05:00,282.94,283.35,279.17,280.57,35618878,56049846.5,50.16663452255637,54.746511581279584,NaN,NaN,18.48746303174915,58.46932954379251,0.2890558802498542,2.387718802418192,2.0986629221683377,4931612445,4980355299.8,57.02407197356705,51.480472701110344,NaN,NaN,7.700791631052622,4.313444123506234
2022-11-30T09:30:00-05:00,280.84,293.47,279.97,293.36,74718088,57490956.05,60.01243444117878,56.03476850151924,NaN,NaN,78.41799143716186,61.459376640963434,0.761038604004983,3.0499611771745663,2.2889225731695833,5006330533,4986577966.8,58.2446471112432,53.55430340276091,NaN,NaN,9.699628986850325,5.082899103983961
2022-12-01T09:30:00-05:00,293.69,295.75,290.88,293.72,51547332,56078165.55,60.25049047942792,56.33158179695094,NaN,NaN,109.95776945717637,65.18593720691213,1.0190800190428169,3.5627725969731046,2.5436925779302877,5057877865,4993832106.8,59.68222015410298,55.03312068941295,NaN,NaN,11.36474445234359,5.980305582321051
2022-12-02T09:30:00-05:00,288.54,293.45,288.36,292.55,53583172,55255379,59.02071245349916,56.33466923181088,NaN,NaN,92.48875719035263,68.56474761465024,1.029536493995976,3.830613195425258,2.801076701429282,5004294693,4993469371.8,59.57177503813953,55.96528079070007,NaN,NaN,12.38525038456362,6.895297696927132
2022-12-05T09:30:00-05:00,290.38,291.68,286.15,287.64,41482121,53413824.4,54.0361099381789,56.12101051684605,NaN,NaN,61.330334540508915,72.13646313138977,0.6432387947241742,3.6051251948345,2.9618864001103256,4962812572,4992585621.6,59.28392701230842,56.63105218244981,NaN,NaN,11.826301565118747,7.599726820954506
2022-12-06T09:30:00-05:00,287.48,287.62,280.255,281.68,53937605,53744013.25,48.6635716826062,55.36132835287983,NaN,NaN,-14.819192921903094,65.47513194065934,-0.039960989159199656,2.911935163661326,2.9518961528205256,4908874967,4988038126,57.7379205711977,56.93357077989454,NaN,NaN,9.698718757147908,7.899582811839277
2022-12-07T09:30:00-05:00,280.47,282.57,278.7801,280.53,45614254,52864036.7,47.67853010516624,54.75944292657365,NaN,NaN,-71.17809698234178,35.5559142567586,-0.5663847439821224,2.2439152228428725,2.810299966824995,4863260713,4959424162,49.067185703578815,56.35285201347354,NaN,NaN,7.668888120461927,7.866626427356799
2022-12-08T09:30:00-05:00,281.91,284.84,279.79,283.85,42594913,51750675.9,50.776304080511316,54.41556500224936,NaN,NaN,-63.863646207659215,0.7916311237914812,-0.6803924552801357,1.9598093977248254,2.640201853004961,4905855626,4929019714.2,41.871713796941634,55.304976157208465,NaN,NaN,6.816327584089153,7.716583735461421
2022-12-09T09:30:00-05:00,282.81,285.64,281.59,282.04,47860487,49180865.6,49.070552004335866,53.94935063434144,NaN,NaN,-65.078241865265,-30.721768687332048,-0.8557631710580216,1.570497889182434,2.4262610602404555,4857995139,4899759803.4,36.347579935911135,53.946664526564845,NaN,NaN,5.617315792182646,7.416688314993024
2022-12-12T09:30:00-05:00,282.22,285.64,281.16,285.58,35732518,47619403.95,52.435997679349576,53.91061092845917,NaN,NaN,-37.113826574711574,-50.41060091037614,-0.7170268477430048,1.5299775005616993,2.247004348304704,4893727657,4885942820.4,34.06228555730958,52.47148996522155,NaN,NaN,5.527050848423699,7.14674010548312
2022-12-13T09:30:00-05:00,296.65,296.875,285.91,288.65,80667675,48898785.3,55.20079751571524,53.84874944304705,NaN,NaN,99.02484658988377,-27.64179300801876,-0.4170471576769197,1.7256954012085544,2.142742558885474,4974395332,4899046893.4,38.04105203270943,51.41894373347406,NaN,NaN,6.234618472603182,7.0164370150717
2022-12-14T09:30:00-05:00,288.05,291.41,283.19,286.51,64984432,48448738.3,52.892766362569354,53.47258925826646,NaN,NaN,28.305897733984473,-7.744994064753511,-0.363268173838299,1.6886573415876,2.051925515425899,4909410900,4908276930.8,40.752889014771,50.44260509580998,NaN,NaN,6.189516685774238,6.898305539457777
2022-12-15T09:30:00-05:00,282.33,283.01,275.67,276.89,60554119,49033454.05,43.98878464774661,52.596840293162494,NaN,NaN,-143.93194843527635,-23.758654510276937,-0.9431503698674355,0.8729875530916047,1.8161379229590402,4848856781,4896877161.8,38.5109633909476,49.09346881795023,NaN,NaN,3.361528972472673,6.3930517441741905
2022-12-16T09:30:00-05:00,276.2,277.77,272.61,274.25,68300351,49675367.8,41.90401922115748,51.86412179528567,NaN,NaN,-188.69172186691023,-48.481350510605985,-1.442203810534997,0.01338315979029403,1.455586970325291,4780556430,4881389420,35.6421431206586,47.56002674381337,NaN,NaN,0.37622025135836035,5.5335043880576436
2022-12-19T09:30:00-05:00,273.87,273.96,268.49,269.75,44167920,49204332.25,38.550232044780486,51.03437876115883,NaN,NaN,-218.44907116511453,-84.74839942868657,-1.9798479277374714,-1.0192229393465482,0.9606249883909233,4736388510,4849921590.6,30.64677885428293,45.675934378150224,NaN,NaN,-3.2295333131709922,4.281641859310696
2022-12-20T09:30:00-05:00,268.56,271.32,266.95,269.54,51064199,49753365.85,38.39579377258778,49.4903329991166,NaN,NaN,-198.95319761495273,-144.3440082696539,-2.2352054886406716,-1.833381872409916,0.40182361623075546,4685324311,4792107386.4,23.99333592525757,43.229412150579826,NaN,NaN,-6.170812344140986,2.788434115960456
2022-12-21T09:30:00-05:00,270.6,274.78,269.74,273.45,46394694,49979428.35,42.97641714535193,48.25647061811118,NaN,NaN,-129.0950234294166,-175.82419250233409,-2.03222177918103,-2.1384536077455323,-0.10623182856450208,4731719005,4756569007.4,20.978378011403095,40.464851997529834,NaN,NaN,-7.384042845931764,1.3352231214044248
2022-12-22T09:30:00-05:00,270.38,270.5149,262.455,266.76,60278377,50673848.85,37.797789719215636,46.74054756566236,NaN,NaN,-167.58310203903196,-180.55442322308522,-2.224434774424743,-2.886775296595431,-0.6623405221706878,4671440628,4721085776.8,18.48129367585146,37.52981761450926,NaN,NaN,-10.08170157632617,-0.2957661211285172
2022-12-23T09:30:00-05:00,265.47,268.04,263.53,267.36,39373584,51867588.2,38.51339704222856,45.63178235880876,NaN,NaN,-144.01430501994153,-171.61893985369147,-2.183972579077846,-3.392306246017995,-1.2083336669401492,4710814212,4707137333.2,17.59468868643887,34.55201487694715,NaN,NaN,-12.047324441827598,-1.9745601669426716
2022-12-27T09:30:00-05:00,266.74,266.85,263.03,263.58,38009005,51824186.2,35.724929627105894,44.70759364055874,NaN,NaN,-135.57686911618794,-155.04449944390615,-2.274338829318435,-4.051257203588193,-1.776918374269758,4672805207,4694420672.6,16.803239854480395,31.628109111467342,NaN,NaN,-14.571164254276352,-3.7740750365617686
2022-12-28T09:30:00-05:00,263.17,265.47,259.73,260.1,47139043,52400194.45,33.33221939819471,43.68285716148934,NaN,NaN,-134.25131015805263,-142.1041219525261,-2.4176396891355667,-4.798967985689217,-2.38132829655365,4625666164,4682489043.2,16.072703959945528,29.27136041549354,NaN,NaN,-17.44629645979622,-5.727249525595261
2022-12-29T09:30:00-05:00,262.96,267.405,262.25,266.44,45893567,50958968.4,41.07525306500378,42.98992494609594,NaN,NaN,-94.10398985057698,-135.10591523675822,-1.9544071202771627,-4.824337196900103,-2.8699300766229405,4671559731,4670457188.4,15.348068198146905,27.376814301293912,NaN,NaN,-17.609197465017015,-7.424670659798369
2022-12-30T09:30:00-05:00,263.62,266.41,262.29,266.28,37858277,50274515.65,40.946005580452116,42.409600201532825,NaN,NaN,-87.57821102103122,-119.10493703315805,-1.5456548911970076,-4.8019986906192,-3.2563437994221927,4633701454,4662909353.6,14.894410156089151,25.84444503130663,NaN,NaN,-17.777044926269557,-8.903581269294254
2023-01-03T09:30:00-05:00,268.65,270.155,262.13,264.48,42335325,49712123.3,39.44237177944342,41.481484065825235,NaN,NaN,-76.0638141798481,-105.51483886513938,-1.2936154594197582,-4.87336312369689,-3.579747664277132,4591366129,4639019737,13.531143333974654,24.37793487249699,NaN,NaN,-18.344758860548346,-10.252320925187695
2023-01-04T09:30:00-05:00,266.64,267.45,262.53,265.74,47754861,50025760.3,41.07363086660116,40.47240073374566,NaN,NaN,-72.26442649312172,-92.85235034052613,-0.9547824338641506,-4.77322570660732,-3.8184432727431696,4639120990,4632282893.6,13.16519743180865,22.60108811528979,NaN,NaN,-18.365198401486243,-11.411303421801772
2023-01-05T09:30:00-05:00,264.04,264.21,261.26,261.58,45396744,49598717.25,37.48356478822222,39.37174347843514,NaN,NaN,-88.78091169163588,-83.75827064724278,-0.9230266478866476,-4.972226582601479,-4.0491999347148315,4593724246,4625894510,12.811365492784631,20.60526500657648,NaN,NaN,-19.40426640430489,-12.553155276445075
2023-01-06T09:30:00-05:00,263.35,269.94,260.34,268.8,54659739,50050991.5,46.262561005621784,39.534156075426225,NaN,NaN,-50.27233705525737,-74.99194008817885,-0.3570568386921682,-4.495520983080041,-4.138464144387873,4648383985,4621259360.8,12.547855802445525,18.750757321683476,NaN,NaN,-17.642369329327764,-13.280185855428316
2023-01-09T09:30:00-05:00,270.83,275.29,269.92,270.54,45568676,50199679.65,48.15219530185192,39.980454366904404,NaN,NaN,3.1370031624765553,-56.8488972514773,0.16517190523019742,-3.931999262850127,-4.097171168080324,4693952661,4633309602.2,17.309671672331277,17.44129507537438,NaN,NaN,-15.621479773960727,-13.614656415218661
2023-01-10T09:30:00-05:00,269.49,272.94,268.97,272.83,35247763,49569043.45,50.613578726500926,40.84212198702729,NaN,NaN,6.00361902974809,-40.43541060955806,0.6673317580636775,-3.263006470500727,-3.9303382285644046,4729200424,4660876461.2,27.09023869413818,17.1872564925069,NaN,NaN,-13.19177487791837,-13.554244767032905
2023-01-11T09:30:00-05:00,273.92,277.66,273.12,277.55,44077036,49986269.35,55.3215930782926,42.0511076517205,NaN,NaN,62.760508363671185,-13.430423638199482,1.284144708509276,-2.3251573429278096,-3.6093020514370857,4773277460,4687707755.2,35.13245575025627,17.982907908578234,NaN,NaN,-9.610331164600657,-12.990828538114013
2023-01-12T09:30:00-05:00,278.12,280.1,273.74,279.05,60599953,48982883.25,56.7332162484018,43.03373615908121,NaN,NaN,99.47383225197797,24.220525150523287,1.7320659422017135,-1.444219623684944,-3.1762855658866576,4833877413,4735738388.6,46.507311954889815,19.806403190255853,NaN,NaN,-6.2331454238876995,-12.025445236081682
2023-01-13T09:30:00-05:00,276.5,281.219,276.16,280.97,44802936,47973808.45,58.53895929403585,44.51524827156835,NaN,NaN,139.34962312159783,62.14491718589433,2.073504038744897,-0.5844055174555365,-2.6579095562004333,4878680349,4781797661.4,54.70916897776045,22.394108568963638,NaN,NaN,-2.865033681843156,-10.716815014047606
2023-01-17T09:30:00-05:00,280.77,282.85,279.581,281.54,36269738,46759589.4,59.084897256295704,45.98464114400172,NaN,NaN,158.67387100267828,93.25229075393467,2.239422037338781,0.14136799047304294,-2.0980540468657383,4914950087,4825997146.6,60.904067122265424,25.487635600094105,NaN,NaN,0.07232802136739536,-9.175508866131178
2023-01-18T09:30:00-05:00,283.11,284.69,277.67,277.88,47754549,45732299.3,54.154014613378095,47.30100435730689,NaN,NaN,130.43101957803773,118.13777086359259,2.011576929514238,0.416417115027059,-1.5951598144871788,4867195538,4853596169.4,64.19714997530863,28.87291489443898,NaN,NaN,1.2911725512085457,-7.680268663654075
2023-01-19T09:30:00-05:00,276.22,277.375,273.89,275.15,44150436,45731425.1,50.75176937880912,48.54525792735077,NaN,NaN,64.540607749113,118.49379074068096,1.6036383887219272,0.4093881714152303,-1.194250217306697,4823045102,4863549697.8,65.33131559123322,32.39138715381667,NaN,NaN,1.375962671636006,-6.386521330041206
2023-01-20T09:30:00-05:00,276.79,283.02,275.71,282.68,60613606,46208895.45,58.49695650109927,49.78966531564331,NaN,NaN,109.74485612098184,120.54799551448176,1.7553198000284123,0.9998995327288185,-0.7554202672995938,4883658708,4873505956.8,66.47531905660071,36.043333643706234,NaN,NaN,3.8755022769234184,-4.9205179576176885
2023-01-23T09:30:00-05:00,283.54,290.21,282.73,288.96,52799905,46529156,63.633719389206945,51.41021630198294,NaN,NaN,159.05444674037903,124.488960238238,2.1660359567870238,1.9521246786841857,-0.21391127810283783,4936458613,4885061609.6,67.80327791274527,39.82253848346738,NaN,NaN,7.779504792482833,-3.1062289933176137
2023-01-24T09:30:00-05:00,287.31,289.55,286.78,288.37,44875146,45758994.45,62.84672922370405,53.081956119430124,NaN,NaN,143.43252454929996,121.44069094756233,2.2742154695275953,2.6288580588066566,0.3546425892790611,4891583467,4880388285.6,66.65338273724572,43.61698415512961,NaN,NaN,10.627217496922748,-1.1443080661404195
2023-01-25T09:30:00-05:00,283.77,288.36,281.18,287.73,50872022,46333916.35,61.95167835373457,54.57324522565394,NaN,NaN,106.74391521643109,116.703270075241,2.1787256458179556,3.0780496465515057,0.89932400073355,4840711445,4875091467,65.3016049407776,47.3410132629131,NaN,NaN,12.669448210495778,0.8290856876647517
2023-01-26T09:30:00-05:00,291.22,293.52,288.519,293.34,51596335,47013282.85,66.46073920120395,56.64304339800979,NaN,NaN,141.70831751588963,132.13681202859632,2.354480204503119,3.842424256362449,1.4879440518593299,4892307780,4888944002.6,67.17645873579656,51.224234208842525,NaN,NaN,15.899313880742765,2.9819754295330396
2023-01-27T09:30:00-05:00,292,298.26,291.88,296.26,56441939,47478427.65,68.54992448380781,58.23499793216593,NaN,NaN,154.5806807989326,141.10397696418647,2.5139962904915363,4.6304394149737504,2.116443124482214,4948749719,4901962204.8,68.8783323333289,55.2478396753342,NaN,NaN,19.26053524073919,5.3074839739910615
2023-01-30T09:30:00-05:00,292.93,294.38,289.89,290.27,49405833,47654040.95,60.25780698383388,59.09968448087893,NaN,NaN,110.32445981465054,131.35797957904077,2.08062702887918,4.717226910581189,2.636599881702009,4899343886,4894539259.4,66.7530201934801,58.77950742684482,NaN,NaN,19.585208090410237,7.347158847765229
2023-01-31T09:30:00-05:00,290.31,294.72,290.2,294.62,46705106,48096382.4,63.69260118044015,60.03390037044601,NaN,NaN,112.7636937629339,125.22421342176759,1.953499124299289,5.0784737870761205,3.1249746627768316,4946048992,4905432364.4,68.2988959765591,61.72298294701774,NaN,NaN,20.96280210083914,9.292250741061501
2023-02-01T09:30:00-05:00,294.41,303.43,292.3,300.92,67562173,49357724.8,68.00542059148339,60.93988804995964,NaN,NaN,141.21356070186388,132.1181425188541,2.144973649041223,5.80619172407836,3.6612180750371373,5013611165,4940012308.4,72.64686794454029,64.40258381803804,NaN,NaN,23.601040302702426,11.336363535581633
2023-02-02T09:30:00-05:00,307.57,313.68,306.73,311.72,83070628,51123513.15,73.75982906663224,62.156074679833246,NaN,NaN,195.95133486940367,142.96674598955696,2.8083952514935415,7.171712139404065,4.363316887910523,5096681793,4980887111,76.71268498983264,66.5601104633911,NaN,NaN,28.103654439112226,13.731690807514575
2023-02-03T09:30:00-05:00,304.94,312.39,304.54,306.18,76170804,52662216.15,67.09365813375013,62.767124596955696,NaN,NaN,155.36506066619492,143.1236219630094,2.683664954828866,7.717898081446606,5.03423312661774,5020510989,4995239365,77.9519389073858,68.22030831550718,NaN,NaN,29.33390191850617,15.960578109084803
2023-02-06T09:30:00-05:00,303.51,305.91,302.22,303.59,40802348,51969346.6,64.1736248751878,63.13060514116228,NaN,NaN,116.18886026558062,144.2965020531954,2.2536203780760236,7.85125859921277,5.597638221136746,4979708641,5011312316,79.2816469750064,69.53299259070297,NaN,NaN,29.286829037762512,17.864328241753046
2023-02-07T09:30:00-05:00,303.46,311.03,302.32,309.88,67583981,53070111.85,67.83485785867549,64.1078082301121,NaN,NaN,126.08965941752581,146.9616951841138,2.2163187708114735,8.368036684651088,6.151717913839614,5047292622,5031561042,80.84865742055335,70.72238597964902,NaN,NaN,30.506671626495002,19.670377296716183
2023-02-08T09:30:00-05:00,308.54,309.5,303.67,304.37,56720860,54143766.7,61.87012337499764,64.90197637269698,NaN,NaN,102.04526954463743,139.1280369526685,1.6690363881749288,8.238013399058275,6.568977010883346,4990571762,5026953161.4,79.377356552568,71.72567461974437,NaN,NaN,29.444068357411208,21.066618876815472
2023-02-09T09:30:00-05:00,308.84,308.99,300.2,301.68,49137818,54396805.8,59.13625633539043,64.94764064657492,NaN,NaN,78.33945899257297,115.60566177730236,1.0069591227695343,7.827675914345264,6.820716791575729,4941433944,4995903591.6,70.11769028816738,71.9858439934277,NaN,NaN,27.68774107862471,22.012493477073935
2023-02-10T09:30:00-05:00,299.48,301.57,297.25,299.7,50050104,53869313.35,57.13502888269476,64.48344846753834,NaN,NaN,43.88012162823193,93.30867396970977,0.3506533108573686,7.25903343014744,6.908380119290071,4891383840,4970078161.8,63.48421507398245,71.67733950494464,NaN,NaN,25.642436529956637,22.531056770342893
2023-02-13T09:30:00-05:00,301.13,305.1,299.93,304.5,39636720,53611002.55,60.61469495089139,64.32401744805172,NaN,NaN,63.13942700726548,82.69878731804677,0.16425412019585828,7.113697769534895,6.949443649339036,4931020560,4960340545.6,61.13567487477654,71.28321751476827,NaN,NaN,25.002275009730752,22.884087947398303
2023-02-14T09:30:00-05:00,302.89,307.72,300.91,306.75,64079057,55001468.5,62.165128852677206,64.33926391226191,NaN,NaN,70.4640921026363,71.57367385506885,0.11904523861459904,7.098250197607285,6.979204958992686,4995099617,4949901944.6,58.63164972812358,70.80679214243584,NaN,NaN,24.952221455202857,23.17953559137038
2023-02-15T09:30:00-05:00,304.9,309.27,304.2,309.1,43427298,54785105.95,63.769353391000045,64.14702206867591,NaN,NaN,81.25515352311108,67.4156506507636,0.17081206993320475,7.1927200464091925,7.021907976475988,5038526915,4959492975.2,60.24291188069388,70.31153879564279,NaN,NaN,25.38817163033681,23.495055025508442
2023-02-16T09:30:00-05:00,304.38,308.43,303.15,303.3,59498630,55552515.65,57.310547030403,63.34420939343271,NaN,NaN,56.15351293315337,62.97846143887968,-0.23985557884572106,6.722088502918837,6.961944081764558,4979028285,4967011843.4,61.5086194313843,69.78513073121817,NaN,NaN,23.77462290751409,23.53499329436639
2023-02-17T09:30:00-05:00,301.07,301.93,298.1,301.16,58230729,55433371.8,55.093322483450535,62.975317643405326,NaN,NaN,8.0009357899707,55.80262427122743,-0.6847209952053621,6.106042837757855,6.790763832963217,4920797556,4972894586.6,62.51415674085429,69.48235477031633,NaN,NaN,21.776729256912258,23.283812717587228
2023-02-21T09:30:00-05:00,297.26,298.73,293.89,294.03,46526708,55119711.95,48.377774589887665,61.881401458365865,NaN,NaN,-49.4587075754988,33.28299735467458,-1.444589854330225,4.985026515050436,6.4296163693806605,4874270848,4961544644.2,59.29563901579964,68.83926498740495,NaN,NaN,17.85778194355133,22.508665464153527
2023-02-22T09:30:00-05:00,294.62,296.3599,292.56,294.25,51389237,55445416.5,48.58602291672797,60.494301624454764,NaN,NaN,-69.56462124642596,5.2772546848620765,-1.8897108459821137,4.067477811903018,5.957188657885132,4925660085,4947656737.8,55.52842177706069,67.61651883258497,NaN,NaN,14.80037918597554,21.4074817101281
2023-02-23T09:30:00-05:00,297.97,298.13,292.55,296.82,69294443,56366537.55,51.069279168468675,58.87354806030022,NaN,NaN,-64.32852494580526,-23.83948100892119,-1.9599414508327797,3.507261844344157,5.467203295176937,4994954528,4938942260.4,53.24257955672766,65.94008273022033,NaN,NaN,12.941710734381346,20.198085856449993
2023-02-24T09:30:00-05:00,291.76,292.97,290.05,291.85,74331958,57503318.7,46.4017929087711,57.39555768708744,NaN,NaN,-118.10122417383457,-58.690428430318775,-2.2682345018766172,2.6319101678311654,4.900144669707783,4920622570,4927261117.4,50.25617248406031,63.961813699982805,NaN,NaN,9.906437964757707,18.727850443351095
2023-02-27T09:30:00-05:00,295.07,296.49,293.34,293.94,48995009,57130972.2,48.53206296078438,56.27830326463005,NaN,NaN,-78.83176113774996,-76.05696781586292,-2.253856779193379,2.0828236957160584,4.336680474909437,4969617579,4937025122,52.64708640733353,62.05934508800617,NaN,NaN,7.993837311059865,17.19441999588092
2023-02-28T09:30:00-05:00,293.3,296.124,292.96,293.56,48243141,57072837.6,48.157289843148575,54.872762692092415,NaN,NaN,-87.57837310683826,-83.6809009221308,-2.190481604812301,1.5985784688940612,3.789060073706362,4921374438,4946445840,54.899493436407624,60.2058333748529,NaN,NaN,6.324181188156036,15.64152873763451
2023-03-01T09:30:00-05:00,293.26,293.93,290.2,291.2,58286972,57651930.9,45.792217426308966,53.72434083861465,NaN,NaN,-116.87873250412626,-93.14372317367086,-2.221084432001677,1.012704533704266,3.233788965705943,4863087466,4933931316.2,51.401711309532914,58.2075730003504,NaN,NaN,4.233563533265902,14.011819422724708
2023-03-02T09:30:00-05:00,288.66,294.43,288.37,293.61,53738557,56960750.1,48.56994176434687,52.96960408354011,NaN,NaN,-101.30041926294723,-100.53810203709926,-1.999514042039006,0.7343964131571852,2.7339104551961912,4916826023,4918305615.2,47.3455652311312,56.58099263913353,NaN,NaN,3.1932153470816753,12.466304554775704
2023-03-03T09:30:00-05:00,295.39,299.92,294.87,299.68,60511540,55832795.7,54.84591242324252,52.806095765007804,NaN,NaN,-22.597241935646405,-81.43730558946163,-1.3933715044073973,0.9921960746869445,2.385567579094342,4977337563,4929648613.8,50.40503820597399,55.64676571999007,NaN,NaN,4.083918330964841,11.26882080851701
2023-03-06T09:30:00-05:00,300.94,304,299.82,300.02,56736294,54861070.2,55.17586438979369,52.41760786778655,NaN,NaN,23.825178895684406,-60.90591758277475,-0.9404610266098072,1.2099912958320829,2.15045232244189,5034073857,4942539869.4,53.69783541443492,55.11549147282282,NaN,NaN,4.904492069700712,10.35963098868611
2023-03-07T09:30:00-05:00,300.07,301.01,295.72,296.34,65955756,56118740.6,50.845175498991914,51.609039771094736,NaN,NaN,-22.415754596879616,-47.87339388078302,-0.8617392585948072,1.0732782491983812,1.9350175077931884,4968118101,4951888602,55.98036324343143,54.92611386677337,NaN,NaN,4.397904896695792,9.507955832687493
2023-03-08T09:30:00-05:00,296.77,298.43,294.88,297.82,50876265,55283354.8,52.461224090888784,50.80131624965822,NaN,NaN,-26.065854009156567,-29.710818181789087,-0.6904152264110033,1.0719984747794342,1.7624137011904375,5018994366,4983069982,62.602324988092,55.094643374444665,NaN,NaN,4.4230189168385605,8.781536273280503
2023-03-09T09:30:00-05:00,298.33,300.98,291.8299,292.66,71456691,56020146.35,46.69689296909043,50.04319810242161,NaN,NaN,-50.40298934016012,-19.531332197231663,-0.8922066697084559,0.6471553640548677,1.5393620337633236,4947537675,4989212312.4,63.75887497769566,55.255375913466914,NaN,NaN,2.759143982133384,7.921194517402343
2023-03-10T09:30:00-05:00,292.83,294.35,287.38,288.55,98593561,58492933.5,42.674743350012925,49.1561567357475,NaN,NaN,-122.9688194218286,-39.6056476944681,-1.248239357203737,-0.020937162741347493,1.2273021944623894,4848944114,4963533622.6,55.96646091758334,54.78768335466184,NaN,NaN,0.09712917374178548,6.803470896879406
2023-03-13T09:30:00-04:00,286.73,294.47,285.19,290.69,97123603,60846608.45,45.31586391463899,48.937448830372595,NaN,NaN,-109.97986844198607,-66.3666571620022,-1.2805782577698381,-0.37342062774990836,0.9071576300199298,4946067717,4945932394.6,51.335178713619,54.219079047363216,NaN,NaN,-1.3604362253246958,5.637198450850249
2023-03-14T09:30:00-04:00,294.31,297.93,293.45,297.37,73602545,62544899.7,52.649424048108585,49.22769176832834,NaN,NaN,-7.689827712499556,-63.42147178512619,-0.8156860144582925,-0.11244988805293588,0.7032361264053566,5019670262,4956242826.8,53.74957055798234,54.09201824600048,NaN,NaN,-0.3814670092107293,4.777389099412967
2023-03-15T09:30:00-04:00,294.71,299.27,293.24,298.93,83631535,63522523.6,54.194342095598294,49.450910548837605,NaN,NaN,16.757971896543545,-54.85670660398616,-0.3883966680478116,0.21774029134559214,0.6061369593934037,5103301797,4973104313,57.46605210949733,54.393694856912596,NaN,NaN,0.8890311746040294,4.221909395868833
2023-03-16T09:30:00-04:00,298,307.18,297.19,306.81,98556824,66278999.9,61.09879858757125,50.50069666875191,NaN,NaN,160.30040421309522,-12.716027893335092,0.3971375673719474,1.102558918608338,0.7054213512363906,5201858621,5023968502.2,66.27090104565394,55.53760403988351,NaN,NaN,4.332606298751175,4.237723239137739
2023-03-17T09:30:00-04:00,306.72,309.15,303.37,305.36,89923732,67800255,59.32670335815727,51.27174241142139,NaN,NaN,202.7120323279888,52.42014245662839,0.7697097959438494,1.6675585961662023,0.8978488002223529,5111934889,5076566657.2,72.58980090161509,56.962083646617906,NaN,NaN,6.547342889356518,4.567668903454707
2023-03-20T09:30:00-04:00,304.26,306.3,302.01,305.97,56359491,67706693.1,59.85422555955915,52.10723781973643,NaN,NaN,160.7967977442782,106.57547569388123,0.9936246503021118,2.1398796130999926,1.1462549627978809,5168294380,5121011989.8,76.58211525866294,58.510842348207575,NaN,NaN,8.487424973123364,5.127634056264515
2023-03-21T09:30:00-04:00,307.94,310.8,306.395,310.34,49757048,67868210.1,63.50588669556995,53.37249991039793,NaN,NaN,194.97277575173518,147.1079963867282,1.350315700194712,2.834149588041271,1.483833887846559,5218051428,5160688223,79.45842258837378,60.51489315383906,NaN,NaN,11.3004036377923,6.0094582821970555
2023-03-22T09:30:00-04:00,310.27,315.25,305.95,306.12,75791914,69088343.95,58.01772357493723,54.04734146829724,NaN,NaN,158.3875821238516,175.43391843218978,1.220258588091257,3.00915712296063,1.7888985348693731,5142259514,5168479766.4,79.97849298163669,62.84581656458945,NaN,NaN,12.050032520830236,6.872397459144652
2023-03-23T09:30:00-04:00,309.92,314.15,307.01,309.75,74575981,69352420.85,61.12952404979785,54.49617087019406,NaN,NaN,143.64928011821158,172.10369361321304,1.2901224114666903,3.401551549202736,2.111429137736046,5216835495,5171475141.2,80.18617979326545,64.9730409636817,NaN,NaN,13.650158017782452,7.8406489675214806
2023-03-24T09:30:00-04:00,309.32,310.99,306.95,310.89,57245803,68498113.1,62.08011928068512,54.98933193382915,NaN,NaN,115.9733531172668,154.75595777106867,1.3197839941756513,3.76115913045561,2.4413751362799587,5274081298,5203904423,82.32398161264891,67.01776569212555,NaN,NaN,15.237329697804574,8.897317643276208
2023-03-27T09:30:00-04:00,311.6,312.7,307.89,308.76,50287407,68562733,59.16855635080479,55.58385913753007,NaN,NaN,103.09152664923786,143.2149035520606,1.1110008667313425,3.8301262196941366,2.719125352962794,5223793891,5215004325.2,83.00008405322893,68.94774574996823,NaN,NaN,15.726890876178546,9.872970962262256
2023-03-28T09:30:00-04:00,308.17,308.2,304.774,307.12,48585917,68579871.8,56.95370517663826,55.90475064365503,NaN,NaN,63.00721823444192,116.82179204860195,0.7924484305060195,3.7096858910953188,2.9172374605892992,5175207974,5206435634.4,80.44213637018372,70.22201799154621,NaN,NaN,15.506055013084072,10.6776972552368
2023-03-29T09:30:00-04:00,310.88,313.35,310.05,312.72,53274266,68329236.5,62.16215866580373,57.009412479134554,NaN,NaN,108.15204561802135,106.77468474743588,0.8820274989824775,4.019771834317396,3.1377443353349186,5228482240,5223680179.6,81.6666851216183,71.50114728754069,NaN,NaN,16.873155537190854,11.56276272408738
2023-03-30T09:30:00-04:00,315.24,316.32,312.8088,315.68,58354808,68560049.05,64.60031095763543,58.57552445110759,NaN,NaN,125.55853069578245,103.15653486295007,1.0522306534282366,4.453032652120214,3.4008019986919775,5286837048,5237680490.2,82.61820922355889,73.40484359511038,NaN,NaN,18.770177531251715,12.592393410825142
2023-03-31T09:30:00-04:00,315.91,321.17,315.6,320.93,62138097,68641376.9,68.47980944881445,60.23009198926298,NaN,NaN,150.29164847880944,110.02019393525862,1.407789296046983,5.1605386187507065,3.7527493227037234,5348975145,5252659259.6,83.59899126081228,75.70940163419561,NaN,NaN,21.66747957261522,13.888834291080867
2023-04-03T09:30:00-04:00,318.77,320.42,317.4201,320.15,47126839,68160904.15,67.29973481323339,61.27654275820047,NaN,NaN,133.18492223662713,116.03887305273645,1.4728570467484117,5.593820631139238,4.120963584390826,5301848306,5268270142.6,84.57581504800646,77.9112762406259,NaN,NaN,23.655306869010843,15.284044659356578
2023-04-04T09:30:00-04:00,320.6,321.63,317.8251,319.07,45875384,67156885.55,65.61374254396421,62.09221421879803,NaN,NaN,122.13778151864337,127.86498570957671,1.329937536845554,5.783385505447768,4.453447968602214,5255972922,5284423132.2,85.53577054009688,79.91625612852587,NaN,NaN,24.81282512593359,16.645299011724724
2023-04-05T09:30:00-04:00,318.1,319.06,314.07,315.92,62795706,67752857.6,60.82730616031565,62.07282190256549,NaN,NaN,85.98258400157609,123.43109338628767,0.9290139574834182,5.614715415456487,4.685701457973069,5193177216,5277362127.4,83.10102526340204,81.11840785836502,NaN,NaN,24.426501088173335,17.75689930836024
2023-04-06T09:30:00-04:00,314.24,318.55,312.82,318.05,46916496,66525847.85,62.803256967963854,62.32114716040882,NaN,NaN,81.00031723007012,114.5194506931452,0.7222353565065287,5.5884956536062305,4.866260297099702,5240093712,5268013460.2,79.8598527915307,81.6376972790733,NaN,NaN,24.66231041444,18.743386609228775
2023-04-10T09:30:00-04:00,315.07,317.92,313.25,317.87,45134736,63852906.6,62.516269238672,62.5112931374883,NaN,NaN,76.36512286189804,99.73414556976293,0.49891781882747477,5.489907570634045,4.990989751806571,5194958976,5237210226.4,70.15113735312613,81.17834171439208,NaN,NaN,24.77702367398406,19.605334761336675
2023-04-11T09:30:00-04:00,317.83,317.89,315.31,315.83,40113594,61002406.15,59.21374483945738,62.20471157633741,NaN,NaN,69.37094822394218,86.97135076722594,0.15710268104513325,5.187368103112988,5.030265422067854,5154845382,5207809641.6,62.358678622921424,79.95693143114548,NaN,NaN,23.968288124579626,20.228613813228524
2023-04-12T09:30:00-04:00,317.82,318.42,312.565,313.04,62813305,60462944.15,54.939162054457206,61.984814324874556,NaN,NaN,41.76002335320607,70.89579913413849,-0.2892872591085718,4.6686563481821395,4.957943607290711,5092032077,5175021472.6,55.01868206035621,78.17408779391114,NaN,NaN,22.054771999805443,20.489493554168085
2023-04-13T09:30:00-04:00,314.83,319.65,313.63,319.17,54613792,59012057,61.51309340977871,62.012212136301756,NaN,NaN,72.85370273826351,68.27002288147598,-0.2079092557170119,4.698057037644446,4.905966293361458,5146645869,5165715203.2,53.107942192342165,76.23992796527378,NaN,NaN,22.240004019774695,20.739566477826173
2023-04-14T09:30:00-04:00,317.59,320.36,315.61,318.57,56278284,56898130,60.581468362980594,61.90516564218,NaN,NaN,76.50319626014857,67.37059868749168,-0.22902150952730782,4.6196894064523235,4.848710915979631,5090367585,5135769977.8,47.40320387761676,73.74558669848577,NaN,NaN,22.12004948590335,20.936778336122913
2023-04-17T09:30:00-04:00,318.15,319.1999,316.04,318.84,43007023,54552294.55,60.86867556939508,62.02660272922217,NaN,NaN,68.70116227269192,65.83780656965045,-0.2572225778865862,4.527182693621398,4.784405271507985,5133374608,5123453104.2,45.25015491862705,71.04916318887135,NaN,NaN,22.100713565716767,21.103054797493463
2023-04-18T09:30:00-04:00,320.99,321.42,317.64,318.86,46746940,54071667,60.891406541128696,62.307867112400054,NaN,NaN,86.79826626374047,69.32327017761011,-0.3037565849371324,4.404709540336569,4.708466125273701,5180121548,5128508337.4,46.32766682563709,68.61241536426088,NaN,NaN,22.090673465819624,21.244143178682915
2023-04-19T09:30:00-04:00,316.41,319.79,316.28,318.71,38960127,53531820.95,60.607050440429276,62.19678795344474,NaN,NaN,62.61997777587529,73.49526106214395,-0.369498613396285,4.246592858528345,4.61609147192463,5141161421,5138334206.2,48.45126172193049,66.23988512142604,NaN,NaN,22.00977994196048,21.353519859151138
2023-04-20T09:30:00-04:00,315.69,319.27,314.97,316.28,62462142,52865332.35,56.04127789830445,61.5854284492068,NaN,NaN,29.724958010898114,64.86951211667088,-0.5884956632101508,3.8804718929119417,4.4689675561220925,5078699279,5124744888.2,45.754946672825916,63.606794939230824,NaN,NaN,20.735778474582236,21.26527108992701
2023-04-21T09:30:00-04:00,315.91,317.4,314.1,316.61,59002285,52086647.55,56.52031577558737,60.73117890111916,NaN,NaN,6.534338979797901,50.87574066060074,-0.7145917513457309,3.5757278669399284,4.290319618285659,5137701564,5134211684,47.92891014923412,61.058932002689524,NaN,NaN,19.775471736541185,21.05244261087189