time,open,high,low,close,Volume,Volume MA,RSI,RSI-based MA,Upper Bollinger Band,Lower Bollinger Band,CCI,Smoothing Line,Histogram,MACD,Signal,OnBalanceVolume,Smoothing Line,RSI,RSI-based MA,Upper Bollinger Band,Lower Bollinger Band,True Strength Index,Signal
1998-12-22T09:30:00-05:00,23.21899,23.28101,23.21899,23.28101,600,NaN,NaN,NaN,NaN,NaN,NaN,NaN,NaN,NaN,NaN,NaN,NaN,NaN,NaN,NaN,NaN,NaN,NaN
1998-12-23T09:30:00-05:00,23.45312,23.75,23.45312,23.6875,900,NaN,NaN,NaN,NaN,NaN,NaN,NaN,NaN,NaN,NaN,900,NaN,NaN,NaN,NaN,NaN,NaN,NaN
1998-12-24T09:30:00-05:00,23.90625,24.01562,23.82812,24,1400,NaN,NaN,NaN,NaN,NaN,NaN,NaN,NaN,NaN,NaN,2300,NaN,NaN,NaN,NaN,NaN,NaN,NaN
1998-12-28T09:30:00-05:00,24,24.14062,24,24.125,7400,NaN,NaN,NaN,NaN,NaN,NaN,NaN,NaN,NaN,NaN,9700,NaN,NaN,NaN,NaN,NaN,NaN,NaN
1998-12-29T09:30:00-05:00,24.25,24.46875,24.25,24.46875,1400,NaN,NaN,NaN,NaN,NaN,NaN,NaN,NaN,NaN,NaN,11100,NaN,NaN,NaN,NaN,NaN,NaN,NaN
1998-12-30T09:30:00-05:00,24.45312,24.45312,24.29687,24.35937,2800,NaN,NaN,NaN,NaN,NaN,NaN,NaN,NaN,NaN,NaN,8300,6460,NaN,NaN,NaN,NaN,NaN,NaN
1998-12-31T09:30:00-05:00,24.35937,24.5625,24.3125,24.5625,33100,NaN,NaN,NaN,NaN,NaN,NaN,NaN,NaN,NaN,NaN,41400,14560,NaN,NaN,NaN,NaN,NaN,NaN
1999-01-04T09:30:00-05:00,24.59375,24.84375,24.21875,24.21875,6400,NaN,NaN,NaN,NaN,NaN,NaN,NaN,NaN,NaN,NaN,35000,21100,NaN,NaN,NaN,NaN,NaN,NaN
1999-01-05T09:30:00-05:00,24.46875,24.76562,24.35937,24.71875,2000,NaN,NaN,NaN,NaN,NaN,NaN,NaN,NaN,NaN,NaN,37000,26560,NaN,NaN,NaN,NaN,NaN,NaN
1999-01-06T09:30:00-05:00,24.95312,25.32812,24.95312,25.25,13500,NaN,NaN,NaN,NaN,NaN,NaN,NaN,NaN,NaN,NaN,50500,34440,NaN,NaN,NaN,NaN,NaN,NaN
1999-01-07T09:30:00-05:00,25.0625,25.125,24.84375,25.03125,13100,NaN,NaN,NaN,NaN,NaN,NaN,NaN,NaN,NaN,NaN,37400,40260,NaN,NaN,NaN,NaN,NaN,NaN
1999-01-08T09:30:00-05:00,24.96875,25.25,24.82812,25.21875,11000,NaN,NaN,NaN,NaN,NaN,NaN,NaN,NaN,NaN,NaN,48400,41660,NaN,NaN,NaN,NaN,NaN,NaN
1999-01-11T09:30:00-05:00,25.15625,25.15625,24.875,24.98437,2200,NaN,NaN,NaN,NaN,NaN,NaN,NaN,NaN,NaN,NaN,46200,43900,NaN,NaN,NaN,NaN,NaN,NaN
1999-01-12T09:30:00-05:00,24.85937,24.92187,24.60937,24.6875,6500,NaN,NaN,NaN,NaN,NaN,NaN,NaN,NaN,NaN,NaN,39700,44440,NaN,NaN,NaN,NaN,NaN,NaN
1999-01-13T09:30:00-05:00,24.03125,24.35937,24,24.0625,1700,NaN,58.805025069010206,NaN,NaN,NaN,NaN,NaN,NaN,NaN,NaN,38000,41940,NaN,NaN,NaN,NaN,NaN,NaN
1999-01-14T09:30:00-05:00,24,24.21875,23.95312,23.95312,4100,NaN,57.284488704970954,NaN,NaN,NaN,NaN,NaN,NaN,NaN,NaN,33900,41240,NaN,NaN,NaN,NaN,NaN,NaN
1999-01-15T09:30:00-05:00,24.07812,24.42187,24.07812,24.35937,4900,NaN,61.288226082669034,NaN,NaN,NaN,NaN,NaN,NaN,NaN,NaN,38800,39320,NaN,NaN,NaN,NaN,NaN,NaN
1999-01-19T09:30:00-05:00,24.57812,24.57812,24.10937,24.3125,10100,NaN,60.582697130188585,NaN,NaN,NaN,NaN,NaN,NaN,NaN,NaN,28700,35820,NaN,NaN,NaN,NaN,NaN,NaN
1999-01-20T09:30:00-05:00,24.375,24.5,24.20312,24.20312,1700,NaN,58.87925362779207,NaN,NaN,NaN,NaN,NaN,NaN,NaN,NaN,27000,33280,NaN,NaN,NaN,NaN,NaN,NaN
1999-01-21T09:30:00-05:00,24.14062,24.14062,23.98437,24,2500,6365,55.74465585462564,NaN,NaN,NaN,-60.32989930758909,NaN,NaN,NaN,NaN,24500,30580,73.26388888888889,NaN,NaN,NaN,NaN,NaN
1999-01-22T09:30:00-05:00,23.65625,23.75,23.53125,23.53125,8700,6770,49.23091192644212,NaN,NaN,NaN,-150.6048476593124,NaN,NaN,NaN,NaN,15800,26960,68.13966326248965,NaN,NaN,NaN,NaN,NaN
1999-01-25T09:30:00-05:00,23.64062,23.92187,23.60937,23.92187,4600,6955,54.04945743226912,NaN,NaN,NaN,-114.0671030933685,NaN,NaN,NaN,NaN,20400,23280,63.29325870617331,NaN,NaN,NaN,NaN,NaN
1999-01-27T09:30:00-05:00,24.20312,24.20312,24.10937,24.10937,500,6910,56.198462488091764,NaN,NaN,NaN,-53.45157551870293,NaN,NaN,NaN,NaN,20900,21720,61.302763228771504,NaN,NaN,NaN,NaN,NaN
1999-01-28T09:30:00-05:00,24.03125,24.1875,23.95312,24.14062,1900,6635,56.56308143723747,NaN,NaN,NaN,-63.01327744362798,-88.29334060452018,NaN,NaN,NaN,22800,20880,60.204833686310366,NaN,NaN,NaN,NaN,NaN
1999-01-29T09:30:00-05:00,24.23437,24.40625,23.95312,24.29687,109200,12025,58.42654409959242,NaN,NaN,NaN,-35.19895294105698,-83.26715133121375,NaN,NaN,NaN,132000,42380,73.35748884296038,NaN,NaN,NaN,NaN,NaN
1999-02-01T09:30:00-05:00,24.5,24.5,24.32812,24.32812,2400,12005,58.807169703012256,NaN,NaN,NaN,-2.375178157362489,-53.621217430823776,NaN,-0.11723108260464699,NaN,134400,66100,80.8696753041035,NaN,NaN,NaN,NaN,NaN
1999-02-02T09:30:00-05:00,24.15625,24.1875,23.85937,24.14062,20700,11385,55.52253490059377,NaN,NaN,NaN,-60.9460184811807,-42.997000508386215,NaN,-0.11194706770469764,NaN,113700,84760,84.55832387182554,NaN,NaN,NaN,NaN,NaN
1999-02-03T09:30:00-05:00,24.14062,24.375,24.14062,24.375,20100,12070,58.63292983753957,57.14395987814536,NaN,NaN,-14.220749150121195,-35.15083523466986,NaN,-0.08783443987476858,NaN,133800,107340,87.65920466103452,NaN,NaN,NaN,NaN,NaN
1999-02-04T09:30:00-05:00,24.34375,24.42187,24.25,24.40625,6100,12275,59.04417925650861,57.16104232010952,NaN,NaN,0.4256790123958371,-22.463043943465106,NaN,-0.06544894012340308,NaN,139900,130760,89.9201596698781,NaN,NaN,NaN,NaN,NaN
1999-02-05T09:30:00-05:00,24.48437,24.48437,24.29687,24.32812,4300,11815,57.50493294414866,57.17678833719365,NaN,NaN,12.786076751532203,-12.866038004947267,NaN,-0.05339717889229689,NaN,135600,131480,89.98093206889027,NaN,NaN,NaN,NaN,NaN
1999-02-08T09:30:00-05:00,24.5,24.5,24.14062,24.40625,2900,11305,58.66539126303068,56.98944299293377,NaN,NaN,17.955761808554573,-8.799850011763862,NaN,-0.03711380836772804,NaN,138500,132300,90.05447593220157,NaN,NaN,NaN,NaN,NaN
1999-02-09T09:30:00-05:00,24.35937,24.35937,24.07812,24.07812,4100,10960,52.216149363505465,56.39183243817069,NaN,NaN,-21.54426065946629,-0.919498447420979,NaN,-0.05010884504086732,NaN,134400,136440,90.43617568650411,NaN,NaN,NaN,NaN,NaN
1999-02-10T09:30:00-05:00,24.17187,24.17187,24.04687,24.17187,5400,11120,53.77955209483009,56.02756804295912,NaN,NaN,-25.154003938811954,-3.1061494051591323,NaN,-0.05224046813189531,NaN,139800,137640,90.54939471416331,78.82787418029964,NaN,NaN,NaN,NaN
1999-02-11T09:30:00-05:00,24.32812,24.5,24.32812,24.5,3500,10970,58.853874049285864,56.249655056863425,NaN,NaN,113.27780938930366,19.46427667022243,0.03980056101786961,-0.02713959769743468,-0.06694015871530429,143300,138320,90.61717971090712,80.06739495330093,NaN,NaN,NaN,NaN
1999-02-12T09:30:00-05:00,24.39062,24.39062,24.3125,24.35937,2600,11015,56.01550510055222,56.73426885501414,NaN,NaN,68.0711715865469,30.521295637225364,0.038845936586980344,-0.018382737981578856,-0.0572286745685592,140700,139340,90.72464799078689,81.68060814817932,NaN,NaN,NaN,NaN
1999-02-16T09:30:00-05:00,24.51562,24.53125,24.46875,24.48437,3800,11000,57.956435832915815,57.013338740774614,NaN,NaN,114.67634877773281,49.86541303106102,0.044710179181350646,-0.001340950591870893,-0.04605112977322154,144500,140540,90.85732206878002,83.64946981693694,NaN,NaN,NaN,NaN
1999-02-17T09:30:00-05:00,24.28125,24.75,24.28125,24.48437,5400,11025,57.956435832915815,57.13890826540491,NaN,NaN,108.35482937991104,75.84523103893648,0.04646183071724559,0.012026158623335448,-0.034435672093910144,144500,142560,91.0884039927083,85.77701558578958,NaN,NaN,NaN,NaN
1999-02-18T09:30:00-05:00,24.32812,24.53125,24.26562,24.48437,4300,10735,57.956435832915815,57.23843357938193,NaN,NaN,74.6608580563427,95.80820343796742,0.04543806947337187,0.02236191474780469,-0.023076154725567177,144500,143500,91.1998700922286,87.99094675764088,NaN,NaN,13.027532823004865,NaN
1999-02-19T09:30:00-05:00,24.375,24.67187,24.375,24.64062,2800,10790,60.66625195471176,57.39841271189046,NaN,NaN,113.17595119201374,95.78783179850943,0.05259634794391137,0.042669280204322035,-0.009927067739589334,147300,144300,91.29961088305426,89.27252690336186,NaN,NaN,13.935401757429236,NaN
1999-02-22T09:30:00-05:00,24.65625,25.01562,24.65625,25.01562,6400,10985,66.28300227240051,57.932400752561044,NaN,NaN,200.5629165562839,122.28618079245685,0.07834795785307737,0.08800787957675738,0.009659921723680008,153700,146900,91.63157820161489,90.04123425318411,NaN,NaN,16.350708930653557,NaN
1999-02-23T09:30:00-05:00,24.9375,25.04687,24.85937,25,5400,10820,65.86112765677484,58.670871663716845,NaN,NaN,217.44472607597444,142.83985625210516,0.08929653906676381,0.12128059555713477,0.03198405649037096,148300,147660,91.73089892683696,90.55356104282778,NaN,NaN,18.2454174140659,NaN
1999-02-24T09:30:00-05:00,25.15625,25.17187,24.875,24.9375,5300,10855,64.1030281986012,59.061592975221245,NaN,NaN,194.32884291022324,160.0346589581676,0.0871976290024137,0.1409810927433881,0.053783463740974397,143000,147360,91.27041055298183,90.81150432082403,NaN,NaN,19.422650660950577,NaN
1999-02-25T09:30:00-05:00,24.57812,24.57812,24.28125,24.4375,3200,10990,52.117155685815,58.56680557731456,NaN,NaN,2.2945390616344286,145.56139515922595,0.04891186355576968,0.1149232931856865,0.06601142962991682,139800,146420,89.75011055515867,90.79935795548691,NaN,NaN,17.130520734648965,NaN
1999-02-26T09:30:00-05:00,24.5625,24.65625,24.375,24.51562,3400,11065,53.57763458791199,58.286284266154794,NaN,NaN,25.331416038664777,127.99248812855615,0.02673466907570246,0.09942976597454489,0.07269509689884243,143200,145600,88.367303534094,90.68409877443004,NaN,NaN,15.642623300938762,NaN
1999-03-01T09:30:00-05:00,24.46875,24.5,24.3125,24.5,3200,5765,53.22804431884091,57.89790234156981,NaN,NaN,-7.813813243650989,86.31714216856918,0.009773378458366566,0.08491181997180064,0.07513844151343407,140000,142860,83.72530786729543,90.23201534122245,NaN,NaN,14.327169197149143,NaN
1999-03-02T09:30:00-05:00,24.5625,24.60937,24.29687,24.29687,47600,8025,48.77129873821937,57.651841582620804,NaN,NaN,-22.21300663053114,38.385595627268046,-0.015018271434200425,0.05636560222068354,0.07138387365488397,92400,131680,68.02354797485205,88.63111336181873,NaN,NaN,11.92463299850624,NaN
1999-03-03T09:30:00-05:00,24.48437,24.48437,24.10937,24.15625,13600,7670,45.90578522029906,57.08942966301145,NaN,NaN,-87.44720668501007,-17.96961429177862,-0.039394747723858,0.022140439000061463,0.061535186723919465,78800,118840,55.21603751217287,86.10730213310514,NaN,NaN,9.053437617158073,NaN
1999-03-04T09:30:00-05:00,24.34375,24.625,24.34375,24.625,15700,7450,55.3279893981984,56.837580759362346,NaN,NaN,21.073826472492854,-14.213756809606943,-0.023254787675776642,0.032466702129198666,0.05572148980497531,94500,109780,48.30497030972508,83.08500146159213,NaN,NaN,9.216241327901475,NaN
1999-03-05T09:30:00-05:00,25.04687,25.17187,25.04687,25.17187,5200,7405,63.348786809974676,57.361386595749664,NaN,NaN,206.68349016426077,22.05665801551228,0.022472444621765023,0.08381204558218158,0.06133960096041656,99700,101080,42.769102014598495,79.65960532043582,NaN,NaN,12.139576227111359,NaN
1999-03-08T09:30:00-05:00,25.26562,25.3125,25.1875,25.3125,1800,7280,65.08488424003124,57.870561481972196,NaN,NaN,193.00375657673496,62.22017197958947,0.058370801890554894,0.13430310332361017,0.07593230143305528,101500,93380,38.557398338744896,75.92389648257617,NaN,NaN,15.050552605339346,14.266651199604423
1999-03-09T09:30:00-05:00,25.3125,25.51562,25.29687,25.4375,1800,7225,66.59934305675232,58.48791199796052,NaN,NaN,179.1461469513161,102.49200269595892,0.08509625055084272,0.18230261462160868,0.09720636407076597,103300,95560,40.34841696007939,72.29961169453124,NaN,NaN,17.88603841044106,14.783706515438228
1999-03-10T09:30:00-05:00,25.34375,25.46875,25.23437,25.39062,2700,7155,65.45268553194859,59.023358405034294,NaN,NaN,138.7291631404322,147.72727666104737,0.09350837399842533,0.21409183156879763,0.1205834575703723,100600,99920,43.872307208650035,68.91907148856134,NaN,NaN,19.81183819892931,15.502011041651238
1999-03-11T09:30:00-05:00,25.40625,25.70312,25.40625,25.42187,1800,6975,65.87446971621563,59.395373959427424,NaN,NaN,142.09709461521635,171.9319302895921,0.09477403215418884,0.23905099776310834,0.1442769656089195,102400,101500,45.13714287148838,65.62175234487806,NaN,NaN,21.495799424114182,16.35826652486023
1999-03-12T09:30:00-05:00,25.45312,25.54687,25.45312,25.5,2200,6910,66.96054845774513,59.44377011552347,NaN,NaN,120.94690901986554,154.78461406071304,0.09426983931282754,0.2621142647499539,0.16784442543712638,104600,102480,45.950723259330246,62.35883413471487,NaN,NaN,23.21183084332377,17.337347141783592
1999-03-15T09:30:00-05:00,25.48437,25.57812,25.4375,25.4375,1900,6875,65.17364619237748,59.394664296637934,NaN,NaN,105.22215928048139,137.22829460146232,0.08349323068076278,0.27221096378807985,0.18871773310731707,102700,102720,46.16128844008837,59.10386195708996,NaN,NaN,24.173437451441206,18.31393147173468
1999-03-16T09:30:00-05:00,25.48437,25.5,25.26562,25.26562,4800,6925,60.400015080784044,59.130163359651,NaN,NaN,74.19416778697844,116.2378987685948,0.05967232444280379,0.2633081386608218,0.20363581421801802,97900,101640,45.305928506953805,55.82068466808796,NaN,NaN,23.707360567177066,19.084421342512165
1999-03-17T09:30:00-05:00,25.3125,25.45312,25.1875,25.21875,1900,6750,59.12819479268428,59.630951867284516,NaN,NaN,58.7787198104194,100.24781010259224,0.03676607729865369,0.24959341084133513,0.21282733354268143,96000,100720,44.548652309491196,52.5920090791117,NaN,NaN,22.974929662598317,19.640208245381615
1999-03-18T09:30:00-05:00,25.17187,25.28125,25.10937,25.28125,3900,6730,60.32781713547684,60.11310776353914,NaN,NaN,43.613863356539476,80.55116385085685,0.022529844645250485,0.24098963934924456,0.21845979470399407,99900,100220,44.11706098713858,49.43127746861488,NaN,NaN,22.66425470113691,20.072214881918086
1999-03-19T09:30:00-05:00,25.3125,25.42187,25.26562,25.34375,9100,7045,61.54337754822947,60.7070601370669,NaN,NaN,59.07399010745043,68.17658006837382,0.014422745875241338,0.23648822704804573,0.2220654811728044,109000,101100,45.12471690263711,46.67409239971071,NaN,NaN,22.71169244251997,20.449283104861212
1999-03-22T09:30:00-05:00,25.23437,25.34375,25.14062,25.15625,9900,7220,55.99988434971173,61.22338768074492,NaN,NaN,32.74492633417719,53.68113347911299,-0.005405031313531289,0.21530919203089027,0.22071422334442156,99100,100380,44.4189907455413,44.988052597617084,NaN,NaN,21.259420872378946,20.56501707164946
1999-03-23T09:30:00-05:00,25.15625,25.15625,24.5625,24.5625,4900,7195,42.840310263036514,61.00442518379759,NaN,NaN,-45.14608520999444,29.81308287971841,-0.0574533045900682,0.14889759260683633,0.20635089719690453,94200,99640,43.66316643221379,44.16284752047715,NaN,NaN,15.476379966801012,19.838068913813967
1999-03-24T09:30:00-05:00,24.5625,25.57812,24.4375,24.5,4800,7170,41.72870476514445,60.03304771000803,NaN,NaN,-29.512906004363465,12.15475771676184,-0.09293422250291788,0.09018311906825716,0.18311734157117504,89400,98320,42.28111101654572,43.732571856678625,NaN,NaN,10.488823762560036,18.502462463634835
1999-03-25T09:30:00-05:00,24.625,24.92187,24.60937,24.76562,6500,7335,47.91430667629751,58.93058484331681,NaN,NaN,-47.08173652981425,-5.9843622605089,-0.09501940694679473,0.06434308288768165,0.15936248983447637,95900,97520,41.42530239703457,43.63658616970978,NaN,NaN,8.08739658573868,17.01459590964967
1999-03-26T09:30:00-05:00,24.57812,24.85937,24.57812,24.82812,3100,7320,49.278644975232545,57.801567752974044,NaN,NaN,-53.1230415696295,-28.423768595924876,-0.08880955924680162,0.04835054077597434,0.13716010002277595,99000,95520,39.28450184541026,43.688522134471576,NaN,NaN,6.563583767172199,15.521594175010032
1999-03-29T09:30:00-05:00,25.125,25.23437,25.125,25.23437,3000,7310,57.13780403745491,57.12574353730994,NaN,NaN,24.276252107594612,-30.117503441241393,-0.0555863396910556,0.06767717540895646,0.12326351510001206,102000,96100,40.24886227339589,43.68141108542276,NaN,NaN,7.760733656057742,14.412899815159705
1999-03-30T09:30:00-05:00,25.0625,25.25,25.0625,25.21875,3500,5105,56.77355062742045,56.505805329843646,NaN,NaN,13.971909000989243,-18.29390459904466,-0.03396934338262693,0.0808018358717284,0.11477117925435533,98500,96960,41.726825527966845,43.52816239394539,NaN,NaN,8.588755945034709,13.580879262284705
1999-03-31T09:30:00-05:00,25.0625,25.10937,24.9375,24.9375,21700,5510,50.52751821961041,55.40959450865756,NaN,NaN,-46.32629364999435,-21.656582128170832,-0.03763456465760609,0.06772797343234771,0.1053625380899538,76800,94440,38.7056329812098,43.06876883035407,NaN,NaN,7.331969578708781,12.688177878916717
1999-04-01T09:30:00-05:00,24.96875,25.20312,24.96875,25.20312,3500,4900,55.50616114790914,54.59142398652642,NaN,NaN,-20.732611791433904,-16.386757180494765,-0.021968310562688068,0.07790214988659372,0.09987046044928179,80300,91320,35.29800657521962,42.307860495774726,NaN,NaN,7.8754123126050155,12.000639940872189
1999-04-05T09:30:00-04:00,25.39062,25.75,25.375,25.75,7700,5025,63.623048753270425,54.480667026590204,NaN,NaN,134.04035743105078,21.04592261964128,0.02299271320311766,0.12861135195317885,0.1056186387500612,88000,89120,33.08605527070188,41.373915269389975,NaN,NaN,11.302981574158688,11.900974459913117
1999-04-06T09:30:00-04:00,25.65625,25.67187,25.5,25.60937,2700,5070,60.563407043879494,54.492337881097015,NaN,NaN,111.00612151405225,38.39189650093281,0.04003051280864252,0.15565677976086434,0.11562626695222182,85300,85780,30.011247949235283,40.2814380866958,NaN,NaN,12.959208789119717,12.052150792656917
1999-04-07T09:30:00-04:00,25.71875,25.76562,25.46875,25.65625,24400,6200,61.23269955569807,54.64265964988372,NaN,NaN,113.31109290537891,58.25973328181074,0.050548639370720905,0.17881206616562295,0.12826342679490205,109700,88020,34.41348766656205,39.557497755058,NaN,NaN,14.468054423519291,12.397279882780113
1999-04-08T09:30:00-04:00,25.59375,25.84375,25.53125,25.79687,24800,7305,63.24756861390253,54.85121332691413,NaN,NaN,125.40031732776555,92.60505547736273,0.062296040833661026,0.20613347783697833,0.1438374370033173,134500,99560,51.380297981875465,40.076300397539214,NaN,NaN,16.343190180461285,12.960981353877424
1999-04-09T09:30:00-04:00,25.8125,25.84375,25.67187,25.8125,1200,7275,63.474801102556036,54.98917215222316,NaN,NaN,128.90661521296508,122.53290087824253,0.06607955471428059,0.22643688039616805,0.16035732568188746,135700,110640,61.640897548590445,41.25602758653588,NaN,NaN,17.907775425498276,13.667666221251832
1999-04-12T09:30:00-04:00,25.8125,26.4375,25.78125,26.4375,11500,7740,71.15483448044563,56.071668590132724,NaN,NaN,202.99936806261408,136.32470300455518,0.10341108122371351,0.28962117721152936,0.18621009598781585,147200,122480,69.13644031047292,43.021559698316715,NaN,NaN,22.062056926231325,14.866864893391758
1999-04-13T09:30:00-04:00,26.40625,26.64062,26.375,26.64062,1100,7700,73.1320855902838,58.23536682779324,NaN,NaN,220.110875195008,158.14565374074633,0.13265378102541808,0.35202732226958844,0.21937354124417036,148300,135080,74.78350642153896,45.24444112612566,NaN,NaN,26.12467481041113,16.475123452965953
1999-04-14T09:30:00-04:00,26.76562,27.45312,26.75,27.21875,25500,8735,77.79712669699956,60.81168268006861,NaN,NaN,241.06602059357945,183.6966392783864,0.1789235276166608,0.44302795076499635,0.26410442314833554,173800,147900,78.99472184275044,47.866841899425985,NaN,NaN,31.507586605517226,18.622618189044704
1999-04-15T09:30:00-04:00,27.5,28.04687,27.46875,27.92187,61700,11725,81.91079776041013,63.240003471790935,NaN,NaN,252.48851494398167,209.11427880162964,0.24100872758205016,0.5653653326258983,0.3243566050438481,235500,168100,83.63285921216705,50.88166738622117,NaN,NaN,37.90536876754858,21.377296843116685
1999-04-16T09:30:00-04:00,28,28.1875,27.75,28.07812,173300,20195,82.67881884478474,65.62573017675895,NaN,NaN,211.0663523959359,225.54622623822382,0.2743028650998167,0.667235186418619,0.3929323213188023,408800,222720,90.03816191537511,54.50692881979008,NaN,NaN,43.02262967915077,24.46948724826441
1999-04-19T09:30:00-04:00,28.39062,29.3125,28.1875,28.3125,292800,34380,83.79056781934156,67.52949901832228,NaN,NaN,200.33660992165136,225.01367461003127,0.2921668711050902,0.758140910200165,0.46597403909507484,701600,333600,94.63137227164182,58.3913938196648,NaN,NaN,47.46296995484558,27.75427049206172
1999-04-20T09:30:00-04:00,28.46875,28.46875,27.84375,28.125,102300,39000,79.40005315159468,69.145677770049,NaN,NaN,137.13380688958938,208.41826094894753,0.2718338054860666,0.8057662959526581,0.5339324904665915,599300,423800,96.17602259038091,62.2806221812658,NaN,NaN,49.49776445937131,30.86048391596309
1999-04-21T09:30:00-04:00,28.1875,28.26562,27.9375,28.21875,58100,41660,79.96532491268397,71.2483782481257,NaN,NaN,117.18478374296026,183.6420135788237,0.24595460199141883,0.841375742955865,0.5954211409644462,657400,520520,97.12967876639773,66.45376830877922,NaN,NaN,51.283606641766056,33.77807287679209
1999-04-22T09:30:00-04:00,28.10937,29.21875,28.10937,28.23437,56200,44230,80.06348498531761,73.00247280794058,NaN,NaN,120.00049590718092,157.14440977146356,0.2124091629699032,0.8609325946768251,0.648523431706922,713600,616140,97.73189975564941,70.91333210738135,NaN,NaN,52.723713505902126,36.48459296666495
1999-04-23T09:30:00-04:00,28,28.45312,28,28.45312,109800,49395,81.43529019511068,74.27477576807202,NaN,NaN,95.1975397600531,133.970647244287,0.18829634198744838,0.8838938591912324,0.695597517203784,823400,699060,98.10349819544648,75.55743517343454,NaN,NaN,54.359028812522205,39.038083801787415
1999-04-26T09:30:00-04:00,28.54687,28.625,28.42187,28.42187,64900,52485,80.58225050328548,75.7046931580296,NaN,NaN,93.28359234485114,112.56004372892694,0.1549761557659075,0.8893177119111684,0.7343415561452609,758500,710440,98.14833571090712,80.42437001355395,NaN,NaN,55.441744186752715,41.38146385678246
1999-04-27T09:30:00-04:00,28.76562,28.78125,28.5,28.5625,160800,60375,81.52037891998674,77.15381311262163,NaN,NaN,89.6420503906595,103.06169242914098,0.12824742865907923,0.8946508419691099,0.7664034133100307,919300,774440,98.38026455359022,84.99342550548454,NaN,NaN,56.62494924106058,43.55910462596505
1999-04-28T09:30:00-04:00,28.57812,29.0625,28.57812,28.92187,27200,61560,83.68903894536564,78.61391813629757,NaN,NaN,93.14397130270413,98.25352994108974,0.12071843842141117,0.9173014613367947,0.7965830229153835,946500,832260,98.55621047115076,88.36313354043277,NaN,NaN,58.33852267466854,45.670450061494115
1999-04-29T09:30:00-04:00,29.14062,29.21875,28.76562,29.03125,85400,64745,84.29321899923738,80.10094798606053,NaN,NaN,93.04533708052513,92.86249817575857,0.10938923388417687,0.9333195652706046,0.8239303313864277,1031900,895920,98.72094934161927,91.01170866850626,NaN,NaN,59.93772522718217,47.70863222802098
1999-04-30T09:30:00-04:00,29.0625,29.0625,28.39062,28.6875,63200,67730,74.90300393341435,80.3686743755583,NaN,NaN,71.72120595847407,88.16723141544279,0.06710500607193293,0.9078115889763438,0.8407065829044109,968700,924980,98.78888402977178,93.1297403627419,NaN,NaN,58.507400718200216,49.25131344090373
1999-05-03T09:30:00-04:00,28.57812,29.25,28.57812,29.25,26700,68680,79.02136666999746,80.78933730982355,NaN,NaN,84.80087213909972,86.47068737429248,0.0653171904146369,0.922353070922707,0.8570358805080701,995400,972360,98.89219605557226,94.85178962231569,NaN,NaN,58.52396924472429,50.57597855573524
1999-05-04T09:30:00-04:00,29.25,29.5625,29.1875,29.375,333200,85205,79.81409301305703,80.93340633239909,NaN,NaN,103.10114409686668,89.16250611553392,0.06093636259167401,0.9332063337476626,0.8722699711559886,1328600,1054220,99.04394008846064,96.28387663986642,NaN,NaN,58.78660322100292,51.74892493648777
1999-05-05T09:30:00-04:00,29.29687,29.45312,29.04687,29.375,70000,87485,79.81409301305703,80.78364170758816,NaN,NaN,95.79655843804298,89.69302354260168,0.047043840938003845,0.9310747723284933,0.8840309313904895,1328600,1130640,99.15966366175921,97.39293410055157,NaN,NaN,58.994035362396225,52.78394071161755
1999-05-06T09:30:00-04:00,29.25,29.4375,29.10937,29.4375,108700,91680,80.24692581299297,80.60993506246018,NaN,NaN,97.08827674254101,90.50161147500486,0.03179922436388394,0.9237799618453444,0.8919807374814605,1437300,1211720,99.26176320609206,98.05176276417423,NaN,NaN,59.28677941195243,53.712917668808245
1999-05-07T09:30:00-04:00,29.5625,30,29.53125,30,119300,97585,83.64575661724902,80.59959140516786,NaN,NaN,140.05468649409178,104.1683075821284,0.048342643923590334,0.9524090423859484,0.904066398462358,1556600,1329300,99.37950105719766,98.39091482028536,NaN,NaN,60.63526981838297,54.70182511874749
1999-05-10T09:30:00-04:00,29.75,29.95312,29.59375,29.59375,24900,98255,73.77281163101186,80.19764558226908,NaN,NaN,125.44424110707992,112.29698137572446,0.02200941081778507,0.9315781619845893,0.9095687511668042,1531700,1436560,99.46355107633696,98.62573828356793,NaN,NaN,58.5456400596971,55.250941538883154
1999-05-11T09:30:00-04:00,29.9375,30.14062,29.79687,30.09375,83400,102370,77.32086824466803,80.00875582026795,NaN,NaN,147.110374787034,121.0988275137579,0.027966948008501413,0.944527436177431,0.9165604881689295,1615100,1493860,99.50233364454031,98.79521363200669,NaN,NaN,57.92588649670671,55.63307653285795
1999-05-12T09:30:00-04:00,30,30,29.67187,29.79687,50900,103640,71.1648491408201,79.37313897423242,NaN,NaN,114.42744034305458,124.82500389476021,0.00293264822633732,0.9202262984518512,0.9172936502255139,1564200,1540980,99.53227906005561,98.92381215374999,NaN,NaN,55.304372942617555,55.58611887710932
1999-05-13T09:30:00-04:00,29.67187,29.79687,29.40625,29.5,32400,102175,65.54514061588422,78.23812829000194,NaN,NaN,75.38514060963645,120.48437666817931,-0.04022044111885392,0.8670180988269465,0.9072385399458004,1531800,1559880,99.54412791192773,99.0267142763558,NaN,NaN,51.23555683376656,54.96461001377464
1999-05-14T09:30:00-04:00,29.125,29.5,29.03125,29.125,34400,95230,59.1870780584575,76.70990168679995,NaN,NaN,25.72154500815312,97.61774837099158,-0.09736228404529679,0.7855356848891795,0.8828979689344763,1497400,1548040,97.87142069547212,99.00693463239614,NaN,NaN,45.63953067945866,53.63245582315807
1999-05-17T09:30:00-04:00,29.07812,29.09375,28.82812,29.0625,22600,81720,58.17422066166217,75.04231895406248,NaN,NaN,-7.63244143753471,71.00241186206867,-0.1401116085979316,0.7077584581870617,0.8478700667849933,1474800,1536660,96.19822557735918,98.85107470552249,NaN,NaN,40.938349421826544,51.81901205153928
1999-05-18T09:30:00-04:00,28.79687,28.92187,28.34375,28.6875,19500,77580,52.38206826853697,72.80610676286042,NaN,NaN,-62.63845921578748,29.052645061504393,-0.19122266847567837,0.6088417311903953,0.8000643996660737,1455300,1504700,91.46875367451285,98.34482779147694,NaN,NaN,35.00383831625694,49.416844375070376
1999-05-19T09:30:00-04:00,28.84375,29.15625,28.84375,29.125,74300,78390,57.676533603082184,70.90491494884935,NaN,NaN,-12.623071586251552,3.6425426756431682,-0.19260768885198465,0.5593047886010929,0.7519124774530775,1529600,1497780,90.43205629264344,97.75276400226439,NaN,NaN,31.650278074396798,46.87876347497415
1999-05-20T09:30:00-04:00,29.28125,29.39062,29.1875,29.20312,9200,76040,58.5624934832788,69.73773563098253,NaN,NaN,17.945008524002038,-7.845483741483716,-0.18524858610486394,0.5203517448219976,0.7056003309268616,1538800,1499180,90.45562486982149,97.15753120512508,NaN,NaN,29.281921618133588,44.36492892399693
1999-05-21T09:30:00-04:00,29.09375,29.09375,28.79687,28.85937,90800,75090,53.27752919756048,67.89889009723701,NaN,NaN,-50.585076023390954,-23.106807947792532,-0.19929515154722854,0.45648139149282585,0.6557765430400544,1448000,1489300,88.79332765179183,96.4361834619979,NaN,NaN,25.568046742766736,41.679660040964045
1999-05-24T09:30:00-04:00,28.92187,29.20312,28.60937,28.60937,14900,72590,49.760399826059874,65.75219772673721,NaN,NaN,-77.48081959153578,-37.07648357859274,-0.2195848909961734,0.3812954292948376,0.600880320291011,1433100,1480960,87.33433895682248,95.5997833811666,NaN,NaN,21.359538399162183,38.77678552070664
1999-05-25T09:30:00-04:00,28.84375,28.875,28.51562,28.51562,17600,65430,48.4682364238876,63.51320797036798,NaN,NaN,-111.69113285483073,-46.88701830640139,-0.232252120937397,0.3105651691192648,0.5428172900566618,1415500,1473000,85.88384877420613,94.65151088919853,NaN,NaN,17.56436743829561,35.746440080362206
1999-05-26T09:30:00-04:00,28.34375,28.42187,28.1875,28.3125,77400,67940,45.69932264198522,61.045522029581704,NaN,NaN,-158.04910997767638,-75.97222598468636,-0.2459280607949531,0.23540721406297038,0.4813352748579235,1338100,1434700,79.0783819612472,93.20984080028104,NaN,NaN,13.536725933621302,32.573623773684936
1999-05-27T09:30:00-04:00,28.1875,28.1875,27.65625,27.84375,719300,99635,40.01764008559376,57.92922799160632,NaN,NaN,-193.50161263385723,-118.26155021625823,-0.27591069136355834,0.13644691065347558,0.4123576020170339,618800,1250700,56.08522436818628,90.11739246535167,NaN,NaN,8.12666690435698,29.08120136378094
1999-05-28T09:30:00-04:00,27.90625,28.23437,27.90625,28.125,2200,96585,44.477984160546605,55.8367403151445,NaN,NaN,-147.23332694926336,-137.5912004014327,-0.26605019657854023,0.07979485629385863,0.34584505287239886,621000,1085300,43.76607309179701,86.13900118074166,NaN,NaN,4.963617219697345,25.635832200340428
1999-06-01T09:30:00-04:00,28.125,28.5,27.89062,28.14062,11800,95840,44.72382609790852,53.50838016180455,NaN,NaN,-117.01694666096992,-145.49842581531954,-0.2480792099672643,0.035746040413318525,0.2838252503805828,632800,925240,35.61374022571445,81.57553022225409,NaN,NaN,2.518704123800582,22.33338533226331
1999-06-02T09:30:00-04:00,28.6875,28.6875,28.39062,28.51562,22800,80320,50.4017787562542,52.02530370576413,NaN,NaN,-62.60761190002916,-135.68172162435923,-0.2024665782958654,0.030742027510751058,0.23320860580661645,655600,773260,29.915630653510163,76.60291247892941,NaN,NaN,2.102479384452588,19.443255911147492
1999-06-03T09:30:00-04:00,28.51562,28.85937,28.51562,28.8125,17900,77715,54.39565304381705,51.22891173633076,NaN,NaN,-32.850363488941575,-110.64197232661225,-0.14644376214267232,0.050153903128276056,0.19659766527094838,673500,640340,25.99785704065087,71.34960741669536,NaN,NaN,2.990049944619087,17.09279791592915
1999-06-04T09:30:00-04:00,28.96875,29.10937,28.96875,29.10937,4600,72510,58.03470783666944,51.14659957763161,NaN,NaN,13.43241246223973,-69.25516730739285,-0.0864997158513334,0.08847302045678163,0.17497273630811502,678100,652200,26.917530028404542,66.28147236904768,NaN,NaN,4.892874739295169,15.349951747838581
1999-06-07T09:30:00-04:00,29.35937,29.42187,29.3125,29.39062,10800,67085,61.1940157732051,51.3622992284561,NaN,NaN,62.12527769945999,-27.383446377648188,-0.028039965994999055,0.1399227788143662,0.16796274480936527,688900,665780,28.020585137838665,61.41164090908192,NaN,NaN,7.5055798524753605,14.229327191358122
1999-06-08T09:30:00-04:00,29.34375,29.34375,29.125,29.125,24900,67085,56.841687963027944,51.68084349234831,NaN,NaN,42.84847133414186,4.589637221374164,-0.008411158133713875,0.15744879714222293,0.1658599552759368,664000,672020,28.55420278492656,56.9177444169686,NaN,NaN,8.376004077929906,13.39313817515409
1999-06-09T09:30:00-04:00,29.23437,29.3125,29.09375,29.15625,8500,63340,57.22712638564523,51.648742976817104,NaN,NaN,51.85120491531862,27.481400584443712,0.004814913610616839,0.17187859728920785,0.167063683678591,672500,675400,28.861841708532324,52.51987194667496,NaN,NaN,9.188826974297209,12.792522289317393
1999-06-10T09:30:00-04:00,28.90625,28.92187,28.67187,28.8125,46400,63115,51.75198959541497,51.16227841339826,NaN,NaN,-3.7628736917136325,33.2988985438893,-0.010608056231131424,0.15380361338967674,0.16441166962080817,626100,665920,28.49128645387438,48.09384777410731,NaN,NaN,8.261265186972937,12.145199846125328
1999-06-11T09:30:00-04:00,28.9375,29.07812,28.76562,28.76562,2100,61600,51.03487319504527,51.00208869893289,NaN,NaN,16.703128875674224,33.953041826576204,-0.02420946498702406,0.1341498383870281,0.15835930337405216,624000,655100,28.0486526812452,43.754942419068264,NaN,NaN,7.3008707888980044,11.453152837949997
1999-06-14T09:30:00-04:00,29,29.15625,29,29.10937,14400,60600,55.864268145403486,51.43807929317172,NaN,NaN,63.43341096661524,34.214668480007255,-0.010971873936688442,0.1446444609531916,0.15561633488988005,638400,645000,27.61733911622906,39.48944243045445,NaN,NaN,7.890463909973479,10.944197276810494
1999-06-15T09:30:00-04:00,29.125,29.26562,29.125,29.20312,4400,59690,57.10680002528396,52.05511955041431,NaN,NaN,81.83996571642427,42.01296735646375,0.0024645370030878244,0.15869700614373983,0.156232469140652,642800,640760,27.426668689337404,35.313929567249545,NaN,NaN,8.738371646020832,10.629079329554827
1999-06-16T09:30:00-04:00,29.45312,29.71875,29.45312,29.60937,183200,67875,62.0876625001166,53.22571525456656,NaN,NaN,141.05441850443444,59.85361007428692,0.0352586082983683,0.20030572951361236,0.16504712121524406,826000,671460,31.13401755844943,31.889332109906842,NaN,NaN,11.026082976664684,10.685794136284807
1999-06-17T09:30:00-04:00,29.46875,29.85937,29.46875,29.84375,11000,64710,64.63891555719292,54.98437778825222,NaN,NaN,146.30877095622444,89.86793900387451,0.06741786329660998,0.24931945033600655,0.18190158703939657,837000,713640,35.973501282051146,30.452780460897195,NaN,NaN,13.752485228918474,11.123892863803903
1999-06-18T09:30:00-04:00,29.90625,30.03125,29.8125,30.03125,1000,64300,66.5766251170502,56.56285214228818,NaN,NaN,165.6816432006858,119.66364186887684,0.09434795542318991,0.29983653131838395,0.20548857589519404,838000,756440,40.53958723727697,30.22231718557433,NaN,NaN,16.633429656988262,11.910969548544525
1999-06-21T09:30:00-04:00,30,30,29.5625,29.625,4400,59980,59.029077093795095,57.58465578485151,NaN,NaN,112.35972454631444,129.4489045848167,0.07848201367161037,0.303591092984707,0.22510907931309662,833600,795480,44.432342848007465,30.852217372880975,NaN,NaN,16.853259432858497,12.617010960589377
1999-06-22T09:30:00-04:00,29.6875,29.76562,29.48437,29.48437,33000,60885,56.63552795274247,58.029923584600674,NaN,NaN,81.46829758212996,129.37457095795781,0.053396437344812614,0.2918546259941124,0.23845818864929977,800600,827040,47.4286753730375,32.103149138561506,NaN,NaN,16.309078371071823,13.14444916208687
1999-06-23T09:30:00-04:00,29.5,29.57812,29.20312,29.57812,29500,61480,57.86219376055478,58.277533635796225,NaN,NaN,58.918532905763136,112.94739383822358,0.03868308280715421,0.2868120421582425,0.2481289593510883,830100,827860,47.50787508770797,33.63957899906558,NaN,NaN,16.219403326542736,13.583728328437708
1999-06-24T09:30:00-04:00,29.51562,29.51562,28.98437,29.26562,34000,59310,52.52824860353147,57.88421511914351,NaN,NaN,27.0868630372812,89.1030122544349,0.005228041804705041,0.2546640116069696,0.24943596980226457,796100,819680,46.75123058945829,35.0562718962837,NaN,NaN,14.538814646137805,13.720169230966293
1999-06-25T09:30:00-04:00,29.25,29.29687,29.0625,29.09375,2800,23485,49.808719170848484,57.070979647546615,NaN,NaN,2.4069142444695624,56.448066463191665,-0.02925739435801039,0.2128642268547516,0.24212162121276198,793300,810740,45.890984813429434,36.33272901596876,NaN,NaN,12.315940380135087,13.519565109418979
1999-06-28T09:30:00-04:00,29.26562,29.3125,29.14062,29.14062,3600,23555,50.560437298312586,56.62231888578123,NaN,NaN,1.0511388766088072,34.18634932925054,-0.04855471939359704,0.1814282219707657,0.22998294136436273,796900,803400,45.15631662344818,37.518594290148876,NaN,NaN,10.705096738732268,13.117498199320877
1999-06-29T09:30:00-04:00,29.14062,29.29687,29.14062,29.29687,4400,23185,53.083136508950815,56.32631960887449,NaN,NaN,-0.3869346654947633,17.815302879725582,-0.050229790856139295,0.1671957027941886,0.2174254936503279,801300,803540,45.17434532061186,38.68377311958313,NaN,NaN,10.032947561543521,12.676848108209827
1999-06-30T09:30:00-04:00,29.45312,29.84375,29.17187,29.8125,24700,23280,60.285047261777486,56.93582372790039,NaN,NaN,78.69287015766174,21.77017033010531,-0.01772248928830017,0.19527238203995267,0.21299487132825284,826000,802720,45.08086923658138,39.86874331834792,NaN,NaN,11.624544054225797,12.526518957640679
1999-07-01T09:30:00-04:00,29.57812,29.82812,29.57812,29.82812,15200,23145,60.482940484547335,57.61068567715053,NaN,NaN,100.71885091458407,36.496567905565875,0.002636498060928305,0.21629049390441324,0.21365399584348493,841200,811740,46.39486039477067,41.17918672645688,NaN,NaN,12.960334315098269,12.58849258013462
1999-07-02T09:30:00-04:00,29.84375,30.01562,29.84375,29.96875,11400,23485,62.30411852498822,58.07067498997802,NaN,NaN,131.43358566932218,62.30190219053641,0.022285742692868343,0.24151117420957036,0.219225431516702,852600,823600,48.151441901393895,42.64590835396865,NaN,NaN,14.61680769858959,12.878251882771044
1999-07-06T09:30:00-04:00,29.78125,30.15625,29.78125,30,42200,25055,62.71532025141386,58.47128357755872,NaN,NaN,120.68131530151027,86.2279374755167,0.0334289186832501,0.2610115798707646,0.22758266118751452,894800,843180,51.00586688802547,44.33013679673208,NaN,NaN,16.098359461261335,13.3382672511268
1999-07-07T09:30:00-04:00,29.96875,30,29.54687,29.78125,12000,24410,57.949948319409636,58.17573256465108,NaN,NaN,69.36033538513878,100.1773914856434,0.022625904718328316,0.25586504208542493,0.23323913736709662,882800,859480,53.31029255666191,45.91415643946154,NaN,NaN,16.076049162616616,13.729378952768203
1999-07-08T09:30:00-04:00,29.70312,29.92187,29.65625,29.89062,3300,24150,59.60270995923204,57.816003593368166,NaN,NaN,72.16523472782653,98.87186439967635,0.019522038739196945,0.2576416857910928,0.23811964705189587,886100,871500,54.99147540161091,47.27258316228723,NaN,NaN,16.513611226013307,14.127126420374646
1999-07-09T09:30:00-04:00,29.90625,29.98437,29.85937,29.92187,80700,25865,60.0854479111655,57.352348078662104,NaN,NaN,88.03938084044204,96.33597038484795,0.016376628771175156,0.2585904330158648,0.24221380424468966,966800,896620,58.36549106583952,48.54586200718457,NaN,NaN,17.008133903839266,14.538698918012448
1999-07-12T09:30:00-04:00,29.95312,29.95312,29.60937,29.65625,3400,25930,54.161080737295556,57.004634053197854,NaN,NaN,40.83860064690636,78.21697338036479,-0.005612808083348603,0.2351977941405039,0.2408106022238525,963400,918780,61.133470655127624,49.73879970769315,NaN,NaN,15.805996658226013,14.719741452328671
1999-07-13T09:30:00-04:00,29.48437,29.57812,29.40625,29.54687,32500,26835,51.892075315169606,56.665816007656936,NaN,NaN,-28.143246888632152,48.4520609423363,-0.02827692878527993,0.2054644412422526,0.23374137002753254,930900,926000,62.019448432969035,50.78099778340255,NaN,NaN,14.149735267185493,14.638311997308218
1999-07-14T09:30:00-04:00,29.78125,29.78125,29.51562,29.70312,82700,30750,54.8048496407911,56.44743428481668,NaN,NaN,11.792574655041694,36.938508796316896,-0.033159502713665884,0.1922919916354502,0.22545149434911607,1013600,952160,65.12176946483297,52.03913309605433,NaN,NaN,13.510490768609278,14.477194678922656
1999-07-15T09:30:00-04:00,29.90625,29.90625,29.79687,29.90625,14200,22300,58.33655240868916,56.86231312804223,NaN,NaN,70.09056196501015,36.523574243753615,-0.02357364572287121,0.19598443719552705,0.21955808291839826,1027800,980500,68.15632724708648,53.5680685715992,NaN,NaN,13.947285810270351,14.401493411972327
1999-07-16T09:30:00-04:00,29.90625,30.0625,29.89062,29.95312,3800,21940,59.13015104198568,57.52812969026632,NaN,NaN,92.75523928010668,37.46674593168653,-0.015340182036440608,0.2003828553728475,0.2157230374092881,1031600,993460,69.46470435189636,55.251905681489696,NaN,NaN,14.530266090322577,14.419889508879505
1999-07-19T09:30:00-04:00,30.1875,30.1875,29.98437,29.98437,1100,21945,59.68157924080678,58.179639829015905,NaN,NaN,114.1746834209771,52.133962486500685,-0.00934785257554252,0.20403822168985997,0.2133860742654025,1032700,1007320,70.84437386709362,57.08676691317866,NaN,NaN,15.16635989218904,14.526528135066581
1999-07-20T09:30:00-04:00,29.92187,30.09375,29.875,29.95312,73500,25400,58.82681575225151,58.58990263210881,NaN,NaN,83.9874616237351,74.56010418897412,-0.009041648783126216,0.20208401328649472,0.21112566206962094,959200,1012980,71.41242591062253,58.960915526750846,NaN,NaN,15.48654554426348,14.663673479237566
1999-07-21T09:30:00-04:00,29.85937,30.07812,29.85937,29.92187,1900,23845,57.93326678289499,58.42191831218863,NaN,NaN,71.29610339464188,86.46080993689417,-0.012294842363415298,0.19575710911535182,0.20805195147876712,957300,1001720,68.55097668878989,60.637351773337166,NaN,NaN,15.536462387414227,14.788357608977089
1999-07-22T09:30:00-04:00,30.625,30.625,29.8125,29.8125,9600,22850,54.79618244832766,58.01572130960152,NaN,NaN,98.93833657659675,92.23036485921149,-0.022565872941503085,0.17984461030188825,0.20241048324339134,947700,985700,64.58583818699044,61.93670732992429,NaN,NaN,14.781733675916314,14.787411332825549
1999-07-23T09:30:00-04:00,29.78125,29.95312,29.625,29.65625,67100,24505,50.58211343247334,57.178435231564734,NaN,NaN,-0.9006693213885447,73.49918313891244,-0.03963746328747164,0.15286365413405179,0.19250111742152343,880600,955500,57.79862715691215,62.625791991032735,NaN,NaN,12.985002107956728,14.529924300701431
1999-07-26T09:30:00-04:00,29.53125,29.8125,29.42187,29.4375,33100,26020,45.32657773805358,55.93638219489615,NaN,NaN,-74.0735531860866,35.849535817499714,-0.0639748539637468,0.11253254996683992,0.17650740393058673,847500,918460,50.75378586157536,62.60778620342916,NaN,NaN,9.86235613531934,13.86312884850399
1999-07-27T09:30:00-04:00,29.65625,29.82812,29.5625,29.82812,3000,25990,54.43149313402333,55.68506396736855,NaN,NaN,-22.86654972857495,14.47873354703771,-0.05255611985669545,0.1108122541097174,0.16336837396641285,850500,896720,47.12331643774868,62.1658593377925,NaN,NaN,9.670618232719292,13.264198760534748
1999-07-28T09:30:00-04:00,29.71875,29.71875,29.65625,29.65625,1100,25825,50.450466132116105,55.03133226543169,NaN,NaN,-66.41764560098973,-13.064016252088612,-0.0551017400497949,0.09449119890416924,0.14959293895396414,849400,875140,43.77592675324141,61.36474872005182,NaN,NaN,8.272831767807256,12.551146333002249
1999-07-29T09:30:00-04:00,29.375,29.375,29.01562,29.0625,16800,25430,39.65910915675032,53.572308068687754,NaN,NaN,-262.8324600638963,-85.41817558018722,-0.09306430936665788,0.033262552245641785,0.12632686161229967,832600,852120,40.4731726708512,60.08672597755265,NaN,NaN,3.064564060368375,11.195920294054552
1999-07-30T09:30:00-04:00,29.0625,29.0625,28.71875,28.71875,3900,24865,34.99242238989332,52.20311818673046,NaN,NaN,-288.5297971638888,-142.94400114868728,-0.13506894729976954,-0.04250932251241224,0.09255962478735728,828700,841740,39.042770265061755,58.508818806833666,NaN,NaN,-3.020416935033302,9.165014975613431
1999-08-02T09:30:00-04:00,28.90625,29.03125,28.79687,28.79687,43800,26485,36.81213819725647,51.12597982116523,NaN,NaN,-210.79466201498172,-170.2882229144663,-0.15017451571654433,-0.09515851985832313,0.055015995858221194,872500,846740,40.140217008984685,56.94601656226336,NaN,NaN,-7.102953184442086,6.841019524176929
1999-08-03T09:30:00-04:00,28.95312,28.95312,28.625,28.8125,2000,24475,37.19096711011214,49.86784535468816,NaN,NaN,-180.9652268864794,-201.9079583460472,-0.15127409733834826,-0.13407662581471413,0.01719747152363412,874500,851540,41.234022535018134,55.23974892441944,NaN,NaN,-10.155904262284917,4.41288755468238
1999-08-04T09:30:00-04:00,28.89062,28.90625,28.59375,28.59375,9500,24350,34.10884241204046,48.13729464064183,NaN,NaN,-161.41129874616936,-220.9066889750831,-0.15815015567067428,-0.18049022306470874,-0.022340067394034456,865000,854660,41.97620239441344,53.36974000637137,NaN,NaN,-13.732977701425789,1.8206210895240704
1999-08-05T09:30:00-04:00,28.46875,28.76562,28.375,28.75,14400,24905,38.05757381400632,46.63211055292902,NaN,NaN,-142.93171087131233,-196.9265391365663,-0.14399426322939252,-0.20233289643077512,-0.05833863320138259,879400,864020,44.25091675122773,51.56875517775217,NaN,NaN,-15.466845146612448,-0.6490169442097176
1999-08-06T09:30:00-04:00,28.5,28.5,28.29687,28.48437,1500,20945,34.294859358527574,44.8187734184805,NaN,NaN,-144.10266597188954,-168.04111289816646,-0.14399323073153691,-0.23833017161580372,-0.0943369408842668,877900,873860,46.62011961238471,49.83845130241583,NaN,NaN,-18.16630411603861,-3.1514865401852736
1999-08-09T09:30:00-04:00,28.48437,28.57812,28.375,28.39062,103400,25945,33.052786479157646,42.97777132754523,NaN,NaN,-119.7866563207421,-149.83951175931853,-0.1415670745896036,-0.2712957841212713,-0.1297287095316677,774500,854260,42.72523468196075,47.78936621465427,NaN,NaN,-20.74334924145412,-5.66460978322368
1999-08-10T09:30:00-04:00,28.46875,28.46875,28.07812,28.125,3600,24500,29.76367368743523,40.96565753501238,NaN,NaN,-126.17642827688348,-138.88175203739934,-0.14839376292529033,-0.3152209131882806,-0.16682715026299028,770900,833540,39.01445511151535,45.679614673420375,NaN,NaN,-24.021566975924415,-8.287032239323786
1999-08-11T09:30:00-04:00,28.25,28.625,28.15625,28.625,5400,20635,41.55385480459978,40.019776989031826,NaN,NaN,-87.26784337956903,-124.05306096407928,-0.11146378946427463,-0.30615688709333355,-0.19469309762905893,776300,815800,36.121787818817936,43.646468218550915,NaN,NaN,-22.94116606983782,-10.380479929397218
1999-08-12T09:30:00-04:00,28.75,28.75,28.5,28.51562,4400,20145,39.973048856959686,39.261986662209424,NaN,NaN,-67.3409473652706,-108.9349082628709,-0.08767907778342351,-0.3042919448583383,-0.2166128670749148,771900,794300,32.93468562452169,41.870472394808736,NaN,NaN,-22.599639260235804,-12.126074119517016
1999-08-13T09:30:00-04:00,28.71875,29.04687,28.71875,29.01562,3600,20135,49.44148622669696,39.555908697112514,NaN,NaN,-25.410751058151973,-85.1965252801234,-0.03429134907788958,-0.2594770534222768,-0.2251857043443872,775500,773820,30.201140360839418,40.40242628761331,NaN,NaN,-18.920162801873293,-13.096658216996484
1999-08-16T09:30:00-04:00,29.07812,29.20312,29.03125,29.125,38800,22020,51.25296330794481,39.328870852392626,NaN,NaN,3.1089700927487716,-60.61739999742523,0.010002005315706858,-0.21268319769975363,-0.2226852030154605,814300,781780,32.5445989042876,39.361089320937516,NaN,NaN,-15.420307835424927,-13.428608162486261
1999-08-17T09:30:00-04:00,29.375,29.53125,29.25,29.53125,2700,18480,57.36326462664719,39.82264217343056,NaN,NaN,50.73071617256605,-25.235971107535338,0.06519600451351962,-0.14119019737356098,-0.2063862018870806,817000,791000,35.2561033370347,38.75253050549418,NaN,NaN,-10.24830701442265,-12.974279427048602
1999-08-18T09:30:00-04:00,29.25,29.32812,29.20312,29.25,5300,18650,52.460607071341876,40.73703488161567,NaN,NaN,33.77668595781073,-1.027065240059386,0.08030571729559244,-0.10600405526759005,-0.18630977256318249,811700,798080,37.33904737909972,38.52866441322622,NaN,NaN,-7.664398060508732,-12.215724946114335
1999-08-19T09:30:00-04:00,28.875,28.92187,28.6875,28.875,4200,18380,46.726281571439785,41.57516768029756,NaN,NaN,-24.436738786718436,7.553776475651046,0.06333336084550584,-0.1071430715063002,-0.17047643235180604,807500,805200,39.44880660622689,38.557667009023724,NaN,NaN,-7.484291185477258,-11.539805837451896
1999-08-20T09:30:00-04:00,29.07812,29.28125,29.07812,29.17187,2800,15165,51.26764402931762,42.60770381115907,NaN,NaN,43.621603213518,21.36024732998504,0.06987512815305288,-0.08313252216048994,-0.15300765031354283,810300,812160,41.521550666069146,38.65633369881548,NaN,NaN,-5.758735734752878,-10.713938679923464
1999-08-23T09:30:00-04:00,29.5,29.84375,29.5,29.79687,14900,14255,59.160770820037186,44.17697550472515,NaN,NaN,138.5970323821973,48.457859787874746,0.11159339291273415,-0.013515909172625129,-0.12510930208535928,825200,814340,42.18907154438827,38.72455148519906,NaN,NaN,-1.3060636307587845,-9.369956530042796
1999-08-24T09:30:00-04:00,29.90625,30,29.78125,29.8125,32700,15740,59.33814178833046,45.97906831731729,NaN,NaN,161.61076391764826,70.6338693368912,0.13402975070250117,0.04242788629276717,-0.09160186440973399,857900,822520,44.7381091356618,38.921830538145365,NaN,NaN,2.0943234050620134,-7.732202253599252
1999-08-25T09:30:00-04:00,29.8125,30.23437,29.8125,30.14062,33800,17375,62.97371998301461,47.758793043675034,NaN,NaN,182.17538618509178,100.3136093823474,0.16284133265957773,0.1119498014147382,-0.05089153124483954,891700,838520,49.43457648398133,39.292091947627775,NaN,NaN,6.164930477907089,-5.746897577669775
1999-08-26T09:30:00-04:00,30.17187,30.17187,29.98437,29.98437,15800,17325,60.21284086044985,49.61007743666948,NaN,NaN,151.54277367562824,135.50951187481672,0.16285592072112773,0.1526783696565701,-0.01017755106455761,875900,852200,53.10426898668467,39.755245474363484,NaN,NaN,8.531478854424881,-3.707129515941967
1999-08-27T09:30:00-04:00,29.875,29.875,29.60937,29.64062,6300,17445,54.54697747226172,51.14537679331977,NaN,NaN,89.25010420384062,144.63521207288127,0.13248335261764868,0.15542663970750326,0.022943287089854568,869600,864060,56.08017943174418,40.709170099348015,NaN,NaN,8.678843256086147,-1.9377048342236654
1999-08-30T09:30:00-04:00,29.51562,29.51562,28.89062,28.89062,7200,15615,44.67051942320438,52.21015148873185,NaN,NaN,3.1952072244241805,117.55484704132664,0.058429001650078166,0.09597953915245228,0.03755053750237411,862400,871500,57.88564667720804,42.05711235404035,NaN,NaN,5.240225073856372,-0.9122862759265171
1999-08-31T09:30:00-04:00,28.89062,29.01562,28.8125,28.95312,2800,15655,45.555207786184674,52.49596241598791,NaN,NaN,-22.272039762502178,80.77828630529655,0.012596487224907471,0.05329614653350845,0.04069965930860098,865200,872960,58.248363056653744,43.63758201388577,NaN,NaN,2.905792878052591,-0.36684639678664455
1999-09-01T09:30:00-04:00,29.04687,29.125,28.85937,29.03125,6800,15520,46.70247156367992,52.97663546646793,NaN,NaN,-13.74917458071011,41.59337415213617,-0.01217575051943269,0.02547997115931011,0.0376557216787428,872000,869020,56.825994555272835,45.344104080367984,NaN,NaN,1.4235595850345601,-0.11107411366932962
1999-09-02T09:30:00-04:00,28.78125,28.84375,28.67187,28.78125,10700,15335,43.54084441467523,52.55516105132352,NaN,NaN,-50.879443002709,1.1089308164687153,-0.04336195223900198,-0.01654671862000967,0.026815233618992306,861300,866100,55.73965893207827,47.168283978313625,NaN,NaN,-0.8122462409267416,-0.21124156042038847
1999-09-03T09:30:00-04:00,29.375,29.48437,29.35937,29.48437,11000,15810,53.14760026740225,52.69049226271334,NaN,NaN,44.36892696028203,-7.867304632243007,-0.016008747693955626,0.0068042990015477756,0.0228130466955034,872300,866640,55.90753043991064,48.8370648022867,NaN,NaN,0.403710894818403,-0.12339120967198969
1999-09-07T09:30:00-04:00,29.48437,29.8125,29.48437,29.8125,24400,11860,56.83856128461683,52.65301345256831,NaN,NaN,75.60905883172276,6.615465689216721,0.0227074238389607,0.051197326494204276,0.028489902655243576,896700,873500,58.08259267115478,50.46752832615242,NaN,NaN,2.6556422161326214,0.27361356544295473
1999-09-08T09:30:00-04:00,29.71875,30,29.71875,29.90625,2900,11825,57.859999669642924,53.03868435244696,NaN,NaN,92.31835587862369,29.533544817441896,0.05150677839767314,0.092873375652335,0.04136659725466186,899600,880380,60.20294116668997,52.10066359669458,NaN,NaN,4.756847780685225,0.9140755961918505
1999-09-09T09:30:00-04:00,30,30.04687,29.6875,29.6875,12800,12195,54.612354092051525,53.60197524677636,NaN,NaN,73.55578028326799,46.994535790237514,0.05252034013324182,0.10701702242121414,0.05449668228797232,886800,883340,61.114302673219015,53.64819903005116,NaN,NaN,5.478534622208564,1.5661411713370952
1999-09-10T09:30:00-04:00,29.6875,29.8125,29.60937,29.60937,3400,12145,53.458212531792626,53.75844442552458,NaN,NaN,45.986558414142316,66.36773607360779,0.04491950805361561,0.11064606735499183,0.06572655930137622,883400,887760,62.49544661836257,55.146334455214976,NaN,NaN,5.717206225853542,2.1591504648394446
1999-09-13T09:30:00-04:00,29.35937,29.4375,29.26562,29.39062,7500,12340,50.25585533448923,53.12237903369972,NaN,NaN,-15.354657980476953,54.42301908545598,0.023241368465388004,0.09477826988311122,0.07153690141772322,875900,888480,62.72768305187758,56.61337813432135,NaN,NaN,4.96953371832092,2.5606337867653695
1999-09-14T09:30:00-04:00,29.04687,29.26562,29.04687,29.125,1700,10485,46.60507311454031,52.21287412842901,NaN,NaN,-57.951403224817675,27.710926674147892,-0.009167856530936935,0.06007708075405205,0.06924493728498898,874200,883980,60.21789733782894,57.71907729161901,NaN,NaN,3.234754531019706,2.6569367502302748
1999-09-15T09:30:00-04:00,29.40625,29.40625,29.125,29.17187,21200,11410,47.33212254535323,51.09561716859605,NaN,NaN,-37.78736158792624,1.6897831808379038,-0.0266408956714915,0.0359438176956246,0.0625847133671161,895400,883140,59.737417359965214,58.45499449704643,NaN,NaN,2.0249276587015563,2.5666497371547434
1999-09-16T09:30:00-04:00,28.92187,29,28.76562,28.90625,13100,11800,43.700498863101686,49.916164168785464,NaN,NaN,-94.0216807953453,-31.825709034884756,-0.053717919071323436,-0.004562685472038197,0.04915523359928524,882300,882240,59.192458157775164,58.88986515212432,NaN,NaN,-0.08608723319161228,2.1876873128195498
1999-09-17T09:30:00-04:00,29,29.32812,29,29.32812,7400,11960,50.231795196985324,49.607936863408575,NaN,NaN,-41.040852528612724,-49.231191223435765,-0.04139867173391186,-0.002593106068104589,0.03880556566580727,889700,883500,59.74611172654483,59.151717458895796,NaN,NaN,-0.011255748188873873,1.8735525898183465
1999-09-20T09:30:00-04:00,29.3125,29.39062,29.15625,29.35937,9600,12300,50.68814955694229,50.037767587247,NaN,NaN,-26.986603609628833,-51.55758034926614,-0.02986650032649417,0.0014724402576895557,0.031338940584183725,899300,888180,61.81822627502888,59.43261600159729,NaN,NaN,0.18082945561432348,1.6317349992177719
1999-09-21T09:30:00-04:00,29.01562,29.17187,28.82812,28.98437,14600,12285,45.317994337135545,50.02082376945777,NaN,NaN,-77.88152158906297,-55.5436040221152,-0.0452900424752947,-0.02527361250993465,0.02001642996536005,884700,890280,62.74494774560309,59.75380062223652,NaN,NaN,-1.259300047594897,1.2187299925302477
1999-09-22T09:30:00-04:00,28.9375,29.04687,28.82812,28.89062,15600,11430,44.061207879259804,49.83216207771348,NaN,NaN,-84.57257727804884,-64.90064716013971,-0.058748432979797933,-0.053419111259387364,0.0053293217204105695,869100,885020,58.88943914374006,59.90118952141275,NaN,NaN,-2.8118355594549764,0.6429349136752157
1999-09-23T09:30:00-04:00,28.90625,28.90625,28.57812,28.65625,9600,10220,41.00001788720001,49.65067446860811,NaN,NaN,-116.99018877369807,-69.49434875581026,-0.07910973375947822,-0.0935578454789372,-0.014448111719458985,859500,880460,55.694385787473394,59.89795572536955,NaN,NaN,-5.0496182192281065,-0.17028696245383024
1999-09-24T09:30:00-04:00,28.21875,28.26562,27.90625,28.04687,119800,15420,34.322904155762686,48.306053317776716,NaN,NaN,-219.82112054027385,-105.2504023581425,-0.1264822269584878,-0.17255089541756874,-0.04606866845908094,739700,850460,40.230021875114296,58.77813368502695,NaN,NaN,-9.305004616875012,-1.475246627371142
1999-09-27T09:30:00-04:00,28.125,28.40625,28.125,28.40625,24300,16320,40.479256481444345,47.13753154612154,NaN,NaN,-153.03309778634832,-130.4597011934864,-0.12618918931939122,-0.20380515510831998,-0.07761596578892875,764000,823400,31.68418802223252,56.89253335296108,NaN,NaN,-10.941096144072684,-2.8275108440427905
1999-09-28T09:30:00-04:00,28.1875,28.21875,27.71875,28.0625,111500,21535,36.914873239940476,45.64145108685708,NaN,NaN,-174.48945897528952,-149.7812886707317,-0.14062018517522634,-0.25339119725796166,-0.11277101208273532,652500,776960,22.751778446066595,54.21745030148798,NaN,NaN,-13.490624125898465,-4.350812741450744
1999-09-29T09:30:00-04:00,28,28.45312,28,28.21875,44000,23595,39.52170732676698,44.56354774647961,NaN,NaN,-121.70674780102456,-157.20812277532684,-0.13129408956951058,-0.27688862404462355,-0.14559453447511297,696500,742440,18.56260588731216,51.178043388208906,NaN,NaN,-14.733633644063715,-5.834072870395454
1999-09-30T09:30:00-04:00,28.23437,28.75,28.23437,28.75,142800,30395,47.469738698720185,44.135799615545864,NaN,NaN,-62.259496415938024,-146.26198430377482,-0.08333552890952028,-0.24976394561201332,-0.16642841670249303,839300,738400,18.141604188004337,48.00991178604046,NaN,NaN,-13.191445069825333,-6.88512604174258
1999-10-01T09:30:00-04:00,28.53125,28.53125,28.34375,28.35937,2000,29960,42.9953578060081,43.617192649225785,NaN,NaN,-80.54969073426327,-118.40769834257271,-0.07231924397909045,-0.2568274716763561,-0.18450822769726566,837300,757920,26.782218177142326,45.442378580702226,NaN,NaN,-13.380530748405913,-7.813040999837342
1999-10-04T09:30:00-04:00,28.54687,28.875,28.54687,28.85937,7300,29775,49.55023223118884,43.82756115755782,NaN,NaN,-28.256231880781442,-93.45232516145934,-0.028032397533103603,-0.21954872461364516,-0.19151632708054156,844600,774040,33.06569530118193,43.50293557808459,NaN,NaN,-11.282291502639936,-8.308648214523426
1999-10-05T09:30:00-04:00,28.73437,28.98437,28.5625,28.5625,39200,30515,46.156569589376176,43.743593089273745,NaN,NaN,-31.142356645793182,-64.78290469556006,-0.016004287620331153,-0.2115216866059555,-0.19551739898562434,805400,804620,43.05032274997468,42.31100024879955,NaN,NaN,-10.710442101244649,-8.651761626912172
1999-10-06T09:30:00-04:00,28.82812,29.07812,28.8125,28.96875,12100,30975,51.092924867325145,44.27162351814685,NaN,NaN,14.789905451023955,-37.483574045150355,0.0200820905841671,-0.17041478575541547,-0.19049687633958257,817500,828820,49.47369664009579,41.616802997536745,NaN,NaN,-8.559204549204996,-8.638539187239719
1999-10-07T09:30:00-04:00,29.0625,29.20312,28.98437,29,4300,30550,51.461563462186476,44.35946410851837,NaN,NaN,42.790809834468234,-16.473512795069105,0.045378622614159425,-0.13377359807188327,-0.1791522206860427,821800,825320,48.619573590018746,40.82205027349916,NaN,NaN,-6.767846909283206,-8.371297433245932
1999-10-08T09:30:00-04:00,29.07812,29.51562,29.07812,29.39062,102600,35510,55.932856639800725,44.734086043008254,NaN,NaN,98.45933282830136,19.32829191744382,0.08541692887254207,-0.07238105959536512,-0.15779798846790719,924400,842740,52.971412447037316,40.19013500007119,NaN,NaN,-3.797293082943691,-7.717868240345612
1999-10-11T09:30:00-04:00,29.25,29.48437,29.25,29.4375,4300,35350,56.45134607324994,45.52932545273071,NaN,NaN,109.71501501743175,46.92254129708647,0.1104648532277751,-0.019716921933188303,-0.1301817751609634,928700,859560,56.77805366164348,39.76392827978835,NaN,NaN,-1.273343615213846,-6.797221865326788
1999-10-12T09:30:00-04:00,29.10937,29.14062,28.70312,28.82812,6100,35570,48.468308836168234,45.844118378224174,NaN,NaN,18.086438897851334,56.76830040581537,0.08267129123140941,-0.02684266112170164,-0.10951395235311105,922600,883000,61.459823010174425,39.94752712739081,NaN,NaN,-1.5405057833180753,-6.04626242503983
1999-10-13T09:30:00-04:00,28.625,28.70312,28,28.01562,25600,35790,40.28769127749653,45.79323790610249,NaN,NaN,-97.46159970119878,34.317999375370775,0.010063625276057517,-0.09693442075803915,-0.10699804603409667,897000,898900,64.28581326305633,40.561200518503874,NaN,NaN,-4.660419741358083,-5.84828489879958
1999-10-14T09:30:00-04:00,27.875,27.96875,27.45312,27.73437,4500,35360,37.90287864604063,46.04895036969378,NaN,NaN,-163.42399987973064,-6.924962567468998,-0.05294624215399307,-0.173180848726588,-0.12023460657259494,892500,913040,66.62928356371205,42.44686206768943,NaN,NaN,-7.975656395717872,-6.1521951126450505
1999-10-15T09:30:00-04:00,27.20312,27.625,27.14062,27.34375,27600,36370,34.81999446990194,45.644717368869316,NaN,NaN,-183.93241754673707,-63.40331264247668,-0.1134963767350341,-0.26210507749138756,-0.14860870075635346,864900,901140,62.889235043466016,44.67579399777754,NaN,NaN,-11.762209582537055,-6.953625751201051
1999-10-18T09:30:00-04:00,27.14062,27.32812,26.8125,26.8125,261100,48945,31.11350247009861,45.230333742452046,NaN,NaN,-199.6077999106915,-125.26787562810132,-0.17804665717230977,-0.3711670222217407,-0.19312036504943092,603800,836160,47.28201648978174,46.427953858042905,NaN,NaN,-16.25016610741957,-8.281702944946554
1999-10-19T09:30:00-04:00,27.20312,27.375,26.79687,26.82812,202900,58360,31.34490808469208,44.64627665373241,NaN,NaN,-167.0604580917164,-162.29725502601488,-0.20641454901297052,-0.45113855131564407,-0.24472400230267355,806700,812980,43.16658566149707,48.185380984770404,NaN,NaN,-19.640094494131848,-9.904330309115881
1999-10-20T09:30:00-04:00,27.0625,27.15625,27.03125,27.0625,3500,57755,34.8798276260992,43.74699729140234,NaN,NaN,-135.96257900916737,-169.9974508876086,-0.1961857162372963,-0.48995614759929396,-0.29377043136199765,810200,795620,40.33504480373291,49.770626743036736,NaN,NaN,-21.344509776208938,-11.538641661557746
1999-10-21T09:30:00-04:00,26.96875,26.96875,26.48437,26.76562,209500,67750,32.590820476822145,43.00381605360334,NaN,NaN,-147.50729171387778,-166.81410925443802,-0.1957580416795376,-0.5384679834614197,-0.3427099417818821,600700,737260,32.59452629544211,50.18579160862958,NaN,NaN,-23.483203781101494,-13.245007678635424
1999-10-22T09:30:00-04:00,27.14062,27.65625,27.09375,27.48437,14900,62505,42.43951880098673,42.49590795144605,NaN,NaN,-71.5426210574561,-144.33614995658183,-0.13623465654189448,-0.5130032624592502,-0.3767686059173557,615600,687400,27.70308047327353,49.80274769235041,NaN,NaN,-22.173931712612884,-14.520568254917919
1999-10-25T09:30:00-04:00,27.39062,27.46875,27.125,27.4375,10800,61830,42.00849751179627,42.19961708876178,NaN,NaN,-69.60354680230662,-118.33529933490486,-0.09134111252597554,-0.49094499657482515,-0.3996038840488496,604800,687600,27.74991793201349,48.7098616339246,NaN,NaN,-21.27619737755223,-15.485658129579964
1999-10-26T09:30:00-04:00,27.39062,27.60937,27.25,27.26562,5800,56545,40.38854761874074,41.43501871386288,NaN,NaN,-61.06242376724693,-97.13569247001097,-0.06574032454040085,-0.4817792897243507,-0.41603896518394984,599000,646060,24.23766708158915,46.90728809403128,NaN,NaN,-21.019073976746633,-16.27614610774663
1999-10-27T09:30:00-04:00,27.25,27.35937,27.0625,27.35937,42900,56490,41.70892213452999,40.73840147617313,NaN,NaN,-64.02435411019312,-82.74804749021612,-0.03647217634393851,-0.461629185613873,-0.4251570092699345,641900,612400,21.826935331099676,44.993528218394204,NaN,NaN,-20.426906900703987,-16.869111935311967
1999-10-28T09:30:00-04:00,27.76562,28,27.6875,27.98437,8100,49755,49.70672621469035,40.29367787437955,NaN,NaN,-9.018595777442348,-55.050308302929025,0.027546578862938875,-0.39072378569126087,-0.41827036455419975,650000,622260,24.20511922057156,42.93879298793236,NaN,NaN,-17.39919452081608,-16.944838018955412
1999-10-29T09:30:00-04:00,28.17187,28.35937,28.10937,28.125,20500,50680,51.32501903849388,39.927511657611255,NaN,NaN,18.517835927474444,-37.0382169059429,0.07901622633019934,-0.3195000816414506,-0.39851630797164994,670500,633240,26.873057739091536,40.80272185060722,NaN,NaN,-14.431734129274835,-16.585823177572472
1999-11-01T09:30:00-05:00,28.01562,28.01562,27.40625,27.40625,3100,50470,43.60273914049325,39.57997096506303,NaN,NaN,-28.884735779331926,-28.894454701347957,0.06489849431832162,-0.3173931900737479,-0.3822916843920695,667400,645760,29.90291770376801,38.54865718586391,NaN,NaN,-14.172465371504561,-16.241057776705627
1999-11-02T09:30:00-05:00,27.6875,28.03125,27.65625,27.75,25700,49795,47.658844766116246,40.10648192853587,NaN,NaN,-6.829753085417008,-18.047920564981972,0.07807028933822047,-0.28470382271929395,-0.3627741120575144,693100,664580,34.3089846403346,36.407455141383785,NaN,NaN,-12.655245163774662,-15.728798832001203
1999-11-03T09:30:00-05:00,27.75,27.75,27.5625,27.5625,8400,49610,45.72702143668456,40.665349270724725,NaN,NaN,-20.335760939928385,-9.310201930929022,0.0735750720708091,-0.27080527196900306,-0.34438034403981216,684700,673140,36.27110816582887,34.239014041534986,NaN,NaN,-12.014471574691203,-15.198180652385489
1999-11-04T09:30:00-05:00,27.75,27.90625,27.35937,27.48437,17800,50285,44.910120578707485,41.386072564210835,NaN,NaN,-19.140684438958957,-11.334619663232342,0.06505420590555056,-0.26306258665787396,-0.3281167925634245,666900,676520,37.07039561001273,32.39481122485975,NaN,NaN,-11.736410673161117,-14.703642083924864
1999-11-05T09:30:00-05:00,27.625,27.85937,27.5625,27.625,88600,49585,46.7539825401578,42.503249712072204,NaN,NaN,3.2125581055866372,-14.395675227609908,0.06826929932772446,-0.24278016840376893,-0.3110494677314934,755500,693520,41.073476347215944,31.951344071819335,NaN,NaN,-10.976151149497413,-14.171143379006656
1999-11-08T09:30:00-05:00,27.48437,27.67187,27.48437,27.67187,4000,49570,47.38604384281265,43.64904512336653,NaN,NaN,7.090673122188608,-7.200593447305801,0.07253258064393164,-0.22038374192657884,-0.2929163225705105,759500,711940,45.14520939811903,32.092674338720904,NaN,NaN,-10.174799069412153,-13.600237049064583
1999-11-09T09:30:00-05:00,27.67187,27.6875,27.5625,27.6875,4500,49490,47.60938782365577,44.558299423192,NaN,NaN,30.23804593643293,0.2129663570641874,0.07507037733322885,-0.1990783509039744,-0.27414872823720327,764000,726120,48.117301872249335,32.64854984361494,NaN,NaN,-9.450040007013003,-13.00735175734293
1999-11-10T09:30:00-05:00,27.45312,27.64062,27.45312,27.57812,5900,48505,46.133500088539954,45.52563368117184,NaN,NaN,20.263515209109137,8.332821586871692,0.06824469146164275,-0.18884286391014982,-0.25708755537179256,758100,740800,51.07281244186589,33.96842742550235,NaN,NaN,-9.208171879056595,-12.464611774730596
1999-11-11T09:30:00-05:00,27.625,27.82812,27.59375,27.6875,23800,49470,47.873712279343565,45.913790358197325,NaN,NaN,56.514722450596956,23.463902964782875,0.06971317853442485,-0.1699460822037615,-0.23965926073818636,781900,763800,55.36313651031518,35.94414571386246,NaN,NaN,-8.553288335024009,-11.90585128334394
1999-11-12T09:30:00-05:00,27.90625,27.90625,27.59375,27.875,41400,50160,50.8075107970701,46.542291307145454,NaN,NaN,71.46492122423518,37.11437558851259,0.08112985746702189,-0.13824693890440898,-0.21937679637143087,823300,777360,57.71721001013487,38.08466657658543,NaN,NaN,-7.211366352057182,-11.235210578874403
1999-11-15T09:30:00-05:00,28,28.25,28,28.03125,14300,37820,53.17275264692211,47.45544880915842,NaN,NaN,137.01370858780874,63.098982681636606,0.09600417580367898,-0.09937157661683216,-0.19537575242051114,837600,792980,60.313623291207875,40.661520591558194,NaN,NaN,-5.416777651838634,-10.40400587501215
1999-11-16T09:30:00-05:00,28.26562,28.6875,28.26562,28.6875,9900,28170,61.53742739505666,48.871770613481736,NaN,NaN,225.89269961437782,102.22991341722559,0.14395595815986514,-0.015430804720679703,-0.15938676288054485,847500,809680,62.934238390949794,43.59775652440463,NaN,NaN,-1.1545285542772012,-9.082651972050014
1999-11-17T09:30:00-05:00,28.85937,28.9375,28.73437,28.875,8500,28420,63.541291861257804,49.85995387395085,NaN,NaN,238.3728784259428,145.8517860605923,0.179883707816382,0.06546787188993264,-0.11441583592644936,856000,829260,65.7868081935365,46.567877165330735,NaN,NaN,3.046887855647502,-7.349860568093226
1999-11-18T09:30:00-05:00,28.85937,29.0625,28.8125,28.96875,38300,19860,64.53617100581383,50.80360758590227,NaN,NaN,209.64227434450746,176.4772964393744,0.19999873737643148,0.13558258579409,-0.06441615158234149,894300,851740,68.75949840624514,49.55976578441314,NaN,NaN,6.827460367725112,-5.324529005833464
1999-11-19T09:30:00-05:00,28.8125,28.85937,28.59375,28.625,5000,19365,58.258683836876116,51.850460778501045,NaN,NaN,134.2137938630332,189.02707096713402,0.18077213173696594,0.16154901308886593,-0.0192231186481,889300,864940,70.38657148663144,52.451455340331954,NaN,NaN,8.358461324069392,-3.3698161015616273
1999-11-22T09:30:00-05:00,28.20312,28.5,28.20312,28.5,24600,20055,56.12092149709349,52.45489483071371,NaN,NaN,73.94304502482329,176.41293825453693,0.15144293947209952,0.1700805556920244,0.01863761621992488,864700,870360,71.0532236697463,55.07604384243279,NaN,NaN,9.024020305412057,-1.5992680434225297
1999-11-23T09:30:00-05:00,28.32812,28.32812,28.125,28.21875,27700,21150,51.53847388232934,52.869998576831186,NaN,NaN,39.007083471964435,139.03581502605425,0.10700244728844695,0.15239067533048356,0.04538822804203661,837000,868260,70.39201475256537,57.51325145577111,NaN,NaN,8.256062915180527,-0.19136362076495028
1999-11-24T09:30:00-05:00,28.09375,28.28125,28.09375,28.23437,3900,19200,51.77399355934037,53.36027521830497,NaN,NaN,29.353489924657392,97.23193732579718,0.074121798740739,0.13804047646796036,0.06391867772722136,840900,865240,69.39193134469483,59.821932579676975,NaN,NaN,7.693942042764597,0.9351086168821279
1999-11-26T09:30:00-05:00,28.0625,28.20312,28.0625,28.09375,14800,19535,49.44430875121665,53.552441376237745,NaN,NaN,13.061218803278768,57.915726217551445,0.040070483794722916,0.11400678247062501,0.0739362986759021,826100,851600,64.90660709061086,61.52429906134804,NaN,NaN,6.562885421396612,1.7390767318127685
1999-11-29T09:30:00-05:00,27.60937,27.78125,27.53125,27.625,231100,30065,42.56810564008147,53.208302933185514,NaN,NaN,-63.09985281054713,18.452996882835368,-0.013961374740062094,0.05648458025082448,0.07044595499088657,595000,792740,49.91345164128402,61.86488779300269,NaN,NaN,3.4244509333098963,1.9798444748837867
1999-11-30T09:30:00-05:00,27.59375,27.75,27.48437,27.5,14100,30615,40.933312909511415,52.731440439318064,NaN,NaN,-74.07406780325529,-11.150425682780346,-0.055715068866574936,0.0008021189076679036,0.05651718777424284,580900,735980,40.256376155478954,61.30339309894766,NaN,NaN,0.32143589622209306,1.7429289636464018
1999-12-01T09:30:00-05:00,27.5625,27.9375,27.5625,27.71875,41800,31420,44.91985352181829,52.64475139883793,NaN,NaN,-45.7385000219268,-28.099542381558592,-0.06551994191946953,-0.025382739625094075,0.04013720229437546,622700,693120,34.78371618964174,60.139886223788785,NaN,NaN,-1.1929801111008191,1.323513381539656
1999-12-02T09:30:00-05:00,27.90625,28.03125,27.65625,27.65625,219000,41950,44.00598861401576,52.3684854227431,NaN,NaN,-40.7760776978552,-42.125455906061106,-0.0725853099754807,-0.050594435174975416,0.021990874800505284,403700,605680,26.78389632063262,58.098511924525745,NaN,NaN,-2.705451249182531,0.7479470057222007
1999-12-03T09:30:00-05:00,28.04687,28.34375,28.04687,28.10937,24100,42265,51.68100726417418,52.430878027536245,NaN,NaN,20.89657697642111,-40.55838427143264,-0.044492130682417544,-0.033624288552516646,0.010867842129900898,427800,526020,21.852960531817132,55.53677981893163,NaN,NaN,-1.776318565646745,0.38733763838377994
1999-12-06T09:30:00-05:00,28.03125,28.04687,27.84375,28.03125,17300,38700,50.39841555672268,52.232711092521996,NaN,NaN,-16.546447330447297,-31.24770317541267,-0.029636035086366353,-0.026177201728057042,0.00345883335830931,410500,489120,20.014822649277534,52.65829405879374,NaN,NaN,-1.3897897147925098,0.13346230221573857
1999-12-07T09:30:00-05:00,28.01562,28.03125,27.5,27.5,8000,38900,42.647206670409105,50.88340961219003,NaN,NaN,-72.68736327739835,-30.97036227024129,-0.052705619673335924,-0.0624231912333606,-0.00971757156002467,402500,453440,18.402923766698805,49.47748587134725,NaN,NaN,-3.508323529297545,-0.3867928165718733
1999-12-08T09:30:00-05:00,27.65625,28.07812,27.65625,27.98437,210500,49200,50.17191591457762,49.928454187427164,NaN,NaN,-33.610860233414854,-28.5448343125389,-0.033402317616790134,-0.05147046858101234,-0.018068150964222204,613000,451500,18.31654813288681,46.08675300987227,NaN,NaN,-2.863495424149648,-0.7406074747972697
1999-12-09T09:30:00-05:00,27.4375,27.625,27.14062,27.23437,12700,49540,41.16575089472545,48.25913846520656,NaN,NaN,-137.82376784324717,-47.95437234161729,-0.06725090115047845,-0.10213177740232027,-0.034880876251841816,600300,490820,25.90716538000396,43.02587207942647,NaN,NaN,-5.582449314140833,-1.4322991661320645
1999-12-10T09:30:00-05:00,27.65625,27.75,27.5,27.73437,37100,50205,47.88246010189651,47.517979626993736,NaN,NaN,-75.49742866449658,-67.23317346980083,-0.0527142999887603,-0.1007737512377922,-0.048059451249031895,637400,532740,33.05022954093789,40.35899051187693,NaN,NaN,-5.3468077893178725,-1.991514683730037
1999-12-13T09:30:00-05:00,27.71875,28.01562,27.71875,27.89062,22600,49265,49.810747504046034,47.067252913204634,NaN,NaN,-36.917380461461285,-71.30736009600363,-0.030430010474889968,-0.08609696434264436,-0.05566695386775439,660000,582640,40.41424576901017,38.17049209039578,NaN,NaN,-4.491529975738297,-2.348659725445503
1999-12-14T09:30:00-05:00,27.98437,28.10937,27.875,27.89062,9400,49020,49.810747504046034,46.94384388618439,NaN,NaN,-19.719578415657388,-60.71380312365544,-0.014359953101199127,-0.0736168952442533,-0.05925694214305417,660000,634140,46.90520604233482,36.49286289680788,NaN,NaN,-3.8366621547042348,-2.5612315010538933
1999-12-15T09:30:00-05:00,27.95312,27.95312,27.59375,27.625,18800,49465,46.42430737020564,46.561723444103336,NaN,NaN,-58.26228177019748,-65.64408743101197,-0.019945793630737216,-0.0841891841814757,-0.06424339055073848,641200,639780,47.57869563875006,34.934774632097536,NaN,NaN,-4.366128098689965,-2.819073872144761
1999-12-16T09:30:00-05:00,27.65625,27.90625,27.65625,27.875,17100,49895,49.87821554644362,46.592716786619555,NaN,NaN,-35.713937200414975,-45.22212130244552,-0.0058611881148701445,-0.07156987569432616,-0.06570868757945601,658300,651380,49.01126852684136,33.799393306114005,NaN,NaN,-3.7226316967709514,-2.9481535613770737
1999-12-17T09:30:00-05:00,28.1875,28.53125,28,28.53125,788400,87400,57.604591079752396,47.666751460881756,NaN,NaN,104.98476843106747,-9.125681883332717,0.04575341836678078,-0.008516914620980032,-0.054270332987760815,1446700,813240,63.85452208536517,34.7951840521198,NaN,NaN,-0.5160917115954265,-2.60071615426541
1999-12-20T09:30:00-05:00,28.3125,28.3125,27.625,27.67187,459700,110135,47.3179065769791,48.12279386570088,NaN,NaN,-9.212277994782884,-3.5846613899970388,0.021357132308590168,-0.0275739176020231,-0.04893104991061327,987000,878640,67.91834320451986,36.77103884133701,NaN,NaN,-1.3953139669440413,-2.428515841790929
1999-12-21T09:30:00-05:00,27.48437,28.10937,27.48437,28.0625,519300,134870,51.55288567145658,48.59658187638933,NaN,NaN,3.7934729601982133,1.1179488851740789,0.03032162573432747,-0.011029017742703928,-0.0413506434770314,1506300,1047900,75.57281604169083,39.684545973626236,NaN,NaN,-0.5738367343502607,-2.1635616835851192
1999-12-22T09:30:00-05:00,28.01562,28.09375,27.84375,27.9375,511700,159070,50.16324358096333,49.03638580259987,NaN,NaN,36.02369092543589,19.975143424300743,0.02675066476360556,-0.007912312522524445,-0.034662977286130006,994600,1118580,77.93979761914058,43.33853892351965,NaN,NaN,-0.4090534853127632,-1.912917655260497
1999-12-23T09:30:00-05:00,28.25,28.45312,28.20312,28.3125,152100,166480,54.1557091307095,49.21315022163811,NaN,NaN,164.08812948750028,59.9355567618838,0.04735778123684452,0.024534249259925645,-0.022823531976918873,1146700,1216260,80.72025674089689,47.54334579559678,NaN,NaN,1.065358341125638,-1.4874496557767634
1999-12-27T09:30:00-05:00,28.875,28.875,28.42187,28.59375,1067100,219095,56.94178764164733,49.68053394198988,NaN,NaN,230.9201266851339,85.12262841269708,0.07594814520174722,0.07211164952526516,-0.0038364956764820636,2213800,1369680,84.10823212236494,52.121446472245886,NaN,NaN,3.1821371755873082,-0.8203658227247531
1999-12-28T09:30:00-05:00,28.6875,29.1875,28.6875,28.89062,34900,209285,59.72413550627975,50.9003145731235,NaN,NaN,244.29957342596407,135.82499869684648,0.10886723063402803,0.13224754261605298,0.023380311982024945,2248700,1622020,87.88056611540524,57.084135211439204,NaN,NaN,5.828252456341502,0.12943678857042618
1999-12-29T09:30:00-05:00,29.01562,29.14062,28.95312,29.10937,9000,209030,61.68862453908257,51.72293661773099,NaN,NaN,210.86881779307328,177.24006766342148,0.1375402356285993,0.19530560651777407,0.05776537088917477,2257700,1772300,89.4818779111309,62.16737305274235,NaN,NaN,8.61343582975205,1.3414366515963723
1999-12-30T09:30:00-05:00,29.25,29.34375,29.17187,29.17187,10200,207450,62.25509814211704,53.229318563973244,NaN,NaN,189.44130356413953,207.9235901911622,0.15176380137330944,0.24747012260581158,0.09570632123250214,2267900,2026960,91.52531535522635,66.85438376525823,NaN,NaN,11.021398071756987,2.7242882830478887
1999-12-31T09:30:00-05:00,29.28125,29.60937,29.25,29.60937,4700,196735,66.0403741560944,54.52631242498738,NaN,NaN,185.0223011160654,212.11042451687527,0.1797708392383353,0.3204198702804213,0.14064903104208598,2272600,2252140,92.84838069151307,71.1256802760136,NaN,NaN,14.304570101947483,4.378614257176402
2000-01-03T09:30:00-05:00,29.48437,29.48437,28.6875,28.84375,82800,199670,55.542841342633764,54.93574769917222,NaN,NaN,99.82510276365143,185.89141973257875,0.13775887339498785,0.3128476227858208,0.17508874939083294,2189800,2247340,92.51681124341962,74.84729209561428,NaN,NaN,13.837230638279255,5.729845168762523
2000-01-04T09:30:00-05:00,28.46875,28.60937,27.9375,28.04687,146900,206150,47.143193889135794,54.745208155250054,NaN,NaN,-6.062619188976757,135.8189812095906,0.051753768682580165,0.23978096024405815,0.18802719156147799,2042900,2206180,89.56323124603242,77.89429389587839,NaN,NaN,10.435679350157914,6.40210719467615
2000-01-05T09:30:00-05:00,28,28.125,27.71875,27.92187,129200,212210,45.96884187385624,54.712674905510816,NaN,NaN,-44.844851369392025,84.67624737709751,-0.014556998820228484,0.1698309430361924,0.18438794185642088,1913700,2137380,84.6959283799999,80.54552480596767,NaN,NaN,7.40270935613615,6.545050360599007
2000-01-06T09:30:00-05:00,27.92187,28.375,27.8125,28.29687,54000,204385,49.99335159912481,54.72089890927375,NaN,NaN,-14.726783969923574,43.84262987028488,-0.033105607043207946,0.14300593305241094,0.17611154009561888,1967700,2077340,80.58040573371841,82.80046317788745,NaN,NaN,6.204390188357626,6.4963846217073815
2000-01-07T09:30:00-05:00,28.625,29.375,28.625,29.375,32900,205395,59.364605972761964,54.84661425877443,NaN,NaN,103.04113006997484,27.446395661066777,0.024202097891929703,0.20636416246053102,0.18216206456860132,2000600,2022940,76.932727736034,83.73462072436381,NaN,NaN,8.491158577819128,6.781352329723346
2000-01-10T09:30:00-05:00,29.53125,29.625,29.28125,29.375,122500,209665,59.36460597276195,55.707092787044644,NaN,NaN,122.81415268880116,32.04420564609673,0.05719200637597319,0.2536520725385678,0.19646006616259462,2000600,1985100,74.40952308679212,84.1982764302404,NaN,NaN,10.213068885176476,7.2715975519309355
2000-01-11T09:30:00-05:00,29.46875,29.46875,29,29,109800,214025,55.1922836959252,55.9670497887924,NaN,NaN,78.88476477029835,49.03368243795173,0.04914862955959548,0.25789585311208896,0.20874722355249348,1890800,1954680,72.35503849091185,83.96843517661331,NaN,NaN,10.26967616621985,7.699894496829352
2000-01-12T09:30:00-05:00,28.92187,28.92187,28.65625,28.65625,39900,215550,51.61138609314684,56.070488539662655,NaN,NaN,24.49583333595723,62.90181937902158,0.017690313893305054,0.2308601159191248,0.21316980202581975,1850900,1942120,71.47751464956208,83.50684353592915,NaN,NaN,9.161500811900797,7.908695398982416
2000-01-13T09:30:00-05:00,29.0625,29.26562,28.84375,29.20312,189700,224095,56.452074072356965,56.234514606923184,NaN,NaN,63.52112676363932,78.55140152573416,0.030002033013807466,0.2506723432930791,0.22067031027927161,2040600,1956700,71.90350026332155,82.87707521610233,NaN,NaN,9.794423747126835,8.178085163003047
2000-01-14T09:30:00-05:00,29.28125,29.29687,28.89062,29,5700,223525,54.280084698756795,56.04439296814529,NaN,NaN,52.508540145300685,68.44488354079934,0.02117157092310376,0.2471347739331513,0.22596320301004755,2034900,1963560,72.11452669825253,82.02038197152287,NaN,NaN,9.620648004774415,8.384165568970385
2000-01-18T09:30:00-05:00,28.78125,29.09375,28.76562,28.96875,83600,188285,53.93625719301425,55.63097308862632,NaN,NaN,32.54985354423075,50.39202371188525,0.010472594243411876,0.23905394581431239,0.2285813515709005,1951300,1953700,71.28577392486957,80.8350396721989,NaN,NaN,9.380259169794588,8.526464654802414
2000-01-19T09:30:00-05:00,29,29.03125,28.875,28.875,62800,168440,52.85460198686164,54.9999714777534,NaN,NaN,25.336230480366606,39.682316853898904,-0.004849146294016282,0.22251991870338017,0.22736906499739645,1888500,1953240,71.24463811781979,79.53237968696239,NaN,NaN,8.874667467198162,8.576207913716091
2000-01-20T09:30:00-05:00,29,29,28.375,28.6875,49600,144955,50.666132612778654,54.1721882256578,NaN,NaN,-20.42273508600397,30.69860316950666,-0.028237008500331617,0.19207280437198193,0.22030981287231355,1838900,1950840,71.01438708353089,78.06731338184127,NaN,NaN,7.832515025197575,8.46996607249916
2000-01-21T09:30:00-05:00,28.65625,28.76562,28.32812,28.32812,45700,121655,46.67683546154138,52.78907831890401,NaN,NaN,-67.82824991807065,4.428727833164669,-0.06635915132134027,0.1373608737206382,0.20372002504197848,1793200,1901360,66.25990365976563,76.16813645100218,NaN,NaN,5.772418224570757,8.084602094223674
2000-01-24T09:30:00-05:00,28.51562,28.54687,27.5,27.51562,51600,116630,39.16812203965438,51.619455511548345,NaN,NaN,-167.95275042039043,-39.66353027997356,-0.14048384396078334,0.028115220090999316,0.16859906405178265,1741600,1842700,61.042146724064196,73.91994612819109,NaN,NaN,1.453610892228754,7.137317636795829
2000-01-25T09:30:00-05:00,27.15625,27.39062,26.8125,27.35937,89700,67760,37.90529085514298,50.95960529483457,NaN,NaN,-221.47652648277986,-90.46880628537568,-0.19108796549002682,-0.07026089281075087,0.12082707267927595,1651900,1782820,56.17885476981724,71.53534780846142,NaN,NaN,-2.4519149121307,5.767427272663467
2000-01-26T09:30:00-05:00,27.26562,27.75,26.26562,27.57812,93400,70685,40.78378855100245,50.58924434320216,NaN,NaN,-174.44277012922416,-130.42460640729382,-0.1999299449885738,-0.12908535855644132,0.07084458643213248,1745300,1754180,53.96431679456035,69.34023269521575,NaN,NaN,-4.865465433347298,4.248442600376215
2000-01-27T09:30:00-05:00,27.64062,28.28125,27.64062,27.73437,156000,78035,42.82266924567423,50.077052746527116,NaN,NaN,-80.43105697935815,-142.42627078596465,-0.1856656349557356,-0.16123745726253702,0.024428177693198577,1901300,1766660,54.80044082368461,67.49880663021332,NaN,NaN,-6.288055534611936,2.743228581092194
2000-01-28T09:30:00-05:00,27.625,27.73437,27,27,17600,78405,36.46737973919848,48.44153658698688,NaN,NaN,-132.09533138416876,-155.27968707918427,-0.2140806272013459,-0.2431726063084838,-0.029091979107137907,1883700,1784760,56.04728028367129,66.00698895504455,NaN,NaN,-9.600358075569309,0.9798590587119793
2000-01-31T09:30:00-05:00,26.85937,27.29687,26.85937,27.1875,45700,80455,38.95829684749633,46.983943078039324,NaN,NaN,-127.41797617885739,-147.17273223087767,-0.208437095635493,-0.2896383486515042,-0.08120125301601117,1929400,1822320,58.599475412106045,64.87769983542412,NaN,NaN,-11.56599444662218,-0.8124057277643288
2000-02-01T09:30:00-05:00,27.15625,27.15625,26.90625,27,5500,76590,37.380007672432384,45.71163764778985,NaN,NaN,-120.31026433920334,-126.93947980216237,-0.20519873804622982,-0.33769967557379843,-0.1325009375275686,1923900,1876720,62.037731914677444,64.1407493656931,NaN,NaN,-13.665191203104744,-2.6485179385272453
2000-02-02T09:30:00-05:00,27.23437,27.23437,26.875,27.01562,3500,69420,37.60677916652006,44.71130858160222,NaN,NaN,-104.06847255728132,-112.8646202877738,-0.19020732365940074,-0.37026009210181954,-0.1800527684424188,1927400,1913140,64.18237459295204,63.6196679330781,NaN,NaN,-15.307036825785056,-4.456877779564075
2000-02-03T09:30:00-05:00,27.125,27.15625,26.75,27,107900,68355,37.46068400338016,43.35478071953245,NaN,NaN,-99.96718271465302,-116.77184543483277,-0.17019533853275853,-0.392796941608367,-0.22260160307560845,1819500,1896780,62.47496829882275,62.94620136418532,NaN,NaN,-16.70260528420609,-6.206267423084363
2000-02-04T09:30:00-05:00,27.29687,27.29687,27.0625,27.10937,31400,67225,39.24054240133149,42.28052769828778,NaN,NaN,-75.37838341723031,-105.42845584144509,-0.13972113885553317,-0.39725302664502493,-0.25753188778949176,1850900,1890220,61.76543654575372,62.20698063900683,NaN,NaN,-17.427975718733226,-7.809368608177057
2000-02-07T09:30:00-05:00,26.9375,26.9375,26.5,26.64062,43800,67770,34.68442806154293,40.90539704603983,NaN,NaN,-101.20757212824445,-100.18637503132251,-0.1408627487562243,-0.43361032373477215,-0.29274757497854786,1807100,1865760,59.07153722485175,61.334535160434136,NaN,NaN,-19.3700433566104,-9.460893572238962
2000-02-08T09:30:00-05:00,27.09375,27.09375,26.70312,26.75,119600,67625,36.53611510623102,39.7397908402805,NaN,NaN,-82.71882202155939,-92.66808656779371,-0.12454472984199816,-0.44842848728104556,-0.3238837574390474,1926700,1866320,59.11550259830212,60.46816833761145,NaN,NaN,-20.502080166275167,-11.038205942815562
2000-02-09T09:30:00-05:00,26.73437,26.73437,26.375,26.46875,58400,65055,33.876670950944,38.540543578720886,NaN,NaN,-99.73445502559832,-91.8012830614571,-0.12278400273650442,-0.4773637608596779,-0.3545797581231735,1868300,1854500,57.706460707996584,59.51760216793043,NaN,NaN,-22.23842785807087,-12.638237644994891
2000-02-10T09:30:00-05:00,26.3125,26.375,26,26.01562,65200,66320,30.077994128819995,37.35491205495508,NaN,NaN,-121.0933974440436,-96.02652600733522,-0.1409289348175483,-0.5307409266451089,-0.38981199182756054,1803100,1851220,57.298324158024386,58.87748934637748,NaN,NaN,-24.930034607615877,-14.394208639655032
2000-02-11T09:30:00-05:00,26.0625,26.0625,25.32812,25.46875,50400,59355,26.252033182948736,36.4323342794761,NaN,NaN,-154.07130147188337,-111.76510961826583,-0.17626022337406644,-0.6101372710451436,-0.43387704767107715,1752700,1831580,54.7990912541043,58.43155681280892,NaN,NaN,-28.563901229589522,-16.4184504382171
2000-02-14T09:30:00-05:00,25.5,25.90625,25.45312,25.875,4900,59315,33.06361352648217,36.086500184571754,NaN,NaN,-140.77398121037916,-119.67839143469276,-0.15928383824530207,-0.6329818454777048,-0.4736980072324027,1757600,1821680,53.53157588801991,58.2424654641091,NaN,NaN,-29.53299753948778,-18.291957166970054
2000-02-15T09:30:00-05:00,25.92187,26.57812,25.8125,26.32812,21200,56195,39.74817025433619,36.01252744909559,NaN,NaN,-91.6762454783041,-121.46987612604171,-0.10705777278893525,-0.6075202232185717,-0.5004624504296364,1778800,1792100,49.82339546892405,57.94668536942079,NaN,NaN,-28.18984381231709,-19.7059409734482
2000-02-16T09:30:00-05:00,26.42187,26.45312,26.15625,26.26562,77400,56925,39.16715986353082,35.75141963608535,NaN,NaN,-79.56266578119293,-117.43551827716063,-0.06813732475163548,-0.5856341063691808,-0.5174967816175453,1701400,1758720,45.95478985020258,57.31485315702922,NaN,NaN,-27.29650252691033,-20.790306909657076
2000-02-17T09:30:00-05:00,26.375,26.4375,26.14062,26.375,16400,55265,40.79812546428891,36.06075861644896,NaN,NaN,-68.02974394184983,-106.82278757672186,-0.028472575336218164,-0.553087500787818,-0.5246149254515998,1717800,1741660,44.0713370499547,56.45942864033518,NaN,NaN,-26.080448746410983,-21.546041457764776
2000-02-18T09:30:00-05:00,26.48437,26.5,25.70312,25.79687,115300,58745,35.396339947640655,35.80633312360212,NaN,NaN,-96.2255580229676,-95.25363888693872,-0.0342309912364368,-0.5674036644971459,-0.533172673260709,1602500,1711620,40.89314556296717,55.194690793968114,NaN,NaN,-26.65096767212954,-22.275316631245456
2000-02-22T09:30:00-05:00,26.25,26.25,25.79687,26.21875,46900,58510,41.484882211714115,36.09953844783654,NaN,NaN,-76.44952051198533,-82.38874674725994,-0.004261580139179655,-0.5384996484346836,-0.5342380682955039,1649400,1689980,38.726565095982004,53.52960744977559,NaN,NaN,-25.188939437651527,-22.691548460732037
2000-02-23T09:30:00-05:00,26.39062,26.39062,26.01562,26.01562,63100,57180,39.5520463518858,36.238486103934086,NaN,NaN,-62.5994360236273,-76.57338485632457,0.006653329645728845,-0.5259214062383428,-0.5325747358840717,1586300,1651480,35.157679218574344,51.45641492303432,NaN,NaN,-24.58398176525284,-22.96189607566358
2000-02-24T09:30:00-05:00,26,26,25.42187,25.78125,19500,53485,37.387607020358104,36.23326631943251,NaN,NaN,-105.13788872280924,-81.68842944464787,0.0030442414463773826,-0.5287694340761,-0.5318136755224774,1566800,1624560,32.87625998808299,49.34222147226719,NaN,NaN,-24.73671423530071,-23.215441527040316
2000-02-25T09:30:00-05:00,25.71875,25.82812,25.29687,25.32812,26700,47020,33.56334867354427,35.82775248173343,NaN,NaN,-129.13682644334799,-93.90984594494749,-0.023446703524559576,-0.5611220549281768,-0.5376753514036172,1540100,1589020,30.099307473718724,47.08035510997898,NaN,NaN,-26.070056649376923,-23.623243687374117
2000-02-28T09:30:00-05:00,25.42187,25.8125,25,25.40625,463900,69335,34.80167661771357,35.836127378602754,NaN,NaN,-129.62109671818772,-100.58895368399152,-0.028933642055221975,-0.5738424039726446,-0.5449087619174227,2004000,1669320,42.01648460124342,45.862137065435526,NaN,NaN,-26.773818476964177,-24.073325800172697
2000-02-29T09:30:00-05:00,25.625,25.75,25.57812,25.6875,9100,67505,39.19531559257663,36.02607027048459,NaN,NaN,-85.46605290958398,-102.39226016351125,-0.007939452382271561,-0.5548330773952621,-0.5468936250129905,2013100,1742060,50.284906218814946,45.231380181186445,NaN,NaN,-26.055622093159535,-24.3565109848851
2000-03-01T09:30:00-05:00,25.70312,25.90625,25.5,25.54687,2408000,187630,37.82281689909128,36.30793783820939,NaN,NaN,-81.44143373142755,-106.1606597050713,0.001646744916660503,-0.544835193867165,-0.5464819387838254,-394900,1345820,27.38020965729089,43.06521939185033,NaN,NaN,-25.856108880060415,-24.57073925562443
2000-03-02T09:30:00-05:00,25.78125,25.8125,25.40625,25.64062,421400,208525,39.34758519610162,36.97005148587237,NaN,NaN,-79.89944920580993,-101.11297180167143,0.018533940083061085,-0.523314513679999,-0.5418484537630601,26500,1037760,19.821028371349158,40.3882696928021,NaN,NaN,-25.25954843034369,-24.669140566298612
2000-03-03T09:30:00-05:00,26.03125,26.60937,26.01562,26.34375,41200,205190,49.37495955541852,38.62168908390593,NaN,NaN,41.55311187877737,-66.97498413724638,0.07795896997229845,-0.444399741297687,-0.5223587112699855,67700,743280,15.434383669135073,37.576504865304294,NaN,NaN,-21.545109101904202,-24.22285035709941
2000-03-06T09:30:00-05:00,26.25,26.48437,26.01562,26.23437,292100,218225,48.044296958676036,39.6917379004912,NaN,NaN,40.189562326579534,-33.01285232829292,0.10890055801846882,-0.38623301374689945,-0.49513357176536826,-224400,297600,11.34288904356795,34.563027233557726,NaN,NaN,-18.91582558210165,-23.46470396067116
2000-03-07T09:30:00-05:00,26.45312,26.45312,25.1875,25.1875,50300,218550,37.59982404281944,39.53828459966858,NaN,NaN,-75.35227998613048,-30.990097743602224,0.06029063930697576,-0.41977027263164857,-0.4800609119386243,-274700,-159960,8.771919554448843,31.63077895395235,NaN,NaN,-19.935597537635164,-22.960545900237445
2000-03-08T09:30:00-05:00,25.14062,25.45312,25,25.45312,350700,230105,41.098652248093515,39.676248341423054,NaN,NaN,-124.9466020678574,-39.69113141088819,0.04799022061303493,-0.42007313617233066,-0.4680633567853656,76000,-65780,13.136149585762965,29.286590363635234,NaN,NaN,-19.580568505212295,-22.477691986662425
2000-03-09T09:30:00-05:00,25.5,25.85937,25.1875,25.71875,30400,228705,44.452929795243165,39.937305793634074,NaN,NaN,-59.7732055639368,-35.66588268251357,0.05898396012804097,-0.39433340662531435,-0.4533173667533553,106400,-49800,13.888882822321278,27.13070077594713,NaN,NaN,-18.193644005456207,-21.865685132204394
2000-03-10T09:30:00-05:00,25.9375,26.25,25.73437,25.78125,114200,231155,45.2430633134927,40.64064317690922,NaN,NaN,16.422929418683836,-40.69191917453228,0.07090399830626265,-0.364687368870527,-0.43559136717678965,220600,-19220,15.39972527317596,25.30974218381918,NaN,NaN,-16.850202626653797,-21.14918763141145
2000-03-13T09:30:00-05:00,25.17187,25.70312,25.17187,25.39062,86600,232965,41.28982803889782,40.62671073599377,NaN,NaN,-92.7311781609935,-67.27606727204689,0.053700451882726485,-0.36846580232338155,-0.42216625420610804,134000,52460,18.98775333165821,23.899827057796056,NaN,NaN,-16.926009404913454,-20.54587645619745
2000-03-14T09:30:00-05:00,25.75,25.75,25.17187,25.25,38600,234650,39.93700094848993,40.65420749289406,NaN,NaN,-90.91398964814366,-70.38840920444952,0.034977305118167545,-0.37844462280839863,-0.4134219279265662,95400,126480,22.636598065711155,23.00546411830583,NaN,NaN,-17.395923707143194,-20.09588320633256
2000-03-15T09:30:00-05:00,24.9375,26.34375,24.90625,26.26562,121300,239655,52.13494448253653,41.70758874019253,NaN,NaN,8.192831829481866,-43.760522424981666,0.08999201585032701,-0.30093190811365744,-0.39092392396398445,216700,154620,24.0373603845579,22.374114146625462,NaN,NaN,-13.66645133304353,-19.17739293871984
2000-03-16T09:30:00-05:00,26.3125,27.73437,26.3125,27.73437,281000,249835,63.636299227586875,43.85565663690985,NaN,NaN,269.22330845587015,22.03878037897974,0.21705281307572133,-0.11960790761933282,-0.33666072069505415,497700,232880,27.944820295975376,22.22022220535808,NaN,NaN,-5.503557764825366,-17.223987913877775
2000-03-17T09:30:00-05:00,27.79687,28.125,27.39062,27.59375,34400,250735,62.09782329561316,45.80538139961697,NaN,NaN,275.0466130458517,73.76351710441331,0.27940902371736637,0.012600558951653795,-0.26680846476571257,463300,281420,30.33831819443718,21.38606746201478,NaN,NaN,-0.01672945331837524,-14.765808133797862
2000-03-20T09:30:00-05:00,27.85937,27.92187,27.5,27.75,129700,251455,63.1634911618883,47.51739394028209,NaN,NaN,210.47955362528643,134.4056634616693,0.3162495575977454,0.12850348223146923,-0.1877460753662762,593000,373220,34.75258660541013,20.276616061057293,NaN,NaN,4.568339045329478,-12.003787108208241
2000-03-21T09:30:00-05:00,27.4375,28.34375,27.4375,28.34375,11100,249665,66.96456281891535,49.598947220269494,NaN,NaN,192.52047707438768,191.09255680617557,0.36236554915061464,0.2652108610719921,-0.09715468807862253,604100,474960,39.340324520479314,21.13090997985646,NaN,NaN,9.740332534497135,-8.897484302107474
2000-03-22T09:30:00-05:00,28,28.34375,27.96875,28.21875,69100,249965,65.43375555458985,51.46224510301865,NaN,NaN,163.58742653605663,222.17147574749052,0.3651828911423858,0.3593239258493597,-0.005858965293026083,535000,538620,42.08436616636121,22.7211483937859,NaN,NaN,13.286576831607158,-5.728332711576812
2000-03-23T09:30:00-05:00,28.39062,29.03125,28.23437,28.875,19200,249950,69.38999738116256,52.89189066200037,NaN,NaN,165.6789118113617,201.46259641858882,0.3897390128805826,0.48131480080770217,0.09157578792711958,554200,549920,42.580893927574195,24.660184840817266,NaN,NaN,17.67661522112717,-2.3847687211905284
2000-03-24T09:30:00-05:00,28.98437,29.375,28.98437,29.04687,6200,248925,70.34721688347778,54.48495637091479,NaN,NaN,157.54348442280155,177.9619706939788,0.39483301408865557,0.585117055537939,0.19028404144928346,560400,569340,43.477749747192455,26.955532033933302,NaN,NaN,21.476562563912452,1.02399289096704
2000-03-27T09:30:00-05:00,29.07812,29.07812,28.67187,28.6875,10300,226245,65.71947942762131,56.493503184114914,NaN,NaN,117.851949428721,159.4364498546657,0.35265909919950056,0.6311079154486592,0.2784488162491586,550100,560760,43.15701915235564,29.41161057664093,NaN,NaN,23.186667457733083,4.190089257647903
2000-03-28T09:30:00-05:00,28.78125,29,28.60937,28.60937,8900,226235,64.72260949089694,58.180928701458015,NaN,NaN,99.72483208541075,140.8773208568703,0.30021369488929495,0.6537159348607773,0.35350223997148233,541200,548180,42.660114136125976,31.520465187381145,NaN,NaN,24.260096610736984,7.0572331652320575
2000-03-29T09:30:00-05:00,28.78125,29.0625,28.5625,28.96875,5200,106095,67.18806405160473,59.804866862626696,NaN,NaN,94.83425613370595,127.12668677640019,0.27131621311688514,0.6926475063675888,0.4213312932507036,546400,550460,42.788685058476446,33.58473677567794,NaN,NaN,25.908939033180538,9.750334003510412
2000-03-30T09:30:00-05:00,29,29.45312,28.96875,29.15625,9300,85490,68.4278226660845,61.460921102097544,NaN,NaN,100.92135729792479,114.1751758737128,0.24710560214912397,0.7302132959371086,0.4831076937879846,555700,550760,42.80685698574934,35.54238904086176,NaN,NaN,27.638692993355235,12.30581385920253
2000-03-31T09:30:00-05:00,29.29687,29.51562,29.10937,29.20312,23400,84600,68.74572453417805,63.42205656604613,NaN,NaN,94.84266613922759,101.635012216998,0.21756390952071258,0.7550625806888753,0.5374986711681627,579100,554500,43.04971363763731,37.261100491288836,NaN,NaN,29.14434710270924,14.711318608274917
2000-04-03T09:30:00-04:00,29.3125,29.40625,29.07812,29.32812,39400,71965,69.62417321891657,65.54256887107661,NaN,NaN,86.45969757491049,95.3565618462359,0.1907196244461541,0.7758982017258553,0.5851785772797012,618500,568180,43.98662171896523,38.786102180806985,NaN,NaN,30.651559178561506,16.988495832601572
2000-04-04T09:30:00-04:00,29.375,29.875,27.875,29,220700,80485,64.49945075028123,66.42574789020122,NaN,NaN,64.56647520086312,88.32489046932639,0.13762149551878422,0.7572054466781815,0.6195839511593972,397800,539500,42.41133102213457,40.098528654919605,NaN,NaN,30.560708969556536,18.92738342359514
2000-04-05T09:30:00-04:00,29.15625,29.26562,28.75,28.89062,7600,63330,62.838987089636205,66.36879702320475,NaN,NaN,62.61085158071426,81.88020955872805,0.08449726610204045,0.7252055337869479,0.6407082676849074,390200,508260,40.701447541587676,41.00971631532048,NaN,NaN,30.03274154991035,20.513863155925883
2000-04-06T09:30:00-04:00,29.20312,29.4375,29.09375,29.14062,23000,62960,65.05343095872712,66.57991185628433,NaN,NaN,72.72786988964234,76.24151207707156,0.05688374295516763,0.7118129463788669,0.6549292034236993,413200,479760,39.150694633498965,41.639171775253466,NaN,NaN,30.163426240528324,21.892372168011946
2000-04-07T09:30:00-04:00,29.39062,29.6875,29.29687,29.57812,136600,64080,68.58185231549096,66.96693765297023,NaN,NaN,86.37840680423488,74.54866021007301,0.058543545195498536,0.7281086349180725,0.669565089722574,549800,473900,38.82315712724807,41.9299268125276,NaN,NaN,31.274151189115663,23.232626313883905
2000-04-10T09:30:00-04:00,29.625,29.75,29.42187,29.625,21100,60805,68.94369509325848,67.10830424399474,NaN,NaN,89.49043921047067,75.15480853718506,0.05340240267175089,0.7363180930622626,0.6829156903905117,570900,464380,38.26310838036033,41.8529828025191,NaN,NaN,32.291591508808715,24.526764198873163
2000-04-11T09:30:00-04:00,29.54687,30.07812,29.5,29.98437,313700,74560,71.64008763036593,67.55161367797874,NaN,NaN,113.76627518050789,84.99476853311401,0.06408873380099511,0.7630266076417556,0.6989378738407604,884600,561740,46.72700573530606,42.18459991458659,NaN,NaN,33.95477620969461,25.87362305756194
2000-04-12T09:30:00-04:00,29.6875,30.125,29.32812,29.45312,157700,76380,62.94038273911857,67.09092691783273,NaN,NaN,97.79501773737147,92.03160176444545,0.027151864713262475,0.7328777047323385,0.705725840019076,726900,629080,51.66308151995633,42.83332759975674,NaN,NaN,32.86202181020273,26.871965736510624
2000-04-13T09:30:00-04:00,29.20312,29.625,29.20312,29.53125,590800,91870,63.63970819484331,66.61181915435886,NaN,NaN,71.44173638035964,91.77437506258892,0.001129311442359282,0.7071374793220251,0.7060081678796658,1317700,809980,61.88107264179775,44.14785066365712,NaN,NaN,32.163727746643914,27.62793173795824
2000-04-14T09:30:00-04:00,28.21875,28.46875,27.59375,27.59375,19600,91130,42.31505792932662,64.9400747616235,NaN,NaN,-151.7732735509544,44.14403899155106,-0.14532358652730815,0.5243536847205306,0.6696772712478387,1298100,959640,67.9224926698105,45.91681305776104,NaN,NaN,23.143562391881495,26.98730754566156
2000-04-17T09:30:00-04:00,27.92187,28.26562,27.6875,28.26562,20200,85655,48.730689768445984,63.79779478144844,NaN,NaN,-132.9931289924923,-0.3526746490415462,-0.19272746923163042,0.42876793470830066,0.6214954039399311,1318300,1109120,72.594450422347,48.054979935348264,NaN,NaN,18.2585419037733,25.74034102539181
2000-04-18T09:30:00-04:00,28.25,28.51562,28.1875,28.375,10700,85635,49.7112741200658,62.54945264348138,NaN,NaN,-96.20714399197566,-42.34735848353826,-0.2110218910370345,0.35771804014363795,0.5687399311806725,1329000,1198000,74.93230915086943,50.35095308480489,NaN,NaN,14.938354730349971,24.197200126100118
2000-04-19T09:30:00-04:00,28.45312,28.6875,28.25,28.48437,13700,82865,50.726095109662666,61.28504353230839,NaN,NaN,-83.7073919689498,-78.64784042480251,-0.20963171947545578,0.3067002818363527,0.5163320013118085,1342700,1321160,77.76307991457797,52.84782615114981,NaN,NaN,12.698517133874848,22.554531127210794
2000-04-20T09:30:00-04:00,28.65625,28.71875,28.5,28.71875,2900,82050,52.91876704257517,60.15454656862247,NaN,NaN,-55.287289946525895,-103.99364569017962,-0.18752086198913587,0.28193092382538865,0.4694517858145245,1345600,1326740,77.88493057312034,55.33605593225574,NaN,NaN,11.579813943033269,20.986714386614004
2000-04-24T09:30:00-04:00,28.5,29.10937,28.5,28.75,8900,82185,53.21768536564092,58.98265457910278,NaN,NaN,-30.142459649015073,-79.66748290979174,-0.1661176517527143,0.2618047211236316,0.42792237287634594,1354500,1338020,78.14563655177194,57.775985563170494,NaN,NaN,10.780210792771532,19.528642444636507
2000-04-25T09:30:00-04:00,29.34375,30.32812,29.3125,30.25,13100,82325,64.77749875940899,59.00251515118333,NaN,NaN,133.4458575250144,-26.379685606290412,-0.052169163288161624,0.3627109187661439,0.41488008205430554,1367600,1347880,78.3854979806613,60.345568917350974,NaN,NaN,14.105683128375713,18.753933970884965
2000-04-26T09:30:00-04:00,30.39062,30.4375,29.60937,29.79687,515300,107645,59.95768543741257,58.79670789031021,NaN,NaN,116.29270176205593,16.120283544515907,-0.010713745042777723,0.4014879007508334,0.4122016457936111,852300,1252540,70.34574002832517,62.463018380689356,NaN,NaN,15.10924614863539,18.23326428199217
2000-04-27T09:30:00-04:00,29.35937,29.82812,29.35937,29.82812,6500,107710,60.177746781701295,58.448444734808376,NaN,NaN,71.77208111356194,47.21617816101825,0.014067678479251056,0.42978624389267495,0.4157185654134239,858800,1155760,63.25344799372541,64.18464362070554,NaN,NaN,15.951000046329183,17.907226534040316
2000-04-28T09:30:00-04:00,29.84375,29.85937,29.5,29.625,9600,107725,57.94851982820314,57.688920985716386,NaN,NaN,64.79818419919185,71.2332729901618,0.012110073013454847,0.43085615668024246,0.4187460836667876,849200,1056480,56.91429804123864,65.47686797170486,NaN,NaN,15.940910914654719,17.626324302699516
2000-05-01T09:30:00-04:00,29.73437,30.3125,29.60937,30.3125,2000,106655,62.951143858149315,57.260881611780015,NaN,NaN,106.76556562331633,98.61487804462807,0.05030526955574299,0.4816276706114664,0.4313224010557234,851200,955820,51.300599324104304,66.40811732482943,NaN,NaN,17.554727811397736,17.61609623251355
2000-05-02T09:30:00-04:00,29.96875,30.21875,29.71875,30,187400,114055,59.48696435639159,56.3928013779247,NaN,NaN,85.83385852221207,89.09247824406762,0.04773288948765081,0.4909885129152869,0.4432556234276361,663800,815060,44.66603865528638,66.26090539054232,NaN,NaN,17.78603277261153,17.640372881098976
2000-05-03T09:30:00-04:00,29.59375,29.6875,28.84375,29,52900,105665,50.00414588653136,55.46878445988276,NaN,NaN,-8.376217823133599,64.1586943270297,-0.02424040617195311,0.4129551157126947,0.43719552188464783,610900,766780,42.629589514054814,65.61565596154936,NaN,NaN,14.748215791949232,17.22720758264901
2000-05-04T09:30:00-04:00,28.85937,29.28125,28.82812,29.04687,29200,106745,50.40321561579478,54.52332070423643,NaN,NaN,-23.84518631888546,45.035240840540226,-0.06907584560665425,0.35085071487633,0.41992656048298427,640100,723040,40.81406473563156,64.11086968253748,NaN,NaN,12.520385224349628,16.554804388606243
2000-05-05T09:30:00-04:00,29.28125,29.78125,29.17187,29.5625,7200,105955,54.688243020222004,55.40711963930039,NaN,NaN,28.078607109621892,37.691325422626235,-0.0644788487690956,0.33932799952161474,0.40380684829071034,647300,682660,39.15614618738842,62.056130648078764,NaN,NaN,11.9974322412526,15.90375122469858
2000-05-08T09:30:00-04:00,29.70312,29.70312,29.5,29.54687,4000,99325,54.5344359167894,55.821672935610636,NaN,NaN,36.72561656225518,23.683335610414012,-0.06289635245261732,0.3251864077249387,0.388082760177556,643300,641080,37.46834716629355,59.54712327264638,NaN,NaN,11.538329071213502,15.280119488486426
2000-05-09T09:30:00-04:00,29.54687,29.54687,29.17187,29.3125,10400,98790,52.16529018799076,55.99695979760527,NaN,NaN,10.387457338254649,8.594055373622528,-0.07710236600764708,0.29170480266799714,0.3688071686756442,632900,634900,37.211610481371956,56.852787653396554,NaN,NaN,10.45984749474121,14.59150920366568
2000-05-10T09:30:00-04:00,29.0625,29.10937,28.75,29.01562,2100,83210,49.246772510205254,55.89129389764404,NaN,NaN,-30.747040310189995,4.119890876211246,-0.104273119247898,0.2384657696157717,0.3427388888636697,630800,638880,37.50858761711311,53.977466775006214,NaN,NaN,8.691920025979416,13.748710749710499
2000-05-11T09:30:00-04:00,29.45312,29.73437,29.45312,29.73437,2200,75435,55.70764373301349,56.09049937553249,NaN,NaN,51.99123369698129,19.287174879384594,-0.07309279093751841,0.2513729001917717,0.32446569112929013,633000,637460,37.44054581657549,51.088582149538716,NaN,NaN,9.080992708973385,13.081893886748054
2000-05-12T09:30:00-04:00,29.875,30.09375,29.875,30.09375,4100,46100,58.54898451210843,56.47130645742303,NaN,NaN,90.46075229628929,31.76360391671808,-0.029741220083044584,0.2872891660254844,0.31703038610852896,637100,635420,37.335761422716324,48.17359106889189,NaN,NaN,10.283826545477504,12.682169980852262
2000-05-15T09:30:00-04:00,30,30.59375,30,30.59375,9700,45605,62.183730055083885,56.28603726425695,NaN,NaN,126.61091008775225,49.74066262181749,0.02800831496528966,0.35204077981514104,0.3240324648498514,646800,636120,37.400502189568776,45.24609136952814,NaN,NaN,12.458894267012035,12.650273450303658
2000-05-16T09:30:00-04:00,30.625,31.0625,30.625,30.875,10500,45120,64.09115511120842,56.58128509809951,NaN,NaN,171.56790812008657,81.97675277818388,0.0777309384061784,0.42119613785757437,0.343465199451396,657300,641000,37.88231660388954,42.927275410639886,NaN,NaN,14.85076678503072,12.964629640978952
2000-05-17T09:30:00-04:00,30.71875,30.71875,30.4375,30.67187,4900,44830,61.671681957359205,56.68799475350364,NaN,NaN,131.4422809945354,114.41461703912896,0.08872674254315172,0.4543736276303356,0.3656468850871839,652400,645320,38.33479487462155,41.14737161641818,NaN,NaN,16.11506703768264,13.414692126222336
2000-05-18T09:30:00-04:00,30.78125,30.78125,30.53125,30.53125,500,44170,59.98352659482247,56.83335237969073,NaN,NaN,120.0435989586299,128.02509009145868,0.07865992435244207,0.4639717905277365,0.38531186617529445,651900,649100,38.7551773420643,39.85029156647715,NaN,NaN,16.679011987747128,13.881023535011591
2000-05-19T09:30:00-04:00,30,30,29.6875,29.6875,3900,44220,50.968273602808445,55.977433075737814,NaN,NaN,1.48697004501175,110.23033364120317,0.01086778594275184,0.3988965986037343,0.38802881266098244,648000,651280,39.01339636863843,38.9726342125153,NaN,NaN,14.392806997696534,13.954135458252297
2000-05-22T09:30:00-04:00,29,29.20312,29,29.17187,5500,44050,46.38061106706306,55.04126498364292,NaN,NaN,-105.05370629801114,63.897410364050494,-0.06863660696891294,0.30223305394984123,0.3708696609187542,642500,650420,38.94364029229024,38.5638914723013,NaN,NaN,10.968327665111069,13.52759148780355
2000-05-23T09:30:00-04:00,29.17187,29.17187,28.90625,29.04687,800,43435,45.31573973899067,54.706378830247154,NaN,NaN,-104.89906905624653,8.604014928783869,-0.12622873171899363,0.21308374627001214,0.33931247798900577,641700,647300,38.67347947717414,38.281312183952686,NaN,NaN,7.88054677796613,12.720870814969633
2000-05-24T09:30:00-04:00,29,29.46875,29,29.46875,3800,17860,49.52763828905371,54.64383759262279,NaN,NaN,-59.4746274274143,-29.579366755606067,-0.13187929214905802,0.17446336280268326,0.3063426549517413,645500,645920,38.54610702454923,38.11931520458966,NaN,NaN,6.504991214585513,11.832888014914758
2000-05-25T09:30:00-04:00,29.75,29.75,28.9375,28.9375,51700,20120,44.843694888717856,53.940655583229635,NaN,NaN,-68.4962903776414,-67.28734462286033,-0.1652036249550915,0.09983812375787693,0.26504174871296843,593800,634300,37.42828186499409,37.995896324418645,NaN,NaN,3.848924991908773,10.692321868771046
2000-05-26T09:30:00-04:00,29.23437,29.23437,28.67187,28.78125,8900,20085,43.5394687169195,53.155300783238935,NaN,NaN,-100.42473679734141,-87.66968599133095,-0.18981826915462058,0.02776891226969269,0.21758718142431327,584900,621680,36.200432672498714,37.90533100343329,NaN,NaN,1.2902577988001425,9.349169858775202
2000-05-30T09:30:00-04:00,29.0625,29.45312,28.90625,29.29687,157200,27845,48.82847732597571,52.91695700738071,NaN,NaN,-53.287403306117675,-77.31642539295225,-0.16437370092672796,0.012120055265903318,0.17649375619263127,742100,641600,39.57028115129756,38.07380747985655,NaN,NaN,0.6733132917909141,8.109761777777447
2000-05-31T09:30:00-04:00,29.48437,29.90625,29.45312,29.5,2000,18575,50.78444077583502,53.026790454925695,NaN,NaN,2.991191759001798,-55.738373229902585,-0.12845457532168064,0.015925537040530457,0.1443801123622111,744100,662080,42.9090417120262,38.45955420092177,NaN,NaN,0.7475804509468909,7.058021588230225
2000-06-01T09:30:00-04:00,29.54687,29.84375,29.54687,29.73437,1500,16005,53.01593427098774,52.83452549335243,NaN,NaN,11.984811453365843,-41.44648545374656,-0.08556670221777626,0.03742173458999076,0.12298843680776703,745600,682100,46.047149796034915,39.07431162802601,NaN,NaN,1.4649788549754266,6.259015483479539
2000-06-02T09:30:00-04:00,30.07812,30.07812,29.6875,29.95312,86800,18885,55.06388474935923,52.58558979601321,NaN,NaN,34.87903966725921,-20.77141944476644,-0.04136101445173271,0.07128716874310115,0.11264818319483386,832400,729820,52.71848811463846,40.17307782030616,NaN,NaN,2.661501395550455,5.74508489948967
2000-06-05T09:30:00-04:00,30.1875,30.1875,29.875,29.90625,4500,18750,54.51558117521423,52.037864876022525,NaN,NaN,42.55338413127652,7.8242047409571445,-0.015503658929744035,0.09326860953265381,0.10877226846239785,827900,778420,58.36497038033987,41.670539833932665,NaN,NaN,3.4980139608710803,5.4240747654013
2000-06-06T09:30:00-04:00,29.65625,29.875,29.65625,29.6875,204700,28785,51.91719759718767,51.168296482163896,NaN,NaN,5.733798660498306,19.628445134280344,-0.013435811977989418,0.09197750348991107,0.10541331546790049,623200,754640,54.909595871620425,42.88677406734201,NaN,NaN,3.5125026355946054,5.150993032571772
2000-06-07T09:30:00-04:00,29.75,29.96875,29.5,29.54687,20000,29265,50.25872358895468,50.353085170135,NaN,NaN,-6.592965687228964,17.71161364503419,-0.021371109242140057,0.07869942891522541,0.10007053815736547,603200,726460,51.05239052464247,43.79517375662921,NaN,NaN,3.080778857827679,4.8552481504654725
2000-06-08T09:30:00-04:00,29.4375,29.4375,29,29.07812,13000,29810,45.08847994576297,49.289153266630755,NaN,NaN,-84.45775400158088,-1.5768994459551622,-0.0560513448836254,0.03000635705283372,0.08605770193645912,590200,695380,47.12085353518147,44.392722056137586,NaN,NaN,1.2299431808775922,4.337347440524347
2000-06-09T09:30:00-04:00,29.3125,29.40625,28.96875,29.1875,14900,30445,46.472237380182456,48.968007822157475,NaN,NaN,-75.0659371207358,-23.565894803554166,-0.06865413616984997,0.00024003172414666096,0.06889416789399663,605100,649920,42.02321891503455,44.607709380880166,NaN,NaN,0.05367398083467661,3.7253940891401083
2000-06-12T09:30:00-04:00,29.25,29.29687,29.04687,29.21875,63900,33435,46.884067491857955,49.003968995357106,NaN,NaN,-68.00913800659457,-45.67839923112838,-0.07158815131145879,-0.020591021245326857,0.050997130066131935,669000,618140,38.858394953899655,44.601620428137984,NaN,NaN,-0.820095148432132,3.0760384837726455
2000-06-13T09:30:00-04:00,29.09375,29.4375,28.95312,29.34375,13700,33635,48.58798401870568,49.23770072962246,NaN,NaN,-53.886578091648104,-57.60247458155766,-0.062162089098452444,-0.02670548130693362,0.035456607791518824,682700,630040,40.660507144680096,44.74355097581697,NaN,NaN,-1.1299529103994592,2.475182570319488
2000-06-14T09:30:00-04:00,29.46875,29.64062,29.1875,29.28125,57400,35980,47.76295470816312,49.11165190241599,NaN,NaN,-27.69187024762023,-61.82225549363591,-0.057307231601756214,-0.036177431710676444,0.02112979989107977,625300,634460,41.35195356235945,44.94396858566056,NaN,NaN,-1.6034917574079872,1.8925148092155628
2000-06-15T09:30:00-04:00,29.54687,29.625,29.45312,29.5625,44500,37960,51.73462661794748,49.603861311646675,NaN,NaN,14.036184396878008,-42.12346781394414,-0.03350407960433728,-0.020750299614341827,0.01275377998999545,669800,650380,43.88810461733973,45.405384496542396,NaN,NaN,-0.9887451931142934,1.4809062374541548
2000-06-16T09:30:00-04:00,29.34375,29.34375,28.98437,28.98437,109900,43430,44.28155516620055,49.656867486595324,NaN,NaN,-72.03151462633514,-41.516583315064004,-0.053839565620907026,-0.05454567703613833,-0.0007061114152313065,559900,641340,42.75741587826228,45.87374043981122,NaN,NaN,-2.536705859173214,0.9069616522216736
2000-06-19T09:30:00-04:00,28.9375,28.9375,28.35937,28.6875,219100,54190,41.01407906495716,49.09869618223686,NaN,NaN,-163.6146708494647,-60.63768988363803,-0.08270220767131103,-0.10408387100437011,-0.02138166333305907,340800,575700,35.58798797437407,45.58929092717383,NaN,NaN,-4.839902552642419,0.08598105152680313
2000-06-20T09:30:00-04:00,28.17187,28.375,27.79687,27.79687,8100,54320,33.11861865628241,47.836851745125955,NaN,NaN,-265.2523835450051,-102.91085097430941,-0.1531003595438793,-0.2127571127629082,-0.0596567532190289,332700,505700,29.841440639515724,44.65589085056594,NaN,NaN,-9.69308173663798,-1.311027918211023
2000-06-21T09:30:00-04:00,27.70312,27.92187,27.70312,27.90625,11700,54865,34.779184136662565,46.5342267355313,NaN,NaN,-241.71777499538436,-145.71603192386223,-0.18167452816512505,-0.2867499134254352,-0.10507538526031016,344400,449520,26.18672849104425,43.23728932878089,NaN,NaN,-13.044279795317602,-2.9872067577976766
2000-06-22T09:30:00-04:00,27.67187,27.67187,27.29687,27.29687,76800,58515,30.26999834975082,44.763234849844984,NaN,NaN,-233.48961318345567,-195.221191439929,-0.22799184026085864,-0.3900651855863835,-0.16207334532552484,267600,369080,22.027009919563298,41.04504088627552,NaN,NaN,-17.520821861845455,-5.063437486947359
2000-06-23T09:30:00-04:00,27.67187,27.73437,27.59375,27.59375,2400,56050,34.711146013133714,43.348632338267805,NaN,NaN,-160.3952573290858,-212.89393998047913,-0.22464714537544464,-0.44288227704483063,-0.218235131669386,270000,311100,19.609144207230912,38.276767588196314,NaN,NaN,-19.765419165766463,-7.163720583921517
2000-06-26T09:30:00-04:00,28,28.26562,27.96875,28.25,18100,56510,43.3068110401447,42.733604727050455,NaN,NaN,-89.39901731240221,-198.05080927306662,-0.16690443092803275,-0.4268656703294269,-0.25996123940139415,288100,300560,19.196620890713874,35.72584080384585,NaN,NaN,-18.80014362871318,-8.826066733177468
2000-06-27T09:30:00-04:00,28.3125,28.45312,28.26562,28.375,3800,48840,44.797625432364796,42.34352628729403,NaN,NaN,-60.419148937675445,-157.0841623516007,-0.11161578513432546,-0.399480970819301,-0.28786518568497554,291900,292400,18.865720344595985,33.42679293384253,NaN,NaN,-17.553268599752915,-10.07280985697396
2000-06-28T09:30:00-04:00,28.15625,28.73437,28,28.73437,203200,58900,48.95361255058207,42.61960718763826,NaN,NaN,-42.28061339112806,-117.19673003074945,-0.045552283381394,-0.34480553991171803,-0.29925325653032403,495100,322540,24.071831006647443,31.780434181804385,NaN,NaN,-15.15982919286422,-10.799526904958283
2000-06-29T09:30:00-04:00,28.5,28.5,27.78125,28.23437,22200,59935,43.99117696258811,42.44238858638152,NaN,NaN,-65.39319707641543,-83.5774468093414,-0.03093763147039985,-0.33792529586832387,-0.306987664397924,472900,363600,30.60463812628423,30.96482126832222,NaN,NaN,-14.714879135332188,-11.35886293786884
2000-06-30T09:30:00-04:00,28.23437,28.28125,28.09375,28.28125,7300,55960,44.558651272448856,42.2762874278523,NaN,NaN,-54.34986254517719,-62.36836785255967,-0.014365129004450694,-0.3249440756534874,-0.3105789466490367,480200,405640,36.61767061829552,30.80476953006478,NaN,NaN,-14.188014116200923,-11.763027391916282
2000-07-03T09:30:00-04:00,28.40625,28.65625,28.40625,28.65625,4700,55970,49.00916580823899,42.306371841390394,NaN,NaN,-12.721759783783122,-47.03291634683586,0.02353835118206765,-0.2811560076714521,-0.30469435885351975,484900,445000,41.710191301765924,30.879746969856626,NaN,NaN,-12.348710513030339,-11.84669640921829
2000-07-05T09:30:00-04:00,28.71875,29,28.40625,28.40625,9000,46185,46.33854484952094,42.204628280058806,NaN,NaN,-3.3038599131512565,-35.60985854193102,0.03288502334051413,-0.2635880796778771,-0.29647310301839125,475900,481800,46.07283372057628,31.216952695443542,NaN,NaN,-11.622667160647476,-11.81469223085103
2000-07-06T09:30:00-04:00,28.5625,28.5625,28.1875,28.32812,16800,46025,45.504005028631966,41.759583880821985,NaN,NaN,-27.52860365575972,-32.65945659485734,0.03473626372527744,-0.25305277336179444,-0.2877890370870719,459100,474600,45.35755389789829,31.321913358340584,NaN,NaN,-11.27380653525066,-11.737422845765263
2000-07-07T09:30:00-04:00,28.40625,28.60937,28.40625,28.46875,212800,56015,47.34228443811042,41.978207400244116,NaN,NaN,-5.2527865499619555,-20.631374489566646,0.045674048770236675,-0.23069647612427602,-0.2763705248945127,671900,514400,49.98037162057973,31.83783876850612,NaN,NaN,-10.457861000605106,-11.554628296456668
2000-07-10T09:30:00-04:00,28.23437,28.75,28.15625,28.5,115800,61060,47.76395564481085,42.46034144166224,NaN,NaN,-4.174384067175149,-10.596278793966237,0.0546492507422634,-0.20805896146668346,-0.26270821220894686,787700,575900,56.153288025140824,33.30678877213232,NaN,NaN,-9.66886635882192,-11.28523373393742
2000-07-11T09:30:00-04:00,28.5,29.17187,28.46875,29.04687,8100,58270,54.61344113932089,43.99568590473642,NaN,NaN,66.25028064907573,5.198129292605531,0.09470495586835281,-0.14432701737350584,-0.23903197324185865,795800,638080,61.34716409882093,35.55719759065412,NaN,NaN,-6.918332674937042,-10.661390725508793
2000-07-12T09:30:00-04:00,29.3125,29.3125,29.10937,29.15625,5700,57870,55.860127604090444,45.50146758098127,NaN,NaN,114.82412804390104,28.82372688401599,0.1240060904955195,-0.08402436012245929,-0.20803045061797878,801500,703200,65.90254664086689,38.39404174421286,NaN,NaN,-4.273533509204814,-9.748839694608225
2000-07-13T09:30:00-04:00,29.23437,29.4375,29.15625,29.39062,4400,55220,58.49112110935341,47.51726206381003,NaN,NaN,137.6262608917457,61.85469979351708,0.15272438962610935,-0.0171249635853421,-0.16984935321145145,805900,772560,69.96304031075495,41.81804391501227,NaN,NaN,-1.2364913898211485,-8.5327899367815
2000-07-14T09:30:00-04:00,29.59375,29.6875,29.4375,29.6875,1300,53060,61.61247107226586,49.43878528231947,NaN,NaN,180.52266501457132,99.00979010642374,0.18321307045199342,0.05916698485354033,-0.12404608559845309,807200,799620,71.39428250230063,45.51698236466011,NaN,NaN,2.3289183605581734,-6.981117322875832
2000-07-17T09:30:00-04:00,29.79687,30.07812,29.79687,29.85937,13500,48240,63.331557618800694,50.86912432365204,NaN,NaN,201.14368377119078,140.07340367409694,0.20481769939584815,0.1319760386463571,-0.07284166074949106,820700,806220,71.74787987495716,49.270643720677484,NaN,NaN,5.846286781876963,-5.148631022196861
2000-07-18T09:30:00-04:00,30,30.01562,29.75,29.9375,17900,38180,64.11821222284317,52.24916623725765,NaN,NaN,163.93232535675673,159.6098126156331,0.21327233760998893,0.19374876126299512,-0.019523576346993816,838600,814780,72.22737872335188,53.082190747731474,NaN,NaN,9.002634828174001,-3.127021615001024
2000-07-19T09:30:00-04:00,29.85937,29.89062,29.42187,29.6875,10400,38295,59.70448536437227,53.017085723956946,NaN,NaN,114.26183446471002,159.49735389979492,0.19161502946012318,0.21999521047816017,0.028380181018036986,828200,820120,72.54047772113188,56.544236941623225,NaN,NaN,10.544702113235312,-1.173918225252976
2000-07-20T09:30:00-04:00,30.07812,30.15625,29.90625,30.04687,5200,37970,63.58501236878347,54.416645395828034,NaN,NaN,132.73593306136397,158.51928833371858,0.1906712889635595,0.26671929222248636,0.07604800325892686,833400,825620,72.87960824443415,59.56387766434822,NaN,NaN,13.050742590891575,0.8581761770533884
2000-07-21T09:30:00-04:00,30.10937,30.10937,29.78125,30,2400,34250,62.73643459194582,55.715058490077816,NaN,NaN,110.79396470351472,144.57354827150726,0.17640001763420704,0.29654802530168567,0.12014800766747863,831000,830380,73.1882312625056,62.17606056750607,NaN,NaN,14.88209125354544,2.8615926165522527
2000-07-24T09:30:00-04:00,29.9375,30.03125,29.65625,29.78125,16000,34930,58.79278160275494,56.4138881896861,NaN,NaN,85.54349149556693,121.45350981638248,0.14315240042206406,0.2990885081950587,0.15593610777299466,815000,829240,72.97404905931823,64.4091932644741,NaN,NaN,15.369929826088482,4.648497932200286
2000-07-25T09:30:00-04:00,29.9375,29.9375,29.6875,29.84375,1800,34115,59.57467760232365,57.359326243457716,NaN,NaN,77.02069254300788,104.07118325363271,0.11737611694824177,0.3026562539582969,0.1852801370100551,816800,824880,72.10494159349571,66.2686295411112,NaN,NaN,15.98923744596195,6.268603577023381
2000-07-26T09:30:00-04:00,29.60937,29.60937,29.40625,29.46875,3700,34110,53.0681994185678,57.89962584273885,NaN,NaN,37.67122596484405,88.75306155365953,0.06944620425730247,0.2720878923316832,0.2026416880743807,813100,821860,71.46999974222663,68.13380424427751,NaN,NaN,14.680683013676877,7.470329210831023
2000-07-27T09:30:00-04:00,29.8125,29.8125,29.26562,29.26562,900,23995,49.88969643994482,58.08158384286988,NaN,NaN,28.559285886216117,67.91773211862997,0.020953451117190047,0.22883350197086827,0.20788005085367822,812200,817620,70.53094219607044,69.60170214252685,NaN,NaN,12.63164980058077,8.207660723652415
2000-07-28T09:30:00-04:00,29,29,28.28125,28.28125,39100,24840,38.0089625091392,57.384798618893335,NaN,NaN,-82.5183947130073,29.25526023532556,-0.07525467809680625,0.11381170323267042,0.18906638132947667,773100,806040,67.90667367936676,70.44122968925727,NaN,NaN,6.422105086264447,7.952581346882705
2000-07-31T09:30:00-04:00,28.5625,29,28.5625,28.71875,38500,26400,44.35185659055219,56.65182829398129,NaN,NaN,-60.516959450337495,0.04317004614467237,-0.10541454923741028,0.05729819478271381,0.1627127440201241,811600,805360,67.7472674077648,70.8983799256104,NaN,NaN,3.37351791350431,7.298429427828649
2000-08-01T09:30:00-04:00,28.82812,29,28.82812,28.9375,97300,31030,47.25770063153189,56.03736922451282,NaN,NaN,-44.06543907534718,-24.17405627752634,-0.10631547438222344,0.02981840104234479,0.13613387542456823,908900,823780,69.81435465713736,71.17779478391545,NaN,NaN,1.8952874547378211,6.526552003101387
2000-08-02T09:30:00-04:00,28.75,29,28.75,28.8125,2700,30715,45.78638905847295,55.129888363735645,NaN,NaN,-55.990101504451,-42.90632177138535,-0.11052523849785043,-0.0020226726977448095,0.10850256580010562,906200,842400,71.78304398734397,71.30779504652894,NaN,NaN,0.24483960590179255,5.629164517787159
2000-08-03T09:30:00-04:00,28.8125,29,28.70312,28.85937,3200,30035,46.459496113125375,54.047533009511326,NaN,NaN,-62.71292517400858,-61.16076398343027,-0.1053679847304356,-0.02320741511293889,0.08216056961749671,909400,861840,73.71081362162492,71.4732615550521,NaN,NaN,-0.8723843937007258,4.700371816146033
2000-08-04T09:30:00-04:00,29,29.25,29,29.21875,39500,21370,51.43817838032605,53.19800592104885,NaN,NaN,-26.762037189611533,-50.00949247875113,-0.07442620431705824,-0.010872185778826093,0.06355401853823214,948900,897000,76.79828130236493,71.83400451415265,NaN,NaN,-0.31469777917091357,3.9839333025293264
2000-08-07T09:30:00-04:00,29.20312,30.07812,29.20312,30.07812,5600,15860,60.82035180960909,52.96244446296071,NaN,NaN,63.461276137501294,-25.21384536118337,0.003132624717285662,0.06746979943483922,0.06433717471755356,954500,925580,78.96121845417781,72.3149930663545,NaN,NaN,3.4764379543682007,3.911433967077737
2000-08-08T09:30:00-04:00,30,30.40625,29.96875,30.34375,5100,15710,63.187807137176726,53.21125316101817,NaN,NaN,124.76720674487214,8.552683802860468,0.06794611512657754,0.14926981862577549,0.08132370349919794,959600,935720,79.68482860096368,72.82530384348534,NaN,NaN,7.3405030218067715,4.401300974896171
2000-08-09T09:30:00-04:00,30.75,30.75,30.35937,30.60937,22500,16550,65.43687517720511,53.34352907590544,NaN,NaN,155.3426952517597,50.81924315410261,0.12121794282035968,0.23284613202464755,0.11162818920428787,982100,950900,80.75212572016315,73.38762652032314,NaN,NaN,11.239476021823455,5.378183124457212
2000-08-10T09:30:00-04:00,30.46875,30.8125,30.46875,30.53125,25700,17615,64.19466246082158,53.44768820939656,NaN,NaN,140.84383170750425,91.53059453040518,0.14225011871575466,0.2894408375989812,0.14719071888322655,956400,960300,81.40365393999352,73.97444242585799,NaN,NaN,13.952119460972035,6.603031172530757
2000-08-11T09:30:00-04:00,30.6875,31.0625,30.59375,30.875,23900,18745,67.14979309139821,54.0446176014425,NaN,NaN,150.07285514380575,126.89757299708863,0.16857110507527323,0.35790460022731807,0.18933349515204484,980300,966580,81.84577842118189,74.60813738027683,NaN,NaN,17.20026912420222,8.116922308483822
2000-08-14T09:30:00-04:00,31,31.21875,30.75,31.1875,60500,21095,69.60570604027905,54.761119632725034,NaN,NaN,154.4019242797051,145.0857026255294,0.19444871613288534,0.4323943903181515,0.2379456741852662,1040800,983840,83.0392904279191,75.38916229702136,NaN,NaN,20.7229028584183,9.917776672760176
2000-08-15T09:30:00-04:00,31,31,30.625,30.79687,4400,20420,63.24106000645307,55.4877525318597,NaN,NaN,112.89137721353221,142.7105367192614,0.17337657909139598,0.45466639804951114,0.28128981895811517,1036400,999200,84.04458289907818,76.28734680822504,NaN,NaN,21.72534458291349,11.604572088496363
2000-08-16T09:30:00-04:00,30.75,30.84375,30.59375,30.65625,22100,21005,61.07601808034673,56.28677550617412,NaN,NaN,90.47586694532345,129.73717105797417,0.1395417795897569,0.4557170434453113,0.3161752638555544,1014300,1005640,84.46046083788337,77.2823124254974,NaN,NaN,21.875683370021047,13.071873700142746
2000-08-17T09:30:00-04:00,30.8125,30.90625,30.8125,30.8125,25500,22020,62.6078300369484,58.043837472446214,NaN,NaN,95.07387336378191,120.58317938922968,0.1181087725266517,0.463811229513869,0.3457024569872173,1039800,1022320,85.51366170099351,78.53995442704216,NaN,NaN,22.453229158464975,14.41206733704592
2000-08-18T09:30:00-04:00,30.875,30.96875,30.71875,30.71875,31500,23475,61.05527390584225,59.23693870925265,NaN,NaN,81.62791474535953,106.89419130954045,0.0893489126100333,0.45738859774975893,0.3680396851397256,1008300,1027920,85.86015464481231,79.83373208683126,NaN,NaN,22.482609378435004,15.565001914387217
2000-08-21T09:30:00-04:00,30.84375,31.15625,30.84375,31.15625,5000,22925,65.37096642469032,60.53074340876397,NaN,NaN,91.87420694676302,94.38864784295204,0.09120385230767614,0.4820445005243208,0.39084064821664466,1013300,1022420,83.7416156928723,80.82853644652663,NaN,NaN,23.79886064296884,16.741267447041736
2000-08-22T09:30:00-04:00,31.0625,31.3125,31.0625,31.09375,1300,22900,64.2751654368109,61.85137029293097,NaN,NaN,89.75550888372189,89.76147417698998,0.08003361235533146,0.490882663660809,0.41084905130547755,1012000,1017540,81.81272567829964,81.54494228159489,NaN,NaN,24.558533407486756,17.85801972710531
2000-08-23T09:30:00-04:00,31.09375,31.21875,30.9375,30.9375,35400,24485,61.49964711853635,62.92566679331746,NaN,NaN,73.01881120240758,86.2700630284068,0.05511968579968596,0.479748658555085,0.424628972755399,976600,1010000,78.7928494546003,81.90794484109313,NaN,NaN,24.41402668939246,18.79459215028919
2000-08-24T09:30:00-04:00,30.95312,31.46875,30.9375,31.26562,33700,26125,64.9249325682961,63.88900637817246,NaN,NaN,81.46269899135362,83.54782815392115,0.05368324484876236,0.49173302881635195,0.4380497839675896,1010300,1004100,76.41591371655062,81.88063287067783,NaN,NaN,25.27696720926624,19.720645730143055
2000-08-25T09:30:00-04:00,31.53125,31.5625,31.34375,31.40625,202400,34290,66.30844502089249,64.28101303612128,NaN,NaN,94.58706811228808,86.13965882730686,0.054949808885469964,0.5067370450744271,0.4517872361889571,1212700,1044980,80.74924554991446,82.00834909180188,NaN,NaN,26.39646027258039,20.674333521919817
2000-08-28T09:30:00-04:00,31.71875,31.9375,31.5625,31.82812,113000,38015,70.1164856804512,64.77591864635518,NaN,NaN,121.13418849044918,91.9916551360441,0.07566700674523663,0.5463709946205029,0.47070398787526624,1325700,1107460,85.21929919618968,82.4036684200323,NaN,NaN,28.54757121727609,21.79908176411357
2000-08-29T09:30:00-04:00,31.79687,31.79687,31.5625,31.625,5500,33425,66.23475682757747,64.83291019281035,NaN,NaN,110.08524212505036,96.05760178430978,0.06743159319490966,0.5549934793689033,0.48756188617399365,1320200,1169100,88.1441513592365,82.93167025139469,NaN,NaN,29.211345857873106,22.857976634650647
2000-08-30T09:30:00-04:00,31.53125,31.6875,31.15625,31.32812,5400,33560,60.925687118166216,64.59941195404924,NaN,NaN,80.11960318868314,97.47776018156489,0.0353437233042701,0.5317415403043313,0.4963978170000612,1314800,1236740,90.39116320875434,83.5736351991633,NaN,NaN,28.18217041324328,23.618575745878168
2000-08-31T09:30:00-04:00,31.3125,31.75,31.3125,31.5625,31700,34985,63.418653707694126,64.33290199807038,NaN,NaN,97.79335118791226,100.74389062087661,0.023810911625808173,0.5261614565323214,0.5023505449065132,1346500,1303980,92.01193880491097,84.29978951228682,NaN,NaN,28.048378370516296,24.251404692255043
2000-09-01T09:30:00-04:00,31.75,31.84375,31.5625,31.84375,2700,33145,66.20499486370339,64.08999405688635,NaN,NaN,125.12173251247701,106.8508235009144,0.028703045281428752,0.5382293515082992,0.5095263062268705,1349200,1331280,92.56060630996197,84.9798835038613,NaN,NaN,28.771300587388087,24.89710410584548
2000-09-05T09:30:00-04:00,31.71875,32.03125,31.71875,31.84375,151500,40440,66.2049948637034,64.3017036895471,NaN,NaN,132.99971375553798,109.22392855393218,0.02561942474334289,0.5415505871560491,0.5159311624127062,1349200,1335980,92.65415325605582,85.594852815074,NaN,NaN,29.353080534995847,25.533672167152673
2000-09-06T09:30:00-04:00,31.78125,32.1875,31.78125,32,31000,41735,67.78594045527944,64.78098385918514,NaN,NaN,137.9864608536306,114.80417229964822,0.027611522596969973,0.5504455656589187,0.5228340430619487,1380200,1347980,92.89964681150903,86.19765181319012,NaN,NaN,30.29300347541415,26.213576639761456
2000-09-07T09:30:00-04:00,31.875,31.90625,31.75,31.8125,45200,42870,63.921578250342584,64.87482301728473,NaN,NaN,96.75454385850446,118.1311604336125,0.010680299161685669,0.5361844170140557,0.5255041178523701,1335000,1352020,92.98464945105684,86.7312937953375,NaN,NaN,30.012729127863114,26.756312709490263
2000-09-08T09:30:00-04:00,31.71875,31.71875,31.25,31.4375,328700,58020,56.93116357273773,64.58024370777727,NaN,NaN,29.30252187555236,104.43299457114051,-0.029214287269839767,0.4889862587650704,0.5182005460349102,1006300,1283980,76.39663789324352,86.05532831308258,NaN,NaN,27.68003273726793,26.888272713458502
2000-09-11T09:30:00-04:00,31.65625,31.84375,31.25,31.28125,169900,65320,54.268146911747685,63.7871851711385,NaN,NaN,22.886645509488147,83.98597717054274,-0.06738382537947574,0.43397076431056547,0.5013545896900412,836400,1181420,59.241092761464806,84.3052909608392,NaN,NaN,24.931376131606267,26.608716058908183
2000-09-12T09:30:00-04:00,31.25,31.3125,31.14062,31.1875,200200,72305,52.67603769321075,62.95867604659564,NaN,NaN,-27.320060779729236,51.922022263489296,-0.09832904100381895,0.37844328843526753,0.4767723294390865,636200,1038820,44.33398879798434,81.62823832653096,NaN,NaN,22.18232771637724,25.976374867118047
2000-09-13T09:30:00-04:00,31.3125,31.40625,31.15625,31.28125,30200,73595,54.125425480500276,62.431945929593056,NaN,NaN,-20.050464236811283,20.314637245400924,-0.1109340681750185,0.33810474422031334,0.44903881239533183,666400,896060,34.87309085335282,78.49111271215614,NaN,NaN,20.261161791316713,25.159915856289285
2000-09-14T09:30:00-04:00,31.34375,31.34375,31.1875,31.25,13000,73140,53.53682643982754,61.618509777559595,NaN,NaN,-34.05717573343495,-5.847706672986964,-0.11910741097532779,0.3001545486761721,0.41926195965149987,653400,759740,28.597420377101244,75.07550604505262,NaN,NaN,18.498580132736972,24.20829646721038
2000-09-15T09:30:00-04:00,30.71875,30.8125,30.375,30.375,14900,72610,40.31646366778394,59.76193968090898,NaN,NaN,-197.01414969483545,-51.11104098706453,-0.17764928369614358,0.19720035503132038,0.37484963872746396,638500,686180,25.889927340182723,71.15698331578606,NaN,NaN,12.326835972659179,22.51094496798878
2000-09-18T09:30:00-04:00,30.3125,30.625,30.03125,30.03125,22400,72155,36.50284869109251,57.360965610240505,NaN,NaN,-231.97486572567843,-102.08334323409784,-0.2303842809112403,0.08686928758841361,0.3172535684996539,616100,642120,24.399829658732855,66.812735491682,NaN,NaN,5.797816952660619,20.12335525151333
2000-09-19T09:30:00-04:00,30.0625,30.0625,29.59375,29.6875,11800,72495,33.12814099113349,54.99620733620879,NaN,NaN,-255.86772513862883,-147.79287610587775,-0.27619009298461095,-0.02798404773110974,0.24820604525350118,604300,635740,24.18278401497416,62.24406639566326,NaN,NaN,-0.8599989843361984,17.125733217820542
2000-09-20T09:30:00-04:00,29.84375,29.84375,29.34375,29.84375,20200,73440,36.02343279003731,53.21747488419959,NaN,NaN,-211.4718173886528,-186.07714673624605,-0.2827132846941148,-0.1051855606141423,0.17752772407997247,624500,627360,23.88228149689499,57.493431987673304,NaN,NaN,-5.319275424096392,13.91930341183241
2000-09-21T09:30:00-04:00,29.75,29.9375,29.625,29.9375,16200,72480,37.764529342701934,51.38503742955729,NaN,NaN,-153.60942123597178,-209.98759583675343,-0.2676171777276608,-0.15699374807960353,0.11062342964805727,640700,624820,23.785802228088727,52.62013651790028,NaN,NaN,-8.389049900740623,10.732395795750548
2000-09-22T09:30:00-04:00,29.625,29.71875,29.4375,29.71875,5800,71085,35.347290730983616,49.1809157057916,NaN,NaN,-142.39087006178534,-199.0629399101434,-0.25909494232044156,-0.2132452482524947,0.04584969406794688,634900,624100,23.756505156985327,47.70555786411622,NaN,NaN,-11.719290375288672,7.52501205703066
2000-09-25T09:30:00-04:00,30.25,30.59375,30.25,30.59375,38300,62880,49.32091057935932,47.97490968548131,NaN,NaN,-52.03729551746038,-163.0754258684998,-0.18474873232822817,-0.18508622134233832,-0.0003374890141101608,673200,635520,25.327537641200962,42.896513891626604,NaN,NaN,-10.050587320028594,5.014212146022194
2000-09-26T09:30:00-04:00,30.28125,30.625,30.21875,30.625,4100,57435,49.738723972843076,46.68582279387871,NaN,NaN,-44.82099854112822,-120.86608054899966,-0.12646775558186857,-0.15842218349144588,-0.03195442790957731,677300,650120,27.38752725865615,38.21707678070853,NaN,NaN,-8.629595536052749,3.065096762868631
2000-09-27T09:30:00-04:00,30.40625,30.625,30.3125,30.375,10000,57660,46.440181125348346,45.43715157066483,NaN,NaN,-44.09780347301152,-87.39127776587141,-0.09897181325646724,-0.15566919448016137,-0.056697381223694124,667300,658680,28.630672172967493,33.620364117987876,NaN,NaN,-8.49908627339056,1.4130706148316037
2000-09-28T09:30:00-04:00,30.4375,30.84375,30.21875,30.78125,51900,59985,52.009715212376584,45.08561954492476,NaN,NaN,-24.095481677443065,-61.48848985416564,-0.05010679816979152,-0.11933087893593353,-0.069224080766142,719200,674380,30.965148619413597,30.375257741285736,NaN,NaN,-6.543174069060771,0.27646423141840737
2000-09-29T09:30:00-04:00,30.59375,30.8125,30.42187,30.5625,4800,58640,49.0518747327511,44.71302867499643,NaN,NaN,-21.87160272869072,-37.384636387546735,-0.030181483457984687,-0.10695093508862286,-0.07676945163063817,714400,690280,33.34311156029209,28.525401941201967,NaN,NaN,-5.8804530441851135,-0.6030953793820955
2000-10-02T09:30:00-04:00,30.28125,30.48437,30.125,30.25,10800,59045,45.10543235606489,44.17227115091458,NaN,NaN,-48.03472374744109,-36.58412203354287,-0.03535364648521207,-0.12096150973715325,-0.08560786325194118,703600,696360,34.275411596848215,27.80693214112082,NaN,NaN,-6.582170808139029,-1.4572490120616575
2000-10-03T09:30:00-04:00,30.4375,31.0625,30.375,30.84375,16000,52270,52.8649145131993,44.082234653250225,NaN,NaN,8.037638597745406,-26.012394605768144,0.0019300469385603036,-0.0831953045787408,-0.0851253515173011,719600,704820,35.624628823830335,27.86061342472636,NaN,NaN,-4.55396589232163,-1.899637137813082
2000-10-04T09:30:00-04:00,30.84375,31.0625,30.84375,31.0625,16600,51550,55.36801723828875,44.21303399599746,NaN,NaN,45.30056491911852,-8.132720927342138,0.039933752962536276,-0.035208160314130765,-0.07514191327666704,736200,718600,37.86218286536297,28.52238217388791,NaN,NaN,-2.086242843716998,-1.9262950957993559
2000-10-05T09:30:00-04:00,31.15625,31.15625,30.9375,31.09375,2500,49415,55.729704685524304,45.31397978297891,NaN,NaN,65.41625350926078,9.769626109998631,0.06433970280085358,0.0052827152243999365,-0.05905698757645364,738700,722500,38.51356103755614,29.42407029512887,NaN,NaN,-0.03376507675325085,-1.6559336645070553
2000-10-06T09:30:00-04:00,31,31.0625,30.25,30.25,2400,33100,45.10215792463087,45.92821615680309,NaN,NaN,-5.533315894166788,13.037283476903417,0.022956343237145772,-0.030361558530021426,-0.0533179017671672,736300,726880,39.28336315773151,30.487179830771634,NaN,NaN,-1.745289042393679,-1.6686987184908586
2000-10-09T09:30:00-04:00,30.1875,30.4375,30.125,30.4375,1300,24670,47.49819053171895,46.954648266844906,NaN,NaN,-28.999282014821993,16.844371823427238,0.008266546844198593,-0.04298471821191896,-0.05125126505611755,737600,733680,40.52825024877979,31.654713133186327,NaN,NaN,-2.3145544181680604,-1.7609638184447445
2000-10-10T09:30:00-04:00,30.3125,30.34375,30.03125,30.03125,3200,14820,43.10810329270583,47.460696159892656,NaN,NaN,-56.327346466581005,3.971374810561959,-0.026832756917058456,-0.08479221120244063,-0.05795945428538217,734400,736640,41.09441936943165,32.88415155265323,NaN,NaN,-4.256768585772827,-2.1175073566344706
2000-10-11T09:30:00-04:00,29.5625,29.84375,29.46875,29.5,20400,14330,38.14327415394667,47.487749360695844,NaN,NaN,-134.6286944601661,-32.01447706529497,-0.08080043169338388,-0.15895999390211202,-0.07815956220872813,714000,732200,40.472024033785466,34.076024538774426,NaN,NaN,-7.62589544012191,-2.904419939989819
2000-10-12T09:30:00-04:00,29.625,29.625,28.59375,28.82812,17000,14530,32.97127353142366,47.31803384644156,NaN,NaN,-200.82235043558714,-85.26219785426454,-0.15255587872633264,-0.26885441061664395,-0.11629853189031131,697000,723860,39.26892801294464,35.18405474277152,NaN,NaN,-12.393451219213429,-4.259995837021764
2000-10-13T09:30:00-04:00,28.92187,29.71875,28.90625,29.71875,5900,14080,43.84166348163498,46.92665905374696,NaN,NaN,-112.11266897902037,-106.57806847123527,-0.13163537410136184,-0.2808427495170136,-0.14920737541565177,702900,717180,38.28719364201391,36.109744457115305,NaN,NaN,-12.445097788486272,-5.429296115802408
2000-10-16T09:30:00-04:00,29.90625,30.25,29.84375,30.125,3600,13140,47.98538253327004,46.801420379491745,NaN,NaN,-17.08409392038692,-104.19503085234825,-0.08433604218600782,-0.2546274281481615,-0.1702913859621537,706500,710960,37.3508315338584,36.82140904820118,NaN,NaN,-10.963500652746648,-6.219896763937299
2000-10-17T09:30:00-04:00,30.125,30.15625,29.3125,29.3125,11000,13100,41.40509943720022,46.441771687481165,NaN,NaN,-84.71410675562038,-109.87238291015612,-0.10056804038350564,-0.29600143644153576,-0.19543339605803012,695500,703180,36.1596222313951,37.35919119523172,NaN,NaN,-12.185039290320287,-7.072059981992011
2000-10-18T09:30:00-04:00,28.60937,29.375,28.60937,28.78125,29200,13550,37.75909302858703,45.423870102924774,NaN,NaN,-161.91184455957784,-115.32901293003847,-0.13759140446614584,-0.3674226516407124,-0.22983124717456657,666300,693640,34.69828879997843,37.62584406527207,NaN,NaN,-14.505343038027219,-8.133957561425612
2000-10-19T09:30:00-04:00,29,29.28125,29,29.28125,5700,13025,42.85905307155364,44.98152569855353,NaN,NaN,-113.70350570055868,-97.90524398303278,-0.11958000351185905,-0.37930625156439035,-0.2597262480525313,672000,688640,33.924460343830205,37.66736897838194,NaN,NaN,-14.516629400337713,-9.04576782412734
2000-10-20T09:30:00-04:00,29.375,29.4375,29.25,29.4375,700,12770,44.39246628016687,44.93059955027511,NaN,NaN,-86.61658497161852,-92.80602718155242,-0.08968284035422497,-0.3718297984953125,-0.28214695814108753,672700,682600,32.96797027258914,37.573980312363425,NaN,NaN,-14.00525002570828,-9.754265281496046
2000-10-23T09:30:00-04:00,29.8125,30.0625,29.75,29.78125,7600,11235,47.71663214860451,44.562865095661195,NaN,NaN,-24.304200562646262,-94.25004851000428,-0.0417329531085015,-0.3343131495267144,-0.2925801964182129,680300,677360,32.12182152702819,37.32377979116328,NaN,NaN,-12.49181183754446,-10.145343360931534
2000-10-24T09:30:00-04:00,30.0625,30.4375,30.0625,30.25,33600,12710,51.936043146216115,44.317724089084585,NaN,NaN,24.15741340623843,-72.47574447763252,0.02309074535244987,-0.2637167647276506,-0.28680751008010047,713900,681040,33.41433903680988,37.006076660552345,NaN,NaN,-9.83754770955695,-10.101372553592308
2000-10-25T09:30:00-04:00,29.71875,30,29.6875,29.6875,1200,12270,47.03104514418511,43.6963912647032,NaN,NaN,-28.408498903459837,-45.77507534640891,0.02922786210225048,-0.2502726824522874,-0.2795005445545379,712700,690320,36.68831128895224,36.8757016785092,NaN,NaN,-9.208508833324784,-9.97382059355409
2000-10-26T09:30:00-04:00,29.59375,29.84375,29,29.84375,72200,13285,48.486416818514115,43.93812404283772,NaN,NaN,-50.880584474886874,-33.21049110127454,0.04406197824142233,-0.22442307175276,-0.2684850499941823,784900,712900,43.91444429771157,37.206493188507785,NaN,NaN,-8.24902149709883,-9.72742072263191
2000-10-27T09:30:00-04:00,29.82812,29.875,29.5,29.82812,502700,38180,48.34332570171229,43.99849084069439,NaN,NaN,-25.07618213982905,-20.90241053491665,0.05250017001053148,-0.202859837481018,-0.25536000749154947,282200,634800,30.81408706439302,36.512624389623014,NaN,NaN,-7.529212492233482,-9.413390975432135
2000-10-30T09:30:00-05:00,30,30.20312,30,30.15625,1000,37690,51.57434624282127,44.603222479988354,NaN,NaN,27.06727454069878,-10.628115514247643,0.07830547794495665,-0.15747816006035364,-0.2357836380053103,283200,555380,23.22624500789783,35.236326220942026,NaN,NaN,-5.963145788440915,-8.92049880586196
2000-10-31T09:30:00-05:00,30.71875,31.25,30.71875,31.25,5400,37160,60.45360959252814,46.19681786845846,NaN,NaN,147.24380819855168,13.98916344421501,0.16232500669994882,-0.03287737963037429,-0.1952023863303231,288600,470320,18.08869196145622,33.63751678720423,NaN,NaN,-1.529944757863332,-7.864705370433585
2000-11-01T09:30:00-05:00,31.4375,31.46875,31.0625,31.28125,2900,36475,60.675470923444124,48.17568911074563,NaN,NaN,166.01358428081375,52.873580081069726,0.21025139940387355,0.06761186292451882,-0.14263953647935473,291500,386080,14.635874263230733,31.878012947938945,NaN,NaN,2.012582957397088,-6.453664180743489
2000-11-02T09:30:00-05:00,31.28125,31.40625,31.20312,31.21875,3300,36515,59.951057825551835,49.32636013531113,NaN,NaN,161.75443880415088,95.40058473687728,0.2265808215194458,0.14058649041995253,-0.08599433109949328,288200,286740,11.780194902311223,29.98465589510304,NaN,NaN,4.65911702318707,-4.86612400875341
2000-11-03T09:30:00-05:00,31.1875,31.1875,30.96875,30.96875,400,36415,57.018583380582996,49.971588767262055,NaN,NaN,123.3062109547668,125.07706335579644,0.2097676238242494,0.17621519868081847,-0.03355242514343093,287800,287860,11.98869572855179,28.173074766152563,NaN,NaN,6.05748991717324,-3.3056077336210317
2000-11-06T09:30:00-05:00,31.09375,31.46875,31.09375,31.25,30900,37895,59.42323419257355,51.25859839264586,NaN,NaN,132.59841265471758,146.18329097860018,0.20648768077339313,0.22455717582331047,0.018069495049917353,318700,294960,13.386202041263516,26.546401895428883,NaN,NaN,7.941813320112509,-1.6988332973733833
2000-11-07T09:30:00-05:00,31.21875,31.375,31.125,31.375,15700,38520,60.48145051356649,52.88162392728725,NaN,NaN,116.48017745513056,140.03056482991596,0.2014199224213178,0.2698443980765646,0.0684244756552468,334400,304120,15.25579531903827,25.15765236107601,NaN,NaN,9.809525261702927,-0.05478207464819618
2000-11-08T09:30:00-05:00,31.4375,31.53125,31.09375,31.17187,6000,37800,57.841560883704766,53.951803056726625,NaN,NaN,99.00092215239806,126.62803240423284,0.17409768956631683,0.28604658761314283,0.111948898046826,328400,311500,16.813758287060338,23.93545935702102,NaN,NaN,10.682573205193751,1.479125822472082
2000-11-09T09:30:00-05:00,31.1875,31.375,31.03125,31.375,3400,37120,59.73426982643969,55.047646167174676,NaN,NaN,87.04635663232018,111.6864159698667,0.159788820079507,0.31168492314620977,0.15189610306670276,331800,320220,18.715278091726304,22.91740991553082,NaN,NaN,11.947349703355695,2.9745863768840266
2000-11-10T09:30:00-05:00,30.90625,31.125,30.65625,30.65625,24200,38035,51.00804390307148,55.28274700677946,NaN,NaN,41.524394688952746,95.33005271670389,0.09519015026077521,0.2708837908926718,0.17569364063189657,307600,324180,19.613934153654412,22.023989388861263,NaN,NaN,10.53693268573532,4.0549215638627825
2000-11-13T09:30:00-05:00,30,30.25,29.60937,30.09375,10800,38395,45.416337568287176,54.8170537512131,NaN,NaN,-32.546619534607146,62.30104627883893,0.012211729249547554,0.19095830219383103,0.17874657294428348,296800,319800,19.35899820988176,21.020036472652116,NaN,NaN,7.5365419571047365,4.55229590575449
2000-11-14T09:30:00-05:00,30.1875,30.6875,30.1875,30.6875,1400,37915,51.46459320773286,55.13373575575223,NaN,NaN,11.856214921775601,41.37625377216794,-0.004175557001405428,0.17352712669252668,0.1777026836939321,298200,312560,18.921209662937628,19.75095778507964,NaN,NaN,6.832556550353935,4.878047426411554
2000-11-15T09:30:00-05:00,30.6875,30.9375,30.6875,30.75,7700,36840,52.066689522382234,55.38946952031423,NaN,NaN,31.149696250107468,27.80600859170977,-0.011859378409390636,0.1628784606821938,0.17473783909158444,305900,308060,18.639069844363632,17.945573895554784,NaN,NaN,6.453783314459949,5.10315255327561
2000-11-16T09:30:00-05:00,31.03125,31.03125,30.76562,30.90625,800,36595,53.61586788324887,55.76607967613827,NaN,NaN,36.74527308759286,17.7457918827643,-0.007675302147618163,0.16514371140706174,0.1728190135546799,306700,303040,18.31104665972012,17.052499580935294,NaN,NaN,6.59398652235224,5.316128834572272
2000-11-17T09:30:00-05:00,30.78125,31.28125,30.75,30.78125,5900,36855,52.16340643947805,55.808155404470895,NaN,NaN,35.49537642938324,16.5399882308504,-0.014203218119894445,0.15506499090481185,0.1692682090247063,300800,301680,18.217508427340547,16.69473268232406,NaN,NaN,6.297721527154283,5.456356362083987
2000-11-20T09:30:00-05:00,30.78125,30.78125,30.3125,30.34375,2000,36575,47.33053327242718,54.870792810177974,NaN,NaN,-26.95205171330351,17.65890179511113,-0.04701364709246905,0.11050115015911999,0.15751479725158904,298800,302080,18.349619727735856,16.71337037991546,NaN,NaN,4.615467036683476,5.3362293155981995
2000-11-21T09:30:00-05:00,30.3125,30.71875,30.3125,30.71875,2900,35040,51.480051513911256,54.21397713806848,NaN,NaN,-15.948545433226297,12.097949724110753,-0.04261846366987562,0.1042417176642445,0.14686018133412013,301700,302780,18.597442045308327,16.99633950720672,NaN,NaN,4.380817017534879,5.199741844446296
2000-11-22T09:30:00-05:00,30.34375,30.34375,30.03125,30.21875,1200,35040,46.24818266602813,53.23520034095964,NaN,NaN,-76.01663406097387,-9.335316338105516,-0.07087724570911341,0.05826362419772835,0.12914086990684176,300500,301700,18.504124962494245,17.47662022579122,NaN,NaN,2.56427521945421,4.82324661230457
2000-11-24T09:30:00-05:00,30.21875,30.75,30.21875,30.71875,3900,31625,51.550787699363596,52.84464350658683,NaN,NaN,-34.65467228446272,-23.61530541251663,-0.05414232123984601,0.06146296835703424,0.11560528959688025,304400,301240,18.4616339738822,17.938972957600537,NaN,NaN,2.6473236134611016,4.512400469612646
2000-11-27T09:30:00-05:00,31.0625,31.0625,30.59375,30.78125,4800,6730,52.18575033328084,52.327680373780204,NaN,NaN,-2.0138605559800573,-31.11715280958929,-0.03788031221607899,0.06825489932678153,0.10613521154286051,309200,302920,19.1914638807268,18.353634517562202,NaN,NaN,2.9033640028484307,4.282538117217758
2000-11-28T09:30:00-05:00,30.59375,30.59375,30.25,30.39062,3300,6845,47.955463632350934,51.432967025121954,NaN,NaN,-88.25939128988361,-43.3786207249053,-0.051598559928138485,0.041637011632687404,0.09323557156082589,305900,304340,19.844529118839645,18.68140121754801,NaN,NaN,1.8468145117741714,3.9345776021543886
2000-11-29T09:30:00-05:00,30.53125,30.78125,30.5,30.64062,53000,9225,50.70932295900945,50.92352145907228,NaN,NaN,-36.745657580245926,-47.538043154309236,-0.04238760500782396,0.04025106530104594,0.0826386703088699,358900,315780,25.09651687491497,19.2730268309662,NaN,NaN,1.777473253245467,3.6264198380245425
2000-11-30T09:30:00-05:00,30.09375,30.1875,29.84375,30.1875,8300,9495,45.96225110781137,49.93980583631311,NaN,NaN,-135.94637260717099,-59.52399086354866,-0.064062789424846,0.0025601835278123986,0.0666229729526584,350600,325800,29.45639704279297,20.040249613185246,NaN,NaN,0.2653871845299531,3.146272316096744
2000-12-01T09:30:00-05:00,30.46875,30.75,30.45312,30.45312,1002700,59465,48.97755758961302,49.794771099637515,NaN,NaN,-34.993744549122276,-59.59180531648057,-0.05794623888290058,-0.005809825650967326,0.05213641323193326,1353300,535580,69.49283507172767,23.60302825019048,NaN,NaN,-0.09693741544953835,2.682956640161561
2000-12-04T09:30:00-05:00,30.84375,31.3125,30.8125,31.28125,17200,60305,57.02835066313041,50.62420060641203,NaN,NaN,84.68763853569226,-42.2515054981461,0.0012991383032284892,0.053760336110968865,0.052461197807740376,1370500,747840,81.15008243962001,28.01667712374321,NaN,NaN,2.2146853225514893,2.6160607376458365
2000-12-05T09:30:00-05:00,31.6875,32.42187,31.6875,32.42187,71700,62345,65.17829435376942,51.60375068827177,NaN,NaN,254.29258336370452,26.25888943257152,0.11067831495047688,0.19080909149583647,0.08013077654535959,1442200,975100,86.91513189775796,32.87338585480181,NaN,NaN,7.337607936160401,3.290567480290774
2000-12-06T09:30:00-05:00,32.26562,32.26562,31.78125,31.78125,9300,62025,58.47086235769379,52.061191605079735,NaN,NaN,188.87441598090453,71.38290414480161,0.1318197149002206,0.24490542017063532,0.11308570527041473,1432900,1189900,90.02151027642438,37.972131599949,NaN,NaN,9.112704397672317,4.122301325630994
2000-12-07T09:30:00-05:00,31.78125,31.79687,31.59375,31.6875,2100,61830,57.53769145902156,52.34132186049207,NaN,NaN,135.3114738532241,125.63447343688063,0.13114664076322785,0.2770190062244495,0.14587236546122168,1430800,1405940,92.06254673192734,43.240095890820946,NaN,NaN,10.151720879349627,4.983646976162228
2000-12-08T09:30:00-05:00,31.96875,32.40625,31.96875,32.23437,5500,61935,61.40695442464185,53.00157528800377,NaN,NaN,181.46358371574,168.9259390898531,0.1574199226160554,0.3426472687312909,0.18522734611523553,1436300,1422540,92.19465699072451,48.52417793106266,NaN,NaN,12.329404208243695,6.03304086645958
2000-12-11T09:30:00-05:00,32.28125,32.65625,32.28125,32.59375,8600,61155,63.74497000887539,54.17403505489293,NaN,NaN,174.8515732108587,186.9587260248864,0.18688140388077687,0.4188291009662066,0.23194769708542975,1444900,1437420,92.31808238793647,53.807639549648414,NaN,NaN,14.873456572118046,7.295957395839361
2000-12-12T09:30:00-05:00,32.1875,32.46875,31.96875,32.10937,6100,60920,58.59269751554879,54.68208119786704,NaN,NaN,116.59801075406466,159.41981150295842,0.16252403469604348,0.43510274045548414,0.27257870575944065,1438800,1436740,92.2462943416223,59.068271856527986,NaN,NaN,15.30563523721076,8.440197087463847
2000-12-13T09:30:00-05:00,32.09375,32.09375,31.53125,31.54687,5700,61135,53.21374473221646,55.17962134545191,NaN,NaN,60.78396878160511,133.80172206309854,0.10035504518755739,0.3980225122438874,0.29766746705633,1433100,1436780,92.24667627625341,64.33559695036793,NaN,NaN,13.884093341461535,9.21789655232066
2000-12-14T09:30:00-05:00,31.25,31.54687,30.875,30.875,15100,61505,47.59356872693988,54.896962847421655,NaN,NaN,-4.336237815978628,105.87217972925798,0.010536998412918441,0.31083871507247807,0.3003017166595596,1418000,1434220,91.93455515049546,69.58366274869745,NaN,NaN,10.76497886621526,9.43890831144846
2000-12-15T09:30:00-05:00,30.21875,30.46875,29.9375,30.25,12700,62100,43.03975429677639,54.24367741624277,NaN,NaN,-88.18200213095272,51.94306255991944,-0.08893541342334449,0.18913244988037903,0.2780678633037235,1405300,1428020,91.13034076134127,74.72215395445562,NaN,NaN,6.588951863890784,9.031771676083077
2000-12-18T09:30:00-05:00,30.6875,30.85937,30.53125,30.8125,8700,62240,47.873795566851335,54.2378439829928,NaN,NaN,-35.52872746415843,9.867002424916013,-0.1132583084648259,0.13649497772269115,0.24975328618751705,1414000,1421840,90.28256998368616,79.75344258765894,NaN,NaN,4.752834991981062,8.420495006925647
2000-12-19T09:30:00-05:00,30.8125,30.90625,30.28125,30.28125,23200,63300,44.06979454208545,53.76359195321252,NaN,NaN,-59.63008014837081,-25.378615755571083,-0.1587463271234417,0.051320377283214924,0.21006670440665662,1390800,1412240,88.89906702325227,84.31076759825446,NaN,NaN,1.9559212460216007,7.49698446965364
2000-12-20T09:30:00-05:00,29.53125,29.65625,29.125,29.28125,18900,64100,37.956023003558876,53.19171851719448,NaN,NaN,-152.6098483796533,-68.05737918782276,-0.2446683930491529,-0.09576878690478452,0.14889960614436837,1371900,1400000,87.06706911675242,88.42581560353729,NaN,NaN,-2.649125722112375,6.047540156544209
2000-12-21T09:30:00-05:00,29.21875,29.5,29.03125,29.45312,20800,65080,39.50927433600358,52.51541257050809,NaN,NaN,-143.38616088998566,-95.86736380262417,-0.2760859053318141,-0.19620777552039925,0.07987812981141484,1392700,1394940,86.2755357680016,89.62457993898542,NaN,NaN,-5.718937107531476,4.366614833104826
2000-12-22T09:30:00-05:00,29.625,30.21875,29.625,30.15625,3400,65055,45.51841131996422,51.693274045996226,NaN,NaN,-80.43797302974154,-94.31855798238195,-0.23716103370639346,-0.21657316232157697,0.020587871384816478,1396100,1393100,85.96947226668527,89.96882206949009,NaN,NaN,-6.314040318440394,2.8408069543126517
2000-12-26T09:30:00-05:00,30.3125,30.5,30,30.5,15500,65590,48.226261296998715,50.482414541941175,NaN,NaN,-49.29644186010822,-97.0721008615719,-0.17858167875095377,-0.20263922705387571,-0.024057548302921963,1411600,1392620,85.8838782075607,89.89516109161886,NaN,NaN,-5.916693721754089,1.5897354291602603
2000-12-27T09:30:00-05:00,30.375,31,30.32812,31,16200,66235,51.96595455879406,50.01777827059119,NaN,NaN,-15.112309296912375,-88.16854669128021,-0.10037556725869352,-0.14952700737628888,-0.049151440117595355,1427800,1400020,86.11342419036428,89.6160120854717,NaN,NaN,-4.379945021698836,0.7369239361803895
2000-12-28T09:30:00-05:00,31.0625,31.45312,31,31.45312,23000,64735,55.12909989319315,49.84573601588915,NaN,NaN,25.71381866863999,-52.50381328162155,-0.01673047445460908,-0.0700645331858567,-0.05333405873124762,1450800,1415800,86.61332848662154,89.226782210807,NaN,NaN,-2.0928510244975165,0.3326703703692601
2000-12-29T09:30:00-05:00,31.46875,31.78125,31.25,31.25,15900,65115,53.43052931148767,49.27599136494957,NaN,NaN,31.671437135461613,-17.492293676532096,0.024097280915201746,-0.02321245758724544,-0.047309738502447185,1434900,1424240,86.88526734669225,88.84754009337613,NaN,NaN,-0.7518747252432458,0.1777353567103307
2001-01-02T09:30:00-05:00,31.21875,31.21875,29.70312,29.85937,150900,22525,43.53971835143599,47.8327591037039,NaN,NaN,-66.12007665639788,-14.628714401863373,-0.03989133624796879,-0.09717390881240817,-0.05728257256443938,1284000,1401820,82.11337732265953,88.11863258871348,NaN,NaN,-2.831840973388032,-0.2522041190180068
2001-01-03T09:30:00-05:00,29.1875,31.375,29.1875,31.15625,212300,32280,52.390969169489665,47.38977850755682,NaN,NaN,-36.51755283416623,-12.072936596674973,0.005379094074740569,-0.05055870497101367,-0.05593779904575424,1496300,1418760,82.87852951497652,87.44950652966736,NaN,NaN,-1.4752493498063517,-0.42692486627348464
2001-01-04T09:30:00-05:00,31.375,31.625,31.32812,31.40625,7200,29055,53.89157555069471,47.43819499459098,NaN,NaN,40.76316190017099,-0.8978423572582954,0.049936131957838456,0.0064823659015438295,-0.043453766056294627,1503500,1433900,83.5556011735576,86.82871545090337,NaN,NaN,0.0856406781861965,-0.3537012170649588
2001-01-05T09:30:00-05:00,30.3125,31.03125,30.28125,30.5,37600,30470,47.98693875909224,47.466292854030435,NaN,NaN,-27.94543717658173,-11.629693526302635,0.017807287392704506,-0.021194656815413992,-0.0390019442081185,1465900,1436920,83.6941183437941,86.24011282185327,NaN,NaN,-0.630620476613893,-0.3932611112862351
2001-01-08T09:30:00-05:00,30.23437,30.25,29.875,30.25,6000,30665,46.47421022714525,47.71161113477107,NaN,NaN,-65.53193769014379,-31.070368491423714,-0.018862780045726994,-0.06258041926527724,-0.04371763921955025,1459900,1441920,83.93538848695373,85.72618765939703,NaN,NaN,-1.6898342342483423,-0.5784858431379647
2001-01-09T09:30:00-05:00,30.39062,30.46875,30,30.34375,293600,45070,47.147067563309804,47.65970199166095,NaN,NaN,-47.44905271817147,-27.336163703778436,-0.034476578444904454,-0.08681336227568082,-0.05233678383077636,1753500,1535820,87.63550861112849,85.53711184707149,NaN,NaN,-2.3195107294174044,-0.8272036840350275
2001-01-10T09:30:00-05:00,29.8125,30.625,29.78125,30.625,123400,50810,49.209813103841995,48.02684617464357,NaN,NaN,-33.71985902547884,-26.776624942040957,-0.02402982316335052,-0.08237406278496451,-0.05834423962161399,1876900,1611940,89.70550073786623,85.5947142552582,NaN,NaN,-2.2230640452460366,-1.0266123070651716
2001-01-11T09:30:00-05:00,30.5625,31.15625,30.5625,31,9700,50990,51.90506482657851,49.02320630485925,NaN,NaN,45.92138121274456,-25.74498107952624,0.008241220924786977,-0.04804271346563027,-0.05628393439041725,1886600,1688560,91.28675100979471,85.89612010476121,NaN,NaN,-1.3463688434681975,-1.0722918122656038
2001-01-12T09:30:00-05:00,31,31.125,30.53125,30.90625,33300,52370,51.17393744786104,49.856396527134784,NaN,NaN,49.08438738442608,-10.339016167324678,0.022566291649641204,-0.028076069828365746,-0.05064236147800695,1853300,1766040,92.53538449322483,86.34325215656288,NaN,NaN,-0.8336517953659072,-1.0382003812799327
2001-01-16T09:30:00-05:00,30.96875,31.3125,30.71875,31.20312,7200,51975,53.411827293907955,50.420211953845055,NaN,NaN,82.58928190475667,19.285227751655416,0.04976925276030678,0.011569204472376526,-0.038200048287930256,1860500,1846160,93.56268117100274,86.88562422115699,NaN,NaN,0.22854405455560484,-0.8572368904462846
2001-01-17T09:30:00-05:00,31.5625,31.5625,31.15625,31.15625,32800,52980,52.99881169055206,50.76110841052745,NaN,NaN,102.17286355762872,49.20961100681545,0.06156768395141257,0.03875955665133546,-0.022808127300077113,1827700,1861000,93.73467377566728,87.4463953331646,NaN,NaN,0.9994990494246567,-0.5919888990361502
2001-01-18T09:30:00-05:00,30.9375,31.4375,30.71875,31.35937,6800,52885,54.63594232351127,50.95182182229296,NaN,NaN,78.30397756172435,71.61437832425608,0.07890581353744859,0.07582413962173362,-0.0030816739157149657,1834500,1852520,92.21842971895134,87.88246715663512,NaN,NaN,2.0940925581715133,-0.20826297657791254
2001-01-19T09:30:00-05:00,31.6875,31.6875,30.79687,31.03125,12300,52340,51.51440939807245,50.69362964407005,NaN,NaN,70.39668198088168,76.5094384778835,0.06472488731627579,0.07782443522962978,0.013099547913353986,1822200,1839640,89.84131770726968,88.11303781525284,NaN,NaN,2.2292021913742333,0.13994633312953686
2001-01-22T09:30:00-05:00,30.84375,31,30.59375,30.96875,37500,53270,50.91766281509208,50.514139180041795,NaN,NaN,21.827819319057447,71.0581248648098,0.04833554187867027,0.07351897526169182,0.025183433383021554,1784700,1825920,87.2609892758506,88.13987509590702,NaN,NaN,2.1897453307478663,0.43277476136072673
2001-01-23T09:30:00-05:00,31.0625,31.40625,30.9375,31.375,106400,57550,54.59914958119793,51.304098553596226,NaN,NaN,74.26075712006494,69.39241990787144,0.061225522067654914,0.10171533596759019,0.04048981389993528,1891100,1832040,87.43435595162029,88.51994499797563,NaN,NaN,3.127862543845346,0.8177873017156723
2001-01-24T09:30:00-05:00,31.21875,31.40625,31.15625,31.20312,16600,58210,52.79485974017763,51.33294788007394,NaN,NaN,71.32658913316394,63.22316502297849,0.05475705093105012,0.10893612756374793,0.05417907663269781,1874500,1841400,87.70984006754513,88.8650386088734,NaN,NaN,3.4650030532580702,1.1959609805074434
2001-01-25T09:30:00-05:00,31.15625,31.25,31.03125,31.1875,3300,57600,52.62466343615538,51.24245415760684,NaN,NaN,47.85374765427517,57.133119041488655,0.046341511237575725,0.11210596567966746,0.06576445444209174,1871200,1848740,87.93325229416433,89.17772797463103,NaN,NaN,3.706428961182447,1.5545992634610153
2001-01-26T09:30:00-05:00,30.78125,31,30.57812,30.67187,78000,60690,47.21376983783887,51.18722780608874,NaN,NaN,-29.377996479027487,37.17818334950681,0.005131651426891121,0.07217901872570565,0.06704736729881453,1793200,1842940,86.59372234404681,89.38484254607764,NaN,NaN,2.48593871156881,1.6876477560478431
2001-01-29T09:30:00-05:00,30.91,30.91,30.66,30.8,17700,60425,48.62731364142642,51.34102090710883,NaN,NaN,-17.60871070025774,29.290877345643775,-0.013401200766729793,0.050295866340402284,0.06369706710713208,1810900,1848180,86.78951927965281,89.58870903127044,NaN,NaN,1.810344760180497,1.7051758994953652
2001-01-30T09:30:00-05:00,30.72,31.31,30.45,31.3,14800,60370,53.82380951345362,51.81793104640481,NaN,NaN,34.08635539222318,21.255997000075418,0.007013397514660097,0.0724638140004572,0.06545041648579711,1825700,1835100,83.51082011734715,89.29408842457177,NaN,NaN,2.6194818997499634,1.8357910423888792
2001-01-31T09:30:00-05:00,31.31,31.58,31.19,31.37,56000,55625,54.51745220377125,52.1970481249712,NaN,NaN,100.99106838125692,27.188892849694014,0.023311755847656518,0.09459011129536776,0.07127835544771124,1881700,1836540,83.58434459456868,88.85686298576479,NaN,NaN,3.4839292580071435,2.0712393589057743
2001-02-01T09:30:00-05:00,31.3,31.34,30.83,30.96001,17300,45875,49.79901307864348,52.04661585726154,NaN,NaN,23.865568233699385,22.391256965578854,0.00549077518734184,0.07814182443188855,0.07265104924454671,1864400,1835180,83.20698640290432,88.27973694241548,NaN,NaN,2.961564203139677,2.1984286223677603
2001-02-02T09:30:00-05:00,31.23,31.23,30.64999,30.86,20100,46520,48.6919438887805,51.8693306030415,NaN,NaN,0.5804733663988809,28.38295093466413,-0.013011656055677195,0.05638647917495021,0.0693981352306274,1844300,1845400,83.79891538138243,87.65570343442674,NaN,NaN,2.22227346262486,2.2018350281187744
2001-02-05T09:30:00-05:00,30.91,31.16,30.75,31.00999,13700,45325,50.470318007132086,51.659222796843224,NaN,NaN,11.441962309196127,34.193085536554904,-0.014987207151906448,0.05066412629074435,0.0656513334426508,1858000,1854820,84.3466046198029,86.99741225219817,NaN,NaN,2.0570461707722036,2.181150905640693
2001-02-06T09:30:00-05:00,31.10001,31.28,31.06,31.16,13600,45705,52.25281153357762,51.60593707134506,NaN,NaN,56.67540792562656,38.71089604323557,-0.006465033068123613,0.05757004210749628,0.06403507517561989,1871600,1864000,84.882936981363,86.3651453383193,NaN,NaN,2.382236740766697,2.209877453515836
2001-02-07T09:30:00-05:00,31.06,31.06,30.67,30.89,23100,32180,48.84547525195842,51.19233228051986,NaN,NaN,-49.93703194996402,8.525275976991384,-0.01859915652589085,0.04078612951825633,0.05938528604414718,1848500,1857360,82.67637092028781,85.68356970984334,NaN,NaN,1.7600524273162828,2.1456167354873283
2001-02-08T09:30:00-05:00,30.88,31.17,30.85001,30.85001,3600,26190,48.342660276861466,50.96577877186193,NaN,NaN,-37.26572361263338,-3.7009823922751695,-0.028323064206727998,0.023981455785737182,0.05230451999246518,1844900,1853460,81.33892516601917,85.07625595689686,NaN,NaN,1.104356225508879,1.9968652340618356
2001-02-09T09:30:00-05:00,30.64999,30.67,30.10001,30.12,7100,26060,40.20614588806169,50.20067041993118,NaN,NaN,-258.4571708162565,-55.50851122880624,-0.07999746241856989,-0.0476923080307472,0.0323051543878227,1837800,1852160,80.86931018939462,84.61970745072144,NaN,NaN,-1.921511911137685,1.4370970704619042
2001-02-12T09:30:00-05:00,30.22,30.58,30.22,30.47,167100,32750,44.986914993440124,49.51408223509134,NaN,NaN,-181.570781145987,-94.11105991984286,-0.08615071253863829,-0.07538323628547516,0.010767476253163127,2004900,1881540,83.22633710833705,84.3191346762012,NaN,NaN,-3.1504604504858826,0.7817317103265061
2001-02-13T09:30:00-05:00,30.72,31.11,30.72,30.78999,298100,47295,49.001594362120954,49.24313470808729,NaN,NaN,-33.93560247056993,-112.23326199908217,-0.0651684385777106,-0.07069307196897512,-0.005524633391264522,2303000,1967820,87.92959492402743,84.33483145166421,NaN,NaN,-3.009345214891077,0.24014929243827998
2001-02-14T09:30:00-05:00,30.66,30.66,30.24001,30.47,14500,46380,45.43114230109571,48.729311769868744,NaN,NaN,-145.0395440174153,-131.25376441257242,-0.06897156573415915,-0.09173909055896345,-0.02276752482480431,2288500,2055820,90.77174837492683,84.53758117171868,NaN,NaN,-3.9621434314061483,-0.36017823953949535
2001-02-15T09:30:00-05:00,30.62,31.12,30.58,30.99001,7000,46390,51.602691278249864,49.04280615846953,NaN,NaN,-8.767646813465534,-125.55414905273885,-0.034346298171399565,-0.06570039753905377,-0.0313540993676542,2295500,2145940,92.67416629275314,84.97189859662627,NaN,NaN,-2.866508119341413,-0.7182253652254835
2001-02-16T09:30:00-05:00,30.55,30.59,30.02,30.08,36900,47620,42.536408028299086,48.60774147181758,NaN,NaN,-183.71845706091736,-110.60640630167102,-0.06863222447300342,-0.11714437995890847,-0.048512155485905054,2258600,2230100,93.93218730065459,85.48208916955498,NaN,NaN,-4.981777641427635,-1.3273042618257909
2001-02-20T09:30:00-05:00,30.3,30.49001,30.13,30.19,9500,46220,43.821280344151766,47.89327510258174,NaN,NaN,-141.6747293723156,-102.62719594693674,-0.07906194515247521,-0.14733958692649907,-0.06827764177402386,2268100,2282740,94.5612900364572,86.2714084494914,NaN,NaN,-6.219639453068149,-2.0262092891461276
2001-02-21T09:30:00-05:00,30.19,30.42,29.82001,29.82001,9900,41395,40.53797525507456,46.894741034817685,NaN,NaN,-166.93496135646853,-129.22706772411647,-0.10444395741743653,-0.19883258854581953,-0.094388631128383,2258200,2273780,92.79767690459653,86.92950361449338,NaN,NaN,-8.321009695328284,-2.925466490029293
2001-02-22T09:30:00-05:00,29.7,29.78,29.45,29.53999,46100,42870,38.20489875635806,46.066590011797295,NaN,NaN,-203.96016741770214,-141.0111924041738,-0.13188748522996915,-0.25924798766584445,-0.1273605024358753,2212100,2258500,89.7244079775915,87.39503372697105,NaN,NaN,-10.79911328967467,-4.050273175692918
2001-02-23T09:30:00-05:00,29.53,29.58,28.89,29.5,41600,44785,37.86969737736428,45.29357240383899,NaN,NaN,-200.3735537306599,-179.33237378761268,-0.14356574387023088,-0.3068176822736639,-0.16325193840343302,2170500,2233500,84.7773754492629,87.46492373181965,NaN,NaN,-12.877351385404243,-5.3112843485088215
2001-02-26T09:30:00-05:00,29.60001,30.25,29.48,30.09,11800,41475,45.471177342870284,44.936490927820294,NaN,NaN,-91.64001138790877,-160.91668465301098,-0.10421873820286362,-0.29352536115701255,-0.18930662295414893,2182300,2218240,81.81219309096988,87.283894336903,NaN,NaN,-12.343726165569919,-6.315918893803264
2001-02-27T09:30:00-05:00,30.10001,30.25,29.8,30.02,11700,41175,44.771294972287855,44.40209688772817,NaN,NaN,-71.42709635327205,-146.86715804920226,-0.07683484298005111,-0.2853501766792128,-0.2085153336991617,2170600,2198740,78.05521943169387,86.79620022621235,NaN,NaN,-12.122888763023457,-7.145486017977578
2001-02-28T09:30:00-05:00,29.97,30.02,29.28,29.49001,23000,41585,39.77903271372007,43.754493849282575,NaN,NaN,-117.40222841964984,-136.96061146183854,-0.08756506768749203,-0.31797166830852674,-0.2304066006210347,2147600,2176620,73.90899680264147,86.16995921780904,NaN,NaN,-13.477577165016474,-8.050070467554562
2001-03-01T09:30:00-05:00,29.28,29.42999,29,29.28,11500,39360,37.97218993859244,43.01374596797764,NaN,NaN,-148.3919784605804,-125.8469736704142,-0.1010020336937596,-0.3566591427382342,-0.2556571090444746,2136100,2161420,71.11358131019571,85.43957751382165,NaN,NaN,-15.148209798080437,-9.064090371915402
2001-03-02T09:30:00-05:00,29.36,29.85001,29.3,29.45,206400,48815,40.334741530977595,43.022931371043065,NaN,NaN,-98.85179873679982,-105.54262267164218,-0.09094959025350668,-0.36934409686135794,-0.27839450660785126,2342500,2195820,73.55165639679481,84.91688795720736,NaN,NaN,-15.833647754011942,-10.031169997929194
2001-03-05T09:30:00-05:00,29.60001,29.86,29.60001,29.82001,2000,47910,45.22494468351358,43.039933491762596,NaN,NaN,-61.91299792182746,-99.5972199784259,-0.05372994228009842,-0.3455569344579743,-0.2918269921778759,2344500,2228260,75.6397156325443,84.37498642322218,NaN,NaN,-14.954093949172192,-10.734444848106765
2001-03-06T09:30:00-05:00,30.25,30.60001,30.12,30.25,8600,47655,50.320719729123624,43.13415673226279,NaN,NaN,19.05598581283869,-81.50060354520376,0.002516712611842997,-0.2886811014130721,-0.2911978140249151,2353100,2264760,77.76661359269147,83.64905918526962,NaN,NaN,-12.60700967565906,-11.001954109185665
2001-03-07T09:30:00-05:00,30.31,30.61,30.31,30.61,5400,47245,54.16531397932881,43.758026137850855,NaN,NaN,53.697801279962405,-47.28059760528131,0.06326824984560042,-0.21211250171791463,-0.27538075156351505,2358500,2306940,79.94568077069351,82.8757686421101,NaN,NaN,-9.400575139324975,-10.773185684919852
2001-03-08T09:30:00-05:00,30.71001,30.85001,30.57001,30.8,53000,48740,56.09644051872894,44.07900822645651,NaN,NaN,90.90971191042772,0.5797404689203006,0.11266546009993689,-0.13454892643859395,-0.24721438653853084,2411500,2362020,82.37490945007664,82.14010743906178,NaN,NaN,-6.160151288521772,-10.114180771148698
2001-03-09T09:30:00-05:00,30.39999,30.49001,29.92,30.14999,24300,49775,48.5587982497026,44.50917895655676,NaN,NaN,12.58991977307289,22.86808417089485,0.09849225162996073,-0.12409907200107995,-0.22259132363104067,2387200,2370960,82.74035329220536,81.34069072417255,NaN,NaN,-5.62995703492826,-9.473577380260064
2001-03-12T09:30:00-05:00,29.55,29.55,28.5,28.5,165200,57680,35.51381550324757,43.915788610777895,NaN,NaN,-175.45816717392356,0.15905032047562956,-0.01882355195342239,-0.24612076357281865,-0.22729721161939626,2222000,2346460,77.96917672470131,80.15553977333285,NaN,NaN,-10.157297850534427,-9.571251733156402
2001-03-13T09:30:00-05:00,28.49001,28.62,28.25,28.53999,7700,49710,35.962832179076685,43.58899267677805,NaN,NaN,-189.62046346453516,-41.57623953499914,-0.08674376948965912,-0.33572692348147015,-0.24898315399181103,2229700,2321780,73.3788582054858,78.76848129482494,NaN,NaN,-13.3420933029019,-10.109943385977187
2001-03-14T09:30:00-05:00,27.89999,28.3,27.71001,27.94,63000,37955,32.325986543190766,43.16907037583753,NaN,NaN,-207.40607323736066,-93.79701443846373,-0.16078762249988277,-0.4499676821166645,-0.2891800596167817,2166700,2283420,66.79635934783774,77.1307635355568,NaN,NaN,-17.280194750077253,-11.134265009420053
2001-03-15T09:30:00-05:00,28.10001,28.10001,27.7,27.81,10300,37745,31.580777991741854,42.71986184829307,NaN,NaN,-182.8099660167399,-148.54095002389727,-0.20442801913087366,-0.5447150835303738,-0.3402870643995001,2156400,2232400,59.19096399725514,75.30316271755625,NaN,NaN,-20.580616785262272,-12.48374383454037
2001-03-16T09:30:00-05:00,27.71001,27.71001,27.00999,27.00999,7700,37780,27.395351942983794,41.42873146258689,NaN,NaN,-201.45293244013817,-191.34952046653947,-0.2690169567397965,-0.6765582603242457,-0.40754130358444923,2148700,2184700,53.10326922844271,73.25252529880431,NaN,NaN,-24.919587990318867,-14.260292999651583
2001-03-19T09:30:00-05:00,27.03,27.55,26.89,27.55,32200,37545,33.77544438032008,40.643313563160625,NaN,NaN,-159.27083903690425,-188.11205483913562,-0.2572200852254945,-0.7290664101163173,-0.47184632489082284,2180900,2176480,52.10867573366233,71.39920074894492,NaN,NaN,-26.298596495024622,-15.98005064184773
2001-03-20T09:30:00-05:00,27.55,27.78,26.99001,26.99001,4900,37315,30.757085478461065,39.998888760642124,NaN,NaN,-138.40932135583813,-177.8698264173962,-0.26777765348490734,-0.806568391746957,-0.5387907382620497,2176000,2165740,50.770680736999765,69.74646388711335,NaN,NaN,-28.47524037085874,-17.765077745992162
2001-03-21T09:30:00-05:00,26.75,26.85001,26.14,26.28999,59500,39795,27.454200375768238,39.24760379186897,NaN,NaN,-161.68986185304672,-168.72658414053342,-0.30011917436955116,-0.9139397062239887,-0.6138205318544375,2116500,2155700,49.49133554450406,68.20201776099252,NaN,NaN,-31.457796128997582,-19.721180372135795
2001-03-22T09:30:00-05:00,26.14,26.14,24.5,25.58,18700,38425,24.572052924849487,38.121697462859814,NaN,NaN,-182.17117971833886,-168.5988268808532,-0.3443712885697997,-1.0442846425666872,-0.6999133539968875,2097800,2143980,47.97170338115697,66.37487825987553,NaN,NaN,-34.963570718842476,-21.898664707379606
2001-03-23T09:30:00-05:00,25.55,26.17,25.55,26.09,13000,36995,30.2374743346371,37.0511638665115,NaN,NaN,-130.54890724982036,-154.41802184278964,-0.31512715945749215,-1.0938223033187526,-0.7786951438612605,2110800,2136400,46.967247898620066,64.32684485030951,NaN,NaN,-35.84714014053466,-23.891304054973187
2001-03-26T09:30:00-05:00,26.5,26.88,26.48,26.56,4500,36630,35.077083786494654,35.96233272775229,NaN,NaN,-86.31126273395489,-139.82610658219977,-0.2431845024800532,-1.082675771961327,-0.8394912694812737,2115300,2123280,45.20299016087959,62.000871748037234,NaN,NaN,-34.922843047351606,-25.467238196741533
2001-03-27T09:30:00-05:00,26.66,27.13,26.63,26.99001,21500,37120,39.23080178212129,34.89558185652318,NaN,NaN,-65.9100710114184,-125.32625651331583,-0.1502483901068088,-1.0273017571147847,-0.8770533670079759,2136800,2115440,44.13608063357445,59.44304316681445,NaN,NaN,-32.788492733149276,-26.51313170194264
2001-03-28T09:30:00-05:00,26.60001,26.60001,26.2,26.5,4400,36190,36.374847560079395,33.48689664519107,NaN,NaN,-80.49937856403555,-109.08815985551357,-0.10739693177488496,-1.011299531726582,-0.9039025999516971,2132400,2118620,44.706156880444155,56.752417983269275,NaN,NaN,-31.945324825968473,-27.289159291089188
2001-03-29T09:30:00-05:00,26.42999,26.59,26,26.5,24900,36860,36.374847560079395,32.61661445307512,NaN,NaN,-76.69904368283103,-87.993732648412,-0.06666783577053548,-0.9872373946648665,-0.920569558894331,2132400,2125540,45.99760865464366,54.12793622344345,NaN,NaN,-31.285759898131342,-27.860102234952354
2001-03-30T09:30:00-05:00,26.45,26.59,26.34,26.59,15600,27320,37.346423734838154,32.74751504104588,NaN,NaN,-64.43666830008104,-74.77128485846413,-0.023508542643481567,-0.949955237198683,-0.9264466945552015,2148000,2132980,47.41953583951358,51.94581901735861,NaN,NaN,-30.46797030168445,-28.23265481591408
2001-04-02T09:30:00-04:00,26.59,26.91,26.16,26.39999,50600,29750,36.093301985890164,32.75683431296113,NaN,NaN,-59.984249375216265,-69.50588218671642,0.0010954661746653827,-0.9250773618368697,-0.9261728280115351,2097400,2129400,46.78122715984996,50.045988228384616,NaN,NaN,-30.1344112218114,-28.50433430247084
2001-04-03T09:30:00-04:00,26,26.17999,25.3,25.3,27300,30685,29.849153417887976,32.57991766115379,NaN,NaN,-100.16360348487308,-76.35658868140736,-0.04529569504466546,-0.982792446817367,-0.9374967517727015,2070100,2116060,44.3837476307995,48.44508739145332,NaN,NaN,-31.772947926587765,-28.971279105916118
2001-04-04T09:30:00-04:00,25.60001,25.98,25.24001,25.42,4000,30615,31.246545660538303,32.55604392321068,NaN,NaN,-100.37812656110002,-80.33233828082025,-0.055793202377308226,-1.0072382547443368,-0.9514450523670286,2074100,2104400,42.341192501093026,47.2415322845846,NaN,NaN,-32.67441806502258,-29.50029895721704
2001-04-05T09:30:00-04:00,26,26.92999,26,26.89999,7300,28330,45.63114622994369,33.85860065799353,NaN,NaN,-28.57849105476046,-70.70822775520614,0.043675582460682705,-0.8968505742911752,-0.9405261567518579,2081400,2094200,40.58178178342952,46.347140324226515,NaN,NaN,-28.596598552208192,-29.371198899358635
2001-04-06T09:30:00-04:00,26.5,26.52,26.07001,26.36,19200,28075,42.16485156041583,34.457844028000366,NaN,NaN,-44.133582477583765,-66.64761059070668,0.07784484071904951,-0.843220105853046,-0.9210649465720955,2062200,2077040,37.74050434651965,45.32084236800204,NaN,NaN,-26.422778986626348,-28.949996054682593
2001-04-09T09:30:00-04:00,26.84,27.00999,26.53,26.83,3200,19975,46.00918300970756,35.547279565946546,NaN,NaN,8.987334275216037,-52.85329386062021,0.13357218994025055,-0.7540997091467823,-0.8876718990870328,2065400,2070640,36.708234127502166,44.31638189589507,NaN,NaN,-23.36553312115974,-28.1522156356079
2001-04-10T09:30:00-04:00,27,27.82001,27,27.62,47800,21980,51.80774297858563,37.28681832329064,NaN,NaN,97.78666322008895,-13.263240519627848,0.22000762757797743,-0.612662364614561,-0.8326699921925385,2113200,2079260,39.12340588007415,43.575815491292936,NaN,NaN,-18.7834475716053,-26.813820197893243
2001-04-11T09:30:00-04:00,28.14999,28.14999,27.14999,27.31,41800,20920,49.55849346427388,39.07156407610667,NaN,NaN,112.42912893471043,29.298210579534235,0.25045833956624475,-0.5195970677347326,-0.7700554073009773,2071400,2078720,39.02294614243306,42.936618545669795,NaN,NaN,-15.84175228664668,-25.24638192485802
2001-04-12T09:30:00-04:00,27.10001,27.97,27.10001,27.85001,22500,21530,53.357334460744156,40.72298265654289,NaN,NaN,129.81115501481113,60.97613979344855,0.2978974406852254,-0.39768360644444556,-0.695581047129671,2093900,2081220,39.79372198801593,42.424223837769496,NaN,NaN,-12.152897376592255,-23.375884132248625
2001-04-16T09:30:00-04:00,27.73,27.91,27.64,27.8,3700,21330,52.95955065881109,42.00030171885121,NaN,NaN,136.62826969126286,97.12851022721789,0.3151650323900209,-0.30162475664214483,-0.6167897890321657,2090200,2086820,41.57524429977569,42.16509913340493,NaN,NaN,-9.357775749015852,-21.37329722035823
2001-04-17T09:30:00-04:00,27.67,28.14999,27.67,28.14999,10200,20230,55.46201009102567,43.15967374091581,NaN,NaN,147.03482935754,124.73800924368268,0.33742525148968316,-0.19500822467006174,-0.5324334761597449,2100400,2093820,43.813333785091395,42.14204578708472,NaN,NaN,-6.2632622847961645,-19.214720800992218
2001-04-18T09:30:00-04:00,28.3,29.75999,28.3,29.36,15900,20780,62.825146652783026,45.048980818966065,NaN,NaN,223.1665935581081,149.8139953112865,0.41576324208292254,-0.012729423556091746,-0.4284926656390143,2116300,2094440,44.017887868940264,42.092883714834436,NaN,NaN,-0.9533211957042631,-16.605949428808223
2001-04-19T09:30:00-04:00,29.5,29.55,29.17,29.46001,7000,18155,63.36425544668269,46.97679566800916,NaN,NaN,193.91541583485497,166.11125269131543,0.4533578711605044,0.13820467331161623,-0.3151531978488882,2123300,2104820,47.46618125214399,42.19778175751303,NaN,NaN,3.4151347082575096,-13.745794552084547
2001-04-20T09:30:00-04:00,29.59,29.59,29.09,29.38,9900,17715,62.582331671402926,48.779360520620926,NaN,NaN,159.32093906619008,172.0132095015912,0.4509228278580297,0.24850033697364893,-0.20242249088438075,2113400,2108720,48.74366222067406,42.2923622133102,NaN,NaN,6.708690898113436,-10.823725202056265
2001-04-23T09:30:00-04:00,29.38,29.38,28.75,28.92999,16600,17895,58.229930376026495,50.36054826277353,NaN,NaN,118.05197931816643,168.2979514269719,0.3988853304554597,0.29618417218494386,-0.10270115827051582,2096800,2110040,49.193985710335916,42.46470210977349,NaN,NaN,8.263834532570197,-8.096930954252485
2001-04-24T09:30:00-04:00,29.06,29.25,28.64,28.64,30900,19215,55.54892084486662,52.19624593612914,NaN,NaN,94.17857279731092,157.7267001149261,0.3277888295936942,0.30703487872160196,-0.020753950872092253,2065900,2103140,46.87561007476921,42.64269228434275,NaN,NaN,8.795112283957051,-5.683781920222552
2001-04-25T09:30:00-04:00,28.60001,29.31,28.60001,29.31,5100,18395,60.117780998943694,54.25847703172952,NaN,NaN,97.22290115861686,132.53796163502784,0.3089907326953416,0.36548446499708476,0.05649373230174315,2071000,2094080,43.946979356109736,42.75739134541538,NaN,NaN,10.630349640888076,-3.353191697206748
2001-04-26T09:30:00-04:00,29.45,29.72,29.42,29.72,10100,18680,62.64786382028799,55.473956859611256,NaN,NaN,115.69085052945297,116.89304857394742,0.30666084453979126,0.43981978797648225,0.133158943436691,2081100,2085640,41.354926428286426,42.812615962905156,NaN,NaN,12.943288556085644,-1.0251230895935493
2001-04-27T09:30:00-04:00,29.8,29.99001,29.67,29.94,20400,18455,63.96872906428322,57.031376681316075,NaN,NaN,114.76400081671677,107.98166092405276,0.30195074894790774,0.5105973796215757,0.20864663067366795,2101500,2083260,40.627228355861824,43.01881053500103,NaN,NaN,15.247191757054464,1.299493317070453
2001-04-30T09:30:00-04:00,30.17,30.24001,29.63,29.63,12100,18280,60.7108633891841,58.08149670842154,NaN,NaN,100.57121581462366,104.48550822334423,0.2614841277826357,0.5355017904019626,0.27401766261932686,2089400,2081780,40.15405226325325,43.2649404018404,NaN,NaN,16.26364935085372,3.4372298933252052
2001-05-01T09:30:00-04:00,29.46001,29.89999,29.42999,29.89999,14300,16465,62.5020610674539,58.845376571912134,NaN,NaN,85.88926308330619,102.82764628054329,0.23714496787396677,0.5704488724617853,0.33330390458781856,2103700,2089340,43.7574746681592,43.59594531527504,NaN,NaN,17.630527668173258,5.464843861160642
2001-05-02T09:30:00-04:00,29.58,29.95,29.55,29.91,13500,15775,62.570194408491396,59.77478378221338,NaN,NaN,82.21666209745612,99.82639846831111,0.20705826963046564,0.5921267416259006,0.385068471995435,2117200,2098580,47.88753945172282,44.22913055165288,NaN,NaN,18.77156479525062,7.365803994602067
2001-05-03T09:30:00-04:00,29.5,29.53999,29.32001,29.47,9700,16060,57.614680192874566,60.07887990593698,NaN,NaN,56.55605892124856,87.99944014667024,0.14575580557019252,0.5672632289581756,0.4215074233879831,2107500,2103860,50.14066388706287,44.968197830156235,NaN,NaN,18.40690471908176,8.943104098099166
2001-05-04T09:30:00-04:00,29.55,29.92,29.39,29.92,72900,19340,61.01531338913797,60.65429152953176,NaN,NaN,71.70571395606656,79.3877827745402,0.12456699454286263,0.5772161665665614,0.45264917202369875,2180400,2119640,56.2313289590926,46.015061020107446,NaN,NaN,19.038362999583693,10.385283941168383
2001-05-07T09:30:00-04:00,29.89999,30.10001,29.89,30.03,13100,19035,61.82166810365969,61.10855281614847,NaN,NaN,88.76467874337638,77.02647536029075,0.10764947751699955,0.5872110189199482,0.47956154140294865,2193500,2140460,62.704703056040884,47.364444539460976,NaN,NaN,19.785096213815258,11.728114265832222
2001-05-08T09:30:00-04:00,30.3,30.3,29.78,30.08,30000,20375,62.204348243046276,61.06421007259585,NaN,NaN,91.39405359923103,78.12743346347573,0.09022155425633893,0.5923384842233723,0.5021169299670334,2223500,2164420,68.48191094540138,49.1118747592082,NaN,NaN,20.509633947119006,12.982617077444619
2001-05-09T09:30:00-04:00,29.7,30.21001,29.7,29.91,13700,18670,60.002184359147236,60.82406213777188,NaN,NaN,76.73935722171038,77.03197248832657,0.05914179957953869,0.5760441794414568,0.5169023798619181,2209800,2182940,72.08180790053241,50.870133805521654,NaN,NaN,20.556444626064792,14.064592441533215
2001-05-10T09:30:00-04:00,30.27,30.44,30.22,30.24001,4200,16790,62.75844072661656,60.83664135600143,NaN,NaN,111.23551442713183,87.96786358950322,0.05290926750911906,0.5830389642483169,0.5301296967391979,2214000,2204240,75.54182010516175,52.78428794012791,NaN,NaN,21.326906594242292,15.102065891920226
2001-05-11T09:30:00-04:00,30.60001,30.60001,29.92,30.09,10200,16175,60.71046552692466,61.013822438208436,NaN,NaN,97.87604309926995,93.20192941814392,0.03182286691873393,0.5699082803876152,0.5380854134688813,2203800,2208920,76.23862756889791,54.716048072882344,NaN,NaN,21.446913201668938,16.008472650455758
2001-05-14T09:30:00-04:00,30.23,30.24001,29.95,30.23,5200,16250,61.958155326185974,61.47162490115982,NaN,NaN,86.56675173523416,92.76234401651547,0.020966963202806554,0.5642941174723894,0.5433271542695829,2209000,2212020,76.71191285249513,56.84721255700562,NaN,NaN,21.87159435628131,16.846061465573694
2001-05-15T09:30:00-04:00,30,30.46001,30,30.35001,11000,16290,63.04162483662331,61.680470889565505,NaN,NaN,106.63195942012011,95.80992518069328,0.01576891809141656,0.5630383018838536,0.5472693837924371,2220000,2211320,76.34213846203158,59.16115249314289,NaN,NaN,22.513529920685276,17.65569981630392
2001-05-16T09:30:00-04:00,30.55,31.45,30.3,31.33,22500,16620,70.44425331820433,62.23735585370239,NaN,NaN,216.83195939175627,123.82844561470247,0.06923557323237539,0.6338138503329063,0.5645782771005309,2242500,2217860,77.43646168132949,61.7384050112174,NaN,NaN,25.364789962332456,18.75699840859371
2001-05-17T09:30:00-04:00,31.53999,31.99001,31.46001,31.85001,36000,18070,73.47972284450438,62.91671255228961,NaN,NaN,271.1022870566951,155.80180014061511,0.1271566646762886,0.7235241079458916,0.596367443269603,2278500,2230760,79.455152025892,64.51182813050526,NaN,NaN,28.822243678941923,20.194890590072024
2001-05-18T09:30:00-04:00,31.85001,31.95,31.58,31.95,10800,18115,74.03199367593348,63.868221858485995,NaN,NaN,223.22013255108507,180.87061803097814,0.1577388802579237,0.7935410435920076,0.6358021633340839,2289300,2247860,81.78193478326475,67.4852483105061,NaN,NaN,31.798900503487626,21.85260629198854
2001-05-21T09:30:00-04:00,31.95,32.25999,31.7,32.25999,60100,20290,75.72008889273384,64.81236670314885,NaN,NaN,203.2223727698647,204.20174223790426,0.18262463840192722,0.8640829613364929,0.6814583229345657,2349400,2275940,84.82182638444861,70.41841629024104,NaN,NaN,34.848436665454635,23.70915348819798
2001-05-22T09:30:00-04:00,32.35001,32.35001,32,32.16,28900,20190,74.04797789995959,65.63220838111087,NaN,NaN,170.44580312657357,216.96451097919493,0.17605521051501527,0.9015273360783347,0.7254721255633194,2320500,2296040,86.55167351785462,73.18014015210761,NaN,NaN,36.88946913805858,25.59205572389235
2001-05-23T09:30:00-04:00,32.39999,32.39999,31.63,31.67,47700,22320,66.3190942720481,66.25395224390898,NaN,NaN,120.12885400999953,197.6238899028436,0.12482386917484845,0.88150196203188,0.7566780928570316,2272800,2302100,87.03155859419726,75.81520405976006,NaN,NaN,36.40919753444312,27.137361696828176
2001-05-24T09:30:00-04:00,31.7,32.47,31.39999,31.63,32100,23420,65.7160852032562,66.58972165920315,NaN,NaN,97.91586854788619,162.9866062010818,0.07671838716687895,0.8525760768156303,0.7758576896487513,2240700,2294540,83.0500929025506,77.73083005572134,NaN,NaN,35.84484814146703,28.381288331776584
2001-05-25T09:30:00-04:00,31.38,31.38,31,31.16,27800,23790,58.93525353328995,66.38354918989101,NaN,NaN,40.68651091168397,126.47988187320156,0.005477449923291577,0.7827045020528658,0.7772270521295742,2212900,2279260,75.52923245763019,78.64686787012059,NaN,NaN,33.31323983630273,29.085852832423175
2001-05-29T09:30:00-04:00,31.39999,31.39999,30.97,31.08,18500,24110,57.84123260231571,66.07189807269597,NaN,NaN,33.564079851662115,92.54822328956107,-0.05165337013081828,0.7126603394660513,0.7643137095968696,2194400,2248260,63.05365404878497,78.25913523464799,NaN,NaN,30.912062920318554,29.346739987836802
2001-05-30T09:30:00-04:00,30.89999,31.00999,30.45,30.45,28700,24830,49.97387725543706,65.35559042243095,NaN,NaN,-11.43690537096822,56.17168159005271,-0.13192733671830292,0.599404538698991,0.7313318754172939,2165700,2217300,53.54184928479125,76.93485247638077,NaN,NaN,26.25410098660633,28.90493441623245
2001-05-31T09:30:00-04:00,30.64999,30.99001,30.64999,30.87,37300,26020,54.42445621764934,64.7603058146476,NaN,NaN,1.0351243520843234,32.35293565846966,-0.15518964912560929,0.5373448140102823,0.6925344631358916,2203000,2203340,49.887472534082164,75.10239907844651,NaN,NaN,23.587977007773077,28.145369072166826
2001-06-01T09:30:00-04:00,30.89999,30.98,30.39,30.78,20200,26545,53.32957824657968,64.23309958033722,NaN,NaN,-16.54970675128297,9.459820598635824,-0.17369201228153985,0.47541944778396683,0.6491114600655067,2182800,2191760,47.0205529676472,73.01539374978574,NaN,NaN,21.096493695586833,27.13838687551254
2001-06-04T09:30:00-04:00,30.89999,31.49001,30.71001,30.98,23900,24095,55.47328061407827,63.76989424375811,NaN,NaN,10.91908268962607,3.5063349542242555,-0.16933800527451526,0.4374389534723626,0.6067769587468779,2206700,2190520,46.71099574506163,70.87247109925478,NaN,NaN,19.621145183213677,26.064495205184134
2001-06-05T09:30:00-04:00,31.10001,31.34,30.94,31.31,41000,25490,58.833268964007665,63.46929739571413,NaN,NaN,20.197467817064496,0.8330125473047317,-0.14220406062891056,0.42902188296073973,0.5712259435896503,2247700,2201180,49.77236782673353,68.97463033959063,NaN,NaN,19.330398607094004,25.102481405456974
2001-06-06T09:30:00-04:00,31.07001,31.39999,30.95,30.95,20500,25015,54.04229205844759,62.297728734302936,NaN,NaN,4.055733886022831,3.9315403987029476,-0.14592457482230914,0.38882022506176384,0.534744799884073,2227200,2213480,53.118999908106744,67.23766878436044,NaN,NaN,17.636189939361348,24.035868338871886
2001-06-07T09:30:00-04:00,30.75,31.19,30.75,31.09,28000,25730,55.55796417457392,61.017603115022176,NaN,NaN,-14.591544625413194,0.8062066032034412,-0.1365476070315561,0.3640602910946278,0.5006078981261839,2255200,2223920,55.8103248973328,65.54875256089193,NaN,NaN,16.671185867997888,22.983770843032744
2001-06-08T09:30:00-04:00,31.10001,31.10001,30.61,30.71001,57200,28380,50.67309285363175,59.34911019914349,NaN,NaN,-47.10969447120449,-5.305790940780864,-0.15232627481120764,0.31020005461217437,0.462526329423382,2198000,2226960,56.59177114577041,63.74945515821376,NaN,NaN,14.362028873178312,21.752093418767824
2001-06-11T09:30:00-04:00,30.41,30.71001,30.17,30.17999,19200,28830,44.76135938792455,57.13777237737139,NaN,NaN,-112.77298281375178,-30.04420404145643,-0.19227224549255384,0.2221860225576897,0.41445826805024355,2178800,2221380,54.680356377631774,61.5964930148697,NaN,NaN,10.437472280966222,20.135718970510453
2001-06-12T09:30:00-04:00,30,30.56,29.8,30.38,16700,29405,47.26174683037485,55.224470158115345,NaN,NaN,-129.74581603192524,-60.03286081125437,-0.19824474318655272,0.16665233906705268,0.3648970822536054,2195500,2210940,51.19625466702443,59.07110595409612,NaN,NaN,7.952475222453711,18.395255577930918
2001-06-13T09:30:00-04:00,30.48,30.64999,30.27,30.27,68500,32280,46.027761935293896,53.775089276918614,NaN,NaN,-110.48791018998439,-82.94158962645582,-0.2019425120790257,0.11246894215482328,0.314411454233849,2127000,2190900,45.237688139823184,56.0858294930694,NaN,NaN,5.5502424444525404,16.56025370171972
2001-06-14T09:30:00-04:00,30.08,30.2,29.86,30.07001,6500,31480,43.78920858614457,52.208883804267785,NaN,NaN,-141.2115793881137,-108.26559657899593,-0.20930336560506113,0.05278224722752256,0.2620856128325837,2120500,2163960,38.71447545290604,52.918999675237636,NaN,NaN,2.866467549064085,14.603998537054629
2001-06-15T09:30:00-04:00,29.89999,30,29.58,29.85001,8400,30100,41.403674843838076,50.956628183592656,NaN,NaN,-151.38955808185912,-129.12156930112684,-0.21937424825366209,-0.0121321974844939,0.20724205076916818,2112100,2146780,35.22600696278859,50.040197854177514,NaN,NaN,-0.11513158359418647,12.501265662676227
2001-06-18T09:30:00-04:00,29.75,30.14999,29.75,29.81,9300,30025,40.966576965090866,49.75129563807659,NaN,NaN,-124.24016792615545,-131.41500632360757,-0.21862925274735462,-0.06604451516502508,0.15258473758232954,2102800,2131580,32.44079633631331,47.85356516042955,NaN,NaN,-2.695545849244778,10.330292589544655
2001-06-19T09:30:00-04:00,30.28999,30.28999,29.5,29.5,110100,32525,37.65005238624953,48.87102243313462,NaN,NaN,-129.1377685910073,-131.293396835424,-0.22787595901038676,-0.1322602111806539,0.09561574782973285,1992700,2091020,26.434522387108274,45.91732752488076,NaN,NaN,-5.924638708910901,8.008159546908146
2001-06-20T09:30:00-04:00,29.63,29.77,29.50999,29.63,11300,31645,39.849233761632604,47.82993511484771,NaN,NaN,-130.59388451633723,-135.31459170069456,-0.214301395264323,-0.17226099625067093,0.04204039901365209,2004000,2066420,23.582661765198694,44.03841246996052,NaN,NaN,-8.049206775083842,5.714250072337862
2001-06-21T09:30:00-04:00,29.82001,30.02,29.74001,29.75999,29400,30730,42.05027221991264,47.02427039865721,NaN,NaN,-94.52853156431655,-125.97798213593515,-0.18664670460861546,-0.19126798174711723,-0.004621277138501773,2033400,2049000,21.789948777803218,42.23622645640023,NaN,NaN,-9.258115700738664,3.5753406761840725
2001-06-22T09:30:00-04:00,30,30,29.49001,29.5,12200,29735,38.978146172945635,45.846046510004875,NaN,NaN,-106.82999657035845,-117.06606983363501,-0.17607877470577116,-0.22471974552071572,-0.04864097081494456,2021200,2030820,20.0748080655912,40.33364162215234,NaN,NaN,-11.177003546349795,1.4678629301078057
2001-06-25T09:30:00-04:00,29.73,29.78999,29.11,29.11,15900,29140,34.8634885222241,44.13391933559176,NaN,NaN,-134.28177086346824,-119.07439042109756,-0.18467009909375004,-0.2794785946821321,-0.09480849558838207,2005300,2011320,18.4016897033043,38.092878899050255,NaN,NaN,-14.109592778071246,-0.7574878853463445
2001-06-26T09:30:00-04:00,29,29.44,28.81,29.19,12300,28830,36.34783661569199,42.87002966110922,NaN,NaN,-140.31697835438365,-121.31023237377283,-0.17440449896881438,-0.31281411929940006,-0.13840962033058568,2017600,2016300,20.23018259596263,35.74367766246853,NaN,NaN,-16.12455309116002,-2.952782914748298
2001-06-27T09:30:00-04:00,29.25,29.27,28.88,29.13,3900,27590,35.690913009562635,41.45095457789413,NaN,NaN,-128.22587018448405,-120.8366295074022,-0.16139485340308868,-0.34015318708444653,-0.17875833368135785,2013700,2018240,20.973106092605704,33.255304890702305,NaN,NaN,-17.986830187199626,-5.100503953669916
2001-06-28T09:30:00-04:00,28.95,29.5,28.95,29.23,4400,25945,37.7115002437736,40.525126534332834,NaN,NaN,-101.8822256369141,-122.3073683219217,-0.1367686027054905,-0.34971908706322097,-0.21295048435773048,2018100,2015180,20.64647628300426,30.68778382907615,NaN,NaN,-19.032953771543568,-7.0908539276518665
2001-06-29T09:30:00-04:00,29,29.34,28.89999,28.89999,269800,38425,33.923439587137906,39.75098940570522,NaN,NaN,-111.42511130235717,-123.22639126832144,-0.13328274802401524,-0.3795539193877495,-0.24627117136373428,1748300,1960600,15.892288829106704,27.917207575610067,NaN,NaN,-21.039813092505685,-9.083562379773841
2001-07-02T09:30:00-04:00,28.95,29.53,28.95,29.32001,39600,39210,41.91990376078149,39.36942918644854,NaN,NaN,-80.69329289835423,-112.50869567529863,-0.09506107753418552,-0.3650975182814662,-0.27003644074728067,1787900,1917120,13.270698481869928,25.208239276670458,NaN,NaN,-20.473839224187202,-10.710744786118607
2001-07-03T09:30:00-04:00,29.48,29.5,29.25,29.5,4300,37375,44.99203146159847,39.29544843832745,NaN,NaN,-58.28675261577816,-96.10265052757754,-0.052172804187224364,-0.3352524459813111,-0.28307964179408673,1792200,1872040,11.206596421404186,22.777447011069103,NaN,NaN,-19.076852873613838,-11.905903084332211
2001-07-05T09:30:00-04:00,29.25999,29.47,29.25,29.27,90600,40880,41.939243294465086,39.16330806035034,NaN,NaN,-64.59389677149929,-83.37625584498059,-0.03465356034928557,-0.3263965922306937,-0.29174303188140815,1701600,1809620,9.096760482810751,20.66189594177658,NaN,NaN,-18.768847273757434,-12.886323682821528
2001-07-06T09:30:00-04:00,29.3,29.3,28.67999,28.73,43700,41665,35.79782938853718,38.762890527828844,NaN,NaN,-120.01074262058677,-87.00195924171513,-0.053658013748731914,-0.35881554906732305,-0.30515753531859113,1657900,1737580,7.371787219554605,18.672308817259868,NaN,NaN,-20.43362592850615,-13.96450971791933
2001-07-09T09:30:00-04:00,28.89999,28.89999,28.67,28.82001,5000,39055,37.44224140917214,38.51115227383465,NaN,NaN,-125.91961071971009,-89.9008591251857,-0.05423050429540516,-0.3729456656878476,-0.31871516139244244,1662900,1720500,7.0313528896608375,16.8573485710704,NaN,NaN,-21.272134198470145,-15.008456072283732
2001-07-10T09:30:00-04:00,28.94,28.94,28.38,28.38,16200,38905,32.99342213645697,38.178535827420895,NaN,NaN,-148.66509054176493,-103.49521865386785,-0.0769212225996122,-0.4148666896419577,-0.3379454670423455,1646700,1692260,6.4971059811029335,15.433247399212876,NaN,NaN,-23.432710160728863,-16.211920942061607
2001-07-11T09:30:00-04:00,28.28999,28.33,27.82001,28.09,15900,38865,30.427359109857306,37.50554478086552,NaN,NaN,-203.541497827502,-132.54616769621262,-0.10253712583766522,-0.46611687433942706,-0.36357974850176183,1630800,1659980,5.941399577941823,14.17315724298024,NaN,NaN,-26.07449435593,-17.62086000118566
2001-07-12T09:30:00-04:00,28.50999,28.96001,28.50999,28.77,15600,36220,41.84821394979003,37.491112047285334,NaN,NaN,-90.49831992094147,-137.72705232610105,-0.06650681359194954,-0.44671326549169876,-0.3802064518997492,1646400,1648940,5.759946584725924,13.028157086331861,NaN,NaN,-24.499953339984614,-18.603587621014082
2001-07-13T09:30:00-04:00,28.98,29.03999,28.59,29,22200,37005,45.12920454525453,37.930473359593115,NaN,NaN,-61.550279100931355,-126.03495962216996,-0.022292982508676396,-0.4080726800355947,-0.3857796975269183,1668600,1651080,6.356954772301748,12.048310422525475,NaN,NaN,-22.11986818128875,-19.105913415339035
2001-07-16T09:30:00-04:00,29.2,29.2,28.46001,28.50999,25600,37865,39.956779615448276,38.29427986625198,NaN,NaN,-80.11387658088076,-116.8738127944041,-0.02116618835321943,-0.4122374329684426,-0.3910712446152232,1643000,1647100,6.277307275036222,11.182283106220613,NaN,NaN,-21.851104150990086,-19.498083520432044
2001-07-17T09:30:00-04:00,28.33,29.09,28.33,29.09,15400,38170,47.61085983928762,39.09878152508024,NaN,NaN,-53.31398819934502,-97.8035923259201,0.021229836041849248,-0.36453394956291163,-0.3857637856047609,1658400,1649440,7.014962716376715,10.238338829107331,NaN,NaN,-18.875375018291884,-19.40912516298345
2001-07-18T09:30:00-04:00,29.09,29.17999,28.77,29.17999,8800,33105,48.703458272750794,40.02824904387939,NaN,NaN,-7.470960535793178,-58.58948486757835,0.05594982606373139,-0.3158265030250966,-0.371776329088828,1667200,1656720,9.403973703406379,9.411972229878808,NaN,NaN,-16.21043632361749,-18.952169614502598
2001-07-19T09:30:00-04:00,29.5,29.5,29.10001,29.10001,9600,33020,47.7502952293079,40.745305828560426,NaN,NaN,39.252332948308435,-32.639354293728374,0.07306393791081134,-0.28044640670031384,-0.3535103446111252,1657600,1658960,10.168748993980685,8.663563137805694,NaN,NaN,-14.400495001477848,-18.30193038407049
2001-07-20T09:30:00-04:00,29.28,29.33,29.2,29.25,16800,32390,49.73694743775429,41.87484210360444,NaN,NaN,56.71844618276212,-8.985609236989678,0.09275549703204844,-0.23756597332106466,-0.3303214703531131,1674400,1660120,10.589676222996275,8.284805094512093,NaN,NaN,-12.309816068154424,-17.445914053225337
2001-07-23T09:30:00-04:00,29.00999,29.25,28.92999,28.92999,2400,31900,45.74091690747002,42.1477716140822,NaN,NaN,10.40096390903384,9.11735886099324,0.08282457556883616,-0.2267907508920679,-0.30961532646090406,1672000,1665920,12.790068962979007,8.250474414591313,NaN,NaN,-11.734524522293452,-16.63000126309221
2001-07-24T09:30:00-04:00,28.83,28.83,27.97,28.16,186800,40445,37.85910251912948,41.63827668962013,NaN,NaN,-156.2402635031257,-11.467896199762897,0.02594200614519515,-0.2771878187794101,-0.3031298249246053,1485200,1631280,11.042221378303026,8.23873334008409,NaN,NaN,-13.86137829353766,-16.23448369601299
2001-07-25T09:30:00-04:00,28.5,28.5,28.06,28.35001,21400,40900,40.580107012232574,41.54119552660352,NaN,NaN,-138.39016197538197,-37.65173648768066,0.0038187618531324574,-0.2983563726081897,-0.30217513446132216,1506600,1599160,9.716310337852008,8.282986901158464,NaN,NaN,-14.685429112989551,-16.0131901841525
2001-07-26T09:30:00-04:00,28.32001,28.64,28.2,28.63,23300,41870,44.44074348248561,42.15854653331412,NaN,NaN,-85.21878291527483,-62.54595966039731,0.010375335835823285,-0.289205964666543,-0.2995813005023663,1529900,1573620,8.810403050290063,8.385745174782425,NaN,NaN,-14.131626605302856,-15.744395387173979
2001-07-27T09:30:00-04:00,28.63,28.97,28.57001,28.89999,12000,42250,47.952442143517125,42.90927515719591,NaN,NaN,-9.568003278734702,-75.80324955269667,0.03390233372306167,-0.2572033833485392,-0.2911057170716009,1541900,1547120,7.9791232741616085,8.453443059389622,NaN,NaN,-12.559269402963007,-15.289377389429555
2001-07-30T09:30:00-04:00,28.99001,28.99001,28.64999,28.84,16000,29560,47.23799818498109,43.92674487494763,NaN,NaN,-4.043773521064745,-78.69219703871639,0.04569691745330906,-0.23398457025496455,-0.2796814877082736,1525900,1517900,7.175216864982659,8.501879551095318,NaN,NaN,-11.510747027220603,-14.749573051971133
2001-07-31T09:30:00-04:00,28.75,29.17999,28.75,28.84,14800,28320,47.23799818498109,45.127504808885035,NaN,NaN,24.899905978709338,-42.464163142349385,0.053243828849832475,-0.21312670164598302,-0.2663705304958155,1525900,1526040,9.898612103090969,8.784537588605971,NaN,NaN,-10.664792727797597,-14.166033005660628
2001-08-01T09:30:00-04:00,29.10001,29.28,29,29,24800,29345,49.562456959897,45.67852216674982,NaN,NaN,76.90613719848946,0.595096692424903,0.06782223270733923,-0.18159273961164146,-0.2494149723189807,1550700,1534860,12.881161669627375,9.293195808956076,NaN,NaN,-9.294621176200266,-13.470117030023433
2001-08-02T09:30:00-04:00,29,29.22,28.95,29.03999,11700,25400,50.15354337771998,46.03740351192592,NaN,NaN,77.37721482033723,33.114296239547315,0.0782302773747375,-0.1516271256005588,-0.2298574029752963,1562400,1541360,15.111318636466905,9.918507513539302,NaN,NaN,-7.994530955724173,-12.687890447980681
2001-08-03T09:30:00-04:00,29.17999,29.17999,28.73,29.17999,20400,24235,52.26273438681027,46.916400281308924,NaN,NaN,62.880462042164574,47.60398930372717,0.09168291672702764,-0.11525375706651175,-0.2069366737935394,1582800,1549540,17.9576539236691,10.75281798844165,NaN,NaN,-6.307470300726646,-11.77640185551582
2001-08-06T09:30:00-04:00,29,29.03999,28.55,28.55,16000,24785,43.369557774817984,46.613450133846804,NaN,NaN,-23.389374749182835,43.73486905810354,0.05699071258419541,-0.13569828306329512,-0.19268899564749054,1566800,1557720,20.81691219610397,11.738671522707884,NaN,NaN,-7.319678188357176,-11.139727045921727
2001-08-07T09:30:00-04:00,28.8,28.96001,28.52,28.75999,10000,24475,46.62954101778604,46.46531318706361,NaN,NaN,-17.54366000253872,35.246155861853936,0.047416543818096374,-0.13341831587487007,-0.18083485969296645,1576800,1567900,24.350380663947178,12.806272019889368,NaN,NaN,-7.212610740038655,-10.578710430795574
2001-08-08T09:30:00-04:00,28.78,29,28.39,28.5,9500,24155,43.30560796192058,46.14783552510737,NaN,NaN,-67.10133363978619,6.444661694198812,0.023986669220444345,-0.15085152316741102,-0.17483819238785536,1567300,1571220,25.51771898907498,13.90262701953896,NaN,NaN,-8.114521750189335,-10.226683476423254
2001-08-09T09:30:00-04:00,28.42,28.57001,28.27,28.50999,9400,23845,43.47235018412092,45.70036429270499,NaN,NaN,-112.47555095446492,-31.52589146076162,0.010275361785971271,-0.1619939901553913,-0.17226935194136256,1576700,1574080,26.568912306028068,15.044001025469802,NaN,NaN,-8.798282185707016,-10.022626149178077
2001-08-10T09:30:00-04:00,28.28,29.03999,28.28,29.03999,29500,24210,51.60450252654872,46.119191836924884,NaN,NaN,-9.090253638763715,-45.920034596947275,0.036536637095849256,-0.12659855557155097,-0.16313519266740023,1606200,1578760,28.35090066067093,16.15548900387637,NaN,NaN,-6.9485783950693,-9.58347647001968
2001-08-13T09:30:00-04:00,29.10001,29.10001,28.7,28.77,16200,23740,47.829663839485065,46.83137478837886,NaN,NaN,10.364104738554786,-39.169338699399745,0.03533852616178837,-0.11896203496516478,-0.15430056112695315,1590000,1583400,30.160501639498236,17.5210804511046,NaN,NaN,-6.528705310340639,-9.147080590065531
2001-08-14T09:30:00-04:00,29,29.74001,27.33,28.78999,27300,24335,48.132186936074106,47.37080906865326,NaN,NaN,-56.962089204420366,-47.05302453977608,0.03541751336616497,-0.11002866941924694,-0.1454461827854119,1617300,1591500,33.32626600810735,19.20750585612284,NaN,NaN,-6.10309839533942,-8.712225990818943
2001-08-15T09:30:00-04:00,29,29,28.7,28.73,88400,28315,47.24675008352064,47.57123811158432,NaN,NaN,2.899711180883928,-33.05281557564206,0.031107959873113017,-0.10656123294402065,-0.13766919281713366,1528900,1583820,31.852002547538433,20.853334391640576,NaN,NaN,-5.998020092302847,-8.324482291030929
2001-08-16T09:30:00-04:00,28.5,28.78999,28.38,28.72,20200,28845,47.09123664794576,47.50972343332923,NaN,NaN,-46.115565603477684,-19.780818505444614,0.02739301168758035,-0.10342792820765823,-0.13082093989523857,1508700,1570220,29.373936019872502,22.381535302048498,NaN,NaN,-5.952590989662553,-7.985640676549732
2001-08-17T09:30:00-04:00,28.59,28.59,28.21001,28.37,21800,29095,41.89370147725243,47.12798795420576,NaN,NaN,-112.53874519461765,-40.470516816615394,0.0024850543992511187,-0.12771462189617466,-0.13019967629542578,1486900,1546360,25.60954826565002,23.698273259239024,NaN,NaN,-7.381829665833124,-7.8993819607330735
2001-08-20T09:30:00-04:00,28.62,28.62,28.17999,28.35001,13800,29665,41.61121531749735,46.726074892242636,NaN,NaN,-102.01765604514243,-62.946868973354846,-0.013345750843578447,-0.14688186484989885,-0.1335361140063204,1473100,1522980,22.558796416546187,24.60257213877154,NaN,NaN,-8.640848579970562,-8.005305763481287
2001-08-21T09:30:00-04:00,28.47,28.67,28.24001,28.31,26200,21635,41.01509678684055,46.11554916559574,NaN,NaN,-98.0846031600612,-71.171371764483,-0.02390450803184324,-0.16341674904612447,-0.13951224101428122,1446900,1488900,19.00486173003489,25.039979285943506,NaN,NaN,-9.859614166745747,-8.270206963947638
2001-08-22T09:30:00-04:00,28.2,28.50999,28.17,28.25999,30100,22070,40.239128846259696,45.407376699062866,NaN,NaN,-129.96723553049586,-97.74476110675896,-0.031189033565709012,-0.1784985329714175,-0.14730949940570848,1416800,1466480,17.096655207414557,25.181789041011196,NaN,NaN,-11.100404752652464,-8.674520933762613
2001-08-23T09:30:00-04:00,28.39999,28.42,28.24001,28.35001,22200,22015,42.353305557111305,44.69956035408437,NaN,NaN,-114.63619939314219,-111.44888786469187,-0.02703199368463577,-0.18109949151150317,-0.1540674978268674,1439000,1452540,16.019632035966623,25.043358906175307,NaN,NaN,-11.647246657955426,-9.099196037218729
2001-08-24T09:30:00-04:00,28.39999,28.87,28.39999,28.87,9500,21890,52.751404282717736,45.369692247505775,NaN,NaN,8.861750125450623,-87.16878880067821,0.01157977113211514,-0.13959278391172347,-0.1511725550438386,1448500,1444860,15.442449460131584,24.659468710748705,NaN,NaN,-9.16801006458277,-9.109026612556448
2001-08-27T09:30:00-04:00,28.89999,28.97,28.71001,28.86,4500,21315,52.55507554077126,45.79294471343328,NaN,NaN,52.33758613039698,-56.297740365570334,0.0359138812375131,-0.10628020349694722,-0.14219408473446032,1444000,1439040,15.001349071308695,23.991680739845954,NaN,NaN,-7.192307608328906,-8.835209611952514
2001-08-28T09:30:00-04:00,28.67,28.7,28.31,28.31,35100,22330,43.06227776688467,45.77556398521643,NaN,NaN,-73.22418525557151,-51.32565678467239,0.015480006250525286,-0.12284407692130372,-0.138324083171829,1408900,1431440,14.422023444541395,23.19913105809356,NaN,NaN,-8.224358865363282,-8.747945219582624
2001-08-29T09:30:00-04:00,28.5,28.5,28.00999,28.12,12900,21735,40.35079262217519,45.5525955879346,NaN,NaN,-134.8175251827359,-52.295714715120404,-0.009003320091345551,-0.14957823328601094,-0.1405749131946654,1396000,1427280,14.101021675985763,22.30856744166196,NaN,NaN,-9.935332781979524,-8.917572014210752
2001-08-30T09:30:00-04:00,27.95,28.16,27.44,27.60001,103000,26300,34.034580490516575,44.29760115678944,NaN,NaN,-236.6026664051387,-76.6890081175197,-0.05577997816344882,-0.2102998858989764,-0.1545199077355276,1293000,1398080,12.0702075721602,21.145660792482627,NaN,NaN,-13.636525827836051,-9.59170827330008
2001-08-31T09:30:00-04:00,27.49001,27.88,27.49001,27.85001,6800,25620,38.98003584786335,43.665484871673605,NaN,NaN,-201.4357867904768,-118.74851550070518,-0.06481145814322434,-0.235534230414558,-0.17072277227133367,1299800,1368340,10.42363269037088,19.735884438973528,NaN,NaN,-15.062313672128298,-10.37322333027554
2001-09-04T09:30:00-04:00,27.72,28.25999,27.59,27.59,21900,25915,35.9604344799654,42.79607398195156,NaN,NaN,-157.67200273014,-160.7504332728126,-0.08211147493652143,-0.27336211594198545,-0.19125064100546402,1277900,1335120,8.954237238615946,17.995025241152714,NaN,NaN,-17.248217834453644,-11.355365402300983
2001-09-05T09:30:00-04:00,27.55,27.8,27.39999,27.66,78800,29355,37.36713715839632,42.090387344442675,NaN,NaN,-173.6921217614793,-180.84402057399416,-0.08243953905183612,-0.29430006482025917,-0.21186052576842304,1356700,1324680,8.546488291837605,16.330345651459798,NaN,NaN,-18.5481962051621,-12.38291265985257
2001-09-06T09:30:00-04:00,27.60001,27.60001,27.17999,27.17999,13400,29550,32.151657737757546,41.02327456514352,NaN,NaN,-190.83035709932764,-192.0465869573125,-0.10702517125798122,-0.34564198984089956,-0.23861681858291833,1343300,1314140,8.143316303142143,14.813872814550487,NaN,NaN,-21.452258718644153,-13.678533525394224
2001-09-07T09:30:00-04:00,27,27.03,26.45,26.5,41000,31130,26.507382546758834,39.924251784393974,NaN,NaN,-231.58811931946332,-191.0436775401774,-0.15804448212618705,-0.43617242124065214,-0.2781279391144651,1302300,1316000,8.959511891605274,13.62458450211872,NaN,NaN,-26.146413419444155,-15.459659224544215
2001-09-10T09:30:00-04:00,26.5,26.58,26.24001,26.45,8400,30075,26.143946402648226,38.81944686190475,NaN,NaN,-205.47079735030863,-191.85067965214378,-0.18239268872082215,-0.5061188000154928,-0.32372611129467066,1293900,1314820,8.905449769895483,12.649345455929383,NaN,NaN,-29.85126583660433,-17.515603026267087
2001-09-17T09:30:00-04:00,26.14999,26.14999,23.92999,24,155900,37060,15.169050186793982,36.97330067618714,NaN,NaN,-295.8311638426754,-219.48251187465084,-0.34149427396929566,-0.7505939537562902,-0.4090996797869946,1138000,1286840,7.716462103617033,11.843031196899537,NaN,NaN,-39.538600737004,-20.66174555637236
2001-09-18T09:30:00-04:00,24.14999,24.2,23.55,23.66,123700,41880,14.273563361374343,35.118617427266756,NaN,NaN,-271.92028751387977,-239.12814502513092,-0.4412826931667606,-0.9607030462454453,-0.5194203530786847,1014300,1218360,5.707854474101865,11.029545430234345,NaN,NaN,-46.65918865117293,-24.375665998486728
2001-09-19T09:30:00-04:00,23.55,23.75,22.17999,23.07001,32000,39060,12.855368934125664,33.01162195419636,NaN,NaN,-236.23814624443196,-248.20970285415177,-0.5136117004012946,-1.1614349785803029,-0.6478232781790083,982300,1146160,4.405729106153146,10.199980935247666,NaN,NaN,-52.615831590011474,-28.409975368704547
2001-09-20T09:30:00-04:00,22.39999,22.47,21.72,21.75,84500,42275,10.372268103457529,29.984540798534912,NaN,NaN,-215.0829618357398,-244.9086713574071,-0.6103556200994171,-1.4107678033032798,-0.8004121832038626,897800,1065260,3.454712969933169,9.343714043090637,NaN,NaN,-58.682157702921145,-32.734572845021205
2001-09-21T09:30:00-04:00,21,21.89999,20.39999,21.67999,19600,42165,10.259083870936962,26.96339853640389,NaN,NaN,-188.81370904995293,-241.57725369733598,-0.636167654109404,-1.5956217508406176,-0.9594540967312136,878200,982120,2.788532386818261,8.47136999419846,NaN,NaN,-62.93961998272258,-37.049579578978545
2001-09-24T09:30:00-04:00,22.55,23.19,22.45,23.13,35300,43240,27.825773808556008,25.8750768250947,NaN,NaN,-112.10988511001,-204.83299795080293,-0.5177137667505551,-1.6065963051694077,-1.0888825384188525,913500,937220,2.5073337851454482,7.620320732813036,NaN,NaN,-59.13399439567293,-40.20449598136346
2001-09-25T09:30:00-04:00,23.12,23.38,22.86,23.28,69500,45405,29.36611689760096,25.090457130482257,NaN,NaN,-89.59734161241074,-168.36840877050912,-0.39682997002663134,-1.5849200009521418,-1.1880900309255105,983000,930960,2.469936851880405,6.789528959662654,NaN,NaN,-55.81527511875106,-42.43460728670454
2001-09-26T09:30:00-04:00,23.10001,23.38,22.7,22.87,56000,46700,27.630321444052385,24.633010055734818,NaN,NaN,-83.39310670029862,-137.79940086168244,-0.31559351752886866,-1.5825819278365962,-1.2669884103077276,927000,919900,2.4017780137287446,6.098926848346123,NaN,NaN,-53.87955853157806,-44.06960032168647
2001-09-27T09:30:00-04:00,22.84,23.12,22.58,23.12,9900,46085,30.334351669050946,24.015461185819643,NaN,NaN,-75.20812431532867,-109.82443335760021,-0.2206268417880588,-1.5427719625428011,-1.3221451207547423,936900,927720,4.41033237256643,5.669405397074377,NaN,NaN,-51.44899689608595,-45.12379983231497
2001-09-28T09:30:00-04:00,23.35001,23.74001,23.14999,23.67,35500,47385,35.999911578796045,24.01828097859326,NaN,NaN,-52.729709229865804,-82.6076333935828,-0.10238448583850301,-1.4501257280528712,-1.3477412422143682,972400,946560,9.25562728193718,5.690933257311607,NaN,NaN,-47.515591712054935,-45.46548438656354
2001-10-01T09:30:00-04:00,23.7,23.7,23.17,23.46001,7700,47545,34.83508405678954,23.837420042764204,NaN,NaN,-49.42712351270062,-70.07108107412094,-0.0240192755153803,-1.3777653366085936,-1.3537460610932133,964700,956800,11.870405026092328,5.9283558811869455,NaN,NaN,-44.777383834582565,-45.36718430770912
2001-10-02T09:30:00-04:00,23.61,23.92,23.50999,23.92,17100,46645,39.45637261394535,24.35918539106333,NaN,NaN,-34.52487660084904,-59.056588071808584,0.06805498185233749,-1.2686773337777915,-1.336732315630129,981800,956560,11.861778005448855,6.1939602884945675,NaN,NaN,-41.01233678608986,-44.74506323319208
2001-10-03T09:30:00-04:00,23.88,24.53999,23.77,24.5,34000,47700,44.7744380631092,25.663975070802646,NaN,NaN,-13.78276475497862,-45.134519682744575,0.17139876636752494,-1.1224838576707228,-1.2938826240382477,1015800,974320,16.687075376395867,6.745929108836753,NaN,NaN,-36.09567499009299,-43.50943634132078
2001-10-04T09:30:00-04:00,24.5,24.78999,24.39999,24.53,28300,43965,45.04333358279296,27.013931297955846,NaN,NaN,2.921451928524905,-29.508604433973858,0.24089825266125975,-0.9927598082116731,-1.2336580608729328,1044100,995760,22.222849111559654,7.697171918955621,NaN,NaN,-32.138278713583574,-41.88498525164403
2001-10-05T09:30:00-04:00,24.5,24.50999,24,24.50999,6400,43945,44.88634495893357,29.136595210251528,NaN,NaN,0.47252896734719396,-18.868156794531263,0.2818009333747875,-0.8814068941544484,-1.163207827529236,1037700,1008820,25.47141661953134,8.965382955806643,NaN,NaN,-28.995869052039158,-40.043682937414765
2001-10-08T09:30:00-04:00,24.39,24.39999,24.03,24.22,33000,44500,42.57071469897858,31.157820305794694,NaN,NaN,3.497806240159178,-8.283170843959304,0.2847637300442285,-0.8072531649739503,-1.0920168950181788,1004700,1016820,27.469851163699104,10.519811290777872,NaN,NaN,-26.961128444832926,-38.17474658133165
2001-10-09T09:30:00-04:00,24.2,24.2,23.95,24.13,10300,41075,41.84913283776717,33.22880344176908,NaN,NaN,7.387008063106155,0.09920608883176278,0.2759050881596714,-0.7471355348185895,-1.023040622978261,994400,1019340,28.123656221835006,12.213948941898009,NaN,NaN,-25.46478255047731,-36.35903743406674
2001-10-10T09:30:00-04:00,24.13,24.73,24.13,24.57001,20400,41425,46.613556539460134,35.817466901483556,NaN,NaN,46.44173506773397,12.144106053374282,0.29329653874881667,-0.65641994954224,-0.9497164882910567,1014800,1019140,28.102005062632145,13.97446980566222,NaN,NaN,-22.803327463519558,-34.42250743827429
2001-10-11T09:30:00-04:00,24.89999,25.33,24.89999,25.3,32200,40985,53.43056999044647,38.90114448144852,NaN,NaN,111.04590622032858,33.768996911735016,0.3440667141880345,-0.5196330955560136,-0.863699809744048,1047000,1019720,28.274456136910374,15.7948929306688,NaN,NaN,-18.31420927501717,-32.121321986380416
2001-10-12T09:30:00-04:00,25.39999,25.39999,24.63,25.06,30100,42070,51.119420195056406,40.56497636619855,NaN,NaN,113.36265286207303,56.34702169068019,0.35040987785398536,-0.4256874624265663,-0.7760973402805517,1016900,1015560,27.760150875056198,17.59866557994814,NaN,NaN,-15.232629574064013,-29.708651641763787
2001-10-15T09:30:00-04:00,25.06,25.25,24.82001,25.23,22900,35420,52.680763409450925,42.23030825990212,NaN,NaN,114.89370337311438,78.62620111727122,0.35394111928673155,-0.33367094117213725,-0.6876120604588688,1039800,1022580,30.071725840832897,19.570221936301888,NaN,NaN,-12.218760562556206,-27.21009577330556
2001-10-16T09:30:00-04:00,25.42,25.44,25.00999,25.17,38700,31170,52.04884624671922,43.97448860294975,NaN,NaN,109.35713859754404,99.0202272241588,0.34004002274484235,-0.2625620320278159,-0.6026020547726583,1001100,1023920,30.528697182967235,21.579287591247493,NaN,NaN,-9.896689921370019,-24.73675208017191
2001-10-17T09:30:00-04:00,25.3,25.3,24.58,24.58,199800,39560,46.18246066364427,45.10649638827784,NaN,NaN,72.50177236477568,104.23223468356714,0.2813430111139338,-0.250923290880241,-0.5322663019941748,801300,981220,24.93653222367344,23.045444723469423,NaN,NaN,-9.46434704797271,-22.554979932714883
2001-10-18T09:30:00-04:00,24.46001,24.59,24.35001,24.48,7900,35730,45.25151298406462,45.76732506008274,NaN,NaN,40.72638676335031,90.16833079217149,0.22827519972671367,-0.24692230233578272,-0.4751975020624964,793400,930500,20.20266194605783,23.827375770906617,NaN,NaN,-9.365962105554662,-20.670834528834853
2001-10-19T09:30:00-04:00,24.3,24.36,24.19,24.34,46900,37095,43.916788885914144,46.416018262163064,NaN,NaN,16.429558510869626,70.7817119219308,0.17844457245161344,-0.2521417864979796,-0.430586358949593,746500,876420,16.586983308875602,24.164274219676848,NaN,NaN,-9.647906169697682,-19.09613047752954
2001-10-22T09:30:00-04:00,24.45,24.87,24.45,24.85001,12800,35970,49.73343863598784,47.150094406594675,NaN,NaN,57.43953556203451,59.29087835971484,0.1743305616681592,-0.21267315686439403,-0.3870037185325532,759300,820320,13.823217553934214,24.30437704456866,NaN,NaN,-8.258373269220494,-17.547879447771106
2001-10-23T09:30:00-04:00,25,25.02,24.64,24.72,16500,33320,48.35661385573124,47.40596410606768,NaN,NaN,60.759501943710234,49.57135102894807,0.1578445878569047,-0.18969798371142232,-0.347542571568327,742800,768660,11.862998822464277,23.95980014785926,NaN,NaN,-7.475928751396389,-16.109029348289003
2001-10-24T09:30:00-04:00,24.7,24.94,24.7,24.84,9500,30995,49.739685132276364,47.741417788173635,NaN,NaN,59.24316595180332,46.9196297463536,0.15006362368019766,-0.15996304196807998,-0.31002666564827763,752300,758860,11.529001156602035,23.195953865362288,NaN,NaN,-6.442623468701959,-14.72811422263371
2001-10-25T09:30:00-04:00,24.52,25.23,24.52,25.23,5100,30755,54.0470466562857,48.39575362369879,NaN,NaN,77.71124891739306,54.316602177162146,0.16503542577559155,-0.10373238342878821,-0.26876780920437976,757400,751660,11.277775780834688,22.182122376883957,NaN,NaN,-4.319085691895901,-13.241110146814023
2001-10-26T09:30:00-04:00,25.2,25.75,25.2,25.7,10800,29520,58.64659633901663,49.54403088370151,NaN,NaN,151.96548630998487,81.4237877369852,0.19821263835727004,-0.02100201125779222,-0.21921464961506226,768200,756000,12.515277909755852,21.113938573030868,NaN,NaN,-1.0731854255217859,-11.502835186629419
2001-10-29T09:30:00-05:00,25.25,25.35001,24.75,24.75,20800,30175,48.15475936402912,49.99443277843451,NaN,NaN,48.614296730189594,79.65873997061621,0.1499885959098727,-0.031728904727721385,-0.1817175006375941,747400,753620,12.413027942439996,19.991750838788366,NaN,NaN,-1.387896496948403,-10.057843945246416
2001-10-30T09:30:00-05:00,24.39999,24.56,24.2,24.21001,8600,29750,43.40180831428127,49.765022190921734,NaN,NaN,-77.4720919412058,52.01242119363301,0.07909583379839777,-0.08284770838959687,-0.16194354218799464,738800,752820,12.376425032871438,18.868495122376885,NaN,NaN,-3.2422777178823234,-9.084191627051545
2001-10-31T09:30:00-05:00,24.55,24.55,24,24.09,18900,28995,42.40017631852978,48.977136928641976,NaN,NaN,-97.93924554051887,20.575938895168576,0.024332940147644228,-0.13152736700343937,-0.1558603071510836,719900,746340,12.066059809851637,17.710752527586976,NaN,NaN,-5.035090149950124,-8.505748558894199
2001-11-01T09:30:00-05:00,24.14999,24.59,23.8,24.59,49700,30065,47.80483070292857,48.740380536347125,NaN,NaN,-70.27377955125885,-9.02106679856181,0.02206282698810169,-0.12828177341595648,-0.15034460040405817,769600,748780,12.951256632053983,16.652974367372533,NaN,NaN,-4.86617048721946,-7.985808834369236
2001-11-02T09:30:00-05:00,24.58,24.97,24.48,24.97,9100,30200,51.527388639771104,48.65799662422713,NaN,NaN,17.338878600884577,-35.94638834038187,0.04510476946563288,-0.09396363857201706,-0.13906840803764994,778700,750880,13.75594299651685,15.487561307064245,NaN,NaN,-3.5471031671779825,-7.351708024770486
2001-11-05T09:30:00-05:00,25.22,25.42,25.17999,25.34,27300,29915,54.900174926098906,48.86166295846855,NaN,NaN,109.79713753652122,-23.709820179115546,0.08206294180925092,-0.036489730776086304,-0.11855267258533722,806000,762600,18.295397402729094,14.613754179904378,NaN,NaN,-1.3777904770024856,-6.4982912322322
2001-11-06T09:30:00-05:00,25.39999,25.7,25.14999,25.7,56400,32220,57.96488967236979,49.70326503052036,NaN,NaN,138.70917054876503,19.526432318878616,0.12498091428383254,0.037673470269453446,-0.0873074440143791,862400,787320,27.02068590561187,14.762622300042837,NaN,NaN,1.4042528750361427,-5.369356359765294
2001-11-07T09:30:00-05:00,25.60001,25.97,25.59,25.64,33900,32895,57.26641823001156,50.561472548088,NaN,NaN,157.83139409330732,70.68056024564386,0.14229626739617418,0.09056289023083863,-0.05173337716533555,828500,809040,33.71833963729381,15.728027849416836,NaN,NaN,3.432033330249896,-4.112014975477409
2001-11-08T09:30:00-05:00,25.95,26.17999,25.86,25.91,20500,32310,59.62419165357736,51.683429888635374,NaN,NaN,177.41555081187136,120.21842631826989,0.16339220235786742,0.15250687578199873,-0.010885326575868687,849000,824920,38.185088407516076,17.27074964217687,NaN,NaN,5.843055618563345,-2.689862033471587
2001-11-09T09:30:00-05:00,25.95,26.02,25.8,25.82001,15600,31585,58.46633756502902,52.30720838356689,NaN,NaN,136.07028952396917,143.96470850288682,0.16240572433288356,0.19212182884023576,0.02971610450735221,833400,835860,41.12852427136661,19.221128693422042,NaN,NaN,7.505519484972223,-1.2333789594081856
2001-11-12T09:30:00-05:00,25.8,25.8,25.00999,25.52,25000,31690,54.655738482832575,52.757145856931274,NaN,NaN,63.584640875671646,134.7222091707169,0.13385698921138844,0.19703734102158776,0.06318035181019932,808400,836340,41.2606838998746,21.320963341808493,NaN,NaN,7.863261610192657,0.06614112196336319
2001-11-13T09:30:00-05:00,25.89999,26.14999,25.86,26.14999,25500,31030,60.48053821832255,53.52434964879171,NaN,NaN,131.9202247299862,133.36442000696113,0.14857467737659844,0.24889869853094737,0.10032402115434894,833900,830640,40.1092043343921,23.36240642593636,NaN,NaN,9.948538131374445,1.4779121233078032
2001-11-14T09:30:00-05:00,26.2,26.41,26.16,26.28,61300,24105,61.577452293790756,54.06223576575636,NaN,NaN,137.03797262564237,129.20573571342814,0.15739320861569375,0.2970655319239661,0.13967232330827237,895200,843980,44.04493080284396,25.70291749893702,NaN,NaN,11.983674362512135,2.9787353003369934
2001-11-15T09:30:00-05:00,26.48,26.52,26.23,26.41,58300,26625,62.69253880259835,54.351231656012196,NaN,NaN,130.84791518081568,119.89220858721701,0.16169261146323158,0.34178808763731183,0.18009547617408025,953500,864880,49.62980733742852,28.353955315199354,NaN,NaN,13.994557941603048,4.552424249089287
2001-11-16T09:30:00-05:00,26.75,26.75,26.45,26.62,16200,25090,64.48557012342346,55.517718138826076,NaN,NaN,139.32446646943774,120.54304397631071,0.16767101332014892,0.3896842428242664,0.22201322950411748,969700,892140,55.823250366592276,31.454685488353086,NaN,NaN,16.215725167296476,6.218610094547457
2001-11-19T09:30:00-05:00,26.95,26.95,26.7,26.86,100600,29480,66.46899338202356,57.16537421509339,NaN,NaN,144.8766148302122,136.80143876721883,0.17592075528316403,0.4419141736080725,0.26599341832490847,1070300,944520,64.78364708719903,35.198058492233635,NaN,NaN,18.68787899267061,7.999934222850764
2001-11-20T09:30:00-05:00,26.75,26.87,26.5,26.5,80000,32655,60.96861198158156,58.49169104816851,NaN,NaN,109.99083522161568,132.41556086554473,0.14647010683875866,0.4490810518733568,0.3026109450345981,990300,975800,68.84728757964584,39.25386047579036,NaN,NaN,19.28440813635686,9.612001924780206
2001-11-21T09:30:00-05:00,26.74001,26.74001,26.35001,26.55,34800,33920,61.44580874283063,59.46604662244723,NaN,NaN,91.69407466186883,123.34678127279003,0.12076484288515954,0.45356699864104755,0.332802155755888,1025100,1001780,71.76179444583846,43.45461317677496,NaN,NaN,19.90754316034104,11.082793529860325
2001-11-23T09:30:00-05:00,26.60001,26.89999,26.53999,26.87,22400,34785,64.44210143930468,60.388526108128204,NaN,NaN,102.3363519923514,117.64446863509718,0.11571014750824504,0.47743984014119434,0.3617296926329493,1047500,1020580,73.68067256143597,47.73495100284061,NaN,NaN,21.296685460384108,12.54192094850658
2001-11-26T09:30:00-05:00,26.89999,27.00999,26.71001,27,43200,36405,65.61134734052375,61.153609852015684,NaN,NaN,102.63277440371117,110.30613022195186,0.11147472097406091,0.5010730938505255,0.38959837287646454,1090700,1044780,75.94651879615154,51.85288824522793,NaN,NaN,22.792136096546628,14.006237398226586
2001-11-27T09:30:00-05:00,26.8,27.25,26.71001,26.82001,398600,55295,62.54479318784444,61.480745817406735,NaN,NaN,95.93302570568461,100.51741239704634,0.08793791329130063,0.49952076449059035,0.4115828511992897,692100,969140,58.88306646603486,54.12877257097243,NaN,NaN,23.234640769458828,15.324580736974049
2001-11-28T09:30:00-05:00,26.62,26.74001,26.39,26.39999,30400,56385,55.97066150477625,61.38819176560422,NaN,NaN,52.93132964654786,89.10551128203278,0.03801863004741374,0.4591061387585569,0.42108750871114314,661700,903420,48.654539075363274,55.19564395940596,NaN,NaN,21.727816667581955,16.239328727060894
2001-11-29T09:30:00-05:00,26.60001,26.60001,26.36,26.55,43100,57595,57.68151292580307,61.249428999334626,NaN,NaN,46.418763710267115,80.05044909171244,0.010471504308372404,0.4341768890966087,0.4237053847882363,704800,839360,41.15083923378756,55.40748330413964,NaN,NaN,20.93264362586347,16.90980228403269
2001-11-30T09:30:00-05:00,26.55,26.67,26.5,26.5,48500,57535,56.88805176781434,61.13669429953358,NaN,NaN,46.829268336522865,68.94903236054674,-0.014397158293295853,0.40570893692161647,0.4201060952149123,656300,761120,34.2110658837195,54.913379133593416,NaN,NaN,20.053204316296245,17.358859717213196
2001-12-03T09:30:00-05:00,26.37,26.37,26.05,26.27,9600,57560,53.25875443763337,61.03690972487649,NaN,NaN,-8.230034849410462,46.77647050992241,-0.04773772115499947,0.360433943771163,0.40817166492616247,646700,672320,28.364391934460485,53.99221542177812,NaN,NaN,18.272631192386285,17.48939849938078
2001-12-04T09:30:00-05:00,26.37,26.62,26.32001,26.59,10800,56735,57.33688285862381,60.812362913469435,NaN,NaN,31.426073620759862,33.87508009293746,-0.04943202055125728,0.34638163923709087,0.39581365978834815,657500,665400,27.963332252680942,53.12465313022733,NaN,NaN,17.828412663016962,17.53782909418595
2001-12-05T09:30:00-05:00,26.89999,27.37,26.89999,27.16,69500,57390,63.45355635749053,60.94637034659085,NaN,NaN,142.33948683254525,51.75671153013693,-0.015135155595006666,0.37689471529458984,0.3920298708895965,727000,678460,29.97569423865656,52.1197076613568,NaN,NaN,19.289240193494155,17.788030679801405
2001-12-06T09:30:00-05:00,27.36,27.60001,27.25,27.49001,93100,60350,66.45244612396942,61.214935155260214,NaN,NaN,190.0337864037294,80.47971606882939,0.024641270520312286,0.42283145903998687,0.3981901885196746,820100,701520,33.507725109099866,50.96813035933332,NaN,NaN,21.47670653639142,18.31498437359998
2001-12-07T09:30:00-05:00,27.2,27.39999,27.07001,27.19,18900,60270,61.51092187926778,61.00246028067767,NaN,NaN,129.22969659672233,96.9598017208693,0.02550446643066062,0.43007077155800033,0.4045663051273397,801200,730500,37.75677222130664,49.677667634670065,NaN,NaN,21.792122402502486,18.81171837772891
2001-12-10T09:30:00-05:00,27.19,27.19,26.67,26.77,12000,60090,55.310056493900056,60.205393360097425,NaN,NaN,54.035085732565136,109.4128258372644,-0.005783257952402032,0.3973372326868372,0.4031204906392392,789200,759000,41.70228155797938,48.02899866829723,NaN,NaN,20.073202482927943,18.991930392757343
2001-12-11T09:30:00-05:00,26.85001,27.05,26.64999,26.64999,47400,61210,53.64591758754702,59.68234376052352,NaN,NaN,23.715076007372016,107.87062631458684,-0.03642455991250154,0.3575897907486123,0.39401435066111384,741800,775860,43.96518641487324,46.25170572795633,NaN,NaN,18.16580571004838,18.873912580941777
2001-12-12T09:30:00-05:00,26.87,26.89999,26.61,26.78,16300,60750,55.217851921105314,59.237489701828856,NaN,NaN,11.34368456186773,81.67146586045133,-0.04901571789240866,0.332744703295603,0.3817604211880117,758100,782080,44.81621417232504,44.327021422705364,NaN,NaN,17.056629064948527,18.6143006500856
2001-12-13T09:30:00-05:00,26.56,26.73,26.48,26.59,27900,59080,52.42012091738006,58.378776807405664,NaN,NaN,-39.80703297745365,35.70330198421472,-0.06994391987007254,0.29433052135042104,0.36427444122049357,730200,764100,42.792997085236166,42.1207588886911,NaN,NaN,15.29476860905242,18.14008178708086
2001-12-14T09:30:00-05:00,26.25,26.63,26.25,26.32001,31000,57715,48.648124182174236,57.167118010380705,NaN,NaN,-98.25549015633607,-9.793735366396964,-0.09994588716745811,0.23934208226117093,0.33928796942862904,699200,743700,40.555891738852374,39.59285695602687,NaN,NaN,12.649798928073503,17.355755664365525
2001-12-17T09:30:00-05:00,26.7,26.89,26.64,26.72,17000,57755,53.93643501887982,56.55223528402608,NaN,NaN,1.4470723085126675,-20.31133805120745,-0.09107800677918226,0.2254404609546512,0.31651846773383346,716200,729100,38.98509601105745,38.17157335209991,NaN,NaN,11.917078252593413,16.57880174839808
2001-12-18T09:30:00-05:00,27.25,27.37,27.14,27.36,36400,54545,60.87854084847788,56.90279809429048,NaN,NaN,141.9223576148179,3.3301182702817202,-0.042787665145540055,0.2630338863019084,0.30582155144744844,752600,731260,39.35930610438058,37.507628139886855,NaN,NaN,13.540536095114511,16.144763797929
2001-12-19T09:30:00-05:00,27.2,27.66,27.2,27.62,11800,51135,63.29843476382222,57.30400679700614,NaN,NaN,161.64921667622303,33.39122469315278,0.0035272614454804896,0.31023062825429903,0.30670336680881854,764400,732520,39.59204831355539,37.39628593129885,NaN,NaN,15.66416929854822,16.0761074408746
2001-12-20T09:30:00-05:00,27.63,27.64,27.38,27.46001,3893700,244080,60.80595538929899,57.58385705568361,NaN,NaN,137.8812794931079,68.92888718726509,0.019365311205135127,0.33091000581523744,0.3115446946101023,-3129300,-39380,11.209110978791188,35.753289152375395,NaN,NaN,16.61199381528172,16.152662637218477
2001-12-21T09:30:00-05:00,27.67999,27.77,27.45,27.77,1077300,296825,63.781766719373046,58.33550079009359,NaN,NaN,146.71770645530927,117.92352650959415,0.04521967644216718,0.3680692901628113,0.32284961372064414,-2052000,-589620,7.230133477388236,34.24369926258452,NaN,NaN,18.350011201766147,16.466569575011
2001-12-24T09:30:00-05:00,27.64999,27.8,27.57001,27.8,162900,302810,64.06611313657189,58.81616009566131,NaN,NaN,132.51165035856252,144.13644211960414,0.05802537314217887,0.39538133014836774,0.33735595700618887,-1889100,-1110680,5.3084290469529805,32.62549189074681,NaN,NaN,19.82613884198067,16.946508041720953
2001-12-26T09:30:00-05:00,27.8,28.02,27.67,27.89999,104800,288120,65.05097552826864,58.93026146500261,NaN,NaN,131.6424873814123,142.080468072923,0.06631546814436412,0.420250292186644,0.3539348240422799,-1784300,-1618060,4.151356480198032,30.780896336571203,NaN,NaN,21.332636555891852,17.573097829459652
2001-12-27T09:30:00-05:00,27.89999,27.98,27.83,27.89,40600,288630,64.85970856894758,58.81649449678675,NaN,NaN,120.83469773200903,133.9175642840802,0.06417087797253812,0.4341484215079525,0.3699775435354144,-1824900,-2135920,3.3489909541748943,28.62670103979085,NaN,NaN,22.517901308277594,18.279498326433643
2001-12-28T09:30:00-05:00,28,28.12,27.91,28.05,1280200,350485,66.55578836460927,59.176842102882574,NaN,NaN,124.64971003121823,131.27125039170227,0.0663005585086936,0.4528532416712814,0.3865526831625878,-544700,-1619000,19.975493057278683,27.356609670931707,NaN,NaN,24.0043398096721,19.097332824039135
2001-12-31T09:30:00-05:00,27.89999,28.08,27.7,27.7,60600,351090,59.76078100552688,59.494750996570204,NaN,NaN,88.02539675045647,119.53278845073172,0.0382995068143146,0.43442706668048103,0.39612755986616643,-605300,-1329660,27.49410455366764,26.341739884909437,NaN,NaN,23.42230675597369,19.71518624288693
2002-01-02T09:30:00-05:00,27.60001,27.7,27.3,27.7,2623400,481780,59.76078100552689,59.931526954997345,NaN,NaN,45.85904632743741,102.20226764450669,0.015129847299447774,0.4150398689904762,0.3999100216910284,-605300,-1072900,33.46788857487863,25.591932896338395,NaN,NaN,22.944500491737603,20.176516849865596
2002-01-03T09:30:00-05:00,27.7,27.7,27.39,27.69,51800,483830,59.55929033779228,60.24162969904642,NaN,NaN,44.64848409783194,84.80346698779064,-0.004469657979729369,0.3943229492163667,0.39879260719609605,-657100,-847460,38.276452226552415,25.124807043068927,NaN,NaN,22.49266862661963,20.50739567511617
2002-01-04T09:30:00-05:00,27.8,27.96001,27.64999,27.7,1325400,546625,59.70559833527949,60.762020943182094,NaN,NaN,67.2842910429978,74.09338564998838,-0.019517480764971895,0.3743957562398812,0.3939132370048531,668300,-348820,47.34191441060245,25.44972970916652,NaN,NaN,22.146781043648424,20.741593584906493
2002-01-07T09:30:00-05:00,27.94,27.99001,27.50999,27.50999,1613300,622635,55.59022824737294,61.25788551926771,NaN,NaN,48.324663730131974,58.82837638977111,-0.043643252061531634,0.3393591719279385,0.38300242398947015,-945000,-428880,46.1694308925008,25.850696791569977,NaN,NaN,20.772080165172248,20.745948810658742
2002-01-08T09:30:00-05:00,27.7,27.75,27.28999,27.42999,226600,633020,53.90551777317487,61.255677144574506,NaN,NaN,18.008424134395334,44.82498186655888,-0.06507413982243665,0.30165974921142436,0.366733889033861,-1171600,-542140,44.49071958634015,26.243955618375885,NaN,NaN,19.148174156389167,20.51769528862023
2002-01-09T09:30:00-05:00,27.60001,27.8,27.2,27.28,180800,641460,50.797212256683295,60.535582245160604,NaN,NaN,3.8182317587107475,36.41681895281355,-0.08801076540527031,0.25672043227727315,0.34473119768254346,-1352400,-691560,42.30530813240516,26.454384334663356,NaN,NaN,16.892801231371667,19.999853280441865
2002-01-10T09:30:00-05:00,27.25,27.28999,26.99001,27,26100,640395,45.52034214185508,59.26571848644867,NaN,NaN,-60.118307800053664,15.463460573236427,-0.11878512260569912,0.19624979442541957,0.3150349170311187,-1378500,-835840,40.24939290146731,26.501337519514205,NaN,NaN,13.352425211869532,19.050220699217245
2002-01-11T09:30:00-05:00,26.95,27.12,26.56,26.56,34300,641295,38.71439821033731,57.68775011652283,NaN,NaN,-123.33467210770905,-22.66033205690493,-0.16279886637392899,0.11153633406370744,0.27433520043763643,-1412800,-1252060,34.96975196150248,28.198526161136442,NaN,NaN,7.926810801770487,17.461162142439136
2002-01-14T09:30:00-05:00,26.75,26.75,26.25999,26.25999,77600,643780,34.884532911840424,55.62366198741336,NaN,NaN,-175.04614696522046,-67.33449419597541,-0.20349864167060008,0.01996189834938633,0.22346054001998641,-1490400,-1361140,33.72134325868571,30.09075543122912,NaN,NaN,1.952948972840677,15.245703118210784
2002-01-15T09:30:00-05:00,26.03999,26.34,25.94,26.28999,82500,646355,35.570910646211004,53.58829038095901,NaN,NaN,-206.48480398704316,-112.23313982026312,-0.218463454452914,-0.04961877804615611,0.1688446764067579,-1407900,-1408400,33.16884882618784,32.08078541546018,NaN,NaN,-2.6705497789594514,12.686238418615037
2002-01-16T09:30:00-05:00,25.77,25.87,25.32001,25.39999,312000,661105,26.609611181085214,50.84247864187448,NaN,NaN,-253.32548196690516,-163.6618825653863,-0.2747279393950164,-0.17456524783701255,0.10016269155800381,-1719900,-1481900,32.282968995171345,34.090186309386844,NaN,NaN,-10.61707847442079,9.357193148181349
2002-01-17T09:30:00-05:00,25.7,25.75,25.5,25.50999,23100,660440,28.99071593913459,48.28040773974498,NaN,NaN,-186.70328084036112,-188.97887717344778,-0.28948495710264904,-0.2616935048203075,0.027791452282341533,-1696800,-1545560,31.498284105541515,36.10085010591303,NaN,NaN,-16.04393541435664,5.728460496390207
2002-01-18T09:30:00-05:00,25.39999,25.69,25.39999,25.67999,11500,660425,32.628655251417726,45.857041088802724,NaN,NaN,-150.45747100331315,-194.4034369525686,-0.2729634566248518,-0.3134128684987232,-0.04044941187387141,-1685300,-1600060,30.807888053071594,36.87459260561252,NaN,NaN,-19.266612964792323,2.157735716221275
2002-01-22T09:30:00-05:00,26.35001,26.35001,25.71001,25.83,15000,466490,35.75636466532873,44.142439921645725,NaN,NaN,-98.85575612360772,-179.16535878424605,-0.23835684743679425,-0.33839547116986424,-0.10003862373306999,-1670300,-1636040,30.33516465340533,37.077525469879504,NaN,NaN,-20.909961335844336,-1.1376495769309551
2002-01-23T09:30:00-05:00,25.52,25.71001,25.25999,25.7,27200,413985,34.27148280762147,42.32177576465248,NaN,NaN,-115.0676397337728,-160.881925933592,-0.21155529868991052,-0.36448274709545814,-0.15292744840554762,-1697500,-1693960,29.549129548517726,36.79761411085372,NaN,NaN,-22.710205926921105,-4.219443341215262
2002-01-24T09:30:00-05:00,25.7,26.02,25.7,25.92999,14500,406565,39.09065821424758,40.85973061297072,NaN,NaN,-78.609247066538,-125.93867895351858,-0.16759489397450816,-0.36242106587368283,-0.19482617189917467,-1683000,-1686580,29.79873439841724,36.19206283741549,NaN,NaN,-22.75725364773912,-6.867701956432956
2002-01-25T09:30:00-05:00,25.92,26.32001,25.92,26.28999,61600,404405,45.790609626458604,39.86580284805494,NaN,NaN,-49.75726829221946,-98.54947644389023,-0.10650521067936025,-0.327957685248375,-0.22145247456901473,-1621400,-1671500,30.34182019065669,34.97777039313365,NaN,NaN,-20.643787933076737,-8.835714238810638
2002-01-28T09:30:00-05:00,26.39999,26.39999,26.10001,26.27,15800,403165,45.491375040961174,39.14445619045409,NaN,NaN,-38.344280864781936,-76.12683841618399,-0.06188897671909341,-0.2988136954678815,-0.2369247187487881,-1637200,-1661880,30.710078017313137,33.87353090204882,NaN,NaN,-19.04965683939691,-10.294848896037248
2002-01-29T09:30:00-05:00,26.39999,26.39999,25.03999,25.27,195700,348940,33.64616387363573,37.69735948334415,NaN,NaN,-87.38294055582205,-73.83227530262684,-0.09233772958836295,-0.3523468807342418,-0.26000915114587886,-1832900,-1694400,30.130192950623822,32.847778999497656,NaN,NaN,-21.6548505484579,-11.917706274954483
2002-01-30T09:30:00-05:00,25.27,25.62,24.35001,25.55,261100,358965,38.47670769020098,36.817323442881126,NaN,NaN,-112.31555001481134,-73.28185735883456,-0.08634252196199926,-0.36793730359837795,-0.2815947816363787,-1571800,-1669260,31.211566749969606,32.05536890075226,NaN,NaN,-22.02616539455324,-13.36177186346859
2002-01-31T09:30:00-05:00,25.58,25.96001,25.5,25.95,95300,232560,44.67328045565823,36.75681903672421,NaN,NaN,-52.78354967836802,-68.11671788120056,-0.04996431289323494,-0.3440501727529224,-0.29408585985968744,-1476500,-1627960,33.044891817382066,31.54076168046046,NaN,NaN,-20.119364661488763,-14.327142263185758
2002-02-01T09:30:00-05:00,25.94,25.94,25.53,25.75,299800,244960,42.37513371674983,37.01830014432511,NaN,NaN,-54.368468725033786,-69.03895796776342,-0.034626352483218825,-0.337368800463711,-0.30274244798049216,-1776300,-1658940,32.34843628010616,31.353524846075004,NaN,NaN,-19.383075494062087,-15.049418439025233
2002-02-04T09:30:00-05:00,25.2,25.28,24.61,24.61,341500,195765,32.20524755835737,36.82692261907631,NaN,NaN,-138.7106006262218,-89.11222192005138,-0.09318973707173367,-0.41922961932015923,-0.32603988224842556,-2117800,-1755060,30.22027514641755,31.103448552341565,NaN,NaN,-22.664179774976887,-16.137241487018326
2002-02-05T09:30:00-05:00,24.64999,24.7,24.12,24.27,2663200,248260,29.900407142041047,36.42188665449275,NaN,NaN,-177.18107227585202,-107.07184826405737,-0.1437365342915552,-0.5057105501128696,-0.3619740158213144,-4781000,-2344680,21.065229141694104,30.238904289163436,NaN,NaN,-26.06872633972422,-17.556025037404883
2002-02-06T09:30:00-05:00,24.64999,24.83,24.38,24.45,1516500,312755,32.64855082286492,36.853239486048444,NaN,NaN,-147.13084760644466,-114.03490778238404,-0.15309615339915839,-0.5533442075702624,-0.400248054171104,-3264500,-2683220,17.741826816938556,29.200251276432528,NaN,NaN,-27.696250741748056,-19.004628709453907
2002-02-07T09:30:00-05:00,24.89999,25.03,24.64,24.74001,1814300,394430,36.93814153805605,37.420912743114265,NaN,NaN,-110.5437570489914,-125.5869492565087,-0.1287802821962547,-0.5612234069164224,-0.43244312472016766,-1450200,-2677960,17.958403288256207,28.23311693234072,NaN,NaN,-27.51834865796289,-20.22087441638376
2002-02-08T09:30:00-05:00,24.67999,25.07001,24.53999,24.89,158100,401030,39.098524491607336,37.88304626027066,NaN,NaN,-99.54270844447333,-134.62179720039663,-0.0932741771929656,-0.5490358462113747,-0.4557616690184091,-1292100,-2581120,22.02865225085796,27.606028660754028,NaN,NaN,-26.66813868819567,-21.141912169499747
2002-02-11T09:30:00-05:00,25,25.59,25,25.42999,39300,401280,46.23917817916708,38.63181865411626,NaN,NaN,-24.10885738768008,-111.70144855268828,-0.027514059523641055,-0.49015424342296043,-0.4626401838993194,-1252800,-2408120,28.8223542824922,27.49797077711738,NaN,NaN,-23.50905478618974,-21.480075400455462
2002-02-12T09:30:00-05:00,25.39,25.50999,25.21001,25.21001,11300,397965,43.97704403787221,39.325073027705606,NaN,NaN,-21.57878361832523,-80.58099082118291,0.005324633271131141,-0.45598439231040544,-0.4613090255815366,-1264100,-1704740,48.47817845235055,28.85004569881972,NaN,NaN,-21.69414051742079,-21.51065613145051
2002-02-13T09:30:00-05:00,25.63,25.75,25.39999,25.48,34300,395555,47.37964621794876,39.91714359939855,NaN,NaN,19.712824476461048,-47.212256404601774,0.04706396103330068,-0.4024790742899107,-0.4495430353232114,-1229800,-1297800,56.041544401976715,30.7245321276454,NaN,NaN,-19.10535353349928,-21.167041474600335
2002-02-14T09:30:00-05:00,25.5,25.63,25.35001,25.57001,8800,380395,48.50259074580662,40.110856536494836,NaN,NaN,15.561651231956466,-21.991174748412206,0.08060081840566091,-0.3487920123161352,-0.4293928307217961,-1221000,-1251960,56.810673510661275,32.61516450764572,NaN,NaN,-16.68450076265747,-20.526678515751353
2002-02-15T09:30:00-05:00,25.35001,25.67999,25.33,25.39,11400,379810,46.371292187165714,40.17370776122373,NaN,NaN,8.588861305244878,-0.36486079846856934,0.0898227176123988,-0.31711443370629766,-0.40693715131869646,-1232400,-1240020,57.02160983192903,34.49455963726115,NaN,NaN,-15.298194892887393,-19.779752283913645
2002-02-19T09:30:00-05:00,25.10001,25.42999,25.10001,25.32001,54700,381970,45.53350354677978,41.022803452162584,NaN,NaN,-18.75711357621596,0.7054879638242426,0.0901375401355744,-0.29426522614922845,-0.38440276628480285,-1287100,-1246880,56.849815643141994,36.403104115298156,NaN,NaN,-14.39798341866684,-19.010928160306957
2002-02-20T09:30:00-05:00,25.55,25.69,25.11,25.69,28700,382655,50.613168941659005,41.88969354155245,NaN,NaN,20.8592813921835,9.193100965925982,0.11272613007493426,-0.24349510369113503,-0.3562212337660693,-1258400,-1245740,56.87306885611792,38.2360685514516,NaN,NaN,-12.10623969920316,-18.024544094434987
2002-02-21T09:30:00-05:00,25.85001,26.09,25.57001,25.59,24200,382505,49.275551700560335,42.2184272019026,NaN,NaN,61.31905638163248,17.51434734696027,0.1178407652354238,-0.20892027722178952,-0.3267610424572133,-1282600,-1256300,56.56896474250672,39.9163594746748,NaN,NaN,-10.5829643264267,-16.9614612704338
2002-02-22T09:30:00-05:00,25.8,25.96001,25.39999,25.84,94500,386505,52.64500046478034,42.951989112476205,NaN,NaN,60.81311952651068,26.564641005871113,0.13380254583610396,-0.1595078601620834,-0.29331040599818736,-1188100,-1249720,56.72424168718809,41.65748843232351,NaN,NaN,-8.296850351981472,-15.723659710654898
2002-02-25T09:30:00-05:00,25.99001,26.57001,25.99001,26.52,560300,411440,60.35840683617025,44.96292906089142,NaN,NaN,162.8549946116057,57.41786766714328,0.18286299651405172,-0.06473166035562272,-0.24759465686967444,-627800,-1128800,59.58392449131362,43.75489195695894,NaN,NaN,-3.6932972578153005,-14.005036503106384
2002-02-26T09:30:00-05:00,26.7,26.75,26.28,26.62,197500,420525,61.35529433543995,47.20970671756277,NaN,NaN,186.0232680382495,98.37394399003638,0.2126661957028616,0.018238087758902566,-0.19442810794395904,-430300,-957440,63.28643061363593,46.770692062097645,NaN,NaN,0.33692989894201586,-11.956184159956612
2002-02-27T09:30:00-05:00,26.82001,27.12,26.66,26.94,2123800,516930,64.43724125918342,49.480327463014085,NaN,NaN,203.20112655247164,134.842313022094,0.24239216654624096,0.10856210023884216,-0.1338300663073988,1693500,-367060,72.59972663784903,50.689113477876965,NaN,NaN,4.751962803809396,-9.569306022275754
2002-02-28T09:30:00-05:00,27.10001,27.25,26.60001,26.60001,150200,511385,59.0489827870474,51.059673266513464,NaN,NaN,160.56073598921822,154.69064894361114,0.22783996692594605,0.15096989235003377,-0.07687007457591227,1543300,198120,78.28007479041733,54.99780429945991,NaN,NaN,6.897731845489023,-7.2168720411665
2002-03-01T09:30:00-05:00,26.8,27.22,26.61,27.22,33400,508290,64.82523229211012,52.89729525226367,NaN,NaN,156.55127445462963,173.83827992923494,0.24704230575996547,0.23193280762404456,-0.015109498135920905,1576700,751080,82.17383789314914,59.293888988194986,NaN,NaN,10.733387424880519,-4.65254926030264
2002-03-04T09:30:00-05:00,27.55,28.34,27.44,28.14999,320300,509315,71.35268153825623,54.69111692077003,NaN,NaN,205.03902723136315,182.27508645318642,0.30561513342815955,0.3669094186492785,0.06129428522111898,1897000,1256040,84.84560054541016,63.29554943554627,NaN,NaN,16.63611800292499,-1.6113110798415504
2002-03-05T09:30:00-05:00,28.05,28.25,27.67999,27.8,332700,508875,66.36163752072488,56.290016455259504,NaN,NaN,161.36613022997514,177.34365889153156,0.3034122443091184,0.44055959060751704,0.13714734629839861,1564300,1654960,86.55944268457782,66.01563973784822,NaN,NaN,19.59293154779211,1.4178664383918291
2002-03-06T09:30:00-05:00,27.85001,28.64999,27.85001,28.64,145600,382995,71.51213658894648,58.01376576747363,NaN,NaN,165.10115676011065,169.72366493305935,0.338482636304468,0.5602506416789836,0.22176800537451563,1709900,1658240,86.5728885078292,68.1964500311234,NaN,NaN,24.06988271188609,4.653868763176723
2002-03-07T09:30:00-05:00,28.7,28.7,28.11,28.3,304400,322390,67.0378977065563,59.33771626467003,NaN,NaN,141.922225385488,165.99596281231328,0.3190004371984218,0.6205185518725429,0.3015181146741211,1405500,1630680,85.79623305807115,70.26684714165268,NaN,NaN,25.987788734506545,7.7015716162238395
2002-03-08T09:30:00-05:00,28.52,28.7,28.21001,28.49001,124100,237880,68.23404206053502,60.899341255624975,NaN,NaN,130.04707073399356,160.6951220681861,0.2994439533957457,0.6758230564188032,0.37637910302305755,1529600,1621260,85.51384955835294,72.30200712211153,NaN,NaN,27.88582922964539,10.585036989569776
2002-03-11T09:30:00-05:00,28.39999,28.78,28.25,28.55,105800,235265,68.62120347003449,62.54846267871461,NaN,NaN,118.39602235911427,143.36652109373634,0.2718860265902074,0.7162366362608168,0.4443506096706094,1635400,1568940,83.86286762561134,74.23151083514506,NaN,NaN,29.48999385298952,13.285745112915453
2002-03-12T09:30:00-05:00,28.35001,28.69,28.2,28.49001,138300,240215,67.73218683628731,63.77124967118806,NaN,NaN,101.9249929498882,131.47829363771893,0.23248105582831446,0.7349519294560025,0.502470873627688,1497100,1555500,83.41733614410454,76.1275299271441,NaN,NaN,30.507641854048938,15.746016075934522
2002-03-13T09:30:00-05:00,28.39999,28.47,28.10001,28.10001,226200,250960,62.09956561356976,64.68725066497444,NaN,NaN,78.69936929605322,114.19793614490746,0.16612592252214298,0.7101282767803667,0.5440023542582237,1270900,1467700,80.41189040925032,77.83059604619721,NaN,NaN,29.675218879641747,17.73590219074984
2002-03-14T09:30:00-05:00,28.22,28.31,28.10001,28.13,147100,256600,62.358789829300015,65.38109276244013,NaN,NaN,68.12163255955353,99.43781757972056,0.11278154122473283,0.6849792807891397,0.5721977395644069,1418000,1470200,80.43350742468121,79.52411502744671,NaN,NaN,29.076318980485322,19.355961732140624
2002-03-15T09:30:00-05:00,28.2,28.2,27.92,28.07001,139300,263125,61.45334090019321,65.45930233844177,NaN,NaN,54.55700718820246,84.33980487056235,0.06438908250515729,0.6526840926958535,0.5882950101906962,1278700,1420020,78.55947495459941,80.87951148910999,NaN,NaN,28.330258116269203,20.63800407273042
2002-03-18T09:30:00-05:00,28.3,28.3,27.81,27.96001,220400,273575,59.74043629266211,65.34395533538621,NaN,NaN,46.53754343652737,69.96810908604496,0.018298928462387676,0.6111686707686808,0.5928697423062931,1058300,1304600,74.27294516745499,81.6642625286685,NaN,NaN,27.234989999694832,21.58043063372534
2002-03-19T09:30:00-05:00,28.14999,28.39,28.10001,28.25999,132800,277480,62.78671728548865,65.22606076583659,NaN,NaN,56.58716309286428,60.90054311464017,0.0021901952757830134,0.5956074864010219,0.5934172911252389,1191100,1243400,72.02871209166914,81.62347577536994,NaN,NaN,27.08876910516158,22.3673361296448
2002-03-20T09:30:00-05:00,28.2,28.25999,27.8,27.95,111700,281630,57.91034229491155,65.1447293021126,NaN,NaN,33.51916005741089,51.86450126691172,-0.0332141700396823,0.551899578575636,0.5851137486153183,1079400,1205100,70.5911727289872,81.07426848526778,NaN,NaN,25.581777732930917,22.82654207297139
2002-03-21T09:30:00-05:00,27.95,27.95,27.07001,27.39,176200,289230,50.308851905422465,64.10784498877776,NaN,NaN,-20.59793581771483,34.12058759145803,-0.09473606074122176,0.46669367268879114,0.5614297334300129,903200,1102140,66.73528769796908,79.97151489989778,NaN,NaN,21.88128164515184,22.691504868997168
2002-03-22T09:30:00-05:00,27.39,27.53,26.98,27.23,91000,289055,48.355825740259505,62.465212431778,NaN,NaN,-57.484370787551256,11.712311996307296,-0.14365984303089674,0.381854929641392,0.5255147726722887,812200,1008840,63.35796401431506,78.43668371910528,NaN,NaN,18.223876284815994,22.05327221411414
2002-03-25T09:30:00-05:00,27.44,27.44,26.75,26.8,158600,268970,43.47153217452693,60.83020490704956,NaN,NaN,-95.696735047904,-16.734543700578985,-0.1990260489126972,0.27673221153141725,0.47575826044411446,653600,927900,60.497598562219586,76.57512342465111,NaN,NaN,13.484575315028977,20.829172657101974
2002-03-26T09:30:00-05:00,26.83,27.34,26.83,26.97,184600,268325,45.80229972503004,58.99378798819839,NaN,NaN,-98.40273888001705,-47.732524095155256,-0.2167836341760117,0.20477871772409983,0.42156235190011154,838200,857320,58.03706719233734,74.53685047354455,NaN,NaN,10.230118421985237,19.315022052085297
2002-03-27T09:30:00-05:00,27.14999,27.44,26.92,27.14999,73000,165785,48.23587489683072,57.65078635893228,NaN,NaN,-87.18496840976646,-71.87334978859073,-0.208906350458549,0.16042941382692533,0.3693357642854743,911200,823680,56.85025445175595,72.46928057309347,NaN,NaN,8.198808293845273,17.726991515193866
2002-03-28T09:30:00-05:00,27.25,27.48,27.21001,27.24001,13800,158965,49.4582087823496,56.309655410490464,NaN,NaN,-76.82730637957198,-83.11922390096215,-0.1906401031065122,0.1310356354023341,0.3216757385088463,925000,828040,56.973064060388516,70.43065303752458,NaN,NaN,6.8547774462611715,16.17381807677491
2002-04-01T09:30:00-05:00,26.98,27.28999,26.73,27.23,15000,158045,49.318747784984836,54.930908575844065,NaN,NaN,-110.29281593832665,-93.68091293111723,-0.17276897503990535,0.10571451970896462,0.27848349474886996,910000,847600,57.556684448782704,68.55163995346538,NaN,NaN,5.708596858875635,14.67878647421787
2002-04-02T09:30:00-05:00,27,27.12,26.88,26.97,115700,147815,45.71313301291095,53.35811901703146,NaN,NaN,-105.85879642234359,-95.71332520600515,-0.17164233648665078,0.06393057414055647,0.23557291062720725,794300,875740,58.43027339396593,66.76684975702692,NaN,NaN,3.7027548353288426,13.11078195437658
2002-04-03T09:30:00-05:00,26.8,27,26.41,26.60001,189200,140640,41.10749675034589,51.85868552680118,NaN,NaN,-125.13404249138776,-101.05958592827929,-0.18769797705912086,0.0009504393033061831,0.18864841636242705,605100,829120,56.36057941657941,65.04889897183614,NaN,NaN,0.5653867906288061,11.318582645269757
2002-04-04T09:30:00-05:00,26.5,26.88,26.5,26.81,274800,147100,44.5237425760158,50.58475358013802,NaN,NaN,-105.06188827069109,-104.63496990046421,-0.1762407037839503,-0.03165246336751082,0.14458824041643947,879900,822860,56.073361480641594,63.308888547261894,NaN,NaN,-1.1569239510568219,9.536367417223103
2002-04-05T09:30:00-05:00,27.25,27.25,26.89999,26.92999,153700,139565,46.43577413094433,49.512070239477396,NaN,NaN,-65.25401205805917,-102.32031103616166,-0.1534813798499642,-0.0472634843960158,0.10621789545394841,1033600,844580,56.89417080695461,61.761366822430105,NaN,NaN,-2.0731203179128825,7.877869169346534
2002-04-08T09:30:00-04:00,26.75999,27.14,26.7,27.14,156000,141160,49.70321495940262,48.79512585853029,NaN,NaN,-63.70484683106878,-93.00271721471009,-0.11873654968111971,-0.04220279164745122,0.07653375803366849,1189600,900500,59.01744168371722,60.67168800216314,NaN,NaN,-1.9464384385525908,6.474396653932374
2002-04-09T09:30:00-04:00,27.3,27.3,27.09,27.12,97100,140725,49.39419713289087,47.83851727620188,NaN,NaN,-37.81253782347557,-79.39346549493649,-0.09270889405271368,-0.0393523595322236,0.05335653452049007,1092500,960140,61.21187955740166,59.89905710685832,NaN,NaN,-1.9241944617746327,5.274597923117087
2002-04-10T09:30:00-04:00,27.36,27.75,27.33,27.75,95900,138605,58.20840412479886,47.85980740690811,NaN,NaN,29.076169548012206,-48.551423087056484,-0.03181662345911393,0.01358575519659766,0.04540237865571159,1188400,1076800,65.14354423552157,59.50994078589648,NaN,NaN,0.7883368487661971,4.633703483924102
2002-04-11T09:30:00-04:00,27.60001,27.60001,26.82001,26.86,218100,138200,46.01518810249909,47.55311713527073,NaN,NaN,-42.70417445264886,-36.079880323448045,-0.04919429357153378,-0.01609048830870563,0.03310380526282815,970300,1094880,65.72342183517254,59.43766465283959,NaN,NaN,-0.7850708394904735,3.8595928662934487
2002-04-12T09:30:00-04:00,27.02,27.05,26.7,26.82001,38100,132750,45.553445562102794,47.35294712254525,NaN,NaN,-78.13208085726346,-38.6554940832889,-0.060361303827533117,-0.04234782452158825,0.018013479305944866,932200,1074600,64.42867015813506,59.51414366311245,NaN,NaN,-2.1514251988965807,3.00087599983773
2002-04-15T09:30:00-04:00,26.71001,26.71001,26.39999,26.53999,93900,130480,42.34892263537187,47.27276072689131,NaN,NaN,-129.84264051122457,-51.88305281932006,-0.08223077790067554,-0.08477499306989955,-0.002544215169224019,838300,1004340,60.0173553831623,59.47984057889407,NaN,NaN,-4.319769382049269,1.955069516711016
2002-04-16T09:30:00-04:00,26.77,27.10001,26.77,27.00999,329400,135930,48.85260285425602,47.49063952183604,NaN,NaN,-45.66417850022862,-53.453380954670685,-0.06160997019177833,-0.07955667790894694,-0.017946707717168605,1167700,1019380,60.63862979027538,59.665666478746786,NaN,NaN,-4.049396670199125,1.09728863286671
2002-04-17T09:30:00-04:00,26.95,27,26.7,26.82001,305800,144580,46.56587627261816,47.371353905820854,NaN,NaN,-71.25839474176983,-73.5202938126271,-0.05741601403171903,-0.0897167252568174,-0.032300711225098366,861900,954080,56.531376064655326,59.64288945109674,NaN,NaN,-4.559664808170806,0.2891524270042076
2002-04-18T09:30:00-04:00,26.78,26.83,26.2,26.62,392200,158605,44.21913462206656,46.997134322943495,NaN,NaN,-152.6218576108728,-95.50383044427187,-0.06424717275161473,-0.11260967716461678,-0.04836250441300205,469700,853960,50.84491556819288,59.20516455879705,NaN,NaN,-5.711075521888414,-0.5680229942661669
2002-04-19T09:30:00-04:00,26.61,26.73,26.46001,26.47,39700,151780,42.48969521765515,46.50934485384852,NaN,NaN,-135.03009408236463,-106.88343308929211,-0.07429260558815329,-0.14122826139819367,-0.06693565581004038,430000,753520,45.861042854662635,58.36976158778848,NaN,NaN,-7.180958760809519,-1.5127281037723599
2002-04-22T09:30:00-04:00,26.35001,26.44,25.98,26.05,525900,173525,38.00734894643569,45.95893170624314,NaN,NaN,-208.31117719412563,-122.57714042587232,-0.10288752633637273,-0.19554506373050629,-0.09265753739413356,-95900,566680,38.333608850463726,56.93428554896689,NaN,NaN,-9.878364706919625,-2.707819047079112
2002-04-23T09:30:00-04:00,26.05,26.24001,25.86,26,574300,194310,37.50017091663154,45.70126557526355,NaN,NaN,-193.1261496488546,-152.06953465559752,-0.11776287665078235,-0.2398611332076115,-0.12209825655682914,-670200,199100,28.44262649923124,54.94014605487059,NaN,NaN,-12.19806992209577,-4.0635691720814915
2002-04-24T09:30:00-04:00,25.89999,26.17999,25.75999,25.78,39300,187045,35.27001195012738,45.04028481627152,NaN,NaN,-180.22802448537314,-173.86346060431816,-0.13383987299783034,-0.28939809780411707,-0.15555822480628673,-709500,-115180,22.982461004056518,52.576510306543085,NaN,NaN,-14.830309579763155,-5.601674944607443
2002-04-25T09:30:00-04:00,25.27,25.57001,25.09,25.47,159400,191365,32.350518434959724,44.03419512370119,NaN,NaN,-225.10115220921048,-188.3593195239857,-0.15526579668389914,-0.34964047066116066,-0.19437467397726152,-868900,-382900,19.54107549467625,49.90843206995178,NaN,NaN,-17.996867975839102,-7.372416806211966
2002-04-26T09:30:00-04:00,25.5,25.69,25.2,25.21001,90200,195185,30.10016651748367,42.633977377849824,NaN,NaN,-185.99167612137774,-198.55163593178833,-0.17537573855063318,-0.413594347165553,-0.2382186086149198,-959100,-660720,16.739807677018163,46.888601069473275,NaN,NaN,-21.382736792907732,-9.373891090025646
2002-04-29T09:30:00-04:00,25.34,25.34,24.64999,24.66,303500,209610,25.982519764970704,40.96171470871268,NaN,NaN,-202.60663004698776,-197.41072650236077,-0.21171533420243682,-0.5028627763679658,-0.291147442165529,-1262600,-894060,14.81840653499225,43.5747815678726,NaN,NaN,-25.77959881836462,-11.7175636226455
2002-04-30T09:30:00-04:00,24.78999,25.53999,24.74001,25.36,313800,219515,37.66928759765398,39.494634956773744,NaN,NaN,-133.68579223619903,-185.52265501982964,-0.1760671207526987,-0.5112313431064024,-0.3351642223537037,-948800,-949780,14.393550193871732,39.94978199346904,NaN,NaN,-25.71489010131767,-13.717181691027239
2002-05-01T09:30:00-04:00,25.3,25.47,24.78,25.44,61700,213140,38.85746205571558,38.98336881057492,NaN,NaN,-112.38760077752248,-171.95457027825952,-0.13633274043268706,-0.5055801478945625,-0.36924740746187545,-887100,-985300,14.115713271137153,36.26351709603794,NaN,NaN,-25.27649621833421,-15.368512337785377
2002-05-02T09:30:00-04:00,25.52,25.57001,25.37,25.53,42900,201545,40.23766479966032,38.60367018468617,NaN,NaN,-76.69137409453403,-142.27261465532425,-0.09517126522402036,-0.4882114889919009,-0.39304022376788056,-844200,-980360,14.363296174534796,32.6874189543522,NaN,NaN,-24.49742192333715,-16.672642278578486
2002-05-03T09:30:00-04:00,25.39999,25.63,25.3,25.53999,35700,195645,40.39849378499971,38.46435383823102,NaN,NaN,-69.01116431979804,-118.8765122950083,-0.06016220385055476,-0.468242978581074,-0.40808077473051924,-808500,-950240,15.954170267317025,29.540048588934678,NaN,NaN,-23.826226236346642,-17.694582843973937
2002-05-06T09:30:00-04:00,25.49001,25.50999,24.78,24.82001,173000,196495,33.4183895539052,37.36191003106311,NaN,NaN,-100.76071967640323,-98.50733022089136,-0.07729244734870133,-0.5046963339163959,-0.42740388656769457,-981500,-894020,18.979625089608604,26.564405396029912,NaN,NaN,-25.41735483376789,-18.797835985373073
2002-05-07T09:30:00-04:00,24.89999,25.14999,24.77,24.84,73100,195295,33.76059757543189,36.44724726697837,NaN,NaN,-101.31424246955676,-92.03302026756293,-0.07880527954630823,-0.5259104860005799,-0.44710520645427165,-908400,-885940,19.42853682261243,23.914202593026854,NaN,NaN,-26.57190564969384,-19.908417365990324
2002-05-08T09:30:00-04:00,25.48,25.89,25.39999,25.87,277900,204395,48.45972975613526,36.750146919411854,NaN,NaN,-19.95792123319778,-73.54708435869799,-0.005814023931400958,-0.4543727363685228,-0.44855871243712186,-630500,-834620,22.370605961495556,21.880323335405617,NaN,NaN,-22.53205163907312,-20.28322226214501
2002-05-09T09:30:00-04:00,25.64999,25.75,25.39999,25.42999,229900,204985,43.970735732111024,36.85593552758728,NaN,NaN,-34.557994062357345,-65.12040835226267,0.016249275656678386,-0.4282471178662739,-0.4444963935229523,-860400,-837860,22.315205222858765,20.198477790276772,NaN,NaN,-20.753994415565113,-20.35047542691931
2002-05-10T09:30:00-04:00,25.67,25.67,25.05,25.05,60500,206105,40.48306313198122,37.03277225512624,NaN,NaN,-59.87845024281332,-63.29386553686571,0.009028625219549946,-0.43321061199851485,-0.4422392372180648,-920900,-860340,21.909779047144312,19.02534709003967,NaN,NaN,-20.499214127931563,-20.371723812778203
2002-05-13T09:30:00-04:00,25.05,25.34,24.98,25.21001,381300,220475,42.54951510658629,37.39343969726586,NaN,NaN,-64.522500968697,-56.04622179532447,0.01827284105684457,-0.41939818589700906,-0.4376710269538536,-539600,-771960,27.487611729140625,18.957131749318908,NaN,NaN,-19.61834463840208,-20.264098216438757
2002-05-14T09:30:00-04:00,25.69,25.85001,25.58,25.77,48700,206440,49.19746799355473,38.3882579860821,NaN,NaN,16.31232778015477,-32.52090774538216,0.06283646070075077,-0.35912545107791516,-0.42196191177866593,-490900,-688460,32.40042184260746,19.629843237786837,NaN,NaN,-16.602566279509613,-19.74102222544888
2002-05-15T09:30:00-04:00,25.69,26.12,25.67,25.87,55700,193935,50.30339226907888,39.67060611709061,NaN,NaN,52.714763726788746,-17.98637075338486,0.09770279563652445,-0.2998334172330104,-0.39753621286953483,-435200,-649400,34.63150969163601,20.707731394712532,NaN,NaN,-13.872599604107311,-18.9026761366858
2002-05-16T09:30:00-04:00,26.06,26.06,25.87,26.03,33700,176010,52.10010745369469,41.24203046967712,NaN,NaN,81.40396441168167,5.206020941422942,0.12826968488820883,-0.2371991067592738,-0.36546879164748264,-401500,-557620,39.67006510851723,22.34560692553389,NaN,NaN,-11.096293365463245,-17.787478597939717
2002-05-17T09:30:00-04:00,26.17999,26.3,26.10001,26.25999,91800,178615,54.63880317882838,43.288907856381236,NaN,NaN,135.22268455696036,44.22624790137768,0.15871364376769398,-0.16707673693786518,-0.32579038070555916,-309700,-435380,45.67598351899895,24.54971956724865,NaN,NaN,-8.004842492178879,-16.389959154259596
2002-05-20T09:30:00-04:00,26.22,26.22,25.94,26.05,82100,156425,51.93242159024982,44.30770314156665,NaN,NaN,108.29587370404182,78.78992283592545,0.15904439341561277,-0.1269848889360432,-0.286029282351656,-391800,-405820,47.0487558345381,26.882234255867676,NaN,NaN,-6.213038143291113,-14.936113295549813
2002-05-21T09:30:00-04:00,26.11,26.35001,25.60001,25.64999,166600,136040,47.142209882818285,44.899470843502556,NaN,NaN,71.42094485742001,89.8116462513785,0.12799430164131143,-0.1260364053000167,-0.2540307069413281,-558400,-419320,46.47118611071594,29.193339458694734,NaN,NaN,-6.09944991313558,-13.67373281234778
2002-05-22T09:30:00-04:00,25.55,25.87,25.52,25.75999,137700,140960,48.547698899860364,45.493044707802554,NaN,NaN,44.06779655040274,88.0822528161013,0.11115892534976074,-0.11508205025412721,-0.22624097560388795,-420700,-416420,46.622772845464404,31.49758779233256,NaN,NaN,-5.596002949426198,-12.519771403358982
2002-05-23T09:30:00-04:00,25.82001,26.24001,25.72,26.24001,76000,136790,54.26298063181722,46.48336519686095,NaN,NaN,103.2856444311109,92.45858881998717,0.12747605387214223,-0.06689590826371017,-0.1943719621358524,-344700,-405060,47.252912885302315,33.73321226504579,NaN,NaN,-3.4002996778065246,-11.21698972828006
2002-05-24T09:30:00-04:00,26.14,26.22,25.95,25.95,22200,133390,50.60560327587016,47.71102331985844,NaN,NaN,87.24688490927966,82.86342889045102,0.11428509991918237,-0.05151558723687444,-0.1658006871560568,-366900,-416500,46.65557917005849,35.71006612793507,NaN,NaN,-2.651912487341399,-9.993407265288823
2002-05-28T09:30:00-04:00,26.05,26.05,25.63,25.66,20000,119215,47.18105361064069,48.66962732237336,NaN,NaN,32.526925255711106,67.70963920078489,0.08303070245688915,-0.06201230908494537,-0.14504301154183452,-386900,-415520,46.71771698857063,37.659293282646374,NaN,NaN,-3.060038868204409,-9.002926065705335
2002-05-29T09:30:00-04:00,25.58,25.58,25.36,25.37,239100,115480,43.976206547129514,48.349375664587235,NaN,NaN,-41.72205935825294,45.08103835765029,0.04190365194413426,-0.0926634466116667,-0.13456709855580096,-626000,-429040,45.92296393071305,39.341604566161905,NaN,NaN,-4.384283217213986,-8.343119944492285
2002-05-30T09:30:00-04:00,25.14999,25.42999,25.10001,25.25999,59600,115375,42.78882875038475,48.26495373732108,NaN,NaN,-79.47184285755512,20.37311047605872,0.008135596123053201,-0.12439760340198447,-0.13253319952503767,-685600,-482020,42.846935748345075,40.80815674655379,NaN,NaN,-5.821033404400405,-7.982821867336302
2002-05-31T09:30:00-04:00,25.32001,25.7,25.32001,25.47,52000,115830,45.79755405396285,48.644560231748336,NaN,NaN,-29.572377039229853,-6.198493818009431,0.0011545789982042864,-0.13108997577728232,-0.1322445547754866,-633600,-539800,39.72199545329128,42.08045791842143,NaN,NaN,-6.173982454799028,-7.724416236973834
2002-06-03T09:30:00-04:00,25.60001,25.60001,24.50999,24.50999,49900,116540,36.37919488346774,48.20382307295415,NaN,NaN,-141.27762814785066,-51.903396429435496,-0.06334145930878446,-0.21142137891146717,-0.1480799196026827,-683500,-603120,36.57394412371032,42.7294816608907,NaN,NaN,-9.668756053888751,-8.002179067961679
2002-06-04T09:30:00-04:00,24.5,24.60001,24.14999,24.31,72400,111510,34.774787485466206,47.17363160809068,NaN,NaN,-212.1246754302462,-100.83371656662696,-0.11185874088578507,-0.28790334570991405,-0.17604460482412898,-755900,-676920,33.264937763669664,42.79123279810943,NaN,NaN,-13.009451294699026,-8.7175036717813
2002-06-05T09:30:00-04:00,24.37,24.72,24.37,24.72,80600,111885,40.562201450433115,46.477832263901696,NaN,NaN,-158.53394745081823,-124.19609418514001,-0.10863440578380237,-0.31183761205388194,-0.20320320627007957,-675300,-686780,32.83747256393475,42.6630872889879,NaN,NaN,-13.98014690276377,-9.46930984763594
2002-06-06T09:30:00-04:00,24.60001,24.66,24.10001,24.13,38600,99920,35.6588877784868,45.30345942995829,NaN,NaN,-171.85936897042657,-142.6735994077143,-0.13671851675553548,-0.3741013522144989,-0.23738283545896344,-713900,-692440,32.57866821174784,42.15655893921866,NaN,NaN,-16.47683816367636,-10.470385321355998
2002-06-07T09:30:00-04:00,23.89999,24.35001,23.58,24.13,144200,95635,35.6588877784868,43.94775118707674,NaN,NaN,-170.81188432549362,-170.92150086496707,-0.14498990886952406,-0.41862022154586853,-0.27363031267634447,-713900,-708500,31.812518404769236,41.1663114310594,NaN,NaN,-18.413122824068232,-11.605062107457746
2002-06-10T09:30:00-04:00,24.06,24.45,24.06,24.32001,11400,93180,38.4384201022678,42.98389393793517,NaN,NaN,-120.12633859980765,-166.69124295535846,-0.12795301696443578,-0.4335715838818892,-0.3056185669174534,-702500,-712300,31.623019612597858,40.064473129492235,NaN,NaN,-19.169400217119236,-12.685681837409387
2002-06-11T09:30:00-04:00,24.39999,24.59,23.94,24.03,57500,76990,35.88996274428126,42.18016199946824,NaN,NaN,-113.40208877329424,-146.94672562396806,-0.1262886091427809,-0.46347932834592953,-0.33719071920314864,-760000,-713120,31.57930507355846,39.00076734112385,NaN,NaN,-20.581068837306436,-13.813594265966108
2002-06-12T09:30:00-04:00,23.92999,24.12,23.62,24.02,66900,77900,35.80181957705287,41.26974204783913,NaN,NaN,-119.95202907040093,-139.2303419478846,-0.11618920620705181,-0.4824272269619634,-0.3662380207549116,-826900,-743440,29.931696918969322,37.808547632088484,NaN,NaN,-21.7436985828772,-14.94646631123912
2002-06-13T09:30:00-04:00,24.19,24.27,23.96001,23.96001,48800,77555,35.242644661623586,39.911146621396725,NaN,NaN,-93.9296468348702,-123.64439752077332,-0.10425776544783083,-0.4965602275647001,-0.39230246211686925,-875700,-775800,28.23831785632929,36.45036227287612,NaN,NaN,-22.861519730974315,-16.07718822834415
2002-06-14T09:30:00-04:00,23.74001,23.91,23.58,23.84,24900,77115,34.09538573265969,38.73184536831027,NaN,NaN,-106.04518365206546,-110.69105738608769,-0.0953962163593906,-0.5115477325661075,-0.4161515162067169,-900600,-813140,26.383482160926874,35.00235534365243,NaN,NaN,-24.121820896383404,-17.226421466635472
2002-06-17T09:30:00-04:00,23.96001,24.50999,23.96001,24.50999,24100,73730,44.88276496320197,38.56768189349322,NaN,NaN,-53.303850687259875,-97.32655980357814,-0.03828997125303368,-0.464013980273009,-0.4257240090199753,-876500,-847940,24.75170321493927,33.43335435982162,NaN,NaN,-22.09619125674757,-17.922102865222914
2002-06-18T09:30:00-04:00,24.52,24.82001,24.44,24.74001,231200,81185,48.02798914785168,38.85709493640195,NaN,NaN,-17.918808110771405,-78.22990367107357,0.018070923970093578,-0.40313535405735834,-0.4212062780274519,-645300,-825000,27.916626359508797,32.14718739044989,NaN,NaN,-19.43982755484511,-18.138920678026086
2002-06-19T09:30:00-04:00,24.60001,24.99001,24.5,24.55,86800,77195,45.707664483709834,39.06558320306802,NaN,NaN,-11.801837671063545,-56.599865391206116,0.04416359644224921,-0.36600178247464044,-0.41016537891688964,-732100,-806040,30.517801809452095,31.26653496624325,NaN,NaN,-17.876125014834475,-18.101378440427283
2002-06-20T09:30:00-04:00,24.62,24.64999,24.35001,24.36,120800,76350,43.447297541579495,38.89770773789778,NaN,NaN,-31.39551079775057,-44.093038183782184,0.04981689268689682,-0.34789426305826865,-0.39771115574516547,-852900,-801480,31.16119881277156,30.65504949192041,NaN,NaN,-17.20140767114391,-17.972811187672516
2002-06-21T09:30:00-04:00,24.06,24.17,23.67999,23.69,38100,74455,36.577954339421005,38.91190484189444,NaN,NaN,-97.15801738254704,-42.31560492987849,0.011616807350053271,-0.38319014655759887,-0.39480695390765214,-891000,-799560,31.44903152389284,30.28898430621916,NaN,NaN,-18.74179070706981,-18.082665404729273
2002-06-24T09:30:00-04:00,23.82001,24.25999,23.44,24.02,199600,83325,41.48524370857088,39.39122314354478,NaN,NaN,-85.59888101202625,-48.77461099483176,0.011723970378993198,-0.3801519909339106,-0.3918759613129038,-691400,-762540,36.92526729351816,30.550436415494055,NaN,NaN,-18.48813662513451,-18.140589864787163
2002-06-25T09:30:00-04:00,24,24.19,23.38,23.50999,116200,88135,36.752260988274784,39.1190845391049,NaN,NaN,-112.81537286414019,-67.75392394550552,-0.017798440197661525,-0.4141240115599807,-0.39632557136231916,-807600,-795000,34.3352340440114,30.65741937835667,NaN,NaN,-19.819894789074034,-18.380490568256715
2002-06-26T09:30:00-04:00,23,23.5,22.7,23.5,343500,93355,36.664023552986954,39.190879951569194,NaN,NaN,-175.27103238010037,-100.44776288731288,-0.03239380543660042,-0.4368178281580697,-0.40442402272146927,-1151100,-878800,28.73211905345481,30.38266586705003,NaN,NaN,-20.891059839323255,-18.73914332126622
2002-06-27T09:30:00-04:00,23.73,23.87,23.34,23.87,37100,92230,42.19910826951956,39.65803855807154,NaN,NaN,-91.06673998253791,-112.38200872427035,-0.012544168570004288,-0.4201042334339746,-0.40756006486397034,-1114000,-931020,25.896145467496055,29.96006780010194,NaN,NaN,-20.094384482992307,-18.932749201512802
2002-06-28T09:30:00-04:00,23.98,24.21001,23.85001,23.85001,22000,90730,41.98562190297529,39.91141011526493,NaN,NaN,-34.780788675442324,-99.90656298284941,0.0029947175265888637,-0.40381666795573423,-0.4068113854823231,-1136000,-980020,23.547471667341824,29.383242946869363,NaN,NaN,-19.518911684087456,-19.016486699023467
2002-07-01T09:30:00-04:00,23.97,24.00999,23.32001,23.32001,71900,91830,36.68631873496529,39.96829268602807,NaN,NaN,-110.90558640067766,-104.96790406057968,-0.01753733782297051,-0.4287330577610362,-0.4111957199380657,-1207900,-1083320,19.526731130759927,28.522344808098037,NaN,NaN,-20.63861332522208,-19.248219074194697
2002-07-02T09:30:00-04:00,23.24001,23.5,22.78999,22.96001,158900,96155,33.58546778383902,39.809981843655656,NaN,NaN,-179.51664552342348,-118.30815859243634,-0.048712662202338275,-0.47208654769098857,-0.4233738854886503,-1366800,-1195160,16.28466347248657,27.54755670477784,NaN,NaN,-22.573082292218473,-19.72319953391238
2002-07-03T09:30:00-04:00,22.95,22.99001,22.39999,22.99001,26500,93450,34.085457916028304,39.72732564754171,NaN,NaN,-202.14825035196574,-123.68360218680941,-0.059924804496853945,-0.4982798911097177,-0.43835508661286376,-1340300,-1233000,15.355695640362029,26.627369403637324,NaN,NaN,-23.972303059498785,-20.330214323281865
2002-07-05T09:30:00-04:00,23.19,23.94,23.19,23.94,17400,92390,47.55085562877042,40.68843064012105,NaN,NaN,-36.66815400693841,-112.80388499168953,0.000811541301181995,-0.43734065998638627,-0.43815220128756827,-1322900,-1274780,14.380276832172214,25.76999759444056,NaN,NaN,-20.77460615446081,-20.39369887059314
2002-07-08T09:30:00-04:00,24,24,23.47,23.53999,173100,93835,43.51943857909005,40.59105018411305,NaN,NaN,-36.65832887094702,-113.17939303079046,0.017304210132368603,-0.4165219386221075,-0.4338261487544761,-1496000,-1346780,12.863787900585876,24.920860786272467,NaN,NaN,-19.469599164425716,-20.261684626854937
2002-07-09T09:30:00-04:00,23.61,23.75999,22.95,22.95,175700,102050,38.35440522890418,39.900079904188225,NaN,NaN,-105.23747712990426,-112.04577117663578,-0.006962293137036835,-0.44252901517577214,-0.4355667220387353,-1671700,-1439540,11.22187421907985,23.728378490527543,NaN,NaN,-20.13993647471926,-20.244292033692698
2002-07-10T09:30:00-04:00,23.16,23.17999,22.31,22.39,207600,109555,34.20481551843136,39.07844783523977,NaN,NaN,-178.14131884488532,-111.77070584092814,-0.053574005430548355,-0.5025342288269208,-0.4489602233963724,-1879300,-1542040,9.742140269125088,22.244402666218466,NaN,NaN,-22.1655133376641,-20.518752219974328
2002-07-11T09:30:00-04:00,21.95,22.5,21.75,22.42,98300,111125,34.61294651914437,38.44742276220869,NaN,NaN,-196.1051548272029,-110.56208673597557,-0.07397327121340469,-0.5414268124131283,-0.4674535411997236,-1781000,-1630180,8.681981387431165,20.638744278694155,NaN,NaN,-23.585234259690736,-20.956821082790956
2002-07-12T09:30:00-04:00,22.57001,22.82001,22.07001,22.35001,50200,111195,34.08178424689579,38.26912489845689,NaN,NaN,-141.85377176853686,-131.59921028829527,-0.08308624827910799,-0.5713113515486086,-0.4882251032695006,-1831200,-1731840,7.6481814465965385,18.938683558887274,NaN,NaN,-24.876212949352,-21.51673420658539
2002-07-15T09:30:00-04:00,22.08,22.17999,21.31,22.17999,32900,111595,32.76636085583635,37.646347551832996,NaN,NaN,-166.59754355803628,-157.5870532257131,-0.09084179145761961,-0.6017773425915252,-0.5109355511339055,-1864100,-1805460,6.99829115345004,16.801042406025267,NaN,NaN,-26.335098060666805,-22.205071900025594
2002-07-16T09:30:00-04:00,21.8,22.14999,21.62,21.72,27000,111740,29.454116973700607,37.12505155079198,NaN,NaN,-147.57553710640957,-166.05466522101418,-0.1156381241437281,-0.6554832063135656,-0.5398450821698375,-1891100,-1849340,6.63632733885477,14.822549069942653,NaN,NaN,-28.640832255104918,-23.124466236465498
2002-07-17T09:30:00-04:00,22.22,22.25,21.58,21.98,55900,102975,33.543352867494704,36.90214650182825,NaN,NaN,-122.85523805057649,-154.99744906215238,-0.10360378637664902,-0.6693498151406487,-0.5657460287639997,-1835200,-1840520,7.6700461461739025,13.318115290851162,NaN,NaN,-29.334786086985876,-24.011654786539836
2002-07-18T09:30:00-04:00,21.95,21.95,21.34,21.34,39600,100615,29.07558802439307,35.96475219860493,NaN,NaN,-139.77012532171722,-143.73044316105526,-0.12631532121957623,-0.72364018028847,-0.5973248590688938,-1874800,-1859280,7.48033430869269,12.00270020807949,NaN,NaN,-31.398086426216654,-25.06685930649367
2002-07-19T09:30:00-04:00,21.17,21.17,20.48,20.67999,98500,99500,25.328840945685386,34.77498213022708,NaN,NaN,-177.85602473138957,-150.9308937536258,-0.17060341297451553,-0.8105791252870382,-0.6399757123125227,-1973300,-1887700,7.190190843064514,10.834323006345397,NaN,NaN,-34.47906317796786,-26.41145985956141
2002-07-22T09:30:00-04:00,20.55,20.63,19.74001,20.02,115200,103355,22.24226851330316,33.74326425725121,NaN,NaN,-192.61898420214834,-156.1351818824482,-0.22570350160116903,-0.9221050893139839,-0.6964015877128149,-2088500,-1932580,6.745249017914858,9.921359998285036,NaN,NaN,-38.204927734016245,-28.09624098448353
2002-07-23T09:30:00-04:00,20.14999,20.17,19.57001,19.57001,99900,98370,20.415546907145725,32.80255562320169,NaN,NaN,-183.54154018319895,-163.3283824978061,-0.2707757693724533,-1.0348712994283815,-0.7640955300559282,-2188400,-1992040,6.1980160530506225,9.200885182611037,NaN,NaN,-41.89099158489528,-30.066919641685207
2002-07-24T09:30:00-04:00,19.10001,20.67,19.10001,20.62,55600,95340,34.03017030999169,32.798606508484795,NaN,NaN,-137.69830726588202,-166.2969963408672,-0.2108576584238797,-1.0276676030857779,-0.8168099446618982,-2132800,-2051560,5.699547946460868,8.511160347332382,NaN,NaN,-40.12807799587114,-31.504227977997484
2002-07-25T09:30:00-04:00,20.39999,20.89,20.13,20.64,47100,80520,34.26086145331935,31.84932121023829,NaN,NaN,-98.15553108227488,-157.97407749297872,-0.15352558678113437,-1.0087169281383161,-0.8551913413571818,-2085700,-2093740,5.369950886350821,7.867565636916568,NaN,NaN,-38.72941602564745,-32.53639769909034
2002-07-26T09:30:00-04:00,20.7,21.06,20.61,20.97,117600,84545,38.10675650189099,31.46270106186693,NaN,NaN,-70.58103676271801,-136.51907989924442,-0.08068644475686315,-0.9560493973032607,-0.8753629525463975,-1968100,-2092700,5.515034069639782,7.342654648991849,NaN,NaN,-36.32079711139017,-33.07702618656174
2002-07-29T09:30:00-04:00,21,22.41,21,22.28,105100,88700,50.48940635804047,32.32948685680523,NaN,NaN,-2.2663741950989036,-98.4485578978345,0.06077909164488715,-0.7993890879902885,-0.8601681796351757,-1863000,-2047600,11.828178283530022,7.385962082166862,NaN,NaN,-29.482345979493157,-32.563500442694796
2002-07-30T09:30:00-04:00,22.14,22.67999,21.87,22.53999,76400,88925,52.51967750187171,33.63769128419383,NaN,NaN,35.086035801432864,-54.72304270090816,0.17069475231996434,-0.6467997392352203,-0.8174944915551846,-1786600,-1967240,21.848228453828213,8.250682666788515,NaN,NaN,-23.477166087591986,-31.26545267768011
2002-07-31T09:30:00-04:00,22.2,22.5,21.85001,22.5,61800,84070,52.165339776951896,34.89143365975151,NaN,NaN,33.37787783687909,-20.50780568035595,0.2355405308920614,-0.5230688279401079,-0.7586093588321693,-1848400,-1910360,28.078449646652345,9.636144685304313,NaN,NaN,-18.972573449515533,-29.5093270736566
2002-08-01T09:30:00-04:00,22.42999,22.49001,21.95,22,41900,84840,47.821059658905654,35.872810474895076,NaN,NaN,26.341967183618642,4.391693972822743,0.23884444959779083,-0.46005379683493075,-0.6988982464327216,-1890300,-1871280,32.08447202191829,11.38159401211301,NaN,NaN,-16.5695622974131,-27.660789248478956
2002-08-02T09:30:00-04:00,21.75,22,21.06,21.2,56500,86795,41.82004192607657,36.51950197991223,NaN,NaN,-21.35515720335765,14.236869884694809,0.18371225196601026,-0.4692579314752088,-0.652970183441219,-1946800,-1867020,32.525669116759346,13.204978152349387,NaN,NaN,-16.485532463571058,-26.064323993492113
2002-08-05T09:30:00-04:00,21.2,21.2,20.5,20.5,29400,79610,37.39778171393838,37.086906604214924,NaN,NaN,-67.81811695890983,1.126521331932625,0.10080659860944619,-0.5269619351794113,-0.6277685337888574,-1976200,-1889660,31.35970020282481,14.970933356918678,NaN,NaN,-17.93304866368333,-24.902713232090857
2002-08-06T09:30:00-04:00,21.10001,21.75999,21,21.2,36200,72635,43.79801981007004,37.81938281439888,NaN,NaN,-11.299763711091469,-8.150638570572236,0.09395410332530596,-0.510325904632225,-0.604280007957531,-1940000,-1920340,29.800684164380755,16.551693215362025,NaN,NaN,-16.94332084596732,-23.76565717693035
2002-08-07T09:30:00-04:00,21.82001,21.82001,21.17999,21.73,277500,76130,48.122629121480216,39.179885749905104,NaN,NaN,18.130059393199822,-11.200202259308089,0.12406632999700962,-0.44919709546126896,-0.5732634254582786,-1662500,-1883160,34.07778219325402,18.45151092140212,NaN,NaN,-14.661980018452372,-22.465131868576353
2002-08-08T09:30:00-04:00,21.85001,22.56,21.72,22.36,28600,72645,52.77443698961947,41.140285467328965,NaN,NaN,80.33972556667075,-0.4006505826976678,0.18186778970440354,-0.3459286883277741,-0.5277964780321777,-1633900,-1831880,39.54852780841718,20.762820704641598,NaN,NaN,-11.180756471388785,-20.853078240406703
2002-08-09T09:30:00-04:00,22.12,22.56,22.05,22.53,22300,71250,53.97377668049164,43.40682176498529,NaN,NaN,96.96152812385503,23.26268648274487,0.22422363738180728,-0.24751693130491859,-0.47174056868672587,-1611600,-1764840,45.87267472355847,23.55763682647328,NaN,NaN,-8.05405294712586,-19.024646055652298
2002-08-12T09:30:00-04:00,22.39999,22.46001,22.05,22.27,44400,71825,51.80676790127931,45.64905183599483,NaN,NaN,81.64242994331481,53.15479586318979,0.22672546467810772,-0.18833373783909124,-0.41505920251719897,-1656000,-1700800,51.131908194132464,26.76720055083627,NaN,NaN,-6.181404212730759,-17.18989722094922
2002-08-13T09:30:00-04:00,22.24001,22.36,21.75,21.75,18900,71420,47.68333296616921,46.624277740007514,NaN,NaN,51.33077046796874,65.68090269900183,0.1870070683908268,-0.18130036702866548,-0.3683074354194923,-1674900,-1647780,55.027933850798256,30.29065668686037,NaN,NaN,-5.872260696225716,-15.573092003131578
2002-08-14T09:30:00-04:00,21.75999,22.31,21.16,22.22,50000,71125,51.44504383236675,47.8517193385109,NaN,NaN,46.239807383051506,71.30285229697218,0.18566121811090863,-0.13623091278085653,-0.32189213089176516,-1624900,-1640260,55.56899378621017,33.8763026082789,NaN,NaN,-4.445842501036542,-13.983484931403716
2002-08-15T09:30:00-04:00,22.39,22.56,21.97,22.39999,36800,70985,52.8434163492869,48.90433789903917,NaN,NaN,78.20827206146163,70.87656159593034,0.18950616780900315,-0.08500942113051124,-0.2745155889395144,-1588100,-1631100,56.259313767552534,37.500894015272664,NaN,NaN,-2.86658030183989,-12.395355698608883
2002-08-16T09:30:00-04:00,22.32001,22.62,22.21001,22.38,26500,67385,52.662016925847134,49.05952436816822,NaN,NaN,79.5419491924497,67.39264580964928,0.18320887245430648,-0.045504498371631286,-0.22871337082593776,-1614600,-1631700,56.19772188671502,40.67014712978588,NaN,NaN,-1.6407919429096411,-10.858989447794706
2002-08-19T09:30:00-04:00,22.5,23.05,22.45,22.91,59700,64610,56.887673812954894,49.37152410467416,NaN,NaN,109.47664691599019,72.95948920418437,0.20556623586014797,0.028244423999247203,-0.17732181186090076,-1554900,-1611480,57.87158055583746,43.24324370850082,NaN,NaN,0.6694933202427379,-9.21206333807507
2002-08-20T09:30:00-04:00,22.91,22.91,22.53999,22.8,18900,60560,55.77485507481268,49.629346625949935,NaN,NaN,102.62837726749237,83.21901056408907,0.20339994243397644,0.0769281161815698,-0.12647182625240663,-1573800,-1591260,59.536783513306524,45.49026755611898,NaN,NaN,2.26916448554163,-7.571887934701256
2002-08-21T09:30:00-04:00,22.8,23.13,22.61,22.87,25200,59040,56.359890446742206,50.2392631107954,NaN,NaN,115.01728449244438,96.97450598596765,0.1969998465635066,0.11977798195197664,-0.07722186461152997,-1548600,-1576000,60.796224905661894,47.54110704781495,NaN,NaN,3.7577840319632725,-5.9533633680348945
2002-08-22T09:30:00-04:00,23,23.34,22.92999,23.2,32600,58315,59.10632695599683,51.4739977557897,NaN,NaN,144.30988451018268,110.19482847571187,0.2044251790378207,0.1783096091857459,-0.02611556985207479,-1516000,-1561580,61.999868931752005,49.646407034600145,NaN,NaN,5.810639311031548,-4.272791556739689
2002-08-23T09:30:00-04:00,23.11,23.11,22.64999,22.66,20900,53480,53.20559925512282,52.60312758016001,NaN,NaN,93.80088354521276,113.04661534626447,0.16413948010215124,0.17905878027561428,0.014919300173463032,-1536900,-1546040,63.30730430914798,51.92837875648037,NaN,NaN,5.989320524989735,-2.806775545064057
2002-08-26T09:30:00-04:00,22.86,22.94,22.39,22.94,31000,49775,55.67649624751129,53.4515901828344,NaN,NaN,79.45808304923754,107.04290257291396,0.14801765115547938,0.19994136411781227,0.05192371296233288,-1505900,-1536240,64.1451099447257,54.381552026505005,NaN,NaN,6.836717900478084,-1.4291336242723227
2002-08-27T09:30:00-04:00,23.14999,23.28,22.69,22.74001,37700,47840,53.503409124127465,53.835931611594916,NaN,NaN,92.73176936121492,105.06358099165845,0.11691719807568451,0.19807021055693852,0.081153012481254,-1543600,-1530200,64.68038276661214,56.56745206745916,NaN,NaN,6.94909756841026,-0.23224345388909673
2002-08-28T09:30:00-04:00,22.55,22.55,22.17,22.3,22100,45855,48.974303402389175,53.564493498221324,NaN,NaN,12.65825484994626,84.59177506315885,0.06247477710107732,0.15924648385760065,0.09677170675652333,-1565700,-1533620,64.09688716412613,58.320906307152654,NaN,NaN,5.747072745893007,0.6219445746512038
2002-08-29T09:30:00-04:00,21.8,22.17999,21.8,22.13,33700,45445,47.30806460529265,53.08837120713569,NaN,NaN,-28.830080641754225,49.96378203277146,0.013345039281432963,0.11345300585831453,0.10010796657688156,-1599400,-1550300,61.19719977341266,59.41551523928509,NaN,NaN,4.264686335066574,1.1423362547105422
2002-08-30T09:30:00-04:00,22.14999,22.46001,21.99001,22.14999,45800,44910,47.534109436182796,52.78318131677165,NaN,NaN,-12.762641410108255,28.65107704170726,-0.0177850477161339,0.0778766569317142,0.0956617046478481,-1553600,-1553640,60.60595860030843,60.09223312544052,NaN,NaN,3.0976222396824933,1.4216628239922495
2002-09-03T09:30:00-04:00,21.75999,21.75999,21.33,21.38,152100,51045,40.35311670438635,52.259594440930016,NaN,NaN,-140.0734315894102,-15.255225886022297,-0.08637555403055244,-0.012307737890342452,0.07406781614020999,-1705700,-1593600,53.896913504657235,60.01144595785902,NaN,NaN,-0.14861500592281376,1.197337419718669
2002-09-04T09:30:00-04:00,21.25,21.71001,21,21.59,37200,51095,42.88725913863146,51.648324105663214,NaN,NaN,-152.76299975627822,-64.35417970952092,-0.11211235803812587,-0.06607263140744735,0.046039726630678526,-1668500,-1618580,50.158866663754615,59.625008306255054,NaN,NaN,-2.154205086958563,0.7185456330504931
2002-09-05T09:30:00-04:00,21.07001,21.42,21,21.21001,40200,39230,39.6080836957211,50.70294320183708,NaN,NaN,-179.31534625214218,-102.7488999299386,-0.14703638259363233,-0.1377557516113619,0.009280630982270444,-1708700,-1647180,46.20746423592906,58.90701905399623,NaN,NaN,-4.87043411151778,-0.07988004474497457
2002-09-06T09:30:00-04:00,21.2,21.62,21.2,21.48,36800,39640,42.94605235579981,50.00894573254799,NaN,NaN,-123.52626373178374,-121.68813654794451,-0.144072673139592,-0.17081021044221956,-0.02673753730262756,-1671900,-1661680,44.30194644680026,58.05732080828803,NaN,NaN,-6.218399593488102,-0.9568114088511357
2002-09-09T09:30:00-04:00,21.32001,21.89999,21.25,21.66,75600,42305,45.12374902844413,49.16866539079722,NaN,NaN,-86.77661011776726,-136.4909302894763,-0.12293160936459234,-0.18040204900836798,-0.05747043964377564,-1596300,-1670220,43.172710387310026,57.00740151053607,NaN,NaN,-6.733613047874249,-1.7820687858544373
2002-09-10T09:30:00-04:00,21.85001,21.98,21.67999,21.89999,44800,42325,47.97496050763117,48.61153006456997,NaN,NaN,-47.67069291514597,-118.01038255462345,-0.08739697389544884,-0.1667166570130867,-0.07931968311763785,-1551500,-1639380,48.29791458278819,56.20462515835619,NaN,NaN,-6.367778908111296,-2.4371702318911312
2002-09-11T09:30:00-04:00,22.22,22.22,21.88,21.89999,27300,42745,47.97496050763116,48.01260649749061,NaN,NaN,-28.53982728579623,-93.16574806052706,-0.05981991660523896,-0.15409457887418654,-0.09427466226894758,-1551500,-1615980,51.84659891037416,55.56536615869278,NaN,NaN,-6.067068879392559,-2.955727181534192
2002-09-12T09:30:00-04:00,22,22,21.50999,21.60001,47600,42625,44.61456653648327,46.97748075323965,NaN,NaN,-65.74578568044679,-70.45183594618798,-0.057683831167509025,-0.16637945122833386,-0.10869562006082484,-1599100,-1594060,54.96491187516003,55.062869226079066,NaN,NaN,-6.721031111733357,-3.4936277429912157
2002-09-13T09:30:00-04:00,21.13,21.17999,20.89999,21.08,21500,41860,39.455331160480476,45.99531874647947,NaN,NaN,-129.71404784677924,-71.6893927691871,-0.08551595859207456,-0.21559056830091805,-0.1300746097088435,-1620600,-1583800,56.38850284265161,54.56866912132932,NaN,NaN,-8.824903281858619,-4.2552385342579875
2002-09-16T09:30:00-04:00,20.89999,21.32001,20.89999,21.28999,92100,45140,42.354323105840066,45.04373495064582,NaN,NaN,-103.04687310698212,-74.94344536703008,-0.08389077239333348,-0.23493807520051035,-0.15104730280717688,-1528500,-1570240,58.2661735235694,54.148745091246724,NaN,NaN,-9.779685210988047,-5.044445202362281
2002-09-17T09:30:00-04:00,21.50999,22.06,20.85001,20.85001,177400,51025,38.22449597215816,43.95238401121943,NaN,NaN,-85.81637734852715,-82.5725822537063,-0.105175870556458,-0.2825171410027494,-0.1773412704462914,-1705900,-1601120,52.701453627586844,53.293107295602056,NaN,NaN,-11.860203351096064,-6.018124937895679
2002-09-18T09:30:00-04:00,20.64999,20.91,20.57001,20.82001,71700,53665,37.95275791192474,43.165130761900535,NaN,NaN,-127.16471549642029,-102.2975598958311,-0.1133012081981121,-0.3189677806939315,-0.2056665724958194,-1777600,-1646340,45.802904252990956,51.98639423052098,NaN,NaN,-13.631916142827333,-7.105809395743058
2002-09-19T09:30:00-04:00,20.5,20.8,20.31,20.41,284200,66615,34.35781410109196,42.240112868743346,NaN,NaN,-141.93515931515347,-117.53543462277244,-0.13674543332156414,-0.3765983641477746,-0.23985293082621045,-2061800,-1738880,35.54795665969627,50.15430543668409,NaN,NaN,-16.2678580906378,-8.414673495013735
2002-09-20T09:30:00-04:00,20.14999,20.45,20.14999,20.41,40400,67005,34.35781410109196,41.29894891623686,NaN,NaN,-149.76016688410283,-121.54465843023715,-0.14208470447654753,-0.4174588114218949,-0.27537410694534736,-2061800,-1827120,28.90285212310667,47.88979783116968,NaN,NaN,-18.413594824454858,-9.843090827791038
2002-09-23T09:30:00-04:00,20.2,20.28,19.96001,20.14999,62900,69105,32.120167313634695,40.71088110261174,NaN,NaN,-158.07890485415442,-132.5510647796716,-0.1520656388056172,-0.46545615545236885,-0.31339051664675166,-2124700,-1946360,22.721703176873362,45.66299709347083,NaN,NaN,-20.917873770763652,-11.425202676787125
2002-09-24T09:30:00-04:00,19.92,20,19.64,19.72,77000,71405,28.78178052157419,39.70334691567907,NaN,NaN,-173.9668557974087,-150.18116046944792,-0.17493379876316945,-0.5320577651007135,-0.357123966337544,-2201700,-2045520,19.06941447144004,43.44232193687693,NaN,NaN,-24.15793997447985,-13.244165147886084
2002-09-25T09:30:00-04:00,20.17999,20.22,19.75999,20.10001,165300,77785,35.19248257602196,39.38794683570057,NaN,NaN,-133.03518533389004,-151.35525443694186,-0.15258961813963678,-0.54786098901209,-0.39527137087245323,-2036400,-2097280,17.489131386902613,41.39101244766075,NaN,NaN,-25.079706749798518,-14.934956805302146
2002-09-26T09:30:00-04:00,20.25,20.60001,20.13,20.49001,532300,103295,41.05661561747655,39.252987068677484,NaN,NaN,-79.96940132128715,-138.96210283816862,-0.10209321615177813,-0.5228878910621759,-0.4207946749103978,-1504100,-1985740,30.79789970029725,40.42643768005339,NaN,NaN,-24.07432302383415,-16.24058055080672
2002-09-27T09:30:00-04:00,20.45,20.45,19.69,19.71001,35900,103405,34.36011752984386,38.48415624734889,NaN,NaN,-114.30500455756325,-131.87107037286071,-0.11103262762119276,-0.5595854594368888,-0.448552831815696,-1540000,-1881380,40.4724891064198,40.233564731418376,NaN,NaN,-25.369093266281673,-17.54465379587457
2002-09-30T09:30:00-04:00,19.60001,19.67999,19.02,19.52,147000,108465,32.9502140536643,37.41096007206555,NaN,NaN,-149.1563367116925,-130.08655674436832,-0.11885178748794989,-0.5971175661756334,-0.4782657786876835,-1687000,-1793840,47.1472813637711,40.151376644345724,NaN,NaN,-26.8633506591758,-18.875896204917602
2002-10-01T09:30:00-04:00,19.64,20.37,19.5,20.37,91900,105455,44.01692658520959,37.12824336332115,NaN,NaN,-72.64091009899462,-109.82136760468549,-0.05891700626033447,-0.5519120365131016,-0.49299503025276714,-1595100,-1672520,54.72426101044238,40.35692393720774,NaN,NaN,-24.34386141300415,-19.657034091787107
2002-10-02T09:30:00-04:00,20,20.25,19.64999,19.67,140700,110630,38.39641657477858,36.68408979462796,NaN,NaN,-85.54605975716385,-100.32354248934027,-0.05844034277864185,-0.5660454587260695,-0.5076051159474276,-1735800,-1612400,57.94198517919144,40.569572030352845,NaN,NaN,-24.202764352879065,-20.306424129085958
2002-10-03T09:30:00-04:00,19.5,20.00999,19.47,19.50999,91800,113210,37.226272517876176,36.52487132015623,NaN,NaN,-94.00383123727264,-103.13042847253735,-0.06066176544493651,-0.5834323227535982,-0.5227705573086617,-1827600,-1677100,53.53266044628916,40.36558328775552,NaN,NaN,-24.488509154759804,-20.903864847039365
2002-10-04T09:30:00-04:00,19.58,19.58,18.85001,19,47700,113755,33.701015083754555,35.90677789000726,NaN,NaN,-130.20463286539393,-106.3103541341035,-0.0866544911401228,-0.6310886712338153,-0.5444341800936925,-1875300,-1744160,49.341493535623684,39.7281061457594,NaN,NaN,-25.92593899138465,-21.621304010517264
2002-10-07T09:30:00-04:00,19.05,19.16,18.33,18.49001,57100,112830,30.58216698358123,35.36089724796606,NaN,NaN,-159.4299157998824,-108.36506995174148,-0.12598652430155488,-0.7019173354706361,-0.5759308111690812,-1932400,-1793240,46.47369262100523,39.28326607386071,NaN,NaN,-28.19047876198249,-22.559757546440867
2002-10-08T09:30:00-04:00,18.38,18.86,18.17999,18.63,180300,119605,32.43067301113402,34.96646261219529,NaN,NaN,-154.46438579429218,-124.729765090801,-0.12985017288453282,-0.7382435272747472,-0.6083933543902144,-1752100,-1824640,44.68431663086889,39.203366957994845,NaN,NaN,-29.377637343861423,-23.533740374643802
2002-10-09T09:30:00-04:00,18.63,18.63,17.95,18,153800,125930,28.7237075903232,34.56402643285467,NaN,NaN,-173.138614759292,-142.24827609122661,-0.16012339446040624,-0.8085475974657221,-0.6484242030053159,-1905900,-1858660,42.763199010699815,39.71874141163796,NaN,NaN,-31.640213419738465,-24.69180795251447
2002-10-10T09:30:00-04:00,18.10001,18.66,17.75,18.62,601300,153615,36.42533457072628,34.711706466399974,NaN,NaN,-141.42803107605405,-151.7331160589829,-0.12522561907294982,-0.8049562268465031,-0.6797306077735533,-1304600,-1754060,49.89590202087193,41.218244975764044,NaN,NaN,-30.946377513582473,-25.5853178898099
2002-10-11T09:30:00-04:00,19.17,19.74001,19.17,19.48,85300,156805,45.2607621382656,35.65032038244504,NaN,NaN,-31.305449048511786,-131.95327929560648,-0.035707670579907425,-0.7243651959984376,-0.6886575254185302,-1219300,-1622860,57.1148307041967,43.67489694200143,NaN,NaN,-27.18038013641855,-25.813183925039706
2002-10-14T09:30:00-04:00,19.60001,19.60001,19.3,19.37,187300,161565,44.410586005605566,36.766663631304425,NaN,NaN,-28.461950836379756,-105.75968630290595,0.021530716566757535,-0.6617441297100832,-0.6832748462768408,-1406600,-1517700,61.858347418382316,46.73124929535446,NaN,NaN,-24.558553364587596,-25.63395098783226
2002-10-15T09:30:00-04:00,19.37,20.37,19.37,20.31,644700,184930,52.603737640133815,38.01032470731241,NaN,NaN,43.056303624476854,-66.25554841915213,0.1224958433346297,-0.5301550421085537,-0.6526508854431834,-761900,-1319660,68.84682589778613,50.399656046131845,NaN,NaN,-19.33792855526486,-24.734519211751202
2002-10-16T09:30:00-04:00,20.31,20.31,19.75,19.81,134600,188075,48.5082872325767,38.54258696553385,NaN,NaN,43.22688269908842,-22.98244892747605,0.15339865588446755,-0.4609025655875989,-0.6143012214720664,-896500,-1117780,74.06375853172605,53.49007453409104,NaN,NaN,-16.49994758478406,-23.55815183647018
2002-10-17T09:30:00-04:00,20.64999,20.64999,20.25,20.42999,655200,206625,53.357449553532106,39.89953925294015,NaN,NaN,102.29075761996376,25.76130881172752,0.20989330944970974,-0.35193458465992933,-0.5618278941096391,-241300,-905120,78.20433049676748,56.18520606197302,NaN,NaN,-12.45840055399591,-21.972473081830998
2002-10-18T09:30:00-04:00,20.42999,20.46001,20.00999,20.39999,23100,205760,53.09688240553408,41.33858699235942,NaN,NaN,84.42837491142562,48.90807360371501,0.2375076574600501,-0.2649433222845765,-0.5024509797446266,-264400,-714140,81.11944033386482,58.61178884555114,NaN,NaN,-9.43169669159047,-20.180933597510922
2002-10-21T09:30:00-04:00,20.39999,21.05,20.2,21.02,59800,205605,57.69498419860977,42.315591107602295,NaN,NaN,130.98416639481204,80.79729704995336,0.2865135913637348,-0.14430899053995816,-0.43082258190369294,-204600,-473740,84.01723653644308,60.70414424026548,NaN,NaN,-5.3357013443946135,-18.06018613278002
2002-10-22T09:30:00-04:00,21.05,21.05,20.48,20.73,488700,226190,54.98001020458032,43.500133509730986,NaN,NaN,117.06680672916217,95.59939767089043,0.28763065016660977,-0.07128426919543074,-0.3589149193620405,-693300,-460020,84.16659560982315,62.57733069959631,NaN,NaN,-2.8554227291410013,-15.888077075117305
2002-10-23T09:30:00-04:00,20.64999,20.94,20.35001,20.94,24100,219130,56.57363852310162,44.88208822438995,NaN,NaN,106.54930541298341,108.26388221366942,0.2899265952250895,0.003493324669321396,-0.2864332705557681,-669200,-414560,84.67753385521652,64.8019645145197,NaN,NaN,-0.3479852887378557,-13.668063962777385
2002-10-24T09:30:00-04:00,21.05,21.08,20.44,20.5,125900,198810,52.389161755002824,46.21695584376482,NaN,NaN,96.21723775221913,107.0491782401205,0.25069880327780214,0.02694023354148456,-0.22375856973631758,-795100,-525320,78.06751549901675,66.85382322619064,NaN,NaN,0.5131218237555141,-11.64218027898697
2002-10-25T09:30:00-04:00,20.35001,20.75999,20.35001,20.75999,126400,203335,54.52932594465258,47.927467198127054,NaN,NaN,83.93948718630236,106.95140069509584,0.23160145631039963,0.06574325065168196,-0.16585820565871767,-668700,-606180,73.55339976886017,68.78808802246598,NaN,NaN,1.8653358601468693,-9.712535116253564
2002-10-28T09:30:00-05:00,21.05,21.05,20.42999,20.47,193300,205650,51.735856228788414,49.30640885653094,NaN,NaN,78.79086737217702,96.51274089056885,0.1904962914362322,0.0722621586365726,-0.11823413279965961,-862000,-737660,66.79057471119621,70.36710645677508,NaN,NaN,2.180474115686633,-8.013533797404964
2002-10-29T09:30:00-05:00,20.47,20.47,19.92999,20.3,255300,213820,50.115044606202524,50.83436150052233,NaN,NaN,38.440981982175124,80.78757594117144,0.14497515522602042,0.06298481123286592,-0.0819903439931545,-1117300,-822460,62.781206874978345,71.7969641613664,NaN,NaN,1.9777034968813123,-6.586214183935496
2002-10-30T09:30:00-05:00,20.2,20.56,20.2,20.32001,165500,215060,50.31236504720095,51.826292248841945,NaN,NaN,46.614931147862876,68.80070108814735,0.11086803351198522,0.05659469789682703,-0.054273335615158194,-951800,-878980,60.187860011408645,72.5321040178333,NaN,NaN,1.8645697776058574,-5.3789593322867315
2002-10-31T09:30:00-05:00,20.58,20.58,20.27,20.48,33100,212125,51.948939980882145,52.304019237600265,NaN,NaN,50.038270206858876,59.564907579075296,0.09438345254406291,0.06370598006492045,-0.030677472479142463,-918700,-903700,59.039171703668096,72.66955694636698,NaN,NaN,2.2027428729697927,-4.295859017250085
2002-11-01T09:30:00-05:00,20.38,20.75,20.05,20.75,40100,211745,54.66286149854965,53.03632462995342,NaN,NaN,52.81313460937596,53.339637063690006,0.09661394990070112,0.09008996489673393,-0.006523985003967184,-878600,-945680,57.04798378086647,72.32595954368728,NaN,NaN,3.225504761726028,-3.221378477396355
2002-11-04T09:30:00-05:00,20.95,21.2,20.7,20.77,71000,212440,54.86621282200103,53.19793000008679,NaN,NaN,84.30387880272555,54.44223934979967,0.09428315073346691,0.11132995341286644,0.017046802679399543,-807600,-934800,57.448534631896635,71.51179588183803,NaN,NaN,4.133473843917022,-2.1706852886373014
2002-11-05T09:30:00-05:00,20.95,21,20.60001,20.97,100900,208470,56.94587296590218,53.80061469532433,NaN,NaN,79.07373379569913,62.568789712504476,0.10048789273100983,0.14265666859316184,0.04216877586215201,-706700,-852680,60.446738326615346,70.53915158147298,NaN,NaN,5.465777699249755,-1.0797620046534362
2002-11-06T09:30:00-05:00,21.17,21.39999,21,21.36,125700,207065,60.74437037271321,54.328251896694404,NaN,NaN,132.73585870328577,79.79297522358907,0.12361360763257748,0.19668578540287385,0.07307217777029637,-581000,-778520,62.98332378431635,69.4519368162979,NaN,NaN,7.69939174147334,0.1744028162218174
2002-11-07T09:30:00-05:00,20.95,21.10001,20.75,20.89999,42300,179115,54.62285694063958,54.43725007777336,NaN,NaN,85.44115503041976,86.87355218830123,0.10160537951018658,0.2000789021580296,0.09847352264784301,-623300,-719440,64.91377692853655,68.29438943020303,NaN,NaN,8.001866327257416,1.2926118892269027
2002-11-08T09:30:00-05:00,20.85001,21.07001,20.5,20.59,121400,180920,50.90032508699994,53.95191728408695,NaN,NaN,42.39585522058862,84.79009631054377,0.0618041246885728,0.175728678508559,0.1139245538199862,-744700,-692660,65.78481181013672,66.992073378324,NaN,NaN,7.197801041546696,2.1362103395583016
2002-11-11T09:30:00-05:00,20.5,21.24001,20.06,20.2,127300,177920,46.59773089502533,53.353183047690166,NaN,NaN,-21.647223268115305,63.5998758963756,0.0076900776023947764,0.12353715082297967,0.11584707322058489,-872000,-705540,64.94965932429953,65.61943507221517,NaN,NaN,5.22209558726309,2.577051089230414
2002-11-12T09:30:00-05:00,20.3,20.44,20.12,20.21001,70300,149200,46.722213925969186,52.64950986218071,NaN,NaN,-96.0420954369128,28.57671004985321,-0.027048026161565403,0.08203704051862815,0.10908506668019355,-801700,-724540,63.66565126745575,64.11858631594654,NaN,NaN,3.644734970697817,2.7295773580114715
2002-11-13T09:30:00-05:00,20.21001,20.42,19.97,20.17,182200,151580,46.258065304089804,52.21157440140121,NaN,NaN,-126.26247053886894,-23.222955798577726,-0.05095114684553674,0.04539613312327262,0.09634727996880936,-983900,-805120,58.3932120457919,62.713278926430476,NaN,NaN,2.2041997579668253,2.6545234151479504
2002-11-14T09:30:00-05:00,20.56,20.59,20.37,20.45,69100,122275,50.0014561281052,51.88815512879068,NaN,NaN,-41.08204585387942,-48.52759597543756,-0.04627165039088274,0.03850771698020594,0.08477936737108868,-914800,-863420,54.85373901915272,61.37758887287994,NaN,NaN,1.9359557331905797,2.5518708891540403
2002-11-15T09:30:00-05:00,20.21001,20.52,20.21001,20.45,40400,123140,50.0014561281052,51.7642694073133,NaN,NaN,-67.80916955363686,-70.56860093028266,-0.041685913605614175,0.03267197536407096,0.07435788896968513,-914800,-897440,52.84095427610157,60.381187413230336,NaN,NaN,1.712676536625655,2.4319859816499854
2002-11-18T09:30:00-05:00,20.75,20.75,20.3,20.3,13800,120840,47.92731836317411,51.60800324709699,NaN,NaN,-45.1212610178007,-75.26340848021974,-0.04687697440789597,0.015761670959815177,0.06263864536771115,-928600,-908760,52.15517352405938,59.622185031021836,NaN,NaN,0.9785552473111488,2.22435301960158
2002-11-19T09:30:00-05:00,20.10001,20.49001,20.10001,20.33,52500,99030,48.38844116975034,51.470580112993375,NaN,NaN,-81.29681734851364,-72.3143528625399,-0.04632979695084184,0.004726399179158847,0.05105619613000069,-876100,-923640,51.21426634354396,58.98121405474579,NaN,NaN,0.46983373195031214,1.9737074070799705
2002-11-20T09:30:00-05:00,20.3,20.67,20.25,20.63,46900,100170,52.88188436585683,51.53721899763442,NaN,NaN,-14.043725246998392,-49.8706038041658,-0.024878322657874118,0.01995829280765804,0.04483661546553216,-829200,-892700,53.10855041862819,58.55759824867151,NaN,NaN,1.180116348525873,1.8603372558579565
2002-11-21T09:30:00-05:00,20.63,21.48,20.63,21.48,77800,97765,62.771693583581566,52.11642128942242,NaN,NaN,168.6029291587398,-7.933608801641958,0.04370745600841615,0.09947093547605235,0.0557634794676362,-751400,-860020,55.0920054162338,58.417885508340596,NaN,NaN,4.963312690366825,2.303619460787795
2002-11-22T09:30:00-05:00,21.36,21.47,21.24001,21.38,37600,93325,61.145653129759786,52.56495273997661,NaN,NaN,172.66157760337052,40.160540629759524,0.07751432490224192,0.1526563855954386,0.07514206069319668,-789000,-834860,56.61358858357533,58.358246504889074,NaN,NaN,7.578810457840102,3.05721817465241
2002-11-25T09:30:00-05:00,21.28,21.46001,21.05,21.34,50300,86175,60.47087895015164,52.816738881708716,NaN,NaN,129.36290107780204,75.05737304888007,0.09140262400259122,0.1893953406964357,0.09799271669384449,-839300,-817000,57.70899563934959,58.16269345579867,NaN,NaN,9.529530691951587,3.9818342485522926
2002-11-26T09:30:00-05:00,21.09,21.3,20.95,21.03999,884300,117625,55.521879037208905,52.44370378631555,NaN,NaN,80.68332649865128,107.45340181831304,0.07527674601685763,0.19208864921491653,0.1168119031980589,-1723600,-986500,45.87197999979712,56.94045461404729,NaN,NaN,9.817167466767616,4.81545327972591
2002-11-27T09:30:00-05:00,21.23,21.75,21.23,21.60001,67600,112730,61.80568020613649,52.956762590993904,NaN,NaN,143.7450427236314,139.011155412439,0.09589744295758457,0.2366837068950396,0.14078626393745503,-1656000,-1151860,37.73923365867741,54.999415809057346,NaN,NaN,12.040543518055346,5.847609028058686
2002-11-29T09:30:00-05:00,21.50999,21.75,21.50999,21.55,25100,112330,60.9772012324659,53.67653945852719,NaN,NaN,137.0124084001253,132.69305126071612,0.09931995102578975,0.2649362027196922,0.16561625169390246,-1681100,-1337800,31.06896188249233,52.519712242797034,NaN,NaN,13.587545189712797,6.953314194009273
2002-12-02T09:30:00-05:00,21.85001,22.09,21.5,21.69,979000,159275,62.492932047907836,54.81191096944737,NaN,NaN,142.94218647582474,126.74917303520695,0.10368317800787186,0.2952202242037423,0.19153704619587042,-702100,-1320420,32.273909283191685,50.18573009700362,NaN,NaN,15.322329049475675,8.148887744790187
2002-12-03T09:30:00-05:00,21.75,21.75,21.24001,21.33,56700,158560,56.42381818229331,55.50488270204194,NaN,NaN,81.24021028763185,117.12463487717291,0.07626215496766103,0.2868647399054467,0.21060258493778566,-758800,-1304320,33.43472108120487,48.02637794084285,NaN,NaN,15.038609556358159,9.133133717871326
2002-12-04T09:30:00-05:00,21.24001,21.53,21.03999,21.25999,59100,156470,55.29907210160185,56.15066890186423,NaN,NaN,51.497502317736924,111.28747004099004,0.048689502568654536,0.27146446314860384,0.2227749605799493,-817900,-1123180,44.8813487841496,47.061244850725544,NaN,NaN,14.47972273117338,9.896932148343048
2002-12-05T09:30:00-05:00,21.28,21.28,20.95,21.03999,34500,151910,51.804403627935066,56.279450866137786,NaN,NaN,25.75928512019647,87.69031852030307,0.012784231204263002,0.23875524958527805,0.22597101838101505,-852400,-962460,52.659907704189656,46.90454261394247,NaN,NaN,12.981012455520094,10.33751504936834
2002-12-06T09:30:00-05:00,20.78999,21.17999,20.74001,21.03,67300,153160,51.644800194282155,56.39683258515043,NaN,NaN,9.257098621899042,62.139256564657806,-0.013088340912956464,0.20961059223981948,0.22269893315277595,-919700,-810180,58.618748865071105,47.3172422274403,NaN,NaN,11.7078768445469,10.533281020108134
2002-12-09T09:30:00-05:00,20.89999,21.05,20.7,20.7,47600,149470,46.54363926318874,56.29799836372291,NaN,NaN,-16.406927799244603,30.269433709643938,-0.0517087881467988,0.15806294796927745,0.20977173611607625,-967300,-863220,55.975860506547235,47.590148440475154,NaN,NaN,9.08269841415662,10.326054933543633
2002-12-10T09:30:00-05:00,20.71001,20.97,20.62,20.87,57500,145980,49.32074436087598,56.36459144880331,NaN,NaN,-19.06711310655754,10.207969030806058,-0.06426812217846542,0.12943658339299446,0.19370470557145988,-909800,-893420,54.46998982387629,47.82270011764174,NaN,NaN,7.619917444834404,9.93946386372803
2002-12-11T09:30:00-05:00,20.89999,21.12,20.74001,20.98,38400,144385,51.091291793851646,56.23669197937436,NaN,NaN,-5.096452342817729,-1.1108219013048686,-0.0635170540779289,0.11430838797404874,0.17782544205197764,-871400,-904120,53.91654986614725,47.88041436389311,NaN,NaN,6.875076757231137,9.501694277085615
2002-12-12T09:30:00-05:00,21.10001,21.10001,20.77,20.89999,1076900,189120,49.73036350723358,55.30516840249236,NaN,NaN,-17.086837264640113,-9.680046378272184,-0.06644388210475119,0.09477058942103866,0.16121447152578985,-1948300,-1123300,44.04451133847418,47.09130764405313,NaN,NaN,5.873933139167158,8.983442685954408
2002-12-13T09:30:00-05:00,20.8,21,20.46001,20.53999,51300,188230,44.04535190603983,54.0837183150838,NaN,NaN,-69.73281898113773,-25.478029898879537,-0.08923938365476947,0.04966524195732802,0.1389046256120975,-1999600,-1339280,36.878806668098534,45.68168036437623,NaN,NaN,3.304185571177499,8.172120240986278
2002-12-16T09:30:00-05:00,20.61,21.05,20.61,21.05,78200,190120,52.35508626442475,53.50401883753188,NaN,NaN,-30.706992505545898,-28.3380428401398,-0.0675678066852968,0.05444486725547648,0.12201267394077328,-1921400,-1530100,31.935319486278686,43.84070349629973,NaN,NaN,3.5093731356731563,7.506013511655832
2002-12-17T09:30:00-05:00,20.78999,21.09,20.78999,20.78999,32000,191030,48.40810473069036,52.99589210135199,NaN,NaN,-41.04761157584229,-32.734142533996746,-0.06814806303947314,0.03682759514143186,0.104975658180905,-1953400,-1738820,27.580384056475282,42.5341609289196,NaN,NaN,2.441993542131281,6.782582087438039
2002-12-18T09:30:00-05:00,20.85001,20.85001,20.61,20.75999,66200,191715,47.95885184112393,52.00683293242252,NaN,NaN,-86.40518788199094,-48.99588964183139,-0.06781089535905102,0.02021203898209123,0.08802293434114225,-2019600,-1968460,23.743920783245144,41.53449572353158,NaN,NaN,1.4524401298837373,6.021133236358853
2002-12-19T09:30:00-05:00,20.75999,20.95,20.47,20.61,101300,194435,45.67645616975758,50.91392257080049,NaN,NaN,-106.59418759602472,-66.89735970810831,-0.0744193056883734,-0.005001197769324506,0.0694181079190489,-2120900,-2002980,23.221019213449125,40.97392839002849,NaN,NaN,-0.05099901339945252,5.153685772107667
2002-12-20T09:30:00-05:00,20.7,20.82001,20.60001,20.82001,365900,208840,49.313720979291745,49.97255035161363,NaN,NaN,-80.50364838091959,-69.05152558806468,-0.06189067034115423,-0.007945230007393889,0.05394544033376034,-1755000,-1954060,25.717645376475062,40.505623825263015,NaN,NaN,-0.2784412938558805,4.37766761982716
2002-12-23T09:30:00-05:00,20.57001,20.89,20.57001,20.72,95400,211730,47.67660194755881,49.347749191989735,NaN,NaN,-78.51523792936938,-78.61317467282939,-0.057667768057400155,-0.01813926973798985,0.039528498319410306,-1850400,-1939860,26.465110951016555,40.00779453024957,NaN,NaN,-0.9365632669303936,3.618491778861795
2002-12-24T09:30:00-05:00,20.75,20.81,20.57001,20.62,25300,210480,46.03107551791646,48.68574943601221,NaN,NaN,-86.38105729681344,-87.6798638170236,-0.05874003517973626,-0.03389654565526001,0.024843489524476244,-1875700,-1924320,27.326950209933187,38.75390891780553,NaN,NaN,-1.9527035734646476,2.822606728529446
2002-12-26T09:30:00-05:00,20.5,21.06,20.5,20.69,30100,167770,47.39965763847665,48.371124722479465,NaN,NaN,-60.91190158749323,-82.58120655812407,-0.05209211861587555,-0.0402716587453682,0.011820459870507356,-1845600,-1889520,29.324576139116076,37.087099520300285,NaN,NaN,-2.4359417901683873,2.071385511572613
2002-12-27T09:30:00-05:00,20.60001,20.67999,20.28999,20.28999,243500,176565,41.00112532951619,47.61086223213904,NaN,NaN,-139.08771244045977,-89.07991152701108,-0.0708300469492238,-0.0767170988160224,-0.0058870518667985955,-2089100,-1883160,29.70487806442246,35.02182303453967,NaN,NaN,-4.775088672848578,1.0933177709410145
2002-12-30T09:30:00-05:00,20.7,20.7,20.16,20.39999,373300,193975,43.26906563290021,47.376964115689866,NaN,NaN,-136.33706621705636,-100.24659509423843,-0.0717879751643137,-0.09562202082219073,-0.023834045657877025,-1715800,-1875320,30.203461239592997,33.180937372614366,NaN,NaN,-6.083456263246435,0.06806433748566465
2002-12-31T09:30:00-05:00,20.64999,20.64999,20.27,20.59,72400,148645,47.05506686633504,47.21513000893693,NaN,NaN,-111.77850470377331,-106.89924844911923,-0.056281856982523526,-0.09418636688603144,-0.03790450990350791,-1643400,-1833920,32.90955035708302,31.640905982129134,NaN,NaN,-6.1147640660064235,-0.815196863013205
2003-01-02T09:30:00-05:00,20.83,21.25999,20.62,21.12,320600,161840,55.89642027424435,47.55835347182212,NaN,NaN,80.66606999699968,-73.4898229903566,-0.009443604560406361,-0.04970901560401586,-0.0402654110436095,-1322800,-1723340,39.6410358522673,30.621226409709134,NaN,NaN,-3.2894126731407853,-1.1686562644600023
2003-01-03T09:30:00-05:00,21.25,21.25,20.97,21.19,70700,162420,56.919666742741,48.07187513150124,NaN,NaN,144.1899435314691,-32.46945396656413,0.025243082539642997,-0.008711557869055753,-0.03395464040869875,-1252100,-1604640,45.91427293124725,30.75478080919293,NaN,NaN,-0.698250229035051,-1.1014554022564378
2003-01-06T09:30:00-05:00,21.3,21.56,21.25,21.38,76900,164540,59.6557440738696,49.186903143489076,NaN,NaN,224.7624598649864,40.30058049452511,0.058095656022803664,0.03866492961980583,-0.019430726402997832,-1175200,-1421860,53.86556593786271,31.968120757033226,NaN,NaN,2.335944899707929,-0.6103982162615282
2003-01-07T09:30:00-05:00,21.39999,21.44,21.10001,21.25999,62500,164300,57.18526069062658,49.53191560250349,NaN,NaN,156.70812193860644,98.90961812565766,0.06815993072356134,0.06576918700145384,-0.002390743722107496,-1237700,-1326240,57.394364611251184,33.78662398024555,NaN,NaN,4.130933969357127,0.06693495311256525
2003-01-08T09:30:00-05:00,21.2,21.22,20.82001,21,41800,164010,52.146976140346034,49.79897784605033,NaN,NaN,60.86982141240499,133.43928334889333,0.054324808469327066,0.06551526686455134,0.011190458395224272,-1279500,-1253460,59.908027880090785,36.09574139621808,NaN,NaN,4.173000621864923,0.6535157629343306
2003-01-09T09:30:00-05:00,21,21.28999,21,21.27,177500,170010,56.43923484144971,50.404719488930745,NaN,NaN,103.57797072284647,138.0216634940627,0.05993417360143008,0.08610817539701188,0.026174001795581794,-1102000,-1209300,61.396261510746896,38.785194305325355,NaN,NaN,5.537480697623996,1.3512250393185685
2003-01-10T09:30:00-05:00,21.10001,21.36,20.98,21.23,99400,173060,55.64295160453308,51.116612019986135,NaN,NaN,95.52201880855105,128.28807854947905,0.057516836647158544,0.09807004760452998,0.04055321095737143,-1201400,-1199160,61.74739182110089,41.53707806301476,NaN,NaN,6.407215062603017,2.073509328359204
2003-01-13T09:30:00-05:00,21.3,21.3,20.98,21.19,101900,124310,54.81016779955213,51.509215364290455,NaN,NaN,78.4614849466302,99.02788356580783,0.05006414662062911,0.10313339423315782,0.05306924761252871,-1303300,-1224780,60.25608930299753,44.00410977205208,NaN,NaN,6.888158314418835,2.7613163263677225
2003-01-14T09:30:00-05:00,21.25,21.25,21.00999,21.23,357900,139640,55.526976797186514,52.069956424978145,NaN,NaN,72.68508891927928,82.22327696194239,0.04483738395391709,0.10911597755492508,0.06427859360100799,-945400,-1166320,62.48269412995837,46.57679428483364,NaN,NaN,7.484150122090387,3.436006868613817
2003-01-15T09:30:00-05:00,21.35001,21.35001,20.75999,20.92999,88000,140130,49.22072704094761,52.29778867662322,NaN,NaN,29.47538203480587,75.94438908642256,0.019478947626417817,0.08862727813403026,0.06914833050761245,-1033400,-1117100,64.29634109882386,49.217465062611545,NaN,NaN,6.212234274754743,3.8326107837768064
2003-01-16T09:30:00-05:00,20.92999,21.14999,20.75999,20.81,143400,145700,46.92527627560663,52.26390429356108,NaN,NaN,0.7135535963455295,55.371505661122384,-0.005724241222583137,0.061993028979383524,0.06771727020196666,-1176800,-1132060,63.29481127308964,51.643910429323945,NaN,NaN,4.472869652455469,3.9240763364451867
2003-01-17T09:30:00-05:00,20.5,20.82001,20.5,20.66,33300,144055,44.15315282164291,52.48904911442728,NaN,NaN,-63.240285998431766,23.619044699725823,-0.031411052541476935,0.028453454525120492,0.059864507066597426,-1210100,-1133800,63.17155712393779,54.034387505003615,NaN,NaN,2.176435292871693,3.674413330220402
2003-01-21T09:30:00-05:00,20.60001,20.8,20.14,20.14999,67100,142345,36.30088568199363,51.99132197507681,NaN,NaN,-128.53187269856008,-17.779626829312228,-0.07895784896884496,-0.03883280414445878,0.04012504482438618,-1277200,-1128580,63.40180679705867,56.40569790196544,NaN,NaN,-2.5637457044701897,2.783247753836032
2003-01-22T09:30:00-05:00,19.95,20.14999,19.7,19.77,105300,129315,31.767756911962877,50.899371264050224,NaN,NaN,-202.6257262930765,-72.84178987178339,-0.12923604536893585,-0.12142001188678364,0.007816033482152221,-1382500,-1216000,56.977263837719555,58.124820293439484,NaN,NaN,-8.270856416552489,1.2040900152091008
2003-01-23T09:30:00-05:00,20,20.17,19.75,20.13,134400,131265,39.4786464800344,49.726673135892376,NaN,NaN,-147.1146910857136,-108.15980449588729,-0.13107157608225323,-0.1560234366206643,-0.024951860538411086,-1248100,-1258940,54.07857395183947,59.15607301483749,NaN,NaN,-10.529314823019309,-0.47211067596638623
2003-01-24T09:30:00-05:00,19.95,19.95,19.46001,19.50999,65000,133250,32.637712176607195,47.99224780973996,NaN,NaN,-179.45471589201878,-144.19345839356012,-0.16469117096343439,-0.23081582424270408,-0.0661246532792697,-1313100,-1286200,52.26086132771642,59.60940075744243,NaN,NaN,-15.093274904288705,-2.5608484228695745
2003-01-27T09:30:00-05:00,19.35001,19.60001,19.2,19.36,76600,135575,31.227952856169125,45.96169129418992,NaN,NaN,-177.1799163950428,-166.98138447288233,-0.18609906394816095,-0.2987484832144709,-0.11264941926630995,-1389700,-1322120,49.88163460399292,59.324834233594586,NaN,NaN,-19.126430966134464,-4.927360214764558
2003-01-28T09:30:00-05:00,19.2,19.64999,19.2,19.48,218800,134340,33.69553525707751,44.28385376322213,NaN,NaN,-146.0476524485365,-170.48454042287761,-0.1810763731742028,-0.33899488573406344,-0.15791851255986064,-1170900,-1300860,51.2949682957108,58.88916306819885,NaN,NaN,-21.478029542201455,-7.291741547255544
2003-01-29T09:30:00-05:00,19.48,19.8,19.14999,19.5,28000,117075,34.11981078522449,42.99619909499916,NaN,NaN,-122.75853307072487,-154.5111017784073,-0.1657198589950917,-0.36506833630372526,-0.19934847730863356,-1142900,-1252940,54.415329478205685,58.496827468064204,NaN,NaN,-23.186710573171414,-9.562451408100667
2003-01-30T09:30:00-05:00,19.64999,19.64999,19.16,19.16,94800,118195,30.541860490004737,41.146386641324526,NaN,NaN,-119.84401977678237,-149.05696751662103,-0.16728796824779588,-0.4084584376183784,-0.24117046937058254,-1237700,-1250860,54.55143708586806,58.00791143771571,NaN,NaN,-25.815243049734317,-11.884278785476903
2003-01-31T09:30:00-05:00,19.3,19.67999,19.25999,19.48,57700,105050,37.21512677977087,39.8301134395558,NaN,NaN,-92.29169567911286,-131.62436347403985,-0.13688095946673773,-0.41227166870400467,-0.27539070923726694,-1180000,-1224240,56.34782000626165,57.622227736655766,NaN,NaN,-25.89196406666646,-13.885376682789698
2003-02-03T09:30:00-05:00,19.67999,19.77,19.52,19.64999,39400,103485,40.486205737432385,38.80697329226153,NaN,NaN,-68.37576163216822,-109.86353252146493,-0.09728786016309315,-0.39700053444113337,-0.2997126742780402,-1140600,-1174420,59.568715655190786,57.573129618955285,NaN,NaN,-24.91240063591062,-15.46066581894983
2003-02-04T09:30:00-05:00,19.42,19.48,19.21001,19.48,92600,104270,38.335308547712096,37.578996988727646,NaN,NaN,-83.29775724368255,-97.31355348049415,-0.07548762360613409,-0.39407220378570784,-0.31858458017957375,-1233200,-1186880,58.40795751114897,57.282077003326044,NaN,NaN,-24.76180993900179,-16.789400693242968
2003-02-05T09:30:00-05:00,19.64999,19.75999,19.3,19.5,167900,109540,38.747621367265445,36.83091801203607,NaN,NaN,-64.78039780524531,-85.71792642739824,-0.05368564362476991,-0.38569163471053614,-0.3320059910857662,-1065300,-1171360,59.46742124736293,56.93715415679311,NaN,NaN,-24.519776986607738,-17.89374016372365
2003-02-06T09:30:00-05:00,19.55,19.55,19.10001,19.34,54500,110175,36.63711708353792,36.09604949831687,NaN,NaN,-76.60715712294726,-77.07055389663121,-0.04439028576132298,-0.38749384828741995,-0.343103562526097,-1119800,-1147780,61.08916834166721,56.77960823312008,NaN,NaN,-24.92132038895074,-18.897680195898946
2003-02-07T09:30:00-05:00,19.45,19.45,19.02,19.14999,18300,102215,34.2511856483365,35.388766128794984,NaN,NaN,-83.67229577122451,-75.34667391505354,-0.045235108017592285,-0.39964744754808734,-0.35441233953049506,-1138100,-1139400,61.676028069578614,56.67278472923728,NaN,NaN,-25.95713801011781,-19.906174169358785
2003-02-10T09:30:00-05:00,19.3,19.3,18.89999,19.17,28900,98690,34.73322680777885,35.2767904949225,NaN,NaN,-87.87113871898963,-79.24574933241783,-0.03888522603000638,-0.403018872068003,-0.36413364603799664,-1109200,-1133120,62.13690001421003,56.58243424474809,NaN,NaN,-26.671613992365113,-20.872665572645403
2003-02-11T09:30:00-05:00,19.37,19.37,18.95,18.97,121400,99665,32.19271405529466,35.30714457658905,NaN,NaN,-87.59620557799984,-80.10543899928129,-0.04231061103415823,-0.4170219098306944,-0.3747112987965362,-1230600,-1132600,62.17745916391806,56.953876768047984,NaN,NaN,-28.01225706179016,-21.892607213951795
2003-02-12T09:30:00-05:00,19,19.02,18.75,18.81,133600,88450,30.284317152622776,34.65040676748823,NaN,NaN,-117.26499794484978,-90.60235902720217,-0.04903423867443257,-0.4360040971395769,-0.3869698584651443,-1364200,-1192380,54.89700347077427,57.01233601940047,NaN,NaN,-29.708476187659127,-23.009159924481413
2003-02-13T09:30:00-05:00,18.86,18.86,18.35001,18.57001,43700,86235,27.63781271279771,34.293271091501836,NaN,NaN,-156.8064079114628,-106.64220918490528,-0.06246569321050871,-0.4650519749782802,-0.4025862817677715,-1407900,-1250000,48.947775900494825,56.77568706031322,NaN,NaN,-31.977426957010863,-24.290340929128476
2003-02-14T09:30:00-05:00,18.59,19.00999,18.59,19,77600,82945,38.07885208188381,34.78262103619574,NaN,NaN,-114.16019536108577,-112.73978910287754,-0.03649845429656556,-0.44820934963847847,-0.4117108953419129,-1330300,-1288440,45.412055525500676,56.456431411849486,NaN,NaN,-30.793663484320238,-25.219387008441586
2003-02-18T09:30:00-05:00,19.25,19.45,19.05,19.21001,67300,84645,42.44671002188722,35.407704947967865,NaN,NaN,-35.88084047742427,-102.34172945456446,-0.0011535455067693823,-0.4131528272253746,-0.4119992817186052,-1263000,-1319200,42.75085622280737,55.84613769235638,NaN,NaN,-28.418994810265403,-25.67647383727356
2003-02-19T09:30:00-05:00,19.35001,19.39999,19.10001,19.3,52600,83920,44.26108471271209,36.132081657074124,NaN,NaN,-19.360449453784884,-88.69457822972147,0.03055949971425609,-0.37379990707578514,-0.40435940679004123,-1210400,-1315160,43.221475874008604,55.04657672062802,NaN,NaN,-25.927855420223107,-25.712385491980637
2003-02-20T09:30:00-05:00,19.39999,19.45,19,19.2,138700,85590,42.65197233745509,36.99708964617772,NaN,NaN,-26.036986592706615,-70.44897595929284,0.04613934374733769,-0.34668522710586913,-0.3928245708532068,-1349100,-1312140,43.59475253108241,54.26395639528618,NaN,NaN,-24.32551465213117,-25.514261086287856
2003-02-21T09:30:00-05:00,19,19.5,19,19.5,177500,87745,48.6797723383434,37.81599290036147,NaN,NaN,20.709101119133386,-34.94587415317359,0.07621239328880969,-0.2975590792421947,-0.3737714725310044,-1171600,-1264880,49.22080761172428,53.75488408139065,NaN,NaN,-21.053034386216257,-24.876942986277626
2003-02-24T09:30:00-05:00,19.39999,19.39999,18.85001,18.85001,103300,89660,39.09234341653392,37.716431306011586,NaN,NaN,-71.52776352017379,-26.419387784991194,0.052993178401939844,-0.3075299995285796,-0.36052317793051947,-1274900,-1253800,50.46818940486795,53.104846492081876,NaN,NaN,-21.19381734049971,-24.350782179737923
2003-02-25T09:30:00-05:00,18.64999,19.14999,18.60001,19.14999,281500,99905,44.522824094190895,38.15839670218863,NaN,NaN,-83.72601851108479,-35.988423391723295,0.05809267815028718,-0.28790733024266046,-0.34600000839294764,-993400,-1199880,56.117549863702465,52.9412459458357,NaN,NaN,-19.442344877324892,-23.649576850821777
2003-02-26T09:30:00-05:00,19.2,19.25,18.89999,19,341100,106020,42.483253064339166,38.42522753769391,NaN,NaN,-49.86316781791722,-42.088967064549756,0.05182603625151139,-0.28121746307855844,-0.3330434993300698,-1334500,-1224700,53.11448551351709,52.48746482198957,NaN,NaN,-18.71340792074768,-22.94440986081119
2003-02-27T09:30:00-05:00,19.14999,19.24001,18.8,19.13,76000,108420,44.8417345001484,39.011271638880366,NaN,NaN,-41.591392784874095,-45.199848302983256,0.056514010362899936,-0.26240098637644493,-0.31891499673934487,-1258500,-1206580,55.007471660321684,52.05305791617917,NaN,NaN,-17.37424542904292,-22.148672084844296
2003-02-28T09:30:00-05:00,19.14,19.39999,19.05,19.17999,38900,105625,45.7627361062326,39.833525243015806,NaN,NaN,12.57001122681515,-46.8276662814469,0.06258751607057611,-0.2406806016511247,-0.3032681177217008,-1219600,-1216180,53.76885404141221,51.48825977131015,NaN,NaN,-16.022024362096424,-21.273436695880314
2003-03-03T09:30:00-05:00,19.39,19.39999,19.00999,19.10001,155500,110515,44.48298172904297,40.52993630882038,NaN,NaN,4.240467299073988,-31.674020117597347,0.06077403155974881,-0.22730057827201477,-0.2880746098317636,-1375100,-1236220,51.17818680664981,50.70549454219871,NaN,NaN,-15.278729857060657,-20.417050004620364
2003-03-04T09:30:00-05:00,18.89999,19.10001,18.75,18.75,26500,109870,39.30304372682174,41.037816999643745,NaN,NaN,-99.97934192727635,-34.924684800835706,0.03674100015912235,-0.24214835963286063,-0.278889359791983,-1401600,-1317860,42.247721194332776,49.28194183008547,NaN,NaN,-16.19251051180564,-19.81354436278969
2003-03-05T09:30:00-05:00,18.95,18.95,18.60001,18.89999,851400,147810,42.398542793619846,41.903118831143544,NaN,NaN,-107.01562384497005,-46.35517600624627,0.03186613018837697,-0.23905669705651178,-0.27092282724488875,-550200,-1161000,57.56825759956306,49.47274569642752,NaN,NaN,-16.02909117104018,-19.27290819253976
2003-03-06T09:30:00-05:00,18.8,18.85001,18.53999,18.75999,576300,168230,40.33100606320547,42.809775499029804,NaN,NaN,-132.01788078900344,-64.44047360707214,0.02067565969878482,-0.2450782526214077,-0.2657539123201925,-1126500,-1134600,59.51485844396498,50.227537306675394,NaN,NaN,-16.503208986201777,-18.87723687734862
2003-03-07T09:30:00-05:00,18.35001,18.95,18.35001,18.83,1321300,231570,41.85790298643548,43.079707706497786,NaN,NaN,-117.22690946231087,-90.39985774489735,0.019468539679575958,-0.24141823772072257,-0.26088677740029853,194800,-851720,73.52842800775268,52.23584962683625,NaN,NaN,-16.460808173336027,-18.53203277677539
2003-03-10T09:30:00-05:00,18.89999,18.89999,18.35001,18.35001,144700,237890,35.20614714626113,42.56252464395306,NaN,NaN,-155.17229563025555,-122.28241033076324,-0.010562018288086616,-0.2740893002604068,-0.26352728197232017,50100,-566680,80.75653575979543,54.95054102233539,NaN,NaN,-18.51033150768716,-18.528932595477073
2003-03-11T09:30:00-05:00,18.45,18.49001,18,18.00999,39300,238410,31.399532052977065,41.643842311114845,NaN,NaN,-222.223086156291,-146.7311591765662,-0.048127665906530726,-0.32368686435548355,-0.2755591984489528,10800,-284200,85.09892744018263,57.94178756277639,NaN,NaN,-21.537310950192783,-18.95870093186503
2003-03-12T09:30:00-05:00,17.96001,18.22,17.85001,18.22,77700,236225,36.00216105655912,41.16885579105084,NaN,NaN,-198.66164280836495,-165.06036296924518,-0.053235586101234744,-0.34210368107549627,-0.2888680949742615,88500,-156460,86.5743148882479,61.01175630257392,NaN,NaN,-22.588515380010342,-19.47724585302865
2003-03-13T09:30:00-05:00,18.42,18.78999,18.3,18.75,926400,275865,45.872218822233236,40.96831625418583,NaN,NaN,-62.990636462745,-151.25491410399349,-0.01718951702617394,-0.31035499125697896,-0.293165474230805,1014900,271820,90.10998100229116,63.93241154475727,NaN,NaN,-20.147210463267726,-19.5729550830628
2003-03-14T09:30:00-05:00,18.89999,19.10001,18.67,19.05,518600,299610,50.52360601739146,41.78483501138994,NaN,NaN,11.726145384598334,-125.46430313461164,0.02812259644201237,-0.25801222867828955,-0.2861348251203019,1533500,539560,91.5993952071575,66.87035481634939,NaN,NaN,-16.529603928097764,-19.13819063235351
2003-03-17T09:30:00-05:00,18.64999,19.71001,18.64999,19.59,375400,314500,57.588464306842916,42.71809502657937,NaN,NaN,95.2099592271547,-75.38785216312958,0.09211929339031316,-0.17098570838241045,-0.2631050017727236,1908900,911320,93.14343661970028,69.51506101320638,NaN,NaN,-10.823606942726025,-17.950392962406728
2003-03-18T09:30:00-05:00,19.78999,19.89999,19.53999,19.85001,627000,342485,60.512270324264726,44.00588197371691,NaN,NaN,181.30300325148386,5.31736571842539,0.14639404648409166,-0.08011244366760906,-0.2265064901517007,2535900,1416340,94.59641981770989,72.47805632064872,NaN,NaN,-5.22260303699291,-16.132137258776183
2003-03-19T09:30:00-05:00,19.99001,20.02,19.64,19.97,78900,343800,61.82035578854158,45.218640637173564,NaN,NaN,182.6267574749709,81.57504577509255,0.18246069034109777,0.001569372774671507,-0.18089131756642626,2614800,1921600,95.60083896086721,75.37758255640198,NaN,NaN,-0.38651347727548435,-13.882762432847512
2003-03-20T09:30:00-05:00,20,20.10001,19.64999,19.96001,1269900,400360,61.63728351994484,46.35253688101016,NaN,NaN,164.01432878498196,126.97603882463793,0.19651328624559514,0.06475029024056767,-0.13176299600502747,1344900,1987600,95.71293924679397,78.37358864250066,NaN,NaN,3.337917278940376,-11.422665331163529
2003-03-21T09:30:00-05:00,20.14999,20.58,19.92,20.58,179500,400460,67.9756246628759,48.030582804855364,NaN,NaN,207.0250134460141,166.03581243692105,0.23578720140025486,0.1629710057452911,-0.07281619565496375,1524400,1985780,95.64056382238223,81.54947271505297,NaN,NaN,8.917289174514652,-8.516957544638075
2003-03-24T09:30:00-05:00,19.85001,20.05,19.7,19.85001,335600,412075,56.201445203262736,49.237611481744004,NaN,NaN,109.52444217776886,168.8987090270439,0.20212057078588683,0.1798345178273948,-0.022286052958492036,1188800,1841760,89.85057866146916,84.94967681984845,NaN,NaN,9.664403172945226,-5.919620299269031
2003-03-25T09:30:00-05:00,19.89999,20.08,19.62,19.89,120200,404010,56.64448321323882,50.25517865457393,NaN,NaN,95.2950695577316,151.69712228829343,0.17317873070567485,0.19418736042360152,0.021008629717926677,1309000,1596380,80.86777595665941,86.61392813106961,NaN,NaN,10.378769984854227,-3.591278830108566
2003-03-26T09:30:00-05:00,19.75,19.97,19.64999,19.89,893400,431625,56.644483213238814,51.42042702243346,NaN,NaN,81.47307607868295,131.46638600903586,0.14576869914519588,0.20321950364942154,0.057450804504225655,1309000,1335220,72.55389338047229,87.54528776939155,NaN,NaN,10.932405968402435,-1.5164667160355658
2003-03-27T09:30:00-05:00,19.64,19.85001,19.42,19.84,825600,469105,55.825636040358184,52.41812224057079,NaN,NaN,58.568539076241606,110.37722806728777,0.11723253509394065,0.20399147337165147,0.08675893827771082,483400,1162920,67.61494606040573,87.12289620172393,NaN,NaN,11.13535329885995,0.2909361432352222
2003-03-28T09:30:00-05:00,19.7,19.75,19.5,19.62,143000,474310,52.24679623123642,53.63531146092617,NaN,NaN,44.837884326426895,77.93980224337035,0.07837024637743782,0.1847217462495081,0.10635149987207028,340400,926120,61.426125406056684,85.7421526050283,NaN,NaN,10.247590103394893,1.7133152804008893
2003-03-31T09:30:00-05:00,19.2,19.48,19.10001,19.31,169700,475020,47.614741259603896,54.79354068997094,NaN,NaN,6.1844415200551675,57.27180211182762,0.02915075677468247,0.14278994584042337,0.1136391890657409,170700,722500,56.62648995656854,83.70840707048443,NaN,NaN,8.065161445426698,2.620721875404576
2003-04-01T09:30:00-05:00,19.45,19.64,19.2,19.58,94300,478410,51.63652139165401,55.91028071390629,NaN,NaN,23.7612411691029,42.9650364341019,0.012967545828043811,0.12984862135079567,0.11688107552275186,265000,513700,52.12843686588316,81.24798721174409,NaN,NaN,7.401663275963512,3.3037135040558523
2003-04-02T09:30:00-05:00,19.85001,20.14,19.75999,20.02,369100,454295,57.37908245216794,56.732199544615916,NaN,NaN,76.45677260669454,41.961775739704215,0.02915863217228888,0.15332936573811295,0.12417073356582407,634100,378720,49.396773787177025,78.33990098209308,NaN,NaN,8.626896301648523,4.064168189426233
2003-04-03T09:30:00-05:00,20.35001,20.35001,19.94,20,248100,437885,57.04750366499172,57.19819223373021,NaN,NaN,83.87603503980853,47.0232749324176,0.03536995358640127,0.16838317554882565,0.13301322196242438,386000,359240,48.99771901805277,75.29692411144275,NaN,NaN,9.501130097580832,4.840877033448319
2003-04-04T09:30:00-05:00,20.2,20.2,19.86,20.05,79200,375780,57.7055272305144,57.20655387113533,NaN,NaN,71.5796409671555,52.371626260563325,0.039387165138638464,0.18224717838572246,0.142860013247084,465200,384200,49.55999477009701,72.18382112218538,NaN,NaN,10.402879188776213,5.635448769923732
2003-04-07T09:30:00-04:00,20.55,20.67,20.17,20.2,100200,373555,59.70015714636102,57.14854578699934,NaN,NaN,105.19298708975082,72.17333537450244,0.04811055733393921,0.202998209914508,0.1548876525805688,565400,463140,51.38541784995202,69.09732098163124,NaN,NaN,11.731983719850083,6.506382334198925
2003-04-08T09:30:00-04:00,20.14,20.3,20,20.12,179000,380540,58.12570185047399,56.88464193428023,NaN,NaN,76.14996904337609,82.65108094935708,0.044538681378850864,0.21056100430413238,0.16602232292528152,386400,487420,51.96127679074912,65.98020939805137,NaN,NaN,12.416268366115933,7.350651767329926
2003-04-09T09:30:00-04:00,20.10001,20.3,19.84,19.88,198800,386595,53.56199691046428,56.30783574788877,NaN,NaN,51.54135309071634,77.66799704616145,0.02313527431089818,0.19494141581390423,0.17180614150300605,187600,398120,49.6326264879488,62.688758486705304,NaN,NaN,11.738517663943568,7.977489752560446
2003-04-10T09:30:00-04:00,20.05,20.05,19.7,19.91,383100,359430,54.04767834499016,55.31298243946835,NaN,NaN,18.30525461169089,64.55384096053793,0.008855450222352207,0.18287545428094631,0.1740200040585941,570700,435060,50.61849478261053,59.4728964124359,NaN,NaN,11.305689753340397,8.45294689552901
2003-04-11T09:30:00-04:00,19.99001,20.23,19.85001,19.94,180600,342530,54.559484960368856,55.195699564975925,NaN,NaN,44.25980226763625,59.08987322063407,-0.00023106144875567614,0.17373117724764953,0.1739622386964052,751300,492280,52.17990033087645,56.78213367453643,NaN,NaN,11.073999493211202,8.82738298091218
2003-04-14T09:30:00-04:00,20.12,20.28,19.92,20.28,120000,329760,59.99736234741791,55.435190931703,NaN,NaN,86.11435265436118,55.274146333556146,0.01419782686800991,0.19170952228141758,0.17751169541340767,871300,553460,53.85977695450069,54.85299088866795,NaN,NaN,12.367159757362987,9.33306537754801
2003-04-15T09:30:00-04:00,20.42999,20.46001,20.13,20.45,534800,325150,62.41900013093969,55.84765642582449,NaN,NaN,130.81346002690927,66.20684453026277,0.03172796359164071,0.21717164990295856,0.18544368631131786,1406100,757400,59.02684247718002,53.88677296700421,NaN,NaN,14.169051939893848,10.023920600740272
2003-04-16T09:30:00-04:00,20.45,20.55,20.11,20.17,338700,338140,56.36649231933407,55.88628901717992,NaN,NaN,96.42761162927455,75.18409623797443,0.021492680836415756,0.21230953735683755,0.1908168565204218,1067400,933360,62.88846177847191,53.54916694686608,NaN,NaN,14.020817452566856,10.594905865286927
2003-04-17T09:30:00-04:00,20.17,20.5,20.13,20.5,132100,281250,61.14807514604883,56.52209465395224,NaN,NaN,112.34209402967554,93.99146412157135,0.03327091025406528,0.2324054943380034,0.1991345840839381,1199500,1059120,65.39848854025769,53.832907170737585,NaN,NaN,15.336632725998816,11.272295416817197
2003-04-21T09:30:00-04:00,20.49001,20.58,20.32001,20.32001,76800,276115,57.45012018096446,57.224621719763704,NaN,NaN,119.18221600447966,108.97594686894004,0.025607146875547493,0.2311435176783725,0.205536370802825,1122700,1133400,66.82569019996254,54.561421473837136,NaN,NaN,15.330610993060754,11.85205478485199
2003-04-22T09:30:00-04:00,20.25,20.95,20.25,20.92999,71900,262930,65.1434612841829,58.18940314065862,NaN,NaN,173.89331561226166,126.53173946052013,0.056514942224967724,0.27618004858403467,0.21966510635906694,1194600,1198060,68.0606828898754,55.69943904697944,NaN,NaN,17.9036135555289,12.716563180662977
2003-04-23T09:30:00-04:00,20.89999,21.13,20.89999,21.10001,79700,260905,66.9378512252317,58.87217233873461,NaN,NaN,210.34065602420827,142.43717865997993,0.08177237726651715,0.32188057794221336,0.24010820067569622,1274300,1171700,66.96619117520794,56.9543974318388,NaN,NaN,20.573652114951276,13.839004456989876
2003-04-24T09:30:00-04:00,21,21,20.75,20.89999,35600,218015,62.839374130433924,59.28587737198047,NaN,NaN,150.53915371708692,153.25948707754242,0.07836277534422292,0.33806166985597486,0.25969889451175193,1238700,1205960,67.69335894024343,58.289800283423844,NaN,NaN,21.466449394607366,14.928639448078089
2003-04-25T09:30:00-04:00,20.7,20.91,20.60001,20.74001,105500,182010,59.691342792974545,59.42772134072762,NaN,NaN,109.02802354009675,152.59667297962667,0.05954062163574325,0.334124671556431,0.27458404992068774,1133200,1192700,67.07790394684612,59.54107951033449,NaN,NaN,21.215669245366524,15.826786561976437
2003-04-28T09:30:00-04:00,20.74001,21.22,20.74001,21.11,143800,182050,64.16281066235697,59.746482306155904,NaN,NaN,143.2426999911833,157.4087697769674,0.06573060963087246,0.35674731195927833,0.2910167023284059,1277000,1223560,67.81138616726238,60.71436296157095,NaN,NaN,22.43218606786647,16.77041506281787
2003-04-29T09:30:00-04:00,21.27,21.35001,21,21.17,325000,189815,64.8438912934416,60.22635298065359,NaN,NaN,154.82975278319591,153.59605721115423,0.06734058311882063,0.3751924312269317,0.30785184810811106,1602000,1305040,69.72903118313324,61.98348827531267,NaN,NaN,23.6126644375829,17.747879259212876
2003-04-30T09:30:00-04:00,21.14999,21.39999,20.95,21.39999,65400,188370,67.40133885925283,61.21487740556706,NaN,NaN,144.29797708041457,140.3875214223955,0.0766903766345366,0.4037148189012818,0.3270244422667452,1667400,1383660,71.49373935056666,63.544996336928236,NaN,NaN,25.40076901224152,18.841149223931254
2003-05-01T09:30:00-04:00,21.39999,21.39999,20.85001,21.08,34300,171630,60.77679650351684,61.695528702604676,NaN,NaN,103.18809539555448,130.917309758089,0.055127976144875745,0.3959344124478399,0.34080643630296414,1633100,1462540,73.18292186872735,65.15674112879371,NaN,NaN,24.870927739563918,19.70254615473592
2003-05-02T09:30:00-04:00,20.98,21.49001,20.98,21.37,407200,179585,64.20996959517478,62.38484903366225,NaN,NaN,114.79996023508728,132.0716970970871,0.05412323692846288,0.4084604824635427,0.35433724553507984,2040300,1643960,76.61513423432592,66.9021149790401,NaN,NaN,25.50263048497785,20.531129630484767
2003-05-05T09:30:00-04:00,21.3,21.48,21.16,21.3,33700,177310,62.781506267178045,62.58371645650226,NaN,NaN,107.00323146007153,124.82380339086475,0.04295859484069353,0.4080354890859468,0.36507689424525325,2006600,1789880,78.94887371155815,68.69419331882993,NaN,NaN,25.57751798870172,21.25204225308719
2003-05-06T09:30:00-04:00,21.35001,21.56,21.25999,21.36,324400,188520,63.53042590139533,62.663104011534806,NaN,NaN,106.50669613491966,115.15919206120952,0.03420957641914901,0.4078388647691895,0.3736292883500405,2331000,1935680,80.99024243315176,70.26300760139934,NaN,NaN,25.8548622370889,21.909587965087432
2003-05-07T09:30:00-04:00,21.42,21.5,21.21001,21.33,61500,182645,62.84944868203186,63.126172323156084,NaN,NaN,91.15083438375967,104.52976352187852,0.0216117018277725,0.4006439156347561,0.3790322138069836,2269500,2056100,82.49968875812561,71.66380952851746,NaN,NaN,25.89350684172883,22.47871923317906
2003-05-08T09:30:00-04:00,20.95,21.28,20.95,21.13,21600,173785,58.35840139285622,62.92690991221375,NaN,NaN,51.740251415295305,94.2401947258267,-0.003636420132102358,0.37448668864185564,0.378123108773958,2247900,2179060,83.90502818790962,72.98570521763546,NaN,NaN,24.658177710240043,22.790070444187773
2003-05-09T09:30:00-04:00,21.25,21.45,21.06,21.45,13800,155320,62.92349428274852,63.31786520519832,NaN,NaN,78.21090999833335,86.92238467847591,-0.0022964504706143307,0.3752525456856901,0.37754899615630444,2261700,2223340,84.39113881796182,74.24038011892112,NaN,NaN,24.880272679521816,23.088670763521208
2003-05-12T09:30:00-04:00,21.19,21.64999,21.19,21.61,36400,148110,64.99014563802987,63.306914087615965,NaN,NaN,101.01892045170177,85.72552247680196,0.005432584362681792,0.38433972660965665,0.37890714224697486,2298100,2281640,85.03212783612385,75.4526261865103,NaN,NaN,25.67330840853857,23.457904712809402
2003-05-13T09:30:00-04:00,21.7,21.7,21.42999,21.53999,386800,161450,63.32680657678466,63.04898232701261,NaN,NaN,110.56687631462229,86.53755851274248,0.002069909877953191,0.3814945295944163,0.37942461971646313,1911300,2197700,79.94188117179031,76.37946118626618,NaN,NaN,25.859064128476618,23.800927486476148
2003-05-14T09:30:00-04:00,21.5,21.62,21.33,21.47,72100,138315,61.6286545720312,62.96250235855526,NaN,NaN,89.48012158790472,86.20341595357148,-0.0080719975621803,0.36933462276373774,0.37740662032591804,1839200,2111640,74.98565592095463,76.90033954203126,NaN,NaN,25.545360405113275,24.050132189138594
2003-05-15T09:30:00-04:00,21.60001,21.72,21.5,21.7,152900,129025,64.95446992017438,63.33844001049811,NaN,NaN,122.07294620488639,100.26995491148969,-0.002768282652573839,0.37394626701020073,0.37671454966277457,1992100,2060480,72.12303054513137,77.26070572762308,NaN,NaN,26.206937678470005,24.358247259043083
2003-05-16T09:30:00-04:00,21.5,21.71001,21.44,21.60001,53800,125110,62.421451293594735,63.21405719844366,NaN,NaN,103.38796693951508,105.30536629972603,-0.009114461792176287,0.3653214724225542,0.3744359342147305,1938300,1995800,68.55951843308304,77.31414374661027,NaN,NaN,26.05872603073498,24.60117279785621
2003-05-19T09:30:00-04:00,21.60001,21.60001,21.03999,21.03999,333300,137935,50.53497678725291,62.19199187657305,NaN,NaN,-2.3673821115013505,84.62810578708542,-0.05176715781275615,0.3097269869487853,0.36149414476154146,1605000,1857180,61.54152303913798,76.72932173632489,NaN,NaN,22.11296891847915,24.245715100802347
2003-05-20T09:30:00-04:00,21.28999,21.28999,20.87,21.16,246400,146660,52.617251533289966,61.13598563900427,NaN,NaN,-52.98639095135082,51.9174523338908,-0.07142423668457637,0.272213848905821,0.3436380855903974,1851400,1845200,60.96074366590236,75.976964901706,NaN,NaN,19.51685267737354,23.5701633260268
2003-05-21T09:30:00-04:00,21.16,21.16,20.85001,21.03999,107000,148025,50.33534652801707,60.390167783611425,NaN,NaN,-84.30132472327983,17.16116307165388,-0.09079237705692411,0.23014761426924224,0.32093999132616635,1744400,1826240,59.99573870274327,75.03502324699285,NaN,NaN,16.673510244723417,22.584927171554888
2003-05-22T09:30:00-04:00,21.14,21.3,21.03,21.2,1526600,222575,53.24670699264512,59.60707759771645,NaN,NaN,-35.111542192055694,-14.27573460773453,-0.09088695003787228,0.20733130377882603,0.2982182538166983,3271000,2082020,67.47571164429522,74.38220734770495,NaN,NaN,15.131075959677803,21.520091284143877
2003-05-23T09:30:00-04:00,21.25,21.39999,21.11,21.28,52000,219900,54.67722269898374,59.028200199988284,NaN,NaN,-13.339125122588014,-37.62115302015515,-0.08379516823537941,0.19347429352247403,0.27726946175785344,3323000,2358960,73.29742373489522,73.97853234937189,NaN,NaN,14.265749838499014,20.483756791908895
2003-05-27T09:30:00-04:00,21.35001,21.8,21.12,21.8,182000,221810,62.672103340506055,58.96689144563904,NaN,NaN,113.40220818467972,-14.467234960918933,-0.044300123179953965,0.22189430778291097,0.26619443096286494,3505000,2738960,78.88289571843005,73.82800758403462,NaN,NaN,16.026096692646448,19.846948206299974
2003-05-28T09:30:00-04:00,22.17999,22.17999,21.64,21.72,99800,210550,60.89247058247773,58.82710729567089,NaN,NaN,191.1776898977003,34.36558120889129,-0.0247553653462681,0.23525022428002984,0.26000558962629794,3405200,3049720,82.16789657740593,73.80430814255465,NaN,NaN,16.896928610392987,19.42551683545612
2003-05-29T09:30:00-04:00,21.56,21.84,21.39999,21.48,341100,224335,55.775579742096205,58.64262003490232,NaN,NaN,75.58918354460033,66.34368286246732,-0.02889403326940848,0.22388804803953732,0.2527820813089458,3064100,3313660,84.38912468680076,73.83888646390402,NaN,NaN,16.048678585565682,18.943111371186056
2003-05-30T09:30:00-04:00,21.48,21.99001,21.48,21.98,1330100,289125,62.79073238289157,58.6331370420554,NaN,NaN,144.48592151544108,102.26317560396667,-0.0003691312498138588,0.25232066724667845,0.2526897984964923,4394200,3538300,85.98880210803503,73.95300527033781,NaN,NaN,17.647011500647956,18.75795424682347
2003-06-02T09:30:00-04:00,22.2,22.41,22.05,22.2,312600,284395,65.39202119299182,58.6618424388384,NaN,NaN,228.252866230824,150.58157387464908,0.029265236568185915,0.28927134420672473,0.2600061076385388,4706800,3815060,87.66574746331966,74.14112095799464,NaN,NaN,19.829638024176194,18.91105192930243
2003-06-03T09:30:00-04:00,22.28999,22.31,22.03999,22.23,98700,287645,65.74371199435927,58.83447854009372,NaN,NaN,183.2678962620394,164.554711490121,0.04584945600597046,0.31731792764600186,0.2714684716400314,4805500,4075160,88.99841170883106,74.7880159963547,NaN,NaN,21.653974994206315,19.302898081431557
2003-06-04T09:30:00-04:00,22.39999,22.57001,22.16,22.52,599800,301415,69.02099307894026,59.362502719158655,NaN,NaN,196.8296751645766,165.68510854349626,0.06987281548333552,0.3588094909942008,0.28893667551086527,5405300,4475180,90.66832379392267,75.90820655870957,NaN,NaN,24.27788045484523,20.01360984906208
2003-06-05T09:30:00-04:00,22.49001,22.64,22.28999,22.58,72600,301970,69.66756756733511,59.69915255109871,NaN,NaN,176.14008165766302,185.7952881661088,0.08246222265852576,0.39201445383402245,0.3095522311754967,5477900,4957940,92.20590532155941,77.34269761416871,NaN,NaN,26.586571152745282,20.952604321016825
2003-06-06T09:30:00-04:00,22.60001,23.07001,22.60001,22.77,802100,340995,71.68307410574292,60.36069703768072,NaN,NaN,188.19113504064725,194.53633087115003,0.09533344072651306,0.42871903208363804,0.333385591357125,6280000,5335100,93.15484922906816,79.09950695673908,NaN,NaN,29.161728508027775,22.125336347732674
2003-06-09T09:30:00-04:00,22.77,22.77,22.42,22.47,78800,344245,64.40601746712679,61.35148565767172,NaN,NaN,122.872768560578,173.46031133710085,0.07621862241667249,0.4286588693779656,0.3524402469612931,6201200,5633980,93.79914106358865,81.40362252991413,NaN,NaN,29.159049783566477,23.13015255285179
2003-06-10T09:30:00-04:00,22.25,22.71001,22.25,22.59,107000,347775,65.89734159097476,62.30006351893491,NaN,NaN,102.2794235103327,157.2626167867595,0.06468730768474179,0.43329938156722037,0.3686120738824786,6308200,5934520,94.37271406807386,83.79019184435494,NaN,NaN,29.60634845312641,24.055323395748164
2003-06-11T09:30:00-04:00,22.75,23.13,22.64,23.03999,491200,352995,70.83249873104216,63.764145819151,NaN,NaN,137.13434794581698,145.32355134300758,0.07942543207548947,0.4678938639768404,0.38846843190135094,6799400,6213340,94.84876612237582,86.27969380290013,NaN,NaN,31.61489392809202,25.135262043225858
2003-06-12T09:30:00-04:00,23.25,23.28999,23,23.10001,89000,353840,71.4264552904131,65.06269926899157,NaN,NaN,137.74224140502616,137.6439832924802,0.08478813416577735,0.4944535996085726,0.40966546544279525,6888400,6495440,95.2835143542066,88.26596542503664,NaN,NaN,33.40170121334196,26.316181924671014
2003-06-13T09:30:00-04:00,23.21001,23.21001,22.77,22.85001,32300,347810,65.44810655618866,65.83204811593478,NaN,NaN,102.168674921105,120.43949126857176,0.06401538003984275,0.48968469049259866,0.4256693104527559,6856100,6610660,95.45233459977084,89.84845905824206,NaN,NaN,33.071476525412265,27.281224010491194
2003-06-16T09:30:00-04:00,22.7,23.39999,22.7,23.39999,61900,348215,71.16580833251712,66.43874132964986,NaN,NaN,112.96303388630724,118.4575443337176,0.07885732108289722,0.5242409618063775,0.44538364072348025,6918000,6754020,95.66046431016474,91.04685681479452,NaN,NaN,34.69954471678594,28.340984111390444
2003-06-17T09:30:00-04:00,23.59,23.59,23.32001,23.41,1540600,408580,71.25903129798206,67.17920995218587,NaN,NaN,129.58194494832517,123.9180486213161,0.08060446829437984,0.546139226091455,0.4655347577970752,8458600,7184100,96.21945651576426,92.05053966753441,NaN,NaN,35.990320128174154,29.433746399502404
2003-06-18T09:30:00-04:00,23.24001,23.45,23.17999,23.28999,40400,398280,68.4036604762779,68.08121571891314,NaN,NaN,106.00525411841757,117.69222985583622,0.06557117753927849,0.5474987297211733,0.4819275521818948,8418200,7507860,96.57692482961515,92.92109682059257,NaN,NaN,36.175747358179805,30.396889393599174
2003-06-19T09:30:00-04:00,23.39999,23.39999,22.8,22.86,89600,397410,59.24375880965887,67.82786046368224,NaN,NaN,70.06128950448038,104.15603947572706,0.020876653893045327,0.5080233695482015,0.48714671565515616,8328600,7795900,96.86127342830932,93.69770191489788,NaN,NaN,33.36485099787998,30.82088390849643
2003-06-20T09:30:00-04:00,23.10001,23.10001,22.83,22.92,91400,325650,60.04771189046494,67.4461240849303,NaN,NaN,56.78137546875459,95.07857958525699,-0.008843560135155248,0.4760922654862121,0.48493582562136733,8420000,8108680,97.13917838384776,94.37437555207846,NaN,NaN,31.36453263729723,30.89854801261083
2003-06-23T09:30:00-04:00,23,23,22.53999,22.64,486500,347375,54.631777717726074,66.65241449374223,NaN,NaN,20.87206555796414,76.66038591958836,-0.04929803370127134,0.42331328349477815,0.4726113171960495,7933500,8311780,97.30597963825304,94.96777326132289,NaN,NaN,27.934890305203492,30.475168340124068
2003-06-24T09:30:00-04:00,22.62,22.74001,22.53,22.64999,44600,340505,54.788459448256944,65.6358049486934,NaN,NaN,0.7079418953985834,50.88558530900305,-0.07574099831514186,0.3779350693021222,0.45367606761726403,7978100,8215680,94.49840594778736,95.2413505580275,NaN,NaN,25.244124521724327,29.727876366066962
2003-06-25T09:30:00-04:00,22.75,22.75,22.3,22.3,65900,338810,48.47253197598467,64.12187383502553,NaN,NaN,-38.116249352283255,22.06128461486289,-0.11481609023089273,0.3101559548286481,0.42497204505954084,7912200,8114480,91.50424804899919,95.19123218141605,NaN,NaN,20.874713513398447,28.463138815685745
2003-06-26T09:30:00-04:00,22.39999,22.61,22.27,22.57001,58200,324665,52.976278484025094,62.78567414775997,NaN,NaN,-45.78256560293085,-1.1074864066193597,-0.11993173326624207,0.2750573784767383,0.39498911174298035,7970400,8042840,89.3460789858015,94.91917716403987,NaN,NaN,18.50967639841364,27.041215613218302
2003-06-27T09:30:00-04:00,22.64999,22.64999,22.25,22.35001,42200,260270,49.20271452905017,61.69972393789735,NaN,NaN,-71.32396016403305,-26.728553533176893,-0.13449202595358,0.22687407930100534,0.36136610525458535,7928200,7944480,86.33529089732015,94.3860450093064,NaN,NaN,15.333081269178676,25.368624992641212
2003-06-30T09:30:00-04:00,22.25,22.5,21.53,22.39,42600,246770,49.901285060338815,60.55714847142336,NaN,NaN,-129.68591691996176,-56.84015002876208,-0.13731027851905786,0.18972825710576302,0.3270385356248209,7970800,7951940,86.3727982461711,93.81462245059906,NaN,NaN,12.980307909744186,23.59886540937021
2003-07-01T09:30:00-04:00,22.22,22.44,22,22.44,59600,244815,50.812102421275746,59.1271201635829,NaN,NaN,-98.93145075739595,-76.76802855932098,-0.13166933764627659,0.16245186356697516,0.29412120121325175,8030400,7962400,86.42904583382885,93.21321385856,NaN,NaN,11.30318352899293,21.84233942645917
2003-07-02T09:30:00-04:00,22.60001,22.60001,22.33,22.5,398700,234760,51.94123071043927,57.73531840787048,NaN,NaN,-59.72957634316563,-81.09069395749745,-0.120083767957326,0.14401649126659422,0.2641002592239202,8429100,8065780,87.00016228818022,92.62154585384383,NaN,NaN,10.210678485593382,20.180673577764058
2003-07-03T09:30:00-04:00,22.5,22.62,22.37,22.48,10500,231655,51.5167122351178,56.740218813508285,NaN,NaN,-56.50482677429219,-83.23514619176973,-0.11021127270813383,0.12633616833875294,0.23654744104688677,8418600,8155420,87.49170624858579,92.0529295430449,NaN,NaN,9.187599075437113,18.610234363145924
2003-07-07T09:30:00-04:00,22.78999,22.92999,22.62,22.78,508000,216950,57.17123381521873,55.74060634798697,NaN,NaN,7.556880106523398,-67.45897813765843,-0.0812571856388977,0.13497595899826464,0.21623314463716234,8926600,8355100,88.5319418728558,91.5437493689514,NaN,NaN,9.83581566868133,17.35674597822241
2003-07-08T09:30:00-04:00,22.75,22.95,22.69,22.95,137700,219895,60.01695299346038,54.93760075480685,NaN,NaN,23.728918254945587,-36.77601110267696,-0.04997204231083907,0.1537680917486135,0.20374013405945257,9064300,8573800,89.55637543944047,91.06781500635687,NaN,NaN,11.215467735130348,16.479420514923543
2003-07-09T09:30:00-04:00,22.95,22.95,22.62,22.7,22700,215680,54.3027689599824,53.9303942179286,NaN,NaN,-3.2194029510899482,-17.633601541415764,-0.04555537940000631,0.14679590980944468,0.192351289209451,9041600,8776040,90.409546318974,90.62728796988247,NaN,NaN,10.77473952176094,15.664466087328886
2003-07-10T09:30:00-04:00,22.53999,22.66,22.37,22.39999,100400,196140,48.35319506871495,53.152496807861176,NaN,NaN,-62.65508794956332,-18.2187038626953,-0.061298579696665106,0.11572806458861962,0.17702664428528472,8941200,8878460,90.81861422401715,90.19566945529017,NaN,NaN,8.559696214262257,14.649498962605083
2003-07-11T09:30:00-04:00,22.62,22.73,22.46001,22.63,553800,219380,52.63762486558996,52.62320487751297,NaN,NaN,-27.875069613726623,-12.492752430582184,-0.05488795707717345,0.10841669793881792,0.16330465501599137,9495000,9093740,91.62703781927343,89.80194512924915,NaN,NaN,7.985322777122196,13.697473793250385
2003-07-14T09:30:00-04:00,22.8,22.99001,22.55,22.55,72100,221370,51.05132763994485,52.36745844338573,NaN,NaN,-3.086484367933542,-14.621425325473577,-0.0545868160787219,0.095071134917589,0.1496579509963109,9422900,9193000,91.97777426206443,89.42135903094996,NaN,NaN,7.0424639549814385,12.746758102069107
2003-07-15T09:30:00-04:00,22.56,22.78,22.37,22.41,509700,243760,48.307686828978326,51.90454611343726,NaN,NaN,-42.61704028059376,-27.89061703258144,-0.06183541154219968,0.07236368656856129,0.13419909811076097,8913200,9162780,90.73163841520231,89.15230420719388,NaN,NaN,5.436403468461349,11.702421725839427
2003-07-16T09:30:00-04:00,22.62,22.62,22.25999,22.36,50100,169235,47.329374271109224,51.82289199166045,NaN,NaN,-66.92584663288099,-40.631905768939646,-0.06755152705086824,0.04975968929717567,0.11731121634804391,8863100,9127080,89.19427023038106,88.9873057915783,NaN,NaN,3.8342656083551163,10.578399423341668
2003-07-17T09:30:00-04:00,22.17999,22.45,21.31,22.3,1268000,230615,46.12228841071079,51.333321272137994,NaN,NaN,-181.25960061444147,-64.35280830191529,-0.07249167863629505,0.026696618052675092,0.09918829668897014,7595100,8857860,78.40511767195572,88.20580855487502,NaN,NaN,2.158239959020233,9.375519499867178
2003-07-18T09:30:00-04:00,22.3,22.75,22.3,22.60001,4202199,436244.95,52.628045811677296,51.577987792325644,NaN,NaN,4.88044677357591,-57.80170502445478,-0.05354627980806444,0.0322554469288896,0.08580172673695403,11797299,9318319.8,82.33984004203157,87.9204192080687,NaN,NaN,2.53159718916709,8.397816312624307
2003-07-21T09:30:00-04:00,22.8,22.8,22.48,22.5,205200,441934.95,50.4414492593249,51.61657094939608,NaN,NaN,32.06648707945512,-50.77111073497705,-0.04602932891028276,0.02826506559910058,0.07429439450938334,11592099,9752159.6,85.09537893687113,87.82917497169012,NaN,NaN,2.2191278464896156,7.515146531747923
2003-07-22T09:30:00-04:00,22.8,22.84,22.47,22.78,670300,451124.95,55.95856577468043,51.984175474639265,NaN,NaN,78.36225505353212,-26.57525166815186,-0.02171329817799962,0.04715277178688382,0.06886606996488344,12262399,10421999.4,88.16568279963269,87.95322046924754,NaN,NaN,3.6137220038511955,6.9578001706198185
2003-07-23T09:30:00-04:00,22.95,22.95,22.50999,22.71001,244000,461094.95,54.33039823484111,52.154830297810825,NaN,NaN,85.7575878361257,3.9614352256494785,-0.010428671329879,0.055830230802534686,0.06625890213241369,12018399,11053059.2,90.21147658262947,88.1826000617082,NaN,NaN,4.292069387598636,6.576981487331079
2003-07-24T09:30:00-04:00,22.89999,23.05,22.67,22.71001,165300,466064.95,54.33039823484111,52.35580786921964,NaN,NaN,107.61130990302547,61.73561732914286,-0.003413067420384483,0.06199256785693308,0.06540563527731756,12018399,11937719,92.2373751886456,88.52157641456961,NaN,NaN,4.844491489926015,6.3294829162732125
2003-07-25T09:30:00-04:00,22.7,23.22,22.7,23.22,312800,478794.95,63.343571160918195,52.796689108198166,NaN,NaN,169.02196285872145,94.56392054617197,0.03311317550763812,0.1067971046618652,0.07368392915422708,12331199,12044499,92.440741050361,88.80077635581998,NaN,NaN,8.273957516465153,6.607265002014918
2003-07-28T09:30:00-04:00,23.39999,23.39999,23.05,23.24001,1153800,534374.95,63.646725733642434,53.05595858963974,NaN,NaN,195.37504136515344,127.22563140331165,0.054876498702882665,0.14227955253283042,0.08740305382994776,13484999,12423079,93.12812176671159,89.05590109348222,NaN,NaN,11.101386265910737,7.249282325428606
2003-07-29T09:30:00-04:00,23.25999,23.25999,22.83,22.92,1189600,591724.95,55.711489101469304,53.15658145688881,NaN,NaN,112.46227312164876,134.04563501693497,0.04442148375862372,0.1429299085282274,0.09850842476960368,12295399,12429679,93.13983356882125,89.25092161132844,NaN,NaN,11.150595577672156,7.806612790034827
2003-07-30T09:30:00-04:00,23.10001,23.10001,22.81,22.92,27600,590124.95,55.71148910146931,53.682173887799834,NaN,NaN,85.56722112149403,134.00756167400863,0.03464175285219083,0.14181061583484222,0.1071688629826514,12295399,12485079,93.24391986976318,89.42415772888172,NaN,NaN,11.189651993566361,8.289904104825046
2003-07-31T09:30:00-04:00,23.10001,23.45,23.03,23.13,441600,592269.95,59.54971485132977,54.175894601066965,NaN,NaN,149.79302520162315,142.44390473372817,0.03912070039224522,0.1560697384729579,0.11694903808071269,12736999,12628799,93.51865620967351,89.55927332819601,NaN,NaN,12.383168992224308,8.874656231596369
2003-08-01T09:30:00-04:00,23.14999,23.14999,22.89999,22.95,178000,600644.95,55.138743893310796,54.467852904878825,NaN,NaN,77.93822737485108,124.2271576369541,0.027323864636508044,0.15110386887634775,0.1237800042398397,12558999,12674359,93.60740243126853,89.67567534028203,NaN,NaN,12.069665311533491,9.331086100158815
2003-08-04T09:30:00-04:00,23.10001,23.10001,22.64999,23,189000,584694.95,56.11124467541122,55.025249893909745,NaN,NaN,48.59773928678049,94.8716972212795,0.020559878912459972,0.14947985288041465,0.12891997396795468,12747999,12526959,89.34500873745945,89.5766303633004,NaN,NaN,12.095947096134815,9.726066242441101
2003-08-05T09:30:00-04:00,23.10001,23.14999,22.55,22.61,789800,617299.95,47.467630571857505,55.0351253439632,NaN,NaN,6.437581226422169,73.66675884223417,-0.010821666808273067,0.11539289045761336,0.12621455726588643,11958199,12459519,87.38443928319651,89.44735672421577,NaN,NaN,9.371577639550933,9.675425013456792
2003-08-06T09:30:00-04:00,22.50999,22.7,22.38,22.57001,170800,624704.95,46.673688042368944,55.074511031938776,NaN,NaN,-55.192802458002674,45.51475412633484,-0.03362646445083653,0.08418147670234077,0.1178079411531773,11787399,12357919,84.38034163373099,89.87415843577115,NaN,NaN,6.9431414376873235,9.285098788346868
2003-08-07T09:30:00-04:00,22.39999,22.73,22.39999,22.71001,1054600,672414.95,49.8369609892938,54.87514783033996,NaN,NaN,-39.723338332098166,7.61148141959058,-0.03829687455670386,0.06993684795729749,0.10823372251400135,12841999,12378919,84.49895975890774,90.02838127269088,NaN,NaN,5.829181398558662,8.79139630409141
2003-08-08T09:30:00-04:00,22.89999,22.89999,22.61,22.74001,209800,655214.95,50.51437177729214,54.88035658162334,NaN,NaN,-0.7748958539987191,-8.131143226179374,-0.03828882795696453,0.06037268756779568,0.09866151552476021,13051799,12477479,85.07195186003881,90.02670791005998,NaN,NaN,5.112474984000593,8.265836115507009
2003-08-11T09:30:00-04:00,22.89999,22.97,22.69,22.92,178600,660539.95,54.48563406690324,54.77514717392497,NaN,NaN,30.423806486536527,-11.765929786228167,-0.025689557767017576,0.06654956831598824,0.09223912608300582,13230399,12573959,85.631851120892,89.84571993300709,NaN,NaN,5.640643423912287,7.890808588136334
2003-08-12T09:30:00-04:00,23.05,23.14,22.82001,23.14,233600,646734.95,58.834190685762266,55.09684663470505,NaN,NaN,75.42086513994765,2.0307269964769232,-0.003246930697970135,0.08818046271054314,0.09142739340851327,13463999,12875119,87.24057874815995,89.6335129448307,NaN,NaN,7.419267790302612,7.823445617017231
2003-08-13T09:30:00-04:00,23.35001,23.49001,23,23.06,536100,671034.95,56.712286455313134,55.266981507595915,NaN,NaN,110.05481205650204,35.08024989937787,0.0050509434362929345,0.09774107270387944,0.0926901292675865,12927899,13103219,88.30833189350122,89.35286699517754,NaN,NaN,8.28101549991098,7.888812743144909
2003-08-14T09:30:00-04:00,23,23.42,23,23.33,268000,621034.95,61.72905067829045,55.151658615979656,NaN,NaN,124.54347809956082,67.93361318570967,0.026372842401117383,0.12565618226898323,0.09928333986786585,13195899,13173999,88.62639121332299,89.0804134353891,NaN,NaN,10.602909572290542,8.276540861594285
2003-08-15T09:30:00-04:00,23.39999,23.55,23.28999,23.55,51700,413510,65.2617788327255,55.267019551628444,NaN,NaN,173.92172491280456,102.87293733907032,0.05148922640255284,0.1636448728710569,0.11215564646850405,13247599,13213159,88.80780230154153,88.77181918787696,NaN,NaN,13.729636229471218,9.055554485576703
2003-08-18T09:30:00-04:00,23.60001,23.89999,23.45,23.89999,498100,428155,70.00532171316715,56.28800759532114,NaN,NaN,223.74207195420385,141.53659043260376,0.08584558151882007,0.21946262336702915,0.13361704184820908,13745699,13316219,89.29187555870355,88.49696504429711,NaN,NaN,18.119337811620323,10.350380675011506
2003-08-19T09:30:00-04:00,24.03999,24.03999,23.78,24.03999,900000,439640,71.67169729386576,57.4280224662066,NaN,NaN,225.33490018022516,171.51939744065928,0.11059562394536784,0.2718615717799189,0.16126594783455103,14645699,13552559,90.32527048717068,88.28849008839764,NaN,NaN,22.248900056776357,12.05016915812077
2003-08-20T09:30:00-04:00,24.03,24.03,23.78,23.89999,2655100,560195,67.62570392445022,58.00487882857235,NaN,NaN,173.42097874728213,184.1926307788153,0.10990616189458502,0.2986486502027823,0.1887424883081973,11990599,13365099,83.44640799424081,87.5690437872953,NaN,NaN,24.375982627336935,13.81099965372308
2003-08-21T09:30:00-04:00,24.10001,24.21001,23.96001,24.17999,451200,574490,71.13531490548456,59.14749104372761,NaN,NaN,181.0369747436393,195.49133010763097,0.11986077445122562,0.3385684563722293,0.2187076819210037,12441799,13214279,78.28106584022919,86.47430545936392,NaN,NaN,27.370395074023318,15.748056142337399
2003-08-22T09:30:00-04:00,24.35001,24.39999,23.86,23.95,529700,585335,64.91072543036458,59.77602538336714,NaN,NaN,143.4862080708604,189.40422673924218,0.10314549220168465,0.3476395471731095,0.24449405497142487,11912099,12947179,70.0152840223228,85.09361083685415,NaN,NaN,27.85629532962562,17.47780459766429
2003-08-25T09:30:00-04:00,23.75,23.92,23.64999,23.73,960500,575670,59.543404894635536,60.638580692137005,NaN,NaN,80.48231710148804,160.752275768699,0.07099272830619252,0.3332349653541655,0.262242237047973,10951599,12388359,56.559337374600744,82.89181784338304,NaN,NaN,26.49623058454503,18.76615116721868
2003-08-26T09:30:00-04:00,23.53,23.89,23.53,23.87,365700,534475,61.71301774538035,61.71281852806639,NaN,NaN,70.57862494623448,129.80102072190087,0.053662103188254595,0.3293198660332912,0.2756577628450366,11317299,11722679,45.372809177717684,80.10556552509637,NaN,NaN,26.071081288095225,19.80971261305819
2003-08-27T09:30:00-04:00,23.7,23.87,23.67,23.85001,287200,547455,61.208272219742454,62.52505504452701,NaN,NaN,67.36398697144965,108.58962236673435,0.036197712687643324,0.3209049037045908,0.28470719101694747,11030099,11530579,42.74540444029632,77.12316871662414,NaN,NaN,25.580751974997145,20.634146807620898
2003-08-28T09:30:00-04:00,24.05,24.05,23.73,24.03999,119100,531330,64.20468509183239,63.50293456699416,NaN,NaN,78.84671249055951,88.1515699161184,0.03288228580775132,0.3258100482766366,0.2929277624688853,11149199,11272059,39.43581869729234,73.8634449192851,NaN,NaN,26.06193964296373,21.409545784098444
2003-08-29T09:30:00-04:00,23.87,24.13,23.87,24.03,136500,529255,63.92506011318277,64.17717928458556,NaN,NaN,80.1861262602983,75.49155355400598,0.02577239175550672,0.32514325216326867,0.29937086040776195,11012699,11092179,37.27332073026576,70.40926417709751,NaN,NaN,26.36980075573608,22.118153637189536
2003-09-02T09:30:00-04:00,24.39999,24.48,23.97,24.38,830700,561340,69.0163624429826,64.90447726724416,NaN,NaN,105.90674947559125,80.57644002882662,0.03957189188912241,0.34883572526916495,0.30926383338004254,11843399,11270539,40.7431090155363,67.08801633905296,NaN,NaN,28.223619559849013,22.99036305471232
2003-09-03T09:30:00-04:00,24.58,24.64,24.41,24.58,758200,559760,71.49226012296427,65.96018967207638,NaN,NaN,130.2080363569766,92.50232231097505,0.05609076069772334,0.37937728425219674,0.3232865235544734,12601599,11527399,45.42506776209848,64.02492604395276,NaN,NaN,30.579174985458792,24.074479044818958
2003-09-04T09:30:00-04:00,24.53999,24.62,24.37,24.56,1947100,648575,70.88227029661267,66.61399107338511,NaN,NaN,121.7403358875908,103.37759209420328,0.05928040248029065,0.3973870266548367,0.33810662417454607,10654499,11452279,44.32212474076889,60.860335581627474,NaN,NaN,32.28991763673654,25.248113129378613
2003-09-05T09:30:00-04:00,24.59,24.59,24.17,24.28999,565200,624105,63.05969155270266,66.45669912481205,NaN,NaN,95.96015169799827,106.80027993569104,0.037858170540599534,0.3854293373502955,0.34757116680969596,10089299,11240299,41.276448026095764,57.46523884766706,NaN,NaN,31.413068671329487,26.128821063943022
2003-09-08T09:30:00-04:00,24.5,24.55,24.31,24.41,1571900,692210,64.91313427546581,66.09297145069053,NaN,NaN,101.65528049926341,111.09411078348406,0.026936560573447232,0.381241867526505,0.3543053069530578,11661199,11369999,43.8201911920667,54.21726139290729,NaN,NaN,31.23494226695423,26.85826695008748
2003-09-09T09:30:00-04:00,24.45,24.49001,24.11,24.14999,307400,698650,58.110311536104184,65.12430103942185,NaN,NaN,66.03047555820595,103.11885600000701,-0.001144316604827389,0.3528749111970235,0.3540192278018509,11353799,11272079,42.32939220863029,50.788984373011544,NaN,NaN,28.94912459462578,27.156960899307236
2003-09-10T09:30:00-04:00,23.94,24.10001,23.82001,23.87,58500,689895,51.81329362982234,63.99484316123414,NaN,NaN,-7.569213356951025,75.56340605722147,-0.03978071285171553,0.3042933367372065,0.344074049588922,11295299,11010819,38.56002595189754,47.58281422712987,NaN,NaN,24.909888154563976,26.835950507201055
2003-09-11T09:30:00-04:00,23.87,24.17,23.75,24.07001,485400,687360,55.52119921160719,62.87954918310004,NaN,NaN,-1.8029583257035353,50.8547472145626,-0.05228457329766323,0.278718332966843,0.33100290626450624,11780699,11236059,43.25178590373656,45.080722803094694,NaN,NaN,22.6949530992594,26.244379448923677
2003-09-12T09:30:00-04:00,24.07001,24.14999,23.8,24.06,1639700,755945,55.291885578188214,62.19248919365888,NaN,NaN,-11.375702656871464,29.38757634358867,-0.06103741218506781,0.25470614103317146,0.31574355321823927,10140999,11246399,43.46521822310726,43.18428953172215,NaN,NaN,20.873434841495342,25.477101647862487
2003-09-15T09:30:00-04:00,24.25,24.25,24,24.09,271600,766940,55.88002214774042,61.93081899745208,NaN,NaN,13.218049923188955,11.700130228373776,-0.0642878838127634,0.23538369845228502,0.2996715822650484,10412599,10996679,39.59231737654878,41.972359531861294,NaN,NaN,19.557629802973945,24.63146281287841
2003-09-16T09:30:00-04:00,24.07001,24.47,23.91,24.39999,36500,743860,61.51389343935001,61.91659583273563,NaN,NaN,54.774098789361794,9.448854874604944,-0.04590435036315321,0.24229114431110688,0.2881954946742601,10449099,10815739,37.01849143599499,41.375622550309686,NaN,NaN,20.07130259855094,23.980011353688774
2003-09-17T09:30:00-04:00,24.55,24.55,24.27,24.3,238400,710780,58.90119486708719,61.75180459326025,NaN,NaN,83.06020287441284,27.574738120877715,-0.04098407736418419,0.23696539796902982,0.277949475333214,10210699,10598819,34.15210084962571,40.76181515097606,NaN,NaN,19.720771736760433,23.37154855127044
2003-09-18T09:30:00-04:00,24.45,24.63,24.28,24.59,758000,615925,63.714812373645366,61.71681368481832,NaN,NaN,108.86501100170815,49.70833198636006,-0.019778582315156168,0.2532262474392688,0.27300482975442497,10968699,10436419,32.14529577325024,40.24106351354448,NaN,NaN,20.911993017737387,23.020183475051432
2003-09-19T09:30:00-04:00,24.60001,24.67,24.25999,24.39999,105800,598655,58.85118041238383,61.35439370618983,NaN,NaN,81.23015023504236,68.22950256474283,-0.020065490092450122,0.2479229671388623,0.2679884572313124,10862899,10580799,35.759418736872945,40.13292765687357,NaN,NaN,20.403456017438874,22.646365266821068
2003-09-22T09:30:00-04:00,24.2,24.25,24.00999,24.08,188400,581590,51.69453412787635,60.11712025511081,NaN,NaN,-16.33441796521756,62.31900898706152,-0.042057666036732555,0.21541637468539676,0.2574740407221293,10674499,10633179,37.06899492770646,39.8704909363143,NaN,NaN,17.610944722457024,21.92701947476906
2003-09-23T09:30:00-04:00,23.95,24.2,23.95,24.17,506500,558890,53.41059361298824,58.825572647255385,NaN,NaN,-25.246805097969997,46.31482820959516,-0.05024095544692342,0.19467284641347504,0.24491380186039846,11180999,10779559,40.706702976355,39.533464880189754,NaN,NaN,15.894489398536468,21.06522946387869
2003-09-24T09:30:00-04:00,24.35001,24.35001,23.67999,23.7,204700,550840,44.5165783391458,56.94230893600775,NaN,NaN,-93.88680727582933,10.92542617954673,-0.08496350318473525,0.1387094228794794,0.22367292606421466,10976299,10932679,44.33168698128642,39.53414789736958,NaN,NaN,11.264078741445942,19.665065074959728
2003-09-25T09:30:00-04:00,23.62,23.75,23.45,23.52,105500,541755,41.65567014058783,55.413450263713834,NaN,NaN,-191.30018228569287,-49.10761247793347,-0.11579935904548819,0.07892372725735441,0.1947230863028426,10870799,10913099,43.96156989221393,39.72594231637802,NaN,NaN,6.537626296182232,17.789716677991514
2003-09-26T09:30:00-04:00,23.33,23.5,23.22,23.27,178200,544710,38.00267955513472,53.49127492654732,NaN,NaN,-225.7509246881751,-110.50382746257696,-0.14678595152155277,0.011240646900901652,0.15802659842245442,10692599,10879039,43.28459144571039,39.68768519163829,NaN,NaN,1.3535602313647574,15.441694328473407
2003-09-29T09:30:00-04:00,23.45,23.61,23.25999,23.50999,710500,573410,43.15610585803808,52.42311737811402,NaN,NaN,-163.87005654949013,-140.0109551794315,-0.14463808243804563,-0.02277100462510262,0.12186707781294301,11403099,11024759,47.04203236950794,40.02430234598669,NaN,NaN,-1.2489477677746683,13.057316886152254
2003-09-30T09:30:00-04:00,23.60001,23.60001,23.05,23.28999,256700,544710,39.88324282059563,51.570970891740686,NaN,NaN,-164.5794599714856,-167.8774861541346,-0.1508605973490712,-0.066708668873396,0.08415192847567521,11146399,11017839,46.88318507587617,40.61881371198516,NaN,NaN,-4.485517273374113,10.55119772050563
2003-10-01T09:30:00-04:00,23.39999,23.8,23.35001,23.75,31900,508395,48.65200595914701,51.080314230850675,NaN,NaN,-84.75723360426205,-166.05157141982116,-0.11826282088276079,-0.06367659762777578,0.05458622325498501,11178299,11058239,47.98742153284772,40.95707339977882,NaN,NaN,-4.276343630332165,8.432977527528802
2003-10-02T09:30:00-04:00,23.64999,23.89999,23.64999,23.86,70400,414560,50.51093221786026,50.73881756225582,NaN,NaN,-42.426913295219435,-136.27691762172645,-0.08510934278471204,-0.05180045522590504,0.033308887558806996,11248699,11133819,50.07830387277749,41.42943666046955,NaN,NaN,-3.49016532342261,6.729671405964314
2003-10-03T09:30:00-04:00,23.91,24.35001,23.91,24.10001,202500,396425,54.39076331132925,50.6324419310836,NaN,NaN,31.43305792080284,-84.84012109993087,-0.0448546058940538,-0.022759369808760255,0.022095236085293547,11451199,11285539,54.0698377525651,42.463545258756426,NaN,NaN,-1.5465210140164634,5.547358203109917
2003-10-06T09:30:00-04:00,24.24001,24.24001,24.03999,24.11,99100,322785,54.55048124016797,50.135055345427745,NaN,NaN,38.64228079646627,-44.33765363073959,-0.01683626370338927,0.0010499064560569593,0.01788617015944623,11550299,11314979,54.82463757256873,43.73541283994026,NaN,NaN,0.023655105158738386,4.7582577605454635
2003-10-07T09:30:00-04:00,23.89999,24.23,23.89999,24.23,86900,311760,56.52013328431866,49.964979518087134,NaN,NaN,38.52330468043042,-3.7171007003563816,0.009102729999111266,0.029264582658335314,0.020161852659224048,11637199,11413139,57.341835691271534,45.39182247148641,NaN,NaN,1.9196141906665698,4.352737250562765
2003-10-08T09:30:00-04:00,24.08,24.25,24.00999,24.12,232400,320455,54.20131780807933,49.28544419197528,NaN,NaN,37.24764989952721,20.683876000401472,0.017679853799842913,0.04226166990902769,0.024581816109184775,11404799,11458439,58.491319907977974,47.27368133825267,NaN,NaN,2.8265717878010075,4.1347136130253705
2003-10-09T09:30:00-04:00,24.37,24.5,24.23,24.28,153600,303865,56.966846487540664,49.15084891162934,NaN,NaN,80.14454045127553,45.19816674970045,0.032115740166493614,0.06472649131730179,0.03261075115080818,11558399,11520379,60.075477078137226,49.010542648342984,NaN,NaN,4.412628096113687,4.174415682037987
2003-10-10T09:30:00-04:00,24.48,24.48,24.05,24.14,67900,225275,53.899902123466546,49.30837519702863,NaN,NaN,50.18989001127643,48.94953316779517,0.030248534975374552,0.07042141987002637,0.04017288489465182,11490499,11528239,60.282622783453014,50.66865892375345,NaN,NaN,4.878729310044537,4.275031914610351
2003-10-13T09:30:00-04:00,24.38,24.47,24.10001,24.24001,143900,218890,55.73331709495352,49.47428401716901,NaN,NaN,57.83218961150816,52.78751493080354,0.03350868478376303,0.0820587408743556,0.048550056090592576,11634399,11545059,60.75191440986238,52.10045974043255,NaN,NaN,5.793135002309613,4.491903784281674
2003-10-14T09:30:00-04:00,24.3,24.42,24.08,24.36,170300,225580,57.89683256335685,50.43001646175552,NaN,NaN,61.01847640887727,57.286549276492906,0.0410103627847133,0.0998130095714842,0.0588026467867709,11804699,11578559,61.72201073358427,53.342625722739534,NaN,NaN,7.185444630897836,4.876695333798269
2003-10-15T09:30:00-04:00,24.66,24.66,24.23,24.39999,155200,221420,58.622665332171294,51.641944689725776,NaN,NaN,91.26030194038162,68.0890796846638,0.04557841411022062,0.11577566442454668,0.07019725031432605,11959899,11689579,64.82494296398633,54.83286665643756,NaN,NaN,8.545093460689698,5.4007522090684725
2003-10-16T09:30:00-04:00,24.17999,24.5,24,24.41,430100,205025,58.81406364394018,53.128472124640446,NaN,NaN,67.29884648794125,65.51994089199694,0.046051124283945866,0.12776115566925839,0.08171003138531252,12389999,11855899,68.89318395842425,56.66205183591712,NaN,NaN,9.729744164980584,6.019179631341631
2003-10-17T09:30:00-04:00,24.49001,24.49001,24.12,24.24001,300200,214745,54.22670410865296,53.91922914254151,NaN,NaN,65.85713934134202,68.65339075801005,0.03234003440064778,0.12213507438612226,0.08979503998547447,12089799,11975759,71.45537053564325,58.405861704926785,NaN,NaN,9.567801623122152,6.526125630167419
2003-10-20T09:30:00-04:00,24.35001,24.35001,24.14,24.3,167100,213680,55.54449738802279,55.037890183072015,NaN,NaN,58.5557769890119,68.7981082335108,0.02506064826033068,0.12112085031088782,0.09606020205055714,12256899,12100259,73.86351294924074,60.33302798159569,NaN,NaN,9.776000058694965,6.990393405671354
2003-10-21T09:30:00-04:00,24.45,24.45,24.25,24.25999,70100,191860,54.41921442263362,55.44983364474963,NaN,NaN,67.14873369337434,70.02415969041022,0.015755242204998923,0.11575425480680579,0.09999901260180687,12186799,12176679,75.24408508473117,62.27993252101594,NaN,NaN,9.664255524768189,7.372373708399474
2003-10-22T09:30:00-04:00,24.05,24.25,23.95,23.98,204400,191845,47.21107403629913,55.21412948892384,NaN,NaN,9.028981179382543,53.577895538210406,-0.009683101467567734,0.0878951357673472,0.09757823723491493,11982399,12181179,75.32673239458377,64.08339170114496,NaN,NaN,7.53807080810288,7.396044722642817
2003-10-23T09:30:00-04:00,23.99001,24.12,23.85001,24.03999,166200,194880,48.776600420288,54.813117853849455,NaN,NaN,-9.253512941966349,38.267423652228885,-0.022180938789829116,0.06985206374762853,0.09203300253745765,12148599,12132899,72.52903293811167,65.40190564296971,NaN,NaN,6.166229558678857,7.220356842076537
2003-10-24T09:30:00-04:00,23.78,24.10001,23.75,24.05,281600,200050,49.04813027647694,54.42009278501438,NaN,NaN,-31.14794808844138,18.86640616627221,-0.029051812138213895,0.05571823736469028,0.08477004950290418,12430199,12200979,73.99570808100758,66.77126782214391,NaN,NaN,5.092678946141907,6.9164028569430185
2003-10-27T09:30:00-05:00,24,24.21001,24,24.06,151600,172105,49.337058653041275,53.907016025637425,NaN,NaN,-5.078974394286575,6.139455889612519,-0.03197005416588214,0.044807481795551496,0.07677753596143364,12581799,12265959,75.34855072223984,68.05746175292735,NaN,NaN,4.258915368679674,6.536761787191113
2003-10-28T09:30:00-05:00,24.13,24.34,24.08,24.34,67800,162660,56.73497979280045,54.087991881688936,NaN,NaN,46.70435039005003,2.0505792289476537,-0.014954248936567424,0.05808472479072435,0.07303897372729178,12649599,12358519,77.17046383328595,69.39168631902078,NaN,NaN,5.523726513661843,6.392042462401217
2003-10-29T09:30:00-05:00,24.37,24.58,24.34,24.5,134000,167765,60.30221847989451,54.32623273828564,NaN,NaN,141.6585566787505,28.57649432882124,0.006039798399485596,0.08058872172664877,0.07454892332716317,12783599,12518759,79.93519227557165,70.81023740455181,NaN,NaN,7.674475796552066,6.575247224422767
2003-10-30T09:30:00-05:00,24.85001,24.87,24.56,24.69,166800,172585,64.08876976595727,55.05400899846355,NaN,NaN,239.2501665069135,78.27723021859721,0.030327552156561716,0.11245836352286531,0.0821308113663036,12950399,12679119,82.25164430488537,72.37945322751126,NaN,NaN,10.720050741213154,7.167362012535679
2003-10-31T09:30:00-05:00,24.88,24.88,24.7,24.73,645000,194710,64.84893356814058,55.70512446083406,NaN,NaN,225.9955595412208,129.70593174452966,0.04576476090443411,0.13933676249684623,0.09357200159241212,13595399,12912159,84.96766916755911,74.10914999591817,NaN,NaN,13.452293556106792,8.065209375902981
2003-11-03T09:30:00-05:00,24.88,25.02,24.78999,24.85001,131120,196311,67.09915900231783,56.362433492188416,NaN,NaN,218.609241221974,174.44357486778176,0.05984711964744159,0.1683809011517141,0.10853378150427252,13726519,13141103,87.06233603090755,75.91917323144126,NaN,NaN,16.46978999222463,9.265863749663216
2003-11-04T09:30:00-05:00,25,25,24.8,24.92,44140,194173,68.37084067916848,57.05873173125964,NaN,NaN,178.6022904811879,200.82316288600936,0.06901350090423497,0.19480065763456622,0.12578715673033125,13770659,13365315,88.72005161191709,77.62596670629345,NaN,NaN,19.384032719367877,10.711316459621024
2003-11-05T09:30:00-05:00,24.99001,24.99001,24.73,24.89999,63100,185708,67.56675879243366,57.683924241866315,NaN,NaN,138.4793049821459,200.18731254668842,0.06871724038662813,0.2116837072136164,0.14296646682698827,13707559,13550107,89.87189002403632,79.12444571098004,NaN,NaN,21.590970104019757,12.265552694535128
2003-11-06T09:30:00-05:00,24.86,25.05,24.75,25.03,167300,186393,70.03274516928167,58.81292717476837,NaN,NaN,132.01596536722147,178.74047231875002,0.07192281522755678,0.23286998586143426,0.16094717063387748,13874859,13734999,90.87580855739897,80.51161985539116,NaN,NaN,24.239086375838095,13.976057506149838
2003-11-07T09:30:00-05:00,25.03999,25.14999,24.89,24.94,272200,196608,66.27603840742053,59.579465819011055,NaN,NaN,123.09686459494984,158.16073332949583,0.06295078023835105,0.2396356459318163,0.17668486569346525,13602659,13736451,90.88345102686185,81.72732971807838,NaN,NaN,25.489889499094957,15.62089064799914
2003-11-10T09:30:00-05:00,25.10001,25.10001,24.7,24.71001,692800,224053,57.75065041027484,59.817425532414,NaN,NaN,77.24599747102226,129.88808457930548,0.03773907190721243,0.22385870557748078,0.18611963367026835,12909859,13573119,82.51121169075887,82.2464101899375,NaN,NaN,24.099988623683604,16.832190358811207
2003-11-11T09:30:00-05:00,24.64999,24.75,24.59,24.62,160600,223568,54.78068388879265,60.358111950449256,NaN,NaN,33.19716269321725,100.80705902171132,0.01251747195368691,0.20176647361237698,0.18924900165869007,12749259,13368839,73.40343336436452,82.10903168777898,NaN,NaN,22.04245143025294,17.576513369017167
2003-11-12T09:30:00-05:00,24.69,25.07001,24.67999,25.02,751300,253373,63.71193661174823,61.42492167841069,NaN,NaN,81.90079552361257,89.49135713000467,0.019854593665844245,0.2140672437409954,0.19421265007515115,13500559,13327439,71.67665580273686,82.04814760668079,NaN,NaN,23.00794381679348,18.352432004413785
2003-11-13T09:30:00-05:00,24.82001,25.06,24.82001,25.00999,1747200,319228,63.374600841463185,62.44824100448115,NaN,NaN,81.45947236186359,79.38005852893309,0.02100313432961526,0.22046656798717024,0.19946343365755498,11753359,12903139,56.902336083002346,80.82719246396614,NaN,NaN,23.6571169009696,19.110244132493186
2003-11-14T09:30:00-05:00,25.12,25.12,24.75,24.82001,74800,307958,57.18603438228798,63.008882127998774,NaN,NaN,62.43711503368187,67.2481086166795,0.006679448536625138,0.2078127443283364,0.20113329579171127,11678559,12518319,47.366288647468146,78.82845945862529,NaN,NaN,22.23560582203867,19.556724373856827
2003-11-17T09:30:00-05:00,24.60001,24.75,24.45,24.75,119500,305578,55.05255155178728,62.88870868221211,NaN,NaN,8.945303176949091,53.587969757864855,-0.008950076460710693,0.1899457002158229,0.1988957766765336,11559059,12248159,42.03973427749596,76.31912163321172,NaN,NaN,20.41357841589111,19.679132094147437
2003-11-18T09:30:00-05:00,24.85001,24.89999,24.57001,24.63,122800,308213,51.50556777655375,62.260376489116354,NaN,NaN,16.561827431325334,50.260902705486465,-0.02774859662567375,0.16421003089444142,0.19195862752011517,11436259,11985559,37.61218021373467,73.29604934308051,NaN,NaN,17.77935377805348,19.4077351918483
2003-11-19T09:30:00-05:00,24.72,24.94,24.64,24.85001,92800,302633,56.978422711502446,61.75249455665529,NaN,NaN,37.687471633352764,41.418237927434504,-0.025786043538621767,0.15972607309683795,0.18551211663545972,11529059,11591259,32.13885719904772,69.71656454980639,NaN,NaN,17.18538576795311,19.090256702720417
2003-11-20T09:30:00-05:00,24.73,24.98,24.62,24.67,441700,316408,51.8249514775637,60.82221012161409,NaN,NaN,16.885299491332724,28.50340335332832,-0.03638330249295202,0.1400329885192697,0.17641629101222173,11087359,11458059,30.522968404728914,65.82765735246139,NaN,NaN,15.00978652205358,18.507332391196584
2003-11-21T09:30:00-05:00,24.75,24.8,24.53999,24.69,43300,304493,52.34072014583806,59.76803591757982,NaN,NaN,-24.090751581997214,11.197830030192511,-0.041450186639168635,0.12460355771326093,0.16605374435242956,11130659,11348479,29.221323059574317,61.69615642593758,NaN,NaN,13.436555940633493,17.78293575540186
2003-11-24T09:30:00-05:00,24.78999,24.99001,24.78,24.99001,62900,300058,59.36805745339975,59.12497997288206,NaN,NaN,67.94402426384809,22.997574247572338,-0.024821067151803322,0.1350274104126754,0.15984847756447873,11193559,11275379,28.352700514564077,57.38420277612665,NaN,NaN,14.292643783667417,17.284322616582653
2003-11-25T09:30:00-05:00,25.05,25.25,25,25.19,214900,307413,63.257353412994796,58.81716530292214,NaN,NaN,175.80097325219157,54.845403411745586,-0.0017915093324105125,0.15760909089896558,0.1594006002313761,11408459,11269819,28.28383344698443,52.985055877765795,NaN,NaN,16.31396858330491,17.14570061182869
2003-11-26T09:30:00-05:00,25.3,25.3,24.98,25.19,168000,309113,63.257353412994796,58.33320874890165,NaN,NaN,170.40501237605324,81.38891156028568,0.011283660386231492,0.17350517571416546,0.16222151532793397,11408459,11245699,27.966480763722814,48.49153246393178,NaN,NaN,17.8914960146731,17.252242812235036
2003-11-28T09:30:00-05:00,25.25999,25.27,25.14999,25.22,132500,307398,63.85919687504106,58.16057721087454,NaN,NaN,178.9041662034447,113.79268490270809,0.019323002659576954,0.18637526865240517,0.1670522659928282,11540959,11336419,31.09793840494065,44.22113870522312,NaN,NaN,19.348058650929257,17.55164507490564
2003-12-01T09:30:00-05:00,25.39999,25.59,25.3,25.59,326900,291493,70.31701533351797,59.05817470539183,NaN,NaN,259.4274137865841,170.49631797642434,0.04543851491035686,0.2238504096307743,0.17841189472041744,11867859,11483859,35.96978737502451,40.896751254099236,NaN,NaN,22.859627347268017,18.309928256671693
2003-12-02T09:30:00-05:00,25.78999,25.89,25.44,25.53999,200600,294967,68.53448471517626,60.04058905013351,NaN,NaN,234.82803757666932,203.8731206389886,0.054607181456553605,0.24667087154110945,0.19206369008455584,11667259,11578599,38.95656772967303,38.436260851621284,NaN,NaN,25.114694586512037,19.28203773236317
2003-12-03T09:30:00-05:00,25.75,25.75,25.53,25.56,441200,314820,68.87447628984214,60.40934188428307,NaN,NaN,180.45454912991715,204.8038358145337,0.05701730878730016,0.26333532606868104,0.20631801728138088,12108459,11718599,43.17487381595244,36.400419281136685,NaN,NaN,27.028335403210185,20.388651685341316
2003-12-04T09:30:00-05:00,25.58,25.67,25.52,25.64,177400,320535,70.25813531997477,60.901022918462466,NaN,NaN,145.96197391113847,199.91522812155077,0.058763439487522634,0.27977231664078417,0.22100887715326153,12285859,11894079,48.023211499940665,35.76619609663228,NaN,NaN,29.04071563283162,21.624660820697073
2003-12-05T09:30:00-05:00,25.61,25.66,25.42,25.45,822800,353310,63.08532930058116,61.322401126911984,NaN,NaN,103.77528339919246,184.8894515607003,0.04263715191085132,0.2743053170418257,0.23166816513097438,11463059,11878499,47.63461434535733,35.78536221791008,NaN,NaN,28.675426479089676,22.6319130576103
2003-12-08T09:30:00-05:00,25.60001,25.69,25.46001,25.67999,181900,348795,67.42112302170813,62.20587051762062,NaN,NaN,109.29046839073382,154.86206248153024,0.04285974737966164,0.28524284935555144,0.2423831019758898,11644959,11833919,46.47575125880407,36.102220573717794,NaN,NaN,29.706847444594906,23.642617970036675
2003-12-09T09:30:00-05:00,25.72,25.86,25.61,25.67999,149900,321650,67.42112302170813,63.3426958922745,NaN,NaN,115.57061793888649,131.0105785539737,0.0385427266532527,0.2905615102924557,0.252018783639203,11644959,11829459,46.35425063196871,36.72665417502022,NaN,NaN,30.525845316104018,24.62593616233201
2003-12-10T09:30:00-05:00,25.55,25.75,25.5,25.63,228900,325065,65.48230467845943,63.95011603277142,NaN,NaN,87.69798845402308,112.45926641879487,0.0283285761179925,0.28742950378669363,0.25910092766870113,11416059,11690979,42.6279063113078,37.4758719687531,NaN,NaN,30.651184618344075,25.486685941762307
2003-12-11T09:30:00-05:00,25.69,26.08,25.69,26.03,398600,307430,72.33717451509362,65.41527482116642,NaN,NaN,128.0556878067966,108.87800919792649,0.04360640550013384,0.3136089345438684,0.27000252904373456,11814659,11596739,40.256209328804054,38.171103463329885,NaN,NaN,33.004983860661206,26.560728501605006
2003-12-12T09:30:00-05:00,25.8,26.11,25.8,26.07001,1787700,309455,72.91654286312055,66.88497644382946,NaN,NaN,121.4018072926446,112.40331397661694,0.050988116354635626,0.33373767448702907,0.28274955813239344,13602359,12024599,53.03270702381193,39.87191660363258,NaN,NaN,35.061741585797826,27.77515894220398
2003-12-15T09:30:00-05:00,26.42,26.42,26.00999,26.10001,416900,326560,73.3669614795342,67.88489815998192,NaN,NaN,135.2126782185365,117.58775594217745,0.05227870456273048,0.34809793883580653,0.29581923427307605,14019259,12499459,62.593864544017116,42.31771403430779,NaN,NaN,36.85897452714021,29.072846882909158
2003-12-16T09:30:00-05:00,26.3,26.3,25.96001,26.25999,475700,344370,75.68887680095229,68.77286411626459,NaN,NaN,124.93072893555892,119.45977814151195,0.05785970653467365,0.36814386744141814,0.3102841609067445,14494959,13069459,70.38670276129156,45.32506184247263,NaN,NaN,39.1271719271203,30.509179032082177
2003-12-17T09:30:00-05:00,26.35001,26.35001,26.07001,26.28999,470700,361765,76.10949802293554,69.69087444554607,NaN,NaN,128.41353873137115,127.60288819698158,0.05741039747110693,0.38204715774562814,0.3246367602745212,14965659,13779379,76.85429313119732,48.817048440149385,NaN,NaN,41.10200406750421,32.02243975142818
2003-12-18T09:30:00-05:00,26.45,26.60001,26.33,26.59,435500,378900,79.86185960211475,70.8339217831942,NaN,NaN,161.5847955655569,134.30870974873363,0.07030551729922174,0.4125186568985484,0.34221313959932664,15401159,14496679,81.29861590664433,52.4028111188425,NaN,NaN,44.13737041856996,33.75314413244843
2003-12-19T09:30:00-05:00,26.64999,26.64999,26.32001,26.48,467100,380170,75.19818337523056,71.18257664331652,NaN,NaN,140.59052300838783,138.14645289188226,0.06456256230538049,0.42291634248105225,0.35835378017567177,14934059,14763019,82.63214238099127,55.735836476411556,NaN,NaN,45.214669279775876,35.390504867780926
2003-12-22T09:30:00-05:00,26.55,26.67999,26.41,26.64,938400,424925,77.27678267427123,71.80702649753759,NaN,NaN,136.75136178403417,138.4541896049818,0.0645222963748246,0.4390066506442025,0.37448435426937793,15872459,15133659,84.30894035499794,58.975291663934755,NaN,NaN,46.7837706677076,37.01811426777045
2003-12-23T09:30:00-05:00,26.82001,26.82001,26.61,26.7,200200,431790,78.02068743911965,72.46032729391456,NaN,NaN,139.26598123189476,141.32124006424897,0.061529650529575375,0.4513964174313472,0.3898667669017718,16072659,15449199,85.58490547437333,62.00457963953625,NaN,NaN,48.28839741198866,38.62815471694448
2003-12-24T09:30:00-05:00,27,27,26.53,26.60001,265000,434295,73.69104308805356,72.70553499163448,NaN,NaN,124.30298512881224,140.4991293437372,0.04649296303731215,0.447982970698412,0.4014900076610998,15807659,15617599,86.22853933619113,64.73353162783987,NaN,NaN,48.258624227711366,40.00393607562546
2003-12-26T09:30:00-05:00,26.72,26.72,26.53,26.55,94100,430600,71.55233634036469,73.31032120876186,NaN,NaN,96.12380577091311,127.40693138480842,0.027779191548136795,0.43621399709627084,0.40843480554813405,15713559,15680079,86.46992158035808,67.50748214462563,NaN,NaN,47.612509709265474,41.090875166145466
2003-12-29T09:30:00-05:00,26.75,26.89,26.64999,26.89,244900,436220,76.5378611538317,73.96151678962784,NaN,NaN,117.01598638342874,122.69202405981659,0.03256791453999497,0.4491446987231278,0.4165767841831328,15958459,15884959,87.25857560551492,70.42054102653354,NaN,NaN,48.581794724022735,42.1610065315565
2003-12-30T09:30:00-05:00,27.05,27.05,26.7,26.73,495500,444650,70.29459354669346,74.16676468426965,NaN,NaN,108.73697949263145,117.08914760153604,0.01985345220747864,0.44139359944248113,0.4215401472350025,15462959,15803059,85.12258166217329,73.18970752869102,NaN,NaN,47.375446773503704,42.905926566120385
2003-12-31T09:30:00-05:00,26.8,26.89,26.67999,26.75999,253600,447300,70.77578690174644,74.54487055736159,NaN,NaN,91.32312651087635,107.50057665733236,0.008914313447013933,0.4326830390437699,0.423768725596756,15716559,15731839,83.21494363198065,76.0887816230248,NaN,NaN,46.558623982217604,43.4277404827057
2004-01-02T09:30:00-05:00,27,27.00999,26.63,26.74001,118300,431155,69.96266775980678,74.37526293198394,NaN,NaN,85.18826308279965,99.67763224812987,-0.003547925346823244,0.41933381891322696,0.4228817442600502,15598259,15689959,82.05049118629336,79.07408746998831,NaN,NaN,45.660410451354274,43.746693335369784
2004-01-05T09:30:00-05:00,27.05,27.05,26.82001,27,302600,437415,74.12796428475717,74.46179303352942,NaN,NaN,102.10464666081252,100.87380042610974,0.0015635951947864934,0.42483623825353334,0.42327264305874684,15900859,15727419,82.28921949333278,81.16383836066836,NaN,NaN,46.11963600908573,44.085685145900634
2004-01-06T09:30:00-05:00,27.14999,27.14999,26.87,26.96001,360900,414320,72.46346689840917,74.39725770630619,NaN,NaN,101.78719385753335,97.82804192093066,-0.0017255332673715151,0.42111572647453244,0.42284125974190395,15539959,15643719,79.73736676238482,82.38837423340892,NaN,NaN,45.99513288171486,44.358463393874096
2004-01-07T09:30:00-05:00,27,27.03999,26.75999,27,558400,433145,73.11362353883388,74.21331104472631,NaN,NaN,87.48290367361294,93.57722675712697,-0.004999534636970837,0.4165918414456904,0.42159137608266123,16098359,15770799,80.715198799329,83.1261239504116,NaN,NaN,46.077830225979476,44.60408722703201
2004-01-08T09:30:00-05:00,27.14999,27.25,27.02,27.17,653000,458300,75.73631772047511,74.1866553088363,NaN,NaN,122.56846990109287,99.82629543517025,0.0002159033474854466,0.421861255267018,0.42164535191953256,16751359,15977759,82.2200475963713,83.50939212649544,NaN,NaN,46.92627737290654,44.93582867644266
2004-01-09T09:30:00-05:00,26.95,27.13,26.83,26.89999,1932100,543460,64.9065420503174,73.11841834085075,NaN,NaN,79.24484299034732,98.6376114166798,-0.017601946769766452,0.39964291845732447,0.4172448652270909,14819259,15821959,77.32811098088897,83.22578463179865,NaN,NaN,44.23722898763777,44.83602872089911
2004-01-12T09:30:00-05:00,26.83,27.03999,26.83,26.99001,695700,558315,66.62027021552484,72.50571025801464,NaN,NaN,74.45276601996346,93.10723528851,-0.02590618259301103,0.38486213698582716,0.4107683195788382,15514959,15744779,74.94912613670242,82.67699775720658,NaN,NaN,42.552992340945615,44.509880666620035
2004-01-13T09:30:00-05:00,27.14,27.16,26.73,26.88,309100,484385,62.59727916135181,71.45717429280612,NaN,NaN,63.047403368442815,85.35927719069188,-0.04051854938519106,0.36012013284734934,0.4006386822325404,15205859,15677959,72.85922752703466,81.85916112663779,NaN,NaN,39.89765792392224,43.850991703377495
2004-01-14T09:30:00-05:00,27,27.28999,27,27.25,336600,480370,69.30993939719369,70.83497800409711,NaN,NaN,132.60339088264035,94.38337463249736,-0.027593259267627623,0.3661471081480059,0.3937403674156335,15542459,15566779,69.39207156425442,80.70253013305786,NaN,NaN,39.68063137204271,43.25522594175824
2004-01-15T09:30:00-05:00,27.39999,27.42,27.09,27.28999,764700,494820,69.93791805977642,70.56689764493447,NaN,NaN,152.61482368613824,100.39264538950644,-0.01908304097515434,0.3698865661966906,0.3889696071718449,16307159,15477939,66.6622434370463,79.30493756883322,NaN,NaN,39.71190874504724,42.749037770799525
2004-01-16T09:30:00-05:00,27.55,27.8,27.42999,27.8,757800,509175,76.53295839068032,70.92265636281415,NaN,NaN,250.70278664370775,134.6842341201785,0.016252848584210056,0.4092856679021075,0.39303281931789746,17064959,15927079,72.54303570453338,78.31016000627433,NaN,NaN,42.17181798070356,42.66657780078582
2004-01-20T09:30:00-05:00,27.85001,27.95,27.34,27.46001,744000,524600,66.11939411333441,70.17848014563577,NaN,NaN,191.874911182328,158.16866315265142,0.012268125699004429,0.408367976441653,0.3960998507426486,16320959,16088279,74.29560364602548,77.38423343773935,NaN,NaN,40.30129671901938,42.328680503390615
2004-01-21T09:30:00-05:00,27.55,27.73,27.24001,27.64999,311400,516815,68.68357960370098,70.0634077211363,NaN,NaN,149.9796584436403,175.55511416769093,0.01764037621187431,0.4181503210074915,0.4005099447956172,16632359,16373579,77.08358829268747,76.81001962563323,NaN,NaN,39.76451781354944,41.96237154769902
2004-01-22T09:30:00-05:00,27.85001,27.85001,27.48,27.52,251700,482480,65.05556151514162,69.65482019352167,NaN,NaN,141.71687101970997,177.37781019510484,0.00813583024944231,0.4106797326074201,0.40254390235797777,16380659,16541219,78.5554292687205,76.47719717111464,NaN,NaN,38.07112916233454,41.40647977836124
2004-01-23T09:30:00-05:00,27.62,27.67,27.25,27.42,521700,498555,62.32800060634893,69.10948682541755,NaN,NaN,86.82811706831339,164.22046887153988,-0.008299610992353823,0.3921693886175355,0.4004689996098893,15858959,16451579,75.7536948039978,76.02742600095068,NaN,NaN,35.820171190161716,40.608435694332734
2004-01-26T09:30:00-05:00,27.3,27.78,27.3,27.77,367300,503670,67.46892452550554,68.63384112832816,NaN,NaN,111.71007006867572,136.4219255565335,0.0005192350769127052,0.4011180434560302,0.4005988083791175,16226259,16283839,70.6740841023268,75.19777347302168,NaN,NaN,35.64731561926721,39.89970425503766
2004-01-27T09:30:00-05:00,27.78999,27.85001,27.48,27.5,964300,547180,60.5987669701909,67.78636256202685,NaN,NaN,98.29316844327835,117.70557700872355,-0.014863454316220659,0.38201949048384165,0.3968829448000623,15261959,16072039,64.76848018011556,74.12856728857388,NaN,NaN,33.08550632149256,38.92624740738836
2004-01-28T09:30:00-05:00,27.7,27.7,27,27.07001,920000,580935,51.58925192708193,66.24890744690171,NaN,NaN,12.940049747185991,90.2976552694327,-0.05478512249408457,0.3284015416824566,0.3831866641765412,14341959,15613959,54.21646549323598,72.23580062385294,NaN,NaN,27.530392129489673,37.298268081974264
2004-01-29T09:30:00-05:00,27.35001,27.35001,26.82001,27.08,1215800,616950,51.76866691039905,64.53693238903914,NaN,NaN,-32.89129423083061,55.37602221932457,-0.07979122525933885,0.2834476326023676,0.36323885786170645,15557759,15449379,51.0015088803529,70.0059050012802,NaN,NaN,23.426252647447416,35.316551591327574
2004-01-30T09:30:00-05:00,27.12,27.12,26.81,27.03,222700,615405,50.75479476683821,63.52609329736206,NaN,NaN,-61.780136787157026,25.65437144823049,-0.09778424066885838,0.2410085570256335,0.3387927976944919,15335059,15344599,49.0089757088834,67.98310962470836,NaN,NaN,19.87942445125776,33.111247714174745
2004-02-02T09:30:00-05:00,26.83,27.17999,26.77,26.98,395000,629240,49.70642752197763,62.3179616763944,NaN,NaN,-68.93555098363387,-10.474752762231441,-0.11021549512586859,0.20102342878715618,0.31123892391302477,14940059,15087359,44.42066919612287,65.80250555752411,NaN,NaN,16.71305904352702,30.76864933265364
2004-02-03T09:30:00-05:00,27.89999,27.89999,25.84,26.88,170600,622640,47.589237713506286,61.245958715834,NaN,NaN,-93.98662824683552,-48.93071210025422,-0.12144875844993602,0.15942797585060475,0.2808767343005408,14769459,14988859,42.76949339348532,63.65323883369917,NaN,NaN,13.45286730996937,28.29496618655589
2004-02-04T09:30:00-05:00,26.96001,26.96001,26.67999,26.75,640000,636595,44.91112289061809,59.50318610822145,NaN,NaN,-107.79409043203299,-73.07754013609801,-0.13298000154274753,0.11465173237210635,0.24763173391485388,14129459,14946359,42.0433162650798,61.69975631232956,NaN,NaN,9.901860620167962,25.6673796770719
2004-02-05T09:30:00-05:00,26.89999,27.06,26.7,27,219800,619665,50.66139801528281,58.12629181932905,NaN,NaN,-76.1202818731529,-81.72333766456248,-0.11953972519106873,0.09820707742601797,0.2177468026170867,14349259,14704659,38.08314746085026,59.65839231402983,NaN,NaN,8.493252990096193,23.213933007503943
2004-02-06T09:30:00-05:00,27.14999,27.2,26.86,27.12,712200,622625,53.18728797656358,56.458743932606424,NaN,NaN,-38.96094165599286,-77.15949863832964,-0.09917618680784782,0.09377656910727694,0.19295275591512476,15061459,14649939,37.2281933282939,57.13590357286988,NaN,NaN,8.071263822013421,21.050694552433868
2004-02-09T09:30:00-05:00,27.2,27.2,26.99001,27.05,1147100,583375,51.53003243275931,55.41664666970821,NaN,NaN,-36.32260649713103,-70.63690974102907,-0.0874400857746725,0.08365264869678413,0.17109273447145662,13914359,14444799,34.13440063884441,54.26724621521409,NaN,NaN,7.245567154036533,19.078533495519963
2004-02-10T09:30:00-05:00,27.05,27.05,26.89999,27.03,369900,567085,51.040687842211184,54.15644011531608,NaN,NaN,-59.36092508103306,-63.71176910786858,-0.07833654430673875,0.07317205408803318,0.15150859839477193,13544459,14199799,30.838233966169895,50.96400662046283,NaN,NaN,6.433006121643707,17.272029584966212
2004-02-11T09:30:00-05:00,27.03,27.47,26.92,27.33,1008700,602065,57.552247434550274,53.62048910955956,NaN,NaN,-0.045362784797096115,-42.1620235784214,-0.050760065607805605,0.08805851638501494,0.13881858199282054,14553159,14284539,33.239517313565074,47.727155766523154,NaN,NaN,7.624389164418307,15.893795239173654
2004-02-12T09:30:00-05:00,27.5,27.5,27.28,27.31,314600,600965,57.007897518325706,53.24048174612932,NaN,NaN,30.60389628112016,-20.817187947566776,-0.03335667227853906,0.09712274164464674,0.1304794139231858,14238559,14262399,32.917941157540625,44.6674590774905,NaN,NaN,8.442225358395334,14.829285256205322
2004-02-13T09:30:00-05:00,27.35001,27.48,27.10001,27.17999,735400,599500,53.46761339135233,52.240388093689795,NaN,NaN,1.2560315602743384,-12.773793304313333,-0.030186441002731407,0.09274636266977154,0.12293280367250295,13503159,13950739,28.707626522459947,41.669854964642866,NaN,NaN,8.152206834440284,13.875416910238888
2004-02-17T09:30:00-05:00,27.34,27.46001,27.21001,27.39,401400,581680,58.00446063810155,52.05508049854056,NaN,NaN,34.68633849570736,1.4279956942543408,-0.014335385665476721,0.10501357159065705,0.11934895725613377,13904559,13948779,28.682780159809155,39.09230496319241,NaN,NaN,9.235292442361999,13.212541986256475
2004-02-18T09:30:00-05:00,27.49001,27.49001,27.14,27.25,441100,566535,54.20999241666361,52.2422762477964,NaN,NaN,22.912213306499627,17.882623371760882,-0.013671321257440167,0.10225980568433357,0.11593112694177374,13463459,13932579,28.463500941186794,37.2528074951889,NaN,NaN,9.052942865981063,12.618313540502845
2004-02-19T09:30:00-05:00,27.45,27.45,27.03999,27.03999,497800,575855,49.02871699892402,52.0465655398339,NaN,NaN,-7.530089162708515,16.3856780961786,-0.026997694833817906,0.08218400839950135,0.10918170323331926,12965659,13615079,24.50881544831259,35.36047225004316,NaN,NaN,7.326710312326279,11.862370222191906
2004-02-20T09:30:00-05:00,27.00999,27.28999,26.85001,26.99001,530500,589795,47.856417770707814,51.83953861153886,NaN,NaN,-44.89216583173072,1.2864656736084181,-0.03812013942700018,0.061531528949569037,0.09965166837656922,12435159,13254399,20.94814191307367,33.35612697891389,NaN,NaN,5.570292670645373,10.963502000542402
2004-02-23T09:30:00-05:00,27.14999,27.14999,26.75,26.89,1550700,641245,45.511431495938304,51.53989603825034,NaN,NaN,-77.37568390847481,-14.43987742014141,-0.050384061318305376,0.0366715917286875,0.08705565304699288,10884459,12730659,17.07001436942197,31.402508777006684,NaN,NaN,3.4061496977318853,9.883880242998043
2004-02-24T09:30:00-05:00,26.7,27.03,26.64,26.89,508600,648310,45.511431495938304,51.391481308424055,NaN,NaN,-100.17084916957553,-41.41131495319799,-0.056223303989478585,0.016776523060144655,0.07299982704962324,10884459,12126639,13.878843148059062,29.338890902333382,NaN,NaN,1.637616004694108,8.705842494668909
2004-02-25T09:30:00-05:00,26.95,26.95,26.72,26.82001,238900,612040,43.770646971734664,51.310018742789524,NaN,NaN,-106.81102546569703,-67.35596270763732,-0.06206803345047722,-0.004585214763473289,0.05748281868700393,10645559,11563059,11.684028862421712,27.17037037357209,NaN,NaN,-0.34710936231961825,7.412563657956262
2004-02-26T09:30:00-05:00,26.75999,26.89,26.66,26.84,474700,589775,44.42448399539683,50.86452488422624,NaN,NaN,-110.6774826110098,-87.98544139729758,-0.06172603255511801,-0.019674722006893575,0.04205131054822443,11120259,11193979,10.511657175094129,25.200978210303795,NaN,NaN,-1.8471890849312789,6.089741837543757
2004-02-27T09:30:00-05:00,26.88,26.95,26.73,26.83,284400,543205,44.14792448185301,50.218856063175494,NaN,NaN,-83.412529171361,-95.68951406522362,-0.0592974428051492,-0.03207049295821207,0.027226949846937132,10835859,10874119,9.611557559865219,23.22836136970174,NaN,NaN,-3.1859085401706557,4.764648926441698
2004-03-01T09:30:00-05:00,26.86,27.06,26.78999,26.97,380400,551090,48.94036403427793,50.03387974899825,NaN,NaN,-37.97440957017646,-87.80925919756396,-0.04598052983336296,-0.030248712444766568,0.015731817388596393,11216259,10940479,11.308367364039341,21.597930421501385,NaN,NaN,-3.1492930231247045,3.6340857907893547
2004-03-02T09:30:00-05:00,26.85001,27.06,26.78,26.88,540200,558350,46.196124435265936,49.687839505645016,NaN,NaN,-49.509397528238885,-77.67696886929663,-0.0411103851408156,-0.03565616403742311,0.005454221103392491,10676059,10898799,11.166577120618456,20.19281207539057,NaN,NaN,-3.8381303773089583,2.566626338203881
2004-03-03T09:30:00-05:00,26.89999,26.92,26.75999,26.87,547600,577200,45.88823248450128,48.854695580641526,NaN,NaN,-71.87964781684636,-70.6906933395265,-0.03659070020799553,-0.040284154156601915,-0.0036934539486063907,10128459,10795379,10.804571354592369,18.590315935463945,NaN,NaN,-4.497150619115685,1.557515344301086
2004-03-04T09:30:00-05:00,26.91,27,26.83,26.97,240800,557240,49.512041384801414,48.31927728538979,NaN,NaN,-42.19740882422037,-56.99467858216862,-0.025424265388383945,-0.03547378568408632,-0.010049520295702379,10369259,10645179,10.283169587055951,16.973546537572187,NaN,NaN,-4.135253875807297,0.744262598571317
2004-03-05T09:30:00-05:00,26.74001,27.14,26.74001,27.03,94600,550980,51.60615217953654,48.18631577026009,NaN,NaN,-28.084534822626242,-45.92907971242166,-0.013171898982664937,-0.02651439402403355,-0.013342495041368613,10463859,10570779,10.025097375779211,15.639080169952134,NaN,NaN,-3.2690099387385083,0.17093795038419912
2004-03-08T09:30:00-05:00,26.83,27.02,26.57001,26.57001,1022400,566490,38.44184763508446,46.78898627004458,NaN,NaN,-119.88718175125636,-62.311634148637644,-0.03403570657619277,-0.055887128261609575,-0.021851421685416806,9441459,10215819,8.880056156576288,14.224599884006926,NaN,NaN,-6.549885771819726,-0.7891797242163616
2004-03-09T09:30:00-05:00,26.48,26.60001,26.31,26.39,1146100,566440,34.71030974261299,45.39615179332668,NaN,NaN,-201.2740866815162,-92.6645719792931,-0.05661713142001355,-0.09262283596043375,-0.036005704540420194,8295359,9739679,7.622394355931235,12.735949413631532,NaN,NaN,-10.587308815135962,-2.18891245149059
2004-03-10T09:30:00-05:00,26.25999,26.42999,25.88,25.89999,1693100,632600,27.02112874063232,43.824181203448695,NaN,NaN,-266.40287990529566,-131.56921839698296,-0.09874580376469586,-0.15943795924629,-0.06069215548159416,6602259,9034439,6.217744754629649,11.429444364082752,NaN,NaN,-17.3475971122626,-4.354438831600877
2004-03-11T09:30:00-05:00,25.7,26.07001,25.16,25.50999,1404400,652385,22.709231687227074,42.02795362605722,NaN,NaN,-310.6246119981341,-185.2546590317657,-0.14431039131175616,-0.24108014462128935,-0.09676975330953319,5197859,8000159,4.8160500032785905,10.277152084811673,NaN,NaN,-24.827689144901242,-7.279188876358072
2004-03-12T09:30:00-05:00,25.5,26,25.5,25.95,2531100,763210,35.26120800717494,41.295794805431264,NaN,NaN,-195.8631718530953,-218.8103864378595,-0.1363417612537126,-0.26719695487667394,-0.13085519362296133,7728959,7453179,4.268063979757514,9.362727056978498,NaN,NaN,-25.941340025691872,-9.945210469120044
2004-03-15T09:30:00-05:00,25.94,26.03999,25.61,25.63,1048200,778850,31.282370061513888,40.279433274400944,NaN,NaN,-163.01438011301417,-227.4358261102111,-0.14342858849179999,-0.3101409292377113,-0.16671234074591132,6680759,6901039,3.798251393136411,8.642684788769738,NaN,NaN,-28.414358435231623,-12.583660178564555
2004-03-16T09:30:00-05:00,25.55,25.98,25.55,25.92,2137700,865665,38.09927875029566,39.87433554429816,NaN,NaN,-126.04543992133902,-212.39009675817564,-0.12032470380161062,-0.3171182204979246,-0.19679351669631398,8818459,7005659,5.91164214934922,8.2303714521217,NaN,NaN,-27.64042624563282,-14.734626759574308
2004-03-17T09:30:00-05:00,26.10001,26.34,26.05,26.24001,299200,858570,44.627080571843464,39.88880672833006,NaN,NaN,-56.004155640744166,-170.31035190526535,-0.07731959714856182,-0.29344301313201626,-0.21612341598345444,9117659,7508739,15.522157389710898,8.588264324594325,NaN,NaN,-24.46121657715849,-16.124139590657762
2004-03-18T09:30:00-05:00,26.10001,26.31,25.98,26.27,297600,848560,45.21021468713534,39.964684600135946,NaN,NaN,-52.08330279067307,-118.60209006377315,-0.04242736073160741,-0.2691576168979637,-0.22673025616635628,9415259,8352219,28.676415642870822,9.950039901951868,NaN,NaN,-21.90757940046569,-16.95034527777318
2004-03-19T09:30:00-05:00,26,26.17999,25.85001,25.85001,439200,843995,39.01384956211423,39.25564785212425,NaN,NaN,-77.33080505519945,-94.89561670419398,-0.04306919472327819,-0.280566749570454,-0.23749755484717583,8976059,8601639,32.04602521497928,11.431301177019005,NaN,NaN,-21.991303045523733,-17.670482101737544
2004-03-22T09:30:00-05:00,25.64,25.64999,25.28999,25.5,688500,800885,34.740550271058396,38.437392554680855,NaN,NaN,-130.21177413376992,-88.33509550834512,-0.061385326118569394,-0.3142292124953876,-0.2528438863768182,8287559,8922999,36.22655685994028,13.221299729827706,NaN,NaN,-23.63250309436463,-18.522199386398558
2004-03-23T09:30:00-05:00,25.53999,25.64999,25.41,25.42999,484900,799700,33.93976217432039,37.583930389667934,NaN,NaN,-112.87318101215867,-85.70064372650904,-0.07181034740055836,-0.34260682062751613,-0.27079647322695777,7802659,8719839,34.770241511731555,14.933133312480505,NaN,NaN,-25.156176328788792,-19.469910378168592
2004-03-24T09:30:00-05:00,25.37,25.52,25.28,25.42999,262500,800880,33.93976217432039,36.47162473177643,NaN,NaN,-111.84333267132638,-96.8684791326255,-0.07211133194625541,-0.36093563815977703,-0.2888243062135216,7802659,8456839,32.9249872737669,16.550406004388428,NaN,NaN,-26.326636444163746,-20.449442673310756
2004-03-25T09:30:00-05:00,25.47,25.95,25.47,25.85001,557600,805025,43.07034911364888,35.861924512784455,NaN,NaN,-60.72804936998797,-98.59742844848847,-0.039081936824770847,-0.33767672724448516,-0.2985947904197143,8360259,8245839,31.48149252522404,18.083005657920204,NaN,NaN,-24.302069888387233,-20.99981798975025
2004-03-26T09:30:00-05:00,25.95,26.14999,25.87,25.99001,921500,836880,45.76132840704655,36.3847445679246,NaN,NaN,-23.103346076299115,-87.7519366527084,-0.004674307498145569,-0.30443767479239625,-0.2997633672942507,9281759,8306979,32.40624148355094,19.76344746698982,NaN,NaN,-21.794916369581205,-21.113403472583244
2004-03-29T09:30:00-05:00,26.39999,26.45,26.17,26.3,360600,835890,51.255495088886136,37.566543521229825,NaN,NaN,26.769576959384956,-56.355666434077435,0.03965248590687914,-0.25019775991065174,-0.2898502458175309,9642359,8577939,36.496741508276024,21.825900835014448,NaN,NaN,-17.827472337644316,-20.64398473902054
2004-03-30T09:30:00-05:00,26.23,26.48,26.2,26.46001,666300,842195,53.85392880521479,39.48317209727143,NaN,NaN,45.19530973061701,-24.741968285522297,0.078210986177636,-0.19208651309548586,-0.27029749927312186,10308659,9079139,43.32839567309248,24.47666161490465,NaN,NaN,-13.75354515820068,-19.659636227474845
2004-03-31T09:30:00-05:00,26.27,26.55,26.27,26.41,444600,837045,52.904691971594374,41.639990689011945,NaN,NaN,57.24320258985503,9.075338766713989,0.0975514873502065,-0.14835814008536374,-0.24590962743557024,9864059,9491419,48.25931528999545,27.579751992527285,NaN,NaN,-10.784211729227176,-18.39171844201089
2004-04-01T09:30:00-05:00,26.53,26.64,26.42999,26.56,906500,870330,55.44160631693672,43.08144771113779,NaN,NaN,89.10556779845386,39.042062200402356,0.11637448934027994,-0.10044151576022031,-0.21681600510050025,10770559,9973479,53.36832728255025,31.086913657012477,NaN,NaN,-7.530087450777632,-16.84005687183471
2004-04-02T09:30:00-05:00,26.89999,27,26.73,26.86,1383100,934755,60.07393484869014,45.137988053078956,NaN,NaN,152.0425403429957,74.07123948426131,0.14319380857183656,-0.03782374438570457,-0.18101755295754113,12153659,10547859,58.61228409188638,35.002201706923195,NaN,NaN,-3.2217256409071604,-14.894580981702205
2004-04-05T09:30:00-04:00,26.99001,27.17999,26.86,27.17999,551400,911205,64.33319238616798,47.011839027069854,NaN,NaN,179.06946366785968,104.53121682595626,0.17456849894985518,0.037193070729777844,-0.13737542822007734,12705059,11160399,63.34616531443254,39.104667647286284,NaN,NaN,1.9108629733567608,-12.493803273836638
2004-04-06T09:30:00-04:00,27.24001,27.24001,27.05,27.16,344000,871100,63.87476791174602,48.386673837062894,NaN,NaN,168.49612096073676,129.1913790719802,0.18505908833102655,0.09394843219370586,-0.0911106561373207,12361059,11570879,66.14103644851579,42.72030186577235,NaN,NaN,5.8484173680994855,-9.873486039274335
2004-04-07T09:30:00-04:00,27.25,27.3,26.97,27.10001,538800,813385,62.43688127983632,49.61715002225582,NaN,NaN,139.2003044842919,145.58279945086758,0.17893550012078926,0.1325587190136659,-0.04637678110712337,11822259,11962519,68.60104853342474,45.57206135795477,NaN,NaN,8.668141130720485,-7.2246821578465035
2004-04-08T09:30:00-04:00,27.39999,27.39999,26.87,26.95,234600,754895,58.86824387075182,51.03532104430136,NaN,NaN,116.71179973630339,151.1040458384375,0.15656677958251847,0.1493316933710247,-0.007235086211493755,11587659,12125939,69.59377352283643,48.25404337994457,NaN,NaN,10.060409752994797,-4.755383313440603
2004-04-12T09:30:00-04:00,27.13,27.27,27.08,27.22,213200,639000,62.97062359178436,53.051754852924645,NaN,NaN,116.91792713039014,144.0791231959164,0.15163573973391292,0.1823095884558974,0.030673848721984483,11800859,12055379,68.58548671950923,50.56539551277092,NaN,NaN,12.51430441139116,-2.288285067036066
2004-04-13T09:30:00-04:00,27.42,27.42,26.74001,26.8,460200,609600,53.95562716138893,54.48145949485811,NaN,NaN,80.74359732660062,124.41394992766456,0.11351299701679587,0.17256509499297934,0.05905209797618346,11340659,11782499,64.68248949981515,52.70198465477689,NaN,NaN,11.877337962281375,-0.2646246342764318
2004-04-14T09:30:00-04:00,26.72,26.91,26.58,26.78,725900,539010,53.56239148442915,55.883075874151594,NaN,NaN,45.17367248056805,99.74946023163082,0.08185314158546186,0.1613685249580108,0.07951538337254893,10614759,11433239,59.97792647379954,54.63433745477922,NaN,NaN,11.252846767652693,1.3807284231420145
2004-04-15T09:30:00-04:00,26.60001,26.94,26.60001,26.86,811600,564630,54.97592352203817,56.7334740461794,NaN,NaN,46.214806370714506,81.15236060891534,0.062098967149969736,0.1571390923100111,0.09504012516004137,11426359,11354059,58.931446322667114,56.59504844031087,NaN,NaN,11.144072013587603,2.7754917932056697
2004-04-16T09:30:00-04:00,26.7,27.12,26.7,27.10001,556600,577580,59.00740995705284,57.679622728322705,NaN,NaN,62.63516876338908,70.33703441433246,0.060912517657435286,0.17118077223183548,0.11026825457440019,11982959,11433119,59.687760889678806,58.543728397891435,NaN,NaN,12.24105946715703,4.127715746627293
2004-04-19T09:30:00-04:00,26.89999,27.05,26.87,26.95,548900,583065,55.65323027410467,57.993746670124025,NaN,NaN,55.445508043925265,58.04255059703949,0.046397156894207175,0.16826470069215915,0.12186754379795198,11434059,11359759,58.6091966391848,60.12318947867063,NaN,NaN,12.178284496617808,5.277796996625938
2004-04-20T09:30:00-04:00,27.10001,27.11,26.64,26.67999,170500,557165,50.12967182124761,57.72772831412637,NaN,NaN,30.514889723743853,47.996809076468125,0.016524543803275893,0.14252322355204683,0.12599867974877094,11263559,11344339,58.37043563153368,61.19762090427357,NaN,NaN,10.43162376759971,6.014057963907905
2004-04-21T09:30:00-04:00,26.48,26.85001,26.41,26.85001,1433900,604615,53.27443526637151,57.7541385494676,NaN,NaN,6.92649430797419,40.34737344194935,0.006636298044924993,0.1342940523049272,0.1276577542600022,12697459,11760879,62.7812287474141,62.23490043694634,NaN,NaN,9.899161004122352,6.56907268393854
2004-04-22T09:30:00-04:00,26.8,27.44,26.8,27.44,2104600,696720,62.185563804206396,58.235849798558284,NaN,NaN,99.1151945416474,50.92745107613596,0.03657860355918169,0.17338100870897932,0.13680240514979763,14802059,12436019,68.59022907475891,63.32217913638981,NaN,NaN,12.411803259858562,7.4037484804985425
2004-04-23T09:30:00-04:00,27.39999,27.39999,27.08,27.32001,754500,706565,59.692226617969574,58.208584924935394,NaN,NaN,105.70036340439248,59.54049000433664,0.044523666838861636,0.1924569886983747,0.14793332185951305,14047559,12848939,71.51818046810017,64.24402887754793,NaN,NaN,13.604809798027532,8.289614383002684
2004-04-26T09:30:00-04:00,27.31,27.42,27.12,27.17999,324000,676690,56.82877759614724,57.67255529707677,NaN,NaN,94.71928963229159,67.39524632200991,0.03688504524839001,0.19403962842000055,0.15715458317161055,13723559,13306839,74.37127110780496,65.0315364342174,NaN,NaN,13.671827687507164,9.058501997931895
2004-04-27T09:30:00-04:00,27.24001,27.45,27.19,27.2,205100,668915,57.145160673886785,57.19186906580111,NaN,NaN,100.37438994670906,81.36714636660295,0.03000797331498878,0.19466454981534653,0.16465657650035775,13928659,13839859,77.23055822108464,65.82364513225802,NaN,NaN,13.818958368497592,9.738567193726995
2004-04-28T09:30:00-04:00,27.3,27.3,26.83,26.84,1106700,690935,50.03996570805144,56.3063750963879,NaN,NaN,6.64350777487231,81.31054905998256,-0.0003510112409786381,0.16421781244913447,0.1645688236901131,12821959,13864759,77.35764280249751,66.44911615147751,NaN,NaN,11.71289584232045,10.02061414352606
2004-04-29T09:30:00-04:00,26.59,26.95,26.5,26.60001,248400,681125,45.939283733650356,55.3828779437378,NaN,NaN,-113.40105709414802,38.80729873282349,-0.03617697771188272,0.1193476015502597,0.15552457926214242,12573559,13419059,69.84326567756571,66.46693701967246,NaN,NaN,8.615370641205383,9.819865071765964
2004-04-30T09:30:00-04:00,26.5,26.74001,26.39999,26.39999,1413500,706475,42.79179252606086,53.94153286761469,NaN,NaN,-175.21812091908996,-17.376398131872996,-0.07091823949917314,0.06687677988817597,0.13779501938734912,11160059,12841559,61.50637799912335,65.96128639678776,NaN,NaN,5.019288179494103,9.134068372869983
2004-05-03T09:30:00-04:00,26.35001,26.75,26.3,26.7,647200,669680,48.49213378872107,53.55128334099555,NaN,NaN,-132.1685377009072,-62.75396359851275,-0.07108605160304218,0.048937454883546394,0.12002350648658858,11807259,12458299,56.67165600653828,65.38908400441083,NaN,NaN,3.727443153120564,8.361693341477208
2004-05-04T09:30:00-04:00,26.55,26.96001,26.55,26.81,874200,685820,50.4419702441538,53.32839610954731,NaN,NaN,-59.961654986711544,-94.82117258519688,-0.06153907306775122,0.04309966515189956,0.10463873821965078,12681459,12208859,53.712395740385084,64.94154609488122,NaN,NaN,3.278827874472693,7.635569703333706
2004-05-05T09:30:00-04:00,26.64999,26.99001,26.64999,26.83,85900,672915,50.80660112852121,53.030587367153245,NaN,NaN,-38.25806576824798,-103.80148729382093,-0.05200685010505206,0.0396301755883357,0.09163702569338776,12767359,12197939,53.58048955508848,64.55933489719703,NaN,NaN,3.025091685920171,6.976929986560344
2004-05-06T09:30:00-04:00,26.45,26.77,26.39999,26.69,507000,671325,48.13668091183337,52.254106721066144,NaN,NaN,-94.73818311177257,-100.06891249734585,-0.053075862607878166,0.025292197433540053,0.07836806004141822,12260359,12135299,52.779785456242486,64.06590808052302,NaN,NaN,2.0373900597289327,6.271281425584428
2004-05-07T09:30:00-04:00,26.58,26.72,26.22,26.22,654400,692315,40.45130397027603,51.16825484222124,NaN,NaN,-148.50087162974208,-94.72546263947626,-0.0816723431513807,-0.023722368897807655,0.05794997425357304,11605959,12224479,53.83746814681397,63.725070331067954,NaN,NaN,-1.3352689241337559,5.184631375624688
2004-05-10T09:30:00-04:00,26.00999,26.12,25.66,25.84,1260700,744690,35.51430762705225,50.12430025692157,NaN,NaN,-257.36630132685565,-119.76501536466597,-0.12009369506931929,-0.09216714458307607,0.027926550486243217,10345259,11932079,49.89154200848975,63.1194350722791,NaN,NaN,-5.944614071593807,3.5947391688791894
2004-05-11T09:30:00-04:00,25.7,26.06,25.7,26,779500,760655,38.895903287256196,49.09726225841333,NaN,NaN,-200.40617067632755,-147.85391850258915,-0.12792371898449706,-0.13197809824437812,-0.0040543792598810476,11124759,11620739,46.0235409086273,61.92245736950862,NaN,NaN,-8.615208696108786,1.850460902452336
2004-05-12T09:30:00-04:00,25.85001,26.22,25.66,26.22,242200,736470,43.29879477479459,47.748207327741056,NaN,NaN,-144.14893752319523,-169.0320928535786,-0.11204860450698338,-0.14411513489361027,-0.03206653038662689,11366959,11340659,42.80825878896392,60.080888063380414,NaN,NaN,-9.443678772091351,0.2370123775175237
2004-05-13T09:30:00-04:00,26,26.28999,26,26.22,1492200,770500,43.29879477479459,46.57724791037141,NaN,NaN,-101.07321751347551,-170.2990997339192,-0.09593227286818164,-0.15198187147185394,-0.0560495986036723,11366959,11161979,40.84767706505221,57.890137820305554,NaN,NaN,-10.097714616840278,-1.2393771931050193
2004-05-14T09:30:00-04:00,26.05,26.28999,25.96001,26.17,106000,747970,42.49176580807947,45.55317563979514,NaN,NaN,-94.19929746954527,-159.43878490187984,-0.08348182985723361,-0.16040188592521432,-0.0769200560679807,11260959,11092979,40.084213038520346,55.44106224392808,NaN,NaN,-10.863959889924354,-2.614317578364924
2004-05-17T09:30:00-04:00,25.85001,25.97,25.77,25.88,347200,737885,38.06074968276778,44.19000342614378,NaN,NaN,-124.52740180413952,-132.8710049973366,-0.08910773495353447,-0.1883047247598988,-0.09919698980636432,10913759,11206679,42.00769296287185,52.925143296912886,NaN,NaN,-12.866297529234028,-4.078886142774796
2004-05-18T09:30:00-04:00,26.10001,26.16,25.92,26.14,219800,740350,43.726560216464435,43.73904589103042,NaN,NaN,-79.99547278368567,-108.78886541880824,-0.07046581595256618,-0.18727925974707205,-0.11681344379450587,11133559,11208439,42.03871149969839,50.40236248957009,NaN,NaN,-12.887062027467493,-5.337196983445182
2004-05-19T09:30:00-04:00,26.28999,26.53999,26.06,26.10001,574800,697395,43.0739208769973,43.53437711555521,NaN,NaN,-48.663080481194704,-89.69169401040814,-0.056574590271989494,-0.18753168163449274,-0.13095709136250325,10558759,11046799,39.92652024350104,48.26545210142262,NaN,NaN,-13.092493254053917,-6.445096450675001
2004-05-20T09:30:00-04:00,25.96001,26.07001,25.91,26.03999,208500,602590,42.05926475372697,43.48205370324564,NaN,NaN,-77.30461623260565,-84.93797375423416,-0.04753853100392333,-0.19038025511740742,-0.1428417241134841,10350259,10843459,37.38200478463448,46.54228258610198,NaN,NaN,-13.546526079255644,-7.459586397615093
2004-05-21T09:30:00-04:00,26.10001,26.28,26.07001,26.22,212200,575475,46.15590546789278,43.31518025175791,NaN,NaN,-41.237122323057086,-74.34553872493653,-0.026592777366855447,-0.17608269582205338,-0.14948991845519793,10562459,10703759,35.69873129167689,45.044216535040455,NaN,NaN,-12.775415555996847,-8.2189905630982
2004-05-24T09:30:00-04:00,26.45,26.55,26.27,26.42,546400,586595,50.355729152915266,43.3090201738123,NaN,NaN,6.9854187860275765,-48.042974606903115,0.0020560563732053283,-0.1469198479886913,-0.14897590436189662,11108859,10742779,36.558030272015976,43.818904715871234,NaN,NaN,-10.877000542347064,-8.598706274419467
2004-05-25T09:30:00-04:00,26.37,26.85001,26.05,26.8,98800,581280,57.18843017358968,43.764865105602894,NaN,NaN,50.990039389243286,-21.845872172317318,0.04551370560256421,-0.09208377235869136,-0.13759747796125557,11207659,10757599,36.90291950887738,42.62764971257045,NaN,NaN,-6.987441948524571,-8.368525656434482
2004-05-26T09:30:00-04:00,26.89999,26.92,26.73,26.86,444300,548160,58.16744663059703,44.48134837122887,NaN,NaN,117.46765291071304,11.380274506064238,0.07544972434001924,-0.04328532253623152,-0.11873504687625076,11651959,10976239,41.919411142021616,41.851908690126095,NaN,NaN,-3.5324835640223005,-7.6776625003755985
2004-05-27T09:30:00-04:00,27.05,27.17999,26.89999,27.05,704600,570970,61.193782896763345,45.96295400883512,NaN,NaN,152.07521360736234,57.25624047405783,0.10346568258613995,0.010597056356424162,-0.09286862622971578,12356559,11377499,49.80653935121508,41.56398520472618,NaN,NaN,0.35329265701465606,-6.530383192176991
2004-05-28T09:30:00-04:00,27.22,27.22,26.89999,27.05,205000,510545,61.193782896763345,47.7972022423859,NaN,NaN,136.7386984373921,92.85140462614768,0.11644836594367936,0.05269183119988341,-0.06375653474379595,12356559,11736319,55.611435405862196,41.97254901882421,NaN,NaN,3.4909595184699347,-5.098762804941716
2004-06-01T09:30:00-04:00,26.89999,27.05,26.85001,27.05,394700,497920,61.193782896763345,49.38990792877927,NaN,NaN,110.66327320332165,113.58697550960649,0.11906250074845018,0.08507159119176677,-0.0339909095566834,12356559,11985859,59.149703476435576,42.910132059381944,NaN,NaN,6.071124965427424,-3.5030645520318386
2004-06-02T09:30:00-04:00,27.17,27.32001,27.05,27.3,339000,471160,65.3172012716108,50.962651249980425,NaN,NaN,141.5936150054542,131.70769063284868,0.13072384135773651,0.12941389214048726,-0.001309949217249265,12695559,12283439,62.94316915509751,44.34833994267719,NaN,NaN,9.604206436183608,-1.6305972680010605
2004-06-03T09:30:00-04:00,27.25,27.28999,27.08,27.10001,198000,476765,59.83951548551152,52.144131300745926,NaN,NaN,120.44826801312847,132.30381365333176,0.11842923192912275,0.14672659069415417,0.028297358765031422,12497559,12452559,64.93603421786553,46.06893688216386,NaN,NaN,11.14084466588572,0.19389443683990804
2004-06-04T09:30:00-04:00,27.08,27.34,27.08,27.25,252700,464050,62.387190518109044,53.56523306574804,NaN,NaN,115.99671441038731,125.08811381393676,0.11382898267032063,0.1705835871029322,0.05675460443261158,12750259,12531299,65.85669635469557,47.909828547604945,NaN,NaN,13.202093005854593,2.05220851812772
2004-06-07T09:30:00-04:00,27.44,27.72,27.37,27.72,713500,467005,69.01936116723907,55.776562457495984,NaN,NaN,145.4701666327496,126.83440745300827,0.1344554132906784,0.22482387104595958,0.09036845775528118,13463759,12752739,68.37181708261696,49.79298027044388,NaN,NaN,17.318092104065013,4.2330490304044766
2004-06-08T09:30:00-04:00,27.8,27.81,27.60001,27.78,269200,417430,69.75260096619542,57.63556536819106,NaN,NaN,140.67594822168869,132.83694245668167,0.14334047331094363,0.2695440493939607,0.12620357608301708,13732959,13028019,71.21093914148737,51.87671081628595,NaN,NaN,20.846223586116132,6.606359681220427
2004-06-09T09:30:00-04:00,27.89999,27.89999,27.53999,27.53999,1466000,451755,63.2988223872726,59.080201190353584,NaN,NaN,116.99946625511747,127.91811270661432,0.12492786092368324,0.28236340223762113,0.1574355413139379,12266959,12942299,69.12995727045676,53.962670603925645,NaN,NaN,21.86862141852318,8.786682786549392
2004-06-10T09:30:00-04:00,27.72,27.73,27.53,27.73,429300,461110,65.98225664310014,60.78898632530881,NaN,NaN,106.26503298372879,125.08146570073436,0.11752895181143633,0.3043467310782333,0.18681777926679696,12696259,12982039,69.5738710928551,56.26208962594141,NaN,NaN,23.569100830816982,10.898456792873333
2004-06-14T09:30:00-04:00,27.64999,27.64999,27.49001,27.58,541800,413590,62.1208307914048,61.92933813413109,NaN,NaN,87.28590259429514,119.33930333751593,0.09545456545337985,0.30613598608352177,0.21068142063014192,12154459,12862879,66.48654490176814,58.461219169519346,NaN,NaN,23.789595184584176,12.740047991689167
2004-06-15T09:30:00-04:00,27.78,27.87,27.69,27.83,627600,439670,65.72144412432178,63.02688920351727,NaN,NaN,105.70334845296388,111.3859397015588,0.09064855534189714,0.32399211480751333,0.2333435594656162,12782059,12726539,63.03965316717961,60.35276366203103,NaN,NaN,25.10829835522458,14.506940900765654
2004-06-16T09:30:00-04:00,27.95,28,27.77,27.89999,652100,454915,66.67645411702335,63.70460519947682,NaN,NaN,110.98298591677049,105.44734724057514,0.08522354385156095,0.3398729892800674,0.2546494454285064,13434159,12666779,61.53381025698877,62.11211300118185,NaN,NaN,26.46600953065662,16.215379276464365
2004-06-17T09:30:00-04:00,27.99001,27.99001,27.74001,27.92,386700,463260,66.95986918444287,64.33263538189439,NaN,NaN,101.58820861677862,102.36509571290736,0.07631109382274898,0.35003831270694263,0.27372721888419366,13820859,12977559,66.0726324903817,63.83734309749327,NaN,NaN,27.646697971860245,17.848424804378062
2004-06-18T09:30:00-04:00,27.64999,28.11,27.64999,28.02,1271300,498085,68.40602023743588,64.84779519194242,NaN,NaN,99.23049942814833,100.95818900179128,0.07061083674836921,0.3619907648196552,0.291379928071286,15092159,13456739,71.63090451252052,65.3962263233008,NaN,NaN,29.054720979470066,19.449324257962633
2004-06-21T09:30:00-04:00,28.10001,28.14,27.91,27.91,658200,520570,65.03400322739199,65.12209664413018,NaN,NaN,98.49730062523845,103.20046860797993,0.053660091100616536,0.3584550419470567,0.30479495084644015,14433959,13912639,75.70846317839775,66.83172830705334,NaN,NaN,29.3100210725108,20.857995231469513
2004-06-22T09:30:00-04:00,27.87,28.2,27.87,28.17,466200,533270,68.93225998626284,65.67484500766587,NaN,NaN,104.82919849200307,103.02563861578778,0.05403657668048456,0.3723406716970459,0.3183040950165613,14900159,14336259,78.76296358859778,68.23267545792206,NaN,NaN,30.682539521732345,22.26150155864992
2004-06-23T09:30:00-04:00,28.21001,28.59,28.13,28.57001,341500,523025,73.77623369560546,66.27906160937977,NaN,NaN,151.05520162625592,111.04008175768486,0.07406564993574982,0.41088615743624857,0.33682050750049874,15241659,14697759,80.96286543865968,69.51979662103365,NaN,NaN,33.511381459247744,23.868627258735323
2004-06-24T09:30:00-04:00,28.77,28.78,28.39999,28.50999,1503800,593275,71.96317339933397,67.1450371746528,NaN,NaN,164.5748997930152,123.63741999293218,0.07583577681135634,0.43161522851469414,0.3557794517033378,13737859,14681159,80.55023555461628,70.63509671651585,NaN,NaN,35.22787812664999,25.491377382723133
2004-06-25T09:30:00-04:00,28.62,28.62,28.37,28.47,959000,619010,70.71620680079965,67.7399669091307,NaN,NaN,138.60561463570698,131.51244303444392,0.06717417958587085,0.4397471761856764,0.37257299659980553,12778859,14218499,69.86310232976204,70.92126857187773,NaN,NaN,36.25566290738596,27.029132457674965
2004-06-28T09:30:00-04:00,28.60001,28.60001,28.25999,28.25999,251700,596365,64.40466988348678,67.4103461031484,NaN,NaN,107.61480672328753,133.33594425405371,0.04142485228357323,0.42435406195427205,0.3829292096706988,12527159,13837139,62.50194940210666,70.50199230898413,NaN,NaN,35.25437522517351,28.204167138746186
2004-06-29T09:30:00-04:00,28.25999,28.56,28.25999,28.48,482300,610230,67.66100994285472,67.26094674433834,NaN,NaN,107.52651847948673,133.87540825155048,0.03366354527653681,0.42500864126636984,0.391345095989833,13009459,13458999,56.18090464089932,69.428418416085,NaN,NaN,35.36729309796285,29.22747084720571
2004-06-30T09:30:00-04:00,28.60001,28.69,28.34,28.66,451100,613050,70.07320129852587,67.74483095228501,NaN,NaN,119.48278993802735,127.56092591390475,0.034953570684502666,0.43503705934546133,0.40008348866095866,13460559,13102779,50.95313354520666,68.13007386428141,NaN,NaN,36.19964270978574,30.223495399002857
2004-07-01T09:30:00-04:00,28.78,28.78,28.13,28.23,975200,644860,58.7913718065467,67.23119632110262,NaN,NaN,76.63680128178314,109.97330621165834,0.002840729446449086,0.40363440046902,0.4007936710225709,12485359,12852279,47.598859827734096,66.56043020248705,NaN,NaN,33.1679967752477,30.64413845275212
2004-07-02T09:30:00-04:00,28.24001,28.24001,27.92,27.99001,2125900,741255,53.604144103683204,66.62286155769394,NaN,NaN,7.26769370625542,83.70572202576803,-0.03640545357765024,0.3552868540505081,0.3916923076281583,10359459,12368399,41.86562412455277,64.80179300411453,NaN,NaN,28.87244122394257,30.39103884863647
2004-07-06T09:30:00-04:00,28.05,28.05,27.75,27.92999,337000,745470,52.35989310320693,65.66846505618574,NaN,NaN,-31.80101825290425,55.82255703052965,-0.06649708692204676,0.3085709489755999,0.37506803589764665,10022459,11867459,36.90917847250816,62.9353305259237,NaN,NaN,25.074300415824744,29.63150478680622
2004-07-07T09:30:00-04:00,27.97,28.08,27.89,27.98,424600,731025,53.33191305134651,64.71528355149454,NaN,NaN,-20.45642871031545,30.225967592569226,-0.08209995487439292,0.27244309230465547,0.3545430471790484,10447059,11354979,32.650468288413435,60.87223467102547,NaN,NaN,22.307565075222758,28.58522768515144
2004-07-08T09:30:00-04:00,27.85001,28,27.8,27.82001,833200,759225,49.82918137341471,63.491662993563956,NaN,NaN,-49.74054375371237,-3.6186991457787174,-0.101018204249893,0.22827029186668213,0.3292884961165751,9613859,10585639,27.517398629349245,58.11828939523743,NaN,NaN,18.892227100637843,27.20051331593521
2004-07-09T09:30:00-04:00,27.95,28.05,27.94,28.05,489100,710380,54.4595718400552,62.49548810803676,NaN,NaN,-20.593711481631555,-23.064801698461658,-0.09590489112164541,0.20940738221451838,0.3053122733361638,10102959,10109159,24.905838893157664,54.78078470814008,NaN,NaN,17.334226418367457,25.791043759139818
2004-07-12T09:30:00-04:00,28.05,28.17,27.87,28.09,480900,712960,55.23342054697121,61.795446488006704,NaN,NaN,-18.71538511280043,-28.261417462272824,-0.08790323981060094,0.1954332235729126,0.28333646338351354,10583859,10154039,25.621868056366026,51.20317077085211,NaN,NaN,16.297725349122818,24.434855414851675
2004-07-13T09:30:00-04:00,28.2,28.22,28.13,28.14999,763600,724050,56.42921863341274,60.90237210566027,NaN,NaN,7.362921298002381,-20.428629552091493,-0.07703462950257206,0.18704317650529845,0.2640778060078705,11347459,10419039,29.87376539835934,47.71108518583508,NaN,NaN,15.776710661413693,23.197977592931963
2004-07-14T09:30:00-04:00,27.92999,28.33,27.8,28.10001,853000,735320,55.10845752858768,59.56895952230185,NaN,NaN,-24.479994000592193,-21.233342610146842,-0.07178126633622378,0.17435122308759077,0.24613248942381455,10494459,10428519,30.027867924424967,44.07287107767546,NaN,NaN,14.977511969816074,22.023625361058265
2004-07-15T09:30:00-04:00,28.08,28.36,28.08,28.24001,1405300,772980,58.069003983073415,58.57651884971182,NaN,NaN,17.390061641749703,-7.807221531054428,-0.05803513747289907,0.1735885675826907,0.23162370505558977,11899759,10885699,37.19561650888012,40.97611257440859,NaN,NaN,15.102551529443275,21.03490052797041
2004-07-16T09:30:00-04:00,28.48,28.48,28.11,28.13,837900,795540,54.999589001304514,57.45390329260503,NaN,NaN,16.691972003392532,-0.35008483404961055,-0.05550928270579045,0.1622371016733517,0.21774638437914215,11061859,11077479,39.97342312765875,38.84113548854407,NaN,NaN,14.359354906809319,20.081251153518828
2004-07-19T09:30:00-04:00,28.05,28.14,27.88,28.00999,530300,758490,51.78388674588067,56.55241878277601,NaN,NaN,-63.20241722545706,-9.247491256580936,-0.06066014760454433,0.14192119987346175,0.20258134747800607,10531559,11067019,39.86984462027057,37.22455657555578,NaN,NaN,12.817634769322215,19.04359167006217
2004-07-20T09:30:00-04:00,27.8,28.19,27.75,28.17999,1156400,783400,55.732274225438175,55.70036623153198,NaN,NaN,-54.511390437642234,-21.62235360370986,-0.0517065973872578,0.13794810074393382,0.18965469813119162,11687959,11135119,40.94277478732474,36.13611872887188,NaN,NaN,12.580475186115095,18.120289315212588
2004-07-21T09:30:00-04:00,28.24001,28.39,27.81,27.81,490100,784595,46.75782825736212,54.03498244287742,NaN,NaN,-64.73595322467608,-29.67354544852663,-0.06872508341088138,0.10374834386758991,0.1724734272784713,11197859,11275799,43.197614306049935,35.58215306893211,NaN,NaN,9.533281961044707,16.89357397890289
2004-07-22T09:30:00-04:00,27.73,27.75,27.36,27.64,2017500,868395,43.30715267021059,52.92896679028199,NaN,NaN,-182.442096745771,-69.63997712603077,-0.08821066847563294,0.0622100916839301,0.15042076015956304,9180359,10731919,37.27262003819695,34.8445645125366,NaN,NaN,5.867574800232587,15.318431239092845
2004-07-23T09:30:00-04:00,27.60001,27.66,27.39,27.50999,134800,799945,40.82575405736089,52.016224644116114,NaN,NaN,-185.58430485385477,-110.09523249748023,-0.10546799852350881,0.01858576200517703,0.12405376052868584,9045559,10328659,33.59345259589145,34.25369511763222,NaN,NaN,2.0402142620168098,13.421543099510554
2004-07-26T09:30:00-04:00,27.7,27.8,27.25999,27.42,1001700,802080,39.15347262451278,51.07290889563796,NaN,NaN,-179.2290401371906,-133.30055707982694,-0.11762967792918216,-0.02298333688279186,0.0946463410463903,8043859,9831119,29.698345317374304,33.73863560655123,NaN,NaN,-1.6281344755940779,11.271589160209892
2004-07-27T09:30:00-04:00,27.3,27.75,27.3,27.7,776200,828305,46.49695586957257,50.58469766836839,NaN,NaN,-133.6045748582201,-149.1191939639425,-0.10207996763488017,-0.0329536184972099,0.06912634913767027,8820059,9257539,25.961198188089227,33.260830599385216,NaN,NaN,-2.5864236625557964,9.291873042671936
2004-07-28T09:30:00-04:00,27.52,27.94,27.42999,27.87,327200,820550,50.41017743995147,50.62619738740674,NaN,NaN,-71.99900462158206,-150.5718042433237,-0.07676371876881778,-0.026828299323351956,0.049935419445465826,9147259,8847419,23.667857763108444,32.98586339465373,NaN,NaN,-2.1525516839768866,7.656955224579248
2004-07-29T09:30:00-04:00,27.7,28.02,27.69,27.89999,1051100,850550,51.08979973127008,50.38549937963637,NaN,NaN,-24.21835536088035,-118.92705596634558,-0.05541326340228162,-0.0193311598073862,0.03608210359489542,10198359,9051019,27.11026066622084,33.14332209272967,NaN,NaN,-1.5996093516844896,6.334588856541571
2004-07-30T09:30:00-04:00,27.87,27.96001,27.73,27.86,558300,829705,50.103736428123945,50.01909337114728,NaN,NaN,-23.79703296473866,-86.56960158852236,-0.04200737879904371,-0.016427119903909215,0.025580258895134496,9640059,9169919,29.1205715307495,33.39322948375706,NaN,NaN,-1.4263966021038443,5.225876648163655
2004-08-02T09:30:00-04:00,27.75999,28.03,27.64,27.99001,896800,768250,53.26201626000911,49.792864630189875,NaN,NaN,-7.3748618489258595,-52.19876593086941,-0.02333900969889991,-0.003593503228490391,0.01974550647040952,10536859,9668519,36.97098362946476,33.90017364312173,NaN,NaN,-0.36232719251756684,4.427561813780623
2004-08-03T09:30:00-04:00,27.7,28.02,27.7,27.84,383900,770595,49.37830531764647,49.383568043694076,NaN,NaN,-18.751834430862576,-29.2282178453979,-0.020167871921733044,-0.005464333431756785,0.01470353848997626,10152959,9935099,40.74952398381008,34.6660062187921,NaN,NaN,-0.5589932537226497,3.7151968041372987
2004-08-04T09:30:00-04:00,27.60001,27.87,27.60001,27.84,388900,768810,49.37830531764647,48.76280385330644,NaN,NaN,-45.686387184180845,-23.965694357917666,-0.017257080379941107,-0.006867811984950123,0.010389268394990983,10152959,10136239,43.50168957757966,35.116440009413495,NaN,NaN,-0.7192556485878001,3.081703596605142
2004-08-05T09:30:00-04:00,28.05,28.05,27.25,27.27,1283300,791315,37.370111252360864,47.503555442667604,NaN,NaN,-119.81796737428357,-43.08561676059831,-0.05099879331634964,-0.053359223250446064,-0.002360429934096426,8869659,9870499,40.8049515915337,35.17583489969028,NaN,NaN,-4.869668632100709,1.9457932782185916
2004-08-06T09:30:00-04:00,26.89999,27.10001,26.67,26.71001,1970500,865385,29.722623965394575,45.92775095834717,NaN,NaN,-266.0014344629881,-91.5264970602482,-0.10518973825423948,-0.13384760275189578,-0.028657864497656296,6899159,9322319,35.86568270725441,34.88982333447483,NaN,NaN,-11.620968441374234,0.007684461133902198
2004-08-09T09:30:00-04:00,26.55,26.89999,26.55,26.77,1007200,891700,31.343534658623582,44.18569813214612,NaN,NaN,-225.508003258801,-135.15312534222323,-0.1295516628584126,-0.19059744307067206,-0.061045780212259454,7906359,8796219,31.877591340053385,34.24231023109831,NaN,NaN,-16.189605316886876,-2.306214078583352
2004-08-10T09:30:00-04:00,26.95,27.22,26.81,27.22,913700,899205,42.12657164811115,43.8548940886282,NaN,NaN,-127.02017507235028,-156.80679347052077,-0.10875544154685726,-0.19699008214583102,-0.08823464059897376,8820059,8529639,30.053981379918383,33.303479307803194,NaN,NaN,-16.228899369362352,-4.295169120123209
2004-08-11T09:30:00-04:00,27.00999,27.22,26.86,27.19,1674400,940275,41.65685114548142,43.7370154082904,NaN,NaN,-109.87267603974861,-169.64405124163432,-0.09112974450150021,-0.20214682122584904,-0.11101707672434882,7145659,7928179,26.386320598775583,32.52588649070167,NaN,NaN,-16.416911269375056,-6.02684657001633
2004-08-12T09:30:00-04:00,27.19,27.19,26.7,26.78999,423700,891195,35.90768243762609,43.38572457830934,NaN,NaN,-131.88756110253814,-172.05796998728525,-0.09982070947493699,-0.23579296356802004,-0.13597225409308306,6721959,7498639,24.12226647247664,31.849373196172046,NaN,NaN,-18.60863588182012,-7.824245043131157
2004-08-13T09:30:00-04:00,26.7,26.84,26.66,26.74001,723200,885460,35.25300874438193,43.10712001544285,NaN,NaN,-138.0119677016582,-146.46007663501928,-0.10198524516359284,-0.2634538105475741,-0.16146856538398127,5998759,7318559,23.222632250231072,31.386822262804667,NaN,NaN,-20.514763520343354,-9.63717625416147
2004-08-16T09:30:00-04:00,26.7,27.28,26.7,27.24001,625200,890205,45.88293363980843,43.063261284745415,NaN,NaN,-68.37787245717277,-115.03405047469361,-0.06461478912731547,-0.2422370517931256,-0.17762226266581013,6623959,7062079,21.966100328143085,31.10145812995137,NaN,NaN,-18.423948353089738,-10.892429411151223
2004-08-17T09:30:00-04:00,27.47,27.5,27.14999,27.22,672400,866005,45.56055859761049,42.71685993886392,NaN,NaN,-24.13835459629951,-94.45768637948348,-0.03746214044225857,-0.22444993821863335,-0.18698779777637478,5951559,6488379,19.433177659602237,30.79898097970093,NaN,NaN,-16.934997165513614,-11.755653376060136
2004-08-18T09:30:00-04:00,27,27.64999,27,27.64999,642900,873645,53.17418450442371,42.865744565517744,NaN,NaN,7.94150581294196,-70.89485000894537,0.010666130349008374,-0.1736551348401143,-0.18432126518912267,6594459,6378139,18.980269260039847,30.21826730783086,NaN,NaN,-12.962363773654829,-11.92804057571652
2004-08-19T09:30:00-04:00,27.45,27.50999,27.19,27.32001,407300,793135,47.66495338031067,42.691545776388224,NaN,NaN,-8.110572473833544,-46.13945228320445,0.020894730987930515,-0.15820285145420954,-0.17909758244214005,6187159,6271179,18.529051063574926,29.461730131604103,NaN,NaN,-11.553409198487625,-11.874521807540964
2004-08-20T09:30:00-04:00,27.52,27.62,27.3,27.59,240800,798435,52.0430602652963,42.60447749105159,NaN,NaN,24.68649155838341,-13.599760431196092,0.04507341290872707,-0.12275581630623122,-0.1678292292149583,6427959,6357019,20.169290403205395,28.26160918687129,NaN,NaN,-8.87668201929912,-11.446258980649272
2004-08-23T09:30:00-04:00,27.85001,27.85001,27.5,27.58,276900,762195,51.869980286995336,42.782454274576516,NaN,NaN,50.15738726478343,10.107291513195154,0.05875720994161138,-0.09438271678794408,-0.15313992672955545,6151059,6262439,19.698707161417474,26.757979413843252,NaN,NaN,-6.874903705670161,-10.793208227080829
2004-08-24T09:30:00-04:00,27.75,27.75999,27.5,27.60001,311200,738945,52.21245655607222,42.98489364874978,NaN,NaN,45.00770956623831,23.936504345702723,0.06692693771894423,-0.06948125458087517,-0.1364081922998194,6462259,6364579,21.820105124053924,25.209294810019987,NaN,NaN,-5.184724895506068,-9.991996322570149
2004-08-25T09:30:00-04:00,27.55,27.95,27.5,27.89999,387400,741955,57.136602653782354,44.39678589170846,NaN,NaN,76.12885275786448,37.573973734687215,0.08892677439228962,-0.025249724309457378,-0.114176498701747,6849659,6415619,22.915986196557867,23.93151156752171,NaN,NaN,-2.1647939900332203,-8.873824560779159
2004-08-26T09:30:00-04:00,27.97,27.97,27.81,27.91,68400,692820,57.29473622999402,46.366222482036996,NaN,NaN,97.52161824630828,58.70041187871559,0.09973389751241507,0.010490873188771843,-0.08924302432364323,6918059,6561799,26.11055836619292,23.234716971731604,NaN,NaN,0.29455146248472325,-7.564056557455747
2004-08-27T09:30:00-04:00,27.8,27.94,27.78999,27.89999,504300,690120,57.068003163113076,48.20368451807195,NaN,NaN,93.07142783848661,72.37739913473622,0.10145417400823926,0.03757469318665585,-0.06387948082158341,6413759,6558959,26.08793781413158,22.82117029130862,NaN,NaN,2.236900492002228,-6.163919836104608
2004-08-30T09:30:00-04:00,27.67,27.89999,27.60001,27.75,401500,665355,53.6425171551952,49.02625205429224,NaN,NaN,71.24776631590593,76.59547494496073,0.08822438017906219,0.04640099440224432,-0.041823385776817865,6012259,6531199,25.852177890906987,22.521041470664947,NaN,NaN,2.97440227257827,-4.858445249149911
2004-08-31T09:30:00-04:00,27.55,27.88,27.55,27.88,583600,675340,56.10197955916929,50.058046940984234,NaN,NaN,76.83681742043376,82.96129651579982,0.08398492603881093,0.06315777177169579,-0.020827154267115133,6595859,6557919,26.540324402059895,22.532041742328115,NaN,NaN,4.292099795968496,-3.55122452841871
2004-09-01T09:30:00-04:00,27.95,28.02,27.75999,27.89,484600,680125,56.29406836431025,51.514217364318824,NaN,NaN,97.8781798049897,87.31116192522487,0.07775314354218912,0.07636427516062128,-0.0013888683815678482,7080459,6604079,27.78716500929424,22.793820209243655,NaN,NaN,5.434838163136348,-2.2675012867679873
2004-09-02T09:30:00-04:00,27.98,28.28999,27.89,28.27,307800,631350,62.93189341531331,53.491280555099635,NaN,NaN,131.6500702098503,94.13685231793326,0.09403460903617138,0.11615439291364638,0.022119783877475,7388259,6698119,30.379727045235924,23.305041266029715,NaN,NaN,8.47208089461214,-0.7332752608565405
2004-09-03T09:30:00-04:00,28.10001,28.39,28.10001,28.19,806800,573165,60.83708229419153,54.55943403041271,NaN,NaN,132.019856983905,101.92653814701694,0.0940029916401698,0.13962352342768725,0.045620531787517446,6581459,6731659,31.326700483036447,23.973655562807814,NaN,NaN,10.413997870197328,0.859192329294012
2004-09-07T09:30:00-04:00,28.39,28.48,28.27,28.39999,561900,550900,64.20520044029561,55.891194162033074,NaN,NaN,146.30740774843113,116.938466433522,0.10204053985948686,0.17317120661187602,0.07113066675238916,7143359,6957879,37.50151852348461,25.264251338799415,NaN,NaN,13.111024367293112,2.609454049008169
2004-09-08T09:30:00-04:00,28.25,28.47,28.25,28.35001,79400,509185,62.82037471907106,56.580207748793605,NaN,NaN,128.74974966504362,127.32105288244398,0.09789109410799832,0.19349453438738706,0.09560344027938875,7063959,7051499,39.90955996390219,26.75920067478958,NaN,NaN,14.954465124017169,4.37302705972374
2004-09-09T09:30:00-04:00,28.14999,28.5,28.14999,28.28,575100,454220,60.84081570845979,57.521340772232826,NaN,NaN,109.64553897275546,129.6745247159971,0.0848192160287694,0.2016274603153505,0.1168082442865811,6488859,6933179,37.920957412315076,28.144336842556733,NaN,NaN,15.965827101824189,6.029141351452376
2004-09-10T09:30:00-04:00,28.05,28.44,28.05,28.36,925000,479285,62.30263444384067,58.25416749927171,NaN,NaN,98.56104130111997,123.05671893425105,0.07622014727071463,0.2120834283749744,0.13586328110425977,7413859,6938299,38.06477277193777,29.422585583180474,NaN,NaN,17.224873402138186,7.6285316444074915
2004-09-13T09:30:00-04:00,28.5,28.56,28.38,28.39,344500,460350,62.862506036548105,59.03934790995405,NaN,NaN,119.44896901895774,120.54254134126161,0.06751072181178067,0.2202516833689856,0.15274096155720493,7758359,7173679,44.43751304091757,31.18964314600191,NaN,NaN,18.43179686623491,9.171855247525695
2004-09-14T09:30:00-04:00,28.22,28.46001,28.22,28.46001,1349600,496570,64.19878966252656,59.89551456041507,NaN,NaN,96.52354272112096,110.58576833579957,0.06158816352321578,0.22972616596122464,0.16813800243800886,9107959,7566599,53.1107469301698,33.424688989295895,NaN,NaN,19.822587911611688,10.693388485252266
2004-09-15T09:30:00-04:00,28.5,28.5,28.17999,28.2,693600,497630,56.12208005236042,59.82304866031351,NaN,NaN,69.65104117109323,98.76602663700949,0.03652135258272504,0.21378969316641516,0.17726834058369012,8414359,7836679,57.96761581645633,35.928376819288644,NaN,NaN,18.855313958614214,11.859377838589687
2004-09-16T09:30:00-04:00,28.27,28.46001,28.14999,28.38,481400,489555,59.88465608831503,60.00804293590787,NaN,NaN,69.80821401388924,90.79856164523626,0.028766509322617206,0.21322647723696164,0.18445996791434444,8895759,8318059,64.93858021214986,38.701806951142714,NaN,NaN,19.072843328036846,12.889872908510709
2004-09-17T09:30:00-04:00,28.53,28.64,28.39,28.59,646600,501520,63.78626752501149,60.48791896175776,NaN,NaN,107.32480718637467,92.5513148222872,0.03411795893490974,0.2271074165829816,0.19298945764807188,9542359,8743759,69.72102818620247,41.8184562634335,NaN,NaN,20.424327730038897,13.96622359730045
2004-09-20T09:30:00-04:00,28.60001,28.62,28.39,28.44,296700,504315,59.346261975788735,60.89532930608586,NaN,NaN,88.4742836051599,86.35637773952763,0.024351526472878027,0.22342886573916942,0.1990773392662914,9245659,9041219,72.53964777564347,45.15327554091466,NaN,NaN,20.24893035486309,14.863753134095113
2004-09-21T09:30:00-04:00,28.45,28.64,28.45,28.55,435600,512250,61.46463255817298,61.27837594887184,NaN,NaN,98.11975241587888,86.67561967847922,0.022158561474589833,0.2267755411095287,0.20461697963493886,9681259,9155879,73.56130090937394,48.51191672000852,NaN,NaN,20.723501030088205,15.70085997637984
2004-09-22T09:30:00-04:00,28.55,28.55,28.08,28.14999,317900,512585,51.047687524730975,60.903634460330466,NaN,NaN,18.329814872464738,76.41137441875352,-0.0077706925584243025,0.19490361393690847,0.20267430649533277,9363359,9345679,75.2057388672984,51.89895770986596,NaN,NaN,17.748182814996824,15.993334667610839
2004-09-23T09:30:00-04:00,28.10001,28.10001,27.87,27.88,155800,501005,45.44883128509039,59.65484430817168,NaN,NaN,-79.05972694081716,46.63778622781224,-0.04520029063527076,0.14617394320124433,0.19137423383651508,9207559,9408039,75.73965009409795,55.138952213356106,NaN,NaN,13.28736891478575,15.606768131492968
2004-09-24T09:30:00-04:00,27.81,28.07001,27.7,27.98,172900,506230,47.73531738268048,58.719003957349464,NaN,NaN,-90.20633224344873,7.13155834184756,-0.0616539196309808,0.1143068342977891,0.1759607539287699,9380459,9375659,74.83849744665685,58.246937710757564,NaN,NaN,10.43085344414894,14.867351747586678
2004-09-27T09:30:00-04:00,27.82001,27.89999,27.75999,27.75999,1513500,556690,43.42299351788079,57.234560605748406,NaN,NaN,-120.73983604471458,-34.71126558812733,-0.0843794600025432,0.07048642892559087,0.15486588892813408,7866959,9099919,67.47589528036758,60.38796462196349,NaN,NaN,6.586563051042189,13.684381933794608
2004-09-28T09:30:00-04:00,27.63,28.08,27.60001,28.03999,2896700,681450,49.65628082815222,56.29426818496849,NaN,NaN,-97.21289688607484,-73.77779544851806,-0.07774301459589758,0.057687120683262094,0.13543013527915967,10763659,9316399,69.97344675850658,62.53538510729238,NaN,NaN,5.348130311055494,12.493488844831877
2004-09-29T09:30:00-04:00,28.10001,28.17999,27.96001,28.14,180900,661315,51.703041400534644,55.6415700201167,NaN,NaN,-47.576587361826164,-86.95907589537626,-0.0643602880285626,0.05497977524345643,0.11934006327201903,10944559,9632639,73.20988537845722,65.05602281915968,NaN,NaN,5.010334841644387,11.424466844376521
2004-09-30T09:30:00-04:00,28.06,28.44,28.06,28.38,465100,660340,56.295070849670125,55.212458334818805,NaN,NaN,18.08234918885305,-67.5306606694422,-0.03837014289446691,0.0713773846539354,0.10974752754840231,11409659,10073059,76.93803339223041,67.83268429203773,NaN,NaN,6.222119793268143,10.681274408503896
2004-10-01T09:30:00-04:00,28.2,28.78999,28.2,28.78,795700,684735,62.66625141077381,55.1984401472635,NaN,NaN,123.60800614366683,-24.767792992019142,0.004457921124348396,0.1153199289538378,0.1108620078294894,12205359,10638039,80.65679065785417,70.41977555039033,NaN,NaN,9.518166567711537,10.51511614553356
2004-10-04T09:30:00-04:00,28.92,29,28.75,28.75,1116200,700205,61.93698617943367,55.036882755614,NaN,NaN,187.46301819452026,36.87277785582783,0.028142792663944954,0.1460404986594206,0.11789770599547564,11089159,11282479,83.85479564741253,72.6157790301934,NaN,NaN,11.83742522184171,10.70401744214901
2004-10-05T09:30:00-04:00,28.72,28.74001,28.59,28.63,150400,679630,58.9803115886324,55.241042151062,NaN,NaN,112.0642612394833,78.72820948093946,0.032779749058555935,0.15887239231867056,0.12609264326011463,10938759,11317499,84.0095100384379,74.4759143317635,NaN,NaN,12.812211849087518,11.005188071711654
2004-10-06T09:30:00-04:00,28.74001,28.92999,28.64999,28.92999,517300,701525,63.65171715829576,55.51011794177491,NaN,NaN,146.6490145996688,117.57332987323844,0.051962833291330474,0.1910461848742777,0.13908335158294724,11456059,11419799,84.47745446997494,75.87154820732243,NaN,NaN,15.186855207682317,11.602569091136035
2004-10-07T09:30:00-04:00,28.8,28.87,28.60001,28.60001,395800,692560,56.08561459737958,54.96007130408692,NaN,NaN,91.43415645192715,132.24369132585326,0.038935892190434473,0.18775321682099033,0.14881732463055586,11060259,11349919,82.69718724383645,76.79841671143915,NaN,NaN,14.708583811820963,12.04628547980531
2004-10-08T09:30:00-04:00,28.45,28.60001,28.24001,28.37,555000,674060,51.49111537600269,54.3989894041022,NaN,NaN,11.285618159778652,109.77921372907562,0.012694334078412778,0.16468524222857184,0.15199090815015906,10505259,11009899,74.47323043826404,76.9365297587692,NaN,NaN,12.769062382553182,12.149539323055006
2004-10-11T09:30:00-04:00,28.42,28.48,28.37,28.39999,206300,667150,52.04275487761983,53.725998141205544,NaN,NaN,15.412521509033473,75.36911439197827,-0.0038906044907278114,0.1471276525367493,0.15101825702747712,10711559,10934379,72.7429239440603,76.87807426124678,NaN,NaN,11.42087687534311,12.045444687667592
2004-10-12T09:30:00-04:00,28.2,28.46001,28.14999,28.39,279400,613640,51.83130864653446,53.78197107847722,NaN,NaN,-7.068453773145881,51.542571389452426,-0.016096113849897564,0.13089811471510515,0.14699422856500272,10432159,10833059,70.38031452205448,76.53340109372937,NaN,NaN,10.28365814399336,11.793760895714131
2004-10-13T09:30:00-04:00,28.39999,28.58,27.98,28.06,1047700,631345,45.285912601130896,53.77033402962297,NaN,NaN,-40.25399556978965,14.161969355560748,-0.04530245315356746,0.09036616212304338,0.13566861527661084,9384459,10418739,61.57347216594945,75.52153124171876,NaN,NaN,7.207237892677204,11.138543323851714
2004-10-14T09:30:00-04:00,27.96001,28.13,27.5,27.94,1669700,690760,43.15190614173315,53.442947512412445,NaN,NaN,-117.62249585355478,-27.64936110553565,-0.07012857588196364,0.04800789542415629,0.11813647130611993,7714759,9749639,50.568500886686955,73.78796005886376,NaN,NaN,4.007134100714446,10.119770577689247
2004-10-15T09:30:00-04:00,28.00999,28.28,28,28.14,1899700,753415,47.585138374237836,53.740243573580806,NaN,NaN,-42.52216238686206,-38.410917214863794,-0.07032634771158879,0.030228536666633943,0.10055488437822273,9614459,9571479,48.10318292112552,72.40419489034647,NaN,NaN,2.6187037718456576,9.048189605425877
2004-10-18T09:30:00-04:00,27.88,28.22,27.87,28.22,786400,777900,49.288685370003286,53.713986755141605,NaN,NaN,-46.919584833547404,-50.87733848337997,-0.06257501048832224,0.02233612126781992,0.08491113175614216,10400859,9509339,47.23815227945611,70.78024528470002,NaN,NaN,1.9816905095134945,8.03868973458125
2004-10-19T09:30:00-04:00,28.3,28.39,27.97,27.97,1887000,850470,44.429072965397026,53.194417581203204,NaN,NaN,-40.71233675857057,-57.6061150804649,-0.07116487156956611,-0.004044957705815477,0.06711991386375063,8513859,9125679,42.1931684972116,68.56476550746818,NaN,NaN,-0.062326047028423565,6.881401765779868
2004-10-20T09:30:00-04:00,28.09,28.09,27.7,27.89,816200,875385,42.969098366946945,52.242562403865826,NaN,NaN,-85.77689375671694,-66.71069471785036,-0.07853558246802221,-0.031049564221277137,0.047486018246745074,7697659,8788319,38.317911966101484,65.80618540560182,NaN,NaN,-2.177822210859768,5.587226911974206
2004-10-21T09:30:00-04:00,27.8,28.11,27.75999,28.03,846200,909905,46.29504399634535,51.07319044569237,NaN,NaN,-68.60742959893155,-56.907681466925716,-0.07053688428750421,-0.04068508711263519,0.02985179717486902,8543859,8954139,41.177665338195006,62.98624788276903,NaN,NaN,-3.0020647426708704,4.360185247024909
2004-10-22T09:30:00-04:00,28.14999,28.14999,27.72,27.78,732600,937890,41.62659661141011,49.622448333690684,NaN,NaN,-87.73536567643518,-65.95032212484034,-0.0780523642885171,-0.06771365818577735,0.010338706102739747,7811259,8593499,37.144167655443795,59.64977445477127,NaN,NaN,-5.147522274996486,3.001941315307567
2004-10-25T09:30:00-04:00,27.69,27.87,27.58,27.78,1495000,936965,41.62659661141011,48.38289726388909,NaN,NaN,-119.18526850202545,-80.40345885853594,-0.07876554365274156,-0.0881182234631872,-0.009352679810445647,7811259,8075579,32.25738796029832,55.953194306332726,NaN,NaN,-6.870510019924161,1.5915911245601775
2004-10-26T09:30:00-04:00,27.77,28.21001,27.74001,28.2,773000,830780,51.212354862935285,47.49437138564906,NaN,NaN,-49.537860007667305,-82.16856350835529,-0.04819484530950885,-0.0695962364473317,-0.02140139113782286,8584259,8089659,32.51731361632659,52.24175567392927,NaN,NaN,-5.471136236524004,0.5826300729767231
2004-10-27T09:30:00-04:00,28.10001,28.60001,28.10001,28.60001,752900,859380,58.24510370573159,47.648620607674204,NaN,NaN,38.941340069902054,-57.2249167430315,-0.0007844543099442686,-0.022381959025253195,-0.021597504715308927,9337159,8417559,38.441126345772645,49.080608466924716,NaN,NaN,-1.8267542549262283,0.23843231184773006
2004-10-28T09:30:00-04:00,28.7,28.7,28.39999,28.53999,602200,866235,56.919283891788105,48.0363469302303,NaN,NaN,60.440272560833456,-31.415376311078496,0.02533914681340793,0.010076428801450987,-0.015262718011956944,8734959,8455779,39.11205176603604,46.554809990337,NaN,NaN,0.6334458520876154,0.2948628175962851
2004-10-29T09:30:00-04:00,28.57001,28.69,28.53,28.67,398100,846355,59.09150502662579,48.53982908373073,NaN,NaN,78.64894640455623,1.8614861051197977,0.0488206757120079,0.04576312662805293,-0.0030575490839549677,9133059,8720139,43.68403721080742,44.47917522367608,NaN,NaN,3.342168788764857,0.7301922420489382
2004-11-01T09:30:00-05:00,28.73,28.82001,28.59,28.75999,584100,819750,60.573384214673645,49.16426305288353,NaN,NaN,103.22811758678614,46.344163322882125,0.06675000927799007,0.08037996251353263,0.013629953235542554,9717159,9101319,49.56471063629255,42.99234637469308,NaN,NaN,6.016240540715959,1.4853419990013697
2004-11-02T09:30:00-05:00,28.86,29.03,28.73,28.78999,1362700,880365,61.07954545606569,50.29237968537887,NaN,NaN,126.15078022183846,81.48189136878327,0.07627889065533204,0.10897856655470761,0.03269967589937557,11079859,9600439,56.038097703957966,42.596962484550836,NaN,NaN,8.34015227967719,2.4646006105264866
2004-11-03T09:30:00-05:00,29.2,29.25,28.91,29.11,398200,874410,66.08173348697397,51.930224495753215,NaN,NaN,170.14564065065693,107.72275148493425,0.09837691729943078,0.15567082252366404,0.05729390522423326,11478059,10028619,60.69839319040404,43.320526220530624,NaN,NaN,12.00316792065844,3.82725308340248
2004-11-04T09:30:00-05:00,29.19,29.67,29.08,29.59,641600,886700,71.91285482935268,53.66791852826142,NaN,NaN,212.48223420616614,138.13114381400078,0.13718059276004457,0.22876964617428897,0.09158905341424439,12119659,10705559,66.70728838011179,44.64939089617251,NaN,NaN,17.401604822183014,5.766446188942556
2004-11-05T09:30:00-05:00,29.8,29.94,29.67999,29.82001,664200,892160,74.20161900321101,55.447413787776256,NaN,NaN,220.1800042671739,166.4373553865243,0.16815445237150906,0.3017821188786307,0.13362766650712166,12783859,11435719,71.72827607977054,46.398685453337826,NaN,NaN,22.658962766307127,8.17966284285178
2004-11-08T09:30:00-05:00,29.95,29.95,29.73,29.89999,271600,895425,74.96554442778472,57.628590320803944,NaN,NaN,180.29351134911917,181.85043413899092,0.1826392120810926,0.3619266816084874,0.1792874695273948,13055459,12103379,75.38404460006488,48.76946231782735,NaN,NaN,27.08960137823541,10.88108263362087
2004-11-09T09:30:00-05:00,29.8,30.10001,29.8,30.00999,680700,915490,76.01738754692207,59.98918240508788,NaN,NaN,159.8370076299761,188.58767962061845,0.187529142939579,0.41369889820186856,0.22616975526228955,13736159,12634639,77.83955265910566,51.59243665304193,NaN,NaN,31.04264687300277,13.761306096389713
2004-11-10T09:30:00-05:00,30.14999,30.21001,30,30.10001,231600,874685,76.87373369439271,62.173374526376975,NaN,NaN,146.36029820302434,183.83061113109193,0.1844463889280129,0.45672774142230566,0.27228135249429275,13967759,13132579,79.86673772855224,54.35594182378173,NaN,NaN,34.55224007998485,16.73143952261759
2004-11-11T09:30:00-05:00,30.2,30.47,30.16,30.45,2861200,934260,79.88153420210608,64.90587006856956,NaN,NaN,145.62134979117948,170.4584342480946,0.1926984009884053,0.5131543537297993,0.32045595274139405,16828959,14074439,83.0291132078382,57.633437934667036,NaN,NaN,38.67640141643239,19.866434078876846
2004-11-12T09:30:00-05:00,30.60001,30.60001,30.34,30.56,559000,867225,80.72983649023695,67.69895863134289,NaN,NaN,134.4821686556245,153.31886712578472,0.19186744094945152,0.5602902539282084,0.3684228129787569,17387959,14995259,85.4374146240674,61.432011267793406,NaN,NaN,42.318857789698974,23.073923180422863
2004-11-15T09:30:00-05:00,30.41,30.63,30.41,30.53999,578600,856835,80.06844853794256,69.7601081795577,NaN,NaN,118.54453054424056,140.969070964809,0.176652771081723,0.5892387768309106,0.41258600574918763,16809359,15746039,87.05091153189662,65.32726826176268,NaN,NaN,45.06066690114494,26.214886569097445
2004-11-16T09:30:00-05:00,30.60001,30.60001,30.31,30.34,1082300,816600,73.58017846839596,70.85547066260516,NaN,NaN,97.42649498015882,128.48696843484555,0.14133171815522538,0.5892506534432194,0.447918935287994,15727059,16144219,87.82158741171847,68.85444405218739,NaN,NaN,45.53008984161595,28.97420132231437
2004-11-17T09:30:00-05:00,30.53999,30.8,30.42999,30.56,957800,823680,75.89430084269254,72.21082901624119,NaN,NaN,99.65400094524814,119.14570898329032,0.12174061886517523,0.600094708869463,0.4783540900042878,16684859,16687639,88.80118041866874,72.40366752737543,NaN,NaN,46.62539778834176,31.49580081746114
2004-11-18T09:30:00-05:00,30.74001,30.75,30.59,30.73,1126700,837705,77.53199175919802,73.52800663999635,NaN,NaN,97.34118017670338,109.4896750603951,0.10956739288527917,0.6153133311108867,0.5057459382256075,17811559,16884159,89.14134329622833,75.65061796204836,NaN,NaN,48.045086432809725,33.859984476796654
2004-11-19T09:30:00-05:00,30.89,30.89,30.28999,30.36,960100,849080,66.8817953572596,73.97860743589536,NaN,NaN,77.22540245883098,98.03832182103638,0.06797042209613902,0.5907089658457814,0.5227385437496423,16851459,16776859,87.5771758085542,78.36579404578133,NaN,NaN,45.88811358890067,35.578288635668656
2004-11-22T09:30:00-05:00,30.14999,30.5,30.10001,30.42999,187500,783705,67.7833175961228,74.45744830304228,NaN,NaN,58.66818570799384,86.06305285378706,0.03803601559990333,0.5702835632495216,0.5322475476496182,17038959,16822779,87.67683404967204,80.62570378476092,NaN,NaN,44.422251272247024,36.84171186946556
2004-11-23T09:30:00-05:00,30.5,30.5,30.25,30.38,137600,751935,66.39315752932484,74.47969287749592,NaN,NaN,57.51038631373308,78.0798311205019,0.009237154435547068,0.5437939906940521,0.534556836258505,16901359,17057639,88.19830385690538,82.58998311808243,NaN,NaN,42.81775093659673,37.695431736198586
2004-11-24T09:30:00-05:00,30.55,30.58,30.42,30.52,315900,730085,68.35080394149801,74.22526067122058,NaN,NaN,66.12411880386996,71.37385469222625,-0.005236620418582083,0.5280110607352775,0.5332476811538596,17217259,17164119,88.43720237997493,84.14211983235838,NaN,NaN,42.013207534138644,38.312256850190025
2004-11-26T09:30:00-05:00,30.38,30.64999,30.38,30.52,127200,706335,68.35080394149801,73.80734530966966,NaN,NaN,63.06265725213497,64.51815010731256,-0.018895507119148447,0.509628297254924,0.5285238043740724,17217259,17045259,86.33625767274764,85.1855470889996,NaN,NaN,41.35898609507212,38.74750388517318
2004-11-29T09:30:00-05:00,30.3,30.63,30.17999,30.39999,222800,697570,64.60918486474375,73.06760534088102,NaN,NaN,44.77630355182044,58.02833032591045,-0.03894330745285213,0.47984467005800724,0.5187879775108594,16994459,17073859,86.41985626883782,85.9738193510548,NaN,NaN,39.75167193125102,38.8909564631843
2004-11-30T09:30:00-05:00,30.45,30.55,30.31,30.47,153600,676045,65.7858398868672,72.33678050801996,NaN,NaN,45.811789853496045,55.45705115501089,-0.049729224103326364,0.45662644738170144,0.5063556714850278,17148059,17095679,86.4877812279081,86.59154996311213,NaN,NaN,38.70018151413742,38.86370289903475
2004-12-01T09:30:00-05:00,30.60001,30.98,30.25,30.98,509100,633365,72.86372618633997,72.0503514003019,NaN,NaN,96.728595594725,63.300693011209276,-0.025952079055905908,0.4739155726651454,0.4998676517210513,17657159,17246839,86.97386099876215,87.09920162526998,NaN,NaN,39.85997211256612,39.00602707239637
2004-12-02T09:30:00-05:00,30.7,31.03,30.7,30.88,281400,627525,69.81404118757311,71.33124475640669,NaN,NaN,135.43339925836042,77.16254910210736,-0.020627538658317845,0.474083228398154,0.4947107670564718,17375759,17278539,87.0788368852085,87.38846760222499,NaN,NaN,39.875983989430104,39.130306631972616
2004-12-03T09:30:00-05:00,30.75,31.00999,30.75,30.89,433100,617100,69.94949153234273,70.56122011655711,NaN,NaN,143.41493902681083,93.23300545704254,-0.02008089722184586,0.4696096455291645,0.48969054275101037,17808859,17396859,87.48426492921975,87.53467119545017,NaN,NaN,39.9278431962064,39.24424042686316
2004-12-06T09:30:00-05:00,30.72,30.92999,30.71001,30.72,204400,594110,64.63935419801712,69.45914194941957,NaN,NaN,107.93814924033526,105.8653745947455,-0.03399901719876125,0.4471917712525588,0.4811907884513201,17604459,17518859,87.9056517981569,87.59572407161161,NaN,NaN,38.4115047456863,39.125278186695034
2004-12-07T09:30:00-05:00,30.89999,30.89999,30.44,30.47,280200,594540,57.70208613059454,68.32499249671947,NaN,NaN,38.787114778015926,104.46043957964949,-0.061281681020720735,0.4045886871754192,0.4658703681961399,17324259,17554099,88.03100718325825,87.61068262672161,NaN,NaN,34.92889830678671,38.52579534670813
2004-12-08T09:30:00-05:00,30.39999,30.64999,30.39999,30.55,262900,573650,59.21068085849219,67.13330535499088,NaN,NaN,-1.0211954066277054,84.91048137937894,-0.07431127728361908,0.3729812715916161,0.4472925488752352,17587159,17540099,87.64236366548442,87.52791000149413,NaN,NaN,32.493426178581025,37.66402832268997
2004-12-09T09:30:00-05:00,30.64999,30.75999,30.34,30.74001,1157700,619955,62.620693802858334,66.06821264382376,NaN,NaN,27.004458030013613,63.22469313370958,-0.0705343423326803,0.3591246209593848,0.4296589632920651,18744859,17813919,88.6937363290296,87.49593807526567,NaN,NaN,31.395941568882662,36.768587357860355
2004-12-10T09:30:00-05:00,30.64,30.89999,30.64,30.85001,921200,522955,64.47241731455176,65.89611421220177,NaN,NaN,107.09119588983965,55.95994450631535,-0.06136668163298287,0.3529506112508365,0.41431729288381935,19666059,18185359,89.94362394124758,87.66497008474377,NaN,NaN,31.02215364415864,35.94766825590297
2004-12-13T09:30:00-05:00,30.95,31.21001,30.92,31.19,464100,518210,69.50142793503343,66.0188363792668,NaN,NaN,208.49232394990287,76.07077944822888,-0.03448351081032708,0.3712129043709105,0.40569641518123756,20130159,18690499,91.34492225760796,87.92697638531062,NaN,NaN,32.28310563629936,35.42415931024531
2004-12-14T09:30:00-05:00,31.3,31.34,31.14,31.25,707500,524655,70.3004101925442,66.29792585521105,NaN,NaN,206.22193368940523,109.55774323050673,-0.015695574481797703,0.38607694707899043,0.40177252156078813,20837659,19393179,92.8396265577574,88.25849943537149,NaN,NaN,33.54699529229842,35.155993021967184
2004-12-15T09:30:00-05:00,31.35001,31.35001,31.03999,31.28999,429000,491990,70.84856398029578,66.47633728655374,NaN,NaN,167.77146086312544,143.31627448445735,-0.004207687035225782,0.39651291276675593,0.4007205998019817,21266659,20129079,94.00692052586149,88.65633644579195,NaN,NaN,34.73780388607467,35.09625171683968
2004-12-16T09:30:00-05:00,31.3,31.3,30.99001,31.11,2337700,560985,65.03084152679789,66.23919711407517,NaN,NaN,118.99061946003631,161.71350677046192,-0.011926562361926796,0.38581239684957325,0.39773895921150004,18928959,20165899,94.05910557151724,89.20796843856121,NaN,NaN,34.0551164515294,34.947518107509644
2004-12-17T09:30:00-05:00,30.95,31.02,30.5,30.92,1076200,558460,59.478550404843666,65.8727232240823,NaN,NaN,25.53311403245674,145.40189039898533,-0.03189086006532171,0.3578753841298479,0.3897662441951696,17852759,19803239,86.10611307991887,89.1855582107813,NaN,NaN,31.77953226672223,34.49494870168287
2004-12-20T09:30:00-05:00,31.05,31.14999,30.89999,30.94,281700,524540,59.8669830673552,65.44994773697431,NaN,NaN,69.73332477918508,117.65009056484178,-0.04500939468346765,0.33350450084083505,0.3785138955243027,18134459,19404099,78.26286832645312,88.59806443210593,NaN,NaN,30.043486846218126,33.859025579473624
2004-12-21T09:30:00-05:00,30.85001,31.17,30.85001,31.11,210800,525705,63.10447073147762,64.752858061627,NaN,NaN,75.79148056134095,91.56399993922892,-0.043474207274621146,0.32417113643102624,0.3676453437056474,18345259,18905619,69.72135592630016,87.36574264121577,NaN,NaN,29.46499321888974,33.23130667081878
2004-12-22T09:30:00-05:00,31.2,31.28999,31.11,31.21001,170800,527365,64.89842790427085,64.40174282710541,NaN,NaN,110.25751985262072,80.06121173712796,-0.03720233962806169,0.3211424191705703,0.358344758798632,18516059,18355499,61.71615469661598,85.55412248488774,NaN,NaN,29.49298473846645,32.697260680482735
2004-12-23T09:30:00-05:00,31.24001,31.35001,31.21001,31.25,764100,549775,65.61830486025696,64.09237235052785,NaN,NaN,115.2470236815744,79.31249258143559,-0.03203593876412064,0.31829983534348116,0.3503357741076018,19280159,18425739,62.31117364266998,83.75604453584846,NaN,NaN,29.71728777526581,32.271550265451744
2004-12-27T09:30:00-05:00,31.45,31.45,31.05,31.07001,206700,553750,59.68522498207863,63.73850597796082,NaN,NaN,83.38687374403757,90.88324452375176,-0.041798847635396486,0.2980872145633562,0.33988606219875267,19073459,18669879,64.38326305268544,82.07587391117194,NaN,NaN,28.211083787609336,31.69148362575997
2004-12-28T09:30:00-05:00,31.14999,31.27,31.11,31.24001,154600,550340,63.08065227841068,64.1226892742334,NaN,NaN,79.78514076274675,92.8936077204641,-0.03797655861609567,0.2924153639286331,0.33039192254472877,19228059,18888599,66.17732749371888,80.51489679049055,NaN,NaN,27.884877768533855,31.147682789013384
2004-12-29T09:30:00-05:00,31.35001,31.35001,31.08,31.16,101100,547715,60.498083795435925,64.21464662687224,NaN,NaN,70.52947020967409,91.84120565013072,-0.04170819932652248,0.27825667338657567,0.31996487271309815,19126959,19044939,67.43984292418241,79.07185959468327,NaN,NaN,26.866047702666496,30.53602063382097
2004-12-30T09:30:00-05:00,31.28999,31.28999,31.16,31.17999,178800,531200,60.92848073750644,64.09377426506138,NaN,NaN,68.78909480455086,83.54752064051675,-0.04350205027059334,0.26558730987485646,0.3090893601454498,19305759,19202879,68.7105161605286,77.64448672550465,NaN,NaN,26.144497438165725,29.908660177298792
2004-12-31T09:30:00-05:00,31.23,31.25,31.07001,31.07001,162800,525270,57.23370183639624,63.576723159478846,NaN,NaN,39.28122059491292,68.35436002318446,-0.052182527293902714,0.2438612010280714,0.2960437283219741,19142959,19175439,68.21244924802168,76.0922599617028,NaN,NaN,24.488572973113005,29.13436200527225
2005-01-03T09:30:00-05:00,31.25,31.28999,30.77,30.8,689900,538110,49.32530110145039,62.13557124279434,NaN,NaN,-19.77496417453954,47.72199243946904,-0.07481816938379049,0.20252101659223598,0.27733918597602647,18453059,19051359,65.8866911617043,74.27381488342397,NaN,NaN,20.55917980881377,27.909335977206755
2005-01-04T09:30:00-05:00,30.83,30.94,30.28999,30.42,1901800,622980,40.78414556652891,60.027266626650395,NaN,NaN,-139.97468473600966,3.770027339717731,-0.11186281992007804,0.1375106610759289,0.24937348099600695,16551259,18515999,56.87598827431725,71.70498357746396,NaN,NaN,14.001613124983493,25.922518426889145
2005-01-05T09:30:00-05:00,30.3,30.42,30.19,30.21001,882400,653090,36.973988432202745,57.6076540875009,NaN,NaN,-201.04882246477328,-50.545631195171744,-0.14489221698743016,0.06825820976171926,0.2131504267491494,15668859,17824379,47.78415979980051,68.40335781131675,NaN,NaN,7.1802403977198175,23.245050137007812
2005-01-06T09:30:00-05:00,30.2,30.46001,30.2,30.31,252600,652575,39.85530821079247,55.80940170778622,NaN,NaN,-173.88098482311852,-99.07964712070562,-0.15356103729468548,0.021199130130792554,0.17476016742547804,15921459,17147519,40.89442679214275,64.60588075564715,NaN,NaN,2.6042340340373826,20.29636212229775
2005-01-07T09:30:00-05:00,30.41,30.45,30.10001,30.17,245400,606960,37.28512883475031,54.22415730992241,NaN,NaN,-174.21579196619578,-141.77904963292735,-0.16147229061985732,-0.027080195849343625,0.1343920947705137,15676059,16454139,35.28224429105195,60.97560441358522,NaN,NaN,-2.017018641643316,17.1087362988776
2005-01-10T09:30:00-05:00,30.25,30.38,30.12,30.28,222400,572020,40.530191835681734,52.84295793623145,NaN,NaN,-143.2553612462061,-166.47512904726068,-0.1521715506979138,-0.055822343601878543,0.09634920709603526,15898459,15943219,31.81729278517912,57.65806330349422,NaN,NaN,-4.818101397113061,13.976330913736076
2005-01-11T09:30:00-05:00,30.3,30.3,30,30.14,371300,567380,37.84612081184273,51.03879008482895,NaN,NaN,-137.54450842928725,-165.98909378591617,-0.14817781322508863,-0.08887305943532553,0.0593047537897631,15527159,15738399,30.52317213954609,54.858193033011794,NaN,NaN,-8.004072043650378,10.836273348395155
2005-01-12T09:30:00-05:00,30.10001,30.3,29.8,30.17999,826400,573325,39.08701087791357,49.19511744008914,NaN,NaN,-125.24378491853088,-150.8280862766677,-0.13589549187114117,-0.11056461104916337,0.0253308808219778,16353559,15875339,32.499951824508386,52.77132139928983,NaN,NaN,-10.221616610511152,7.828003354265682
2005-01-13T09:30:00-05:00,30.25,30.25,29.8,29.89,333600,568555,33.814848100064566,46.92344195721826,NaN,NaN,-123.36708014611936,-140.72530534126787,-0.13981072568975494,-0.14943252629021586,-0.00962180060046093,16019959,15895039,32.79618439382591,50.66310788151525,NaN,NaN,-13.89445328657379,4.724795262717186
2005-01-14T09:30:00-05:00,29.87,30.14999,29.87,30.09,427400,473040,39.841612255240754,45.50604104815841,NaN,NaN,-100.26893773136776,-125.93593449430227,-0.12208435624668164,-0.162227245908813,-0.04014288966213135,16447359,16049299,35.19453215964245,48.57819853201219,NaN,NaN,-15.103652057386215,1.8921599312738433
2005-01-18T09:30:00-05:00,29.7,30.22,29.60001,30.21001,1082900,473375,43.18479653791182,44.08490849526563,NaN,NaN,-92.15187673277248,-115.71523759161555,-0.09654921471011774,-0.16082940804977852,-0.06428019333966078,17530259,16375659,40.06765933806709,46.71322223517991,NaN,NaN,-15.045640912888619,-0.5275259036065081
2005-01-19T09:30:00-05:00,30.10001,30.21001,29.96001,29.97,205900,469585,38.56850225783329,42.518509814008304,NaN,NaN,-78.72095587435203,-103.95052708062852,-0.09021386055799074,-0.17704751903714921,-0.08683365847915847,17324359,16735099,44.975250068805046,45.108608459795825,NaN,NaN,-16.469207573743716,-2.804908999340395
2005-01-20T09:30:00-05:00,29.77,30.02,29.7,29.7,727400,495415,34.14641927674731,40.60550542395408,NaN,NaN,-101.80168288882302,-99.26210667468693,-0.09795294701135564,-0.20927484224335302,-0.11132189523199738,16596959,16783779,45.62465852988924,43.45961862903586,NaN,NaN,-19.167485498258273,-5.142419927757235
2005-01-21T09:30:00-05:00,29.75999,29.89999,29.49001,29.50999,504700,512110,31.416502972792202,38.76141979083951,NaN,NaN,-115.27496378993432,-97.64368340344993,-0.10877989496004103,-0.2472967639320487,-0.13851686897200766,16092259,16798239,45.829174734186026,41.86081330661903,NaN,NaN,-22.312286160437125,-7.59525796099722
2005-01-24T09:30:00-05:00,29.55,29.64999,29.39,29.42,436900,495750,30.18564729295916,37.394301661661565,NaN,NaN,-127.50979007910567,-103.09185387299753,-0.11434371405045782,-0.28144651153507994,-0.16710279748462212,15655359,16639839,43.882091089109224,40.28905615857652,NaN,NaN,-25.233123961097036,-10.114953103868622
2005-01-25T09:30:00-05:00,29.60001,29.8,29.50999,29.7,380300,504430,38.28727824960423,37.215953996166945,NaN,NaN,-97.78913369593006,-104.21930526562906,-0.09244453145619083,-0.28265846180486065,-0.19021393034866982,16035659,16340919,40.39432458368109,39.111794466388226,NaN,NaN,-25.096107478399006,-12.25511801451582
2005-01-26T09:30:00-05:00,29.55,29.98,29.55,29.75999,825500,537975,39.896561796265,37.424709236457105,NaN,NaN,-80.07544883751991,-104.49020385826262,-0.0683098872207234,-0.27560128937457407,-0.20729140215385067,16861159,16248279,39.35047406113925,38.509388342198136,NaN,NaN,-24.477680339603054,-14.001198346671138
2005-01-27T09:30:00-05:00,29.89999,29.89999,29.60001,29.84,430700,554455,42.06645358752954,37.582648191938326,NaN,NaN,-72.50948872973656,-98.63176502644532,-0.04260595518780025,-0.26054884613860096,-0.21794289095080072,17291859,16387259,41.78111221530271,38.57272301528099,NaN,NaN,-23.308008465318622,-15.330742649335065
2005-01-28T09:30:00-05:00,29.64999,29.89999,29.63,29.81,452700,568150,41.462016851191564,37.880997335969845,NaN,NaN,-68.61526218915193,-89.29982470628886,-0.024189340162898032,-0.24817956615442327,-0.22399022599152524,16839159,16536639,44.362114265920724,39.22128515634305,NaN,NaN,-22.52910120807363,-16.359079586297717
2005-01-31T09:30:00-05:00,29.78999,30.2,29.78999,30.2,729500,596485,51.26548299780418,38.647803847550016,NaN,NaN,4.929275163408717,-62.81201165778598,0.01555284755120323,-0.2045491665525212,-0.22010201410372443,17568659,16919299,50.425162707729804,40.55041872223952,NaN,NaN,-18.630573790907658,-16.68357875838485
2005-02-01T09:30:00-05:00,30.3,30.34,30.21001,30.28999,517800,587880,53.2125702541585,39.745407379144005,NaN,NaN,81.81779124395568,-26.890626669808803,0.047396754523544804,-0.16085607094929344,-0.20825282547283824,18086459,17329459,55.96439194029431,42.36764870800726,NaN,NaN,-14.838859869271257,-16.42004748851148
2005-02-02T09:30:00-05:00,30.35001,30.36,30.12,30.28999,466400,516110,53.2125702541585,40.754375906018645,NaN,NaN,83.70717786869663,5.865898671434502,0.06676988356113739,-0.1247904710214165,-0.19156035458255388,18086459,17574519,58.917940122182884,44.25464787212686,NaN,NaN,-11.810323841960928,-15.761515539004257
2005-02-03T09:30:00-05:00,30.17,30.24001,30.09,30.2,613600,502670,50.85610412136288,41.97160847896852,NaN,NaN,60.65652225562984,32.499100868507774,0.07141586551387138,-0.10229052269021466,-0.17370638820408604,17472859,17610719,59.351654441676274,46.15146716125903,NaN,NaN,-9.914503825024292,-14.926228151292834
2005-02-04T09:30:00-05:00,30.23,30.46001,30.23,30.45,523500,516215,56.60538171882954,43.16902058351057,NaN,NaN,125.00033776250119,71.22222085883841,0.08812220325289755,-0.06355363413796411,-0.15167583739086166,17996359,17842159,62.10610706562967,48.07372251168669,NaN,NaN,-6.452467521414622,-13.71569091845309
2005-02-07T09:30:00-05:00,30.3,30.52,30.3,30.42999,276500,517770,56.040268241132544,44.087268562312055,NaN,NaN,129.57005140306325,96.15037610676931,0.09407970878675664,-0.03407620140741585,-0.1281559101941725,17719859,17872399,62.46401252918236,49.67346202533778,NaN,NaN,-3.8011357508376546,-12.299325894508028
2005-02-08T09:30:00-05:00,30.46001,30.60001,30.41,30.60001,410600,527180,59.71991342917558,45.59808364597935,NaN,NaN,154.30470923012794,110.64775970400376,0.10490059621807753,0.00296983507842441,-0.10193076113965312,18130459,17881199,62.57478935746721,50.930571974527936,NaN,NaN,-0.3862830352541529,-10.597462628900331
2005-02-09T09:30:00-05:00,30.5,30.7,30.27,30.28,466400,531935,51.057162863397544,46.80599390216866,NaN,NaN,108.76280397967506,115.65888492619945,0.08669084892498603,0.006432800016579421,-0.08025804890840661,17664059,17796719,60.72209514286461,52.008960304026175,NaN,NaN,0.04215989286272228,-9.077516554362752
2005-02-10T09:30:00-05:00,30.28,30.47,30.25,30.42,197600,500495,54.18803093747419,48.43253161393165,NaN,NaN,89.21400943314688,121.37038236170285,0.08039902479907948,0.020240732090442748,-0.060158292708636735,17861659,17874479,61.84198961506975,53.15273279551786,NaN,NaN,1.3785674152206515,-7.583790272993695
2005-02-11T09:30:00-05:00,30.3,30.72,30.3,30.62,228000,495215,58.2926672873474,50.4401758992451,NaN,NaN,115.58781051264405,119.48787691173143,0.08555276603174307,0.0467826648310421,-0.03877010120070097,18089659,17893139,62.121093761302305,54.45551870067452,NaN,NaN,3.828732471545643,-5.953429880916646
2005-02-14T09:30:00-05:00,30.78,30.78,30.55,30.59,178900,482790,57.46100900229965,51.8097280958662,NaN,NaN,119.42099182861413,117.45806499684161,0.08273714352474736,0.06465132820523323,-0.01808581531951413,17910759,17931319,62.721912075881946,56.05034637868886,NaN,NaN,5.542839063907942,-4.311105745941705
2005-02-15T09:30:00-05:00,30.42,30.73,30.42,30.69,252800,441285,59.533488241774606,53.21236569911689,NaN,NaN,100.78063618029428,106.7532503868749,0.08318179941257559,0.08589143394620535,0.002709634533629768,18163559,17937939,62.831995448588465,57.727597906363805,NaN,NaN,7.594568534847344,-2.6102951344004124
2005-02-16T09:30:00-05:00,30.85001,30.85001,30.55,30.78,219400,441960,61.35817301862312,54.590345658480715,NaN,NaN,110.97898944561578,107.19648748006303,0.08481886025480825,0.10873320985214008,0.02391434959733183,18382959,18081719,65.2333491232051,59.40275768549966,NaN,NaN,9.851587976651544,-0.8300261185358471
2005-02-17T09:30:00-05:00,30.57001,30.75999,30.5,30.5,230400,417110,53.305109503805454,55.436280847953135,NaN,NaN,76.76687440332226,104.7070604740981,0.06331162503512512,0.10305388089123824,0.039742255856113115,18152559,18139899,66.18538059916759,60.961562423588724,NaN,NaN,9.421331547351812,0.6344535480195328
2005-02-18T09:30:00-05:00,30.53,30.58,30.39999,30.5,844300,434090,53.305109503805454,55.58196845552465,NaN,NaN,53.65260431930446,92.32001923543018,0.04615008410146012,0.09742986098293827,0.05127977688147815,18152559,18152479,66.39963220692103,62.10259595924524,NaN,NaN,9.077766281449438,1.840641081366662
2005-02-22T09:30:00-05:00,30.24001,30.45,30,30.00999,645700,444530,42.092438709880625,54.78767334521909,NaN,NaN,-32.94849603796858,61.84612166211364,0.001235497665863658,0.052824148963807716,0.05158865129794406,17506859,18071699,63.612423938688636,62.64888395913054,NaN,NaN,4.95243394465971,2.2851829189799546
2005-02-23T09:30:00-05:00,29.82001,30.42,29.81,30.05,408900,445960,43.14407188142205,54.06849489002362,NaN,NaN,-58.789000872527055,29.93219425154938,-0.024897840958172303,0.02046635010022868,0.045364191058400984,17915759,18022139,61.895792707557455,62.86158771522873,NaN,NaN,2.0312815650185496,2.2489112969854683
2005-02-24T09:30:00-05:00,30.25999,30.48,30.03,30.48,417900,425580,53.01903573981801,54.22299000562756,NaN,NaN,-0.801493627578549,7.576097636910504,-0.01294450658507789,0.02918355782705362,0.04212806441213151,18333659,18012279,61.53997897217548,63.01789661026438,NaN,NaN,2.7381671960381966,2.318804996850144
2005-02-25T09:30:00-05:00,30.5,30.75,30.39,30.73,1288700,468480,57.626962764659105,54.29596008032968,NaN,NaN,88.93634538633074,10.009991833512203,0.010796526683092417,0.05562372276599703,0.04482719608290461,19622359,18306239,67.5324635330403,63.40549350079372,NaN,NaN,4.934310290143853,2.6924486101778164
2005-02-28T09:30:00-05:00,30.7,30.72,30.39101,30.55,202400,455965,53.55415408121012,54.11838049747808,NaN,NaN,58.21851026664389,10.923173022980084,0.013215114149083475,0.061346088769258955,0.04813097462017548,19419959,18559719,71.63638574144214,64.06066301595513,NaN,NaN,5.329609019916972,3.0691858115691244
2005-03-01T09:30:00-05:00,30.7,30.72,30.50999,30.64999,192800,429130,55.438234412111036,53.81254628197347,NaN,NaN,80.57591059088124,33.62805434875004,0.01998060709321388,0.07310673348669283,0.053126126393478953,19612759,18980899,76.86835345914011,65.08163188036033,NaN,NaN,6.259646637627912,3.5249659295775224
2005-03-02T09:30:00-05:00,30.64999,30.81,30.39999,30.74001,222800,414380,57.1245107688439,54.245928275219626,NaN,NaN,82.41419963817987,61.868694450891425,0.028434195904424496,0.08866887127400958,0.06023467536958508,19835559,19364859,80.41508351530274,66.48827390696307,NaN,NaN,7.540813189364426,4.098658395261365
2005-03-03T09:30:00-05:00,30.64999,30.89999,30.59,30.81,400600,411090,58.44128153525679,54.54973188934696,NaN,NaN,121.90923473756706,86.41084012392055,0.03615962431651132,0.10543420576522422,0.0692745814487129,20236159,19745359,83.16918585168742,68.01164506672147,NaN,NaN,8.981846533089819,4.79625670066543
2005-03-04T09:30:00-05:00,30.92999,31.34,30.92999,31.24001,1337000,447260,65.45990387898053,55.06167736017789,NaN,NaN,261.542283596857,120.9320277660258,0.06591689640368967,0.151670701953325,0.08575380554963533,21573159,20135519,85.43146862354675,69.67667184259606,NaN,NaN,12.660958583757099,5.919785541107097
2005-03-07T09:30:00-05:00,31.39999,31.5,31.3,31.39,414900,441830,67.5203867572854,55.780204342676875,NaN,NaN,278.59870761758805,165.00806723621463,0.0899029157415591,0.1981324502265842,0.1082295344850251,21988059,20649139,87.76326753920534,71.46534008997631,NaN,NaN,16.34466099747027,7.409053463444693
2005-03-08T09:30:00-05:00,31.39999,31.47,31.34,31.37,545200,455265,66.94689355825699,56.30973329385419,NaN,NaN,219.909076197196,192.8747003574776,0.09796096729236983,0.2306807436004874,0.13271977630811757,21442859,21015159,89.10193385448963,73.3417642618264,NaN,NaN,19.08301187306102,9.076761807675597
2005-03-09T09:30:00-05:00,31.2,31.34,31.03,31.03,374700,453470,57.93765891393264,56.065410857804864,NaN,NaN,120.23293489205697,200.438447408253,0.07496833555109711,0.22643019574698897,0.15146186019589186,21068159,21261679,89.90310745537367,75.1038898569813,NaN,NaN,18.640394819990757,10.442995095149191
2005-03-10T09:30:00-05:00,31,31.23,30.94,31.10001,680800,464190,59.15649775944159,56.48336716177887,NaN,NaN,93.64477257849985,194.78555497643956,0.059714061164065996,0.22610443665097435,0.16639037548690835,21748959,21564239,90.79731022186226,76.86188483003092,NaN,NaN,18.658139120074445,11.616587098709942
2005-03-11T09:30:00-05:00,31,31.28,30.92999,31.02,474200,478020,57.11942949215723,56.755818589518285,NaN,NaN,79.11426347307017,158.2999509516822,0.04039966716941354,0.21688995944867528,0.17649029227926175,21274759,21504559,89.12071235081193,78.48481912602313,NaN,NaN,18.06226604672686,12.537398376998073
2005-03-14T09:30:00-05:00,30.95,31.2,30.95,31.19,1482200,540730,60.25137751384783,58.05288564694451,NaN,NaN,76.95373867449885,117.97095716306436,0.03541593642857471,0.22076021281498015,0.18534427638640544,22756959,21658339,89.65099828957398,80.3447172939435,NaN,NaN,18.48509845619098,13.387069816882773
2005-03-15T09:30:00-05:00,31.35001,31.35001,31.02,31.02,843300,573950,55.85776053158397,58.961006264813214,NaN,NaN,71.32503568284667,88.2541490601945,0.017896917403769363,0.20771542314111713,0.18981850573734776,21913659,21752499,89.97326860860319,82.35025128687535,NaN,NaN,17.518565741362853,13.977283520379927
2005-03-16T09:30:00-05:00,30.96001,30.98,30.58,30.66,1068200,614720,47.89311328612182,58.59486894669205,NaN,NaN,-11.028351455332054,62.001891790716684,-0.01872674836274507,0.1664100702839164,0.18513681864666148,20845459,21707959,88.56829368035092,84.28084519460216,NaN,NaN,14.047423518665209,13.987303520134967
2005-03-17T09:30:00-05:00,30.75,30.82001,30.61,30.64999,401600,623830,47.68949255747181,57.885049646178686,NaN,NaN,-20.42231011230435,39.18847525255584,-0.04302673730413456,0.1313533970164933,0.17438013432062785,20443859,21446939,80.62279462679675,85.21586884415619,NaN,NaN,11.24686802799359,13.595812735543342
2005-03-18T09:30:00-05:00,30.74001,30.74001,30.44,30.58,657300,645175,46.21013632032608,57.36047694897268,NaN,NaN,-42.798652096198495,14.805892138702125,-0.06205835562475043,0.09680718978968983,0.15886554541444026,19786559,21149299,72.62232891163426,85.28629335631277,NaN,NaN,8.501001927549206,12.867982620115608
2005-03-21T09:30:00-05:00,30.69,30.75,30.42,30.67999,407600,623340,48.66037297932162,56.87634398948772,NaN,NaN,-38.39626401444485,-8.264108399086615,-0.06580102238362495,0.07661426743490907,0.14241528981853402,20194159,20636739,61.33472104985569,84.17674818422104,NaN,NaN,6.8841591352340155,12.013150693703952
2005-03-22T09:30:00-05:00,30.75,30.91,30.46001,30.50999,444100,613260,44.91435551123237,56.00419004251547,NaN,NaN,-43.968772807103065,-31.322870097076567,-0.07684483093779644,0.04635925114628847,0.12320408208408491,19750059,20204019,53.740543656615735,82.27142390860054,NaN,NaN,4.376277797123591,10.922168851335329
2005-03-23T09:30:00-05:00,30.41,30.5,30.3,30.32001,1197000,652665,41.10595389432645,54.76595235387759,NaN,NaN,-108.74822115141602,-50.866844036293365,-0.09298585103845355,0.006971768286017976,0.09995761932447153,18553059,19745539,47.08806757713134,79.69420117470368,NaN,NaN,1.0435542022470856,9.510938187179866
2005-03-24T09:30:00-05:00,30.41,30.7,30.39,30.47,430300,653285,45.06632027312228,53.309267810602,NaN,NaN,-78.51513862823539,-62.48540973947958,-0.0895675409098949,-0.012001806812897087,0.07756573409699781,18983359,19453439,43.40181567909303,76.69208310724268,NaN,NaN,-0.6297165217022584,8.062273228768134
2005-03-28T09:30:00-05:00,30.55,30.60001,30.42,30.44,588100,618255,44.4228711250358,51.65944526544131,NaN,NaN,-83.28104213954116,-70.5818877481481,-0.08535141375344152,-0.029123533094804088,0.05622788065863743,18395259,19175179,40.175276639284434,73.29294090010548,NaN,NaN,-2.180951494994888,6.598955411087703
2005-03-29T09:30:00-05:00,30.39999,30.5,29.89999,29.94,1400000,678135,35.360963107600426,49.40330737610869,NaN,NaN,-156.90485170267303,-94.28360528579375,-0.110656015550093,-0.08209213877897881,0.02856387677111418,16995259,18535399,33.929687053582796,69.35206612861214,NaN,NaN,-6.685782991914832,4.7011356392301975
2005-03-30T09:30:00-05:00,30.19,30.50999,30.12,30.50999,846600,710825,48.306757738719504,48.715385863593475,NaN,NaN,-91.50382878306931,-103.790616480987,-0.08460065975182945,-0.07718694791867264,0.007413711833156814,17841859,18153759,30.8488969082552,65.1339082323894,NaN,NaN,-6.15349509197145,3.150474106201391
2005-03-31T09:30:00-05:00,30.32001,30.5,30.32001,30.42999,398600,719615,46.887382390736256,47.83902048011453,NaN,NaN,-78.65979473110694,-97.77293119692519,-0.0690077636344919,-0.07884599270995807,-0.009838229075466162,17443259,17931799,29.188906422161395,60.73330796098219,NaN,NaN,-6.230599806803168,1.8103206900578823
2005-04-01T09:30:00-05:00,30.50999,30.64999,30.03999,30.14,991000,749135,42.0627448018958,46.763543002238706,NaN,NaN,-96.93480928191518,-101.45686532766115,-0.07403372850705256,-0.10238038970928187,-0.028346661202229305,16452259,17425579,25.781503669786957,56.2090787694804,NaN,NaN,-7.966249327635791,0.41366783038735755
2005-04-04T09:30:00-04:00,30.11,30.19,29.92,30.11,501700,707370,41.58600780634172,45.43030230884541,NaN,NaN,-125.98629297357122,-109.99791549446715,-0.07495903435203005,-0.12204545414226686,-0.04708641979023681,15950559,16936639,22.989957780651068,51.4475758759859,NaN,NaN,-9.462250485270305,-0.9971776432780226
2005-04-05T09:30:00-04:00,30.25,30.3,30.11,30.25999,206900,696970,44.94569077413415,44.65086875474186,NaN,NaN,-91.12469033180089,-96.84188322029271,-0.061608232387612594,-0.12409671027475255,-0.06248847788713996,16157459,16769079,22.106558321014532,46.59995371258672,NaN,NaN,-9.630463643105532,-2.230504214681953
2005-04-06T09:30:00-04:00,30.14999,30.45,30.14999,30.27,327100,686065,45.17233133938388,44.45652718711772,NaN,NaN,-72.35189464403408,-93.01149639248567,-0.04880209268008269,-0.12349109373724332,-0.07468900105716063,16484559,16497619,20.71763188481043,41.75347787004811,NaN,NaN,-9.696514140153809,-3.2970770611779323
2005-04-07T09:30:00-04:00,30.25999,30.53999,30.25999,30.52,474400,691050,50.63784577779191,44.66712384571202,NaN,NaN,-31.584741531964262,-83.59648575265713,-0.021581824747450323,-0.10166628199147354,-0.08008445724402322,16958959,16400759,20.22924819028502,37.43965312458298,NaN,NaN,-8.073411246133924,-3.9794105161716455
2005-04-08T09:30:00-04:00,30.42999,30.53,30.21001,30.21001,672400,690630,44.68910212678722,44.55847854617353,NaN,NaN,-58.11453446624665,-75.83243078952344,-0.02244205613288283,-0.10813702741012676,-0.08569497127724393,16286559,16367619,20.055052434941203,33.684847661962046,NaN,NaN,-8.526504536702774,-4.628995376247521
2005-04-11T09:30:00-04:00,30.49001,30.49001,30.19,30.27,298000,681820,46.01092059628265,44.369231947385025,NaN,NaN,-53.12352401490084,-61.259876997789355,-0.017195096485768405,-0.10718884188445443,-0.08999374539868603,16584559,16494419,22.794466533362694,30.931972339355404,NaN,NaN,-8.487437896162321,-5.180201450521063
2005-04-12T09:30:00-04:00,30.10001,30.57001,29.91,30.50999,469900,631205,51.0506477383186,44.80753853503404,NaN,NaN,-43.03985764187629,-51.64291045980442,0.003131048479982773,-0.08607993479870757,-0.08921098327869034,17054459,16673819,26.62536370272889,28.995173771220628,NaN,NaN,-6.879845235735046,-5.423007705551632
2005-04-13T09:30:00-04:00,30.45,30.5,29.95,29.98,1041300,641105,41.77617920633035,44.85541177160575,NaN,NaN,-110.0906043003737,-59.19065239107234,-0.017302456514530926,-0.110839053921854,-0.09353659740732308,16013159,16579539,25.898083913843763,27.481603509557228,NaN,NaN,-8.561048873337771,-5.871299300949652
2005-04-14T09:30:00-04:00,29.95,30.07001,29.42999,29.53,1370300,656210,35.8249945025739,44.19531707370944,NaN,NaN,-263.64207758056017,-105.60211960079153,-0.05706795163482278,-0.16487153695085155,-0.10780358531602877,14642859,16116319,22.62769963327065,25.99773807771277,NaN,NaN,-12.175550474982854,-6.771906611525824
2005-04-15T09:30:00-04:00,29.39999,29.57001,28.95,28.95,855500,678905,29.910716990873297,43.15873463555498,NaN,NaN,-333.43212837881026,-160.66563838330424,-0.11503201757035864,-0.25159360727897706,-0.13656158970861842,13787359,15616479,19.73213292705836,24.53751352683948,NaN,NaN,-17.60007336142426,-8.31878757579703
2005-04-18T09:30:00-04:00,28.89999,29.2,28.8,29.03999,826900,687385,31.792201050166966,42.90382306002402,NaN,NaN,-264.8732865330516,-203.01559088693438,-0.13834464519273829,-0.3094923961995413,-0.171147751006803,14614259,15222419,17.798425429616245,23.385280553699012,NaN,NaN,-21.014701111468437,-10.132489509464374
2005-04-19T09:30:00-04:00,29,29.24001,29,29.17,547700,694390,34.526715627631575,41.91953433780344,NaN,NaN,-185.22666922511692,-231.4529532035825,-0.13584703779146984,-0.3409565482461403,-0.20510951045467046,15161959,14843919,16.16027524080917,22.336093291738575,NaN,NaN,-22.769336822459397,-11.937753411320806
2005-04-20T09:30:00-04:00,29.25,29.3,28.81,28.87,1293900,736880,31.39858117613319,40.81319139390322,NaN,NaN,-165.4543347605725,-242.52569929562227,-0.14443561455187984,-0.38565402864452025,-0.24121841409264042,13868059,14414899,14.528064503926942,21.288890297578977,NaN,NaN,-25.289153121986985,-13.84509622713026
2005-04-21T09:30:00-04:00,29,29.64,29,29.64,1572200,755640,45.137685539354116,41.032830018007395,NaN,NaN,-82.65056113130896,-206.32739600577202,-0.0909084711172331,-0.3548540029891818,-0.2639455318719487,15440259,14574379,17.84968551608118,20.72233185802856,NaN,NaN,-22.441128072595653,-15.073100776482459
2005-04-22T09:30:00-04:00,29.8,29.8,29.03999,29.28999,494200,758835,41.10753582999333,40.998653448268215,NaN,NaN,-77.9730194956283,-155.23557422913564,-0.07252360181190493,-0.35460003413682983,-0.2820764323249249,14946059,14806119,22.55919686637438,20.69156322129452,NaN,NaN,-21.641538013774525,-16.011448953238467
2005-04-25T09:30:00-04:00,29.56,29.7,29.45,29.64,654300,762145,46.27354054070195,41.09349986016591,NaN,NaN,-40.85720512050295,-110.43235794662591,-0.0322900573562061,-0.32243900402018255,-0.29014894666397645,15600359,15003339,26.42493056707974,21.000018381727745,NaN,NaN,-19.11587271646477,-16.454938062270795
2005-04-26T09:30:00-04:00,29.45,29.7,29.23,29.25999,554200,719855,41.969034641485216,40.864692953173154,NaN,NaN,-61.95108624512882,-85.77724135062829,-0.02698587084642512,-0.3238812852220079,-0.29689541437558276,15046159,14980179,26.259157050761118,21.395841607867077,NaN,NaN,-18.60142156659183,-16.761578562888086
2005-04-27T09:30:00-04:00,29.02,29.35001,28.89999,29.3,1380300,746540,42.574726669711055,40.28875587402452,NaN,NaN,-81.84163520488299,-69.0547014394904,-0.016986582009594353,-0.3181286418875757,-0.30114205987798137,16426459,15491859,35.83628647205889,22.510630056565212,NaN,NaN,-18.008103189489862,-16.939653509545483
2005-04-28T09:30:00-04:00,29.17999,29.36,28.95,28.98,1274900,790355,39.06297729284909,39.886889814457504,NaN,NaN,-85.21194004712704,-69.56697722265402,-0.027504954531847314,-0.3355232530427905,-0.3080182985109432,15151559,15434119,35.27946967540272,23.598088430883887,NaN,NaN,-18.672993945237913,-17.18727357178726
2005-04-29T09:30:00-04:00,29.11,29.37,28.91,29.32001,2476900,864650,44.31842315202786,39.76599713986788,NaN,NaN,-65.37535859512478,-67.04744504255333,-0.008149023581064452,-0.31820457798727375,-0.3100555544062093,17628459,15970599,43.98777404387168,25.111896110205958,NaN,NaN,-17.487442596338738,-17.2301548610089
2005-05-02T09:30:00-04:00,29.49001,29.57001,29.28,29.48,971900,888160,46.649994115855336,39.451664738263354,NaN,NaN,-27.98109393516523,-64.47222280548579,0.01744698957325086,-0.28824681743964575,-0.3056938070128966,18600359,16570599,51.799166818226894,26.910024904170104,NaN,NaN,-15.7873622455197,-17.024041630224726
2005-05-03T09:30:00-04:00,29.5,29.5,29.14,29.27,1644100,960020,44.043084472019075,39.61358654295542,NaN,NaN,-43.95855553863357,-60.87371666418674,0.021960717403001262,-0.27824291025914505,-0.3002036276621463,16956259,16952619,56.006029498294026,29.060592445916548,NaN,NaN,-15.192475088607479,-16.762389267136548
2005-05-04T09:30:00-04:00,29.33,29.64999,29.25,29.61,334900,960410,49.011218719989586,40.55545970134225,NaN,NaN,-8.293478141710164,-46.164085251552166,0.0480735223341926,-0.24011172474440556,-0.28818524707859816,17291159,17125559,57.801565700620074,31.573011450727222,NaN,NaN,-13.11016722009054,-16.24064326041569
2005-05-05T09:30:00-04:00,29.47,29.67999,29.39,29.46001,641000,968740,47.02759016366078,41.778093499398494,NaN,NaN,0.796427221762569,-28.96241179777425,0.05497574758936158,-0.2194655625918962,-0.2744413101812578,16650159,17425279,60.788460028964465,34.505606243720514,NaN,NaN,-12.010866817085523,-15.636389482797096
2005-05-06T09:30:00-04:00,29.52,29.7,29.52,29.58,194800,944860,48.81242024642323,42.993823441988226,NaN,NaN,29.68976293923269,-9.949387490902751,0.06657951964939868,-0.1912169106195094,-0.2577964302689081,16844959,17268579,58.458702888874456,37.40991177652467,NaN,NaN,-10.578053050188723,-14.913769992424472
2005-05-09T09:30:00-04:00,29.41,29.78,29.41,29.78,515200,955720,51.7317193994754,44.222752282834215,NaN,NaN,57.94233123377794,7.235297542885884,0.08547614434603804,-0.15095124983636055,-0.23642739418239858,17360159,17020539,54.87368718234989,40.17515548663472,NaN,NaN,-8.504154415979157,-13.998110624360855
2005-05-10T09:30:00-04:00,29.89999,29.89999,29.36,29.42999,3093200,1086885,46.710975357526124,45.31649472436228,NaN,NaN,51.4445541656504,26.315919483742675,0.07265802479810965,-0.1456048631847615,-0.21826288798287116,14266959,16482679,47.999645987038,42.56598273542837,NaN,NaN,-8.189656867515877,-13.168331516240144
2005-05-11T09:30:00-04:00,29.32001,29.71001,29.31,29.64,675000,1068570,49.855661320568224,45.653492994449,NaN,NaN,65.55204289106541,41.085023690297795,0.07620723073747279,-0.12300384956103017,-0.19921108029850296,14941959,16012839,42.93942341549802,44.35810687110101,NaN,NaN,-6.983042342123123,-12.28471877708057
2005-05-12T09:30:00-04:00,29.84,29.84,29.28999,29.32001,959100,1048010,45.45422074893258,45.96397048865895,NaN,NaN,45.95601760839896,50.116941767625065,0.055832050447002485,-0.12942101723974986,-0.18525306768675234,13982859,15479379,38.03636419884643,45.46361882342044,NaN,NaN,-7.277397545064651,-11.569387172506868
2005-05-13T09:30:00-04:00,29.45,29.47,28.96001,29.17,3046100,1157540,43.51474098868086,45.76691337780029,NaN,NaN,-61.02206673290598,31.97457583319733,0.0322501029383693,-0.14494043901379072,-0.17719054195216002,10936759,14297739,29.893816652186345,45.71139640092805,NaN,NaN,-8.100525116144881,-11.073835450169442
2005-05-16T09:30:00-04:00,29.10001,29.58,29.10001,29.58,388100,1135600,49.81725445590152,46.32750050740146,NaN,NaN,16.093894996210665,23.604888585683874,0.043559445924923806,-0.12274123454600527,-0.16630068047092908,11324859,13090679,24.19573696590355,45.564009252009654,NaN,NaN,-6.8815752622082265,-10.474941137603555
2005-05-17T09:30:00-04:00,29.7,29.78,29.35001,29.78,1150100,1165720,52.595853075573885,47.04329525067738,NaN,NaN,101.50500920311818,33.61697959317743,0.0626441291999413,-0.08799551897100244,-0.15063964817094375,12474959,12732279,22.805736095048488,44.633255653651766,NaN,NaN,-5.014842726150541,-9.694927078824552
2005-05-18T09:30:00-04:00,29.7,30.33,29.62,30.23,2704400,1236245,58.20347556269427,48.41047369852346,NaN,NaN,256.47113683663383,71.8007983822911,0.10141343181353707,-0.023872858404022423,-0.1252862902175595,15179359,12779759,23.433279337224448,43.78709920092474,NaN,NaN,-1.564532520810316,-8.533442141965375
2005-05-19T09:30:00-04:00,30.28999,30.31,30.08,30.27,2282200,1271745,58.671474114427475,49.43569162440915,NaN,NaN,252.79529317286924,113.16865349518517,0.12409193767769025,0.029828631879553313,-0.09426330579813694,17461559,13475499,32.138912943381726,42.94075197946118,NaN,NaN,1.3258640216120605,-7.1249698328828845
2005-05-20T09:30:00-04:00,29.47,30.3,29.47,30.25999,3394700,1416770,58.49495914135394,50.281760554801906,NaN,NaN,151.06682312647243,155.58643146706086,0.13202184712326936,0.07076400310594977,-0.061257844017319596,14066859,14101519,38.87356725992547,42.017494868153925,NaN,NaN,3.6085138564877566,-5.5916150201156505
2005-05-23T09:30:00-04:00,30.10001,30.57001,30.10001,30.47,3516900,1559900,61.13666920625549,51.50273089296165,NaN,NaN,210.1585058874287,194.39935364530447,0.14403218100308388,0.11878238223653526,-0.025249798766548627,17583759,15353299,49.636586932710074,41.56253468489793,NaN,NaN,6.337669939797822,-3.887431454413726
2005-05-24T09:30:00-04:00,30.60001,30.78,30.25999,30.39,229800,1543680,59.58096671902812,52.25771289289297,NaN,NaN,185.24478078182224,211.14730796104527,0.13913440516022327,0.14866820768373046,0.00953380252350719,17353959,16329099,56.12241312066257,41.44259521490097,NaN,NaN,8.189905300264492,-2.162097632316838
2005-05-25T09:30:00-04:00,30.33,30.39999,30.05,30.13,1765400,1562935,54.70851295689298,52.8063502352667,NaN,NaN,105.02596225013151,180.85827304374482,0.11209140827004324,0.14964806286106125,0.03755665459101801,15588559,16410939,56.62691174704953,41.145341766192765,NaN,NaN,8.447454624294283,-0.646447309943821
2005-05-26T09:30:00-04:00,30.25,30.41,30.14999,30.35001,867600,1542570,57.84970545276809,53.45187060714847,NaN,NaN,108.32748030544894,151.96471047026074,0.10296349225095598,0.16626101990471298,0.063297527653757,16456159,16209859,54.95500352859037,40.89507752617247,NaN,NaN,9.56669948525014,0.8125736607981733
2005-05-27T09:30:00-04:00,30.38,30.39999,30.3,30.33,132500,1425350,57.459378763034294,53.860989133116966,NaN,NaN,100.7194376270692,141.89523337038014,0.08999071199423453,0.17578591764655016,0.08579520565231563,16323659,16661219,57.95578699737453,41.11522751295995,NaN,NaN,10.380392725806804,2.1794049557994057
2005-05-31T09:30:00-04:00,30.22,30.36,30.14999,30.25,188100,1386160,55.83727404972353,54.51286761113107,NaN,NaN,74.8662332359187,114.83677884007811,0.07125457121001806,0.1748634196648382,0.10360884845482014,16135559,16371579,55.40509534224748,41.64418818118919,NaN,NaN,10.636181687560015,3.387515917479493
2005-06-01T09:30:00-04:00,30.42,30.44,30.13,30.36,769400,1342425,57.60932292014065,55.0667005825291,NaN,NaN,76.54562468903335,93.09694762152034,0.06185119970617908,0.180922848087544,0.11907164838136491,16904959,16281779,54.60271938392173,42.47728075036232,NaN,NaN,11.324419335172466,4.521359262864204
2005-06-02T09:30:00-04:00,30.28,30.44,30.25999,30.36,103400,1330850,57.60932292014065,55.934922166186816,NaN,NaN,76.65346225206935,87.4224476219079,0.051629453038776474,0.1836084646798355,0.13197901164105902,16904959,16545059,56.587747826308764,43.80237958089534,NaN,NaN,11.900661802627718,5.575545339973277
2005-06-03T09:30:00-04:00,30.31,30.42,30.16,30.22,148300,1306215,54.38804645547588,56.71158684238646,NaN,NaN,56.018725480637684,76.96069665694566,0.032378458622839945,0.17245208491960895,0.140073626296769,16756659,16605159,57.0494342145578,45.742066549636164,NaN,NaN,11.579254633183842,6.433218096146215
2005-06-06T09:30:00-04:00,30.21001,30.28,30.12,30.24001,587800,1325865,54.77726701245831,57.06587345356909,NaN,NaN,42.21687601762985,65.26018433505779,0.018614942912537374,0.16334230493744073,0.14472736202490336,17344459,16809319,58.65788690897603,48.20364868842705,NaN,NaN,11.402316631704323,7.143089315511658
2005-06-07T09:30:00-04:00,30.33,30.63,30.2,30.37,305000,1315355,57.3249128361319,57.40366343646609,NaN,NaN,73.07399918906368,64.90173752568678,0.015988618227818996,0.1647131348096771,0.1487245165818581,17649459,17112099,60.99104887169137,50.93117102961583,NaN,NaN,11.886250007067378,7.820683700019618
2005-06-08T09:30:00-04:00,30.35001,30.46001,30.16,30.17999,158700,1168630,52.655352721527684,57.00736894781134,NaN,NaN,42.80894813622615,58.154402215125344,0.00002245167769934775,0.14875258117898227,0.14873012950128292,17490759,17229259,61.88735863450052,53.677890979421264,NaN,NaN,11.091025629280564,8.287875404199752
2005-06-09T09:30:00-04:00,30.02,30.23,29.99001,30.19,496800,1159720,52.873145424508856,56.593202612817144,NaN,NaN,9.714976535946304,44.76670507190073,-0.010703138539680773,0.13535120632668196,0.14605434486636273,17987559,17445779,63.554018006392894,55.92182705535064,NaN,NaN,10.47528454726883,8.600362424638192
2005-06-10T09:30:00-04:00,30.05,30.32001,30,30.14999,1494700,1186500,51.846521871304496,56.11831423638504,NaN,NaN,7.651812612138992,35.093322498201,-0.02074954880254601,0.12011740886318023,0.14086695766572624,16492859,17393019,62.83298204732458,57.633213825879146,NaN,NaN,9.686495083655174,8.75552423306919
2005-06-13T09:30:00-04:00,30.17,30.37,30.07001,30.2,433100,1055850,53.07303315277396,55.542340232564925,NaN,NaN,13.088920107815856,29.2677313162382,-0.024051454285149293,0.11080263980928962,0.1348540940944389,16925959,17309319,61.63825255671306,58.490475656165074,NaN,NaN,9.29895066232991,8.833156580106436
2005-06-14T09:30:00-04:00,30.16,30.25,30.12,30.13,280000,1050445,51.11066152395257,54.937318432916676,NaN,NaN,-29.11720051355454,8.829491375714557,-0.030556883198050305,0.09665799009687603,0.12721487329492634,16645959,17108619,58.75341334496762,58.67840424361543,NaN,NaN,8.470090208656687,8.781289955613616
2005-06-15T09:30:00-04:00,30.23,30.23,29.94,30.16,599100,1022895,51.93097632428417,54.7389229591589,NaN,NaN,-93.71331163693645,-18.474960578917965,-0.03227778150157816,0.08686764641795364,0.1191454279195318,17245059,17059479,58.03718729257059,58.77913821115265,NaN,NaN,7.947932336788711,8.662238867210059
2005-06-16T09:30:00-04:00,30.05,30.32001,30.05,30.19,556900,915520,52.784152769465884,54.37709776749445,NaN,NaN,-46.817151276003244,-29.78138614130787,-0.0308360487850233,0.08060036693825268,0.11143641572327598,17801959,17022359,57.46729177462574,58.958587371583754,NaN,NaN,7.694859059848687,8.52404175187272
2005-06-17T09:30:00-04:00,30.06,30.48,30.06,30.36,1386000,870710,57.398505025523356,54.37274964338652,NaN,NaN,36.308897949264434,-24.049969073882785,-0.01848286369963456,0.08833283609873277,0.10681569979836733,19187959,17561379,63.1290894204866,59.32810897323461,NaN,NaN,8.626362686879801,8.538659028302302
2005-06-20T09:30:00-04:00,30.17,30.36,30.17,30.25,553900,728670,53.7388529599609,54.2228624226892,NaN,NaN,-3.973683416646767,-27.462489778775307,-0.017764985718138934,0.08460946765069366,0.1023744533688326,18634059,17902999,66.2000254641121,60.099175410510654,NaN,NaN,8.511276749837686,8.534747274235928
2005-06-21T09:30:00-04:00,30.28999,30.34,30.19,30.24001,2044500,655050,53.405821468322294,53.92261231898789,NaN,NaN,-1.5917293869228037,-21.95739555344896,-0.01795463061169554,0.07993116510421316,0.0978857957159087,16589559,17891719,66.00454146207885,60.91359127323616,NaN,NaN,8.329422224345816,8.505415124251625
2005-06-22T09:30:00-04:00,30.21001,30.36,30.09,30.09,534400,670280,48.541222674682714,53.27489087288375,NaN,NaN,-66.68523696875612,-16.5517806198129,-0.02759797881573557,0.06338832219623924,0.09098630101197482,16055159,17653739,61.854607692420494,61.289795549387,NaN,NaN,6.871390391980473,8.27198301964146
2005-06-23T09:30:00-04:00,30.03999,30.03999,29.48,29.48,1745800,669300,34.699823323923084,51.86858922062998,NaN,NaN,-396.9775096184136,-86.58385228829498,-0.07195379066165614,0.0010440626849046453,0.07299785334656078,14309359,16955219,51.59958502149922,60.90052060702567,NaN,NaN,0.5488399396530825,7.168676865357407
2005-06-24T09:30:00-04:00,29.53,29.55,29.12,29.28999,810300,666435,31.670437066532116,50.21810136734954,NaN,NaN,-389.52750835827925,-171.7511335498037,-0.10877471940420969,-0.06297054590870133,0.04580417349550836,13499059,15817439,39.97417641511362,59.56596985746406,NaN,NaN,-5.7856233643636195,5.318062546825832
2005-06-27T09:30:00-04:00,29.34,29.34,29.13,29.25,536400,686630,31.05592351389828,48.34174498718999,NaN,NaN,-275.16723617925624,-225.9898441023256,-0.12912086994982436,-0.11559691394177207,0.01352395600805227,12962659,14683159,32.188311342301816,57.50863146250767,NaN,NaN,-10.986837133520831,2.9887911639191658
2005-06-28T09:30:00-04:00,29.35001,29.78,29.35001,29.75999,820300,718240,45.56264738945409,47.83512317775616,NaN,NaN,-121.90702756161602,-250.05290373726424,-0.10268163853154547,-0.11482809215637957,-0.012146453624834103,13782959,14121839,29.16133090091344,55.17105805296574,NaN,NaN,-10.708206761831722,1.032077174526182
2005-06-29T09:30:00-04:00,29.78999,29.8,29.57001,29.57001,812800,720410,42.01600011983829,47.05961279885112,NaN,NaN,-97.79783251457607,-256.2754228464282,-0.09274064219934461,-0.12807225637401487,-0.03533161417467026,12970159,13504839,26.24027944119682,52.50579101259459,NaN,NaN,-11.73865638412644,-0.7923133338527639
2005-06-30T09:30:00-04:00,29.64999,29.74001,29.34,29.38,1053700,767925,38.765793410528545,46.12527505165284,NaN,NaN,-113.6681381111929,-199.6135485449841,-0.09345208329646597,-0.15214671829525273,-0.05869463499878676,11916459,13026259,24.214201777450768,49.747306707603606,NaN,NaN,-13.707902133612492,-2.6373974481041538
2005-07-01T09:30:00-04:00,29.60001,29.60001,29.39,29.48,1354700,828245,41.33774764283895,45.28704037237177,NaN,NaN,-96.6874960154022,-141.0455460764087,-0.08208221399935964,-0.1612974024979863,-0.07921518849862666,13271159,12980679,24.023946616672674,47.06057056902929,NaN,NaN,-14.408184068860363,-4.318938393926469
2005-07-05T09:30:00-04:00,29.49001,29.62,29.28999,29.57001,877100,842710,43.63269057892025,44.752899590583745,NaN,NaN,-83.97402614373809,-102.80690406930505,-0.06418649722970951,-0.15944831003576354,-0.09526181280605403,14148259,13217799,27.227359875992633,44.808709606959646,NaN,NaN,-14.232358339342321,-5.735141243271591
2005-07-06T09:30:00-04:00,29.39999,29.57001,29.24001,29.24001,868200,870870,37.7948335359125,43.743175105700054,NaN,NaN,-98.36934269911437,-98.0993670968047,-0.06979639170455434,-0.18250730243674695,-0.11271091073219261,13280059,13117219,26.712860603601342,42.571257700604704,NaN,NaN,-16.035811041841363,-7.206665500210129
2005-07-07T09:30:00-04:00,28.83,29.36,28.83,29.31,808800,903375,39.63943065537602,42.804266383265066,NaN,NaN,-117.01622099104414,-101.94304479209829,-0.06415956054432359,-0.1929103614125971,-0.1287508008682735,14088859,13340959,29.886779570474417,40.60122111459389,NaN,NaN,-16.87547543413279,-8.58792406219908
2005-07-08T09:30:00-04:00,29.32001,29.82001,29.32001,29.82001,1711200,964095,51.03398219424239,42.34965760960214,NaN,NaN,-26.601762041717073,-84.52976957820313,-0.023541710595479243,-0.15817793911262257,-0.13463622851714332,15800059,14117679,39.656925216959046,38.92463795719907,NaN,NaN,-13.578346884111673,-9.300841608186595
2005-07-11T09:30:00-04:00,29.7,30,29.7,29.87,727600,925740,51.99064504341698,42.224785615563285,NaN,NaN,13.996415134053107,-62.392987348312076,0.007568564034029557,-0.12517552347460636,-0.13274408750863592,16527659,14768979,46.40150630663518,37.510458017379285,NaN,NaN,-10.712398311652121,-9.502492565824527
2005-07-12T09:30:00-04:00,29.8,29.84,29.7,29.71001,496600,928915,48.710584579607485,41.88941155208365,NaN,NaN,-2.1650909426991953,-46.0312003081043,0.017671139305521638,-0.11065516337673387,-0.1283263026822555,16031059,15145539,49.888887188001476,36.35933985494518,NaN,NaN,-9.422429037446085,-9.49105491891332
2005-07-13T09:30:00-04:00,29.64999,29.86,29.64999,29.8,822300,956030,50.5985014342891,42.03636003491268,NaN,NaN,6.508747157702379,-25.055582336740947,0.029989765416890066,-0.09083909591114292,-0.12082886132803299,16853359,15860199,55.77064785514746,35.92477129513996,NaN,NaN,-7.78494705455096,-9.247325224004411
2005-07-14T09:30:00-04:00,30.00999,30.14,29.98,30.07001,853400,968745,55.84970662580165,43.54706598504687,NaN,NaN,72.74811623817725,12.89728510910329,0.05447170962509394,-0.052739224296665554,-0.1072109339217595,17706759,16583779,60.78891650528897,36.58115211541065,NaN,NaN,-4.655619114048601,-8.591367208296438
2005-07-15T09:30:00-04:00,30.06,30.42,29.91,30.03,657800,973790,54.91815233859479,45.20761707590849,NaN,NaN,87.25199410383803,35.668036338214314,0.06538509782239411,-0.025479561643766857,-0.09086465946616097,17048959,16833559,62.37587485923844,38.18127343284815,NaN,NaN,-2.4415516320940016,-7.712822125981804
2005-07-18T09:30:00-04:00,29.87,30.11,29.85001,29.97,821100,945545,53.47760800453891,46.809165968097105,NaN,NaN,62.19271294993847,45.307295901391385,0.06579713917215414,-0.008618235500968296,-0.07441537467312244,16227859,16773599,61.7300099636807,40.29139476294664,NaN,NaN,-1.048579033527351,-6.7607873984883105
2005-07-19T09:30:00-04:00,30.14,30.25,30.10001,30.22,1048900,970295,58.37675114278435,47.724459093334985,NaN,NaN,116.11272328497677,68.96285874692657,0.07923905066826045,0.024633438662203133,-0.05460561200605732,17276759,17022739,63.42465961306286,42.738775385243024,NaN,NaN,1.6879606788672867,-5.553823387437511
2005-07-20T09:30:00-04:00,30.39,30.60001,30,30.57001,448100,890475,64.07996855437442,49.30045683865899,NaN,NaN,159.12462512614863,99.48603434061583,0.1063449878627526,0.07832562282238342,-0.02801936504036917,17724859,17197039,64.6055125523549,45.47914917889721,NaN,NaN,6.023205844402249,-3.8999620686032594
2005-07-21T09:30:00-04:00,30.59,30.69,30.39,30.41,975500,912530,60.03041930701564,50.819358688408066,NaN,NaN,170.1702954286794,118.97047017871625,0.10780366699165222,0.10673521869919611,-0.0010684482924561145,16749359,17005559,62.22862646483258,48.19446522799591,NaN,NaN,8.322330029980284,-2.1539203402341816
2005-07-22T09:30:00-04:00,30.39999,30.60001,30.38,30.5,694400,859960,61.50402008319251,52.2598067198619,NaN,NaN,141.9816103379521,129.91639342553907,0.10882002303224177,0.1349565804978461,0.026136557465604327,17443759,17084519,62.83582634506272,50.966742351452346,NaN,NaN,10.648426967364202,-0.3250135820058411
2005-07-25T09:30:00-04:00,30.45,30.64,30.28,30.28,721100,855500,56.06287313462801,53.14767690241245,NaN,NaN,108.33414241893045,139.14467931933746,0.08947436183921212,0.13797950976461948,0.04850514792540736,16722659,17183479,63.625065013757734,53.56657843272128,NaN,NaN,10.950400691712751,1.2857598856682435
2005-07-26T09:30:00-04:00,30.42,30.5,30.33,30.42999,438900,850625,58.74273085791082,54.64395528255518,NaN,NaN,99.95329727619749,135.91279411758163,0.08178828151536674,0.1507404998196158,0.06895221830424905,17161559,17160439,63.28807793223632,56.17909395619521,NaN,NaN,12.027971559709542,2.820361553388429
2005-07-27T09:30:00-04:00,30.53,30.56,30.41,30.55,1142900,866755,60.80276910877155,56.15562231494057,NaN,NaN,102.91532066873029,124.67093322609794,0.07971345202903543,0.16859403334054335,0.08888058131150792,18304459,17276359,64.31223128261499,58.63805479277668,NaN,NaN,13.547447526097772,4.3528024066326205
2005-07-28T09:30:00-04:00,30.67999,30.75999,30.53999,30.72,1007400,876485,63.577142971280146,57.05156237044327,NaN,NaN,117.86830974147165,114.21053608865641,0.08427297378252871,0.1942217985396688,0.1099488247571401,19311859,17788859,68.49664702379735,60.69803492183656,NaN,NaN,15.684354499125302,5.971595562703003
2005-07-29T09:30:00-04:00,30.72,30.75,30.5,30.5,666900,857145,57.86877059344126,57.47142848115929,NaN,NaN,93.15602362273304,104.4454187456126,0.06767079665702053,0.19453732057841577,0.12686652392139525,18644959,18029099,70.25713997887529,62.40200875556799,NaN,NaN,15.771012027592118,7.371512200544305
2005-08-01T09:30:00-04:00,30.58,30.61,30.42999,30.48,505800,814700,57.36451973246033,58.089566706363065,NaN,NaN,73.40317893175154,97.45922604817682,0.05128448753266465,0.19097213333722607,0.13968764580456142,18139159,18312399,72.22806283098353,63.997664158638145,NaN,NaN,15.692661766541525,8.560247852829622
2005-08-02T09:30:00-04:00,30.39999,30.52,30.35001,30.44,977900,819740,56.3077383458986,58.4973693429066,NaN,NaN,55.60559455085156,88.58968550310763,0.03449923669353641,0.18281169167148192,0.1483124549779455,17161259,18312339,72.22697120048579,65.17311582616232,NaN,NaN,15.329741284382592,9.527318343051475
2005-08-03T09:30:00-04:00,30.45,30.45,30.31,30.38,1268000,839730,54.68050348191312,58.41385483262885,NaN,NaN,39.503510255101766,75.90732342038193,0.016988863486416705,0.1695485343359664,0.1525596708495497,15893259,17830099,63.87145702792486,65.39329729206487,NaN,NaN,14.575597914079335,10.248501138912598
2005-08-04T09:30:00-04:00,30.39999,30.39999,30.14999,30.17999,417500,820165,49.54088309176541,58.029764172141036,NaN,NaN,-0.5612351090844873,52.22141445027071,-0.009031911842456969,0.14126978104647847,0.15030169288893544,15475759,17062879,53.30594006097622,64.74544480647471,NaN,NaN,12.42549121065558,10.559499720590166
2005-08-05T09:30:00-04:00,30.05,30.21001,30,30.02,631600,766185,45.83002422493725,57.48350818788378,NaN,NaN,-53.82350746403579,22.825508232916935,-0.036448221847289436,0.10474141557982364,0.14118963742711307,14844159,16302719,45.308775471909875,63.57249948563394,NaN,NaN,9.464301759622511,10.403042869023357
2005-08-08T09:30:00-04:00,30.07001,30.19,29.95,29.95,697200,764665,44.26764311822108,56.47571475755783,NaN,NaN,-72.43392358823452,-6.341912271080278,-0.05747599323999458,0.06934464587711986,0.12682063911711444,14146959,15504279,38.735374261801965,61.80897910340102,NaN,NaN,6.531740317047857,9.849999647312572
2005-08-09T09:30:00-04:00,30.03,30.25,30.03,30.17,465700,763120,50.03303922315603,55.47236266247081,NaN,NaN,-47.54116235963056,-26.9712636531767,-0.05475911995211305,0.058371739176973136,0.11313085912908619,14612659,14994559,35.22220975589822,59.710171760796975,NaN,NaN,5.580645975494336,9.240091979909966
2005-08-10T09:30:00-04:00,30.3,30.5,30.05,30.14999,401700,742090,49.53114842904462,54.72241474261574,NaN,NaN,-31.842228245650496,-41.24041135332716,-0.05249405675769776,0.047513288181963986,0.10000734493966175,14210959,14658099,33.08887420528312,57.628760885114865,NaN,NaN,4.660867058394768,8.585916991122081
2005-08-11T09:30:00-04:00,30.07001,30.42,30.07001,30.39999,438400,721340,55.53278726003579,54.295898112390255,NaN,NaN,-13.495738229472485,-43.82731197740476,-0.03327986575112854,0.05840751275075107,0.09168737850187961,14649359,14492819,32.06157037171057,55.43059974416114,NaN,NaN,5.605088126632879,8.160084296195052
2005-08-12T09:30:00-04:00,30.42999,30.5,30.17,30.27,866100,731755,52.06578987472554,54.01039216525436,NaN,NaN,-11.408805062609506,-35.3443714971195,-0.028623751961781824,0.055907688549652335,0.08453144051143416,13783259,14280639,30.742042813526282,53.0818124441446,NaN,NaN,5.382884456138918,7.763341461901319
2005-08-15T09:30:00-04:00,30.19,30.39999,30.06,30.33,585000,719950,53.50857897606605,53.63652417369402,NaN,NaN,-43.54023125695469,-29.56563303086354,-0.021146482844642753,0.058098336955630714,0.07924481980027347,14368259,14324899,31.376494016165864,50.80241359299672,NaN,NaN,5.6136058914431874,7.4562363804073
2005-08-16T09:30:00-04:00,30.24001,30.28999,29.96001,29.98,989300,716970,44.99976546384197,52.5077381990562,NaN,NaN,-124.70755585898073,-44.99891173073358,-0.03840998407897048,0.031232339701560363,0.06964232378053084,13378959,14078159,29.74082869131766,48.33302769361834,NaN,NaN,3.140651793748513,6.839724296598902
2005-08-17T09:30:00-04:00,30.14999,30.21001,29.86,30.06,845000,736815,47.071535321177855,51.32876622404889,NaN,NaN,-121.063665197714,-62.84319912114628,-0.04274640003508774,0.016209323736671166,0.05895572377175891,14223959,14080759,29.78236756205237,45.56772201777941,NaN,NaN,1.7475905455414078,6.112276617876403
2005-08-18T09:30:00-04:00,29.89999,30.09,29.89999,29.92999,474000,711740,44.16028033712307,50.34958834859759,NaN,NaN,-132.93433653675325,-86.73091878260243,-0.05205796717403276,-0.0061167351957820415,0.045941231978250716,13749959,13900879,28.525805915052487,42.58691244179206,NaN,NaN,-0.31483124665044127,5.194118351515425
2005-08-19T09:30:00-04:00,30.07001,30.2,30.03999,30.05,540100,704025,47.394562312380195,49.63744853287759,NaN,NaN,-75.47598288829414,-99.54435434773936,-0.04792539200849423,-0.013965508032367069,0.03395988397612716,14290059,14002239,30.310085549378215,39.592771207391685,NaN,NaN,-1.085738757908617,4.296995907311991
2005-08-22T09:30:00-04:00,30.03,30.32001,30.02,30.11,545400,695240,48.98547731273962,49.114429887651944,NaN,NaN,-49.18277965185318,-100.67286402671905,-0.03930339166475668,-0.01516935560481869,0.02413403605993799,14835459,14095679,31.995482963556483,36.71909347618244,NaN,NaN,-1.2603522177918665,3.503089032297154
2005-08-23T09:30:00-04:00,30.12,30.14999,29.92,29.97,452900,695940,45.52580148419806,48.460522602100866,NaN,NaN,-94.33657666876815,-94.59866818867656,-0.04099343848281529,-0.02710776204358112,0.013885676439234168,14382559,14296399,35.5985358341501,34.69959910519853,NaN,NaN,-2.4236855646573305,2.656406947017942
2005-08-24T09:30:00-04:00,29.92999,30.12,29.71001,29.73,457400,661665,40.27450901106616,47.79863873919377,NaN,NaN,-140.89665347108993,-98.56526584335174,-0.05534661568080748,-0.05529759316177518,0.000049022519032297304,13925159,14236639,35.003896155705704,33.392310254822064,NaN,NaN,-5.085722458780687,1.5503884604752807
2005-08-25T09:30:00-04:00,29.75,29.84,29.7,29.78,347300,628660,41.7811699416166,47.509434861813716,NaN,NaN,-158.81863227394044,-103.74212499078916,-0.05825111176938808,-0.07276486719270281,-0.014513755423314725,14272459,14341139,36.98610079413231,32.797833492123665,NaN,NaN,-6.817206218029511,0.3550177921174533
2005-08-26T09:30:00-04:00,29.8,29.8,29.58,29.62,1614100,676020,38.43946717095511,47.093136579866155,NaN,NaN,-182.8554717109536,-125.21802275532107,-0.06709648118698319,-0.09838435690704372,-0.031287875720060525,12658359,14014799,33.545501073906465,32.427128264416844,NaN,NaN,-9.322230372025949,-1.027446231331604
2005-08-29T09:30:00-04:00,29.62,29.8,29.46001,29.8,259200,663690,43.87772387595052,46.653471197922904,NaN,NaN,-158.7200068579546,-147.12546819654136,-0.057350853881360034,-0.10297644307176057,-0.04562558919040054,12917559,13631219,30.011594967135437,32.05494149379093,NaN,NaN,-9.840427491596449,-2.2864435542265817
2005-08-30T09:30:00-04:00,29.64999,29.67999,29.33,29.56,1653900,697490,38.938487285235,45.896852544793646,NaN,NaN,-190.32862558086478,-166.32387797896067,-0.06313633649086811,-0.12454600980398567,-0.061409673313117565,11263659,13007439,25.337071770157976,31.501241319853424,NaN,NaN,-11.863714639257761,-3.654625137802465
2005-08-31T09:30:00-04:00,29.50999,29.8,29.38,29.78,1055800,686880,45.0453265936245,45.14774821147855,NaN,NaN,-122.9828618761476,-162.74111965997218,-0.04885310751097405,-0.12247605770183512,-0.07362295019086107,12319459,12686299,23.322977148347476,30.8770560896132,NaN,NaN,-11.620992063810535,-4.792677555803618
2005-09-01T09:30:00-04:00,29.41,29.86,29.14999,29.66,1001200,716065,42.54584830237038,44.467752384881756,NaN,NaN,-132.50398860104522,-157.47819092539314,-0.04432660895146112,-0.12903121138018747,-0.08470460242872635,11318259,12095459,20.14942098402726,30.120440244648986,NaN,NaN,-12.211216984262533,-5.8524689027263195
2005-09-02T09:30:00-04:00,29.55,29.87,29.55,29.75999,659400,717455,45.27091909896523,43.87934810794599,NaN,NaN,-69.14117367375005,-134.73533131795244,-0.03201244936293754,-0.12472016413239828,-0.09270771476946074,11977659,11959319,19.49130321075853,29.27149804426275,NaN,NaN,-11.851414604472588,-6.709461145832929
2005-09-06T09:30:00-04:00,29.64999,30.13,29.64999,30.11,818400,723515,53.57216652393488,44.4916624693812,NaN,NaN,3.8991258088497087,-102.21150478459157,0.000565991847932712,-0.09200022495954485,-0.09256621680747756,12796059,11935019,19.369693290550032,28.53070265849363,NaN,NaN,-8.740499665636163,-6.99960950580482
2005-09-07T09:30:00-04:00,30.09,30.23,30.00999,30.23,1976700,799065,56.03437022087118,45.13186496221643,NaN,NaN,63.2426412004033,-51.49725142833795,0.02945788560910864,-0.055743859796091755,-0.0852017454052004,14772759,12636839,32.473728381702045,28.722942717040038,NaN,NaN,-5.4050801493948395,-6.771819597746251
2005-09-08T09:30:00-04:00,30.05,30.17,29.98,30.06,200000,788980,51.840034388537305,45.680418823031744,NaN,NaN,40.31957796564759,-18.836763459978908,0.03595029904941789,-0.040263871593428036,-0.07621417064284593,14572759,13087499,39.29604228159707,29.492245314650358,NaN,NaN,-3.955682775573952,-6.369514337435923
2005-09-09T09:30:00-04:00,30.06,30.25999,30.06,30.23,270200,780570,55.432645770606136,46.25456764147645,NaN,NaN,79.768379104134,23.617710081056913,0.049678876828380736,-0.014115574607370007,-0.06379445143575074,14842959,13792439,48.124920508744076,30.76473352603364,NaN,NaN,-1.5830948987900768,-5.685740131915088
2005-09-12T09:30:00-04:00,30.14999,30.42,30.10001,30.42,713800,772955,59.1045273635013,46.977356930816576,NaN,NaN,121.89625835183635,61.825196486174185,0.06838639256149581,0.021688539266119022,-0.04669785329537679,15556759,14508259,55.24332542915628,32.42529370214791,NaN,NaN,1.6111566850060857,-4.643326300926349
2005-09-13T09:30:00-04:00,30.34,30.42,30.2,30.28999,620600,774735,55.72152243928121,47.705622713322505,NaN,NaN,117.09490450084208,84.46435222457265,0.0686557742387004,0.039121864502998704,-0.02953390973570169,14936159,14936279,58.87705835776779,34.08804531097775,NaN,NaN,3.186684698948067,-3.5247533009442895
2005-09-14T09:30:00-04:00,30.3,30.33,30,30.06,1806300,815585,50.24287626930775,48.41764894605405,NaN,NaN,59.887996779942334,83.79342334048046,0.05081739883741036,0.033987838811061266,-0.016829560026349097,13129859,14607699,55.17375346053042,35.528749404179514,NaN,NaN,2.7816007833194067,-2.6238455746209044
2005-09-15T09:30:00-04:00,30.17999,30.17999,29.94,30.02,525200,799595,49.33435426808248,48.957162112230186,NaN,NaN,33.29040485402388,82.38758871815571,0.034573444037389434,0.026387245020387695,-0.008186199017001738,12604659,14214079,51.0326842117276,36.53207679115061,NaN,NaN,2.179902038541209,-1.9375959155977454
2005-09-16T09:30:00-04:00,30.08,30.16,29.86,30.11,1144900,833140,51.46111180763617,49.88727958627883,NaN,NaN,30.70764227456368,72.57544135224165,0.028397872557506386,0.027311141679881246,-0.0010867308776251411,13749559,13995399,48.83953550750748,37.624507822122105,NaN,NaN,2.311220118814074,-1.3306221963960567
2005-09-19T09:30:00-04:00,30.02,30.02,29.58,29.71001,1704500,891360,42.851860434543774,49.81400362617834,NaN,NaN,-49.29558198280728,38.33707328531294,-0.002478039242560364,-0.004184279930825596,-0.001706240688265232,12045059,13293059,42.51935658624017,38.51791936634387,NaN,NaN,-0.39075915978943304,-1.1963560483093962
2005-09-20T09:30:00-04:00,30.06,30.06,29.50999,29.50999,631400,895660,39.31024840304245,49.84055799173602,NaN,NaN,-65.74259045355186,1.7695742944341533,-0.03444981332731564,-0.04476850734740978,-0.010318694020094141,11413659,12588559,37.30455288723516,39.3727394461351,NaN,NaN,-3.8267869991050003,-1.572131898423054
2005-09-21T09:30:00-04:00,29.39999,29.60001,29.3,29.41,601200,903075,37.63569474311336,49.311298573842365,NaN,NaN,-127.08620646372148,-35.6252663542986,-0.05897024042862602,-0.08403149455587666,-0.025061254127250646,10812459,12125079,34.322187031028136,40.15839729489801,NaN,NaN,-7.14620140698268,-2.3684275425030004
2005-09-22T09:30:00-04:00,29.37,29.62,29.31,29.53,3667500,1063580,40.89003773657525,49.19302639057129,NaN,NaN,-100.23535863569266,-62.330419052241915,-0.06336125332091538,-0.10426282077839488,-0.0409015674574795,14479959,12500139,38.600000849456706,41.476295856714394,NaN,NaN,-8.890284033889502,-3.3001213269867864
2005-09-23T09:30:00-04:00,29.57001,29.82001,29.47,29.75,1895400,1140985,46.411163976050915,49.27447245322027,NaN,NaN,-46.1721868995286,-77.70638488706037,-0.04837917571218393,-0.10137553709770941,-0.05299636138552548,16375359,13025299,44.091104975336066,43.233424554184225,NaN,NaN,-8.6578888046254,-4.0655166809351595
2005-09-26T09:30:00-04:00,29.8,30,29.58,29.71001,1362300,1128395,45.577801814650236,48.70344640255708,NaN,NaN,-25.84714171207062,-73.01669683291304,-0.03852149404990743,-0.10114822894790976,-0.06262673489800233,15013059,13618899,49.57995630533359,45.39130048381162,NaN,NaN,-8.71974568689795,-4.730406538929843
2005-09-27T09:30:00-04:00,29.56,29.94,29.56,29.87,1542800,1192575,49.48577127378668,48.23568933490818,NaN,NaN,-20.44298430207785,-63.956775602618244,-0.019542385765312156,-0.08705471710464252,-0.06751233133933036,16555859,14647339,57.38587289662317,47.170739377734556,NaN,NaN,-7.594735352203505,-5.139596369397509
2005-09-28T09:30:00-04:00,29.88,29.95,29.67999,29.88,151800,1117470,49.72876022263165,48.08488403734349,NaN,NaN,-12.672816513644493,-41.07409761260284,-0.005368530548849698,-0.0742229945253925,-0.0688544639765428,16707659,15826379,64.22412643130664,48.95131681699952,NaN,NaN,-6.615499827752652,-5.350439720591101
2005-09-29T09:30:00-04:00,29.92,30.03999,29.60001,30.02,1069300,1118145,53.1281255228385,47.92027544821723,NaN,NaN,-1.5772375037749804,-21.342473386219307,0.013359000489458844,-0.05215571336471925,-0.06551471385417809,17776959,16485779,67.37709287352105,50.326471985912164,NaN,NaN,-4.786726597897222,-5.269909274491976
2005-09-30T09:30:00-04:00,30,30.16,29.96001,30.16,261400,1081155,56.30973999690108,47.720647779174364,NaN,NaN,55.014460664057204,-1.1051438735021477,0.03392851132636585,-0.023104074696220778,-0.05703258602258663,18038359,16818379,68.86748744074939,51.299626415311664,NaN,NaN,-2.2783257005218207,-4.84254019249624
2005-10-03T09:30:00-04:00,30.25999,30.25999,29.92999,29.98,906400,1093505,51.4720722480255,47.41711562265609,NaN,NaN,39.068911315920325,11.878066732096045,0.034075269306384985,-0.014438499389605397,-0.04851376869599038,17131959,17242159,70.70398375857977,52.14440680108395,NaN,NaN,-1.4979413813029128,-4.364740362325764
2005-10-04T09:30:00-04:00,30.09,30.14999,29.69,29.71001,1626400,1133905,45.199495799577925,47.05687416053253,NaN,NaN,-25.218022276082532,10.923059137295109,0.015593132155939445,-0.029022353501066078,-0.04461548565700552,15505559,17032099,68.54553063798203,53.09953374233049,NaN,NaN,-2.749159586033614,-4.133943108569743
2005-10-05T09:30:00-04:00,29.59,29.69,29.33,29.34,2624400,1166290,38.30933457129053,46.269372753618825,NaN,NaN,-134.18563079745897,-13.379503719467786,-0.020014954028291537,-0.06963417819236994,-0.04961922416407841,12881159,16266799,61.21357971749028,53.826740564170684,NaN,NaN,-6.210799427483242,-4.4306368684145285
2005-10-06T09:30:00-04:00,29.44,29.71001,29.33,29.53999,6168398,1464709.9,43.33709028964863,45.68908550233401,NaN,NaN,-100.79204469272514,-33.222465157257815,-0.02806893205987311,-0.08470538923891979,-0.05663645717904668,19049557,16521318.6,62.644670485627984,54.81282163403644,NaN,NaN,-7.41483520091877,-4.856950915915134
2005-10-07T09:30:00-04:00,29.67,29.8,29.59,29.8,2373700,1569884.9,49.14062021116886,46.138282629235796,NaN,NaN,-35.95826709899578,-51.41701070986842,-0.014536015119909304,-0.07480647607893331,-0.06027046095902401,21423257,17198298.2,66.2153133150446,56.505389971808185,NaN,NaN,-6.468153147855067,-5.0871226633351245
2005-10-10T09:30:00-04:00,29.77,29.77,29.52,29.57001,390800,1553734.9,44.772374412984306,46.52843448708878,NaN,NaN,-64.6288128333746,-72.1565555397274,-0.019419793239376912,-0.08454520250824515,-0.06512540926886824,21032457,17978397.8,69.79785154034347,58.826339875601626,NaN,NaN,-7.157686351062918,-5.382917475867666
2005-10-11T09:30:00-04:00,29.45,29.67,29.37,29.41,406000,1543004.9,41.97663366163468,46.838501552697444,NaN,NaN,-104.86723550869749,-88.08639818625039,-0.031080561561365613,-0.10397611122057526,-0.07289554965920965,20626457,19002577.4,73.73560946383894,61.64158433508812,NaN,NaN,-8.64554209566707,-5.849006707267581
2005-10-12T09:30:00-04:00,29.39999,29.62,29.23,29.41,1061300,1505754.9,41.97663366163468,46.91611554734454,NaN,NaN,-115.83508780364161,-84.41628958748693,-0.03609543603201784,-0.11801484469923196,-0.08191940866721412,20626457,20551637,78.3362779556954,64.4798898426766,NaN,NaN,-9.805621813220622,-6.414237436689444
2005-10-13T09:30:00-04:00,29.5,29.5,29.17999,29.37,4903398,1724664.8,41.23021143233783,46.5460475085079,NaN,NaN,-126.61338177417345,-89.58055700377659,-0.03915234273520751,-0.1308598370862235,-0.091707494351016,15723059,19886337.4,72.46521151047807,66.50661173804387,NaN,NaN,-10.965831182539421,-7.064465114668012
2005-10-14T09:30:00-04:00,29.48,29.67999,29.38,29.63,1830300,1758934.8,47.73570289896531,46.70018330024469,NaN,NaN,-42.827672039173464,-90.95443799181211,-0.021587249819112225,-0.11869155662490627,-0.09710430680579404,17553359,19112357.8,66.24501375287463,67.6969729842968,NaN,NaN,-10.01113045287517,-7.485417305840463
2005-10-17T09:30:00-04:00,29.88,29.88,29.47,29.69,3865500,1866984.8,49.13499273600552,46.67512769040319,NaN,NaN,3.9449116707502307,-77.23969309098716,-0.004731809306317489,-0.10301906843869091,-0.09828725913237342,21418859,19189638.2,66.55372110008155,68.35181928454384,NaN,NaN,-8.816048005005175,-7.675507405721136
2005-10-18T09:30:00-04:00,29.71001,29.71001,29.42,29.48,1170200,1893924.8,44.631054354617,46.31100584268785,NaN,NaN,-47.94534983640357,-65.85531595652837,-0.006424739695847795,-0.10631818375218316,-0.09989344405633536,20248659,19114078.6,65.9189396668213,68.47287737279488,NaN,NaN,-9.122032662765768,-7.882153871013227
2005-10-19T09:30:00-04:00,29.45,29.87,29.3,29.87,1481000,1937914.8,53.209176541533715,46.31679520116608,NaN,NaN,2.319077825491559,-42.224482830701746,0.018650558155113725,-0.0765802463624432,-0.09523080451755693,21729659,19334719,66.91139373660098,68.43961314872915,NaN,NaN,-6.591433715511686,-7.6977652773701495
2005-10-20T09:30:00-04:00,29.7,30.03999,29.39999,29.49001,450500,1777064.8,45.76890566640698,45.563878463273646,NaN,NaN,-16.71108009178997,-20.244022494225042,0.010007702974526106,-0.0827211757993993,-0.09272887877392541,21279159,20445939,71.42463725925336,68.62226670719373,NaN,NaN,-6.916442950011518,-7.586147802033202
2005-10-21T09:30:00-04:00,29.52,29.61,29.24001,29.28999,1035300,1734059.8,42.40742906831513,44.91640395043719,NaN,NaN,-112.94644378895474,-34.2677768441813,-0.007853509169018766,-0.10254576523519887,-0.0946922560661801,20243859,20984039,73.32224808261137,68.8092855874817,NaN,NaN,-8.324510178486138,-7.691628141526478
2005-10-24T09:30:00-04:00,29.3,29.77,29.3,29.74001,2441700,1788029.8,51.107875684810416,45.33843108509666,NaN,NaN,-22.276225111614917,-39.51200420065433,0.010945639311158634,-0.08101020692723182,-0.09195584623839045,22685559,21237379,74.19122501009343,69.21254947120394,NaN,NaN,-6.436754868886779,-7.512360531149378
2005-10-25T09:30:00-04:00,29.78999,29.89,29.49001,29.7,776800,1749729.8,50.37917768960094,46.20056273640454,NaN,NaN,16.073993077847554,-26.708135617804107,0.02043979204698762,-0.06640610617965592,-0.08684589822664354,21908759,21569399,75.32558535723301,70.22054987404272,NaN,NaN,-5.235759079930161,-7.187131752403776
2005-10-26T09:30:00-04:00,29.57001,29.75999,29.44,29.44,1256200,1804949.8,45.808359338025916,46.37708195414577,NaN,NaN,-39.948523182271785,-35.161655819356774,0.009518220259361929,-0.07494812290244113,-0.08446634316180306,20652559,21353979,73.08120828044554,70.96601685938683,NaN,NaN,-5.756969453481897,-6.982822852557793
2005-10-27T09:30:00-04:00,29.60001,29.60001,29.12,29.17999,810300,1791999.8,41.730794053348106,45.84780865715858,NaN,NaN,-133.36176667859027,-58.49179313671683,-0.013649337427054903,-0.10152801494562169,-0.08787867751856679,19842259,21066599,70.08128222167382,71.24215749557462,NaN,NaN,-7.5633749126695085,-7.065758861145181
2005-10-28T09:30:00-04:00,29.34,29.64999,29.2,29.64999,844200,1821139.8,50.336491492118675,46.245245591382464,NaN,NaN,-40.54619105589844,-44.01174259010557,0.0033406821903379236,-0.08370282478064439,-0.08704350697098232,20686459,21155119,70.48320587540238,71.29111137665026,NaN,NaN,-6.10642866489082,-6.928711690251701
2005-10-31T09:30:00-05:00,29.72,29.84,29.66,29.73,1339700,1842804.8,51.645712769723396,46.935894099103095,NaN,NaN,102.67426089792025,-19.02164538819854,0.019714183574476102,-0.062400777502887195,-0.0821149610773633,22026159,21023239,68.99608170262567,70.95257367942074,NaN,NaN,-4.538624552690402,-6.587270670600087
2005-11-01T09:30:00-05:00,29.85001,29.85001,29.60001,29.64,694100,1796189.8,50.047477276802496,47.51238292875793,NaN,NaN,86.04144835333622,-5.028154333100804,0.023948363637689624,-0.052179506530251274,-0.0761278701679409,21332059,20907899,67.65168968947238,70.18938880326195,NaN,NaN,-3.794693059500656,-6.188331011871597
2005-11-02T09:30:00-05:00,29.61,29.97,29.48199,29.94,880200,1708979.8,55.04182315279871,48.498926623076564,NaN,NaN,130.15369130487065,28.992288564327687,0.04518619528301715,-0.01964512606416946,-0.06483132134718661,22212259,21219839,69.38891452739068,69.96965330446999,NaN,NaN,-1.5352595289634487,-5.52360651431329
2005-11-03T09:30:00-05:00,30.10001,30.21001,30.02,30.07001,726200,1436869.9,57.04612763949552,49.16395696168587,NaN,NaN,245.19157861299453,104.70295762264463,0.06501691094420155,0.01643981733306532,-0.04857709361113623,22938459,21839079,72.54141526051501,70.41939626930144,NaN,NaN,0.9356305583179594,-4.600858361080254
2005-11-04T09:30:00-05:00,30.14999,30.17,29.96001,30.09,662900,1351329.9,57.36089076558481,49.75152110665582,NaN,NaN,198.26601579675892,152.46539899317614,0.07575670861839662,0.046118792161859545,-0.029637916456537072,23601359,22422059,75.13740114372695,71.03251627241897,NaN,NaN,3.0021492879688005,-3.5147144112161035
2005-11-07T09:30:00-05:00,30.2,30.25,30.02,30.2,297900,1346684.9,59.13545909406473,50.787550016616365,NaN,NaN,189.22016257343188,169.77457932827843,0.08580706013522144,0.07762090871248972,-0.008186151422731713,23899259,22796679,76.66415721111832,71.80003181129733,NaN,NaN,5.248146057620062,-2.2628772013823655
2005-11-08T09:30:00-05:00,30,30.11,29.96001,30.00999,269500,1339859.9,54.88617266283044,50.90733545385184,NaN,NaN,123.42460203751604,177.2512100651144,0.07555691515449699,0.08625999252038952,0.010703077365892533,23629759,23256219,78.41516809761335,72.62172997994107,NaN,NaN,5.9567027638456,-1.0886514920640848
2005-11-09T09:30:00-05:00,30.05,30.25,29.97,30.08,562000,1314894.9,56.13682444648304,51.647901081000136,NaN,NaN,128.0805664622374,176.83658509658775,0.06954180124517406,0.09763032892236012,0.028088527677186052,24191759,23652119,79.82002728446108,73.22140069602733,NaN,NaN,6.898668599790378,0.05239423534369547
2005-11-10T09:30:00-05:00,30.16,30.5,30.06,30.47,282500,1083850,62.39146507927681,53.075332224640256,NaN,NaN,170.34903279022052,161.86807593203295,0.086758959388966,0.13653722691339354,0.04977826752442755,24474259,23959279,80.86083602068548,73.75987126303264,NaN,NaN,9.687057891297576,1.4287747576228211
2005-11-11T09:30:00-05:00,30.35001,30.58,30.35001,30.53,502200,1017445,63.259463846292164,53.94330280760324,NaN,NaN,171.2537028897947,156.46561335064013,0.09637753341403638,0.17025018429197303,0.07387265087793665,24976459,24234299,81.76756864806265,74.30103866574471,NaN,NaN,12.218021486706295,2.9700957189204598
2005-11-14T09:30:00-05:00,30.52,30.61,30.49001,30.59,198900,834115,64.15051031655446,54.92696942381421,NaN,NaN,155.64172045770576,149.74992492749487,0.1005095766843691,0.19950962173339803,0.09900004504902893,25175359,24489519,82.59179298281543,74.82005349614346,NaN,NaN,14.566858786276205,4.626776157114137
2005-11-15T09:30:00-05:00,30.74001,30.75,30.5,30.58,840000,817605,63.872473675317636,56.217263305049336,NaN,NaN,141.2684017002575,153.3186848600432,0.09628984210979379,0.21936234768627116,0.12307250557647738,24335359,24630639,83.04812110462473,75.53197584072768,NaN,NaN,16.426442845280793,6.312442826852231
2005-11-16T09:30:00-05:00,30.64999,30.75999,30.64,30.69,885400,787825,65.63677670797298,57.92483349466539,NaN,NaN,136.7088502875773,155.04434162511117,0.09449523607255217,0.24119155066716758,0.1466963145946154,25220759,24836439,83.71840920931534,76.50605633984495,NaN,NaN,18.514117084655574,8.055539149395566
2005-11-17T09:30:00-05:00,30.8,31.02,30.62,30.98,426600,786630,69.82112643962965,59.31659313377332,NaN,NaN,147.9359887530771,150.56173281768247,0.10558653556363584,0.2786794840491602,0.17309294848552437,25647359,25071059,84.4722117791951,77.50527104725872,NaN,NaN,21.652618304259263,9.997979028661808
2005-11-18T09:30:00-05:00,31.10001,31.37,31.10001,31.3,786500,774190,73.63601458274128,60.88732897756031,NaN,NaN,185.821493300514,153.47529089982632,0.12584692359358557,0.3304016029775063,0.20455467938392075,26433859,25362539,85.37793971341488,78.67540376231509,NaN,NaN,25.685020123886638,12.238984899408212
2005-11-21T09:30:00-05:00,31.31,31.53,31.25011,31.48,1097900,707000,75.51123722125288,62.706168973592476,NaN,NaN,174.7885418016155,157.30465516860826,0.14157093213614816,0.38151834455410594,0.23994741241795778,27531759,25833819,86.72610030195507,80.03786166320671,NaN,NaN,29.69121006225902,14.732159922672613
2005-11-22T09:30:00-05:00,31.71001,31.71001,31.36,31.56,1308700,733595,76.31749079856264,64.22585951971847,NaN,NaN,161.45771941927907,161.34251871241258,0.1469229122168348,0.4236010526890013,0.2766781404721665,28840459,26734839,88.843902779208,81.42750368119366,NaN,NaN,33.228021543999255,17.37442586857642
2005-11-23T09:30:00-05:00,31.56,31.69,31.55,31.60001,559600,698765,76.73012209340826,65.63185912356938,NaN,NaN,147.45675479622443,163.492099614142,0.1426064107451831,0.4549361539036454,0.3123297431584623,29400059,27570699,90.37764413973035,82.70152002970904,NaN,NaN,36.250411492683305,20.07099524344883
2005-11-25T09:30:00-05:00,31.8,31.8,31.55,31.61,394300,677965,76.83863470713253,67.02312654796565,NaN,NaN,135.4092040478967,160.98674267310594,0.13021533536175883,0.4750989123606608,0.344883576998902,29794359,28400099,91.6102000197691,83.87814852085491,NaN,NaN,38.769145414312746,22.742159553572247
2005-11-28T09:30:00-05:00,31.63,31.71001,31.42,31.44,1541200,712815,70.78911726761034,67.85553070321892,NaN,NaN,106.95040431751391,145.21252487650594,0.10162950572812213,0.4719204591590547,0.37029095343093255,28253159,28763959,92.08895574981207,84.97991984504732,NaN,NaN,39.323906657126514,25.11098056836571
2005-11-29T09:30:00-05:00,31.25,31.74001,31.24001,31.50999,564000,674030,71.77438938990213,69.06183189800974,NaN,NaN,91.90550583213775,128.63591768261037,0.07947560123873149,0.4696354549793469,0.3901598537406154,28817159,29021039,92.41815289443326,85.98013304482016,NaN,NaN,40.0593146626152,27.24645686754421
2005-11-30T09:30:00-05:00,31.75,31.75,31.42,31.46001,300700,654360,69.95969147260797,70.04917954273296,NaN,NaN,86.46521701676113,113.63741720210677,0.054677101003893336,0.4585062299954821,0.40382912899158874,28516459,28956239,91.38588418745374,86.80626568074821,NaN,NaN,40.19670350412285,29.09649210134116
2005-12-01T09:30:00-05:00,31.69,31.86,31.5,31.81,530200,636860,74.77021600674531,70.93337603755212,NaN,NaN,96.39981806409212,103.42602985568033,0.054921528573950884,0.47248103970902733,0.41755951113507644,29046659,28885559,90.20240718373815,87.47352076382342,NaN,NaN,41.72944040010063,30.901199001163942
2005-12-02T09:30:00-05:00,31.60001,31.78,31.60001,31.69,248500,612975,70.59596810927489,71.45741205633661,NaN,NaN,83.27514477773983,92.99921800164896,0.040730723742099295,0.46847291581270056,0.42774219207060127,28798159,28686319,86.79034607136386,87.8322905797735,NaN,NaN,41.79730361058629,32.45778537393856
2005-12-05T09:30:00-05:00,31.47,31.60001,31.44,31.52,2599100,709785,65.05503537616346,71.52202098916584,NaN,NaN,57.71524890001988,83.15218691815016,0.014952383586863682,0.44643267155418087,0.4314802879673172,26199059,28275499,80.06519323922467,87.65181916951701,NaN,NaN,40.191312601163446,33.56257497782783
2005-12-06T09:30:00-05:00,31.77,31.89,31.60001,31.64999,829000,736340,67.17648981222457,71.75802214180204,NaN,NaN,75.2401157787207,79.81910890746676,0.002373125428326961,0.4344466947527259,0.43207356932439894,27028059,27917679,74.64017615217615,87.05125167291354,NaN,NaN,39.44300887123194,34.40263696259984
2005-12-07T09:30:00-05:00,31.89999,31.97,31.32001,31.42,749800,760355,60.21161848512432,71.37051084017,NaN,NaN,52.84382737716901,73.09483097954833,-0.024252269798444692,0.4017582320763431,0.4260105018747878,26278259,27470039,68.39650233368545,85.9568297532257,NaN,NaN,36.62040900086678,34.71946153949512
2005-12-08T09:30:00-05:00,31.67,31.67,31.17,31.28,476900,756100,56.379649973407766,70.410405378297,NaN,NaN,18.8021801916343,57.57530340505677,-0.05248753701097192,0.3604010806110729,0.4128886176220448,25801359,26820979,60.49471032239335,84.24415107773986,NaN,NaN,33.05198094659157,34.48125002622319
2005-12-09T09:30:00-05:00,31.10001,31.59,31.09,31.45,2306800,857315,59.73098756947318,69.41718916306357,NaN,NaN,12.660807149360913,43.45243587938099,-0.06034859593446246,0.33745287270396673,0.3978014686384292,28108159,26682979,58.93569971808394,82.35541964950194,NaN,NaN,31.013895858690322,33.98591371657564
2005-12-12T09:30:00-05:00,31.64999,31.7,31.37,31.46001,1050700,884740,59.92622323016802,68.30397387798608,NaN,NaN,34.66408677229912,38.84220345383684,-0.06510004749462328,0.3164264092701501,0.38152645676477337,29158859,27274939,63.30432241343647,80.68243551460775,NaN,NaN,29.4315173323206,33.335285661682065
2005-12-13T09:30:00-05:00,31.7,31.7,31.33,31.49001,2426700,996130,60.543638074292815,67.1772701119668,NaN,NaN,28.102736562371536,29.414727610567006,-0.06622928718403126,0.2987398477847343,0.36496913496876554,31585559,28186439,68.8071312208414,79.25123754615299,NaN,NaN,28.294982131041312,32.61524230016196
2005-12-14T09:30:00-05:00,31.53,31.86,31.53,31.75999,710900,989675,65.66975714077917,66.38724404392187,NaN,NaN,92.87229411164057,37.420420957461324,-0.04956308513099128,0.3030152785550264,0.3525783636860177,32296459,29390079,74.28987887154915,78.10211145556863,NaN,NaN,28.768071890263236,32.06564652731929
2005-12-15T09:30:00-05:00,31.89999,31.91,31.69,31.81,793100,985060,66.5370111661087,65.6514137909916,NaN,NaN,138.37145812815862,61.33427654476618,-0.03654172201337652,0.30690121116929703,0.34344293318267355,33089559,30847719,79.08445728937181,77.20741554625454,NaN,NaN,29.40862969087758,31.686072693541902
2005-12-16T09:30:00-05:00,31.84,31.84,31.62,31.67,380300,982745,61.82819353632506,65.01134781018551,NaN,NaN,87.02508520827554,76.20713215654912,-0.03853018302552136,0.29528020440077185,0.3338103874262932,32709259,31767939,81.4378800627489,76.44662442575002,NaN,NaN,28.593169215230063,31.244229339497355
2005-12-19T09:30:00-05:00,31.60001,31.61,31.27,31.36,521600,969500,52.90072113846757,63.66322864936876,NaN,NaN,-99.60422371945023,49.35347005819924,-0.0605834573695857,0.2580810657143111,0.3186645230838968,32187659,32373699,82.80914654148127,75.7602668291106,NaN,NaN,25.019184951465036,30.354937284064167
2005-12-20T09:30:00-05:00,31.36,31.48,31.32001,31.38,476300,938420,53.36853597830049,62.478146114061076,NaN,NaN,-110.2426037507226,21.684401995580416,-0.07285898789369344,0.22759078821678003,0.30044977611047347,32663959,32589379,83.28268449189312,75.18146685085627,NaN,NaN,22.293123599757163,29.203249614877453
2005-12-21T09:30:00-05:00,31.53,31.67,31.45,31.53999,447200,895345,57.04414750676013,61.21199836406213,NaN,NaN,-10.570066711121266,0.9959298310280484,-0.06926261929430189,0.21387150199259608,0.28313412128689797,33111159,32752319,83.649122849451,74.7133751126929,NaN,NaN,21.03413356955173,28.03623303697378
2005-12-22T09:30:00-05:00,31.69,31.82001,31.60001,31.78,794700,907100,61.89634404368572,60.59059664509148,NaN,NaN,92.40010143094138,-8.198341508415401,-0.05064202642033322,0.21983158826148141,0.27047361468181463,33905859,32915579,84.02692096979025,74.51598760543763,NaN,NaN,21.43827719441957,27.093667916608894
2005-12-23T09:30:00-05:00,31.8,31.89999,31.77,31.84,318600,903315,63.02089473495889,60.445300885005445,NaN,NaN,134.68925415238283,1.3344922804060502,-0.034953057327950066,0.22678229302187702,0.2617353503498271,34224459,33218619,84.73210543737272,74.84933847673392,NaN,NaN,22.108288994464097,26.381470927731066
2005-12-27T09:30:00-05:00,31.89,32.03,31.52,31.56,304500,841480,54.880884415294005,59.56704335665326,NaN,NaN,56.726225938160226,32.600582211928135,-0.043542355521574816,0.20730740594785857,0.2508497614694334,33919959,33565079,85.51923019812897,75.62641376573056,NaN,NaN,20.115095928159043,25.486274499220777
2005-12-28T09:30:00-05:00,31.5,31.67,31.45,31.61,534000,839980,55.974442636598255,59.2643879389014,NaN,NaN,-11.602551693943226,52.32859262328401,-0.04573946520163866,0.19367542996738507,0.23941489516902373,34453959,33923079,86.30490714835408,76.90558553820688,NaN,NaN,18.840369805241526,24.536859542938025
2005-12-29T09:30:00-05:00,31.64999,31.8,31.60001,31.60001,392500,844570,55.684045533944456,59.21470190751116,NaN,NaN,33.114380533974085,61.06548207230308,-0.04753907099777763,0.1799910564218017,0.22753012741957931,34061459,34113139,86.7169501540966,78.77860266904283,NaN,NaN,17.728665695530594,23.56426042187982
2005-12-30T09:30:00-05:00,31.39999,31.52,31.39,31.42,806400,858380,50.590850480285866,58.561834972569216,NaN,NaN,-77.93877494372462,26.99770679736988,-0.0597371187941709,0.1528587289268657,0.2125958477210366,33255059,33982979,84.83450812814955,80.62851755547608,NaN,NaN,15.235472024359664,22.374433507948368
2006-01-03T09:30:00-05:00,31.17,31.69,31.12,31.63,1256500,908780,55.683379467686805,58.258774703820556,NaN,NaN,-53.61989664335551,-10.664123361777786,-0.05278758672038447,0.146611364320556,0.19939895104094046,34511559,34040399,84.98931437292401,82.17744555258234,NaN,NaN,14.58940130480787,21.262286050356867
2006-01-04T09:30:00-05:00,31.75,31.78999,31.62,31.71001,3369000,947275,57.48147984025692,58.04004911567513,NaN,NaN,60.82559669875923,-9.844249209657987,-0.042376373020792224,0.14642848476495018,0.1888048577857424,37880559,34832519,86.96593898577544,83.47450325007763,NaN,NaN,14.593108735749563,20.309546433984394
2006-01-05T09:30:00-05:00,31.78999,31.78999,31.57001,31.66,386200,925135,55.95331437607727,57.346017489625005,NaN,NaN,45.35824017108476,1.5479091633476103,-0.03854220569150915,0.14062710067135598,0.17916930636286513,37494359,35440599,88.24555647501455,84.47133736461087,NaN,NaN,14.156435321624183,19.43053056079008
2006-01-06T09:30:00-05:00,31.89,31.89,31.63,31.78,458700,910580,58.784766848106585,56.79228575262484,NaN,NaN,84.0145394464699,11.727940945846768,-0.028093910486935714,0.1440519182541955,0.1721458287411312,37953059,36218919,89.64663960417619,85.22577895852547,NaN,NaN,14.602107763268899,18.74075587542991
2006-01-09T09:30:00-05:00,31.64999,32.05,31.62,32.03999,960100,934740,64.16028863259749,56.95886397378717,NaN,NaN,137.1234513285062,54.74038620029294,-0.005049858504047183,0.16583350561107224,0.17088336411511942,38913159,37350539,91.27501213933336,85.92843124971007,NaN,NaN,16.680541859968905,18.446439587506912
2006-01-10T09:30:00-05:00,31.8,31.97,31.8,31.95,760900,857445,61.18564660004714,57.5506443639,NaN,NaN,129.08908724524494,91.28218297801303,0.0023575661898042055,0.17383032185237468,0.17147275566257048,38152259,38078679,92.13246468892304,86.59438254595591,NaN,NaN,17.513319514373936,18.313136719916486
2006-01-11T09:30:00-05:00,31.91,32.02,31.86,31.97,592100,834515,61.61162594993922,58.139436504731336,NaN,NaN,137.81474006056362,106.6800116503739,0.006589877861128357,0.17971010298898094,0.17312022512785258,38744359,38251439,92.32518442929882,87.24027539862774,NaN,NaN,18.313090559393007,18.31313012555599
2006-01-12T09:30:00-05:00,31.99001,31.99001,31.69,31.73,1296900,778025,53.958760389780956,57.91905171066139,NaN,NaN,59.84397757054253,109.57715913026546,-0.007997386826513742,0.1631234915947104,0.17112087842122414,37447459,38242059,92.19313685747072,87.85056211348629,NaN,NaN,16.712193357911016,18.084424873035278
2006-01-13T09:30:00-05:00,31.41,31.71001,31.41,31.62,903100,787635,50.841683850243506,57.129433125415524,NaN,NaN,-49.77726359232965,82.81879852250555,-0.02530118490235811,0.1394943972932765,0.16479558219563462,36544359,37960319,88.11653765571215,88.14267759105213,NaN,NaN,14.419909186258876,17.56092263206722
2006-01-17T09:30:00-05:00,31.87,31.87,31.36,31.46001,886200,792290,46.62305724240589,55.95815901880459,NaN,NaN,-52.01899937956472,44.990308380891356,-0.04653313828557443,0.10662915933866657,0.153162297624241,35658159,37309319,79.38202355619137,87.76052888525348,NaN,NaN,11.142833280883014,16.64405272475519
2006-01-18T09:30:00-05:00,31.23,31.5499,31.23,31.5,928400,819695,47.78920798248537,55.45161070217541,NaN,NaN,-104.10386462789566,-1.6482819937367652,-0.05624585438885049,0.0828549796381779,0.13910083402702839,36586559,36996179,75.50499286516404,87.04522621861314,NaN,NaN,8.80766845678238,15.524569257901932
2006-01-19T09:30:00-05:00,31.64,31.7,31.44,31.64999,1295100,858370,52.023001340109545,55.16936489528336,NaN,NaN,-32.71494419514261,-35.75421884487802,-0.05108124040267695,0.07524928352368221,0.12633052392635916,37881659,36823639,73.37841480596192,86.12190533701369,NaN,NaN,8.034688075397757,14.454586231829907
2006-01-20T09:30:00-05:00,31.53,31.60001,30.89999,30.96001,2775400,973325,37.11357223488301,53.84290251677896,NaN,NaN,-223.16349673874964,-92.35571370673645,-0.09035104033486026,0.013391723507783837,0.1037427638426441,35106259,36355399,67.7977689747737,84.77053525277634,NaN,NaN,1.6633300761077312,12.627263923869597
2006-01-23T09:30:00-05:00,31,31.11,30.95,30.98,1260300,1013980,37.6709086006048,52.92004952537318,NaN,NaN,-228.23949112180762,-128.04815921263204,-0.10989832719302323,-0.03363014514863494,0.07626818204438829,36366559,36319839,67.37867009954137,83.52368967930433,NaN,NaN,-2.936627316836173,10.403850889483058
2006-01-24T09:30:00-05:00,31.12,31.3,31.07001,31.21001,1639900,1056240,43.83852773681874,52.073988687454026,NaN,NaN,-138.41419403085365,-145.32719814288984,-0.10240575759469625,-0.05173901494898203,0.05066674264571422,38006459,36789499,70.0150663737278,82.4541005365046,NaN,NaN,-4.66450311434732,8.251228888935861
2006-01-25T09:30:00-05:00,31.39,31.39,31.11,31.2,883900,1084505,43.6361581239261,51.08503713628754,NaN,NaN,-109.61353104547534,-146.42913142640577,-0.09344201493113988,-0.06613577601821063,0.027306238912929246,37122559,36896699,70.59913651835416,81.28504321740307,NaN,NaN,-6.06209339700761,6.206468562372509
2006-01-26T09:30:00-05:00,31.21001,31.55,31.21001,31.55,822500,1110405,51.98268608640686,50.80142082988251,NaN,NaN,-38.05961393494324,-147.4980653743659,-0.060838093289562405,-0.04874137769902376,0.012096715590538645,37945059,36909379,70.67190694024319,80.02978253634797,NaN,NaN,-4.455659872032527,4.683307357457504
2006-01-27T09:30:00-05:00,31.67999,31.67999,31.42999,31.62,578500,1112630,53.466851750520924,50.42156975148354,NaN,NaN,7.480161699205102,-101.36933368677495,-0.03285640044686686,-0.028973784968044924,0.0038826154788219307,38523559,37592839,74.35621151547419,78.93760910144069,NaN,NaN,-2.699413345969671,3.6286329712536216
2006-01-30T09:30:00-05:00,31.50999,31.69,31.44,31.69,1174500,1151730,54.96588355715761,49.76482653180926,NaN,NaN,18.433466665941776,-52.03474212922507,-0.009163791261445441,-0.00757212359798487,0.0015916676634605705,39698059,38259139,77.34428252731898,77.94255698629681,NaN,NaN,-0.8127575191291083,2.99414861548466
2006-01-31T09:30:00-05:00,31.60001,31.7,31.48,31.50999,749200,1148870,50.463818213502954,48.998981647056105,NaN,NaN,2.266881087241796,-23.898527105605993,-0.005335670339851129,-0.005077920261353341,0.00025775007849778786,38948859,38447619,78.12091928563223,76.94173231463317,NaN,NaN,-0.5984392689942302,2.480921774844819
2006-02-01T09:30:00-05:00,31.41,31.84,31.41,31.78,1824600,1177275,56.25202968584372,48.61615334247786,NaN,NaN,37.689863955470344,5.562151894583155,0.014572483895911618,0.01847335494838731,0.0039008710524756924,40773459,39177799,80.85849172911755,76.12268283604878,NaN,NaN,1.4812435816337766,2.3381106043860984
2006-02-02T09:30:00-05:00,31.62,31.85001,31.42,31.50999,979100,1057780,49.96465377271989,48.33086001268778,NaN,NaN,11.354106186671899,15.44489591890618,0.009019644695957061,0.01517542692242202,0.006155782226464958,39794359,39547659,82.08150243206507,75.40042323423408,NaN,NaN,1.1846836413070134,2.173335323946229
2006-02-03T09:30:00-05:00,31.47,31.60001,31.36,31.44,766900,1076815,48.452863636853145,48.16022999744562,NaN,NaN,-28.953791269349715,8.158105325195217,0.0005436886004557256,0.006835392977034616,0.00629170437657889,39027459,39648439,82.41127172569291,74.99290423923271,NaN,NaN,0.4681298032170623,1.9297345352706339
2006-02-06T09:30:00-05:00,31.39,31.56,31.38,31.55,543800,1081070,50.96408107411351,48.47030312828188,NaN,NaN,-14.332625802366566,1.6048868315335436,0.002165205223636589,0.008998210906124626,0.006833005682488037,39571259,39623079,82.00229910977347,75.18006677877429,NaN,NaN,0.6579106897191064,1.7480454144775586
2006-02-07T09:30:00-05:00,31.53999,31.61,31.28,31.32001,649500,1065540,45.92626974761691,48.33723611150556,NaN,NaN,-40.5910141310059,-6.966692212115996,-0.011671682916531551,-0.007756597963176404,0.003915084953355148,38921759,39617659,81.90874290522241,75.6374774959213,NaN,NaN,-0.7731226896806522,1.3878785424549571
2006-02-08T09:30:00-05:00,31.33,31.53,31.25,31.47,968100,1075900,49.436630445577485,48.152495333324694,NaN,NaN,-28.720627955226565,-20.248790594255375,-0.01019620911887921,-0.008830176445243865,0.001366032673635346,39889859,39440939,78.7538162069027,76.02143473884564,NaN,NaN,-0.8663498855573363,1.0658459098817723
2006-02-09T09:30:00-05:00,31.42999,31.78999,31.42999,31.64999,501600,1071375,53.350307232751625,49.31226211888674,NaN,NaN,67.75369675722413,-8.96887248014492,0.0027371788546716284,0.0047875062419748815,0.002050327387303253,40391459,39560359,79.33312467844883,76.84538871767958,NaN,NaN,0.28885315521798344,0.9548469449298025
2006-02-10T09:30:00-05:00,31.89999,31.96001,31.58,31.86,961900,1054625,57.48520971129798,50.72756934107911,NaN,NaN,146.64781518653012,26.15144881103105,0.024083743571525238,0.0321550068517098,0.008071263280184562,41353359,40025539,81.45440633463008,77.85079844875735,NaN,NaN,2.599820481893562,1.1898431644960539
2006-02-13T09:30:00-05:00,31.83,31.96001,31.58,31.89999,387800,1028860,58.24418830350002,51.75654509584206,NaN,NaN,137.72103335979378,56.56218064346312,0.03867933135926045,0.05642042747926013,0.017741096119999675,41741159,40459519,83.18810476655334,78.7917297625306,NaN,NaN,4.68387408817879,1.6889904393078732
2006-02-14T09:30:00-05:00,31.92999,32.33,31.78,32.28,664500,1017775,64.69424199452837,53.26069394374222,NaN,NaN,220.6783493969132,108.81605334904694,0.06988953679717322,0.10510301711646619,0.03521348031929298,42405659,41156299,85.52742310917162,79.85803594758899,NaN,NaN,8.72940389983006,2.6947637908110424
2006-02-15T09:30:00-05:00,32.2,32.38,32.13,32.37,772700,1009990,66.03250682156663,54.264252567682206,NaN,NaN,226.44608346329235,159.8493956327507,0.09121031908278743,0.14922637917277726,0.058016060089989836,43178359,41813999,87.32083539299549,81.04724512278558,NaN,NaN,12.421438837913584,4.084288797539977
2006-02-16T09:30:00-05:00,32.52,32.52,32.25,32.46001,657800,978125,67.36484696335698,55.25696651145621,NaN,NaN,209.51282406563,188.2012210944319,0.10500768329767166,0.18927566421207942,0.08426798091440776,43836159,42502939,88.87586533065587,82.0843632524414,NaN,NaN,15.856548426455912,5.766040173099396
2006-02-17T09:30:00-05:00,32.45,32.59,32.35001,32.53999,923400,885525,68.54546707770285,56.22693676292373,NaN,NaN,185.81395478350578,196.03444901382704,0.11248680926824213,0.22487649249971042,0.1123896832314683,44759559,43184179,90.16087923910649,82.99983444614051,NaN,NaN,19.046603434055204,7.663263496093083
2006-02-21T09:30:00-05:00,32.60001,32.60989,32.32001,32.41,1011100,873065,64.46365790626712,57.22692531240688,NaN,NaN,146.2056212760927,197.73136659708683,0.10195754270599325,0.23983661161395986,0.1378790689079666,43748459,43585639,90.83292550803473,83.90783489059784,NaN,NaN,20.565444440971888,9.50643220250434
2006-02-22T09:30:00-05:00,32.55,32.78,32.55,32.75,1452400,863690,69.56818455237172,58.178079231444585,NaN,NaN,162.95315823240117,186.18632836418442,0.11045420809063605,0.27594682902126166,0.1654926209306256,45200859,44144679,91.68466702058376,84.68113312570256,NaN,NaN,23.578030953077096,11.516660595443305
2006-02-23T09:30:00-05:00,32.66,32.8,32.60001,32.64,521800,845585,66.2524253316983,59.34149148565733,NaN,NaN,133.84839795440865,167.66679126240768,0.10146085358572274,0.29231868791277904,0.1908578343270563,44679059,44444819,92.10859961698755,85.39735435319702,NaN,NaN,25.036410636062477,13.448053458388902
2006-02-24T09:30:00-05:00,32.58,32.75999,32.48,32.66,581400,833530,66.56445985963222,60.63517693014155,NaN,NaN,108.54246803423253,147.47272005612817,0.0900415864435376,0.3034098173814783,0.21336823093794072,45260459,44729679,92.49944316539766,86.11793802746165,NaN,NaN,26.300846559361048,15.28416675852778
2006-02-27T09:30:00-05:00,32.95,32.97,32.56,32.87,1078600,858535,69.72933136812269,61.97555195114221,NaN,NaN,116.61614650444007,133.63315840031504,0.08962055424740717,0.32539392374719966,0.2357733694997925,46339059,45045579,92.91832151501781,86.89765391355054,NaN,NaN,28.363170589876034,17.152595877291816
2006-02-28T09:30:00-05:00,32.89,32.89,32.42999,32.49001,626700,831145,58.870501455360866,62.900139930266775,NaN,NaN,78.81432553813588,120.15489925272368,0.058259027000397645,0.3085971532502896,0.25033812624989193,45712359,45438359,93.41103667083473,87.71924632538,NaN,NaN,26.714903790250748,18.518639864857377
2006-03-01T09:30:00-05:00,32.64999,32.75,32.55,32.75,526200,819995,63.10414481615071,63.876390956736294,NaN,NaN,81.97174944669133,103.9586174955817,0.04985786433615658,0.3126604566700877,0.2628025923339311,46238559,45645899,93.66196599156382,88.7841141671415,NaN,NaN,26.702382459627135,19.687745949824485
2006-03-02T09:30:00-05:00,32.66,32.69,32.21001,32.66,676600,762595,60.77210643134635,64.40651947092162,NaN,NaN,53.546400940927846,87.89821809288557,0.03383903588775955,0.30510138719363056,0.271262351305871,45561959,45822479,93.87567219653256,89.82286756129032,NaN,NaN,25.945713505453444,20.581741314914336
2006-03-03T09:30:00-05:00,32.52,33,32.44,32.74001,860200,756650,62.11258307239489,64.7370461395714,NaN,NaN,76.9808405228293,81.58589259060489,0.024657850579609897,0.3020846645303834,0.2774268139507735,46422159,46054819,94.154938666552,90.7300484421419,NaN,NaN,25.73930255276841,21.318535777464916
2006-03-06T09:30:00-05:00,32.94,33.03999,32.44,32.57001,703600,753485,57.608175139052946,64.69161662782518,NaN,NaN,66.1762899945462,71.49792128862609,0.004232406069350325,0.28271732153746143,0.2784849154681111,45718559,45930719,91.74840808597173,91.3414986792432,NaN,NaN,24.17537972967779,21.726656342066754
2006-03-07T09:30:00-05:00,32.47,32.67999,32.42999,32.59,2502700,851430,57.9939364467994,64.21302337441598,NaN,NaN,43.47618973878035,64.430294128755,-0.010054915279453014,0.2659162713687948,0.2759711866482478,48221259,46432499,92.57479422265841,91.84488233020656,NaN,NaN,23.02613561769323,21.912296238584823
2006-03-08T09:30:00-05:00,32.53999,32.59,32.25,32.55,1115200,874715,56.878571190984054,63.55917082937436,NaN,NaN,18.80347061443078,51.796638362302886,-0.023551519418684996,0.24653178737489156,0.27008330679357656,47106059,46605999,92.84174030213977,92.23923268085971,NaN,NaN,21.7620110815782,21.89082693044102
2006-03-09T09:30:00-05:00,32.67,32.96001,32.48,32.50999,1567300,904675,55.724131954374045,62.72769118587558,NaN,NaN,56.16766577431198,52.3208913289797,-0.03579196253853334,0.22534335362040991,0.26113531615894325,45538759,46601359,92.7457091666272,92.51565009771481,NaN,NaN,20.388708338313528,21.67623856013709
2006-03-10T09:30:00-05:00,32.64,32.87,32.46001,32.85001,1152600,937225,62.66022206346076,62.307316542001146,NaN,NaN,75.61964544141328,52.048652312696504,-0.02226920010937289,0.23329881602222713,0.2555680161316,46691359,46655199,92.83827657203251,92.70689276435239,NaN,NaN,21.141955573476245,21.59991241918554
2006-03-13T09:30:00-05:00,32.95,32.97,32.75,32.83,582900,918275,62.04422826758559,62.13450013923818,NaN,NaN,115.07123507736436,61.82764132926013,-0.016232962602801604,0.23527681287809799,0.2515097754808996,46108459,46733179,92.9780370965136,92.8601150206723,NaN,NaN,21.57932789036977,21.59697177221186
2006-03-14T09:30:00-05:00,32.8,33.24001,32.8,33.14,711900,934480,67.39237024662455,61.97908483168481,NaN,NaN,198.70125260043537,92.87265390159114,0.005891902017707118,0.2588746530030335,0.25298275098532635,46820359,46452999,86.45016849590726,92.4862222689097,NaN,NaN,23.631309536800465,21.887591452867373
2006-03-15T09:30:00-05:00,33.25,33.66,33.23,33.64,1200800,961295,73.8038178502379,62.5184700115805,NaN,NaN,334.12838727910486,155.93763723452597,0.04905291175056614,0.314298890673534,0.26524597892296786,48021159,46636019,87.08789460299369,92.12760048219585,NaN,NaN,27.826538130302662,22.7360124067867
2006-03-16T09:30:00-05:00,33.85001,33.86,33.64999,33.66,1058400,975580,74.02383502059863,63.05128252307809,NaN,NaN,294.4367378315091,203.59145164596538,0.0723921181108621,0.3557361265615455,0.2833440084506834,49079559,47344179,89.2049918233925,91.89228252919547,NaN,NaN,31.137418705886898,23.936213306658157
2006-03-17T09:30:00-05:00,33.73,33.84,33.67,33.78999,1050100,995195,75.46611485901636,63.46105277242764,NaN,NaN,223.62991447093546,233.1935054518698,0.08893823092847686,0.3945167971112795,0.30557856618280266,50129659,48031839,90.78502111428062,91.7399039291428,NaN,NaN,34.325053363268445,25.420333314745342
2006-03-20T09:30:00-05:00,33.99001,34.10001,33.71001,33.73,928800,995465,73.43956090007886,64.50169987562178,NaN,NaN,183.89810476116853,246.95887938863066,0.08803240175186022,0.41561906837262796,0.32758666662076774,49200859,48650319,91.92920322882003,91.63405868328461,NaN,NaN,36.29813850848517,26.974305485279604
2006-03-21T09:30:00-05:00,33.81,33.95,33.56,33.60001,1701800,1030000,69.10888361425468,64.93060978977206,NaN,NaN,128.3008685089851,232.8788025703406,0.07156763837784857,0.41704621459307845,0.34547857621522987,47499059,48786059,92.15930617199483,91.52672583902968,NaN,NaN,36.667724599780655,28.35907964449404
2006-03-22T09:30:00-05:00,33.64,33.92,33.52,33.85001,613500,988055,72.47112550428625,65.76625400926777,NaN,NaN,116.29465225522802,189.31205556556523,0.07030090352792395,0.4333547056251348,0.36305380209721083,48112559,48804339,92.19159269303604,91.40643444592277,NaN,NaN,38.03435059395986,29.741261208703445
2006-03-23T09:30:00-05:00,33.82001,33.84,33.57001,33.71001,488100,986370,68.00714195866095,66.18729392971534,NaN,NaN,93.53127263707516,149.13096252667842,0.0535772839877281,0.430025407081871,0.3764481230941429,47624459,48513319,86.11216637416267,90.83195071075211,NaN,NaN,37.803058179097754,30.892946490188347
2006-03-24T09:30:00-05:00,33.67999,33.83,33.61,33.67999,1006000,1007600,67.05336788994094,66.86195055477877,NaN,NaN,82.08622342596746,120.82222431768484,0.03493882154294842,0.4201216500228284,0.38518282847988,46618459,47811079,73.51446045225094,89.52952587977204,NaN,NaN,37.335625815177735,31.813329250901116
2006-03-27T09:30:00-05:00,33.71001,33.74001,33.58,33.71001,483900,977865,67.54357138150678,67.5440673358293,NaN,NaN,69.50748484656978,97.9441003347651,0.019829211556115,0.40996934292502374,0.39014013136890874,47102359,47391379,67.18805384031589,87.7161872810333,NaN,NaN,37.08721058605274,32.56674087020849
2006-03-28T09:30:00-05:00,33.71001,33.82001,33.45,33.47,944800,993770,59.87343821227309,67.75798640877852,NaN,NaN,50.97278307304097,82.47848324757629,-0.009554389897209192,0.37819714399739723,0.3877515338946064,46157559,47123079,63.430143548665,85.61535894149938,NaN,NaN,34.58353197589306,32.854853885306284
2006-03-29T09:30:00-05:00,33.57001,33.86,33.57001,33.81,1002900,1017605,65.79856299663435,68.47758862608282,NaN,NaN,66.47321179702227,72.51419515593513,-0.009307656148159482,0.37611696370940706,0.38542461985756654,47160459,46932659,60.82970480831157,83.33564434447683,NaN,NaN,34.148022432476075,33.039592249187685
2006-03-30T09:30:00-05:00,33.78,33.97,33.66,33.81,1178300,1042690,65.79856299663435,68.70175583559522,NaN,NaN,69.69203510833721,67.74634765018754,-0.012178928186989402,0.3702009596238298,0.3823798878108192,47160459,46839859,59.54843271405468,80.95779835462129,NaN,NaN,33.80403858782332,33.14879886899278
2006-03-31T09:30:00-05:00,33.78999,33.94,33.78,33.8,292500,1014305,65.46880871737201,68.94636872486568,NaN,NaN,68.47211543368944,65.02352605173195,-0.017464407420304695,0.36054937853543834,0.37801378595574303,46867959,46889759,60.03588610876745,78.60478756978227,NaN,NaN,33.43150247497226,33.18918509841842
2006-04-03T09:30:00-04:00,34.00999,34.2,33.84,33.92,1188900,1038570,67.56918826035317,68.95899858298915,NaN,NaN,85.84572568851223,68.29117422012044,-0.015649890183430215,0.3584514232264553,0.3741013134098855,48056859,47080659,61.92611752701133,76.85306964343256,NaN,NaN,33.702538856671666,33.262521349597456
2006-04-04T09:30:00-04:00,33.81,34.17,33.8,34.14999,334200,930145,71.18656428438084,68.77205189971365,NaN,NaN,93.57880696344236,76.81237899820073,-0.0024253785920431703,0.37106959016983154,0.3734949687618747,48391059,47527359,65.98085625577949,75.34542404720297,NaN,NaN,35.02427065817693,33.51419982225167
2006-04-05T09:30:00-04:00,34.3,34.48,33.96001,34.17,801800,914475,71.4845794982457,68.59067650525986,NaN,NaN,127.00117641040988,88.91797192087824,0.0038625405423150516,0.37832314443976856,0.3744606038974535,49192859,47933839,69.19566714400625,73.91618657010395,NaN,NaN,36.18669748739894,33.89598520298699
2006-04-06T09:30:00-04:00,34.23,34.25,34,34.12,1090200,890620,69.54886616169163,68.16801588402238,NaN,NaN,115.83843790784131,98.14725248077906,0.000996436642344889,0.37570614970038463,0.37470971305803974,48102659,48122279,70.58351368096763,72.47322175343872,NaN,NaN,36.62827864755107,34.28631283792472
2006-04-07T09:30:00-04:00,34.11,34.34,33.83,33.95,1085700,887275,63.27514220707829,67.44198597737949,NaN,NaN,97.39238970208613,103.9313073344584,-0.01511737638899241,0.3558129925717992,0.3709303689607916,47016959,48152079,70.80750372948873,70.96452893205792,NaN,NaN,35.22890257244142,34.42096851428425
2006-04-10T09:30:00-04:00,33.91,33.97,33.78999,33.83,401600,878210,59.21462510820151,66.73525322694712,NaN,NaN,30.8686365206329,92.93588950088252,-0.03546454539757027,0.3265996872138288,0.3620642326113991,46615359,47863779,65.60305146625717,69.0676535959338,NaN,NaN,32.84689439932343,34.19610078357556
2006-04-11T09:30:00-04:00,33.96001,33.96001,33.62,33.77,1090600,897145,57.23684243143799,65.6470901503151,NaN,NaN,-18.355813619146065,70.54896538436485,-0.05348857699566195,0.29520351136682166,0.3486920883624836,45524759,47290519,56.68170632237658,66.5312331408867,NaN,NaN,30.28414330070103,33.63724971459348
2006-04-12T09:30:00-04:00,33.89,34.02,33.81,34,632500,868730,62.41867044043793,65.24791361329918,NaN,NaN,51.38000805384596,55.42473171305206,-0.05048262775810619,0.28558880366485084,0.33607143142295703,46157259,46683399,49.07079019273069,63.885420556498694,NaN,NaN,29.468670018522218,33.04173832944044
2006-04-13T09:30:00-04:00,33.89,34.03,33.75,33.86,649200,848270,57.82545152734907,64.5887767302569,NaN,NaN,15.341172680206911,35.32527866752518,-0.05795054626961943,0.26363324858593273,0.32158379485555216,45508059,46164479,43.67298230940391,61.75388640343819,NaN,NaN,27.385458073260182,32.233698292843265
2006-04-17T09:30:00-04:00,33.92,33.97,33.56,33.69009,841400,837835,52.751854712800984,63.53222553963506,NaN,NaN,-56.69536195188522,4.507728336730898,-0.07336850685284424,0.22987316128949686,0.3032416681423411,44666659,45694419,39.440683039978204,59.771931346271224,NaN,NaN,24.01528203827663,31.059638827905175
2006-04-18T09:30:00-04:00,33.88,34.53999,33.76801,34.5,914900,837140,67.42408296009577,64.07155730733669,NaN,NaN,174.68231139259493,33.2704633111233,-0.03026411978809146,0.26541151840722677,0.2956756381953182,45581559,45487659,37.7096173226098,57.93475090155299,NaN,NaN,26.101502889251215,30.351333693811753
2006-04-19T09:30:00-04:00,34.41,34.78999,34.41,34.72,618300,782965,70.13687879082403,64.38143700692167,NaN,NaN,252.56960513391377,87.45554706173526,0.009683637807695655,0.3077801854549378,0.29809654764724214,46199859,45622679,39.5747254889065,56.416538093024045,NaN,NaN,28.77382580830804,30.12597542445408
2006-04-20T09:30:00-04:00,34.82001,34.95,34.64999,34.85001,862000,795390,71.63990614186415,64.7986758030095,NaN,NaN,239.22282003747742,125.02410945846154,0.0397937312063833,0.3478387116552213,0.308044980448838,47061859,45803599,42.07739923218079,55.16860713003306,NaN,NaN,31.380781242262163,30.30523339842666
2006-04-21T09:30:00-04:00,34.95,35.12,34.62,34.89,1363100,839140,72.10497553876833,65.27268771882353,NaN,NaN,203.28915144129218,162.6137052106786,0.0563237823633041,0.3784497084029681,0.322125926039664,48424959,46386979,49.360622213498985,54.40608828037102,NaN,NaN,33.53530588008446,30.766672324377776
2006-04-24T09:30:00-04:00,34.85001,35.00999,34.84,35.00999,431500,810415,73.50873018639521,65.69694071354083,NaN,NaN,177.08903830091427,209.37058526123852,0.06845263334823548,0.4076917177249584,0.3392390843767229,48856459,47224939,57.60641047155125,54.09753777640959,NaN,NaN,35.73751494224537,31.47679269835886
2006-04-25T09:30:00-04:00,35.05,35.05,34.48,34.60001,2203900,896415,62.0238720117899,65.04246269407005,NaN,NaN,108.97206809335141,196.2285366013898,0.04320961822877978,0.3932511071626976,0.35004148893391784,46652559,47439139,59.42519447703285,53.62927622078483,NaN,NaN,33.73265906896774,31.79905932273156
2006-04-26T09:30:00-04:00,34.57001,34.86,34.56,34.78999,859200,892135,64.77063640735443,64.56289533043496,NaN,NaN,99.22754063113823,165.5601237008347,0.034055484136820635,0.3926108441049436,0.358555359968123,47511759,47701519,61.59852029674605,53.08662287455196,NaN,NaN,33.033498116713425,31.975407721871825
2006-04-27T09:30:00-04:00,34.50999,34.88,34.41,34.60001,1407300,912355,60.09007291089692,63.88726724109248,NaN,NaN,69.90194322198715,131.69594833773664,0.011139644933836346,0.3724799161354184,0.3613402712015821,46104459,47510039,59.11018947725044,52.267099717143594,NaN,NaN,30.887582913301486,31.82000417779035
2006-04-28T09:30:00-04:00,34.5,34.75,34.5,34.53,2827300,994805,58.4148218140452,63.540101498732966,NaN,NaN,55.999357354338045,102.23798952034579,-0.011569662642470557,0.34687819289849386,0.3584478555409644,43277159,46480479,47.90474062353169,50.63118806671809,NaN,NaN,28.64945330238506,31.367068338446735
2006-05-01T09:30:00-04:00,34.45,34.81,34.45,34.62,708000,1015580,59.96020485500518,63.59335719493323,NaN,NaN,55.07629199855773,77.83544025987447,-0.022721226778928516,0.3300463220673038,0.3527675488462323,43985159,45506219,40.14860700745675,48.813013462518065,NaN,NaN,27.298227843816527,30.78580541064242
2006-05-02T09:30:00-04:00,34.87,34.92999,34.64,34.89999,370000,974635,64.39336302335249,64.10453723721284,NaN,NaN,81.3217166839333,72.30536997799084,-0.013867533598290849,0.33543313184836876,0.3493006654466596,44355159,45046739,37.0979516708442,47.414173844551456,NaN,NaN,27.517827769276803,30.318951461875905
2006-05-03T09:30:00-04:00,34.94,35,34.85001,34.91,478700,981860,64.54450363996051,64.25638246575018,NaN,NaN,88.97214998206479,70.25429184817615,-0.010136943887406324,0.3366294855874017,0.346766429474808,44833859,44511159,33.86760202589447,46.328231832634586,NaN,NaN,27.73712700745086,29.95011939695804
2006-05-04T09:30:00-04:00,34.99001,35.39999,34.99001,35.33,731800,978360,70.25048136753955,65.14388459719235,NaN,NaN,128.60244443941568,81.99439209166185,0.016374728276699335,0.36723483982068217,0.35086011154398283,45565659,44403399,33.240433585861695,45.583049780953,NaN,NaN,29.806983626625744,29.929671429767712
2006-05-05T09:30:00-04:00,35.64,35.73,35.50999,35.67999,2844500,1066075,74.00479671785368,66.66195188326755,NaN,NaN,173.75207909851954,105.54493644049815,0.05127015995439954,0.41494781148698223,0.3636776515325827,48410159,45429999,43.89899826133623,45.90150086819286,NaN,NaN,32.89981222399342,30.35397725751424
2006-05-08T09:30:00-04:00,35.52,36.02,35.52,35.64999,1278700,1075725,73.15261742223022,67.07113291627715,NaN,NaN,173.05879579270885,129.14143719932835,0.06522416434479006,0.44520785696357024,0.3799836926187802,47131459,46059259,49.247768124815806,46.725654496921855,NaN,NaN,35.040855295948944,31.023531263004912
2006-05-09T09:30:00-04:00,35.89,35.89,35.59,35.64999,1496600,1130475,73.15261742223022,67.28654281852046,NaN,NaN,154.00434860803693,143.6779635841491,0.06708686669681974,0.4638422759898049,0.39675540929298514,47131459,46614519,53.46398937094649,47.71774477421043,NaN,NaN,36.73426422413,31.839350257451354
2006-05-10T09:30:00-04:00,35.63,35.83,35.57001,35.67,700300,1110960,73.38965479103733,67.41152486488997,NaN,NaN,136.1874360722163,153.1210208021794,0.0623974161568987,0.47475217948910853,0.41235476333220983,47831759,47214099,57.56359658446978,48.82390172794536,NaN,NaN,38.18073428063127,32.74526226076277
2006-05-11T09:30:00-04:00,35.64999,35.67,35.37,35.49001,1764800,1167575,67.6074263992779,67.09027135492636,NaN,NaN,96.64488702608114,146.7295093195125,0.04094128277019471,0.4635313667949532,0.4225900840247585,46066959,47314359,58.226303122998544,49.45716465005246,NaN,NaN,37.7912550261753,33.46611837010742
2006-05-12T09:30:00-04:00,35.3,35.33,34.89999,34.92999,1244200,1197325,53.48698279507083,65.66014654126033,NaN,NaN,18.144856266690574,115.60806475314669,-0.014245056879164664,0.40478376292580265,0.4190288198049673,44822759,46596879,51.97148616729806,49.05467005689152,NaN,NaN,32.70284755805466,33.357079682671305
2006-05-15T09:30:00-04:00,34.73,34.98,34.62,34.94,958000,1203155,53.67323487691312,65.06367246019771,NaN,NaN,-28.80117906343095,75.23606978191873,-0.0512694269636621,0.35494203610038966,0.40621146306405176,45780759,46326739,49.80224380368138,48.36731643736641,NaN,NaN,28.78371710890115,32.70374217213271
2006-05-16T09:30:00-04:00,35.11,35.27,34.89,34.92999,582200,1186520,53.44277236761579,64.25453931450208,NaN,NaN,-1.7841070297397656,44.07837865436339,-0.07613012395586188,0.3110488081192244,0.3871789320750863,45198559,45940159,46.792338313041284,47.30973200995893,NaN,NaN,25.57758000734764,31.685719005734846
2006-05-17T09:30:00-04:00,34.77,34.8,34.10001,34.21001,3193600,1315285,40.10433686142326,62.826986739539684,NaN,NaN,-128.47044900805903,-8.853198361691607,-0.13719873831522472,0.2156805091810554,0.35287924749628014,42004959,44774799,39.11733432377074,45.88167092756753,NaN,NaN,17.582561883754874,29.670982274023423
2006-05-18T09:30:00-04:00,34.35001,34.35001,33.82001,33.92999,2104200,1377395,36.30873750480755,61.247980717451284,NaN,NaN,-171.03432793339326,-62.38904135358648,-0.18937053309029256,0.11616608113341442,0.305536614223707,39900759,43541559,32.956767790267094,44.81395858233434,NaN,NaN,9.628271497074973,26.8077378773165
2006-05-19T09:30:00-04:00,33.97,34.17,33.75,34.03999,2165600,1417520,38.76066600096769,59.73372794216289,NaN,NaN,-155.983046892185,-97.2146219853616,-0.20790926302524498,0.04565003544215074,0.2535592984673957,42066359,42990279,30.634205653850074,44.13435848564814,NaN,NaN,4.1736617410833015,23.57429842928319
2006-05-22T09:30:00-04:00,33.78999,34.11,33.66,33.97,1971200,1494505,37.76448221315291,57.83166502714864,NaN,NaN,-144.11908523304325,-120.27820321928407,-0.21540828268656037,-0.015701054890804755,0.19970722779575562,40095159,41853159,26.487671425844624,43.37648132529103,NaN,NaN,-0.47385644897722573,20.138847732388843
2006-05-23T09:30:00-04:00,34.22,34.24001,33.78,33.81,1617500,1465185,35.51720964630445,55.75828688474464,NaN,NaN,-124.51972251138653,-144.8253263156134,-0.22084798369226627,-0.07635275181957724,0.14449523187268903,38477659,40508979,22.59439559270315,42.57125229434879,NaN,NaN,-5.04254522905537,16.541505880753956
2006-05-24T09:30:00-04:00,33.89999,33.89999,33.35001,33.72,1713300,1507890,34.28143736727388,53.189069456154236,NaN,NaN,-140.2347884295193,-147.17819419990548,-0.21974119184984597,-0.13018125793961843,0.08955993391022754,36764359,39460859,20.112030910910093,41.63350924613797,NaN,NaN,-9.157490551898908,12.87022067608926
2006-05-25T09:30:00-04:00,33.98,33.98,33.72,33.95,1310900,1503070,40.024499331794004,50.76190535714998,NaN,NaN,-100.19066809300223,-133.00946223182726,-0.1936667179271785,-0.15252346349874557,0.04114325442843292,38075259,39095759,19.315933757855504,39.87757606731792,NaN,NaN,-10.968263810380728,9.464722892307835
2006-05-26T09:30:00-04:00,34.14,34.17,33.96001,34.14,1207400,1422075,44.35087506375323,48.70463804583019,NaN,NaN,-70.3561158060681,-115.88407601460388,-0.15542115251784522,-0.15313318621887362,0.002287966298971607,39282659,38539019,18.13697076881803,37.65537625617522,NaN,NaN,-11.176667272992418,6.515952868693514
2006-05-30T09:30:00-04:00,34.16,34.16,33.67,33.7,3879600,1580655,37.58863392877689,46.164353510583524,NaN,NaN,-86.87103178314669,-104.43446532462458,-0.15140277045452363,-0.18696549676918295,-0.03556272631465931,35403059,37600599,16.32794217581808,35.00280145652319,NaN,NaN,-13.579282978327608,3.6452048905476397
2006-05-31T09:30:00-04:00,33.7,34,33.7,33.94,1454600,1634885,42.71893435333441,43.97358776503331,NaN,NaN,-74.4131191733181,-94.41314465701087,-0.1253068851140649,-0.19219633270724046,-0.06688944759317554,36857659,37276599,15.74405399115669,32.01569127128654,NaN,NaN,-13.886880142547012,1.140621314391261
2006-06-01T09:30:00-04:00,33.86,34.33,33.86,34.28999,1210600,1671480,49.26814459670736,42.663639064849704,NaN,NaN,-43.17963100495942,-75.00211317209889,-0.07943633328130849,-0.16618486419481115,-0.08674853091350267,38068259,37537379,18.277172859889944,29.162181966778785,NaN,NaN,-11.912515277905017,-0.7241124845082072
2006-06-02T09:30:00-04:00,34.34,34.5,34.14,34.34,2147000,1742240,50.145286721601835,42.42494648817335,NaN,NaN,-23.72888628474611,-59.70975681044767,-0.04253898503485008,-0.13992226220706527,-0.09738327717221519,40215259,37965379,22.40068312686104,27.049981749604715,NaN,NaN,-10.083053795875156,-2.0611041004177713
2006-06-05T09:30:00-04:00,34.34,34.34,33.55,33.60001,916000,1645815,39.31380284290123,41.3992727714582,NaN,NaN,-68.73233963767639,-59.385001576769334,-0.06351908638581384,-0.1767821351544825,-0.11326304876866865,39299259,37968699,22.433377843319334,25.095062752436,NaN,NaN,-12.232910442631763,-3.514219292162627
2006-06-06T09:30:00-04:00,33.61,33.87,33.2,33.47,3365600,1750160,37.77017560384594,40.27980157404607,NaN,NaN,-100.04028478110594,-62.01885217636119,-0.08060356886915968,-0.21401750985511825,-0.13341394098595857,35933659,38074819,23.54225894221743,23.434342797377152,NaN,NaN,-14.432400944941062,-5.073959528273832
2006-06-07T09:30:00-04:00,33.59,33.67,33.10001,33.10001,2196200,1785140,33.71325944748037,39.82329604447873,NaN,NaN,-123.80108931545458,-71.89644620478849,-0.10948200723949092,-0.27026645003532224,-0.16078444279583132,33737459,37450779,21.587833813294537,22.182235618057415,NaN,NaN,-17.694966175932677,-6.876960477939381
2006-06-08T09:30:00-04:00,33.11,33.17999,32.34,33.12,3012400,1900745,34.124954311408004,39.66731153066447,NaN,NaN,-177.772134928386,-98.81494698947381,-0.11910166903812064,-0.3096615290934821,-0.19055986005536146,36749859,37187099,20.80200918686208,21.31403857495706,NaN,NaN,-20.068033209256914,-8.761399439556172
2006-06-09T09:30:00-04:00,33.28999,33.28999,32.84,32.84,6334500,2129230,31.201759308871218,39.127389624086156,NaN,NaN,-159.8321703328376,-126.03560379909212,-0.13501922839202868,-0.3593338955453973,-0.22431466715336862,30415359,35227119,16.108222728388284,20.276468365995505,NaN,NaN,-23.017616996174738,-10.798001947644538
2006-06-12T09:30:00-04:00,32.91,32.98,32.41,32.42999,1532300,2143635,27.488480615324292,38.39338950995553,NaN,NaN,-197.03000135041194,-151.6951361416392,-0.1620389614990217,-0.4268633690271457,-0.26482440752812403,28883059,33143879,12.801781523567882,19.298904801547167,NaN,NaN,-26.824424854522906,-13.087490934341448
2006-06-13T09:30:00-04:00,32.25999,32.67999,32.25999,32.33,1823700,2186920,26.65535639649771,37.7603999921122,NaN,NaN,-183.06877640997016,-168.30083446741205,-0.17444683126502702,-0.4828829466094078,-0.30843611534438076,27059359,31369019,10.772905506746483,18.454512652550267,NaN,NaN,-30.114490712366,-15.519919474059241
2006-06-14T09:30:00-04:00,32.33,32.62,32.31,32.61,2045000,2260060,32.79763779947152,37.654414308697746,NaN,NaN,-144.90802820286584,-172.52222224489432,-0.15239815344207053,-0.4989338071469689,-0.34653565370489836,29104359,30442399,9.8915116572647,17.72447556300417,NaN,NaN,-30.927915727618572,-17.721061795996288
2006-06-15T09:30:00-04:00,32.77,33.45,32.73,33.35001,1427900,2171775,45.732585522407945,38.062134750884454,NaN,NaN,-49.54903726380731,-146.87760271197857,-0.08020449749836239,-0.44679127557785137,-0.366586778079489,30532259,29198879,8.845588700897267,16.97659377322144,NaN,NaN,-27.040832752789168,-19.0524576469667
2006-06-16T09:30:00-04:00,33.34,33.34,33.07001,33.25999,856100,2109370,44.60778148406188,38.08048520947792,NaN,NaN,-38.14713657860317,-122.54059596113169,-0.03315322470223642,-0.4080283089572845,-0.37487508425504806,29676159,29051039,8.727434950558276,16.30448407191717,NaN,NaN,-24.40946281127023,-19.817744099010064
2006-06-19T09:30:00-04:00,33.25999,33.45,32.85001,33,1026200,2052400,41.437844784972135,38.3554288420633,NaN,NaN,-48.71549205538488,-92.87769410212627,-0.015098741456413156,-0.3937485110755645,-0.37864976961915137,28649959,29004419,8.688024915087496,15.758775696150702,NaN,NaN,-23.277400649806783,-20.31198074912388
2006-06-20T09:30:00-04:00,33.02,33.16,32.87,32.96001,1223900,2015035,40.95574796101383,38.22948695689753,NaN,NaN,-56.368486880361,-67.53763619620443,-0.002091030859088794,-0.3812635581930124,-0.3791725273339236,27426059,29077759,9.381277441172116,15.304291656866086,NaN,NaN,-22.534072713748238,-20.62942245835593
2006-06-21T09:30:00-04:00,33.08,33.45,33,33.35001,726900,1970505,47.384790525481684,38.0949616660957,NaN,NaN,-16.288321348460094,-41.81369482532328,0.034517297877911024,-0.33602590498653484,-0.37054320286444586,28152959,28887479,9.186406842299007,14.654951227038163,NaN,NaN,-19.819330964439427,-20.513695102082142
2006-06-22T09:30:00-04:00,33.39,33.39,33.02,33.14999,1854900,1977585,44.6967365206246,37.70577950888304,NaN,NaN,-24.683007631676077,-36.84048889889703,0.04626659785042697,-0.3127099555514121,-0.3589765534018391,26298059,28040639,8.354634110311082,13.651662011570307,NaN,NaN,-18.410385882102485,-20.213222356370764
2006-06-23T09:30:00-04:00,33.19,33.47,32.97,33.24001,488600,1936470,46.176595919437105,38.195979014349895,NaN,NaN,-15.213023535877674,-32.253666290351916,0.060223046751827436,-0.2836977449620548,-0.34392079171388223,26786659,27462739,7.833385941711498,12.608805447169749,NaN,NaN,-16.821037097728695,-19.72862446227904
2006-06-26T09:30:00-04:00,33.25,33.34,33.09,33.33,1871100,1969655,47.68371145985227,38.90408871835034,NaN,NaN,-5.363806975572268,-23.5833292743894,0.07469209869358728,-0.25055566834689813,-0.3252477670404854,28657759,27464299,7.850099486335694,11.487936914606772,NaN,NaN,-15.072987543934618,-19.063533473944123
2006-06-27T09:30:00-04:00,33.25,33.42999,32.97,33.02,1026700,1827010,43.19650434896391,39.581463354170594,NaN,NaN,-20.636992522716685,-16.437030402860557,0.06302728292650811,-0.24646366338235026,-0.3094909463088584,27631059,27505299,8.320654470957123,10.540281247296955,NaN,NaN,-14.86082697840686,-18.463146831724515
2006-06-28T09:30:00-04:00,33.10001,33.17,32.82001,33.12,515900,1780075,44.99468656091816,40.357872800564174,NaN,NaN,-35.18841897991599,-20.217049929151734,0.061615344332724364,-0.23247176589295293,-0.2940871102256773,28146959,27504099,8.319315456787649,9.64866026657735,NaN,NaN,-14.16510478867267,-17.849140825574253
2006-06-29T09:30:00-04:00,33.37,33.85001,33.25,33.82001,1282400,1783665,55.59225603622994,42.10005113823265,NaN,NaN,103.84704141608859,5.488959880401199,0.10485452930813788,-0.16301894859050492,-0.2678734778986428,29429359,28130359,15.923624801848874,9.635474700395966,NaN,NaN,-10.007221185255444,-16.728866591242994
2006-06-30T09:30:00-04:00,34.00999,34.00999,33.78,33.81,929000,1722765,55.42780227740268,44.095716971238254,NaN,NaN,172.71729874044416,43.07502433566557,0.12826270162892373,-0.10754510086248814,-0.23580780249141187,28500359,28473099,19.842151261642215,10.13835825311556,NaN,NaN,-6.797701633959141,-15.310128740202444
2006-07-03T09:30:00-04:00,33.92,34,33.85001,33.92999,661200,1710025,57.06730926774472,46.26799931918447,NaN,NaN,183.24942761017726,80.79767125281548,0.14601804398953142,-0.05328524750449759,-0.199303291494029,29161559,28573859,21.007729554237173,10.869417113650611,NaN,NaN,-3.6589392588267344,-13.645673100005915
2006-07-05T09:30:00-04:00,33.7,33.8,33.57001,33.67999,1263900,1604940,52.716450150801094,47.69077162999372,NaN,NaN,119.54175475190387,108.83342070773958,0.1353548355641945,-0.030109747038785883,-0.1654645826029804,27897659,28627179,21.656935692295136,11.709804544724213,NaN,NaN,-2.249039636745397,-12.017582605254413
2006-07-06T09:30:00-04:00,33.69,33.89999,33.67,33.77,806400,1535450,54.07407862850783,48.28659256614372,NaN,NaN,125.45760282293526,140.96262506830982,0.12882855589574638,-0.004428887733297415,-0.1332574436290438,28704059,28738599,23.079583324608805,12.726518446417895,NaN,NaN,-0.6921781874531636,-10.399667688425662
2006-07-07T09:30:00-04:00,33.60001,33.60001,33.2,33.27,1305500,1450105,46.14754365086353,48.39657557805811,NaN,NaN,30.176825871427063,126.22858195937754,0.08729065522358796,-0.024144124599558836,-0.1114347798231468,27398559,28332439,21.543774148425243,13.641971246265536,NaN,NaN,-1.7343745665246688,-9.161768671011234
2006-07-10T09:30:00-04:00,33.27,33.47,33.24001,33.36,1221400,1194450,47.635494039407625,48.8392648105178,NaN,NaN,26.476858894654868,96.98049399021967,0.06343910277756017,-0.032135901351196594,-0.09557500412875676,28619959,28356359,21.87350254985415,14.583791077320297,NaN,NaN,-2.136588529484067,-8.158171507935926
2006-07-11T09:30:00-04:00,33.21001,33.47,33.05,33.45,1683400,1202005,49.14860402323697,49.4244688149623,NaN,NaN,12.031917663934912,62.7369920009712,0.051778758002571576,-0.030851556625542287,-0.08263031462811386,30303359,28584719,25.10943604892627,15.707230977874165,NaN,NaN,-2.0308602600544368,-7.282841329667142
2006-07-12T09:30:00-04:00,33.53999,33.53999,33.00999,33.11,922500,1156945,43.97854571280414,49.18116561405676,NaN,NaN,-25.76291212162497,33.67605862626543,0.020811270848914,-0.056616226066971365,-0.07742749691588537,29380859,28881359,29.211106096543247,17.13756663889161,NaN,NaN,-3.503267358581086,-6.742902190940563
2006-07-13T09:30:00-04:00,32.89,32.91,32.44,32.46001,2140100,1161700,36.14964578220186,48.57065913274085,NaN,NaN,-199.5619300204812,-31.32784794241787,-0.04046446296104243,-0.1280080756171884,-0.08754361265614598,27240759,28588699,27.6047711400674,18.51257642673135,NaN,NaN,-7.535579936889213,-6.856141868933227
2006-07-14T09:30:00-04:00,32.46001,32.46001,31.74001,32,4097699,1295189.95,31.830931201952822,47.54596879577769,NaN,NaN,-281.14572440403975,-93.59235799751123,-0.10530833691890001,-0.219179033804771,-0.11387069688587098,23143060,27737599.2,23.549088102587703,19.635126581079646,NaN,NaN,-12.511815220963124,-7.664095204937498
2006-07-17T09:30:00-04:00,32.06,32.11,31.78999,31.89,1746100,1339689.95,30.880873190597043,46.345766062259464,NaN,NaN,-239.8799406103814,-146.86371789851847,-0.14641258945846203,-0.2968864337089485,-0.1504738442504865,21396960,26292999.4,18.563725616347412,20.4003855903662,NaN,NaN,-16.74072453949848,-8.960756538446208
2006-07-18T09:30:00-04:00,32,32.05251,31.64999,32.03999,1558400,1366299.95,33.7830524930402,45.6733766439792,NaN,NaN,-190.52803555936617,-187.37570854317872,-0.15355689604269696,-0.3424199643038577,-0.18886306826116073,22955360,24823399.6,15.068802639815857,20.882396173856108,NaN,NaN,-19.257046995116927,-10.431655175113454
2006-07-19T09:30:00-04:00,32.12,32.72,32.07001,32.69,2387200,1424464.95,44.63282806373844,45.647529608466364,NaN,NaN,-89.16616928670963,-200.05635997619567,-0.10678115456950293,-0.3223395114730394,-0.21555835690353647,25342560,24015739.8,13.558080034248192,21.256593643674723,NaN,NaN,-17.845142000599036,-11.490724721611393
2006-07-20T09:30:00-04:00,32.61,32.86,32,32.02,3451700,1560704.95,37.764182131656625,44.37409575813969,NaN,NaN,-100.5276142076269,-180.24949681362477,-0.11265801180519416,-0.3563808716600292,-0.24372285985483502,21890860,22945760,11.861489612377312,20.96644113014104,NaN,NaN,-19.08782753190808,-12.576025123082347
2006-07-21T09:30:00-04:00,32.02,32.03999,31.56,31.7,2855000,1610709.95,34.99422550331195,42.91455455999035,NaN,NaN,-138.9123199262623,-151.80281591806929,-0.12863547056046465,-0.40451719805541586,-0.2758817274949512,19035860,22124320,10.749380950291041,20.316957536473094,NaN,NaN,-21.06238548379224,-13.788362317469474
2006-07-24T09:30:00-04:00,31.81,32.27,31.81,32.22,2052500,1688904.95,42.38917222741471,41.866116199966775,NaN,NaN,-88.1692868217252,-121.46068516033806,-0.09620620201307323,-0.39613948001129273,-0.2999332779982195,21088360,22062600,10.668444556709716,19.578437179506846,NaN,NaN,-20.05757864933777,-14.683964650593516
2006-07-25T09:30:00-04:00,32.05,32.2,31.64999,32.13,5472000,1868949.95,41.50903657188163,41.065586658615395,NaN,NaN,-87.55153449536284,-100.86538494753741,-0.07384603196446293,-0.39224081795379817,-0.31839478598933524,15616360,20594800,8.943771631992988,18.67035403234241,NaN,NaN,-19.57875490730424,-15.383220401552192
2006-07-26T09:30:00-04:00,32.10001,32.13,31.52,31.72,2504700,1942849.95,37.67165159492679,39.89398472764532,NaN,NaN,-95.23418694894875,-102.07898847998523,-0.07922247722370218,-0.417422882518963,-0.3382004052952608,13111660,18148620,6.932388710078598,17.516982988447392,NaN,NaN,-20.464536943473448,-16.1091227646838
2006-07-27T09:30:00-04:00,31.85001,31.95,31.58,31.66,5677500,2200929.95,37.13067602773937,39.24992275456502,NaN,NaN,-90.19470183669915,-100.0124060057997,-0.07918510707889381,-0.43718178914387806,-0.35799668206498425,7434160,15257280,5.389545934309268,16.363109544581967,NaN,NaN,-21.329043856617417,-16.854825777817172
2006-07-28T09:30:00-04:00,31.84,32.10001,31.7,32.02,1563500,2214984.95,42.46895410777727,38.88088418802,NaN,NaN,-65.81618622185366,-85.39317926491796,-0.048772523646648636,-0.4189623366232951,-0.37018981297664644,8997660,13249640,4.620580733052009,15.130757986238958,NaN,NaN,-20.36737658583359,-17.356618750390947
2006-07-31T09:30:00-04:00,32.03999,32.03999,31.82001,31.89,748400,2205954.95,41.111421012542145,38.30679968725609,NaN,NaN,-63.21429157034001,-80.40218021464094,-0.03207511569303945,-0.41028370759294575,-0.3782085918999063,8249260,10681820,3.861666505348012,13.613060161697652,NaN,NaN,-19.999561678423852,-17.734182025824218
2006-08-01T09:30:00-04:00,31.66,31.85001,31.55,31.69,1862300,2266009.95,39.04365834134966,37.95430773215219,NaN,NaN,-80.30347597857511,-78.95256851128337,-0.02924355052886618,-0.414763030060989,-0.38551947953212284,6386960,8835940,3.4260419262431725,11.771269863819075,NaN,NaN,-20.30970039866285,-18.102113221944023
2006-08-02T09:30:00-04:00,31.67,31.97,31.6516,31.89,1221000,2263864.95,42.175739268996914,38.38474298120899,NaN,NaN,-61.19323894253156,-72.14437890999994,-0.00965754482985376,-0.39759141056944003,-0.38793386573958627,7607960,7735200,3.194610916740828,10.027686990724321,NaN,NaN,-19.64557533661705,-18.322607809754455
2006-08-03T09:30:00-04:00,31.85001,32.25999,31.66,32.14999,2952200,2371154.95,46.05606376475785,39.4008238785522,NaN,NaN,-34.1093802133941,-60.927314585338934,0.023253521976467906,-0.35886696326900136,-0.38212048524546927,10560160,8360400,7.035781576061538,8.848165095972453,NaN,NaN,-17.92639710151095,-18.26600628000538
2006-08-04T09:30:00-04:00,32.37,32.58,31.86,32.06,1513800,2381569.95,44.932138746205034,40.40448570395277,NaN,NaN,-6.829235624259219,-49.129924465820054,0.04040332096737709,-0.3316163340362479,-0.372019655003625,9046360,8370140,7.097628134979956,8.029158133017633,NaN,NaN,-16.825233497251034,-18.06018159675476
2006-08-07T09:30:00-04:00,31.89999,32.10001,31.77,31.92999,868300,2363914.95,43.28855878430358,41.08345043904301,NaN,NaN,-41.39337862106799,-44.765741875965645,0.044129171589058935,-0.31685819051730135,-0.3609873621063603,8178060,8355900,7.090201466974506,7.4592580492432505,NaN,NaN,-16.35305723153409,-17.81630668743752
2006-08-08T09:30:00-04:00,31.92999,32,31.5,31.64999,2577700,2408629.95,39.903180416736795,40.745618464257184,NaN,NaN,-88.95583678586738,-46.4962140374241,0.029573245487270305,-0.3240208052472724,-0.3535940507345427,5600360,8198580,7.003019882149545,6.991039466950489,NaN,NaN,-16.900290975664596,-17.68544730004139
2006-08-09T09:30:00-04:00,31.75,31.8519,31.13,31.16,1754100,2450209.95,34.777553579034745,40.53228785335562,NaN,NaN,-192.42294485283796,-72.74215521948538,-0.009146773022726706,-0.3650275170129511,-0.3558807439902244,3846260,7446240,6.5859584152936606,6.614215810015941,NaN,NaN,-18.9629710558863,-17.86795069373352
2006-08-10T09:30:00-04:00,31.2,31.46001,31.03,31.41,1934800,2439944.95,39.07742250880233,40.823944782319224,NaN,NaN,-202.0698941405169,-106.33425800490996,-0.013737328771479873,-0.37305240495457426,-0.3593150761830944,5781060,6490420,6.089753496848758,6.281385277627207,NaN,NaN,-19.413574192353007,-18.08875405067916
2006-08-11T09:30:00-04:00,31.28,31.49001,31.12,31.23,1118100,2290965,37.17700212980133,40.451646918203984,NaN,NaN,-172.41216526449196,-139.4508439329565,-0.024105839231719772,-0.3894473752227441,-0.3653415359910243,4662960,5613740,5.667943144392666,5.924206605318848,NaN,NaN,-20.356152076109186,-18.41266805431202
2006-08-14T09:30:00-04:00,31.37,31.75999,31.28,31.28999,2420600,2324690,38.25475289913814,40.219198084436584,NaN,NaN,-108.20251160892516,-152.81267053052792,-0.022181782092738855,-0.39306876360694787,-0.370886981514209,7083560,5394840,5.564305429732087,5.682816162300213,NaN,NaN,-20.8221791042398,-18.75688391858742
2006-08-15T09:30:00-04:00,31.64999,31.89999,31.56,31.86,1506600,2322100,47.47520736559033,40.91945206805541,NaN,NaN,-15.323820463900402,-138.08626726613454,0.019944997684832766,-0.34595573440816807,-0.36590073209300084,8590160,5992800,10.384731303230964,5.929412061811097,NaN,NaN,-18.39451888835072,-18.705117485696462
2006-08-16T09:30:00-04:00,32.25,32.64999,32.064,32.57001,4211199,2413299.95,56.24085983782305,42.2844651973471,NaN,NaN,168.9722395544818,-65.80723038467059,0.0939507239992548,-0.24846232709393234,-0.34241305109318715,12801359,7783819.8,23.05391654961963,7.19115282004755,NaN,NaN,-13.158957845207498,-17.91280896562661
2006-08-17T09:30:00-04:00,32.45,32.73,32.45,32.61,803100,2280869.95,56.67937662273507,43.29949537698695,NaN,NaN,199.03385356096575,14.413519155625954,0.1410848101277012,-0.16605703843356068,-0.30714184856126187,13604459,9348499.6,32.08687774450439,9.153031178008435,NaN,NaN,-8.937263322111475,-16.630588159410163
2006-08-18T09:30:00-04:00,32.73,32.78,32.42999,32.53,1281800,2202209.95,55.48156260303627,44.325934062022235,NaN,NaN,162.57967588261738,81.41188738504782,0.1609263837952341,-0.10598386881721922,-0.2669102526124533,12322659,10880439.4,39.56715311493023,11.703423078692879,NaN,NaN,-5.893818518127239,-15.096763924941174
2006-08-21T09:30:00-04:00,32.41,32.42,32.21001,32.24001,1914100,2195289.95,51.25328267478785,45.19805008583925,NaN,NaN,89.91083208993359,121.03455612481957,0.1488535563120013,-0.0808433072224517,-0.229696863534453,10408559,11545439.2,42.52650102336739,14.496313014201752,NaN,NaN,-4.561165480991931,-13.591678432948424
2006-08-22T09:30:00-04:00,32.13,32.42999,32.13,32.34,1178200,1980599.95,52.59480893527062,45.942269347715936,NaN,NaN,84.33864189930416,140.9670485974605,0.14195862320903213,-0.05224858452316283,-0.19420720773219496,11586759,12144759,45.134137094293,17.49199345545548,NaN,NaN,-3.074180625103585,-12.089178746113447
2006-08-23T09:30:00-04:00,32.23,32.37,31.96001,32.10001,1701400,1940434.95,49.10200437922184,46.159836534463366,NaN,NaN,46.26813877245199,116.42622844105452,0.11665025601542173,-0.04839438771291782,-0.16504464372833955,9885359,11561559,43.085549442655186,20.06697687449788,NaN,NaN,-2.821693184602306,-10.765252237326141
2006-08-24T09:30:00-04:00,32.24001,32.24001,31.82001,31.92999,1357300,1724424.95,46.73413800983166,46.28855076757956,NaN,NaN,12.832571771026604,79.18597208306669,0.08532686389762856,-0.05838606385630385,-0.1437129277539324,8528059,10546279,39.70671892841592,22.396197645457594,NaN,NaN,-3.296097935658376,-9.698230194230746
2006-08-25T09:30:00-04:00,31.81,31.94,31.7,31.94,918800,1692189.95,46.896505776216806,46.546261267001924,NaN,NaN,-15.591252268063293,43.55178645293056,0.06317001149643692,-0.06475041338338627,-0.1279204248798232,9446859,9971119,37.89375189660173,24.59645124757382,NaN,NaN,-3.639662711510637,-8.832720553842158
2006-08-28T09:30:00-04:00,31.94,32.17999,31.87,32.07001,2617600,1785649.95,49.06804926539848,47.20089475619204,NaN,NaN,21.16775229123037,29.803170493189917,0.055434209843501364,-0.05862766257544649,-0.11406187241894786,12064459,10302299,39.603751380746715,26.92507492604505,NaN,NaN,-3.3469141588552973,-8.049033925986892
2006-08-29T09:30:00-04:00,32.17,32.17,31.88,32.14999,833200,1734194.95,50.411481880754145,48.317603920600575,NaN,NaN,23.446395271782443,17.62472116768556,0.05382362342461751,-0.046782343138175975,-0.10060596656279348,12897659,10564479,40.98895660182335,29.382431939368598,NaN,NaN,-2.74224317859027,-7.2909209620730895
2006-08-30T09:30:00-04:00,32.03999,32.21001,32.03999,32.17999,697400,1708014.95,50.93427318138212,49.164521825784846,NaN,NaN,36.63874154135628,15.698841721466426,0.05282435108796714,-0.03457552770283456,-0.0873998787908017,13595059,11306419,44.84417885536004,32.150605179262264,NaN,NaN,-2.0976851502630836,-6.549030131814518
2006-08-31T09:30:00-04:00,32.08,32.28999,32.08,32.25,602800,1590544.95,52.20073456165926,50.23764557091756,NaN,NaN,47.17988482208619,22.56830433167834,0.054693569429983505,-0.019032917003322325,-0.07372648643330583,14197859,12440379,50.199254428155,35.331413128102426,NaN,NaN,-1.2214722071516548,-5.787950428291252
2006-09-01T09:30:00-04:00,32.44,32.5,32.25,32.48,791200,1554414.95,56.20050662898453,51.51948512304944,NaN,NaN,84.77124860301768,42.640804505894536,0.06834824496935213,0.011708819778384338,-0.05663942519096779,14989059,13548819,54.81717798732684,38.849475453644914,NaN,NaN,0.6292058693345477,-4.871213814344709
2006-09-05T09:30:00-04:00,32.38,32.59,32.33,32.55,1600500,1591024.95,57.36970249572774,52.226234775202116,NaN,NaN,90.9773035549914,56.60271475864674,0.07830741041617728,0.04124483782925381,-0.03706257258692347,16589559,14453839,58.22341237306132,42.26652410148994,NaN,NaN,2.521321038907829,-3.815137406737204
2006-09-06T09:30:00-04:00,32.49001,32.49001,32.21001,32.21001,2513800,1587829.95,50.34074936689735,51.804798312993135,NaN,NaN,50.266155029231264,61.96666671013651,0.05908514340456259,0.03679385666877977,-0.022291286735782824,14075759,14689459,59.08815896256146,44.840398559557215,NaN,NaN,2.340392700055302,-2.935775962909703
2006-09-07T09:30:00-04:00,32.05,32.22,32,32.13,1184100,1559329.95,48.82470981869986,51.24375068413348,NaN,NaN,6.393927747913934,55.91770395144804,0.03903683211212588,0.026504753404374526,-0.012532078707751353,12891659,14548779,58.312056354479616,46.713625603126864,NaN,NaN,1.771137936765689,-2.263359691527504
2006-09-08T09:30:00-04:00,32.12,32.19,32.08,32.19,1063700,1515774.95,50.039795014255,50.855052999220526,NaN,NaN,6.005293688027767,47.68278572463636,0.028367876148213383,0.022927766477515377,-0.005440109670698006,13955359,14500279,58.02907462820074,48.0323342826462,NaN,NaN,1.6093424537924812,-1.7101165279103632
2006-09-11T09:30:00-04:00,32,32.24001,31.91,32.22,835600,1501649.95,50.67047354857485,50.8134237759196,NaN,NaN,-16.26173914477056,27.47618817507871,0.02215781665464401,0.022257161147607007,0.00009934449296299715,14790959,14460659,57.78238385530494,49.12204019921317,NaN,NaN,1.6341913306718119,-1.232358262398624
2006-09-12T09:30:00-04:00,32.28999,32.53999,32.17,32.52,3449600,1553099.95,56.57408180366516,51.09765755223349,NaN,NaN,69.25383088762449,23.131493641605324,0.03624831575034736,0.04540973918089719,0.009161423430549837,18240559,14790859,59.33400587857353,50.13631654094748,NaN,NaN,3.287736851623386,-0.5866303889669083
2006-09-13T09:30:00-04:00,32.52,32.91,32.5,32.85001,2139500,1584744.95,61.96632427890206,52.0165375450678,NaN,NaN,173.43936272193858,47.76613518014679,0.06415671528388181,0.0893573175354021,0.025200602251520293,20380059,16051719,64.67314978915441,51.678287994268864,NaN,NaN,6.412827124937354,0.4132921130194147
2006-09-14T09:30:00-04:00,32.66,32.8,32.63,32.7,1588500,1453610,58.41552223577879,52.850922132635446,NaN,NaN,142.01400888034203,74.89015140663241,0.06848292157718225,0.11080425422299811,0.04232133264581586,18791559,17231699,68.80141502780391,53.756480572796576,NaN,NaN,8.029812627835248,1.5013664722788196
2006-09-15T09:30:00-04:00,32.62,32.89,32.62,32.73,1908100,1508860,58.92246718905525,53.70991937640962,NaN,NaN,146.10621803687584,102.91033627640202,0.06913321036077222,0.12873784559678114,0.059604635236008924,20699659,18580559,72.72516812156634,56.244438874579764,NaN,NaN,9.500596148676967,2.6441135689071267
2006-09-18T09:30:00-04:00,32.67999,32.89,32.67999,32.81,472500,1468395,60.31191769871903,54.51305283593251,NaN,NaN,149.0415381090625,135.9709917271686,0.07047873067130365,0.1477030485751385,0.07722431790383484,21172159,19856799,75.8233888760477,58.83155583852983,NaN,NaN,11.130489475131041,3.8564529840819715
2006-09-19T09:30:00-04:00,32.81,32.81,32.48,32.67999,1592700,1452325,56.941094335625465,54.97945372556618,NaN,NaN,93.16790280889478,140.75380611142268,0.058626491374075704,0.15050743212142947,0.09188094074735377,19579459,20124579,76.42840875775377,61.362945278239145,NaN,NaN,11.611596144657856,4.964330578449955
2006-09-20T09:30:00-04:00,32.66,32.96001,32.66,32.86,1442900,1465560,60.25344922221509,55.64510915705425,NaN,NaN,119.68052606835536,130.00203878070604,0.05877459651064053,0.16534918638565443,0.1065745898750139,21022359,20253039,76.72926483515326,63.64045141965295,NaN,NaN,12.968722913251682,6.107815197707344
2006-09-21T09:30:00-04:00,32.99001,32.99001,32.42,32.55,1396300,1450305,52.73053976044648,55.68295238553905,NaN,NaN,68.70996982430869,115.34123096949938,0.0350312684953927,0.15036367549425478,0.11533240699886207,19626059,20419939,77.13755199367023,65.56461553147547,NaN,NaN,11.935670013285002,6.94036588564701
2006-09-22T09:30:00-04:00,32.42,32.49001,32.28,32.39,2069200,1485900,49.30862058586771,55.19067481103071,NaN,NaN,-1.539363968355995,85.81211456845301,0.00705072374877147,0.12414581168482641,0.11709508793605494,17556859,19791379,72.01315748382436,66.79289978122529,NaN,NaN,10.01510380890902,7.3796141603987255
2006-09-25T09:30:00-04:00,32.64999,32.82001,32.37,32.78,1061700,1493045,56.686914638965234,55.14190424983338,NaN,NaN,62.42826319042834,68.48945958472623,0.012964805108796093,0.13330109432205006,0.12033628921325397,18618559,19280659,68.0570280351768,67.49530089994782,NaN,NaN,10.627505554288124,7.843598645240069
2006-09-26T09:30:00-04:00,32.85001,33.28,32.8,33.19,3463500,1535340,62.81462160142762,56.0328951237284,NaN,NaN,159.56908839655708,81.7696967022587,0.04106015941000174,0.17166148847575613,0.1306013290657544,22082059,19781179,69.80759833049237,68.26097514051432,NaN,NaN,13.27375281059745,8.619334954576837
2006-09-27T09:30:00-04:00,33.35001,33.46001,33.25,33.27,1907200,1589040,63.88816411753034,57.10885614507343,NaN,NaN,189.84408500258888,95.80240848910539,0.06043208750148227,0.20614143844260724,0.14570935094112497,23989259,20374559,71.78196220942183,69.22311127301019,NaN,NaN,15.713115714415865,9.632732205982412
2006-09-28T09:30:00-04:00,33.45,33.55,33.25999,33.5,1211500,1614745,66.85120298388665,58.309671000047125,NaN,NaN,188.64966121573363,119.79034676739039,0.08275574518548878,0.24915403242298595,0.16639828723749717,25200759,21489499,75.07949854161907,70.44099869539721,NaN,NaN,18.73347189851589,10.932837876344337
2006-09-29T09:30:00-04:00,33.63,33.67,33.33,33.34,861400,1627675,62.97982093712736,59.18891009922945,NaN,NaN,168.25561842118333,153.74934324529826,0.08068174079776452,0.2672504632347028,0.18656872243693828,24339359,22845999,78.38852455384628,71.91286588815017,NaN,NaN,19.98542496788176,12.226064603706826
2006-10-02T09:30:00-04:00,33.59,33.62,33.3,33.44,2924900,1734360,64.36866534914098,59.74566606676344,NaN,NaN,145.33338040007803,170.3303666872282,0.07983317980694538,0.28636019719562,0.20652701738867463,27264259,24575139,81.72050627294215,73.51190163060507,NaN,NaN,21.43289791488095,13.541326505303129
2006-10-03T09:30:00-04:00,33.37,33.78,33.37,33.64999,1645800,1736625,67.15520326127174,60.11630027978985,NaN,NaN,146.7225273599893,167.76105447991463,0.08663453484378342,0.3148201859434039,0.22818565109962047,28910059,25940739,83.83959209100718,74.88093322359455,NaN,NaN,23.53084923671655,14.968401181219331
2006-10-04T09:30:00-04:00,33.58,34.14999,33.57001,34.14999,3151900,1768530,72.64152029732047,61.1324429984714,NaN,NaN,171.01959397165766,163.9961562737284,0.11618447382799801,0.373416243384618,0.25723176955661997,32061959,27555279,85.91811643394031,76.1035547526043,NaN,NaN,27.328045303778488,16.73406462729921
2006-10-05T09:30:00-04:00,34.10001,34.42999,34.03,34.32001,978900,1758270,74.21853795100618,62.22501948146789,NaN,NaN,179.11305558197714,162.0888351469771,0.13712036726250165,0.42863222863474704,0.2915118613722454,33040859,29123299,87.58781647188269,77.1651724919126,NaN,NaN,30.930926467098523,18.76218774727054
2006-10-06T09:30:00-04:00,34.21001,34.32001,34.10001,34.25,2477300,1828950,72.3686732940643,63.08621630970684,NaN,NaN,149.63862856444797,158.36543717563,0.13592897079973698,0.4614230748719166,0.3254941040721796,30563559,30368139,88.7302683199167,78.08709245218895,NaN,NaN,33.22384052045512,20.828138143439766
2006-10-09T09:30:00-04:00,34.25999,34.36,34.06,34.28999,373400,1805840,72.78592407867778,64.217989862782,NaN,NaN,132.52942346590285,155.80464578879497,0.12764120607736062,0.4850456116688804,0.35740440559151976,30936959,31102679,89.3530035345427,79.01027779338816,NaN,NaN,35.19352656331668,22.880336489136468
2006-10-10T09:30:00-04:00,34.22,34.48,34.22,34.34,1492200,1707970,73.32834388703918,65.15191091026945,NaN,NaN,129.37864735106615,152.33586978701035,0.11568856639462732,0.5020151135848039,0.38632654719017656,32429159,31806499,89.92733808449425,79.95299731119825,NaN,NaN,36.96705978735375,24.892725531738936
2006-10-11T09:30:00-04:00,34.34,34.36,34.09,34.35001,966300,1649310,73.44244553998847,66.63133275166531,NaN,NaN,106.97177149592488,139.5263052918638,0.09924904701322507,0.5103878559567079,0.4111388089434828,33395459,32073199,90.14429408401284,80.88205031765129,NaN,NaN,38.4560799915479,26.83034759742593
2006-10-12T09:30:00-04:00,34.42999,34.64999,34.3712,34.64,2358600,1687815,76.56963780308133,68.57854826718055,NaN,NaN,125.49870196881089,128.80343456923055,0.09850048599451022,0.5342644164366206,0.43576393044211037,35754059,32615839,90.5884759605811,82.20885878027676,NaN,NaN,40.72202598439781,28.814873081279057
2006-10-13T09:30:00-04:00,34.57001,34.63,34.46001,34.56,592300,1622025,73.98153519875729,69.81387830716571,NaN,NaN,109.5685471620823,120.7894182887574,0.0837895545306056,0.5405008736053674,0.45671131907476176,35161759,33535479,91.30378558696381,83.86934146254727,NaN,NaN,41.89081319639175,30.682864526295155
2006-10-16T09:30:00-04:00,34.46001,34.91,34.46001,34.78999,1319900,1664395,76.44636269375235,70.78757409947461,NaN,NaN,112.89864615000523,116.8632628255779,0.08069031536689536,0.557574213283381,0.4768838979164856,36481659,34644419,92.08498308007505,85.4605832303746,NaN,NaN,43.644010056449716,32.534456744888665
2006-10-17T09:30:00-04:00,34.67999,34.7,34.39999,34.60001,2131300,1691325,70.50471828154971,71.26018511119028,NaN,NaN,87.35088759748346,108.45771087486135,0.058046113395102905,0.5494415396603642,0.49139542626526134,34350359,35028659,92.34169296031892,86.92913542686725,NaN,NaN,43.39824062827117,34.08642587108616
2006-10-18T09:30:00-04:00,34.89999,35.05,34.41,34.50999,2943200,1766340,67.81509167428001,71.32903430336124,NaN,NaN,88.26547759306895,104.71645209429016,0.030585468710451924,0.5296272621533262,0.4990417934428743,31407159,34630999,89.12017336676219,87.93204077152032,NaN,NaN,42.40798447003401,35.27521995665014
2006-10-19T09:30:00-04:00,34.41,34.52,34.35001,34.42999,2157500,1804400,65.42638725814805,71.503789040577,NaN,NaN,59.62131778319483,91.54097525716695,0.002115245935769283,0.5016858508625859,0.4995706049268166,29249659,33330119,79.3656603880381,88.0018361882483,NaN,NaN,40.893755716292574,36.077867922313345
2006-10-20T09:30:00-04:00,34.39,34.49001,34.16,34.28,4171801,1909530.05,61.08220752690954,71.26904205327476,NaN,NaN,40.17270436726665,77.66180669820383,-0.029966724068265282,0.462112199841485,0.4920789239097503,25077858,31313338.8,67.10317141306886,86.9577408411145,NaN,NaN,38.32558374739208,36.39897018303888
2006-10-23T09:30:00-04:00,34.09,34.58,34.09,34.46001,1401300,1926510.05,64.15805910054883,71.05496032750884,NaN,NaN,44.12166830166793,63.90641112853636,-0.04150254809829795,0.4402007387868778,0.4817032868851758,26479158,29312838.6,57.59690734920046,85.08326335955688,NaN,NaN,36.95215394199598,36.47799643431846
2006-10-24T09:30:00-04:00,34.36,34.52,34.36,34.48,807000,1793685.05,64.49366062284217,70.47297035076039,NaN,NaN,52.63244388835074,56.96272238670982,-0.049673228781004164,0.41961175090892056,0.4692849796899247,27286158,27899998.4,51.99463183824016,82.66015731700688,NaN,NaN,35.915441675333234,36.39763146874915
2006-10-25T09:30:00-04:00,34.55,34.57001,34.33,34.50999,1918900,1794270.05,65.0227948585972,69.81613155844546,NaN,NaN,53.18083009776812,49.94579288764966,-0.054554990250046065,0.4010912418773671,0.4556462321274132,29205058,27459578.2,50.350531835521174,80.00035127155247,NaN,NaN,35.18771965128063,36.2247869233965
2006-10-26T09:30:00-04:00,34.50999,34.53999,34.25,34.5,1976800,1832535.05,64.67702771575134,69.26672830285167,NaN,NaN,40.884438881936894,46.198417107398065,-0.059546499211290294,0.38121310811330034,0.44075960732459063,27228258,27055298,48.82435055203924,77.14992857384695,NaN,NaN,34.48732041098666,35.97657742162367
2006-10-27T09:30:00-04:00,34.49001,34.49001,34.17,34.25,1352600,1857095.05,56.5699703930475,68.10844589673522,NaN,NaN,-1.5435284667945375,37.85517054058583,-0.07952629160281227,0.3413517428210753,0.42087803442388755,25875658,27214858,49.47527747869492,74.3015195698578,NaN,NaN,31.556131015840144,35.345085077940304
2006-10-30T09:30:00-05:00,34.00999,34.45,33.7,34.36,739000,1747800.05,59.00487930737259,67.0853412839019,NaN,NaN,-65.56974594539203,15.916887691173837,-0.08469746046548726,0.31500620884202846,0.3997036693075157,26614658,27241958,49.59254926901316,71.42046322589488,NaN,NaN,29.687713236744035,34.53688910062655
2006-10-31T09:30:00-05:00,34.36,34.48,34.12,34.28,1387100,1734865.05,56.52289529747972,65.87680198086557,NaN,NaN,-40.03638153105685,-2.61687739270768,-0.09224810325468052,0.2843935402391651,0.3766416434938456,25227558,26830238,47.77813614530657,68.39430908741585,NaN,NaN,27.399763687066265,33.51729975583223
2006-11-01T09:30:00-05:00,34.41,34.44,33.99001,34.11,1483300,1651435.05,51.55966155639673,64.09037510610237,NaN,NaN,-105.78560907249566,-34.41016522676044,-0.1064276746874992,0.2436070501344716,0.3500347248219708,23744258,25738078,43.2570231644932,65.01349103055243,NaN,NaN,23.931545196888322,32.14790624741167
2006-11-02T09:30:00-05:00,33.89999,34.05,33.88,33.99001,1618600,1683420.05,48.33361644907376,62.258380909696406,NaN,NaN,-184.5406883435153,-79.49519067185088,-0.1205847220390669,0.19930382227313714,0.31988854431220404,22125658,24717558,39.49613284190382,61.31294440590529,NaN,NaN,19.998150766246393,30.412226892959488
2006-11-03T09:30:00-05:00,34.07001,34.14,33.78999,33.92,1376000,1628355.05,46.5052547582008,60.1197303428713,NaN,NaN,-172.73525091986897,-113.73353516246577,-0.13052107210637381,0.15673720417923676,0.28725827628561057,20749658,23692358,36.10051220971838,57.31405362945124,NaN,NaN,16.150759568193713,28.37487441799295
2006-11-06T09:30:00-05:00,34.00999,34.31,33.99001,34.22,1522400,1685805.05,54.45571968255527,58.97337330008598,NaN,NaN,-76.25718398186811,-115.87102276976097,-0.11338043328062619,0.14553273468482786,0.25891316796545405,22272058,22823838,33.47484840541813,53.109279018386886,NaN,NaN,14.962771382225014,26.45885969859753
2006-11-07T09:30:00-05:00,34.10001,34.67999,34.10001,34.61,3315900,1776990.05,62.29996536223117,58.5794357063682,NaN,NaN,39.565162634857266,-99.95071393657817,-0.07416499631043605,0.166206922577409,0.24037191888784504,25587958,22895918,33.904500840781324,49.165302409388254,NaN,NaN,16.51703026224419,25.03859835054705
2006-11-08T09:30:00-05:00,34.39999,34.75,34.39999,34.66,899100,1773630.05,63.17563972486013,58.41866802541906,NaN,NaN,86.79699082965077,-61.434193956148874,-0.04469821019900416,0.18449915613908985,0.229197366338094,26487058,23444478,37.227243060741834,46.155415457438515,NaN,NaN,18.02857143921921,24.037165934643074
2006-11-09T09:30:00-05:00,34.59,34.69,34.35001,34.45,1534000,1732400.05,57.16945216636124,58.13918549966562,NaN,NaN,46.8825652712434,-15.149543233197136,-0.039377103532634405,0.179975986922301,0.2193530904549354,24953058,24009958,40.545335580243766,44.2584271836653,NaN,NaN,17.38140215827707,23.08634253801936
2006-11-10T09:30:00-05:00,34.34,34.57001,34.34,34.5,1413900,1773480.05,58.188696582861056,57.71280246268792,NaN,NaN,38.66036655490721,27.12958026175811,-0.032786641190333976,0.17836978896701794,0.21115643015735192,26366958,25133418,46.58615906334745,43.471945163247234,NaN,NaN,17.17828900886498,22.242334890997306
2006-11-13T09:30:00-05:00,34.5,34.83,34.5,34.77,1261500,1770560.05,63.27153118860444,57.625507503099506,NaN,NaN,132.9805470388057,68.97712646589287,-0.011631440800863091,0.19661712915627305,0.20824856995713614,27628458,26204698,51.63268235940429,43.44609162904466,NaN,NaN,18.65023921301374,21.729178365571084
2006-11-14T09:30:00-05:00,34.87,34.97,34.52,34.88,1344200,1731205.05,65.1313108622243,57.63325864621572,NaN,NaN,155.81905320828852,92.22790458057912,0.007359348864536319,0.21744775603780653,0.2100884071732702,28972658,26881638,54.55455130544313,43.746378734039084,NaN,NaN,20.449876476295067,21.546420952817368
2006-11-15T09:30:00-05:00,34.94,35.25999,34.89,35.22,2041200,1686105.05,70.16072953392703,58.02495163322828,NaN,NaN,245.31912932775577,123.93233228020013,0.03865928847800135,0.2584125177707719,0.21975322929277055,31013858,27786998,58.19220846824945,44.41551144233982,NaN,NaN,23.776575806221995,21.865014503303744
2006-11-16T09:30:00-05:00,35.37,35.5,35.27,35.38,1200700,1638265.05,72.19335128420286,59.14090741116794,NaN,NaN,257.79305825692245,166.11443087733593,0.06445827843022572,0.3003260773305527,0.235867798900327,32214558,29239298,63.270998001050664,45.40092005107952,NaN,NaN,27.189649636619666,22.62567666520602
2006-11-17T09:30:00-05:00,35.37,35.42,35.28,35.39999,848400,1472095,72.44589246764706,60.10097977975897,NaN,NaN,196.21962546090444,197.6262826585354,0.0763749294555588,0.3313364607197755,0.2549615312642167,33062958,30578498,67.2248585702456,46.66037071545326,NaN,NaN,29.953517521444468,23.672511073240084
2006-11-20T09:30:00-05:00,35.45,35.45,35.25,35.28,595700,1431815,68.4285588673663,60.95138432046516,NaN,NaN,151.05233832353449,201.24064091548115,0.06985843835455341,0.3422845792074085,0.2724261408528551,32467258,31546258,69.7583778601682,48.230387980800515,NaN,NaN,31.042044142965597,24.7253015117723
2006-11-21T09:30:00-05:00,35.41,35.5,35.2,35.39999,2369300,1509930,70.20770945467893,62.28338774177103,NaN,NaN,132.5822042133038,196.5932711164842,0.06728575756060512,0.3565333378036115,0.2892475802430064,34836558,32719038,72.5296397104393,50.321289162653805,NaN,NaN,32.4939698024226,25.835111267579485
2006-11-22T09:30:00-05:00,35.58,35.58,35.44,35.53999,1154900,1471730,72.17776292828735,63.98654106171485,NaN,NaN,132.89832061956128,174.1091093748453,0.06844347844219717,0.3748019282957529,0.3063584498535557,35991458,33714558,74.65297056834254,52.83249185739943,NaN,NaN,34.32397776034088,27.047806480831113
2006-11-24T09:30:00-05:00,35.28999,35.52,35.25,35.47,108600,1378320,69.69647272767746,65.64305663096319,NaN,NaN,101.50136240561088,142.85077020458297,0.05832158542534027,0.37926043163523104,0.32093884620989077,35882858,34448218,76.11802287092691,55.69088547605718,NaN,NaN,35.11692560227862,28.200537783895044
2006-11-27T09:30:00-05:00,35.36,35.37,34.86,34.89999,1635300,1392455,53.55036793800131,65.57838864920933,NaN,NaN,43.25142911345289,112.25713093509266,0.009617420344409822,0.3329606216404031,0.32334320129599325,34247558,34685138,76.58861507862032,58.77044023842876,NaN,NaN,30.33048653183219,28.504816176457492
2006-11-28T09:30:00-05:00,34.72,34.86,34.64999,34.86,1699400,1440475,52.62920305400624,64.88761991290754,NaN,NaN,2.8214507658328327,82.61095342355235,-0.026913494459832488,0.2897013332212026,0.3166148276810351,32548158,34701318,76.62249435305218,61.82172548930526,NaN,NaN,26.297978121936367,28.189553597240188
2006-11-29T09:30:00-05:00,34.86,35.14,34.84,35.14,1002100,1421225,58.06809929615544,64.5227955965715,NaN,NaN,35.82138232789799,63.2587890464712,-0.03341708536425392,0.2748434709757177,0.3082605563399716,33550258,34444058,74.76976724730962,64.50333435977439,NaN,NaN,24.59846788710075,27.676541352934553
2006-11-30T09:30:00-05:00,35.03999,35.27,34.89999,35.12,693400,1381730,57.55973444891024,64.55067290246785,NaN,NaN,39.04310357452447,44.487745637463846,-0.03982833724049151,0.25847513478935724,0.29830347202984875,32856858,33817138,70.30821691775668,66.62925445531103,NaN,NaN,23.10785559853887,27.023871959449455
2006-12-01T09:30:00-05:00,35.00999,35.21001,34.67999,34.92,742500,1337925,52.60052278138333,64.15151763093372,NaN,NaN,6.147366297132769,25.41694641576822,-0.05724202703548115,0.2267509382354973,0.28399296527097845,32114358,33063438,65.26603973755209,67.96353164632565,NaN,NaN,20.263489173531244,26.058102990032566
2006-12-04T09:30:00-05:00,35,35.39,34.96001,35.37,1575200,1347885,60.78690763006271,63.974044519609315,NaN,NaN,55.435182491165826,27.8536970913108,-0.03902702973153055,0.23520917810656528,0.2742362078380958,33689558,32951838,64.52811619200236,68.8846340629398,NaN,NaN,20.458025553884905,25.258091927725758
2006-12-05T09:30:00-05:00,35.35001,35.48,35.25,35.45,896000,1316565,62.04202348275671,63.75338113536163,NaN,NaN,81.82126780476817,43.653660499097874,-0.02295910697128145,0.24553732412399398,0.26849643109527543,34585558,33359318,66.03800207393982,69.70488054640384,NaN,NaN,21.024115275602743,24.653238120279614
2006-12-06T09:30:00-05:00,35.42,35.46001,35.33,35.33,2713600,1286450,58.991875778186454,62.95560586709444,NaN,NaN,71.5290494767555,50.79519392886937,-0.021790440315950566,0.24125838070033723,0.2630488210162878,31871958,33023658,63.63510796588726,70.0936590819494,NaN,NaN,20.51697813294803,24.062343836375103
2006-12-07T09:30:00-05:00,35.28,35.55,35.27,35.27,483800,1265685,57.470506543376565,61.90397409989257,NaN,NaN,63.51224676671344,55.68902256730716,-0.026142877527533748,0.23037022410687058,0.25651310163440433,31388158,32729918,61.525301395441524,69.96896646726303,NaN,NaN,19.6452897149517,23.43133610474319
2006-12-08T09:30:00-05:00,35.25,35.34,35.16,35.31,991700,1238570,58.243647015988365,60.889527996202666,NaN,NaN,33.76135724790389,61.21182075746138,-0.027286322442830885,0.22240519858086572,0.2496915210236966,32379858,32783018,61.77204338009547,69.5794796679666,NaN,NaN,19.159376432657446,22.82105615158808
2006-12-11T09:30:00-05:00,35.17999,35.34,35.14999,35.14999,286000,1182175,54.01361856182721,59.859889402949875,NaN,NaN,8.696222611450837,51.86402878151839,-0.039060471775295785,0.20086593130457686,0.23992640307987265,32093858,32463878,59.31015537713736,68.83317806203583,NaN,NaN,17.499454214381757,22.06082730341575
2006-12-12T09:30:00-05:00,35.14999,35.25,34.92999,35.21001,2616500,1249925,55.32430731163367,58.79678924987521,NaN,NaN,-30.58406884588026,29.382961451388702,-0.04274969303550227,0.1864892867854948,0.22923897982099709,34710358,32488838,59.44628573454837,67.89865277804361,NaN,NaN,16.490659104041455,21.26508898921942
2006-12-13T09:30:00-05:00,35.24001,35.35001,34.96001,35.09,1596000,1262515,52.125232005740266,57.364465612550426,NaN,NaN,-40.4776972216189,6.981612111713818,-0.052569701755782294,0.1635268526262692,0.2160965543820515,33114358,32737318,60.85047919037465,66.91276053676019,NaN,NaN,14.713970179204255,20.32921487350297
2006-12-14T09:30:00-05:00,35.17,35.37,34.96001,35.28999,1107700,1215840,56.62625215191065,56.430878428567084,NaN,NaN,-10.63876653962328,-7.848590549553526,-0.04517611879332706,0.15962640589039268,0.20480252468371973,34222058,33304098,63.919348803119554,66.04142667477394,NaN,NaN,14.452777801768434,19.48972386325518
2006-12-15T09:30:00-05:00,35.14,35.25999,35.08,35.2,2519200,1281765,54.158825959882925,56.474339715844344,NaN,NaN,-18.70501810431756,-18.34186561999782,-0.045783854523954115,0.14757270652877708,0.1933565610527312,31702858,33168698,62.655771264020196,65.04622354515966,NaN,NaN,13.523290389697431,18.6373762241755
2006-12-18T09:30:00-05:00,35.31,35.38,35.16,35.24001,978700,1288280,55.09568322264572,56.65051687074716,NaN,NaN,21.84775182737929,-15.711559776812129,-0.0429741563269887,0.1396388656439953,0.182613021970984,32681558,33286238,63.33340013347655,64.09700252947569,NaN,NaN,13.011822652916786,17.833725713995683
2006-12-19T09:30:00-05:00,35.12,35.34,35.03,35.25,579000,1287445,55.34110173605602,56.45573133074006,NaN,NaN,-1.0898938072553803,-9.81272476908715,-0.039987625245962694,0.13262849041353064,0.17261611565949334,33260558,32996278,60.4207289802732,63.07207122468737,NaN,NaN,12.652965823501708,17.09361715821083
2006-12-20T09:30:00-05:00,35.12,35.42999,35.12,35.3,428900,1190425,56.61903346064467,56.388538403006805,NaN,NaN,40.73727104311681,6.430268883859978,-0.03440233301735643,0.1296131993877978,0.16401553240515424,33689458,33111298,61.18332913834648,62.42029352615807,NaN,NaN,12.680561200814408,16.463180592868483
2006-12-21T09:30:00-05:00,35.35001,35.48,35.14999,35.23,879900,1176675,54.27733545907258,56.508310737127466,NaN,NaN,52.29683090229635,19.017388372243904,-0.03506068767799386,0.12018967280766191,0.15525036048565577,32809558,32828798,58.21641921282106,61.916749202963,NaN,NaN,12.09678870364213,15.839410322979004
2006-12-22T09:30:00-05:00,35.27,35.27,34.92999,35.00999,357500,1189120,47.61210889349751,55.56725368451566,NaN,NaN,-60.47935101137538,10.66252179083234,-0.049091304560098775,0.0938862297855323,0.14297753434563107,32452058,32978638,59.3425917774778,61.54635460192553,NaN,NaN,9.68409617172942,14.960079729943349
2006-12-26T09:30:00-05:00,35.03,35.17999,35.02,35.17999,696600,1142185,52.46906256240798,54.88347076163361,NaN,NaN,-31.84396047430173,-0.07582066950386519,-0.045766472138625225,0.08576944417234955,0.13153591631097478,33148658,33072058,60.06527303058159,61.11973109882852,NaN,NaN,8.935814944514593,14.099470474882098
2006-12-27T09:30:00-05:00,35.36,35.38989,35.16,35.36,1033200,1108875,57.01366462427473,54.74216996492563,NaN,NaN,69.83798621066053,14.109755334079319,-0.03099474767173098,0.09279248172131105,0.12378722939304203,34181858,33256318,61.518182523104926,60.96852213862978,NaN,NaN,9.637989610891985,13.462116065740654
2006-12-28T09:30:00-05:00,35.42999,35.46001,35.21001,35.24001,231300,1070335,53.35180490992292,54.44797699110752,NaN,NaN,63.42388384718922,18.6470778948938,-0.02889734708535098,0.0876655455363533,0.11656289262170429,33950558,33308538,61.94079088406292,60.99819995924559,NaN,NaN,9.147102466821671,12.845685551609371
2006-12-29T09:30:00-05:00,35.28,35.28999,35.00999,35.00999,252000,1048265,47.10579952425284,53.65241645598355,NaN,NaN,-87.2622336555469,-9.26473501667485,-0.0418099110198651,0.06430050384687291,0.10611041486673801,33698558,33486338,63.41404113541061,61.115485513196674,NaN,NaN,6.753519001871649,11.975376044503982
2007-01-03T09:30:00-05:00,35.13,35.56,35.02,35.23,3095700,1165925,52.797941011282454,53.56558234523035,NaN,NaN,30.27151935297975,8.885439056196176,-0.03463837549394705,0.0628124454993042,0.09745082099325125,36794258,34354778,69.60326802987544,61.850707845535105,NaN,NaN,6.5045001870797705,11.193822350586236
2007-01-04T09:30:00-05:00,35.08,35.19,34.83,35.08,1706700,1172500,48.93167910825803,53.10896604498924,NaN,NaN,-150.4219178082178,-14.830152410587038,-0.0387886851873637,0.04896496450904664,0.08775364969641034,35087558,34742558,71.88998936238075,62.7395438189517,NaN,NaN,5.056209076453482,10.317020454281558
2007-01-05T09:30:00-05:00,35.08,35.08,34.77,34.96001,3413800,1298390,46.028086501818315,52.67345565185196,NaN,NaN,-195.29746193389286,-67.85724203949772,-0.04781416668061571,0.027985941345640697,0.0758001080262564,31673758,34240938,65.07060293302803,63.040981229141224,NaN,NaN,2.9387550704700747,9.262982542308489
2007-01-08T09:30:00-05:00,34.87,35.14999,34.75,35.09,1669600,1246190,49.522640572880086,52.16605482477835,NaN,NaN,-132.11099811709593,-106.96421843235476,-0.04336006299764031,0.021600029279206012,0.06496009227684632,33343358,34119498,63.500155978080976,63.01103888449562,NaN,NaN,2.2590399556244822,8.262419315639345
2007-01-09T09:30:00-05:00,35.2,35.24001,34.92999,35.07001,1043200,1274160,48.99724890779801,51.797370749629415,NaN,NaN,-65.18481252174993,-102.54873420559537,-0.04016325480924758,0.014756023765286841,0.05491927857453442,32300158,33839818,59.91382924078129,62.81518588283569,NaN,NaN,1.5582233247265058,7.304677031223226
2007-01-10T09:30:00-05:00,34.89999,35.19,34.85001,35.19,2762800,1362715,52.27052744641226,51.59557390846989,NaN,NaN,-60.82399163489607,-120.7678364031705,-0.02889734028361518,0.018797603220015446,0.04769494350363063,35062958,33493558,55.71819430856929,62.271242609628025,NaN,NaN,1.9300404770003599,6.536871809191387
2007-01-11T09:30:00-05:00,35.10001,35.52,35.10001,35.48,2757700,1486300,59.102198557637834,51.864223681440016,NaN,NaN,134.01167913032086,-63.88111701546279,-0.002248940176362124,0.04488376828317797,0.047132708459540096,37820658,34040178,60.42919702757989,62.27184747014993,NaN,NaN,4.4611488865147955,6.240339963094732
2007-01-12T09:30:00-05:00,35.58,35.62,35.41,35.58,1263200,1418635,61.16632136764093,52.18902996051118,NaN,NaN,203.30653045596094,15.839681462507968,0.02052372038139314,0.07278735893628152,0.05226363855488838,39083858,35522198,69.80776493138572,62.88787859822417,NaN,NaN,7.198480842395654,6.377217231566292
2007-01-16T09:30:00-05:00,35.45,35.84,35.45,35.77,1560600,1416865,64.80128950777373,52.940740963989825,NaN,NaN,231.62247461242904,88.58637600841296,0.045370174011914774,0.10897635606978184,0.06360618205786707,40644458,36982418,75.87485573043777,64.14919549233964,NaN,NaN,10.726551995928466,6.998550769332317
2007-01-17T09:30:00-05:00,35.85001,35.96001,35.73,35.8,1659600,1444460,65.35274847409906,54.20792950546137,NaN,NaN,234.44130764620488,148.51160004200392,0.05989971479342024,0.13848082554964236,0.07858111075622212,42304058,38983198,81.39235584650434,65.72417864012725,NaN,NaN,13.726211647616354,7.959645180515751
2007-01-18T09:30:00-05:00,35.72,35.89999,35.63,35.64,1329300,1384965,59.95747804938462,54.7428163259597,NaN,NaN,161.5730713565408,192.9910126402913,0.05493927224445343,0.1472552010617889,0.09231592881733548,40974758,40165558,83.75656256214364,67.4164136066674,NaN,NaN,14.684708851572633,8.920368562095305
2007-01-19T09:30:00-05:00,35.64999,35.81,35.59,35.62,1531000,1412580,59.298474763912516,54.90601705021954,NaN,NaN,122.19098268373324,190.62687335097377,0.04683217554278349,0.15085614824581484,0.10402397270303135,39443758,40490178,84.34468283877938,69.04687791492987,NaN,NaN,15.270768858444889,9.82756860443096
2007-01-22T09:30:00-05:00,35.58,35.62,35.13,35.23,1188600,1443060,48.17822976033201,54.5364759681059,NaN,NaN,8.480875086886385,151.66174227715888,0.01345852877069073,0.12084713366639477,0.10738860489570404,38255158,40324438,82.69833453482401,70.52955960426995,NaN,NaN,12.200343855393353,10.166536497425588
2007-01-23T09:30:00-05:00,35.14999,35.71001,35.14999,35.64,1829300,1513080,57.253771680233974,55.26133112210455,NaN,NaN,58.41349731895176,117.01994681846341,0.017021255964686663,0.12866517485156237,0.1116439188868757,40084458,40212438,81.54006288991614,71.82427544387748,NaN,NaN,12.615336853185303,10.516365119676976
2007-01-24T09:30:00-05:00,35.73,35.73,35.5,35.53999,2334300,1585800,54.735660286906246,55.39973964179196,NaN,NaN,76.54939755720767,85.44156480066397,0.01096178112848148,0.12534614529747756,0.11438436416899608,37750158,39301658,72.63129589487407,72.04056314852023,NaN,NaN,12.084954209775256,10.740449275405302
2007-01-25T09:30:00-05:00,35.67999,35.67999,35.24001,35.35001,2087600,1672305,50.21737181338192,55.4915748350151,NaN,NaN,23.608053422540912,57.84856121386399,-0.0065777151737147765,0.10616222020185262,0.1127399353755674,35662558,38239218,63.86555090366693,71.46738897289782,NaN,NaN,10.116001469298391,10.651242445961458
2007-01-26T09:30:00-05:00,35.46001,35.46001,34.95,35.21001,1850800,1730015,47.12988701326244,55.57027487154682,NaN,NaN,-43.02451147958337,24.80546238120066,-0.027188618365990735,0.07875416241807898,0.10594278078406971,33811758,37112818,56.13091189611023,70.82883961311798,NaN,NaN,7.489437765935078,10.199556063100546
2007-01-29T09:30:00-05:00,35.2,35.34,35.08009,35.28999,2823500,1819530,49.05685563803082,55.53700451905759,NaN,NaN,-32.45232068976844,16.618823225869683,-0.03454358424313045,0.06276330048015666,0.09730688472328711,36635258,36788838,54.10139760706141,70.15749972947373,NaN,NaN,5.983988141154424,9.597332074251101
2007-01-30T09:30:00-05:00,35.39999,35.39999,35.11,35.27,1692500,1892590,48.58027059101922,55.507220353573395,NaN,NaN,-24.604898460344057,0.015144070010523336,-0.03950554599244846,0.047924952232726525,0.08743049822517499,34942758,35760498,48.15035913652039,69.31725186488366,NaN,NaN,4.639566793024409,8.889079891218717
2007-01-31T09:30:00-05:00,35.2,35.78,35.2,35.74001,1263600,1943170,58.7318701797951,55.96874483452931,NaN,NaN,61.607902632288045,-2.9731549149734007,-0.011346808479368573,0.07324698762596427,0.08459379610533284,36206358,35451738,46.496591909808515,68.65856597925789,NaN,NaN,6.778475882370475,8.587565032811826
2007-02-01T09:30:00-05:00,35.95,36.19,35.50999,36.05,2036800,1890225,63.80707572779604,56.30480748954061,NaN,NaN,139.99969369120996,20.30517313876041,0.02590897323391192,0.11698001264772273,0.09107103941381081,38243158,35967858,49.612009238107184,67.88590970858127,NaN,NaN,10.401761450855757,8.846735949675244
2007-02-02T09:30:00-05:00,36,36.30991,36,36.19,2448900,1927335,65.84974401462188,56.639337678610666,NaN,NaN,179.39801985358937,64.78967940539496,0.056006179909958195,0.16107876430125856,0.10507258439130036,40692058,37343918,56.82959955351265,66.95889789587605,NaN,NaN,13.99962153628441,9.582862462047983
2007-02-05T09:30:00-05:00,36.28,36.33,35.89999,36.25999,1521100,1832700,66.8568171845863,56.78616108409728,NaN,NaN,160.066733664362,103.29349027622104,0.07544326107330418,0.1993766607329306,0.12393339965962641,42213158,38459498,61.62830607156001,65.94128720595621,NaN,NaN,17.178060872484092,10.667890806395999
2007-02-06T09:30:00-05:00,36.23,36.28,36.14,36.27,2814600,1889950,67.00667380376683,56.90429860764498,NaN,NaN,156.5590459089092,139.5262791500717,0.08318012424503601,0.22790855496592144,0.14472843072088543,45027758,40476498,68.45562126362289,65.01723473575053,NaN,NaN,19.738278753550833,11.963660513132403
2007-02-07T09:30:00-05:00,36.35001,36.35001,36.19,36.24001,1130400,1894310,66.04320658842448,57.33899350329068,NaN,NaN,142.45727840806973,155.69615430522805,0.08043564741701342,0.2452729899921522,0.16483734257513877,43897358,42014698,72.47741501510902,64.21158133953377,NaN,NaN,21.550165908714348,13.333161283929824
2007-02-08T09:30:00-05:00,36.28,36.28,35.96989,35.99001,2209000,1866620,58.4928126345633,57.28144620833717,NaN,NaN,91.16739660701296,145.92969488838864,0.057041686417359155,0.23613945059683772,0.17909776417947856,41688358,42703738,74.07212270985877,63.47782704461087,NaN,NaN,20.913845148223242,14.416116121686027
2007-02-09T09:30:00-05:00,36.02,36.07001,35.74001,35.85001,3604600,1908965,54.72004045415308,57.74871840075296,NaN,NaN,40.72203946495028,118.19449881066082,0.028821312356458045,0.2151244046250511,0.18630309226859307,38083758,42182078,70.73072798550237,62.62299800537361,NaN,NaN,19.23613590744314,15.104690376794187
2007-02-12T09:30:00-05:00,35.87,35.92999,35.75,35.91,2738108,1982710.4,56.0288059736321,57.661220850281396,NaN,NaN,31.469175186455534,92.47498711507953,0.011752399718229112,0.20099359191637944,0.18924119219815033,40821866,41903819.6,68.94417459887144,61.72329169887041,NaN,NaN,18.22805778858211,15.550885721335318
2007-02-13T09:30:00-05:00,35.82001,36.2,35.82001,36.2,4795211,2144440.95,61.77991133474608,58.16438163941282,NaN,NaN,72.56311177642229,75.67580028858214,0.01721970242404286,0.2107658202282039,0.19354611780416103,45617077,42021683.4,69.29792137349409,61.485193518771844,NaN,NaN,19.077633842519056,16.054706881504423
2007-02-14T09:30:00-05:00,36.34,36.78,36.25999,36.73,2329023,2177912.1,69.60440537365321,59.54916975086077,NaN,NaN,159.37315289088448,79.0589751851451,0.051802655397557074,0.25829943705110736,0.2064967816535503,47946100,42831431.8,71.68425797429737,62.04367259524545,NaN,NaN,22.645021372124962,16.9961803801645
2007-02-15T09:30:00-05:00,36.84,36.84,36.25,36.81,1417900,2182342.1,70.58334664278551,61.22441686725527,NaN,NaN,144.11047507421023,89.64759087858457,0.07398582090629452,0.2989790577864184,0.2249932368801239,49364000,44366560.2,75.56223088628181,63.43162395168628,NaN,NaN,25.766531052783904,18.249087619110128
2007-02-16T09:30:00-05:00,36.8,36.8,36.56,36.66,971800,2154382.1,66.2734064577376,62.45417049723433,NaN,NaN,132.97618188689313,108.09841936297312,0.07238747033429721,0.31547757479799543,0.24309010446369822,48392200,46428248.6,79.60255029414787,65.25313485790674,NaN,NaN,26.92433699717372,19.4884089588335
2007-02-20T09:30:00-05:00,36.62,36.78999,36.5,36.72,1537800,2171842.1,67.13779765766056,63.77970814485157,NaN,NaN,118.7915941743324,125.56290316054852,0.06920383809989972,0.3295949020885729,0.2603910639886732,49930000,48249875.4,82.37522426248135,67.69776808118966,NaN,NaN,28.118976136883838,20.721347127126403
2007-02-21T09:30:00-05:00,36.5,36.83,36.5,36.82001,2347400,2197747.1,68.58316153755342,64.48337181326288,NaN,NaN,113.70799925118634,133.7918806555013,0.06758908847776662,0.34487742458588144,0.2772883361081148,52277400,49581940,84.07946575454103,70.38225907009912,NaN,NaN,29.54246077084158,21.981506219085713
2007-02-22T09:30:00-05:00,36.89,36.95,36.50999,36.7,1525100,2157287.1,64.89467433385576,64.56105742798142,NaN,NaN,104.354102340971,122.78807054551862,0.05284712032845912,0.3433472365186887,0.2905001161902296,50752300,50143180,84.74861771459217,72.89201681841948,NaN,NaN,29.642038658311755,23.075867996118003
2007-02-23T09:30:00-05:00,36.61,36.61,36.37,36.60001,1953000,2150557.1,61.907255287996755,64.27945109036536,NaN,NaN,67.31705400441426,107.42938633155943,0.03180724460567108,0.33025917194731846,0.2984519273416474,48799300,50030240,83.98364544892307,74.83159152523451,NaN,NaN,28.849983006356567,23.900741569009227
2007-02-26T09:30:00-05:00,36.55,36.60001,36.25,36.39,1548808,2135457.5,56.06906200676813,63.508897149092626,NaN,NaN,42.63772907094368,89.36169576836953,0.0008291929610760862,0.29948841854299246,0.2986592255819164,47250492,49801898.4,82.3649050393097,76.31277716578806,NaN,NaN,26.38806256762264,24.256073140239714
2007-02-27T09:30:00-05:00,36.2,36.2,35,35.3,4292801,2208922.55,36.71559734195162,61.34524883039154,NaN,NaN,-133.49131735363693,38.905113462775674,-0.09091479004221831,0.1850157380291435,0.2759305280713618,42957691,48407436.6,73.09876629065906,76.64443038200493,NaN,NaN,15.762780537671148,23.042745625587063
2007-02-28T09:30:00-05:00,35.34,35.63,35.09,35.42,3121100,2280352.55,39.20361039266959,59.42813481640905,NaN,NaN,-160.43389848154885,-15.923266083771376,-0.13850972398459924,0.10279337309061276,0.241303097075212,46078791,47167714.8,65.99084535200888,76.18110397749777,NaN,NaN,8.760798779490084,21.002467504716066
2007-03-01T09:30:00-05:00,34.87,35.47,34.09,35.28,4232863,2428815.7,37.3582792707504,57.9185252904224,NaN,NaN,-218.8321879857185,-80.56052414910928,-0.1722147851146487,0.02603461568190113,0.19824940079654982,41845928,45386440.4,57.360352030831855,74.987406071853,NaN,NaN,2.6828932270955783,18.385385465055997
2007-03-02T09:30:00-05:00,35.35001,35.35001,34.84,34.84,3170500,2485500.7,32.22443309602963,56.31169619341358,NaN,NaN,-174.4619576554015,-128.91632648107242,-0.21419985487263024,-0.06950041779423799,0.14469943707839225,38675428,43361666,49.444456803718495,73.46695813029702,NaN,NaN,-4.41408448265586,15.12831832966859
2007-03-05T09:30:00-05:00,34.62,35.03999,34.35001,34.75,4217199,2573915.65,31.27762011336634,54.54375434625175,NaN,NaN,-176.17762331143683,-172.67939695754853,-0.2363493597608041,-0.1507372626226129,0.0856120971381912,34458229,40803213.4,41.62725353570062,71.51574948292767,NaN,NaN,-10.18943877935353,11.511495885522573
2007-03-06T09:30:00-05:00,34.99001,35.14999,34.77,35.14999,5726801,2784200.7,39.7503738334961,52.97021595330532,NaN,NaN,-114.90063664391302,-168.96126081560377,-0.21309649812730752,-0.18075852552094318,0.03233797260636433,40185030,40248681.2,40.145734353986605,69.43345041010572,NaN,NaN,-12.129593819615463,8.13419735621714
2007-03-07T09:30:00-05:00,35.08,35.25,35.00999,35.00999,2483100,2767625.7,37.985134306817784,50.711696591388495,NaN,NaN,-93.76022014046683,-155.62652514738735,-0.19658047643907317,-0.21338762294247715,-0.016807146503403966,37701930,38573309,35.97941258379768,66.8831043107843,NaN,NaN,-14.251728159185367,4.936207996873925
2007-03-08T09:30:00-05:00,35.19,35.99001,35.19,35.27,2759100,2849060.7,43.04395139684199,48.74459693096396,NaN,NaN,-45.500494400122705,-120.96018643026818,-0.1591770222889232,-0.21577842436455796,-0.056601402075634764,40461030,38296329.4,35.326676907822176,64.00913616946578,NaN,NaN,-14.309568212184848,2.1868113955798147
2007-03-09T09:30:00-05:00,35.60001,35.60001,35.25999,35.45,1306900,2803955.7,46.309227850242415,47.318584173285736,NaN,NaN,-46.11535381121828,-95.29086566143154,-0.11538573565134194,-0.2008335716398122,-0.08544783598847025,41767930,38914829.8,38.03026070582502,61.03968691315699,NaN,NaN,-13.285466463589463,-0.023514012872939194
2007-03-12T09:30:00-04:00,35.64999,35.71001,35.25,35.62,1513400,2699395.7,49.26743141067041,46.042129441357865,NaN,NaN,-33.707099876333835,-66.79676097441094,-0.07026148017722386,-0.17327468621000008,-0.10301320603277622,43281330,40679450,45.08385744526659,58.376017854784514,NaN,NaN,-11.497946384830769,-1.6627186374383434
2007-03-13T09:30:00-04:00,35.62,35.62,34.88,35.02,2573800,2691180.3,40.73645646582206,44.05307907909134,NaN,NaN,-64.02258384173072,-56.621150413974476,-0.0756466947103556,-0.1975715744207207,-0.12192487971036511,40707530,40783950,45.479624395736856,55.61888632915565,NaN,NaN,-12.798041135805175,-3.2534789943478906
2007-03-14T09:30:00-04:00,35.14999,35.2,34.55,35.16,3341700,2618504.75,43.20755891231546,42.50399940612418,NaN,NaN,-76.705158129198,-53.2101380117207,-0.06501047932444365,-0.20318797886591966,-0.138177499541476,44049230,42053410,50.17701483655793,53.149486123581774,NaN,NaN,-13.003932558697848,-4.64640093211217
2007-03-15T09:30:00-04:00,34.96001,35.33,34.96001,35.2,2479500,2626028.6,43.92696455649982,41.219692925302965,NaN,NaN,-53.58399365885463,-54.826837863467084,-0.051123504387113494,-0.20208188002536787,-0.15095837563825437,46528730,43266950,54.23620682661349,51.024669079131094,NaN,NaN,-12.940869466582336,-5.831325008465051
2007-03-16T09:30:00-04:00,35.28999,35.38,34.99001,35.25,1633400,2636803.6,44.867096619939275,40.41955254052947,NaN,NaN,-45.48190228089244,-54.70014755740192,-0.03517229706808361,-0.1949237469733589,-0.1597514499052753,48162130,44545790,58.10943322915043,49.29213537840543,NaN,NaN,-12.610755547392516,-6.799815085454689
2007-03-19T09:30:00-04:00,35.37,35.56,35.33,35.5,3446800,2760553.6,49.43232464638267,41.32789020513169,NaN,NaN,-11.821866638632855,-50.323100909861715,-0.005919759985644951,-0.16715114988733148,-0.16123138990168653,51608930,46211310,62.554413433425495,48.53896731717447,NaN,NaN,-10.946229505659367,-7.392160002626786
2007-03-20T09:30:00-04:00,35.58,35.64,35.46001,35.59,1330550,2750191.1,51.005180620418265,42.17085950711374,NaN,NaN,9.270714245912881,-35.664441292332995,0.01993899269115762,-0.1363076490377395,-0.15624664172889713,52939480,48657700,67.93622800764868,48.67792322114873,NaN,NaN,-9.11135084749013,-7.637758694750121
2007-03-21T09:30:00-04:00,35.62,36.19,35.57001,36.08,3295000,2797571.1,58.56220551952228,43.68542566774031,NaN,NaN,81.08848243755465,-4.105713178982467,0.06779664903563551,-0.07150083043435274,-0.13929747946998824,56234480,51094750,72.21963610039643,49.73930065468907,NaN,NaN,-4.987501748924965,-7.259150559632242
2007-03-22T09:30:00-04:00,36.19,36.19,35.92999,36.14999,2537800,2848206.1,59.52257460169064,45.635292918144664,NaN,NaN,120.74390296997383,30.759866146783224,0.09997543532575726,-0.014328185312791675,-0.11430362063854893,58772280,53543460,75.72823553451894,51.6167134211748,NaN,NaN,-1.3695321810081178,-6.417776505543081
2007-03-23T09:30:00-04:00,36.03999,36.36,35.89,36.36,3497350,2925423.6,62.34276621841461,47.85423192564811,NaN,NaN,151.20668033890237,70.09758267074218,0.12934802951344074,0.047381416253251984,-0.08196661326018875,62269630,56364960,79.01672538799421,54.287389982052915,NaN,NaN,2.574963355569191,-5.133099382527043
2007-03-26T09:30:00-04:00,35.96001,36.47,35.84,36.06,2302400,2963103.2,56.30748100823224,49.03688243812927,NaN,NaN,144.67776074410398,101.39750814728956,0.12257953988573426,0.07125781159697908,-0.05132172828875518,59967230,58036620,80.68632613407027,57.183146537773176,NaN,NaN,4.1570118290683915,-3.805940638013409
2007-03-27T09:30:00-04:00,35.91,36.03,35.75,35.89,2552300,2876078.15,53.166521574377995,50.121267242955,NaN,NaN,88.85721044682431,117.31480738747184,0.1015302472319774,0.07559108075121657,-0.02593916648076083,57414930,58931710,81.53360229696193,60.43701723157063,NaN,NaN,4.5202716450186875,-2.6164817404373952
2007-03-28T09:30:00-04:00,35.98,35.98,35.41,35.60001,4467301,2943388.2,48.22472594810236,50.49132256804502,NaN,NaN,42.263098366809636,109.54973057332283,0.06474457315745208,0.054991549966054265,-0.00975302319139781,52947629,58274339.8,78.7995195454906,63.54222027711837,NaN,NaN,3.29332520559414,-1.772223605290033
2007-03-29T09:30:00-04:00,35.63,35.78,35.37,35.59,4731398,2968314.95,48.0586701587992,50.61628273294194,NaN,NaN,22.287281289120653,89.8584062371522,0.03774410943015933,0.037427113596301353,-0.0003169958338579762,48216231,56163130,70.61018796330808,65.86935793836717,NaN,NaN,2.265260925400954,-1.1954401009056064
2007-03-30T09:30:00-04:00,35.82001,35.89,35.31,35.55,5694074,3094493.65,47.35692671991321,50.47981811217357,NaN,NaN,18.33844104688468,63.28475837874866,0.016292316704091685,0.02004840004625663,0.003756083342164945,42522157,52213635.4,58.3858043852252,66.81949700550706,NaN,NaN,1.2229350504161578,-0.8499579364310687
2007-04-02T09:30:00-04:00,35.64,35.64,35.41,35.61,4166348,3091951.1,48.570032859925384,51.03935928318095,NaN,NaN,3.9261460976742373,35.134435449462714,0.005787494784473322,0.010990451822756597,0.005202957038283275,46688505,49557890.4,51.881489357616026,67.27677307421273,NaN,NaN,0.6772518303376771,-0.6317851126069621
2007-04-03T09:30:00-04:00,35.78,35.94,35.74001,35.86,3727958,2992008.95,53.38965835937476,51.76665210082803,NaN,NaN,65.74219305954821,30.511431972007482,0.014806867465747107,0.02371154137046716,0.008904673904720052,50416463,48158197,48.79609558476048,67.17813598479862,NaN,NaN,1.5455926699935294,-0.3207311436640348
2007-04-04T09:30:00-04:00,35.60001,35.89999,35.60001,35.72,3915700,3063638.95,50.53370632543638,52.238562227180644,NaN,NaN,32.98547381454517,28.655907061554586,0.01066817992163731,0.02223989880676669,0.01157171888512938,46500763,46868823.8,46.07766035025578,66.59538266505878,NaN,NaN,1.4886334974161208,-0.06225048065258404
2007-04-05T09:30:00-04:00,35.7,35.84,35.63,35.83,2502929,3050830.4,52.675743009848425,52.796322683602725,NaN,NaN,35.77179515809271,31.352809835349,0.01442933299658179,0.029608385130856618,0.015179052134274828,49003692,47026316,46.46994086311455,65.76399035319908,NaN,NaN,2.0352235188603163,0.23738866213497312
2007-04-09T09:30:00-04:00,36,36.06,35.78999,35.78999,2471906,3109080.7,51.7971575529375,52.96523931978521,NaN,NaN,57.969413983688675,39.279004422709804,0.013338612149059258,0.0318523173205989,0.018513705171539642,46531786,47828241.8,48.52345281651289,64.76177888056245,NaN,NaN,2.2568368801340855,0.5258812647062748
2007-04-10T09:30:00-04:00,35.87,35.96001,35.69,35.78,3088596,3187840.5,51.5658885299635,53.005289884752735,NaN,NaN,36.95752366666339,45.88527993650764,0.011149412985107937,0.03245047140292456,0.021301058417816626,43443190,47179178.8,46.95343622077616,63.26300803864298,NaN,NaN,2.3826548236937173,0.7911346302759095
2007-04-11T09:30:00-04:00,35.92,35.96001,35.59,35.64,4280457,3273173.35,48.310517752874084,52.27302647284929,NaN,NaN,11.241806815304892,34.98520268765897,0.00006412409071214834,0.02138121353120681,0.021317089440494662,39162733,44928432.8,41.891644476428795,61.0967229226453,NaN,NaN,1.6389599105876003,0.9122525274632939
2007-04-12T09:30:00-04:00,35.5,36.07001,35.5,36.07001,3867714,3299474.05,57.23973766549511,52.10996669169247,NaN,NaN,46.27989915710776,37.64408775617149,0.020360608061525322,0.046767849517401316,0.026407241455875995,43030447,44234369.6,40.44372227856401,58.57640054721994,NaN,NaN,3.553085304986208,1.2895143528237103
2007-04-13T09:30:00-04:00,36.10001,36.14999,35.89,36.06,4796500,3415324.05,56.99292214424316,51.72783497210879,NaN,NaN,88.46489664900783,48.18270805435451,0.031135149692831404,0.06532617857191525,0.034191028879083846,38233947,42080420.6,36.25564631883103,55.52203775656544,NaN,NaN,5.040008002727973,1.8252991599528907
2007-04-16T09:30:00-04:00,36.28999,36.37,36.25,36.35001,1428931,3405100.6,62.09280355787246,52.1410722970831,NaN,NaN,173.54747049591103,71.29831935679898,0.054452315254441455,0.10225642294713566,0.047804107692694206,39662878,40706639,33.848151562005924,52.17645385856084,NaN,NaN,7.922567212650258,2.6963374531953717
2007-04-17T09:30:00-04:00,36.34,36.37,36.17999,36.35001,1527852,3309153.2,62.09280355787245,52.778663867332696,NaN,NaN,147.7106837079131,93.44895136504893,0.065776761631239,0.13002505973174294,0.06424829810050395,39662878,39950576.6,32.56645615292777,48.6788005625584,NaN,NaN,10.254711633331178,3.7761051932147724
2007-04-18T09:30:00-04:00,36.10001,36.64999,36.10001,36.45,1542651,3319758.25,63.808874334526664,53.89181732350586,NaN,NaN,154.55650878839046,122.11189175966604,0.0752219674288465,0.15827575738656208,0.08305378995771558,41205529,40359135.8,34.020380193690826,45.48029060885841,NaN,NaN,12.729534832873451,5.055166570308869
2007-04-19T09:30:00-04:00,36.42,36.71001,36.32001,36.57001,3395311,3324773.8,65.80949432742884,55.15973333555083,NaN,NaN,160.6909374191351,144.9940994120715,0.0841003518930003,0.18817922982396595,0.10407887793096565,44600840,40673214.4,35.17745083691054,42.949380814115734,NaN,NaN,15.43100064052439,6.5374285803396575
2007-04-20T09:30:00-04:00,36.97,37.2,36.82001,36.82001,1695201,3282643.85,69.58177221043245,56.747222299159354,NaN,NaN,216.44516954189686,170.5901539906493,0.10026202054799635,0.2294064036159611,0.12914438306796475,46296041,42285633.2,40.90687786626508,41.700886062761434,NaN,NaN,18.996881149536257,8.31735037593917
2007-04-23T09:30:00-04:00,36.92999,37.12,36.89999,36.96001,2643110,3239931.85,71.4794757513023,58.38361107711485,NaN,NaN,187.8646639944195,173.453592690351,0.1128930288106704,0.27026066908130275,0.15736764027063235,48939151,44140887.8,46.73994584537806,41.33363295474445,NaN,NaN,22.61233398691637,10.359490891793056
2007-04-24T09:30:00-04:00,37.11,37.2,36.83,36.85001,4675324,3358578.05,67.8953454090763,59.419731580664966,NaN,NaN,149.6436784848783,173.84019164574403,0.10643722721182164,0.2904141742854094,0.18397694707358775,44263827,45061077.6,49.40745086299729,41.37730118890422,NaN,NaN,24.639827589232244,12.399538991427226
2007-04-25T09:30:00-04:00,37.13,37.86,36.84,37.23,2316384,3346782.25,72.94257504915032,61.020365060930246,NaN,NaN,168.10491296301754,176.54987248066945,0.11938403187541638,0.3332069869178582,0.21382295504244184,46580211,46136014,52.406225491716484,41.82934155615141,NaN,NaN,28.13785263957834,14.64786951259167
2007-04-26T09:30:00-04:00,37.27,37.36,37.16,37.21001,724043,3159619.35,72.29864229766144,62.42200072434546,NaN,NaN,135.70408154351142,171.5525013055447,0.11801543182797058,0.36134224482740507,0.24332681299943448,45856168,46387079.6,53.10537405126308,42.303301069590596,NaN,NaN,30.736979943157472,16.946313859815355
2007-04-27T09:30:00-04:00,37.2,37.81,37.17999,37.64,3192853,3082692.1,77.00174581793596,64.22232845755964,NaN,NaN,151.6259084524053,158.5886490876464,0.13619364904258202,0.413568874302662,0.27737522526007996,49049021,46937675.6,54.677767188842225,42.74289495332841,NaN,NaN,34.72351556350195,19.485914103199153
2007-04-30T09:30:00-04:00,37.92999,38,37.2,37.2,1713875,2883682.15,64.86569084601089,65.1723143372773,NaN,NaN,123.39427168701232,145.69457062616496,0.10983935822777091,0.4146744230447936,0.3048350648170227,47335146,46616874.6,53.55110468073096,43.214156986182324,NaN,NaN,33.98592390857414,21.55734407539558
2007-05-01T09:30:00-04:00,37.34,37.5,37.25999,37.42999,3308753,2840802.4,67.7287705269442,66.55933239256802,NaN,NaN,101.64952363458079,136.09573965610545,0.09946134005664142,0.42916173988782447,0.32970039983118304,50643899,47892889,57.31838917499113,44.316067321793916,NaN,NaN,34.37316222709006,23.388175239923363
2007-05-02T09:30:00-04:00,37.33,37.89999,37.33,37.67,2236803,2766244.65,70.43625817777257,67.50194100058785,NaN,NaN,112.7417245040092,125.02310196430378,0.10005373340663876,0.4547675665894815,0.3547138331828427,52880702,49152987.2,60.70757484876855,45.763485362522815,NaN,NaN,35.61931197492954,25.13548048778139
2007-05-03T09:30:00-04:00,37.89999,37.98,37.83,37.94,2078952,2674407.25,73.1639122249301,68.65701172063692,NaN,NaN,126.85144648646883,123.25257495289527,0.10917696296827395,0.49118503689318516,0.3820080739249112,54959654,50973684.4,65.02858938553072,47.81869558157276,NaN,NaN,37.589708821366266,26.9146559640078
2007-05-04T09:30:00-04:00,38.14999,38.39999,37.89,37.98,3364041,2717462.85,73.55321162709518,69.47561229700997,NaN,NaN,130.5988322238133,119.04715970717686,0.1082420015676549,0.5173105758844798,0.4090685743168249,58323695,52828619.2,68.7938318278684,50.31481560056294,NaN,NaN,39.24522969152057,28.676166496509623
2007-05-07T09:30:00-04:00,38.10001,38.14999,37.98,38.08,1978752,2692805.15,74.54729579156017,70.36521888513052,NaN,NaN,118.44687994449518,118.05768135867345,0.10463412756539142,0.5398612337735642,0.4352271062081728,60302447,55422079.4,73.14702400948113,53.213427590316755,NaN,NaN,40.89531431735798,30.4217590423451
2007-05-08T09:30:00-04:00,37.89999,38.069,37.839,38.06,1202500,2598500.35,73.94861552664103,71.08948611313869,NaN,NaN,101.00000371571001,117.92777737489928,0.09164345244411254,0.5497814217633135,0.4581379693192009,59099947,57113289,75.542953012929,56.17932564883376,NaN,NaN,42.04225641112434,32.08183009502785
2007-05-09T09:30:00-04:00,38.03,38.28999,37.92,38.16,2064100,2487682.5,75.02846441439056,71.7479839764931,NaN,NaN,106.43610602995597,116.66665368008864,0.08090205770487469,0.5592655414502943,0.4783634837454196,61164047,58769958,77.64693313495613,59.21286009869416,NaN,NaN,43.31347499748472,33.68635079537883
2007-05-10T09:30:00-04:00,38.02,38.2,37.75,37.89999,3222569,2455425.25,67.22580061185133,71.57970029088015,NaN,NaN,81.76166375345346,107.64869713348556,0.0489741606895272,0.5395811846073286,0.4906070239178014,57941478,59366322.8,78.36835307082428,61.888679756162674,NaN,NaN,42.10218723009205,34.888613143195
2007-05-11T09:30:00-04:00,37.89999,38.19,37.7,38.19,1681350,2299667.75,70.86525039976118,71.53582705148436,NaN,NaN,84.76158470557392,98.48124762983768,0.040430057052482704,0.5411445952334049,0.5007145381809222,59622828,59626149.4,78.69103135924186,64.1709001500101,NaN,NaN,42.14564529330979,35.92533202178283
2007-05-14T09:30:00-04:00,38.28,38.28,37.89999,38.02,3746800,2415561.2,66.22295444365201,71.41637055395407,NaN,NaN,83.35403048061686,91.46267773706202,0.01754144630577925,0.5226413460631463,0.505099899757367,55876028,58740865.6,74.6074078075188,65.97089707461878,NaN,NaN,40.73717882178974,36.6127387074981
2007-05-15T09:30:00-04:00,38.09,38.46001,38.03999,38.12,2981250,2488231.1,67.56880908619996,71.03253012802904,NaN,NaN,95.31791737663539,90.3262604692471,0.004052623925362098,0.5101656796640697,0.5061130557387076,58857278,58692331.8,74.37952041526421,67.54041814058647,NaN,NaN,39.97499053548152,37.09306039721002
2007-05-16T09:30:00-04:00,38.27,38.35001,38.02,38.31,2150400,2518618.55,70.01358640865587,70.86931185024292,NaN,NaN,91.37100583778688,87.31324043081328,0.002896866141089527,0.5097341384150695,0.50683727227398,61007678,58661058,74.22219706173856,69.04876264133472,NaN,NaN,40.05337174125714,37.515962017788176
2007-05-17T09:30:00-04:00,38.39999,38.46001,38.2,38.38,2809300,2489318,70.88441183640575,70.43235942299076,NaN,NaN,102.67967596529975,91.49684287318254,0.001867098845323989,0.5091711458306349,0.507304046985311,63816978,59836158,76.25454979007736,70.5899613985658,NaN,NaN,40.37064892083341,37.92377443250892
2007-05-18T09:30:00-04:00,38.33,38.5,38.25,38.25,2837615,2546438.7,66.99334887152457,70.58433499624174,NaN,NaN,94.25096811066831,93.39471955420142,-0.011797506209307862,0.4925571642236761,0.504354670432984,60979363,60107465,76.71108398938313,72.24424563489809,NaN,NaN,39.5082492472784,38.15012797747599
2007-05-21T09:30:00-04:00,38.5,38.53999,38.3,38.47,4293180,2628942.2,69.99509391431229,70.7462152381966,NaN,NaN,108.1049412652815,98.34490171113434,-0.010301990377839632,0.4914771824606845,0.5017791728385241,65272543,61986768,79.63225127327087,73.83809292763236,NaN,NaN,39.63514274086672,38.36227294367467
2007-05-22T09:30:00-04:00,38.72,38.72,38.31,38.39,1107865,2450569.25,67.58799524037627,70.54276788552544,NaN,NaN,114.63592780766828,102.20850379734092,-0.01850462071176312,0.4786483969488202,0.49715301766058334,64164678,63048248,81.07608701341465,75.29298665367851,NaN,NaN,39.041275270830155,38.45927327612545
2007-05-23T09:30:00-04:00,38.34,38.65739,38.34,38.58,4071023,2538301.2,70.20840021641621,70.33165988491731,NaN,NaN,120.67695068578915,108.06969276694137,-0.015082920737066408,0.47829936673925033,0.49338228747631674,68235701,64493852.6,82.85826816138211,76.5665351376679,NaN,NaN,39.28981485365177,38.57792207291492
2007-05-24T09:30:00-04:00,38.7,38.74001,38.2,38.27,3748121,2689505.1,61.47551990430085,69.46896761900344,NaN,NaN,88.8271689730703,105.29919136849549,-0.03642914177389811,0.44784586025894413,0.48427500203284224,64487580,64627973,83.01806131694299,77.58255152974466,NaN,NaN,36.78319019211875,38.32153180422976
2007-05-25T09:30:00-04:00,38.46001,38.59,38.35001,38.5,2288450,2644284.95,64.95814222349463,68.78402807842733,NaN,NaN,100.18245307804322,106.48548836197047,-0.037635843842182215,0.43723019723011447,0.4748660410722967,66776030,65787306.4,84.37402711129042,78.38448032273104,NaN,NaN,35.720884409801904,37.95001074788292
2007-05-29T09:30:00-04:00,38.25,38.75,38.25,38.75,5165551,2816868.75,68.31141787922323,68.38137110361176,NaN,NaN,117.65096952908661,108.3946940147315,-0.024794095294481955,0.4438734219541942,0.46866751724867617,71941581,67121114,85.78074742066661,79.11575135185514,NaN,NaN,35.88450781927915,37.65493890093953
2007-05-30T09:30:00-04:00,38.5,38.94,38.36,38.92,4116000,2857231.1,70.3866347647336,68.04981184292198,NaN,NaN,151.2814559893345,115.72379965106475,-0.008869138090165318,0.4575810946359695,0.46645023272613484,76057581,69499694.6,87.87673892098923,79.84645176514321,NaN,NaN,36.68091202031968,37.51579220370812
2007-05-31T09:30:00-04:00,39.06,39.2,39.00999,39.13,4611602,2975971.05,72.75979022817668,68.44509681551665,NaN,NaN,225.9321585377665,136.7748412214602,0.010726423109506222,0.4798582616130176,0.46913183850351137,80669183,71986391,89.60233159438705,80.64887880254057,NaN,NaN,38.11314453110631,37.60112825047929
2007-06-01T09:30:00-04:00,39.38,39.42999,39.09,39.28,5356770,3139861.95,74.34149842279515,68.69340024573336,NaN,NaN,223.30995621069255,163.67139866898466,0.027741908566778495,0.5038092242119845,0.476067315645206,86025953,76294065.6,91.78398144544079,81.58408952298332,NaN,NaN,39.79828730104305,37.91500811484554
2007-06-04T09:30:00-04:00,39.03,39.36,39.03,39.28999,5474863,3245403.05,74.44791302028338,69.28089728692132,NaN,NaN,178.29477084516185,179.2938622224084,0.033249932136314775,0.5176297308155995,0.4843797986792847,91500816,81239022.8,93.4761925818359,82.93185986400599,NaN,NaN,41.17374419373252,38.380541840400824
2007-06-05T09:30:00-04:00,39.25,39.39999,39.00999,39.17,4470352,3369983.05,70.65745115617804,69.50151457763403,NaN,NaN,145.1773890746296,184.799146131517,0.02288575856998165,0.5129869968917617,0.4901012383217801,87030464,84256799.4,94.25399355035849,84.35146508794128,NaN,NaN,41.234351944548294,38.78822899813618
2007-06-06T09:30:00-04:00,38.96001,39.00999,38.63,38.75,6151500,3617433.05,59.28018155910144,68.73484280266585,NaN,NaN,55.73058783895598,165.68897250144127,-0.016081592156265034,0.4699992481264488,0.4860808402827138,80878964,85221076,94.48044276211911,85.79848263796848,NaN,NaN,37.64355843412643,38.62470463184907
2007-06-07T09:30:00-04:00,38.55,38.78999,38.06,38.12,5776590,3803057.55,47.043679059915284,67.03193331863082,NaN,NaN,-44.7403066710669,111.5544794596746,-0.08429918347536319,0.3807068609385098,0.465006044413873,75102374,84107714.2,90.06688108622092,86.78507773055014,NaN,NaN,29.766020430575153,37.35917831738137
2007-06-08T09:30:00-04:00,38.3,38.73,38.07001,38.64999,3031400,3793499.1,55.386709750424444,66.20288766712368,NaN,NaN,-17.728371935156154,63.34681383050486,-0.09305419332259579,0.34868830276062823,0.441742496083224,78133774,82529278.4,84.07079674830803,87.31077149904478,NaN,NaN,26.11220719187937,35.75246815659537
2007-06-11T09:30:00-04:00,38.55,38.89999,38.55,38.7,2960600,3857461.6,56.089695222216655,65.20964490340255,NaN,NaN,27.734596760188484,33.23477901351019,-0.09449936995143426,0.3236182836439312,0.41811765359536546,81094374,80447990,76.80960103128407,87.10915362461716,NaN,NaN,23.62442570127889,34.01989066297873
2007-06-12T09:30:00-04:00,38.67,38.75,38.2,38.2,3105144,3825378.8,47.95383828110336,63.807205120597345,NaN,NaN,-55.4117240463704,-6.883043610689815,-0.12617209628403325,0.2604025332403239,0.38657462952435717,77989230,78639743.2,71.06660307883563,86.39419048643292,NaN,NaN,18.48135180270628,31.800099397225523
2007-06-13T09:30:00-04:00,38.55,39.11,38.44,39.11,3294500,3841041.3,59.47506290685888,63.040538169914676,NaN,NaN,57.81048436788747,-6.467064304903505,-0.08486005080261777,0.28049956602108495,0.3653596168237027,81283730,78720696.4,71.17052827081332,85.55935192282088,NaN,NaN,18.509969137686188,29.901509360148474
2007-06-14T09:30:00-04:00,39.11,39.48,39.11,39.31,2121185,3839580.55,61.4926260091906,63.04176003454966,NaN,NaN,136.17377710041802,29.715752449393484,-0.045085338076569115,0.30900294422799135,0.35408828230456046,83404915,80381204.6,73.2898162444143,84.86447727478311,NaN,NaN,19.30795620831263,28.388144624171925
2007-06-15T09:30:00-04:00,39.60001,39.62,39.42,39.42,1733202,3785775.65,62.59562361264315,62.87300870520312,NaN,NaN,151.4581402135281,63.55305487913033,-0.014000083042482014,0.33658817850145795,0.35058826154393996,85138117,81782073.2,74.96203603452211,84.1921921978711,NaN,NaN,20.30370709573173,27.233224977251897
2007-06-18T09:30:00-04:00,39.5,39.64,39.28,39.39999,1543096,3721049.7,62.24633571079281,62.439788550315235,NaN,NaN,122.60055121626513,82.52624577034567,0.0017442223664606016,0.3527685395020157,0.3510243171355551,83595021,82282202.6,75.55054797752749,83.4614636662183,NaN,NaN,20.948225404391827,26.335367895414745
2007-06-19T09:30:00-04:00,39.33,39.7,39.17,39.52,3627800,3687780.7,63.55967473285546,61.95214854803823,NaN,NaN,110.9943605852046,115.80746269666065,0.015979549100341328,0.37099875351098177,0.35501920441064044,87222821,84128920.8,77.64043385194037,82.73029901842908,NaN,NaN,21.880481997916526,25.698955624343572
2007-06-20T09:30:00-04:00,39.81,39.87,39.3,39.3,2117850,3738279.95,59.47513518977953,61.003244616724146,NaN,NaN,102.36754256677796,124.71887433643876,0.006787773384932527,0.3635039211418061,0.35671614775687355,85104971,84893169,78.46097062269233,81.9344875204509,NaN,NaN,21.396446593471172,25.084311477076085
2007-06-21T09:30:00-04:00,39.28999,39.50999,39.03999,39.38,2777700,3673613.8,60.46994675986456,60.01241949794339,NaN,NaN,63.28516147514511,110.14115121138418,0.002524020221133849,0.35987117303329086,0.357347152812157,87882671,85788720.2,79.41429584096426,81.05093854870256,NaN,NaN,21.299235667772393,24.543586361461273
2007-06-22T09:30:00-04:00,39.37,39.461,38.99001,39.14999,3238300,3648122.75,56.198404994979136,58.70888321042166,NaN,NaN,38.667001158998495,87.58292340047826,-0.01821729760536961,0.334575530805445,0.3527928284108146,84644371,85689971,78.99908863395238,80.0168596952823,NaN,NaN,19.94403348631693,23.886507379297797
2007-06-25T09:30:00-04:00,39.23,39.41,38.82001,39.05,2682029,3667801.7,54.39939460668602,57.547593456886524,NaN,NaN,13.897245002141299,65.8422621576535,-0.039860046029322416,0.3029677708741616,0.342827816903484,81962342,85363435.2,77.55511736167477,78.82408282466204,NaN,NaN,18.30121668016898,23.08860870799368
2007-06-26T09:30:00-04:00,39.03999,39.16,38.71001,38.72,7165020,3767775.15,48.84229939535055,56.80203044519003,NaN,NaN,-37.5330682173329,36.136776397145994,-0.0755210967997505,0.24842644590379592,0.3239475427035464,74797322,82878335.4,67.45051035598307,76.8933733670809,NaN,NaN,15.17076741679913,21.957488523537315
2007-06-27T09:30:00-04:00,38.50999,39.10001,38.42,39.10001,2196800,3671815.15,54.59442921876822,57.341369742250954,NaN,NaN,-37.789392268008676,8.105389430188668,-0.07261582934969218,0.2331777560164312,0.3057935853661234,76994122,81256165.6,61.791089611897455,74.8736739760578,NaN,NaN,14.1848932763974,20.847117773945897
2007-06-28T09:30:00-04:00,38.85001,39.17,38.85001,38.89999,2308875,3556678.8,51.323316872372125,57.05112739381865,NaN,NaN,-14.26321279365976,-7.404285423572307,-0.08254089309364071,0.20261746899907251,0.2851583620927132,74685247,78616680.8,53.87069439532981,72.71652380798794,NaN,NaN,12.353355188041457,19.63372311881669
2007-06-29T09:30:00-04:00,39.16,39.35001,38.8,39.03999,4411102,3509395.4,53.426723410946025,56.86091512158503,NaN,NaN,7.892268402547001,-13.559231974862607,-0.07810006218037208,0.18753328436724814,0.2656333465476202,79096349,77507076.4,50.91602316872272,70.86698253209069,NaN,NaN,11.469677111865494,18.467430832109375
2007-07-02T09:30:00-04:00,39.16,39.46001,38.89,39.32001,3608294,3416066.95,57.3925480289103,57.53510867499982,NaN,NaN,44.04882054851772,-7.528916865587322,-0.055774007376712176,0.19591583732673,0.2516898447034422,82704643,77655536.6,51.30088444662743,69.45514548693296,NaN,NaN,11.917915170183658,17.53178573754856
2007-07-03T09:30:00-04:00,39.57001,39.66,39.5,39.60001,1674303,3276264.5,60.97132158902903,57.64198429515483,NaN,NaN,114.74072480511583,22.925841738902424,-0.02328236552631896,0.22258688779554348,0.24586925332186244,84378946,79571861.4,56.08718051756694,68.37776350455822,NaN,NaN,13.415529523283498,16.943749135510693
2007-07-05T09:30:00-04:00,39.60001,40.49001,39.41,39.56,1979173,3067648.15,60.19329935329745,57.54917524830531,NaN,NaN,144.33442320258655,59.35060483302148,-0.006491621588598978,0.23775472633611372,0.2442463479247127,82399773,80652991.6,58.56160914017973,67.32574871139859,NaN,NaN,14.396501826760922,16.579856662832153
2007-07-06T09:30:00-04:00,39.63,39.83,39.5,39.8,1566499,2857143.6,63.22474294427433,57.594112343421834,NaN,NaN,113.60764620006599,84.92477663176662,0.017462284936103495,0.26607420409484206,0.24861191915873856,83966272,82509196.6,62.471604382810256,66.4335750219906,NaN,NaN,16.14992216337965,16.518437448624653
2007-07-09T09:30:00-04:00,39.87,40.12,39.81,40.10001,2363355,2823741.35,66.64431918145328,57.90825401989756,NaN,NaN,160.95928884963067,115.53818072118335,0.04844011756089395,0.30916206610985597,0.260721948548962,86329627,83955852.2,65.22556265744589,65.69607607055622,NaN,NaN,18.73353810729172,16.834880399862804
2007-07-10T09:30:00-04:00,39.89999,40.17999,39.34,39.42999,2392001,2795311.4,54.46390471080425,57.25855616117962,NaN,NaN,78.08965408323017,122.34634742812584,0.020181048555127923,0.2859482592428719,0.265767210687744,83937626,84202448.8,65.68778688318997,64.84231557278834,NaN,NaN,17.065790534779413,16.867867561993748
2007-07-11T09:30:00-04:00,39.39999,39.85001,39.39149,39.85001,3833187,2831713.55,59.465316409487876,57.25785481973021,NaN,NaN,81.4653719326464,115.69127685363196,0.02579263388594555,0.29800800304517594,0.2722153691592304,87770813,84880822.2,66.98775891621926,64.0228004508974,NaN,NaN,17.373995333093912,16.94017152929377
2007-07-12T09:30:00-04:00,39.99001,40.96001,39.92999,40.44,3015000,2817738.55,65.24054456074582,57.59861180550745,NaN,NaN,223.09507408655847,131.44340703042636,0.06312782228471575,0.3511251470151251,0.28799732473040934,90785813,86558030.2,70.0127539120165,63.35126174168685,NaN,NaN,19.734960657985308,17.339427119106848
2007-07-13T09:30:00-04:00,40.5,40.8885,40.49899,40.72,3053200,2864339.3,67.59986658085003,58.41300191878395,NaN,NaN,223.0182827181039,153.3255343340339,0.09846285954555128,0.41107589916234843,0.31261303961679715,93839013,88532578.4,73.13393657514425,62.93232230891483,NaN,NaN,22.45098019524725,18.069648987126904
2007-07-16T09:30:00-04:00,40.7,41.11,40.7,40.98,2413635,2898360.95,69.65926490865897,59.50299265463916,NaN,NaN,207.08484099438144,162.55064476298406,0.1291911497306576,0.4741019767801191,0.3449108270494615,96252648,90517182.6,75.85422301819511,62.81082985580915,NaN,NaN,25.341045134551088,19.108419865330358
2007-07-17T09:30:00-04:00,41.08,41.44,40.99001,41.22,4281746,3035293.45,71.4624207568253,61.11871560903021,NaN,NaN,198.7399428106607,186.68070250847018,0.1538503863093516,0.537223809936151,0.38337342362679944,100534394,93836536.2,79.5786491445403,63.677125483563245,NaN,NaN,28.28308017975048,20.41908562453323
2007-07-18T09:30:00-04:00,41.10001,41.42,40.89,41.13,4158297,3061818.3,69.78747554397366,62.20393320368773,NaN,NaN,154.70245677979787,201.3281194779005,0.15200249452477743,0.5733765417827712,0.42137404725799377,96376097,95557593,81.19802623143215,65.06333524210143,NaN,NaN,30.09371565752208,21.801175629245925
2007-07-19T09:30:00-04:00,41.38,41.59,41.36,41.5,4174699,3164660.75,72.62785055244402,63.72568560940715,NaN,NaN,155.9352639629565,187.8961574531801,0.1626469986755278,0.6246827956024035,0.4620357969268757,100550796,97510589.6,82.85909718044596,67.13393544103829,NaN,NaN,32.55797711525618,23.33786155581882
2007-07-20T09:30:00-04:00,41.17,41.48,40.73,40.89999,4509383,3251244.9,62.38521354840075,64.3655777620825,NaN,NaN,98.08568579510265,162.90963806857985,0.11828901459395602,0.6098970651693207,0.4916080505753647,96041413,97951069.6,83.21918398458895,69.44130407074303,NaN,NaN,31.291426546357314,24.474085125895748
2007-07-23T09:30:00-04:00,41.19,41.37,41.02,41.17,1963600,3187509.9,64.79157692013621,64.89407982574149,NaN,NaN,97.61628950993384,141.01592777169031,0.09703489457026027,0.6129016687881901,0.5158667742179298,98005013,98301542.6,83.5159072626526,71.74237712903054,NaN,NaN,31.050108181957743,25.413516991047462
2007-07-24T09:30:00-04:00,41.07001,41.2,40.56,40.60001,7209504,3413883.65,56.5649453042409,64.57933866254233,NaN,NaN,56.59635634915098,112.58721047938839,0.03754800527453017,0.5628017808110926,0.5252537755365624,90795509,96353765.6,75.52329371138664,73.13067092858908,NaN,NaN,28.003158534222834,25.783465782929657
2007-07-25T09:30:00-04:00,40.85001,41.03999,40.28999,40.7,8328934,3472079.35,57.582419510039685,64.39284724516678,NaN,NaN,41.402790269962196,89.92727717742123,-0.00011306316942527594,0.5251124465747807,0.525225509744206,99124443,96903434.8,76.2150741326365,74.39163271376457,NaN,NaN,25.944056262035907,25.806407279944835
2007-07-26T09:30:00-04:00,40.13,40.59,39.37,39.85001,8377883,3781133.5,47.414422072198036,63.26353861144704,NaN,NaN,-31.309965683732013,52.478231248083524,-0.08274512107978127,0.4217941083944794,0.5045392294742607,90746560,94942587.6,68.75029613468936,74.84011069604165,NaN,NaN,20.434358437544194,25.038971731030458
2007-07-27T09:30:00-04:00,39.74001,40.00999,39.05,39.11,7648227,4048101.1,40.679539838031914,61.40891151548838,NaN,NaN,-88.23365940326572,15.214362208409856,-0.18202515540094694,0.277007785223077,0.45903294062402394,83098333,92353971.6,60.347159671517865,74.49165333990393,NaN,NaN,13.198652149000733,23.34749750502621
2007-07-30T09:30:00-04:00,39.42999,40.00999,39.3,39.95,6668410,4160966.5,49.45593367954837,61.0511992989701,NaN,NaN,-58.81001334772448,-16.070898363121803,-0.18528797620230386,0.22742297037114412,0.412710946573448,89766743,90706317.6,55.68201758597063,73.7769555329597,NaN,NaN,10.408980590581008,21.499137945819754
2007-07-31T09:30:00-04:00,40.11,40.59,39.31,39.41,9482395,4454671.55,44.86099565558526,60.0080335308342,NaN,NaN,-62.584143988974105,-39.906998430746825,-0.2158440925647257,0.14290583086754083,0.3587499234322665,80284348,88604085.4,50.33538004331518,72.58749989918083,NaN,NaN,6.460575497181681,19.3507718817286
2007-08-01T09:30:00-04:00,39.42999,40.28999,39.12,39.7,9594227,4850667.75,47.67275436728099,58.753191374158135,NaN,NaN,-71.12836368314706,-62.41322922136867,-0.20844470239813073,0.09819404543460308,0.3066387478327338,89878575,86754911.8,46.13863836473316,70.88220593151775,NaN,NaN,4.411492968295021,17.216589179809517
2007-08-02T09:30:00-04:00,39.89,40.14999,39.67,39.97,7948148,5149116.5,50.21806812810705,57.51163434181935,NaN,NaN,-47.32261333777144,-65.61575875217656,-0.17844468995451013,0.08358288538959613,0.26202757534410626,97826723,88170944.4,49.603750951870296,69.20147838699818,NaN,NaN,3.666705579652776,15.280891522644268
2007-08-03T09:30:00-04:00,40.03999,40.12,39.10001,39.14999,5419406,5341761.85,43.32528045300596,55.63063545212985,NaN,NaN,-96.2366175086763,-67.21635037325868,-0.20500687573326096,0.005768980677530067,0.21077585641079102,92407317,90032741.2,53.811213733493275,67.62697772380518,NaN,NaN,0.5732309089690535,13.179797149262095
2007-08-06T09:30:00-04:00,39.2,39.74001,39,39.74001,6602230,5553705.6,48.773582223123455,54.01000412829401,NaN,NaN,-85.86422768452627,-72.62719324061904,-0.1751766452442211,-0.008194950144485347,0.16698169509973576,99009547,91881302,57.59658952718973,66.05683060828014,NaN,NaN,-0.03335829030068435,11.29220351503884
2007-08-07T09:30:00-04:00,39.5,40.00999,39.25,39.74001,8034590,5835835.05,48.773582223123455,52.509011748233284,NaN,NaN,-68.02476915293082,-73.71531827341038,-0.14881892571212912,-0.01904196204042563,0.1297769636717035,99009547,95626341.8,64.02847976546072,64.83043443213933,NaN,NaN,-0.4934241465872601,9.608542420520827
2007-08-08T09:30:00-04:00,39.85001,40.05,39.39999,40.05,7222641,6005307.75,51.6081960682405,51.007607856504464,NaN,NaN,-51.94076216772951,-69.87779797032687,-0.10589739794456929,-0.0025947837590081235,0.10330261418556116,106232188,98897064.4,68.51955795595902,63.806181630390256,NaN,NaN,0.03324558973632323,8.240642873265898
2007-08-09T09:30:00-04:00,39.13,39.53,38.66,38.98,9365238,6322819.65,42.80374200936155,49.60893131800166,NaN,NaN,-116.97104149722745,-83.80748360221807,-0.1426703897803313,-0.07503537303985297,0.06763501674047834,96866950,98705109.8,67.98310417522013,62.717890215435354,NaN,NaN,-2.524252796966819,6.702800634661225
2007-08-10T09:30:00-04:00,38.17999,38.82001,37.67999,38.53,15654246,6952871.95,39.733622157449716,47.8190774063812,NaN,NaN,-163.06611027810533,-97.17338215610388,-0.18757453532300294,-0.16683315241327534,0.0207413829097276,81212704,96466187.2,61.89606575873925,61.17361582229868,NaN,NaN,-5.645800773656623,4.938714719187247
2007-08-13T09:30:00-04:00,39.02,39.27,38.77,39.05,6220102,7143195.3,44.67210190436602,46.96958859210442,NaN,NaN,-93.71219705014484,-98.74297602922759,-0.1728905267610525,-0.19537177554158802,-0.022481248780535527,87432806,94150839,56.28365721516519,59.79935607256858,NaN,NaN,-6.558745904967324,3.2962203443080225
2007-08-14T09:30:00-04:00,39.25,39.25,38.05,38.05,4621176,7160166.8,38.1908506409856,45.58447653002913,NaN,NaN,-140.08844989037584,-113.15571217671659,-0.218236374133904,-0.29527671644791553,-0.07704034231401152,82811630,90911255.6,49.51804286529435,57.892425267758426,NaN,NaN,-9.656218654210125,1.4458719159482873
2007-08-15T09:30:00-04:00,37.99001,38.45,37.36,37.60001,7857898,7345146.85,35.682084204210014,44.74645239660141,NaN,NaN,-184.38080680254797,-139.6437211036803,-0.26323290986768666,-0.40608147964861985,-0.1428485697809332,74953732,84655564.4,39.61524167907216,55.81134994950006,NaN,NaN,-13.00196788935006,-0.6181051990943334
2007-08-16T09:30:00-04:00,37.03,37.62,36.03999,37.62,14361445,7854484.15,35.883579440411424,44.403883796771375,NaN,NaN,-213.92569364804692,-159.03465153384417,-0.2750587243878252,-0.4866719752657147,-0.2116132508778895,89315177,83145209.8,37.65716149243158,54.19063579385104,NaN,NaN,-15.509499876125767,-2.7454472958131095
2007-08-17T09:30:00-04:00,38.59,38.81,37.55,38,11701402,8214085.1,39.74779421529829,43.71044526361066,NaN,NaN,-108.27146161502164,-148.07572180122744,-0.24187193311399213,-0.5139531672703797,-0.2720812341563875,101016579,87105984.8,45.29362119553344,53.448607480248384,NaN,NaN,-16.37675199828208,-4.6927765390229625
2007-08-20T09:30:00-04:00,38.17,38.66,37.97,38.55,11070422,8669426.2,44.92189358132422,43.71479511544915,NaN,NaN,-73.92106385922418,-144.11749516304332,-0.17081154109450347,-0.48559566052451686,-0.3147841194300134,112087001,92036823.8,53.01034692244495,53.63967654304337,NaN,NaN,-15.474395428987547,-6.233007809017903
2007-08-21T09:30:00-04:00,38.48,38.72,38.28,38.39999,4968121,8557357.05,43.81668676679381,43.43936171541436,NaN,NaN,-59.4453398586131,-127.98887315669076,-0.12402150182782812,-0.46981099671479853,-0.3457894948869704,107118880,96898273.8,59.13125775542816,54.56772078523586,NaN,NaN,-15.077373371070102,-7.496488603596789
2007-08-22T09:30:00-04:00,38.64999,39.2,38.64,39.09,4456301,8363725.4,49.920050324862615,43.41807472946832,NaN,NaN,-5.703691660607317,-92.25345012830263,-0.04100567659723564,-0.397046590633515,-0.35604091403627935,111575181,104222563.6,66.26176672674953,55.75757905487011,NaN,NaN,-12.807302930686973,-8.255176364609673
2007-08-23T09:30:00-04:00,39.28999,39.39999,38.61,38.88,3297300,8109696.25,48.20375752711956,43.766537377619294,NaN,NaN,-2.2750944953294856,-49.92333029775914,0.0030208673487391313,-0.35226482985035545,-0.3552856971990946,108277881,108015104.4,69.2531955216249,56.86057775402236,NaN,NaN,-11.467086930523053,-8.714020731168727
2007-08-24T09:30:00-04:00,38.75,39.37,38.75,39.2,4095000,7932034.9,50.97002038244216,43.92342581757064,NaN,NaN,14.807231809359441,-25.307591612882927,0.05411821760496405,-0.28763792519288955,-0.3417561427978536,112372881,110286364.8,70.916328279436,57.81198766489708,NaN,NaN,-9.513485743259892,-8.828230018610322
2007-08-27T09:30:00-04:00,39.3,39.39,39.11,39.11,3444800,7770854.4,50.15865166755188,44.02235934931552,NaN,NaN,29.26250105647827,-4.67087862974243,0.08068021620721161,-0.2409058725388391,-0.3215860887460507,108928081,109654580.8,69.78554652298212,58.22320671900576,NaN,NaN,-8.144858448286005,-8.730605508563992
2007-08-28T09:30:00-04:00,39.05,39.07001,38.12,38.17,4981898,7545829.55,42.54159410101366,43.37474492308503,NaN,NaN,-47.939131141634924,-2.369636886346794,0.03604260708547591,-0.2765328298892058,-0.3125754369746817,103946183,109020041.4,68.60237862078468,58.229122480779026,NaN,NaN,-9.216261498899534,-8.799984935754784
2007-08-29T09:30:00-04:00,38.39999,39.08,38.35001,39.07001,3397500,7235993.2,50.320565776565914,43.91166090645677,NaN,NaN,-0.0392852500502525,-1.2367556042353864,0.0664614316472002,-0.2294986474156815,-0.2959600790628817,107343683,108173741.8,66.97150180630913,58.15686516871394,NaN,NaN,-7.618256537874095,-8.6311665932004
2007-08-30T09:30:00-04:00,38.72,39.13,38.57001,38.83,2472300,6962200.8,48.43728491087117,44.53335110312974,NaN,NaN,8.347826170128636,0.8878285288562349,0.0694246775568062,-0.20917923211687395,-0.27860390967368015,104871383,107492442.2,65.61908415354256,58.42279505405704,NaN,NaN,-6.923275635606292,-8.387182170686955
2007-08-31T09:30:00-04:00,39.24001,39.55,39.03999,39.42,4389102,6910685.6,53.085478698419706,45.134306588419285,NaN,NaN,74.17108228865624,12.760598624715595,0.10783502668507716,-0.1438101263173337,-0.25164515300241086,109260485,106869963,64.34065211797787,58.99829468997224,NaN,NaN,-4.840338517336769,-7.880490220208357
2007-09-04T09:30:00-04:00,39.36,39.77,39.14,39.60001,5069602,6834054.2,54.43508867939434,46.29460930544848,NaN,NaN,95.97460527791806,26.10301946900355,0.14003901758769946,-0.07659638101778654,-0.216635398605486,114330087,107950364.2,65.59359611687844,60.14654849365682,NaN,NaN,-2.7434898291230128,-7.14663302148188
2007-09-05T09:30:00-04:00,39.22,39.35001,38.95,39.2,2298500,6547249.7,50.92898380288546,47.383673562496725,NaN,NaN,57.22998279871368,47.13684225707327,0.129330098358363,-0.054972775657532225,-0.18430287401589523,112031587,109567445,67.43777756324079,62.13387248538315,NaN,NaN,-2.0329644249474024,-6.416108936262669
2007-09-06T09:30:00-04:00,39.23,39.52,38.89,39.52,3230200,6347627.65,53.50875369434996,48.6426145806352,NaN,NaN,84.06073121066936,63.9568455492172,0.13794016433159037,-0.011877668601407265,-0.14981783293299764,115261787,111151065.8,69.17999072565019,64.38550314489876,NaN,NaN,-0.6651205703362957,-5.594539169701759
2007-09-07T09:30:00-04:00,39.03,39.08,38.57001,38.71001,6721602,6215445.85,46.80169830403855,49.14646487268807,NaN,NaN,11.356149417119276,64.55851019861532,0.08577992659881051,-0.0425929246844845,-0.128372851283295,108540185,111884826.2,69.98141991013156,66.14891733879863,NaN,NaN,-1.550438024550845,-5.0168104346802
2007-09-10T09:30:00-04:00,38.87,38.96001,38.21001,38.74001,5938602,5729663.65,47.066344238678205,49.29963991964193,NaN,NaN,-13.284253424133727,47.067443056057336,0.0516750552981704,-0.063779032160582,-0.11545408745875241,114478787,112928486.6,71.13129154714304,67.44327052627706,NaN,NaN,-2.176414419154317,-4.611039575319359
2007-09-11T09:30:00-04:00,38.64,39.19,38.64,39.09,4543199,5645818.5,50.180132597060364,49.75417176466097,NaN,NaN,38.65971523522092,35.604465047517905,0.05097800793703407,-0.05173157753745983,-0.1027095854744939,119021986,113866866.4,72.1637534121,68.37416307318219,NaN,NaN,-1.792671090961574,-4.20841550612539
2007-09-12T09:30:00-04:00,38.98,39.39,38.86,39.06,3671400,5598329.7,49.90912127940087,49.753391118556564,NaN,NaN,54.09845864188006,34.97816021615118,0.04689061451260926,-0.044096317333732316,-0.09098693184634157,115350586,114530666.2,72.90204237251818,68.84846847645137,NaN,NaN,-1.5560537783597055,-3.8295066878731494
2007-09-13T09:30:00-04:00,39.39999,39.64999,39.17999,39.47,3566100,5383739.8,53.59756907829251,50.138663372211774,NaN,NaN,102.30224263922008,38.62646250186132,0.06886538465933836,-0.004905201022168626,-0.07377058568150699,118916686,115261646,73.72837624825458,69.16812424263922,NaN,NaN,-0.30104113116039943,-3.325440179771328
2007-09-14T09:30:00-04:00,39.39999,39.61,39.16,39.53999,2426700,4787002.55,54.217328224651226,50.370613932369565,NaN,NaN,104.6526158697371,57.28575579238488,0.0841678582454666,0.03143923712532626,-0.05272862112014034,121343386,117822286.2,76.43883960558213,69.56258933736395,NaN,NaN,0.9088140364801045,-2.720546720306838
2007-09-17T09:30:00-04:00,39.49001,39.53999,39.2,39.2,2308200,4317342.45,50.67650915043917,50.40760375257579,NaN,NaN,71.91673776891942,74.32595403099552,0.06813028327342893,0.03243423297164583,-0.035696050301783105,119035186,118733566,77.33502872189311,70.10183806585758,NaN,NaN,0.9941197263812204,-2.1898800850656865
2007-09-18T09:30:00-04:00,39.41,40.62,39.41,40.47,5280898,4027866.25,60.93859690192888,51.7216753812126,NaN,NaN,239.06829986748787,114.40767095744891,0.13588060707652633,0.1341547085438748,-0.0017258985326515236,124316084,119792385.6,78.36475029938723,70.7991503286149,NaN,NaN,4.370145042330573,-1.2527336382947925
2007-09-19T09:30:00-04:00,40.92999,41.03999,40.66,40.89999,3263650,3942642.7,63.69290628834986,52.67684256062574,NaN,NaN,304.70266616610695,164.5285124622943,0.1986788034918477,0.24662260583215811,0.04794380234031041,127579734,122238215.2,80.56166234500388,71.76987608137881,NaN,NaN,8.077722997860816,0.08018873829886575
2007-09-20T09:30:00-04:00,40.75999,40.81,40.50999,40.56,7924500,4116052.65,60.085249433276715,53.50884002651185,NaN,NaN,206.88647549323753,185.44535903309776,0.20548996320589719,0.3048062563476819,0.09931629314178471,119655234,122385924.8,80.68919410858695,72.84631250673912,NaN,NaN,10.025784372729804,1.5009881146461426
2007-09-21T09:30:00-04:00,40.8,40.8,40.5,40.63,2176200,4059997.65,60.58031631161082,54.04418557031121,NaN,NaN,168.61925130360456,198.23868611987126,0.20254873151372824,0.352502207533945,0.14995347602021677,121831434,122483534.4,80.77893804532621,74.020475787264,NaN,NaN,11.738114754220605,2.9634347774424943
2007-09-24T09:30:00-04:00,40.69,40.73,40.21001,40.24001,4150102,4062752.75,56.38437561103523,54.183420351142715,NaN,NaN,114.34954462311228,206.72524749070982,0.16383193733881732,0.3547433976937384,0.1909114603549211,117681332,122212763.6,79.67280139005015,75.02613330677627,NaN,NaN,11.960318217939339,4.248703840370615
2007-09-25T09:30:00-04:00,40.25,40.60001,40.05,40.39999,10900926,4435559.05,57.679309089908465,54.665586443072925,NaN,NaN,93.56175995276628,177.6239395077655,0.13944570645947255,0.3652185934292618,0.22577288696978923,128582258,123065998.4,80.5754386972612,75.96453767349202,NaN,NaN,12.515466920264483,5.429669994641167
2007-09-26T09:30:00-04:00,40.64999,40.87,40.56,40.67999,7758199,4574374.1,59.92209294478524,55.1236821038183,NaN,NaN,112.69637384505374,139.22268104355484,0.13266153258307728,0.3915998026986358,0.25893827011555853,136340457,124818143,82.31240211898394,76.90256705873014,NaN,NaN,13.62840135562831,6.600917331925045
2007-09-27T09:30:00-04:00,40.94,40.99001,40.71001,40.86,3595800,4584289.1,61.34054191949474,56.16217093349375,NaN,NaN,110.482253546955,119.94183665429834,0.13058213395998908,0.4221659375655449,0.2915838036055558,139936257,128874347.6,85.53673813956937,78.01366121797571,NaN,NaN,14.962971489069488,7.795496497231394
2007-09-28T09:30:00-04:00,41.03,41.08,40.74001,41.08,3124626,4616905.4,63.061228849186264,57.30466269138718,NaN,NaN,106.66757448684437,107.55150129094632,0.1338150481096127,0.4588526137425717,0.325037565632959,143060883,133120237.4,88.0022391646287,79.21872890493897,NaN,NaN,16.58045328672502,9.050490324301911
2007-10-01T09:30:00-04:00,41.06,41.64,40.92,41.61,8254500,4810175.3,66.88513290050255,58.49787699877591,NaN,NaN,127.15914599802971,110.1134215659298,0.1596866265075464,0.524645848767392,0.36495922225984556,151315383,139847047.6,90.70551040026258,80.54314011837916,NaN,NaN,19.150108905241005,10.493292978721781
2007-10-02T09:30:00-04:00,41.67999,41.77,41.19,41.27,1351600,4624275.2,62.42094359063367,59.391578592435394,NaN,NaN,114.17134955390942,114.23533948615844,0.14250612453767203,0.5430918779319356,0.40058575339426356,149963783,144123352.6,91.94761491638403,81.90353815722672,NaN,NaN,20.06724516868359,11.861000434430611
2007-10-03T09:30:00-04:00,41.19,41.27,40.8775,40.99001,3975500,4708125.2,58.932617877578075,59.772653506670075,NaN,NaN,77.40184483555556,107.1764336842588,0.10274694067520918,0.529019429238275,0.4262724885630659,145988283,146052917.8,92.43864456597932,83.23998589420705,NaN,NaN,19.83604967361622,13.000293182885699
2007-10-04T09:30:00-04:00,41.14999,41.14999,40.92999,41.13,3475100,4720370.2,60.13224870245897,60.19514782651349,NaN,NaN,73.46907037398606,99.77379704966502,0.0774880799299969,0.523132588475562,0.4456445085455651,149463383,147958343,92.8991259928355,84.41572063615372,NaN,NaN,19.977883986164265,13.99709186906835
2007-10-05T09:30:00-04:00,41.52,41.75,41.3,41.58,2919900,4530285.1,63.79355961816988,61.13208000277997,NaN,NaN,108.41723620143541,100.12372939258321,0.08224935496702224,0.5484562022543429,0.46620684728732065,152383283,149822823,93.32734101880789,85.55802865736192,NaN,NaN,21.162243174425974,15.020684912690868
2007-10-08T09:30:00-04:00,41.52,41.67,41.34,41.50999,849600,4275835,62.826857972177,61.266955793511976,NaN,NaN,100.45665596443557,94.7832313858644,0.0722037893414752,0.5564615839641647,0.4842577946226895,151533683,149866483,93.33747312551837,86.62750885922843,NaN,NaN,21.869471926662438,15.999083057543949
2007-10-09T09:30:00-04:00,41.7,41.89999,41.45,41.89999,1840900,4140720.05,65.92460359206024,61.426362743777,NaN,NaN,120.46724816380208,96.04241110784292,0.08259638448593265,0.5875032752301053,0.5049068907441726,153374583,150548643,93.50345865710237,87.55192288152116,NaN,NaN,23.379099148486354,17.05337107053572
2007-10-10T09:30:00-04:00,41.99001,41.99001,41.25,41.44,1855000,4049900.05,59.61449521712503,61.3927374426233,NaN,NaN,94.62550677648609,99.48714349602903,0.05082179590148228,0.5684341356210254,0.5176123397195431,151519583,151654903,93.77433594028012,88.48657586949926,NaN,NaN,22.848186750034795,17.881201881892732
2007-10-11T09:30:00-04:00,41.75,41.791,40.96001,41.14,5550500,4149120.05,55.859220528157074,61.05551631523375,NaN,NaN,58.8576097474819,96.5648513707282,0.004377664789607882,0.523084420706553,0.5187067559169452,145969083,150956043,91.18764793107454,89.23005514705271,NaN,NaN,21.27650496297261,18.366245179189857
2007-10-12T09:30:00-04:00,41.14999,41.32001,40.87,41.32001,4771000,4266335.05,57.58570299730618,61.1413254142531,NaN,NaN,35.63902408313521,82.00920894706817,-0.018203234058472795,0.49595271334385416,0.514155947402327,150740083,150627403,89.931368708494,89.96280995551298,NaN,NaN,20.454356711450377,18.664546826655645
2007-10-15T09:30:00-04:00,40.31,41.74001,40.31,41,5630199,4432435,53.57400793617281,60.848089617557704,NaN,NaN,0.03626825491791112,61.925131405164635,-0.056512012610014706,0.4435159316398085,0.5000279442498232,145109884,149342643.2,85.00120386428762,90.27893603887203,NaN,NaN,18.565489414971683,18.65039576784365
2007-10-16T09:30:00-04:00,41,41,40.63,40.82001,4872855,4412032.85,51.40487073473789,60.23971660255432,NaN,NaN,-47.561426467102976,28.319396478983627,-0.09360596039039193,0.38302049376183334,0.47662645415222527,140237029,146715132.4,75.84370202279405,89.8168860320013,NaN,NaN,16.34842358343235,18.321542598642036
2007-10-17T09:30:00-04:00,40.95,41.17,40.42999,40.92999,7526230,4625161.85,52.6659901267635,59.62010576021637,NaN,NaN,-41.730409303706175,1.0482132629451726,-0.10927539484562815,0.34003221059519007,0.4493076054408182,147763259,145963867.6,73.4085189600764,88.95058466203753,NaN,NaN,14.839227483827026,17.82406901081132
2007-10-18T09:30:00-04:00,40.78,41.05,40.61,41.03999,3888600,4423366.85,53.95313428390837,58.96952757698224,NaN,NaN,-34.24371527343754,-17.572051741238713,-0.11044460468153522,0.3112518495888992,0.4216964542704344,151651859,147100422.8,74.73040075518841,88.00259620422035,NaN,NaN,13.909677230444114,17.26487018504458
2007-10-19T09:30:00-04:00,40.64,40.75,39.69,39.89999,5618699,4595491.8,41.39115023812123,57.14852881538358,NaN,NaN,-181.08332907630202,-60.916522373126156,-0.18198441690780875,0.19421593313567342,0.3762003500434822,146033160,146159038.2,71.55743000215767,86.63487617578429,NaN,NaN,8.85249249325158,16.063101943359865
2007-10-22T09:30:00-04:00,39.48,40.05,39.33,40.05,9143102,4845141.8,43.26315430905429,55.78011529527076,NaN,NaN,-215.71680886985817,-104.06713779808138,-0.21114072043720222,0.1122744494969794,0.3234151699341816,155176262,148172313.8,74.09103892739556,85.35940646228512,NaN,NaN,5.347354746383318,14.532280915220358
2007-10-23T09:30:00-04:00,40.3,40.37,39.97,40.32001,5009199,4550555.45,46.571141415834106,54.89715269086048,NaN,NaN,-137.91389175347277,-122.13763085535534,-0.204064088141509,0.06833505975729537,0.2723991478988044,160185461,152162000.2,78.22966404601436,84.34447928228761,NaN,NaN,3.4235370650111383,12.945317508047612
2007-10-24T09:30:00-04:00,40.28999,40.48,39.00999,40.2,7285898,4526940.4,45.30674359220222,53.838188040127854,NaN,NaN,-167.8825889588946,-147.36806678639303,-0.1990733842851526,0.023557417542363623,0.2226308018275162,152899563,153189261,79.15303369277115,83.36261554656872,NaN,NaN,1.4728160478031949,11.306388728012696
2007-10-25T09:30:00-04:00,40.37,40.49001,39.81,40.27,7023602,4698330.5,46.22385440948331,52.58320909665024,NaN,NaN,-106.25787939133856,-161.77089960997324,-0.18307199809313715,-0.00620919578890522,0.17686280230423193,159923165,154843522.2,80.58139029732735,82.45219049503442,NaN,NaN,0.12808967964211732,9.709488863959756
2007-10-26T09:30:00-04:00,39.53,40.75,39.53,40.3,4185102,4751354.3,46.63684242751183,51.42677941488845,NaN,NaN,-92.25310009804302,-144.00485381432142,-0.16314359706811682,-0.027066694030914107,0.1360769030372027,164108267,158458543.6,83.27776143606147,81.73363966007321,NaN,NaN,-0.8720395273415095,8.197841950916718
2007-10-29T09:30:00-04:00,40.37,40.56,40.2775,40.56,2597100,4468484.3,50.20596818010332,50.30401974260581,NaN,NaN,-49.79789868085579,-110.82107177652097,-0.12674859900019678,-0.02235884571304325,0.10438975328715352,166705367,160764364.6,84.73385817962713,81.10723962596784,NaN,NaN,-0.768522778889968,6.916932703801478
2007-10-30T09:30:00-04:00,40.39999,40.49001,40.19,40.2,2207283,4511268.45,45.6529154127167,49.30676404229092,NaN,NaN,-64.30426545510602,-96.0991465168476,-0.12121860872661802,-0.04713350762111901,0.07408510110549901,164498084,161626889.2,85.2512063284412,80.49844465369361,NaN,NaN,-1.9669518332035667,5.647806341372186
2007-10-31T09:30:00-04:00,40.10001,40.82001,40.10001,40.55,5443387,4584662.8,50.365718591818,48.91437104683814,NaN,NaN,-34.647479811170236,-69.45212468730273,-0.08973727557214184,-0.038086493359678286,0.05165078221246355,169941471,165035270.8,87.11013744979802,80.20719390503102,NaN,NaN,-1.6436647999383132,4.606167606899257
2007-11-01T09:30:00-04:00,40,40.42,39.84,39.86,6016383,4711726.95,42.53479289264518,47.83930603936235,NaN,NaN,-83.03545994035946,-64.80764079710688,-0.10980628793273679,-0.08560707770345743,0.024199210229279355,163925088,165835655.4,87.50830278060938,80.03411776732499,NaN,NaN,-3.833368695855629,3.400519563648559
2007-11-02T09:30:00-04:00,40.35001,40.35001,39.67999,40.22,6475305,4889497.2,47.15166135495447,47.380566997846756,NaN,NaN,-70.92220368274234,-60.54146151404675,-0.09387518962533555,-0.09314477680239008,0.000730412822945465,170400393,167094080.6,88.12918477701794,80.25754497537716,NaN,NaN,-4.205084580706361,2.3140046858835706
2007-11-05T09:30:00-05:00,39.97,40.44,39.69,40.05,7972086,5245621.5,45.30077701739023,46.9445603037505,NaN,NaN,-68.51328882468162,-64.28453954281191,-0.08982445516464775,-0.11155015613286423,-0.021725700968216476,162428307,166238668.6,85.03519451385202,80.91408015330987,NaN,NaN,-5.079727375844267,1.2577572484938797
2007-11-06T09:30:00-05:00,40.53999,40.7,40.12,40.67999,4168816,5362017.3,52.70923818787115,46.94764945097247,NaN,NaN,0.32700626773243735,-51.35828519824422,-0.042174227815702896,-0.0744434857378451,-0.0322692579221422,166597123,166658476.4,85.30780695044584,81.7640292954791,NaN,NaN,-3.4225101414992487,0.5891476213520043
2007-11-07T09:30:00-05:00,40.53999,40.53999,39.67,39.7,10259605,5782247.55,42.96158957175208,46.16253911438988,NaN,NaN,-80.0877119398024,-60.44633162397065,-0.07234362543984751,-0.12269878972195158,-0.05035516428210408,156337518,163937685.8,75.68476550342963,81.83219820606777,NaN,NaN,-5.40776067474028,-0.2675535638040363
2007-11-08T09:30:00-05:00,39.89,39.92,39.23,39.71001,8635711,5936508.1,43.07738597725347,46.2829845243279,NaN,NaN,-135.1338582955093,-70.86601129500065,-0.08636295376895048,-0.15830885649329218,-0.0719459027243417,164973229,164147314,75.91023891793603,82.14311312862337,NaN,NaN,-6.87076356727037,-1.210869278584941
2007-11-09T09:30:00-05:00,39.25,39.39999,38.92,38.92,5710832,5983499.7,36.738259254707884,45.816920591874585,NaN,NaN,-220.02529689738327,-100.68662993792884,-0.14038338395223718,-0.24742513266463817,-0.10704174871240099,159262397,161919714.8,68.62761600155034,81.75286863392013,NaN,NaN,-10.398014766532539,-2.5233186340060265
2007-11-12T09:30:00-05:00,38.75,39.25,38.5,38.5,5374145,5970697,33.88349847151423,44.91066038156602,NaN,NaN,-243.3361002868567,-135.65119223036385,-0.19271075369503887,-0.3479301908311996,-0.1552194371361607,153888252,160211703.8,63.59011259869321,80.70718638768291,NaN,NaN,-14.259871318763768,-4.199969017542847
2007-11-13T09:30:00-05:00,38.8,39.50999,38.8,39.48,4289598,5941534.15,44.6844049316499,44.866207620097995,NaN,NaN,-133.16480776597743,-162.34955503710583,-0.15144990263120245,-0.34453181542516376,-0.1930819127939613,158177850,158527849.2,58.99270157487264,79.26716266497588,NaN,NaN,-13.674675524158856,-5.553498518487991
2007-11-14T09:30:00-05:00,39.72,39.85001,39.21001,39.35001,5032984,5816871.85,43.66544574557602,44.68346414410462,NaN,NaN,-85.46636919156087,-163.42528648745753,-0.1241845135616837,-0.3483125547460659,-0.22412804118438223,153144866,157889318.8,57.300909718602234,77.60427119506696,NaN,NaN,-13.577734416821915,-6.699817932535694
2007-11-15T09:30:00-05:00,39.63,39.63,38.64,38.8,3506769,5797780.3,39.55535490265846,44.1776436066151,NaN,NaN,-138.08304755573468,-164.0151243395026,-0.1336421592123459,-0.39118074019981464,-0.25753858098746873,149638097,154822292.4,49.89874289652391,75.22005558509998,NaN,NaN,-14.907911155942774,-7.872402678736705
2007-11-16T09:30:00-05:00,38.82001,38.97,38.34,38.81,7695289,5901609.8,39.66655003611694,43.42482802490178,NaN,NaN,-154.96285884675294,-151.00263672937652,-0.1295781787407715,-0.4195113044134331,-0.2899331256726616,157333386,154436490.2,49.040550704367625,72.67053362258146,NaN,NaN,-15.895644274183173,-9.018580049514771
2007-11-19T09:30:00-05:00,38.42,38.56,38.08,38.25,7974262,5843167.8,35.705291058113474,42.71428342814441,NaN,NaN,-169.64913804179446,-136.26524428036407,-0.15333287904069232,-0.481599224473527,-0.32826634543283467,149359124,153530664.6,46.99680046635737,69.93807606100404,NaN,NaN,-18.028844515477086,-10.305760687509387
2007-11-20T09:30:00-05:00,38.03999,38.75999,37.8,38.31,7125461,5948980.9,36.43770446712376,41.719425276380534,NaN,NaN,-144.36406966174047,-138.50509665951668,-0.15336210065393263,-0.5199689712502504,-0.3666068705963178,156484585,153192011.6,46.22125153622547,67.01744135289171,NaN,NaN,-19.493760501996547,-11.618332089578981
2007-11-21T09:30:00-05:00,37.82001,38.10001,37.62,37.67,4936680,5831520,32.22134075556025,40.982750123731606,NaN,NaN,-163.00568790717264,-154.01296040263904,-0.18284194144302707,-0.5951592974001017,-0.4123173559570746,151547905,152872619.4,45.45931662046385,64.01394234145273,NaN,NaN,-22.1297610553534,-13.119964798975326
2007-11-23T09:30:00-05:00,37.64,38.28999,37.64,38.17,1069052,5533792.5,38.23456343662036,40.345814558136325,NaN,NaN,-122.53076749706429,-150.90250439090497,-0.15606660728914556,-0.6074006150685065,-0.45133400777936095,152616957,153468391.4,47.20750733483623,61.0909653812969,NaN,NaN,-22.43861905792455,-14.451201121682358
2007-11-26T09:30:00-05:00,38.56,38.62,37.57001,37.57001,3644311,5506752.95,34.30186425093643,39.56017793196105,NaN,NaN,-116.85812913337027,-143.2815584482284,-0.16527831124108544,-0.6579318968307177,-0.4926535855896323,148972646,151796243.4,43.03786974416215,58.09115646917619,NaN,NaN,-23.989116060602008,-15.81376039867088
2007-11-27T09:30:00-05:00,37.50999,38.45,37.50999,38.32001,6404246,5697110.25,42.292297234370174,38.81611072099669,NaN,NaN,-92.46130031395181,-127.84399090265988,-0.11003319006930234,-0.6301950731762602,-0.5201618831069579,155376892,152999797,46.687836849062755,55.33258717622025,NaN,NaN,-22.607508262702176,-16.784295807818207
2007-11-28T09:30:00-05:00,38.25,39.49001,38.25,39.25,5381199,5855806.05,50.3552209040641,39.34422724473326,NaN,NaN,-11.51866870435402,-101.2749107111826,-0.005546490978110996,-0.5270949968295966,-0.5215485058514856,160758091,153854498.2,49.17832928287479,53.439270303323475,NaN,NaN,-18.51241858402712,-17.031170490133768
2007-11-29T09:30:00-05:00,38.78999,39.44,38.78999,39.25,3274457,5747359.55,50.3552209040641,39.86407259664831,NaN,NaN,10.227877065708535,-66.62819771660637,0.06498936216372708,-0.4403118031468267,-0.5053011653105538,160758091,155696535.4,54.14963514693169,51.88494146253745,NaN,NaN,-15.40711326697634,-16.79916231539699
2007-11-30T09:30:00-05:00,39.96001,39.96001,39.12,39.39999,6791730,5786126.9,51.61961220874392,40.92702637907946,NaN,NaN,48.25431946229611,-32.47118032473428,0.11997176431867579,-0.3553364599122091,-0.47530822423088487,167549821,158683108.2,60.83833998125662,51.32856460394505,NaN,NaN,-12.530095551409701,-16.189295634827378
2007-12-03T09:30:00-05:00,39.64999,39.64999,39,39,3348610,5629792.15,48.10128589402507,41.94258262354452,NaN,NaN,25.478529035498134,-4.0038486909606075,0.12695141767526247,-0.3166189521368068,-0.44357036981206927,164201211,161728821.2,66.24616803532984,51.51828284941909,NaN,NaN,-11.185791466224419,-15.474509325026956
2007-12-04T09:30:00-05:00,38.89,39.08,38.8,38.91,3113915,5386883.6,47.319762479638555,42.130822448400856,NaN,NaN,-0.059975446052672576,14.47641628261923,0.12297148273686748,-0.2898560163909849,-0.4128274991278524,161087296,162870902,68.02900049378422,52.163732772198486,NaN,NaN,-10.32839560617142,-14.739350222333307
2007-12-05T09:30:00-05:00,39.53999,39.56,39.24001,39.55,2815711,5319228.35,53.1491739109255,42.80823160306867,NaN,NaN,74.22827332316062,31.625804688122145,0.15863754264685387,-0.21453057081928506,-0.37316811346613893,163903007,163499885.2,69.00012364675091,52.999390909923385,NaN,NaN,-7.7713463721840546,-13.743921100883414
2007-12-06T09:30:00-05:00,39.7,40.22,39.42,40,2220067,4917251.45,56.771321685909804,44.03794351615806,NaN,NaN,131.53415688262504,55.88706065150545,0.20479634708726419,-0.11717267960705868,-0.32196902669432287,166123074,164572881.8,70.63859521109642,54.480808932392854,NaN,NaN,-4.465305485124627,-12.418404584346444
2007-12-07T09:30:00-05:00,40.17999,40.37,40.16,40.3,3432328,4657082.3,59.04460445745896,45.42209026053963,NaN,NaN,170.31235027496245,80.29866681403873,0.24507265784483567,-0.015628204388278277,-0.26070086223311395,169555402,164973998,71.25033713300343,56.06722224872398,NaN,NaN,-1.0142853972131982,-10.789244700470267
2007-12-10T09:30:00-05:00,40.38,40.59,40.22,40.49001,2496033,4496342.35,60.46277220602899,47.19048177110502,NaN,NaN,163.52928573317556,107.9088181535742,0.27197270975784615,0.07926502496419374,-0.1927076847936524,172051435,166544042.8,73.57142551240844,57.96540975201334,NaN,NaN,2.2569797654920847,-8.925498348189931
2007-12-11T09:30:00-05:00,40.82001,40.82001,39.2,39.2,8748418,4665056,48.24773683508314,48.03405551167356,NaN,NaN,77.69068102719532,123.4589494482238,0.1940073369733959,0.049801486423092456,-0.14420585055030344,163303017,166987187,74.20445129573277,59.9642097348353,NaN,NaN,1.3496929366010204,-7.457613878934081
2007-12-12T09:30:00-05:00,40,40.36,39.2,39.7,4597652,4680458.7,52.272471289920844,49.466279121270745,NaN,NaN,73.54869297078892,123.32303337774947,0.16819349568812925,0.06603601905985812,-0.10215747662827113,167900669,167786719.4,75.3515807083242,62.09937145539675,NaN,NaN,1.9327716692561336,-6.116130229192622
2007-12-13T09:30:00-05:00,39.17999,39.99001,39.17999,39.89999,3178241,4587721.55,53.81946933067549,50.579486685131826,NaN,NaN,64.6844343162993,109.95308886448433,0.1568911438983605,0.0939564532446795,-0.062934690653681,171078910,168777886.6,76.73293411217084,64.20833051092066,NaN,NaN,2.8888279104244097,-4.8297076378187604
2007-12-14T09:30:00-05:00,39.27,39.91,39.27,39.46001,5104934,4667629.8,49.981188611570694,51.69943842517713,NaN,NaN,45.89900121883499,85.07041905325883,0.1140778235810137,0.07966258882258614,-0.03441523475842757,165973976,168061601.4,73.52606812994716,66.38605896704816,NaN,NaN,2.477532845718242,-3.785816140170617
2007-12-17T09:30:00-05:00,39.22,39.28,38.62,38.75,5244152,4545072.95,44.4696003883177,51.854960079030526,NaN,NaN,-21.260191317216265,48.11252364318047,0.036265693459990186,0.010916882066560163,-0.02534881139343002,160729824,165797279.2,64.36796158406128,67.64892501954805,NaN,NaN,0.31599201840931374,-3.1998435460877697
2007-12-18T09:30:00-05:00,38.73,39.00999,38.37,38.86,5743613,4433540.5,45.47282025136446,51.506217175266265,NaN,NaN,-38.776128477687905,24.819161742203818,-0.007155506511035907,-0.0342931945322249,-0.027137688021188995,166473437,166431363.2,65.65794429981155,68.82604037790068,NaN,NaN,-1.0963188017272454,-2.8993400111791234
2007-12-19T09:30:00-05:00,39.21001,39.21001,38.44,38.73,3489583,4251746.6,44.45075225611782,51.084469414698674,NaN,NaN,-38.183710141838574,2.472681119678319,-0.0420448571439544,-0.079693759451132,-0.037648902307177594,162983854,165448000.2,61.91437018965626,69.38066430952385,NaN,NaN,-2.548426536459551,-2.849209514790613
2007-12-20T09:30:00-05:00,38.78,39.05,38.56,39.05,3717476,4190786.4,47.57440383924536,50.7955259597345,NaN,NaN,-37.39056557216359,-17.94231885801426,-0.040943875036860575,-0.08882874610325331,-0.047884871066392734,166701330,164572484.2,58.70507469820433,69.22828821787726,NaN,NaN,-2.8724577254497676,-2.8525306877419205
2007-12-21T09:30:00-05:00,39.67999,39.67999,39.10001,39.55,2760790,4275373.3,52.10618133976088,51.0815899201442,NaN,NaN,23.3685030631599,-22.448418489149276,-0.00576206605779913,-0.05508745363864165,-0.04932538758084252,169462120,165270113,60.46364553031687,68.81525089609063,NaN,NaN,-1.8043412640132366,-2.7027893414949657
2007-12-24T09:30:00-05:00,40.03,40.03,39.578,39.99001,891176,4137716.55,55.73266561002837,51.68251157231489,NaN,NaN,73.2518630428432,-3.5460076171373798,0.045121367649084414,0.007076321980513001,-0.03804504566857141,170353296,167194807.4,64.90422895845751,68.59205292928158,NaN,NaN,0.2086065947786029,-2.2868756363130274
2007-12-26T09:30:00-05:00,39.94,39.94,39.59,39.84,2219351,3928471.8,54.22519179519636,51.75936999261995,NaN,NaN,57.11587747973607,15.632393574347414,0.06542234313886008,0.043732883255003685,-0.021689459883856392,168133945,167526909,65.62172799800632,68.35073895437124,NaN,NaN,1.4295722030130227,-1.755954516409306
2007-12-27T09:30:00-05:00,39.59,39.96001,39.3,39.38,2490919,3783957.8,49.77880976669106,51.2599048555329,NaN,NaN,12.42166513012945,25.753468628741018,0.04555866725744177,0.03525887418794582,-0.010299793069495949,165643026,168058743.4,66.79255345960588,68.07602168640763,NaN,NaN,1.1825863441413258,-1.336162964902073
2007-12-28T09:30:00-05:00,39.55,39.66,39.24001,39.34,1541381,3697304,49.39948175628432,50.57096751973471,NaN,NaN,-13.861813344269507,30.459219074319833,0.02826143411320728,0.025026999572013153,-0.0032344345411941273,164101645,167538806.4,64.4805122203581,67.59246276407582,NaN,NaN,0.8744149704165668,-1.0203661169994103
2007-12-31T09:30:00-05:00,39.53999,39.53999,39.05,39.16,2378223,3476628.65,47.640177423414585,49.65506789240511,NaN,NaN,-40.27052508784628,17.7314134441186,0.004480660640606283,0.002366391259563727,-0.0021142693810425562,161723422,165991066.8,58.03991485597866,66.48306914575942,NaN,NaN,0.1269437729130329,-0.8564647041547755
2008-01-02T09:30:00-05:00,39.05,39.21001,38.22,38.50999,7781430,3698269.65,41.84467613534134,49.197706413852124,NaN,NaN,-132.2378863569987,-23.366536435849792,-0.05212239536434991,-0.06726726358647994,-0.015144868222130032,153941992,162708806,47.25927372644802,64.55841360509622,NaN,NaN,-2.270156996568073,-1.0584207459281036
2008-01-03T09:30:00-05:00,38.75999,38.81,38.49001,38.53999,5334691,3809308.45,42.194198495075746,48.4778297856489,NaN,NaN,-129.20892084318498,-60.631496100434006,-0.08281514940445048,-0.11866380497769313,-0.035848655573242655,159276683,160937353.6,42.65435197011515,62.22289726665271,NaN,NaN,-4.129231225154627,-1.4971079572461785
2008-01-04T09:30:00-05:00,38.14,38.31,37.55,37.75,12500258,4293535.8,36.04987260860355,47.20857287692947,NaN,NaN,-192.49277644191244,-101.61438441484238,-0.14779995693136014,-0.22059860173744283,-0.0727986448060827,146776425,157164033.4,34.8620321630475,59.232118556001055,NaN,NaN,-7.751569297537513,-2.3906024344306545
2008-01-07T09:30:00-05:00,37.73,37.89999,37.03999,37.28,8542777,4609671.3,32.97344453722087,45.99373401447592,NaN,NaN,-202.85031525979247,-139.41208479794696,-0.21011386799974774,-0.33544097980576737,-0.12532711180601963,138233648,151990434,27.455880298200555,55.94139085373344,NaN,NaN,-11.838346232411723,-3.7402801198565214
2008-01-08T09:30:00-05:00,37.45,37.53999,36.25999,36.45,10547746,4965442.2,28.369230497172595,44.84370759367984,NaN,NaN,-223.0573722920829,-175.9694542387943,-0.28998258169225677,-0.4878053389213406,-0.19782275722908382,127685902,145182930,21.103076100820005,52.851041890644765,NaN,NaN,-17.055897413286992,-5.64251116177516
2008-01-09T09:30:00-05:00,36.35001,36.8,35.91,36.56,11917078,5436494.45,29.768882412403457,43.72199774803977,NaN,NaN,-213.86452450620814,-192.29478186863616,-0.31601792267824147,-0.5928451605768856,-0.27682723789864416,139602980,142315127.6,19.09827938789924,49.525351539793895,NaN,NaN,-20.769876503675334,-7.803563353475185
2008-01-10T09:30:00-05:00,36.44,37.44,36.31,37.07001,14380410,5718094.05,36.01184462963302,43.11921863186228,NaN,NaN,-141.71049735656447,-194.79509717131208,-0.28069876050832904,-0.6277006885340555,-0.34700192802572644,153983390,141256469,18.403238706183515,46.417413576688695,NaN,NaN,-21.996007450305996,-9.831055367308158
2008-01-11T09:30:00-05:00,36.87,37.12,36.24001,36.44,8846934,5930558.15,32.20364589427055,42.02130735007837,NaN,NaN,-139.53736762315626,-184.20401540756083,-0.28088891708833874,-0.6981130743861499,-0.41722415729781115,145136456,140928475.2,18.182457072945354,43.522940889170194,NaN,NaN,-24.290343212611482,-11.896667916637204
2008-01-14T09:30:00-05:00,36.58,36.94,36.5,36.89,4419777,5992634.95,37.30360355702462,40.9639803655972,NaN,NaN,-107.77832487553852,-165.18961733071006,-0.2337617406490936,-0.7094263331091781,-0.4756645924600845,149556233,143192992.2,24.882880415786957,40.98145766670377,NaN,NaN,-24.56245795239516,-13.706066493174054
2008-01-15T09:30:00-05:00,36.49001,36.66,35.92,36.12,13396063,6407191.4,32.76214409152199,39.323228828561035,NaN,NaN,-122.39353949438392,-145.05685077117025,-0.23677222059083092,-0.7716298681986231,-0.5348576476077922,136160170,144887845.8,29.534193015779138,38.45502652794103,NaN,NaN,-26.31372749787665,-15.507160922417281
2008-01-16T09:30:00-05:00,35.82001,36.39,35.66,35.7,8588047,6574386.15,30.57557813817769,37.63397071020256,NaN,NaN,-121.62086232501264,-126.60811833493116,-0.24817436377022217,-0.8450756023205699,-0.5969012385503477,127572123,142481674.4,26.97997911271156,35.694901607562834,NaN,NaN,-28.468988445602623,-17.358850568586615
2008-01-17T09:30:00-05:00,36.11,36.16,34.49001,34.75,12869098,6930660.4,26.29991392494405,35.95690672150635,NaN,NaN,-141.56232564238647,-126.57848399209556,-0.29749624195464763,-0.9687715409936573,-0.6712752990390096,114703025,134625601.4,20.688810659977776,32.40177712187511,NaN,NaN,-31.849515911386916,-19.428945617558085
2008-01-18T09:30:00-05:00,34.88,35.56,34.63,34.67999,8142973,7163329.9,26.011237654367193,34.286317857083695,NaN,NaN,-130.85179696727022,-124.84136986091835,-0.31116298096229156,-1.060229025241874,-0.7490660442795825,106560052,126910320.6,16.595981953926994,28.98145353141575,NaN,NaN,-34.557009874239924,-21.59009765422692
2008-01-22T09:30:00-05:00,32.72,35.17,32.39999,34.8,10142703,7484591.25,27.48067990885403,32.8463537489008,NaN,NaN,-148.6662883492119,-133.01896255565302,-0.2889295005927218,-1.1102279200204848,-0.8212984194277629,116702755,120339625,14.04725255232536,25.83912050972623,NaN,NaN,-36.27077509050285,-23.687337287980625
2008-01-23T09:30:00-05:00,33.75,35.85001,33.75,35.75,11973262,7945214.85,37.98099659521012,32.570376638891425,NaN,NaN,-95.73876633396283,-127.6880079235688,-0.19173342243209346,-1.0609651974678798,-0.8692317750357863,128676017,118842794.4,13.537221862095635,23.430402519415342,NaN,NaN,-34.37123458744842,-25.21360833076174
2008-01-24T09:30:00-05:00,36.10001,36.17,35.64,35.96001,7188422,8260077.15,40.047596134043346,32.417047898817685,NaN,NaN,-54.81279454801679,-114.32639436816962,-0.09943485306399646,-0.9935253413657819,-0.8940904883017854,135864439,120501257.6,17.127540686067462,21.607058856269077,NaN,NaN,-32.19025386638123,-26.210271978707382
2008-01-25T09:30:00-05:00,36.50999,36.50999,35.75,35.8,16851968,8991708,38.98177341985801,32.62646938533586,NaN,NaN,-45.57954344077206,-95.12983792784675,-0.038431570671047854,-0.9421299516405952,-0.9036983809695474,119012471,121363146.8,19.009745487319492,20.474752665145644,NaN,NaN,-30.736826954980636,-26.85692268960356
2008-01-28T09:30:00-05:00,36.02,36.44,35.7226,36.33,11629703,9448647.2,44.27223508340166,33.433525852920205,NaN,NaN,-32.59726001818535,-75.47893053802977,0.04388095880444465,-0.8488471824639916,-0.8927281412684362,130642174,126179571.2,28.748603281691388,20.567090021109276,NaN,NaN,-27.847813046421066,-26.998478454863204
2008-01-29T09:30:00-05:00,36.75,36.75,36.41,36.64999,5273953,9635275.8,47.24618131925637,34.78187948306905,NaN,NaN,2.053846797318464,-45.33490350872369,0.12173239155278082,-0.7405626518274602,-0.862295043380241,135916127,130022245.6,35.4206969821295,21.5897772269171,NaN,NaN,-24.525018533204086,-26.64512703748333
2008-01-30T09:30:00-05:00,36.75999,37.5,36.46001,36.8,6795141,9856121.7,48.6301872728314,36.12911554452818,NaN,NaN,36.07794594388262,-18.971561053154602,0.18158141531027194,-0.6353182742424011,-0.816899689552673,142711268,132829295.8,39.85161772335921,23.072158536592806,NaN,NaN,-21.386193302589913,-25.893850789641412
2008-01-31T09:30:00-05:00,36.3,37.49001,36.14,37,9120918,9923096.1,50.49496840367807,37.163624385531406,NaN,NaN,43.84946741690792,0.7608913398303472,0.22978587739434242,-0.5296673428097449,-0.7594532202040873,151832186,136022845.2,44.51582560650095,24.937343315186904,NaN,NaN,-18.2176772687037,-24.797254572364597
2008-02-01T09:30:00-05:00,37.35001,37.85001,37.24001,37.85001,8863281,10099525.6,57.548291519750016,38.9739562159228,NaN,NaN,121.27231846273021,34.131263720530804,0.309123187420244,-0.37304923592878225,-0.6821724233490263,160695467,144359444.4,54.446442228722965,27.52762796917102,NaN,NaN,-13.088828895103804,-23.124622332755912
2008-02-04T09:30:00-05:00,37.99001,37.99001,37.44,37.44,7162840,9832654.7,53.58256267971157,40.13673901040045,NaN,NaN,122.1249047784357,65.07569667985501,0.32269888346549735,-0.27879881901715464,-0.601497702482652,153532627,148937535,58.80671499754614,29.95075901072525,NaN,NaN,-9.94454811089527,-21.24175458677582
2008-02-05T09:30:00-05:00,36.57001,37.0692,36.42999,36.49001,8321547,9821593.2,45.72089669723049,41.06236419652248,NaN,NaN,38.21837650094349,72.30860262058002,0.2591490553234268,-0.27756138332836855,-0.5367104386517954,145211080,150796525.6,60.461673595901,32.159864766448244,NaN,NaN,-9.661714579922933,-19.587463157225407
2008-02-06T09:30:00-05:00,36.71001,36.92,36.25,36.42999,5560336,9572222.7,45.268985079874966,42.11189326378657,NaN,NaN,27.02643396719905,70.4983002252433,0.20679498294302923,-0.27821670997300885,-0.4850116929160381,139650744,150184420.8,59.61243284053504,34.490754318435634,NaN,NaN,-9.578682047391375,-18.157637284391974
2008-02-07T09:30:00-05:00,36.23,36.60001,36.06,36.44,7200426,9336390.1,45.365974583500865,43.47375473939777,NaN,NaN,10.88652229048791,63.905711199959306,0.16820050376209583,-0.2747610632134183,-0.44296156697551414,146851170,149188217.6,58.18013859955926,37.16870631412003,NaN,NaN,-9.484197248720537,-16.9185744221532
2008-02-08T09:30:00-05:00,36.3,36.53,35.95,36.17,7242699,8979504.55,43.14503652637101,44.69759751596947,NaN,NaN,-0.41888707906877387,39.5674700915995,0.12200051038686449,-0.29046092899193354,-0.41246143937879803,139608471,144970818.4,52.436220452246296,39.72872334971426,NaN,NaN,-10.04277326709379,-15.936317114287569
2008-02-11T09:30:00-05:00,36.03999,36.62,35.94,36.53,5167363,8795526,46.879207240612764,46.08320661109509,NaN,NaN,16.302693981856827,18.4030279322837,0.11338247241632993,-0.2707333488583856,-0.38411582127471555,144775834,143219459.8,50.21896222006048,42.312416897409626,NaN,NaN,-9.454082645844792,-15.010283618795743
2008-02-12T09:30:00-05:00,36.82001,37.14999,36.55,36.89999,10939953,9121534.8,50.47907618631517,46.97592658188831,NaN,NaN,68.55825814058487,24.47100426021198,0.1291509646730306,-0.22267711543342728,-0.3518280801064579,155715787,145320401.2,52.79749966516628,45.11672245477182,NaN,NaN,-7.902304145712822,-13.994857979783898
2008-02-13T09:30:00-05:00,36.91,37.56,36.62,37.56,5794629,8741463.1,56.183421612830394,48.128485544658815,NaN,NaN,96.26032617312067,38.31778270139631,0.17759188889762084,-0.12983821898443182,-0.30743010788205266,161510416,149692335.6,57.70684883979389,48.01524446575228,NaN,NaN,-4.764389950034575,-12.676219689819709
2008-02-14T09:30:00-05:00,37.69,37.7,36.82001,37,6746168,8649369.15,50.83303334466143,48.975004110716206,NaN,NaN,81.07146382598697,52.354771008496115,0.16570895134467273,-0.10029391870121174,-0.26600287004588447,154764248,151274951.2,59.3548376903915,50.89703676597171,NaN,NaN,-3.6989763287937767,-11.39375635253029
2008-02-15T09:30:00-05:00,36.62,36.92999,36.5428,36.77,6852477,8348538.1,48.77842348973368,49.296874711168485,NaN,NaN,35.32308721785641,59.50316586788116,0.13732125395936517,-0.09435130259667801,-0.23167255655604319,147911771,152935611.2,61.06906732625602,53.20564134058346,NaN,NaN,-3.4452722494468233,-10.258258623518365
2008-02-19T09:30:00-05:00,37.02,37.27,36.64999,36.95,5918609,8237319.9,50.465821971526964,49.52684904347353,NaN,NaN,51.919782054369556,66.62658348238371,0.12592908211708048,-0.0742612039096926,-0.20019028602677308,153830380,154746520.4,62.906286960902314,55.16889776763867,NaN,NaN,-2.742300700627808,-9.184550348819714
2008-02-20T09:30:00-05:00,36.83,37.14,36.39999,37.07001,4769559,7968662.7,51.610402456577624,49.73972155659827,NaN,NaN,33.371352900469056,59.58920243436055,0.12167113339636876,-0.048101369281312145,-0.1697725026776809,158599939,155323350.8,63.497206727236424,56.85786841077276,NaN,NaN,-1.83710799384177,-8.134915726680008
2008-02-21T09:30:00-05:00,37.42999,37.45,36.50999,36.78,6812980,7710648.6,48.6828951044379,49.61028774950968,NaN,NaN,31.67470632724829,46.67207846518607,0.09566415458018018,-0.050192309452455675,-0.14585646403263586,151786959,153378659.4,60.025438022472045,57.9656978690564,NaN,NaN,-1.8866866431232852,-7.242311571886191
2008-02-22T09:30:00-05:00,36.78,37.14999,36.19,37.14999,6112488,7656851.9,52.39305604191458,49.242056643950015,NaN,NaN,9.956029878261786,32.44899167564103,0.09929025401342191,-0.021743646515858472,-0.12103390052928038,157899447,154005699.2,60.77024015252269,58.41739772075639,NaN,NaN,-0.871217961625549,-6.3321553418489565
2008-02-25T09:30:00-05:00,37.28,37.49001,36.692,37.44,5766875,7102597.25,55.13135716922365,49.3526848217723,NaN,NaN,79.97324756903828,41.379023745877404,0.1159692673557602,0.023927683665419863,-0.09204158369034034,163666322,157156609.4,64.36341895976803,58.81430514662937,NaN,NaN,0.7832959245003968,-5.315662303799049
2008-02-26T09:30:00-05:00,37.25,37.78,37.14999,37.47,6428664,6842545.3,55.417032565206426,50.045265955199156,NaN,NaN,124.37498002810793,55.87006334062507,0.12309770463147754,0.061830547099006594,-0.06126715753247095,170094986,160409530.6,67.65698160217454,59.32825571850606,NaN,NaN,2.2236296705500735,-4.238620593177745
2008-02-27T09:30:00-05:00,37.05,37.82001,37.05,37.53999,2573852,6707540.25,56.11898230611633,50.820265757073535,NaN,NaN,108.5171744380864,70.89922764814854,0.12613784519997567,0.09640514896749863,-0.029732696232477034,172668838,163223310.4,70.22078321269069,60.08599503080289,NaN,NaN,3.6211109960799357,-3.115801794712362
2008-02-28T09:30:00-05:00,37.41,37.45,37.03,37.27,3924293,6563997.85,52.67368192618784,51.34224485297974,NaN,NaN,56.51837264913478,75.86796091252583,0.10447192839466049,0.1008572142608486,-0.003614714133811904,168744545,166614827.6,72.99903587846569,61.14448769358192,NaN,NaN,3.9314028746851677,-2.1090582705127146
2008-02-29T09:30:00-05:00,36.98,36.99001,36.25,36.25,6461641,6431034,42.14642497173976,51.27091545622037,NaN,NaN,-84.69601344765603,56.937552247342275,0.020354497926269872,0.021828408274025435,0.001473910347755564,162282904,167491519,73.68253801804636,62.66208180542478,NaN,NaN,0.9571119036787642,-1.6710339599139319
2008-03-03T09:30:00-05:00,36,36.78,35.99001,36.78,3710161,6173378,47.96573327735658,51.34852445884493,NaN,NaN,-75.03330951856181,25.93624082982226,0.0003742301826830149,0.0019416980761093328,0.0015674678934263179,165993065,167956867.6,74.05792709453985,64.36486501074474,NaN,NaN,0.20738074238983495,-1.4026890024419651
2008-03-04T09:30:00-05:00,36.24001,36.56,35.97,36.35001,4853422,6057907.1,44.09086491473395,50.89222365373198,NaN,NaN,-110.07504100579688,-20.9537633769587,-0.039623879891993494,-0.04796238197156555,-0.008338502079572055,161139643,166165799,69.92382411856842,65.58817390027346,NaN,NaN,-1.6734450607787248,-1.4413684393472166
2008-03-05T09:30:00-05:00,36.38,37.03,36.38,36.83,4740809,5878870.2,49.039838938126046,50.38196774839596,NaN,NaN,-16.868453123301208,-46.03088888923622,-0.03190891014772518,-0.04822463976422853,-0.01631572961650335,165880452,164808121.8,66.87627441403993,66.24313286986246,NaN,NaN,-1.685079951351651,-1.4761843696335644
2008-03-06T09:30:00-05:00,36.87,36.87,36.13,36.13,5262367,5863971.75,43.05434589977907,49.82634721661865,NaN,NaN,-90.83840277468597,-75.50224397400038,-0.06992421605874415,-0.10372099968993354,-0.03379678363118939,160618085,163182829.8,63.3185202243069,66.52625305085643,NaN,NaN,-3.711098714767093,-1.7954578475097827
2008-03-07T09:30:00-05:00,36.00999,36.28,35.39,35.61,7012840,5854592.45,39.224363431090964,49.14391435528703,NaN,NaN,-191.61199043709385,-96.88543937188794,-0.12296299673488387,-0.18750052954979424,-0.06453753281491037,153605245,161447298,59.66818652643356,66.4261901365834,NaN,NaN,-6.703925444076211,-2.4966675041621293
2008-03-10T09:30:00-04:00,35.57001,35.71001,34.89,35.03999,5627941,5773854.55,35.496739677411355,48.074694191421635,NaN,NaN,-245.10097846822447,-130.89897316182046,-0.1855490836403587,-0.29647388736535873,-0.11092480372500005,147977304,157844145.8,52.855384588092875,65.70826853852557,NaN,NaN,-10.49287774808075,-3.638983253293361
2008-03-11T09:30:00-04:00,35.61,36.23,35.28999,36.23,9575082,5994240.5,46.85240539498282,47.734837258450575,NaN,NaN,-120.06017259136594,-132.89599947893427,-0.13809510246742754,-0.28354368180928446,-0.14544857934185693,157552386,157126694.4,51.59221499830249,64.85791198645886,NaN,NaN,-9.744615197898776,-4.511216388236992
2008-03-12T09:30:00-04:00,36.12,36.67999,36.12,36.16,7534605,5823973.1,46.335657901057516,47.56717745820912,NaN,NaN,-53.240726362901746,-140.1704541268544,-0.10425390247500793,-0.2757659574356168,-0.1715120549606089,150017781,153954160.2,46.32058447786677,63.87899387612991,NaN,NaN,-9.353679804613561,-5.202996876290787
2008-03-13T09:30:00-04:00,35.42,36.66,35.42,36.66,7434754,5905979.35,50.532504160985184,47.434280895285596,NaN,NaN,-56.710047805601974,-133.3447831330376,-0.04410525751846381,-0.22664362685868866,-0.18253836934022485,157452535,153321050.2,45.32527355990378,62.77578197665713,NaN,NaN,-7.617971619886796,-5.547993268233074
2008-03-14T09:30:00-04:00,37,37.00999,35.49001,36.08,14902828,6313812.35,46.03503304690265,46.78454345797695,NaN,NaN,-57.89950881725113,-106.60228680906906,-0.03944325919747224,-0.23184244333706516,-0.19239918413959292,142549707,151109942.6,41.93614076362742,61.17383353407566,NaN,NaN,-7.675792121000905,-5.8519645329141925
2008-03-17T09:30:00-04:00,35.13,36.24001,35.13,35.89999,9241051,6433241.05,44.705164896320674,46.01941005305654,NaN,NaN,-107.67125417470442,-79.11634195036504,-0.04418727917155499,-0.24763328310403665,-0.20344600393248166,133308656,148176213,37.888091657225225,59.047484252293565,NaN,NaN,-8.146496926375715,-6.1797548748372675
2008-03-18T09:30:00-04:00,36.55,37.78999,36.37,37.78999,9586414,6616631.3,58.31965277847313,46.17660080108202,NaN,NaN,100.18143640336721,-35.068020151418395,0.07762579420463939,-0.10641376117668244,-0.18403955538132183,142895070,145244749.8,34.322844584170994,56.483345778827875,NaN,NaN,-3.4781387777878217,-5.793809718115918
2008-03-19T09:30:00-04:00,37.17,37.57001,36.32001,36.41,5599211,6658113.9,48.86011263137908,45.90420299430997,NaN,NaN,28.555994796248992,-18.708675919588256,0.06351671188731145,-0.10464366552218252,-0.16816037740949397,137295859,142700365.4,31.547982205896034,53.52255623078719,NaN,NaN,-3.2251911897896077,-5.426864214069303
2008-03-20T09:30:00-04:00,36.3,36.85001,36.02,36.63,3951604,6515045.1,50.2456479311437,46.48271891998167,NaN,NaN,-4.4751218160679045,-8.261690721681436,0.06691673353736985,-0.08451446048778166,-0.1514311940251515,141247463,139459351,28.398517383086258,50.28798332829003,NaN,NaN,-2.5319994437527953,-5.013312104024087
2008-03-24T09:30:00-04:00,37.03999,37.46001,36.81,37.46001,6765176,6547679.5,55.17943581442001,46.997983386914775,NaN,NaN,91.2526741417963,21.568745870128048,0.11988978392713065,-0.0015689641162381918,-0.12145874804336884,148012639,140551937.4,30.90281000455387,47.205474964719606,NaN,NaN,-0.17340062443216764,-4.321896178368099
2008-03-25T09:30:00-04:00,37.39,37.77,37.09,37.69,6335688,6576120.15,56.46760317336193,47.88203611967391,NaN,NaN,120.88374177400742,67.27974505987042,0.1625921857938712,0.08178148419897013,-0.08081070159490104,154348327,144759871.6,39.656503973973344,45.043523525819964,NaN,NaN,2.0824786570780387,-3.406985487590079
2008-03-26T09:30:00-04:00,37.37,37.49001,37.1499,37.39,3638182,6436596.05,54.27630134445167,48.25606914869717,NaN,NaN,101.00077903018929,67.44361358523483,0.16242530954651938,0.12222093533824818,-0.04020437420827119,150710145,146322886.6,42.56702777265809,43.30714876572126,NaN,NaN,3.167257579615834,-2.467807906560663
2008-03-27T09:30:00-04:00,37.62,37.62,36.92,36.98,7984422,6707124.55,51.343800506667236,48.848173049189185,NaN,NaN,83.83593534642054,78.49960169526915,0.12800740506615862,0.11980488212442708,-0.008202522941731537,142725723,147408859.4,44.56755829275824,41.96779434203921,NaN,NaN,3.1269452987939963,-1.6685574486528547
2008-03-28T09:30:00-04:00,37.28,37.32001,36.81,36.84,3255600,6673689.9,50.34356847513369,49.64240198090652,NaN,NaN,62.99903949198776,91.99443395688027,0.09086487752916952,0.10537857396973038,0.014513696440560851,139470123,147053391.4,44.026967175396756,40.85056438839372,NaN,NaN,2.7928537568526144,-1.031212990723502
2008-03-31T09:30:00-04:00,37,37.39999,36.77,37.39999,4198859,6560550.8,54.18797376464289,50.977490129994486,NaN,NaN,80.14408511248477,89.77271615101796,0.09842630877337116,0.1375465824072748,0.03912027363390364,143668982,146184660,42.66492443175165,40.122674377226495,NaN,NaN,3.6689226015334047,-0.3597650489725154
2008-04-01T09:30:00-04:00,37.67999,38.39,37.45,38.25,14300973,7090091.4,59.334437220959266,51.86906383184995,NaN,NaN,157.33535643086958,97.06303908239039,0.15189499799464123,0.2289890211272052,0.07709402313256396,157969955,146908985.6,44.21454699077425,39.59569809097447,NaN,NaN,6.066759636295056,0.5583099060657091
2008-04-02T09:30:00-04:00,38.23,38.53,38.08,38.42,5795234,7137182,60.295126143232984,52.866168706291056,NaN,NaN,165.19234748075107,109.90135277250275,0.18759170110448276,0.3115836495131674,0.12399194840868465,163765189,149519994.4,49.51184301016853,39.82364512899603,NaN,NaN,8.293007136270651,1.6632666532378435
2008-04-03T09:30:00-04:00,37.94,38.28999,37.94,38.25,4375762,7118929.65,58.799193468527676,53.45664651397266,NaN,NaN,125.52431758050363,118.23902921931935,0.18815242232652346,0.359182476316839,0.1710300539903155,159389427,152852735.2,55.341171046143835,40.539066378013175,NaN,NaN,9.688383875289757,2.809711970673831
2008-04-04T09:30:00-04:00,38.25999,38.64,38.02,38.39999,5044980,7108060.3,59.748080482226506,54.43614990221008,NaN,NaN,126.41169620894355,130.9215605627105,0.1866533736805755,0.4043467710910349,0.2176933974104594,164434407,157845592,62.35382065819897,41.99747208476828,NaN,NaN,11.111807239461747,3.995725580500676
2008-04-07T09:30:00-04:00,38.67,38.73,38.14,38.16,6896598,7102248.2,57.467493885663735,55.347744830020304,NaN,NaN,115.19306059635575,137.93135565948472,0.15862885046249564,0.4159794604885789,0.2573506100260833,157537809,160619357.4,65.58681522665705,43.975952339727705,NaN,NaN,11.694451924402408,5.0955436296294945
2008-04-08T09:30:00-04:00,37.98,38.14,37.82001,38.13,4186699,7030186.1,57.17370743823219,55.26589159143167,NaN,NaN,82.47833876570661,122.95995212645212,0.12848728946941346,0.41795972186285013,0.2894724323934367,153351110,159695588.4,63.627049344429125,46.069109822603274,NaN,NaN,12.101086524224913,6.096335471714554
2008-04-09T09:30:00-04:00,37.84,38.12,37.49001,37.75999,5800574,6841460.7,53.538316656647986,55.60004902180801,NaN,NaN,52.897784155017206,100.50103946130534,0.07660738824897767,0.3852316677046588,0.3086242794556811,147550536,156452657.8,57.16892196594039,47.899176948320736,NaN,NaN,11.486640078747062,6.866378987004913
2008-04-10T09:30:00-04:00,37.74001,38.035,37.45,37.92,2775035,6603482.2,54.87458686056851,55.93068751676693,NaN,NaN,48.258172016467626,85.04781034849813,0.04747198110785339,0.36796425584049786,0.32049227473264447,150325571,154639886.6,53.87693772365584,49.71906411550428,NaN,NaN,11.309526151009061,7.501114296148362
2008-04-11T09:30:00-04:00,36.86,36.99001,36.33,36.42999,6944484,6578968.7,42.590589014447275,55.031484173911736,NaN,NaN,-87.15262499541711,42.33494610762601,-0.07128891149208205,0.2313811353675419,0.30267004685962395,143381087,150429222.6,47.09348431341114,50.87554085185122,NaN,NaN,7.2679540462152525,7.46780568901506
2008-04-14T09:30:00-04:00,36.59,36.62,36.38,36.45,3620566,6014855.6,42.77585273717982,54.05350199989873,NaN,NaN,-102.02676770280394,-1.1090195522059276,-0.14347124924274174,0.1233309853061968,0.26680223454893853,147001653,148321991.4,44.1009304259465,51.19299988413502,NaN,NaN,4.097381854483572,6.986316569796276
2008-04-15T09:30:00-04:00,36.67999,36.7,36.22,36.62,4748176,5790211.85,44.41695684384143,53.349263106998,NaN,NaN,-109.21929378499077,-39.44854606234539,-0.17277612237560747,0.0508320815794292,0.22360820395503667,151749829,148001735.2,43.64698313548472,51.270139552908354,NaN,NaN,1.9251765595473085,6.263296568332138
2008-04-16T09:30:00-04:00,36.86,37.64,36.86,37.64,7933016,5707541.95,53.10664247757081,53.475180390633966,NaN,NaN,-5.638262902684117,-51.15575547388566,-0.11903121551001039,0.07481918456752368,0.19385040007753407,159682845,150428197,48.01325615505284,51.516260828786535,NaN,NaN,2.5842297375836774,5.73771559251093
2008-04-17T09:30:00-04:00,37.39,37.46001,37.09,37.2,5176504,5686406.6,49.51081375445076,53.41569791058519,NaN,NaN,-25.223947585155457,-65.85217939421028,-0.10895220526622679,0.05766014349475057,0.16661234876097736,154506341,151264351,49.466279161192524,51.90478311348624,NaN,NaN,2.023890452916544,5.207169143997446
2008-04-18T09:30:00-04:00,37.92999,38.38,37.84,38.32001,7603473,5869000.05,57.415054431060376,53.64620367247215,NaN,NaN,82.42732324145221,-31.936189746836412,-0.026965973600999282,0.13290488175972826,0.15987085536072754,162109814,155010096.4,55.47059382913321,52.819473784727776,NaN,NaN,4.16898951269846,5.0588577680975915
2008-04-21T09:30:00-04:00,38.05,38.19,37.88,38.19,7976254,5929553.95,56.31298271395751,53.43038549340059,NaN,NaN,63.52917611680148,1.17499901708467,0.016080562420241223,0.17997155838602907,0.16389099596578785,154133560,156436477.8,57.539538938074095,53.77125892382062,NaN,NaN,5.511950696743657,5.123585329332744
2008-04-22T09:30:00-04:00,37.95,37.97,37.44,37.58,3361759,5780857.5,51.33414292389712,52.79031526344803,NaN,NaN,9.828344837418198,24.984526741566462,0.0017953897394694662,0.16613523314012468,0.16433984340065522,150771801,156240872.2,57.14740997800782,54.31665656438057,NaN,NaN,5.066886736097089,5.115485530299079
2008-04-23T09:30:00-04:00,37.75999,38,37.48,37.60001,4164180,5807157.4,51.48567047042825,52.26792076358379,NaN,NaN,11.604444037123459,28.43306812952798,-0.007473660573516228,0.15499776768375995,0.16247142825727617,154935981,155291499.4,55.18179458565284,54.305272531488356,NaN,NaN,4.760054404130274,5.0647096551321065
2008-04-24T09:30:00-04:00,37.84,38.28999,37.45,37.84,4105340,5613203.3,53.36128891631937,51.81172136601899,NaN,NaN,29.457308209224244,39.369319288403915,0.0009428400397955838,0.16364997830702066,0.16270713826722508,159041321,156198495.4,56.7136106645792,53.90240038908695,NaN,NaN,5.051838083461701,5.062870859179191
2008-04-25T09:30:00-04:00,38.32001,38.48,37.85001,38.37,2686444,5584745.5,57.28852026999867,51.79893753632863,NaN,NaN,73.8227987855391,37.64841439722129,0.03850870623848929,0.2108430210653367,0.1723343148268474,161727765,156122085.6,56.538293985545515,53.25607744329327,NaN,NaN,6.477307372778474,5.264933218264803
2008-04-28T09:30:00-04:00,38.49001,38.59,38.255,38.59,11001574,5924881.25,58.837938146009904,51.917811158312745,NaN,NaN,99.93370106997173,44.929319387855344,0.07250432037375351,0.2629647152940393,0.1904603949202858,172729339,159841241.4,62.598710896879126,53.18262469703969,NaN,NaN,8.115666766535881,5.672180868017814
2008-04-29T09:30:00-04:00,38.44,38.49001,38.14999,38.23,5395930,5479629.1,55.30257675321068,52.043829736638656,NaN,NaN,70.47000738576558,57.05765189752482,0.06530056638839088,0.2720861029057744,0.20678553651738352,167333409,163153563,67.01076459738519,53.8856134564286,NaN,NaN,8.498674611975913,6.075965688583257
2008-04-30T09:30:00-04:00,38.39,38.78,38.13,38.5,7494031,5564568.95,57.37139999381596,52.22217353187062,NaN,NaN,93.42074730703447,73.42091255150702,0.07270777432234174,0.2976702544203107,0.22496248009796896,174827440,167131854.8,71.37796872497555,55.135687099380014,NaN,NaN,9.414141115731248,6.552847892461542
2008-05-01T09:30:00-04:00,38.27,38.88,38.14,38.75,10938961,5892728.9,59.25204839286208,53.412277773185956,NaN,NaN,103.3017825885634,88.18980742737486,0.0874424830449208,0.33426558390412,0.24682310085919917,185766401,172476870.8,75.97903732584885,57.19894088598271,NaN,NaN,10.72268858123918,7.148539419429776
2008-05-02T09:30:00-04:00,39.07001,39.24001,38.61,38.89999,8936500,6087304.9,60.38135820480031,54.669813878015994,NaN,NaN,135.73559415712407,100.57236650169185,0.09941580586027787,0.3710928581845465,0.27167705232426864,194702901,179071898,80.2069278174141,59.77794069965897,NaN,NaN,12.134745479031919,7.860854570801511
2008-05-05T09:30:00-04:00,38.94,38.98,38.53,38.8,3242889,5904619.45,59.203391932553465,55.725987812924004,NaN,NaN,110.72525314959518,102.73067691761653,0.09285095578652774,0.38774074705742834,0.2948897912709006,191460012,182818032.6,82.13085473523176,62.52678867106947,NaN,NaN,13.01100176259092,8.596589883914284
2008-05-06T09:30:00-04:00,38.57001,39.08,38.42,38.95,3398358,5865202.4,60.449905132202176,56.2505065739691,NaN,NaN,104.30766432252072,109.49820830496756,0.0907530300464573,0.40833107882897224,0.31757804878251494,194858370,188323024.8,84.51315418624893,65.13392424472633,NaN,NaN,14.089575654103658,9.38130213679848
2008-05-07T09:30:00-04:00,39.03,39.06,38.27,38.35001,5739297,5862138.55,53.41907471270951,56.529668070987576,NaN,NaN,68.17715087341071,104.4494890182428,0.04349540847445049,0.3719473093755781,0.3284519009011276,189119073,191181351.4,85.58756359211576,67.71401598979227,NaN,NaN,13.121667843046458,9.915640094833906
2008-05-08T09:30:00-04:00,38.42999,38.71001,38.3,38.48,6928141,6069793.85,54.6497439862684,56.33214589635958,NaN,NaN,56.18783847258849,95.02670019504782,0.01689637045548814,0.34957236397048774,0.3326759935149996,196047214,193237514,86.32265109712252,69.91773436607723,NaN,NaN,12.639583765391327,10.304774904913538
2008-05-09T09:30:00-04:00,38.16,38.36,38.11,38.24001,4176332,5931386.25,51.92230469150542,56.018526037613,NaN,NaN,22.83678805477318,72.44693897457765,-0.01900967159522471,0.30891390402096874,0.32792357561619345,191870882,192671110.2,85.03600860489477,71.88176791370726,NaN,NaN,11.475299431836637,10.47199269447398
2008-05-12T09:30:00-04:00,38.44,38.85001,38.14999,38.85001,3550137,5927864.8,57.70086699213053,56.47329204248681,NaN,NaN,66.33517438626178,63.56892322191097,-0.004579206454988882,0.3221995675474574,0.32677877400244626,195421019,193463311.6,85.36458199000906,73.8972802002788,NaN,NaN,12.07133529056563,10.70047020820136
2008-05-13T09:30:00-04:00,38.50999,39.17,38.50999,39.11,3191548,5850033.4,59.9124206652666,57.07520277068954,NaN,NaN,111.81088942427,65.06956824226083,0.018318353809441745,0.34967671626424845,0.3313583624548067,198612567,194214151,85.68540111289852,76.0761092379392,NaN,NaN,13.217205332204326,11.06000379734464
2008-05-14T09:30:00-04:00,39.10001,39.5,39.10001,39.14999,2979456,5602355.4,60.25662018396275,57.567726432664074,NaN,NaN,153.22153759894658,82.07844558736801,0.03124096004370408,0.3704095625094368,0.3391686024657327,201592023,196708741,86.7264675342552,78.21988472863033,NaN,NaN,14.256086550467636,11.516587047790782
2008-05-15T09:30:00-04:00,39.14999,39.39,39.00999,39.38,3619098,5524485.1,62.26359072121599,57.92308860775103,NaN,NaN,149.80667083428952,100.8022120597082,0.04928946197773071,0.4007804299378961,0.3514909679601654,205211121,198541522.4,87.4487112187297,80.42777167385779,NaN,NaN,15.70713690870138,12.115237027920868
2008-05-16T09:30:00-04:00,39.46001,39.46001,39.03,39.28,2605624,5274592.65,60.825456106742074,58.06505417637476,NaN,NaN,131.02480240578745,122.43981492991107,0.04843183584560651,0.41203076276717354,0.36359892692156703,202605497,200688445.4,88.25491335520331,82.26035756373808,NaN,NaN,16.54959270122316,12.748716409821196
2008-05-19T09:30:00-04:00,39.35001,39.97,39.19,39.72,6566852,5204122.55,64.69001772416742,58.735585674300246,NaN,NaN,169.43661511254405,143.06010307516752,0.07012032560407533,0.4512493339266612,0.3811290083225859,209172349,203438711.4,89.21096456802229,83.8460861330693,NaN,NaN,18.40010521112043,13.556057667149657
2008-05-20T09:30:00-04:00,39.36,39.36,38.89,39.09,4368371,5254453.15,56.14897871917898,58.648269868969024,NaN,NaN,75.60114669977939,135.8181545302694,0.036358618849427315,0.42657728188437005,0.39021866303494274,204803978,204676993.6,89.62062656967079,85.1491331219761,NaN,NaN,17.537532055009788,14.124839722558248
2008-05-21T09:30:00-04:00,39.03999,39.25,38.3,38.42999,8489074,5470697.85,48.86941685104849,57.90665333026806,NaN,NaN,-11.915570039979746,102.79073300248413,-0.0323863891122978,0.3497356766445705,0.3821220657568683,196314904,203621569.8,86.60231209207639,85.90793846242093,NaN,NaN,14.417276171535242,14.16661635812639
2008-05-22T09:30:00-04:00,38.42999,38.55,38.2,38.34,6620574,5596459.55,47.956483382999636,57.01916227156801,NaN,NaN,-79.4011233734237,56.949174160941496,-0.08300336575712852,0.27836785856045765,0.36137122431758617,189694330,200518211.6,78.2565341184244,85.7686246267788,NaN,NaN,11.630328694619822,13.804289549054023
2008-05-23T09:30:00-04:00,38.21001,38.21001,37.64999,37.78999,4037365,5664005.6,42.70543371672936,55.84073668472343,NaN,NaN,-167.0089834864439,-2.657583017504777,-0.14877283826352772,0.17540517648817655,0.32417801475170427,185656965,197128505.2,70.28874239102679,84.9227594593356,NaN,NaN,7.496376859361731,12.903159164812266
2008-05-27T09:30:00-04:00,37.78,38.19,37.66,38.19,3903514,5309102.6,47.23090092890587,54.896522098773694,NaN,NaN,-128.77259098988685,-62.299424237990955,-0.1596247168235398,0.12464711872227952,0.2842718355458193,189560479,193206131.2,62.374715154038405,83.34144238560627,NaN,NaN,5.409746351484494,11.832671620051155
2008-05-28T09:30:00-04:00,38.39999,38.49001,38.09,38.45,5650965,5321854.35,49.9955850592855,54.651987123529125,NaN,NaN,-68.37562846748712,-91.09477927144425,-0.14405773211526857,0.10419967040173361,0.24825740251700218,195211444,191287624.4,58.88253005555529,81.43393999013767,NaN,NaN,4.536180160148334,10.790315697207895
2008-05-29T09:30:00-04:00,38.53999,38.92,38.13,38.60001,7581297,5326217.65,51.57208218505642,54.43215413772827,NaN,NaN,-30.755189016216683,-94.86270306669164,-0.11943893092243099,0.09895873886396345,0.21839766978639444,202792741,192583191.8,60.49118904750934,79.58883555802244,NaN,NaN,4.291799642618625,9.861956260838
2008-05-30T09:30:00-04:00,38.77,39.02,38.57001,38.84,4003194,4979429.3,54.06706003617872,54.58535094806207,NaN,NaN,16.38257378098083,-75.70596363581072,-0.0844226458851691,0.11286936242993306,0.19729200831510216,206795935,196003512.8,64.44593350750696,78.11811590820902,NaN,NaN,4.823893160881939,9.142232960844277
2008-06-02T09:30:00-04:00,38.67,38.94,38.25,38.50999,5004227,4782815.65,50.2344782484891,54.052037466373406,NaN,NaN,-26.741556302068055,-47.652478198935555,-0.08090868301941875,0.09615615454082871,0.17706483756024746,201791708,199230461.4,67.72808805647665,76.85836634152814,NaN,NaN,4.146968190234428,8.428623707900012
2008-06-03T09:30:00-04:00,38.53999,38.67999,37.89999,38.38,5398262,4890584.3,48.768047455783126,53.256010808553164,NaN,NaN,-67.45940176567936,-35.389840354094076,-0.08437475675779849,0.07159639161299935,0.15597114837079784,196393446,200597054.8,69.03190376506824,75.66883081668311,NaN,NaN,3.163310838250064,7.676436155092877
2008-06-04T09:30:00-04:00,38.03,38.39,37.94,38.23,4411559,4941244.35,47.060843602573485,52.31345533845393,NaN,NaN,-84.11650803798334,-38.53801626819332,-0.09311876921616599,0.039572686850590344,0.13269145606675634,191981887,199951143.4,67.64092856069303,74.30557803285726,NaN,NaN,1.8541168921668678,6.8446762603891615
2008-06-05T09:30:00-04:00,38.25,38.595,38.03999,38.50999,6498363,4979197.65,50.541243538222616,51.47614482538297,NaN,NaN,-46.372932643071664,-41.66156499356431,-0.07705932205570114,0.03636730349712991,0.11342662555283105,198480250,199088645.2,65.73615324120028,72.75468103446228,NaN,NaN,1.701832772411592,6.109984333535223
2008-06-06T09:30:00-04:00,38.14999,38.28999,37.00999,37.00999,11162152,5190898.2,36.642613397740284,49.74879891759713,NaN,NaN,-182.62756897253328,-81.46359354426713,-0.15971457932248373,-0.08621659860027364,0.0734979807222101,187318098,195193077.8,57.81686833706774,70.58053496173831,NaN,NaN,-3.368392903343325,4.7559304425525735
2008-06-09T09:30:00-04:00,37.28999,37.49001,37.09,37.39,7946766,5379419.9,41.06434747505818,48.06125104266075,NaN,NaN,-175.10426058913316,-111.13613440168015,-0.1795675077483234,-0.15096140396319413,0.028606103785129254,195264864,193887709,55.4080622921477,68.16604194203299,NaN,NaN,-5.941402050466755,3.227740086406955
2008-06-10T09:30:00-04:00,37.02,37.59,37.02,37.17,4217902,5412808.15,39.352065681200486,46.861471539948006,NaN,NaN,-154.33605887205508,-128.51146582295527,-0.19689839562076902,-0.21751689074083203,-0.02061849512006301,191046962,192818412.2,53.44382250718914,65.58198450899859,NaN,NaN,-8.555038203635187,1.5444860449723636
2008-06-11T09:30:00-04:00,37.14999,37.14999,36.39999,36.47,6568133,5581637.4,34.4323795892704,45.830254592678145,NaN,NaN,-193.12714384066317,-150.31359298349125,-0.24192371091458964,-0.32302313376330005,-0.08109942284871041,184478829,191317800.6,50.726084445415495,63.01939681995138,NaN,NaN,-12.517099879943464,-0.46431194430132594
2008-06-12T09:30:00-04:00,36.64,37.33,36.42999,36.60001,7316871,5798508.15,36.031924883484066,44.978500414141315,NaN,NaN,-152.35547242253918,-171.51010093938476,-0.2484263631387978,-0.39163237677220764,-0.14320601363340985,191795700,189980890.6,48.36630429615402,60.884380404074925,NaN,NaN,-15.113105665326593,-2.55699676159065
2008-06-13T09:30:00-04:00,36.75999,37.16,36.71001,37.02,8574410,6046273.75,41.03618175120699,44.859268130889724,NaN,NaN,-116.24618238481266,-158.23382362184063,-0.21137081659732665,-0.40741953438006817,-0.19604871778274152,200370110,192591293,52.96709019041379,59.647119532602574,NaN,NaN,-15.673369262472592,-4.430764261716641
2008-06-16T09:30:00-04:00,37.10001,37.25999,36.69501,36.82001,5625961,6197290.6,39.45342198167917,44.30373392037353,NaN,NaN,-105.94837873416613,-144.40264725084722,-0.188040266279901,-0.4310990506326178,-0.24305878435271677,194744149,192487150,52.765089525598796,58.960717701999734,NaN,NaN,-16.618289477328513,-6.171839292518337
2008-06-17T09:30:00-04:00,37.13,37.14999,36.55,36.74001,3678305,6052863.25,38.808596216869546,43.50466328877239,NaN,NaN,-103.95828609071239,-134.32709269457868,-0.16644924041290976,-0.45112033486885394,-0.2846710944559442,191065844,192490926.4,52.77212312605041,58.52426006417795,NaN,NaN,-17.571120338879624,-7.800308013427092
2008-06-18T09:30:00-04:00,36.32001,36.57001,36.17,36.21001,6784281,6173658.75,34.75579337515411,42.30349980235079,NaN,NaN,-133.32646005347877,-122.3669559371418,-0.17541892925452246,-0.5039447560240973,-0.3285258267695748,184281563,192451473.2,52.68385963311924,57.9665936774358,NaN,NaN,-19.652474246367916,-9.493474618132923
2008-06-19T09:30:00-04:00,36.23,36.825,36.16499,36.67999,6266301,6062520.1,40.672397751320986,41.346738210575246,NaN,NaN,-99.04906762181237,-111.70567497699646,-0.1388570734175088,-0.5020971685414608,-0.363240095123952,190547864,192201906,52.09035540187219,57.084052384176175,NaN,NaN,-19.59833121416006,-10.937025560422514
2008-06-20T09:30:00-04:00,36.14999,36.39999,35.81,35.89999,5842281,6023605.45,34.999641972710634,40.25853561944821,NaN,NaN,-130.91841976924587,-114.6401224538831,-0.15512788042770792,-0.5571499456585869,-0.40202206523087897,184705583,189069000.6,45.205676820410666,55.47530872445717,NaN,NaN,-21.420740309450142,-12.434699095997889
2008-06-23T09:30:00-04:00,36.17,36.2,35.869,35.97,3460208,5994747.6,35.86429986367868,39.33683936286932,NaN,NaN,-118.45256132125196,-117.14095897130028,-0.14906101414176337,-0.5883483329080832,-0.4392873187663198,188165791,187753329,42.655965413914245,53.59131312794617,NaN,NaN,-22.585679553958695,-13.88483916142086
2008-06-24T09:30:00-04:00,35.67999,35.88,35.38499,35.53999,6387453,6118944.55,32.963823678425854,38.329909368287346,NaN,NaN,-136.21005748681125,-123.59131325052006,-0.1608817302011164,-0.6403894815177154,-0.47950775131659895,181778338,185895827.8,39.28688102857812,51.56602401850939,NaN,NaN,-24.484618053859645,-15.399093288912114
2008-06-25T09:30:00-04:00,35.59,35.59,35,35.28,8762387,6274515.65,31.314827162593247,36.956593912885246,NaN,NaN,-143.95857209301207,-125.7177356584267,-0.17207741365736318,-0.694604518388303,-0.5225271047309398,173015951,183642705.4,35.612570932173156,49.414339567864594,NaN,NaN,-26.56170288269186,-16.99375180230922
2008-06-26T09:30:00-04:00,34.95,34.95,33.8,34.7,10217617,6406331.65,27.95513295507085,36.33605959555171,NaN,NaN,-185.62228749864983,-143.0323796337942,-0.20232453392499739,-0.7754327721371865,-0.5731082382121891,162798334,178092799.4,28.53359712983378,47.322677338776465,NaN,NaN,-29.4467869950623,-18.772756829845374
2008-06-27T09:30:00-04:00,34.08,34.08,33.50999,33.7,9277156,6670029.75,23.311332762326714,35.06798711607089,NaN,NaN,-206.55651612488742,-158.1599989049225,-0.2692694019374783,-0.909694990634037,-0.6404255886965587,153521178,171855918.4,23.000474586045783,45.00784964548347,NaN,NaN,-33.69027597661825,-20.90383099367007
2008-06-30T09:30:00-04:00,33.64999,34.22,33.59,34.00999,5948008,6717218.8,27.34068847771789,34.21003160153642,NaN,NaN,-164.54579519129257,-167.37864567893064,-0.27149212582143023,-0.9797907459733466,-0.7082986201519164,159469186,166116597.4,19.292906291069443,42.56849848718921,NaN,NaN,-35.74995424850394,-23.024705744360624
2008-07-01T09:30:00-04:00,33.5,34.161,33.3701,33.99001,12149027,7054757.05,27.241339053730513,33.69638584899786,NaN,NaN,-146.55524433495376,-169.44768304855913,-0.2534708738410062,-1.0251372124531741,-0.7716663386121679,147320159,159224961.6,15.965021034061763,40.08556538637822,NaN,NaN,-37.38760762114855,-25.07654886961604
2008-07-02T09:30:00-04:00,34.13,34.17,32.89999,32.95,12311688,7449763.5,22.631410066328428,32.73920621920103,NaN,NaN,-151.46120520189902,-170.94820967033652,-0.28822401401785336,-1.1319463561344847,-0.8437223421166313,135008471,151623465.6,13.250130720272708,37.57726727381527,NaN,NaN,-40.45719839303777,-27.273784515819145
2008-07-03T09:30:00-04:00,33.35001,33.53,32.95,33.41,5800543,7414872.5,28.402632807170363,31.836809866055557,NaN,NaN,-131.95781279151566,-160.2153147289097,-0.2578492490212826,-1.1660339033932345,-0.908184654371952,140809014,147225601.6,11.980743899799307,34.649671110199954,NaN,NaN,-41.04141469744693,-29.240588827480256
2008-07-07T09:30:00-04:00,33.49001,33.82001,33,33.37,7051473,7209338.55,28.2056059491415,31.033394435160012,NaN,NaN,-110.32148660527821,-140.96830882498784,-0.2195670114850249,-1.182643418728233,-0.9630764072432082,133757541,143272874.2,10.96406207384345,31.663883435074574,NaN,NaN,-41.558265785747864,-31.000256964375627
2008-07-08T09:30:00-04:00,33.25,34.14,33.25,34.14,12327504,7428375.45,37.232113598473035,30.92078853384598,NaN,NaN,-77.50883895351936,-123.56091757743323,-0.12614259617881118,-1.1207546524667222,-0.994612056287911,146085045,140596046,10.325060124862759,28.63195036356117,NaN,NaN,-39.04288033922734,-32.14920316078302
2008-07-09T09:30:00-04:00,34.13,34.28,33.16,33.19,9153297,7675145.2,31.90275469968526,30.717000057026773,NaN,NaN,-82.882700778136,-110.82640886606968,-0.11253247162844837,-1.1352776458234715,-1.022745174195023,136931748,138518363.8,9.845427644494393,25.572062364373682,NaN,NaN,-38.637421853043406,-33.07609154539164
2008-07-10T09:30:00-04:00,33.5,33.78999,33.17999,33.7,9592215,7826349.3,37.10736616391403,30.462354943640566,NaN,NaN,-73.95248703883958,-95.3246652334578,-0.05623159004306921,-1.0930346617488595,-1.0368030717057903,146523963,140821462.2,14.582199196940039,22.89290834973567,NaN,NaN,-36.520917142574504,-33.56820948784634
2008-07-11T09:30:00-04:00,33.42,33.78999,32.95,33.09,9542402,7937625.85,33.781658441670274,30.37535611999482,NaN,NaN,-80.42353761373967,-85.01781019790258,-0.04747197455864138,-1.0961430399040921,-1.0486710653454507,136981561,140055971.6,14.313022117718603,20.686290156686233,NaN,NaN,-35.88534596037322,-33.89922898392161
2008-07-14T09:30:00-04:00,33.45,33.89,32.89,33.24001,7401547,7878982.7,35.31694529174844,30.336259364856947,NaN,NaN,-71.5674280779801,-77.26699849244297,-0.020359236246509926,-1.0741201106535883,-1.0537608744070783,144383108,142181085,18.794560322202628,18.981904078706833,NaN,NaN,-34.89072321911295,-34.040871017520374
2008-07-15T09:30:00-04:00,33.09,33.14,32,32.58,9592352,8077302.25,31.82117831251749,30.254641838720634,NaN,NaN,-107.50277973248875,-83.26578664823685,-0.03481159187697669,-1.0972753642532993,-1.0624637723763226,134790756,139922227.2,17.73290479470019,17.442334347715555,NaN,NaN,-35.17497841138736,-34.20288635950137
2008-07-16T09:30:00-04:00,32.75,33.59,32.34,33.33,9211184,8353946.2,39.18745387493045,30.816972318173292,NaN,NaN,-74.06013478537093,-81.50127344968385,0.015504360041658005,-1.0430833223242502,-1.0585876823659082,144001940,141336265.6,20.75079452073102,16.380778889755405,NaN,NaN,-32.9474222248399,-34.023534340264014
2008-07-17T09:30:00-04:00,33.83,34.25,33.4599,34.25,10626281,8546046.2,46.783016841145155,32.1618211671786,NaN,NaN,-11.044442745529153,-68.91966459102176,0.11459185229494251,-0.9153478669972301,-1.0299397192921727,154628221,142957117.2,24.184037876598595,16.070096085952894,NaN,NaN,-28.37607239349435,-33.21675406215406
2008-07-18T09:30:00-04:00,34.14999,34.3,33.8,34.3,7400555,8602758.9,47.16922427523876,33.86595627524375,NaN,NaN,10.395123548196494,-50.755932358634524,0.18327152555770532,-0.800850312345041,-0.9841218379027463,162028776,147966560.2,33.73841463059608,16.837091803420773,NaN,NaN,-24.728134053948587,-32.00409406098185
2008-07-21T09:30:00-04:00,34.24001,34.33,33.83,34.33,7538176,8687553.65,47.415806365928006,35.29989326725875,NaN,NaN,25.69825550600772,-31.30279564183696,0.2275977988592317,-0.6996245893287067,-0.9272223881879385,169566952,153003329,41.69448487431506,18.437204559366887,NaN,NaN,-21.771527627162392,-30.5422988561505
2008-07-22T09:30:00-04:00,34.08,34.78999,34.08,34.75,6980602,8863573.35,50.87287953240705,36.98786044430708,NaN,NaN,86.16855770400461,7.431471845461724,0.27870632384363836,-0.5788394833833905,-0.8575458072270289,176547554,161354688.6,51.988248422590644,21.0102922299761,NaN,NaN,-18.214905772663354,-28.781242701366622
2008-07-23T09:30:00-04:00,35,35.21001,34.62,35.02,8744309,8981416.15,53.011548853838576,39.15787035770065,NaN,NaN,151.08790861801506,52.46108052613893,0.32117876179513205,-0.4560723549831138,-0.7772511167782459,185291863,169612673.2,59.586189479846674,24.320010712802805,NaN,NaN,-14.613702355642241,-26.75730836626314
2008-07-24T09:30:00-04:00,35.3,35.35001,34.13,34.14999,9031898,8994891.7,46.05429802515056,40.41870358755638,NaN,NaN,110.0476390726198,76.67949688976871,0.28252698602871684,-0.42409238424234985,-0.7066193702710667,176259965,173939022,62.89878665865537,27.95701376700681,NaN,NaN,-13.505184710452959,-24.864147844004542
2008-07-25T09:30:00-04:00,34.64,34.64,34.25,34.47,8324035,8900212.6,48.72016092187355,41.88402894275153,NaN,NaN,97.60791023810246,94.1220542277499,0.27035467484161846,-0.36867602671904365,-0.6390307015606621,184584000,178450066.8,66.0257909331921,31.88999439981743,NaN,NaN,-11.77354106294914,-22.994061160996626
2008-07-28T09:30:00-04:00,34.60001,34.60001,33.57001,33.67999,7177086,8795209.1,43.0625344581567,42.30048757558608,NaN,NaN,23.126705695796975,93.60774426570775,0.20396219554460093,-0.3840779571299109,-0.5880401526745118,177406914,180018059.2,67.06487613478672,35.942838400526284,NaN,NaN,-12.045554459430175,-21.42998877505856
2008-07-29T09:30:00-04:00,33.88,34.95,33.87,34.95,6799363,8837776.85,52.59324026204737,43.77837940146908,NaN,NaN,103.2273838521558,97.01950949533803,0.2380667614853189,-0.2904567008178631,-0.528523462303182,184206277,181549803.8,68.09155479616166,40.1032760542168,NaN,NaN,-8.999349010417184,-19.654183094395506
2008-07-30T09:30:00-04:00,34.95,35.48,34.84,35.36,9428066,8701728.8,55.20037065608622,45.07073686519567,NaN,NaN,158.0113755035878,98.40420287245257,0.2779466793628087,-0.18109011309967116,-0.45903679246247986,193634343,183218299.8,69.21721331563464,44.00577706269498,NaN,NaN,-5.6816097493860305,-17.65810118796558
2008-07-31T09:30:00-04:00,35.12,35.25,34.27,34.28,17874272,8979858,47.750852364450694,46.068536431108555,NaN,NaN,76.24416517760795,91.64350809345021,0.22363408896011022,-0.17949418126234207,-0.4031282702224523,175760071,183118321,69.0599979412979,47.91627533580779,NaN,NaN,-5.3990607719491,-15.906809699963226
2008-08-01T09:30:00-04:00,34.60001,34.7,34.05,34.25,7999980,9089829.85,47.55885301742991,46.942958411514375,NaN,NaN,39.95150793916302,80.11222763366231,0.17962945459900026,-0.17859145197370196,-0.3582209065727022,167760091,179753539.2,63.80727190660497,51.13146902040796,NaN,NaN,-5.24505269487823,-14.383701556379656
2008-08-04T09:30:00-04:00,34.17999,34.32001,33.87,34.10001,7557008,9115106.6,46.55105412432964,47.995092398072394,NaN,NaN,7.355213494916105,76.95792919348614,0.1363255496900747,-0.18781396946010886,-0.3241395191501836,160203083,176312773,58.875785464570626,54.07024621111299,NaN,NaN,-5.432479949328174,-13.104955612515159
2008-08-05T09:30:00-04:00,34.42,35.09,34.42,35.05,9724871,8984974.95,53.30088059898374,49.00319430693334,NaN,NaN,94.16601083591853,75.14565459023868,0.16561835102061523,-0.11711658037441453,-0.28273493139502975,169927954,173457108.4,55.07151481025678,56.52172623179341,NaN,NaN,-3.4297492949368964,-11.72278328143255
2008-08-06T09:30:00-04:00,35.05,35.72,34.69,35.72,6914934,8873056.8,57.3880730694482,49.760698323240696,NaN,NaN,140.9808309758784,71.73954568469681,0.22063199892490082,-0.006944932738903731,-0.22757693166380455,176842888,170098817.4,50.9057269696304,58.4304183098671,NaN,NaN,-0.40690518851439605,-10.106229268158527
2008-08-07T09:30:00-04:00,34.82001,35.10001,34.52,34.52,10655750,8926233.55,49.09942122635196,49.89856953403449,NaN,NaN,56.964680758650445,67.8836488009053,0.16904117254327372,-0.01627546598471241,-0.18531663852798613,166187138,168184230.8,48.64648392411276,59.495280402261145,NaN,NaN,-0.574281241360363,-8.744522407187361
2008-08-08T09:30:00-04:00,34.66,35.89,34.53,35.71001,11684734,9033350.15,55.90147915361718,50.504689018869435,NaN,NaN,126.61245777540292,85.21583876815328,0.20547677899493794,0.07152933521568627,-0.13394744377925166,177871872,170206587,51.11447677445358,60.16813696655676,NaN,NaN,1.7070617673700599,-7.251438953679158
2008-08-11T09:30:00-04:00,35.82001,36.11,35.5,35.8,12795797,9303062.65,56.37623365193984,50.897785741693205,NaN,NaN,163.9810062443211,116.54099731803429,0.22450660379822343,0.14668581096852762,-0.07782079282969581,190667669,176299504.2,57.70887618208193,60.57675323509185,NaN,NaN,3.606049659769716,-5.70036915175789
2008-08-12T09:30:00-04:00,35.78999,35.8,35.28999,35.45,7227512,9184820.65,53.94377816057081,50.96437354931693,NaN,NaN,122.3561541198827,122.17902597482711,0.2030384171426403,0.17597722859860454,-0.027061188544035747,183440157,179001944.8,60.26888409080587,60.62551713587465,NaN,NaN,4.362042617570522,-4.262881756139546
2008-08-13T09:30:00-04:00,35.28,35.39,34.72,35.32001,11051953,9276859.1,53.02864155284171,51.46254094415202,NaN,NaN,63.04616038826512,106.59209185730447,0.17089001789388797,0.18655133382332423,0.015661315929436252,172388204,178111008,59.00086473728304,60.34709414149091,NaN,NaN,4.6897051050071585,-2.9839407759757313
2008-08-14T09:30:00-04:00,35.07001,35.73,34.89,35.45,9603871,9225738.6,53.87139316045713,51.83048610405084,NaN,NaN,84.05412922035015,112.00998154964441,0.14993456383421547,0.2030795207222056,0.05314495688799012,181992075,181271995.4,62.05148446212631,60.063215107843355,NaN,NaN,5.199001239703284,-1.8149490594501578
2008-08-15T09:30:00-04:00,35.59,35.86,35.42999,35.64999,6119145,9161668.1,55.20306670884582,52.69766697910006,NaN,NaN,112.81443464168605,109.25037692290103,0.1412186557723378,0.22966827660341238,0.08844962083107458,188111220,183319865,63.92428916838654,59.8388874673862,NaN,NaN,5.995867993680443,-0.6991180518600719
2008-08-18T09:30:00-04:00,35.77,35.8,35,35.25,6234758,9096497.2,51.97146428770866,52.65325440950444,NaN,NaN,63.08954646649059,89.07208496733492,0.1020199725059994,0.21597458646357381,0.11395461395757442,181876462,181561623.6,61.13466238282117,59.341966580719024,NaN,NaN,5.775438412456896,0.22581858589949488
2008-08-19T09:30:00-04:00,35.21001,35.21001,34.50999,34.81,6894238,9092179,48.60101145657147,52.18187160953911,NaN,NaN,-14.093912436869964,61.78207165598438,0.042984267157367945,0.16768494790428434,0.1247006807469164,174982224,179870037,58.490046619446936,58.575740388134186,NaN,NaN,4.626464610308248,0.8544823036721739
2008-08-20T09:30:00-04:00,34.67,34.85001,34.21001,34.53,9990441,9154485.6,46.532902199854504,52.09487516921081,NaN,NaN,-56.30641047836241,37.911557482658885,-0.01527729372805664,0.1056040635868456,0.12088135731490224,164991783,178390752.8,56.20046039602441,57.65720199204323,NaN,NaN,3.0684826088903643,1.1707680615604867
2008-08-21T09:30:00-04:00,34.31,34.77,34.2,34.61,8100484,9107914.9,47.22390854222687,52.07095056383916,NaN,NaN,-56.57992374623924,9.784746889341001,-0.0469902895502929,0.06214349537703612,0.10913378492732902,173092267,176610791.2,53.48733602975783,56.92006371512557,NaN,NaN,1.9541742257530335,1.2826832278737077
2008-08-22T09:30:00-04:00,34.86,35.28999,34.73,35.28999,6478586,9015642.45,52.806948135775706,52.51780013608531,NaN,NaN,23.575625350130395,-8.063014968970126,-0.02200365098885207,0.08162922119126392,0.10363287218011599,179570853,174902717.8,50.945674449922905,56.3536272140793,NaN,NaN,2.5046490887410133,1.4572497794261798
2008-08-25T09:30:00-04:00,35.10001,35.10001,34.41,34.74001,5858262,8949701.25,48.35167755902374,52.164285633231025,NaN,NaN,-39.14998269912278,-28.510920802092794,-0.04123228212635735,0.05209251952216931,0.09332480164852666,173712591,173269943.6,48.56972767401468,55.889213847204864,NaN,NaN,1.6986492260738668,1.4917354146615638
2008-08-26T09:30:00-04:00,34.53999,34.74001,34.28999,34.73,7859211,9002693.65,48.27185073888714,51.513126895333805,NaN,NaN,-66.11585827142116,-38.91530996900304,-0.05261259045798179,0.027559063576049425,0.08017165403403122,165853380,171444174.8,45.98705523768238,55.53788015206572,NaN,NaN,1.0184394747281103,1.4241217089567848
2008-08-27T09:30:00-04:00,34.42999,34.99229,34.42999,34.83,5629555,8812768.1,49.174603171228014,51.51849703425352,NaN,NaN,-35.274467585685734,-34.7089213904677,-0.051336651601689334,0.016000839531919553,0.06733749113360889,171482935,172742405.2,48.10034386635124,55.49887014793989,NaN,NaN,0.6859025260426638,1.318661825683339
2008-08-28T09:30:00-04:00,34.91,35.77,34.91,35.61,8420996,8340104.3,55.672779776383315,51.502161364451105,NaN,NaN,69.95257305095059,-9.402422031029738,0.00131810898586035,0.06898512736593432,0.06766701838007397,179903931,174104738,50.29795739403711,55.440547335053004,NaN,NaN,2.2342243945413633,1.4494564783773423
2008-08-29T09:30:00-04:00,35.57001,35.75,35.19,35.22,3775650,8128887.8,52.086913861013585,51.19578137938494,NaN,NaN,56.94364899123624,-2.7288173028085696,0.008746199199831467,0.0785997673798633,0.06985356818003183,176128281,173416223.6,49.164888298434576,54.830262486221045,NaN,NaN,2.5409708100681208,1.6053870971903106
2008-09-02T09:30:00-04:00,35.75999,36.16,35,35.23,10442566,8273165.7,52.1719793932722,51.069224324577895,NaN,NaN,64.97329435775303,18.09583810856659,0.012944827016415611,0.08603460195055135,0.07308977493413574,186570847,175987874.8,53.388489831781925,54.338805753433626,NaN,NaN,2.8153242462754626,1.7782352613453323
2008-09-03T09:30:00-04:00,35.22,35.31,34.702,34.97,9964691,8285156.7,49.70125195370103,50.831553638924994,NaN,NaN,-27.16915001207172,25.885179760436483,-0.002361081750663477,0.0701384227458064,0.07249950449646987,176606156,178138430,56.63336570573261,54.16969867975144,NaN,NaN,2.3784906001566757,1.863986024032667
2008-09-04T09:30:00-04:00,34.64999,34.66,33.52,33.77,11476887,8513254.35,40.23136360425341,49.857265813481874,NaN,NaN,-185.19581476671127,-4.099089675768627,-0.08907291775902296,-0.03884164270230883,0.050231275056714125,165129269,176867696.8,54.23099007675877,53.61109193793948,NaN,NaN,-1.01614167260714,1.4525392102269805
2008-09-05T09:30:00-04:00,33.42,33.78999,33.14,33.75999,12674766,8614205.15,40.16261924428373,48.78294813744172,NaN,NaN,-212.76245337478838,-60.64209496091642,-0.13984963090789268,-0.12458076357815173,0.015268867329740955,152454503,171377811.2,45.292082756416924,52.28022005137022,NaN,NaN,-3.747205425455565,0.7097185479866169
2008-09-08T09:30:00-04:00,34.41,34.82001,33.94,34.3,15607117,8810324.3,45.566332827515154,48.3254387474279,NaN,NaN,-85.22856479682234,-89.07653771852813,-0.13002136896915012,-0.14725784388169672,-0.01723647491254658,168061620,169764479,43.046544852416986,50.988211656341356,NaN,NaN,-4.531878863190272,-0.03908108218150996
2008-09-09T09:30:00-04:00,34.09,34.57001,33.25999,33.28999,11434867,8742277.8,38.553518772292016,47.6077606985508,NaN,NaN,-155.5372208754803,-133.1786407651748,-0.18134460676038527,-0.24391723336302817,-0.0625726266026429,156626753,163775660.2,35.92605758264948,49.37649815371295,NaN,NaN,-7.5464480360748505,-1.1115620755948443
2008-09-10T09:30:00-04:00,33.45,33.86,33.2,33.42999,9732238,8867514.1,39.93348272776443,47.13637359340151,NaN,NaN,-159.25653480312474,-159.5961177233854,-0.1945016983403051,-0.30569974952802426,-0.11119805118771917,166358991,161726227.2,33.861823283063174,47.78088121707287,NaN,NaN,-9.531270803007198,-2.3143776080823235
2008-09-11T09:30:00-04:00,33.14,34.2,33.03999,34.2,8516234,8740728.15,46.98557223804536,47.11934957167425,NaN,NaN,-103.83345146619851,-143.32364506328287,-0.14239819729848596,-0.2891957978108266,-0.14679760051234064,174875225,163675418.4,37.537794831728995,46.64162827435651,NaN,NaN,-9.009856900547788,-3.2708746498631043
2008-09-12T09:30:00-04:00,33.86,34.17,33.57001,34.11,10793258,8800197.5,46.301330343919105,46.65466258654163,NaN,NaN,-78.68136121120901,-116.50742663056697,-0.10668124749469352,-0.28014915988070754,-0.17346791238601403,164081967,166000911.2,41.700986177647,45.981293397765384,NaN,NaN,-8.802143996179039,-4.0610559850510946
2008-09-15T09:30:00-04:00,32.64,33.67,32.64,32.74001,16085512,9298515.85,37.37810283003813,45.87083582018551,NaN,NaN,-163.78515937743236,-132.21874554668898,-0.16455023544234731,-0.37915570668894816,-0.21460547124660084,147996455,161987878.2,37.10495106488969,45.16238078282789,NaN,NaN,-11.659996799078096,-5.146618958483523
2008-09-16T09:30:00-04:00,31.99001,33.2,31.92,32.84,18499824,9911769.15,38.31253816530257,45.15945635064376,NaN,NaN,-171.47376040087633,-135.40605345176817,-0.18385775540917187,-0.4444276655080657,-0.2605699100988938,166496279,163961783.4,40.574311926135586,44.775756260574546,NaN,NaN,-13.589053023376053,-6.3526809677538845
2008-09-17T09:30:00-04:00,32.36,32.37,31.42999,31.73,15598473,10346980.9,32.51257208272912,43.96931127289383,NaN,NaN,-202.85031021996,-144.12480853513523,-0.2547832482321273,-0.5790489703890529,-0.3242657221569256,150897806,160869546.4,37.11992289839729,43.99144047714926,NaN,NaN,-17.32150600738868,-7.919655973415998
2008-09-18T09:30:00-04:00,31.64999,32.85001,30.56,32.38,30949520,11394934.85,38.39399781743415,42.735112561540326,NaN,NaN,-163.7186235086854,-156.10184294363262,-0.2414440640232252,-0.6260708021859571,-0.3846267381627319,181847326,162263966.6,39.61649424686809,43.228478823780044,NaN,NaN,-18.399516174666218,-9.416778859308886
2008-09-19T09:30:00-04:00,35,35,33.10001,33.11,15910059,11785413.6,44.26829920368868,42.176640086017116,NaN,NaN,-22.426846858548593,-144.85094007310053,-0.1703329618405901,-0.5975429404634696,-0.42720997862287946,197757385,168999050.2,49.95239291197737,43.28472915331882,NaN,NaN,-17.273825903148712,-10.539214151286004
2008-09-22T09:30:00-04:00,33,33.38,32.2,32.23,5309395,11726954.05,39.392046171143946,41.26378771300795,NaN,NaN,-100.0678374459723,-132.10747568680853,-0.16909751765358338,-0.6385818756898587,-0.4694843580362753,192447990,177889357.2,59.7469928212055,43.73890793827764,NaN,NaN,-18.019525219809946,-11.607830018217996
2008-09-23T09:30:00-04:00,32.44,32.59,31.5,31.52,12016063,12034844.1,35.95118632920219,40.28164016840089,NaN,NaN,-137.51944519514782,-125.3166126456628,-0.20048913591089135,-0.7200957779248895,-0.5196066420139982,180431927,180676486.8,62.24181492222046,44.139511453741065,NaN,NaN,-19.825460762574842,-12.781777267411831
2008-09-24T09:30:00-04:00,31.85001,31.88,30.97,31.45,8931086,12088437.85,35.62082681941236,39.95231611234082,NaN,NaN,-144.65859941755608,-113.67827048518203,-0.20938490417699906,-0.781337772235247,-0.571952868058248,171500841,184797093.8,65.63314284326015,44.95395093706259,NaN,NaN,-21.325810770510714,-14.002353482140244
2008-09-25T09:30:00-04:00,31.37,31.92999,31,31.7,11687813,12391350.75,37.81849181377551,39.78487843873309,NaN,NaN,-119.0275006349521,-104.74004591043536,-0.1828154956411019,-0.8004722376096254,-0.6176567419685235,183188654,185065359.4,65.84820336931638,46.42224526655541,NaN,NaN,-21.85830862899519,-15.124632788833807
2008-09-26T09:30:00-04:00,31.03,31.61,30.64,31.57001,14530961,12696849,37.1091561543874,39.18079439065253,NaN,NaN,-119.61074364518966,-124.17682526776358,-0.15924341423941024,-0.8167110097677863,-0.6574675955283761,168657693,179245421,57.44894351458643,47.450988028138944,NaN,NaN,-22.498068616703193,-16.17798076424372
2008-09-29T09:30:00-04:00,31.03999,31.34,29.28999,30.5,16947344,13355433.7,31.818705470311343,38.69973629765392,NaN,NaN,-153.6671402137638,-134.89668582132185,-0.19841261926485843,-0.9054833696094491,-0.7070707503445907,151710349,171097892.8,48.18311731991841,48.326492295086716,NaN,NaN,-24.7591115072574,-17.403856584674248
2008-09-30T09:30:00-04:00,30,30.8,29.755,30.8,10050242,13335817.5,34.632494954647555,38.32109431385985,NaN,NaN,-134.18055085140804,-134.2289069525739,-0.18697047256976673,-0.940783841056799,-0.7538133684870323,161760591,167363625.6,44.63012394865166,49.095656628343036,NaN,NaN,-25.744602897387914,-18.59539177220477
2008-10-01T09:30:00-04:00,30.31,30.31,29.38,30.07001,21014512,13888308.55,31.252672689572393,37.197315774683204,NaN,NaN,-146.36688858142884,-134.57056478534847,-0.20971133938639763,-1.0159525427200293,-0.8062412033336317,140746079,161212673.2,39.46760208997946,49.23350000393236,NaN,NaN,-27.66152331057731,-19.890553420543704
2008-10-02T09:30:00-04:00,29.63,29.63,27.81,28.27,14679254,14048426.9,24.820434088149923,35.66296604212826,NaN,NaN,-188.7338726805367,-148.51183919446538,-0.3204935450966012,-1.2068581347043832,-0.886364589607782,126066825,149788307.4,32.051765037053826,48.54426992246142,NaN,NaN,-31.785924633008307,-21.589892165181503
2008-10-03T09:30:00-04:00,28.5,28.92999,27.58,27.82001,18081808,14318779,23.51733990294099,34.67291154733561,NaN,NaN,-182.85386942923515,-161.16046435127447,-0.39376537797330236,-1.3785713120744099,-0.9848059341011075,107985017,137653772.2,26.38159357621612,47.778315816127595,NaN,NaN,-35.49864462117801,-23.57685680175243
2008-10-06T09:30:00-04:00,26.87,27.21001,25.57001,27.09,20767296,14576787.95,21.541494776316455,33.474979876693745,NaN,NaN,-210.19742300538357,-172.46652090959844,-0.456658156574562,-1.55562862981931,-1.098970473244748,87217721,124755246.6,21.93877802892736,46.44720625204129,NaN,NaN,-39.238775779214166,-25.81427379853268
2008-10-07T09:30:00-04:00,27.57001,27.78,25.82001,26.19,15985129,14804301.05,19.37971937178125,32.536918968768894,NaN,NaN,-173.16824318432998,-180.26405937618284,-0.5195561500130876,-1.7484156607611077,-1.22885951074802,71232592,106649646.8,17.487027813962342,45.044856603153086,NaN,NaN,-43.12290293050839,-28.286935103100635
2008-10-08T09:30:00-04:00,25.03,26.75,25.03,25.78999,19231952,15279286.75,18.491500665460066,31.11531202934218,NaN,NaN,-165.36444532218556,-184.06357072433417,-0.5460678279670501,-1.9114442957068327,-1.3653764677397826,52000640,88900559,14.401825179395033,43.2438088126193,NaN,NaN,-46.5167246955364,-30.89119075916289
2008-10-09T09:30:00-04:00,26.42,26.42,24,24.32001,15437438,15625346.95,15.65241196056283,29.07132008340462,NaN,NaN,-165.49695746657622,-179.41618768154208,-0.6154218690454285,-2.134653804046568,-1.5192319350011396,36563202,70999834.4,12.085893638991735,40.5390588645489,NaN,NaN,-50.53861105212432,-33.69796508672881
2008-10-10T09:30:00-04:00,22.91,24.92,22.2,23.53999,23376032,16254485.65,14.389878419146939,27.28545095826198,NaN,NaN,-169.8994561384218,-176.8253050233794,-0.6625587136460109,-2.347430327058653,-1.6848716134126422,13187170,52040265,10.212668565094233,37.00089284625523,NaN,NaN,-54.252307782155285,-36.63429975750402
2008-10-13T09:30:00-04:00,25.1925,26.46001,24.60001,26.06,7824109,15841415.5,33.15029100572404,27.085387006584966,NaN,NaN,-97.09552237038362,-154.20492489637942,-0.48118894817056956,-2.286357798625854,-1.8051688504552845,21011279,38798976.6,9.146441254958248,33.2083661557365,NaN,NaN,-50.353343985089005,-38.59416321858759
2008-10-14T09:30:00-04:00,27.8,27.8,25.06,26.05,17373728,15785110.7,33.11927538216206,26.90670476106709,NaN,NaN,-72.6706269592977,-134.10540165137297,-0.3264659699016452,-2.213251312832341,-1.8867853429306958,3637551,25279968.4,8.20462035306393,29.106328835008203,NaN,NaN,-47.515983577765184,-39.86870898418439
2008-10-15T09:30:00-04:00,25.44,25.44,23.41,23.60001,15899254,15800149.75,26.56224803831212,26.102687348533994,NaN,NaN,-112.64924388119104,-123.56236136317406,-0.35152589536394685,-2.3261927121356294,-1.9746668167716825,-12261703,12427499.8,7.4221428055497825,24.933038794739158,NaN,NaN,-47.465485417244956,-40.9539627603359
2008-10-16T09:30:00-04:00,23.44,24.58,22.46001,24.08,20528144,15279080.95,29.506843817436263,25.55966503875177,NaN,NaN,-110.4014033678175,-112.54325054342235,-0.30017090195465945,-2.3498804442150067,-2.0497095422603473,8266441,6768147.6,7.101000308159968,21.336757137137273,NaN,NaN,-46.35369036947809,-41.72535241878478
2008-10-17T09:30:00-04:00,23.24001,25.17999,23.24001,23.56,12076066,15087381.3,28.188194227552117,25.30034280712611,NaN,NaN,-94.60060484460918,-97.4834802846598,-0.2667455068514082,-2.3831414258246078,-2.1163959189731996,-3809625,3368788.6,6.907663458405523,18.388510432743495,NaN,NaN,-45.93810946969068,-42.32717485462848
2008-10-20T09:30:00-04:00,24.39999,24.92,23.97,24.73,13286875,15486255.3,35.204648479248746,25.341210916026196,NaN,NaN,-74.4523355506817,-92.95484292071941,-0.1378504322374603,-2.288708959270025,-2.1508585270325646,9477250,1061982.8,6.772901123237574,15.684423088071057,NaN,NaN,-43.154449553129155,-42.445356954414294
2008-10-21T09:30:00-04:00,24.73,25.10001,24.17999,24.50999,11165473,15443725.8,34.52159617470477,25.57470545067851,NaN,NaN,-67.61203239850408,-91.9431240085607,-0.04426670672537503,-2.2061919104392835,-2.1619252037139085,-1688223,-3172,6.707827406223672,13.344439182088502,NaN,NaN,-41.209156589472954,-42.26875690227982
2008-10-22T09:30:00-04:00,23.61,23.85001,22.33,23.38,20321408,16013241.9,31.175876963756608,26.02866565607898,NaN,NaN,-100.24771046594141,-89.46281732551077,-0.035693169208876,-2.2065416652250036,-2.1708484960161276,-22009631,-1952757.6,6.583152497917268,11.525252572150176,NaN,NaN,-40.645781817614875,-42.03690331875625
2008-10-23T09:30:00-04:00,23.24001,23.60001,21.92,23.44,19569312,16407316.85,31.555192353106918,26.60279797394798,NaN,NaN,-100.48477604102386,-87.47949186015204,-0.004828075891714079,-2.17688359088077,-2.172055514989056,-2440319,-4094109.6,6.441534977637431,10.1009626722517,NaN,NaN,-40.08776879708299,-41.758455529945785
2008-10-24T09:30:00-04:00,21.64999,22.72,21.56,22.09,17650160,16563276.8,27.837622638186843,27.05252139265301,NaN,NaN,-120.0612854385287,-92.57162797893594,-0.051580968273059025,-2.23653172533038,-2.184950757057321,-20090479,-7350280.4,6.222335121408619,8.978359607428933,NaN,NaN,-40.78026823086485,-41.61871448721994
2008-10-27T09:30:00-04:00,21.8,22.75999,21.24001,21.24001,11494184,16290618.8,25.77837508159105,27.50956822906799,NaN,NaN,-122.99845335873306,-102.2808515405462,-0.11250541295991745,-2.325582523257218,-2.2130771102973004,-31584663,-15562663,5.69588327134376,8.136134997241893,NaN,NaN,-42.01692929092097,-41.67560231632009
2008-10-28T09:30:00-04:00,22.16,23.73,21.39,23.42,12324086,16404311,38.3702930831647,28.929481973189755,NaN,NaN,-81.2776955487871,-105.01398417060281,0.014504115587958388,-2.1949469658123526,-2.209451081400311,-19260577,-19077133.8,5.482121820165091,7.499013328725469,NaN,NaN,-38.77865483844857,-41.261752676624155
2008-10-29T09:30:00-04:00,23.84,24.92,23.47,23.52,15938332,16150502,38.8825137466243,30.588774957908434,NaN,NaN,-32.5182102015514,-91.4680841177248,0.1198758079360922,-2.059606321480196,-2.179482129416288,-3322245,-15339656.6,9.37713896563183,7.305530852056909,NaN,NaN,-36.118497996372405,-40.527002008016765
2008-10-30T09:30:00-04:00,24.2,24.83,23.85001,24.37,14639219,16148500.25,43.203585897276064,32.64689692063194,NaN,NaN,-7.442200865345808,-72.85956908258919,0.2537515921659992,-1.862292639208789,-2.1160442313747883,11316974,-12588198,12.24422183378526,7.450641799820553,NaN,NaN,-32.514988195868746,-39.38242860628134
2008-10-31T09:30:00-04:00,24.53,25.3,24.09,25.17999,12745816,15881700.65,47.04571998107754,33.63942756172862,NaN,NaN,31.783132045090365,-42.4906855858654,0.39534350320624156,-1.6218648523669863,-2.017208355573228,24062790,-3757544.2,20.89438586189185,8.28978070031581,NaN,NaN,-28.28775237146631,-37.79747485845062
2008-11-03T09:30:00-05:00,25.09,25.19,24.62,24.75,8841336,15285402.65,45.29403505158674,34.50905325240181,NaN,NaN,40.14437556027603,-9.862119802063578,0.45431555650451116,-1.449313909942589,-1.9036294664471,15221454,5603679.2,28.89582584203832,9.76772394952827,NaN,NaN,-25.36913788269181,-36.02199814762793
2008-11-04T09:30:00-05:00,25.52,26.36,25.25,25.83,15205430,15246417.7,50.2995239879279,36.204572963088644,NaN,NaN,109.98065265880884,28.38954983945562,0.5537402282383197,-1.2114541811492003,-1.76519440938752,30426884,15541171.4,36.26574362442303,11.827981150876358,NaN,NaN,-21.283022758789244,-33.91643023493669
2008-11-05T09:30:00-05:00,26.14,26.17999,24.69,24.75,15585535,15064096.85,45.78776443918202,37.36749586464192,NaN,NaN,73.2118228798891,49.53555645574372,0.5341995720898676,-1.0974449442751855,-1.631644516365053,14841349,19173890.2,38.76442572339703,14.089654394821864,NaN,NaN,-19.19010319521412,-31.81266922926204
2008-11-06T09:30:00-05:00,24.5,24.92999,23.14999,23.59,13678625,14976156.2,41.48370261993881,38.31717503552668,NaN,NaN,-16.618795355586204,47.700237557695644,0.4347951446632432,-1.088150585535999,-1.5229457301992422,1162724,17143040.2,37.87056346878423,16.301290109848914,NaN,NaN,-18.774069664576302,-29.95001214859265
2008-11-07T09:30:00-05:00,23.94,24.0623,23.28,23.83,11548094,14384759.3,42.684146225223245,38.85142487452486,NaN,NaN,-29.55179633735132,35.433251881207305,0.3788983402215811,-1.0493228049222658,-1.428221145143847,12710818,14872645.8,36.847612677412876,18.449483792290007,NaN,NaN,-18.076817137234574,-28.253841432684354
2008-11-10T09:30:00-05:00,24.55,24.61,23.52,23.84,9504031,14468755.4,42.73685871554078,39.43822934172743,NaN,NaN,-4.155704028316838,26.57323596348873,0.33765982519940896,-1.0061463636445858,-1.3438061888439947,22214849,16271324.8,37.959421825150905,20.681740536499095,NaN,NaN,-17.502375592384734,-26.71791774121298
2008-11-11T09:30:00-05:00,23.44,23.75,22.83,23.31,15414570,14370797.5,40.605371139622065,40.11176464000353,NaN,NaN,-52.7578235485822,-5.974459277989477,0.27253949960326573,-1.0031318143399126,-1.2756713139431783,6800279,11546003.8,35.674376558585706,22.759685112261128,NaN,NaN,-17.619070701411854,-25.418082449812818
2008-11-12T09:30:00-05:00,22.92,22.92,21.96001,22.2,11420742,14146871.9,36.49955437898115,40.46493335613741,NaN,NaN,-116.66457205532537,-43.949738265032366,0.1582288152179845,-1.0778852949206978,-1.2361141101386823,-4620463,7653641.4,33.865933235244,24.71857070209017,NaN,NaN,-18.940949216150095,-24.492777702146714
2008-11-13T09:30:00-05:00,22.42999,23.47,20.89999,23.39,24198496,14330389.5,43.1377327377733,41.55779836325072,NaN,NaN,-87.26939832187425,-58.07985885828998,0.1654989131885567,-1.0292404686529864,-1.194739381841543,19578033,11336703.2,37.11441217895015,26.925147634771708,NaN,NaN,-18.093510914241907,-23.578596732446027
2008-11-14T09:30:00-05:00,23.17999,23.56,22.19,22.39999,17514256,14602299,39.44349502429906,42.53387835915844,NaN,NaN,-69.28939234153701,-66.02737805912712,0.10909202878043756,-1.058374345865996,-1.1674663746464335,2063777,9207295,36.01300282376078,29.090656174230066,NaN,NaN,-18.511098140802698,-22.854668362211264
2008-11-17T09:30:00-05:00,21.89999,22.62,21.64,21.95,17218816,14798896.05,37.8565688064802,42.49718376796669,NaN,NaN,-102.67152984606032,-85.7305432226758,0.04994475954830446,-1.105035425211053,-1.1549801847593575,-15155039,1733317.4,32.38079090016092,31.011989679944048,NaN,NaN,-19.335428795506342,-22.351919852681988
2008-11-18T09:30:00-05:00,21.83,22.25999,21.27,21.97,14682098,14974727.3,37.97600965083975,42.432433475410654,NaN,NaN,-107.18818427494459,-96.6166153679483,0.022060297395803286,-1.1274048130146035,-1.1494651104104068,-472941,278673.4,31.710437691266577,32.60722530320368,NaN,NaN,-19.966332690071116,-22.01112168659472
2008-11-19T09:30:00-05:00,22.21001,22.21001,20.50999,20.55,23026320,15109972.9,33.110128134946564,41.71147220667283,NaN,NaN,-137.19785999841008,-100.72327295656524,-0.07671520913502294,-1.2453591218291855,-1.1686439126941626,-23499261,-3497086.2,29.975760193388112,33.87376375746102,NaN,NaN,-22.027428702951934,-22.013451260360036
2008-11-20T09:30:00-05:00,20.34,21.07001,19.24001,20,20907024,15176858.5,31.43031870887262,40.596086401515336,NaN,NaN,-167.14447816415944,-116.69828892502228,-0.15904965662241954,-1.3674559834721869,-1.2084063268497673,-44406285,-16293949.8,24.98679043182382,34.16607836959902,NaN,NaN,-24.26060133614775,-22.33447269975828
2008-11-21T09:30:00-05:00,20.06,20.75999,19.19,20.59,27855872,15687144.1,35.22669469108443,39.876990661479454,NaN,NaN,-146.0757065170907,-132.055551760133,-0.1536484159371052,-1.400466846771149,-1.2468184308340438,-16550413,-20016787.8,23.748473947678136,33.79841037714472,NaN,NaN,-25.034838919730294,-22.720239302611425
2008-11-24T09:30:00-05:00,20.88,22.16,20.81,21.62,20405504,16132710.1,41.333284610897,39.23654499169153,NaN,NaN,-76.76231516797657,-126.87370882451626,-0.06510931969015088,-1.3282050804467325,-1.2630957607565816,3855091,-16214761.8,27.68983447762851,33.18584543808797,NaN,NaN,-23.86578511143696,-22.883888703872216
2008-11-25T09:30:00-05:00,22.25,22.38,21.37,21.92999,14812281,16257119.85,43.07275875632555,39.04261601434464,NaN,NaN,-54.24567960440158,-116.28520789040765,0.025096649230215817,-1.2317249492188118,-1.2568215984490276,18667372,-12386699.2,31.527460836633182,32.668919374747695,NaN,NaN,-22.392875963127462,-22.813744026622967
2008-11-26T09:30:00-05:00,21.56,22.75999,21.41,22.62,11156348,16018020.65,46.850382762214295,39.42595031022147,NaN,NaN,-32.68024033879561,-95.38168395848477,0.1358134239643547,-1.0870548184935842,-1.222868242457939,29823720,-1722103,40.93252583257058,32.887630972161006,NaN,NaN,-20.0153995242018,-22.413980526277086
2008-11-28T09:30:00-05:00,22.56,23.25,22.50999,23.11,4169273,15494523.35,49.417379377743245,39.90689553540146,NaN,NaN,4.9819090640450145,-60.95640651284386,0.2405083009342439,-0.922232866290134,-1.162741167224378,33992993,13957752.6,51.48399085095726,33.933086555985604,NaN,NaN,-17.259265039508282,-21.67759259959583
2008-12-01T09:30:00-05:00,22.78,22.78,21.14,21.21001,11050047,15409734.9,41.12354086529668,39.79165854609831,NaN,NaN,-54.65383181863841,-42.672031573153404,0.18286874518297158,-0.9341552357456635,-1.117023980928635,22942946,21856424.4,55.7702240524552,35.20528671507877,NaN,NaN,-17.297999752669604,-21.05193647860637
2008-12-02T09:30:00-05:00,21.66,22.24001,21.38,22.19,13488137,15642074.95,46.14422771557694,40.187291158666525,NaN,NaN,-37.0791932897404,-34.73540719750618,0.20987947328076428,-0.8546746393276798,-1.0645541126084441,36431083,28371622.8,58.98871549471685,36.870596639088134,NaN,NaN,-15.714683344853567,-20.28947174521311
2008-12-03T09:30:00-05:00,21.87,22.77,21.53,22.57001,18148976,15789252.25,47.99611810927064,41.008474282258625,NaN,NaN,-6.538092115436725,-25.19388969971321,0.2497637326354547,-0.7523494468141259,-1.0021131794495806,54580059,35554160.2,62.25000568398396,38.8980303854267,NaN,NaN,-13.858186175684628,-19.370716663851898
2008-12-04T09:30:00-05:00,22.25999,22.87,21.73,22.12,16594352,15839693.1,45.97978723139852,41.21147817466043,NaN,NaN,0.5988442476633913,-18.538072782421406,0.24208687380860883,-0.6995045871888195,-0.9415914609974283,37985707,37186557.6,62.97072142044085,40.744909616961756,NaN,NaN,-12.93123739947556,-18.450791054655276
2008-12-05T09:30:00-05:00,21.71001,22.73,21.24001,22.662,19686224,16140073.05,48.77124641629501,41.87774613123156,NaN,NaN,5.870722276430415,-18.36031013994432,0.26775805687187726,-0.6068938899075818,-0.874651946779459,57671931,41922345.2,65.05512409517411,42.81934685063413,NaN,NaN,-11.323920358157427,-17.432666669441296
2008-12-08T09:30:00-05:00,23.55,23.95,22.89999,23.25,17034320,16414384.35,51.687955608731755,42.86570233139239,NaN,NaN,120.5190000939178,16.674256242566894,0.3153107584592594,-0.48051349870538473,-0.7958242571646441,74706251,52275006.2,69.14413739645485,45.44530017179799,NaN,NaN,-9.10042526547754,-16.242346468875045
2008-12-09T09:30:00-05:00,23.23,23.46001,22.60001,22.84,15503777,16714371.65,49.56872460152595,43.69375339929855,NaN,NaN,92.74041372210412,42.6381776449358,0.3096768952584066,-0.4087281380916359,-0.7184050333500425,59202474,56829284.4,70.76480256448205,48.23489766274195,NaN,NaN,-7.845220892440365,-15.042757100812947
2008-12-10T09:30:00-05:00,23.14,23.47,22.82001,23.21001,10248781,16456082.2,51.50128666420889,45.007407579960145,NaN,NaN,115.39891457049418,67.02557898212198,0.32007465973070803,-0.31831170868665737,-0.6383863684173654,69451255,59803523.6,71.80627802024775,51.22279179323192,NaN,NaN,-6.241543476275168,-13.78544086873612
2008-12-11T09:30:00-05:00,22.77,23.08,22.05499,22.21001,12010621,16485576.15,46.333550839708415,46.07192416073413,NaN,NaN,38.85547538798336,74.67690521018598,0.25181531734836304,-0.32361722173191154,-0.5754325390802746,57440634,63694509,73.15367698991447,54.6632836902384,NaN,NaN,-6.327497376064177,-12.720020369782986
2008-12-12T09:30:00-05:00,21.72,22.37,21.5,22.27,10671301,15809216.4,46.679205472911555,46.88996064515036,NaN,NaN,-0.4654910333187381,73.40966254823614,0.20490563917665539,-0.3193004901094554,-0.5242061292861108,68111935,65782509.8,73.87520376632791,58.24376439157053,NaN,NaN,-6.3014608122754,-11.803083290139046
2008-12-15T09:30:00-05:00,22.57001,22.57001,21.87,22.25999,10048742,15435940.7,46.62524192210091,47.267957595950634,NaN,NaN,23.19110569478552,53.94408366840969,0.16890234189770909,-0.3130782019139744,-0.4819805438116835,58063193,62453898.2,70.61688662723776,61.3099824022569,NaN,NaN,-6.294423326070708,-11.016131866700713
2008-12-16T09:30:00-05:00,22.32001,23.50999,22.25,23.36,14467074,15298353.6,53.0487394220078,47.980527643499364,NaN,NaN,101.2149576482993,55.638992453648726,0.2120762257948937,-0.2168852615680663,-0.42896148736296,72530267,65119456.8,71.69357370207518,64.17899046407419,NaN,NaN,-4.464986472074947,-10.080253953182746
2008-12-17T09:30:00-05:00,23.22,23.63,22.92999,23.37,10703020,15099399.7,53.103992891919326,48.427214081335435,NaN,NaN,115.45989435864816,55.65118841127952,0.23256833024593543,-0.13825107455554075,-0.3708194048014762,83233287,67875863.2,72.80337787712557,66.45547989582812,NaN,NaN,-2.9481212024032732,-9.061377845928536
2008-12-18T09:30:00-05:00,23.46001,23.56,22.49001,22.55,12514855,14573826.45,48.10480672732662,48.33345889201996,NaN,NaN,66.55707194869798,61.191507723422454,0.18427097354527527,-0.1404806878698821,-0.3247516614151574,70718432,70531422.8,73.86643700915994,68.05422604998545,NaN,NaN,-2.990772937059203,-8.194148573232917
2008-12-19T09:30:00-05:00,22.64,23.03,22.46001,22.58,13076988,14182324.65,48.29657798064102,48.845818685973136,NaN,NaN,39.07404468477534,69.09941486704126,0.14921456593601834,-0.13823345399513443,-0.28744801993115277,83795420,73668119.8,75.10428755775587,69.43523058607835,NaN,NaN,-2.9746401749318983,-7.448504516332772
2008-12-22T09:30:00-05:00,22.75,22.75,21.92,22.23,10035105,13291286.3,46.15371449257058,48.84649631290125,NaN,NaN,-25.23944732012956,59.413304264058254,0.09970424108279985,-0.16281771857765293,-0.2625219596604528,73760315,76807544.2,76.31357952383108,70.67272087387222,NaN,NaN,-3.5379260473144547,-6.889850449330155
2008-12-23T09:30:00-05:00,22.36,22.58,22.02,22.16,6316680,12586845.1,45.71682770499608,48.68368985545307,NaN,NaN,-39.82170123918073,31.205972486562235,0.06137159369613618,-0.18580746754028254,-0.24717906123641872,67443635,75790217.8,75.04153219515767,71.58640133895607,NaN,NaN,-4.126254926109417,-6.49505108887005
2008-12-24T09:30:00-05:00,22.17999,22.39,22.13,22.3,2206967,11956579.4,46.80144559088216,48.74237973827333,NaN,NaN,-41.1241053581763,-0.1108274568026573,0.04531618984109903,-0.19053382393504492,-0.23585001377614395,69650602,73073680.8,71.60904202236026,72.20342423909317,NaN,NaN,-4.358208941264267,-6.1897879249263665
2008-12-26T09:30:00-05:00,22.47,22.56,22.22,22.47,1231221,11460323.05,48.156058235726846,48.698437725375605,NaN,NaN,-19.544970071653054,-17.331235860872866,0.0458766266014948,-0.17850423052427544,-0.22438085712577024,70881823,73106359,71.6258555007865,72.67276219663691,NaN,NaN,-4.222563780015239,-5.908755904224777
2008-12-29T09:30:00-05:00,22.37,22.48,21.86,22.05,3072489,11405483.85,45.10055839462065,48.22790935293909,NaN,NaN,-61.673407762444114,-37.480726350316765,0.019065187571928877,-0.20054937266085915,-0.21961456023278803,67809334,69909141.8,67.41899149070414,72.54953748908328,NaN,NaN,-4.88494145900126,-5.762496697764274
2008-12-30T09:30:00-05:00,22.38,22.97,22.28999,22.87,4753969,11090679.95,51.562490424426585,48.370321197432,NaN,NaN,29.305466865337362,-26.571743513223378,0.05559353673123715,-0.1501226393187416,-0.20571617604997874,72563303,69669739.4,67.10118709699759,72.28785066997725,NaN,NaN,-3.740838828681783,-5.47368843075249
2008-12-31T09:30:00-05:00,23.02,23.53999,22.86,23.42,6278914,10730218.8,55.358012328266504,48.645801602007545,NaN,NaN,113.53691885074988,4.099980504762743,0.11254968346215713,-0.06502907172228234,-0.17757875518443947,78842217,71949455.8,68.61821075558848,72.06013157964445,NaN,NaN,-1.6560025315519342,-4.928304730866696
2009-01-02T09:30:00-05:00,23.52,24.42,23.27,24.28,6659438,10155741.9,60.5618810709059,49.662110904235924,NaN,NaN,195.06066543346202,51.3369346630904,0.19885079491995833,0.07098473846550846,-0.12786605645444987,85501655,75119666.4,70.64533875776632,71.88096456306243,NaN,NaN,1.800839503241763,-3.9669984117083446
2009-01-05T09:30:00-05:00,24.17999,24.46001,23.88,24.09,11182035,9885126.05,58.92754636987374,50.53699239687608,NaN,NaN,180.3049319920272,91.30691507582647,0.2315589467001408,0.1615826269207261,-0.06997631977941468,74319620,75807225.8,71.08163750144121,71.68142411557052,NaN,NaN,4.196059853088813,-2.8008472310230363
2009-01-06T09:30:00-05:00,24.42,24.74001,24.23,24.62,13438273,9572728.5,62.00751503581795,51.63572619071301,NaN,NaN,192.54362061826365,142.150320751968,0.2743824025282071,0.2730016833808442,-0.001380719147362916,87757893,79796937.6,73.53931015167018,71.89016865302997,NaN,NaN,7.187088496004433,-1.3739992700191122
2009-01-07T09:30:00-05:00,24.25999,24.25999,23.50999,23.52,10726109,9257317.95,53.10640706236661,51.6398453078815,NaN,NaN,95.48483480757046,155.38619434041465,0.21665289363056367,0.2694353978908417,0.052782504260278015,77031784,80690633.8,74.07089301036613,72.05997717505076,NaN,NaN,7.139211555127386,-0.1578262949981839
2009-01-08T09:30:00-05:00,23.50999,23.77,23.35001,23.75,11184352,9041346.7,54.57471529597393,51.74489690817111,NaN,NaN,71.32485980114839,146.94378253049433,0.18330870783592884,0.28191838905518907,0.09860968121926023,88216136,82565417.6,75.1966040282081,72.2309219001281,NaN,NaN,7.543366662508172,0.942344127502724
2009-01-09T09:30:00-05:00,23.85001,23.8877,23.2,23.23,6161375,8836976.4,50.708842057935826,51.930899431786045,NaN,NaN,48.86826643286911,117.70530273037575,0.11871568197011162,0.24700428368189975,0.12828860171178813,82054761,81876038.8,73.92566127255166,72.23515220465607,NaN,NaN,6.704281823986085,1.765478084143204
2009-01-12T09:30:00-05:00,23.22,23.27,22.61,22.72,8466848,8659787.75,47.17899164800584,51.851071836597825,NaN,NaN,-13.889442603403623,78.86642781128958,0.038290161274360385,0.1761513033047386,0.13786114203037822,73587913,81729697.4,73.64112206048685,72.13064038342257,NaN,NaN,4.903430162294617,2.2137569524505487
2009-01-13T09:30:00-05:00,22.71001,22.81,22.00999,22.33,19223424,9087393.9,44.62104512928754,51.74159545350618,NaN,NaN,-69.75490916441753,26.406721854753346,-0.040271973127378125,0.08752117562115558,0.1277931487485337,54364489,75051016.6,61.926424581442625,71.10298645896626,NaN,NaN,2.610967881253735,2.270501370851004
2009-01-14T09:30:00-05:00,21.99001,22.00999,21.39,21.5,15643090,9367111.3,39.689160717625334,51.31104781155113,NaN,NaN,-143.2309879292166,-21.33644269260405,-0.1415358003035434,-0.04912660163089555,0.09240919867264785,38721399,67388939.6,51.75457488147216,69.43963236513157,NaN,NaN,-0.9862262013679537,1.8052545748197244
2009-01-15T09:30:00-05:00,21.55,21.86,20.8,21.7,14149156,9351215.4,41.370765605068016,50.92314209827868,NaN,NaN,-140.975234813934,-63.79646161562052,-0.185665409103896,-0.13967256270722217,0.045992846396673844,52870555,60319823.4,44.49317120375102,67.50278444951662,NaN,NaN,-3.416248633175656,1.0593255451060988
2009-01-16T09:30:00-05:00,21.92,22.06,21.22,21.82001,9030164,9267572.6,42.40843637228057,50.51259767946109,NaN,NaN,-105.37419756219826,-94.644954414634,-0.19635265559117426,-0.199447973092294,-0.0030953175011197293,61900719,56289015,40.96390136399314,65.31264486831711,NaN,NaN,-5.109185628342513,0.17810966318486843
2009-01-20T09:30:00-05:00,21.67999,21.84,20.8,20.81,13047930,9294226.35,36.546000137228006,49.901557803933045,NaN,NaN,-136.6137418758989,-119.18981426913305,-0.2571863431932264,-0.32457824649265277,-0.06739190329942633,48852789,51341990.2,37.076763557817536,63.14534287311091,NaN,NaN,-8.500281193476479,-1.0616604591953238
2009-01-21T09:30:00-05:00,21.25,21.44,20.57001,21.34,16046063,9442680.1,41.14382854665645,49.15736766980661,NaN,NaN,-121.96449810605752,-129.63173205746108,-0.24739582600558718,-0.3766366858064103,-0.12924085980082312,64898852,53448862.8,39.7010847999385,61.18819270903526,NaN,NaN,-9.959746394830386,-2.3328155928574756
2009-01-22T09:30:00-05:00,21.03999,21.48,20.67,21.27,17930144,9837432.05,40.72411569032479,48.11208933852505,NaN,NaN,-108.78421414813734,-122.74237730124521,-0.23157939372311817,-0.41871510195472084,-0.18713570823160267,46968708,55098324.6,41.749391931253655,59.26899136443992,NaN,NaN,-11.259153853603323,-3.6080067729640253
2009-01-23T09:30:00-05:00,20.69,21.08,20.53999,20.63,19148400,10479018.05,37.00706229797734,46.42960228331587,NaN,NaN,-122.95158703908686,-119.1376477462758,-0.24866341021032815,-0.49796497099451287,-0.24930156078418472,27820308,50088275.2,37.574344444280804,56.90677748490525,NaN,NaN,-13.522938107731344,-5.024425535073642
2009-01-26T09:30:00-05:00,20.64,21.28,20.5,20.87,19811696,11359254.5,39.24647714895013,45.02381162467848,NaN,NaN,-102.24799078133871,-118.51240639010389,-0.22874691985364964,-0.5352352106012468,-0.30648829074759715,47632004,47234532.2,35.40262243412758,54.358276408668566,NaN,NaN,-14.747441820337471,-6.413427861539903
2009-01-27T09:30:00-05:00,21.05,21.39,20.96741,21.25,14817309,12038558.9,42.71873772675139,43.646041816888,NaN,NaN,-73.60781605288074,-105.91122122550023,-0.17722745052553346,-0.5280226039045139,-0.3507951533789805,62449313,49953837,39.019481974972685,51.8925743960473,NaN,NaN,-14.778901706627966,-7.608495553695341
2009-01-28T09:30:00-05:00,21.82001,22.09979,21.64999,21.86,17245952,12747232.05,47.86941526812708,43.27197097444232,NaN,NaN,-31.229611997709416,-87.76424400383063,-0.09351858205639435,-0.46769338094947344,-0.3741747988930791,79695265,52913119.6,42.774561345355494,49.65712213426083,NaN,NaN,-13.259215956210104,-8.415741325483165
2009-01-29T09:30:00-05:00,21.73,21.73,20.99001,21.06,11543070,13086687.1,42.47515838592019,42.40771690943848,NaN,NaN,-62.21910006034086,-78.45122118627133,-0.08379193724298706,-0.47891472044681294,-0.3951227832038259,68152195,57149817,47.73650835161611,47.695686728789966,NaN,NaN,-13.58042506999115,-9.153553288984305
2009-01-30T09:30:00-05:00,21.12,21.23,20.39999,20.61,7889891,13167235.95,39.760983485217956,41.6257270113872,NaN,NaN,-84.83605320577519,-70.82811441960898,-0.09841864262625544,-0.5181460864866452,-0.41972744386038974,60262304,63638216.2,54.275446952745,46.29209999166092,NaN,NaN,-14.68978926692589,-9.94444414297596
2009-02-02T09:30:00-05:00,20.3,20.33,19.85001,20.14,9383484,13303438.25,37.09482376614122,40.90542930553972,NaN,NaN,-115.78635824138995,-73.53578791161922,-0.12859483732609256,-0.5804709905180054,-0.4518761531919129,50878820,64287579.4,54.883828277145184,44.952293292850804,NaN,NaN,-16.449854085246116,-10.873788420443125
2009-02-03T09:30:00-05:00,20.17999,20.61,20.105,20.50999,9090258,13198849.4,40.47843308092904,40.60952844494268,NaN,NaN,-94.123263473622,-77.63887739576748,-0.11303597161939505,-0.5931711177161567,-0.48013514609676167,59969078,63791532.4,54.289587047294006,44.40680489755447,NaN,NaN,-16.895620037194902,-11.734050079979093
2009-02-04T09:30:00-05:00,20.73,20.98,20.39999,20.39999,10429742,13048422.85,39.79311971947284,40.616954087931795,NaN,NaN,-79.84129453170202,-87.36121390256599,-0.10000108614708725,-0.6051365037806207,-0.5051354176335334,49539336,57760346.6,47.54863820819594,44.10638084946332,NaN,NaN,-17.457366511205798,-12.55166671301148
2009-02-05T09:30:00-05:00,20.25,20.89999,20.03999,20.64,11882344,13106234.6,42.09663269102394,40.66880173692864,NaN,NaN,-82.21352322536286,-91.3600985355704,-0.06666674960736907,-0.5884688546427448,-0.5218021050353757,61421680,56414243.6,46.170695449846754,44.22620400989872,NaN,NaN,-17.27478664203432,-13.226398131443315
2009-02-06T09:30:00-05:00,20.85001,21.31,20.71001,21.14,12767160,13185375,46.67393335107193,40.9734800925566,NaN,NaN,-28.289282184984273,-80.05074433141222,-0.005612649984500284,-0.528817917516001,-0.5232052675315008,74188840,59199550.8,49.43593160450331,44.83134902707802,NaN,NaN,-15.783370875244385,-13.591679951986325
2009-02-09T09:30:00-05:00,21.19,21.72,21.05,21.53999,8462738,13300443.15,50.07406431631652,41.939770391062915,NaN,NaN,30.345392423984965,-50.82439419833723,0.06324549113472167,-0.4441484036130987,-0.5073938947478204,82651578,65554102.4,55.99437156653372,46.18260674198632,NaN,NaN,-13.504497347920374,-13.579225294262619
2009-02-10T09:30:00-05:00,21.42999,21.55,20.32001,20.41,8791191,13316660.3,41.93863407484103,41.99654221450468,NaN,NaN,-56.01589664369906,-43.20292083235265,0.035601498179001934,-0.462892022024068,-0.4984935202030699,73860387,68332364.2,58.52713988094101,47.52732496205793,NaN,NaN,-13.942201997283107,-13.631079108979831
2009-02-11T09:30:00-05:00,20.53,20.78,20.35001,20.57001,6449629,12677970.55,43.34236331434235,42.18355990193451,NaN,NaN,-78.75992147566978,-42.9866462211462,0.031164624241390104,-0.4595377399013323,-0.4907023641427224,80310016,74486500.2,63.53388354411198,49.0833600772621,NaN,NaN,-13.866655831936885,-13.664732926545124
2009-02-12T09:30:00-05:00,20.28999,20.39999,19.7,20.34,12775191,12534575.6,41.778727594769535,42.524393137419665,NaN,NaN,-134.59408012579541,-53.46275760123272,0.01654491544634773,-0.47002121983478773,-0.48656613528113546,67534825,75709129.2,64.45204339459225,51.00319571657006,NaN,NaN,-14.266493609241005,-13.750698738358821
2009-02-13T09:30:00-05:00,20.46001,20.75999,20.3,20.34,8666891,12260462.35,41.77872759476954,42.7052681692639,NaN,NaN,-73.43677744189098,-62.49225665261406,0.010950183975630523,-0.4728784053115973,-0.48382858928722783,67534825,74378326.2,62.604320453619366,52.94617414653376,NaN,NaN,-14.59068461865057,-13.870696721257643
2009-02-17T09:30:00-05:00,19.64,19.8243,19.28,19.31,15837770,12600842.65,35.186158083630204,42.167226766183816,NaN,NaN,-214.9333613499001,-111.54800740739105,-0.05445173289898547,-0.5518932554109597,-0.4974415225119742,51697055,68187421.6,54.74207751256515,54.069216684933224,NaN,NaN,-16.93070746015545,-14.307841112528758
2009-02-18T09:30:00-05:00,19.63,19.66,19.13,19.34,11520813,12524486.8,35.50537927572948,41.28408133815542,NaN,NaN,-191.60483104314324,-138.66579428727988,-0.08614032821247919,-0.6051169327775732,-0.518976604565094,63217868,66058917.8,52.30970853835138,54.75029862729007,NaN,NaN,-18.718435112485132,-14.937925969665383
2009-02-19T09:30:00-05:00,19.60001,19.66,18.91,18.91,12503965,12347381.9,32.99680092257468,40.607055805059304,NaN,NaN,-186.29968570090767,-160.1737471323275,-0.12419669230151231,-0.6742224699419843,-0.550025777640472,50713903,60139695.2,46.166315251757645,54.63814197730018,NaN,NaN,-21.003406340653555,-15.804423165520836
2009-02-20T09:30:00-05:00,18.73,18.92999,18.27,18.62,16660797,12283914.55,31.38620517084594,40.008857354032735,NaN,NaN,-206.51986059102032,-174.55890322537246,-0.15503173068552967,-0.7438154409973841,-0.5887837103118544,34053106,53443351.4,40.38759390391166,53.64615247381209,NaN,NaN,-23.40712534894364,-16.89052347743838
2009-02-23T09:30:00-05:00,18.84,18.94,17.77,17.89999,11756699,11914329.5,27.762901170564902,39.34229145434871,NaN,NaN,-194.68419058360706,-198.80838585371566,-0.20681304329770045,-0.84730001443398,-0.6404869711362795,22296407,44395667.8,34.16498968034874,52.16623543118376,NaN,NaN,-26.68299246057092,-18.289447617885884
2009-02-24T09:30:00-05:00,17.86,18.545,17.64,18.28999,10561688,11451829.1,32.320478102862936,38.75958038448685,NaN,NaN,-162.15952066883247,-188.25361771750215,-0.19769899905372235,-0.8876107199534324,-0.6899117208997101,32858095,40627875.8,31.9568698842468,50.57104134810896,NaN,NaN,-28.078655866576323,-19.687905939127376
2009-02-25T09:30:00-05:00,18.33,18.33,17.67,17.85001,14158559,11418891.6,30.019412930604275,38.061458470996236,NaN,NaN,-148.8260668111603,-179.69786487110554,-0.20341148673707465,-0.9441760793210534,-0.7407645925839788,18699536,31724209.4,27.44308452127541,49.13493037047179,NaN,NaN,-29.96808639476287,-21.156503147075302
2009-02-26T09:30:00-05:00,18.21001,18.23,17.53999,17.53999,8399023,10976545.15,28.48074820712199,37.08889529357466,NaN,NaN,-137.74512167379402,-169.98695206568283,-0.20936013983709645,-1.0024647673803493,-0.7931046275432528,10300513,23641531.4,24.11337902157257,47.5594077684522,NaN,NaN,-32.01287357909429,-22.7074132087923
2009-02-27T09:30:00-05:00,17.25,17.64011,17.07001,17.10001,12093297,11004056.5,26.411720079295065,35.641594345590605,NaN,NaN,-146.4472540202871,-157.97243075153617,-0.22296154810166346,-1.0718065626703321,-0.8488450145686687,-1792784,16472353.4,21.608967537963494,45.57176747798508,NaN,NaN,-34.39072747820454,-24.37645810442262
2009-03-02T09:30:00-05:00,16.89,16.89999,15.98,15.98,9658527,11092488.3,22.025297806786426,33.638111023481315,NaN,NaN,-174.4069546698963,-153.91698356879402,-0.2835362982056936,-1.2032653873257857,-0.9197290891200921,-11451311,9722809.8,19.550280483826853,42.968618114934586,NaN,NaN,-38.058329688914284,-26.33101118792143
2009-03-03T09:30:00-05:00,16.44,16.49001,15.7824,15.86,10173949,11132011.55,21.61116843874882,32.18614919233187,NaN,NaN,-156.87301314516557,-152.85968206406065,-0.30591306188295053,-1.3021204164737803,-0.9962073545908298,-21625260,-1173861.2,16.772169047400723,39.986120198253126,NaN,NaN,-41.09792924090556,-28.440570909776305
2009-03-04T09:30:00-05:00,16.3,16.60001,15.85,16.3,10930266,11224011.95,27.02894371594452,31.020904935303452,NaN,NaN,-126.6200479657055,-148.4184782949697,-0.26673991127229324,-1.3296322436811963,-1.062892332408903,-10694994,-7052767.2,15.493022828162651,36.55463014711389,NaN,NaN,-41.97706020346869,-30.374355094589504
2009-03-05T09:30:00-05:00,16.05,16.09,15.3811,15.67,13472250,11376137.35,24.425854147186413,29.781413974761797,NaN,NaN,-132.2910372733944,-147.32766141488977,-0.25871893416271297,-1.3862910001122941,-1.1275720659495811,-24167244,-13946318.6,14.131998956527994,32.960341258680735,NaN,NaN,-43.5557517099227,-32.25741175392282
2009-03-06T09:30:00-05:00,15.86,16.03,15.14,15.5,13882137,11476127,23.760863834454796,28.494423706167886,NaN,NaN,-123.7662943514629,-142.79146948112492,-0.2406982106192952,-1.4284448292237002,-1.187746618604405,-38049381,-21197638,12.852939466968635,29.406671188205678,NaN,NaN,-45.03456193650594,-34.082718922863265
2009-03-09T09:30:00-04:00,15.48,15.84,15.16,15.36,9734711,11324504.55,23.200680631025662,27.638318173838993,NaN,NaN,-116.52197933954564,-131.2144744150548,-0.2148913860196351,-1.4563608511289488,-1.2414694651093137,-47784092,-28464194.2,11.709239468418119,26.332897042195178,NaN,NaN,-46.4079341733509,-35.84346395864721
2009-03-10T09:30:00-04:00,15.63,16.61,15.63,16.52,10318457,11417290.5,36.54885719421191,27.712852310873448,NaN,NaN,-75.51153340471468,-114.94217846696463,-0.10210447660927402,-1.369100060870906,-1.266995584261632,-37465635,-31632269.2,11.23965456814247,23.399321758608828,NaN,NaN,-43.3594842616304,-36.91718114478767
2009-03-11T09:30:00-04:00,16.78999,17.03,16.5,16.67999,9343590,11444910.45,38.14567073218355,28.080628725845514,NaN,NaN,-47.98131478714402,-99.21443183125233,-0.0042981965251502885,-1.27236832991807,-1.2680701333929196,-28122045,-35117679.4,10.72982927880905,20.868144189112495,NaN,NaN,-40.41488597236867,-37.41685326301353
2009-03-12T09:30:00-04:00,16.87,17.42,16.42999,17.22,8489914,11546924.7,43.32966141250179,28.933732743106646,NaN,NaN,-28.518509555591457,-78.45992628769173,0.1032531335643867,-1.1390037164374363,-1.242256850001823,-19632131,-34210656.8,11.850395870692623,18.82977290102542,NaN,NaN,-36.253156645996896,-37.25061088915401
2009-03-13T09:30:00-04:00,17.5,17.64999,16.97,17.25,8101098,11313220.05,43.612397909189426,30.065839653008396,NaN,NaN,-8.932375992114244,-55.493142615822,0.17849147225988427,-1.0191425096769677,-1.197633981936852,-11531033,-28906987.2,18.30775819547388,17.69711350924865,NaN,NaN,-32.84227900998845,-36.62084919213036
2009-03-16T09:30:00-04:00,17.49001,18.03999,17.41,17.44,11528090,11456280,45.46803994725954,31.00495121332244,NaN,NaN,20.23717042232711,-28.141312663447444,0.23933654395682313,-0.898463301990823,-1.1377998459476462,-2943,-19350757.4,28.474678406967968,17.448385546585875,NaN,NaN,-29.46060190804667,-35.597956722975546
2009-03-17T09:30:00-04:00,17.58,17.95,17.28,17.95,8408555,11084819.25,50.204978577267504,32.44677733094124,NaN,NaN,34.657381774935864,-6.107529627517333,0.30784675156808605,-0.7529914064875385,-1.0608381580556245,8405612,-10176508,36.62866674790864,18.104498562773966,NaN,NaN,-25.07622223183424,-34.09485179566965
2009-03-18T09:30:00-04:00,17.82001,18.52,17.42999,18.28999,12540910,11135824.1,53.128055674700505,34.20729929291114,NaN,NaN,67.49444188248846,16.987621706409165,0.36601861353789533,-0.6033148911332553,-0.9693335046711506,20946522,-362794.6,43.985010840284446,19.5239008355391,NaN,NaN,-20.47087958677211,-32.14857005154143
2009-03-19T09:30:00-04:00,18.5,18.58,18.08,18.11,8776867,10949469.2,51.40758043350516,35.992717889640424,NaN,NaN,87.64972542858044,40.221268703243545,0.38064299632766185,-0.4935297592615733,-0.8741727555892351,12169655,5997562.6,48.18329475558936,21.422067065369514,NaN,NaN,-17.106885680675532,-29.999757998560586
2009-03-20T09:30:00-04:00,18.05,18.09,17.27,17.39,12500520,10741455.35,45.11391280965203,37.641904675559395,NaN,NaN,42.202437627429234,50.448231427152244,0.331876289487789,-0.4593273937294988,-0.7912036832172878,-330865,8237596.2,49.61555435917989,23.56958662789473,NaN,NaN,-15.93050415103846,-27.98986459177171
2009-03-23T09:30:00-04:00,17.83,18.73,17.69,18.64999,8478410,10577540.9,55.4034759271688,40.05564092473225,NaN,NaN,103.29580578402481,67.05995849949178,0.37153563010017865,-0.3267841455920646,-0.6983197756922432,8147545,9867693.8,50.68383414610143,25.991848420659068,NaN,NaN,-11.328880139871469,-25.60972395578596
2009-03-24T09:30:00-04:00,18.39999,18.99001,18.37,18.5,14726516,10785782.3,54.10319419635076,41.98951595904699,NaN,NaN,119.58559178506015,84.04560050151665,0.37371126150501277,-0.23118069881097725,-0.60489196031599,-6578971,6870777.2,48.64188620070954,28.359624375840987,NaN,NaN,-8.112052610783364,-23.11005662078559
2009-03-25T09:30:00-04:00,18.66,19.22,18.14999,18.64999,10734809,10614594.8,55.234623373873056,44.19014233238175,NaN,NaN,116.4765101771921,93.84201416045737,0.37057103919841083,-0.1416781613179765,-0.5122492005163873,4155838,3512640.4,46.38672630739789,30.663533472331693,NaN,NaN,-5.1737722034883,-20.547730275457404
2009-03-26T09:30:00-04:00,18.92999,19.64999,18.89999,19.64999,16534563,11021371.8,61.96646622459711,46.919113931677636,NaN,NaN,152.47676842330358,106.80742275940199,0.41766460447746934,0.009831555080449306,-0.40783304939702003,20690401,5216789.6,47.711575372805704,33.15343603703434,NaN,NaN,-0.2693364420535427,-17.650816870685425
2009-03-27T09:30:00-04:00,19.41,19.49001,19.10001,19.28,10114918,10922452.85,58.46338388904294,49.43787845010744,NaN,NaN,125.5842704794157,123.4837893297993,0.40539350874264823,0.09890883653129023,-0.306484672211358,10575483,7398059.2,49.43399565113358,35.848061478656874,NaN,NaN,2.6245344348702364,-14.754338112748902
2009-03-30T09:30:00-04:00,18.64999,18.69,18.09,18.32001,8718113,10875432.15,50.48813334810152,50.433541032528126,NaN,NaN,60.89730275882788,115.0040887247599,0.3179806692228511,0.09099116431720589,-0.22698950490564523,1857370,6140024.2,48.442863778656466,38.50543356512215,NaN,NaN,2.4778990723625594,-12.292589943447265
2009-03-31T09:30:00-04:00,18.59,18.87,18.25999,18.42999,10759504,10904709.9,51.30764077399546,51.373681749800404,NaN,NaN,65.16963577605176,104.12089752295822,0.25561100941556225,0.09252425686380761,-0.16308675255175464,12616874,9979193.2,51.6300714548401,41.42687943483866,NaN,NaN,2.621726415012932,-10.161973320810095
2009-04-01T09:30:00-04:00,18.25999,18.85001,18.13,18.84,8654285,10790910.85,54.34173074719611,52.16025813085,NaN,NaN,65.47344640915743,93.9202847693513,0.23077207459310117,0.12537834068962184,-0.10539373390347934,21271159,13402257.4,54.34036605397824,44.461877305073344,NaN,NaN,3.687202437243763,-8.183519641088115
2009-04-02T09:30:00-04:00,19.24001,20.12,19.2,19.85001,13176926,10776144.65,60.818579082112336,53.38927107177307,NaN,NaN,131.4643091262554,89.71779290994162,0.26852339116015833,0.23026050504671858,-0.038262886113439754,34448085,16153794.2,56.45262890301939,47.186510927040885,NaN,NaN,6.798178016911516,-6.043277118516739
2009-04-03T09:30:00-04:00,19.86,19.97,19.61,19.87,11174375,10640756.55,60.93668866652771,54.49417455172079,NaN,NaN,131.31319207563817,90.86357722918612,0.2797332956700386,0.31140373347410844,0.03167043780406989,45622460,23163189.6,61.35692948157053,49.535243146655354,NaN,NaN,9.259096503108516,-3.857223743998846
2009-04-06T09:30:00-04:00,19.66,20.09,19.44,19.92,7783273,10543184.65,61.251321289906635,55.28319903119501,NaN,NaN,127.08509324342685,104.10113532610592,0.2749975149032939,0.37541733143318723,0.10041981652989336,53405733,33472862.2,67.20681919893167,51.719396893157,NaN,NaN,11.325411144797046,-1.6882759027422902
2009-04-07T09:30:00-04:00,19.61,19.78,19.34,19.35001,9263754,10490449.5,55.73967840560024,55.46974351197356,NaN,NaN,92.99373919901132,109.66595601069784,0.22032245662466016,0.37582288731071856,0.1555004306860584,44141979,39777883.2,70.17992976481531,53.59046253062349,NaN,NaN,11.474954010536871,0.1921855134404471
2009-04-08T09:30:00-04:00,19.55,19.64999,19.24001,19.52,11783539,10612446.95,56.98289725627575,55.86798042788575,NaN,NaN,83.65697080631,113.30266089012835,0.18393421901386584,0.3854182044533907,0.20148398543952487,55925518,46708755,73.07024932034493,55.36810214239175,NaN,NaN,11.955683555474527,1.8726852337310298
2009-04-09T09:30:00-04:00,19.92999,20.64,19.92999,20.48,18412736,11108588.05,63.25932699251037,57.164081440947065,NaN,NaN,145.21715240814353,116.05322954650599,0.210912707168747,0.4651248694004586,0.2542121622317116,74338254,54686788.8,75.95883585511477,57.249765106387095,NaN,NaN,14.3566036826549,3.6561021550058683
2009-04-13T09:30:00-04:00,20.21001,20.72,20.07001,20.53999,13678004,11387433.35,63.61657303773512,57.75073123455894,NaN,NaN,134.39746127222304,116.67008338582295,0.2182767261517326,0.5270580699213774,0.3087813437696448,88016258,63165548.4,78.58753481271275,59.24288658257361,NaN,NaN,16.384701659668316,5.4744735128147894
2009-04-14T09:30:00-04:00,20.3,20.7,20.16,20.24001,13458016,11483929.65,60.45121058124173,58.204160976336865,NaN,NaN,114.35818228392897,114.12470119392337,0.1894908005534494,0.5456448444614566,0.35615404390800715,74558242,67396050.2,79.77576791097823,61.466735276164236,NaN,NaN,17.167773282027365,7.144944908416586
2009-04-15T09:30:00-04:00,20.17,20.64999,20.09,20.42999,10098168,11568410.3,61.749265946157614,58.66949258864291,NaN,NaN,106.53330700094709,116.83261475431054,0.17039201051837194,0.569144057055972,0.3987520465376001,84656410,75498936.4,81.85294562701927,64.0000366561372,NaN,NaN,18.188351268355653,8.722574388407882
2009-04-16T09:30:00-04:00,20.74001,21.25999,20.46001,21.12,15534211,11718075.35,66.10114872266591,58.964827052790675,NaN,NaN,141.46006785445437,128.3932341639394,0.18988850809622193,0.6361126816578775,0.44622417356165556,100190621,84351957,83.80952561333004,66.5784616733175,NaN,NaN,20.405417356418283,10.391551955266511
2009-04-17T09:30:00-04:00,21.27,21.34,20.965,21.11,9920438,11775253.9,65.98398174367568,59.50201261383587,NaN,NaN,142.7446378547409,127.89873125325889,0.18744794844596208,0.6805341091191082,0.4930861606731461,90270183,87538342.8,84.45899994965737,69.08024769464063,NaN,NaN,22.16413775891024,12.073349927215615
2009-04-20T09:30:00-04:00,20.77,20.8,20.11,20.17999,11248004,11712628.1,56.035986884397175,59.89828786642842,NaN,NaN,69.21497081378244,114.86223316157077,0.11224548380602761,0.6333930154306806,0.521147531624653,79022179,85739527,82.4482553544085,71.50920423576578,NaN,NaN,20.728923028853075,13.30986037030668
2009-04-21T09:30:00-04:00,20.03,20.72,19.98,20.67,7147879,11646101.55,59.50054771468281,60.48349550504894,NaN,NaN,71.13421579048241,106.21743986288145,0.08574603302535577,0.6283300729063477,0.5425840398809919,86170058,88061890.2,83.01061827845754,73.75067186602416,NaN,NaN,20.567527818887577,14.346670005818236
2009-04-22T09:30:00-04:00,20.41,21.48,20.41,20.99001,13736328,11596592.15,61.62729815580028,61.003893177092095,NaN,NaN,108.445741195434,106.59992670177883,0.08011739739278356,0.6427307866219714,0.5626133892291878,99906386,91111885.4,83.74713078736752,75.85115506126625,NaN,NaN,21.076620047971044,15.308091440411495
2009-04-23T09:30:00-04:00,21.17,21.28999,20.69,21.22,8470961,11483399.75,63.1260082177613,61.16870954392417,NaN,NaN,106.5758873851212,99.62309060791219,0.08193777688928816,0.665035610340798,0.5830978334515098,108377347,92749230.6,84.1445125481213,77.8291467502021,NaN,NaN,21.94038658721518,16.255562175669166
2009-04-24T09:30:00-04:00,21.49001,21.8,21.28,21.66,9277180,11120530.6,65.87220632215883,61.52124651932638,NaN,NaN,136.68958505856077,98.41208004867617,0.10154722226656165,0.7100318612847119,0.6084846390181502,117654527,98226099.4,85.42795163894091,79.54850547572855,NaN,NaN,23.502215693571085,17.290798392512297
2009-04-27T09:30:00-04:00,21.49001,21.69,21.17999,21.23,7980410,11013805.2,61.08433958706297,61.50931925483756,NaN,NaN,107.29858409157376,106.02880270423444,0.07552573579487576,0.7028918087617448,0.6273660729668691,109674117,104356487,86.72340736415879,80.94254748753049,NaN,NaN,23.397948559028706,18.163248416300355
2009-04-28T09:30:00-04:00,21.03,21.33,20.8,20.98,9559699,11055884.5,58.42546262989421,61.70116098514427,NaN,NaN,74.59601379801519,106.72116230574099,0.03358279563564337,0.6693445675114233,0.63576177187578,100114418,107145359,87.27752125337668,82.16380402242773,NaN,NaN,22.52314287622184,18.786090482003424
2009-04-29T09:30:00-04:00,21.17999,21.95,21.17999,21.67999,14356531,11235735.85,63.24908228650686,62.148745630160775,NaN,NaN,125.91172466872158,110.2143590003985,0.04440891545122683,0.6912729161898135,0.6468640007385866,114470949,110058271.6,87.84800533632176,83.21935802356893,NaN,NaN,23.21612454787518,19.418952491413673
2009-04-30T09:30:00-04:00,22.14,22.3176,21.64999,21.75999,11382598,11372151.5,63.766497016753576,62.18497206046386,NaN,NaN,142.05272160268956,117.30972584391218,0.04807460637077998,0.7069572587020616,0.6588826523312816,125853547,113553511.6,88.51357122088581,84.1161248354097,NaN,NaN,23.92749788916048,20.063030405377503
2009-05-01T09:30:00-04:00,21.78,22.235,21.66,22,9052090,11165909.7,65.34296806684395,62.308285991114495,NaN,NaN,130.93178687749193,116.15816620769843,0.05716201023863976,0.7303351651295813,0.6731731548909415,134905637,117003733.6,89.1455548558437,84.87026912420478,NaN,NaN,24.979202316352513,20.765340678373935
2009-05-04T09:30:00-04:00,22.28999,22.84,22.06,22.72,9579762,11086179.05,69.61403651566809,62.96277355785924,NaN,NaN,168.8870990182744,128.47586919303853,0.09967281869131006,0.7977641782550791,0.698091359563769,144485399,123965990,90.30477604345607,85.62234113366749,NaN,NaN,27.236658194240103,21.689814609211957
2009-05-05T09:30:00-04:00,22.64,22.89,22.515,22.78999,9942570,11194143.9,70.00106170361654,63.552187540534874,NaN,NaN,167.67379015181913,147.09142446379934,0.11919498862026479,0.8470850953391,0.7278901067188353,154427969,134828700.2,91.7798427808811,86.33140521608618,NaN,NaN,29.17845396608018,22.759620231621703
2009-05-06T09:30:00-04:00,23.00999,23.23,22.7,23.14999,18727776,11667345,71.97809960116888,63.97196974614223,NaN,NaN,169.57508789429926,155.82409710891486,0.14152103207398725,0.9047913968113193,0.763270364737332,173155745,146565659.4,93.0162090306184,86.98902546017821,NaN,NaN,31.426969852636443,23.99781303462381
2009-05-07T09:30:00-04:00,23.37,23.39,22.50999,22.67999,17176048,11936970.45,65.87423701184083,63.96413083672546,NaN,NaN,135.8174490287054,154.57704259411804,0.11114290501557933,0.9021989960068062,0.7910560909912269,155979697,152590889.4,93.55234110415499,87.63854982835662,NaN,NaN,31.573986182461173,25.08012348431486
2009-05-08T09:30:00-04:00,22.87,23.50999,22.87,23.50999,9326715,11482669.4,70.61355962170026,65.0053860322471,NaN,NaN,149.6897695542725,158.32863912947414,0.13203294234803264,0.9560972689262677,0.824064326578235,165306412,158671044.4,94.04882902722295,88.46716223355763,NaN,NaN,33.20718101024231,26.241131702304497
2009-05-11T09:30:00-04:00,23.03,23.22,22.78,22.81,10456898,11321614.1,62.70439991652572,65.23423261809303,NaN,NaN,105.83460061388904,145.71813944859707,0.08602046436764932,0.9315899070377966,0.8455694426701473,154849514,160743867.4,94.21244804800574,89.26729293138251,NaN,NaN,32.0158728367846,27.06609472151594
2009-05-12T09:30:00-04:00,23.07001,23.07001,22.16,22.564,12735453,11285485.95,60.15441448666937,65.12902664172654,NaN,NaN,69.73032321622543,126.12944606147832,0.02926335919216827,0.8821486416603577,0.8528852824681894,142114061,158281085.8,91.01080662702049,89.78612691992916,NaN,NaN,30.238438344515682,27.51928666765876
2009-05-13T09:30:00-04:00,22.00999,22.248,21.55,21.63,12479629,11404559,51.57808683620785,64.30417511447271,NaN,NaN,-0.021246636964632613,92.21017915522555,-0.07522621873272861,0.7588525090522786,0.8340787277850072,129634432,149576823.2,80.5871315175764,89.53202827489022,NaN,NaN,25.729540697663083,27.263608671945093
2009-05-14T09:30:00-04:00,21.58,22.07001,21.58,21.78999,10311637,11143430.3,52.818972871995946,63.37180129660395,NaN,NaN,-3.6706224456573913,64.31256486035299,-0.1341687277005562,0.666367818159312,0.8005365458598682,139946069,146370097.6,77.08438421043289,88.93605917285394,NaN,NaN,22.55289221753086,26.590649178457344
2009-05-15T09:30:00-04:00,21.87,22.19,21.625,21.8,17495744,11522195.6,52.900299734595244,62.787227021427675,NaN,NaN,-1.7409379669656015,34.02642335610537,-0.17073892807087931,0.5871128857712691,0.7578518138421484,157441813,144797177.8,75.35424792681759,88.12397635590101,NaN,NaN,20.063706472921318,25.658228791952197
2009-05-18T09:30:00-04:00,21.91,22.60001,21.91,22.60001,10524535,11486022.15,58.98519734873153,62.8272080727732,NaN,NaN,39.34525263025315,20.728553759378183,-0.14056442553316262,0.5821462819256951,0.7227107074588577,167966348,147420544.6,76.30930395340748,87.34053226304606,NaN,NaN,19.730837139638695,24.81145855590741
2009-05-19T09:30:00-04:00,22.55,22.71249,22.33,22.42999,19701776,12113717,57.291201500510766,62.401645159487764,NaN,NaN,44.165772383810236,15.615643592895145,-0.1317221072304866,0.5580580734207494,0.689780180651236,148264572,148650646.8,76.76399365827638,86.54881714318569,NaN,NaN,18.946149985599295,23.97355733157768
2009-05-20T09:30:00-04:00,22.78999,23.09,22.45,22.45,13316609,12092731.05,57.446097591616756,61.95018805769227,NaN,NaN,56.45103107261635,26.910099134811343,-0.1242864256876196,0.5344221485417116,0.6587085742293312,161581181,155039996.6,79.01673120522996,85.8704714277817,NaN,NaN,18.358152869397237,23.171356694123332
2009-05-21T09:30:00-04:00,22.11,22.25,21.55,21.77,20545648,12696465.4,50.71472422552788,60.90531349759827,NaN,NaN,-44.80381072222232,18.683461479498355,-0.16251191647238106,0.45556867863885486,0.6180805951112359,141035533,155257889.4,79.0911786098299,85.15230169592357,NaN,NaN,15.7887009073057,22.116691581720815
2009-05-22T09:30:00-04:00,21.75,21.985,21.57001,21.69,8858102,12675511.5,49.97282855272964,59.50237007167409,NaN,NaN,-60.2974789634068,6.972153280210117,-0.18869210625560562,0.38221546229172887,0.5709075685473345,132177431,150205013,72.65371587927046,83.891511684196,NaN,NaN,13.481339745194942,20.883069890788548
2009-05-26T09:30:00-04:00,21.84,22.50999,21.50999,22.48,16082293,13080605.65,56.70785978236371,58.552855648727466,NaN,NaN,-13.429723056478817,-3.582841857136277,-0.1499986909181621,0.3834092048996318,0.5334078958177939,148259724,146263688.2,68.0041707848188,82.193249398763,NaN,NaN,13.435992019780832,19.81920162350173
2009-05-27T09:30:00-04:00,22.48,22.58,21.75,21.75,10835625,13144401.95,50.008164749246546,56.983574587875864,NaN,NaN,-43.84650672806659,-21.185297679511642,-0.16933310111612787,0.32174151942263407,0.49107462053876194,137424099,144095593.6,65.52018870944922,80.22924794725093,NaN,NaN,11.23832322305627,18.593361852009522
2009-05-28T09:30:00-04:00,21.95,22.09,21.47,21.96001,10851332,12969142,51.77339070376165,55.97637128015593,NaN,NaN,-76.17773218545858,-47.71105033112663,-0.16364949988746458,0.2865127456794312,0.45016224556689577,148275431,141434443.6,62.50242264763404,78.01139662892801,NaN,NaN,10.002990479681507,17.36616594167695
2009-05-29T09:30:00-04:00,22.16,22.52,21.92999,22.49001,10999590,12949991.6,55.99629329088863,54.9322808279551,NaN,NaN,-5.414989437825764,-39.83328607424731,-0.12178903298598015,0.2979259543344206,0.41971498732040075,159275021,145082341.2,64.88970030883195,75.92860172047152,NaN,NaN,10.269584601533074,16.352368607370682
2009-06-01T09:30:00-04:00,22.97,23.58,22.77,23.53,19476912,13471232.7,62.86727954712888,54.94391508728389,NaN,NaN,136.20413291725336,-0.5329636981152795,-0.026624050177309955,0.3864349245987633,0.41305897477607323,178751933,154397241.6,70.12075851963816,74.20776675415955,NaN,NaN,12.854105453424728,15.852616728235546
2009-06-02T09:30:00-04:00,23.39999,23.75,23.37,23.57001,10763461,13530417.65,63.105956314696364,55.154739503571534,NaN,NaN,152.00585804697175,32.55415252257483,0.03320675900185205,0.4545674235283883,0.42136066452653625,189515394,162648375.6,73.83893908435013,72.98120478682594,NaN,NaN,14.939402701259349,15.72215758152466
2009-06-03T09:30:00-04:00,23.25999,23.46001,22.89999,23.11,15375426,13802060.45,58.45384728295102,55.645865249767475,NaN,NaN,88.92778163799805,59.109010195787754,0.03576856962093211,0.46607137655270137,0.43030280693176925,174139968,169991549.4,76.62658683300339,72.69830873792787,NaN,NaN,15.238953014506592,15.653128357664936
2009-06-04T09:30:00-04:00,23.25999,23.58,23.06,23.53,7971352,13264239.25,61.261775161587416,56.24892255616687,NaN,NaN,113.06036423080293,96.95662947904006,0.05837964561236031,0.5032773639472197,0.44489771833485936,182111320,176758727.2,78.8619864769926,72.82528032839642,NaN,NaN,16.37018259675369,15.755564677534759
2009-06-05T09:30:00-04:00,24.05,24.08,23.60001,23.73,12146000,13012736.85,62.55944093278659,56.93886121318054,NaN,NaN,145.3261710371577,127.10486157403675,0.07819895769263063,0.5426464154506476,0.464447457758017,194257320,183755187,80.89624955566504,73.22113758759981,NaN,NaN,17.687943551378222,16.03161880236954
2009-06-08T09:30:00-04:00,23.72,23.92,23.315,23.78999,8434656,12968133.9,62.96023830670992,57.222792710179,NaN,NaN,123.7652352421334,124.61708203901276,0.08611614279602059,0.5720926362530427,0.48597649345702215,202691976,188543195.6,82.1614620284343,73.63914887867314,NaN,NaN,18.8733905497218,16.437586194848436
2009-06-09T09:30:00-04:00,23.84,23.87,23.49001,23.74001,10302590,12960418.5,62.36127584194473,57.58494087742428,NaN,NaN,114.06965574316858,117.02984157825213,0.07894396876820176,0.5846564544172743,0.5057124856490726,192389386,189117994,82.3129041447646,74.035499627708,NaN,NaN,19.686877520928075,16.90177067000267
2009-06-10T09:30:00-04:00,24.09,24.13,23.17,23.59,12810102,12964150.95,60.500887405117886,57.80314014981722,NaN,NaN,93.22411953555051,117.88910915776262,0.05612644379517728,0.5758705403930442,0.5197440965978669,179579284,190205857.2,82.61374504213406,74.29242918748687,NaN,NaN,19.87949973875025,17.32716053696661
2009-06-11T09:30:00-04:00,23.53999,23.855,23.5,23.55,10526805,12866509.75,59.9869973335773,58.46544537182074,NaN,NaN,83.14182428984884,111.90540116957179,0.03159150599173155,0.5592334790875313,0.5276419730957997,169052479,187594089,79.13368479875672,74.2954653438388,NaN,NaN,19.908312100231623,17.695896474575896
2009-06-12T09:30:00-04:00,23.53,23.60001,23.23,23.59,8454660,12773660.9,60.349690809788974,59.206649818753554,NaN,NaN,61.06856461519642,95.05387988517954,0.012299698752665345,0.5430165965366314,0.530716897783966,177507139,184244052.8,74.78224949861038,74.44750345950594,NaN,NaN,20.023573640670367,18.028421784017965
2009-06-15T09:30:00-04:00,23.48,23.48,22.66,22.87,8953254,12346536.4,51.33043448288303,58.82254801164779,NaN,NaN,11.567987370423483,72.61443031083755,-0.05122396541415086,0.4666869410162775,0.5179109064304284,168553885,177416434.6,66.72868536705762,74.35639735823727,NaN,NaN,17.621113637567536,17.970234905953617
2009-06-16T09:30:00-04:00,22.97,23.06,22.45,22.45,9303594,12285489.35,46.924882301048235,58.602313551062196,NaN,NaN,-26.21440977230554,44.55761720774272,-0.11987923622229052,0.36806186115256523,0.48794109737485575,159250291,170788615.6,59.97632596067508,73.96040716189626,NaN,NaN,14.213834925509289,17.433606337318714
2009-06-17T09:30:00-04:00,22.34,22.53999,22.16,22.28,17690624,12184931.75,45.232643332389934,58.13511731024993,NaN,NaN,-58.671525677257776,14.178488165181085,-0.17192423093140818,0.2730358087105955,0.4449600396420037,141559667,163184692.2,53.311133764617246,73.30388652739506,NaN,NaN,10.858711357181358,16.49433562587052
2009-06-18T09:30:00-04:00,22.45,22.46001,22.03,22.3,12271816,12132692.1,45.481739044353404,57.3840777212117,NaN,NaN,-61.06032889756269,-14.661942472301217,-0.19831273552890583,0.19706912023087142,0.39538185575977725,153831483,160140493,50.87362856158213,72.30273854544865,NaN,NaN,8.148964923872702,15.302139811299403
2009-06-19T09:30:00-04:00,22.49001,22.64,22.06,22.2,8822211,11546520.25,44.39449196598771,56.06459289398733,NaN,NaN,-61.870967701888375,-39.24984893571818,-0.21444304497662542,0.12732804953899546,0.3417710945156209,145009272,153640919.6,46.0340929347411,70.58226243224172,NaN,NaN,5.5530766198847035,13.90941649824016
2009-06-22T09:30:00-04:00,22.02,22.05,21.37,21.46001,11339586,11670594.45,37.290534812028405,54.22063421522534,NaN,NaN,-129.5515000207991,-67.4737464139627,-0.26365204655320096,0.012206036324119651,0.2758580828773206,133669686,146664079.8,41.47332085004641,68.27043255836288,NaN,NaN,0.9483751580171671,12.05783916392259
2009-06-23T09:30:00-04:00,21.39,21.47,21.08,21.25999,14739250,11603442.3,35.63083516910616,52.59041906423642,NaN,NaN,-150.1101572936282,-92.25289591822722,-0.2959539740616777,-0.09408438469977654,0.2018695893619012,118930436,138600108.8,36.92030698555619,65.43426971211666,NaN,NaN,-3.4247899358398075,9.846035006813677
2009-06-24T09:30:00-04:00,21.48,21.89999,21.28999,21.39999,13853805,11754351.3,37.72021449390459,50.908879016544795,NaN,NaN,-118.38427610448787,-104.19544600367325,-0.2935917336488212,-0.1651200776991253,0.1284716559496959,132784241,136845023.6,35.99412628441722,62.372279698361275,NaN,NaN,-6.515430901207882,7.508682734239169
2009-06-25T09:30:00-04:00,21.32001,22.105,21.32001,22.06,18079232,12115746.3,46.531592473294,49.76403269800961,NaN,NaN,-90.92082950859675,-110.16754612588007,-0.23577151857495568,-0.1662427422689987,0.06952877630595697,150863473,136251421.6,35.66821928574895,59.141706107652986,NaN,NaN,-6.71074309712576,5.477336186901322
2009-06-26T09:30:00-04:00,22.07001,22.2001,21.91,21.97,11819266,12156730.1,45.58450382257471,48.52290880628566,NaN,NaN,-69.94050018639413,-111.78145262278122,-0.193548865658001,-0.17240730576654428,0.021141559891456718,139044207,135058408.6,34.98265324011555,55.77179119420164,NaN,NaN,-7.144580160638952,3.6742052801098546
2009-06-29T09:30:00-04:00,22.14999,22.35001,21.94501,22.19,6238785,11494823.75,48.35184305229879,47.52223503559667,NaN,NaN,-52.21919934600545,-96.31499248782248,-0.14309123096232018,-0.15772247881144352,-0.014631247849123334,145282992,137381069.8,37.501283087750735,52.57096111870065,NaN,NaN,-6.707733272374917,2.1910712011834588
2009-06-30T09:30:00-04:00,22.19,22.28999,21.765,21.96001,8985043,11405902.85,45.733393620769185,46.46741405100034,NaN,NaN,-60.08836116659794,-78.31063326241645,-0.11850831849544413,-0.1627666459684285,-0.04425832747298437,136297949,140854572.4,41.17148084841388,49.61079939057778,NaN,NaN,-7.079829693450016,0.8666567876643911
2009-07-01T09:30:00-04:00,21.75999,22.37,21.75,22.05,14009270,11337595.05,46.94408908500393,45.53577774753081,NaN,NaN,-50.54909198907607,-64.74359643933408,-0.09074137703976572,-0.15768504877269152,-0.0669436717329258,150307219,144359168,44.70004569660417,47.15125374042403,NaN,NaN,-7.051293412193223,-0.26447895517241093
2009-07-02T09:30:00-04:00,22.00999,22.00999,21.32001,21.36,13736117,11625833.3,39.641287151407376,44.05660605764642,NaN,NaN,-87.24328650872278,-64.00808783935926,-0.11200465850037605,-0.20694949485839587,-0.09494483635801981,136571102,141500693.8,42.46286761650927,44.8427264631311,NaN,NaN,-9.244139063179837,-1.5472875420306147
2009-07-06T09:30:00-04:00,21.09,21.37,21,21.37,13749285,11705997.55,39.78748163648835,43.23210942576109,NaN,NaN,-110.05662847513148,-72.03131349710672,-0.1179568315162792,-0.24239087575336882,-0.12443404423708962,150320387,143755929.8,44.809781240054285,43.277090454059426,NaN,NaN,-10.965558777861931,-2.8927548614350886
2009-07-07T09:30:00-04:00,21.24001,21.3,20.59,20.64,13589863,11963757.9,33.42323445351798,42.267706008080346,NaN,NaN,-141.30250241717488,-89.84797411134062,-0.1609564993853367,-0.3256296684687605,-0.1646731690834238,136730524,142045436.2,43.36499906250978,42.09056710419048,NaN,NaN,-14.599974292465005,-4.565214780153648
2009-07-08T09:30:00-04:00,20.60001,20.77,20.28999,20.56,18108032,12354030,32.803966288008695,41.37994336205312,NaN,NaN,-158.59355179842774,-109.54901223770658,-0.18307437175410077,-0.39351613377604977,-0.210441762021949,118622492,138510344.8,40.46141442933992,41.17273000881353,NaN,NaN,-17.713278936844542,-6.4435096596809185
2009-07-09T09:30:00-04:00,20.69,20.839,20.58,20.75,10261246,12226587.2,35.84425033722218,40.69155131154374,NaN,NaN,-127.9495126034389,-125.02909636057916,-0.1732964510771282,-0.42706232586835924,-0.253765874791231,128883738,134225648.6,37.2094039810995,40.19671396735048,NaN,NaN,-19.41891777794522,-8.297139390861533
2009-07-10T09:30:00-04:00,20.56,20.81,20.21201,20.72,13921367,12396315.3,35.570588705715494,40.061272507238584,NaN,NaN,-129.42850658318784,-133.46614037547215,-0.1576843483760314,-0.45087131026127025,-0.29318696188523885,114962371,129903902.4,34.22170763335164,39.35297216010838,NaN,NaN,-20.888082624934768,-10.09584556715771
2009-07-13T09:30:00-04:00,20.85001,21.28999,20.57001,21.25,9447367,12445950.65,43.74234380812972,40.52211600696011,NaN,NaN,-73.45244654155472,-126.14530398875681,-0.10313661936636553,-0.42210773609319574,-0.3189711167268302,124409738,124721772.6,31.0067604129179,38.60536070031349,NaN,NaN,-19.76913600343568,-11.477744200911705
2009-07-14T09:30:00-04:00,21.49001,21.56,21.24001,21.56,7456543,12371115.1,47.904353784871574,41.39879590808622,NaN,NaN,-18.918051149138638,-101.66841373514957,-0.04084909300740813,-0.37003248298609037,-0.32918338997868224,131866281,123748924,30.428825389716664,38.141683443467805,NaN,NaN,-17.534213689265947,-12.342954127819453
2009-07-15T09:30:00-04:00,21.91,22.28,21.774,22.23,12194328,12515651.8,55.557165440098224,42.672863832814336,NaN,NaN,70.12636591213983,-55.92443019303605,0.046091835648543245,-0.27156859541800316,-0.3176604310665464,144060609,128836547.4,37.038114184722225,38.216254007775305,NaN,NaN,-12.959996159404232,-12.431102989474422
2009-07-16T09:30:00-04:00,22.22,22.75,22.10001,22.64,9080559,12085148.55,59.47985816220323,43.597739953450706,NaN,NaN,121.0310081444334,-6.128326043461587,0.12722980689580393,-0.15862317244679147,-0.2858529793425954,153141168,133688033.4,42.634653088187605,38.71385642223521,NaN,NaN,-7.780910145882807,-11.766789726104191
2009-07-17T09:30:00-04:00,22.59,22.59,22.21001,22.38,8516711,11897393.3,56.09837671904309,44.348730874627016,NaN,NaN,105.13541201445472,40.784457676066914,0.15742939311064866,-0.08906623795428459,-0.24649563106493325,144624457,139620450.6,48.64582492849113,39.689797257119174,NaN,NaN,-4.601486865096363,-10.743175031674502
2009-07-20T09:30:00-04:00,22.66,22.89999,22.53,22.83,11225688,12017567.15,60.304677004522,45.20250472835725,NaN,NaN,142.87056691998316,84.04906036837448,0.19907040209480312,0.0023423715535706435,-0.19672803054123247,155850145,145908532,54.132234839278965,40.877722382228335,NaN,NaN,-0.4951697438205222,-9.27917427626679
2009-07-21T09:30:00-04:00,23.11,23.3,22.58,22.84,11589992,12030087.45,60.39548760241378,46.24979715561757,NaN,NaN,137.52893078125402,115.33845675445302,0.2171662889201617,0.07472983060896965,-0.14243645831119206,167440137,153023303.2,59.41547581974068,42.180864880180245,NaN,NaN,2.7624960709901005,-7.5589356552300915
2009-07-22T09:30:00-04:00,22.74001,23.06,22.69,22.91,8604559,11723352.9,61.06691451005942,47.25857040026439,NaN,NaN,119.80147330989215,125.27347823400348,0.22289002696017265,0.13617607538902377,-0.08671395157114889,176044696,159420120.6,63.487599205641345,43.52283298796861,NaN,NaN,5.612882875938754,-5.677247293634542
2009-07-23T09:30:00-04:00,22.81,23.50999,22.78,23.39,12070086,11634166.95,65.39876582368993,49.09839030542743,NaN,NaN,136.73399556413017,128.41407571794284,0.2462163247315774,0.22105645434332288,-0.025159870388254527,188114782,166414843.4,67.34584711570965,45.30018866648293,NaN,NaN,9.495582819371505,-3.5097001346336785
2009-07-24T09:30:00-04:00,23.25,23.44,23.03999,23.41,7254098,11092910.25,65.57065830415374,50.94004578168924,NaN,NaN,125.70609046198432,132.52821140744877,0.24943546068568045,0.28663445546884603,0.03719899478316559,195368880,176563728,71.9734114662551,47.24044796835442,NaN,NaN,12.677875599635174,-1.1971893154524142
2009-07-27T09:30:00-04:00,23.42,23.58,23.22,23.53999,8301832,10917038.55,66.72760663082838,53.31892950863998,NaN,NaN,123.33433531729625,128.62096508691138,0.2463338556998697,0.3451163144080027,0.09878245870813301,203670712,186127841.4,75.4974199664595,49.53562089006511,NaN,NaN,15.680682721445965,1.2139352612473542
2009-07-28T09:30:00-04:00,23.44,23.69,23.24001,23.52,6436516,10926925.1,66.35831613195597,55.71566878320765,NaN,NaN,112.6457030747494,123.64431954561046,0.22930030609980726,0.3854078413328921,0.15610753523308482,197234196,192086653.2,77.40376872738986,52.174360482782966,NaN,NaN,18.067025571006706,3.6215195912129756
2009-07-29T09:30:00-04:00,23.34,23.42,23.09,23.41,11747535,11065049.7,64.25110636284862,57.74472992789525,NaN,NaN,87.85728516497342,117.25548191662672,0.19816056063828152,0.40380823603093674,0.20564767539265522,185486661,193975046.2,77.98823939061262,55.08713444060533,NaN,NaN,19.55574907154521,5.897838088403295
2009-07-30T09:30:00-04:00,23.83,24.13,23.78,23.78999,13005277,11014850.05,68.0280904528361,60.06312290983243,NaN,NaN,115.05615613303348,112.91991403040738,0.1906300908988579,0.4439352890162276,0.2533051981173697,198491938,196050477.4,78.64210105566265,58.260019685056115,NaN,NaN,21.972639920348726,8.194238350109785
2009-07-31T09:30:00-04:00,23.85001,24.10001,23.78999,23.88,10541301,10855109.25,68.86717243101032,61.85775352575247,NaN,NaN,105.40540564333823,108.85977706667816,0.1793518867701217,0.4774950565800218,0.2981431698099001,209033239,198783349.2,79.50540940987538,61.724208899124505,NaN,NaN,24.240098120206653,10.486504031552194
2009-08-03T09:30:00-04:00,24.19,24.52,23.99001,24.39999,14749031,10905096.55,73.23695869823595,63.66722530527851,NaN,NaN,119.50489426643965,108.09388885650682,0.19334743728782716,0.539827466419684,0.3464800291318569,223782270,202805660.8,80.73941739937179,65.31782261409987,NaN,NaN,27.66274247742362,12.940252380962397
2009-08-04T09:30:00-04:00,24.36,24.59,24.2,24.58,8212262,10636216.5,74.56775810441168,65.02512478130089,NaN,NaN,120.17074491181381,109.59889722391969,0.20031301043477517,0.5968712921753259,0.3965582817405507,231994532,209757728,82.6804718314911,68.57799101744051,NaN,NaN,30.945188148760277,15.51238606207638
2009-08-05T09:30:00-04:00,24.66,24.66,24.19,24.38,10111738,10236401.8,70.3803380400666,65.80373048686256,NaN,NaN,111.55131055614888,114.3377023021548,0.17779927880730423,0.618807380249681,0.44100810144237673,221882794,217036954.6,84.44779593910988,71.56464407822067,NaN,NaN,32.52814565726278,17.943208861388722
2009-08-06T09:30:00-04:00,24.57001,24.64771,24.31,24.50999,20333536,10740016.3,71.50054093814448,66.90388507394123,NaN,NaN,109.89576836300158,113.30562474814842,0.15864264743205292,0.6393114107324429,0.48066876330039,242216330,225781833,86.2615230833659,74.25147966071174,NaN,NaN,34.17613148106037,20.2621978070561
2009-08-07T09:30:00-04:00,24.88,25.33,24.72,25.12,13530293,10720462.6,76.07358971764003,68.0302359820211,NaN,NaN,146.54092073979064,121.5327277674389,0.1728665800307223,0.6967519883387929,0.5238854083080706,255746623,235124509.8,87.88684540653101,76.6625232726583,NaN,NaN,37.154074958135,22.675323114353084
2009-08-10T09:30:00-04:00,25.05,25.08,24.69,24.88,13115141,10903851.3,71.23079584546394,68.80418657081039,NaN,NaN,122.09540970949259,122.05083085604949,0.15262751106364847,0.7146697971376312,0.5620422860739828,242631482,238894352.2,88.47912001893475,78.73849785831501,NaN,NaN,38.14306161371269,24.885000042833028
2009-08-11T09:30:00-04:00,24.67999,24.85001,24.38,24.55,12984984,11180273.35,65.09466189811761,69.09188281281455,NaN,NaN,87.1909957824906,115.45488103018485,0.10575720709850844,0.6942387949471183,0.5884815878486098,229646498,238424745.4,87.90253530536494,80.48242186543814,NaN,NaN,37.0474785253512,26.622496968907054
2009-08-12T09:30:00-04:00,24.46001,25.2294,24.46001,24.98,9455137,11043313.8,68.85907860424213,69.33904801142542,NaN,NaN,102.85602142174812,113.7158232033047,0.09291236218665999,0.7046220405819348,0.6117096783952748,239101635,241868513.6,88.49465070393025,81.99305069316817,NaN,NaN,37.29440784250717,28.147055665135642
2009-08-13T09:30:00-04:00,25.17,25.17999,24.82001,25.09,8606020,11019586.85,69.75760519631208,69.63811564657958,NaN,NaN,105.78625692492494,112.89392091568936,0.08143394533279369,0.7135021100612668,0.6320681647284732,247707655,242966778.6,88.68485918208285,83.18672553001304,NaN,NaN,37.76850803234747,29.521548860451617
2009-08-14T09:30:00-04:00,25.13,25.13,24.45,24.73,14117594,11299631,63.318512474720556,69.3946089211433,NaN,NaN,74.59379172003224,98.5044951117377,0.041233790264121106,0.6836104025586245,0.6423766122945034,233590061,238535466.2,82.74109928785474,83.70413119582697,NaN,NaN,36.131898516277126,30.465884525569546
2009-08-17T09:30:00-04:00,24.14999,24.21001,23.84,24,15285012,11502597.2,52.696232878027566,68.418745831577,NaN,NaN,-5.030007628016165,73.07941164423593,-0.038567751090040625,0.5941669234319527,0.6327346745219933,218305049,233670179.6,76.66571556051952,83.65141311247909,NaN,NaN,30.930286704178165,30.532227693942207
2009-08-18T09:30:00-04:00,24.10001,24.37,24.01801,24.28999,10462934,11446244.3,55.863806687447145,67.81965299761974,NaN,NaN,11.29455547038147,57.900123581814114,-0.0738260628744557,0.5404520959289236,0.6142781588033793,228767983,233494476.6,76.44740707413393,83.54135366130204,NaN,NaN,27.753380672154375,30.135249547972517
2009-08-19T09:30:00-04:00,24.03999,24.49001,23.97,24.36,8427918,11437412.25,56.61905841727456,67.00472213793678,NaN,NaN,9.914699256193515,39.31185914870319,-0.09318758750081557,0.4977936744273599,0.5909812619281755,237195901,233113329.8,75.94222200136483,83.34850515742362,NaN,NaN,25.49245054912269,29.47199254813683
2009-08-20T09:30:00-04:00,24.39999,24.71001,24.28999,24.66,8648063,11266311.1,59.793985401331135,66.35663735010255,NaN,NaN,42.42756207889401,26.64012017949701,-0.08668053293088263,0.48263059576457223,0.5693111286954549,245843964,232740591.6,75.41734769487944,83.05650074920962,NaN,NaN,24.583885155704085,28.77369149207501
2009-08-21T09:30:00-04:00,24.98,25.315,24.57249,25.3,8874914,11347351.9,65.58124914640034,65.80980095354285,NaN,NaN,109.78578941049247,33.678519717589054,-0.042405096465104264,0.5163047581140745,0.5587098545791788,254718878,236966355,77.33029838194838,82.8129922479651,NaN,NaN,25.710235456404973,28.33605491555072
2009-08-24T09:30:00-04:00,25.3,25.56,25.19501,25.35001,7054445,11284982.55,65.99316642447835,65.19733011926189,NaN,NaN,145.6111402948565,63.80674930216359,-0.014333295146654268,0.5407932356458609,0.5551265307925152,261773323,245660009.8,80.66397934591636,82.66895707042406,NaN,NaN,26.72226863309546,28.10551401805711
2009-08-25T09:30:00-04:00,25.53999,25.69,25.32899,25.49001,8624766,11394395.05,67.17741678868231,64.9685500298773,NaN,NaN,151.05522246749038,91.75888270158536,0.007886431412380657,0.564984570057991,0.5570981386456103,270398089,253986031,83.2104419346627,82.58057464153497,NaN,NaN,27.908974132495917,28.07743689154837
2009-08-26T09:30:00-04:00,25.48,25.48,25.12,25.23,6915281,11152782.35,62.8031482144309,64.34730769246919,NaN,NaN,104.64832848947316,110.7056085482413,-0.0002722823729924828,0.5567577856793697,0.5570300680523622,263482808,259243412.4,84.59043596021972,82.46121127559594,NaN,NaN,27.591500760019915,28.00801744418716
2009-08-27T09:30:00-04:00,25.22,25.56,25.02,25.46001,8669586,10935997.8,64.97580750109346,63.55460896271586,NaN,NaN,104.9408189647954,123.20825992542159,0.004228631430746699,0.5623158573407956,0.5580872259100489,272152394,264505098.4,85.8444564111277,82.31532634735285,NaN,NaN,27.972848587660927,28.00299332182627
2009-08-28T09:30:00-04:00,25.73,25.73,25.16,25.32001,7591148,10788490.15,62.57981359978996,62.936681659453434,NaN,NaN,104.84709864607852,122.22052177253879,-0.007194402484963169,0.5490942228038449,0.5562886252888081,264561246,266473572,86.29384221106501,82.15923507536216,NaN,NaN,27.589953145592766,27.94398758236434
2009-08-31T09:30:00-04:00,25.14,25.14999,24.83,25.02,8581961,10480136.65,57.67196506772655,62.40648902871122,NaN,NaN,30.67081019901965,99.23245575337141,-0.03819451090849124,0.508545486653194,0.5467399975616852,255979285,265314764.4,84.59134984817706,81.92272182842017,NaN,NaN,25.800243877165546,27.637738481621653
2009-09-01T09:30:00-04:00,24.96001,25.38,24.53999,24.60001,14918219,10815434.5,51.57411712850216,61.171848923301226,NaN,NaN,-1.8440550330775638,68.65260025325783,-0.08740986374227044,0.43747766788384723,0.5248875316261177,241061066,259447359.8,76.3750503573976,81.05703608938212,NaN,NaN,22.328484720650554,26.87927365862578
2009-09-02T09:30:00-04:00,24.56,24.63,24.36,24.5,10319484,10825821.8,50.21262868524284,59.77577917251056,NaN,NaN,-69.50408790835488,33.82211697369222,-0.12484262793536854,0.368834246706907,0.49367687464227555,230741582,252899114.6,68.39117166253148,79.60748698084275,NaN,NaN,19.08384820849572,25.765641451464344
2009-09-03T09:30:00-04:00,24.67999,24.87,24.39,24.82001,14405527,10529421.35,54.36402588510743,59.136172987538195,NaN,NaN,-34.354966503321215,5.962959880068904,-0.12583876972262248,0.33637841248899747,0.46221718221161995,245147109,247498057.6,62.58033320556141,78.16743226067895,NaN,NaN,17.501008401557367,24.584979587191917
2009-09-04T09:30:00-04:00,24.84,25.35001,24.75999,25.31,8477801,10276796.75,59.880247287749036,59.64931687394687,NaN,NaN,54.0315075599826,-4.200158337150273,-0.09281038457554802,0.3462042014921849,0.4390145860677329,253624910,245310790.4,60.344277527978925,77.0016152583546,NaN,NaN,17.825106537387743,23.61928343721989
2009-09-08T09:30:00-04:00,25.67999,25.75,25.45,25.53,17734928,10507786.1,62.0956060553625,60.09444540022654,NaN,NaN,122.1322871679334,14.092137056632476,-0.05720608505095981,0.3675069797540331,0.42471306480499293,271359838,248386901,62.38013230394855,75.99680991762708,NaN,NaN,18.78377269244533,22.92849618796638
2009-09-09T09:30:00-04:00,25.66,26.10001,25.62,25.96001,12228676,10469970.7,66.04255399067162,60.76755222689775,NaN,NaN,156.07170153130028,45.67528836950804,-0.008320956694915727,0.4143118689363483,0.42263282563126403,283588514,256892390.6,67.36851557565697,75.38440231579081,NaN,NaN,20.886498473517197,22.636782228759355
2009-09-10T09:30:00-04:00,26.02,26.25999,25.75,26.17999,10479223,10521175,67.88489697880547,61.34547448243162,NaN,NaN,158.12768329847088,91.2016426108732,0.032941039884844425,0.46380912548731956,0.43086808560247514,294067737,269557621.6,73.09049987030161,75.21819889974954,NaN,NaN,23.20516416653525,22.717979648441627
2009-09-11T09:30:00-04:00,26.39,26.53999,26.24001,26.35001,10891426,10635445.3,69.27249680549816,61.609135029510036,NaN,NaN,170.74737519138588,132.22211094981463,0.06399857333139031,0.510866302266713,0.44686772893532273,304959163,281520032.4,77.16362122158228,75.20629338829482,NaN,NaN,25.542900319490492,23.12153974430575
2009-09-14T09:30:00-04:00,26.17999,26.64999,26.05,26.60001,10257281,10442429.65,71.24022488649325,61.983924919653965,NaN,NaN,153.1054093204643,152.03689130191097,0.09199033081386943,0.5618556424526595,0.4698653116387901,315216444,293838339.2,80.44590694599353,75.19071678830035,NaN,NaN,28.123632860618365,23.83612447520755
2009-09-15T09:30:00-04:00,26.7,27.03,26.53999,26.92,12289711,10292664.6,73.57296980920049,62.44075013540527,NaN,NaN,179.49394840251372,163.509223548827,0.12085007885354293,0.6209279102057188,0.5000778313521759,327506155,305067602.6,82.86385618978015,75.16596066366587,NaN,NaN,31.06610989374805,24.868979534999053
2009-09-16T09:30:00-04:00,27.13,27.28999,26.84,27.25999,13890391,10464037.45,75.81736726518498,63.370337210459134,NaN,NaN,182.11888188440676,168.71865961944832,0.1497419023791734,0.6872552093261426,0.5375133069469692,341396546,316629209,84.93005775054534,75.19021936297484,NaN,NaN,34.30125549100446,26.21644752871411
2009-09-17T09:30:00-04:00,27.3,27.55,27.02,27.31,12510145,10668148.8,76.13838325656855,64.16766405013593,NaN,NaN,166.55299452796103,170.4037218653463,0.15829213482826432,0.7353784754822996,0.5770863406540353,353906691,328596999.8,86.71564310052767,75.25244698364627,NaN,NaN,37.00609531658457,27.757825784124176
2009-09-18T09:30:00-04:00,27.35001,27.35001,26.96001,27.00999,9784461,10724968.7,70.12448174508789,64.70656891765721,NaN,NaN,126.50760804920282,161.55576843690974,0.13094619627518034,0.7407690859980107,0.6098228897228304,344122230,336429613.2,87.73953336041392,75.3557106371712,NaN,NaN,37.561291761195804,29.158320923705837
2009-09-21T09:30:00-04:00,26.89999,27.11,26.7,26.85001,8399020,10701174,67.08169622215615,65.37869257154505,NaN,NaN,93.45372405777516,149.6254313843719,0.09117268704368475,0.7237887485274364,0.6326160614837516,335723210,340530966.4,88.25021242623615,75.6170579641754,NaN,NaN,37.13488627838201,30.297830260088148
2009-09-22T09:30:00-04:00,27.16,27.28,27,27.17,9695434,10833223.45,69.89546850227059,66.68736052681422,NaN,NaN,102.69231615661458,134.26510493519208,0.07611757345599157,0.7277630283037411,0.6516454548477495,345418644,344113464.2,88.69323206459156,76.49692808611782,NaN,NaN,37.59427503820888,31.340179514105394
2009-09-23T09:30:00-04:00,27.28999,27.38,26.86,26.94,8334066,10818688.45,65.55784100053195,67.78344712076344,NaN,NaN,84.83037453802467,114.80740346591566,0.04207212104460578,0.7042356061535067,0.6621634851089009,337084578,343251070.6,87.83468660624116,77.88575058209709,NaN,NaN,36.6927208768083,32.10482828020581
2009-09-24T09:30:00-04:00,26.95,27.02,26.35001,26.5,11069234,11026386.1,58.12620049800697,68.05217387882769,NaN,NaN,45.116172199589855,90.52003900024141,-0.015588989240506224,0.6426772485582681,0.6582662377987744,326015344,337672801.2,82.2861530602313,79.29330914314492,NaN,NaN,33.56752075321192,32.31378434777811
2009-09-25T09:30:00-04:00,26.39,26.48,26.07001,26.13,8350707,11010442.15,52.71461165480724,67.540342762189,NaN,NaN,9.75468752086155,67.16945489457315,-0.08052647876089103,0.5576081393476606,0.6381346181085517,317664637,332381282.6,77.29793340877916,80.50428456320209,NaN,NaN,29.14252984906332,31.860747990818854
2009-09-28T09:30:00-04:00,26.28999,26.78,26.28999,26.67,5896672,10925718.35,58.75058568813568,67.30141273595851,NaN,NaN,35.69842652182512,55.618395387383146,-0.08836292110627808,0.5276809667257041,0.6160438878319822,323561309,329948902.4,75.04586593192877,81.40897982234353,NaN,NaN,27.21186688466429,31.19662211851106
2009-09-29T09:30:00-04:00,26.77,26.91,26.58,26.61,12950738,11144157.2,57.86670964012836,66.71742385377684,NaN,NaN,41.725261792615804,43.424984514583386,-0.09808793537605753,0.49343396861191025,0.5915219039879678,310610571,322987287.8,68.86204856455424,81.51566075012191,NaN,NaN,25.411403961453242,30.370162381788514
2009-09-30T09:30:00-04:00,26.72,26.72,26.09,26.34,16520055,11224249,53.93444636772317,65.7209630958424,NaN,NaN,5.470729880846721,27.553055583147795,-0.12166501577831956,0.4394406342650683,0.5611056500433879,294090516,314388475.4,62.0597867855868,80.72775267264228,NaN,NaN,22.66938602615841,29.270051473841356
2009-10-01T09:30:00-04:00,26.13,26.36,25.62,25.67999,23754544,11896002,45.75020741920162,64.04079956824978,NaN,NaN,-63.87646450140664,5.754528242948494,-0.1773005812436057,0.3394799234888808,0.5167805047324865,270335972,303252601,54.5452704066015,79.11215618585793,NaN,NaN,17.423272662402287,27.577654500778632
2009-10-02T09:30:00-04:00,25.31,25.56,25.25999,25.35001,17744096,12062930.45,42.29464129825106,61.97325788337533,NaN,NaN,-139.67309954827968,-24.13102917087975,-0.22864742831661056,0.23097121933672327,0.4596186476533338,252591876,290238048.8,47.33195693346283,76.74687404210574,NaN,NaN,11.926539696062397,25.341780957247742
2009-10-05T09:30:00-04:00,25.47,25.89,25.38,25.87,11587355,12218408.15,48.850901491370344,60.20739586067318,NaN,NaN,-106.45435265204767,-52.56158500565431,-0.2198502697625524,0.18480581045014333,0.4046560802126957,264179231,278361633.2,41.88807220269848,73.82003232874276,NaN,NaN,9.425658705269937,23.0680492069652
2009-10-06T09:30:00-04:00,25.98,26.37,25.94,26.12,13055191,11984421.3,51.69263337217408,58.48420058260098,NaN,NaN,-52.755846394861244,-71.45780664314972,-0.1905462230706913,0.16647330137433158,0.3570195244450229,277234422,271686403.4,39.16172131082767,70.5508654401915,NaN,NaN,8.34253577598669,20.964404431111127
2009-10-07T09:30:00-04:00,26.13,26.13,25.89,26.02,8720035,11808989.25,50.484410426462304,56.651773951879115,NaN,NaN,-74.25220822196661,-87.40239426371238,-0.1718269116789949,0.14223588484627925,0.31406279652527413,268514387,266571177.6,37.16547408492867,67.011567653363,NaN,NaN,7.1039296008195185,18.984336598212327
2009-10-08T09:30:00-04:00,26.31,26.52,26.175,26.48,13050625,11937559.35,55.62273432450358,55.6159348504088,NaN,NaN,-19.71832550551405,-78.57076646453388,-0.12459368452176711,0.15832069087306522,0.28291437539483233,281565012,268816985.6,38.64424319155197,63.50476121273,NaN,NaN,7.684662311799817,17.370097414439112
2009-10-09T09:30:00-04:00,26.31,26.55,26.23,26.55,9427504,11864363.25,56.36479838937465,54.85044214806726,NaN,NaN,-12.144216014482076,-53.06498975777434,-0.0865694458649961,0.1747025680635872,0.2612720139285833,290992516,276497113.6,43.537962850814495,60.31102910019988,NaN,NaN,8.375756324761953,16.085191544485234
2009-10-12T09:30:00-04:00,26.67999,26.75,26.3701,26.5,5634570,11633227.7,55.648993235580136,53.83283677187508,NaN,NaN,2.493948057320389,-31.275329615900734,-0.06377132659481269,0.18155785568506744,0.24532918227988013,285357946,280732856.6,46.09175074603508,57.26806614887442,NaN,NaN,8.730484188159023,15.03451906501006
2009-10-13T09:30:00-04:00,26.49001,26.52,26.24001,26.52,8033332,11420408.75,55.890297869934436,53.14229797683241,NaN,NaN,-12.874884755137128,-23.299137287955894,-0.047099174841282954,0.18645521372827645,0.2335543885695594,293391278,283964227.8,48.02318477034634,54.4243874463105,NaN,NaN,9.087837264769254,14.184993093547089
2009-10-14T09:30:00-04:00,26.99001,27.28999,26.74001,27.28999,16827040,11567241.2,64.00914122422225,53.56250802870492,NaN,NaN,100.21321619313859,11.59394759506515,0.01282931564143372,0.24959103312135156,0.23676171747991784,310218318,292305014,52.73086669387303,52.31329556299919,NaN,NaN,11.986498841679778,13.870922486137474
2009-10-15T09:30:00-04:00,27.12,27.27,27,27.25,7673430,11325405.45,63.35690488374581,54.32267183077196,NaN,NaN,113.98583497365057,38.334779690898074,0.045008218782343234,0.29302199095784687,0.24801377217550363,302544888,296500989.2,54.94183032840779,50.716431057258376,NaN,NaN,14.122349794870331,13.90684067309931
2009-10-16T09:30:00-04:00,27.07001,27.19,26.78,27.06,8309465,11251655.65,60.217326417555796,54.42743902573053,NaN,NaN,88.34299334886425,58.43222156356735,0.048431476316370015,0.30855311757096615,0.26012164125459614,294235423,297149570.6,55.28994746348393,49.305294023798034,NaN,NaN,15.01860926221658,14.06566475725892
2009-10-19T09:30:00-04:00,27.17999,27.47,27.08501,27.35001,7929617,11228185.5,63.21377396337197,54.80937219167651,NaN,NaN,127.79602459741652,83.49263687158657,0.06417453113474758,0.34033980517303064,0.27616527403828306,302165040,300510989.4,57.1382153707171,48.46787736709539,NaN,NaN,16.68281335041896,14.439543127710355
2009-10-20T09:30:00-04:00,27.42,27.42,26.98,27.16,11172262,11302026.9,60.02381932487882,55.24432740290191,NaN,NaN,108.37627386201352,107.74286859501669,0.05603409754568911,0.3462078959703945,0.29017379842470536,290992778,300031289.4,56.77749741110606,48.0905709832039,NaN,NaN,17.166696566788104,14.829136476150033
2009-10-21T09:30:00-04:00,27.14999,27.5,26.89999,26.965,11200852,11445366.2,56.85301718512647,56.03738524332511,NaN,NaN,96.66882748637491,107.03399085366395,0.032904527917791804,0.3313044583219451,0.2983999304041533,279791926,293946011,52.269488546269294,47.9280151360373,NaN,NaN,16.665164969433707,15.091426260904845
2009-10-22T09:30:00-04:00,26.92,27.25999,26.7,27.16,11422918,11463050.4,59.175492739324014,57.243160346258904,NaN,NaN,76.42740324430103,99.52230450779406,0.026406441282127213,0.3314079820068123,0.3050015407246851,291214844,291680002.2,50.656578339093286,48.16548809358234,NaN,NaN,16.901635398895706,15.35002756633211
2009-10-23T09:30:00-04:00,27.3,27.3,26.61,26.67999,12069227,11648976.4,51.78601761491379,57.45281149794057,NaN,NaN,44.57517151421295,90.7687401408638,-0.012464460455069382,0.28942096515584836,0.30188542561091775,279145617,288662041,48.50960608930239,48.63845479976834,NaN,NaN,14.86701291138742,15.281025472768583
2009-10-26T09:30:00-04:00,26.82001,27.12,26.36,26.47,10952441,11901764.85,48.90868100727994,57.25395775759099,NaN,NaN,11.448934084216745,67.49932203822384,-0.05232788402135086,0.2364755705842292,0.28880345460558005,268193176,281867668.2,43.98939258339145,48.98328846209432,NaN,NaN,12.286871661402659,14.853289214002022
2009-10-27T09:30:00-04:00,26.42999,26.63,26.11,26.11,13816402,11945048.05,44.35835835855715,56.81638260988348,NaN,NaN,-40.25798571150343,37.77247012352045,-0.10017771642399292,0.16358130907558888,0.2637590254995818,254376774,274544467.4,39.695878679978215,49.16403164745501,NaN,NaN,8.6273950012544,13.963875755038076
2009-10-28T09:30:00-04:00,26.09,26.25,25.57001,25.57001,17674224,12002756.5,38.56282995455677,55.59781801203014,NaN,NaN,-102.03894596983642,-1.9690845677218278,-0.1617831239111101,0.06153012061069418,0.2233132445218043,236702550,265926592.2,35.32623339419413,48.92703094764373,NaN,NaN,3.450964967523113,12.462031356821653
2009-10-29T09:30:00-04:00,25.63,26.17999,25.63,26.17999,12108324,11420445.5,46.9884628446051,54.92807975883232,NaN,NaN,-75.63221710406559,-32.381008637395155,-0.15502366678766433,0.02953366103722388,0.1845573278248882,248810874,257445798.2,31.635623364865012,48.076863841504476,NaN,NaN,1.754187513296809,10.932339379175247
2009-10-30T09:30:00-04:00,26.09,26.17,25.27,25.28999,19261600,11496320.7,38.657989357185926,53.7144366246613,NaN,NaN,-139.33058896722284,-69.16216073368231,-0.20114066796427127,-0.0668685071304509,0.13427216083382038,229549274,247526529.6,27.956746350743984,46.78150638469797,NaN,NaN,-2.86995488875568,8.960583055185115
2009-11-02T09:30:00-05:00,25.41,25.78999,25.2,25.58,19853264,11909616.15,42.25078241714794,52.74018552089084,NaN,NaN,-142.7323457145662,-99.9984166934389,-0.20221815765936824,-0.11850053624038992,0.08371762141897832,249402538,243768402,26.690349871816565,45.25773246337441,NaN,NaN,-5.211289585876755,6.936029820747705
2009-11-03T09:30:00-05:00,25.58,26.02,25.55,26.02,17827008,12148207,47.29453984945903,51.54628542269347,NaN,NaN,-89.8339905266342,-109.91361765646506,-0.16497636284606312,-0.12250283213860058,0.042473530707462535,267229546,246338956.4,29.057519597936107,43.56677909937893,NaN,NaN,-5.338755482457781,5.182489063146921
2009-11-04T09:30:00-05:00,26.24001,26.39999,25.92,25.97,12721379,12348274.2,46.794385730919025,50.363248340348704,NaN,NaN,-58.76943279682819,-101.2597150218634,-0.13656370006249957,-0.12823109437066194,0.008332605691837636,254508167,249900079.8,32.31803400718819,41.950793647863236,NaN,NaN,-5.599504024823377,3.6422043362940215
2009-11-05T09:30:00-05:00,26.22,26.64,26.05,26.64,14457629,12418624.4,53.83900446299523,49.90765391502294,NaN,NaN,-11.014189029494045,-88.33610940694909,-0.06891443067412432,-0.07781043265081777,-0.008896001976693445,268965796,253931064.2,35.90879868698036,40.56642587811298,NaN,NaN,-3.4022288984171833,2.635856731335278
2009-11-06T09:30:00-05:00,26.57001,26.92999,26.53999,26.88,9245293,12409513.85,56.082173456166046,49.398253878793945,NaN,NaN,33.59019021423511,-53.751953570657506,-0.007503228405827437,-0.01827503748397774,-0.010771809078150304,278211089,263663427.2,43.67811849599528,39.60499038706142,NaN,NaN,-0.8952959673871463,2.1314063458035033
2009-11-09T09:30:00-05:00,27.19,27.56,27.05,27.56,9692305,12612400.6,61.75322963294041,49.52178318651264,NaN,NaN,103.07104801810709,-4.591274824122854,0.07487567099799716,0.08282277966934615,0.007947108671348986,287903394,271363598.4,48.950896333449684,39.04594745294311,NaN,NaN,3.258633605181418,2.29243881142892
2009-11-10T09:30:00-05:00,27.38,27.60001,27.24001,27.39999,10369410,12729204.5,59.79653948814891,49.73203477958567,NaN,NaN,95.38373329864285,32.45226994093255,0.11230014613967965,0.14832229134594854,0.036022145206268896,277533984,273424486,50.292195060989506,38.904712203994556,NaN,NaN,5.901562339654297,2.808027886889688
2009-11-11T09:30:00-05:00,27.64999,27.8,27.46001,27.61,8986246,12337164.8,61.51989988400185,49.89949243277694,NaN,NaN,113.409407086575,66.8880379176132,0.1429440634546057,0.21470222452452603,0.07175816106992033,286520230,279826898.6,54.30867140830094,39.16557599465224,NaN,NaN,8.592907203862792,3.634439217885846
2009-11-12T09:30:00-05:00,27.53,27.69,27.22,27.28999,11062219,12506604.25,57.47680834728137,50.30597748508892,NaN,NaN,84.35843543289278,85.96256281009055,0.13358121709077486,0.2387346824333889,0.10515346534261405,275458011,281125341.6,55.10102847493707,39.63639187934043,NaN,NaN,9.592112816928005,4.48553544632044
2009-11-13T09:30:00-05:00,27.32001,27.61,27.16,27.5,7949672,12488614.6,59.36422428113365,51.05280200464989,NaN,NaN,82.02814593380656,95.65015395400485,0.13315390175285682,0.2715958425336851,0.13844194078082825,283407683,282164660.4,55.76231566739935,40.47731495676957,NaN,NaN,10.990545984364019,5.414822666040951
2009-11-16T09:30:00-05:00,27.55,28.17,27.55,28.13,9421629,12563215.2,64.46035035301034,52.488658575682265,NaN,NaN,130.83130522820454,101.20220539602433,0.16484890067851937,0.34450306662897745,0.17965416595045808,292829312,283149844,56.417582385760014,41.67172236432541,NaN,NaN,13.875009669310643,6.623420809365193
2009-11-17T09:30:00-05:00,28.14999,28.14999,27.82001,28.08,7449012,12377052.7,63.77674088488878,54.289652213563116,NaN,NaN,125.9949938158514,107.32445749946605,0.17124430426860182,0.39370954628621035,0.22246524201760853,285380300,284719107.2,57.49753122519652,43.255386495111296,NaN,NaN,15.96496143641429,7.95792661322935
2009-11-18T09:30:00-05:00,28.10001,28.11,27.8,27.92999,5710719,12102546.05,61.6638318211865,55.33789285474751,NaN,NaN,108.41211450750885,106.32499898365282,0.15467444904586553,0.41580830332494045,0.26113385427907493,279669581,283348977.4,56.188382463438515,45.00915500215226,NaN,NaN,17.07820238544638,9.260823152117498
2009-11-19T09:30:00-05:00,27.8,27.8,27.3,27.50999,10685324,12065666.35,56.063515314851735,56.58114470886649,NaN,NaN,64.86420895167021,102.4261536874083,0.1069963682904857,0.39487931464218207,0.28788294635169637,268984257,282054226.6,54.91591357261937,46.93480980371479,NaN,NaN,16.379694251714607,10.277804737774227
2009-11-20T09:30:00-05:00,27.31,27.52,27.25,27.46001,10487598,11986584.9,55.418502277439366,57.52169612745873,NaN,NaN,48.91471747105571,95.80346799485814,0.06568956381454777,0.3699949011198811,0.3043053373053333,258496659,277072021.8,50.20437967453534,48.61438336105184,NaN,NaN,15.626624450589349,11.041921839604958
2009-11-23T09:30:00-05:00,27.81,28.07001,27.7,27.96001,12004563,12039191,60.33498206756393,58.4531562858948,NaN,NaN,83.51819414543945,86.34084577830511,0.06549024176819096,0.38616813951557205,0.3206778977473811,270501222,272606403.8,46.364689845090425,49.850609807277145,NaN,NaN,16.409751259296076,11.808754613846547
2009-11-24T09:30:00-05:00,27.87,27.88,27.55,27.73,8765602,11786651,57.20941714778212,59.197087101385016,NaN,NaN,61.92654802884715,73.52715662090426,0.04432994384361788,0.3760903275519034,0.33176038370828553,261735620,267877467.8,42.645138032641654,50.58826009480954,NaN,NaN,16.148466557017596,12.428713462870983
2009-11-25T09:30:00-05:00,27.82001,28.03,27.71001,27.96001,6123391,11209109.35,59.47049402784677,59.59933635601727,NaN,NaN,72.51749859982559,66.34823343936762,0.0403973349034602,0.38225705233761076,0.34185971743415056,267859011,265515353.8,40.88094430640322,50.94341335333975,NaN,NaN,16.5842846455139,13.022366488962827
2009-11-27T09:30:00-05:00,27.07001,27.69,27.03999,27.42,10091301,11108258.2,52.461615190676014,59.340725051339405,NaN,NaN,21.654143540153818,57.70622035706434,-0.0017640896687537433,0.33965460534820835,0.3414186950169621,257767710,263272044.4,39.22145867623156,50.62508050907091,NaN,NaN,14.823103375940258,13.27961461567389
2009-11-30T09:30:00-05:00,27.45,27.64999,27.3,27.50999,12897188,10790037.6,53.44625804621552,58.74736993800191,NaN,NaN,26.888300633317577,53.30093698951671,-0.025467274797062955,0.3095846015206334,0.33505187631769634,270664898,265705692.2,41.973362285735035,50.12668521994844,NaN,NaN,13.676719146539012,13.336343834368908
2009-12-01T09:30:00-05:00,27.87,28.05499,27.71001,27.96001,8460891,10220418.95,58.118049600879026,58.627477803196925,NaN,NaN,81.22520897952906,52.84233995633463,-0.013324314330333709,0.3183964834047792,0.3317207977351129,279125789,267430605.6,43.911786407209824,49.670941744678466,NaN,NaN,14.075399711640635,13.441923245407725
2009-12-02T09:30:00-05:00,27.96001,28.14,27.78,27.88,6255008,9641818.95,57.02240047494488,58.306227845407136,NaN,NaN,83.01579993972132,57.06019033850946,-0.013145145858525054,0.3152893654119566,0.3284345112704817,272870781,269657637.8,46.40132759252455,49.10613147212301,NaN,NaN,14.082610829026196,13.533450043067507
2009-12-03T09:30:00-05:00,27.97,28.14,27.69,27.75,6782930,9344896.5,55.20146387362574,58.14370324014602,NaN,NaN,62.9858996853429,55.15387055561291,-0.02363432730715692,0.29889160213653554,0.32252592944369246,266087851,269303405.8,46.05119335943438,48.45971467815853,NaN,NaN,13.573655487598806,13.539193678000549
2009-12-04T09:30:00-05:00,28.24989,28.37,27.78,28.17,11692398,9206634.95,59.68115465672563,58.166341124116876,NaN,NaN,111.46710373125858,73.11646259383387,-0.005106781069170618,0.3161424531072292,0.32124923417639983,277780249,273305913.6,50.58814744294011,48.090131233554295,NaN,NaN,14.43200030295305,13.666737481565193
2009-12-07T09:30:00-05:00,28.12,28.28,28.05,28.07001,6715492,9080144.9,58.18932413361124,57.71841067987408,NaN,NaN,112.26535529610186,90.19187352639072,-0.0025362642752532194,0.3180789038323333,0.3206151681075865,271064757,273385885.4,50.67739942639087,47.68011816502792,NaN,NaN,14.720305766461703,13.817247236550408
2009-12-08T09:30:00-05:00,27.87,27.98,27.46001,27.64,12210152,9206037.25,52.15180791338131,56.88805832476641,NaN,NaN,-12.943914270685399,71.35804887634784,-0.031157379889549364,0.28166844324564977,0.31282582313519913,258854605,269331648.6,46.128436497697265,46.868039970206546,NaN,NaN,13.190057779118119,13.727648742631509
2009-12-09T09:30:00-05:00,27.78,27.78999,27.49001,27.77,9893168,9182225.15,53.715321743198615,56.320307604910134,NaN,NaN,-21.035013102266184,50.54788626795035,-0.04201889635453415,0.2603022026920314,0.30232109904656557,268747773,268507047,45.23896812014895,46.08593894568587,NaN,NaN,12.364385897653973,13.532896907634719
2009-12-10T09:30:00-05:00,27.95,28.11,27.82001,27.89,6256039,9045714.8,55.171494922688815,56.25659186261278,NaN,NaN,53.19541411259134,48.589789153400034,-0.0417220685662783,0.2501685133387177,0.291890581904996,275003812,270290239.2,47.59236413086149,45.56282827127459,NaN,NaN,12.079037676445749,13.32520273175058
2009-12-11T09:30:00-05:00,28.05,28.23,27.89999,28.17,6521723,8818690,58.455829126344646,56.47354378039173,NaN,NaN,95.4843928150802,45.39324697016436,-0.02414104773169351,0.26171427224037913,0.28585531997207264,281525535,271039296.4,48.59180534130488,45.447644390329565,NaN,NaN,12.76405937934913,13.24503939569323
2009-12-14T09:30:00-05:00,28.31,28.55,28.31,28.55,5907926,8716602.7,62.47406024254165,56.62633507860442,NaN,NaN,198.4860929169852,62.63739449434104,0.009788533003239008,0.2980909862261214,0.2883024532228824,287433461,274313037.2,52.82607656759774,45.90917201336579,NaN,NaN,14.563358434539374,13.433370686956964
2009-12-15T09:30:00-05:00,28.44,28.56,28.32001,28.47,5982379,8544640.2,61.13347337183137,56.906624808893646,NaN,NaN,168.16474301049837,98.85912595057779,0.022807994268518983,0.3168124460585311,0.2940044517900121,281451082,278832332.6,57.9723467483041,47.00397263591311,NaN,NaN,15.669565505638735,13.75282708962579
2009-12-16T09:30:00-05:00,28.42,28.55,28.28,28.35001,6433813,8493880.25,59.085538334694824,56.87912797366851,NaN,NaN,136.80107690295432,130.4263439516219,0.0194348436647947,0.31829800637100547,0.29886316270621077,275017269,280086231.8,59.29904383759266,48.31955117385521,NaN,NaN,16.034967871012938,14.078847201252525
2009-12-17T09:30:00-05:00,28.23,28.24001,28.005,28.03999,8512496,8633969.1,54.04770597175279,56.99242017231685,NaN,NaN,50.94353439946593,129.9759680089968,-0.00620761894748989,0.29110363902184844,0.2973112579693383,266504773,278386424,56.686646242691666,49.567064571459504,NaN,NaN,14.918563973971668,14.198806740212403
2009-12-18T09:30:00-05:00,28.03,28.065,27.675,27.85001,9836320,8591518.9,51.16852936476316,56.829725266498826,NaN,NaN,-16.83107650549368,107.51287414488203,-0.03678901385224931,0.2513249906540267,0.288114004506276,256668453,273415007.6,49.779381708452675,50.124637387367905,NaN,NaN,13.13947605138772,14.04747378466602
2009-12-21T09:30:00-05:00,28.05,28.14,27.97,28.06,8727789,8503528.45,54.08035254187446,56.54131833371279,NaN,NaN,31.433663769411094,74.10238831536722,-0.04325390797927431,0.2340466195321831,0.2773005275114574,265396242,269007563.8,44.591728259985025,50.173204662566135,NaN,NaN,12.42928612381292,13.816304118829862
2009-12-22T09:30:00-05:00,28.07001,28.235,28.02,28.09,5726094,8189605,54.497802946208964,56.36098993880307,NaN,NaN,44.79162905575773,49.42776552441908,-0.04565210310509571,0.2202353986300878,0.2658875017351835,271122336,266941814.6,42.363358119073986,49.88477827160538,NaN,NaN,11.955740077190812,13.55050925573857
2009-12-23T09:30:00-05:00,28.10001,28.17999,27.98,28.14,2992860,7900967.9,55.2283411951285,56.362909747481844,NaN,NaN,35.53234470153148,29.17401908413451,-0.043995249076889675,0.21089344038907143,0.2548886894659611,274115196,266761400,42.1651754344253,49.60720556267616,NaN,NaN,11.749622817827587,13.29323976460843
2009-12-24T09:30:00-05:00,28.25,28.31,28.17,28.25,1277553,7658676,56.86896073396586,56.162038752999,NaN,NaN,71.71443357073777,33.32819891838888,-0.03595428992324806,0.209945827061901,0.24590011698514908,275392749,268538995.2,44.9002599484261,49.200927884496586,NaN,NaN,12.000951691758713,13.108627182772755
2009-12-28T09:30:00-05:00,28.3,28.3,28.09,28.2,6078336,7458027.75,55.86683828682116,55.99614690679971,NaN,NaN,52.72532209247365,47.239478637982344,-0.03446229683482166,0.20282224594162201,0.23728454277644367,269314413,271068187.2,48.62316762495034,49.05419704153655,NaN,NaN,11.959839890225131,12.94451471240881
2009-12-29T09:30:00-05:00,28.33,28.33,28.24001,28.28,2883006,6957318.65,57.16738150748507,56.3544021635214,NaN,NaN,78.70936566371604,56.69461901684334,-0.028778438702827147,0.20131149439790974,0.2300899331007369,272197419,272428422.6,50.55801010981391,49.37059515668774,NaN,NaN,12.252956970572793,12.845720749289379
2009-12-30T09:30:00-05:00,28.12,28.25,28.09979,28.14,5470980,6807823.1,54.159523603391655,56.38613086782091,NaN,NaN,28.364954829261542,53.40928417154411,-0.03473945216366109,0.18666561789616054,0.22140507005982163,266726439,271549243.2,49.2665570736564,49.65828008193828,NaN,NaN,11.745386488352935,12.688530140584172
2009-12-31T09:30:00-05:00,28.24001,28.24001,27.77,27.78999,3116975,6650921.45,47.43929099897872,55.8338305875559,NaN,NaN,-65.79313231150294,33.14418876893722,-0.06100992870429836,0.14514265917944869,0.20615258788374705,263609464,269448096.8,46.227410113159856,49.56078336638815,NaN,NaN,9.405492994056296,12.219524833937333
2010-01-04T09:30:00-05:00,28.09,28.32001,27.96001,28.32001,7471438,6685346.85,56.28506425190239,55.67877595366717,NaN,NaN,38.57578039368498,26.51645813352666,-0.04233232879549054,0.15323717688938387,0.1955695056848744,271080902,268585727.4,45.00042907702529,49.30425649036818,NaN,NaN,9.870812592054726,11.883994513668389
2010-01-05T09:30:00-05:00,28.28,28.45,28.17999,28.42,8256637,6513558.8,57.73034521674699,55.33993916611041,NaN,NaN,91.55842408488307,34.28307853200854,-0.023808282038844275,0.16580915313631905,0.18961743517516333,279337539,270590352.6,48.42718857981509,48.990050205526565,NaN,NaN,10.686989171801196,11.712993750544504
2010-01-06T09:30:00-05:00,28.35001,28.50999,28.34,28.48,5356668,6445617.6,58.61454327367643,55.16001558767078,NaN,NaN,112.42474506034011,41.02615441133336,-0.008849345049052937,0.17855575386384714,0.18740509891290008,284694207,273089710.2,52.40856314161328,48.592637090762935,NaN,NaN,11.614353816683218,11.698902331421463
2010-01-07T09:30:00-05:00,28.42999,28.83,28.33,28.78999,12118129,6441016.45,62.929090379229606,55.434555019423264,NaN,NaN,170.24405951261454,69.40197534800396,0.01906482523623443,0.21123613045819312,0.1921713052219587,296812336,279106889.6,60.34551566283379,48.66738507828016,NaN,NaN,13.743217881587253,11.990947410016576
2010-01-08T09:30:00-05:00,28.8,29.25999,28.78,29.25,8064906,6349603.35,68.22329368331134,56.44709699882031,NaN,NaN,269.15387985101046,136.39137778050662,0.06316625116701804,0.27112911918073124,0.2079628680137132,304877242,287360445.2,68.1835837216209,49.48859489820368,NaN,NaN,17.410929198008485,12.76523052258685
2010-01-11T09:30:00-05:00,29.45,29.61,29.30099,29.57001,11895508,6631576.8,71.2945284671121,57.8846683632738,NaN,NaN,289.53634507899005,186.58349071756766,0.10602322411760626,0.340491898160721,0.23446867404311475,316772750,296498814.8,74.251968116375,51.236636784483835,NaN,NaN,21.56974790899136,14.023018720644636
2010-01-12T09:30:00-05:00,29.32001,29.41,29.12,29.33,12020672,6906524.25,66.13195803629927,58.74549732716129,NaN,NaN,190.028282704403,206.27746244147164,0.10987274824417992,0.3718096093483396,0.2619368611041597,304752078,301581722.6,76.89201749059578,53.543800300956036,NaN,NaN,23.364723205953215,15.357547932831576
2010-01-13T09:30:00-05:00,29.28,29.505,29.17,29.45,10978199,7160037.9,67.40289894799801,59.66728989871765,NaN,NaN,167.69570159407732,217.3316537482191,0.11179593566475121,0.40168178068509874,0.28988584502034753,315730277,307788936.6,79.63777629602981,56.206258742167165,NaN,NaN,25.218912095551655,16.766314241791587
2010-01-14T09:30:00-05:00,29.41,29.47,29.33,29.45,4762645,7099051.2,67.40289894799801,60.536901166779764,NaN,NaN,140.99672339504068,211.48218652470433,0.10449799068534515,0.420508333377029,0.3160103426916838,315730277,311572524.8,81.11110211931917,58.98811064823102,NaN,NaN,26.696549770897775,18.184919317378185
2010-01-15T09:30:00-05:00,29.35001,29.44,28.99001,29.07001,7250949,7139908,59.23890653363309,60.706183009613135,NaN,NaN,88.9166941214221,175.43474937878665,0.06731474276314164,0.4001537711456109,0.33283902838246926,308479328,312292942,81.3872545865307,61.59432455095277,NaN,NaN,25.4990428207902,19.229794103579902
2010-01-19T09:30:00-05:00,29.17,29.425,29.035,29.39,11941277,7311347.05,63.27310409964015,61.235201996243056,NaN,NaN,91.49958322609062,135.82739700820676,0.057866837633369805,0.4051725754241815,0.3473057377908117,320420605,313022513,81.67936762502377,63.955481693815166,NaN,NaN,25.727861097832548,20.158089388473137
2010-01-20T09:30:00-05:00,29.07001,29.13,28.67,28.94,9810348,7310048.45,55.02536259935471,61.08220064566232,NaN,NaN,37.13366426658993,105.24847332064414,0.017027329650651013,0.3685898998541255,0.3515625702034745,310610257,314194148.8,82.16349541076181,66.21301635816859,NaN,NaN,23.16726502108417,20.587971621703286
2010-01-21T09:30:00-05:00,28.92,29.05,28.25,28.27,17492816,7748299.8,45.51281994437589,60.46457895573262,NaN,NaN,-19.463939726692228,67.81654505649021,-0.055425647119779875,0.28228051130374965,0.3377061584235295,293117441,309671581.6,74.03122918240815,67.98192150879372,NaN,NaN,17.370492334978884,20.1283317235998
2010-01-22T09:30:00-05:00,28.3,28.46001,27.83,27.84,16216520,8272821.1,40.65515394770086,59.979997737784196,NaN,NaN,-85.97030681091273,22.423139015299537,-0.1284526633290286,0.17714032926224377,0.30559299259127237,276900921,301905710.4,62.57763782036644,69.14979491645133,NaN,NaN,10.795115069297728,18.795015058699505
2010-01-25T09:30:00-05:00,28.17,28.21001,27.855,28.02,12695445,8757950.35,43.379464488771944,59.05816918327489,NaN,NaN,-87.04353359404745,-12.768906527794371,-0.15878973494462245,0.10710582391049428,0.26589555885511673,289596366,298129118,57.887294917399494,70.07028533362092,NaN,NaN,6.592754220605721,17.051834938971822
2010-01-26T09:30:00-05:00,27.86,28.17999,27.75,27.89999,12708133,9329479.35,41.99525000778235,57.93423381120598,NaN,NaN,-94.21211860914767,-49.91124689484203,-0.17956328030298563,0.041441458476384696,0.22100473877937032,276888233,289422643.6,48.80533425544265,70.09729573902288,NaN,NaN,2.82611518461095,15.019589259777412
2010-01-27T09:30:00-05:00,27.8,28.03999,27.52,27.98,22437792,10147452.15,43.29439232322146,56.83993731474492,NaN,NaN,-101.67431174614617,-77.67284209738925,-0.1800795389507325,-0.004094684909045299,0.1759848540416872,299326025,287165797.2,46.75751265647231,69.69364927579853,NaN,NaN,0.22856950550990715,12.906586437739197
2010-01-28T09:30:00-05:00,28.02,28.14999,27.401,27.66,21371552,11071879.45,39.48531996755467,55.16538228533957,NaN,NaN,-107.28488233421395,-95.23703061889358,-0.1929891256138208,-0.06525155297558882,0.127737572638232,277954473,284133203.6,44.080977573565335,68.5318965551365,NaN,NaN,-3.2030407294129946,10.605211128146028
2010-01-29T09:30:00-05:00,27.71001,27.97501,27.31,27.38,17136112,11655136.05,36.46240699140756,52.89674752163216,NaN,NaN,-120.07840407843986,-102.05865007239902,-0.2099973005056372,-0.13475905299381452,0.07523824751182268,260818361,280916691.6,41.37563739426438,66.6170432460396,NaN,NaN,-7.061611111399568,8.081379379639515
2010-02-01T09:30:00-05:00,27.69,27.8,27.5,27.78999,16145992,12306586.9,43.306602167406695,50.89760992879605,NaN,NaN,-99.91754454189912,-104.63345226196934,-0.1841706182803758,-0.15497502533864704,0.02919559294172873,276964353,278390289,39.333721852163684,64.12288279859594,NaN,NaN,-8.19329127048137,5.7564264296222465
2010-02-02T09:30:00-05:00,27.95,28.37,27.89,28.32001,20403344,12953182.2,50.699972581824646,49.79532525347644,NaN,NaN,-41.867361858620384,-94.16450091186388,-0.12476995854105122,-0.1267668552345853,-0.0019968966935340823,297367697,282486181.8,44.14627894423995,61.78390147385624,NaN,NaN,-6.661009822914968,3.982506964974073
2010-02-03T09:30:00-05:00,28.24001,28.41,28.08,28.14999,13675387,13224119.7,48.51436221208661,48.446144058054195,NaN,NaN,-38.3242934702993,-81.49449725669452,-0.09183020227545145,-0.1167846495378484,-0.024954447262396946,283692310,279359438.8,41.443484054352886,59.05573774230789,NaN,NaN,-6.142801611837768,2.53603431114381
2010-02-04T09:30:00-05:00,27.96001,28.00999,27.32001,27.32001,20628096,13987691.1,39.55093540976252,46.456718091037374,NaN,NaN,-102.23018266876842,-80.48355732360541,-0.11911018993487951,-0.17384218468099633,-0.05473199474611682,263064214,276381387,38.99470623052395,56.04742375025109,NaN,NaN,-8.87317085200492,0.9061478592654202
2010-02-05T09:30:00-05:00,27.38,27.5295,26.66,27.2,30821248,14922847.05,38.44488032895912,44.971430504989236,NaN,NaN,-128.1854864358414,-82.10497379508571,-0.13712458140805672,-0.22613772150618772,-0.089013140098131,232242966,270666308,34.75108888076862,52.71626905698238,NaN,NaN,-11.35762930996308,-0.8458203077672226
2010-02-08T09:30:00-05:00,27.27,27.32001,26.89999,26.89999,17888816,15414042.55,35.75311692983885,43.00571713571771,NaN,NaN,-124.12262311358897,-86.94598950942368,-0.1595617773564249,-0.2884653617936621,-0.1289035844372372,214354150,258144267.4,27.650802620601738,48.8570858423808,NaN,NaN,-14.28897681916389,-2.7662712379667465
2010-02-09T09:30:00-05:00,27.2,27.67,27.11,27.42,22723408,15955437.55,43.179299189831774,42.15956974932322,NaN,NaN,-84.51465165708629,-95.47544746911686,-0.13089947232817162,-0.2925279248474517,-0.1616284525192801,237077558,246086239.6,22.81642201626829,44.61800917134555,NaN,NaN,-14.270087708362283,-4.409673590880394
2010-02-10T09:30:00-05:00,27.44,27.50999,27.125,27.38,12709766,15989892.25,42.76977133286768,41.96363770564407,NaN,NaN,-85.0081394820878,-104.81221667147456,-0.10715169898026394,-0.29556807624461,-0.18841637726434607,224367792,234221336,19.24997426079969,40.70506239123066,NaN,NaN,-14.384831375085152,-5.834696131481074
2010-02-11T09:30:00-05:00,27.35001,27.82001,27.2,27.78999,11508098,16016387.2,48.1934108406951,42.50208462657223,NaN,NaN,-51.806039308214075,-94.72738799936369,-0.05876762546168385,-0.26187590909145086,-0.20310828362976702,235875890,228783671.2,17.871253714655595,37.51174924082274,NaN,NaN,-12.723415405394464,-6.818798884897273
2010-02-12T09:30:00-05:00,27.42,27.67,27.28,27.57001,16638891,16610199.5,45.69137143558909,42.66722083705916,NaN,NaN,-58.49977501660215,-80.79024571551584,-0.037547639734623356,-0.2500428332980462,-0.21249519356342286,219236999,226182477.8,17.235322132546955,34.608036899047555,NaN,NaN,-12.141355882046048,-7.5791641702042405
2010-02-16T09:30:00-05:00,27.86,28.25,27.785,28.22,10496906,16772497.35,53.39122294114637,43.48121890372802,NaN,NaN,31.599893285993428,-49.64574243559936,0.021139066961881642,-0.18607135986107082,-0.20721042682295246,229733905,229258428.8,20.823256275023653,32.60931704330334,NaN,NaN,-9.028558678406123,-7.786220528518795
2010-02-17T09:30:00-05:00,28.42999,28.49001,28.25,28.46001,14974227,16924144.85,55.87875462703978,44.38010192542934,NaN,NaN,98.28415617445319,-13.085980869291479,0.07402058834924968,-0.11468469138639037,-0.18870527973564005,244708132,230784543.6,22.615696923171654,30.88490163378187,NaN,NaN,-5.688170579205056,-7.486499107188261
2010-02-18T09:30:00-05:00,28.28999,28.77,28.28999,28.72,7602254,16813740.15,58.46476115135284,45.73577629570064,NaN,NaN,140.74853996283423,32.06535501969293,0.12159776434568559,-0.03670807430353307,-0.15830583864921866,252310386,236373062.4,28.958127776709816,29.804698076863616,NaN,NaN,-2.106743858085163,-6.717962643030676
2010-02-19T09:30:00-05:00,28.67999,29,28.59,28.86,12077328,16542965.75,59.83009462406227,47.40489684089025,NaN,NaN,171.89825723689975,76.8062143287157,0.15542157784691907,0.035971133659430166,-0.11945044418748889,264387714,242075427.2,34.82773009004849,29.33699041227677,NaN,NaN,1.2212764209791833,-5.583785633886411
2010-02-22T09:30:00-05:00,29,29.02,28.81,28.88,7382684,16101273.95,60.0322190063503,48.599583757957646,NaN,NaN,160.09105621120668,120.52438057427746,0.17083959311554492,0.09409904720694229,-0.07674054590860264,271770398,252582107,44.007273457733724,29.670815526960343,NaN,NaN,3.955467678418647,-4.221035160699974
2010-02-23T09:30:00-05:00,28.81,28.99001,28.4299,28.50999,16110188,16272011.1,54.56232495909622,48.8754660706199,NaN,NaN,106.2223858060238,135.4488790782835,0.14863406773856114,0.10905203876459879,-0.03958202897396236,255660210,257767368,47.90694363443592,29.93943443340291,NaN,NaN,4.751629629943846,-2.939225904893714
2010-02-24T09:30:00-05:00,28.61,28.86,28.50999,28.8,9011148,16087161.85,57.80733239734483,49.539249655281196,NaN,NaN,102.60287366252902,136.3126225758987,0.14579305367414738,0.14265928811872186,-0.0031337655554255148,264671358,261760013.2,50.751187347327686,30.60427038290111,NaN,NaN,6.402048714392615,-1.6047581021385244
2010-02-25T09:30:00-05:00,28.28,28.78999,28.14999,28.73,12356934,15583118.95,56.753760950804406,50.76802290821276,NaN,NaN,72.1948406806294,122.60188271945772,0.13193098178811638,0.16177996167971997,0.029848979891603587,252314424,261760820.8,50.751773077831444,31.444060871994505,NaN,NaN,7.454742305946057,-0.3105437581264414
2010-02-26T09:30:00-05:00,28.69,28.92999,28.58,28.84,9004172,14964749.95,58.04770678657638,52.168224798042566,NaN,NaN,90.36286062979076,106.29480339803592,0.12307427917990606,0.18369182886648616,0.060617549686580105,261318596,261146997.2,50.26247009846947,32.552016673258855,NaN,NaN,8.6975526316846,0.9763271547037071
2010-03-01T09:30:00-05:00,28.96001,29.25999,28.85001,29.22,11493813,14682635,62.24977320468369,54.06084310338862,NaN,NaN,116.88259193116569,97.65311054202773,0.1347693861037977,0.22907928231632724,0.09430989621252953,272812409,261355399.4,50.437183419917545,34.17961530178141,NaN,NaN,11.033128641810901,2.413013081433306
2010-03-02T09:30:00-05:00,29.35001,29.41,29.22,29.27,7327797,14241725.25,62.77806905259355,55.46075523644304,NaN,NaN,124.83387752614397,101.37540888605176,0.13736589650569575,0.2660172668446492,0.12865137033895346,280140206,266251398.6,54.482426565321965,36.44147276957096,NaN,NaN,13.106022026291175,3.940585787841573
2010-03-03T09:30:00-05:00,29.37,29.60001,29.24001,29.31,5641191,13503617.6,63.22150031854121,56.921593021134,NaN,NaN,117.28495035014836,104.31182422357563,0.13317220820833908,0.2951166305993773,0.16194442239103823,285781397,270473406.4,57.68943329141119,39.18714841461464,NaN,NaN,14.953236749984027,5.513821639576209
2010-03-04T09:30:00-05:00,29.39999,29.489,29.25,29.45,7479504,13193823.45,64.80201293709996,58.10792174230578,NaN,NaN,105.39025959317927,110.9509080060856,0.13102063496588096,0.3257202160983894,0.19469958113250846,293260901,278662701.8,63.11758861189444,42.41902947870312,NaN,NaN,16.97266728507105,7.150799588932615
2010-03-05T09:30:00-05:00,29.64999,29.91,29.60001,29.89999,9905277,12657682.5,69.3598094408775,59.79852445696923,NaN,NaN,133.0311452883129,119.48456493779004,0.14974602397916414,0.38188211110646364,0.2321360871272995,303166178,287032218.2,67.6810941703176,46.02229890997247,NaN,NaN,20.173655064789124,9.011207514054973
2010-03-08T09:30:00-05:00,29.95,29.98,29.72,29.75999,6773191,11455279.65,66.47571181923985,60.73313080540448,NaN,NaN,128.16263003437888,121.74057255843266,0.1425819876911264,0.4103635717412075,0.2677815840500811,296392987,291748333.8,69.93825363792693,49.53051300732271,NaN,NaN,22.072063319446215,10.877044057682294
2010-03-09T09:30:00-05:00,29.69,30.08501,29.62,30,7609816,10941329.65,68.86586049678502,61.660781224672,NaN,NaN,128.76432566570531,122.52666218634492,0.14349288904199636,0.4471476953525766,0.3036548063105802,304002803,296520853.2,72.06448363588045,53.062569201087626,NaN,NaN,24.411980592570696,12.810606419809208
2010-03-10T09:30:00-05:00,30,30.17999,29.89,30.06,7922973,10201307.9,69.45220361923204,62.44559854380623,NaN,NaN,131.10950979760085,125.29157407583543,0.13760238692981563,0.4756577899728498,0.33805540304303416,311925776,301749729,74.21621483039988,56.29528970492263,NaN,NaN,26.520466565058786,14.769157869130575
2010-03-11T09:30:00-05:00,29.97,30.17999,29.78999,30.17,7903191,9960979.15,70.54733368825404,63.21111561981992,NaN,NaN,118.2227143289329,127.85806502298615,0.13063494626336059,0.5013490858722349,0.37071413960887434,319828967,307063342.2,76.22067371727559,59.25192853543884,NaN,NaN,28.61594430265409,16.74727021677679
2010-03-12T09:30:00-05:00,30.3,30.37,30.03999,30.37,9897191,9880433.8,72.47916589736532,64.10018325489243,NaN,NaN,127.89945914951869,126.83172779522731,0.12880359240406059,0.53171863011395,0.40291503770988946,329726158,312375338.2,78.05719165438015,61.68406554948502,NaN,NaN,30.98842287318399,18.781720596263533
2010-03-15T09:30:00-04:00,30.27,30.44,30.11501,30.37,13020547,9699516.6,72.47916589736532,65.37995760762593,NaN,NaN,121.84470520362301,125.56814282907615,0.11723033864351118,0.5494529610142784,0.43222262237076725,329726158,319041972.4,80.13115821534697,63.985795162407236,NaN,NaN,32.95550310549133,20.80654666901036
2010-03-16T09:30:00-04:00,30.39,30.78,30.39,30.78,14118438,9880593.2,76.19189189683367,66.69314042901799,NaN,NaN,144.59792304117798,128.73486230417066,0.12605579035306286,0.5897923603120958,0.46373656995903295,343844596,327010331,82.28625534224426,66.238300019187,NaN,NaN,35.86934180170693,22.95837454510987
2010-03-17T09:30:00-04:00,30.87,30.97,30.73,30.83,10824941,9673128.9,76.60636827722466,68.11118380947659,NaN,NaN,144.40762287192806,131.3944849190361,0.12394244508165203,0.618664626311098,0.49472218122944595,354669537,335559083.2,84.25889618612356,68.63166595549357,NaN,NaN,38.40745589896722,25.16538616708949
2010-03-18T09:30:00-04:00,30.87,31.05,30.75,31.03999,10298496,9807941,78.31390316598467,69.55876926514861,NaN,NaN,136.8165787996306,135.11325781317566,0.12501135696442633,0.6509863774349789,0.5259750204705526,364968033,344586896.4,86.02838842950797,71.1863744077106,NaN,NaN,41.121686867446186,27.444857695711875
2010-03-19T09:30:00-04:00,31.09,31.12,30.69,30.81,8777766,9642962.9,72.10608645898799,70.26279164045606,NaN,NaN,116.42767985297522,132.81890195386697,0.09965538995747181,0.6505442579173923,0.5508888679599205,356190267,349879718.2,86.954301488141,73.79473998401228,NaN,NaN,41.73070377733079,29.48569285022886
2010-03-22T09:30:00-04:00,30.58,30.95,30.56,30.89999,6434348,9595546.1,73.00767883433177,70.99347805343736,NaN,NaN,100.52731630219944,128.55542417358225,0.07925926376311654,0.6499629476638162,0.5707036839006997,362624615,356459409.6,88.01740942939607,76.19009590287473,NaN,NaN,42.49132076901778,31.343639695770136
2010-03-23T09:30:00-04:00,30.98,31.25,30.91,31.25,8871262,9233599.8,76.22629072548051,71.92239165393302,NaN,NaN,122.04618312696442,124.04507619073954,0.07945428939137278,0.6700215456399157,0.5905672562485429,371495877,361989665.8,88.8405556794833,78.4151760734513,NaN,NaN,44.127882286642375,33.16996006589474
2010-03-24T09:30:00-04:00,31.14,31.27,30.97,31.03,8390199,9202552.35,70.53319062095576,72.33176148849415,NaN,NaN,107.430384078575,116.64962843206892,0.055987427549264224,0.6605515406851232,0.604564113135859,363105678,363676894,89.08686956065694,80.27012471264861,NaN,NaN,43.82399527387511,34.69196509560622
2010-03-25T09:30:00-04:00,31.32001,31.42,30.95,31.00999,10004145,9084912.9,70.02094167713219,72.3789852196552,NaN,NaN,101.23935135320494,109.53418294278379,0.03155521263699845,0.6440081289321071,0.6124529162951087,353101533,361303594,86.20456364695713,81.59322967526573,NaN,NaN,43.4298987135962,35.940241326747646
2010-03-26T09:30:00-04:00,31.11,31.28,30.92,31.09,13362367,9302822.65,70.93004605789585,72.69715195098777,NaN,NaN,90.2807146284338,104.30478989787548,0.014109832222857,0.63009020657368,0.615980374350823,366463900,363358320.6,86.60852595567523,82.78396341224776,NaN,NaN,43.34595326812976,36.99820017551652
2010-03-29T09:30:00-04:00,31.28,31.41,31.19,31.37,17198112,9588037.6,73.9115937247942,73.05756146727416,NaN,NaN,105.00668272508418,105.20066318245244,0.014688915408228587,0.6343415186111088,0.6196526032028802,383662012,367565800,87.42081491337761,83.88084421778326,NaN,NaN,44.122321125141085,38.0159317397486
2010-03-30T09:30:00-04:00,31.45,31.59,31.28999,31.42,10610473,9752171.4,74.41620737660418,73.4121331642293,NaN,NaN,108.13497739501025,102.41842203606161,0.011823485000883038,0.634431959453984,0.622608474453101,394272485,372121121.6,88.25169635067508,84.88337861208863,NaN,NaN,44.90574880971319,39.00019132117212
2010-03-31T09:30:00-04:00,31.37,31.42999,31.14999,31.24001,11457160,10042969.85,69.2253437025563,73.31770530810805,NaN,NaN,83.73105230368314,97.67855568108324,-0.007755061813596309,0.6129146471861056,0.6206697089997019,382815325,376063051,88.93292644867392,85.79139666433137,NaN,NaN,44.11117677083199,39.730332099694955
2010-04-01T09:30:00-04:00,31.50999,31.59,31.205,31.44,12537891,10295889.2,71.59613899608787,73.2546319580168,NaN,NaN,96.63933424721316,96.7585522598849,-0.012515615177169703,0.6050251900282397,0.6175408052054094,395353216,384513387.6,90.23951782495288,86.66156281937229,NaN,NaN,44.087528234787904,40.35278869042252
2010-04-05T09:30:00-04:00,31.57001,31.745,31.4496,31.67,11007617,10351006.2,74.07016800206618,73.36827496549542,NaN,NaN,119.68216776398988,102.6388428869961,-0.005795287534389737,0.6102966957874223,0.616091983321812,406360833,392492774.2,91.28572659173648,87.45831770340011,NaN,NaN,44.79030678205878,40.986719846370555
2010-04-06T09:30:00-04:00,31.61,31.73,31.50999,31.67999,9108480,10467770.65,74.17538444342176,73.22423871882314,NaN,NaN,116.22414818525992,104.88233597903124,-0.006258572362267234,0.608268767868978,0.6145273402312452,415469313,398854234.4,92.0200993486066,88.15359227528313,NaN,NaN,45.39177461871868,41.61601338527743
2010-04-07T09:30:00-04:00,31.60001,31.67,31.34,31.5,10235109,10599035.3,68.76164053839975,72.66390102319279,NaN,NaN,89.31429503208483,101.11819950644617,-0.02330993538052195,0.5853899210055928,0.6086998563861148,405234204,401046578.2,92.26211539071576,88.72525078989688,NaN,NaN,44.36732152302628,42.00905740495583
2010-04-08T09:30:00-04:00,31.38,31.66,31.27,31.60249,9100535,10657913.4,70.09986466515849,72.07718398741949,NaN,NaN,85.60949076796496,101.49388719930252,-0.031784182085508816,0.5689696287792287,0.6007538108647376,414334739,407350461,92.92642395260874,89.21796761297549,NaN,NaN,43.86708659677508,42.2744901466443
2010-04-09T09:30:00-04:00,31.69,31.78999,31.59,31.78,6284582,10576982.95,72.31221955301353,72.09190777984989,NaN,NaN,119.91235055856383,106.14849046157266,-0.02957818071653784,0.5637810849690652,0.593359265685603,420619321,412403682,93.41449341400478,89.67940989339434,NaN,NaN,44.053884367710594,42.52868932108234
2010-04-12T09:30:00-04:00,31.78999,31.965,31.78999,31.85001,6771289,10420687.85,73.1558518623416,72.10249156756488,NaN,NaN,136.69865564728153,109.55178803823101,-0.02758663320609589,0.5588759741779832,0.5864626073840791,427390610,416609637.4,93.79806869624487,90.09231412674067,NaN,NaN,44.44451698699075,42.80237898764069
2010-04-13T09:30:00-04:00,31.77,31.98,31.64999,31.89999,8688195,10204070.25,73.77029171940188,71.92706306713069,NaN,NaN,123.1659235867542,110.94014311852986,-0.027049293719884515,0.5526509902342234,0.5797002839541079,436078805,420731535.8,94.15723621666324,90.47207702225353,NaN,NaN,44.938999160603984,43.10761044092116
2010-04-14T09:30:00-04:00,32.08,32.34,31.98,32.31,13027930,10149544.85,78.18217561689282,72.47341913826905,NaN,NaN,180.55447242333688,129.18817859678026,-0.004413667558177403,0.5741831995063862,0.5785968670645636,449106735,429506042,94.84202887749912,90.88315983059941,NaN,NaN,46.74904615973177,43.627815543608385
2010-04-15T09:30:00-04:00,32.28999,32.69,32.25999,32.62,6788758,9947735.7,80.81032561423555,73.24408941949072,NaN,NaN,210.23429788966723,154.11314002112073,0.02451379473253168,0.6092391104802282,0.5847253157476965,455895493,437818192.8,95.39289299022627,91.53946906940435,NaN,NaN,49.20263319873083,44.424218065768734
2010-04-16T09:30:00-04:00,32.5,32.58,31.82001,32.09,26513872,10758504.5,66.1410504864522,72.90201830724475,NaN,NaN,123.88983659416621,154.9086372282412,0.002205723138474003,0.587482469670789,0.585276746532315,429381621,439570652.8,95.50196364463099,92.17471461861547,NaN,NaN,46.30296652363325,44.69261070260652
2010-04-19T09:30:00-04:00,32.06,32.14999,31.73,32.03,16021180,11120675.2,64.70897347961449,72.24468828973191,NaN,NaN,77.68612836700196,143.10613177218528,-0.021057087816924613,0.5589553867611592,0.5800124745780838,413360441,436764619,91.75616572921233,92.48438253403222,NaN,NaN,43.57181431284125,44.53249693264006
2010-04-20T09:30:00-04:00,32.33,32.5,32.23,32.39999,13102934,11454104.5,69.14544760762419,71.86820544909048,NaN,NaN,138.4089270484183,146.1547324645181,-0.01620988528987677,0.5597501179657378,0.5759600032556146,426463375,434841533,89.17471255299918,92.55031226276967,NaN,NaN,42.702950897549904,44.271133213341464
2010-04-21T09:30:00-04:00,32.46001,32.69009,32.36,32.62,19372944,11979188.6,71.44426328123876,72.02669970471065,NaN,NaN,147.46777935749625,139.53739385134998,-0.003532396871453569,0.5715445071662977,0.5750769040377512,445836319,434187449.8,88.26514034380205,92.5026132552788,NaN,NaN,42.765468850188824,44.05603830431966
2010-04-22T09:30:00-04:00,32.46001,32.94,32.19,32.92,34014016,13260379.45,74.26037939350519,72.21700259024047,NaN,NaN,146.2329409698935,126.73712246739521,0.018501214130162147,0.5982034217004539,0.5797022075702918,479850335,438978418.2,89.13899736267558,92.42400465083043,NaN,NaN,43.779039148254405,44.016466996310335
2010-04-23T09:30:00-04:00,32.98,33.14999,32.74899,33.12,15681203,13544232.35,75.96231546814921,72.35215598067497,NaN,NaN,169.80221823804973,135.9195987961719,0.03882008882000676,0.6282273185953002,0.5894072297752935,495531538,452208401.6,91.10813478612127,92.4113195218579,NaN,NaN,45.175039616374335,44.18197737060519
2010-04-26T09:30:00-04:00,33.34,33.39999,33.14,33.19,13312195,13541723.75,76.54683009061064,72.52154495547417,NaN,NaN,173.1358015930843,155.00953344138838,0.04861427589179068,0.6501750746400319,0.6015607987482412,508843733,471305060,93.06315362654247,92.48582339885333,NaN,NaN,46.46754846338381,44.50848752671642
2010-04-27T09:30:00-04:00,33.02,33.27,32.27,32.39,31528608,14258248.55,58.91475410966426,71.81819592485022,NaN,NaN,79.91496671227998,143.31074137416073,-0.004333804098552663,0.5961435436250504,0.6004773477236031,477315125,481475410,93.83994734234639,92.59852568111265,NaN,NaN,41.22773847043448,44.03980909010472
2010-04-28T09:30:00-04:00,32.50999,32.73,32.34,32.62,17520368,14603743.3,61.64981049866703,71.21462062724368,NaN,NaN,61.998709551917614,126.21692741304496,-0.02808982436971419,0.5653650672614603,0.5934548916311745,494835493,491275244.8,94.4812352460447,92.70958363064379,NaN,NaN,38.0433095169632,43.183166293941646
2010-04-29T09:30:00-04:00,32.89,33.36,32.8,33.36,14211383,14741454.45,68.83766064016658,70.96643784775459,NaN,NaN,131.7819833700138,123.32673589306903,0.00030753362324353883,0.5938393086602289,0.5935317750369854,509046876,497114553,94.8268192283331,92.81046404595295,NaN,NaN,37.96408936678565,42.437583875776504
2010-04-30T09:30:00-04:00,33.33,33.46001,32.55499,32.57001,18401776,15034648.7,56.63415786503104,69.78631684794671,NaN,NaN,80.37969508743363,105.44223126294582,-0.03773610609281319,0.546361642420969,0.5840977485137822,490645100,496137265.4,93.7685055938574,92.80835239578242,NaN,NaN,32.88528883769951,41.07297029890836
2010-05-03T09:30:00-04:00,32.59,33.32001,32.59,33.22,16977680,15333151.85,62.521395634332464,68.98282427044174,NaN,NaN,96.22565194698781,90.06020133372651,-0.023447197775628426,0.5547887512942467,0.5782359490698751,507622780,495893074.8,93.48774952659389,92.76053191792032,NaN,NaN,31.235654723464336,39.66763950241636
2010-05-04T09:30:00-04:00,32.85001,33,31.91499,32.17,24814656,16118460.65,50.576555371596434,67.01099425292057,NaN,NaN,-4.501710206983164,73.17686594987389,-0.08554225979321228,0.47130812432835967,0.556850384121572,482808124,496991674.6,93.58086966366228,92.67044911693198,NaN,NaN,24.622949520970696,37.51839807649555
2010-05-05T09:30:00-04:00,31.59,32.13,31.53999,31.75999,28450688,17029239.6,46.81532801319155,64.58278013856028,NaN,NaN,-93.98598883228753,41.97992627303291,-0.151220554074869,0.3678246915279857,0.5190452456028547,454357436,488896063.2,84.04383831453515,91.85980235438262,NaN,NaN,18.194457080229544,34.75783507702898
2010-05-06T09:30:00-04:00,31.55,31.92999,28.44,30.71001,52085616,19178493.65,38.847884794640514,62.63326830343088,NaN,NaN,-273.5494104123639,-39.08635248344263,-0.256198512288308,0.19879710524246974,0.4549956175307777,402271820,467541052,65.17510634246081,89.69359826137047,NaN,NaN,9.47548334909228,31.146070544466593
2010-05-07T09:30:00-04:00,30.82001,30.85001,29.60001,30.03,48211392,21274834.15,34.72592555994915,60.49162202345478,NaN,NaN,-243.3410494787751,-103.83050139668437,-0.3561110711400181,0.009856778605755068,0.3659678497457732,354060428,440224117.6,49.779299404389455,86.69525066674028,NaN,NaN,1.0827912124824384,26.85131635418314
2010-05-10T09:30:00-04:00,31.75999,31.87,31.27,31.75,28537520,22363145.7,49.361636100141425,59.07849263006316,NaN,NaN,-70.77204972521442,-137.2300417311248,-0.29363647386818276,-0.001077742589455255,0.2925587312787275,382597948,415219151.2,40.37700565173993,83.20970017379318,NaN,NaN,0.44245176595827757,23.07862141300816
2010-05-11T09:30:00-04:00,31.60001,32.11501,31.35001,31.66,21222032,22989837.55,48.7457385314198,57.45716943364751,NaN,NaN,-60.37540922675317,-148.40478153507883,-0.24749648931295068,-0.01681188036246084,0.23068460895048984,361375916,390932709.6,33.71595422479295,79.31332973672112,NaN,NaN,-0.24460647550368597,19.746731714649325
2010-05-12T09:30:00-04:00,31.72,32.41,31.72,32.36,23705488,23523715.45,53.59548864087761,55.98110580845984,NaN,NaN,-9.580425002850449,-131.5236687691914,-0.1630334088090533,0.026892847939173237,0.18992625674822652,385081404,377077503.2,30.613175175491094,75.13291386620793,NaN,NaN,1.1214963280916,17.085983802283934
2010-05-13T09:30:00-04:00,32.22,32.395,31.845,31.86,15827883,23975671.7,49.959175374173434,54.12373865889013,NaN,NaN,-21.24689800019759,-81.06316628675815,-0.1351874589191713,0.0209419330992624,0.1561293920184337,369253521,370473843.4,29.23235970539062,70.71321564615575,NaN,NaN,0.8250980269779804,14.76300012009737
2010-05-14T09:30:00-04:00,31.66,31.75,30.94,31.19,24135280,23856742.1,45.50393171909378,51.90638877521036,NaN,NaN,-91.00840945169693,-50.59663828134252,-0.15482864363305143,-0.03740641252288057,0.11742223111017085,345118241,368685406,28.852792351141588,66.12676126934139,NaN,NaN,-1.0380649216115145,12.505705114138959
2010-05-17T09:30:00-04:00,31.28999,31.42999,30.4707,31.11,30409008,24576133.5,44.98804636230045,50.91162393611295,NaN,NaN,-106.54966389333659,-57.75216111496695,-0.165198913529797,-0.0890764108020754,0.07612250272772159,314709233,355107663,26.083727326018604,61.28703126817512,NaN,NaN,-2.618642792061082,10.34508398468181
2010-05-18T09:30:00-04:00,31.38,31.61,30.61,30.72,33895056,25615739.6,42.4607770780496,49.54097869178314,NaN,NaN,-95.12205406762638,-64.70149008314158,-0.18862168098582197,-0.15965459850455588,0.028967082481266088,280814177,338995315.2,23.2341057346634,56.197950588790754,NaN,NaN,-4.722254505319863,8.192607057538714
2010-05-19T09:30:00-04:00,30.39999,30.77,29.85001,30.33,42145152,26754350,40.03853656413456,47.48389840063799,NaN,NaN,-131.26092132485488,-89.03758934754246,-0.21856773390356074,-0.24424258489818484,-0.025674850994624104,238669025,309712839.4,19.14128844469799,50.791841247102525,NaN,NaN,-7.216304340360057,5.991334000696033
2010-05-20T09:30:00-04:00,29.8,29.86,28.89999,29.00999,44340560,27270677.2,33.14628023015676,45.80619285528983,NaN,NaN,-180.60309798759175,-120.90882934502129,-0.3098855396440019,-0.41303177554962645,-0.10314623590562458,194328465,274727828.2,15.604526036776093,45.20869985016815,NaN,NaN,-11.904635381382256,3.4347669461134203
2010-05-21T09:30:00-04:00,28.5,29.53999,28.39,29.42,39374672,28455350.65,36.78624139953954,43.967967552804616,NaN,NaN,-161.3712934625734,-134.9814061471966,-0.3237708142267607,-0.5078597536890754,-0.18408893946231475,233703137,252444807.4,13.849277688331227,39.52023757600653,NaN,NaN,-14.425278354430732,0.8833319031785418
2010-05-24T09:30:00-04:00,29.32001,29.46001,28.94,28.98,24343728,29006927.3,34.608544561601875,42.82739535209072,NaN,NaN,-138.9974806358352,-141.47096949569632,-0.34190270260327393,-0.6114673177164072,-0.26956461511313323,209359409,231374842.6,12.425987865905029,33.72346030473815,NaN,NaN,-17.184365843314726,-1.6977677748919247
2010-05-25T09:30:00-04:00,28.10001,28.97,27.91,28.96001,30034208,28932207.3,34.50859426817529,41.94834294173241,NaN,NaN,-146.48748326855502,-151.74405533588202,-0.3341624602858101,-0.6872676904703958,-0.3531052301845857,179325201,211077047.4,11.22878256195969,28.522384893839902,NaN,NaN,-19.374070766969318,-4.222953916617266
2010-05-26T09:30:00-04:00,29.37,29.67,28.92999,29.02,29128608,29512619.3,35.11421543989741,41.68165227353648,NaN,NaN,-100.49613603008484,-145.59109827692802,-0.30474606337500887,-0.7340378094033468,-0.429291746028338,208453809,205034004.2,10.892310329820617,24.645042321508463,NaN,NaN,-20.964006198614634,-6.614532814045461
2010-05-27T09:30:00-04:00,29.75,30.00999,29.42999,30,21078144,29855957.35,44.1931726132429,42.3578842059146,NaN,NaN,-59.08918001127185,-121.28831468166405,-0.20387806202524167,-0.68413932355989,-0.4802612615346484,229531953,212074701.8,14.12115697212191,22.09803214777507,NaN,NaN,-19.604864281548927,-8.47029445226024
2010-05-28T09:30:00-04:00,30,30.02,29.31,29.60001,25026032,30187170.15,41.63265228521174,41.80581393341962,NaN,NaN,-61.78846965034644,-101.37174991921864,-0.15111630511605822,-0.6691566429297211,-0.5180403378136629,204505921,206235258.6,13.678456723978456,20.190992938649252,NaN,NaN,-19.24514254212602,-10.009558465098209
2010-06-01T09:30:00-04:00,29.31,29.765,28.89999,28.94,27979600,30737266.15,37.74637030446065,41.02014477435112,NaN,NaN,-81.22053946443961,-89.81636168493954,-0.14752191305007578,-0.7024427291262576,-0.5549208160761818,176526321,199668641,13.178136056763648,18.724005926647155,NaN,NaN,-20.137103691650537,-11.45635064031997
2010-06-02T09:30:00-04:00,29.00999,29.69,28.91319,29.69,20844000,30538733.35,44.12876861320051,40.343950486659885,NaN,NaN,-61.49060344968943,-72.8169857211664,-0.0846133202692172,-0.6606874664127034,-0.5760741461434862,197370321,203277665,15.017939081492855,17.610060491361565,NaN,NaN,-18.86407840624392,-12.51459746402339
2010-06-03T09:30:00-04:00,29.98,29.9899,29.55,29.8275,21686640,30200530.95,45.23725547331993,40.00667049374179,NaN,NaN,-32.463235849101125,-59.21040568496967,-0.026720976188301493,-0.609475366378863,-0.5827543901905615,219056961,205398295.4,16.14240046581159,16.675063402820204,NaN,NaN,-17.506460532117355,-13.227720759465386
2010-06-04T09:30:00-04:00,29.03999,29.25999,28.30099,28.42999,26173872,28904943.75,37.166245149964,39.411121453089656,NaN,NaN,-100.89624139329254,-67.57181796137382,-0.07290738157782972,-0.6738886171628486,-0.6009812355850189,192883089,198068522.6,15.384668443258562,15.713054552257132,NaN,NaN,-18.928173343259918,-14.042071128578892
2010-06-07T09:30:00-04:00,28.39999,28.53999,27.67999,27.7,30321200,28010434.15,33.77631612869894,38.61028357926098,NaN,NaN,-128.75905648706137,-80.96593532871681,-0.13914142548321862,-0.7749080174390421,-0.6357665919558235,162561889,189679716.2,14.543265917743966,14.888735880237514,NaN,NaN,-21.259585741945727,-15.073144644774153
2010-06-08T09:30:00-04:00,27.82001,28.07001,27.39999,27.99001,34376880,28302402.15,36.263516436429974,38.167622104859575,NaN,NaN,-129.4438073735978,-90.61058891054844,-0.14905769424685622,-0.8220887097643939,-0.6730310155175376,196938769,193762205.8,16.92447943991766,14.438048287755676,NaN,NaN,-22.317408636262982,-16.10803950070113
2010-06-09T09:30:00-04:00,28.17999,28.67,27.87,27.99001,30023520,28742476.55,36.26351643642997,37.89797781002353,NaN,NaN,-100.86424527275602,-98.48531727516176,-0.14132327346110551,-0.8496851073439196,-0.708361833882814,196938769,193675895.4,16.913749070898916,14.278938332484316,NaN,NaN,-23.14868664168607,-17.11384623512755
2010-06-10T09:30:00-04:00,28.39999,29.07001,28.38409,29.07001,23499728,28732188.55,45.159235803316605,38.75604606524923,NaN,NaN,-51.311105676062716,-102.25489124055409,-0.053686012284539286,-0.7754693492384881,-0.7217833369539488,220438497,193952202.6,17.09496401363255,14.385398187974065,NaN,NaN,-21.042312629272413,-17.67505572000539
2010-06-11T09:30:00-04:00,28.77,29.2,28.62,29.17,14729691,28677278.95,45.911918698316995,39.40788015801905,NaN,NaN,-33.17731133812155,-88.71110522951989,0.017019123792761937,-0.7005094322129963,-0.7175285560057583,235168188,202409222.4,22.655350125499496,15.014403362057513,NaN,NaN,-19.13629227062243,-17.883803798664967
2010-06-14T09:30:00-04:00,29.5,29.67999,29.09,29.14,18225056,28381767.75,45.70921499590749,40.20078518904088,NaN,NaN,4.282599879944842,-62.10277395611864,0.0650706036743498,-0.636190301412821,-0.7012609050871708,216943132,213285471,29.229266793328264,16.214637571159177,NaN,NaN,-17.658645876079465,-17.851638381152753
2010-06-15T09:30:00-04:00,29.38,30.07001,29.31,30.02,17459664,27734300.55,52.35437399440604,41.475483740914505,NaN,NaN,72.23542215149922,-21.766928051099246,0.15433003775588916,-0.5083483578923094,-0.6626783956481985,234402796,220778276.4,33.4272475278005,17.800242211576375,NaN,NaN,-14.291089335323509,-17.34298851746286
2010-06-16T09:30:00-04:00,29.91,30.16499,29.8,29.94,15417047,26810400.1,51.734432165280445,42.66264207844186,NaN,NaN,107.68698831098096,19.943318665648157,0.20312198553168503,-0.40877591373359223,-0.6118978992652773,218985749,225187672.4,35.839238027242786,19.582165618535104,NaN,NaN,-11.738559826349753,-16.542355847303845
2010-06-17T09:30:00-04:00,30.13,30.13,29.60001,30.03,22397488,25823016.9,52.41706380313368,43.25006287771978,NaN,NaN,107.73351726349101,51.7522432535589,0.23437798910587804,-0.31892541288292975,-0.5533034019888078,241383237,229376620.4,38.1324924933285,21.297261012907004,NaN,NaN,-9.441983734291345,-15.528016974016346
2010-06-18T09:30:00-04:00,29.96001,30.05,29.8,30,16529242,24432451,52.15228345441555,44.00146510409149,NaN,NaN,100.6454446261989,78.516794446423,0.24481199672165815,-0.24728840608673508,-0.49210040280839323,224853995,227313781.8,37.42313066558346,22.993309151593078,NaN,NaN,-7.60590955419562,-14.396287342613386
2010-06-21T09:30:00-04:00,30.42999,30.60001,29.895,30.05,17337088,23330571.8,52.58220366315872,45.06116748685563,NaN,NaN,114.56699177601423,100.57367282563686,0.24619564978370623,-0.18435584057876042,-0.43055149036246665,242191083,232363372,40.34842843073217,24.934044321162258,NaN,NaN,-5.9474218656036815,-13.189306560183429
2010-06-22T09:30:00-04:00,30.02,30.2,29.27,29.32249,17664304,22996600.6,46.09268747044123,45.20144740522996,NaN,NaN,41.224938394932344,94.3715760743235,0.1916541810851059,-0.1909837640060843,-0.3826379450911902,224526779,230388168.6,39.569219177358285,26.687707185152647,NaN,NaN,-6.167381595537813,-12.186174422376912
2010-06-23T09:30:00-04:00,29.28,29.5,28.94,29.21001,19311136,22460447,45.164592001182946,45.19625715722019,NaN,NaN,-7.1988486224013055,71.39440868764704,0.14373204256269229,-0.20297289188782486,-0.34670493445051714,205215643,227634147.4,38.45412749221935,28.2814019727532,NaN,NaN,-6.601396873606416,-11.38834905826684
2010-06-24T09:30:00-04:00,29.14,29.23,28.63,28.7,17170736,21862553.4,41.121465981852765,45.47877293092653,NaN,NaN,-48.319697266918794,40.18376578156508,0.07677389934946699,-0.25073756026368343,-0.3275114596131504,188044907,216966481.4,34.409168783995554,29.640294854234412,NaN,NaN,-8.11921780647811,-10.921330308011306
2010-06-25T09:30:00-04:00,28.75999,28.98,28.49001,28.92,18163488,21716820.6,43.472233521747825,46.17133845900145,NaN,NaN,-49.349728744576844,10.184731107409934,0.04780696321220851,-0.2677527555978898,-0.3155597188100983,206208395,213237361.4,33.09847642888866,30.965667033601893,NaN,NaN,-8.775733382576167,-10.614816461520572
2010-06-28T09:30:00-04:00,28.89999,29.10001,28.64,28.72,11263055,21028671.75,41.836907780250414,46.56943784070291,NaN,NaN,-41.49394176232522,-21.02745560025796,0.017258293773152134,-0.2939868515936581,-0.31124514536681025,194945340,203788212.8,29.982036781659986,31.8983497008692,NaN,NaN,-9.781236805950812,-10.495733653582034
2010-06-29T09:30:00-04:00,28.32001,28.33,27.37,27.61,31117792,21185581.35,34.15709095406733,46.41897887767701,NaN,NaN,-141.7826343135689,-57.62897014195822,-0.07079377294150602,-0.39973736154369277,-0.32894358860218675,163827548,191648366.6,26.52635682339988,32.58496454033356,NaN,NaN,-13.141239188283771,-10.873663015682283
2010-06-30T09:30:00-04:00,27.56,27.94,27.37,27.42999,25416112,21414186.95,33.09606506211159,45.55732382473379,NaN,NaN,-140.99813645736432,-84.38882770895081,-0.1307608777038265,-0.49239468573196987,-0.3616338080281434,138411436,178287525.2,23.338165314048055,33.03090749036324,NaN,NaN,-16.220379845152184,-11.637479705606554
2010-07-01T09:30:00-04:00,27.39999,27.53999,26.85001,27.35001,26090688,21634389.35,32.61135349792089,44.60728345327693,NaN,NaN,-153.42922592179198,-105.41073343992545,-0.1632995862857925,-0.565758290885384,-0.4024587045995915,112320748,163142693.4,20.352147681503894,32.86639303007784,NaN,NaN,-18.88376032439355,-12.672662651147553
2010-07-02T09:30:00-04:00,27.17,27.48,26.88,27.00999,15578883,21104639.9,30.562089946450598,43.5253459497443,NaN,NaN,-141.4420637776933,-123.82920044654875,-0.1931639271566047,-0.6439136135453474,-0.4507496863887427,96741865,141249387.4,16.971645736906538,31.990848668904857,NaN,NaN,-21.77834992223766,-13.973475118446139
2010-07-06T09:30:00-04:00,27.5,27.61,26.78999,27.06,16259238,20401541.8,31.246413400534735,42.01763447875349,NaN,NaN,-126.86962356631442,-140.9043368073466,-0.1944554249784095,-0.6938189676117545,-0.49936354263334504,113001103,124860540,14.967448476319063,30.672291593799038,NaN,NaN,-23.98591167321152,-15.403823197698335
2010-07-07T09:30:00-04:00,27.08,28.03999,27.065,28,17141600,19539777.8,42.68096934685663,41.370958563151795,NaN,NaN,-82.23704869672045,-128.9952196839769,-0.12053003000623774,-0.6500260801411422,-0.5294960501349044,130142703,118123571,14.223856508854425,29.128335771057014,NaN,NaN,-22.631444527970924,-16.436340530594418
2010-07-08T09:30:00-04:00,28.22,28.48,28,28.36,17010384,18889121,46.36030632147545,40.938333028747635,NaN,NaN,-37.565495118439785,-108.30869141619198,-0.04007496787967124,-0.5795897599844935,-0.5395147921048222,147153087,119871901.2,15.398506665154898,27.504479640473185,NaN,NaN,-20.359467858046116,-16.996787291658947
2010-07-09T09:30:00-04:00,28.41,28.64,28.34,28.64,12659344,18347101.8,49.09716822742968,40.720110512534355,NaN,NaN,-15.637608412388856,-80.75036791431137,0.03524110166895089,-0.49546341501863367,-0.5307045166875846,159812431,129370237.8,21.67411879652731,26.379550221254885,NaN,NaN,-17.628105142478095,-17.08697555606168
2010-07-12T09:30:00-04:00,28.47,28.64999,28.25,28.49001,14684574,18344845.95,47.693342136538966,40.3709061177758,NaN,NaN,-19.464200115468948,-56.35479518186651,0.07586667854470142,-0.4358711685067078,-0.5117378470514092,145127857,139047436.2,27.569179005931076,25.46674669091195,NaN,NaN,-15.768560387374134,-16.89863053196346
2010-07-13T09:30:00-04:00,28.81,29.14999,28.81,28.99001,15580008,18212593.55,52.56267475379653,40.8330480665869,NaN,NaN,22.655039215944132,-26.449862625414795,0.1339271946073997,-0.3443288537921596,-0.4782560483995593,160707865,148588788.6,32.92914201255016,24.992455464854228,NaN,NaN,-12.665763457821097,-16.293935235657408
2010-07-14T09:30:00-04:00,28.95,29.23,28.81,29.05,15997563,18139488.5,53.1264857297764,41.40175476148642,NaN,NaN,30.662656876367176,-3.86992151079727,0.17148630716550695,-0.26389816444267566,-0.4353844716081826,176705428,157901333.6,37.769575731716564,24.9435589105326,NaN,NaN,-9.968013135418282,-15.39023207848039
2010-07-15T09:30:00-04:00,29.09,29.12,28.60001,29.03999,23101600,18523716.15,53.01326192127855,42.2511687571597,NaN,NaN,27.514378125338112,9.14605313795831,0.18936853799195735,-0.1986737991182359,-0.38804233711019326,153603828,159191481.8,38.43249081303943,25.2309390554643,NaN,NaN,-7.778333051334971,-14.302817931745329
2010-07-16T09:30:00-04:00,28.89,28.89,27.9901,28.07001,21563472,18482015.35,43.36808312575979,42.24372944316055,NaN,NaN,-19.669607223979607,8.33965337564016,0.13228561252620402,-0.22268532145243825,-0.35497093397864227,132040356,153637066.8,36.62365070816142,25.482737218269502,NaN,NaN,-8.580631091775759,-13.485362668892533
2010-07-19T09:30:00-04:00,28.14,28.33,27.89999,28.23,17956992,18553402.85,45.1410000424606,42.47973603331842,NaN,NaN,-28.58032389059297,6.51642862061536,0.10301890060536079,-0.22619730822194128,-0.32921620882730207,149997348,154610965,37.18192316807393,25.997014817299068,NaN,NaN,-8.716802986826414,-12.804139857168801
2010-07-20T09:30:00-04:00,27.87,28.74001,27.74001,28.67,17312512,18552174.05,49.79590468765827,43.59679415714635,NaN,NaN,4.244097021361713,2.8342401816988767,0.11035584497722173,-0.1912714026057749,-0.30162724758299664,167309860,155931364,37.979605217269,26.815103988289714,NaN,NaN,-7.43208306059034,-12.036703171943307
2010-07-21T09:30:00-04:00,28.89999,29.0201,28.37,28.60001,31327168,19235317.25,49.0824649941405,44.73867986657699,NaN,NaN,44.976584601653435,5.697025726756136,0.10745274357122198,-0.16731131811896915,-0.27476406169019113,135982692,147786816.8,35.02518628622802,27.649891200588286,NaN,NaN,-6.589954218015164,-11.258596178525
2010-07-22T09:30:00-04:00,28.92999,29.64,28.92999,29.48,24159184,19477719.65,57.35531226852076,46.5061054930484,NaN,NaN,127.81781802869385,25.757713707427285,0.15866416296261376,-0.07643385798692393,-0.2350980209495377,160141876,149094426.4,35.887489988013115,28.759558508196086,NaN,NaN,-3.166731703060784,-10.10261553917297
2010-07-23T09:30:00-04:00,29.50999,30.16,29.42751,30.07001,25468416,19892603.65,61.832890901468296,48.739734132692526,NaN,NaN,172.7086607323786,64.23336729869894,0.22224145451427102,0.042703797193301085,-0.17953765732096993,185610292,159808413.6,42.60830532190433,30.59074847855307,NaN,NaN,1.2675138329633664,-8.478311343153493
2010-07-26T09:30:00-04:00,30.23,30.60001,30.12,30.56,17556336,19862246.05,65.10931634381576,51.158512914355455,NaN,NaN,198.1055042613175,109.57053292908101,0.28334703252489746,0.1746461333351519,-0.10870089918974557,203166628,170442269.6,48.390984427021195,32.978143903603225,NaN,NaN,6.089608295831369,-6.397179966155656
2010-07-27T09:30:00-04:00,30.8,30.81,30.28,30.35001,14145125,20006349.55,62.628035665359626,52.583303365677104,NaN,NaN,172.2438695168759,143.17048742818386,0.29438323948012907,0.2592781501604158,-0.035105089319713303,189021503,174784598.2,50.580726651014615,35.575063199471806,NaN,NaN,9.209894190577247,-4.167597943765242
2010-07-28T09:30:00-04:00,30.25,30.39,30.14999,30.27,15190441,19209982,61.66377771970195,53.676408465550416,NaN,NaN,132.20807913241788,160.61678633433675,0.28108245945032817,0.31624798499319695,0.03516552554286875,173831062,182354272.2,54.226741416921264,38.348508538883685,NaN,NaN,11.431462089289845,-1.939160796185944
2010-07-29T09:30:00-04:00,30.42999,30.58,29.92,30.17,17623248,18820338.8,60.41182817249389,54.48459846162643,NaN,NaN,112.53983737948529,157.56119020449503,0.25130861744981714,0.34930129735514015,0.09799267990532302,156207814,181567459.8,53.78257840486706,40.64196993947939,NaN,NaN,12.896981357985347,0.1802880829813831
2010-07-30T09:30:00-04:00,29.89999,30.39999,29.77,30.28999,17135616,18372585.2,61.42388505753216,55.46535152741166,NaN,NaN,96.59611511307016,142.33868108063334,0.22623703802849043,0.3807889774409361,0.15455193941244566,173343430,179114087.4,52.34290601665273,42.41152186881664,NaN,NaN,14.402067730406143,2.2119708897563486
2010-08-02T09:30:00-04:00,30.71001,30.92999,30.57001,30.89,15965766,18391929.35,66.09198326884987,56.43173070705832,NaN,NaN,129.10570440162135,128.53872110869412,0.23554515432895795,0.4489833823236431,0.21343822799468515,189309196,176342601,50.69209905726675,43.68030451486783,NaN,NaN,17.156948622942146,4.346967708782891
2010-08-03T09:30:00-04:00,30.8,30.89999,30.58,30.73,11147039,18136319.4,63.87235323821636,57.1992926719469,NaN,NaN,110.61634102374154,116.21321541006725,0.21687493329438984,0.48453189461267243,0.2676569613182826,178162157,174170731.8,49.37785424313523,44.50946726568345,NaN,NaN,18.81291143746708,6.413531098594918
2010-08-04T09:30:00-04:00,30.8,31.03,30.74001,31,9579211,17758199.95,65.95047653398488,58.12337942999734,NaN,NaN,110.9990590626796,111.97141139611958,0.20859444988572717,0.5284000236754416,0.3198055737897144,187741368,176952793,51.125820998642574,45.416133707512245,NaN,NaN,20.826888795623447,8.472582198170421
2010-08-05T09:30:00-04:00,30.73,31.05499,30.7,31.02,20032416,17909301.55,66.10600336883886,59.74751659021727,NaN,NaN,99.44332906339226,109.35210973290097,0.19083028446142453,0.5583434293664951,0.36751314490507053,207773784,187265987,57.04686965277762,46.87493506069911,NaN,NaN,22.52356135401407,10.479864934719513
2010-08-06T09:30:00-04:00,30.64,30.955,30.38,30.85001,13396293,17946149,63.453077893323446,61.05552215099319,NaN,NaN,77.27722117569175,105.4883309454253,0.1554934990166013,0.5618800186758222,0.40638651965922085,194377491,191472799.2,59.21727104097862,48.4488884801923,NaN,NaN,23.259382126231788,12.305510247792695
2010-08-09T09:30:00-04:00,31.14999,31.14999,30.84,31.00999,8554754,17639658,64.88147011983378,62.13306253900572,NaN,NaN,90.20463281704268,97.70811662850957,0.1316984618579803,0.5710095969816962,0.4393111351237159,202932245,194197409,60.605671701072566,50.065036086178274,NaN,NaN,24.2711291852371,14.014884381713324
2010-08-10T09:30:00-04:00,30.7,30.94501,30.465,30.8,15324949,17626905.05,61.48458751008004,63.018928433001406,NaN,NaN,64.92524195520011,88.56989681480128,0.09247415557456468,0.5549038295919217,0.4624296740173571,187607296,196086436.8,61.5822107552068,51.961966405391045,NaN,NaN,24.236110617536916,15.475059558259552
2010-08-11T09:30:00-04:00,30.24001,30.28999,29.47,29.64999,33036480,18478850.9,46.978591970214,62.2777341259795,NaN,NaN,-11.597757976874032,64.05053340689054,-0.014565362379223734,0.4442229710433274,0.45878833342255115,154570816,189452326.4,56.30358365386181,53.42025881009452,NaN,NaN,19.460028272389295,16.04434080313523
2010-08-12T09:30:00-04:00,29.16,29.53999,29.14999,29.44,16303719,18138956.85,44.895695611191485,61.06793446238829,NaN,NaN,-50.421659037770574,34.07753578665798,-0.09847587505445932,0.335693489604477,0.4341693646589363,138267097,175550989,47.177944431506134,53.74666160363751,NaN,NaN,14.892245944195976,15.879755823286766
2010-08-13T09:30:00-04:00,29.28,29.55,29.25,29.39999,8189090,17470237.75,44.490939086255175,59.59519322970539,NaN,NaN,-57.879180534421,7.0462554446354275,-0.15241867463981124,0.24364602135917224,0.3960646959989835,130078007,162691092.2,40.619154531981984,53.19153089684899,NaN,NaN,11.10730027110863,15.19797645868989
2010-08-16T09:30:00-04:00,29.17,29.46001,28.94,29.34,10912965,17118036.4,43.852559350497955,58.254087778643836,NaN,NaN,-85.07635273566615,-28.009941665906336,-0.18567820547343367,0.1639669391571914,0.34964514463062507,119165042,145937651.6,33.98963038550373,52.006452592169644,NaN,NaN,7.818183448271047,14.14372031434434
2010-08-17T09:30:00-04:00,29.63,30.17999,29.57001,29.85001,17148832,17109852.4,50.372112392513955,57.44754025527327,NaN,NaN,-33.658335275234045,-47.72665711199317,-0.1674310780247258,0.14035629709971786,0.30778737512444365,136313874,135678967.2,30.686874487803507,50.32503352580409,NaN,NaN,6.763957020607737,13.089468415239113
2010-08-18T09:30:00-04:00,29.88,30.105,29.64,29.96001,9109727,15998980.35,51.67544248074569,56.82351270586268,NaN,NaN,-41.990405291077224,-53.805186574833805,-0.1430032139963166,0.12903335762904788,0.2720365716253645,145423601,133849524.2,30.12470822248096,48.635185655633656,NaN,NaN,6.26887546040061,12.115097993119326
2010-08-19T09:30:00-04:00,29.75999,29.89,29.14,29.32001,19386576,15760349.95,44.37370383571819,55.60564261859025,NaN,NaN,-105.04745954775099,-64.7303466768299,-0.16351924762998685,0.06763751208788094,0.23115675971786778,126037025,131403509.8,29.350509277458926,46.9928716028341,NaN,NaN,3.530513158475035,10.888728731027285
2010-08-20T09:30:00-04:00,29.21001,29.23,28.84,29.17,13059422,15139900.25,42.84553081522882,53.94518172904589,NaN,NaN,-137.68721112558427,-80.69195279506255,-0.17948705069013765,0.006797946355195705,0.18628499704533336,112977603,127983429,28.25701128164154,45.390365333146576,NaN,NaN,0.82027996792331,9.450378907726718
2010-08-23T09:30:00-04:00,29.35001,29.48,28.81,28.85001,15057125,15014939.7,39.70439771794499,52.21889919188366,NaN,NaN,-122.0408007451242,-88.08484239695414,-0.2022056915194265,-0.06647211735394976,0.13573357416547674,97920478,123734516.2,26.915392284817017,43.78590376469527,NaN,NaN,-2.461594961658414,7.748668354957413
2010-08-24T09:30:00-04:00,28.44,28.49001,27.99001,28.25999,26302160,15622791.45,34.65883324599163,49.983781814169845,NaN,NaN,-178.3469789848898,-117.0225711388853,-0.24473649407160752,-0.17018704342403268,0.07454945064757486,71618318,110795405,23.289069769535914,41.79756439118766,NaN,NaN,-7.034950986169888,5.63672273479637
2010-08-25T09:30:00-04:00,28.00999,28.35001,27.67,28.21001,31737024,16450120.6,34.26164755648446,47.70918497043025,NaN,NaN,-166.0048164589057,-141.825453372451,-0.2624337456745517,-0.2534927314456148,0.008941014228936922,39881294,89686943.6,18.831588849064275,39.0679014766367,NaN,NaN,-10.804602252359912,3.287962022345473
2010-08-26T09:30:00-04:00,28.41,28.62,28.06,28.17,19830576,16560487,33.926469709019955,45.60014152869428,NaN,NaN,-127.15688824776795,-146.2473391124544,-0.2624036877764572,-0.31906359549163454,-0.05665990771517737,20050718,68489682.2,15.602134014418326,35.95253454616811,NaN,NaN,-13.963054298122845,0.8235311194214279
2010-08-27T09:30:00-04:00,28.31,28.81,27.98,28.74001,19744192,16690915.8,42.549492614105795,44.00500027828514,NaN,NaN,-95.53923647597095,-137.81774418253173,-0.2117359490375507,-0.32132984401211573,-0.10959389497456504,39794910,53853143.6,13.837541263577933,32.61195380063278,NaN,NaN,-14.216079747821944,-1.3249847187561965
2010-08-30T09:30:00-04:00,28.60001,28.77,28.28,28.3,15607285,16672991.75,38.385032594664956,42.355032070041204,NaN,NaN,-91.3333859570521,-131.6762612249173,-0.19596010730316557,-0.354544029103522,-0.15858392180035644,24187625,39106573,12.325069737265991,29.093586585065584,NaN,NaN,-15.736863125695654,-3.383824491176119
2010-08-31T09:30:00-04:00,28.14,28.4315,27.9872,28.19,20418192,17136549.4,37.399557624017184,41.67081533102714,NaN,NaN,-102.63580070701265,-116.53402556934186,-0.18137372637523635,-0.38530107976940187,-0.2039273533941655,3769433,25536796,11.120532521440467,25.86622578989263,NaN,NaN,-17.267049240409644,-5.367142312495194
2010-09-01T09:30:00-04:00,28.61,29.39999,28.59,29.31,31329232,18224050.45,51.15102791753422,42.11762478148019,NaN,NaN,-24.227317408411192,-88.17852575924297,-0.08938840472192894,-0.31566285929657667,-0.22627445457464773,35098665,24580270.2,11.038637973682086,23.284846757190913,NaN,NaN,-13.948785150620195,-6.593091289370194
2010-09-02T09:30:00-04:00,29.42999,29.73,29.34,29.67999,13831594,17914009.35,54.69185456922956,42.84626160169265,NaN,NaN,27.330850029313364,-57.280978103826726,-0.0013731008323294436,-0.22799083061505954,-0.2266177297827301,48930259,30356178.4,15.10422943839842,21.462352107649227,NaN,NaN,-10.023207069854125,-7.083107829439327
2010-09-03T09:30:00-04:00,30.11,30.345,29.92,30.13,15635141,18025951.75,58.62057024190073,43.90111952250714,NaN,NaN,87.85186312777024,-20.60275818307847,0.08464978419995556,-0.12080549953278563,-0.2054552837327412,64565400,35310276.4,18.542821605467935,20.35900862336096,NaN,NaN,-5.411328273247533,-6.844282178554785
2010-09-07T09:30:00-04:00,29.94,30.00999,29.77,29.85001,15112699,18353849,55.40170718582361,44.26037629345783,NaN,NaN,73.49870531327238,12.363660070986436,0.11813456934459493,-0.05778707205199751,-0.17592164139659244,49452701,40363291.6,22.01250831024491,19.739411039249635,NaN,NaN,-2.7444736975314967,-6.258595252694315
2010-09-08T09:30:00-04:00,29.89999,30.33,29.85001,30.16,12996059,18237404.5,58.142141009384574,44.722283331217746,NaN,NaN,108.50564177792545,54.59194856797406,0.15431605626296582,0.016973428932114842,-0.13734262733085098,62448760,52099157,29.521267605129026,19.696308138010213,NaN,NaN,0.3397766241432909,-5.315970698860371
2010-09-09T09:30:00-04:00,30.45,30.58,29.9516,30.13,10075695,17089365.25,57.77216126045642,45.67931600441334,NaN,NaN,114.83275523871218,82.40396309739873,0.1682420052494666,0.07295987923098224,-0.09528212601848433,52373065,55554037,31.608859524311242,19.857618869928235,NaN,NaN,2.664201007317578,-4.175946169406378
2010-09-10T09:30:00-04:00,30.21001,30.46001,30.14999,30.39999,10923633,16820360.95,60.22520871729964,46.920721568846965,NaN,NaN,113.99727339659067,99.7372477708542,0.18624979637111966,0.13753011944541527,-0.048719676925704405,63296698,58427324.8,33.376309193536486,20.223283006492164,NaN,NaN,5.364947108700236,-2.8129614153911477
2010-09-13T09:30:00-04:00,30.73,30.83,30.53999,30.7,12911785,17056495.7,62.810448175569846,48.571153744391594,NaN,NaN,131.08954245831862,108.38478363696386,0.20736331420501508,0.21048446583056446,0.003121151625549365,76208483,60755941.4,34.84588701711823,20.78974691594225,NaN,NaN,8.442704208735572,-1.205009183373045
2010-09-14T09:30:00-04:00,30.60001,30.78999,30.5,30.61,14376734,17229684.15,61.51866031880556,50.489712821021165,NaN,NaN,110.31467577771883,115.74797772985316,0.20395448587704568,0.2580642589718565,0.054109773094810784,61831749,63231751,36.450895289385286,21.729877310217205,NaN,NaN,10.596698044455477,0.4809489920310297
2010-09-15T09:30:00-04:00,30.49001,30.67999,30.34,30.61,14647035,17104594.3,61.51866031880555,52.4366423040441,NaN,NaN,95.4590420266332,113.1386577795947,0.19063295867991104,0.29240097144469956,0.10176801276478854,61831749,63108348.8,36.40276038664494,22.984960991472967,NaN,NaN,12.356723494554986,2.1774882066773094
2010-09-16T09:30:00-04:00,30.53999,30.62,30.39999,30.57001,17618816,17530048.75,60.87350265792975,54.361430371823374,NaN,NaN,88.38760078493092,107.84962688883846,0.16881012089094272,0.3127806638784669,0.1439705429875242,44212933,61476322.4,35.730739358675166,24.42271851606274,NaN,NaN,13.66129967371153,3.8180327019679123
2010-09-17T09:30:00-04:00,30.58,30.75,30.32001,30.69749,16835184,17402479.15,62.233206839265115,55.76740995933476,NaN,NaN,83.35223093618846,101.72061839675801,0.15310560728545433,0.3353525520943421,0.18224694480888778,61048117,61026606.2,35.53606269759365,25.972612904206724,NaN,NaN,15.141401396990117,5.4356568012567985
2010-09-20T09:30:00-04:00,30.87,31.21001,30.66499,31.16,16995904,17599303.25,66.74815680276517,57.79334740277049,NaN,NaN,104.15245233822742,96.33320037273977,0.16309107055996067,0.3861107830088386,0.22301971244887794,78044021,61393713.8,35.84335596907627,27.652490492193174,NaN,NaN,17.782206716121113,7.199449646237415
2010-09-21T09:30:00-04:00,31.14999,31.46001,31.08,31.22,23612736,18027083.8,67.29439222851752,59.92869273166337,NaN,NaN,109.97739578405083,96.26574437400616,0.16259609375725825,0.42626482964545076,0.2636687358881925,101656757,69358715.4,42.27307270031931,29.877671933541667,NaN,NaN,20.13944431661963,9.048020313434874
2010-09-22T09:30:00-04:00,31.14,31.37,30.92751,31.06,20258000,17724875.8,64.26275724638779,60.86524482658148,NaN,NaN,94.82683309216192,96.13930258711191,0.1411476522285679,0.4401033011739024,0.2989556489453345,81398757,73272117,45.18005273664756,32.316344416610626,NaN,NaN,21.36729507732914,10.807916708276911
2010-09-23T09:30:00-04:00,30.77,31.00999,30.50999,30.60001,17938672,17034958.2,56.3965773610233,60.98701074028103,NaN,NaN,59.71410661290385,90.40460375270649,0.088223982673176,0.4092356272868045,0.3210116446136285,63460085,77121547.4,47.95630222142385,34.66292104396958,NaN,NaN,20.238683350740224,12.15516908577167
2010-09-24T09:30:00-04:00,31.19,31.48,30.98,31.44,17402960,16913577.4,64.85639868545823,61.432427057678,NaN,NaN,107.04331539812026,95.14282064509285,0.10110720248475369,0.44739564771957063,0.34628844523481694,80863045,81084533,50.72307915180059,36.961510868707634,NaN,NaN,21.879687691352757,13.54438602942611
2010-09-27T09:30:00-04:00,31.46001,31.48,31.19,31.24001,10058309,16429283.25,61.78293562259236,61.888229088875754,NaN,NaN,102.89322995611754,94.89097616867089,0.08796200820576877,0.4562409554920279,0.36827894728625915,70804736,79636676,49.68385520336699,38.93803564678778,NaN,NaN,22.239550810390295,14.786552426706708
2010-09-28T09:30:00-04:00,31.28,31.48,30.84,31.41,19118016,16604819.8,63.37181295247924,62.261777084811094,NaN,NaN,93.63903946304477,91.62330490446966,0.08260257708417751,0.47153216864148106,0.38892959155730356,89922752,77289875,47.96834407024141,40.25568396572438,NaN,NaN,23.020788416260498,15.96287185378582
2010-09-29T09:30:00-04:00,31.31,31.50999,31.21001,31.39999,12394629,16203641.65,63.20517226411537,62.64984929935816,NaN,NaN,109.52591912458294,94.56312211095387,0.07072861424063898,0.47734035935810226,0.4066117451174633,77528123,76515748.2,47.38709950918613,41.382701107501155,NaN,NaN,23.59917131941378,17.053771777446958
2010-09-30T09:30:00-04:00,31.60001,31.91,31.14999,31.28,23180384,15796199.25,61.13008863579462,62.71448357925066,NaN,NaN,111.69242838983023,104.95878646633915,0.04821405038883547,0.46687930810350764,0.41866525771467217,54347739,74693279,45.97470536481959,42.2825865483071,NaN,NaN,23.49551392648463,17.97402065588091
2010-10-01T09:30:00-04:00,31.53999,31.61,31.2,31.31,13619586,15785598.85,61.47068122947003,62.61878594024353,NaN,NaN,90.13472688924836,101.57706876456476,0.02967253643089085,0.4557559282532857,0.42608339182239485,67967325,72114135,43.97704390504482,42.93481204030185,NaN,NaN,23.50110966488949,18.763604800024993
2010-10-04T09:30:00-04:00,31.16,31.45,30.78999,30.98,14881496,15747916.6,55.69003358746842,62.20245545943373,NaN,NaN,38.181321070736224,88.6346869874885,-0.008448758711295745,0.41552244343327516,0.4239712021445709,53085829,68570353.6,41.320341806072946,43.28262964863669,NaN,NaN,21.86833223482751,19.207137290711067
2010-10-05T09:30:00-04:00,31.35001,31.94,31.27991,31.81,15091504,15746856.85,64.68528016693749,62.428642591443165,NaN,NaN,125.63211419295169,95.0333019334699,0.017203846366038777,0.44547601010211935,0.42827216373608057,68177333,64221269.8,38.26516758850652,43.41565873448394,NaN,NaN,23.148738016210633,19.770223108639577
2010-10-06T09:30:00-04:00,31.8,32.07899,31.66,32,13307313,15762419.55,66.36841600144587,62.82113640169432,NaN,NaN,153.57424674127338,103.842967456808,0.04060142875898254,0.47902394968480877,0.43842252092582623,81484646,65012574.4,39.14679709014142,43.659662858160104,NaN,NaN,24.72656154280754,20.478271456377858
2010-10-07T09:30:00-04:00,32.16,32.16,31.735,31.92999,9573742,15737321.9,65.13650589161281,63.02851490543343,NaN,NaN,146.6914217017659,110.84276611919513,0.044673297050491,0.49426414223894,0.449590845188449,71910904,68525207.4,43.0357442182434,44.195354395349376,NaN,NaN,25.62822300194559,21.21397882003039
2010-10-08T09:30:00-04:00,31.99001,32.32001,31.86,32.19501,12642449,15823262.7,67.58902772038168,63.08857711383462,NaN,NaN,162.1716344209383,125.2501476255331,0.05769774050861021,0.5217130208242118,0.4640152803156016,84553353,71842413,46.51213174449634,44.95740980787938,NaN,NaN,27.136666851432594,22.060077110230704
2010-10-11T09:30:00-04:00,32.23,32.28999,32.03,32.11,7427328,15549039.85,65.98553582914863,62.99508737102256,NaN,NaN,148.37656519380647,147.28919645014716,0.053181120105240676,0.5304916804471524,0.47731056034191177,77126025,76650452.2,51.164183146774924,45.59248912548335,NaN,NaN,27.91167327848306,22.89601941998104
2010-10-12T09:30:00-04:00,32.00999,32.2,31.64,32.09,12817715,15471088.9,65.59127709899735,63.089981646208955,NaN,NaN,107.95158326077986,143.75309026371278,0.04193444519990869,0.5297286168417976,0.48779417164188893,64308310,75876647.6,50.4043724249148,45.96565481750243,NaN,NaN,28.438273679204663,23.68777002844156
2010-10-13T09:30:00-04:00,32.28999,32.77991,32.28999,32.62,27458256,16111649.95,70.603779806503,64.10478182088607,NaN,NaN,174.36235629980243,147.9107121754186,0.062063209814992804,0.56537318391063,0.5033099740956372,91766566,77933031.6,52.426292406055545,46.28493983069041,NaN,NaN,30.43569748486575,24.651759665073588
2010-10-14T09:30:00-04:00,32.59,32.62,32.21001,32.42999,11352688,15798343.55,66.84423475149684,64.2467701113174,NaN,NaN,131.0811438086757,144.78865659680054,0.05471149824125132,0.5716993468972014,0.51698784865595,80413878,79633626.4,54.09307920240952,46.525654120019624,NaN,NaN,31.000535228807657,25.558727602749883
2010-10-15T09:30:00-04:00,32.55,32.58,32.05,32.23,17889088,15851038.75,63.039399015240306,64.33651749650654,NaN,NaN,99.13375048528196,132.18107980966928,0.029759346590078395,0.554187031893548,0.5244276853034696,62524790,75227913.8,49.27635653919207,46.49654707257856,NaN,NaN,30.35295774157099,26.24361762258147
2010-10-18T09:30:00-04:00,32.21001,32.355,32.125,32.21001,8869898,15444738.45,62.655497052083255,64.28535207504969,NaN,NaN,81.69365740815279,118.84449825253856,0.006502965013193807,0.5325563915699618,0.526053426556768,53654892,70533687.2,44.708307697545976,46.26368733167174,NaN,NaN,29.71644521746691,26.73973585042225
2010-10-19T09:30:00-04:00,31.99001,32.06,31.58,31.78,21185472,15323375.25,54.90904864744629,63.69277181671618,NaN,NaN,16.011496244747363,100.45648084933205,-0.040652742873243275,0.47523749796521386,0.5158902408384571,32469420,64165909.2,39.375815174586435,45.691452736343194,NaN,NaN,26.803513624680946,26.748846961030633
2010-10-20T09:30:00-04:00,31.92,32.37,31.86,32.23,17689040,15194927.25,60.423468451015935,63.642298946374844,NaN,NaN,62.40544062639107,78.06509771464978,-0.044063267194697,0.4608111568450859,0.5048744240397829,50158460,55844288,33.71621724042886,44.81584644174386,NaN,NaN,25.90435429279852,26.62820515128319
2010-10-21T09:30:00-04:00,32.38,32.67,32.2,32.49001,17236976,15159842.45,63.22218293820393,63.76740621128441,NaN,NaN,103.10852382741848,72.47057371839834,-0.03190066147180842,0.46499859720002235,0.49689925867183077,67395436,53240599.6,32.158743127100664,43.97168210046213,NaN,NaN,26.02033759666518,26.541366929194904
2010-10-22T09:30:00-04:00,32.64,32.64,32.3,32.48,11714453,14875417.1,63.03736351271188,64.29221549165894,NaN,NaN,98.36298530256353,72.31642068185464,-0.027774040952240286,0.4621817074815304,0.4899557484337707,55680983,51871838.2,31.33916043991644,43.25874057430809,NaN,NaN,26.058270709627156,26.472353183542367
2010-10-25T09:30:00-04:00,32.60001,32.95,32.55,32.59,12218758,14983439.55,64.27334997936329,64.26279190683222,NaN,NaN,125.49432847550958,81.07655489532598,-0.021178484049572843,0.46348264337180467,0.4846611274213775,67899741,54720808,35.04955924415968,43.0290542639976,NaN,NaN,26.44362409977208,26.46824902871804
2010-10-26T09:30:00-04:00,32.36,32.57001,32.21001,32.44,14680313,14761554.4,61.264880418575935,63.89825365091293,NaN,NaN,69.24930649605707,91.72411694558794,-0.02992551818816913,0.4472542296861661,0.47717974787433526,53219428,58870809.6,40.125305406464406,43.09894771516353,NaN,NaN,25.91761867160137,26.389587549129946
2010-10-27T09:30:00-04:00,32.22,32.27,31.87,32.2,15778406,14930743.25,56.69247463028492,63.295108560818086,NaN,NaN,10.033935609112108,81.24981594213213,-0.0535058406070511,0.4102974471155214,0.4638032877225725,37441022,56327322,38.15714837073197,42.75047658319843,NaN,NaN,24.136058261518674,26.06765479375691
2010-10-28T09:30:00-04:00,32.35001,32.46001,31.86501,32.13,13483336,14445890.85,55.393900917221224,62.42402807487805,NaN,NaN,12.004100625487737,63.02893130174599,-0.07417630780276674,0.37108290296911406,0.4452592107718808,23957686,47639772,32.324957435312626,41.73710698968531,NaN,NaN,22.287286893058752,25.527602236514316
2010-10-29T09:30:00-04:00,32.08,32.23,31.98,32.17999,9145105,14222166.8,56.166085679560105,61.722638778478874,NaN,NaN,-1.8144003681615104,42.99345416760098,-0.08411280977985375,0.3401181985470636,0.42423100832691735,33102791,43124133.6,29.7772641628209,40.209469919402885,NaN,NaN,20.944798979574163,24.872916056951436
2010-11-01T09:30:00-04:00,32.31,32.62,32.00999,32.17999,9119754,13934079.7,56.166085679560105,61.04941081994764,NaN,NaN,24.104105628762685,22.715409598251618,-0.08979911736291846,0.3119821116232693,0.40178122898618773,33102791,36164743.6,26.33265096042325,38.490061243367784,NaN,NaN,19.824689591287285,24.151740847570842
2010-11-02T09:30:00-04:00,32.42999,32.56,32.35001,32.49001,8592586,13609133.8,61.019529444398145,60.36482150836873,NaN,NaN,80.40493545300966,24.946535389642136,-0.07253397731036254,0.31111375734823454,0.3836477346585971,41695377,33859933.4,25.289275238272936,36.551702874240455,NaN,NaN,20.11269395190983,23.574734148190696
2010-11-03T09:30:00-04:00,32.48,32.59,32.12,32.53999,16251910,13756363.65,61.75473477598258,60.001285795832,NaN,NaN,56.284559691202375,34.19666020606019,-0.0582182073868141,0.31087497542507947,0.36909318281189357,57947287,37961186.4,30.56171027365322,34.87089080790072,NaN,NaN,20.552115561687,23.142931492975883
2010-11-04T09:30:00-04:00,32.92999,33.28999,32.87,33.23,17072272,14131290.15,70.13063321430371,60.50780252433652,NaN,NaN,252.05120495201098,82.20608107136484,-0.005523591392226412,0.36218869357161054,0.36771228496383696,75019559,48173561,41.61142408468561,34.32339563257883,NaN,NaN,23.656438292465833,23.216289607188735
2010-11-05T09:30:00-04:00,33.27,33.53,33.2,33.42999,12831336,14140734.5,72.0418079198819,61.17825330060784,NaN,NaN,259.57149811311575,134.48326076762027,0.03720446071188205,0.4142178608536895,0.37701340014180745,87850895,59123181.8,50.67458671219007,34.749558419339124,NaN,NaN,26.863326921253332,23.73729493776939
2010-11-08T09:30:00-05:00,33.24001,33.37,33.14,33.28999,10577980,14298267.1,68.72665170594406,62.16522494764341,NaN,NaN,188.9292075871372,167.4482811592952,0.049663624544790286,0.4390929308227953,0.38942930627800504,77272915,67957206.6,56.53627895484833,35.97530583221497,NaN,NaN,28.510960407414963,24.41924714771876
2010-11-09T09:30:00-05:00,33.44,33.44,32.86,32.99001,10907707,14202766.7,62.12936637575812,62.28707479941071,NaN,NaN,126.56254103726535,176.67980227614632,0.03217496235541151,0.4296480092222694,0.3974730468668579,66365208,72891172.8,59.435744976962276,37.812414956253065,NaN,NaN,27.884753167090327,24.91431943620041
2010-11-10T09:30:00-05:00,33.00999,33.05499,32.67999,32.98,11871105,13423409.15,61.915782772264194,62.193760501843585,NaN,NaN,76.7789381866823,180.77867797524232,0.015264242301338105,0.41655334974353053,0.4012891074421924,54494103,72200536,58.84400410794692,39.718505026313515,NaN,NaN,27.321247423508638,25.25816629153016
2010-11-11T09:30:00-05:00,32.74001,32.85001,32.58,32.795,9976449,13354597.2,57.95070215534465,61.830427547745934,NaN,NaN,40.26558220489194,138.4215534258185,-0.011599990217334377,0.38678911967052443,0.3983891098878588,44517654,66100155,53.75326724854417,41.319512655501214,NaN,NaN,25.667079813435034,25.316582508945142
2010-11-12T09:30:00-05:00,32.58,32.72,32.25,32.41,14176813,13168983.45,50.67729698670307,60.85928090541305,NaN,NaN,-14.98478260845149,83.51029728150505,-0.056031718096966276,0.32834946226665096,0.38438118036361724,30340841,54598144.2,45.72166860121396,42.08180618100509,NaN,NaN,21.887529408332817,24.826717780286238
2010-11-15T09:30:00-05:00,32.46001,32.78,32.45,32.50999,17186720,13584824.55,52.35001364228115,60.22250470710628,NaN,NaN,4.908155827079832,46.706086929493566,-0.07806659073997829,0.2867979419386444,0.3648645326786227,47527561,48649073.4,42.20881283691218,42.230628140322786,NaN,NaN,19.287659484032847,24.035423737964326
2010-11-16T09:30:00-05:00,32.28999,32.39999,31.82001,31.985,25741360,13812618.95,43.926695697472105,59.31066335476252,NaN,NaN,-102.35448837545951,0.922681046948614,-0.12461527796624439,0.2090954352208172,0.3337107131870616,21786201,39733272,37.552205409812565,42.18741792882855,NaN,NaN,14.083980115842524,22.61378893480407
2010-11-17T09:30:00-05:00,31.99001,32.10001,31.84,32.00999,15984848,13727409.35,44.38542336894011,58.52434352988529,NaN,NaN,-115.60094528781867,-37.553295647951586,-0.1487061279873233,0.14782805320290748,0.2965341811902308,37771049,36388661.2,35.94993969240262,42.4463452329064,NaN,NaN,10.124158631685578,20.82955603435857
2010-11-18T09:30:00-05:00,32.38,32.74001,32.38,32.66,18908176,13810969.35,54.753967060882,58.42347791426543,NaN,NaN,5.362109830945216,-44.53399012274092,-0.11723171097728952,0.14999454246861887,0.2672262534459084,56679225,38820975.4,38.02104468320991,43.03518669864848,NaN,NaN,9.944801957182543,19.274591166190568
2010-11-19T09:30:00-05:00,32.56,32.77,32.42,32.75999,11092320,13779862.7,56.109532679671524,58.41943841427339,NaN,NaN,15.06191677043316,-38.52465024696399,-0.08741379868907564,0.15795900508456384,0.2453728037736395,67771545,46307116.2,44.02078402649875,44.29862477479673,NaN,NaN,10.247747483585927,17.985042068675618
2010-11-22T09:30:00-05:00,32.62,32.75,32.25,32.69,8655574,13601703.5,54.87033174477297,57.98021000715731,NaN,NaN,-1.169887780859104,-39.74025896855178,-0.07084574846910965,0.15681561818725243,0.22766136665636208,59115971,48624798.2,45.77103366959102,45.76160751989088,NaN,NaN,10.107653870859023,16.859700897558962
2010-11-23T09:30:00-05:00,32.35001,32.38,32.07001,32.24001,14588508,13597113.25,47.59259969668428,56.96862893006458,NaN,NaN,-66.4641496988236,-32.562191233224596,-0.08754022013029508,0.11823609149349323,0.20577631162378832,44527463,53173050.6,49.132211104654935,47.08807186496243,NaN,NaN,7.605110566348388,15.53761656452888
2010-11-24T09:30:00-05:00,32.45,33.00999,32.45,32.97,12095137,13412949.8,57.45173934894904,56.06299365396781,NaN,NaN,44.421076584118495,-0.5577868588371672,-0.048704755492856605,0.14489536725771757,0.19360012275057417,56622600,56943360.8,51.79926029096383,47.81577445112516,NaN,NaN,8.863513146727964,14.584173219128749
2010-11-26T09:30:00-05:00,32.67,32.88,32.61,32.72,5190914,12998328.7,53.72418472461256,54.754591997162855,NaN,NaN,24.1362994818442,3.19705107134263,-0.03952968618087882,0.14418801502447565,0.18371770120535447,51431686,55893853,50.99770757466188,47.838854512730286,NaN,NaN,8.56288115544684,13.723988638602762
2010-11-29T09:30:00-05:00,32.50999,32.78,32.24001,32.69,8081625,12945154.7,53.27746990856229,53.651079011635595,NaN,NaN,-17.485219612308327,-3.3123762052056676,-0.03529616814524958,0.13959749102379249,0.17489365916904206,43350061,51009556.2,47.3272448787987,47.18106636444104,NaN,NaN,8.186779234031274,12.932958723663978
2010-11-30T09:30:00-05:00,32.38,32.78999,32.31,32.61,14234258,13200879.9,52.03493400457957,52.93004812797998,NaN,NaN,-21.857089751720046,-7.449816599377857,-0.03749228281086381,0.1280283056554623,0.1655205884663261,29115803,45009522.6,43.21273392317183,46.02227986059886,NaN,NaN,7.502957852113558,12.15724431344249
2010-12-01T09:30:00-05:00,33.11,33.52,33.11,33.45,16577008,13600101,62.04447823102294,52.93924066074846,NaN,NaN,141.57313001367655,34.15763934312217,0.015194460477439359,0.1845136640631253,0.16931920358568595,45692811,45242592.2,43.418511477002426,44.920458958388544,NaN,NaN,10.38106250416489,11.903504054974261
2010-12-02T09:30:00-05:00,33.5,34.03999,33.46001,33.97,12706223,13422816.65,66.68004090267996,53.562764856986696,NaN,NaN,195.62588514248753,64.39860105479599,0.07906250605910892,0.2681473361595721,0.18908483010046317,58399034,45597879,43.75310973906215,44.20616199342554,NaN,NaN,14.502804711679374,12.27483272021785
2010-12-03T09:30:00-05:00,33.8,34.09,33.66,34.03999,10593945,13098900.3,67.25964075309207,54.74721798315734,NaN,NaN,183.12607013070956,96.19655518456905,0.11769192047551594,0.3361997306948581,0.21850781021934215,68992979,49110137.6,47.08449134197328,44.30350647490834,NaN,NaN,17.855609187119768,13.072086501203838
2010-12-06T09:30:00-05:00,33.94,34.13,33.82001,34.0175,16350938,13274880.4,66.85719246375966,55.78344504183438,NaN,NaN,171.35148192806864,133.96389549264444,0.1323071308520361,0.3838917237843873,0.2515845929323512,52642041,50968533.6,48.81203946435519,44.775165519725704,NaN,NaN,20.344417637941394,14.110990949309203
2010-12-07T09:30:00-05:00,34.36,34.42999,34.10001,34.11,19222112,13707087,67.71289267725159,57.482459111818635,NaN,NaN,173.81079467605971,173.0974723782004,0.13814138833856926,0.42426132835556274,0.2861199400169935,71864153,59518203.6,55.93890038415133,46.08850087503561,NaN,NaN,22.623316166968788,15.327037408974858
2010-12-08T09:30:00-05:00,34.14999,34.25,33.89,33.99001,18080352,14065719.25,65.3556542302899,58.980332744772184,NaN,NaN,128.63182633982956,170.509211643431,0.12429060569911732,0.4414831971408901,0.3171925914417728,53783801,61136401.6,57.15480517724618,47.60313412395301,NaN,NaN,23.831919108840943,16.542020508955726
2010-12-09T09:30:00-05:00,34.2,34.25999,33.97,34.09,10672848,14005806.4,66.4051977142298,59.8125635057256,NaN,NaN,114.12671614619511,154.2093778441725,0.11258302843941231,0.4579213769910382,0.3453383485516259,64456649,62347924.6,58.08735909747655,49.03644229640063,NaN,NaN,25.13712455206202,17.769892515113767
2010-12-10T09:30:00-05:00,34.22,34.46001,34.09,34.395,9182625,13966115.2,69.44584664914507,60.765157360688,NaN,NaN,115.29213899181826,140.64259161639424,0.11565916110099211,0.489912299927866,0.3742531388268739,73639274,63277183.6,58.82759117761009,50.094071378622864,NaN,NaN,27.18058621329154,19.114277329139163
2010-12-13T09:30:00-05:00,34.64999,34.66,34.39999,34.42,9198578,13717203.45,69.68802387164665,61.823563941178975,NaN,NaN,114.45836173442058,129.26396757766466,0.1097076242834526,0.5113876691811896,0.401680044897737,82837852,69316345.8,63.35697195439803,51.35020982753765,NaN,NaN,28.921970868849677,20.515376406240666
2010-12-14T09:30:00-05:00,34.50999,34.71001,34.46001,34.58,9619355,13338835.2,71.25817699691947,63.5139623197672,NaN,NaN,107.91972476921639,116.08575359629597,0.10677504727391413,0.5351488539901297,0.42837380671621555,92457207,73434956.6,66.09626703844822,52.561928108522885,NaN,NaN,30.858943450722176,21.993028841166595
2010-12-15T09:30:00-05:00,34.55,34.74001,34.38,34.44,11470781,12625306.25,67.94184624364854,64.2632556693886,NaN,NaN,93.26943143920874,109.0132746161718,0.08649976524134834,0.536498513267901,0.44999874802655265,80986426,78875481.6,69.35522419586005,53.81592553030118,NaN,NaN,31.614521515711363,23.36752779467299
2010-12-16T09:30:00-05:00,34.42999,34.82001,34.38,34.82001,9357535,12293940.6,71.78085151468473,65.55301758296518,NaN,NaN,97.41350077768774,105.67063154247032,0.08940594837158,0.5617561834910276,0.4723502351194476,90343961,84052944,72.10339264317884,55.32347446376668,NaN,NaN,33.426364055070415,24.804504403301195
2010-12-17T09:30:00-05:00,34.72,34.72,34.39,34.53999,8233672,11760215.4,65.55151694996277,66.4297352287795,NaN,NaN,80.10292388389028,98.63278852088472,0.06436413095343196,0.5528053988112376,0.4884412678578056,82110289,85747147,72.95798523235851,57.154241631878094,NaN,NaN,33.15133777107888,25.996909170126578
2010-12-20T09:30:00-05:00,34.62,34.67999,34.36,34.53,7327367,11571967.75,65.33368012778257,67.37964566615115,NaN,NaN,72.71543233020736,90.28420264004208,0.040203766569728905,0.5386959760699668,0.49849220950023787,74782922,84136161,70.73888486616445,59.12039527066328,NaN,NaN,32.8667306774978,26.97831224260818
2010-12-21T09:30:00-05:00,34.66,34.84,34.56,34.81,7127648,11495571.45,68.49392063673132,67.84032012370174,NaN,NaN,88.38100529626911,86.37645874545262,0.036277257909617555,0.5438387818872599,0.5075615239776423,81910570,82026833.6,67.8297667958295,60.86405636486522,NaN,NaN,33.52801396865335,27.913983917757488
2010-12-22T09:30:00-05:00,34.86,34.91,34.78,34.89,5748504,11053571.25,69.3535460862767,68.03128477967293,NaN,NaN,98.9686857417143,87.51630960595374,0.03239255612189729,0.5480522191300139,0.5156596630081166,87659074,83361363.2,68.70661532459462,62.646449620974686,NaN,NaN,34.32064694486777,28.829221493058956
2010-12-23T09:30:00-05:00,34.87,34.89,34.71001,34.82001,4177688,10657698.8,67.6153807305652,68.05669477806387,NaN,NaN,88.63712634042881,85.76103471850195,0.019091859974979752,0.5395244879768413,0.5204326280018615,83481386,81988848.2,66.69323543264885,64.04707419888008,NaN,NaN,34.50804950344196,29.640482637399383
2010-12-27T09:30:00-05:00,34.73,34.89999,34.60001,34.88,3150977,10555701.95,68.34762547859204,68.16315427912333,NaN,NaN,82.84064036952775,86.30857801562944,0.008838151184478837,0.53148031698246,0.5226421657979812,86632363,82893263,67.3717454420508,65.3727674830012,NaN,NaN,34.86082788786217,30.386246244608355
2010-12-28T09:30:00-05:00,34.91,34.95,34.71001,34.86,3581266,10330684,67.79724209404262,68.16917923746554,NaN,NaN,86.684605202124,89.10241259001276,-0.004093167465832659,0.5175257064656904,0.5216188739315231,83051097,84546898,68.63007380847056,66.27927987045257,NaN,NaN,35.01551699622605,31.047570637696598
2010-12-29T09:30:00-05:00,34.97,35,34.87,34.89,3893360,9813639.1,68.21076343195747,68.37311560901323,NaN,NaN,99.65843560274165,91.35789865130727,-0.014824666663202146,0.5030880406025204,0.5179127072657226,86944457,85553675.4,69.40372845347352,67.15420296161167,NaN,NaN,35.25058602841807,31.648001407799665
2010-12-30T09:30:00-05:00,34.85001,34.96001,34.78999,34.83,4316066,9200592,66.3749697437415,68.37095646826405,NaN,NaN,86.60693831857193,88.88554916667879,-0.029324600053712624,0.48125695719858186,0.5105815572522945,82628391,84547538.8,67.60921102215343,67.83433524194574,NaN,NaN,34.998658226365,32.12666666759471
2010-12-31T09:30:00-05:00,34.81,34.92,34.71001,34.87,4004221,8765491.9,67.01237470451119,68.19713704364736,NaN,NaN,76.9570136661222,86.54952663181747,-0.03897780144440066,0.46185930544679366,0.5008371068911943,86632612,85177784,68.16449344525343,68.50125683249168,NaN,NaN,34.93427433441814,32.52775347714092
2011-01-03T09:30:00-05:00,35.05,35.32001,35.05,35.12,6400746,8555831.95,70.74502411388008,68.27263706094975,NaN,NaN,148.14694455323755,99.61078746855942,-0.031596580650742834,0.4613413810777658,0.4929379617285086,93033358,86457983,69.31520952595585,68.9268452304601,NaN,NaN,35.84629042499186,33.001830183976764
2011-01-04T09:30:00-05:00,35.22,35.22,34.73,35.07001,10059602,8241265.15,69.0622164868144,68.11578273879938,NaN,NaN,100.0057991642656,102.27502626098774,-0.032998095804453564,0.45169034197294167,0.48468843777739523,82973756,86442514.8,69.28262377586715,69.15444214027573,NaN,NaN,36.19531621776319,33.45804247451768
2011-01-05T09:30:00-05:00,34.92999,35.35001,34.89,35.25,9908844,7775601.75,71.6747520806921,68.38241887001678,NaN,NaN,131.71174389674144,108.68568791978774,-0.025078994299902235,0.45333969490251746,0.4784186892024197,92882600,87630143.4,70.43196044971376,69.23135187269385,NaN,NaN,37.208747653131056,33.993857500033876
2011-01-06T09:30:00-05:00,35.3,35.39,35.08,35.19,9881668,7365667.55,69.56584878676567,68.22420438945115,NaN,NaN,140.72300822037334,119.50890190014802,-0.026991484269494936,0.44467933386555103,0.47167081813504597,83000932,87704651.6,70.50651897154697,69.1172894675773,NaN,NaN,37.52225148125089,34.49791378306488
2011-01-07T09:30:00-05:00,35.31,35.5,35.03,35.25999,11827867,7423418.5,70.65066979427117,68.58842959261602,NaN,NaN,147.35530167549408,133.5885595020224,-0.02660879224893653,0.4384098278238753,0.4650186200728118,94828799,89343889,72.16925048239415,69.06095127115127,NaN,NaN,38.07548139188651,35.0089948700394
2011-01-10T09:30:00-05:00,35.14999,35.39,35.03,35.31,9419355,7435255,71.43418785692805,69.02418014469784,NaN,NaN,128.55095812471336,129.66936221631755,-0.026022016073239063,0.432491099981263,0.45851311605450207,104248154,91586848.2,74.3039042220106,69.31559551085456,NaN,NaN,38.7529839749602,35.54385045645666
2011-01-11T09:30:00-05:00,35.55,35.61,35.25,35.44,7217219,7336187.05,73.42059068434591,69.37608514809888,NaN,NaN,160.5494738455045,141.77809715256535,-0.020173999312479762,0.4332956169139024,0.45346961622638216,111465373,97285171.6,78.76095790183686,70.09639487556937,NaN,NaN,39.88338171933222,36.16378349401031
2011-01-12T09:30:00-05:00,35.7,35.84,35.63,35.73,7173355,7213887.05,77.2252344003608,69.93834859910488,NaN,NaN,201.3923989542315,155.71422816406334,-0.001078094746120084,0.4521219977937321,0.45320009253985216,118638728,102436397.2,81.8292804295118,71.03372809734917,NaN,NaN,42.06056667853564,37.00618109179965
2011-01-13T09:30:00-05:00,35.75999,35.88,35.67,35.765,9859379,7133316.95,77.64121360974528,70.65447951904632,NaN,NaN,176.90081283904684,162.94978908779805,0.009049243293196618,0.4645116466563479,0.4554624033631513,128498107,111535832.2,85.7464874586792,72.39467467063706,NaN,NaN,43.98650356747693,38.003370016896405
2011-01-14T09:30:00-05:00,35.74001,35.94,35.67,35.91,9937348,7162307.6,79.32593549485533,71.43864452020799,NaN,NaN,162.33875395744502,165.94647954418824,0.02002368375271879,0.4804920080540498,0.460468324301331,138435455,120257163.4,88.34081901824646,73.89246564036532,NaN,NaN,46.164720809041036,39.169277272917064
2011-01-18T09:30:00-05:00,36.00999,36.17999,35.97,36.17,9008406,7201044.3,81.95196681034459,72.44969628565812,NaN,NaN,187.5704810268459,177.75038412461475,0.03824716660822125,0.5082772825616075,0.4700301159533863,147443861,128896304.8,90.23655972883294,75.43578606324833,NaN,NaN,48.96260156659234,40.56832360058496
2011-01-19T09:30:00-05:00,36.14,36.14,35.66,35.78999,11443512,7406851.55,68.29722605234376,72.4558721871143,NaN,NaN,122.9794517895484,170.23637971342353,0.019127787666819995,0.49393985053691125,0.47481206287009126,136000349,133803300,91.11977135077487,76.98693198448414,NaN,NaN,47.00781449322313,41.48825087096184
2011-01-20T09:30:00-05:00,35.64,35.78,35.38,35.61,19478544,8024396.35,62.947397176727556,72.21104557518473,NaN,NaN,62.16225848643702,142.39035161986465,-0.009673891140475566,0.4627196989444968,0.4723935900849724,116521805,133379915.4,90.36024402390636,78.61200577032365,NaN,NaN,43.5881455198812,41.788235820807465
2011-01-21T09:30:00-05:00,36.09,36.17999,35.78999,35.89999,13339211,8403931.7,67.38073049746663,72.23735670325294,NaN,NaN,113.66554753070628,129.7432985581965,-0.013019341935042728,0.45611941266616896,0.4691387546012117,129861016,133652497.2,90.41563520164343,80.20137303863721,NaN,NaN,42.12982179010425,41.83703381642129
2011-01-24T09:30:00-05:00,35.92999,36.29091,35.86279,36.24001,9585363,8674315.45,71.66212347115393,72.30286380020108,NaN,NaN,125.78364020115602,122.43227580693872,0.002988523313035174,0.47287440874250564,0.46988588542947046,139446379,133854682,90.45942625410592,81.71167423350506,NaN,NaN,42.38646936121664,41.91552460853491
2011-01-25T09:30:00-05:00,36.16,36.23,35.87,36.19501,12919230,9162728.1,70.34615953452814,72.39457401789491,NaN,NaN,107.09322397625988,106.33682439682153,0.005709625000343499,0.4770229166798998,0.4713132916795563,126527149,129671339.6,82.10090266181655,82.62726558250145,NaN,NaN,42.14570084817325,41.948406928483244
2011-01-26T09:30:00-05:00,36.19,36.52,36.175,36.41,15750684,9771199,72.90602676915482,72.48252220992796,NaN,NaN,134.08894763110553,108.55872356513296,0.01653913707392085,0.49198721302195736,0.4754480759480365,142277833,130926836.4,82.61994614508318,83.49783598931356,NaN,NaN,42.79352156220618,42.06913759044367
2011-01-27T09:30:00-05:00,36.45,36.64999,36.38,36.545,9505777,10051819.85,74.40043507061984,72.82784980163184,NaN,NaN,141.78823889205108,124.48391964625576,0.026740671806090355,0.5088739157056494,0.4821332438995591,151783610,137979197.4,85.21373544103892,84.54835145142013,NaN,NaN,43.8061716207643,42.3172853090609
2011-01-28T09:30:00-05:00,36.64,36.82001,35.78,35.83,18193584,10745695.75,56.595654759927434,71.82392015632158,NaN,NaN,75.82119714867373,116.91504956984924,-0.018292140446423633,0.45926806834152956,0.4775602087879532,133590026,138724999.4,85.46084885414399,85.49775133511653,NaN,NaN,38.03277943343073,41.70521304111373
2011-01-31T09:30:00-05:00,35.92,36.27499,35.87,36.24001,11530301,11121999.75,62.184298170638094,71.16321375015801,NaN,NaN,68.20082021664425,105.3984855729469,-0.023746875430638137,0.44787661449965555,0.4716234899302937,145120327,139859789,85.84839205491772,86.32235760889562,NaN,NaN,35.39874341669279,40.804288809053595
2011-02-01T09:30:00-05:00,36.47,36.8,36.38,36.75,13750586,11489491.75,67.74710291230264,70.75796462358349,NaN,NaN,142.99317043028867,112.57847486375265,0.0023257218446254835,0.47453064223607555,0.47220492039145007,158870913,146328541.8,87.83842704044221,86.97074826165316,NaN,NaN,35.40727059200192,40.03328620661764
2011-02-02T09:30:00-05:00,36.66,36.82001,36.60001,36.63499,13112883,11642155.8,65.41027748765279,69.91403912981863,NaN,NaN,137.36087131112816,113.23285959975718,0.006900930885556766,0.480831083998396,0.47393015311283926,145758030,147024581.2,88.03342176404121,87.41390121411953,NaN,NaN,34.55247122840631,39.250312638301736
2011-02-03T09:30:00-05:00,36.69,36.69,36.39999,36.64999,10043586,11648892.9,65.57704980693049,69.05231314390329,NaN,NaN,109.19278738348278,106.71376929804353,0.00604335929224914,0.48148435222815067,0.47544099293590153,155801616,147828182.4,88.26731726773849,87.59396048619521,NaN,NaN,33.966055905004055,38.49541881925921
2011-02-04T09:30:00-05:00,36.75,36.81,36.50999,36.78,8689379,11589278.45,67.05949068758405,68.1761385148125,NaN,NaN,119.94510653455633,115.53855117522005,0.009151476845238316,0.4868803389924494,0.4777288621472111,164490995,154008376.2,89.90199993777735,87.70547340901885,NaN,NaN,33.97639384658234,37.84984382316251
2011-02-07T09:30:00-05:00,36.88,37.22,36.88,37.125,9793020,11487536.1,70.66925915705914,67.3702308252921,NaN,NaN,171.33124913003854,136.1646369578989,0.02828158034619027,0.5130808375799489,0.48479925723375866,174284015,159841113.8,91.15459042001548,87.77104702981761,NaN,NaN,35.1885023084459,37.46965217820299
2011-02-08T09:30:00-05:00,37.27,37.39,37.09,37.375,10041996,11518668.15,72.97994480166803,67.70471073595812,NaN,NaN,175.41660726944355,142.64932432572988,0.050323985100301505,0.5477042386091355,0.497380253508834,184326011,164932133.4,92.0782498956981,87.8395097830264,NaN,NaN,36.963300756087264,37.39731626075789
2011-02-09T09:30:00-05:00,37.28999,37.41,37.17999,37.37,12441664,11779890.4,72.85632166642455,68.41249105665077,NaN,NaN,156.2208083375739,146.42131173101905,0.05664806176363513,0.568190330713378,0.5115422689497429,171884347,170157396.8,92.89796824084357,88.02077579852191,NaN,NaN,38.31086698300391,37.527823506793034
2011-02-10T09:30:00-05:00,37.2,37.62,37.125,37.57001,13896730,12116059.15,74.70236754670671,68.93546513159649,NaN,NaN,150.66137884244947,154.71503002281239,0.06574282321332992,0.5937207979664052,0.5279779747530753,185781077,176153289,93.70315533974863,88.25559866552942,NaN,NaN,40.01904646940764,37.883712501452266
2011-02-11T09:30:00-05:00,37.42,37.925,37.38,37.85001,11210641,12183622.25,77.05499397487512,69.32067016757657,NaN,NaN,165.37419364402723,163.80084744470656,0.0810523675227296,0.6292934341564873,0.5482410666337577,196991718,182653433.6,94.43920178414511,88.53986834624651,NaN,NaN,42.23747347736923,38.505678355154686
2011-02-14T09:30:00-05:00,37.89999,37.905,37.69,37.81,6367445,12005127.1,75.96782268360155,69.72221753536753,NaN,NaN,153.17672752154695,160.16994312300824,0.07884764037863146,0.6468006171070471,0.5679529767284156,190624273,185921485.2,94.77019443628375,89.44481775870845,NaN,NaN,43.70018337685268,39.24775050111154
2011-02-15T09:30:00-05:00,37.73,37.74001,37.48,37.67,8727887,11991101.15,72.13274796460688,69.66698333504267,NaN,NaN,114.72663671948062,148.03194901301566,0.059220044708540254,0.6419780326140909,0.5827579879055507,181896386,185435560.2,93.87545150293151,90.2487824271262,NaN,NaN,43.815169522293424,39.90023893270895
2011-02-16T09:30:00-05:00,37.87,38,37.60001,37.85001,11612477,11999549.4,73.95348432281405,69.63505828162796,NaN,NaN,118.32297942549167,140.4523832305992,0.049988359718930675,0.645243437554214,0.5952550778352833,193508863,189760463.4,94.38369198549505,90.90377932315877,NaN,NaN,44.44482878324413,40.54946605421398
2011-02-17T09:30:00-05:00,37.8,37.98,37.69,37.94,10252059,11538225.15,74.8385409211313,70.93812157885682,NaN,NaN,110.20939860960502,132.3619871840303,0.04189777064310052,0.647627291139159,0.6057295204960584,203760922,193356432.4,94.77214870095004,91.56887216935921,NaN,NaN,45.222725168455554,41.217074499105635
2011-02-18T09:30:00-05:00,37.96001,38.08501,37.89999,38.045,10110754,11376802.3,75.86887646742487,71.91559145719873,NaN,NaN,112.75647874186534,121.83844420359794,0.035808930067307565,0.6504906830801929,0.6146817530128853,213871676,196732424,95.11383675106921,92.23068964765574,NaN,NaN,46.17049383314528,41.92470583253987
2011-02-22T09:30:00-05:00,37.63,37.69,36.82001,36.9375,13824785,11588773.4,51.78274512101425,70.77528018639242,NaN,NaN,11.95001749731036,93.59310219875063,-0.046166599418595244,0.5569735037396413,0.6031401031582365,200046891,198616947.6,95.298560331732,92.7635563113193,NaN,NaN,38.37270750131468,41.4172774995077
2011-02-23T09:30:00-05:00,36.91,36.91,35.91,36.28999,52705696,13578096.7,43.15624759500818,69.18570662263208,NaN,NaN,-85.18477719562658,53.61081941572915,-0.1419484324320004,0.4257045626182361,0.5676529950502365,147341195,191705909.4,82.91826591400589,92.39818803631678,NaN,NaN,28.22167455954737,39.53219136522765
2011-02-24T09:30:00-05:00,36.22,36.7299,36.10001,36.5,19520544,13766589.7,46.281951516793555,67.80748531619373,NaN,NaN,-77.22025635154478,14.502172260321856,-0.18631429479770367,0.33476012655310683,0.5210744213508105,166861739,186376484.6,74.84365927675395,91.43935532267503,NaN,NaN,21.591160365788586,36.96918693673636
2011-02-25T09:30:00-05:00,36.77,36.88,36.60001,36.83,12159730,13899287.35,50.8549738018559,66.65001982435601,NaN,NaN,-39.2183937965012,-15.3833862208994,-0.18804576159114372,0.28601721936188085,0.47406298095302457,179021469,181428594,68.203168917144,89.88943882120122,NaN,NaN,17.91267376072869,34.246827911592405
2011-02-28T09:30:00-05:00,37.03,37.2,36.82001,37.00999,10369215,13508068.9,53.195378436716155,65.40188548718865,NaN,NaN,-15.528997446368788,-41.04048145854622,-0.17210874227584083,0.2589270531082235,0.43103579538406434,189390684,176532395.6,62.31151719961247,87.82921930545815,NaN,NaN,15.83673595682911,31.61681477519765
2011-03-01T09:30:00-05:00,37.2,37.22,36.14,36.22501,19056016,13884354.65,43.47202362267549,63.294176831546324,NaN,NaN,-88.63712797632328,-61.15791055327293,-0.20712276346669284,0.1721323410506983,0.37925510451739114,170334668,170589951,55.989836861998185,85.25147551733673,NaN,NaN,10.319899162287841,28.574398259067678
2011-03-02T09:30:00-05:00,36.14999,36.64999,36.13,36.395,22821536,14337902.15,45.78316165583103,61.36037968793249,NaN,NaN,-103.72752596898818,-64.86646030794525,-0.21082038782183782,0.11572961974009388,0.3265500075619317,193156204,179752952.8,62.335208798538886,83.06842127145782,NaN,NaN,6.901005757814412,25.47819933031721
2011-03-03T09:30:00-05:00,36.87,37.38,36.8,37.27499,21481264,14756321.2,55.84696334479897,60.01356510208194,NaN,NaN,-0.19108529727847567,-49.46062609709198,-0.14890462214208716,0.14041922988432276,0.2893238520264099,214637468,189308098.6,67.58387998561413,81.2027587461625,NaN,NaN,7.715635578355442,22.9406902228941
2011-03-04T09:30:00-05:00,37.21001,37.27,36.536,36.841,19897392,15249011.5,50.835320460305574,58.140731279612694,NaN,NaN,-43.518086016880254,-50.3205645411678,-0.13262513162791556,0.1235424374915155,0.25616756911943106,194740076,192451820,69.10911099307683,79.39346654680048,NaN,NaN,6.488402435243285,20.590363396086843
2011-03-07T09:30:00-05:00,37.02,37.14,36.10001,36.5,22921952,15960640.15,47.24759194875571,56.08928622712371,NaN,NaN,-87.56876111259653,-64.72851727441335,-0.1395662879986026,0.08170970912117781,0.2212759971197804,171818124,188937308,65.40413447773224,77.29589083547538,NaN,NaN,4.2264776788875515,18.252665436486943
2011-03-08T09:30:00-05:00,36.57001,37.23,36.42999,37.07001,15966078,16269293.05,53.194165296557145,54.736530322263015,NaN,NaN,-36.077272725812946,-54.21654622431127,-0.10224119937512163,0.09347449790087836,0.195715697276,187784202,192427214.8,67.27998050882377,75.39621433589626,NaN,NaN,4.535091629893535,16.29301203554503
2011-03-09T09:30:00-05:00,36.97,37.13,36.64999,36.99001,19671904,16750788.45,52.30303022266223,53.19006931510931,NaN,NaN,-31.132699318175934,-39.69758089414883,-0.08037662007488364,0.09524492218239544,0.17562154225727908,168112298,187418433.6,62.077503754840464,73.08862946227808,NaN,NaN,4.46923455811445,14.60390096734066
2011-03-10T09:30:00-05:00,36.52,36.67999,36.125,36.245,31935152,17725462.85,44.77959036261979,51.04300141807278,NaN,NaN,-102.38052105986795,-60.13546804666672,-0.11160475591475211,0.03611559736383896,0.14772035327859107,136177146,171726369.2,49.23309462116876,69.83583988515085,NaN,NaN,1.7431570960103282,12.7666518428649
2011-03-11T09:30:00-05:00,36.10001,36.83,36.09,36.67,17060192,17883635.95,49.26316578232985,49.14259351199456,NaN,NaN,-70.89586178683588,-65.61102320065785,-0.09955167188748901,0.0232807634192298,0.1228324353067188,153237338,163425821.6,44.042007278244625,66.18785206566336,NaN,NaN,1.1051917162989315,11.100728967641189
2011-03-14T09:30:00-04:00,36.42999,36.535,35.961,36.36,26105168,18628362.3,46.30955726498539,48.751651522278216,NaN,NaN,-97.60185151270971,-67.61764128068049,-0.10768168483407929,-0.011769670735880311,0.09591201409819898,127132170,154488630.8,39.244073490003174,62.18396014839703,NaN,NaN,-0.4038623929749426,9.457215916124598
2011-03-15T09:30:00-04:00,35.39,36.27,35.17999,36.02,30522320,19836106.05,43.246971753590216,48.75813181931978,NaN,NaN,-150.5446188829035,-90.5111105120986,-0.12970498481247622,-0.0662192169173963,0.06348576789507993,96609850,136253760.4,31.66448102949434,58.52297551378906,NaN,NaN,-2.6478963260152244,7.727914167247481
2011-03-16T09:30:00-04:00,35.89999,36.06,35.08,35.35001,31509792,20975201.3,37.92451955996468,48.16117239383201,NaN,NaN,-174.38270257185653,-119.16111116283471,-0.18004539715424736,-0.16157097854772928,0.018474418606518078,65100058,115651312.4,25.639202629125208,55.00837146752986,NaN,NaN,-6.412673047852816,5.70783027937601
2011-03-17T09:30:00-04:00,35.92999,36.28,35.67999,35.89999,29125840,21850869.45,44.01549905222679,47.67263848314422,NaN,NaN,-103.315176596471,-119.34804227015532,-0.16722950412602297,-0.19056246155101064,-0.02333295742498767,94225898,107261062.8,23.664327466313267,51.82702564961339,NaN,NaN,-7.452808116943374,3.827739079901812
2011-03-18T09:30:00-04:00,36.31,36.38,35.87,35.97,18546016,22265567.3,44.75856922789458,47.07000925394268,NaN,NaN,-81.57323834953905,-121.48351758269595,-0.1457497069582498,-0.2055200911227999,-0.05977038416455012,112771914,99167978,21.9111562838454,48.94128558420145,NaN,NaN,-8.018998918687432,2.135347937246206
2011-03-21T09:30:00-04:00,36.67999,36.9352,36.52,36.75999,11453426,22332700.9,52.430988775012615,47.709935336252464,NaN,NaN,42.27885335058389,-93.50737661003723,-0.07368591432500662,-0.1518777770708084,-0.07819186274580178,124225340,98586612,21.78629329551319,46.498175329452515,NaN,NaN,-5.9050794041895,0.9867154598982479
2011-03-22T09:30:00-04:00,36.78,36.78,36.39999,36.465,11763055,22229614.4,49.657522700444446,47.98667541086771,NaN,NaN,12.556824838201644,-60.887087865816206,-0.04276770018346562,-0.13165148797513382,-0.0888837877916682,112462285,101757099,24.31917731146673,43.78274450894737,NaN,NaN,-5.106847791896773,0.11620642392753067
2011-03-23T09:30:00-04:00,36.35001,36.69,36.17999,36.59,13560805,20272369.85,50.8441048791044,47.62932837760381,NaN,NaN,-1.5151439568912661,-26.313576142823166,-0.012359264526922126,-0.10433286845032086,-0.09197360392339873,126023090,113941705.4,33.263838044556266,41.33131294172894,NaN,NaN,-4.100693897105389,-0.48620790764860067
2011-03-24T09:30:00-04:00,36.75999,37,36.58,36.97,17950128,20193849.05,54.36550032946086,47.88148408254347,NaN,NaN,68.83654375946028,8.116767928363092,0.03243726494399016,-0.051427022743411044,-0.0838642876874012,143973218,123891169.4,39.54687543787292,39.2197246877858,NaN,NaN,-2.1524999924068315,-0.7242496340426336
2011-03-25T09:30:00-04:00,37.06,37.28,36.92999,37.10001,13963238,20284024.45,55.53903498601488,48.473730013776276,NaN,NaN,112.61306181778495,46.9540279618279,0.06787595591046343,0.0009806572006780812,-0.06689529870978535,157936456,132924077.8,44.64250074087753,37.73675084943904,NaN,NaN,-0.2178410746047727,-0.6519055541229393
2011-03-28T09:30:00-04:00,37.21001,37.33,37.06,37.0675,9124578,20221792.6,55.15706549732252,48.613937170973806,NaN,NaN,118.39355696699738,62.176968685110594,0.0850652304966252,0.039436239410996166,-0.04562899108562904,148811878,137841385.4,47.24920748213897,36.30598134753298,NaN,NaN,1.2451763739984094,-0.3808938501056038
2011-03-29T09:30:00-04:00,37.06,37.37,36.85001,37.37,10845039,19811243.75,58.04823574665532,49.02430899411616,NaN,NaN,110.43889378491996,81.75338247445427,0.11110070895614446,0.09324689510955153,-0.017853813846592924,159656917,147280311.8,51.92853041502973,35.581054680403646,NaN,NaN,3.336943858517209,0.15022582255479805
2011-03-30T09:30:00-04:00,37.59,37.64999,37.42,37.52,14824324,19411383.15,59.444538370145075,50.07180528036797,NaN,NaN,144.6612860014512,110.98866846612277,0.13133057910033621,0.14630941002882736,0.014978830928491137,174481241,156971942,56.22254448321164,36.080301099120994,NaN,NaN,5.4883691182997385,0.9128177219469322
2011-03-31T09:30:00-04:00,37.47,37.77,37.47,37.66499,12790535,18976846.7,60.80259570976532,50.896050275184784,NaN,NaN,148.96600378314565,127.01456047085983,0.14624206775362183,0.19778141562051843,0.051539347866896595,187271776,165631653.6,59.68756913346502,37.19784123163674,NaN,NaN,7.685344691129728,1.8803215746873316
2011-04-01T09:30:00-04:00,37.85001,38.2124,37.85001,37.98,19070416,18935497.9,63.65057773910361,52.13469459476466,NaN,NaN,175.30655417625582,139.553258942554,0.16755537699545153,0.260983569111211,0.09342819211575948,206342192,175312800.8,63.194864284956516,38.908612002704835,NaN,NaN,10.418944565953032,3.10012485915386
2011-04-04T09:30:00-04:00,38.13,38.13,37.87,38.03,10374699,18308135.25,64.09648774599124,53.62394573707901,NaN,NaN,148.49380431715403,145.57330841258533,0.17446973278381933,0.31151535809553366,0.13704562531171433,216716891,188893803.4,67.47049749103897,41.46618460710088,NaN,NaN,12.819232890531598,4.488568863636394
2011-04-05T09:30:00-04:00,37.97,38.14999,37.815,37.89,14576902,18238676.45,61.81008993153645,55.330057906477,NaN,NaN,123.504089210787,148.18634749775873,0.15947363360780833,0.33638766732147474,0.1769140337136664,202139989,197390417.8,69.83174225495064,44.622794580374126,NaN,NaN,14.28488550914768,5.888042670138007
2011-04-06T09:30:00-04:00,38.14,38.14999,37.73,37.92999,13974547,17953808.6,62.22459962559054,56.63070794743156,NaN,NaN,106.71776063338719,140.59764242414593,0.14265367467621543,0.35523112705893567,0.21257745238272024,216114536,205717076.8,71.97841497505739,48.07380083099871,NaN,NaN,15.630354508367873,7.279801504170845
2011-04-07T09:30:00-04:00,37.86,38.02,37.58,37.75,13436426,17028872.3,59.11458550377269,57.65613768142284,NaN,NaN,81.64847053613593,127.13413577474401,0.11120853955764357,0.3515881268297747,0.24037958727213113,202678110,208798343.6,72.75110916198932,51.70522603658041,NaN,NaN,16.01993361977971,8.528391806400682
2011-04-08T09:30:00-04:00,37.97,37.98,37.205,37.42,16280719,16989898.65,53.80486075489754,57.75427139427177,NaN,NaN,52.00955141312674,102.4747352221182,0.06241827877924999,0.31840243574619365,0.25598415696694365,186397391,204809383.4,70.05779811004294,55.15319066618968,NaN,NaN,14.948597975496424,9.445564116271502
2011-04-11T09:30:00-04:00,37.50999,37.64999,37.25,37.39,12342801,16301780.3,53.33584381579462,58.01700861679678,NaN,NaN,37.53140423992971,80.2822552066733,0.024317130622326377,0.28638057024485164,0.26206343962252526,174054590,196276923.2,64.55275262538306,58.02701747432656,NaN,NaN,13.925626087191253,10.085572969260038
2011-04-12T09:30:00-04:00,37.14999,37.31,36.91,37.11,15049027,15528115.65,49.03917725856219,57.888085215329475,NaN,NaN,-1.9317538590116208,55.19508659271357,-0.02109680329438307,0.23569243550454644,0.2567892387989295,159005563,187650038,59.4649536463387,59.89852573159674,NaN,NaN,11.844743351475831,10.336883023862294
2011-04-13T09:30:00-04:00,37.28999,37.3,36.78999,37,14816438,14693447.95,47.42288537221209,57.39218414695457,NaN,NaN,-23.145658020295595,29.222402861977024,-0.05781648946308954,0.1845186269700676,0.24233511643315714,144189125,173264955.8,52.09218264450943,60.79461910349935,NaN,NaN,9.626876945155589,10.23545358404705
2011-04-14T09:30:00-04:00,36.81,37.06,36.47,37,14018180,13938064.95,47.42288537221209,56.81245917454009,NaN,NaN,-58.705117797915115,1.151685195166823,-0.08001016445904557,0.14232241085935016,0.22233257531839573,144189125,161567158.8,46.9900474758093,60.962301013137335,NaN,NaN,7.765108958365355,9.882547208949665
2011-04-15T09:30:00-04:00,37.09,37.25999,36.98,37.13,17722992,13896913.75,49.695388305076804,56.42233937509396,NaN,NaN,-28.64070285294173,-14.978365658046874,-0.08345713230543086,0.11801115993660716,0.20146829224203802,161912117,156670104,45.00287645225942,60.801848796717366,NaN,NaN,6.698326419120923,9.427658524688416
2011-04-18T09:30:00-04:00,36.75,36.75,36.24001,36.60001,18557408,14252112.85,41.76906989500992,55.25954181426215,NaN,NaN,-120.18111938806882,-46.520870383646574,-0.1169021358010505,0.05534062249072491,0.1722427582917754,143354709,150530127.8,42.5719632745314,60.133522572396046,NaN,NaN,3.3930269664581814,8.565568302084097
2011-04-19T09:30:00-04:00,36.69,36.98,36.69,36.92,15718469,14449883.55,47.24059880628081,54.3878318454147,NaN,NaN,-72.3953695883561,-60.613593529515484,-0.11288590302848614,0.031135379506167737,0.14402128253465388,159073178,150543650.8,42.57932006774336,59.159006542719744,NaN,NaN,2.04928248316272,7.634670327952472
2011-04-20T09:30:00-04:00,37.47,37.7,37.39,37.52,18141856,14678936.1,55.65460824017072,54.02011845472937,NaN,NaN,31.467417759566843,-49.69097837354299,-0.06747335681316288,0.05967958651820027,0.12715294333136315,177215034,157148832.6,46.20432304266158,58.195917536233786,NaN,NaN,3.5038226209197902,7.044549226947804
2011-04-21T09:30:00-04:00,37.78999,37.78999,37.45,37.63,9808734,14271866.4,57.00828213577535,53.54566876877736,NaN,NaN,41.70038432179997,-29.60987794959997,-0.02961187386708504,0.09013810099750685,0.1197499748645919,187023768,165715761.2,50.563576638475176,57.29368270434226,NaN,NaN,5.101525711391663,6.7669744390112125
2011-04-25T09:30:00-04:00,37.61,37.67,37.41,37.52,9686824,14058045.7,55.19384918593638,52.90976601448772,NaN,NaN,21.900983029415237,-19.501540773128575,-0.012440407178413132,0.10419946589157547,0.1166398730699886,177336944,168800726.6,52.069781347957424,56.193631551265014,NaN,NaN,5.875293623515231,6.639591465368929
2011-04-26T09:30:00-04:00,37.84,38.35001,37.75999,38.24001,13168070,14260220.3,63.40424674612387,53.023634358386815,NaN,NaN,120.16835161238488,28.568353426962165,0.04386045484371576,0.17146544162463329,0.12760498678091753,190505014,178230787.6,56.43881629766125,55.2369939828872,NaN,NaN,9.364795577367026,7.028906338511515
2011-04-27T09:30:00-04:00,38.34,38.49001,37.99001,38.41,15939055,14514921.1,65.0333553578129,53.22425976783127,NaN,NaN,138.84705958331946,70.81683926129729,0.08653452127688771,0.23577313837702718,0.14923861710013947,206444069,187704965.8,60.34936735179911,54.40634772408304,NaN,NaN,12.714135898190095,7.841081989894169
2011-04-28T09:30:00-04:00,38.41,38.63,38.34,38.53999,17645152,14655962.5,66.26989568971203,53.735353352541225,NaN,NaN,149.24236395721732,94.37182850082738,0.11568059492099603,0.2938393607513845,0.17815876583038848,224089221,197079803.2,63.81129660797737,53.76778968451076,NaN,NaN,15.820238397870897,8.980961476747988
2011-04-29T09:30:00-04:00,38.64999,38.87,38.64,38.7,17245632,14878717.35,67.78031484034744,54.73360007293051,NaN,NaN,156.93656977841562,117.41906559215049,0.1364718462158697,0.3487485736002256,0.2122767273843559,241334853,207942020.2,67.36654935155619,53.57555763033314,NaN,NaN,18.855483098665676,10.391607422736229
2011-05-02T09:30:00-04:00,38.96001,38.98,38.57001,38.64,15338688,14692130.95,66.57641865824962,55.67935541882015,NaN,NaN,139.32106404083052,140.90308179443355,0.13658497381379148,0.38300794465159527,0.2464229708378038,225996165,217673864.4,70.1920233250872,53.978362680311996,NaN,NaN,20.988410819099894,11.90543647935961
2011-05-03T09:30:00-04:00,38.58,38.64999,38.28999,38.48,16566910,15001741.5,63.34529744354976,56.701221146319256,NaN,NaN,97.96301191495496,136.46201385494757,0.11703845257928414,0.39272103656190893,0.2756825839826248,209429255,221458712.6,71.23513001298355,54.81908956364378,NaN,NaN,21.87842271758036,13.33014879910543
2011-05-04T09:30:00-04:00,38.47,38.52,37.82001,37.92,28948736,15720333.2,53.54947763584757,57.13883487943608,NaN,NaN,48.44686030821094,118.38197399992586,0.06040048543457377,0.35118319077584204,0.29078270534126827,180480519,216266002.6,67.73304166824768,55.936293779625075,NaN,NaN,19.63650446989472,14.231056752075329
2011-05-05T09:30:00-04:00,37.71001,38.22,37.53,37.74001,34754992,16759355.45,50.828774957955886,57.3821127069892,NaN,NaN,17.858888434159255,92.10527889531426,0.0075970599048758025,0.300279030222363,0.2926819703174872,145725527,200593263.8,58.40077765744674,56.75134593545632,NaN,NaN,16.932595236028448,14.61699082121149
2011-05-06T09:30:00-04:00,38.42,38.52,37.92999,38.07001,26419296,17408498.95,55.31177925610727,57.783283489205665,NaN,NaN,55.729907116561364,71.86394636294341,-0.007505851274037301,0.2832996562249406,0.2908055074989779,172144823,186755257.8,51.63601645557341,57.22514164997875,NaN,NaN,15.980817812898835,14.811823248595395
2011-05-09T09:30:00-04:00,38.06,38.39,37.97,38.23,10792988,17134112.4,57.34235227946483,58.89566080238102,NaN,NaN,53.04774346873811,54.60928224852493,-0.009019624550152483,0.27953097681128725,0.28855060136143973,182937811,178143587,47.91625336054251,57.6068766561224,NaN,NaN,15.810171927818992,14.95444448848448
2011-05-10T09:30:00-04:00,38.36,38.59,38.36,38.58,15208605,17277402.6,61.46726937474006,59.911851557270964,NaN,NaN,80.5777317515186,51.13222621583764,0.010209916893208437,0.30131299747795026,0.2911030805847418,198146416,175887019.2,46.96158840798244,57.919895823282346,NaN,NaN,16.948252562662564,15.239274213367063
2011-05-11T09:30:00-04:00,38.5,38.55,37.92999,38.06,21212000,17585551.25,53.23145350402494,59.7387690761177,NaN,NaN,39.089115802447395,49.26067731468493,-0.014111716187040935,0.27346343535094064,0.2875751515379816,176934416,175177798.6,46.647023910365675,57.95151731383264,NaN,NaN,15.242061092570863,15.239672338967605
2011-05-12T09:30:00-04:00,37.92,38.25999,37.7,38.14,18101536,17749806.15,54.24712307717207,59.5415434290746,NaN,NaN,17.32432008405696,49.15376364466447,-0.026132639790269918,0.2549093518001442,0.2810419915904141,195035952,185039883.6,51.510906430307635,58.01918372753495,NaN,NaN,14.202077304703334,15.091444476929851
2011-05-13T09:30:00-04:00,38.17999,38.28,37.58,37.67999,20606032,18079198.75,47.816692276103524,59.01460364980083,NaN,NaN,-14.166192103261478,35.17454380069991,-0.06421617538474089,0.20077177235948795,0.26498794774422885,174429920,185496903,51.73051418777528,57.99495035895052,NaN,NaN,11.181300783021532,14.532852520657235
2011-05-16T09:30:00-04:00,37.5,37.88,37.45,37.53999,17250912,18055594.75,46.02841513229673,57.77347282024175,NaN,NaN,-52.91096237703576,13.982802631545145,-0.09607019714111215,0.14490020131783865,0.2409703984589508,157179008,180345142.4,49.0345652546233,57.46607528444781,NaN,NaN,8.172572856383615,13.624241140046717
2011-05-17T09:30:00-04:00,37.33,37.39999,36.88,37.03,33980752,18826761.95,40.13937860118557,55.995331623339794,NaN,NaN,-147.9863818844271,-31.730020095643994,-0.1457427738763632,0.05879193111349679,0.20453470498985998,123198256,165355510.4,42.15128208811419,56.166212051327456,NaN,NaN,3.5485006094148543,12.184849635670737
2011-05-18T09:30:00-04:00,37.14999,37.58,36.91,37.53,21989504,19140313.7,47.26337349275342,54.63772289498561,NaN,NaN,-121.45409017229115,-63.8386612905917,-0.1391923775754996,0.03054423302048548,0.16973661059598508,145187760,159006179.2,39.61457675826118,54.43787491920487,NaN,NaN,1.9636311847572112,10.724675571254519
2011-05-19T09:30:00-04:00,37.7,37.98,37.59,37.77,18037344,19135088.1,50.31965200834127,53.39053269269946,NaN,NaN,-47.25600686977098,-76.7547266813573,-0.11402123860207947,0.027210062343385744,0.1412313009454652,163225104,152644009.6,37.19883495507068,52.283038176598765,NaN,NaN,1.6923418962389876,9.434342189109444
2011-05-20T09:30:00-04:00,37.72,37.72,37.25,37.37,17181824,19503742.6,45.57859724973327,51.89068830637687,NaN,NaN,-104.20764495494629,-94.76301725169425,-0.11908191893995897,-0.007621097729483495,0.11146082121047547,146043280,146966681.6,35.13955595616075,49.77929050738974,NaN,NaN,-0.11707616796705798,8.06985385238423
2011-05-23T09:30:00-04:00,36.87,37.05,36.64999,36.84,25556608,20297231.8,40.17707444746604,50.23581523522803,NaN,NaN,-185.22727756389224,-121.22628028906556,-0.15085091322403393,-0.07710282031956694,0.07374809290446699,120486672,139628214.4,32.625423980954196,47.021454362244775,NaN,NaN,-3.533313775135565,6.412258477024259
2011-05-24T09:30:00-04:00,37.03,37.05,36.58,36.64999,20280624,20652859.5,38.41919615031568,49.15508084340432,NaN,NaN,-163.59459315060684,-124.34792254230152,-0.17565359082080972,-0.14581889562154515,0.029834695199264558,100206048,135029772.8,31.122766499397784,44.40643470732693,NaN,NaN,-6.83766216290944,4.519412671319445
2011-05-25T09:30:00-04:00,36.5,37.14,36.42,36.96001,20896016,20900707.55,42.8154911554407,48.58270342893895,NaN,NaN,-132.2006096233366,-126.49722643251059,-0.1624786222305673,-0.1732635825889446,-0.010784960358377275,121102064,130212633.6,29.585510806616497,42.34820136083905,NaN,NaN,-8.143920410553816,2.7103650881946937
2011-05-26T09:30:00-04:00,36.81,37.17999,36.71001,37.11,17463664,20891633.15,44.86625769175169,47.8365947457707,NaN,NaN,-98.55772738027639,-136.7575705346117,-0.1360330734783145,-0.18082630220627038,-0.044793228727955894,138565728,125280758.4,28.057506583470982,40.6640220842603,NaN,NaN,-8.555165003682168,1.1010036464979993
2011-05-27T09:30:00-04:00,37.24001,37.39,37.16,37.28999,14888609,20773782,47.30828714957322,47.1198758079213,NaN,NaN,-55.468599265751934,-127.00976139677282,-0.10043152473351008,-0.1703326346448435,-0.06990110991133341,153454337,126762969.8,29.240314254086883,39.3300264337992,NaN,NaN,-8.147710713479896,-0.22024126207027117
2011-05-31T09:30:00-04:00,37.59,37.74001,37.28999,37.63,21659520,21089823.6,51.66375058316794,46.41962446566615,NaN,NaN,-13.142344731417474,-92.59277483027786,-0.05051645826436704,-0.1330466827417922,-0.08253022447742517,175113857,137688406.8,37.409028271327045,38.64770070975238,NaN,NaN,-6.448093803702857,-1.1099344823034978
2011-06-01T09:30:00-04:00,37.47,37.56,36.28,36.39999,35595152,22041235.7,39.07916394770284,45.408746640214574,NaN,NaN,-115.89988162690835,-83.05383252553816,-0.09432645776976625,-0.20043829668963298,-0.10611183891986672,139518705,145550938.2,42.54914033178188,38.35499473985353,NaN,NaN,-9.311376730961578,-2.281569089254652
2011-06-02T09:30:00-04:00,36.5,36.825,36.3,36.59,32240608,22205829.3,41.451736708931584,44.494790471054536,NaN,NaN,-124.10760030379227,-81.43523066162929,-0.1037475722531884,-0.23579630423635223,-0.13204873198316383,171759313,155682388,48.42648928082139,38.134679229175944,NaN,NaN,-10.71557779933474,-3.4864274764089505
2011-06-03T09:30:00-04:00,36.07001,36.38879,35.98,36.10001,21335696,21534864.5,37.40606068581777,43.75117392889126,NaN,NaN,-154.92533903286352,-92.70875299214671,-0.1342800791322455,-0.2998988308984707,-0.1656187517662252,150423617,158053965.8,49.72308338621778,37.991291314778984,NaN,NaN,-13.285794378226603,-4.886337033811472
2011-06-06T09:30:00-04:00,35.95,36.16499,35.771,35.84,22800416,21353920.5,35.4299708534257,42.9941421946862,NaN,NaN,-160.95233057556567,-113.80549925410946,-0.16146139551886973,-0.36744549616481237,-0.20598410064594264,127623201,152887738.6,46.95379096008767,37.842664579455004,NaN,NaN,-16.00426832038023,-6.4746129318927235
2011-06-07T09:30:00-04:00,36.00999,36.12,35.8,35.82001,16412156,21634878.9,35.27567740058265,42.64673496607169,NaN,NaN,-143.16403041984776,-139.80983639179553,-0.16943184225802915,-0.4177739034684791,-0.24834206121044994,111211045,140107176.2,40.88702277032019,37.75236034246972,NaN,NaN,-18.17118647443402,-8.145552009398623
2011-06-08T09:30:00-04:00,35.73,35.78999,35.45,35.50999,29280000,22338448.65,32.883895559563186,41.619629399415246,NaN,NaN,-162.47239201527304,-149.12433846946846,-0.18306633168593378,-0.47717497581786716,-0.2941086441319334,81931045,128589644.2,36.33125773238234,37.517837554906954,NaN,NaN,-20.735962984249305,-9.944182148663005
2011-06-09T09:30:00-04:00,35.64999,35.92999,35.5498,35.78,20611120,22308404.65,36.89691804377212,40.660862687660305,NaN,NaN,-128.95405592996238,-150.09362959470246,-0.16210278613008156,-0.4967371267945353,-0.33463434066445374,102542165,114746214.6,31.75180850590374,37.12876423710931,NaN,NaN,-21.660568768619505,-11.617951665799648
2011-06-10T09:30:00-04:00,35.59,35.66,35.16,35.21001,23679792,22587317.45,32.481668516440024,39.72536777813936,NaN,NaN,-153.90389937063182,-149.88934166225613,-0.17379017878761022,-0.5518720641489665,-0.3780818853613563,78862373,100433965.8,27.844157566045965,36.60766435210111,NaN,NaN,-23.885498084301013,-13.370458297014128
2011-06-13T09:30:00-04:00,35.38,35.455,35.05,35.22,22249664,22669499.05,32.633824833123256,39.18656423425773,NaN,NaN,-140.54015212348418,-145.80690597183985,-0.16792080289532502,-0.5879828889805125,-0.4200620860851875,101112037,95131733,26.540990716045798,36.17306197603622,NaN,NaN,-25.5984353945895,-15.117312168096324
2011-06-14T09:30:00-04:00,35.61,36.03999,35.58,35.89,20142032,22814055.05,42.06383250370178,39.44689540235674,NaN,NaN,-71.56200617688947,-131.48650112324816,-0.10885184521712366,-0.5561268926065921,-0.44727504738946844,121254069,97140337.8,27.917304151269136,35.94410037974132,NaN,NaN,-24.13455269978919,-16.40548938690959
2011-06-15T09:30:00-04:00,35.57001,35.78,35.25999,35.345,28389008,22534467.85,37.469198315167965,39.06501734233726,NaN,NaN,-95.85287678581547,-118.16259807735669,-0.09682527885573738,-0.5683066459591402,-0.47148136710340277,92865061,99327141,29.466713914108695,35.935614887419334,NaN,NaN,-24.365276028909026,-17.54260176433808
2011-06-16T09:30:00-04:00,35.34,35.71001,35.17999,35.47,25782016,22724093.45,39.1119516161648,38.65399547979534,NaN,NaN,-86.77340294101107,-109.72646747956642,-0.07193590533670274,-0.5614012487742812,-0.48946534343757847,118647077,102548123.4,31.792297859744295,36.20238569286742,NaN,NaN,-24.033614030830613,-18.46988923097987
2011-06-17T09:30:00-04:00,35.66,35.7384,35.33,35.45,29131440,23278798.25,38.93570084965301,38.05595360122961,NaN,NaN,-75.14917295668427,-93.97552219677692,-0.04937872034700597,-0.5511887438713359,-0.5018100235243299,89515637,104678776.2,33.357597780034936,36.49647737329229,NaN,NaN,-23.820537761150902,-19.234267592432875
2011-06-20T09:30:00-04:00,35.28999,35.82001,35.28999,35.75999,15241324,23181773.25,43.20753714953912,37.45193835597041,NaN,NaN,-58.384022081712644,-77.54429618842263,-0.008294055881491125,-0.5121775933761938,-0.5038835374947027,104756961,105407761,33.91638747919285,36.24700303099699,NaN,NaN,-22.36966108743447,-19.682180948861674
2011-06-21T09:30:00-04:00,36,36.39999,35.95,36.32001,20737824,22940834.05,50.011168125742024,38.23279579725893,NaN,NaN,9.597479021363005,-61.31239914877212,0.058224782097472616,-0.43110255987286195,-0.48932734197033456,125494785,106255904.2,34.6034370407794,35.679452795925386,NaN,NaN,-18.93715494648773,-19.575748662808255
2011-06-22T09:30:00-04:00,36.21001,36.53,36.09,36.12,14292184,22641412.05,47.80831112724573,38.686836827138514,NaN,NaN,15.913264904429303,-38.95917081072317,0.08856219480141225,-0.3786245984685692,-0.46718679326998147,111202601,109923412.2,37.62340624779548,34.90780400785211,NaN,NaN,-16.761862638917698,-19.173764945109603
2011-06-23T09:30:00-04:00,35.59,36.07001,35.33,36.03999,22866384,22739930.45,46.9180115877316,39.36626189156093,NaN,NaN,-31.32197697140207,-27.868885616801332,0.10208772229139551,-0.33957714040573705,-0.44166486269713257,88336217,103861240.2,34.76556104522973,33.83940955492439,NaN,NaN,-15.243047485498703,-18.612233879450905
2011-06-24T09:30:00-04:00,36.03999,36.10001,35.57001,35.63,12507805,22492137.5,42.545782225941664,39.874534132454926,NaN,NaN,-32.54979813557969,-19.349010652580418,0.08307562405284008,-0.33782033263108247,-0.42089595668392255,75828412,101123795.2,33.52711083658578,32.88036097467425,NaN,NaN,-15.199452989533278,-18.124693752319814
2011-06-27T09:30:00-04:00,35.60001,36.06,35.5,35.91,11199746,22307694.35,46.231012636937415,40.65705807790884,NaN,NaN,-17.58505696516147,-11.189217629270184,0.08851042167772327,-0.31025792958676846,-0.3987683512644917,87028158,97578034.6,31.93998031522264,32.24128651359585,NaN,NaN,-14.0655710410268,-17.544819079277953
2011-06-28T09:30:00-04:00,36.06,36.48,35.95,36.47,13263867,21887911.7,52.75764233062047,42.07661141869865,NaN,NaN,91.66622292874833,5.224531152206879,0.126650371656784,-0.24045538669351174,-0.36710575835029574,100292025,92537482.6,29.78164661331529,31.773457147948204,NaN,NaN,-10.997560417211517,-16.609496413268463
2011-06-29T09:30:00-04:00,36.73,36.78,36.37,36.66,19847120,21100510.1,54.7639257350255,43.35282625378818,NaN,NaN,161.39862513069642,34.321603197460306,0.1593887208978947,-0.16786985722792735,-0.32725857812582204,120139145,94324791.4,31.547994734603947,31.75889902142679,NaN,NaN,-7.856911652490452,-15.359127161728747
2011-06-30T09:30:00-04:00,36.74001,37.34,36.69,37.24001,18578464,20417402.9,60.30577387178851,45.340262350598785,NaN,NaN,237.1452730884661,88.01505320943394,0.21155150100765396,-0.06281920186625456,-0.2743707028739085,138717609,104401069.8,40.61724252817642,32.67126223300754,NaN,NaN,-3.2733049297703105,-13.632581128591827
2011-07-01T09:30:00-04:00,37.22,37.99001,37.2,37.91,23998608,20550548.5,65.55519028524091,47.691788454321475,NaN,NaN,263.5206231705775,147.22913747066536,0.2784148236709078,0.07364782671472625,-0.20476699695618156,162716217,121778630.8,52.34395847071571,34.5143313583411,NaN,NaN,2.5618207310963115,-11.319095148636379
2011-07-05T09:30:00-04:00,37.88,37.89,37.58,37.69501,19248784,20372966.9,62.6902327443695,49.16510275722631,NaN,NaN,201.37456674128575,191.0210622119548,0.29387515592342245,0.16257694794809652,-0.13129820797532593,143467433,133066485.8,58.12818291726434,36.6722512701979,NaN,NaN,6.331464856521007,-8.797586576471037
2011-07-06T09:30:00-04:00,37.63,38,37.60001,37.89999,19802784,20542498.3,64.29254769492107,51.08105628435153,NaN,NaN,171.7535175122717,207.0385211286595,0.30243833681254767,0.24674971304035864,-0.055688623772189014,163270217,145662124.2,63.458006699818824,39.10020075489148,NaN,NaN,9.904737248001313,-6.125826030117844
2011-07-07T09:30:00-04:00,38.31,38.42999,38.105,38.3,30538368,20605416.7,67.24851973439382,53.09081114993933,NaN,NaN,176.13676944509362,209.98614999153892,0.31798666158270916,0.3417947032061974,0.023808041623488277,193808585,160396012.2,68.50782309522765,41.72273827171164,NaN,NaN,13.884442395783442,-3.267216254989089
2011-07-08T09:30:00-04:00,37.78999,37.84,37.57001,37.82001,21673760,20658548.7,60.74973881956099,54.64895671921846,NaN,NaN,109.3789162685899,184.4328786275637,0.28021377025256217,0.374075254439191,0.09386148418662882,172134825,167079455.4,70.49933428721907,44.37571945079622,NaN,NaN,15.224658233641343,-0.625519899470456
2011-07-11T09:30:00-04:00,37.38,37.46001,36.98,37.12,20456144,20497366.3,52.74435928854194,55.33015830057581,NaN,NaN,56.834369191350504,143.09562783171833,0.19632046479764836,0.3392620651836893,0.14294160038604092,151678681,164871948.2,68.94840902865218,46.87800670432903,NaN,NaN,13.695881656451128,1.4203946085183414
2011-07-12T09:30:00-04:00,36.98,37.12,36.72,36.75999,31263584,20948062.3,49.1566688771349,55.26912263996102,NaN,NaN,25.940110199340566,108.00873652332928,0.10916815461646717,0.2794017936566249,0.1702336390401577,120415097,160261481,65.69766139723994,49.0990227297905,NaN,NaN,11.243899560552212,2.8237524588088943
2011-07-13T09:30:00-04:00,37.02,37.34,36.81,36.91,15477109,20714816.15,50.662601410340024,55.473000517324884,NaN,NaN,34.24363552256065,80.50676012538706,0.05684130011580746,0.24128526418491703,0.18444396406910957,135892206,154785878.8,61.96128145135944,50.83744238718793,NaN,NaN,9.756137312373163,3.8140931521752184
2011-07-14T09:30:00-04:00,36.91,37.14,36.39999,36.50999,20189984,20304864.95,46.69121609761896,55.45680083945971,NaN,NaN,0.8296078346835672,45.44532780330507,-0.006145117540306971,0.17676256714372585,0.18290768468403282,115702222,139164606.2,52.74507415864643,52.12169332386055,NaN,NaN,7.231608228972439,4.302309591717679
2011-07-15T09:30:00-04:00,36.66,36.67,36.19,36.53999,17200800,19875804.15,47.026604039066555,55.7768595403972,NaN,NaN,-24.881016298708722,18.593341289845313,-0.045054651194414375,0.12658937069101484,0.1716440218854292,132903022,131318245.6,48.81733661135962,53.21385230777297,NaN,NaN,5.320285327876997,4.447734696883296
2011-07-18T09:30:00-04:00,36.34,36.45,35.91,36.13,17277360,19283100.15,43.0412220415269,55.54901735501073,NaN,NaN,-59.843199828530885,-4.742172514130965,-0.09481000359316033,0.05313151739397881,0.14794152098713914,115625662,124107641.8,45.4665942940931,54.18003902054942,NaN,NaN,2.4461884920455876,4.161799524763623
2011-07-19T09:30:00-04:00,36.35001,36.69,36.2731,36.601,15177863,19279927.1,48.446486330982395,55.241077640750866,NaN,NaN,-30.15462643192458,-15.961119840384,-0.09231623245005385,0.03254623042457183,0.12486246287462568,130803525,126185327.4,46.60387986889902,55.38162711023398,NaN,NaN,1.602391870682685,3.796169859894918
2011-07-20T09:30:00-04:00,36.77,36.81,36.535,36.67,9926301,18739350.95,49.206941303155574,54.844150181331585,NaN,NaN,-16.99253723396044,-26.20835439168822,-0.08264874399602154,0.021551532879598767,0.1042002768756203,140729826,127152851.4,47.15654833739205,56.496523796147414,NaN,NaN,1.1440419617390578,3.417294445872652
2011-07-21T09:30:00-04:00,36.89999,37.35001,36.84,37.22,18066352,18928059.35,54.91566686949618,54.4591425383107,NaN,NaN,30.269076182607222,-20.320460722103487,-0.03810702472704615,0.056566495966812624,0.09467352069385877,158796178,135771642.6,51.92965881614925,57.30455353100262,NaN,NaN,2.4872378239310313,3.2844292141667064
2011-07-22T09:30:00-04:00,37.06,37.09,36.7,36.83,20127696,18791124.95,50.57499231155044,53.38912839733281,NaN,NaN,-6.059605980751932,-16.55617865851213,-0.033943514106152026,0.05224412806116874,0.08618764216732076,138668482,136924734.6,52.547211944904994,57.31907163630185,NaN,NaN,2.2940144542485363,3.1429413913212536
2011-07-25T09:30:00-04:00,36.5,37.028,36.45,36.81,13278613,18829665.35,50.355178399785665,52.50805308700539,NaN,NaN,-28.17766514884448,-10.223071722574849,-0.031616640769359966,0.04666684120562081,0.07828348197498078,125389869,138877576,53.63360785878459,56.99803056069616,NaN,NaN,2.075132567499458,2.990397273632426
2011-07-26T09:30:00-04:00,36.67999,36.71001,36.045,36.13,24912016,19515278.85,43.44179404829209,51.01871354081761,NaN,NaN,-98.4250963629319,-23.877165708776307,-0.07261051204590892,-0.012479658082405365,0.06013085396350355,100477853,132812441.6,49.81875820931376,56.02379852566008,NaN,NaN,-0.2905396192950996,2.521692003214208
2011-07-27T09:30:00-04:00,35.96001,35.98,35.05,35.14999,42181552,20961163.1,35.81100640875343,48.77317687470043,NaN,NaN,-201.37656853967778,-60.75397196991978,-0.1575884635897268,-0.13685472552365496,0.02073373806607185,58296301,116325736.6,41.23324845034948,54.075614622454495,NaN,NaN,-5.132700404680131,1.4282073735150167
2011-07-28T09:30:00-04:00,35.19,35.50999,34.77,34.85001,32606272,21599120.7,33.85090570258629,46.85183165205938,NaN,NaN,-208.17138955274697,-108.44206511699062,-0.2219229979811826,-0.2566700094104064,-0.03474701142922381,25690029,89704506.8,31.725787845552716,51.30607559090691,NaN,NaN,-9.68718692258013,-0.1597060973557185
2011-07-29T09:30:00-04:00,34.50999,35.02,34.1937,34.67999,27382144,22039304.7,32.756564868030125,45.42413205059425,NaN,NaN,-205.35414955072213,-148.30097383098465,-0.2611465648378565,-0.3611802174765444,-0.10003365263868794,-1692115,61632387.4,25.14232737712564,48.17706975865501,NaN,NaN,-13.67661904581961,-2.0906936614219886
2011-08-01T09:30:00-04:00,35.16,35.215,34.06,34.46001,36471568,22662952.7,31.344634151627403,44.15184385591514,NaN,NaN,-175.48812699756,-177.76306620072776,-0.28516802417405945,-0.45649368285626224,-0.17132565868220279,-38163683,28921677,19.947892626325597,44.909229132161116,NaN,NaN,-17.38430857314927,-4.275495791668742
2011-08-02T09:30:00-04:00,34.12,34.42999,33.25999,33.25999,43640144,23882520.7,25.011196811054972,42.319600670251916,NaN,NaN,-203.52497714068977,-198.78304235627934,-0.36029576007542563,-0.6216953587764849,-0.2613995987010592,-81803827,-7534659,15.98426230801033,41.62515633620761,NaN,NaN,-23.160136675559944,-6.9733016322246275
2011-08-03T09:30:00-04:00,33.28999,33.58,32.67,33.56,49331296,25358946.3,28.880196976269318,41.04738501872695,NaN,NaN,-185.29179295457942,-195.56608723925964,-0.3669680028021177,-0.7201096022037063,-0.3531415994015886,-32472531,-25688425.4,14.445065855301607,38.88944145739726,NaN,NaN,-26.46913510232694,-9.7584206993821
2011-08-04T09:30:00-04:00,33,33.07001,31.7,31.75999,49619584,26313007.1,21.65955607097206,39.23545302100591,NaN,NaN,-200.20956010281708,-193.9737213492737,-0.46356587468310984,-0.932598942755476,-0.4690330680723661,-82092115,-47244854.2,12.86133213293894,36.321155423224354,NaN,NaN,-32.53659173131893,-13.012445132515932
2011-08-05T09:30:00-04:00,32.21001,32.41,30.97,31.75999,67180752,28588356.7,21.65955607097206,37.708191165966284,NaN,NaN,-183.13859355186466,-189.5306101495022,-0.49553457525808886,-1.0884512871449772,-0.5929167118868883,-82092115,-63324854.2,11.820253919934757,33.917845396498755,NaN,NaN,-36.954471502137686,-16.432734613890467
2011-08-08T09:30:00-04:00,30.62,31.17999,29.5,29.52,64519520,30791525.5,15.916299409015707,35.3846063858258,NaN,NaN,-207.82932258020222,-195.99884926603062,-0.6271406164652358,-1.376842482468433,-0.7497018660031973,-146611635,-85014444.6,10.576615551443709,31.34446937382338,NaN,NaN,-43.627117432333925,-20.317646445096674
2011-08-09T09:30:00-04:00,29.92,30.98,29.03,30.98,55588992,32007795.9,29.110473472085346,33.94914439789222,NaN,NaN,-163.1365716652164,-187.92116817093597,-0.5767443080646748,-1.4706322510840408,-0.893887943019366,-91022643,-86858207.8,10.475715939681606,28.724409916844056,NaN,NaN,-43.36639643085765,-23.6103250144911
2011-08-10T09:30:00-04:00,30.38,30.55,29.38,29.39999,45041920,33486036.45,24.60986453317662,31.78444423101225,NaN,NaN,-153.27795290009917,-181.51840016003993,-0.6076061299046267,-1.6533956054001493,-1.0457894754955226,-136064563,-107576614.2,9.391504833884468,25.685970346682286,NaN,NaN,-45.092796288586655,-26.679249482219035
2011-08-11T09:30:00-04:00,29.66,31.25999,29.45,30.8,40562960,34504685.25,34.30220747137861,30.622102456714263,NaN,NaN,-111.43408461198123,-163.76330506187276,-0.4962183740441066,-1.6660624430506559,-1.1698440690065492,-95501603,-110258511.8,9.2579330575836,22.593878997587897,NaN,NaN,-42.258836903794425,-28.904904828158376
2011-08-12T09:30:00-04:00,31.2,31.57001,30.86,31.39999,29823728,35135831.65,37.98204982677878,29.738307558642344,NaN,NaN,-78.22694857571506,-142.78097606664284,-0.35143489429326147,-1.609137686873126,-1.2577027925798645,-65677875,-106975663.8,10.927924907785425,19.543473072516527,NaN,NaN,-38.70875493569994,-30.305454843521456
2011-08-15T09:30:00-04:00,31.59,31.94,31.5274,31.87,36619264,36102926.85,40.78033611306695,29.548203420411973,NaN,NaN,-57.117671373136815,-112.63864582522974,-0.20080343977349924,-1.5087070922967385,-1.3079036525232393,-29058611,-83465059,21.99930735820743,17.556369440294645,NaN,NaN,-34.99832122614583,-30.97586432675351
2011-08-16T09:30:00-04:00,31.50999,31.78,31.14999,31.42,29966800,36842373.7,38.96746475861178,29.77366473111614,NaN,NaN,-60.23012893436472,-92.0573572790594,-0.11265815494656217,-1.448726346206442,-1.3360681912598797,-59025411,-77065612.6,24.741385275160155,16.378379213495403,NaN,NaN,-32.76714083864098,-31.231760971308862
2011-08-17T09:30:00-04:00,31.69,31.87,31.08,31.32001,28800512,37786084.25,38.55730635900764,30.109836206574812,NaN,NaN,-55.11437477192039,-72.42464165342366,-0.04570512097227519,-1.3931995924752236,-1.3474944715029484,-87825923,-67417884.6,28.80487279858238,16.169742424426094,NaN,NaN,-31.18831423748106,-31.225554295047747
2011-08-18T09:30:00-04:00,30.41,30.44,29.3,29.58501,36126864,38689109.85,32.22002577287407,30.071511985492236,NaN,NaN,-97.475285864433,-69.632881903914,-0.09978311524851025,-1.4722233655635861,-1.3724402503150759,-123952787,-73108121.4,27.849761115577778,16.36313054860125,NaN,NaN,-31.978567450854513,-31.33312760302014
2011-08-19T09:30:00-04:00,29.13,30.06,29.09,29.13,36632864,39514368.25,30.790729144896517,30.031947342154318,NaN,NaN,-101.84625931768417,-74.35674405230782,-0.14497275803822474,-1.553656197862857,-1.4086834398246322,-160585651,-92089676.6,24.885474108308898,16.715814940171487,NaN,NaN,-33.081245058590476,-31.58285866810162
2011-08-22T09:30:00-04:00,29.89999,29.89999,29.14,29.24001,26084464,40154660.8,31.58098767576108,30.501218118204754,NaN,NaN,-97.66268708795347,-82.46574719527116,-0.1458337599139976,-1.5909756397171293,-1.4451418798031317,-134501187,-113178191.8,22.074317991045618,17.150818917531147,NaN,NaN,-33.694916277478924,-31.884581183726947
2011-08-23T09:30:00-04:00,29.35001,30.27,29.172,30.27,30759248,40447022.4,38.64483894223603,31.19869254434523,NaN,NaN,-76.78774100549725,-85.77726960949767,-0.059821934315371195,-1.5199192976973457,-1.4600973633819745,-103741939,-122121497.4,20.991348703906326,17.618410549574346,NaN,NaN,-31.955425433810642,-31.89470179088176
2011-08-24T09:30:00-04:00,30.17999,30.935,30.09,30.88,19661264,39321008,42.4353856742437,32.68268037315035,NaN,NaN,-41.670101644398244,-83.08841498399323,0.04946478017444211,-1.398266388163922,-1.447731168338364,-84080675,-121372447.8,21.33943194392174,18.22398910750169,NaN,NaN,-29.31406315566655,-31.52603912870816
2011-08-25T09:30:00-04:00,31.09,31.25,30.19,30.3,23239552,38852672,39.91061456465695,33.98632740841356,NaN,NaN,-38.45755943400419,-71.28486969790747,0.09155499376769227,-1.3332874261287486,-1.424842419896441,-107320227,-118045935.8,22.96263585601865,19.01987353150768,NaN,NaN,-27.898903679619337,-31.00787692169547
2011-08-26T09:30:00-04:00,30.11,31.05,29.59,30.92999,24837296,38725429.6,43.82048351516578,35.9794834159957,NaN,NaN,-34.808110018382514,-57.877239838047146,0.1663313665564614,-1.2169282117008642,-1.3832595782573256,-82482931,-102425391.8,30.242126297574913,20.424552870517054,NaN,NaN,-25.503064076801657,-30.22147508671064
2011-08-29T09:30:00-04:00,31.28,31.94,31.28,31.91,22387120,38021207.2,49.342408599709366,37.424621639397415,NaN,NaN,50.76289240997155,-28.19212393846214,0.2796332455288666,-1.0337180213462425,-1.313351266875109,-60095811,-87544316.6,36.40709750836962,22.276794411137622,NaN,NaN,-21.676974547286022,-29.000832152507122
2011-08-30T09:30:00-04:00,31.81,32.41,31.56,32.17999,25620784,37120239.2,50.77781621471477,39.29376104522157,NaN,NaN,87.48711416205953,4.662847095049227,0.36519353530151166,-0.8568593477482196,-1.2220528830497313,-34475027,-73690934.2,41.582969092562195,24.57618471532889,NaN,NaN,-18.141445712063216,-27.44949123244371
2011-08-31T09:30:00-04:00,32.47,32.89,32.12,32.39999,32650432,36286196,51.97203682864952,40.555891713598065,NaN,NaN,128.57420818879103,38.71170906168708,0.42485812768382836,-0.6909802234449458,-1.1158383511287742,-1824595,-57239718.2,47.09025219926896,27.278493225449274,NaN,NaN,-14.89735567167923,-25.656329009477354
2011-09-01T09:30:00-04:00,32.45,32.78,31.84,31.87,39363888,35773411.2,48.89443257136751,41.335347623925834,NaN,NaN,104.38196590726868,67.27961412994166,0.41633313480160306,-0.5954219326267705,-1.0117550674283735,-41188483,-44013369.4,51.0831063204338,30.14672046920987,NaN,NaN,-13.010078482877695,-23.849721791391687
2011-09-02T09:30:00-04:00,31.17,31.3,30.73,30.85001,30905216,33959634.4,43.54953397096639,41.53314747091866,NaN,NaN,12.408647335120788,76.72296560064231,0.33329556244072656,-0.5951356143774653,-0.9284311768181919,-72093699,-41935523,51.6997794398083,32.268182760752794,NaN,NaN,-12.934926145867315,-22.290465270602493
2011-09-06T09:30:00-04:00,29.99001,30.60001,29.75,30.53,25692048,32018260.8,41.998345524035685,41.74963895416322,NaN,NaN,-44.812538333023475,57.60787945204331,0.2518193558809415,-0.613656981967015,-0.8654763378479565,-97785747,-49473510.2,49.27299209375541,34.02044039065245,NaN,NaN,-13.329332648241083,-21.010303467408004
2011-09-07T09:30:00-04:00,31.08,31.50999,30.95,31.48,26052384,30541430.4,47.928008083051026,42.41897479159489,NaN,NaN,37.35789716263077,47.58203605215756,0.2560680245127128,-0.5453913072070655,-0.8014593317197783,-71733363,-56925177.4,46.927915493101416,35.314943440260954,NaN,NaN,-11.885378872601978,-19.706742811007143
2011-09-08T09:30:00-04:00,31.12,31.56,30.88,31.005,24264640,29502566.4,45.427309755203595,43.36235221890414,NaN,NaN,18.722653462663533,25.611725106932067,0.22230086015219552,-0.523583256529534,-0.7458841166817295,-95998003,-75759859,41.54567134079002,36.29322274206183,NaN,NaN,-11.422814982998023,-18.523324549862984
2011-09-09T09:30:00-04:00,30.64,30.78999,29.99001,30.17999,34468576,29197847.2,41.38808903938772,44.119306497082086,NaN,NaN,-54.357259499192615,-6.136119974360199,0.1436327495746128,-0.5663431797134635,-0.7099759292880763,-130466579,-93615478.2,37.19085710343959,37.17217867028545,NaN,NaN,-12.255271790345999,-17.627888441360557
2011-09-12T09:30:00-04:00,29.74001,30.27,29.49001,30.235,30422384,29227780,41.75994050057532,44.846374555997386,NaN,NaN,-74.35750517355851,-23.489350476096053,0.09677896055603874,-0.5890022285930279,-0.6857811891490666,-100044195,-99205577.4,35.92137639679768,38.16125427069631,NaN,NaN,-12.819283665729603,-16.940944901984707
2011-09-13T09:30:00-04:00,30.35001,31.00999,30.17,30.8,41508624,29472248,45.57887831254068,45.34166308244772,NaN,NaN,-13.680522224487351,-17.262947254388827,0.10464771653028182,-0.5549715434862144,-0.6596192600164962,-58535571,-91355542.2,39.06681057410288,39.45235868999607,NaN,NaN,-12.20546637115531,-16.26444796900908
2011-09-14T09:30:00-04:00,30.98,31.78999,30.34,31.34,35106864,29729251.2,49.019633141567596,45.81196647297086,NaN,NaN,33.207551836815846,-18.09301631955181,0.14456905545401189,-0.47890794069898135,-0.6234769961529932,-23428707,-81694611,42.788843593065195,40.98445952207775,NaN,NaN,-10.682467992860484,-15.46702225813071
2011-09-15T09:30:00-04:00,31.67999,32,31.52,31.97501,32997648,29939108,52.79891843441283,46.732559606524845,NaN,NaN,90.79994713413288,-3.6775575852579507,0.2082214039741147,-0.3632002411853499,-0.5714216451594646,9568941,-60581222.2,49.979926204376824,42.914265975531904,NaN,NaN,-8.253202821018794,-14.43647662425758
2011-09-16T09:30:00-04:00,31.92999,32.2,31.64,31.97,30675968,29666563.2,52.76568309406181,47.371502433588844,NaN,NaN,90.05750257302365,25.205394829185302,0.24209196837813074,-0.26880668468680113,-0.5108986530649319,-21107027,-38709311.8,56.13141993076465,44.76350123504545,NaN,NaN,-6.288291182269178,-13.27245013254495
2011-09-19T09:30:00-04:00,31.49001,31.81,31.16,31.67,25728544,29121347.2,50.707356492884784,47.4689987116728,NaN,NaN,48.985300384026125,49.87395594070223,0.2361429872970297,-0.21571991894364473,-0.45186290624067443,-46835571,-28067587,58.787121067925995,46.362074346442334,NaN,NaN,-5.172853772093537,-12.115364938194748
2011-09-20T09:30:00-04:00,31.82001,32.03999,31.41,31.44,24276800,29030964,49.12516865776468,47.35095245760494,NaN,NaN,50.88330447303019,62.78672128020573,0.2094767607895141,-0.19001695525378182,-0.3994937160432959,-71112371,-30582947,57.894968248667496,47.527217143307,NaN,NaN,-4.647560440356761,-11.048535724217892
2011-09-21T09:30:00-04:00,31.36,31.39999,30.11,30.14,39438976,29464950.4,41.28417836490081,46.5875339959086,NaN,NaN,-68.32254629059754,42.48070165472306,0.10246091367030813,-0.2714175739554108,-0.3738784876257189,-110551347,-48007475,52.00701268336577,47.878414320742486,NaN,NaN,-6.485915864120958,-10.396732887061187
2011-09-22T09:30:00-04:00,29.32001,29.46001,28.64999,29.00999,49906128,30977193.6,35.91759662725413,45.66061714275765,NaN,NaN,-197.83882776297483,-15.24705332469848,-0.03869173595179087,-0.4222431575654575,-0.3835514216136666,-160457475,-82012758.2,42.848422987070464,47.29022265407367,NaN,NaN,-9.864564724765563,-10.320708863876098
2011-09-23T09:30:00-04:00,28.86,29.59,28.86,29.31,40959856,31863208.8,38.21397009575477,45.279505437385396,NaN,NaN,-154.6045902421317,-64.17947188772955,-0.10249249500075219,-0.5116670403646069,-0.40917454536385467,-119497619,-101690876.6,38.611019492737846,46.355311229282925,NaN,NaN,-11.928476820213785,-10.550390000495767
2011-09-26T09:30:00-04:00,29.62,30.11,29.14999,30.05,28701104,32056399.2,43.584112765854094,45.392774526086704,NaN,NaN,-100.84501500163925,-94.14553496486262,-0.08615331134717152,-0.5168661845478191,-0.43071287320064755,-90796515,-110483065.4,36.85719790369192,45.468468787135535,NaN,NaN,-12.054613561510344,-10.765279080640706
2011-09-27T09:30:00-04:00,30.78999,31.12,30.38,30.58,31931664,32533626.4,47.128536980456765,45.33566944732997,NaN,NaN,-20.81847515329857,-108.48589089012839,-0.03364583976079699,-0.4727701729016438,-0.4391243331408468,-58864851,-108033561.4,37.706153782827435,44.80977152211597,NaN,NaN,-11.072880402272185,-10.809222126588061
2011-09-28T09:30:00-04:00,30.63,30.91,29.75999,29.8,22879536,32396564,42.860707808963014,45.152340736884206,NaN,NaN,-59.47638194039421,-106.71665802008772,-0.044745768345833326,-0.49505654357313844,-0.4503107752273051,-81744387,-102272169.4,39.75777064719063,44.68206432971601,NaN,NaN,-11.557490067505995,-10.916117546719194
2011-09-29T09:30:00-04:00,30.42999,30.62,29.59,30.23,25937456,32060915.2,45.77594310128976,45.46575888416293,NaN,NaN,-54.38747489172212,-78.02638744583717,-0.01781034860343267,-0.47257371098159595,-0.4547633623781633,-55806931,-81342060.6,46.63391803234599,45.35656868178076,NaN,NaN,-11.068373086203062,-10.937868338074033
2011-09-30T09:30:00-04:00,29.71001,29.89,29.21001,29.22,35568288,31871135.2,40.543573830352734,45.37887555057559,NaN,NaN,-110.46097064110171,-69.19766352563117,-0.060303951118413246,-0.5301433012761798,-0.46983935015776657,-91375219,-75717580.6,48.340358356424915,46.24363882175413,NaN,NaN,-12.305175630718697,-11.133197951308984
2011-10-03T09:30:00-04:00,29,29.50999,28.36,28.39999,31693712,31910560,36.85977254604297,44.756082281540046,NaN,NaN,-150.44556231329108,-79.11777298796154,-0.13182457200790876,-0.6346200651676526,-0.5027954931597438,-123068931,-82172063.8,46.50268793908731,46.77477291925302,NaN,NaN,-14.555170007894178,-11.622051102249726
2011-10-04T09:30:00-04:00,28,29.19,27.67,29.19,37533776,32502646.4,42.29921071086608,44.27605210791852,NaN,NaN,-135.54865726588312,-102.06380941047844,-0.11474136657381084,-0.6462222013770074,-0.5314808348031965,-85535155,-87506124.6,44.980856168514904,46.931345246070855,NaN,NaN,-14.698763436632344,-12.061581435732958
2011-10-05T09:30:00-04:00,29.17,29.88499,29.00999,29.81,26507856,32525420,46.21528194081154,43.80579235837557,NaN,NaN,-59.70428310571813,-102.10938964354322,-0.05360665144039345,-0.5984891491036883,-0.5448824976632949,-59027299,-82962707,46.58434710205283,46.688803881619144,NaN,NaN,-13.560892592674891,-12.27576874386752
2011-10-06T09:30:00-04:00,29.8,30.45,29.49001,30.41,18317408,32228058.4,49.768250598610976,43.59169003727193,NaN,NaN,-12.234012008389842,-93.67869706687677,0.03077974089116542,-0.5064078215493382,-0.5371875624405036,-40709891,-79943299,47.67573626102949,46.084826476638064,NaN,NaN,-11.482748598447651,-12.162480151664681
2011-10-07T09:30:00-04:00,30.71001,30.74001,30.03999,30.34,26463280,31827793.6,49.35858765867418,43.495349406256885,NaN,NaN,9.00487731564542,-69.78552747552735,0.08248817188932889,-0.4340773475788424,-0.5165655194681713,-67173171,-75102889.4,49.458541336457486,45.418499352961746,NaN,NaN,-9.948344376333894,-11.846175040903141
2011-10-10T09:30:00-04:00,30.89999,31.41,30.75999,31.39999,19918800,31302614.4,55.351885209934416,43.940114874269014,NaN,NaN,69.32438389100496,-25.83153823466813,0.18292936311192542,-0.2879038155782645,-0.4708331786901899,-47254371,-59939977.4,54.66905665375503,45.188077096182276,NaN,NaN,-6.6930747326820565,-11.110017854014414
2011-10-11T09:30:00-04:00,31.12,31.61,31.11,31.49001,17798816,30117124,55.829975141933616,44.97910035834279,NaN,NaN,79.8750237022038,17.25319795894925,0.24633185872309393,-0.16291835528632248,-0.4092502140094164,-29455555,-48724057.4,58.109287781777866,45.623953888925996,NaN,NaN,-3.9401302914692913,-10.085748202222254
2011-10-12T09:30:00-04:00,31.75,32.25,31.64,31.89,26360912,29679826.4,57.98289284478412,46.555192945309216,NaN,NaN,111.76625217055948,51.54730501420477,0.30241567501592065,-0.031230620239515616,-0.33364629525543626,-3094643,-37537526.2,61.2666414987331,46.93954092547333,NaN,NaN,-0.9878138686350523,-8.786043297424083
2011-10-13T09:30:00-04:00,31.7,31.73,31.22,31.62,14206914,28740289.7,55.99873015981905,47.825532949885236,NaN,NaN,84.9372188001102,70.98155117590478,0.3075258154972476,0.050760974116123236,-0.2567648413811244,-17301557,-32855859.4,62.53918450352386,48.6486955691009,NaN,NaN,0.920477198835464,-7.399397512244148
2011-10-14T09:30:00-04:00,32.00999,32.23,31.78999,32.19,12087707,27810876.65,59.17487769826139,48.93915901648575,NaN,NaN,124.21836861716909,94.02424943620952,0.3333246855632389,0.1598910155729243,-0.17343366999031462,-5213850,-20463995.2,65.74698226151799,50.71225159465991,NaN,NaN,3.4988551811257644,-5.84250427033416
2011-10-17T09:30:00-04:00,32.10001,32.10001,31.22,31.27,15218277,27285363.3,52.5780169714374,49.328407587270085,NaN,NaN,84.3934370221672,97.03806006244197,0.27489039765475926,0.17017932707813443,-0.1047110705766248,-20432127,-15099546.4,67.06190831005148,52.80909120374734,NaN,NaN,3.827711563703028,-4.461044865471705
2011-10-18T09:30:00-04:00,31.3,32.50999,31.149,32.17,22586464,27200846.5,57.56218142595511,50.378512845626666,NaN,NaN,111.69907017577026,103.40286935715525,0.2822452374528561,0.2480954762394454,-0.03414976121341076,2154337,-8777568,68.59212733539981,54.868688110048005,NaN,NaN,5.667667992486372,-3.0140858857634085
2011-10-19T09:30:00-04:00,32.17999,32.36,31.67,31.78,14325469,25945171.15,54.87088580313245,51.028151610044,NaN,NaN,98.04267821134165,100.65815456531169,0.24748179478143373,0.2752024822633814,0.02772068748194767,-12171132,-10592865.8,67.62069104223514,56.367743325040074,NaN,NaN,6.368699091990511,-1.673688031798563
2011-10-20T09:30:00-04:00,31.87,32.17999,31.53999,32.05,17667920,24333260.75,56.3910267693417,52.16011253425749,NaN,NaN,87.42081488438733,101.15487378216712,0.22969738278247975,0.31484241596004736,0.08514503317756761,5496788,-6033196.8,68.81536881503591,57.83024407208372,NaN,NaN,7.3940968981126804,-0.3782901846683855
2011-10-21T09:30:00-04:00,32.35001,32.71001,32.24001,32.67,17444000,23157467.95,59.744286482329095,53.79472067256364,NaN,NaN,115.40598402275229,99.39239686328375,0.24530004207269124,0.39177008576843164,0.1464700436957404,22940788,-402269.2,70.27401759782262,59.52819619056481,NaN,NaN,9.279300510586323,1.00136562893943
2011-10-24T09:30:00-04:00,32.89999,33.395,32.8,33.28,20781264,22761475.95,62.77696218810934,55.25741720665245,NaN,NaN,137.97648800621636,110.10900706009356,0.27981388859657474,0.4962374044414588,0.2164235158448841,43722052,12428566.6,73.33468746145459,61.553469854346226,NaN,NaN,11.81429243134553,2.5460694578545873
2011-10-25T09:30:00-04:00,32.86,32.99001,32.34,32.60001,21930896,22261437.55,57.5703559710996,56.0684939231016,NaN,NaN,95.0061360650929,106.77042023795809,0.2414097274409413,0.5181856751460607,0.27677594770511943,21791156,16355930.4,74.20999869864067,63.52673068267393,NaN,NaN,12.41529622249904,3.9559589956609376
2011-10-26T09:30:00-04:00,33.03999,33.10001,32.39,32.83,19522112,22093566.35,58.814553475778574,56.71465841432786,NaN,NaN,94.77786208823339,106.11745701333643,0.21683775743578837,0.5478231444998549,0.33098538706406655,41313268,27052810.4,76.47508409318898,65.5838269563996,NaN,NaN,13.273550474698945,5.287043492666367
2011-10-27T09:30:00-04:00,33.87,34.58,33.69,34.25999,27019504,22147668.75,65.57405329098818,57.87290595949314,NaN,NaN,161.08621546424152,120.85053712930728,0.2783106196108389,0.6788736615776152,0.4005630419667763,68332772,39620007.2,78.82777898836171,67.68162964582135,NaN,NaN,16.25792112980372,6.8543117265431315
2011-10-28T09:30:00-04:00,34.22,34.35001,34.05,34.25999,11953172,20966912.95,65.57405329098818,58.60306082242555,NaN,NaN,151.08221458652784,127.9857832420624,0.29859925933556075,0.7738121161362272,0.4752128568006665,68332772,48698404,80.35611988279337,69.51641987646694,NaN,NaN,18.60521413030258,8.533012069937339
2011-10-31T09:30:00-04:00,33.91,33.96001,33.39,33.42,14055301,20084992.4,58.979541407617155,58.828029841402945,NaN,NaN,109.27025980436787,122.2445376016927,0.23772409473699585,0.7723679752219113,0.5346438804849154,54277471,50809487.8,80.70492376440104,71.13039387522574,NaN,NaN,18.6096860275454,9.972536921024204
2011-11-01T09:30:00-04:00,32.39999,32.91,32.16,32.41,33656320,19891119.6,52.18405718302506,58.41382729413443,NaN,NaN,31.86784386610507,109.61687916189513,0.11777674438828767,0.681864810970275,0.5640880665819873,20621151,50575486.8,80.5342245826437,72.50664980979077,NaN,NaN,16.4022780810659,10.891071372458732
2011-11-02T09:30:00-04:00,33.17,33.25,32.73,33.05,15434582,19337455.9,55.66955184965844,58.390314557694396,NaN,NaN,60.966021927610456,102.85451112977053,0.0721226390135773,0.6542413653489589,0.5821187263353816,36055733,49523979.8,79.71826548939711,73.73372702306743,NaN,NaN,15.66528077631198,11.57310128729491
2011-11-03T09:30:00-04:00,33.49001,33.91,33.08501,33.86,18669568,19355063.9,59.67587838234202,58.42610032084301,NaN,NaN,98.854635099264,90.40819505677504,0.08611198469859493,0.6897587072086253,0.6036467225100304,54725301,46802485.6,77.52883534393892,74.57528795752607,NaN,NaN,16.33063134813164,12.252748438843016
2011-11-04T09:30:00-04:00,33.53999,33.66,33.06,33.60001,12744578,18669128.8,57.8681219398182,58.803964961441636,NaN,NaN,77.2776534705725,75.64728283358397,0.06827081666502688,0.688985243341314,0.6207144266762871,41980723,41532075.8,73.32864869734341,75.02291227090407,NaN,NaN,16.30369498142339,12.83145508778307
2011-11-07T09:30:00-05:00,33.60001,33.78999,33.08,33.67999,14388316,18392604.6,58.286746402071216,58.85571960259278,NaN,NaN,75.53036107196935,68.89930308710427,0.0529546509687745,0.6869077403872552,0.6339530894184807,56369039,41950389.4,73.45158670836662,75.37001651183027,NaN,NaN,16.404342295124287,13.341867545974672
2011-11-08T09:30:00-05:00,33.82001,34.09,33.41,34.06,16127684,18309048,60.30487690240774,59.243861823969596,NaN,NaN,94.96438987449055,81.51861228878136,0.05905052584871762,0.7077662467293777,0.6487157208806601,72496723,52325503.8,76.36183782043241,75.99438413884435,NaN,NaN,17.071120067304413,13.874617906164636
2011-11-09T09:30:00-05:00,33.36,33.36,32.61,32.74001,23690560,18175530.4,51.063331070938304,58.86331213122649,NaN,NaN,5.687196700732215,70.4628472434057,-0.030377119475639924,0.6107443215361101,0.6411214410117501,48806163,54875589.8,77.0283837234271,76.5810280608723,NaN,NaN,14.766757082416976,14.00206635991497
2011-11-10T09:30:00-05:00,33.24001,33.37,32.91,33.14,23184656,18624417.5,53.39408487852413,58.40972630238328,NaN,NaN,22.21190542721005,55.13430130899491,-0.06515477071279907,0.5596779776207512,0.6248327483335503,71990819,58328693.4,77.93567445946925,77.12828926527563,NaN,NaN,13.578051439084168,13.941492799796285
2011-11-11T09:30:00-05:00,33.5,34.05,33.5,33.92999,13918121,18715938.2,57.6810865270729,58.04573518373781,NaN,NaN,84.59133934322239,56.597038483524884,-0.03881837266643873,0.5763097825005019,0.6151281551669406,85908940,67114336.8,80.09028425438021,77.61083189334174,NaN,NaN,13.888833444585167,13.933970034766125
2011-11-14T09:30:00-05:00,33.84,33.97,33.52499,33.72,11332238,18521636.25,56.201228267487686,57.94794034776554,NaN,NaN,69.2193696580565,55.33484020074231,-0.03928538255040448,0.566021426978935,0.6053068095293395,74576702,70755869.4,80.92187376975241,78.09025154127828,NaN,NaN,13.69594710097115,13.8999667585097
2011-11-15T09:30:00-05:00,33.56,34.07001,33.47,33.92,12431527,18013889.4,57.324239305412775,57.841489335596556,NaN,NaN,71.39593822364368,50.62114987057294,-0.030273624504929764,0.5674647788981773,0.597738403403107,87008229,73658170.6,81.58215025928324,78.4550419817136,NaN,NaN,13.861247881987481,13.894435490435098
2011-11-16T09:30:00-05:00,33.52,34.00999,33.36,33.42,14013781,17998305,53.6225955737392,56.987813784364484,NaN,NaN,38.84796511938692,57.25330355430388,-0.06039653456189242,0.5222427352007415,0.5826392697626339,72994448,78495827.6,82.65943529394698,78.72873171782683,NaN,NaN,12.927657068539537,13.75632428730716
2011-11-17T09:30:00-05:00,33.35001,33.41901,32.56,32.84,23763776,18303097.8,49.61988027058249,55.848229997192654,NaN,NaN,-60.13680877537294,40.78356071378729,-0.11843696088620559,0.4345930686548769,0.5530300295410825,49230672,73943798.2,78.03422491713796,78.56288207742287,NaN,NaN,10.936961357682815,13.353558154503682
2011-11-18T09:30:00-05:00,33.00999,33.11,32.74001,32.92,13851035,18123449.55,50.172369456818444,55.219146286421314,NaN,NaN,-68.51724805989852,10.161843233163111,-0.1485433705886965,0.36735081630521194,0.5158941868939084,63081707,69378351.6,73.58686525700128,78.05444932689431,NaN,NaN,9.459521183231008,12.797267158607585
2011-11-21T09:30:00-05:00,32.42,32.42,31.8,32.16,18028592,17985815.95,45.11113318161767,54.71393742917792,NaN,NaN,-161.87272287669666,-36.056575273787516,-0.2128313293174065,0.2498550252471503,0.4626863545645568,45053115,63473634.2,68.17504807275685,77.17165100475954,NaN,NaN,6.646808432658302,11.918630197757688
2011-11-22T09:30:00-05:00,32.14999,32.1888,31.72,31.95,19366528,17857597.55,43.79644944597438,53.86585868605763,NaN,NaN,-167.8041023045864,-83.89658337943354,-0.2595887389911438,0.13820043082562705,0.39778916981677087,25686587,51209305.8,58.544361944851936,75.65922932300631,NaN,NaN,3.9268645007591827,10.776949383900758
2011-11-23T09:30:00-05:00,31.69,31.7,31.19,31.21001,18880000,17825491.95,39.435182697820125,52.42009470859178,NaN,NaN,-203.15216543383005,-132.29660949007695,-0.32613830786350706,-0.009883715012612981,0.3162545928508941,6806587,37971733.6,50.28707453046575,73.7133892649011,NaN,NaN,0.20040590739483877,9.26601460154277
2011-11-25T09:30:00-05:00,31.08,31.58,31.08,31.16,7025176,16825775.55,39.151431904937716,51.08318827752889,NaN,NaN,-180.73527766270465,-156.41630326754324,-0.3568283334599568,-0.12978082397405188,0.22704750948590488,-218589,28081881.4,45.162090633296025,71.70149226032628,NaN,NaN,-2.9222014353660475,7.5248408819843675
2011-11-28T09:30:00-05:00,32.11,32.41,31.965,32.21001,15617930,17009013.45,47.665929137940374,50.32455847294812,NaN,NaN,-78.8360342206901,-158.48006049970158,-0.2924194796876223,-0.13847684012362294,0.1539426395639993,15399341,18545408.2,40.83990395136269,69.3720863491117,NaN,NaN,-3.2556758505888954,5.9847670630453305
2011-11-29T09:30:00-05:00,32.32001,32.6295,32.14999,32.24001,18321312,17222314,47.890286247546435,49.43780199760089,NaN,NaN,-57.142636608366125,-137.53404324603548,-0.23620908136978647,-0.14131871214823377,0.0948903692215527,33720653,16278915.8,39.86344175768507,66.76505805891546,NaN,NaN,-3.4602666745462964,4.63547652910367
2011-11-30T09:30:00-05:00,33.30791,33.89,33.11,33.89,23767776,16727886.8,58.442614181936925,49.96489364838651,NaN,NaN,67.37665856816719,-90.49789107148474,-0.08416161257885077,-0.010311646502010774,0.07384996607684,57488429,22639284.2,43.91594016214125,64.39988351882361,NaN,NaN,-0.16848608697143957,3.9491961553786545
2011-12-01T09:30:00-05:00,33.7,33.97,33.64,33.78,17912016,16851758.5,57.6051106193232,50.26568120130072,NaN,NaN,76.12371689319794,-34.64271460607914,0.007857466948248445,0.08367179976215056,0.07581433281390211,39576413,29193249.4,47.81814732083253,62.24863158034956,NaN,NaN,2.178877716499039,3.6962935212529953
2011-12-02T09:30:00-05:00,34,34.24001,33.67,33.71001,18372928,16836926.5,57.04496321827501,50.220243822100876,NaN,NaN,80.90039878995587,17.684420684452956,0.059963558797559754,0.1507687813108518,0.09080522251329205,21203485,33477664.2,50.25480263458696,60.11752575036432,NaN,NaN,3.904642843869868,3.726057710198263
2011-12-05T09:30:00-05:00,34.25999,34.34,33.83,34.07001,17993056,17099350.4,59.24040709134265,50.4373280238048,NaN,NaN,93.51999076163852,52.155625680918696,0.11162576396260755,0.2303374274665515,0.11871166350394395,39196541,38237104.2,52.88668971950419,58.115012603918025,NaN,NaN,6.009718403126187,4.052294952045109
2011-12-06T09:30:00-05:00,34.14,34.32001,33.92999,34.06,12618277,17010848.45,59.14988004060999,50.567730933461746,NaN,NaN,89.76686118325652,81.53752523924322,0.13643393990615818,0.2892540883866417,0.1528201484804835,26578264,36808626.4,51.99748702028621,56.001822372561094,NaN,NaN,7.703907173477191,4.573953840821121
2011-12-07T09:30:00-05:00,34.08,34.1701,33.60001,34.05,25266416,17467785.05,59.05279520429354,50.9556023356442,NaN,NaN,74.76694098779635,83.01558172316905,0.1427997226359904,0.3313198017754715,0.1885200791394811,1311848,25573310.2,45.51547339849234,53.348682237171474,NaN,NaN,9.084406176844656,5.218304174538768
2011-12-08T09:30:00-05:00,33.83,33.89999,33.13,33.21001,17456800,17156097.05,51.41839610871657,51.08406775265378,NaN,NaN,26.75544282831263,73.14192691019198,0.08397897349300801,0.2934937960057411,0.2095148225127331,-16144952,14429037.2,40.16680147174027,50.64386627678592,NaN,NaN,8.21655540659224,5.646625779117835
2011-12-09T09:30:00-05:00,33.45,34.05,33.39,33.97,22390496,17116389.05,56.853395160162115,51.56128387432119,NaN,NaN,55.68293948025074,68.09843504825096,0.08929963059908125,0.32113936076158467,0.23183973016250342,6245544,11437449,38.847086624625874,48.16245351733054,NaN,NaN,9.051804453923534,6.133079875518649
2011-12-12T09:30:00-05:00,33.69,33.69,33.075,33.35001,15878086,17214387.3,51.765592016118255,52.036602362499806,NaN,NaN,22.015975952782885,53.79763208647984,0.04627332924236663,0.2896813917154617,0.24340806247309507,-9632542,1671632.4,34.824634732456886,45.780281135880536,NaN,NaN,8.226213071007617,6.432098903445644
2011-12-13T09:30:00-05:00,33.64,33.78,32.75999,32.91,25789216,17937236.2,48.45164924396948,52.36911663378517,NaN,NaN,5.749357115150232,36.994131272858574,-0.01341996237145035,0.22663310950878213,0.24005307188023248,-35421758,-10728372,30.505397556272186,43.77749796526769,NaN,NaN,6.516314911679576,6.444129761764778
2011-12-14T09:30:00-05:00,32.64,32.89999,32.45,32.52,19621936,18296756.65,45.66141945509503,52.81384783073338,NaN,NaN,-35.77731409241385,14.885280256816538,-0.077208471423938,0.14354248260031,0.220750954024248,-55043694,-21999480.4,27.202746382873983,42.12861738329685,NaN,NaN,4.230015395201905,6.127827709398653
2011-12-15T09:30:00-05:00,32.97,33.02,32.61501,32.75,14535039,18322819.55,47.57870613383308,53.415795989940186,NaN,NaN,-17.30910240106195,6.0723712109416255,-0.10047695908839471,0.0951547551637546,0.1956317142521493,-40508655,-26872221,25.897377793863498,40.75256646619453,NaN,NaN,2.889507820465605,5.665210582408217
2011-12-16T09:30:00-05:00,32.81,33.13,32.53999,32.67,35073696,18888315.55,46.95807171825074,53.36523474567664,NaN,NaN,-17.755495847838116,-8.615315854676151,-0.11668297824668752,0.049777991443789915,0.16646096969047744,-75582351,-43237800,22.067264112966257,39.41166362059478,NaN,NaN,1.6124994626955775,5.086251851020697
2011-12-19T09:30:00-05:00,32.74001,33,32.22,32.33,16276594,19009593.5,44.312479571686325,53.10967712597235,NaN,NaN,-38.60653172529309,-20.739817390291346,-0.14393948114723784,-0.013463381743569869,0.13047609940366797,-91858945,-59683080.6,19.022715086624046,37.923040286947575,NaN,NaN,-0.23463398746192488,4.326125302666037
2011-12-20T09:30:00-05:00,32.81,33.5,32.81,33.435,24973856,19356856.7,53.48473572943111,52.75554295079336,NaN,NaN,21.610285704725086,-17.567631672376372,-0.08414879084269467,0.02529011085029964,0.1094389016929943,-66885089,-65975746.8,17.999397278816076,36.07185865242435,NaN,NaN,0.8487537389845855,3.82935793642583
2011-12-21T09:30:00-05:00,33.39999,33.53999,32.98,33.45,18989920,19338026.3,53.59646912220168,52.46921141528468,NaN,NaN,23.88452523034603,-5.635263807824396,-0.04230239445212573,0.056560908627837136,0.09886330307996287,-47895169,-64546041.8,19.064698541343887,34.01804088246087,NaN,NaN,1.7481495001388503,3.53204244552769
2011-12-22T09:30:00-05:00,33.49001,33.83,33.49001,33.765,12781008,19033076.7,55.987407705812046,52.39367173582304,NaN,NaN,56.1353941115999,9.053635494707974,0.005344923764360271,0.10554445778541321,0.10019953402105294,-35114161,-63467143,19.910271673783768,31.85057438526065,NaN,NaN,3.20795462452812,3.485744185384894
2011-12-23T09:30:00-05:00,33.91,34.09,33.75999,34.09,5526277,18958131.75,58.37068278237404,52.331548570896715,NaN,NaN,85.85401668055167,29.77553800038593,0.05475639072018776,0.16864502242128765,0.11388863170109989,-29587884,-54268249.6,26.92073787053323,29.995863538905585,NaN,NaN,5.145246239972097,3.7228159074687803
2011-12-27T09:30:00-05:00,33.96001,34.14999,33.89,34.08,5313727,18442921.6,58.26613501670175,52.268423926331835,NaN,NaN,87.39478299186558,54.975800943817674,0.08117964291274243,0.21536318534202792,0.13418354242928549,-34901611,-42876782.8,34.559853566303346,28.75031829219252,NaN,NaN,6.704310584791664,4.148743718514907
2011-12-28T09:30:00-05:00,34.12,34.12,33.46001,33.53999,10798574,18066784.7,52.76958543044955,51.81962322820012,NaN,NaN,33.67647428032008,57.389038658936656,0.057800152077969486,0.20643373252674735,0.14863358044877786,-45700185,-38639802,37.18976360235073,28.15562473532526,NaN,NaN,6.550774103200734,4.491890916327168
2011-12-29T09:30:00-05:00,33.56,33.99001,33.55,33.96001,6053566,17181074.2,56.22834045999424,52.163190681862815,NaN,NaN,50.97714022172939,62.80756165721334,0.06556599185198261,0.23059107026375614,0.16502507841177352,-39646619,-36990092,38.23065500241351,28.017328558944776,NaN,NaN,7.413204153644361,4.909221378801052
2011-12-30T09:30:00-05:00,33.89,34.02,33.75,33.75,4281680,16499557.4,54.09523774932056,51.96617943823128,NaN,NaN,51.4392889756277,61.86834063001889,0.05208954241975866,0.23013700643647184,0.17804746401671318,-43928299,-38752919.6,37.51522125457692,27.922195318226994,NaN,NaN,7.538547365562845,5.28483937690988
2012-01-03T09:30:00-05:00,34.41,34.81,34.41,34.49001,19704592,16566140.6,59.8720211571973,52.545210091165494,NaN,NaN,147.75413762485957,74.24836481888048,0.08651462976885765,0.28619075122778526,0.1996761214589276,-24223707,-37680084.2,38.27230802922146,28.168457696567327,NaN,NaN,9.395592599467296,5.872089837275225
2012-01-04T09:30:00-05:00,34.38,34.69,34.3,34.64999,10290262,16181000.9,61.01423441450724,53.442537603346764,NaN,NaN,134.95258953615578,83.75992612773851,0.11194550851639132,0.33960800710441674,0.22766249858802542,-13933445,-33486451,41.267941509587345,28.937210836089836,NaN,NaN,11.263065491668042,6.642229216474199
2012-01-05T09:30:00-05:00,34.42999,34.67999,34.14999,34.66,8828883,15991531.2,61.08886672019001,54.54449812228212,NaN,NaN,120.97371309607026,101.21937389088855,0.12057998137187775,0.37838747530287264,0.2578074939309949,-5104562,-25367326.4,46.66463052872063,30.327345417936023,NaN,NaN,12.80880695538819,7.523168893461912
2012-01-06T09:30:00-05:00,34.74001,34.745,34.48,34.59,8702395,15163330.15,60.220676148810234,55.44749598049477,NaN,NaN,123.57414688415756,115.73877522337418,0.1128532816293859,0.39887409596772727,0.28602081433834137,-13806957,-20199394,49.82495888856759,32.03645835327203,NaN,NaN,13.87296474956493,8.430282587190915
2012-01-09T09:30:00-05:00,34.69,34.89999,34.53999,34.845,15523340,15066657.15,62.32142571070849,56.544878408527474,NaN,NaN,126.7518677569277,130.8012909796342,0.11576028752337064,0.4307211737425547,0.31496088621918406,1716383,-11070457.6,54.907798229991954,34.38221079020244,NaN,NaN,15.367215853078012,9.421273053746214
2012-01-10T09:30:00-05:00,35.33,35.42,35.25,35.35001,17201120,14807188.35,66.13563328318426,58.1036751022059,NaN,NaN,164.41949028178064,134.13436151101837,0.14087111706851257,0.4910497825548248,0.3501786654863122,18917503,-2442215.6,59.12270184574943,37.246495558711395,NaN,NaN,17.80542016642353,10.61900835555726
2012-01-11T09:30:00-05:00,35.21989,35.53,35.2,35.46001,9828867,14504727.4,66.92111859508154,59.063416735466646,NaN,NaN,146.64506033244717,136.47285567027663,0.15305283278450382,0.541494706466942,0.38844187368243815,28746370,6093747.4,62.82485024086944,40.44831362742949,NaN,NaN,20.069730005097256,11.969111448348688
2012-01-12T09:30:00-05:00,35.57001,35.84,35.39,35.77,9283676,13679450.4,69.0965329864821,60.170564154343815,NaN,NaN,148.61644447662718,142.00140194638803,0.16890630098536163,0.5995747499141402,0.43066844892877854,38030046,14720669,66.16052198452954,43.812301016228496,NaN,NaN,22.663979582477754,13.496949753224268
2012-01-13T09:30:00-05:00,35.49001,35.53999,35.16,35.495,10861801,13241443.65,65.01189386114858,60.81517030829642,NaN,NaN,110.9557876929015,139.4777301081368,0.14851242072748427,0.6163089748381338,0.4677965541106496,27168245,22915709.4,69.0055973846283,47.319109995574536,NaN,NaN,23.785227106019114,14.966703660766388
2012-01-17T09:30:00-05:00,35.97,36.03,35.62,35.67,10633543,13046368.85,66.3741559455421,61.38684696280843,NaN,NaN,128.0528464861646,139.73792585398422,0.13484794445605464,0.6363564846807179,0.5015085402246633,37801788,30132790.4,71.29451508207782,50.48866551068487,NaN,NaN,25.11563692385131,16.41655126977852
2012-01-18T09:30:00-05:00,35.55,36.00999,35.50999,35.99001,15984234,12091895.75,68.76879038152063,62.137036631724065,NaN,NaN,122.28783241652496,131.3115942809331,0.13506449634658058,0.670339160657889,0.5352746643113084,53786022,37106494.2,73.34305260304707,53.258894013309416,NaN,NaN,26.955713045172562,17.922145809120526
2012-01-19T09:30:00-05:00,36.17999,36.38,36.08501,36.37,9950590,11775595.55,71.37552522407461,63.466032331268714,NaN,NaN,147.35521138558335,131.45362449156033,0.14748999992875222,0.7196371642222488,0.5721471642934965,63736612,44104542.6,75.2516870685719,55.97760283232521,NaN,NaN,29.333990010103232,19.55240926640377
2012-01-20T09:30:00-05:00,36.16,36.25,36.02,36.16,11160129,11084909.2,67.99772289051876,64.3067025048776,NaN,NaN,119.00227512373161,125.53079062098122,0.12892852945481703,0.7333078261120178,0.6043792966572008,52576483,47013830,76.02037335211135,58.6768684287322,NaN,NaN,30.400532190510006,21.10214111270466
2012-01-23T09:30:00-05:00,36.10001,36.45,36,36.12,13137688,10792297.6,67.34397687702682,65.25304101399948,NaN,NaN,108.7336837996547,125.08636984233185,0.10247319556440215,0.7324707911127035,0.6299975955483014,39438795,49467940,76.67841543744214,61.474239441794005,NaN,NaN,31.1056933903895,22.53122000951678
2012-01-24T09:30:00-05:00,35.84,36.17,35.77,36.16,5678938,10437194.1,67.67862561187852,65.81065561790528,NaN,NaN,86.03014455651383,116.68182945640169,0.07732882929650653,0.7266586321689346,0.649329802872428,45117733,50931129,77.08222334698007,64.24637625020533,NaN,NaN,31.784983734481997,23.853186255940383
2012-01-25T09:30:00-05:00,36.02,36.67,35.86,36.56,13684246,10845092.55,70.89107799097182,66.51614444479561,NaN,NaN,103.55679072481773,112.93562111806025,0.07712237229597596,0.745732768242398,0.668610395946422,58801979,51934320.4,77.37151789280739,66.82520313472105,NaN,NaN,33.28628335819116,25.200771556261923
2012-01-26T09:30:00-05:00,36.78999,36.92,36.38,36.49001,11594879,11159150.15,69.58778936695745,67.12321034813614,NaN,NaN,113.62617922342002,106.18981468562758,0.062387895209395694,0.7465952649581666,0.6842073697487709,47207100,48628418,74.05404444005731,68.78158984267367,NaN,NaN,34.20002120340134,26.48637864871041
2012-01-27T09:30:00-05:00,36.32001,36.59,36.28999,36.46001,6931098,10965776.35,69.0022150761552,67.75046312866078,NaN,NaN,95.4454705278306,101.47845376644739,0.0417298159669528,0.7363696397074619,0.6946398237405091,40276002,46168321.8,71.59396298140878,70.33651870644805,NaN,NaN,34.81781062261911,27.676583216411654
2012-01-30T09:30:00-05:00,36.13,36.36,36,36.33,9737664,11149981.25,66.39472465330192,68.04141305313175,NaN,NaN,69.29682595926832,93.59108219837012,0.011964353052138721,0.7095952650556825,0.6976309120035438,30538338,44388230.4,69.78740197708507,71.39934754552613,NaN,NaN,34.68105040316556,28.677221385947927
2012-01-31T09:30:00-05:00,36.49001,36.62,36.03999,36.22,18226864,11847240.45,64.18472608726509,67.90206253913752,NaN,NaN,70.82037104401208,90.54912749586977,-0.020699364485833427,0.671756706396252,0.6924560708820854,12311474,37826978.6,63.433719698953006,71.70727739218351,NaN,NaN,33.9925857566556,29.43655915319188
2012-02-01T09:30:00-05:00,36.5,36.82001,36.5,36.61,11771047,11450563.2,68.2232651927452,67.99507301039921,NaN,NaN,102.37589541194954,90.31294843329613,-0.021511355877963045,0.6655668760346316,0.6870782319125947,24082521,30883087,57.47033156805125,71.3248117726965,NaN,NaN,34.43561589606271,30.15071011645914
2012-02-02T09:30:00-05:00,36.69,36.75,36.52,36.63,9223965,11397248.35,68.41992663606759,67.9467439853696,NaN,NaN,95.36068424677701,86.65984943796752,-0.025880243343016973,0.6547279277338234,0.6806081710768404,33306486,28102964.2,55.23157904766379,70.5441729914918,NaN,NaN,34.857670601333666,30.823133042869788
2012-02-03T09:30:00-05:00,37.03999,37.32001,36.98,37.25999,11530582,11532333.3,73.89950393447694,68.58157327632162,NaN,NaN,154.85034442601437,98.54082421760427,0.006737623003863824,0.6890301998316701,0.6822925768278063,44837068,29015177.4,55.83945348518797,69.60373414153177,NaN,NaN,36.88765964296653,31.68949398574075
2012-02-06T09:30:00-05:00,37,37.259,36.98,37.17,8686781,11531552.6,71.9782684585022,68.98186702724735,NaN,NaN,143.5357944970132,113.38861792515324,0.01486538963404127,0.7008743138703579,0.6860089242363167,36150287,30137567.2,56.619938042551006,68.55555006727987,NaN,NaN,38.017077910633276,32.59343454643968
2012-02-07T09:30:00-05:00,37.09,37.21001,36.78,37.13,9038809,11207326.05,71.09352060333265,69.14791918594821,NaN,NaN,125.23678460502589,124.271900637356,0.010373529040926366,0.6989758355374747,0.6886023064965483,27111478,33097568,58.6933365968102,67.50914178112008,NaN,NaN,38.70755777949697,33.46688072259072
2012-02-08T09:30:00-05:00,37.21001,37.27499,37.03,37.21001,10111766,10852858.35,71.83916643085865,69.18103641500421,NaN,NaN,131.22829927042386,130.04238140905085,0.005842515805523085,0.6959054512534522,0.6900629354479291,37223244,35725712.6,60.49862641341714,66.45535173432333,NaN,NaN,39.4923250396982,34.327658482177505
2012-02-09T09:30:00-05:00,37.35001,37.375,37.10001,37.31,9383875,10830608.75,72.78400705136164,69.52291385506442,NaN,NaN,128.95918428718718,136.76208141713292,0.002786246301119677,0.6935457433243286,0.6907594970232089,46607119,38385839.2,62.294869058789395,65.4749585705146,NaN,NaN,40.41589122151333,35.19740601636833
2012-02-10T09:30:00-05:00,36.98,36.985,36.73,36.97,14726820,11102765.95,64.82004126748761,69.34263274009733,NaN,NaN,65.22527699996589,118.8370679319232,-0.027270952027601547,0.6566708069887071,0.6839417590163086,31880299,35794485.4,59.458418313436354,64.24495877594276,NaN,NaN,39.00942075408249,35.7419795503275
2012-02-13T09:30:00-05:00,37.28999,37.45,37.03,37.42,16480652,11383708.5,69.56644228870486,69.47747678844208,NaN,NaN,117.17717754002229,113.56534454052503,-0.022198051012971343,0.6561941952500945,0.6783922462630658,48360951,38236618.2,61.24915367434611,63.11402522789748,NaN,NaN,39.125211033131585,36.22529833358523
2012-02-14T09:30:00-05:00,37.31,37.32001,37.02,37.28999,13354039,11519733.3,66.76385321434955,69.18267501868334,NaN,NaN,93.19333474396954,107.15665456831375,-0.03233650350921968,0.6379716168765412,0.6703081203857609,35006912,39815705,62.405470345112874,62.0450218316336,NaN,NaN,38.385416113437095,36.53388658784978
2012-02-15T09:30:00-05:00,37.42,37.42,36.71001,36.8,18457216,11643382.4,57.38122350292619,68.31077745696682,NaN,NaN,47.47056099409609,90.4051069130482,-0.07437704444893611,0.5773368148245908,0.6517138592735269,16549696,35680995.4,57.56201524848605,60.86701974652136,NaN,NaN,34.691803968730525,36.270731927975596
2012-02-16T09:30:00-05:00,36.8,37.16,36.71001,37.14,12220168,11756861.3,61.431564513379506,67.77001670248283,NaN,NaN,46.54787081861018,73.9228442193328,-0.0810718186328464,0.5503740859824688,0.6314459046153152,28769864,32113544.4,53.690111019189665,59.588173177791425,NaN,NaN,32.81639221213753,35.777254825713015
2012-02-17T09:30:00-05:00,37.25,37.39,37.14999,37.28,9207523,11659231,62.99122174001636,67.52690935153387,NaN,NaN,85.9033119759688,78.05845121453339,-0.07784035353992347,0.534145462690411,0.6119858162303344,37977387,33332962,54.80908220590287,58.51829319413555,NaN,NaN,31.774225712015454,35.20539352375622
2012-02-21T09:30:00-05:00,37.47,37.57001,37.265,37.41,13518641,11678278.65,64.42964067696005,67.5444032507978,NaN,NaN,103.50339434491012,75.32369457551096,-0.06901747543838943,0.5257139719323476,0.594731447370737,51496028,33959977.4,55.40575252596195,57.94486696749333,NaN,NaN,31.351888709163816,34.654892835957305
2012-02-22T09:30:00-05:00,37.37,37.47,37.23,37.37,9040848,11846374.15,63.61040263563133,67.2149130681468,NaN,NaN,88.64658571931851,74.41434477058075,-0.0678442158975967,0.5099261774987411,0.5777703933963378,42455180,35449631,56.86297295419118,57.90148420936047,NaN,NaN,30.770518545754218,34.09998222307115
2012-02-23T09:30:00-05:00,37.33,37.53,37.17,37.49001,9914863,11657905,65.04641523938162,66.97394796838351,NaN,NaN,91.78707669221562,83.27764791020465,-0.06116099819781984,0.5013191456490631,0.5624801438468829,52370043,42613700.4,63.106812910752424,58.4640009138668,NaN,NaN,30.68628894491045,33.61231175476248
2012-02-24T09:30:00-05:00,37.58,37.66,37.42,37.48,8444480,11500385.05,64.81665812822118,66.32517326793668,NaN,NaN,109.97205926512193,95.962485599507,-0.0595327651480142,0.4880641874118652,0.5475969525598794,43925563,45644840.2,65.38946996560031,59.14614494818196,NaN,NaN,30.554481552811332,33.17547886876946
2012-02-27T09:30:00-05:00,37.23,37.66,37.11,37.50999,13756723,11841666.3,65.21310801225775,65.84194752177636,NaN,NaN,84.29151233707505,95.64012567172826,-0.058469859445768435,0.47450962825266885,0.5329794876984373,57682286,49585820,68.14879748672976,59.969634908480444,NaN,NaN,30.54720769836592,32.80001155871181
2012-02-28T09:30:00-05:00,37.48,37.55,37.3,37.46001,12782227,11993894.45,63.92041540559418,65.32958286479504,NaN,NaN,84.923216973475,91.92409019744123,-0.06278724318462703,0.45449543371765344,0.5172826769022805,44900059,48266626.2,66.24492997178689,60.509034435264496,NaN,NaN,30.209680755703467,32.42996430113919
2012-02-29T09:30:00-05:00,37.56,37.62,37.16,37.23,14362086,11800655.55,58.20250684188925,64.35553575129723,NaN,NaN,53.27405109871119,84.84958327331977,-0.08159655291122814,0.4152869857632453,0.49688353867447344,30537973,45883184.8,62.82966926948172,60.67553749641196,NaN,NaN,28.36709196058363,31.849553966774106
2012-03-01T09:30:00-05:00,37.28999,37.50999,37.2,37.36,15367824,11980494.4,60.360768809958934,63.46816159119704,NaN,NaN,55.00898595264254,77.49396512540514,-0.08534213379454558,0.3902058714312915,0.47554800522583707,45905797,44590335.6,60.992801585816416,60.58253267691389,NaN,NaN,27.33199763928053,31.204188777132167
2012-03-02T09:30:00-05:00,37.39,37.45,37.02,37.14,11497297,12094161,55.16902511616294,62.77880329467386,NaN,NaN,-20.152747195714785,51.4690038332378,-0.10159138208295931,0.34855877762213794,0.45015015970509725,34408500,42686923,58.29081624218085,60.499132528967074,NaN,NaN,24.951977957808037,30.311015802943004
2012-03-05T09:30:00-05:00,37.05,37.09,36.75,36.88,15998777,12317570.75,49.725581798208765,61.36159897392413,NaN,NaN,-140.7117634329823,6.468348679226326,-0.12714703366182312,0.29121636762781833,0.41836340128964145,18409723,34832410.4,48.70278967009251,59.60296367152039,NaN,NaN,21.219251319404457,29.01219230529464
2012-03-06T09:30:00-05:00,36.35001,36.48,35.955,36.05,27730272,13269745.3,37.13055136123246,59.24493455584434,NaN,NaN,-320.7016399574954,-74.65662270696774,-0.19328236361082718,0.17676044677610747,0.37004281038693465,-9320549,23988288.8,39.13247477580049,57.94060684514093,NaN,NaN,12.895397156983767,26.709792998393088
2012-03-07T09:30:00-05:00,36.17999,36.48,36.14999,36.42,14552871,13545448.4,43.946557221967275,58.285315535775844,NaN,NaN,-205.05512198998136,-126.32245732470624,-0.20436360033897394,0.11458830996321723,0.31895191030219117,5232322,18927158.6,35.61491035741794,56.37295649577892,NaN,NaN,8.330887653517664,24.084235091982315
2012-03-08T09:30:00-05:00,36.75,37.02,36.59,36.94,16027430,13841231.6,51.84775833812067,57.60075795182878,NaN,NaN,-67.59819345539967,-150.8438932063147,-0.17031866571481513,0.10605357815867222,0.27637224387348736,21259752,13997949.6,32.54643540875888,54.862693952176734,NaN,NaN,7.347239319394726,21.693235695898373
2012-03-09T09:30:00-05:00,37.02,37.17,36.81,37.02,17457504,14244913.05,52.94664461464558,56.88328815715944,NaN,NaN,-28.206710519423478,-152.45468587105643,-0.13746579424452418,0.10454000106783212,0.2420057953123563,38717256,14859700.8,33.623140519427864,53.34941240314281,NaN,NaN,6.978739152323919,19.59116476110202
2012-03-12T09:30:00-04:00,37.07001,37.13,36.89999,37.00999,10597645,14038454.3,52.78432537898547,56.05147992158983,NaN,NaN,-27.13287484700474,-129.7389081538609,-0.11251320224292066,0.10136429250870549,0.21387749475162615,28119611,16801678.4,36.09856391157515,51.97032750211518,NaN,NaN,6.642837275469124,17.741403691725893
2012-03-13T09:30:00-04:00,37.25999,37.8,37.07001,37.78,25778672,14503355.3,62.34697757613211,55.961235274482746,NaN,NaN,97.05799491635352,-46.18698117909115,-0.04378491398532397,0.1591463522699712,0.20293126625529517,53898283,29445444.8,49.34434700103383,51.43328279117537,NaN,NaN,9.798162934798198,16.606655012164794
2012-03-14T09:30:00-04:00,37.71001,37.88,37.5815,37.69,12872961,14479301.4,60.797070566683765,55.65771065500433,NaN,NaN,121.69052135110634,19.16214748912639,-0.006005752213289778,0.19542407598868294,0.20142982820197272,41025322,36604044.8,55.02820894436255,50.856239650718955,NaN,NaN,11.714931420908563,15.907837356271047
2012-03-15T09:30:00-04:00,37.8,38.17,37.61,38.14,15961141,14354497.65,65.42519159409702,55.7011773311383,NaN,NaN,158.01609338800014,64.28500485780636,0.04486987736028791,0.2575171749023326,0.2126472975420447,56986463,43749387,59.86859088113358,50.461891144685616,NaN,NaN,14.98018283094898,15.775315281225037
2012-03-16T09:30:00-04:00,38.09,38.10001,37.85001,37.98,10822551,14284616.8,62.59561004323756,55.514213190494,NaN,NaN,142.75059246836798,98.47646545536466,0.06225609220537373,0.29046741279876187,0.22821132059338814,46163912,45238718.2,60.8152837208781,49.938068732839064,NaN,NaN,16.64151344138504,15.89905787553361
2012-03-19T09:30:00-04:00,37.96001,38.11,37.83,37.98,13637602,14506120.75,62.59561004323756,55.41958423603995,NaN,NaN,125.87547921923662,129.07813626861292,0.06780930856845663,0.31297295630395894,0.2451636477355023,46163912,48847578.4,63.087558801485244,49.71254222067466,NaN,NaN,17.936451583302723,16.190114119500624
2012-03-20T09:30:00-04:00,37.67,37.75999,37.39,37.53999,16480922,14654234.8,55.00784653993471,55.19139421447177,NaN,NaN,47.60982677826566,119.18850264099535,0.0374197605612267,0.2919383484370357,0.254518587875809,29682990,44004519.8,58.20923690667369,49.38251133761695,NaN,NaN,16.643774435952118,16.254922736136553
2012-03-21T09:30:00-04:00,37.62,37.67,37.42999,37.52,9452102,14674797.5,54.68353572753027,54.785877565726864,NaN,NaN,40.93484057393837,103.03736648556176,0.012814462449778186,0.2705366659380317,0.25772220348825353,20230888,39845633,54.324475654257434,48.90620234250559,NaN,NaN,15.523199721145753,16.150390876852153
2012-03-22T09:30:00-04:00,37.24001,37.25,36.8,37.10001,20800016,15219055.15,48.247447797735816,54.29147918583921,NaN,NaN,-42.724184045760154,62.8893109988097,-0.03243180178029975,0.21718245126287883,0.24961425304317858,-569128,28334514.8,45.31084625113538,47.97906162885948,NaN,NaN,12.486364607030561,15.626958552591926
2012-03-23T09:30:00-04:00,37.06,37.22,36.845,37.16,11172727,15355467.5,49.16774760408384,54.25163388625886,NaN,NaN,-34.31467070027401,27.4762583650813,-0.05753841883898328,0.1776912294944495,0.23522964833343277,10603599,21222452.2,40.8058977335547,47.41499791910678,NaN,NaN,10.32050278095281,14.868893442357766
2012-03-26T09:30:00-04:00,37.45,37.71001,37.45,37.71001,22876496,15811456.15,56.75983662625704,55.65372569090348,NaN,NaN,57.67359083451982,13.835880688137939,-0.037302691548213696,0.18860128389816566,0.22590397544637936,33480095,18685688.8,39.3048221185994,47.42730844359242,NaN,NaN,10.792068760620044,14.286489916395235
2012-03-27T09:30:00-04:00,37.73,37.78999,37.58,37.59,11364207,15740555.15,54.83535345148988,56.4314968501551,NaN,NaN,59.44595036048054,16.203105404580903,-0.03238214224044281,0.18542629764582585,0.21780843988626866,22115888,17172268.4,38.39732571049656,47.62605239738375,NaN,NaN,10.575650951569221,13.756370064277233
2012-03-28T09:30:00-04:00,37.53999,37.63,36.91,37.23,26574752,16351188.45,49.42203749570753,56.25823107569702,NaN,NaN,-5.46279417780751,6.923578454231729,-0.05256058880084363,0.1521077038852141,0.20466829268605774,-4458864,12234318,35.51598407308329,47.83816301626406,NaN,NaN,8.666549469789304,13.029252836493242
2012-03-29T09:30:00-04:00,36.89,37.3,36.75,37.25,18527520,16509173.25,49.719011689933005,56.02768586678898,NaN,NaN,-28.907038198251126,9.68700762373353,-0.06304230374656705,0.12586541300284892,0.18890771674941598,14068656,15161874.8,38.46423647496779,48.183955584516916,NaN,NaN,7.238981156404634,12.202071167909155
2012-03-30T09:30:00-04:00,37.47,37.52,37.23,37.41499,12711395,16569878.15,52.2118270910675,55.98679313193769,NaN,NaN,16.630576429691207,19.876057049726573,-0.057500217116140284,0.11703244535424062,0.1745326624703809,26780051,18397165.2,41.63980813831543,48.57975874356979,NaN,NaN,6.772427975929944,11.426407854769268
2012-04-02T09:30:00-04:00,37.34,37.78999,37.1613,37.66,24390608,16989469.7,55.72242441864056,55.51361076354544,NaN,NaN,36.55953107622233,15.653245098067085,-0.03696750334484378,0.12832328328932618,0.16529078663416996,51170659,21935278,44.983529928436674,48.26827180981285,NaN,NaN,7.415088084514165,10.853362173304253
2012-04-03T09:30:00-04:00,37.56,37.66,37.22,37.39,10447113,16125311.75,51.25401346867128,54.83196382797312,NaN,NaN,8.479895998146018,5.460034225600182,-0.04089779230780266,0.11416854624941664,0.1550663385572193,40723546,25656809.6,48.33651661464772,47.79029378626179,NaN,NaN,6.632455449216032,10.250375498434508
2012-04-04T09:30:00-04:00,37.03,37.19,36.95,37.12,13437625,16069549.45,47.179626402827424,53.52870917145386,NaN,NaN,-75.08242877348096,-8.463892693534506,-0.05986177087410169,0.08023912496459218,0.14010089583869387,27285921,32005766.6,53.53880949741224,47.338166544567414,NaN,NaN,4.720062227401263,9.460330745429758
2012-04-05T09:30:00-04:00,37.00999,37.17,36.9166,36.97,10535719,15794963.9,45.037614106758824,52.274566604562516,NaN,NaN,-95.31025586700144,-21.74453622728457,-0.07945989499713846,0.040776027092270795,0.12023592208940925,16750202,32542075.8,53.96054372032949,46.84854225881394,NaN,NaN,2.4872301541101005,8.464173518098379
2012-04-09T09:30:00-04:00,36.37,36.53,36.27,36.37,13810922,15612634.8,37.67027120957248,50.49418525930073,NaN,NaN,-210.75822631906308,-67.22229677703542,-0.1269649667629685,-0.03847028636430139,0.08849468039866712,2939280,27773921.6,49.64583887477308,45.88841940690593,NaN,NaN,-2.009148967543225,6.96798459157815
2012-04-10T09:30:00-04:00,36.33,36.33,35.56,35.63,21444512,16154978.15,30.946509262049602,48.775518310880365,NaN,NaN,-257.35970277778097,-126.00614354783609,-0.19811637239635552,-0.15915078509677727,0.03896558729957824,-18505232,13838743.4,39.66385956439502,44.563749596743165,NaN,NaN,-8.55492033448002,4.750426744998412
2012-04-11T09:30:00-04:00,36.10001,36.19,35.89999,36.03,19239088,15827998.95,37.44603109423598,47.54426797993077,NaN,NaN,-181.1503075852395,-163.93218426451318,-0.20715528369724387,-0.2199785173219766,-0.012823233624732727,733856,5840805.4,35.27949767049947,43.20339402647473,NaN,NaN,-11.610915278554538,2.413092170205134
2012-04-12T09:30:00-04:00,36.10001,36.82001,36.03,36.8,24078240,16388262.9,47.6590234678444,47.502237670652804,NaN,NaN,-93.09110303457773,-167.53391911673253,-0.15270476779572578,-0.20370419336938994,-0.05099942557366417,24812096,5346040.4,35.02159669481914,42.46844762959501,NaN,NaN,-10.40628409010076,0.5817527044471489
2012-04-13T09:30:00-04:00,36.57001,36.63,36.32001,36.33,17838816,16482146.65,43.03988428136193,47.06453314760124,NaN,NaN,-99.58612737132228,-168.3890934175967,-0.14010055301620822,-0.22612511684392445,-0.08602456382771623,6973280,3390656,33.96483287971189,41.979800140034804,NaN,NaN,-11.154253527727759,-1.0948196144349809
2012-04-16T09:30:00-04:00,36.55,36.71001,36.285,36.42999,20864160,16984227.1,44.27723262143456,46.172918575828206,NaN,NaN,-83.16247074384104,-142.8699423025523,-0.1176907751494276,-0.23313803276450074,-0.11544725761507313,27837440,8370288,39.01187640235989,41.9588754460177,NaN,NaN,-11.290448510271087,-2.551338028125853
2012-04-17T09:30:00-04:00,36.69,37.12,36.53,37.03,16311977,17117945.85,51.13670165443623,45.908729161752944,NaN,NaN,-15.779045663393747,-94.55381087967484,-0.0581314685459807,-0.188111593297549,-0.1299801247515683,44149417,20901217.8,49.476546241388846,42.75024834108143,NaN,NaN,-8.952444889198718,-3.4657818654219765
2012-04-18T09:30:00-04:00,36.85001,37.02,36.77,36.87,13415121,16964655.8,49.39068240609066,45.906489512494595,NaN,NaN,-12.07102031853639,-60.73795342633424,-0.02677932360805968,-0.1634542792616429,-0.13667495565358323,30734296,26901305.8,53.583429125903336,44.04078013056858,NaN,NaN,-7.712181648683251,-4.072410405887873
2012-04-19T09:30:00-04:00,36.89,36.97,36.25,36.46001,25315792,17757840.3,45.13769893364129,45.579252887045186,NaN,NaN,-56.66058003919875,-53.45184882725844,-0.030643154665550926,-0.17497889898552188,-0.14433574431997095,5418504,23022587.4,50.71358121916147,44.91573332658241,NaN,NaN,-8.099394153552884,-4.647693798411446
2012-04-20T09:30:00-04:00,36.78,36.94,36.62,36.77,18231728,17629425.9,48.732307017718064,45.3307157389488,NaN,NaN,-19.762539641346457,-37.48713128126327,-0.010359845278023194,-0.15728555091749996,-0.14692570563947677,23650232,26357977.8,53.04261296167696,45.730219385393944,NaN,NaN,-7.230958442807381,-5.016731604753722
2012-04-23T09:30:00-04:00,36.31,36.39999,36.08,36.36,25099232,18325751.15,44.572568385701445,44.534297450881716,NaN,NaN,-87.83768868820657,-38.422174870136374,-0.02192932825118868,-0.1743373659534626,-0.15240803770227393,-1449000,20500689.8,48.69117324297128,45.99505105071785,NaN,NaN,-7.866960820887161,-5.423907207058499
2012-04-24T09:30:00-04:00,36.53,36.86571,36.5,36.84,15002430,17932047.85,49.95805910209334,44.44172928184044,NaN,NaN,-13.161880944750763,-37.898741926407766,0.003990669202864672,-0.14741970119869308,-0.15141037040155775,13553430,14381492.4,44.57683615241475,45.72650244627264,NaN,NaN,-6.608362470220438,-5.593115101795919
2012-04-25T09:30:00-04:00,37.13,37.17,36.8,36.91,18132192,18270447.1,50.710199768882816,44.69391309370154,NaN,NaN,31.878041763853506,-29.108929509929805,0.025875239891883728,-0.11906632053670307,-0.1449415604285868,31685622,14571757.6,44.73320976019023,45.09753103647106,NaN,NaN,-5.382024975207234,-5.562959369426107
2012-04-26T09:30:00-04:00,36.83,37.17,36.75999,37.13,14809160,17682167.5,53.09626167693336,45.26953077728543,NaN,NaN,46.054563328302415,-8.565900836429574,0.0535969325726359,-0.07794539471279194,-0.13154232728542783,46494782,22787013.2,51.1430198627176,44.89627933235592,NaN,NaN,-3.636329528645163,-5.287726535028829
2012-04-27T09:30:00-04:00,37.33,37.44501,37.10001,37.36,13838289,17447705.95,55.52049508960486,46.544546768716316,NaN,NaN,93.55354933026075,14.097316957891872,0.08404002168300988,-0.026492300181665485,-0.11053232186467536,60333071,30123581,56.045753498481595,45.353416091192244,NaN,NaN,-1.4459592707549531,-4.738902640132562
2012-04-30T09:30:00-04:00,37.22,37.28,36.87,37.00999,16463738,17635323.1,51.1849237650944,47.99014780464809,NaN,NaN,54.3036082713243,42.525576349798044,0.07738652491743275,-0.01379916571788442,-0.09118569063531717,43869333,39187247.6,61.222818191506754,46.893341707414514,NaN,NaN,-0.8690476892885326,-4.186066218583415
2012-05-01T09:30:00-04:00,36.92999,37.3999,36.64,37.12,17562192,17293902.3,52.4419756551046,49.061286701852985,NaN,NaN,62.64078045895844,57.68610863053989,0.07701141626536975,0.005078579696395025,-0.07193283656897473,61431525,48762866.6,65.80519225427088,49.073748463398196,NaN,NaN,-0.029306001415554398,-3.5922433304165775
2012-05-02T09:30:00-04:00,36.86,37.16,36.78,37.13,10906445,17316868.9,52.56156214851634,49.411468036186704,NaN,NaN,63.76573703834969,64.06364768543912,0.07403321431176432,0.020608681320730682,-0.05342453299103364,72337970,56893336.2,69.13981200753992,51.51076384287824,NaN,NaN,0.6878155362160053,-2.9808063494690655
2012-05-03T09:30:00-04:00,37.14,37.2,36.73,36.83,12904898,17290232.55,48.612346497833464,49.80950105164896,NaN,NaN,44.82886066108145,63.81850715199492,0.0496273537204299,0.008609659159503735,-0.04101769456092617,59433072,59480994.2,70.13793023758296,54.094556511297604,NaN,NaN,0.20997883516181703,-2.5249798945217967
2012-05-04T09:30:00-04:00,36.64999,36.69,36.2,36.3,20063392,17766616.2,42.53237531202089,49.68486838669084,NaN,NaN,-59.70644950873566,33.16650738419565,-0.0017207260971091112,-0.043168602182312554,-0.04144787608520344,39369680,55288316,66.3911113908646,56.050216153333665,NaN,NaN,-2.0544234866535205,-2.4577575505406144
2012-05-07T09:30:00-04:00,36.10001,36.38,36.09,36.2,15554121,17853776.15,41.47826909479332,48.99498034671635,NaN,NaN,-91.916414522937,3.922502825343389,-0.03981839845094784,-0.09122087414888824,-0.0514024756979404,23815559,51277561.2,62.927950996205546,57.01103077867771,NaN,NaN,-4.223614893902279,-2.710022885306566
2012-05-08T09:30:00-04:00,35.98,36.17999,35.62,36.11,18183184,17690709.75,40.50528963502364,48.360309434497275,NaN,NaN,-148.5687805970813,-38.31940938586456,-0.0668848983487128,-0.1350085986338314,-0.0681237002851186,5632375,40117731.2,54.42148439612453,57.070891869407795,NaN,NaN,-6.301053440873872,-3.22302725038761
2012-05-09T09:30:00-04:00,35.67,36.03,35.46001,35.69,31136400,18285575.35,36.233720484087534,47.724310973814866,NaN,NaN,-186.2766638704538,-88.32788956762525,-0.10652578725748336,-0.2012809343569728,-0.09475514709948944,-25504025,20549332.2,43.35464425414362,56.54525351476366,NaN,NaN,-9.431093941300157,-4.109893920517973
2012-05-10T09:30:00-04:00,35.99001,36.13,35.66499,35.74001,13296703,17746498.5,37.084516573240535,46.89232594206647,NaN,NaN,-139.50984779789337,-125.19563125942022,-0.12173228470384864,-0.24692050297930024,-0.1251882182754516,-12207322,6221253.4,37.363400394452135,55.425309759961884,NaN,NaN,-11.767140821177552,-5.203786334897913
2012-05-11T09:30:00-04:00,35.52,36.05,35.50999,35.67,14050621,17557088.75,36.35326677981503,46.30523297021744,NaN,NaN,-137.70164877086492,-140.79467111184607,-0.12820857274136513,-0.285448934202158,-0.15724036146079287,-26257943,-6904271.2,32.88073539271919,54.29599277065817,NaN,NaN,-13.92269429276107,-6.44934461459265
2012-05-14T09:30:00-04:00,35.35001,35.56,35.11,35.255,23499408,17688851.15,32.288848515240986,45.04314649972798,NaN,NaN,-171.01420152857386,-156.61422851297343,-0.15059767950243724,-0.3454874608388394,-0.19488978133640217,-49757351,-21618853.2,28.720667969789844,53.1634093290421,NaN,NaN,-17.066557448879994,-7.966089305205127
2012-05-15T09:30:00-04:00,35.2,35.47,34.98,35.08,14061699,17576337.25,30.728673225507478,43.615894603772595,NaN,NaN,-158.06544993697204,-158.51356238095158,-0.16612747689364754,-0.4025491274534616,-0.23642165055981407,-63819050,-35509138.2,25.447609594175574,51.785866460041056,NaN,NaN,-20.19036634294867,-9.712414596311348
2012-05-16T09:30:00-04:00,35.35001,35.53,35,35.03999,14807656,17645964,30.367393540631213,41.99240402260816,NaN,NaN,-134.72595418719766,-148.20342044430035,-0.16755050985499192,-0.44585978787855396,-0.27830927802356203,-78626706,-46133674.4,23.263760429548256,49.79449078624324,NaN,NaN,-22.878919126572992,-11.593343814920154
2012-05-17T09:30:00-04:00,35.00999,35.07001,34.27,34.28999,23972496,17578799.2,24.542413986320398,39.77968394380212,NaN,NaN,-172.73631082901642,-154.84871305052496,-0.20498512005581343,-0.5345406780933288,-0.3295555580375154,-102599202,-64212050.4,20.102502775635628,47.227115734611395,NaN,NaN,-27.355164565429096,-13.845032493564288
2012-05-18T09:30:00-04:00,34.39999,34.62,34.02,34.12,21482320,17741328.8,23.44472616432428,37.798241258032824,NaN,NaN,-168.06010644723779,-160.92040458579953,-0.2255466193419497,-0.6114888322149525,-0.38594221287300284,-124081522,-83776766.2,17.35409723289547,44.09363566613916,NaN,NaN,-31.39226721311315,-16.351780310642695
2012-05-21T09:30:00-04:00,34.33,34.91,34.31,34.88,16473473,17310040.85,37.0094734956844,36.6959196752171,NaN,NaN,-111.49385415633184,-149.01633511135114,-0.17459065628173814,-0.6041805332251755,-0.42958987694343737,-107608049,-95346905.8,15.964067826469403,40.53355534986762,NaN,NaN,-30.612916543172343,-18.389085486718358
2012-05-22T09:30:00-04:00,35.00999,35.2301,34.765,35.00999,14395973,17279718,39.000352890476215,35.72726187107137,NaN,NaN,-78.60018520506414,-133.12328216496957,-0.1212879680907133,-0.581199837056829,-0.4599118689661157,-93212076,-101225511,15.293786140497446,36.68741064507888,NaN,NaN,-29.348883283411475,-19.954770886245946
2012-05-23T09:30:00-04:00,34.72,35.27,34.38,35.2,25824336,17664325.2,41.89143902875085,35.24719705185119,NaN,NaN,-75.42554943904334,-121.26320121533868,-0.06520183704915417,-0.5414141652775584,-0.4762123282284042,-67387740,-98977717.8,16.733417412132326,32.87280258611811,NaN,NaN,-27.402015087205083,-21.018662914954394
2012-05-24T09:30:00-04:00,35.28999,35.33009,34.77,35.16,13768070,17612270.7,41.446105236480385,35.16960633216972,NaN,NaN,-58.48736617356401,-98.41341228424818,-0.024841318299356374,-0.5072639761025997,-0.4824226578032433,-81155810,-94689039.4,19.543061539061696,29.526513310989333,NaN,NaN,-25.967684450199606,-21.725665991417994
2012-05-25T09:30:00-04:00,35.17,35.24001,34.8399,34.92,8026492,17321680.85,38.782142743012535,34.9770258784711,NaN,NaN,-59.5259237824799,-76.7065757512966,-0.009159988138012887,-0.4938726429757594,-0.4847126548377465,-89182302,-87709195.4,24.03565666263404,26.7484922871628,NaN,NaN,-25.517766551290684,-22.26739464282838
2012-05-29T09:30:00-04:00,35.21001,35.5,35.175,35.39,14105277,17203757.8,46.089925261198026,35.37592842319784,NaN,NaN,-21.590494444961283,-58.7259038090225,0.035562282268588596,-0.44025980200201076,-0.47582208427059935,-75077025,-81202990.6,28.067693238989477,24.86607863308172,NaN,NaN,-22.831739738703817,-22.348015370810582
2012-05-30T09:30:00-04:00,35.07001,35.07001,34.73,34.8,15655434,17108419.9,39.685525124025745,35.622485897479145,NaN,NaN,-64.89572449818313,-55.985011667646326,0.02841465880811922,-0.4403037607604503,-0.4687184195685695,-90732459,-80707067.2,28.379741748325827,23.796442739809027,NaN,NaN,-22.510791466127188,-22.371269098712954
2012-05-31T09:30:00-04:00,34.7,34.92,34.265,34.67,17828672,17454531.25,38.418772074938026,35.71778986188611,NaN,NaN,-89.06321305432239,-58.712544390702135,0.01842204359230265,-0.4456908650781912,-0.4641129086704939,-108561131,-88941745.4,26.336704562903776,23.008821608984142,NaN,NaN,-22.651792515740848,-22.411343872574083
2012-06-01T09:30:00-04:00,33.98,34.14999,33.67,33.71001,24430464,18030809.55,30.640777321980437,35.30975490061221,NaN,NaN,-177.7998838156614,-82.5750479191216,-0.04583993829326094,-0.5214128315370701,-0.47557289324380914,-132991595,-99308902.4,23.99473367206683,22.374107200366122,NaN,NaN,-25.553806158858933,-22.86026705632906
2012-06-04T09:30:00-04:00,33.73,33.77,33.08,33.36,23893056,18222292.75,28.384445313506006,35.03086895763114,NaN,NaN,-208.9567404689791,-112.46121125642144,-0.10171621148941068,-0.6027181576055725,-0.5010019461161618,-156884651,-112849372.2,21.32718507966416,21.84600127964286,NaN,NaN,-28.685180710668163,-23.692397578377506
2012-06-05T09:30:00-04:00,33.27,33.50999,33.14,33.455,17784496,18333811.5,29.89344683288796,34.97120992958689,NaN,NaN,-182.5872967694882,-144.66057172132682,-0.1207760279685488,-0.6519719810768478,-0.531195953108299,-139100155,-125653998.2,19.15814440377602,21.396753766042895,NaN,NaN,-30.63014365379707,-24.683504160580302
2012-06-06T09:30:00-04:00,33.75999,34.36,33.69991,34.345,20089616,18429133.1,42.18423370678081,35.81526994145472,NaN,NaN,-80.12614074879579,-147.70665497144938,-0.06475053982279866,-0.6121341278867973,-0.5473835880639987,-119010539,-131309614.2,18.27411208441069,21.04035031281878,NaN,NaN,-28.01342404484664,-25.159207001189777
2012-06-07T09:30:00-04:00,34.77,35.06,34.485,34.53999,21550224,17949824.3,44.480760909171636,37.23943757880124,NaN,NaN,-7.545880556191609,-131.4031884718232,-0.008806321000544903,-0.5583914893146797,-0.5495851683141348,-97460315,-129089451,19.83788446735764,21.021449005084634,NaN,NaN,-25.180726292996493,-25.162281185733594
2012-06-08T09:30:00-04:00,34.53,34.83,34.32001,34.8,12402066,17905092.45,47.47674390968245,38.95601027489825,NaN,NaN,-6.24607888485136,-97.0924274856612,0.04832376727839871,-0.4891804592161364,-0.5375042264945351,-85058249,-119502781.8,26.38773788063365,21.66670905135165,NaN,NaN,-21.900810421271277,-24.696356790810405
2012-06-11T09:30:00-04:00,35.16,35.17999,34.31,34.345,15671324,17986127.6,43.09425115633548,39.39063725065904,NaN,NaN,-4.032895821999124,-56.10765855626522,0.05746187448132911,-0.4656768833928737,-0.5231387578742028,-100729573,-108271766.2,33.26695942112843,22.902629879541585,NaN,NaN,-20.569913424428286,-24.106864881327244
2012-06-12T09:30:00-04:00,34.50999,34.935,34.33,34.89999,20210800,17821697.2,49.24815315572792,40.122622983891304,NaN,NaN,18.381060179504384,-15.9139871664667,0.1003647380693245,-0.3976828352875472,-0.4980475733568717,-80518773,-96555489.8,39.60751473295133,24.63932477900258,NaN,NaN,-17.345800528937293,-23.140998545271536
2012-06-13T09:30:00-04:00,34.75,34.89999,34.39,34.55,22045136,18220869.05,45.878690786231594,40.407426680854215,NaN,NaN,5.5898843602320465,1.2292178553388649,0.10419919688307061,-0.36779857725303344,-0.47199777413610405,-102563909,-93266163.8,41.29395588609025,26.39364895571386,NaN,NaN,-15.819752761369058,-22.095106290428326
2012-06-14T09:30:00-04:00,34.64,34.96001,34.42999,34.82001,22124992,18586735.85,48.78965749509681,40.93196612789825,NaN,NaN,31.409403478632367,9.020274662303663,0.12267478831786138,-0.3186542887387773,-0.4413290770566387,-80438917,-89861884.2,43.06595427648567,28.073855579815568,NaN,NaN,-13.636687073488455,-20.886760688008344
2012-06-15T09:30:00-04:00,34.82001,34.97,34.75999,34.955,12906063,18033414.2,50.230893879317044,41.74973406620571,NaN,NaN,55.03941837006265,21.277374113286466,0.14046237537537165,-0.26575110783742417,-0.4062134832127958,-67532854,-86356805.2,44.90974884258752,29.564862164097956,NaN,NaN,-11.435146658711094,-19.536530112394452
2012-06-18T09:30:00-04:00,34.81,35.17,34.7,35.03999,13381031,17628349.75,51.16281483305499,42.112083321338346,NaN,NaN,64.76784637355932,35.03752255239816,0.1533752545549366,-0.21449441501912503,-0.36786966957406164,-54151823,-77041255.2,49.58293831791897,31.101665384021494,NaN,NaN,-9.37543968625833,-18.084945765803578
2012-06-19T09:30:00-04:00,35.2005,35.69501,35.19,35.50999,12630301,17436191.15,56.06251132236207,43.281868049790944,NaN,NaN,137.59447382358786,58.880205281214856,0.18677671232795123,-0.13439877916412257,-0.3211754914920738,-41521522,-69241805,53.16512469136414,32.8720498799528,NaN,NaN,-6.064258050068435,-16.3677046635557
2012-06-20T09:30:00-04:00,35.39999,35.50999,35.07001,35.32001,20907584,17761771.7,53.71654727213781,44.374566278162355,NaN,NaN,104.11924429033469,78.58607726723538,0.1887249709490475,-0.08526927780576443,-0.27399424875481193,-62429106,-61214844.4,56.584065812203136,35.032575683474185,NaN,NaN,-4.005604636205047,-14.601690373934177
2012-06-21T09:30:00-04:00,35.44,35.535,34.59,34.625,16671664,17304138.1,46.1141454095862,45.47980685584849,NaN,NaN,41.74893840227803,80.65398425196452,0.13819686561341876,-0.10124816673803849,-0.23944503235145725,-79100770,-60947215,56.69756739564472,37.36849237801546,NaN,NaN,-4.539242707247909,-13.164197850121854
2012-06-22T09:30:00-04:00,34.73,34.83,34.49001,34.75,11993043,17215386.75,47.551872201769676,46.84890877643875,NaN,NaN,8.065791644623207,71.25925890687662,0.10944250265728983,-0.10264190402984497,-0.2120844066871348,-67107727,-60862189.6,56.736264309749366,39.89771232302155,NaN,NaN,-4.53523955557599,-11.931489522329587
2012-06-25T09:30:00-04:00,34.34,34.39999,33.97,34.105,20371568,17832640.55,41.411964912666235,47.67166006785148,NaN,NaN,-72.01168680491058,43.90335227118264,0.04645380807654237,-0.15401714659145682,-0.2004709546679992,-87479295,-67527684,52.75606516037347,42.297563805635654,NaN,NaN,-6.5132887189964,-11.157460836139132
2012-06-26T09:30:00-04:00,34.17,34.27,33.84,34.17,13684516,17811602.5,42.22161601057737,47.67433023240837,NaN,NaN,-70.11725615143882,2.3610062761773065,0.010514332801796089,-0.1873280386657541,-0.19784237146755018,-73794779,-73982335.4,49.15958722215445,44.50366917261736,NaN,NaN,-7.844983997204818,-10.684249859148515
2012-06-27T09:30:00-04:00,34.3,34.58,34.24001,34.5,14267590,17742210.3,46.2804962287593,47.80288275523606,NaN,NaN,-12.183251908892801,-20.89949296366819,0.01030050745906022,-0.1849667371437249,-0.19526724460278513,-59527189,-73401952,49.49300092400991,46.62189177666394,NaN,NaN,-7.7531666006765265,-10.265523679366803
2012-06-28T09:30:00-04:00,34.25999,34.50999,34.06,34.47,18115360,17756544.7,45.96437460947515,47.69485637664983,NaN,NaN,-24.568935218130267,-34.163067687749844,0.009492200536211942,-0.1834019939325202,-0.19289419446873216,-77642549,-73110307.8,49.67161284176771,48.28502570245923,NaN,NaN,-7.769980414053955,-9.909017498607824
2012-06-29T09:30:00-04:00,35.23,35.67,35.07001,35.67,18559824,17463012.7,58.24912742064855,48.77734753838648,NaN,NaN,142.5698746411792,-7.262251088438651,0.08682774871116161,-0.08435950857978014,-0.17118725729094175,-59082725,-71505307.4,50.70477899635505,49.53058424354685,NaN,NaN,-3.634225182321276,-9.012618596281174
2012-07-02T09:30:00-04:00,35.75999,35.82001,35.12,35.36,14682391,17002479.45,54.784105802168156,49.17277272741792,NaN,NaN,132.8478602145839,33.709658315460246,0.1125257237696613,-0.030530102578865126,-0.14305582634852643,-73765116,-68762471.6,52.49937154806171,50.45143115891187,NaN,NaN,-1.411523579207395,-7.926747879556348
2012-07-03T09:30:00-04:00,35.33,35.74001,35.3,35.73,10841781,16655343.7,57.99579841122217,50.03828041491725,NaN,NaN,144.2314963675924,76.57940881926649,0.14765068057827513,0.041507524374317484,-0.10614315620395764,-62923335,-66588182.8,53.93113303750635,51.354086669727316,NaN,NaN,1.4780891497739084,-6.583199732509169
2012-07-05T09:30:00-04:00,35.53,35.84,35.47,35.69,8770938,16089409.8,57.52012853712219,50.66188548934763,NaN,NaN,137.46782022986142,106.50962324701734,0.16034121070678822,0.09428335717952763,-0.0660578535272606,-71694273,-69021599.6,52.040544124290996,51.995128801713406,NaN,NaN,3.613406053320393,-5.126541763104946
2012-07-06T09:30:00-04:00,35.36,35.36,34.99001,35.21001,9874934,15505645.3,52.00780704793201,50.78880785853442,NaN,NaN,49.154147760910945,121.25423984282557,0.1298604343038096,0.0962676893525014,-0.03359274495130819,-81569207,-69806931.2,51.41413033309424,52.45972747960674,NaN,NaN,3.746212583574259,-3.8590054278650596
2012-07-09T09:30:00-04:00,34.92999,35.27,34.89,35.19,7220680,15246576,51.78500545091768,50.83325004552461,NaN,NaN,33.35945523846172,99.41215596228207,0.10297744280523057,0.09512905855523002,-0.007848384250000548,-88789887,-75748363.6,46.822211768810014,52.26253272609896,NaN,NaN,3.786446305004551,-2.766798037455115
2012-07-10T09:30:00-04:00,35.39999,35.495,34.41,34.62,32477824,16086901,45.76991314356314,50.09806446132468,NaN,NaN,-15.929020557940936,69.6567798077771,0.044424940675023616,0.04768279159377897,0.003257850918755356,-121267711,-85248882.6,40.580920742720394,51.363661015481554,NaN,NaN,1.9591020889332407,-2.0916694479710642
2012-07-11T09:30:00-04:00,34.60001,34.66,34.17,34.34,22717872,16212254.6,43.120268769975006,49.341187425455914,NaN,NaN,-88.66402641487579,23.077675251283473,-0.012502109182547239,-0.012369785559428692,0.0001323236231185465,-143985583,-101461332.2,32.59596751161081,49.650225422582096,NaN,NaN,-0.38649488865769405,-1.8480730823548686
2012-07-12T09:30:00-04:00,34.14,34.38,33.87,34.21001,31598336,16689914.6,41.90734300207011,49.04070153920477,NaN,NaN,-117.77150244933607,-27.97018928455602,-0.05582436443980772,-0.0696481319266411,-0.013823767486833383,-175583919,-122239261.4,25.634338175596184,47.43142333543578,NaN,NaN,-2.671431490047725,-1.9656957120252767
2012-07-13T09:30:00-04:00,34.28,34.89,34.23,34.87,23745328,16770931.4,49.65114835137924,49.19064983560545,NaN,NaN,-35.64116236808756,-44.929251310355724,-0.037806460721714216,-0.061081843388976154,-0.023275382667261937,-151838591,-136293138.2,22.18328643854798,44.963353487492824,NaN,NaN,-2.34462696431018,-2.019828748065977
2012-07-16T09:30:00-04:00,34.71001,34.74001,34.38,34.63,15931586,16922207.55,47.187823417113684,49.6032111573517,NaN,NaN,-44.22831422617575,-60.44680520328321,-0.039635352688108125,-0.0728195735273971,-0.03318422083928897,-167770177,-152089196.2,19.074937627239066,42.5575586636975,NaN,NaN,-2.8285409245798596,-2.135359058996532
2012-07-17T09:30:00-04:00,34.56,34.92,34.32001,34.78,17282160,17117264,48.89439929835113,50.07983853504983,NaN,NaN,-28.024422185002745,-62.86588552869557,-0.02882873227916284,-0.06922013618824252,-0.04039140390907968,-150488017,-157933257.4,18.066325004592116,40.336611362443044,NaN,NaN,-2.722797084974712,-2.2192787769934146
2012-07-18T09:30:00-04:00,34.67,35.52,34.67,35.42999,30368432,18004170.55,55.59111022227663,50.74488239172964,NaN,NaN,56.27424029963166,-33.878232185794076,0.021304981841680337,-0.013760176606979257,-0.035065158448659595,-120119585,-153160057.8,21.70765546973999,38.35194382999519,NaN,NaN,-0.520575598576839,-1.9766068943624753
2012-07-19T09:30:00-04:00,35.52,35.715,35.34,35.595,14611578,17689370.25,57.12701758789993,51.542214033045695,NaN,NaN,104.53095333915053,10.582258971903244,0.06246121531100335,0.04301136069009459,-0.019449854620908757,-105508007,-139144875.4,31.354466796476373,37.04357625533152,NaN,NaN,1.7458685422261584,-1.4448246891355276
2012-07-20T09:30:00-04:00,35.36,35.5,35.12,35.16,16714879,17691531,52.01933844213557,51.09722910600906,NaN,NaN,55.71239108342805,28.85296966220637,0.05739946185321383,0.05229947269560853,-0.0050999891576052996,-122222886,-133221734.4,34.99964062984586,35.92178065772373,NaN,NaN,2.135421524006248,-0.9333609444009883
2012-07-23T09:30:00-04:00,34.62,35.11,34.5,34.98,15299043,17856831,50.02615569940963,50.75737552724058,NaN,NaN,-3.0968045227084993,37.07927160289982,0.039777194350345865,0.04462150378032703,0.0048443094299811685,-137521929,-127172084.8,38.58664275229842,34.9280143151692,NaN,NaN,1.8580255007313922,-0.5345914522392197
2012-07-24T09:30:00-04:00,35.00999,35.06,34.32001,34.59,22018400,17939172.6,45.92064612704525,49.89486464979938,NaN,NaN,-39.18950446334402,34.846255147231545,0.0017136586897858004,0.006986382792213419,0.005272724102427619,-159540329,-128982547.2,37.912362109693284,33.78381639175399,NaN,NaN,0.3666857673550969,-0.40583756372574586
2012-07-25T09:30:00-04:00,34.84,35.02,34.48,34.71001,23364960,18423194.8,47.35245668743125,49.168602374821454,NaN,NaN,-34.062956754614646,16.778815736382285,-0.014622973453642,-0.013005992714624881,0.0016169807390171188,-136175369,-132193704,36.68779662614466,32.68719157045781,NaN,NaN,-0.4405050414140173,-0.4107900605383561
2012-07-26T09:30:00-04:00,35.11,35.39,34.97,35.24001,16735832,18546606.9,53.24045239959217,49.256648471368614,NaN,NaN,37.84431860276922,3.4414887891060233,0.009712722562396655,0.013757883942012938,0.004045161379616283,-119439537,-134980010,35.612914915689416,31.55853332635747,NaN,NaN,0.6337332439531542,-0.26157244561099746
2012-07-27T09:30:00-04:00,35.28999,36.19,35.28999,36.00999,18798368,18580757.3,60.20381586543091,49.857992072405274,NaN,NaN,132.02280116926286,18.703570806272985,0.07355815422041491,0.09599285415513492,0.022434699934720012,-100641169,-130663666.6,38.61335397940687,30.9721863414001,NaN,NaN,3.912297796262445,0.33469473179949427
2012-07-30T09:30:00-04:00,35.96001,36.17,35.8,35.91,12948363,18300184.25,58.975577183306065,50.80125378952976,NaN,NaN,141.97843773578828,47.718619257972335,0.10313353281675895,0.1513516159556687,0.048218083138909754,-113589532,-125877187.2,41.84947373526867,31.062797269439262,NaN,NaN,6.136016044767137,1.1634549193663002
2012-07-31T09:30:00-04:00,35.89999,36.09,35.795,35.81,13125238,18222326.6,57.70757588427772,51.84320429769424,NaN,NaN,122.13629676920166,79.98377950448148,0.10944301549859262,0.18502185251215053,0.07557883701355791,-126714770,-119312075.4,46.050440069615625,32.02383102358247,NaN,NaN,7.562000691746322,2.0775328868491605
2012-08-01T09:30:00-04:00,35.99001,36.05,35.55,35.57001,17120496,18536262.35,54.669686799379036,52.75480028321631,NaN,NaN,93.01439593866412,105.39925004313723,0.09165585432020953,0.19014865491381983,0.09849280059361029,-143835266,-120844054.8,45.22931178170039,33.42347199544705,NaN,NaN,7.873725337747844,2.9055603798346867
2012-08-02T09:30:00-04:00,35.44,35.59,35,35.39,16934384,18944434.65,52.43977310014293,52.95398776527087,NaN,NaN,36.9035532504769,105.21109697267875,0.06331669722438352,0.17763867212408968,0.11432197489970616,-160769650,-129110077.4,40.98302265707282,34.76631029677026,NaN,NaN,7.491827865173486,3.560741449168801
2012-08-03T09:30:00-04:00,35.84,36.32001,35.83,36.16,16954400,19298407.95,59.9626735594279,53.86647706115044,NaN,NaN,137.38510551724877,106.28355784227594,0.09033244619962205,0.22723753264923374,0.1369050864496117,-143815250,-137744893.6,37.06803547422178,36.05153157155474,NaN,NaN,9.499900644399371,4.409192762773168
2012-08-06T09:30:00-04:00,36.32001,36.465,36.16,36.16,14753059,19675026.9,59.9626735594279,54.6570680797988,NaN,NaN,137.26354605342505,105.34057950580329,0.1012818806379164,0.2635074372470072,0.1622255566090908,-143815250,-143790037.2,34.57768495377235,37.23091442506762,NaN,NaN,11.092366296257035,5.363931838985149
2012-08-07T09:30:00-04:00,36.31,36.7,36.31,36.53,16614141,18881842.75,63.20605562285316,55.20099275126854,NaN,NaN,145.34699388190822,109.98271892834461,0.12496896665369081,0.3184367649262043,0.1934677982725135,-127201109,-143887305,34.53747822984991,38.147330336504034,NaN,NaN,13.447744278868706,6.518762187539942
2012-08-08T09:30:00-04:00,36.39,36.53,36.2943,36.48,10220066,18256952.45,62.469586343882966,55.58260480526733,NaN,NaN,120.09680548264117,115.39920083714003,0.12830980136187226,0.35385504997485384,0.22554524861298159,-137421175,-142604486.8,35.60103906917938,38.45065692741139,NaN,NaN,15.155802697735785,7.75262511756792
2012-08-09T09:30:00-04:00,36.46001,36.59,36.37109,36.50999,12669711,17310521.2,62.749945025622495,56.34907670408783,NaN,NaN,114.25537309683008,130.86956480641066,0.12353519878403713,0.379964247093028,0.2564290483089909,-124751464,-135400849.6,41.36230472904647,38.905132934497146,NaN,NaN,16.639983614424544,9.02224775997601
2012-08-10T09:30:00-04:00,36.37,36.7,36.28,36.67999,10448957,16645702.65,64.37455134943997,57.37396210766142,NaN,NaN,109.52772228599449,125.29808816015979,0.12257783929873967,0.4096513474324155,0.2870735081336758,-114302507,-129498301,45.65262796054909,39.40984616365791,NaN,NaN,18.357417706414118,10.355843466610025
2012-08-13T09:30:00-04:00,36.61,36.64,36.35001,36.60001,13026129,16500429.8,62.98280408824449,58.592687676318505,NaN,NaN,97.9991605282038,117.44521105511555,0.1078307209058928,0.42186190926604183,0.31403118836014904,-127328636,-126200978.2,47.94397413863269,40.12638988001073,NaN,NaN,19.445721207234214,11.654397429556338
2012-08-14T09:30:00-04:00,36.78,36.78,36.46001,36.55,9495621,16111102.85,62.07904777345443,59.644587039605874,NaN,NaN,97.71248258482763,107.91830879569943,0.08688036445618486,0.4226316439303801,0.33575127947419525,-136824257,-128125607.8,46.706156498063585,40.841987013719226,NaN,NaN,20.13749034912524,12.86626784663761
2012-08-15T09:30:00-04:00,36.36,36.69,36.35001,36.63,9976934,15091527.95,62.99383737950889,60.34125739531421,NaN,NaN,85.01788996569033,100.90252569230927,0.07123910742129719,0.42480016375081675,0.35356105632951956,-126847323,-126010837.4,48.28606158279706,41.74721177565549,NaN,NaN,20.963570884265444,14.023025423441586
2012-08-16T09:30:00-04:00,36.62,37.07001,36.56,37,12785992,15000248.65,66.96332733946645,60.824079643459605,NaN,NaN,110.652295568708,100.18191018668486,0.07809018575610349,0.45117378852464896,0.37308360276854546,-114061331,-123872810.8,49.903024377190015,42.55361680406856,NaN,NaN,22.79336917691284,15.27593167393748
2012-08-17T09:30:00-04:00,37,37.21001,37,37.17999,8877570,14608383.2,68.72102626219521,61.52018314909456,NaN,NaN,126.02242425088146,103.48085057966225,0.08637590167315362,0.4810534798599875,0.39467757818683386,-105183761,-122049061.6,51.30178109201064,43.22878161526442,NaN,NaN,24.864720968775238,16.64575871605716
2012-08-20T09:30:00-04:00,37.08,37.17,36.92999,37.10001,6612367,14174049.4,67.01480001517248,62.18498487272989,NaN,NaN,111.13361650909927,106.10774177584135,0.0783389234987022,0.4926012325602116,0.4142623090615094,-111796128,-118942560,53.674477398618315,43.77335571019318,NaN,NaN,26.179508696298864,18.007722998948832
2012-08-21T09:30:00-04:00,37.23,37.39,36.92039,37.02,10171258,13581692.3,65.2689725867063,62.94207671468183,NaN,NaN,111.32756004640686,108.83075726815719,0.06031204378431043,0.48965236379189747,0.42934032000758704,-121967386,-115971185.8,55.88835098962922,44.534715653616665,NaN,NaN,26.854847177080956,19.271597881539137
2012-08-22T09:30:00-04:00,36.88,37,36.69,36.84,10960367,12961462.65,61.39399328651361,63.58166387085117,NaN,NaN,73.06728645052493,106.44063656512412,0.030450094591085552,0.46740293824644397,0.4369528436553584,-132927753,-117187271.8,54.73544792711413,45.517031744333906,NaN,NaN,26.431328244075157,20.29441650475857
2012-08-23T09:30:00-04:00,36.78999,36.78999,36.46001,36.53999,11984980,12723920.05,55.481646978604694,63.26159054364951,NaN,NaN,30.67515749467036,90.44520895031658,-0.012992593906588246,0.4207121012721231,0.43370469517871135,-144912733,-123357552.2,49.19072308989263,46.382938002596106,NaN,NaN,24.40237254758556,20.881267368019568
2012-08-24T09:30:00-04:00,36.41,36.80499,36.405,36.71001,8736145,12220808.9,57.95290957017956,63.11803597298892,NaN,NaN,34.01579622414386,72.04388334496906,-0.03264425990710135,0.3928993702948347,0.42554363020193603,-136176588,-129556117.6,44.332227164184346,47.07969101762553,NaN,NaN,23.310830070919113,21.228347754148075
2012-08-27T09:30:00-04:00,36.78,36.83,36.57001,36.60001,5976965,11872239,55.794908132603716,62.588668295113955,NaN,NaN,35.20778053541497,56.858716150232205,-0.05414982046113992,0.35785635462551113,0.41200617508665105,-142153553,-135627602.6,40.14925870922736,47.48053248043821,NaN,NaN,21.78431510877789,21.307771661952334
2012-08-28T09:30:00-04:00,36.56,36.64999,36.45,36.46001,8513535,11641653.85,53.08551186667412,61.91837726102761,NaN,NaN,-1.6449466787671836,34.2642148051974,-0.07748112070524249,0.31515477420509797,0.39263589491034045,-150667088,-141367543,36.630385131187694,47.554057199153085,NaN,NaN,19.716810382733136,21.080491479206735
2012-08-29T09:30:00-04:00,36.46001,36.59,36.32001,36.45,8432031,11207230.6,52.88775851752066,61.213935367591766,NaN,NaN,-29.916965603702383,13.667364394351925,-0.0922614406381162,0.2773090941126952,0.3695705347508114,-159099119,-146601816.2,33.72741309655531,47.00870779683229,NaN,NaN,17.9362525649309,20.631314491453043
2012-08-30T09:30:00-04:00,36.32001,36.34,36.05,36.14,8604039,10790713.35,47.043136766153054,59.97597718307127,NaN,NaN,-136.8628342284871,-19.84023395027956,-0.11984174146061072,0.219768357925048,0.3396100993856587,-167703158,-151159901.2,31.39416449989676,45.990246121071415,NaN,NaN,14.64725061211315,19.776448222975915
2012-08-31T09:30:00-04:00,36.38,36.53,36.13,36.36,9433047,10414645.7,51.16749099049627,59.13202624751783,NaN,NaN,-92.22178916465127,-45.08775102803859,-0.11990251199082952,0.18973195939712184,0.30963447138795136,-158270111,-155578605.8,29.279511827549555,44.657070241708325,NaN,NaN,12.896557977189351,18.79360675929212
2012-09-04T09:30:00-04:00,36.24001,36.32001,35.82001,35.98,17603072,10557146.35,44.69282835990772,57.89015343226449,NaN,NaN,-181.1197719534885,-88.35326152581929,-0.14072870459611947,0.13372359064280204,0.2744522952389215,-175873183,-162322531.8,26.361042049262707,43.203847781079695,NaN,NaN,9.31572235873414,17.439623273498125
2012-09-05T09:30:00-04:00,35.99001,36.06,35.75,35.88,11777293,10315303.95,43.145578660536884,56.472420666623634,NaN,NaN,-193.2393708412777,-126.67214635832138,-0.15528882298176402,0.08034126651171647,0.2356300894934805,-187650476,-169719209.4,23.584372079009768,41.43944138795204,NaN,NaN,5.885339721805137,15.789011337541984
2012-09-06T09:30:00-04:00,36.08,36.7,36.08,36.685,12695180,10439059.65,56.27005681222036,55.708615628963194,NaN,NaN,-25.948890523298115,-125.87853134224054,-0.10704930158106893,0.10181846251714433,0.20886776409821325,-174955296,-172890444.8,22.490570283345917,39.481408952677455,NaN,NaN,6.9848484611595225,14.531273783773061
2012-09-07T09:30:00-04:00,36.8,37.03999,36.78999,37,10639066,10337527.4,60.146908391348425,55.09617863818843,NaN,NaN,92.44837766085442,-80.01628896437224,-0.053003646275855576,0.1426132062533938,0.19561685252924937,-164316230,-172213059.2,23.30875668160506,37.48190720907706,NaN,NaN,9.24699730495372,13.776377143941726
2012-09-10T09:30:00-04:00,36.89,36.98,36.75,36.75999,8961594,10263159.25,56.06822026107592,54.31428008432439,NaN,NaN,55.72606632255383,-50.42671786693121,-0.033450616844147296,0.15380358147406525,0.18725419831821255,-173277824,-175214601.8,22.190949651235655,35.23308379854972,NaN,NaN,9.710194604486565,13.19549392401956
2012-09-11T09:30:00-04:00,36.75,37.06,36.73,36.96001,10463629,10135034.25,58.588544708492904,53.83710666445201,NaN,NaN,70.23071334017165,-0.1566208081991732,-0.008383971857567285,0.17677423349625343,0.18515820535382072,-162814195,-172602804.2,25.53726158596578,33.06514884114519,NaN,NaN,10.920949179375269,12.870558960498947
2012-09-12T09:30:00-04:00,37.07001,37.17999,36.94,37.11,8450344,10082770.4,60.42214017375843,53.76768858496949,NaN,NaN,96.95298542984604,57.88185044602558,0.01565077663842787,0.20472167615185555,0.18907089951342768,-154363851,-165945479.2,33.399702594630725,31.54116703168209,NaN,NaN,12.49051482568607,12.816266941239965
2012-09-13T09:30:00-04:00,37.02,37.69,36.85001,37.53,16405691,10404208.25,65.08418917387874,54.45358445606048,NaN,NaN,138.61217189760464,90.79406293020611,0.05497454729520304,0.25778908363243147,0.20281453633722843,-137958160,-158546052,40.87261809819479,30.94701667513225,NaN,NaN,15.416060698314956,13.187666049393535
2012-09-14T09:30:00-04:00,37.38,38.07001,37.38,37.75999,12252980,10377557.65,67.35209097345705,55.1249545562946,NaN,NaN,184.51503020657228,109.2073934393497,0.08956847139201082,0.31477512557724197,0.22520665418523114,-125705180,-150823842,47.49403235044455,31.172859902722262,NaN,NaN,18.571736628020457,13.95681898919738
2012-09-17T09:30:00-04:00,37.62,37.71001,37.49001,37.58,7801449,10323751.6,63.85641817257287,55.70077670200668,NaN,NaN,144.34781094126865,126.93174236309264,0.09301623815638124,0.3414769518807077,0.24846071372432646,-133506629,-142869603,53.29579318998915,32.111898079919534,NaN,NaN,20.054256714034388,14.827881521316952
2012-09-18T09:30:00-04:00,37.45,37.60001,37.42,37.59,8073094,10396787.95,63.96831058154954,56.478119467354915,NaN,NaN,122.84197375273288,137.4539944456049,0.0886741744018657,0.3593034317266586,0.27062925732479287,-125433535,-135393471,57.99393541192112,33.637865957114784,NaN,NaN,21.265442755032446,15.747533126133451
2012-09-19T09:30:00-04:00,37.52,37.745,37.41,37.67999,9284230,10352436.55,65.01784088149502,57.34455392192451,NaN,NaN,123.41533758166888,142.74646487596948,0.0845798824975128,0.3763541104466839,0.29177422794917107,-116149305,-127750561.8,62.182188994462514,35.67034994982244,NaN,NaN,22.571722867338877,16.722417374877082
2012-09-20T09:30:00-04:00,37.35001,37.36,37.14999,37.32001,12558141,10432325.25,57.76891927721528,58.11068124414324,NaN,NaN,64.95393825314365,128.01481814707728,0.05194670988683309,0.35670761530771244,0.30476090542087936,-128707446,-125900419,63.140274570473814,37.937929240577944,NaN,NaN,21.55796793343642,17.41321031181413
2012-09-21T09:30:00-04:00,37.25,37.28,36.84,36.97501,15045805,10585366.5,51.80738633270233,58.15638805430081,NaN,NaN,25.857234034019157,96.28325891256664,0.003974196115852757,0.3097286505656953,0.30575445444984256,-143753251,-129510033.2,59.949237856844256,40.12862395695613,NaN,NaN,18.797235754471263,17.61092823219372
2012-09-24T09:30:00-04:00,36.74001,37.06,36.7,36.965,11603129,10728715.7,51.640869967976734,58.65267674059146,NaN,NaN,5.783835673827165,68.57046385907834,-0.02972869987385357,0.2685935796075256,0.2983222794813792,-155356380,-133879983.4,56.24331295894464,42.26307187907628,NaN,NaN,16.54218778327895,17.458251025205897
2012-09-25T09:30:00-04:00,36.96001,37.02,36.47,36.48,14575223,11158628.6,44.22407401661113,58.7297121231682,NaN,NaN,-32.07384727782477,37.58729965296681,-0.08296590880375737,0.19461489347668248,0.27758080228043985,-169931603,-142779597,49.528315511411456,44.11621069567639,NaN,NaN,12.101849341540175,16.69305078468222
2012-09-26T09:30:00-04:00,36.5,36.505,36.205,36.33501,12515113,11358707.5,42.26959134305816,57.729678875370894,NaN,NaN,-75.63121665104399,-2.222011193575767,-0.12376832421654177,0.12287039700976266,0.24663872122630442,-182446716,-156039079.2,41.565786049202764,45.47872610752331,NaN,NaN,7.841947601410956,15.428607472786325
2012-09-27T09:30:00-04:00,36.48,36.73,36.3,36.67999,13296766,11601944.25,48.14215937413854,56.87219680271304,NaN,NaN,-44.416734547552686,-24.096145753715025,-0.1230870881286592,0.09277986106548042,0.21586694919413962,-169149950,-164127580,37.59518814692527,46.499185497903326,NaN,NaN,5.969692744897609,14.077333940230794
2012-09-28T09:30:00-04:00,36.47,36.67999,36.25999,36.53,13149207,11829202.65,45.9534186371913,56.149710972435564,NaN,NaN,-61.10010424463705,-41.48761340944627,-0.1277477031614774,0.05618232024229286,0.18393002340377027,-182299157,-171836761.2,34.23815824208627,47.359700397249796,NaN,NaN,3.753574518854351,12.602511165748446
2012-10-01T09:30:00-04:00,36.72,37.02,36.58,36.6991,14697953,12092447.95,48.780695984280385,55.44915034927753,NaN,NaN,-22.627445387955714,-47.169869621802846,-0.11485742864278634,0.04035823760028734,0.15521566624307367,-167601204,-174285726,33.22325622515859,47.908700014335,NaN,NaN,2.7561099509903837,11.195882420783008
2012-10-02T09:30:00-04:00,36.83,36.87,36.5,36.64,10301938,11727391.25,47.83878708201202,54.55033941415279,NaN,NaN,-47.20039740172164,-50.19517964658222,-0.10594373363093187,0.022785999204408824,0.1287297328353407,-177903142,-175880033.8,32.54686617514302,47.84778312722874,NaN,NaN,1.6683160485875865,9.834801510469376
2012-10-03T09:30:00-04:00,36.8,36.89999,36.53999,36.83,7831914,11530122.3,51.107338996073715,53.551992972881,NaN,NaN,-43.521067033097104,-43.77314972299284,-0.08385130498038078,0.023915601609864723,0.1077669065902455,-170071228,-173404936.2,34.767237583582045,47.41168451904211,NaN,NaN,1.6825887515619575,8.670199687768317
2012-10-04T09:30:00-04:00,37.03,37.12,36.89999,37.03999,8888785,11339802.55,54.500787634081824,52.63404273435419,NaN,NaN,3.1649493718527655,-34.256812939111754,-0.05318999383031495,0.041279414302351825,0.09446940813266677,-161182443,-171811434.8,36.22280954786348,46.606597176000605,NaN,NaN,2.691076546306694,7.816039238988085
2012-10-05T09:30:00-04:00,37.28999,37.42,37,37.16,10555125,11335605.5,56.364755928141825,52.09892400260912,NaN,NaN,35.99324163704245,-14.838143762775848,-0.024386272367450584,0.06398656767335353,0.08837284004080412,-150627318,-165477067,41.783743047193724,45.784307880086644,NaN,NaN,4.078194899648199,7.282061476225245
2012-10-08T09:30:00-04:00,36.94,37.13,36.89,37.07001,4917340,11133392.8,54.5597907107367,51.42688686897962,NaN,NaN,0.5646744289743638,-10.199719799389833,-0.011602918962148198,0.07386919133811887,0.08547211030026707,-155544658,-163065757.8,43.79287294014784,44.769946274959985,NaN,NaN,4.742902987484257,6.919324549262247
2012-10-09T09:30:00-04:00,37.07001,37.11,36.61501,36.64,10963434,11158383.05,46.84089187536456,50.12853336854174,NaN,NaN,-47.936710950238854,-10.346982509093277,-0.031203783050154615,0.04646738148757379,0.0776711645377284,-166508092,-160786747.8,45.70026282477719,43.592665834268175,NaN,NaN,3.0318291509511828,6.363968063789238
2012-10-10T09:30:00-04:00,36.5,36.6183,36.25999,36.3,14504441,11461087.9,41.804797889094935,48.988238983676,NaN,NaN,-112.50164751445665,-24.143098605365186,-0.06425958993835545,-0.002653322885215914,0.06160626705313954,-181012533,-162975008.8,44.150996191538056,42.23628880720133,NaN,NaN,-0.06348858115273934,5.445759971654669
2012-10-11T09:30:00-04:00,36.56,36.71001,36.41,36.41,8828801,11082243.4,43.90607323738712,48.42385947686777,NaN,NaN,-82.01890282437103,-41.17986904460994,-0.07515144496715864,-0.03233303915580876,0.04281840581134988,-172183732,-165175266.6,42.58766695020811,40.99617659958447,NaN,NaN,-1.961833483958831,4.387532335138455
2012-10-12T09:30:00-04:00,36.56,36.735,36.31,36.45,9760746,10957631.7,44.68817943530927,47.92723872453438,NaN,NaN,-78.56328197320042,-64.09117376665851,-0.07587634644162086,-0.052027027240676205,0.02384931920094466,-162422986,-167534400.2,40.91482728905425,39.901284766020865,NaN,NaN,-3.279317428799147,3.292268083147369
2012-10-15T09:30:00-04:00,36.45,36.72,36.39,36.7,9734664,11054292.45,49.43361910863109,48.29934908825009,NaN,NaN,-51.98584598173345,-74.60127784880008,-0.05661615091825894,-0.04692086944687901,0.009695281471379926,-152688322,-166963133,41.51392052205595,39.3288279810669,NaN,NaN,-3.029600874100563,2.3891439463976645
2012-10-16T09:30:00-04:00,36.78999,37.12,36.78999,37.08791,9357727,11118524.1,55.773954885868584,49.26394648416512,NaN,NaN,49.121034519906694,-55.18972875477097,-0.016909201370316165,-0.011441220241515282,0.005467981128800884,-143330595,-162327633.6,46.274283250132726,39.66514920970475,NaN,NaN,-0.8066213736899329,1.9326060435280077
2012-10-17T09:30:00-04:00,37.16,37.36,37.09,37.315,7774680,11043046.6,59.01390723827119,50.04049990303174,NaN,NaN,129.20221809199592,-6.848955633480455,0.02330725636799816,0.03460205158879859,0.011294795220800426,-135555915,-153236310,54.155450069067435,40.84802506128634,NaN,NaN,2.098697789404814,1.9563334357961228
2012-10-18T09:30:00-04:00,37.14999,37.53999,37.13,37.42,15649313,11197605.2,60.45639696448862,51.07642692641012,NaN,NaN,154.65624754149033,40.48607443969182,0.053890230272706875,0.07865758306168402,0.024767352788977147,-119906602,-142780884,61.20392819180851,42.7741514862665,NaN,NaN,4.92014212166672,2.3797346766347793
2012-10-19T09:30:00-04:00,37.10001,37.22,36.64999,36.78999,15722871,11231458.5,49.25505941902247,51.1103100288917,NaN,NaN,28.426469946340283,61.88402482359995,0.029802465295762366,0.0620204344086801,0.03221796911291774,-135629473,-137422181.4,64.23868393166106,44.98953917958811,NaN,NaN,3.829372794786186,2.5868258363706946
2012-10-22T09:30:00-04:00,36.67999,36.95,36.37,36.69,14300695,11366336.8,47.74312729175682,51.103477186730615,NaN,NaN,-29.3567296613601,66.40984808767463,0.006467573109065497,0.04030243549924961,0.033834862390184114,-149930168,-136870550.6,64.54613296628554,47.27520109324114,NaN,NaN,2.4758584980260623,2.5709733594643187
2012-10-23T09:30:00-04:00,36.25,36.44,36.11,36.32001,13211340,11298142.65,42.539652154703894,50.4914995552042,NaN,NaN,-123.62137226835085,31.861366730023114,-0.0324176895289137,-0.006687249520958005,0.025730440007955692,-163141508,-140832733.2,60.521380897465484,49.11478275851852,NaN,NaN,-0.4193752790048966,2.1437806968258593
2012-10-24T09:30:00-04:00,36.5,36.50999,36.03999,36.09,12980195,11321396.75,39.64676314087317,49.4304978056893,NaN,NaN,-138.4808849321128,-21.675253874798624,-0.07000411032961512,-0.0617746979040632,0.008229412425551915,-176121703,-148945890.8,53.205516059641376,50.32783322364552,NaN,NaN,-3.7588705628393235,1.300544802587976
2012-10-25T09:30:00-04:00,36.42,36.5,35.99001,36.28999,14926949,11402905.9,43.259819973720404,48.494430951802045,NaN,NaN,-115.4409754096699,-75.69469846503067,-0.07720495097306812,-0.08827677629078323,-0.011071825317715115,-161194754,-157203521.2,46.98069978778045,50.699044419401716,NaN,NaN,-5.36109696303815,0.34888169321281515
2012-10-26T09:30:00-04:00,36.23,36.49001,36.11,36.32001,10533398,11272115.45,43.80365774275147,47.7261357398031,NaN,NaN,-98.50160193948705,-101.08031284219615,-0.07565434129397683,-0.10563975193518615,-0.029985410641209326,-150661356,-160209897.8,44.92014733186523,50.779564018810106,NaN,NaN,-6.472785894654792,-0.6256422479111287
2012-10-31T09:30:00-04:00,36.49001,36.78,36.36,36.4894,10564203,11065427.95,46.89653899975283,47.730110534402264,NaN,NaN,-39.206962698796254,-103.05035944968336,-0.05963307826474462,-0.1045267584721401,-0.04489368020739548,-140097153,-158243294.8,46.57096652558578,50.84175714029643,NaN,NaN,-6.489461079762352,-1.4633306524613032
2012-11-01T09:30:00-04:00,36.59,37.21001,36.45,37.14059,15309180,11315790.05,56.75105601343466,48.797700400426535,NaN,NaN,46.666000588998465,-68.9928848782135,-0.004498484865410199,-0.05051678628915823,-0.046018301423748034,-124787973,-150572587.8,52.54529867932614,51.44135017513844,NaN,NaN,-3.20291228488656,-1.71184231423634
2012-11-02T09:30:00-04:00,37.35001,37.44,36.815,36.83,13363992,11592393.95,51.81238050300117,49.36243663368468,NaN,NaN,62.06159419512334,-28.884389052766274,0.010893040017593378,-0.03240200140175631,-0.043295041419349686,-138151965,-142978640.2,57.5999926142412,52.5136591511408,NaN,NaN,-2.0912119029352327,-1.7660379697647532
2012-11-05T09:30:00-05:00,36.69,37.09,36.67,37.03,8532965,11574602.95,54.55490652179389,50.067202854147865,NaN,NaN,42.531962149761185,2.7101984591199395,0.03312736386510647,-0.001885836587966594,-0.035013200453073066,-129619000,-136663489.4,61.292423796744025,53.96920175883293,NaN,NaN,-0.2888929837672877,-1.555017257479401
2012-11-06T09:30:00-05:00,37.21001,37.61,37.14,37.42999,10045172,11549105.3,59.517273315787534,50.787463868944755,NaN,NaN,136.82148281249962,49.77481540951728,0.07117245216363777,0.053952364751474136,-0.017220087412163625,-119573828,-130445983.8,64.56435361584735,55.6156612655323,NaN,NaN,2.92855734963076,-0.9145065993208066
2012-11-07T09:30:00-05:00,37.12,37.12,36.35001,36.55,17347488,12170612.7,47.28429813870298,50.181059815575786,NaN,NaN,-11.77218259377803,55.26177143052091,0.03528548517100551,0.026886769051593262,-0.008398716119412246,-136921316,-129810816.4,64.89085494562963,56.945416386639224,NaN,NaN,1.3690483636265371,-0.5882844617569003
2012-11-08T09:30:00-05:00,36.55,36.66,36.16,36.17,13403977,12292639.85,43.1590377703169,49.04856913929334,NaN,NaN,-78.97384723600709,30.133801865519803,-0.013231636692083347,-0.02493826198451643,-0.011706625292433083,-150325293,-134918280.4,60.095831433199706,57.3697293412201,NaN,NaN,-1.398549210975739,-0.7040365687881629
2012-11-09T09:30:00-05:00,36.00999,36.58,36,36.27,13424973,12238666.45,44.53051819424838,47.91100636999047,NaN,NaN,-86.4733290403625,0.426817218422633,-0.036459111033423204,-0.057280514084212086,-0.020821403050788882,-136900320,-134667951.4,60.2508649011646,57.3016533918884,NaN,NaN,-3.046027557764201,-1.0386067100704541
2012-11-12T09:30:00-05:00,36.37,36.55,36.24001,36.37,7727613,12183607.05,45.93535611567519,47.67388470546566,NaN,NaN,-62.70166533624158,-20.61990827877792,-0.04253480397449612,-0.07398990801890903,-0.031455104044412915,-129172707,-134578692.8,60.31007707980072,57.02103861675552,NaN,NaN,-3.8879032225555727,-1.4456490689968997
2012-11-13T09:30:00-05:00,36.06,36.64,36.06,36.27,9957816,12193460.55,44.71575622618412,47.457643915067614,NaN,NaN,-72.33955848885843,-62.45211653904953,-0.050208182096894274,-0.09421533166553075,-0.04400714956863648,-139130523,-138490031.8,56.34886068487,56.435519168082976,NaN,NaN,-4.939652225255607,-1.9447923770338578
2012-11-14T09:30:00-05:00,36.39,36.39,35.32001,35.41499,22260784,12819766.55,35.931556579806,46.9856370882892,NaN,NaN,-165.695529820605,-93.23678598441492,-0.1065492469337178,-0.17719370823578373,-0.07064446130206593,-161391307,-143384030,51.7672633112709,55.81022505478336,NaN,NaN,-8.992631176583183,-2.95162649125519
2012-11-15T09:30:00-05:00,35.27,35.61,35.25,35.42,15773980,13140579.2,36.01087955109838,46.72593111759101,NaN,NaN,-184.71555734997634,-114.38512800720878,-0.13531346871250818,-0.23978629719270117,-0.10447282848019299,-145617327,-142442436.8,52.5663656009944,55.76457145059429,NaN,NaN,-12.075111250001092,-4.254981456790318
2012-11-16T09:30:00-05:00,35.33,35.61,35.19,35.52,13761098,13439900.1,37.669705935338115,46.32663725770656,NaN,NaN,-163.56228601540516,-129.80291940221733,-0.13891474482614774,-0.27811625951287766,-0.13920151468672992,-131856229,-141433618.6,53.4560942481137,56.22709962633238,NaN,NaN,-14.051871089397295,-5.654537118591315
2012-11-19T09:30:00-05:00,35.96001,36.2,35.86,36.185,10986656,13206767.25,47.42954882513405,46.58562947787674,NaN,NaN,-56.575022411568995,-128.57759081728278,-0.09018199437943125,-0.251929007661019,-0.16174701328158775,-120869573,-139772991.8,54.95395571585437,56.943800225188745,NaN,NaN,-12.635999992723457,-6.65188895775305
2012-11-20T09:30:00-05:00,36.21001,36.259,35.92999,36.22,8771785,12859212.95,47.89201398572696,46.656734834017755,NaN,NaN,-42.70382624065024,-122.65044436764114,-0.05120152646672102,-0.22574892136498903,-0.174547394898268,-112097788,-134366444.8,59.52134020717642,57.86882691673094,NaN,NaN,-11.380911476382618,-7.32746360327156
2012-11-21T09:30:00-05:00,36.2,36.35001,36.13,36.27,4986664,12393511.4,48.5878228474017,46.07364675072969,NaN,NaN,-18.669756937860647,-93.24528979109229,-0.019303057260283196,-0.198676216473622,-0.1793731592133388,-107111124,-123510408.2,66.80046154803576,58.887052835924486,NaN,NaN,-10.1639692462797,-7.732678695129866
2012-11-23T09:30:00-05:00,36.35001,36.74001,36.35001,36.74001,3286513,11897270.05,54.710048098322055,46.280623007538324,NaN,NaN,45.822831505437506,-47.13761202000952,0.03333243444480821,-0.13770761615732852,-0.17104005060213673,-103824611,-115151865,71.10839062147339,59.85193840786964,NaN,NaN,-7.167782771490608,-7.651979277467115
2012-11-26T09:30:00-05:00,36.60001,36.78999,36.52,36.765,7471813,11621850.95,55.01676508879369,46.31361290518117,NaN,NaN,54.796849535045396,-3.4657849099194094,0.06773014254527499,-0.086377372420543,-0.15410751496581798,-96352798,-108051178.8,74.17419713284848,60.77206507473424,NaN,NaN,-4.673748769312514,-7.226517776302172
2012-11-27T09:30:00-05:00,36.81,37.0099,36.64999,36.69,9702746,11360640.8,53.83832580440014,45.907973797224926,NaN,NaN,63.79567385140258,20.608354342674897,0.08235807760840624,-0.051159917955310164,-0.1335179955637164,-106055544,-105088373,75.34959427074715,61.542439407227086,NaN,NaN,-2.9391280329776794,-6.614033527255816
2012-11-28T09:30:00-05:00,36.5,37.03,36.35001,37,11098711,11388906.45,57.85649252500916,46.66313053910393,NaN,NaN,59.23588860266941,40.99629731133882,0.10820997125996583,0.001744468511240882,-0.10646550274872495,-94956833,-101660182,76.67254786874656,62.38398890173544,NaN,NaN,-0.23680217003098983,-5.703000476223698
2012-11-29T09:30:00-05:00,37.2,37.34,36.965,37.21001,10530926,11387242.6,60.373012725226296,47.89270017874032,NaN,NaN,108.44921210662898,66.42009112023678,0.13311386510884415,0.05992682863733023,-0.07318703647151391,-84425907,-97123138.6,78.33011013106511,63.6864373801544,NaN,NaN,2.811421073427423,-4.486654540559252
2012-11-30T09:30:00-05:00,37.17,37.28,37.05,37.13,7943367,11018951.95,58.92927008364747,48.92118245655454,NaN,NaN,101.34702880322128,77.52493057979353,0.13730627549476626,0.0984458078969439,-0.03886046759782234,-92369274,-94832071.2,79.13631099577944,65.03539781548403,NaN,NaN,4.948110450824711,-3.1388309703615436
2012-12-03T09:30:00-05:00,37.32001,37.39,36.73,36.73,10585031,10880003.9,52.20754685062558,49.36919608047956,NaN,NaN,71.9799283415312,80.9615463410907,0.10756339319309588,0.0955937738935475,-0.01196961929954837,-102954305,-96152372.6,77.35036298239102,66.25256109424048,NaN,NaN,4.9169487287223665,-1.9880052990638422
2012-12-04T09:30:00-05:00,36.82001,37.03,36.71001,36.87,7175969,10812154.1,54.17760948760178,50.04504274200939,NaN,NaN,60.70666957574927,80.34374548596003,0.09232607763935276,0.10343797774964258,0.011111900110289823,-95778336,-94096931,78.17610066271223,67.81164966408636,NaN,NaN,5.457279453526275,-0.9243931915509682
2012-12-05T09:30:00-05:00,36.95,37.39999,36.71001,37.25999,13665023,10993146.65,59.22042960295296,51.708533672234175,NaN,NaN,104.73025502877017,89.44261877118018,0.10272268353468529,0.13951525452864644,0.036792570993961146,-82113313,-91528227,79.19681517044552,69.77090336831311,NaN,NaN,7.462568354097137,0.2737441721130469
2012-12-06T09:30:00-05:00,37.24001,37.28999,37.00999,37.25,5501574,10400850.95,59.04118441884293,53.35355544850164,NaN,NaN,103.90300560165078,88.53337747018455,0.10288121257386715,0.16539408671129507,0.06251287413742793,-87614887,-92166023,78.21860001094234,71.60320582616654,NaN,NaN,9.029496021393065,1.5245658648673353
2012-12-07T09:30:00-05:00,37.46001,37.515,37.25,37.495,6770941,10069199.15,62.07304481763738,55.096651082951574,NaN,NaN,121.87295248860472,92.63856220726123,0.1126527820326183,0.2033288516782008,0.0906760696455825,-80843946,-89860957.4,79.21769453202138,73.44332013215994,NaN,NaN,11.273279879354444,2.9172392955083506
2012-12-10T09:30:00-05:00,37.48,37.72,37.39,37.67999,7387766,9767338.8,64.22628607251632,56.29641802919317,NaN,NaN,129.9666447233852,104.23590548363204,0.12385092068976702,0.24548972050779128,0.12163879981802425,-73456180,-83961332.4,81.55027428783606,75.34305717301577,NaN,NaN,13.814998467104312,4.4740620343077735
2012-12-11T09:30:00-05:00,37.88,37.97,37.67999,37.75999,9455270,9853721.65,65.14779881289263,57.528974088276435,NaN,NaN,138.42552129391754,119.77967582726569,0.12837368252584574,0.28210590297533145,0.1537322204494857,-64000910,-77605847.2,83.6758749595944,77.06838108390276,NaN,NaN,16.194648568280194,6.148431539160976
2012-12-12T09:30:00-05:00,37.95,38.12,37.78,37.82001,6921422,9701901.95,65.85837746876672,58.762585132659645,NaN,NaN,134.8144418764517,125.79651319680201,0.12690769033217628,0.31236683336470605,0.18545914303252978,-57079488,-72599082.2,85.12937231003617,78.37758899547423,NaN,NaN,18.383600387379634,7.896312803192212
2012-12-13T09:30:00-05:00,37.75,37.98,37.58,37.7,9328336,9055279.55,63.088636132185776,59.36105570650706,NaN,NaN,108.57674676189926,126.73126142885171,0.10998657055319672,0.3229423562240257,0.21295578567082896,-66407824,-68357669.6,86.24657790368363,79.45888808706069,NaN,NaN,19.527809994203714,9.557955259050999
2012-12-14T09:30:00-05:00,37.61,37.83,37.60001,37.62,6747840,8603972.55,61.23971419431179,59.80555207118692,NaN,NaN,93.34171736563636,121.02501440425803,0.08656817236601447,0.32116600112834703,0.23459782876233257,-73155664,-66820013.2,86.63849362536098,80.349194979383,NaN,NaN,20.01746108501787,11.052170377046266
2012-12-17T09:30:00-05:00,37.8,37.98,37.72,37.97,9667043,8399269.8,65.94238338856914,60.670127612913284,NaN,NaN,113.9166412208302,117.81501370374704,0.08754932614164085,0.3440344864393836,0.25648516029774276,-63488621,-64826501.4,87.14974880940373,81.1920631607156,NaN,NaN,21.794159936423615,12.586740314100172
2012-12-18T09:30:00-05:00,38.00999,38.5,37.91,38.46001,11656688,8432771.4,71.20904188788184,61.62388113883276,NaN,NaN,153.55107018883015,120.84012348272954,0.11250778117491789,0.3971198867663901,0.2846121055914722,-51831933,-62392706,87.76524789817591,81.98439887710342,NaN,NaN,25.098073307183316,14.374073598826335
2012-12-19T09:30:00-05:00,38.52,38.53,38.23,38.25,15895352,8788949.75,66.46515175495273,62.05903392667036,NaN,NaN,140.3338781260156,121.94401073264233,0.10625631164730748,0.41743249515060654,0.31117618350329906,-67727285,-64522265.4,83.97509544517123,82.38761211382528,NaN,NaN,26.422707195361934,16.095306969759992
2012-12-20T09:30:00-05:00,38.3,38.45,38.21001,38.45,7665746,8922903.85,68.60985637277406,62.7505043758937,NaN,NaN,130.45286767421211,126.31923491510489,0.10669447911855079,0.4445442824014876,0.3378498032829368,-60061539,-63253008.4,84.40731023681235,82.76411205961335,NaN,NaN,28.19401101569828,17.82369326203689
2012-12-21T09:30:00-05:00,37.62,37.99001,37.5,37.92999,10871621,9302159.25,58.18950858505263,63.17778735692419,NaN,NaN,47.01809086823012,117.05450961562364,0.0651100775726367,0.4192374002487327,0.354127322676096,-70933160,-62808507.6,84.56432391718877,83.27939498352748,NaN,NaN,26.351741553763674,19.041985875140718
2012-12-24T09:30:00-05:00,37.84,37.92999,37.75,37.82001,1647009,9010919.05,56.24388977746122,63.32537880619987,NaN,NaN,45.32152770661572,103.33548691278074,0.025385424581182092,0.38585910340257357,0.3604736788213915,-72580169,-64626817.2,80.97235005765093,83.47912708316595,NaN,NaN,24.25133960825205,19.786179265585194
2012-12-26T09:30:00-05:00,37.92999,37.96001,37.64,37.69,6267207,8839142.1,53.947568410136135,62.94874586385582,NaN,NaN,29.63041570124163,78.55135601526305,-0.012427268417797177,0.34493959329914503,0.3573668617169422,-78847376,-70029905.8,71.28307365534707,82.91385983208748,NaN,NaN,21.817470829461488,20.07636377471038
2012-12-27T09:30:00-05:00,37.74001,37.77,37.23,37.63,6386957,8603554.4,52.874656532371354,62.5082795862507,NaN,NaN,-14.68551242588683,47.54747790488257,-0.042563179182418864,0.30416288773891864,0.3467260669213375,-85234333,-73531315.4,65.78901259662021,82.0260321596359,NaN,NaN,19.517604764674743,19.996541058991003
2012-12-28T09:30:00-05:00,37.34,37.62,37.17999,37.22,6625941,8408305.15,46.124129898822616,61.36907137776394,NaN,NaN,-55.43683888417269,10.369536593205591,-0.08854682956820403,0.23604252996108244,0.32458935952928647,-91860274,-79891062.4,57.17001129536266,80.45119764273171,NaN,NaN,15.306860634778024,19.326586712674864
2012-12-31T09:30:00-05:00,37.12,37.92551,37.03999,37.89999,13414391,8681856.35,56.128240806439635,60.790639573044174,NaN,NaN,-6.672760248551774,-0.36863363015079625,-0.07229056566880177,0.23422615244328426,0.30651671811208603,-78445883,-81393607,55.325829509556065,78.57802301571171,NaN,NaN,14.789361998741246,18.67841175354149
2013-01-02T09:30:00-05:00,38.72,38.91,38.55,38.81,14885625,8896886.05,65.39034719832355,60.8079644577178,NaN,NaN,203.25846735109604,31.21875429874526,-0.003031605645395896,0.30272721105534117,0.30575881670073707,-63560258,-79589624.8,57.114520343842926,76.6807834003009,NaN,NaN,17.909408381575687,18.568554128974945
2013-01-03T09:30:00-05:00,38.77,39.09,38.73,38.83,9592078,9017691.5,65.56242537181303,60.786825022221116,NaN,NaN,196.7987364089286,64.65241844028266,0.03902629901438187,0.3545416904687144,0.31551539145433255,-53968180,-74613785.6,61.6728345531552,75.00531641766655,NaN,NaN,20.268038739326265,18.81133764473942
2013-01-04T09:30:00-05:00,38.98,39.14999,38.89,39.12,6466344,8657757.55,68.04350323753187,61.140744101174406,NaN,NaN,183.45243764514916,104.28000845448987,0.07897218468569983,0.41423062231145735,0.3352584376257575,-47501836,-67067286.2,67.34231509291884,73.65501193118334,NaN,NaN,23.03507556196468,19.4147287757716
2013-01-07T09:30:00-05:00,39,39.03,38.81,38.95,5513730,8658365.35,65.08335554671173,61.415289912060125,NaN,NaN,135.99554414630612,142.56648506058562,0.08596414949786602,0.44271362449809004,0.356749475000224,-53015566,-59298344.6,71.94351248690589,72.60537042129369,NaN,NaN,24.259419014314737,20.106827381277764
2013-01-08T09:30:00-05:00,38.83,38.91901,38.51649,38.64999,7543379,8696987.25,60.113220356141646,60.998921124029586,NaN,NaN,87.8193372344512,161.46490455718623,0.06344184063152963,0.43605177578963605,0.3726099351581064,-60558945,-55720957,73.77573265058587,71.65008355280669,NaN,NaN,23.64454754526662,20.612215976133314
2013-01-09T09:30:00-05:00,38.8,39.12,38.77,39.03999,6851629,8670180.4,63.965600329340226,60.48153244127661,NaN,NaN,112.34509864696585,143.28223081636017,0.06749144288018827,0.45697423875834176,0.3894827958781535,-53707316,-53750368.6,74.75377013320781,70.7206922838804,NaN,NaN,24.39712605406435,21.15291741583775
2013-01-10T09:30:00-05:00,39.24001,39.25999,38.95,39.23,11710266,8782930.2,65.70358294696271,60.42713466927732,NaN,NaN,118.82780505560218,127.68804454569491,0.0750667961534065,0.4833162910699116,0.4082494949165051,-41997050,-51356142.6,75.92842568120295,70.14593015788265,NaN,NaN,25.564605414399892,21.783158558489482
2013-01-11T09:30:00-05:00,39.12,39.19,39.00999,39.09,6999828,8786850.5,63.2817570033172,60.046556142887546,NaN,NaN,100.4880919100509,111.09517539867525,0.06322334967805904,0.48727868201407887,0.42405533233601983,-48996878,-51655151,75.45624077894526,69.50656805374929,NaN,NaN,25.76272843517812,22.351668540873572
2013-01-14T09:30:00-05:00,39.16,39.25,39.07001,39.24001,6250477,8632957.55,64.77979428274703,60.517290835580006,NaN,NaN,100.30229598712545,103.9565257668391,0.05819309064065503,0.4967966956368386,0.43860360499618356,-42746401,-49601318,76.53564174948201,68.93309075605593,NaN,NaN,26.375092160805497,22.92644334372099
2013-01-15T09:30:00-05:00,39.03,39.39,39.00999,39.35001,5115141,8551322.6,65.87909970154355,61.20552011587159,NaN,NaN,96.77813171711466,105.74828466337178,0.05501092143266384,0.5073672567870133,0.4523563353543495,-37631260,-45015781,78.77955455187303,68.77646250564324,NaN,NaN,27.20018140747362,23.536977352828508
2013-01-16T09:30:00-05:00,39.14,39.21001,39.08501,39.19,7569824,8446461.65,62.808089985734036,61.83841451412859,NaN,NaN,78.32859000264942,98.94498293450849,0.035797125269552865,0.49710274194129056,0.4613056166717377,-45201084,-43314534.6,79.56051483649617,69.36770830429676,NaN,NaN,27.017021136418233,24.034126464769898
2013-01-17T09:30:00-05:00,39.38,39.67999,39.28,39.61,11890273,8458140.9,67.13831277432585,62.857247102839615,NaN,NaN,108.5178995344374,96.88300183027555,0.04447552916073455,0.5169000281226559,0.47242449896192135,-33310811,-41577286.8,80.35556270955439,70.40817616950633,NaN,NaN,28.153926823635132,24.622669373179217
2013-01-18T09:30:00-05:00,39.77,39.96001,39.59,39.92999,10912945,8209020.55,70.00380796263303,64.56293839311179,NaN,NaN,128.00456496349312,102.386296440964,0.06369751412605029,0.5520463916194842,0.4883488774934339,-22397866,-36257484.4,82.58896214236448,72.22381551572074,NaN,NaN,30.01898016411262,25.393570914741133
2013-01-22T09:30:00-05:00,39.84,40.09,39.77,40.09,7550191,8203242.8,71.34917966629519,65.65014831167291,NaN,NaN,131.11692856124012,108.54922295578695,0.07816563385388431,0.5860559198107893,0.507890285956905,-14847675,-30677739.2,84.57041847369426,74.31271472744491,NaN,NaN,31.971776168081274,26.333314522361153
2013-01-23T09:30:00-05:00,40,40.16,39.89999,40.10001,6431223,7981222.9,71.43549233455367,66.0819443928322,NaN,NaN,130.03751399141146,115.2010994106463,0.07914487534149472,0.6068213801337734,0.5276765047922787,-8416452,-24834777.6,86.32541889599321,76.39920748116992,NaN,NaN,33.5743602900303,27.367749632028175
2013-01-24T09:30:00-05:00,40.11,40.90669,40.07001,40.34,6892965,8243520.7,73.49696175175382,66.6486969913994,NaN,NaN,159.92081224120724,131.51954385835785,0.08611461495874262,0.635319773490707,0.5492051585319644,-1523487,-16099258.2,88.44204628903489,78.31129403373276,NaN,NaN,35.56398309075908,28.53864012613259
2013-01-25T09:30:00-05:00,40.47,40.52,40.28999,40.47,6908859,8275603.3,74.56767010659628,67.11470891061829,NaN,NaN,146.7211621567641,139.1601963828232,0.0892581400107394,0.6607778335453887,0.5715196935346493,5385372,-8360021.6,89.92929717512571,79.92464989674752,NaN,NaN,37.54844308679576,29.825754834798758
2013-01-28T09:30:00-05:00,40.63,40.64999,40.32001,40.5,5583473,8235429.1,74.82047509854303,67.81021745003481,NaN,NaN,137.38242360126037,141.03576811037664,0.0832534753837687,0.6755865377643602,0.5923330623805915,10968845,-1686679.4,91.00420846245096,81.28612818071504,NaN,NaN,39.26157590731704,31.17372927372994
2013-01-29T09:30:00-05:00,40.41,40.60001,40.35001,40.59,5456047,8176934.4,75.60394975781466,68.91669812158288,NaN,NaN,122.60622274645898,139.33362694742044,0.07546898545609071,0.6866692942007049,0.6112003087446142,16424892,4567834,91.8790956440764,82.57922553739293,NaN,NaN,40.93281622938065,32.56788455310861
2013-01-30T09:30:00-05:00,40.55,40.64,40.2,40.22,6991176,7855773.65,66.44985583845676,69.09414494366264,NaN,NaN,94.0046809954937,132.12706034823685,0.03744887689636578,0.6580114048650714,0.6205625279687056,9433716,8137867.6,92.33719920331919,83.83518475668662,NaN,NaN,39.87919281853327,33.61235716245499
2013-01-31T09:30:00-05:00,40.08,40.27499,39.991,40.08,9929234,7607954.1,63.32549992460957,68.92428187063742,NaN,NaN,59.10290345483829,111.96347859096306,-0.0029365456322160144,0.6168918459284356,0.6198283915606516,-495518,8343461.4,92.36391403687806,85.0091482106634,NaN,NaN,38.09414644048139,34.25261277360162
2013-02-01T09:30:00-05:00,40.33,40.52,40.24001,40.47,8661488,7561424.6,67.85912323222473,69.25123660127366,NaN,NaN,83.79677307629561,99.37860077486937,-0.008857375745179086,0.6087566718791777,0.6176140476243568,8165970,8899581,92.44068382095645,86.22232271366418,NaN,NaN,37.799983386722005,34.75938000404739
2013-02-04T09:30:00-05:00,40.27,40.35001,40.07001,40.12,8989543,7687584.55,60.61703159566132,68.95389640933897,NaN,NaN,51.945452377554034,82.29120653012811,-0.040070970797995153,0.5675253341268629,0.607596304924858,-823573,6541097.4,88.38246945022115,87.0685246922884,NaN,NaN,35.277154376460835,34.833347771535024
2013-02-05T09:30:00-05:00,40.34,40.58,40.28,40.49001,8590645,7841430.3,64.88375020465553,68.88280001670411,NaN,NaN,77.4674342011411,73.26344882106453,-0.039460626708805235,0.5582705215388515,0.5977311482476567,7767072,4809533.4,85.41757363931934,87.54266891282029,NaN,NaN,34.42769461850159,34.77539732110168
2013-02-06T09:30:00-05:00,40.35001,40.53,40.25999,40.5,11049426,8016732.65,64.99402200887478,69.03893801835702,NaN,NaN,70.06811518200608,68.476135658367,-0.04182134592056985,0.5454544658469445,0.5872758117675143,18816498,6686089.8,85.96699037562189,88.00027430847214,NaN,NaN,33.78890465235826,34.634469796995475
2013-02-07T09:30:00-05:00,40.56,40.605,40.14999,40.45,8006980,8074500.2,63.912264898804345,68.80850602724834,NaN,NaN,62.13252276717809,69.08205952083496,-0.04965361959380821,0.525208787275254,0.5748624068690622,10809518,8947097,86.62105256992362,88.44780929849851,NaN,NaN,32.95477945675996,34.39451403410469
2013-02-08T09:30:00-05:00,40.50999,40.64,40.44,40.61,7165160,7847244.9,65.86988646122151,68.51322592000467,NaN,NaN,81.27122678308375,68.57695026219258,-0.04698989682903787,0.5161250358327649,0.5631149326618028,17974678,10908838.6,87.17939580220879,88.77569741705882,NaN,NaN,32.79832884088637,34.166487577930646
2013-02-11T09:30:00-05:00,40.53,40.64,40.49001,40.58,7718633,7883185.15,65.15619454031375,68.07086983957743,NaN,NaN,78.94547237907778,73.97695426249734,-0.04990538023250102,0.5007332073711765,0.5506385876036776,10256045,13124762.2,87.79880729622029,89.00629661866783,NaN,NaN,32.47315724340603,33.924583244427126
2013-02-12T09:30:00-05:00,40.66,40.83,40.64999,40.75999,5784270,7859874.8,67.43588043423529,67.78518327526896,NaN,NaN,106.37090075553213,79.75764757337555,-0.04265015183596477,0.4973258978087216,0.5399760496446864,16040315,14779410.8,88.2551123823338,89.14413186769215,NaN,NaN,32.81854095097558,33.766577202505474
2013-02-13T09:30:00-05:00,40.97,41.12,40.855,40.98,6412277,7924731.6,70.0180679365124,67.53669085989458,NaN,NaN,150.19635432703998,95.78329540238232,-0.02674925815460405,0.5065394769514313,0.5332887351060354,22452592,15506629.6,88.45939231491107,89.14537086954046,NaN,NaN,33.85717641504367,33.77951994715379
2013-02-14T09:30:00-05:00,40.8,41.06,40.73,41.03999,9256086,8009044.7,70.70030092963464,67.26045020439732,NaN,NaN,149.47457054996295,113.25170495893931,-0.016414115682796604,0.5127710905025396,0.5291852061853362,31708678,19686461.6,89.58109400004963,89.12049921417788,NaN,NaN,34.914834739365844,33.94170777461265
2013-02-15T09:30:00-05:00,41.10001,41.17,40.92999,41.06,8009109,7814986.5,70.9378502264616,66.9831198563915,NaN,NaN,176.24551128416226,132.246561859155,-0.012623282598557273,0.5134061029371395,0.5260293855356968,39717787,24035083.4,90.60428354157554,89.09193314840107,NaN,NaN,35.86073782392635,34.21585492451461
2013-02-19T09:30:00-05:00,41.22,41.39,41.10001,41.36,8524867,7695582.6,74.3018180870362,66.8901104513359,NaN,NaN,203.01365244940865,157.06019787322117,0.004764061118342711,0.5319844619336251,0.5272204008152824,48242654,31632405.2,92.06957495364752,89.10553881337044,NaN,NaN,37.688585052282235,34.71195922848141
2013-02-20T09:30:00-05:00,41.41,41.42,40.78999,40.82001,10619160,7849031.05,60.68553857890083,66.47837350422476,NaN,NaN,112.75199550829662,158.33641682377407,-0.0238550966864135,0.4974015299572656,0.5212566266436791,37623494,35949041,92.76041476512691,89.13576849635672,NaN,NaN,35.12590875564064,34.771094875218445
2013-02-21T09:30:00-05:00,40.66,40.73,40.34,40.52,15582707,8306605.25,54.68908629936605,65.86148681670737,NaN,NaN,-17.584309761377046,124.78028400609067,-0.06444064125414761,0.44070582507599454,0.5051464663301422,22040787,35866680,92.59467459200143,89.15225139315123,NaN,NaN,30.956151530083158,34.22610296877055
2013-02-22T09:30:00-05:00,40.67,40.89,40.67,40.84,9693367,8446625.35,59.307783092920616,65.25067680675707,NaN,NaN,49.292230440527554,104.74381598420356,-0.07068446090680408,0.41679089019663706,0.48747535110344115,31734154,35871775.2,92.5955560099031,89.16331369236171,NaN,NaN,28.901243196981447,33.465408715657816
2013-02-25T09:30:00-05:00,41.06,41.11,39.98,40,10921379,8647251.35,46.04076894274554,64.20951518869165,NaN,NaN,-64.27118769102727,56.6404761891657,-0.12894362719292746,0.32629581711228184,0.4552394443052093,20812775,32090772.8,84.55294846941061,88.88977647944667,NaN,NaN,21.882526109637794,31.8107112005121
2013-02-26T09:30:00-05:00,40.11,40.325,39.97,40.24001,14203891,9078272.25,49.51574777848171,63.11180072967924,NaN,NaN,-104.04216380728828,-4.770687062173673,-0.1475333595700612,0.2708227448426328,0.418356104412694,35016666,29445575.2,79.35966073097339,88.45706841456482,NaN,NaN,17.6597773430718,29.78914922087777
2013-02-27T09:30:00-05:00,40.25,41.12,40.19,41,10214039,9316171.85,58.6061904649482,62.6555270479702,NaN,NaN,39.741455221752844,-19.372795119482426,-0.1067643876071026,0.28490061990381577,0.3916650075109184,45230705,30967017.4,80.11613885275574,88.0391504486458,NaN,NaN,17.50152673634967,28.0337745802309
2013-02-28T09:30:00-05:00,41.07001,41.28999,40.925,40.97,11139941,9523610.1,58.160986595439084,62.244721454872675,NaN,NaN,97.32179904285881,3.6084266413647557,-0.08109968521454974,0.2902904009927312,0.3713900862072809,34090764,33377012.8,81.28614524388524,87.65808563964306,NaN,NaN,17.22693816155727,26.48994080613467
2013-03-01T09:30:00-05:00,40.71001,41.05,40.47,40.89999,11544758,9604386.3,57.071410539218896,61.61625888901535,NaN,NaN,32.15625763033807,0.18123207932685262,-0.06861593462068333,0.28562016793142675,0.3542361025521101,22546006,31539383.2,77.53954622594627,86.9695249556243,NaN,NaN,16.654281957687218,25.08484668492789
2013-03-04T09:30:00-05:00,40.82001,40.83,40.42,40.82001,17799680,10061295.9,55.78566679487691,60.946935478627,NaN,NaN,-0.21680946088200184,12.992107725355904,-0.06552804060500744,0.2723260517958508,0.33785409240085823,4746326,28326093.4,71.3469508445555,85.79439235193396,NaN,NaN,15.796964165754726,23.758006325046008
2013-03-05T09:30:00-05:00,41.08,41.62,41.08,41.39999,12343078,10228972.65,62.40069800295122,60.587279590678136,NaN,NaN,159.4050232407456,65.68154513496268,-0.026224702898740015,0.30507321377743324,0.33129791667617325,17089404,24740641,65.09946057322612,84.140417222712,NaN,NaN,17.25681689044613,22.829264977246027
2013-03-06T09:30:00-05:00,41.66,41.67,41.33,41.39999,11365230,10367701.9,62.40069800295122,60.043181738280914,NaN,NaN,160.34353300831,89.80196069227411,-0.003235769863547122,0.3272532043467393,0.33048897421028645,17089404,19112380.8,56.705444113326486,81.87227806545596,NaN,NaN,18.387705824733988,22.194756526887165
2013-03-07T09:30:00-05:00,41.50999,41.59,41.37,41.42999,6392535,10134857.35,62.73515916325233,59.474243040682175,NaN,NaN,137.5683521895511,97.85127132161257,0.010244397417810192,0.34329447098254917,0.333050073564739,23481939,16990615.8,53.88468763890274,79.32253475394545,NaN,NaN,19.393045847146027,21.794512144067003
2013-03-08T09:30:00-05:00,41.72,41.86,41.535,41.82001,7986395,10133828.1,66.8622094839568,59.18312584478898,NaN,NaN,171.8445019471951,125.78892018498398,0.04001028816996616,0.3830629337771967,0.34305264560723053,31468334,18775081.4,55.87280817173995,76.84171508467149,NaN,NaN,21.566046630222697,21.761874213517817
2013-03-11T09:30:00-04:00,41.78,41.98,41.69,41.96001,6118711,10081505.65,68.22266338141272,58.74890050867301,NaN,NaN,172.09678927617844,160.25163993239607,0.06237649386000005,0.4210232629322306,0.35864676907223053,37587045,25343225.2,62.31312000902904,74.71625401719874,NaN,NaN,23.774347544337047,22.04937040363485
2013-03-12T09:30:00-04:00,41.82001,41.92999,41.53999,41.72,11166754,10253911.7,63.41598557661835,58.94393243708141,NaN,NaN,125.39659167365834,153.4499536189786,0.0545387277738254,0.4268201787895123,0.3722814510156869,26420291,27209402.6,63.92418021662676,72.65652297802015,NaN,NaN,24.229118409547695,22.360762975908113
2013-03-13T09:30:00-04:00,41.72,41.95,41.63,41.92,7192590,10324327.7,65.59152571299356,59.72267810948337,NaN,NaN,123.30695376856984,146.04263777103057,0.05613667143978862,0.44245229031542266,0.38631561887563404,33612881,30514098,66.64352878949066,70.80286970641222,NaN,NaN,25.263343390770288,22.775417320888423
2013-03-14T09:30:00-04:00,42,42.16,41.96001,42.12,5869840,10297205.85,67.66246485882772,60.31944109276244,NaN,NaN,138.42678122035824,146.214323577192,0.06343702150138097,0.4656118957523603,0.4021748742509793,39482721,33714254.4,69.07455208893089,69.12279799777136,NaN,NaN,26.757618257460074,23.344303168970086
2013-03-15T09:30:00-04:00,41.89999,42.00999,41.8,41.97,9136207,10291211.9,64.52570944327786,61.63979398565761,NaN,NaN,101.77125712609394,132.19967461297176,0.05144806486411707,0.46648495533112566,0.4150368904670086,30346514,33489890.4,68.69653580222185,67.99019709297217,NaN,NaN,27.103640905413144,23.88135141703338
2013-03-18T09:30:00-04:00,41.67,42.05,41.49001,41.71001,6696594,10225586.15,59.38677963585285,62.34486768975555,NaN,NaN,69.6678249569198,111.71388174912003,0.020860860011719273,0.4411129654816577,0.4202521054699384,23649920,30702465.4,64.00976850465614,66.89377621966379,NaN,NaN,25.884990863264516,24.167585623637827
2013-03-19T09:30:00-04:00,41.75999,41.89,41.39,41.67,12386152,10418650.4,58.613152721521686,62.345364993796515,NaN,NaN,51.879222640308306,97.01040794245003,-0.0057888711257335634,0.4130160165627714,0.418804887688505,11263768,27671160.8,59.27376375096613,65.40503514096453,NaN,NaN,24.66813093903033,24.239092097265328
2013-03-20T09:30:00-04:00,41.88,41.92999,41.58,41.72,16633063,10719345.55,59.326239296868025,62.42859732961286,NaN,NaN,58.74991141429391,84.09899947159485,-0.02281622514889492,0.39028460625238637,0.4131008314012813,27896831,26527950.8,57.54454029609469,63.70920621612235,NaN,NaN,23.847403266626095,24.18313655003115
2013-03-21T09:30:00-04:00,41.55,41.95,41.22,41.3,6847449,10282582.65,51.326345389254605,62.01823553318685,NaN,NaN,21.36144791234702,60.68593280999262,-0.06286215678092127,0.3345231354251297,0.39738529220605096,21049382,22841283,52.25067161237433,61.90285802943863,NaN,NaN,20.718815979121185,23.68823361132973
2013-03-22T09:30:00-04:00,41.62,41.63,41.31,41.62,6952285,10145528.55,56.17523578894157,62.046061889905744,NaN,NaN,21.981405115505957,44.72796240787501,-0.06786806620922736,0.3125502094445167,0.3804182756537441,28001667,22372313.6,51.60036673494208,60.49238773589483,NaN,NaN,19.421359094336882,23.07868010890218
2013-03-25T09:30:00-04:00,41.74001,41.75999,41.07001,41.25,18316672,10515293.2,49.97589613764713,61.15857604238403,NaN,NaN,-11.59426950962079,28.475543514566898,-0.0945286534971772,0.2622574587822726,0.3567861122794498,9684995,19579328.6,47.78590119738391,59.25570492333467,NaN,NaN,16.313508244848272,22.112226985465906
2013-03-26T09:30:00-04:00,41.45,41.49001,41.31,41.46001,8772180,10243707.65,53.137100804606774,60.49689052821656,NaN,NaN,-15.027066481747093,15.094285690155811,-0.09613404819317461,0.23661855203798154,0.33275260023115616,18457175,21018010,49.84271799529826,58.76551020061836,NaN,NaN,14.700032028803559,21.053341991657
2013-03-27T09:30:00-04:00,41.27,41.49001,41.05099,41.46001,6666500,10066330.7,53.137100804606774,59.81131493117045,NaN,NaN,-44.94521003746162,-5.6447386001952875,-0.09513441476612144,0.21383458177350434,0.3089689965396258,18457175,19130078.8,47.21433918254755,58.289056739450125,NaN,NaN,13.415679759728361,19.962247387095765
2013-03-28T09:30:00-04:00,41.39999,41.77,41.39999,41.75999,7851766,9901921.95,57.578140831958095,59.1481671703134,NaN,NaN,26.08640601847704,-4.6997469789692845,-0.07319354924839538,0.21747705997913158,0.29067060922752697,26308941,20181990.6,48.83335477141598,57.78623863942698,NaN,NaN,13.623836603352894,19.056760132275354
2013-04-01T09:30:00-04:00,41.7,41.71001,41.17,41.25,15500668,10099717.45,49.06514093294723,57.779772709708716,NaN,NaN,-58.35110380058226,-20.76624876218693,-0.09080087183944652,0.1771695194282188,0.2679703912676653,10808273,16743311.8,44.07433208765789,56.48346807361476,NaN,NaN,11.055330058302491,17.913698693136375
2013-04-02T09:30:00-04:00,41.39,41.44,41.03999,41.12,11715340,9795500.45,47.15138809233646,56.61801574654573,NaN,NaN,-133.65878367894732,-45.179151596052236,-0.1078161999882851,0.13320014128230895,0.24101634127059404,-907067,14624899.4,41.39774440443322,54.874436944172366,NaN,NaN,8.371760072734038,16.55056460450747
2013-04-03T09:30:00-04:00,41.2,41.25999,40.80499,40.87,20235328,10190112.95,43.62725707120654,55.04913941498951,NaN,NaN,-183.57083556166228,-78.88790541203528,-0.13098089060089244,0.07729022801947849,0.20827111862037093,-21142395,6704985.4,33.264386361342886,52.49021248501895,NaN,NaN,4.993110799312732,14.899499775193938
2013-04-04T09:30:00-04:00,40.91,41.11,40.87,41.05,12607121,10252207.5,46.71525926822118,53.552910444231905,NaN,NaN,-151.09856682013145,-100.11857676856924,-0.12904542372711256,0.04696433896148022,0.17600976268859278,-8535274,1306495.6,29.071634462337144,49.63286122597655,NaN,NaN,3.129830085243331,13.21811839091528
2013-04-05T09:30:00-04:00,40.50999,41,40.44,40.97,12848309,10574996.2,45.52173995072903,52.19548405190699,NaN,NaN,-175.15685279743005,-140.36722853175064,-0.1277775967521613,0.016287766748391164,0.14406536350055246,-21383583,-8232009.2,23.447988818666943,46.40082215572262,NaN,NaN,1.2556709741796226,11.509197331381614
2013-04-08T09:30:00-04:00,40.94,41.21001,40.81,41.21001,8246621,10588007.5,49.67578967860758,51.50184191210376,NaN,NaN,-96.62920210315248,-148.0228481922647,-0.10628117352843616,0.011213896590007266,0.11749507011844343,-13136962,-13021056.2,21.227721070720634,43.344961624727226,NaN,NaN,0.8782029073401458,9.990483842232834
2013-04-09T09:30:00-04:00,41.33,41.49001,41.06,41.34,10682020,10816172.95,51.81864458650417,51.01651990245965,NaN,NaN,-39.780056324573955,-129.24710272139004,-0.0800117191758311,0.017480421148654557,0.09749214032448565,-2454942,-13330631.2,21.088709413652396,40.61745774349053,NaN,NaN,1.1920251498509373,8.733561171892564
2013-04-10T09:30:00-04:00,41.53,41.925,41.3701,41.89,11590297,10837350.1,59.647883487766386,51.03949448752381,NaN,NaN,64.69768881656317,-79.59339784574495,-0.025141289713242837,0.0660655281829321,0.09120681789617494,9135355,-7275081.2,30.654841810154267,38.69676499449478,NaN,NaN,4.021586307585568,8.060421905562993
2013-04-11T09:30:00-04:00,41.94,42.13,41.78,42,9854934,10970467.3,61.01240885617643,51.731356163732514,NaN,NaN,118.5775668253777,-25.65817111664312,0.016756808278850926,0.1121528282447386,0.09539601996588767,18990289,-1769968.6,38.011879862923315,37.679708440962564,NaN,NaN,6.742367677915882,7.872128444470549
2013-04-12T09:30:00-04:00,41.85001,41.92,41.605,41.75999,7438375,11048894.05,56.52134607023323,51.756078326681916,NaN,NaN,77.50940574228004,24.875080591298904,0.025952720022554818,0.1278369199940812,0.10188419997152638,11551914,4817130.8,45.46706488915469,37.24161545197775,NaN,NaN,7.677029193519304,7.844257122906086
2013-04-15T09:30:00-04:00,41.48,41.53,40.46001,40.49001,29888160,12086491.7,39.81910691381765,51.03059338212267,NaN,NaN,-140.42359689223258,16.116201633482888,-0.051619960617646274,0.037359249199468536,0.08897920981711481,-18336246,3777274,44.55605992752848,37.010912504130935,NaN,NaN,2.203627021152403,7.03845282265556
2013-04-16T09:30:00-04:00,40.86,41.07001,40.73,41.03999,10143273,12258825.65,47.10837333792591,50.599969991645466,NaN,NaN,-99.82129130781755,4.107954636834177,-0.06324777810167168,0.009919487190025222,0.0731672652916969,-8192973,2629667.8,43.51969268838215,36.559267839351214,NaN,NaN,0.5914796402021926,6.11745665373365
2013-04-17T09:30:00-04:00,40.71001,40.78,40.13,40.36,15939215,12436478.8,40.566098960453296,49.702041288491635,NaN,NaN,-187.64086210890994,-46.359755548260445,-0.11128274100294895,-0.06593616096198929,0.045346580040959664,-24132188,-4023840.8,38.00090866846329,35.90116565977376,NaN,NaN,-3.3365097473586633,4.766890025006177
2013-04-18T09:30:00-04:00,40.5,40.5,40.02,40.17999,16722684,12440959.85,39.02116586673191,48.37654307668977,NaN,NaN,-188.9459613513756,-107.8644611836111,-0.147457733766359,-0.1389755871669891,0.00848214659936991,-40854872,-15992873,30.506422602278633,34.59209907626395,NaN,NaN,-6.847384679970722,3.107707924295191
2013-04-19T09:30:00-04:00,40.22,40.42,40.02499,40.38,15449094,12871042.1,41.678902132385886,47.848954590935385,NaN,NaN,-152.735971356704,-153.91353660340792,-0.14971469950928626,-0.17866122778723792,-0.028946528277951654,-25405778,-23384411.4,26.96909895573249,33.37029670969785,NaN,NaN,-8.637547474239659,1.4298142959330697
2013-04-22T09:30:00-04:00,40.41,40.55,40.03,40.425,13880313,13217443.5,42.288357196527414,47.501595241234746,NaN,NaN,-124.65277254385951,-150.7593717337333,-0.1401453351274745,-0.2041281971872948,-0.06398286205982029,-11525465,-22022255.2,28.61190416189038,32.45702240665907,NaN,NaN,-9.817883157569343,-0.1769996259958464
2013-04-23T09:30:00-04:00,40.60001,40.78999,40.33,40.72,11194344,12861327.1,46.253513094086856,47.68918495715477,NaN,NaN,-71.6365783629933,-145.12242914476843,-0.10739126250942084,-0.19822194019659634,-0.0908306776871755,-331121,-20449884.8,30.553863502256917,32.263413631010074,NaN,NaN,-9.523026547172687,-1.5121463290211095
2013-04-24T09:30:00-04:00,40.91,41.21001,40.88,41.14,9976289,12921532.55,51.37577179551275,48.022078709104164,NaN,NaN,5.193709993775383,-106.55551472423137,-0.0536005121540233,-0.1578313178797046,-0.10423080572568132,9645168,-13694413.6,38.31744569175072,32.92382871882533,NaN,NaN,-7.595674088979493,-2.3812217233008783
2013-04-25T09:30:00-04:00,41.28,41.53999,41.16,41.35001,9845367,13080475.9,53.74935566540347,48.60976554586663,NaN,NaN,50.40396640163871,-58.68552917362854,-0.002723084575271012,-0.10763466144477007,-0.10491157686949906,19490535,-1625332.2,49.236165841112246,34.76584136328571,NaN,NaN,-5.2675046488654225,-2.7935478555243844
2013-04-26T09:30:00-04:00,41.3,41.45,41.14,41.23,7837590,13079767.1,52.181764645659555,48.78876375779891,NaN,NaN,42.71884460324608,-19.59456598163853,0.022606350950350268,-0.07665363818156123,-0.0992599891319115,11652945,5786412.4,54.55620566752693,37.14644740591473,NaN,NaN,-3.850824520010431,-2.944587379022391
2013-04-29T09:30:00-04:00,41.39999,41.53999,41.16,41.44,7934223,12701444.85,54.672936188128126,48.992641729343475,NaN,NaN,61.217391707538845,17.579466868641127,0.05160393192861863,-0.034755074221138216,-0.08635900614975685,19587168,12008939,58.48944196310211,39.817928302304,NaN,NaN,-1.916154067078291,-2.7976683344589484
2013-04-30T09:30:00-04:00,41.5,41.5,41.13,41.45,8112898,12521322.75,54.79371043559101,48.64591508275952,NaN,NaN,55.1977455257244,42.94633164638467,0.0684993857389094,-0.0007347739761200955,-0.0692341597150295,27700066,17615176.4,61.70534550439042,42.03582142332086,NaN,NaN,-0.3172409422539489,-2.4433215641439485
2013-05-01T09:30:00-04:00,41.2,41.34,40.89999,40.91,12152652,12117188.95,47.44244273626959,47.676631788480464,NaN,NaN,1.7991600776796859,42.267421663165536,0.04166793403451199,-0.01714924217188951,-0.0588171762064015,15547414,18795625.6,62.3664649905976,43.775434646726175,NaN,NaN,-1.0542567775429934,-2.2448837374866693
2013-05-02T09:30:00-04:00,41.05,41.47,41.05,41.41499,7421930,11857929.4,53.69849460554907,47.47499954100302,NaN,NaN,43.011975135464226,40.789023409930635,0.055429704982252054,0.010469955021413568,-0.044959749960838485,22969344,19491387.4,62.77439116612057,45.011672237938015,NaN,NaN,0.2715794791622671,-1.885388992251107
2013-05-03T09:30:00-04:00,41.87,42.37,41.8297,42.13,14713891,11951208.5,60.811287801953675,48.974441033012745,NaN,NaN,151.9855033582505,62.642355160931515,0.10718975693867472,0.08902744621250491,-0.018162310726169806,37683235,24697445.4,65.76468580407867,46.52657408626303,NaN,NaN,3.9038631134783848,-1.0583529771468938
2013-05-06T09:30:00-04:00,42.13989,42.44,42.08,42.39999,13658277,12221791.3,63.115433815153175,50.11780249567183,NaN,NaN,154.587019927623,81.31628080494835,0.15140860393885971,0.17109844419740483,0.019689840258545123,51341512,31048314.2,69.03270273422376,48.348931946680295,NaN,NaN,7.6147151012574685,0.18065674833944367
2013-05-07T09:30:00-04:00,42.50999,42.799,42.45,42.78999,14717773,12423578.95,66.20634014930695,51.949248294875666,NaN,NaN,174.01329774329204,105.07939124846189,0.19589641174153336,0.2645603549354618,0.06866394319392846,66059285,38720158,72.45350254990483,50.809831509640404,NaN,NaN,11.747186759662757,1.8330181785284883
2013-05-08T09:30:00-04:00,42.72,43.07001,42.64,43.06,9877309,12337929.55,68.19360408181001,54.03299388166696,NaN,NaN,177.75040609844473,140.26964045261488,0.2301167055373275,0.35630982511558784,0.12619311957826035,75936594,50797994,76.79871028391355,54.11642348690004,NaN,NaN,15.7764836439494,3.824941816445761
2013-05-09T09:30:00-04:00,43.08,43.295,42.94,43.06,8065672,12248466.45,68.19360408181001,55.92690116376868,NaN,NaN,172.49309972232373,166.1658653699868,0.23835174619412708,0.4241328023209192,0.18578105612679213,75936594,61391444,79.8073516139788,57.890584391060486,NaN,NaN,18.94274429905329,5.984627885389694
2013-05-10T09:30:00-04:00,43.13,43.21001,42.88499,43.19,9576258,12355360.6,69.20480205910654,57.84950436823863,NaN,NaN,145.5149620561315,164.871757109563,0.2376210836155454,0.4828074106462239,0.2451863270306785,85512852,70957367.4,82.06859250895124,61.708919272993406,NaN,NaN,21.853753926672233,8.251645891287199
2013-05-13T09:30:00-04:00,43.14,43.16,42.89,43.02,5737730,11147839.1,66.23910726615759,59.27704680910082,NaN,NaN,117.00019082313308,157.354391288665,0.2116223088226334,0.5097142130589702,0.29809190423633686,79775122,76644089.4,83.26814027302049,65.47422475661938,NaN,NaN,23.458833227388418,10.424101225015944
2013-05-14T09:30:00-04:00,43.16,43.55,43.03999,43.55,9893473,11135349.1,70.48564640745587,60.64203785281104,NaN,NaN,122.98510724112751,147.1487531882321,0.21533890417780976,0.5672655344585991,0.3519266302807893,89668595,81365951.4,84.21253087290651,68.75244512670193,NaN,NaN,26.21135858010277,12.679423704314061
2013-05-15T09:30:00-04:00,43.35001,43.74001,43.28999,43.73,12427887,10959782.7,71.7837284857028,61.93020733997529,NaN,NaN,120.03017599980218,135.60470716850358,0.21465870453213592,0.6202500109459592,0.4055913064138233,102096482,86597929,85.20873863405933,71.32191461191243,NaN,NaN,28.887373540632094,14.994845109502352
2013-05-16T09:30:00-04:00,43.55,43.8,43.44,43.50999,12043434,10725820.2,67.85539917907883,63.049752663790954,NaN,NaN,107.46759944679687,122.5996071133982,0.18524138183708644,0.6371430337101813,0.4519016518730949,90053048,89421219.8,85.73194916297832,73.54875343301612,NaN,NaN,29.995056659369396,17.137732473769073
2013-05-17T09:30:00-04:00,43.7,44.17999,43.67999,44.17,14377281,10672229.55,72.68466568824805,64.33630477094236,NaN,NaN,123.24849930934089,118.14631456404008,0.19509290974389626,0.6957677890529652,0.500674879309069,104430329,93204715.2,86.42495185702246,75.54414699686757,NaN,NaN,32.550792584023476,19.339598203805416
2013-05-20T09:30:00-04:00,44.03999,44.44,44.03999,44.3,14154207,10685924.25,73.52825906270952,65.67448681573656,NaN,NaN,126.98083561452835,120.14244352231913,0.19477230286760605,0.7441402578935765,0.5493679550259705,118584536,100966598,87.74048588681177,77.40379988132624,NaN,NaN,34.878602858505495,21.559456011619712
2013-05-21T09:30:00-04:00,44.31,44.55,44.235,44.36,11247098,10688561.95,73.92846708351574,67.5663456976827,NaN,NaN,123.29059964422419,120.20354200293848,0.1831816437746404,0.778345009744271,0.5951633659696306,129831634,108999205.8,88.93548418627572,79.30158696673182,NaN,NaN,36.882264425949494,23.748428642238252
2013-05-22T09:30:00-04:00,44.42999,44.7,43.82001,43.97,16560398,11017767.4,66.85348453677304,68.50598783562727,NaN,NaN,100.2209310710613,116.2416930171903,0.13599927905381892,0.7651624647869042,0.6291631857330853,113271236,111234156.6,89.24947700084454,81.19266452635496,NaN,NaN,36.52164105080495,25.573173272033497
2013-05-23T09:30:00-04:00,43.42999,43.95,43.42999,43.85001,10854941,11068246.1,64.79879719277217,68.79080993497145,NaN,NaN,65.63204066325183,107.87458126048128,0.08590353783582627,0.7365426080278681,0.6506390701920418,102416295,113706806,89.6010817385604,82.8952642359608,NaN,NaN,35.62258213059789,27.008803108971268
2013-05-24T09:30:00-04:00,43.58009,43.78,43.38,43.71001,8787594,11115746.3,62.389443949237645,68.73895351597749,NaN,NaN,52.49725389611423,93.72433217783595,0.03513506721259929,0.694557904207791,0.6594228369951917,93628701,111546480.4,86.92612477902522,84.17336581058949,NaN,NaN,34.177778437536205,28.0329424416234
2013-05-28T09:30:00-04:00,44.25,44.35001,43.86,43.94,13685445,11403307.4,64.7107959363191,68.6321289293355,NaN,NaN,80.947661833895,84.51769742170927,0.010138127462720692,0.6720954963235926,0.6619573688608719,107314146,109292402.4,84.10476444606871,85.0055988031726,NaN,NaN,33.58218992750708,28.825692082463927
2013-05-29T09:30:00-04:00,43.73,43.88901,43.55,43.69,9297914,11462558.2,60.35038868076425,68.07189925783223,NaN,NaN,46.5056552106206,69.16070853498856,-0.02805028242514429,0.6268945158294414,0.6549447982545857,98016232,102929322,76.55133527089242,84.98792915938539,NaN,NaN,31.806150906856185,29.251471914519964
2013-05-30T09:30:00-04:00,43.82001,44.155,43.71001,43.95,7269469,11218399.05,63.13272350031969,67.71040778772577,NaN,NaN,62.94477329180615,61.705476979137515,-0.039894009869939295,0.6050772859171616,0.6449712957871009,105285701,101332215,74.73702868926718,84.6257632361917,NaN,NaN,31.062224680716582,29.510150881119483
2013-05-31T09:30:00-04:00,43.84,44.27499,43.49001,43.53,11180348,11406319.95,56.26420222832034,66.7860792283839,NaN,NaN,37.94254642390775,56.167578131268705,-0.07790961785503281,0.5475842734683098,0.6254938913233427,94105353,99670026.6,72.80310763836444,83.96394288829264,NaN,NaN,28.30555782512807,29.338066158834994
2013-06-03T09:30:00-04:00,43.71001,43.80499,43.23,43.74001,25628800,11952065.4,58.68464900463435,66.24647506684653,NaN,NaN,7.115290826995486,47.09118551744494,-0.08995307438045042,0.5130525483477797,0.6030056227282301,119734153,104891117,74.99210713767175,83.37279766433916,NaN,NaN,26.70042154478231,28.961259785398898
2013-06-04T09:30:00-04:00,43.74001,43.97,43.2,43.5,12262691,11882286.1,54.94233969799266,65.13623887331343,NaN,NaN,-9.62891868614548,28.975869413436904,-0.11360055546228176,0.4610049284003779,0.5746054838626596,107471462,104922580.2,75.00516292453287,82.7151285251696,NaN,NaN,24.210479492127625,28.282576886360143
2013-06-05T09:30:00-04:00,43.33,43.38,42.66,42.71001,12775227,11785158.8,44.81271480753833,63.20973789630169,NaN,NaN,-136.10972686013213,-7.547207000713644,-0.1781210943963496,0.3519541158672226,0.5300752102635722,94696235,104258580.8,74.12564655836863,81.9234790911917,NaN,NaN,18.42901574441677,26.87492529465395
2013-06-06T09:30:00-04:00,42.77499,43.02,42.55,42.98,13916496,11987118.15,48.31960983091625,61.81432437143293,NaN,NaN,-146.74052999747943,-49.48426765857076,-0.19682637958565313,0.2840422357815058,0.4808686153671589,108612731,104923986.8,74.44899036093426,81.11755346247426,NaN,NaN,14.828992562487672,25.154077761487336
2013-06-07T09:30:00-04:00,43.34,43.815,43.17,43.78999,14067473,12287208.2,57.12257683978377,60.702746596542625,NaN,NaN,-10.109188251855162,-59.094614593723335,-0.15092484376355758,0.29221256066271195,0.44313740442626953,122680204,110638957,77.09634306603033,80.45122426311768,NaN,NaN,14.680438344350252,23.657843559039183
2013-06-10T09:30:00-04:00,43.94,43.94,43.52,43.66,9390336,12277912.1,55.48905264762155,59.41423185260777,NaN,NaN,7.768056027386972,-58.964061553645045,-0.12657857791755522,0.2849141820293255,0.4114927599468807,113289868,109350100,75.20391390543077,79.55575483587619,NaN,NaN,14.018611994199725,22.28081047834783
2013-06-11T09:30:00-04:00,43.23,43.63,43.11,43.25999,9883805,12485215.85,50.685656107072745,57.754031068576126,NaN,NaN,-82.53287004280023,-73.54485182497599,-0.13396255658429884,0.2440395642165072,0.37800212080080603,103406063,108537020.2,73.97036398627279,78.48681767873312,NaN,NaN,11.858302173968115,20.7918807205793
2013-06-12T09:30:00-04:00,43.59,43.62,42.89,42.96001,11072543,12544169.35,47.37370000506667,56.362617887739965,NaN,NaN,-116.58917148169184,-69.64074074928793,-0.1541583487555086,0.1853041848564203,0.3394625336119289,92333520,108064477.2,73.21868731836236,77.34176127284152,NaN,NaN,8.997293703417045,19.10693971812755
2013-06-13T09:30:00-04:00,42.92,43.66499,42.83,43.59,12985453,12572047.65,54.14962282008556,55.6019625754052,NaN,NaN,-65.5495351655516,-53.40254178290237,-0.12162576974731099,0.18743032142779015,0.30905609117510113,105318973,107405725.6,72.11845409453475,76.09300215541111,NaN,NaN,8.818562119515382,17.637171489754383
2013-06-14T09:30:00-04:00,43.55,43.75999,43.25,43.3,8207164,12380234.15,50.90070703932345,54.78133851041133,NaN,NaN,-46.62752394647145,-60.70620892182562,-0.11618388355531117,0.1638262367309622,0.28001012028627337,97111809,102292046.6,64.06997477069214,74.46042001195876,NaN,NaN,7.593876469602587,16.202415058304126
2013-06-17T09:30:00-04:00,43.58,43.78999,43.38,43.64,8527340,12087737.1,54.35827459271639,54.041872700153995,NaN,NaN,-7.51573715990056,-63.762967559283126,-0.08753725667570161,0.17058854944164636,0.258125806117348,105639149,100761902.8,61.84583859370515,72.87049673678993,NaN,NaN,7.722021926450305,14.990930325182152
2013-06-18T09:30:00-04:00,43.66,44.255,43.64999,44.155,8798352,11819944.35,59.060961540839386,53.949770761587935,NaN,NaN,92.29845138681426,-28.796703273360237,-0.03448044511794657,0.21502524971991477,0.24950569483786134,114437501,102968190.4,63.79731013273509,71.95949494120727,NaN,NaN,9.411564805105579,14.193878108028356
2013-06-19T09:30:00-04:00,44.06,44.17,43.48,43.48,13613020,11938240.45,51.5620923937093,53.123297111115754,NaN,NaN,31.274622179645796,0.7760554589072897,-0.04476956047579694,0.19354374424311516,0.2383133047189121,100824481,104666382.6,65.26975016900803,71.28326076118876,NaN,NaN,8.281489854736819,13.349251214700994
2013-06-20T09:30:00-04:00,43.05521,43.14,42.44,42.49001,19493120,12084876.55,42.94898462184185,52.17221013922444,NaN,NaN,-191.66180361184357,-24.4463982303511,-0.11422319022244451,0.09553431694085646,0.20975750716330097,81331361,99868860.2,58.082585860647924,70.2317949199233,NaN,NaN,4.0762504000579405,12.02453681260913
2013-06-21T09:30:00-04:00,42.63,42.67,42.0014,42.3,14635801,12273919.55,41.515573646611834,50.9458476136514,NaN,NaN,-213.57589107806032,-57.83607165666888,-0.16580592488652257,0.002500101055147752,0.16830602594167032,66695560,93785610.4,50.4905378940014,68.4816828310897,NaN,NaN,0.35297493860807916,10.357170830608979
2013-06-24T09:30:00-04:00,41.91,41.965,41.37151,41.59,17411184,12705099.05,36.60008704260353,49.63568670969504,NaN,NaN,-251.4835419453027,-106.6296326137493,-0.23629011830874083,-0.1270566219442557,0.10923349636448512,49284376,82514655.8,40.046140261714875,65.98460978374557,NaN,NaN,-4.550614813488344,8.227487167166505
2013-06-25T09:30:00-04:00,41.96001,42.19,41.78999,42.05499,8717305,12456692.05,41.4864099774698,49.39809350754728,NaN,NaN,-160.39539860358983,-157.16840261183012,-0.23940281222433832,-0.19002001891593778,0.04938279330840054,58001681,71227491.8,32.741748105248774,63.02861703709414,NaN,NaN,-6.811452741369559,6.079067180232782
2013-06-26T09:30:00-04:00,42.46001,42.64999,42.22749,42.47,14745285,12729060.6,45.522062738447644,49.198268715228096,NaN,NaN,-90.20134753577666,-181.4635965549146,-0.20276914229581616,-0.20407863456136965,-0.0013094922655535052,72746966,65611988.8,29.826874816537654,59.841323069637255,NaN,NaN,-7.261622324694368,4.173254393814617
2013-06-27T09:30:00-04:00,42.82001,43.00999,42.69,42.89,9177758,12824475.05,49.330763226856746,48.64171060001902,NaN,NaN,-33.51156097799304,-149.83354802814452,-0.1423630170030337,-0.17926326351934563,-0.036900246516311935,81924724,65730661.4,29.968766216066058,56.47506758035409,NaN,NaN,-6.349381036793149,2.670020760870651
2013-06-28T09:30:00-04:00,42.8,42.96001,42.57001,42.64,13129250,12921920.15,47.214792508253794,48.050692018635615,NaN,NaN,-45.13865007883384,-116.14609982829923,-0.11265672678616634,-0.17772115499901986,-0.06506442821285352,68795474,66150644.2,30.504326976658675,53.282239942584646,NaN,NaN,-6.292744694538895,1.3896256958121445
2013-07-01T09:30:00-04:00,42.99001,43.34,42.82001,43.07001,15781426,12429551.45,51.10008031063495,48.08029374746148,NaN,NaN,3.4065922211761928,-65.16807299500344,-0.06009633421961924,-0.14018484598737757,-0.08008851176775833,84576900,73209149,38.954002975007356,50.78107129892283,NaN,NaN,-4.997845430023889,0.47712982069271115
2013-07-02T09:30:00-04:00,42.92,43.12,42.47,42.61,12916844,12462259.1,47.1056286786965,48.0611457955779,NaN,NaN,-37.66873828763409,-40.62274093181231,-0.052628761137177446,-0.14587446318923014,-0.0932457020520527,71660056,75940824,41.898238751260294,48.54389640127268,NaN,NaN,-5.176337135815606,-0.3305083159513341
2013-07-03T09:30:00-04:00,42.44,42.769,42.35001,42.63,6081871,12127591.3,47.29851695270513,47.57178109076501,NaN,NaN,-54.02393700973523,-33.387258826604025,-0.04306288783339397,-0.14707431184379516,-0.10401142401040119,77741927,76939816.2,42.98129373757188,46.46267066148963,NaN,NaN,-5.2596552599905655,-1.0346721650997956
2013-07-05T09:30:00-04:00,42.96001,43.3,42.78,43.3,5687434,11716138.2,53.42584137823225,47.7521478292585,NaN,NaN,15.793834952344154,-23.526179640536604,0.00889633102643711,-0.0928910102273548,-0.10178734125379191,83429361,77240743.6,43.32401778888846,44.98081659136079,NaN,NaN,-3.4110838954969163,-1.374159555156527
2013-07-08T09:30:00-04:00,43.38,43.69,43.35001,43.41499,10901711,11557850.1,54.405622979321336,47.75552985687313,NaN,NaN,64.46734754204496,-1.6049801163608017,0.04926337134064815,-0.040208127077981715,-0.08947149841862986,94331072,82347863.2,48.93395995728624,44.0585395459023,NaN,NaN,-1.6232168903258761,-1.409739174466434
2013-07-09T09:30:00-04:00,43.74001,44.24001,43.73,44.03,13045074,11740587,59.33317598771175,47.77497374593544,NaN,NaN,127.84669889828503,23.283041219060966,0.11204637883750859,0.05058647512825587,-0.061459903709252715,107376146,86907712.4,53.37175773528533,43.31385723179874,NaN,NaN,1.4961644701453538,-0.9946100823790358
2013-07-10T09:30:00-04:00,44.03999,44.24001,43.87,44.02,9349570,11713875.25,59.22110349790504,48.32204596766371,NaN,NaN,121.30766168546462,55.07832121368072,0.14544603687331537,0.12034764238239148,-0.025098394490923874,98026576,92181016.4,57.92552702020227,42.789269864026906,NaN,NaN,3.95384686053043,-0.2876876619633978
2013-07-11T09:30:00-04:00,44.69,44.75,44.47,44.72,14058637,11863179.95,64.30392248794679,49.847398672385495,NaN,NaN,164.29653230501842,98.74241507663143,0.20365695582425375,0.22947280028939332,0.02581584446513957,112085213,99049673.6,62.994931133906974,43.140151669259694,NaN,NaN,7.759152493121173,0.8618609316201121
2013-07-12T09:30:00-04:00,44.56,44.66,44.215,44.45,11366137,11782214.15,61.13848144213106,51.24903494349401,NaN,NaN,124.33496327197706,120.45064074055801,0.21200027058137869,0.29081618269186293,0.07881591211048425,100719076,102507616.6,65.26400504519569,44.19539932291644,NaN,NaN,9.974809500834896,2.163710727222224
2013-07-15T09:30:00-04:00,44.58,44.6875,44.50999,44.61,11794211,11961566.5,62.32213326619295,53.086323959464686,NaN,NaN,122.7997722356339,132.1171256792758,0.21560857072131037,0.34832662551212223,0.13271805479081186,112513287,106144059.6,67.51955783663712,46.15778629255374,NaN,NaN,12.148286873868463,3.5900787481716865
2013-07-16T09:30:00-04:00,44.67999,44.7377,44.31,44.37,6269145,11848656.75,59.39957303536601,54.365835606457274,NaN,NaN,100.68446434392332,126.68467876840346,0.19004142130302928,0.37026983141959846,0.18022841011656918,106244142,105917658.8,67.22687179425711,48.62100941319719,NaN,NaN,13.147362411118605,4.955404985735532
2013-07-17T09:30:00-04:00,44.59,44.69,44.42,44.5,9605137,11888996,60.48062851513874,55.43430459050664,NaN,NaN,100.30478472649062,122.48410337660866,0.17070733031621937,0.3936125730118434,0.222905242695624,115849279,109482199.4,69.47074792817213,51.45271463545679,NaN,NaN,14.282627070638076,6.2878652835787525
2013-07-18T09:30:00-04:00,44.60001,45.08,44.53999,44.95,10896289,11753159.45,64.04909075318872,56.485613699530354,NaN,NaN,113.0202858973627,112.22885409507754,0.17632610048276576,0.44331286829908123,0.2669867678163155,126745568,112414270.4,71.21649097435257,54.39898068962011,NaN,NaN,16.320249631750297,7.721063047603259
2013-07-19T09:30:00-04:00,45.11,45.42999,45.05,45.41,13266582,11441832.55,67.29961863275526,57.92024413699475,NaN,NaN,127.25047623893057,112.81195668846824,0.1975265891743484,0.513895004284251,0.31636841510990255,140012150,120272885.2,75.29422456087967,57.59825908849304,NaN,NaN,19.081296090854654,9.343953482353458
2013-07-22T09:30:00-04:00,45.49001,45.57001,45.36,45.44,5961348,11008109.9,67.50596449926745,59.09209300761136,NaN,NaN,122.37159258802974,112.72632075894742,0.19949023402616328,0.5657312076426066,0.36624097361644337,145973498,126964927.4,78.134913397401,60.39689554723544,NaN,NaN,21.38719352746559,11.064416345940906
2013-07-23T09:30:00-04:00,45.59,45.64,45.27,45.41,6252879,10450194.65,67.0503175380406,60.51671364042165,NaN,NaN,111.78735898278865,114.94689968672046,0.18500992190578136,0.5975033759986701,0.41249345409288873,139720619,133660222.8,80.54509637177674,63.15738537727232,NaN,NaN,23.17320101558206,12.794242727318213
2013-07-24T09:30:00-04:00,45.56,45.64,44.99001,45.06,10964980,10562578.4,61.80867680229399,61.55315362967799,NaN,NaN,90.99345638868971,113.08463401916029,0.14013861055920557,0.5876667172918957,0.4475281067326901,128755639,136241494.8,81.39651253247108,65.90132957690797,NaN,NaN,23.31903630023005,14.297784666305619
2013-07-25T09:30:00-04:00,44.94,45.08,44.675,45.08,7031863,10176907.3,61.991526176419555,62.16498825811995,NaN,NaN,63.95000078762457,103.27057699721266,0.10186416932821224,0.5748583183929554,0.4729941490647432,135787502,138049881.6,81.99113509850885,68.66326652759516,NaN,NaN,23.488147001868338,15.610693571386006
2013-07-26T09:30:00-04:00,44.86,44.96001,44.67,44.92999,5800203,10008029.55,59.683411866577885,62.54197317863827,NaN,NaN,51.839240722915406,88.18832989400963,0.05864911786534566,0.5463055463964253,0.4876564285310796,129987299,136044911.4,78.97709214487037,70.80920454099402,NaN,NaN,23.027755823385878,16.670273893100273
2013-07-29T09:30:00-04:00,44.74001,44.97501,44.73,44.81,8372254,9770179.75,57.82869383643487,62.434510167832784,NaN,NaN,46.225003312716545,72.95901203894698,0.016384925096538994,0.5081375849017533,0.4917526598052143,121615045,131173220.8,72.04676867618784,72.14313389391563,NaN,NaN,22.1486270710309,17.45289577566179
2013-07-30T09:30:00-04:00,45,45.23801,44.875,45,7145109,9338363.9,59.95100521589503,62.486646004832075,NaN,NaN,61.09913130418374,62.821366503226,-0.003322235992612388,0.48759986481444884,0.4909221008070612,128760154,128981127.8,69.10813468919112,72.94189158455768,NaN,NaN,21.920469324422736,18.091120568341925
2013-07-31T09:30:00-04:00,45.07001,45.5,45.07001,45.16,12299977,9307520.55,61.69905040997527,62.30058371354839,NaN,NaN,79.38742122292943,60.50015947007394,-0.009764962545125044,0.4787158976256549,0.48848086017077996,141060131,131442026.2,70.55987848947731,73.48224496709842,NaN,NaN,22.1717361141672,18.674065646316965
2013-08-01T09:30:00-04:00,45.42,45.99001,45.42,45.92999,12594469,9633150.45,68.76475849185579,62.845317788528725,NaN,NaN,139.14718736114776,75.53959678477858,0.031394332944138625,0.5277237763509532,0.4963294434068146,153654600,135015445.8,72.57528641753987,74.0044793508373,NaN,NaN,24.515110119402443,19.508500571043463
2013-08-02T09:30:00-04:00,45.77,46.02,45.64999,46.02,5988152,9648186.35,69.47370043470528,63.35614401485103,NaN,NaN,149.92572877032956,95.1568943942614,0.056765726284777385,0.5672866012627864,0.510520874978009,159642752,140946536.4,75.5652536319048,74.57917190764213,NaN,NaN,26.652829799467,20.529119032246825
2013-08-05T09:30:00-04:00,45.83,45.97,45.771,45.845,4468105,9326506.05,66.32192756237954,63.85059790963771,NaN,NaN,132.22970772681754,112.35783527708159,0.05386985839694258,0.5778581979741872,0.5239883395772447,155174647,147658456.8,78.43107868121837,75.37947239956793,NaN,NaN,27.580045084653953,21.5363941825907
2013-08-06T09:30:00-04:00,45.75999,45.75999,45.42,45.5,8234215,9085963.1,60.49524386423761,63.85164186314478,NaN,NaN,78.80791579682804,115.89959217561045,0.022436641825793635,0.5520341418594867,0.5295975000336931,146940432,151294512.4,79.81240064571327,76.1181618793923,NaN,NaN,26.70002708166675,22.27405602531585
2013-08-07T09:30:00-04:00,45.3,45.45,45.19,45.42999,8927637,9064866.45,59.355645025752146,63.516395739756454,NaN,NaN,40.38563543489409,108.09923501800338,-0.007737369158125507,0.5199257885860362,0.5276631577441617,138012795,150685045.2,78.90028569796881,76.6670043596506,NaN,NaN,25.649413523988535,22.75624995369766
2013-08-08T09:30:00-04:00,45.67999,45.78,45.45,45.64,4971309,8610500.05,61.687167508239554,63.11550637371962,NaN,NaN,77.8145704059381,95.83271162696147,-0.017652505707227206,0.5055975256101277,0.5232500313173549,142984104,148550946,75.64054685576735,76.69174166642829,NaN,NaN,25.38881485598453,23.132330654024358
2013-08-09T09:30:00-04:00,45.67,45.67,45.315,45.49001,5526168,8318501.6,59.08047178035927,62.513685465226175,NaN,NaN,50.368753086289445,75.92131649015343,-0.03728412974142681,0.47664486914057136,0.5139289988819982,137457936,144113982.8,69.23595004660899,76.056101427086,NaN,NaN,24.439647673078397,23.319090228174936
2013-08-12T09:30:00-04:00,45.21001,45.60001,45.19,45.55,6165457,8037063.9,59.811937239591835,61.99665830105126,NaN,NaN,37.05216031946941,56.88580700868381,-0.04849132659813671,0.45331484063432725,0.501806167232464,143623393,141803732,66.09774191330719,75.02414753719533,NaN,NaN,23.837413409590088,23.393136396948528
2013-08-13T09:30:00-04:00,45.57001,45.87,45.39999,45.75,7791656,8113189.45,62.23564940677422,62.02715634422843,NaN,NaN,76.87457742170153,56.49913933365851,-0.04478512327680545,0.44582476313645714,0.4906098864132626,151415049,142698655.4,66.72689287385852,73.97631756158015,NaN,NaN,23.962288679484992,23.474443865882307
2013-08-14T09:30:00-04:00,45.71001,45.8,45.42,45.42999,10253023,8145583.75,56.37691860164209,61.62611294603004,NaN,NaN,44.14731415620912,57.25147507792152,-0.06500952395354792,0.40934798147132767,0.4743575054248756,141162026,143328501.6,67.18840897906982,72.91897998162021,NaN,NaN,22.413857788364748,23.322931569094084
2013-08-15T09:30:00-04:00,44.99001,45.05991,44.77,44.92,7586238,7980081.2,48.53531375655764,60.82982022388573,NaN,NaN,-115.0063480837782,18.68729137997826,-0.11114887701764287,0.33542140915282204,0.4465702861704649,133575788,141446838.4,64.31816250222116,71.87191357857384,NaN,NaN,18.56109082381292,22.642668605482488
2013-08-16T09:30:00-04:00,44.89,45.10989,44.78999,44.98,8138824,7723693.3,49.42656539426372,60.22966819230208,NaN,NaN,-93.3978713754061,-10.066033512360843,-0.13448375807953028,0.2784655885710521,0.41294934665058236,141714612,142298173.6,65.04572206446713,71.37183882059378,NaN,NaN,15.67896783668947,21.64785420994063
2013-08-19T09:30:00-04:00,44.8501,45.05,44.74001,44.74001,5182324,7684742.1,45.99547104145833,59.23284432269946,NaN,NaN,-104.80975750548248,-38.43841707735122,-0.16114013014287504,0.21152418397198858,0.3726643141148636,136532288,140879952.6,62.75028673671723,70.9177068239885,NaN,NaN,12.171606550222252,20.294104544266574
2013-08-20T09:30:00-04:00,44.78999,45.00999,44.62,44.82001,6768621,7710529.2,47.308559029261325,58.2049520812199,NaN,NaN,-97.53116549352454,-73.31956566039644,-0.16769269214992116,0.16304844892746218,0.33074114107738334,143300909,139257124.6,60.13518702898815,70.17308600538213,NaN,NaN,9.631775510673945,18.77091468232477
2013-08-21T09:30:00-04:00,44.75,44.86,44.46001,44.50999,7864984,7555529.4,42.950288908799784,56.3610613967159,NaN,NaN,-121.7440003691224,-106.49782856546274,-0.18580903903721907,0.09847984228085949,0.28428888131807856,135435925,138111904.4,58.28906329969905,69.15264149696493,NaN,NaN,6.089322918125523,16.95925871601059
2013-08-22T09:30:00-04:00,44.61,45.185,44.61,45.12,9124559,7660164.2,52.26812101065768,55.13209143785535,NaN,NaN,-54.99721110106809,-94.49600116892073,-0.15108599179260013,0.09543139157732838,0.2465173833699285,144560484,140308843.6,60.77671634508605,68.0963174050493,NaN,NaN,5.760913515520467,15.359495115940573
2013-08-23T09:30:00-04:00,45.23,45.23,44.91,45.13,5270430,7633675.55,52.40535675300681,54.13805066575729,NaN,NaN,-36.33824907709453,-83.08407670925841,-0.12301135641933025,0.0927531878457657,0.21576454426509595,149830914,141932104,62.55377884846954,66.96222455985297,NaN,NaN,5.542967093352575,13.957133969856574
2013-08-26T09:30:00-04:00,45.22,45.39999,44.98,45.03,6570270,7543576.35,50.83146093937034,53.447780456838196,NaN,NaN,-31.577614105278435,-68.4376480292176,-0.10731511083931533,0.08162065571595178,0.18893576655526712,143260644,143277775.2,64.00951253046472,65.83344683733522,NaN,NaN,4.904596517587255,12.6639143338181
2013-08-27T09:30:00-04:00,44.50999,44.67,44.07001,44.12,14017051,7887173.45,39.272579655264465,52.01327578751765,NaN,NaN,-175.43203981989836,-84.01782289449235,-0.15164793814965308,-0.000624156131799225,0.15102378201785385,129243593,140466312,58.86102263427936,64.40207090421454,NaN,NaN,0.29909398931536196,10.897511427460566
2013-08-28T09:30:00-04:00,44.00999,44.33501,43.97,44.16,7962867,7670317.95,39.9193072993202,50.458428629737696,NaN,NaN,-165.0308707084054,-92.67519696234896,-0.17030940837409106,-0.061862978449759964,0.1084464299243311,137206460,140820419,59.30500238642044,63.235246299261185,NaN,NaN,-3.0752153804057083,8.901407597765385
2013-08-29T09:30:00-04:00,44.05,44.52,44.03,44.28999,4614383,7271313.65,42.07811479054696,49.243974559036815,NaN,NaN,-130.2019321716852,-107.71614117647239,-0.16577118304944885,-0.09876754888747996,0.06700363416196889,141820843,140272490.8,58.25730967721751,62.45105770144751,NaN,NaN,-5.154266734093095,6.893454121785602
2013-08-30T09:30:00-04:00,44.39,44.47,43.92999,44.03999,8162934,7380052.75,39.163537063114205,47.76908883214556,NaN,NaN,-135.12255105194114,-127.4730015714417,-0.1708019872938607,-0.146498849955357,0.024303137338503707,133657909,137037889.8,52.37499400027699,61.47086142194535,NaN,NaN,-7.812735248265683,4.79256992606399
2013-09-03T09:30:00-04:00,44.46001,44.75,44.13,44.32001,9736664,7643480.7,43.85456026834775,46.45615389368653,NaN,NaN,-88.90032512071487,-138.937543774529,-0.1473528203623664,-0.1598878881144543,-0.012535067752087896,143394573,137064675.6,52.41784003582045,60.448786219228346,NaN,NaN,-8.626337876437864,2.875583097135154
2013-09-04T09:30:00-04:00,44.27,44.85001,44.24001,44.77499,7486898,7606114.85,50.52937154864067,46.038471961329286,NaN,NaN,-48.181753325501234,-113.48748647564958,-0.09578081797945562,-0.13226109022640742,-0.0364802722469518,150881471,141392251.2,58.85785986389087,59.85374699671557,NaN,NaN,-7.172726099872971,1.440110354705422
2013-09-05T09:30:00-04:00,44.83,45.02,44.67,44.88,4880219,7403743.95,51.94923901786447,46.28232376570835,NaN,NaN,-6.317704182996034,-81.7448531705677,-0.051401420696683006,-0.10073204811780556,-0.049330627421122555,155761690,145103297.2,63.42892243668081,59.79022984917697,NaN,NaN,-5.557573956223229,0.44044116742990036
2013-09-06T09:30:00-04:00,45.09,45.23,44.45,44.86,11587160,7734536.5,51.645210408287355,46.440798409567186,NaN,NaN,-1.5673122528002146,-56.017929186790695,-0.021717342204441027,-0.07647730517667384,-0.05475996297223281,144174530,145574034.6,63.97567792852714,59.713798125181256,NaN,NaN,-4.348440008087058,-0.24368471478680798
2013-09-09T09:30:00-04:00,45.02,45.53,45.0125,45.42,8454238,7880940,58.89850897748699,47.36244397642638,NaN,NaN,91.4529926887993,-10.702820438642613,0.03426364995044541,-0.011930400534176044,-0.046194050484621454,152628768,149368206.4,68.1136130744236,60.0968928635889,NaN,NaN,-0.9047111493067375,-0.33811706257536933
2013-09-10T09:30:00-04:00,45.78999,46.16,45.717,46.08,14050426,8275188.45,65.47215255529497,48.65984351400021,NaN,NaN,198.0465108922222,46.68654676394479,0.1100960946129467,0.09142606778156193,-0.01867002683138478,166679194,154025130.6,72.3167353799053,60.967003460082985,NaN,NaN,4.5208737371413,0.3560244802412976
2013-09-11T09:30:00-04:00,46.07001,46.28999,45.94,46.27,11984352,8484823.25,67.1033072967466,50.38505911313928,NaN,NaN,210.6188168492977,98.44666079890457,0.16415054980022134,0.1865181604188919,0.022367610618670562,178663546,159581545.6,76.32642496545009,62.25538643620806,NaN,NaN,9.414743857627382,1.65012724843931
2013-09-12T09:30:00-04:00,46.23,46.355,46.03999,46.08,8270430,8385693.6,63.854657323520335,51.21266884977232,NaN,NaN,187.9682456858291,137.3038507726696,0.17709651467456716,0.24373825396187954,0.06664173928731236,170393116,162507830.8,78.12354488266025,63.49444561746336,NaN,NaN,12.361333687739414,3.1802995969107535
2013-09-13T09:30:00-04:00,46.17,46.22,45.92999,46.21001,6506605,8331711.95,65.09973254694289,52.11940997791057,NaN,NaN,149.12897981310164,167.44310918585,0.18361647717207502,0.29616233575240614,0.11254585858033112,176899721,169052869,81.50529054356747,64.84812502425606,NaN,NaN,15.140753646519316,4.888935889711977
2013-09-16T09:30:00-04:00,46.7999,46.95,46.64,46.81,15521773,8700859.4,70.20118833306329,53.50296193460292,NaN,NaN,186.89847327733438,186.532205303557,0.2153414852120435,0.38172271509538547,0.16638122988334197,192421494,177011414.2,84.61886085495313,66.3202213331481,NaN,NaN,19.359158881235373,6.956110602786747
2013-09-17T09:30:00-04:00,46.75999,47.07001,46.74001,47.00999,7650992,8824292.8,71.68679343114204,55.81826291859418,NaN,NaN,162.6116254973788,179.44522822458833,0.23518357781963464,0.46036070215788527,0.22517712433825063,200072486,183690072.6,86.64997150756015,68.30514625266815,NaN,NaN,23.271859417248745,9.286931861995605
2013-09-18T09:30:00-04:00,47.05,47.7,46.892,47.60001,12259941,9098858.8,75.55829215555332,58.3639046940394,NaN,NaN,165.84281860081632,170.49002857489205,0.2708923064347528,0.5637925073816916,0.2929002009469388,212332427,190423848.8,88.32410267279859,70.3779391302666,NaN,NaN,28.06348371821249,11.96929641288373
2013-09-19T09:30:00-04:00,47.77,48.00999,47.72,47.75999,12368453,9324032.25,76.49672269005428,60.822376686861354,NaN,NaN,163.61050180531458,165.61847979878914,0.28661245804129276,0.6511657734985548,0.364553315457262,224700880,201285401.6,90.41256894205787,72.67474336346947,NaN,NaN,32.197108678343604,14.858983879377998
2013-09-20T09:30:00-04:00,47.6599,47.67999,46.92999,46.96001,11923863,9463997.45,63.39011646097827,62.552846643851645,NaN,NaN,103.68913463258107,156.53051076268503,0.2270644281723911,0.6483838506727508,0.42131942250035975,212777017,208460860.8,91.49489771497116,75.46902220023334,NaN,NaN,31.35328016590614,17.21531192031059
2013-09-23T09:30:00-04:00,46.88,47.00999,46.59,46.81,7456133,9573282.6,61.270182362503284,63.79681965057704,NaN,NaN,70.67769671815515,133.2863554508492,0.16442340765521013,0.6268486820693724,0.46242527441416226,205320884,211040738.8,91.85109480589405,78.28568325523861,NaN,NaN,29.98095088989121,19.038974630250678
2013-09-24T09:30:00-04:00,46.78,47.25,46.75999,46.98,6755000,9582519.1,62.78893251103574,64.6725025764624,NaN,NaN,74.831585149449,115.73034738126323,0.12317504271856866,0.6163940778123731,0.49321903509380444,212075884,213441418.4,92.17932228184111,80.66578771366362,NaN,NaN,29.35973358613323,20.51336876680533
2013-09-25T09:30:00-04:00,47.03,47.125,46.77,46.77,8193160,9291324.55,59.67582329347279,65.22440145329156,NaN,NaN,62.85298309478644,95.13238028005726,0.07296603421605474,0.5844265778638729,0.5114605436478181,203882724,211751477.8,89.44802883020992,82.52429531320142,NaN,NaN,27.873685423942785,21.564842574967823
2013-09-26T09:30:00-04:00,46.85001,47.08,46.74989,46.98,5382965,9162329.45,61.71977407346675,65.94401314366152,NaN,NaN,61.284742349482684,74.66722838889089,0.046409821567047316,0.5694728206066273,0.52306299903958,209265689,208664439.6,84.52132563054988,83.99184157763162,NaN,NaN,27.258038040881495,22.378156212955492
2013-09-27T09:30:00-04:00,46.67,46.74001,46.49001,46.67999,5966082,9229914.4,57.25480949606219,65.82660603784548,NaN,NaN,36.22091809301444,61.173585080977546,0.0034174195825993348,0.5273347735178291,0.5239173539352298,203299607,206768957.6,81.55117686438481,84.95166756262884,NaN,NaN,25.362626429416892,22.804509101021406
2013-09-30T09:30:00-04:00,46.2,46.595,46.12,46.405,7457965,9194665.95,53.43874428139661,64.96707687542417,NaN,NaN,9.280254421041592,48.89409662155483,-0.046034205743590406,0.4663745967557418,0.5124088024993322,195841642,204873109.2,78.57693942166895,85.3988249941834,NaN,NaN,22.58701093212339,22.773437934035975
2013-10-01T09:30:00-04:00,46.39,46.81,46.38,46.7,11203980,9268031.75,56.767656835343885,64.22881612818112,NaN,NaN,24.555910103490827,38.8389616123632,-0.060461659743812846,0.43683172781956614,0.497293387563379,207045622,203867056.8,76.97264710105463,85.44498371815516,NaN,NaN,21.229175558910928,22.552829023303826
2013-10-02T09:30:00-04:00,46.44,46.55,46.2,46.48,9274723,9357423,53.68506157451829,63.502416431823825,NaN,NaN,-6.099471973511039,25.0484705987037,-0.08490862322234227,0.3911576085354511,0.4760662317577934,197770899,202644691.8,74.96983620339903,85.21971881249364,NaN,NaN,19.159745827818405,22.068102852520195
2013-10-03T09:30:00-04:00,46.47,46.47,45.67,45.97,15708660,9898845.05,47.27607801910468,62.229298251263955,NaN,NaN,-61.31081608743717,0.5293589113197328,-0.1326676694890428,0.3102316448964899,0.4428993143855327,182062239,197204001.8,66.6563562923055,84.15908065168922,NaN,NaN,15.28008019253897,21.098385329665735
2013-10-04T09:30:00-04:00,46.00999,46.3,45.87,46.27,9868375,9812905.8,50.98303765820094,60.856573203059504,NaN,NaN,-64.33399830663683,-19.581624368610527,-0.14053998534690015,0.2672243327019075,0.40776431804880764,191930614,194930203.2,63.4877455375995,82.64971527187824,NaN,NaN,13.17218225943863,19.96607060534758
2013-10-07T09:30:00-04:00,45.67999,46.25999,45.67999,45.95,8956473,9838017.55,47.173099160615735,59.10559504087905,NaN,NaN,-103.72553597757141,-42.18278244833313,-0.16224602402525268,0.20495678801724182,0.3672028120424945,182974141,192356703,60.010680843293855,80.74690879585921,NaN,NaN,10.190508280914305,18.56956170185711
2013-10-08T09:30:00-04:00,45.99001,46.11,45.41,45.42999,17558752,10013433.85,41.71733915587339,56.68838411233048,NaN,NaN,-144.22832216081275,-75.93962890119384,-0.20387928518112097,0.11235370556609325,0.3162329907472142,165415389,184030656.4,50.39444982314404,78.03764787802675,NaN,NaN,5.790087214715571,16.74392248940832
2013-10-09T09:30:00-04:00,45.62,45.62,45.09,45.41,14004270,10114429.75,41.51855176808813,54.18994333219005,NaN,NaN,-163.85143106189224,-107.49002071887007,-0.2234452685923748,0.03692640500674571,0.2603716735991205,151411119,174758700.4,42.27106962915127,74.59896935567626,NaN,NaN,2.264614244134112,14.675449882940576
2013-10-10T09:30:00-04:00,45.95,46.60001,45.86,46.58,14283410,10415078.75,55.026434875896285,53.59253750468419,NaN,NaN,-31.888612206788416,-101.60557994274033,-0.15170256991400768,0.0707434612066109,0.2224460311206186,165694529,171485158.4,39.829918176684366,70.90861367437007,NaN,NaN,3.58103848031208,13.090533968279363
2013-10-11T09:30:00-04:00,46.5,46.88,46.47,46.8,8039035,10491700.25,57.03597038425321,53.29009379195204,NaN,NaN,16.700469458680885,-85.39868638967678,-0.08677124884257517,0.11398197006739963,0.2007532189099748,173733564,167845748.4,37.2540550115706,67.00882511763268,NaN,NaN,5.304823769422499,11.978289654156955
2013-10-14T09:30:00-04:00,46.58,47.0051,46.45,46.98,9823051,10206764.15,58.663419517575406,52.99541429241915,NaN,NaN,30.58003747082512,-58.537571699997486,-0.031867911765915496,0.16091832920258042,0.19278624096849592,183556615,167962243.2,37.3936250415766,63.095561029042365,NaN,NaN,7.210217120031055,11.297136434996112
2013-10-15T09:30:00-04:00,46.88,46.995,46.46001,46.50999,13450273,10496728.2,53.016251487923284,52.51973059202276,NaN,NaN,9.86874046410121,-27.718159175014694,-0.027537530676864624,0.15836432762241515,0.18590185829927977,170106342,168900433.8,38.578563238162374,59.46202777246754,NaN,NaN,6.983022667164117,10.68083446816297
2013-10-16T09:30:00-04:00,46.73,46.92,46.47,46.819,11999375,10483699.9,56.01421150486963,52.11219040855154,NaN,NaN,28.86076752768513,10.824280542900784,-0.00535430430225417,0.17920897792146206,0.18456328222371624,182105717,175039353.4,45.806434637243626,56.696678415802815,NaN,NaN,7.766956421405867,10.2645661757691
2013-10-17T09:30:00-04:00,46.64,47.19,46.63,47.175,10314656,10381010.05,59.24095415396052,52.2540578841157,NaN,NaN,84.35736558577429,34.07347610141333,0.029866853813022204,0.221896849489994,0.1920299956769718,192420373,180384522.2,51.192048236947684,54.52816922812873,NaN,NaN,9.462531655698811,10.149989815759058
2013-10-18T09:30:00-04:00,47.47,47.78999,47.37,47.69099,12946844,10432159.1,63.42859617906615,52.967618733949244,NaN,NaN,180.53146693333684,66.8396755963445,0.08155569908092558,0.29397461952812876,0.21241892044720317,205367217,186711252.8,56.67964369211946,52.96407667601806,NaN,NaN,12.302039091074182,10.45742542651836
2013-10-21T09:30:00-04:00,47.75999,47.86,47.722,47.81,6115430,10365123.95,64.33865632769422,53.50840441197426,NaN,NaN,184.02115236590802,97.52789857536109,0.11533633882570143,0.35658934397932995,0.24125300515362852,211482647,192296459.2,60.86298911650016,51.813386819978454,NaN,NaN,14.853492122395103,11.085434954500753
2013-10-22T09:30:00-04:00,47.97,48.41,47.97,48.13,8021711,10428459.5,66.73560791926104,54.4405862937416,NaN,NaN,208.36031807503545,137.22621409754794,0.1486854627372925,0.4271098335752441,0.27842437083795163,219504358,202176062.4,66.94389573832835,51.240105358187684,NaN,NaN,17.748705040854436,12.037330681122707
2013-10-23T09:30:00-04:00,48.06,48.17999,47.83,48.14999,8815379,10459570.45,66.88534497680844,55.84124821929187,NaN,NaN,163.3620804459926,164.12647668120943,0.16053108313473252,0.47908822475636725,0.31855714162163473,228319737,211418866.4,71.41814359992804,51.58023302301786,NaN,NaN,20.109894254784496,13.190554048788677
2013-10-24T09:30:00-04:00,48.24001,48.56,48.2,48.50999,8303508,10605597.6,69.54419689147988,57.167045307383226,NaN,NaN,170.6623806653941,181.3874796971334,0.17961051819048413,0.5430702893597399,0.36345977116925576,236623245,220259440.8,74.9154671355695,52.396498851444285,NaN,NaN,22.95657538144452,14.585699953453798
2013-10-25T09:30:00-04:00,48.62,48.78,48.34,48.75999,10031617,10808874.35,71.26940213535529,58.88820980557892,NaN,NaN,154.54558126817292,176.1903025641006,0.19479448089651719,0.6069528722899022,0.41215839139338506,246654862,228516969.8,77.66458698056641,53.65749214696376,NaN,NaN,25.88187883596507,16.19943979381255
2013-10-28T09:30:00-04:00,48.6,48.82,48.58,48.69,6635095,10767730.85,70.07266161649918,60.9135899813379,NaN,NaN,134.58999489621493,166.304071070162,0.18587587831638502,0.6445032392888663,0.4586273609724813,240019767,234224393.8,79.34919675729186,55.72568835654575,NaN,NaN,27.952015292898224,17.87837915082479
2013-10-29T09:30:00-04:00,48.76,48.83,48.51,48.83,7591131,10587088.4,71.11740543303911,63.02779381454868,NaN,NaN,116.20505102216116,147.87301765958713,0.1752952051432749,0.6777463674015749,0.5024511622583,247610898,239845701.8,80.87887698275192,58.483388881802945,NaN,NaN,29.9924312230402,19.608958018284135
2013-10-30T09:30:00-04:00,48.94,48.99,48.47,48.61,8914122,10569058.35,67.1503408979582,63.89378710183882,NaN,NaN,99.62390935279444,135.1253834409475,0.1408535424881534,0.6785180903684918,0.5376645478803384,238696776,241921109.6,81.42592034623192,61.45453189391348,NaN,NaN,30.664922836373325,21.188381563725446
2013-10-31T09:30:00-04:00,48.53,48.95,48.42,48.62,9898086,10278529.65,67.23979535214673,64.62263174240265,NaN,NaN,87.74932769951437,118.54277284777156,0.10761879172141098,0.6721880375321021,0.5645692458106911,248594862,244315433,82.06346549321835,64.65520407117404,NaN,NaN,31.24572631939091,22.625145100249085
2013-11-01T09:30:00-04:00,48.73,49.08,48.57,48.97,9922617,10281241.75,70.28934722250857,65.45305514989788,NaN,NaN,92.36221611377046,106.10609981689109,0.09833545120017984,0.687488559810916,0.5891531086107361,258517479,246687956.4,82.6972352649555,67.89117622998681,NaN,NaN,32.60780932436329,24.051239989408256
2013-11-04T09:30:00-05:00,49.17,49.17,48.985,49.15,5477421,10107289.15,71.74600785401176,66.79089489033277,NaN,NaN,99.48063184938238,99.08422720752458,0.09347790942152434,0.7060004953876415,0.6125225859661172,263994900,251482983,83.93288686316917,71.13077077463016,NaN,NaN,34.18148543616871,25.498417910374034
2013-11-05T09:30:00-05:00,48.96,49.21,48.69,49.1,6572081,9557955.6,70.70895052968179,67.84051910639077,NaN,NaN,86.86827447153127,93.21687189739859,0.07675789517721898,0.708469954937641,0.631712059760422,257422819,253445367.2,84.42315944701585,73.88910826104247,NaN,NaN,35.22685684591565,26.888194901165694
2013-11-06T09:30:00-05:00,49.31,49.37,48.99,49.24,5889554,9152219.8,71.93231086373108,68.74704458566009,NaN,NaN,97.00361687503137,92.69281340184598,0.06542961313664564,0.713499076181229,0.6480694630445833,263312373,258368486.6,85.60951836572346,76.34749898452644,NaN,NaN,36.45440406394464,28.254796210134113
2013-11-07T09:30:00-05:00,49.38,49.52,48.64,48.72,10880927,8982095.65,61.63534475178664,68.61895519799728,NaN,NaN,72.99284675946382,89.74151721383586,0.015805826206777063,0.6678267458030547,0.6520209195962776,252431446,259135803.4,85.79115957455274,78.42689297612881,NaN,NaN,34.63894014167705,29.166816771783104
2013-11-08T09:30:00-05:00,48.68,49.38,48.65,49.38,8966032,9028445.5,67.91351018211944,68.87430190188479,NaN,NaN,83.15979681323465,87.9010333537287,0.020049338259529037,0.6770825924206889,0.6570332541611599,261397478,259711803.2,85.93468237730681,80.21772820904359,NaN,NaN,34.90112725931969,29.98600398428833
2013-11-11T09:30:00-05:00,49.37,49.4,49.23,49.34,5319440,8803264.95,67.19580782290981,68.90717332357399,NaN,NaN,96.37743148056404,87.28039327996503,0.013115316647886788,0.6734273999710183,0.6603120833231315,256078038,258128430.8,83.43962780360137,81.3959947851345,NaN,NaN,34.893813777770035,30.687119669071432
2013-11-12T09:30:00-05:00,49.17,49.45,49.121,49.36,10837961,8672649.35,67.38142062452654,68.94260729841099,NaN,NaN,93.53396117566457,88.61353062079169,0.0033380937204947614,0.66448470047375,0.6611466067532552,266915999,260027066.8,84.03809402846079,82.297419815744,NaN,NaN,34.940402796923344,31.294731544478847
2013-11-13T09:30:00-05:00,49.1,49.649,49.06,49.649,9780860,8561723.6,70.02107555075628,68.97667005978789,NaN,NaN,112.74826758083942,91.76246076195329,0.009450688848432476,0.6729599678137959,0.6635092789653634,276696859,262703964,84.86838352294546,83.00834241484229,NaN,NaN,35.744069774587906,31.930351291637283
2013-11-14T09:30:00-05:00,49.58,49.945,49.58,49.84,11060684,8599025,71.65374409524657,69.00412305692298,NaN,NaN,154.73830911760413,108.11155323358136,0.018926610673634547,0.6871675423074066,0.6682409316337721,287757543,269769183.4,86.81743519279124,83.66211728714406,NaN,NaN,36.90000322448872,32.64030156775892
2013-11-15T09:30:00-05:00,49.98,50.06,49.79,50.01,7836758,8343520.7,73.06004753955355,69.21750776571257,NaN,NaN,165.49520299520807,124.57863446997605,0.028630548519563925,0.7040291172832269,0.675398568763663,295594301,276608548,88.37803762426891,84.30703449192814,NaN,NaN,38.28577665355737,33.446798008587265
2013-11-18T09:30:00-05:00,50.25,50.4,49.97,50.085,6686944,8372096.4,73.68042949906683,69.40058091328599,NaN,NaN,176.90511623946105,140.68417142175545,0.03184077305888189,0.7151995350872653,0.6833587620283834,302281245,285849189.4,90.08577867526813,84.96467032710787,NaN,NaN,39.61484502046165,34.32794758171218
2013-11-19T09:30:00-05:00,50.06,50.17,49.67,49.73,9411831,8441602.4,65.9400320343722,69.3141302801727,NaN,NaN,117.91590578983062,145.56056034458865,0.0032984116226261184,0.6874817765566661,0.68418336493404,292869414,291039872.4,90.89510654253276,85.64104076970078,NaN,NaN,38.56585798558031,34.933363353693345
2013-11-20T09:30:00-05:00,49.91,49.91,49.402,49.51,9381659,8469916.4,61.619768989694975,68.91269982571187,NaN,NaN,70.82558781915552,137.17602439225186,-0.03504175093469586,0.6403811762656701,0.675422927200366,283487755,292398051.6,91.09983637326488,86.28649583256124,NaN,NaN,36.39342863645926,35.14194410837419
2013-11-21T09:30:00-05:00,49.72,49.96,49.56,49.91,6829301,8396206.05,65.98363077682814,68.60514865102041,NaN,NaN,93.08827598728807,124.84601776618865,-0.03786631193884238,0.628090037276813,0.6659563492156554,290317056,292909954.2,91.18033221193991,86.8924313287744,NaN,NaN,35.76155058139995,35.23045931880644
2013-11-22T09:30:00-05:00,50.06,50.35,49.885,50.35,5431364,8166193.4,70.02148706085073,68.48196859436605,NaN,NaN,137.57119748774426,119.2612166646959,-0.015643302248605773,0.6464022214048981,0.6620455236535039,295748420,292940778,91.18550180738065,87.41047525336094,NaN,NaN,36.48627464504223,35.4098615082687
2013-11-25T09:30:00-05:00,50.45,50.51,50.12,50.24,7895030,8229190.15,67.85300091200496,68.27797219310341,NaN,NaN,132.2107400233684,110.32234142147738,-0.013949988238528221,0.6446080383553436,0.6585580265938719,287853390,290055207,86.09774462741147,87.53008848053207,NaN,NaN,36.40656796199456,35.55224814451525
2013-11-26T09:30:00-05:00,50.25,50.46,50.188,50.34,8142480,8256757.6,68.79898967607548,68.05416353684231,NaN,NaN,121.89276390237262,111.11771304398579,-0.011779551826264334,0.6438335868110414,0.6556131386373057,295995870,290680498.2,86.27643565313886,87.57772542963316,NaN,NaN,36.62023844430285,35.70481818734205
2013-11-27T09:30:00-05:00,50.46,50.6192,50.41,50.54,3774503,7999776.65,70.65867692233756,68.69868726331023,NaN,NaN,133.111659437666,123.57492736768788,-0.0030152278357766793,0.6518441038425848,0.6548593316783615,299770373,293937021.8,87.1992403963177,87.6783026311878,NaN,NaN,37.34913997650541,35.939721300079675
2013-11-29T09:30:00-05:00,50.73,50.775,50.34,50.4,6964945,7853119.6,67.62037081312755,68.67774873695366,NaN,NaN,118.20245462338218,128.59776309490672,-0.012268556585873336,0.6395236359460199,0.6517921925318932,292805428,294434696.2,87.33935215337736,87.77863618662141,NaN,NaN,37.082327939335755,36.1029508199734
2013-12-02T09:30:00-05:00,50.38,50.48,50.07,50.19,6976705,7705824,63.22844997487095,68.39436603352232,NaN,NaN,74.80870161758892,116.04526392087564,-0.036769200175456485,0.6058306923125727,0.6425998924880292,285828723,292450756.8,83.41946105622266,87.7771957046658,NaN,NaN,35.5727353696627,36.0272057556433
2013-12-03T09:30:00-05:00,50.11,50.11,49.58,49.76,8975964,7880751.15,55.30721988908717,67.53192312384807,NaN,NaN,6.975565641566814,90.99822904451531,-0.08349828268953863,0.5382270391261059,0.6217253218156445,276852759,290250630.6,79.175617476301,87.4298759509401,NaN,NaN,31.74454085964117,35.41539648478585
2013-12-04T09:30:00-05:00,49.52,49.92,49.13,49.56,6777225,7891008.35,52.04151987529328,66.24766914702928,NaN,NaN,-45.16759001698829,57.58615826064314,-0.12684173220924788,0.46317315655408464,0.5900148887633325,270075534,285066563.4,70.1232580822941,86.3766527051793,NaN,NaN,27.521244337324497,34.287660463719945
2013-12-05T09:30:00-05:00,49.56,49.81,49.46,49.58,6940008,7943531.05,52.34455409995727,64.86844129022292,NaN,NaN,-37.05680222724332,23.552465927661274,-0.1514620133081943,0.4006873721280897,0.552149385436284,277015542,280515597.2,63.282963457506426,84.6956190098018,NaN,NaN,24.198442958490883,32.84634367725865
2013-12-06T09:30:00-05:00,50.19,50.36,50.052,50.34,8399548,7819462.1,62.1355380592853,64.08811918448946,NaN,NaN,70.05641924136614,13.923258851258055,-0.11548605555974256,0.40779181598660585,0.5232778715463484,285415090,279037529.6,61.1950876898668,82.75397972877309,NaN,NaN,24.164838653961038,31.60612867393042
2013-12-09T09:30:00-05:00,50.38,50.54,50.361,50.47,5569734,7649647.2,63.51632546690041,63.362111753620425,NaN,NaN,99.45943820888031,18.853406169516333,-0.0833573805226765,0.4190811458930028,0.5024385264156793,290984824,280068749.8,62.133755401268814,80.75740663777313,NaN,NaN,24.579326325284924,30.602299766981066
2013-12-10T09:30:00-05:00,50.38,50.645,50.2,50.36,10114294,7889389.9,61.47356500306328,63.04307839424122,NaN,NaN,80.13047737349315,33.4843885159016,-0.07045059697497791,0.4143752801969569,0.4848258771719348,280870530,280872304,62.88710821593196,78.75683532873022,NaN,NaN,24.292558233926105,29.700908119401785
2013-12-11T09:30:00-05:00,50.38,50.38,49.52,49.57,11225028,7908743.25,49.2283492638747,62.15797698525406,NaN,NaN,-45.38758586455082,33.4403893463891,-0.11350375777873217,0.3429461799485196,0.4564499377272518,269645502,280786297.6,62.74322395600171,76.73136301321142,NaN,NaN,19.77627465189895,28.28310333832995
2013-12-12T09:30:00-05:00,49.45,49.7682,49.43,49.62,9293418,7884371.15,49.90844515377406,61.009749440750205,NaN,NaN,-97.09407469811015,21.43293485221573,-0.13550907411612506,0.28706359508209545,0.4225726691982205,278938920,281170973.2,63.14933568961736,74.72914897590267,NaN,NaN,16.489697872837098,26.59833112897383
2013-12-13T09:30:00-05:00,49.7,49.879,49.54,49.77,6254101,7644042,51.98632189134877,59.721523357214345,NaN,NaN,-67.9954767068858,-6.177444337434656,-0.13647783528969304,0.25197537508610424,0.3884532103757973,285193021,281126559.4,63.06386271655299,72.72046046941497,NaN,NaN,14.461295075964427,24.864468835686772
2013-12-16T09:30:00-05:00,49.93,50.41,49.93,50.24,9108397,7707623.95,57.88176811431905,59.00929244309393,NaN,NaN,32.20147035959251,-19.62903790729222,-0.10347779415595565,0.2591059676808527,0.36258376183680835,294301418,281789878.2,63.85081356707467,71.1313939651052,NaN,NaN,14.596725122576949,23.397648305242512
2013-12-17T09:30:00-05:00,50.41,50.47,50.14,50.22,11329720,7939762.75,57.55789608870613,58.20635718685327,NaN,NaN,48.30281930034911,-25.994569521921022,-0.08195149095363852,0.2601443981447602,0.3420958890983987,282971698,282210111.8,64.36875456211258,69.56655960146047,NaN,NaN,14.60474087555029,22.14151867242934
2013-12-18T09:30:00-05:00,50.36,51.09,49.91,51.06,21341168,8536229.6,66.12989591409226,57.88287282912146,NaN,NaN,122.70462062633965,7.623871776257067,-0.01367517387972994,0.3250019217487363,0.33867709562846626,304312866,289143584.6,71.59909390919577,68.4522634238089,NaN,NaN,17.607646353595435,21.493822626881638
2013-12-19T09:30:00-05:00,50.99,51.14,50.7701,51.11,13576666,8745979.95,66.56279888689764,57.80733197724789,NaN,NaN,174.46091475427332,61.93486966673377,0.029939202899859185,0.37610109925329027,0.3461618963534311,317889532,296933707,77.19774729657937,67.72786307689476,NaN,NaN,20.076112622830024,21.291292626302837
2013-12-20T09:30:00-05:00,50.94,51.42,50.83,51.26,13805969,9094813.35,67.88877836642254,58.14021257664444,NaN,NaN,186.6302153878867,112.86000808568826,0.06212314446630518,0.4238158269363126,0.3616926824700074,331695501,306234203,81.80845408285688,67.61279115022579,NaN,NaN,22.499804873755814,21.463937233081833
2013-12-23T09:30:00-05:00,51.53,51.58,51.35,51.46,6969457,9171718,69.61873855090414,59.162463909631356,NaN,NaN,200.77125411598257,146.57396483696627,0.0885048672655443,0.47232376655193775,0.38381889928639346,338664958,315106911,84.93755748537907,68.02435829373135,NaN,NaN,25.05306427034304,21.976669666976292
2013-12-24T09:30:00-05:00,51.45,51.71,51.45,51.7,2765278,8915230.4,71.59625802041319,60.55923091999706,NaN,NaN,183.5040397165371,173.61420892020388,0.11221788430380791,0.5240912546661534,0.41187337036234545,341430236,326798618.6,87.89284013730446,69.29361415480354,NaN,NaN,27.821078676038503,22.811585239699465
2013-12-26T09:30:00-05:00,51.87,52.11,51.7,52.06,6725353,8844374.05,74.2986415595225,62.12738002425173,NaN,NaN,187.07231076016103,186.48774694696814,0.14041748513591135,0.5873952267822347,0.4469777416463233,348155589,335567163.2,89.54897849694706,71.16975808619215,NaN,NaN,31.08002581804559,23.992791036606054
2013-12-27T09:30:00-05:00,52.29,52.29,51.9301,52,4157319,8863514.85,73.05116609163714,62.90706774084828,NaN,NaN,163.56342511282463,184.3082490186784,0.14282746144158842,0.6255120684483089,0.48268460700672045,343998270,340788910.8,90.39186032582579,73.2552418459035,NaN,NaN,33.34171919709196,25.328352202389755
2013-12-30T09:30:00-05:00,52.02,52.06,51.89,51.95,4944071,8762471.15,71.96677333239248,63.510671159812,NaN,NaN,127.29591568439756,172.44138907798057,0.1292593097444501,0.6442587441872831,0.514999434442833,339054199,342260650.4,90.62144539691546,75.29007684559255,NaN,NaN,34.887641664762526,26.693964982728723
2013-12-31T09:30:00-05:00,52.12,52.3,52.03,52.26,6576578,8742464.8,74.49470950012507,64.44075290960212,NaN,NaN,126.71559253824722,157.6302567624335,0.12906739275616863,0.6763336753880438,0.5472662826318752,345630777,343653814.2,90.8444654583181,77.28703093433441,NaN,NaN,36.99706663886164,28.16583664789057
2014-01-02T09:30:00-05:00,51.98,52.07,51.46,51.53,9336976,8760515.4,60.629593146100966,65.25512747261828,NaN,NaN,74.44076725866094,135.81760227085826,0.07060496008221451,0.6355224827346433,0.5649175226524288,336293801,342626527.2,89.16079821672601,79.17400052438613,NaN,NaN,34.46543310013932,29.06577899821182
2014-01-03T09:30:00-05:00,51.67,51.9,51.58,51.67,6103904,8726849.35,62.08698477854174,66.12502316010169,NaN,NaN,69.27965714687451,112.25907154820098,0.03404483892474597,0.6074735713083612,0.5734287323836152,342397705,341474950.4,87.2095714779216,80.89258879497929,NaN,NaN,32.8799579186527,29.610661701131946
2014-01-06T09:30:00-05:00,51.92,52.07,51.37,51.37,7486839,8754190.9,57.200629095753584,66.49747367470205,NaN,NaN,53.97288019543863,90.34096256472375,-0.015028162882899432,0.5546435287799909,0.5696716916628903,334910866,339657469.6,84.08206117967838,82.39388868520254,NaN,NaN,29.982756371553805,29.663818082620782
2014-01-07T09:30:00-05:00,51.64,51.81,51.5101,51.69,7068721,8687649.55,60.74914709642057,66.70228645913787,NaN,NaN,54.44364553456528,75.77050853475731,-0.029770304233210476,0.5324588113713773,0.5622291156045878,341979587,340242547.2,84.27753275700728,83.85294005591201,NaN,NaN,28.64167284842914,29.51779733487912
2014-01-08T09:30:00-05:00,51.7,51.72,51.395,51.6,8091468,8813736.25,59.26096672019648,66.82393436138719,NaN,NaN,41.48125309662078,58.72364064643201,-0.04831910955831531,0.5018302286566936,0.5501493382150089,333888119,337894015.6,80.02925242822899,84.97154704634889,NaN,NaN,27.106413620429954,29.173313947100667
2014-01-09T09:30:00-05:00,51.9,52.05,51.52,51.85,10795262,8847784.65,62.04256511355004,66.53198216134845,NaN,NaN,58.304952546063504,55.496477703912525,-0.04647336436725724,0.4920576327559374,0.5385309971231946,344683381,339571931.6,80.77489147765266,85.62696115838153,NaN,NaN,26.641439749173518,28.811617633111073
2014-01-10T09:30:00-05:00,51.94,51.97,51.5849,51.93,12522123,8912639.4,62.915164152525676,66.27143682317902,NaN,NaN,56.174874480884135,52.87552117071446,-0.042684547684648244,0.4851753125173843,0.5278598602020326,357205504,342533491.4,82.04886721131703,85.97346972371994,NaN,NaN,26.51469470605309,28.483485786388503
2014-01-13T09:30:00-05:00,51.8,52.1,51.24,51.3,12241273,9060032.15,52.65028488028496,65.18297300274062,NaN,NaN,20.018147694904286,46.08457467060758,-0.08308972205808018,0.42399770762943234,0.5070874296875125,344964231,344544164.4,82.87841597494415,86.04989557315476,NaN,NaN,23.10448257656057,27.715056756413084
2014-01-14T09:30:00-05:00,51.56,51.88,51.36,51.84,9435781,9219116.15,58.8479471966785,64.41363076315308,NaN,NaN,33.41374318645597,41.878594200985724,-0.07422068288795175,0.41431157607757285,0.4885322589655246,354400012,347028249.4,83.87013895459305,85.97365139238433,NaN,NaN,22.167686336644923,26.922575267874777
2014-01-15T09:30:00-05:00,51.97,52.32,51.92,52.21,6790124,9103202.5,62.47248774313816,63.76193288620486,NaN,NaN,111.87464163139907,55.95727190794139,-0.045612289856965194,0.43151689664431814,0.47712918650128333,361190136,352488652.8,85.81511876845545,85.82524272318082,NaN,NaN,22.606721922244077,26.306024789927534
2014-01-16T09:30:00-05:00,52.02,52.15,51.911,52.08,8180516,8945742.3,60.45765469532497,62.7732909673336,NaN,NaN,91.70289615195846,62.636860629120385,-0.03793622375046929,0.42970890681319673,0.467645130563666,353009620,354153900.6,86.3554768585945,85.5971354632985,NaN,NaN,22.311258243283717,25.735343854692704
2014-01-17T09:30:00-05:00,51.89,51.96,51.7,51.82,8662230,8311795.4,56.530755662167,61.593261650942885,NaN,NaN,28.236719421838394,57.049229617311234,-0.05199235867173563,0.4026546822239965,0.4546470408957321,344347390,351582277.8,81.21052456330901,84.94132576597586,NaN,NaN,20.822644542601296,25.033529667251074
2014-01-21T09:30:00-05:00,52.07,52.305,51.58,51.87,11033469,8184635.55,57.10773303170238,60.53190162946502,NaN,NaN,47.23906921841307,62.493413922013,-0.05903099346941432,0.3808582990589642,0.4398892925283785,355380859,353665603.4,82.13892152501917,84.33543120369757,NaN,NaN,19.803385124041448,24.28636616107827
2014-01-22T09:30:00-05:00,52.06,52.1,51.85,52.03,6348800,7811777.1,58.983876156772574,59.42398496208269,NaN,NaN,65.78488994869102,68.96764327446,-0.0541477316795132,0.372204627928987,0.4263523596085002,361729659,355131532.8,82.78354107610016,83.759650890682,NaN,NaN,19.500654458867427,23.602693060762434
2014-01-23T09:30:00-05:00,51.72,51.87,51.24,51.41,8550584,7890833.45,49.87922956487374,58.65610184913789,NaN,NaN,-117.77155482639061,23.038403982902064,-0.09170240887058251,0.3117243485202721,0.4034267573908546,353179075,353529320.6,79.41017397583053,83.06317773061802,NaN,NaN,16.313347899218876,22.561358037684784
2014-01-24T09:30:00-05:00,51.06,51.06,49.8,49.81,25688054,9036972.25,34.90533982808509,56.71455578124813,NaN,NaN,-403.074859099391,-75.91714706736784,-0.21621998802290893,0.13315177236221842,0.34937176038512735,327491021,348425600.8,69.6709803668946,81.81042122268752,NaN,NaN,6.952414542951005,20.33150896700853
2014-01-27T09:30:00-05:00,50.04,50.24,49.52,49.86,17552951,9578352.15,35.55641226478113,55.168540293321534,NaN,NaN,-333.201051110756,-148.20470117388672,-0.2829248577298148,-0.00428431177714117,0.2786405459526736,345043972,348564917.2,69.77993416190301,80.78884072141786,NaN,NaN,0.35698032331561147,17.4780048750524
2014-01-28T09:30:00-05:00,50.01,50.47,50.01,50.33,9909357,9865954.05,41.48143660143619,53.79227525796551,NaN,NaN,-196.72574614960837,-196.997664247491,-0.28244879989602306,-0.07442045391735519,0.20802834597866787,354953329,348479411.2,69.61463768883192,79.74149107369105,NaN,NaN,-2.88042520674321,14.569657720510168
2014-01-29T09:30:00-05:00,49.81,50.21,49.66,49.79,15007688,10369134.9,37.24448952487535,52.21966974401399,NaN,NaN,-187.88890757512797,-247.73242375225482,-0.30370207643622343,-0.17159924956661143,0.132102826869612,339945641,344122607.6,61.606759257395844,78.42559870434583,NaN,NaN,-7.069005994498458,11.478420046937508
2014-01-30T09:30:00-05:00,50.24,50.399,49.94,50.28,9984775,10539544.75,42.93982551130369,50.855188343853534,NaN,NaN,-121.22094433929381,-248.42230165483542,-0.27103635472226373,-0.2066926165332177,0.06434373818904605,349930416,343472875.8,60.489263142360635,76.97662525182498,NaN,NaN,-8.44740242991568,8.631873978815625
2014-01-31T09:30:00-05:00,49.44,50.38,49.44,50.03,15207928,10833092.35,40.90032931444738,49.28270014113365,NaN,NaN,-122.09810888428997,-192.22695161181522,-0.252894965144612,-0.25177496824171897,0.00111999690289305,334722488,344919169.2,62.135734425108254,75.55425862423864,NaN,NaN,-10.224386257407797,5.938122516497993
2014-02-03T09:30:00-05:00,49.91,50.23,48.62,48.64,23577949,11706794.6,31.84404045349997,47.796539824934726,NaN,NaN,-156.9145852176486,-156.96965843319373,-0.3169838851569916,-0.39510985954334643,-0.07812597438635485,311144539,338139282.6,51.33602690522887,73.30123083354468,NaN,NaN,-15.381333968566317,2.89248587577452
2014-02-04T09:30:00-05:00,48.82,49.12,48.38,48.95,14235866,12044245.95,35.28560511137832,46.11351539027043,NaN,NaN,-151.60415725259492,-147.94534065379102,-0.3200410241820562,-0.47817725461392513,-0.15813623043186892,325380405,332224697.8,44.13006957010546,70.46265444893844,NaN,NaN,-18.066068138654508,-0.10159326914391187
2014-02-05T09:30:00-05:00,48.75,49.116,48.39,48.93,15364820,12459050.9,35.162243039903586,44.162783625753676,NaN,NaN,-129.81988536844997,-136.33153621245543,-0.3050147558150535,-0.5394046752006858,-0.2343899193856323,310015585,326238686.6,38.27440926714849,67.06688948455935,NaN,NaN,-20.12836239310777,-2.9625602868530345
2014-02-06T09:30:00-05:00,49.14,49.675,49.04,49.61,13598221,12734388.55,42.52028545432691,42.88154296568239,NaN,NaN,-80.36482628405969,-128.1603126014086,-0.23407430484704894,-0.5269828004444435,-0.2929084955973945,323613806,320975364.6,34.00217499978399,63.32736792321575,NaN,NaN,-19.36192423715807,-5.3053265654680395
2014-02-07T09:30:00-05:00,49.86,50.51,49.86,50.47,15046588,12946954.85,50.21522290013533,42.43043348268013,NaN,NaN,-24.95145667661104,-108.73098215987281,-0.11978606094944577,-0.44264107178420176,-0.322855010834756,338660394,321762945.8,35.168323607835816,60.038639283539105,NaN,NaN,-15.940468856979079,-6.824632607112473
2014-02-10T09:30:00-05:00,50.52,50.54,50.04,50.15,14047348,13023216.1,47.65859269577764,41.75549488725693,NaN,NaN,-23.407850447234136,-82.0296352057899,-0.059351265469065495,-0.39704409267108787,-0.33769282720202237,324613046,324456647.2,39.12989186202051,56.966565736182055,NaN,NaN,-14.100300973510437,-7.864013802312183
2014-02-11T09:30:00-05:00,50.33,50.91,50.24,50.71,10363953,12929350.1,52.241161639588334,41.27387242174377,NaN,NaN,5.248654100203489,-50.65907293523022,0.020455957714298256,-0.31212288005914957,-0.3325788377734478,334976999,326375966,41.856144304685834,54.04318025250961,NaN,NaN,-11.0059745908512,-8.312865343532042
2014-02-12T09:30:00-05:00,50.79,51.045,50.77,51,10282577,12971689.9,54.464513740336805,41.60139271999113,NaN,NaN,32.087590078831916,-18.27757784577389,0.09094442426493365,-0.21889830744228078,-0.30984273170721444,345259576,333424764.2,50.60579366945506,51.98572451633992,NaN,NaN,-7.793938633399764,-8.238732956370288
2014-02-13T09:30:00-05:00,50.66,51.11,50.49,51.04,11396776,13202022.5,54.77723562400075,43.020813848270826,NaN,NaN,35.5012931069681,4.895646032431658,0.1357352561057502,-0.14017366157502664,-0.27590891768077686,356656352,340033273.4,57.12069267570378,51.08927539554058,NaN,NaN,-5.172436980903469,-7.800690674160743
2014-02-14T09:30:00-05:00,50.98,51.51,50.9,51.37,9132182,13249605.8,57.37788567375955,44.57949052034071,NaN,NaN,73.98908996450311,24.683755360654487,0.18026905333997822,-0.050572601005804074,-0.2308416543457823,365788534,345458901.4,61.59892163901088,50.50491735819114,NaN,NaN,-2.181567923579447,-6.997958852649129
2014-02-18T09:30:00-05:00,51.52,51.62,51.15,51.33,7282125,13180600.55,56.95036994808675,45.684414330815756,NaN,NaN,88.38497230953857,47.042319912009035,0.19828380577296906,0.01701310287042901,-0.18127070290254005,358506409,352237574,66.33019902705115,50.270314596635366,NaN,NaN,0.11390317064542067,-5.981978563607051
2014-02-19T09:30:00-05:00,51.27,51.57,50.82,50.85,10442911,13151072.65,51.9483518750894,46.73469021297391,NaN,NaN,71.23131512612235,60.2388521171928,0.17020087061150294,0.031480385361838614,-0.13872048524966432,348063498,354854873.8,67.97105736779926,50.724907318807034,NaN,NaN,0.6773407310379919,-5.0306472358006165
2014-02-20T09:30:00-05:00,51.03,51.5,50.78,51.33,15387417,13603003.5,56.10067579369116,47.67475094743015,NaN,NaN,93.30885774859664,72.48310565114573,0.17557398684518877,0.08074699830682164,-0.09482698853836713,363450915,358493141.6,70.14885447030417,51.41487812794586,NaN,NaN,2.411737387798619,-3.967449432429297
2014-02-21T09:30:00-05:00,51.53,51.63,51.32,51.39,6108436,13480896.1,56.60546800137908,48.79654656792526,NaN,NaN,119.4512332518718,89.27309368012648,0.17443145287590633,0.12321232755651579,-0.051219125319390546,369559351,361073741.4,71.62271483018324,52.092519585451214,NaN,NaN,3.967042224138304,-2.833950624348211
2014-02-24T09:30:00-05:00,51.58,52.2274,51.5,51.78,9311544,12662070.6,59.83817461101265,50.79612757917617,NaN,NaN,134.49686747907654,101.37464918304117,0.189927193602016,0.18618986668312942,-0.0037373269188865493,378870895,363690213.6,73.07429989115207,53.64525337016001,NaN,NaN,6.25859385373682,-1.5350156989074923
2014-02-25T09:30:00-05:00,51.71,51.9,51.47,51.61,7522052,12160525.65,57.816316389828344,52.40546409906546,NaN,NaN,104.41501103753006,104.58065692863947,0.17886839600545756,0.2198481680879354,0.04097977208247784,371348843,366258700.4,74.4556760476719,55.81136811855762,NaN,NaN,7.613143753552907,-0.22813577712743527
2014-02-26T09:30:00-05:00,51.72,51.867,51.46,51.66,10607330,12195424.3,58.262999328065156,54.055518119648426,NaN,NaN,93.26941643138868,108.98827718969274,0.16537765746298463,0.24770184391120864,0.08232418644822401,381956173,373037235.4,77.70632325949776,58.62793340372542,NaN,NaN,8.856665248770899,1.069692940858041
2014-02-27T09:30:00-05:00,51.59,51.96,51.51,51.96,5723618,11731220.8,60.93581820203347,55.370913315913185,NaN,NaN,95.96260196364929,109.51902603270325,0.16664731907752198,0.29063333529512647,0.1239860162176045,387679791,377883010.6,79.69552693167006,61.891744256003,NaN,NaN,10.679371316559111,2.4425041373867655
2014-02-28T09:30:00-05:00,51.98,52.34,51.8,52.06,12876651,11875814.6,61.81366691774237,56.19937360288511,NaN,NaN,105.2364802064382,106.67607542361654,0.16395860008115834,0.3289342663190524,0.1649756662378941,400556442,384082428.8,81.9183639947323,65.23103285506703,NaN,NaN,12.453462571731567,3.87264105657888
2014-03-03T09:30:00-05:00,51.5,51.88,51.33,51.71,17327448,11981790.6,56.986773164757814,56.86567220781227,NaN,NaN,66.53995601261535,93.0846931303243,0.12983814836418844,0.32727335169312965,0.1974352033289412,383228994,384954048.6,82.21319602401962,68.30841172378125,NaN,NaN,12.721443918126447,5.136755751085675
2014-03-04T09:30:00-05:00,52.19,52.7167,52.12,52.46,12360939,11420940.1,63.55437142474889,57.67375862103802,NaN,NaN,125.10908983737843,97.22350889029397,0.1477090487679295,0.3820715142888531,0.2343624655209236,395589933,389802266.6,83.795906295837,71.30410900886348,NaN,NaN,14.94223622810342,6.5375386763739245
2014-03-05T09:30:00-05:00,52.57,52.71,52.46,52.53,11014864,11259890,64.105251331116,58.36238273466511,NaN,NaN,133.69435596317365,105.30849679665096,0.15349762911501474,0.42623450191469203,0.2727368727996773,406604797,394731991.4,85.23461688919525,73.77759638170207,NaN,NaN,16.913223787212306,8.019779406493694
2014-03-06T09:30:00-05:00,52.79,52.95,52.67,52.83,9427211,10963009.55,66.44604484050768,59.19586910727275,NaN,NaN,153.48835941041324,116.81364828600377,0.16573800890898183,0.47990938393590454,0.3141713750269227,416032008,400402434.8,86.69765588309208,75.89023661080124,NaN,NaN,19.291705915505666,9.630054622066833
2014-03-07T09:30:00-05:00,53.18,53.25,52.87,53,12752095,10920703.25,67.73026629011574,59.9353248655839,NaN,NaN,163.50703268088364,128.46775878089284,0.17270654392511392,0.5300545549333151,0.3573480110082012,428784103,406047967,87.97516194614894,77.7742537755968,NaN,NaN,21.66075407152035,11.348725971988763
2014-03-10T09:30:00-04:00,52.85,52.92,52.435,52.77,8201031,10578425.4,64.15280106351219,60.44978423097144,NaN,NaN,116.72364191605797,138.50449596158137,0.1500847879709833,0.5449539959719303,0.394869208000947,420583072,413518782.6,89.42278043963665,79.42372387649577,NaN,NaN,22.68911654370871,12.968781767948755
2014-03-11T09:30:00-04:00,52.98,52.98,52.255,52.39,9575555,10354835.75,58.64168540167231,60.92787948287022,NaN,NaN,87.55182106904529,130.99304220791473,0.10018755756021924,0.520103654951221,0.4199160973910018,411007517,416602299.4,89.96002321082403,80.99436429385469,NaN,NaN,22.000926089270255,14.259088099566112
2014-03-12T09:30:00-04:00,52.08,52.3,51.895,52.29,12433201,10458298.15,57.247935597779005,61.00982661173364,NaN,NaN,37.15572197997335,111.68531541127467,0.053450881602595424,0.48672969939424604,0.4332788177916506,398574316,414996203.2,87.46796600409112,82.23144368912517,NaN,NaN,21.035242059434225,15.227110093832986
2014-03-13T09:30:00-04:00,52.499,52.6199,51.33,51.55,17725449,10830441.75,48.13151576221833,60.404544308936444,NaN,NaN,-8.74747356585777,79.23814881602047,-0.029819936486005116,0.3960038971841442,0.4258238336701493,380848867,407959575,77.35714102476324,82.6410455601666,NaN,NaN,17.280942570493885,15.520514733355972
2014-03-14T09:30:00-04:00,51.47,51.735,51.27,51.35,17127544,11116980.15,45.99945239620193,59.41606415073568,NaN,NaN,-64.96250898446347,33.544240482951075,-0.09709494906689864,0.304455147336526,0.40155009640342465,363721323,394947019,62.881355209043136,81.91297808287311,NaN,NaN,13.515376046918764,15.234066349579228
2014-03-17T09:30:00-04:00,51.56,52.16,51.56,51.98,11471818,11233961.95,53.053932674549685,59.07589388535863,NaN,NaN,-8.782317661042953,8.44304856753089,-0.09762747332176114,0.27951575475122326,0.3771432280729844,375193141,385869032.8,55.13056829547808,80.53261324343069,NaN,NaN,12.350093697820704,14.822070256470868
2014-03-18T09:30:00-04:00,52.07,52.38,52.0601,52.26,7434230,11241567.2,55.816597404303586,58.90115089080423,NaN,NaN,33.704214947616016,-2.3264726567549716,-0.07841285268582088,0.2791271622157083,0.3575400149015292,382627371,380193003.6,50.90554792793575,78.61827214831912,NaN,NaN,12.248438287249522,14.454408546582105
2014-03-19T09:30:00-04:00,52.26,52.35,51.43,51.72,13222681,11380555.7,49.737571995956145,58.10127616179871,NaN,NaN,-33.24920933925847,-16.40745892060133,-0.09998013194040006,0.2325648499760291,0.33254498191642917,369404690,374359078.4,46.925011149570146,76.27752102102626,NaN,NaN,10.18532244903043,13.844539104074723
2014-03-20T09:30:00-04:00,51.72,51.92,51.48,51.87,11205786,11171474.15,51.32345989137553,57.35197565991536,NaN,NaN,-52.968366290747085,-25.251637465579194,-0.10171606057412086,0.20539990619877813,0.307115966772899,380610476,374311400.2,46.89273915524186,73.77569067534839,NaN,NaN,9.011239347074564,13.154067710217557
2014-03-21T09:30:00-04:00,51.96,52.12,51.61,51.65,13683373,11550221,48.887110902977895,56.77342835550251,NaN,NaN,-51.510631037435886,-22.561261876173678,-0.11431178672377296,0.16422623336818276,0.2785380200919557,366927103,374952556.2,47.41645990867295,71.29020952425219,NaN,NaN,7.295460101726733,12.31712376614744
2014-03-24T09:30:00-04:00,51.89,51.93,51.19,51.48,14063059,11787796.75,47.02929381467399,55.59306566906859,NaN,NaN,-91.52458195722133,-39.109714735409355,-0.12960251191322944,0.11653488020041891,0.24613739211364835,352864044,370486736.8,44.15055050242865,68.4583983961516,NaN,NaN,5.321914434751157,11.317808147376542
2014-03-25T09:30:00-04:00,51.75,52.09,51.679,51.95,11722296,11997808.95,52.413547686861605,54.757943980193275,NaN,NaN,-31.0271575850903,-52.05598924195061,-0.10464215002503116,0.11533470458235939,0.21997685460739055,364586340,366878530.6,41.65418309153929,65.3455102677476,NaN,NaN,5.217475305687747,10.446332027135286
2014-03-26T09:30:00-04:00,52.28,52.28,51.42,51.42,9906839,11962784.4,46.65455516956175,53.34426614655428,NaN,NaN,-66.5168587849111,-58.70951913108114,-0.11934081315574366,0.07080083816271099,0.19014165131845465,354679501,363933492.8,39.681987404992896,61.98724823359766,NaN,NaN,3.301424122492306,9.425630897900575
2014-03-27T09:30:00-04:00,51.42,51.5,51.02,51.35,9377903,12145498.65,45.93664666136013,51.7875790302146,NaN,NaN,-127.73279041848231,-73.6624039566282,-0.12849832942613856,0.029518739535781435,0.15801706896192,345301598,356871717.2,35.358865979632114,58.22894137884646,NaN,NaN,1.5479557422293475,8.300248732804686
2014-03-28T09:30:00-04:00,51.46,51.94,51.45,51.73,8982574,11950794.8,50.39873383049626,50.80514565642775,NaN,NaN,-53.83673944723918,-74.12762563858885,-0.10469188765612375,0.027152209391765325,0.13184409704788908,354284172,354343131,33.933327321522285,54.265409013266854,NaN,NaN,1.3898004099353303,7.313041829537635
2014-03-31T09:30:00-04:00,52,52.42,52,52.33,7563055,11462575.15,56.50316331710366,50.65239407895856,NaN,NaN,28.8160309686262,-50.059503053419334,-0.047193748591388515,0.07285191130865343,0.12004565990004194,361847227,356139767.6,35.91045635171075,50.40472566618734,NaN,NaN,3.2092721481653075,6.726789017913017
2014-04-01T09:30:00-04:00,52.55,52.87,52.355,52.7,13773829,11533219.65,59.78960419408393,50.83394183583748,NaN,NaN,88.4202854924906,-26.170014437903156,0.013837047581382544,0.13734196937677012,0.12350492179538758,375621056,358346710.8,38.3510412538599,46.89637389831368,NaN,NaN,5.797199755537136,6.59399055185932
2014-04-02T09:30:00-04:00,52.74,53.11,52.72,53.07,12813038,11623128.35,62.81524750496149,51.882779817461994,NaN,NaN,129.94775591322446,13.122908501723959,0.07385117217615939,0.21581888701558682,0.14196771483942744,388434094,365097629.4,45.2227306219717,44.601058869542854,NaN,NaN,8.947582408419215,6.930217959939305
2014-04-03T09:30:00-04:00,53.15,53.18,52.9,53.15,9268322,11615183.9,63.45553342767676,53.129642748281626,NaN,NaN,140.02975322327183,66.67541723007479,0.11140658287508559,0.28122594343328444,0.16981936055819885,397702416,375577793,53.82702908925989,43.954321289558344,NaN,NaN,11.66914704270694,7.60720782890611
2014-04-04T09:30:00-04:00,53.4,53.488,52.405,52.54,14930636,11724110.95,55.59472557496046,53.31112795545382,NaN,NaN,105.86966330333054,98.61669778018873,0.08862848394367825,0.2806049654877967,0.19197648154411842,382771780,381275314.6,57.71566427558831,44.13897100242336,NaN,NaN,11.614282229670321,8.179647029015284
2014-04-07T09:30:00-04:00,52.4,52.57,51.68,51.79,12402825,11934200.65,47.760707880654515,52.73570727519318,NaN,NaN,-9.22921740443263,91.00764810557698,0.020092100438226873,0.217091607091902,0.19699950665367513,370368955,382979660.2,58.83257748148435,44.7051873991054,NaN,NaN,8.914322039934644,8.284600602003763
2014-04-08T09:30:00-04:00,51.71,51.965,51.46,51.79,9462353,11928540.55,47.760707880654515,52.594502695528774,NaN,NaN,-49.515504697916874,63.420490067495464,-0.025714444976460776,0.16485645043309916,0.19057089540955993,370368955,381929240,57.8188999447651,45.48332231304789,NaN,NaN,6.822751926451877,8.075765076924922
2014-04-09T09:30:00-04:00,52.07,52.49,51.85,52.45,11329140,11873337.5,54.32888176173271,52.809175686268574,NaN,NaN,38.049077553887855,45.04075439562814,-0.012694846882370547,0.17470233680659675,0.1873971836889673,381698095,380582040.2,56.47492480113291,46.167764144897255,NaN,NaN,7.115696445324376,7.938612415267701
2014-04-10T09:30:00-04:00,52.37,52.57,51.41,51.41,11633998,11568764.95,44.77541376490678,52.515483033549216,NaN,NaN,-39.38010654756219,9.158782441461337,-0.0719477649007973,0.09746247756297066,0.16941024246376796,370064097,375054376.4,51.214633710483646,46.439062273598026,NaN,NaN,3.9604894498391543,7.370309134492194
2014-04-11T09:30:00-04:00,51.26,51.48,50.89,50.9,11243045,11274540,40.97067433504991,52.08272449929035,NaN,NaN,-149.1884089397317,-41.85283200715111,-0.13940621466081118,-0.004847525862246016,0.13455868879856517,358821052,370264230.8,47.11881910175922,46.65108145926449,NaN,NaN,0.04346036118133218,6.323616452590643
2014-04-14T09:30:00-04:00,51.24,51.47,50.78,51.19,6844885,11043193.35,43.89035489570464,51.473925014207715,NaN,NaN,-124.93704550613569,-64.99439762749172,-0.15709958332633545,-0.06181579035935414,0.0952837929669813,365665937,369323627.2,46.33520913185981,46.98544046214453,NaN,NaN,-2.0745049875325074,5.123884818287335
2014-04-15T09:30:00-04:00,51.28,51.62,50.74,51.55,14535099,11398236.8,47.37041427340615,51.52505780733946,NaN,NaN,-92.9291733270154,-73.67713135331142,-0.1378483494537023,-0.07702664385014657,0.06082170560355573,380201036,371290043.4,48.27200861469071,47.59901340569437,NaN,NaN,-2.647419627108096,4.0136984689451305
2014-04-16T09:30:00-04:00,51.71,52.35,51.705,52.34,9096005,11191903,54.09841579225198,52.108041316688876,NaN,NaN,26.976926767570937,-75.8915615105748,-0.06869435622294084,-0.02504623967512032,0.04364811654782052,389297041,372809832.6,49.78055855230693,48.62913430374257,NaN,NaN,-0.8243778862996352,3.322544703910164
2014-04-17T09:30:00-04:00,52.45,52.9,52.36,52.75,12903848,11276806.1,57.15934759766806,52.5909423000583,NaN,NaN,92.30671516438815,-49.554197168184736,0.0040184092822307255,0.04867112815060892,0.0446527188683782,402200889,379237191,55.66870186670063,50.18166105696959,NaN,NaN,1.6923182752761767,3.0896552141053086
2014-04-21T09:30:00-04:00,52.84,52.95,52.57,52.9,9675100,11076392.45,58.256106132393654,52.71615250115043,NaN,NaN,97.30998470943787,-0.2545184383508257,0.05854826962401426,0.11783805589839602,0.059289786274381764,411875989,389848178.4,63.31575406799399,52.13918232241839,NaN,NaN,4.034984369367294,3.224702236285592
2014-04-22T09:30:00-04:00,53.06,53.24,52.91,52.93,11155833,10931031.15,58.485021234923714,52.622968004067566,NaN,NaN,110.78900088310084,46.890690839496486,0.09103132887766668,0.17307894737146512,0.08204761849379844,423031822,401321355.4,69.45172008483642,54.360659381773864,NaN,NaN,5.962289236520642,3.615786093462028
2014-04-23T09:30:00-04:00,52.95,53.24,52.91,53.13,8964977,10793165.2,60.05758837185328,52.42599235170269,NaN,NaN,104.64125389941778,86.40477628478313,0.11863458872175356,0.2303408543959904,0.11170626567423683,431996799,411680508,73.7250842337751,56.396541782616964,NaN,NaN,8.02646107751764,4.245882519755686
2014-04-24T09:30:00-04:00,53.39,53.39,52.79,53.03,11864236,10891035.05,58.85710009406688,52.097532827873415,NaN,NaN,91.93673849398746,99.39673863006642,0.1223165849697973,0.26460199688648345,0.14228541191668614,420132563,417847612.4,75.88762765067034,57.97229882271771,NaN,NaN,9.398353667243601,4.981949826539674
2014-04-25T09:30:00-04:00,52.79,52.95,52.38,52.51,6997511,10772015.45,52.93199172811245,51.90733755309856,NaN,NaN,35.5837842076428,88.05215243871736,0.08372997725752121,0.24694788348858765,0.16321790623106644,413135052,420034445,76.62238284918018,59.322778720831415,NaN,NaN,8.904374658565109,5.542296231114737
2014-04-28T09:30:00-04:00,52.72,52.89,52.01,52.54,12105386,10928156.05,53.224553764997715,52.29761225912307,NaN,NaN,16.079890282263666,71.80613355328252,0.05558187874419371,0.23269525466130858,0.17711337591711487,425240438,422707334.8,77.52389977226694,60.65787317017303,NaN,NaN,8.581624452972557,5.976485977094425
2014-04-29T09:30:00-04:00,52.7,52.74,52.31,52.68,9382821,11019144.35,54.64146496668354,52.78909490812514,NaN,NaN,25.826943961334003,54.81372216892915,0.04234526608105521,0.23004495851843387,0.18769969243737866,434623259,425025622.2,78.30534283063072,62.12119051916344,NaN,NaN,8.691848955829942,6.3643949740566415
2014-04-30T09:30:00-04:00,52.69,53.0999,52.58,53.03,13299643,10995435.05,58.06173100004424,53.05572699657597,NaN,NaN,63.01908211341658,46.48928781172891,0.05245396494834592,0.2532671486228111,0.20081318367446516,447922902,428210842.8,79.36679399131336,63.75632403274775,NaN,NaN,9.737173697495523,6.846220505976482
2014-05-01T09:30:00-04:00,52.98,53.16,52.71,52.9,10600362,10884801.25,56.36174520839029,53.88332209968193,NaN,NaN,65.8927203804151,41.28048418901443,0.04591310628166875,0.2582045665265511,0.21229146024488235,437322540,431648838.2,80.47709836278057,65.8465000793404,NaN,NaN,10.16191061400671,7.319890521409372
2014-05-02T09:30:00-04:00,52.9,53.17,52.81,52.82,8701119,10856441.1,55.28893025696199,54.90605466553279,NaN,NaN,68.67403691784779,47.89853473105542,0.03236574806219489,0.252748645322626,0.2203828972604311,428621421,434746112,81.44577143807263,68.29842524621992,NaN,NaN,10.238246045525543,7.736798453425967
2014-05-05T09:30:00-04:00,52.67,52.995,52.4,52.93,5358642,10377841.4,56.514593881156586,55.8077860216365,NaN,NaN,49.737745654812365,54.630105805565165,0.027188614603895933,0.254368665515301,0.22718005091140508,433980063,436494037,81.98889798036633,70.84511730682753,NaN,NaN,10.620429734125878,8.14874577924024
2014-05-06T09:30:00-04:00,52.85,52.86,52.48,52.53,6032293,10059314.8,51.03582061291811,56.06960076017307,NaN,NaN,28.2181365950413,55.10834433230663,-0.005079807140985493,0.22083029198517323,0.22591009912615873,427947770,435158939.2,80.06112979390204,73.11576881962834,NaN,NaN,9.480681839836274,8.339022359325387
2014-05-07T09:30:00-04:00,52.6,53,52.382,52.98,7958968,9984145.55,56.182292182382604,56.21844907375383,NaN,NaN,45.13268581947528,51.53106507351837,0.0016196326035028685,0.2279346398805373,0.22631500727703444,435906738,432755706.4,76.57107727062476,75.02937729950818,NaN,NaN,9.906972033527762,8.563015169925727
2014-05-08T09:30:00-04:00,52.91,53.31,52.805,52.97,8034226,9819399.85,56.04132705828295,56.138590463797755,NaN,NaN,72.12924250822807,52.778369499080966,0.0030323604684519556,0.2301054578625994,0.22707309739414744,427872512,430865700.8,73.84472689204249,76.3276648013183,NaN,NaN,10.21877878960537,8.799552829879962
2014-05-09T09:30:00-04:00,52.88,53.04,52.65,53.01,5133447,9494372.3,56.511364742293544,56.0139660787906,NaN,NaN,51.92852413687745,49.4292669428869,0.004241394046823166,0.23237483995267638,0.22813344590585322,433005959,431742608.4,74.30191311126859,77.1123904472665,NaN,NaN,10.603747985664828,9.057294994992086
2014-05-12T09:30:00-04:00,53.19,53.82,53.17,53.8,11274962,9495968.15,64.56923722196667,56.44855293500796,NaN,NaN,162.1944682902431,71.92061146997304,0.05311295732283913,0.29452464255940214,0.241411685236563,444280921,433802780,75.39027872560082,77.5365732073211,NaN,NaN,13.407372330202005,9.678734614307789
2014-05-13T09:30:00-04:00,53.88,54.07,53.8,53.89,8650522,9586250,65.356760161599,56.82706520570407,NaN,NaN,223.68668554386346,111.01432125973747,0.08450312288758882,0.34704058884604905,0.2625374659584602,452931443,438799514.6,77.84149710179697,77.83060269789408,NaN,NaN,15.941981390683315,10.573484153790007
2014-05-14T09:30:00-04:00,53.92,53.94,53.39,53.49,6946883,9206839.2,59.07228980795517,56.842435899553244,NaN,NaN,157.7091743452793,133.52961896489828,0.07182750770822899,0.35232185059374643,0.28049434288551744,445984560,440815079,78.76049553021795,78.03580754643319,NaN,NaN,16.319750408541495,11.39437933304022
2014-05-15T09:30:00-04:00,53.26,53.36,52.67,53.02,13024468,9403262.35,52.66436287587859,56.82331955296511,NaN,NaN,12.511713418494057,121.60611314695147,0.02756584566115583,0.31495164996196223,0.2873858043008064,432960092,441832595,79.22883890330351,78.22198297887057,NaN,NaN,14.659720366235273,11.860856623496657
2014-05-16T09:30:00-04:00,53.01,53.09,52.78,53.09,7490309,9132585.4,53.47386059309988,56.84112718354383,NaN,NaN,0.8823096470455559,111.3968702489851,0.00022564114752687825,0.28766785573521503,0.28744221458768815,440450401,443321483.4,79.92635125470746,78.39358665618776,NaN,NaN,13.553090522955058,12.102604323419285
2014-05-19T09:30:00-04:00,52.97,53.335,52.85,53.3,4646822,8881171.5,55.90984745102133,56.931725932425095,NaN,NaN,42.64379959261074,87.48673650945862,-0.0061413442564426934,0.2797655342671348,0.2859068785235775,445097223,443484743.8,80.00563826947881,78.51503633039121,NaN,NaN,13.324581453219258,12.277172484819282
2014-05-20T09:30:00-04:00,53.3,53.3,52.41,52.59,9782305,8812495.1,46.958024593080296,56.13860404621339,NaN,NaN,-57.0357988505985,31.34223963056624,-0.05772720769185846,0.2137478689087544,0.2714750766006129,435314918,439961438.8,73.27884006421132,78.08018247845534,NaN,NaN,10.228308393542443,11.984477614636877
2014-05-21T09:30:00-04:00,52.74,53.13,52.74,53.11,7658892,8747190.85,52.905383105352556,55.891721038853554,NaN,NaN,2.690488305423614,0.3385024225950958,-0.05632387316018439,0.20107023515038236,0.25739410831056675,442973810,439359288.8,72.16214050113493,77.48625691690923,NaN,NaN,9.497293625921136,11.629165616248914
2014-05-22T09:30:00-04:00,53.21,53.37,52.99,53.21,4482121,8378085.1,53.974161048175034,55.79780895251162,NaN,NaN,51.50078705437424,8.136317149771125,-0.0484565463324908,0.19682342539495323,0.24527997172744403,447455931,442258456.6,74.20068101636764,76.96875045821601,NaN,NaN,9.250922060499814,11.289416536856185
2014-05-23T09:30:00-04:00,53.29,53.58,53.21,53.55,3740661,8215242.6,57.5052983068065,55.86857355434376,NaN,NaN,101.30033991278371,28.21992320291876,-0.021523451047354092,0.21837565791825142,0.2398991089656055,451196592,444407694.8,75.62567176828739,76.51423430021036,NaN,NaN,10.152769964681761,11.127038455116981
2014-05-27T09:30:00-04:00,53.71,53.91,53.68,53.83,6703159,7945131.25,60.212515887670016,56.52405178825462,NaN,NaN,155.16813121669574,50.724789527735766,0.012167817651541846,0.2551088810300328,0.24294106337849097,457899751,446968200.4,77.23864714441412,76.31262839667552,NaN,NaN,11.754036262008622,11.216609570387215
2014-05-28T09:30:00-04:00,53.94,54.09,53.85,53.87,10310279,7991504.15,60.598692223045134,56.83950893401623,NaN,NaN,153.6559893028977,92.863147158435,0.03298485430725362,0.284172131262558,0.2511872769553044,468210030,453547222.8,80.76144586837162,76.61194043937174,NaN,NaN,13.155198719914177,11.493550877462495
2014-05-29T09:30:00-04:00,54,54.09,53.755,54.09,4218436,7537443.8,62.740700931838624,57.31803563927021,NaN,NaN,134.67153716117113,119.25935692958451,0.05605330860568242,0.32125391271240744,0.265200604106725,472428466,459438154,83.25981838224426,77.28444697438613,NaN,NaN,14.973084861933375,11.990627160958335
2014-05-30T09:30:00-04:00,54.05,54.12,53.8849,54.05,6163138,7315582.6,62.07988050134736,57.715786764916906,NaN,NaN,120.46858645943226,133.05291681059612,0.06260327195088755,0.34345469404533446,0.2808514220944469,466265328,463200033.4,84.63227882874281,78.02233023992001,NaN,NaN,16.282031282549298,12.603684892614186
2014-06-02T09:30:00-04:00,54.08,54.36,53.87,54.28,7070857,7234069.5,64.40163690358911,57.70381531360422,NaN,NaN,124.72008525374571,137.7368658787885,0.07554448899176391,0.3752820333341518,0.29973754434238786,473336185,467627952,86.07901421747707,78.78581134648259,NaN,NaN,18.072116852415846,13.384889458300139
2014-06-03T09:30:00-04:00,54.14,54.32,54.01,54.22,4006980,7166486.4,63.31259358009048,57.55780341492504,NaN,NaN,112.56278375603948,129.21579638665725,0.07313391636967925,0.3911549398044869,0.31802102343480765,469329205,469913842.8,86.77137865503309,79.4236600288566,NaN,NaN,19.27407460206908,14.226201621695703
2014-06-04T09:30:00-04:00,54.1,54.26,54.06,54.21,3792144,7054478.95,63.12101117045593,57.8469977979608,NaN,NaN,101.38036192907259,118.76067091189225,0.06425170180258,0.39833565068803267,0.3340839488854527,465537061,469379249,85.69791305888836,79.91918985233306,NaN,NaN,20.227973314744734,15.083597577845564
2014-06-05T09:30:00-04:00,54.32,54.84,54.24,54.76,5805604,6946810.75,68.72623618561373,58.994274462941895,NaN,NaN,147.82463153921893,121.39128978750179,0.08737025691835704,0.44329677003339896,0.3559265131150419,471342665,469162088.8,85.23661795999126,80.34831692781076,NaN,NaN,22.759601140293036,16.18016951533806
2014-06-06T09:30:00-04:00,54.85,55.31,54.83,55.31,8384341,6964316.5,73.12514413243095,60.397937572894115,NaN,NaN,190.38908274447894,135.3753890445111,0.12913522716395553,0.5173455470699864,0.38821031990603083,479727006,471854424.4,86.22650660758347,80.79832802444476,NaN,NaN,26.474371381950473,17.650769781996978
2014-06-09T09:30:00-04:00,55.29,55.82,55.22,55.59,11160310,7265659.65,75.04924748208711,61.76503757511309,NaN,NaN,207.49595012027555,151.93056201781707,0.16287292588336771,0.5918014772602405,0.42892855137687275,490887316,475364650.6,87.4116225355741,81.32732690059443,NaN,NaN,30.2259271045354,19.447220828073895
2014-06-10T09:30:00-04:00,55.46,55.57,55.23,55.46,3846763,6894249.7,72.45552351599054,63.586287498178116,NaN,NaN,163.95628450174692,162.20926216695858,0.16327423789935358,0.6330213487510647,0.46974711085171117,487040553,478906920.2,88.48807730560694,82.41370098926554,NaN,NaN,32.53145785378277,21.316397546032306
2014-06-11T09:30:00-04:00,55.28,55.28,54.95,55.05,5541534,6738800.3,64.84398738249014,64.43904494654508,NaN,NaN,112.18669028662646,164.37052783846934,0.1245188302396476,0.6253956486512706,0.500876818411623,481499019,482099311.8,89.37027757189023,83.64285363717661,NaN,NaN,32.196808052614976,22.870741904115544
2014-06-12T09:30:00-04:00,54.98,54.98,54.21,54.31,10181692,6900540.75,53.848657966266785,64.43008044069448,NaN,NaN,48.32973049457668,144.4715476295409,0.04190873912722548,0.5532627423206549,0.5113540031934294,471317327,482094244.2,89.35857109028842,84.72556007102811,NaN,NaN,28.11258972359055,23.61957730689769
2014-06-13T09:30:00-04:00,54.35,54.64,54.27,54.5,6885595,6593597.1,55.91560788420122,64.31653112479411,NaN,NaN,39.86709320949929,114.36714972254497,-0.004603151627461721,0.5056000636591023,0.510203215286564,478202922,481789427.4,88.60673826131014,85.65277910624401,NaN,NaN,25.507145871985347,23.88922995905307
2014-06-16T09:30:00-04:00,54.49,54.57,54.25,54.44,6861412,6562152.25,55.07673503279808,63.9496896351604,NaN,NaN,29.448879141619813,78.75773552681383,-0.041995084006388794,0.457709360278578,0.4997044442849668,471341510,477880266.2,79.38233458055053,85.8058996373966,NaN,NaN,23.17913026781447,23.78778714601898
2014-06-17T09:30:00-04:00,54.41,54.69,54.25,54.59,9600569,6809839.6,56.82079889600307,63.67984011180025,NaN,NaN,33.72404856042162,52.711288338548755,-0.05821323158290376,0.4269379048063371,0.48515113638924084,480942079,476660571.4,76.69936591716656,85.51575106945339,NaN,NaN,21.77624501893934,23.500423985007604
2014-06-18T09:30:00-04:00,54.77,54.96,54.37,54.9,12209876,6931218.15,60.25502159503804,63.502291587743066,NaN,NaN,53.665761021059275,41.00710248543532,-0.049966373013540566,0.4226931701223151,0.4726595431358557,493151955,478991158.6,78.21452304634073,85.15537283117456,NaN,NaN,21.60182446552766,23.229195482224753
2014-06-19T09:30:00-04:00,54.95,55.06,54.75,55.04,7149005,6905723.8,61.73516804294389,63.47766926928568,NaN,NaN,73.59421758898975,46.059999904317955,-0.037552755889113,0.42571859827446445,0.46327135416357745,500300960,484787885.2,81.44618103638162,84.92779441743448,NaN,NaN,21.893053741254004,23.038318090657505
2014-06-20T09:30:00-04:00,54.9,55.05,54.84,55.02,4304736,6896854.55,61.383477609854836,63.262086462590375,NaN,NaN,69.68903689222553,52.02438864086319,-0.03330347343210471,0.42164201237344656,0.4549454858055513,495996224,488346545.6,83.10328240898863,84.71524214539959,NaN,NaN,22.03189870192165,22.894543892266668
2014-06-23T09:30:00-04:00,55.16,55.16,54.6,54.7,5192365,6969439.75,55.89668392606133,62.732378630159715,NaN,NaN,39.664134539408764,54.06743972042098,-0.053463585975935146,0.38811600333563234,0.4415795893115675,490803859,492239015.4,84.71169843775333,84.56812212987961,NaN,NaN,20.56887565045808,22.5623055720083
2014-06-24T09:30:00-04:00,54.61,54.82,54.09,54.15,7429915,7005777.55,47.96149537457242,61.649556073310904,NaN,NaN,-42.397337337992184,38.84316254073822,-0.10242241635622945,0.31355156886628066,0.4159739852225101,483373944,492725388.4,84.90505392546625,84.51148933463517,NaN,NaN,16.729572304350828,21.729057962342946
2014-06-25T09:30:00-04:00,53.99,54.305,53.97,54.2,6506429,6815585.05,48.67483047954715,60.21731280859186,NaN,NaN,-79.71828960962466,12.16635241460143,-0.1283411826679719,0.25554750688754524,0.38388868955551714,489880373,492071072,83.37731826705388,84.37868221371109,NaN,NaN,13.844621908654808,20.602709954673212
2014-06-26T09:30:00-04:00,54.26,54.31,53.79,54.16,6845356,6946931.05,48.10669878920437,58.4302809983614,NaN,NaN,-94.36973853722219,-21.426438810640956,-0.14391125285051043,0.2039996234923791,0.34791087634288953,483035017,488617883.4,75.64173070314689,83.62262679196563,NaN,NaN,11.321964732060234,19.276889208585644
2014-06-27T09:30:00-04:00,53.98,54.48,53.78,54.29,8214586,7049503.45,50.143435811759836,56.651294450480876,NaN,NaN,-80.06092411629513,-51.37643101234509,-0.14100174627502826,0.17165869349910423,0.3126604397741325,491249603,487668559.2,73.61956124942773,82.63747955724088,NaN,NaN,9.74190521444193,17.914748637993686
2014-06-30T09:30:00-04:00,54.27,54.3,54.01,54.06,7976659,7094793.55,46.654549441077535,54.80836773084423,NaN,NaN,-90.04021125914943,-77.31730017205673,-0.14931510761181077,0.12601655525936906,0.2753316628711798,483272944,486162376.2,70.40368482642978,81.34573723729964,NaN,NaN,7.372898541271058,16.408770052747595
2014-07-01T09:30:00-04:00,54.12,54.59,54.12,54.39,8026210,7295755.05,51.832927733750495,53.87900632736283,NaN,NaN,-48.84582414890384,-78.60699753423906,-0.12814873392298276,0.11514574546745138,0.24329447939043414,491299154,487747418.2,71.79975339497878,80.09069979609168,NaN,NaN,6.7655270550710345,15.031163910222372
2014-07-02T09:30:00-04:00,54.24,54.46,54.2,54.3,10074506,7609873.15,50.39609399857578,53.632394615384904,NaN,NaN,-59.67711832773122,-74.59876327786037,-0.11612595163900785,0.09813703984167432,0.21426299148068217,481224648,486016273.2,68.02560581258007,78.56691656196965,NaN,NaN,5.853369140536813,13.720050371695864
2014-07-03T09:30:00-04:00,54.53,54.809,54.52,54.75,8550342,7747110.05,56.83855037033254,53.69831907868,NaN,NaN,9.150399633494317,-53.894735643717055,-0.0757382364256344,0.11959019594863918,0.19532843237427358,489774990,487364267.8,69.37551368118713,77.19325766338945,NaN,NaN,6.974843090601814,12.75644933153957
2014-07-07T09:30:00-04:00,54.74,54.74,54.29,54.36,9334314,7794608.7,50.69350988311339,53.385231567988235,NaN,NaN,-29.000469884377434,-43.68264479733352,-0.07312333638695806,0.10392426189057602,0.17704759827753408,480440676,485202482.4,64.6608337514948,76.14172188988547,NaN,NaN,6.040296051756106,11.796998862999075
2014-07-08T09:30:00-04:00,54.28,54.29,53.84,53.99,8154183,7644302.35,45.65092583301201,52.587383492060304,NaN,NaN,-111.68988674327139,-48.01257989415791,-0.09287776634838135,0.0609503903420574,0.15382815669043876,472286493,483005192.2,60.18385025174255,74.96204219949803,NaN,NaN,3.609866067541227,10.627408463647955
2014-07-09T09:30:00-04:00,54.23,54.26,53.93,54.08,8600618,7881995.1,47.031141233240284,51.64282060907475,NaN,NaN,-99.14000507422595,-58.07141607922233,-0.09604948655383053,0.033766298498150604,0.12981578505198113,480887111,480922783.6,56.21162774005973,73.39040682047798,NaN,NaN,2.07660665489178,9.405865348111359
2014-07-10T09:30:00-04:00,53.47,53.975,53.41,53.76,10553791,8132607.95,42.86311363077981,50.294816722491596,NaN,NaN,-178.6704988351024,-81.87009218069656,-0.114607544687095,-0.013443645806887616,0.10116389888020738,470333320,478744518,52.3215042388761,71.31007276351328,NaN,NaN,-0.5477224357776403,7.9839242361272165
2014-07-11T09:30:00-04:00,53.83,54.09,53.6422,54.07,10186830,8132864.85,47.69874899481296,49.31733610713146,NaN,NaN,-107.56758710660705,-105.21368952871686,-0.10137027529533364,-0.025548945238959675,0.07582133005637397,480520150,476893550,49.20532726993557,68.88879025358092,NaN,NaN,-1.2682459389964131,6.662185639680984
2014-07-14T09:30:00-04:00,54.38,54.56,54.27,54.38,9399935,8258581.85,52.06744879857123,49.043819312310745,NaN,NaN,9.031067404884784,-97.6073820708644,-0.06866718676131092,-0.010012653395264692,0.05865453336604623,489920085,478789431.8,52.3366206035337,66.5762846939938,NaN,NaN,-0.4881189941293905,5.6407135491366445
2014-07-15T09:30:00-04:00,54.46,54.66,54.19,54.41,6944927,8262757.6,52.48111554171319,49.36664932424937,NaN,NaN,13.195152338890413,-72.63037425443204,-0.04319008930512001,0.004666921734646223,0.04785701103976623,496865012,483705135.6,59.33621011417712,64.74993870747316,NaN,NaN,0.2587002794543206,4.871854510610598
2014-07-16T09:30:00-04:00,54.57,54.715,54.41,54.64,5969442,8081201.25,55.64182785867387,49.864291994187,NaN,NaN,53.41145606027867,-42.12008202753112,-0.010715682899853522,0.034462407414949325,0.04517809031480285,502834454,488094604.2,64.36816615900744,63.392142128326974,NaN,NaN,1.8488686694326393,4.439999390442319
2014-07-17T09:30:00-04:00,54.44,54.5,53.77,53.79,14904764,8215945.65,43.99520842391489,49.570614110952036,NaN,NaN,-78.38242553207934,-22.062467366926505,-0.04445651456507291,-0.010392552891538287,0.03406396167353462,487929690,491613878.2,67.80775168581216,62.832572198517354,NaN,NaN,-0.5811671811073106,3.722689880220943
2014-07-18T09:30:00-04:00,53.98,54.29,53.92,54.24,6424415,8179716.15,49.966123816315694,49.557948968420305,NaN,NaN,-39.460560766311566,-8.441062098867409,-0.03486673614828202,-0.009519458511817902,0.025347277636464115,494354105,494380669.2,70.24000471580081,62.59117530325829,NaN,NaN,-0.5462588656803,3.1128400593779086
2014-07-21T09:30:00-04:00,54.17,54.275,53.84,54.21,9365739,8432766.3,49.58657011959524,49.76737901688586,NaN,NaN,-44.2692428700843,-19.101124153861228,-0.029173893104445677,-0.011120088744092982,0.018053804360352695,484988366,493394325.4,68.26002591221544,62.43805680938583,NaN,NaN,-0.6417646794697237,2.5764679538282467
2014-07-22T09:30:00-04:00,54.46,54.54,54.32,54.41,5320432,8439169.65,52.19377659911916,49.793153935840756,NaN,NaN,65.63672564298389,-8.61280949304253,-0.01147744601381366,0.0037069968430856193,0.01518444285689928,490308798,492083082.6,65.61213751685705,61.996084246662846,NaN,NaN,0.10439089668755419,2.2233140885224336
2014-07-23T09:30:00-04:00,54.42,54.52,54.175,54.19,7924377,8463892.75,49.18075829348014,49.70634424261964,NaN,NaN,22.987703805266932,-14.697559944044874,-0.013962308835886039,-0.002268443187958269,0.01169386564792777,482384421,487993076,58.04820573363468,61.283412812452454,NaN,NaN,-0.20536613390054842,1.876359771033436
2014-07-24T09:30:00-04:00,54.24,54.25,53.86,53.93,10014553,8639298.95,45.81468835616144,48.9189255273217,NaN,NaN,-70.33948618306617,-13.08897207424224,-0.031487048745714244,-0.027664945284215037,0.003822103461499207,472369868,484881111.6,53.03810233883523,60.11645485942733,NaN,NaN,-1.505173081563882,1.3932836492338192
2014-07-25T09:30:00-04:00,53.8,54.02,53.705,53.79,7514790,8672770.65,44.06577343596107,48.44551578109654,NaN,NaN,-118.48368216688247,-28.893596354356426,-0.049789931407591456,-0.058415310797990116,-0.008625379390398659,464855078,478981306.2,45.09214026420828,58.718691038906854,NaN,NaN,-3.10094349828059,0.7512511995889036
2014-07-28T09:30:00-04:00,53.78,53.8,53.24,53.52,13004148,8912248.75,40.828718245227776,48.10107238196908,NaN,NaN,-183.32306755440536,-56.70436129122063,-0.07580388648925397,-0.10338023750196612,-0.02757635101271215,451850930,472353819,38.17355885920826,57.146527368011554,NaN,NaN,-5.446967067437257,-0.13420855284340494
2014-07-29T09:30:00-04:00,53.49,53.57,52.85,52.85,13456541,9186242.85,34.128852306894956,47.17948031580156,NaN,NaN,-239.74402051542458,-117.78051052290235,-0.13064159100014186,-0.19087833976288948,-0.060236748762747615,438394389,461970937.2,30.323840062896906,55.29739967678564,NaN,NaN,-9.848092504791065,-1.5219062602644993
2014-07-30T09:30:00-04:00,53,53.12,52.57,52.9,14834652,9526664.95,34.98625615318805,46.61684763883072,NaN,NaN,-231.82856604892638,-168.743764493741,-0.15442430359830148,-0.2532671282606245,-0.098842824662323,453229041,456139861.2,26.9696873231332,53.48655561137543,NaN,NaN,-13.056033920244506,-3.1696387831187858
2014-07-31T09:30:00-04:00,52.49,52.87,51.8,51.83,17185959,9882237.6,26.91297092974507,45.13214920561159,NaN,NaN,-265.0402850223964,-207.68392426160705,-0.22861943905831816,-0.3846171234852207,-0.15599768442690254,436043082,448874504,23.484173070054425,51.64933031138391,NaN,NaN,-19.143622691100642,-5.451636484259051
2014-08-01T09:30:00-04:00,51.7,52.085,51.41,51.78,15724582,10240949.6,26.604033013702434,43.313333792406674,NaN,NaN,-240.02641421526766,-231.99247067128408,-0.26490758587417346,-0.48713216676961935,-0.2222245808954459,420318500,439967188.4,20.06107254897026,49.343934021772235,NaN,NaN,-23.883021247759885,-8.084691450473455
2014-08-04T09:30:00-04:00,51.89,52.03,51.51,51.96,9212374,10234852.6,29.731256660232404,41.6883438723009,NaN,NaN,-180.77278529376548,-231.48241421915608,-0.2602522413173036,-0.5475398825420754,-0.2872876412247718,429530874,435503177.2,18.59797538816086,46.43406011277108,NaN,NaN,-26.68934129277079,-10.742498570801645
2014-08-05T09:30:00-04:00,51.69,52.2,51.5,51.65,13501480,10502217.45,27.55383438946002,39.68205862449991,NaN,NaN,-150.28803427924078,-213.59121697191935,-0.26085583819858604,-0.6133574389730043,-0.3525016007744183,416029394,431030178.2,17.241093530322942,43.067840639293614,NaN,NaN,-29.732455999330178,-13.455349632020008
2014-08-06T09:30:00-04:00,51.44,51.62,51.2,51.39,31000681,11622220.6,25.84425324191693,38.38556182578577,NaN,NaN,-148.8449690441813,-196.9944975709703,-0.2609385697329164,-0.6786748129405638,-0.41773624320764735,385028713,417390112.6,13.908644502100671,39.21790441188565,NaN,NaN,-32.797172681669565,-16.218467210541373
2014-08-07T09:30:00-04:00,51.67,51.86,51.34,51.44,14560079,11822535,26.785034972781503,36.72976976553333,NaN,NaN,-117.20080507818054,-167.42660158212715,-0.2403122884685403,-0.7181266037933227,-0.4778143153247824,399588792,410099254.6,12.516084092424478,35.09476722450163,NaN,NaN,-34.97154984162874,-18.897479014982427
2014-08-08T09:30:00-04:00,51.57,52.21,51.39,52.17,11882697,11907328.35,38.9606638825812,35.97077646288947,NaN,NaN,-81.54139645395911,-135.72959802986546,-0.16384353121775586,-0.6826187293469772,-0.5187751981292213,411471489,408329852.4,12.19692143674952,31.09025976196835,NaN,NaN,-32.99913166451907,-20.91200082205909
2014-08-11T09:30:00-04:00,52.4,52.68,52.2,52.38,7057076,11790185.4,41.95131038725684,35.239171733470734,NaN,NaN,-44.57216870395508,-108.48947471190338,-0.08919416311635886,-0.63026790202467,-0.5410737389083111,418528565,406129390.6,11.794128894014193,27.246116288908148,NaN,NaN,-30.43143902956037,-22.27192056598784
2014-08-12T09:30:00-04:00,52.33,52.585,52.165,52.26,11550877,12020482.9,40.72345688771844,34.63507877591632,NaN,NaN,-44.46850448349151,-87.32556875275353,-0.04045493363443475,-0.5916424059513545,-0.5511874723169198,406977688,404319049.4,11.458852025728092,23.918305309771963,NaN,NaN,-28.720692517504503,-23.19317370191879
2014-08-13T09:30:00-04:00,52.46,52.8,52.455,52.77,7600518,12102036.7,47.72606508206153,34.77160568490919,NaN,NaN,-16.76377205818019,-60.909329355553304,0.02978666515848072,-0.5139541408688189,-0.5437408060272996,414578206,410228948,19.50370128180458,21.52299094855548,NaN,NaN,-24.951917430134763,-23.444422805949646
2014-08-14T09:30:00-04:00,52.78,53.02,52.77,53,7470622,11730329.6,50.562518407538164,35.2356588971647,NaN,NaN,5.835170804978048,-36.302134178921584,0.09188651608387055,-0.4288826609224614,-0.520769177006332,422048828,414720955.2,25.076052847079495,20.093270418760568,NaN,NaN,-20.941575180453942,-23.086873145164546
2014-08-15T09:30:00-04:00,53.22,53.28,52.51,52.89,11193022,11968759.95,49.18785040240292,35.83273976553435,NaN,NaN,8.453032964767493,-18.30324829517626,0.12372046672222947,-0.36611859360354515,-0.4898390603257746,410855806,414597818.6,25.024912160257628,19.154081368835527,NaN,NaN,-18.084546414174085,-22.372255040737336
2014-08-18T09:30:00-04:00,53.24,53.69,53.2233,53.69,7944340,11897690,58.10817052128,37.545548209418996,NaN,NaN,66.18006013291424,3.847197472197614,0.19270763921735756,-0.24895451130407764,-0.4416621505214352,418800146,414652134.8,25.09747774955619,18.780769775025476,NaN,NaN,-12.405796002929325,-20.948475178193334
2014-08-19T09:30:00-04:00,53.8,53.899,53.73,53.82,6246495,11943993.15,59.356814591431295,39.28630238357922,NaN,NaN,96.72073020340702,32.085044409577314,0.23816825536834818,-0.14395183131099998,-0.38212008667934816,425046641,418265925.4,29.95494114178925,18.994002190643766,NaN,NaN,-7.472847219437967,-19.02338546979971
2014-08-20T09:30:00-04:00,53.87,54.48,53.81,54.39,26421385,12868843.55,64.3712911246399,41.96189668321456,NaN,NaN,134.24154238720226,62.28610729865382,0.29403669961853146,-0.014574212156183819,-0.3086109117747153,451468026,425643889.4,38.69593118128075,20.080556341445646,NaN,NaN,-1.4546942127194131,-16.513572433073954
2014-08-21T09:30:00-04:00,54.45,54.5,54.19,54.34,9971763,12866704.05,63.62967797429493,44.606585608971166,NaN,NaN,140.11012412890742,89.14109796343969,0.3132627320394371,0.08296750327458113,-0.23029522876485597,441496263,429533376.4,42.75181336805465,21.70132354280881,NaN,NaN,3.0582842826162295,-13.717592902261071
2014-08-22T09:30:00-04:00,54.28,54.3799,54.0201,54.15,5621920,12772060.55,60.76480361348709,46.823267534203644,NaN,NaN,121.808112044776,111.81211377944139,0.29886568815089454,0.14328688142376222,-0.1555788067271323,435874343,434537083.8,47.55859724889823,23.769939390004335,NaN,NaN,5.932979367137515,-10.910368292346988
2014-08-25T09:30:00-04:00,54.4,54.48,54.27,54.36,3997760,12321741.15,62.76052443705481,49.33803110903184,NaN,NaN,127.21440236147475,124.0189822251535,0.28899495841890604,0.20566489129650023,-0.0833300671224058,439872103,438751475.2,51.2698319097994,26.20056355996694,NaN,NaN,8.938374357502868,-8.074833628082724
2014-08-26T09:30:00-04:00,54.44,54.46,54.16,54.18,2874141,11792621.15,59.94589453571426,51.77386263001737,NaN,NaN,106.39675178955925,125.95418654238392,0.2569311078173273,0.23783381764925338,-0.01909729016807396,436997962,441141739.4,53.28893996675258,29.01344180744207,NaN,NaN,10.639917001878626,-5.401297823802531
2014-08-27T09:30:00-04:00,54.3,54.32,54.04,54.15,3757626,11238769.85,59.46721401061599,54.10830398986269,NaN,NaN,87.27407713984904,116.56069349291329,0.22162493064454128,0.25793387313760263,0.03630894249306135,433240336,437496201.4,49.89342699892588,31.683252015049316,NaN,NaN,11.899672872266658,-2.929730581506932
2014-08-28T09:30:00-04:00,54.05,54.08,53.7963,54.07,4227494,10590846.6,58.13408982811413,55.477834414543615,NaN,NaN,66.03753191510302,101.74617505015242,0.18244132290138,0.26436059611978635,0.08191927321840636,429012842,434999517.2,47.65391415758627,34.215894352251944,NaN,NaN,12.59826978148991,-0.7114448153645263
2014-08-29T09:30:00-04:00,54.1,54.16,53.81,54.02,5453250,10077280,57.269949027133606,56.57202288882053,NaN,NaN,60.23930242924473,89.43241312704615,0.14438019549630554,0.2623945175887883,0.11801432209248275,423559592,432536567,45.484939181863645,36.62238080138405,NaN,NaN,12.960347419269002,1.2416683610116919
2014-09-02T09:30:00-04:00,54.14,54.36,53.96,54.2,7161268,9974724.7,59.598259505613726,57.92022307581305,NaN,NaN,66.08907641551278,77.20734793785377,0.12336683522011233,0.27222286611762314,0.14885603089751082,430720860,430706318.4,43.886393711457416,38.93863377893614,NaN,NaN,13.886832927809284,3.0481204419827765
2014-09-03T09:30:00-04:00,54.32,54.39,54.03,54.13,5298274,9564564.4,58.26856455530615,58.67325875247337,NaN,NaN,61.56235814298142,68.2404692085382,0.0979046462523469,0.27123683871294446,0.17333219246059756,425422586,428391243.2,41.88137684987022,40.53703917665512,NaN,NaN,14.33463361815834,4.660479467150714
2014-09-04T09:30:00-04:00,54.23,54.545,54.045,54.15,6932712,8361165.95,58.553093987940166,59.24401415107352,NaN,NaN,62.47608308256349,63.28087039708108,0.07650923291951234,0.26896873360998796,0.19245950069047563,432355298,428214235.6,41.72441652068687,41.72620801048422,NaN,NaN,14.785172303521355,6.106864158060805
2014-09-05T09:30:00-04:00,54.1,54.34,53.87,54.33,9282290,8097276.5,61.12225950171889,60.0964719438818,NaN,NaN,52.805488060702935,60.63446162620106,0.06882082488203847,0.2784855317930237,0.20966470691098524,441637588,430739184.8,44.89683802724515,43.14563128669761,NaN,NaN,15.83861882471192,7.49711482472525
2014-09-08T09:30:00-04:00,54.24,54.465,54.225,54.28,5321122,7769197.75,60.00949786927385,60.23228104016708,NaN,NaN,64.61348551869759,61.50929824409163,0.0552918220097067,0.2787794844231186,0.22348766241341192,436316466,433290559.6,47.978556448092725,44.77999405087879,NaN,NaN,16.466372834442996,8.77843739754207
2014-09-09T09:30:00-04:00,54.35,54.37,54.02,54.11,5796623,7706175.1,56.259247504805955,60.01102624826526,NaN,NaN,42.97918201524988,56.887319364039044,0.03102711922733173,0.2622715614475766,0.23124444222024484,430519843,433250356.2,47.933065515194656,46.06414579183632,NaN,NaN,16.06925636968445,9.819982964990981
2014-09-10T09:30:00-04:00,54.08,54.22,53.86,54.15,5448497,7401056.1,56.9411131671202,59.48029925129957,NaN,NaN,24.295518608977243,49.433951457238216,0.014636475862630338,0.24954003704853278,0.23490356118590244,435968340,435359507,50.580386158309764,46.91303543305268,NaN,NaN,15.896261861823128,10.688022807395573
2014-09-11T09:30:00-04:00,53.91,54.23,53.91,54.17,5785511,7310305.75,57.299539424615645,59.02814649775105,NaN,NaN,21.867115868034677,41.312158014332454,0.0027306522389777543,0.23831687648462463,0.23558622424564687,441753851,437239217.6,52.87981293911768,47.636463973842886,NaN,NaN,15.83373930229699,11.423125163810061
2014-09-12T09:30:00-04:00,54.06,54.15,53.84,53.99,9045786,7389063.95,53.02176032317454,58.475071977014444,NaN,NaN,-21.103606184364853,26.530339165318896,-0.018509806780925925,0.21244896576948946,0.2309587725504154,432708065,435453313,50.47675831696064,47.84490405013306,NaN,NaN,14.69116267083649,11.889987664813837
2014-09-15T09:30:00-04:00,53.92,54.05,53.71,53.97,7027303,7180778,52.55229760867277,57.7459129178443,NaN,NaN,-90.78629701758283,-4.549617341937174,-0.03423456066061553,0.18816557172464599,0.22240013238526152,425680762,433326172.2,47.696513547643335,47.58966702426478,NaN,NaN,13.594952632733856,12.133554088802411
2014-09-16T09:30:00-04:00,53.91,54.34,53.71,54.27,7319358,7149528.9,58.48948823890713,57.64188389664379,NaN,NaN,-19.992296064525963,-17.143912957892343,-0.02517817992275098,0.1909274074818228,0.21610558740457378,433000120,433822227.6,48.4101458557353,47.24118173062068,NaN,NaN,14.11405528344099,12.416482830893637
2014-09-17T09:30:00-04:00,54.36,54.75,54.225,54.48,9723296,7323368.95,62.06763726660284,57.82762841492856,NaN,NaN,194.49653294100793,16.896289908513793,-0.006750418118721874,0.20766756475617143,0.2144179828748933,442723416,435173242.8,50.39524371738136,47.27702578193894,NaN,NaN,15.568996033066723,12.866841859775507
2014-09-18T09:30:00-04:00,54.61,54.82,54.58,54.74,8057246,6405162,65.97785357808655,58.38789725421231,NaN,NaN,252.7387665453173,63.07062004397032,0.019791398818800793,0.2391572313983943,0.2193658325795935,450780662,436978605,52.99793895269409,47.65874183873235,NaN,NaN,18.021249313183784,13.603185781690975
2014-09-19T09:30:00-04:00,54.8,54.83,54.345,54.43,9271200,6370133.85,58.26568092492385,58.459020961197325,NaN,NaN,146.96655679996292,96.68465264083588,0.013606405439131941,0.23637383937850842,0.22276743393937648,441509462,438738884.4,55.45223989394554,48.37069188959534,NaN,NaN,17.88025279005914,14.214195354314999
2014-09-22T09:30:00-04:00,54.33,54.36,53.76,53.82,10709015,6624488.6,46.69835510390126,57.53759921821786,NaN,NaN,-93.61141423601714,96.11962919714901,-0.0319432019460936,0.1828384315067595,0.2147816334528531,430800447,439762821.4,56.86326422714735,49.297611212144616,NaN,NaN,13.709640416970625,14.142116077551517
2014-09-23T09:30:00-04:00,53.62,53.74,53.36,53.38,8630008,6856101,40.45896131291021,56.26548470090387,NaN,NaN,-252.31300548030237,49.65548731399373,-0.08885619321672061,0.10371139193195233,0.19256758514867295,422170439,437596885.2,53.03642695004113,50.09440050501398,NaN,NaN,7.835247927642006,13.24113491327873
2014-09-24T09:30:00-04:00,53.41,53.72,53.19,53.66,8569761,7140882,45.453524853470576,55.32980119129889,NaN,NaN,-197.369609236264,-28.71774112146066,-0.1037568211279051,0.06287155873879158,0.16662837986669668,430740200,435200242,49.098909744724175,50.621150021016646,NaN,NaN,4.824213575673812,12.03871757933517
2014-09-25T09:30:00-04:00,53.47,53.51,52.81,52.82,10761402,7491070.8,35.7617057495749,53.51833306614576,NaN,NaN,-263.91949922498844,-132.04939427552182,-0.16278309875548527,-0.036850493577659904,0.12593260517782537,419978798,429039869.2,40.72868867276624,50.32342506712529,NaN,NaN,-1.8192815153281374,10.059003422954698
2014-09-26T09:30:00-04:00,52.97,53.44,52.83,53.31,5838989,7571645.55,43.34992234300387,52.3283633856979,NaN,NaN,-181.8947214290699,-197.82164992132837,-0.1611237152726876,-0.07547203891303411,0.08565167635965347,425817787,425901534.2,37.245214838451965,49.556757809293806,NaN,NaN,-4.151468506374712,8.028936004479068
2014-09-29T09:30:00-04:00,52.82,53.32,52.75,53.23,7664446,7682205.35,42.46788904120166,51.343266352583306,NaN,NaN,-162.6468769325657,-211.62874246063808,-0.1575235575436753,-0.11125277056994065,0.04627078697373464,418153341,423372113,34.671329710306225,48.60949096608749,NaN,NaN,-6.197111382206387,5.99664352066686
2014-09-30T09:30:00-04:00,53.3,53.54,53.055,53.15,12379985,7943141.2,41.55728718422977,50.24442163951971,NaN,NaN,-113.73979503211785,-183.91410037100118,-0.15253665828193358,-0.14440003587868233,0.008136622403251241,405773356,420092696.4,31.620310597593928,47.25519985460779,NaN,NaN,-8.073848709985288,3.9865732020022673
2014-10-01T09:30:00-04:00,52.98,52.98,52.03,52.15,20308387,8693646.85,32.24884976901397,48.455086664119584,NaN,NaN,-198.11840319767288,-184.06385916328296,-0.20530658660591866,-0.2484966108541471,-0.04319002424822843,385464969,411037650.2,25.062276020479203,45.2682329318479,NaN,NaN,-13.442847871190553,1.4966559058318647
2014-10-02T09:30:00-04:00,52.13,52.32,51.62,52.09,13006973,8997359.9,31.78876361437139,46.938444042062216,NaN,NaN,-196.59708321416892,-170.59937596111905,-0.23105454945530038,-0.3320082110673539,-0.10095366161205352,372457996,401533489.8,20.302692273954094,43.112942500204575,NaN,NaN,-17.59776020069904,-1.23111782367255
2014-10-03T09:30:00-04:00,52.48,52.89,52.4,52.8,14246676,9245579.2,42.28237893104603,46.20487842223174,NaN,NaN,-103.11960348964111,-154.8443523732333,-0.18884969589327566,-0.3370157814786481,-0.14816608558537242,386704672,393710866.8,17.37747307552779,40.94729675219632,NaN,NaN,-17.29194887384771,-3.5255222594118583
2014-10-06T09:30:00-04:00,53.1,53.19,52.49,52.64,12077137,9583379.95,40.76058467631604,44.93852816776094,NaN,NaN,-85.06416192617237,-139.32780937195463,-0.16135672249739125,-0.3498619887071115,-0.18850526620972025,374627535,385005705.6,14.818739102558709,38.54791055554085,NaN,NaN,-17.586732848594377,-5.534266629295075
2014-10-07T09:30:00-04:00,52.24,52.35,51.36,51.36,19321943,10259645.95,31.113093489893217,42.72748932656741,NaN,NaN,-169.52085661750547,-150.48402168903218,-0.2156341165346674,-0.4580479118780545,-0.24241379534338708,355305592,374912152.8,12.51729279629204,35.8423426326059,NaN,NaN,-21.721006413475642,-7.846658027035156
2014-10-08T09:30:00-04:00,51.38,52.33,51.01,52.28,23937693,11184105.75,41.7793822287892,40.999027087331875,NaN,NaN,-132.1866216975754,-137.29766538901265,-0.17742794787046245,-0.4641987301814652,-0.2867707823110027,379243285,373667816,12.264412544575904,32.932805032026025,NaN,NaN,-20.71428864802213,-9.684890972890438
2014-10-09T09:30:00-04:00,52.17,52.26,50.98,51.07,23240635,12056861.95,34.264768212507576,39.284676179302146,NaN,NaN,-149.80110536134816,-127.93846981844851,-0.21878493405183663,-0.5602519498757985,-0.3414670158239619,356002650,370376746.8,11.597087839711818,29.80029417100933,NaN,NaN,-23.111383616454038,-11.60296135054238
2014-10-10T09:30:00-04:00,51.07,51.17,50.31,50.32,20040951,12606620.2,30.59185208321243,38.134211677824375,NaN,NaN,-183.72737996635908,-144.0600251137921,-0.27798778226469134,-0.688951743654826,-0.4109639613901347,335961699,360228152.2,9.82226270147369,26.44022263346121,NaN,NaN,-26.475918740492638,-13.727669549106702
2014-10-13T09:30:00-04:00,50.46,50.93,49.5,49.54,24625342,13486522.15,27.312805760867008,37.19520056696415,NaN,NaN,-187.64364746070441,-164.5759222206985,-0.3465534994632972,-0.8441558357192562,-0.497602336255959,311336357,347569916.6,8.147405099119766,23.233863929823972,NaN,NaN,-30.417305713682392,-16.111903286903228
2014-10-14T09:30:00-04:00,49.93,50.85,49.82,50.23,22094863,14225297.4,34.047420249610994,36.38047880954561,NaN,NaN,-143.39019189764795,-159.349789276727,-0.3227915220204123,-0.9010917387814743,-0.578300216761062,333431220,343195042.2,7.661178174364977,20.2740259605126,NaN,NaN,-30.789300263980586,-18.208674283628564
2014-10-15T09:30:00-04:00,49.45,50.35,48.83,50.11,28271662,15152715.7,33.46667687432608,36.216548175599264,NaN,NaN,-151.12781241399648,-163.13802742001124,-0.2933625769029071,-0.9450034378896959,-0.6516408609867888,305159558,328378296.8,6.291688353095935,17.81424022339329,NaN,NaN,-31.27164773420314,-20.07481334799636
2014-10-16T09:30:00-04:00,49.28,50.905,49.15,50.48,43949163,16947311.55,37.03298078082265,35.76533806401489,NaN,NaN,-112.97207156004434,-155.77222065975047,-0.22998511224187668,-0.9391222512891346,-0.709137139047258,349108721,326999511,6.1809627538048915,15.595365074489925,NaN,NaN,-30.413705319820256,-21.551797915399774
2014-10-17T09:30:00-04:00,51.46,51.8,51.22,51.48,24733106,17720406.85,45.53089482115499,35.984124191154415,NaN,NaN,-32.52890899949259,-125.53252646637718,-0.10792241384976886,-0.844040156359469,-0.7361177425097002,373841827,334575536.6,15.029626263115816,14.192386256833467,NaN,NaN,-26.61086316485911,-22.274521522465395
2014-10-20T09:30:00-04:00,51.37,51.64,51.21,51.63,17450109,18057461.55,46.693036523853635,36.35096342969898,NaN,NaN,-27.219890216333066,-93.44777501750289,-0.009474713459086015,-0.7479611343335577,-0.7384864208744717,391291936,350566652.4,30.030526775136977,14.078830269515118,NaN,NaN,-23.300560834369016,-22.421098567023055
2014-10-21T09:30:00-04:00,51.98,52.835,51.96,52.78,12838676,18267894.95,54.67700339215248,37.9529744027803,NaN,NaN,44.591899204144255,-55.85135679714447,0.13285003115742489,-0.5724238819276906,-0.7052739130851154,404130612,364706530.8,40.10042602879276,15.152983841537516,NaN,NaN,-17.52986216970954,-21.722350510263983
2014-10-22T09:30:00-04:00,52.99,52.99,52.04,52.09,16417679,18660290.85,49.85244893766342,39.243237640158306,NaN,NaN,40.336004335544665,-17.558593447236234,0.17748786524348958,-0.4834140815307535,-0.6609019467742431,387712933,381217205.8,49.279589756444025,17.222762233143943,NaN,NaN,-14.501027174599631,-20.69073289088336
2014-10-23T09:30:00-04:00,52.82,53.6,52.75,53.24,23317189,19288080.2,56.708698039276285,40.27368900503188,NaN,NaN,97.93087545342945,24.621995955458544,0.275577417973208,-0.3164301743077331,-0.5920075922809411,411030122,393601486,54.866469391845555,19.900547684309494,NaN,NaN,-9.401189778007259,-19.077941017615345
2014-10-24T09:30:00-04:00,53.55,53.74,53.085,53.71,8947970,19443529.25,59.165919716889334,41.58835579364426,NaN,NaN,117.36203321918987,54.600184399195044,0.3580033479023582,-0.1445034074029934,-0.5025067553053516,419978092,402828739,58.53160560857998,23.022895291882442,NaN,NaN,-4.528281325846791,-16.999418204505552
2014-10-27T09:30:00-04:00,53.58,53.74,53.23,53.69,9692934,19544953.65,59.01242128396801,43.58116492179246,NaN,NaN,116.2048124073477,83.28512492393119,0.3942041017484688,-0.009751628119765599,-0.4039557298682344,410285158,406627383.4,59.97268582815273,26.412566222729634,NaN,NaN,-0.8537216363138013,-14.692890123335303
2014-10-28T09:30:00-04:00,54.01,54.69,54.01,54.64,10066790,19429293.9,63.814655432335975,45.155113007760086,NaN,NaN,163.48373557188245,107.06349219747884,0.4605387704366516,0.1717177331775801,-0.2888210372590715,420351948,409871650.6,61.21244132163225,29.908853992519376,NaN,NaN,3.9416786983843664,-12.030808863089636
2014-10-29T09:30:00-04:00,54.83,54.83,54.04,54.45,12589942,19043371.65,62.24392126206651,47.153623939871444,NaN,NaN,142.1804193170548,127.43237519378086,0.4684816224440415,0.2967809907959804,-0.1717006316480611,407762006,413881465.2,62.748187217627866,33.5625039480848,NaN,NaN,7.24681931266922,-9.27686198083837
2014-10-30T09:30:00-04:00,54.22,54.87,53.99,54.67,10528646,18919455.3,63.36825095814945,49.49479528808123,NaN,NaN,125.25185724048539,132.89657155119204,0.4645067153498215,0.40893276253921584,-0.05557395281060569,418290652,415333571.2,63.31465888098688,37.38338938947861,NaN,NaN,10.267166992323874,-6.484857841815193
2014-10-31T09:30:00-04:00,55.53,55.53,55.05,55.21,10174438,18715843.4,66.04133817402267,52.26111903187803,NaN,NaN,143.68485284997175,138.1611354773484,0.4726333065915024,0.5352176804287723,0.06258437383726992,428465090,417030970.8,64.00372173367222,41.37312629194663,NaN,NaN,13.65521316755904,-3.6077048404760177
2014-11-03T09:30:00-05:00,55.29,55.34,54.895,55.14,11111447,18667558.9,65.37536222502851,54.498829172979285,NaN,NaN,121.01579860919557,139.123332717718,0.4479128713653081,0.6224754630439051,0.17456259167859697,417353643,418444667.8,64.60010462849723,45.44019246724179,NaN,NaN,16.203498798549486,-0.7775328920438032
2014-11-04T09:30:00-05:00,55.07,55.36,54.92,55.11,6232598,18013091.65,65.07249794379709,56.75638782079864,NaN,NaN,106.18536464414063,127.66365853216962,0.405432264880253,0.6813529227789132,0.2759206578986602,411121045,416598487.2,63.129147441573714,49.500010973561636,NaN,NaN,18.206904749137095,1.934529628124896
2014-11-05T09:30:00-05:00,55.59,55.59,55.14,55.45,8110596,17221736.8,66.94170228574032,58.89272507114991,NaN,NaN,102.94810939972508,119.81719654870369,0.3767353041800099,0.7468397881236726,0.3701044839436627,419231641,418892414.2,64.21934496608195,53.645609703009995,NaN,NaN,20.451077070502627,4.579750691321715
2014-11-06T09:30:00-05:00,55.55,56.1,55.47,56.03,5731616,16346285.85,69.90091576512309,60.633440852861916,NaN,NaN,108.33829956297397,116.4344850132014,0.37263959107577926,0.8359039727883868,0.46326438171260753,424963257,420226935.2,64.8701174944677,57.20564479096371,NaN,NaN,23.291501978613987,7.252858018077754
2014-11-07T09:30:00-05:00,56.05,56.15,55.85,56.11,8241631,15756319.85,70.29588126255928,62.319358334198036,NaN,NaN,105.42987983335257,108.78349040987757,0.3514200144939973,0.9025393998301041,0.5511193853361068,433204888,421174894.8,65.35218283051196,59.72862022349049,NaN,NaN,25.75427475981295,9.895917552611355
2014-11-10T09:30:00-05:00,56.16,56.42,56.09,56.39,6131317,14831618.6,71.69582046357556,63.53498812501397,NaN,NaN,107.60626835159778,106.10158435835801,0.3325424727624928,0.9667974762892229,0.63425500352673,439336205,425571407.2,67.57456227126312,61.69105852652409,NaN,NaN,28.258705232325287,12.51917293542763
2014-11-11T09:30:00-05:00,56.47,56.54,56.171,56.32,9905356,14222143.25,70.79749218966465,65.03106264301405,NaN,NaN,100.6553698287956,104.995585395289,0.2930283511355828,1.0005404424462085,0.7075120913106258,429430849,429233368,69.3386634335402,63.12384950345953,NaN,NaN,30.128864593041833,15.034843172229658
2014-11-12T09:30:00-05:00,56.08,56.49,56.08,56.4,7108434,13163981.85,71.2409903138015,66.06908351976587,NaN,NaN,94.99956506418812,103.40587652818161,0.25155579526376104,1.021956835390327,0.770401040126566,436539283,432694896.4,70.94766888400997,64.2725066100427,NaN,NaN,31.831611601992023,17.43438151933857
2014-11-13T09:30:00-05:00,56.4,56.62,56.065,56.24,6437026,11288375,68.98447803987014,66.77040911426448,NaN,NaN,91.5574305030759,100.04970271620199,0.19514020479920102,1.0143262961255672,0.8191860913263662,430102257,433722696.4,71.42712164372423,65.19361489826728,NaN,NaN,32.74303079204397,19.62133141543934
2014-11-14T09:30:00-05:00,56.2,56.435,56.13,56.31,5554537,10329446.55,69.44053205293756,67.51527416919087,NaN,NaN,84.11101468219832,95.78592968597113,0.1465493068996231,1.0023727249508951,0.855823418051272,435656794,434213077.6,71.66737064985445,66.02894952838884,NaN,NaN,33.63705588094435,21.62357776765434
2014-11-17T09:30:00-05:00,56.15,56.37,56.06,56.23,4271072,9670494.7,68.20618418509878,67.82895479438822,NaN,NaN,75.75339231622169,89.41535447889592,0.09550332478388612,0.9752025740311296,0.8796992492472435,431385722,432622981,69.6231139430565,66.62971185849058,NaN,NaN,34.1128780980019,23.407763529132563
2014-11-18T09:30:00-05:00,56.2,56.79,56.2,56.65,8658563,9461489.05,71.10967797176379,68.46222313079518,NaN,NaN,91.19242149674523,87.52276481248585,0.07728561868965067,0.9763062726093068,0.8990206539196561,440044285,434745668.2,70.8197183948631,67.20624979972168,NaN,NaN,35.28265609610079,25.104176752985165
2014-11-19T09:30:00-05:00,56.62,56.64,56.27,56.48,5200447,8900627.45,68.38736271366761,68.82073111333219,NaN,NaN,80.61709232868007,84.64627026538423,0.042770471062397286,0.9524837427476527,0.9097132716852554,434843838,434406579.2,70.34302319870403,67.70827582241574,NaN,NaN,35.61182134251651,26.605268837203926
2014-11-20T09:30:00-05:00,56.31,56.695,56.12,56.63,7383084,8103922.2,69.49699566003896,69.06756379090477,NaN,NaN,75.91813670676895,81.51841150612285,0.02017391375488864,0.9349306638788661,0.9147567501239775,442226922,436831512.2,71.8046445526868,68.2654845952025,NaN,NaN,36.17514842557744,27.972394492685858
2014-11-21T09:30:00-05:00,57.29,57.34,57.05,57.18,7509559,8032001.65,73.21016508562846,69.62719256666192,NaN,NaN,125.83881667617509,89.8639719049182,0.031713331928279076,0.9543984150343263,0.9226850831060472,449736481,439647449.6,73.44153249269633,68.897015156931,NaN,NaN,37.70560058441269,29.362852505789693
2014-11-24T09:30:00-05:00,57.34,57.525,57.2,57.33,6706897,7882699.8,74.13492530459627,70.274508806719,NaN,NaN,137.35984414321717,102.1852622703173,0.038444256215250494,0.9707404033751104,0.9322961471598599,456443378,444658980.8,76.10077155430608,69.8235597364119,NaN,NaN,39.26198211030566,30.777013877863403
2014-11-25T09:30:00-05:00,57.47,57.62,57.29,57.5,8276930,7793206.8,75.18059105250353,70.86300086148779,NaN,NaN,141.92628792506943,112.33203555598213,0.042997194556739116,0.9860426403557838,0.9430454457990447,464720308,449594185.4,78.39495887052388,70.83610358672918,NaN,NaN,40.883116398846184,32.22074280943237
2014-11-26T09:30:00-05:00,57.53,57.54,57.28,57.39,5373842,7432401.8,73.12068301549054,71.09298423651404,NaN,NaN,131.80886399263554,122.57038988877324,0.02797939577817965,0.9780196905217693,0.9500402947435896,459346466,454494711,80.40629116788396,71.94583027768748,NaN,NaN,41.73069696070865,33.57930768818613
2014-11-28T09:30:00-05:00,57.54,57.55,56.83,56.91,5865961,7199267.55,64.77975057674627,70.6989749018131,NaN,NaN,95.06443890398923,126.39965032821729,-0.02219401036649815,0.922297781785467,0.9444917921519651,453480505,456745427.6,81.26878787811506,73.08273063823056,NaN,NaN,40.173451742026295,34.52132826730615
2014-12-01T09:30:00-05:00,56.73,56.73,56.04,56.18,16636342,7522362.75,54.58228233120394,69.47657932092942,NaN,NaN,-8.943111375018054,99.44326471797866,-0.10767592858863428,0.8098968814161722,0.9175728100048065,436844163,454166964,77.08256973227628,73.76187402830294,NaN,NaN,35.51460012926636,34.663224247586186
2014-12-02T09:30:00-05:00,56.4,56.72,56.17,56.66,6621039,7297842.35,59.137235304606975,68.6437038291396,NaN,NaN,9.616213400498836,73.89453856943499,-0.133342646294773,0.7508945021363402,0.8842371484311132,443465202,451571328.8,73.00574141418305,74.02380816977742,NaN,NaN,32.864092638435324,34.40620544627892
2014-12-03T09:30:00-05:00,56.7,57.5,56.7,57.415,11434719,7557948.4,65.07105630224872,68.20299425688583,NaN,NaN,98.76280079978132,65.26184114437737,-0.10231909096288083,0.7563382847275122,0.858657375690393,454899921,449607251.4,69.98928255227973,73.95535200322526,NaN,NaN,32.46113131152407,34.128337712742514
2014-12-04T09:30:00-05:00,57.36,57.3751,56.88,57.13,6474510,7476144.1,61.44388589171993,67.66438053201794,NaN,NaN,74.48725410790566,53.79751916743138,-0.10352664126338706,0.7292490741111592,0.8327757153745463,448425411,447423040.4,66.68925959088169,73.61693328516508,NaN,NaN,30.936277576529413,33.67232912185493
2014-12-05T09:30:00-05:00,57.22,57.48,57.09,57.26,7454583,7562292.45,62.47148716471465,67.1665916114306,NaN,NaN,85.06348374377161,51.79732813538787,-0.09815243373080396,0.7100851732110414,0.8082376069418453,455879994,447902938.2,67.05678741318374,73.28760591111718,NaN,NaN,30.034768061202215,33.15267754176168
2014-12-08T09:30:00-05:00,57.17,57.26,56.445,56.63,8838328,7592127.3,54.84306105301433,66.21208281628171,NaN,NaN,4.460670752027443,54.47808456079697,-0.13721234798834492,0.6367221719564142,0.7739345199447591,447041666,449942438.8,68.64035580159305,73.21740890101263,NaN,NaN,26.729170288575798,32.235033648449416
2014-12-09T09:30:00-05:00,56,56.71,55.84,56.64,10282175,7799670.2,54.93712347220596,65.05690035202758,NaN,NaN,-58.32040664246331,40.89076055220453,-0.16091908416355472,0.5727856647403158,0.7337047489038705,457323841,452714166.6,70.70158561643727,73.2089708454108,NaN,NaN,24.160501856052168,31.08152910667838
2014-12-10T09:30:00-05:00,56.48,56.59,55.5,55.56,12942179,7951511.35,44.223165974959926,63.33088629926275,NaN,NaN,-131.38844261092726,-5.139488129937166,-0.24295448589127389,0.4300116415397781,0.672966127431052,444381662,450610514.8,67.09691328962927,72.97710585190545,NaN,NaN,17.991235016119973,29.211487093741464
2014-12-11T09:30:00-05:00,55.47,56.2999,55.39,55.825,11749853,8183582.3,46.95668118232085,61.7208638365686,NaN,NaN,-128.1137392363005,-45.659686798778395,-0.2708602336048833,0.33439083542494785,0.6052510690298312,456131515,452151735.6,68.36930564996881,72.73172450171131,NaN,NaN,13.94812811472003,27.031007239595546
2014-12-12T09:30:00-05:00,55.37,55.61,54.79,54.82,13168792,8520170.6,39.125422851243584,59.28623939125539,NaN,NaN,-206.34863376150528,-103.94211029983379,-0.3438067852275577,0.1754925874953841,0.5192993727229418,442962723,449568281.4,63.908016826990966,72.05075909701807,NaN,NaN,7.476883319288474,24.237560965265963
2014-12-15T09:30:00-05:00,55.28,55.31,54.35,54.64,16225643,9053725.9,37.9060573645873,56.698463109826186,NaN,NaN,-208.42964127218548,-146.52017270467636,-0.3877268835224763,0.034640768319846416,0.4223676518423227,426737080,445507364.2,57.550911214947845,70.72576907277819,NaN,NaN,2.032448765834636,21.065402079632918
2014-12-16T09:30:00-05:00,54.55,55.77,54.51,54.69,15504567,9615400.65,38.47961371223101,54.076964728378144,NaN,NaN,-158.98855917490218,-166.65380321116413,-0.39558962840556616,-0.072119383664635,0.32347024474093117,442241647,442490925.4,53.30901705927078,68.93391608626011,NaN,NaN,-2.036915515082177,17.765070994673618
2014-12-17T09:30:00-05:00,54.53,55.34,54.14,55.2,21899688,10277456.9,44.1467085537452,52.007395123967775,NaN,NaN,-140.94069792925833,-168.56425427483038,-0.3501823904989743,-0.11425774338278671,0.2359246471161876,464141335,446442860,57.707206294746776,67.31255288103604,NaN,NaN,-3.7138306052436794,14.696656480399719
2014-12-18T09:30:00-05:00,56.25,56.63,55.77,56.59,14040435,10719456.3,56.034102980318224,51.382706009937195,NaN,NaN,-8.174307967049629,-144.57636802098017,-0.2168092011717381,-0.03508685434848502,0.18172234682325308,478181770,450852911,62.00802656334701,65.93678421569545,NaN,NaN,-0.9591567057133966,12.460111739526416
2014-12-19T09:30:00-05:00,56.45,56.81,56.31,56.59,12359046,10968254.4,56.034102980318224,51.486407484873936,NaN,NaN,13.309762540187975,-100.64468876064151,-0.12350470133209487,0.027341470158134484,0.15084617149022936,478181770,457896720.4,67.6641388029071,65.26403914931193,NaN,NaN,1.1138306820592574,10.839214445602536
2014-12-22T09:30:00-05:00,56.8,57.15,56.72,57.13,6987860,10942169.45,59.88120827215105,51.539548411127086,NaN,NaN,53.93683658036477,-48.171393190131475,-0.02546262520541498,0.11901788998346063,0.1444805151888756,485169630,469583230.4,74.45832522846364,65.36779513604625,NaN,NaN,4.147899608786436,9.883312326057379
2014-12-23T09:30:00-05:00,57.42,57.565,57.24,57.34,5552859,10884467.55,61.299434975762686,51.27014688780665,NaN,NaN,88.77767744238349,1.3818541333256689,0.04940754973203426,0.20623995235391845,0.1568324026218842,490722489,479279398.8,78.49553775451633,65.97538479334887,NaN,NaN,7.034017849271974,9.476270257945178
2014-12-24T09:30:00-05:00,57.47,57.56,57.35,57.4,1958227,10568532.4,61.7158567073568,51.28957337463786,NaN,NaN,94.18069092447158,48.40613190407164,0.09614394825847206,0.27701233794497426,0.1808683896865022,492680716,484987275,80.45413940925945,66.95859049466158,NaN,NaN,9.459769461293789,9.473913001280694
2014-12-26T09:30:00-05:00,57.6,57.6,57.4,57.4,5733866,10586533.6,61.71585670735679,51.23559977054087,NaN,NaN,96.27300464584499,69.29559442665057,0.11874845019825653,0.32930395243432287,0.21055550223606634,492680716,487887064.2,81.38188684410572,67.98181188258457,NaN,NaN,11.413232819763449,9.750958689635373
2014-12-29T09:30:00-05:00,57.33,57.54,56.91,57.49,3566178,10471544.45,62.419319840163396,51.77676111248009,NaN,NaN,80.13723586509283,82.66108909163152,0.13051551953144197,0.3736999016503688,0.24318438211892685,496246894,491500089,82.49665659758074,68.97154765372655,NaN,NaN,13.234460883386303,10.24860186017122
2014-12-30T09:30:00-05:00,57.73,57.73,57.07,57.15,3602769,9819865.8,58.0776896234928,52.001087266143436,NaN,NaN,73.05019215329473,86.48376020621751,0.10713398013298214,0.37710185728515455,0.2699678771521724,492644125,492994988,82.95149936517329,69.84654149292197,NaN,NaN,13.637437804065058,10.732721280727484
2014-12-31T09:30:00-05:00,57.38,57.38,56.55,56.58,5572882,9767457.95,51.598091652292105,52.52786767166716,NaN,NaN,29.351999805797576,74.59862467890034,0.04802542996490339,0.32999966460830166,0.28197423464339827,487071243,492264738.8,81.83280451929349,70.89910515218371,NaN,NaN,12.109691283397648,10.929431281108936
2015-01-02T09:30:00-05:00,56.86,56.94,56.02,56.51,10982791,9744861.55,50.84781932335149,52.80580611031221,NaN,NaN,2.8166800829617467,56.32582251059837,0.0014218217051064075,0.2837515117747813,0.2823296900696749,476088452,488946286,76.76631302710437,71.49889139340767,NaN,NaN,10.641922910897211,10.888358656792976
2015-01-05T09:30:00-05:00,56.04,56.26,55.065,55.19,15144717,10178371.9,39.25599369551726,52.81513259918891,NaN,NaN,-75.14757414895257,22.041706751638863,-0.11467621346512963,0.13898442323826288,0.2536606367033925,460943735,482598889.8,68.08339444447029,71.79713265179905,NaN,NaN,5.288753780381384,10.08841510301989
2015-01-06T09:30:00-05:00,55.25,55.31,54.16,54.51,19209840,10766134.75,34.84857602241546,52.59674107474806,NaN,NaN,-126.49133816493821,-19.284008054367344,-0.22714128311511553,-0.030265967190501897,0.19687531592461363,441733895,471696290,56.3033163612909,71.70801873368069,NaN,NaN,-0.8186053173875281,8.530269328675974
2015-01-07T09:30:00-05:00,55.02,55.16,54.65,54.92,11770275,10912732.1,39.27549757237688,52.653589921901336,NaN,NaN,-93.56197992344451,-52.60644246971519,-0.2613547210770425,-0.1298180854216895,0.131536635655353,453504170,463868299,49.659545581371674,71.44734219954505,NaN,NaN,-4.337739914927559,6.691982293875469
2015-01-08T09:30:00-05:00,55.41,56.05,55.29,56.02,11419814,10969614.05,49.24071773284872,53.01744772040873,NaN,NaN,-25.10028639014221,-63.49689970890315,-0.20009815901979247,-0.11858606311938757,0.0815120959004049,464923984,459438847.2,46.32826619722171,70.63456076400755,NaN,NaN,-3.9141166929479,5.176825295757845
2015-01-09T09:30:00-05:00,56.09,56.15,55.33,55.42,10168249,10830917.55,44.91136986229024,52.22296678340673,NaN,NaN,-35.136358916794144,-71.08750750885433,-0.19024798502640358,-0.1562978853825996,0.033950099643803994,454755735,455172303.8,43.31422142507957,69.29928896841702,NaN,NaN,-5.101109815750106,3.708548851256709
2015-01-12T09:30:00-05:00,55.46,55.51,54.79,55.04,11229468,10804898.3,42.37052039187615,51.24699659851802,NaN,NaN,-68.07253824797415,-69.67250032865864,-0.1986612018806175,-0.2143764027069679,-0.01571520082635039,443526267,451688810.2,40.97053849618427,67.39260323222253,NaN,NaN,-6.913893032235155,2.1910571536150147
2015-01-13T09:30:00-05:00,55.5,55.93,54.41,54.93,17530923,11023004.85,41.63619683646637,49.94378149596911,NaN,NaN,-69.8474636395858,-58.34372542358817,-0.20039696527286918,-0.2662114074174369,-0.06581444214456769,425995344,448541100,38.921176350431885,64.85423545522025,NaN,NaN,-8.564858152906707,0.6544978241119117
2015-01-14T09:30:00-05:00,54.26,54.71,53.98,54.63,19597505,11191597.95,39.619476634189226,48.39521304299957,NaN,NaN,-112.84286378428342,-62.19990219575594,-0.20952504951905265,-0.3277207540433835,-0.11819570452433087,406397839,439119833.8,33.51719414904014,61.64149662625766,NaN,NaN,-10.547214396962087,-0.9457467788986595
2015-01-15T09:30:00-05:00,54.85,55.05,54.33,54.37,15614528,11197096,37.9058446826666,46.69449789837885,NaN,NaN,-99.3171730966173,-77.04327953705096,-0.21977773148067964,-0.39291786887518043,-0.1731401373945008,390783311,424291699.2,27.132028785210764,57.832774438825616,NaN,NaN,-12.70068107050231,-2.6250231062706098
2015-01-16T09:30:00-05:00,54.16,54.77,53.89,54.73,16371453,10920684.25,41.667941401070294,45.26250394792981,NaN,NaN,-103.75814264239018,-90.76763628217017,-0.19012995749963327,-0.41080258426904237,-0.2206726267694091,407154764,414771505,23.97417423482149,53.732223538162465,NaN,NaN,-13.38526334047591,-4.162200282585653
2015-01-20T09:30:00-05:00,55.1,55.24,54.525,55.12,11072062,10772265.6,45.51892518052056,44.055332900812466,NaN,NaN,-63.95655169618392,-89.94443897181213,-0.13467966148969962,-0.3890222036315336,-0.254342542141834,418226826,409711616.8,22.47682011998033,49.445092361190994,NaN,NaN,-12.80604543608826,-5.3970353045145965
2015-01-21T09:30:00-05:00,54.96,55.69,54.92,55.57,8943537,10601490.15,49.649414479404605,43.45331324766331,NaN,NaN,-32.629084806000485,-82.50076320509507,-0.061827618673607476,-0.33162706548384335,-0.2697994468102359,427170363,409946620.6,22.71824193102502,45.142716830180404,NaN,NaN,-11.050473020306558,-6.204669263913448
2015-01-22T09:30:00-05:00,55.84,56.58,55.59,56.46,10950899,10799642.1,56.64962178621499,43.8141368286578,NaN,NaN,24.886357097648617,-54.95491902870866,0.04633316717518887,-0.21188298784124981,-0.2582161550164387,438121262,416291305.2,29.134741060519843,41.378569440268,NaN,NaN,-7.175338676236831,-6.343336322816789
2015-01-23T09:30:00-05:00,56.06,56.39,55.94,55.985,10148531,11029425.7,52.45778279343727,43.92913421937821,NaN,NaN,23.94098182397856,-30.303288044589486,0.08373810822010119,-0.1535435197413122,-0.2372816279614134,427972731,423729189.2,35.85811002998743,38.45655494047394,NaN,NaN,-5.268667123445205,-6.189812151477992
2015-01-26T09:30:00-05:00,55.88,56.16,55.6,56.06,6037041,11233366.4,53.04853998521854,44.91431609721402,NaN,NaN,18.932311305325968,-5.765197255046263,0.10974268670473569,-0.10010326958049376,-0.20984595628522945,434009772,429100190.8,40.26538550287215,36.46955430178836,NaN,NaN,-3.5712855958932614,-5.815736929251602
2015-01-27T09:30:00-05:00,55.01,55.64,54.87,55.32,12118532,11552599.7,46.86127361917776,45.77236592555418,NaN,NaN,-29.990649566530056,1.0279831708845073,0.0749770140305665,-0.11612468874702131,-0.1911017027775878,421891240,429833073.6,40.86249689757388,35.36663862580857,NaN,NaN,-4.013496504313674,-5.558274011403327
2015-01-28T09:30:00-05:00,55.75,55.81,54.77,54.84,14674032,12107992.4,43.33092541426155,46.06203934283166,NaN,NaN,-36.81045615224664,0.19170890163528326,0.020365904065915374,-0.16564432269519358,-0.18601022676110895,407217208,425842442.6,38.59989994183607,34.57666393727031,NaN,NaN,-5.502985547682081,-5.550375659443149
2015-01-29T09:30:00-05:00,54.9,55.57,54.53,55.47,14215107,12638609.3,48.784586367178996,46.029458530998106,NaN,NaN,-24.149466447402727,-9.615455807374985,0.026970051925175598,-0.15229766185463944,-0.17926771377981504,421432315,422504653.2,36.766180637417314,33.89365782585571,NaN,NaN,-5.029662973794011,-5.475988132921843
2015-01-30T09:30:00-05:00,54.86,55.24,54.52,54.57,14649998,13092465.1,42.493178068148005,45.856730545702234,NaN,NaN,-70.44064498192593,-28.49178116855588,-0.02610595873662197,-0.2119001622005925,-0.18579420346397052,406782317,418266570.4,34.52355211445689,33.26575287509694,NaN,NaN,-6.730090518422956,-5.65514561656486
2015-02-02T09:30:00-05:00,54.71,55.44,54.21,55.38,19465857,13516618.4,48.882595089991376,46.32187873842474,NaN,NaN,-31.84552326200033,-38.64734808202114,-0.004618298490913775,-0.19156707657761274,-0.18694877808669896,426248174,416714250.8,33.71241353564399,32.7473153779155,NaN,NaN,-5.9798969617495,-5.701538665876951
2015-02-03T09:30:00-05:00,55.75,56.32,55.66,56.28,18896189,13704192,54.88109421322103,47.26794283676436,NaN,NaN,124.996929727611,-7.649832223192922,0.06823212326454264,-0.10165862400602066,-0.1698907472705633,445144363,421364875.4,38.38323536601356,32.70889102188561,NaN,NaN,-3.2230632733036453,-5.347470752652193
2015-02-04T09:30:00-05:00,56.11,56.205,55.68,55.85,10600107,13273705.35,51.75612200441644,48.134846077494885,NaN,NaN,87.38848337388991,17.189955682034388,0.08442378169588025,-0.06436102015071299,-0.14878480184659323,434544256,426830285,43.42819018879851,33.41681931043979,NaN,NaN,-2.0805469734989295,-4.880767355630298
2015-02-05T09:30:00-05:00,56.03,56.4,55.878,56.33,9193851,13144884.15,54.84690415294675,49.34492175394347,NaN,NaN,112.08914096688068,44.43767716489107,0.12213568664630373,0.0038848064612864164,-0.11825088018501731,443738107,431291443.4,47.22644709440545,34.8521349039537,NaN,NaN,-0.12140068349118058,-4.200857831038996
2015-02-06T09:30:00-05:00,56.38,56.68,56.07,56.2,6192209,12883503.9,53.8408419670176,50.21441465151112,NaN,NaN,116.95865740140623,81.9175376415575,0.13215199796081356,0.04693911726599964,-0.08521288069481392,437545898,437444159.6,52.01188692327606,36.854828667414736,NaN,NaN,1.111948232912614,-3.441885536188766
2015-02-09T09:30:00-05:00,55.89,56.31,55.875,56.05,7112087,12730695.8,52.64098546825744,50.723133243492335,NaN,NaN,79.95599930948198,104.27784215585396,0.12270662173556461,0.06817039647464185,-0.05453622526092276,430433811,438281287,52.6411268100348,39.009422002418624,NaN,NaN,1.7516972299629192,-2.6999451410242394
2015-02-10T09:30:00-05:00,56.35,56.46,55.89,56.36,9000366,12619240.7,54.878943036017205,51.096670997536094,NaN,NaN,87.26790803471786,96.73203781727533,0.13063463116959417,0.10875706370106997,-0.021877567468524213,439434177,437139249.8,51.646192838053004,41.07570421006348,NaN,NaN,2.945180513762889,-1.8934986189117926
2015-02-11T09:30:00-05:00,56.25,56.59,56.135,56.38,7058071,12095598.1,55.026601343117726,50.980740965886284,NaN,NaN,90.9672785460385,97.44779685170505,0.130231477545279,0.14091177946307454,0.010680301917795537,446492248,439528848.2,53.621414909456206,42.82475234213037,NaN,NaN,3.9570603463569345,-1.0577044810162604
2015-02-12T09:30:00-05:00,56.57,56.96,56.51,56.91,6249088,11428177.25,58.86799696405243,51.43861340664451,NaN,NaN,125.22645362422054,100.07525938317302,0.15687783096317312,0.20677759062176193,0.04989975965858882,452741336,441329494,55.109499966381975,44.199851623301406,NaN,NaN,5.953483472423801,-0.05610620195339466
2015-02-13T09:30:00-05:00,57,57.275,56.86,57.17,5922379,10943569.8,60.643932458634374,51.98114144045993,NaN,NaN,146.7315587779899,106.02983965848975,0.1814931199412552,0.2767661595851578,0.09527303964390263,458663715,445553057.4,58.47504093983097,45.5005412973699,NaN,NaN,8.1485361414856,1.1159855613950331
2015-02-17T09:30:00-05:00,57.04,57.36,56.98,57.25,4174430,10333718.65,61.199057634827554,53.00526887014921,NaN,NaN,151.02816658026768,120.2442731126469,0.1916441639338447,0.3348282445612085,0.14318408062736382,462838145,452033924.2,63.052498025068964,47.08554137790526,NaN,NaN,10.124958630495305,2.4029817141236434
2015-02-18T09:30:00-05:00,57.3,57.61,57.2,57.57,5806383,10070434.7,63.42159304429408,54.44031655800867,NaN,NaN,166.7175327597217,136.13419805764767,0.2070766083896276,0.4020298411143983,0.19495323272477072,468644528,457875994.4,66.62412495083949,49.08727173569122,NaN,NaN,12.456640421850015,3.8392186723702677
2015-02-19T09:30:00-05:00,57.39,57.805,57.39,57.67,5458042,9896159.95,64.11338204365757,55.5352305349,NaN,NaN,163.492504678788,150.63924328419756,0.21049848258103357,0.4580763359510627,0.2475778533700291,474102570,463398058.8,69.61413088001164,51.43355389587652,NaN,NaN,14.60706001576962,5.377481721427318
2015-02-20T09:30:00-05:00,57.56,58.2199,57.2201,58.16,8557441,9776487.05,67.36986287821381,57.31213659276184,NaN,NaN,158.76195430744377,157.3463434208422,0.2306221039822698,0.5358554833478664,0.3052333793655966,482660011,469381793.8,72.4900984995917,54.1454500662433,NaN,NaN,17.452369633726736,7.102465708898663
2015-02-23T09:30:00-05:00,58.1,58.11,57.805,57.91,6238322,9580976.6,64.17038401418174,58.40412151591829,NaN,NaN,139.1141645287034,155.8228645709849,0.21240843783135083,0.5707439266547851,0.3583354888234343,476421689,472933388.6,74.05947393772446,57.02738295210619,NaN,NaN,19.03051899849743,8.806473321698487
2015-02-24T09:30:00-05:00,57.9,58.195,57.77,58.14,4989250,9528587.05,65.78050917259309,59.182651155873444,NaN,NaN,124.778355005292,150.57290225598976,0.2012688498725717,0.6099215511641489,0.4086527012915772,481410939,476647947.4,75.62564588789544,59.687555132240604,NaN,NaN,20.826858627719577,10.523671222558642
2015-02-25T09:30:00-05:00,58.09,58.23,57.94,58.02,4574121,9151366.5,64.16047874456153,60.06867663731238,NaN,NaN,111.23089842346513,139.47557538873843,0.17235219792749673,0.6240929487009481,0.4517407507734514,476836818,478286405.4,76.30520368729591,62.035913239276134,NaN,NaN,21.920869574038647,12.151842415627215
2015-02-26T09:30:00-05:00,57.97,58.07,57.63,57.76,6443067,8739818.25,60.67386083007252,60.48488782853565,NaN,NaN,83.97063341295846,123.57120113557252,0.12448178689542294,0.60734298439273,0.4828611974973071,470393751,477544641.6,75.28191319825837,64.03987510383705,NaN,NaN,21.945537898281106,13.550941770292056
2015-02-27T09:30:00-05:00,57.71,57.84,57.49,57.49,7201523,8389139.05,57.19777119212879,60.724668487472165,NaN,NaN,61.574502431248234,104.13371076033343,0.06631907710076923,0.5657600438732686,0.4994409667724994,463192228,473651085,69.97714351386438,65.32310771745051,NaN,NaN,21.02522785618685,14.618696925419883
2015-03-02T09:30:00-05:00,57.62,58.025,57.49,58.02,8560219,8084650.1,61.821619963637815,61.380428094285044,NaN,NaN,74.10193503899627,91.131264862392,0.05565731565589893,0.569012611342373,0.5133552956864741,471752447,472717236.6,68.72627047357545,66.47204655056056,NaN,NaN,21.482527776400058,15.599244189845622
2015-03-03T09:30:00-05:00,57.89,57.89,57.42,57.65,7716029,7497158.7,57.17780156177139,61.54463227469606,NaN,NaN,52.49209364221138,76.67401258977588,0.01776438382644807,0.5355607754695342,0.5177963916430861,464036418,469242332.4,64.13233180280612,67.3639136194715,NaN,NaN,20.535241917961162,16.304386722433556
2015-03-04T09:30:00-05:00,57.39,57.46,56.94,57.2,6262449,6865471.7,52.056232282271246,61.332463056064164,NaN,NaN,3.5909231591712536,55.146017536917114,-0.04035600967253394,0.4673513795524187,0.5077073892249526,457773969,465429762.6,59.43787505938832,67.77937505875236,NaN,NaN,18.16800466867865,16.570617857611428
2015-03-05T09:30:00-05:00,57.24,57.3,57.03,57.24,4990963,6585014.5,52.46383018950189,60.8750225721677,NaN,NaN,-4.735753653730783,37.404740123579266,-0.07674518242843503,0.4117759111894088,0.48852109361784385,462764932,463903998.8,57.62011475046762,67.95870468618706,NaN,NaN,16.34961379155083,16.5390458481742
2015-03-06T09:30:00-05:00,56.62,57.07,56.385,56.46,8247154,6537679.65,44.51620754994184,59.723042221546805,NaN,NaN,-75.76693432159533,9.936452773010554,-0.1497616329959351,0.301319052372925,0.4510806853688601,454517778,462169108.8,55.54017891996074,67.74907168476774,NaN,NaN,12.162671948496946,15.913849576791735
2015-03-09T09:30:00-04:00,56.46,57.09,56.46,56.99,6106961,6533417.25,50.05293525866207,58.92689062324928,NaN,NaN,-56.057161416040366,-16.095366517996773,-0.1579652320583439,0.25362414529593025,0.41158937735427414,460624739,459943567.2,52.902045598884705,67.02403936861172,NaN,NaN,10.256685395057586,15.105683265115427
2015-03-10T09:30:00-04:00,56.59,56.59,55.94,55.94,10087774,6682201.6,41.266999342313326,57.34441964453636,NaN,NaN,-147.32995145365962,-56.05977553717097,-0.2255872193272629,0.1296053531951955,0.3551925725224584,450536965,457243676.6,49.81097019564962,65.82309974324103,NaN,NaN,5.413341866612202,13.721063065329252
2015-03-11T09:30:00-04:00,56.06,56.16,55.84,55.88,9394675,6701917.05,40.82599597716335,55.681034925501066,NaN,NaN,-166.7357017683579,-90.12510052267679,-0.26321299880193855,0.026176324020035224,0.28938932282197377,441142290,453917340.8,46.22720631198844,64.15260513123937,NaN,NaN,1.523971425879379,11.978621402550699
2015-03-12T09:30:00-04:00,55.99,56.645,55.98,56.6,8721199,6785073.45,48.00648642234559,54.29793660722476,NaN,NaN,-110.27240258009371,-111.23243030794939,-0.22968763737602438,0.0022797761019432983,0.23196741347796768,449863489,451337052.2,43.60630565734583,62.08947707107895,NaN,NaN,0.5418826582140324,10.344801581931176
2015-03-13T09:30:00-04:00,56.5,56.545,55.745,56.08,11110506,7028144.35,43.866388938522796,52.8476512446777,NaN,NaN,-133.84422739794448,-122.84788892321922,-0.23193397265154675,-0.057950052336465774,0.17398392031508098,438752983,448184093.2,40.578787863886305,59.69799949437623,NaN,NaN,-1.6696139268986048,8.628456509241207
2015-03-16T09:30:00-04:00,56.31,57.04,56.31,57.01,11142282,7289139.5,51.86217867218654,51.853484780362955,NaN,NaN,-50.769530488991236,-121.79036273780937,-0.16341932082486904,-0.03029023071600534,0.1331290901088637,449895265,446038198.4,38.613822098073406,57.05429779510323,NaN,NaN,-0.7738070706411214,7.285275997829446
2015-03-17T09:30:00-04:00,56.71,56.94,56.58,56.78,8362080,7498522,49.96657502271962,50.8396345145171,NaN,NaN,-48.75210016988751,-102.07479248105497,-0.12780072875450296,-0.02662182083426501,0.10117890792023795,441533185,444237442.4,36.99488945918772,54.24641820738121,NaN,NaN,-0.7057140718833552,6.143705987870475
2015-03-18T09:30:00-04:00,56.53,57.63,56.25,57.45,20049506,8210678.15,55.11346102372437,50.442463099777946,NaN,NaN,-8.217301985846621,-70.3711125245527,-0.056940753941911976,0.030002965492847977,0.08694371943475995,461582691,448325522.6,42.85264620435812,51.93004199353119,NaN,NaN,1.112675546018343,5.42498735332017
2015-03-19T09:30:00-04:00,57.33,57.35,56.845,57.06,10568565,8466204.3,51.77476456477858,50.05510548353864,NaN,NaN,-8.25004899078789,-49.966641806691534,-0.03522370428632618,0.042914089076852235,0.07813779336317841,451014126,448555650,43.17293693731148,50.0154558094917,NaN,NaN,1.4849861077191056,4.862130032520018
2015-03-20T09:30:00-04:00,57.06,57.31,56.9538,57.12,10878007,8582232.6,52.25397667468905,49.37170239147087,NaN,NaN,1.2203992395066723,-22.95371647920131,-0.01664870102611274,0.0573269170805375,0.07397561810665024,461892133,453183480,49.323926058107936,48.629574065529724,NaN,NaN,1.9267678710764224,4.442792580885219
2015-03-23T09:30:00-04:00,57.22,57.22,56.64,56.64,7219230,8631278,48.133254581630354,48.7256633214608,NaN,NaN,-30.322490281419864,-18.864308437687043,-0.035440396643820565,0.029675122301874524,0.06511551894569509,454672903,454139007.6,50.514933373712545,47.6569027491659,NaN,NaN,1.0189759375318832,3.9536759175490284
2015-03-24T09:30:00-04:00,56.52,56.755,56.35,56.45,12607400,9012185.5,46.56781299013035,48.33363337202216,NaN,NaN,-64.6658939544435,-22.04706719459825,-0.05807982512893604,-0.007484262465474956,0.05059556266346108,442065503,454245471.2,50.65409042622225,47.029489561082606,NaN,NaN,-0.19409956372117038,3.3611365630818573
2015-03-25T09:30:00-04:00,56.6,56.6,55.49,55.49,9037266,9235342.75,39.5659233548572,47.41235431240468,NaN,NaN,-142.81246605766907,-48.96610000896275,-0.13095136725108958,-0.11309364640040087,0.017857720850688694,433028237,448534580.4,43.575303017922785,46.0262887230437,NaN,NaN,-3.588641814794021,2.3683110805281604
2015-03-26T09:30:00-04:00,55.22,55.54,54.95,55.34,10123997,9419389.25,38.589576480035575,46.98902352169709,NaN,NaN,-194.24099925361767,-86.1642900615287,-0.17949660604361098,-0.20651303670382504,-0.027016430660214058,422904240,442912603.2,37.952479979126416,44.7700245129841,NaN,NaN,-6.610317728008197,1.0856498221658237
2015-03-27T09:30:00-04:00,55.25,55.63,55.2,55.55,4969410,9307783.6,40.792367267085396,46.32755437944161,NaN,NaN,-146.5302883270745,-115.71442757484492,-0.18686629950526365,-0.2605993050417936,-0.07373300553652998,427873650,436108906.6,32.48876813558046,43.31193326560523,NaN,NaN,-8.436699199155969,-0.27468575230871806
2015-03-30T09:30:00-04:00,55.8,56.4875,55.71,56.33,5838035,9171674.4,48.22153736108594,46.82430709506822,NaN,NaN,-50.16135085738263,-119.68219969003749,-0.13123965287549183,-0.23778257163089478,-0.10654291875540295,433711685,431916663,29.655789066671687,41.87227747067823,NaN,NaN,-7.7297218689525815,-1.33969091182927
2015-03-31T09:30:00-04:00,55.9,56.9043,55.74,55.77,6532240,9112484.95,43.957028343575075,47.047952264097646,NaN,NaN,-48.02673586362469,-116.35436807187372,-0.12426070925305238,-0.2618688053217184,-0.13760809606866603,427179445,428939451.4,27.801704977622194,40.55617023250921,NaN,NaN,-8.481863615009047,-2.360001297997809
2015-04-01T09:30:00-04:00,55.64,55.64,55.07,55.4,8788853,9238805.15,41.354761174837115,46.572829032132745,NaN,NaN,-136.11063369044342,-115.01400159842858,-0.13573047975272776,-0.30727119575957573,-0.17154071600684798,418390592,426011922.4,26.07536426063841,39.30396013274439,NaN,NaN,-9.921448711502642,-3.4402080713556424
2015-04-02T09:30:00-04:00,55.26,55.76,55.25,55.43,6565718,9317542.9,41.65635422912717,46.41496941003306,NaN,NaN,-108.83253189293629,-97.93230812629231,-0.13232585978479736,-0.3369480407378447,-0.20462218095304732,424956310,426422336.4,26.761954262651244,38.317043446941895,NaN,NaN,-10.980183082535808,-4.517347358667094
2015-04-06T09:30:00-04:00,55.03,56.06,55.0249,55.85,8204929,9315431.65,45.85455516699342,45.98585344537641,NaN,NaN,-78.76915083366454,-84.38008062761033,-0.09458624955108624,-0.3228549928919051,-0.22826874334081887,433161239,427479854.2,28.602065726539593,37.60191799183233,NaN,NaN,-10.641671588342408,-5.392250820049282
2015-04-07T09:30:00-04:00,55.88,56.14,55.72,55.72,5257212,9272944.2,44.780474030484946,45.61541766021679,NaN,NaN,-46.4691024147748,-83.64163093908874,-0.07218863923243446,-0.31850454238136194,-0.24631590314892748,427904027,426318322.6,27.776571482427585,36.943466707778036,NaN,NaN,-10.668419556619561,-6.145989210987893
2015-04-08T09:30:00-04:00,55.7,55.98,55.59,55.91,6526776,9094894.3,46.74391903299943,45.01759323230787,NaN,NaN,-47.464557275703584,-83.52919522150454,-0.039995032047083434,-0.2963096932077818,-0.25631466116069834,434430803,427768594.2,30.474699311004926,36.05932764396709,NaN,NaN,-10.139182955866227,-6.716445460256226
2015-04-09T09:30:00-04:00,55.7,56.28,55.64,56.18,8191222,9034721.65,49.49230944227737,44.854560723557775,NaN,NaN,-21.109624440859672,-60.52899337158779,0.00184744398185116,-0.2540053561833844,-0.25585280016523554,442622025,432614880.8,38.71399631206201,35.740831885020704,NaN,NaN,-8.913805462068808,-7.030354031943738
2015-04-10T09:30:00-04:00,56.63,57.06,56.53,56.97,9486382,9072980.8,56.55677466566722,45.161903437199086,NaN,NaN,79.36700815075174,-22.889085362850185,0.08072516682410025,-0.15494634163511023,-0.23567150845921048,452108407,438045300.2,46.381761209401695,35.53067725297026,NaN,NaN,-5.623225131491469,-6.829335617593414
2015-04-13T09:30:00-04:00,56.81,56.99,56.395,56.43,6388685,8836889.75,51.277216547759245,45.38647214906543,NaN,NaN,44.00316169896403,1.6653771436755236,0.09361948244461882,-0.11864715540343695,-0.21226663784805577,445719722,440556996.8,49.5272145498217,35.460125908406624,NaN,NaN,-4.374591242407943,-6.4786578497097755
2015-04-14T09:30:00-04:00,56.21,56.535,55.9,56.5,5845682,8572059.75,51.90399051317948,45.76762768642608,NaN,NaN,12.01908223390788,13.363014073412064,0.10319613258891067,-0.08327147211191743,-0.1864676047008281,451565404,445289272.2,54.895969388862525,35.76311726288093,NaN,NaN,-3.1819309384167203,-6.007696862382196
2015-04-15T09:30:00-04:00,56.52,56.83,56.52,56.6,7345353,8521223.4,52.837381094824394,46.7155889535666,NaN,NaN,56.329458738261415,34.121817276205064,0.11187063551526363,-0.04662931030674855,-0.15849994582201218,458910757,450185263,59.67506029829181,36.913099925764435,NaN,NaN,-1.93315706758614,-5.425619748839902
2015-04-16T09:30:00-04:00,56.27,56.67,56.27,56.48,7164619,7876979.05,51.544662489408644,47.64095223995039,NaN,NaN,40.472869510280866,46.438316066433174,0.10523009641824818,-0.02696232529920195,-0.13219242171745013,451746138,452010085.6,61.32011322070948,38.58221658587751,NaN,NaN,-1.2382386764862452,-4.82742245278938
2015-04-17T09:30:00-04:00,56.21,56.21,55.595,55.8,11304081,7913754.85,44.848540186402666,47.930678877044485,NaN,NaN,-37.009897350302076,23.162934966222412,0.05336076130160021,-0.06549147009044987,-0.11885223139205008,440442057,449676815.6,58.05872377048297,40.40864198837055,NaN,NaN,-2.5631400174964076,-4.503953533461813
2015-04-20T09:30:00-04:00,56,56.58,56,56.45,6734927,7706600.85,51.353972801461424,48.15442426564273,NaN,NaN,42.84635145343303,22.93157291711621,0.06061784223277525,-0.04307992860108101,-0.10369777083385626,447176984,449968268,58.356666316770614,42.4587046490919,NaN,NaN,-1.7440878588992452,-4.109687008524303
2015-04-21T09:30:00-04:00,56.54,56.72,56.135,56.38,8007659,7746022.3,50.66092742107579,48.63327419974993,NaN,NaN,60.44608913521213,32.61697429737706,0.058466908826632774,-0.030614134800565296,-0.08908104362719807,439169325,447489052.2,54.79107099213792,44.386516507271594,NaN,NaN,-1.2862619026602315,-3.7063405648294356
2015-04-22T09:30:00-04:00,56.42,56.68,56.02,56.62,13779315,7804618.05,53.00277038451226,49.46527485758386,NaN,NaN,66.6275303701993,34.67658862376463,0.07018218765239939,-0.0013533090616988375,-0.07153549671409823,452948640,446296628.8,53.1102526190439,46.317579961443414,NaN,NaN,-0.22011966174797087,-3.208309007246369
2015-04-23T09:30:00-04:00,56.33,56.7999,56.31,56.56,7345195,7720014.5,52.33400246804279,50.2279640175064,NaN,NaN,78.32973386246734,42.24796149420193,0.07066914684997985,0.01680093684837658,-0.053868210001603266,445603445,445068090.2,51.362032172195185,48.0747283835537,NaN,NaN,0.47342940945572815,-2.6823463762889266
2015-04-24T09:30:00-04:00,56.52,56.58,56.165,56.32,5148274,7471228.35,49.636141596654575,50.49807733391078,NaN,NaN,39.237881738866406,57.49751731203562,0.05244463685975803,0.01168758607309428,-0.04075705078666375,440455171,445070713,51.365712796040235,49.700703174232316,NaN,NaN,0.32555732881042426,-2.2526458469890196
2015-04-27T09:30:00-04:00,56.4,56.54,56.225,56.3,8308560,7638185.85,49.40756462032606,50.82858380461372,NaN,NaN,33.90599537967854,55.70944609728472,0.037367853516312846,0.005952766108727303,-0.03141508740758554,432146611,442064638.4,46.977800338885444,51.072219521122165,NaN,NaN,0.1420632874334412,-1.9105445420715252
2015-04-28T09:30:00-04:00,56.15,56.415,55.79,56.4,8348799,7763724.05,50.63172167090873,51.1062839930358,NaN,NaN,2.5867729070736782,44.13758285165703,0.03262730491074809,0.009369043730849569,-0.023258261179898522,440495410,442329855.4,47.40469224781616,52.28150473089439,NaN,NaN,0.3023291312704126,-1.5944197315941055
2015-04-29T09:30:00-04:00,56.63,56.63,55.79,56.12,9978698,7936046.95,47.188755236102224,50.94174440688044,NaN,NaN,-2.2455879540108796,30.362959186814997,0.010288738905598765,-0.010397337547900065,-0.02068607645349883,430516712,437843469.8,41.34119564296484,52.469161825958885,NaN,NaN,-0.46858075115132575,-1.4335855915308513
2015-04-30T09:30:00-04:00,55.86,56.11,55.435,55.63,12970723,8145140.45,41.828285053707134,49.88970943459758,NaN,NaN,-105.43438539593716,-6.389864664865902,-0.03533405845150971,-0.06485364951788597,-0.029519591066376256,417545989,432231978.6,35.265234892550254,51.67512423189806,NaN,NaN,-2.700865644636153,-1.614625599117323
2015-05-01T09:30:00-04:00,55.89,56.36,55.81,56.33,11017898,8367749.45,50.48219534165975,49.83292220559047,NaN,NaN,-19.00058765558612,-18.03755854375641,-0.01713578509436972,-0.05093932243433841,-0.03380353733996869,428563887,429853721.8,33.048332258019656,50.49806121105506,NaN,NaN,-2.141697164345753,-1.6899215370070988
2015-05-04T09:30:00-04:00,56.35,56.74,56.35,56.42,6096265,8262316.25,51.4815882198036,49.80275061320647,NaN,NaN,59.71594843219479,-12.875567933253137,0.0012205963979268902,-0.03227779184256008,-0.03349838824048697,434660152,430356430,33.99289847082247,49.00498471690934,NaN,NaN,-1.391317335857477,-1.6472637939857242
2015-05-05T09:30:00-04:00,56.23,56.52,55.6,55.66,10026905,8500800.9,43.497972127951854,49.135649972715576,NaN,NaN,-101.31778917607676,-33.656480349883225,-0.03553399107514229,-0.07791587708441483,-0.04238188600927254,424633247,427183997.4,31.018788913336877,46.958108189412556,NaN,NaN,-3.255376827081541,-1.8769942272851265
2015-05-06T09:30:00-04:00,55.92,55.98,55.32,55.63,8247719,8586848.05,43.21309640479866,48.54053810952915,NaN,NaN,-170.072123944222,-67.22178754792544,-0.05823644626905301,-0.11517744384558881,-0.0569409975765358,416385528,424357760.6,28.616699675151267,44.62215007901555,NaN,NaN,-4.8216452653074855,-2.2976586612883207
2015-05-07T09:30:00-04:00,55.46,56.05,55.46,55.92,10668317,8710702.8,46.837630474687,48.68261598726375,NaN,NaN,-116.33523255302968,-69.40195697934396,-0.05038681190741576,-0.11992451246080549,-0.06953770055338973,427053845,426259331.8,32.40932393053755,42.79005009044802,NaN,NaN,-5.065854994365148,-2.693115280299296
2015-05-08T09:30:00-04:00,56.52,56.74,56.36,56.58,7025140,8587640.7,54.02909972213523,48.873696481597584,NaN,NaN,81.09031838167019,-49.383775771892694,-0.00007183315976264093,-0.06962749200309304,-0.0695556588433304,434078985,427362351.4,34.58055174474768,41.09175619244638,NaN,NaN,-2.978591612856363,-2.733897613521734
2015-05-11T09:30:00-04:00,56.56,56.765,56.48,56.53,5169762,8526694.55,53.439326532359836,49.072153560975025,NaN,NaN,89.85869037364853,-43.35522738360195,0.02891162884286802,-0.03341612278974537,-0.06232775163261339,428909223,426212165.6,33.37654361618955,39.56214709416436,NaN,NaN,-1.492378502039256,-2.5565377404528085
2015-05-12T09:30:00-04:00,56.36,56.66,56.1,56.47,7542420,8611531.45,52.69596415054473,49.05023882997734,NaN,NaN,39.63332705139671,-15.165004138107253,0.042301476350261866,-0.009450906194786057,-0.05175238254504792,421366803,425558876.8,32.680544514355276,38.102882229543745,NaN,NaN,-0.49498294876825627,-2.262029913069301
2015-05-13T09:30:00-04:00,56.68,56.97,56.51,56.59,7704328,8629480.2,54.07200636062062,49.174381965161466,NaN,NaN,111.69737736529599,41.18889612379635,0.05660639632440713,0.019005612860460985,-0.037600783463946144,429071131,428095997.4,38.080787772957486,37.154221915312476,NaN,NaN,0.7270665728042032,-1.8350161293730862
2015-05-14T09:30:00-04:00,56.84,57.22,56.79,57.16,8698422,8706170.35,60.02100329367228,49.91615780066274,NaN,NaN,182.83990705244446,101.02392404489117,0.09932390974044171,0.08655410371160599,-0.012769806028835717,437769553,430239139,42.291964408600194,36.50609703049533,NaN,NaN,3.6475759541956423,-1.051788688863268
2015-05-15T09:30:00-04:00,57.14,57.27,56.94,57.11,6266250,8454278.8,59.29545304552531,50.62243554531983,NaN,NaN,178.6994652440177,120.54575341736067,0.11781723279341955,0.1345017349629387,0.01668450216951917,431503303,429724002.6,41.56029861660468,36.11913262176099,NaN,NaN,5.821836264803302,-0.06984226691090079
2015-05-18T09:30:00-04:00,57.26,57.29,56.98,57.22,6643755,8449720.2,60.42876942243073,51.32222467042853,NaN,NaN,162.04204778793533,134.98242490021804,0.130100148979499,0.17930968839389294,0.04920953941439393,438147058,431571569.6,45.22074188420454,35.9631361672173,NaN,NaN,7.961922747996589,1.0775527352187404
2015-05-19T09:30:00-04:00,57.01,57.29,56.98,57.06,6186887,8358681.6,57.90340352147778,52.087556690812505,NaN,NaN,129.89228277714167,153.03421604536703,0.12031931790710178,0.19960868679827115,0.07928936889116937,431960171,433690243.2,49.15381993611463,36.52118075958514,NaN,NaN,9.099674440880078,2.2235701217417887
2015-05-20T09:30:00-04:00,57.1,57.13,56.76,56.85,7064403,8022936,54.67383786758855,53.005096177518325,NaN,NaN,82.38681696820613,147.17210396594902,0.09375696957128948,0.19648558085528123,0.10272861128399174,424895768,432855170.6,47.70010057043265,37.409385450862466,NaN,NaN,9.196338341912387,3.2196798674804454
2015-05-21T09:30:00-04:00,56.78,57.28,56.78,57.16,6276681,7969510.3,58.365488404493355,53.56818853914929,NaN,NaN,99.43714821763696,130.49155219898753,0.09104022760519795,0.21652889579048917,0.12548866818529122,431172449,431535749.8,45.414694010356044,38.292697004600775,NaN,NaN,10.323244484067109,4.234474812707111
2015-05-22T09:30:00-04:00,57.13,57.19,56.88,56.9,5835258,8003859.5,54.36607796566379,53.77422352099644,NaN,NaN,76.98666666666786,110.14899248351757,0.0668282983782203,0.2090240411580666,0.1421957427798463,425337191,430302527.4,43.325262502657864,38.95929443544617,NaN,NaN,10.15881086198433,5.080808534032428
2015-05-26T09:30:00-04:00,56.81,56.81,56.1444,56.28,7889870,7982925,46.23076991109658,53.96942336264964,NaN,NaN,-16.139763034321348,74.51263031906623,0.007286157361154233,0.1513034394812891,0.14401728212013487,417447321,426162580,37.14666776031278,39.397000067373014,NaN,NaN,7.454076266029482,5.419846781460579
2015-05-27T09:30:00-04:00,56.47,56.71,56.29,56.64,5498942,7840432.15,50.83151644730747,54.51359622282884,NaN,NaN,2.972116327560105,49.12859702914992,-0.00875427461030806,0.1330744388572498,0.14182871346755785,422946263,424359798.4,34.818111695720276,39.83995806884223,NaN,NaN,6.575819643978334,5.584985761820258
2015-05-28T09:30:00-04:00,56.5,56.54,56.16,56.37,5775316,7630263.05,47.545640672971,54.56416837984913,NaN,NaN,-31.060009594401357,26.439231716628427,-0.03687298761312591,0.09573747895115048,0.13261046656427639,417170947,422814834.2,32.91393754591769,39.876001898512236,NaN,NaN,4.807330651619492,5.47389217464872
2015-05-29T09:30:00-04:00,56.32,56.34,55.7,55.81,11798984,7571676.1,41.54683292027594,53.67257789400203,NaN,NaN,-106.06004267261497,-14.660206461421936,-0.08951118528134124,0.020721484962599845,0.11023267024394108,405371963,417654737,27.50369599613633,39.37051220218285,NaN,NaN,1.2543713312471743,4.871103482734213
2015-06-01T09:30:00-04:00,55.99,56.25,55.67,56.06,8712908,7456426.6,44.88973317980661,53.06189265453394,NaN,NaN,-94.51778202280602,-48.961096199316714,-0.10286201782439189,-0.018344852036548787,0.0845171657878431,414084871,415404273,25.532503295604016,38.81022360785532,NaN,NaN,-0.5967818793157437,4.089977002441362
2015-06-02T09:30:00-04:00,55.87,56.406,55.73,56.17,6126842,7457955.45,46.34376179445056,52.60816391481293,NaN,NaN,-68.36197298853078,-59.405538190158595,-0.09958844791562964,-0.03996839410669395,0.05962005380893569,420211713,415957151.4,26.918266733185632,38.398632337771765,NaN,NaN,-1.6452418423055812,3.27066002462037
2015-06-03T09:30:00-04:00,56.31,56.635,56.13,56.45,7916980,7352459.2,49.96272462569951,52.31464379088999,NaN,NaN,-24.31552881266943,-64.8630672182045,-0.07499064549572333,-0.03411825306071847,0.04087239243500486,428128693,416993637.4,29.564525377640905,37.790327880963446,NaN,NaN,-1.4283110892131625,2.5993784369298654
2015-06-04T09:30:00-04:00,56.16,56.33,55.73,55.82,10183350,7449240.75,42.94434180061071,51.0948822556713,NaN,NaN,-109.44213706502663,-80.53949271232958,-0.09621983992960789,-0.079402407477005,0.016817432452602886,417945343,417148516.6,29.972568430660317,36.91037102539631,NaN,NaN,-3.5217995419549055,1.7249244399463266
2015-06-05T09:30:00-04:00,55.71,55.925,55.5,55.86,9071843,7369417.05,43.487144894017945,49.96571738770649,NaN,NaN,-144.224281904697,-88.17234055874597,-0.10208249948686735,-0.11078569190598131,-0.008703192419113957,427017186,421477561.2,40.37075285539255,36.82540347102401,NaN,NaN,-5.010706038645118,0.7626915144332632
2015-06-08T09:30:00-04:00,55.77,55.86,55.44,55.45,6920477,7364183.9,39.354341091649914,48.460401078365,NaN,NaN,-148.51565655350157,-98.97191546488509,-0.12649166443357995,-0.1668177729610889,-0.040326108527508946,420096709,422679928.8,42.90649959994075,36.66010045071946,NaN,NaN,-7.602436376772576,-0.4323267557389995
2015-06-09T09:30:00-04:00,55.39,55.68,55.3,55.44,5631723,7387281.95,39.25634819022806,47.12846855470432,NaN,NaN,-142.750685208344,-113.84965790884773,-0.13543048527520807,-0.209614215121519,-0.07418372984631096,414464986,421530583.4,41.10696602079685,36.0853251710539,NaN,NaN,-9.697006512563794,-1.7558524352853984
2015-06-10T09:30:00-04:00,55.64,56.14,55.58,55.99,7293460,7374833.95,47.06368711092385,46.5848863577997,NaN,NaN,-72.7648630464714,-123.53952475560814,-0.09815764117431067,-0.19688078131419928,-0.09872314013988862,421758446,420256534,39.14696904571695,35.47438720500278,NaN,NaN,-9.15716919862217,-2.813183401476366
2015-06-11T09:30:00-04:00,56.14,56.34,56.05,56.31,5256705,7252452.8,51.00907533486891,46.05942828139795,NaN,NaN,-24.150762551803126,-106.48124985296343,-0.04832846639296243,-0.15913372313109164,-0.11080525673812922,427015151,422070495.6,43.292738584507326,35.3228189602993,NaN,NaN,-7.458858590406568,-3.4768512856092517
2015-06-12T09:30:00-04:00,56.01,56.17,55.83,55.98,7799261,7207494.75,47.109700011353944,45.541115570375815,NaN,NaN,-52.34845052445136,-88.1060835769143,-0.03461268560923492,-0.15407111374967286,-0.11945842814043794,419215890,420510236.4,40.72284912340048,35.13693229035234,NaN,NaN,-7.233158629849322,-4.01346662050069
2015-06-15T09:30:00-04:00,55.56,55.73,55.25,55.51,8872425,7337803.5,42.16573015066792,45.25075558748806,NaN,NaN,-113.93870905562392,-81.19069407733878,-0.05310666806599515,-0.1858417632229319,-0.13273509515693674,410343465,418559587.6,37.70906484535597,35.17710351071257,NaN,NaN,-8.627495602149303,-4.672613617879064
2015-06-16T09:30:00-04:00,55.44,55.65,55.33,55.56,7514411,7381336.3,42.85282559266051,44.680849097870414,NaN,NaN,-103.63589291763054,-73.36773561919608,-0.057513394970750725,-0.20462683887037514,-0.1471134438996244,417857876,419238165.6,39.389520669294214,35.503632723110705,NaN,NaN,-9.527655376097158,-5.36619101191022
2015-06-17T09:30:00-04:00,55.59,55.83,55.26,55.71,10321010,7588042.45,44.96521987981452,44.49653332693067,NaN,NaN,-84.95428867302138,-75.80562074450609,-0.0463466440622165,-0.20504674897739505,-0.15870010491517855,428178886,420522253.6,42.54806243905103,36.191784501191655,NaN,NaN,-9.649168099338024,-5.978044881542763
2015-06-18T09:30:00-04:00,55.58,56.47,55.58,56.27,9470346,7708339.6,52.085950418824936,45.24932743396988,NaN,NaN,6.3460534429996605,-69.70625754554553,0.00026675703849304844,-0.15836665861706223,-0.15863341565555528,437649232,422649069.8,47.43416243012998,37.615389246476916,NaN,NaN,-7.519290644323591,-6.19822284765431
2015-06-19T09:30:00-04:00,55.88,56.09,55.72,55.72,8899766,7839493.85,45.816003487964,45.31548959883826,NaN,NaN,-36.537632629607636,-66.54409396657677,-0.004184334577612303,-0.16386383387757064,-0.15967949929995834,428749466,424555785,51.42285199000134,39.4646998675053,NaN,NaN,-7.682272206708841,-6.410229898947814
2015-06-22T09:30:00-04:00,56.03,56.2,55.94,56.06,4913253,7793393.6,49.83609140119228,45.56494171360553,NaN,NaN,26.421665453784644,-38.47201906469506,0.01639893037522308,-0.13918083633092948,-0.15557976670615256,433662719,429219635.8,59.51500740569048,41.793038486969934,NaN,NaN,-6.509657416967103,-6.4244338300934265
2015-06-23T09:30:00-04:00,56.14,56.17,55.84,55.92,3837368,7590768.5,48.24870031560824,45.44251140574187,NaN,NaN,9.390727359627327,-15.866695009243482,0.02092438115636125,-0.129424290260701,-0.15034867141706226,429825351,431613130.8,62.928111049424544,44.1761517492402,NaN,NaN,-6.056597591132544,-6.371885795956158
2015-06-24T09:30:00-04:00,55.8,55.89,55.39,55.4,5976608,7614651.8,42.79609460986572,45.431922320688656,NaN,NaN,-95.96612734815132,-18.069062744269466,-0.009150529649600475,-0.16178683347906286,-0.1526363038294624,423848743,430747102.2,60.92665016785207,46.387157587611036,NaN,NaN,-7.415934705471453,-6.521035640172628
2015-06-25T09:30:00-04:00,55.35,55.57,54.965,54.97,8323286,7742050.3,38.88293707185071,45.10305033339099,NaN,NaN,-176.27628422241906,-54.59353027735322,-0.05357125460545678,-0.21960037208628336,-0.16602911748082658,415525457,426322347.2,51.85236082944261,47.20727244290032,NaN,NaN,-9.85127510000417,-6.996784134434277
2015-06-26T09:30:00-04:00,55.13,55.24,54.95,55.07,6424779,7473340.05,40.251197068316,45.167111474581425,NaN,NaN,-163.1881926794832,-79.92364228732832,-0.07070958859294357,-0.25441610322200603,-0.18370651462906246,421950236,424962501.2,49.416446461495774,47.67226864729711,NaN,NaN,-11.373794699370466,-7.62207135799659
2015-06-29T09:30:00-04:00,54.63,54.84,54,54.03,13132849,7694337.1,32.18189771395929,44.66179358341937,NaN,NaN,-263.4281843448617,-137.89361224705758,-0.14244040397848284,-0.361757019602166,-0.21931661562368315,408817387,419993434.8,41.70626594607448,47.71507578481693,NaN,NaN,-15.659356454636905,-8.77025494323092
2015-06-30T09:30:00-04:00,54.57,54.57,53.97,54.06,12494934,8012741.7,32.60163637957828,43.628789959751835,NaN,NaN,-227.27333735991274,-185.22642519096559,-0.17601893042184397,-0.4393402786509881,-0.26332134822914416,421312321,418290828.8,39.4358358893191,47.73570913078852,NaN,NaN,-18.81507289969539,-10.205228937011558
2015-07-01T09:30:00-04:00,54.6,54.7,54.06,54.33,10981592,8165972.3,36.41588641202989,42.586419322406186,NaN,NaN,-170.3087062088173,-200.0949409630988,-0.16820667738322503,-0.4735796949581754,-0.3053730175749504,432293913,419979862.8,42.764581434463395,47.6979836200711,NaN,NaN,-20.20605302888946,-11.633918092994115
2015-07-02T09:30:00-04:00,54.48,54.52,54.125,54.23,10477834,8180696.5,35.61203185400581,41.76515731116704,NaN,NaN,-146.68563974861468,-194.1768120683379,-0.15809017542143833,-0.5029857368517483,-0.34489556143030997,421816079,421237987.2,45.181499345425095,48.01645863593,NaN,NaN,-21.56939891758244,-13.053272496506732
2015-07-06T09:30:00-04:00,53.86,54.3799,53.77,54.02,10782511,8266229.9,33.91874570847685,41.17608699386768,NaN,NaN,-144.4218529136698,-190.42354411517525,-0.15371936215668958,-0.537044764126172,-0.3833254019694824,411033568,419054653.6,41.87666058553182,48.31414404594256,NaN,NaN,-23.210851701590325,-14.504355240090103
2015-07-07T09:30:00-04:00,53.94,54.49,53.4468,54.46,16635985,8752005.3,40.32153634567094,40.99528061908271,NaN,NaN,-115.51503782472906,-160.8409148111487,-0.11134712150646664,-0.5225093038525657,-0.411162182346099,427669553,422825086.8,48.83659168693322,48.988934832916776,NaN,NaN,-22.698327223195744,-15.674922666248051
2015-07-08T09:30:00-04:00,53.92,54.08,53.35,53.48,12608911,9100864.7,32.71771263310298,40.12045867288902,NaN,NaN,-139.4664522950266,-143.27953779817148,-0.13774484526066794,-0.583343238921934,-0.445598393661266,415060642,421574751,46.83380841268404,49.295059545319134,NaN,NaN,-24.79345900265904,-16.977570714306765
2015-07-09T09:30:00-04:00,54.01,54.26,53.61,53.61,8918189,9182101.15,34.48274479306694,38.86308684247774,NaN,NaN,-106.72660073405345,-130.56311670321872,-0.13471088290571465,-0.6139869972934093,-0.4792761143876947,423978831,419911734.6,44.23536776971115,49.06657421243208,NaN,NaN,-25.873092792330098,-18.248359582595814
2015-07-10T09:30:00-04:00,54.14,54.37,53.96,54.17,8348005,9336666.15,41.590970707022244,38.56129878669619,NaN,NaN,-68.95343275315152,-115.01667530412608,-0.08564012641113528,-0.5863262724016138,-0.5006861459904786,432326836,422013886,48.1513685175852,48.832896821545205,NaN,NaN,-24.44258638904455,-19.133249126374206
2015-07-13T09:30:00-04:00,54.53,54.8,54.53,54.77,6754573,9284431.75,48.089414427243256,38.43653614569984,NaN,NaN,-18.44522813858806,-89.82135034910974,-0.0075388716477731155,-0.5101097355501949,-0.5025708639024218,439081409,427623454.2,56.85773576915655,48.643091704649926,NaN,NaN,-20.996637315867545,-19.39944743915897
2015-07-14T09:30:00-04:00,54.71,55.01,54.61,54.92,9130440,9297332.5,49.59911975213685,38.53299467688045,NaN,NaN,-2.3498120833303653,-67.18830520083,0.05596317408084828,-0.43261689630136146,-0.48858007038220974,448211849,431731913.4,61.90341831842247,48.5698993667212,NaN,NaN,-17.780384983625147,-19.168152802654138
2015-07-15T09:30:00-04:00,54.93,54.94,54.58,54.69,7249235,9284073.7,47.32632458493503,38.85658253224254,NaN,NaN,-9.478475123793993,-41.190709766583474,0.08260757260629575,-0.38532060462434004,-0.4679281772306358,440962614,436912307.8,67.12447300668322,49.012600998066304,NaN,NaN,-15.855234346632521,-18.694878737508194
2015-07-16T09:30:00-04:00,55,55.11,54.8401,54.94,8273040,9181675.2,50.00786805800448,39.651220459824955,NaN,NaN,16.892759785202923,-16.466837662732203,0.11519776778231094,-0.3239309675027471,-0.439128735285058,449235654,441963672.4,71.26048877152667,50.39889585107231,NaN,NaN,-13.434311662544186,-17.94336915537048
2015-07-17T09:30:00-04:00,55.03,55.15,54.775,54.92,5506049,8983460.35,49.78949271971897,40.33252729206803,NaN,NaN,23.709423197474635,2.0657335273930215,0.13231291298015302,-0.27373759405986675,-0.40605050704001977,443729605,444244226.2,72.91710113839711,52.07751404227955,NaN,NaN,-11.551164394702834,-17.030197046703673
2015-07-20T09:30:00-04:00,54.92,55.05,54.8401,54.93,5163093,8796626.7,49.9072789606138,41.598625952543344,NaN,NaN,30.364688263060337,11.8277168077227,0.14044435448219483,-0.23049506393727626,-0.3709394184194711,448892698,446206484,74.29031657179283,54.40494622983086,NaN,NaN,-9.979329050972954,-16.02293019017071
2015-07-21T09:30:00-04:00,54.52,54.71,54.28,54.34,7287449,8915336.5,43.43345319116267,42.372327153370804,NaN,NaN,-24.282087644662827,7.441261695456211,0.10390802156743151,-0.2410543914601817,-0.3449624130276132,441605249,444885164,71.65562112603209,56.70635946102465,NaN,NaN,-10.41932129201051,-15.222414633290683
2015-07-22T09:30:00-04:00,54.25,54.52,53.96,54.1,7549157,9100925.95,41.09804808994026,42.706767273221544,NaN,NaN,-53.018551958615156,-1.2667536715080203,0.06338944288823178,-0.2657256094173235,-0.32911505230555527,434056092,443503859.6,68.90448687039664,58.573495563591315,NaN,NaN,-11.475420137477903,-14.687129705317428
2015-07-23T09:30:00-04:00,53.91,54.195,53.465,53.6,11547981,9379494.6,36.67382044269222,42.78260931527058,NaN,NaN,-116.9415292353864,-28.033611475625882,0.005761850605638608,-0.32191273904850704,-0.32767458965414564,422508111,438158351,59.399931888153105,59.58909788807188,NaN,NaN,-13.768966557181228,-14.55596354129797
2015-07-24T09:30:00-04:00,53.58,53.62,52.81,52.9,10889114,9507786,31.55269465745141,42.613605668768756,NaN,NaN,-203.03860397744288,-73.38321691060938,-0.0723450715209128,-0.41810592905528665,-0.34576085753437386,411618997,431736229.4,50.40439891573884,60.198222054515234,NaN,NaN,-17.524132183847353,-14.979987633090738
2015-07-27T09:30:00-04:00,52.54,52.8,52.455,52.64,11680663,9770580.2,29.883522730846096,41.86803326770984,NaN,NaN,-238.9345331493325,-127.24306119308794,-0.1309488857880003,-0.5094469647693742,-0.37849807898137394,399938334,421945356.6,40.367484753848494,59.593285845009184,NaN,NaN,-21.13999893136634,-15.85998924713011
2015-07-28T09:30:00-04:00,52.84,53.74,52.84,53.66,15470321,9887453.8,42.691852347576024,42.580471818743625,NaN,NaN,-105.16615776143762,-143.4198752164429,-0.09227135241911166,-0.4938372695052635,-0.40156591708615186,415408655,416706037.8,36.21199409129627,58.83458482205292,NaN,NaN,-20.033938318790582,-16.456267685938748
2015-07-29T09:30:00-04:00,53.56,54.36,53.53,54.32,13128764,9919145.3,49.1629928465337,43.62906096541982,NaN,NaN,-12.613306013226335,-135.33882602736514,-0.017411349113291952,-0.4233301034777668,-0.40591875436447483,428537419,415602303.2,35.3855916383864,58.202457955529724,NaN,NaN,-16.79108412565241,-16.50409860589784
2015-07-30T09:30:00-04:00,54.03,54.32,53.97,54.27,5884461,9664288.75,48.714215503308935,44.13786416515459,NaN,NaN,4.823694674493043,-110.98578124538926,0.030931982980527684,-0.3672537756388152,-0.3981857586193429,422652958,415631272.6,35.42724480281713,57.29359197590343,NaN,NaN,-14.458108893686262,-16.211814361296188
2015-07-31T09:30:00-04:00,54.49,54.5,54.16,54.22,7504222,9515608.15,48.23999043640596,44.14861959438049,NaN,NaN,19.808912921135736,-66.41627786567355,0.060050441673918264,-0.3231227065269451,-0.38317314820086334,415148736,416337220.4,36.50148152252594,55.83957381542982,NaN,NaN,-12.767250907554182,-15.719733867904473
2015-08-03T09:30:00-04:00,54.12,54.23,53.69,53.96,14268352,9689900.2,45.7461352559865,43.873406416084045,NaN,NaN,-26.0871278088521,-23.84679679757745,0.0620541079416988,-0.30560551327373986,-0.36765962121543866,400880384,416525630.4,36.80365661944299,54.04673369407414,NaN,NaN,-12.110700696219904,-15.204157700520964
2015-08-04T09:30:00-04:00,53.93,54.26,53.8,53.93,8623721,9289287,45.454143836655575,43.739679219778374,NaN,NaN,-19.73905346467287,-6.761375938224508,0.06149434093507067,-0.2907916950466003,-0.35228603598167096,392256663,411895232,32.68679297375766,51.58689940600804,NaN,NaN,-11.66407875880104,-14.698432137418118
2015-08-05T09:30:00-04:00,54.21,54.575,54.15,54.23,8099729,9063827.9,48.96239478327437,43.66500255729765,NaN,NaN,20.57898976215936,-0.12291678314737312,0.08027687854327087,-0.2519399378025824,-0.33221681634585326,400356392,406259026.6,28.50678685772192,48.533063555021975,NaN,NaN,-10.269537987219154,-14.06573297310398
2015-08-06T09:30:00-04:00,54.24,54.32,53.84,53.95,5672497,8901543.3,45.989310336295624,43.3935609584817,NaN,NaN,-21.88942861165332,-5.465541440376645,0.07300097404445105,-0.24096559879028945,-0.3139665728347405,394683895,400665214,25.07895281401214,45.116052960423055,NaN,NaN,-9.924042318890228,-13.474062879644872
2015-08-07T09:30:00-04:00,53.84,53.95,53.525,53.69,8335211,8900903.6,43.35661867127912,42.92565665210065,NaN,NaN,-61.63841535788212,-21.75500709618021,0.05088352709548494,-0.25036216396538435,-0.3012456910608693,386348684,394905203.6,22.128291030354717,41.390193993177476,NaN,NaN,-10.383468594262812,-13.032549410304577
2015-08-10T09:30:00-04:00,54.14,54.77,54.09,54.74,9164555,9021402.7,54.647856482027386,43.726685458590985,NaN,NaN,53.68522404617842,-5.800536725174107,0.1041082877338444,-0.1711103313935638,-0.2752186191274082,395513239,393831774.6,21.617836570400556,37.81606652491808,NaN,NaN,-7.133050599396154,-12.189763865889088
2015-08-11T09:30:00-04:00,54.08,54.32,53.855,54.07,10203208,9075041.1,48.0639716481879,44.224251427037245,NaN,NaN,-5.301914580267208,-2.9131089482929737,0.09176228895134991,-0.16051575793822082,-0.25227804688957073,385310031,392442448.2,20.94440600567738,34.39034646315242,NaN,NaN,-6.5446148006954195,-11.383313999432849
2015-08-12T09:30:00-04:00,53.61,54.18,53.235,54.08,8130518,9119105.25,48.16435172156478,45.04500366124243,NaN,NaN,-38.148522494850866,-14.658611399695019,0.08215187271543328,-0.1495882059952791,-0.2317400787107124,393440549,391059279.6,20.267488046741533,31.59517190305159,NaN,NaN,-6.057662309400476,-10.622506615142509
2015-08-13T09:30:00-04:00,54.11,54.22,53.82,54.04,4747203,8942813.4,47.76665839016509,46.203143927864836,NaN,NaN,0.382068712362558,-10.204311934891845,0.07138173659579752,-0.1425129079659655,-0.21389464456176302,388693346,389861169.8,19.674325099638267,29.400166630472974,NaN,NaN,-5.786845888028981,-9.931697939840577
2015-08-14T09:30:00-04:00,53.98,54.41,53.96,54.38,6666154,9000818.65,51.43719816116757,47.7426921728878,NaN,NaN,49.52604460605331,12.028580057895244,0.08453731768672779,-0.10822299745335329,-0.19276031514008107,395359500,391663333,23.310079643263833,28.181780551145497,NaN,NaN,-4.4623435607712505,-9.15036159997353
2015-08-17T09:30:00-04:00,54.12,54.65,53.87,54.65,5610970,9023212.5,54.190221217421424,48.5640042350196,NaN,NaN,86.11076174904242,18.513687598468046,0.10733952339332697,-0.058585910898422355,-0.16592543429174933,400970470,392754779.2,25.50913464140376,27.41729059043889,NaN,NaN,-2.526335800401817,-8.204072200034714
2015-08-18T09:30:00-04:00,54.35,54.64,54.35,54.55,3844992,8851089.65,52.991999089391406,48.83750468093801,NaN,NaN,109.41596544233326,41.457263602988135,0.11113553312195457,-0.027006017889306122,-0.1381415510112607,397125478,395117868.6,30.177407946602756,27.045277469597206,NaN,NaN,-1.2690431275943443,-7.213353761114662
2015-08-19T09:30:00-04:00,54.38,54.52,53.85,54.04,9147270,8930995.3,47.253418279256316,48.73316202207712,NaN,NaN,34.94846482965036,56.07666106788838,0.07640129179457204,-0.04263993626804563,-0.11904122806261767,387978208,394025400.4,29.26433545995748,26.605069659392946,NaN,NaN,-1.847093599152001,-6.446745166548567
2015-08-20T09:30:00-04:00,53.58,53.71,52.91,52.92,18301130,9268652.75,37.61885027204111,47.974509153193914,NaN,NaN,-135.27978352843274,28.944290619729323,-0.01976504704087688,-0.14374753686371378,-0.1239824898228369,369677078,390222146.8,26.282885467238557,25.87516994115813,NaN,NaN,-5.706922255528677,-6.341056179260011
2015-08-21T09:30:00-04:00,52.33,52.57,51.46,51.46,27372912,10092842.65,29.247323636054205,46.79602260891303,NaN,NaN,-294.88430359316135,-39.93777902011361,-0.17104759322552876,-0.33779198135474786,-0.1667443881292191,342304166,379611080,20.12302823747568,24.683696485303322,NaN,NaN,-12.62660849204272,-7.238992223943256
2015-08-24T09:30:00-04:00,47.91,51.06,47.6,49.57,66306684,12824143.7,22.322172733408024,45.14373895868106,NaN,NaN,-409.27265803504565,-139.01446297693124,-0.3759971727219962,-0.6367408540317143,-0.26074368130971814,275997482,354616482.4,12.620084923428593,23.2503601959941,NaN,NaN,-21.95331311212644,-9.341038065112283
2015-08-25T09:30:00-04:00,50.62,51.49,48.95,48.98,25681278,13334691.55,20.676319040812885,43.12330497707667,NaN,NaN,-250.94390507012497,-211.08643707942286,-0.5200204767987724,-0.9107692773081837,-0.3907488005094113,250316204,325254627.6,8.575209892061451,21.82667612701835,NaN,NaN,-29.53377939547203,-12.225715398020817
2015-08-26T09:30:00-04:00,49.95,50.57,49.15,50.51,26147351,13985620.9,34.22093149881741,42.28270648868537,NaN,NaN,-175.68309700653106,-253.21274944665916,-0.4818277530442534,-0.9930334918147281,-0.5112057387704747,276463555,302951697,6.793946692327722,20.520604261183745,NaN,NaN,-30.04663315687687,-14.77156079214311
2015-08-27T09:30:00-04:00,50.98,51.77,50.47,51.73,21356594,14759227.55,42.632597055893754,42.23099065901498,NaN,NaN,-92.05486222661857,-244.5677651862963,-0.35011297171640465,-0.9488469534159805,-0.5987339816995758,297820149,288580311.2,5.938003082497474,19.364155122051084,NaN,NaN,-26.883200629478694,-16.50179505461962
2015-08-28T09:30:00-04:00,51.54,51.819,51.26,51.75,7899924,14779012.65,42.761818607933854,41.38198795372258,NaN,NaN,-67.44432777449259,-199.07977002256257,-0.24246830130857566,-0.9018193583352954,-0.6593510570267197,305720073,281263492.6,5.554328603469187,18.216761695841704,NaN,NaN,-24.598463580277674,-17.658461986856484
2015-08-31T09:30:00-04:00,51.39,51.7251,51.11,51.29,13446838,14737936.95,40.50207307953369,40.84185234167585,NaN,NaN,-68.65546337488958,-130.95633109053136,-0.18563306593454076,-0.8913923894448956,-0.7057593235103549,292273235,284518643.2,8.390272063659353,17.320037842840417,NaN,NaN,-23.634193624066068,-18.51213793502928
2015-09-01T09:30:00-04:00,50.21,50.78,49.68,49.93,14607007,15037101.25,34.66885023827152,39.877887950012045,NaN,NaN,-106.48964747622746,-102.06547957175187,-0.2206363991803657,-0.9815548224858119,-0.7609184233054462,277666228,289988648,13.111748972116118,16.808913623224317,NaN,NaN,-24.973311071793713,-19.43516266885277
2015-09-02T09:30:00-04:00,50.69,51.05,50.21,51.04,18173204,15540775,42.009836356748934,39.466686376196606,NaN,NaN,-71.52721164394663,-81.23430249923494,-0.1532349308458505,-0.9524620868627593,-0.7992271560169089,295839432,293863823.4,16.39902344761522,16.574963505222673,NaN,NaN,-23.324354436240174,-19.990761492765255
2015-09-03T09:30:00-04:00,51.16,51.58,50.93,51.07,10907311,15802515.7,42.1988761976207,38.80680623594326,NaN,NaN,-48.91779114943265,-72.60688828379776,-0.09375523665664431,-0.9164212018377142,-0.8226659651810699,306746743,295649142.2,17.939371445773972,16.191341491116255,NaN,NaN,-22.03128618405077,-20.282265020091756
2015-09-04T09:30:00-04:00,50.66,50.66,50.18,50.36,10212517,15896381,38.96175267703531,37.71905848305853,NaN,NaN,-73.34411602411467,-73.78684593372218,-0.0893701649623807,-0.9343786713840458,-0.8450085064216651,296534226,293811972.8,17.580404492149654,15.62500362331239,NaN,NaN,-22.05457515763978,-20.53545218259862
2015-09-08T09:30:00-04:00,51.12,51.78,51.02,51.75,8437760,15860041.25,47.45933003988078,37.323867836664924,NaN,NaN,-24.49292058514061,-64.95433737577238,0.014473578708834811,-0.8269165330356216,-0.8413901117444564,304971986,296351723,19.964674554918048,14.895522666763481,NaN,NaN,-19.077154970185955,-20.327124009396808
2015-09-09T09:30:00-04:00,52.19,53.05,51.12,51.2,8866218,15793191.75,44.80155202678675,37.148734532917096,NaN,NaN,-8.645100596310847,-45.38542799978906,0.05137317448378309,-0.7771736436397276,-0.8285468181235107,296105768,300039631,23.428575407400274,14.478682663009396,NaN,NaN,-17.604765284879843,-19.9382156201801
2015-09-10T09:30:00-04:00,51.05,51.59,50.99,51.23,9706979,15872014.8,44.98253633206345,37.67471210863297,NaN,NaN,-28.84629020143747,-36.84924371128723,0.08127629265467051,-0.7269514523051726,-0.8082277449598431,305812747,302034294,25.311409856550256,14.409291547960233,NaN,NaN,-16.409882022054035,-19.434167963304947
2015-09-11T09:30:00-04:00,51.18,51.51,50.99,51.51,6120089,15940659.1,46.737847914957364,38.92403527141177,NaN,NaN,-20.886491283993713,-31.242983738199438,0.12099575418350195,-0.6569830522304656,-0.7779788064139675,311932836,303071512.6,26.325895077584576,14.85235346511087,NaN,NaN,-14.907430689044576,-18.78749120983918
2015-09-14T09:30:00-04:00,51.61,51.61,51.14,51.25,8436893,16029196.05,45.29279814520073,40.56479422939696,NaN,NaN,-15.040239843623903,-19.58220850210129,0.1300484374880383,-0.6154182595539197,-0.745466697041958,303495943,304463856,27.744697541752515,15.932682937848293,NaN,NaN,-14.09135782973911,-18.11661501268203
2015-09-15T09:30:00-04:00,51.46,52.24,51.35,52.14,7747124,16136003.75,50.89016661220422,42.72292619878205,NaN,NaN,34.71120216047823,-7.74138395297752,0.1924991283933104,-0.50484278655032,-0.6973419149436304,311243067,305718072.2,29.069798560708364,17.39658212846593,NaN,NaN,-11.674829196575963,-17.196359896095448
2015-09-16T09:30:00-04:00,52.17,52.62,52.06,52.52,19320854,16909796.85,53.096751263700426,44.07119903913084,NaN,NaN,91.91220850361032,12.370077867006712,0.2521591345601071,-0.3821429967434966,-0.6343021313036037,330563921,312609702.8,36.013656478533335,19.483704256052047,NaN,NaN,-9.006696417799292,-16.026407970624568
2015-09-17T09:30:00-04:00,52.45,53.115,52.16,52.29,18977405,17401303.6,51.58593259922963,44.71072300651198,NaN,NaN,119.74968251141836,42.08927240957787,0.2674390208876256,-0.30000335519407173,-0.5674423760816973,311586516,313764456.6,37.12437506700076,21.71130225494514,NaN,NaN,-7.228720323429,-14.769595449596629
2015-09-18T09:30:00-04:00,51.21,51.47,50.77,50.86,20172452,17494869.7,43.33064144530535,44.751353209181374,NaN,NaN,-12.251645142889949,43.816241637798626,0.17691056678843053,-0.3463041675961591,-0.5232147343845897,291414064,309660702.2,34.81167999922668,23.801113068927815,NaN,NaN,-8.146861889118513,-13.823490655242612
2015-09-21T09:30:00-04:00,51.14,51.45,50.87,51.11,10205156,16636481.9,44.98811382065541,45.07178469069007,NaN,NaN,2.798261882997366,47.38394198312288,0.13161960615966117,-0.35869022668501316,-0.49030983284467433,301619220,309285357.6,34.59937463576806,25.673191824078437,NaN,NaN,-8.39459260954034,-13.047933791570859
2015-09-22T09:30:00-04:00,50.39,50.545,50.04,50.37,12687074,13955501.4,41.15140319405438,45.534824187531704,NaN,NaN,-100.04379770751444,20.432942009524346,0.05357738215235586,-0.42333810515422954,-0.4769154873065854,288932146,304823173.4,32.093522850760564,27.029032815410183,NaN,NaN,-9.78695108146085,-12.582079118698001
2015-09-23T09:30:00-04:00,50.38,50.49,49.84,50.02,7970925,13069983.75,39.43823600058309,45.351138447805575,NaN,NaN,-130.07311725717724,-23.964123142633163,-0.016134821704706925,-0.4970840144374691,-0.48094919273276215,280961221,294902633.4,27.3507821338886,27.81130129300114,NaN,NaN,-11.4536370864079,-12.42087311408513
2015-09-24T09:30:00-04:00,49.43,49.83,49.04,49.71,13891631,12457197.75,37.93197947824574,45.04636011070737,NaN,NaN,-187.6164852192801,-85.43735668877285,-0.07438202031565588,-0.573926718127332,-0.4995446978116761,267069590,285999248.2,23.932522811882222,28.23938353343744,NaN,NaN,-13.282347187540061,-12.543940838864405
2015-09-25T09:30:00-04:00,50.22,50.22,49.6,49.81,10210312,11899883.65,38.74471273150796,45.03085725745541,NaN,NaN,-124.03956516713181,-107.79494069362121,-0.09605498751680774,-0.6196134322076858,-0.5235584446908781,277279902,283172415.8,22.95172352591743,28.62304917870657,NaN,NaN,-14.561454303120158,-12.832157048043799
2015-09-28T09:30:00-04:00,49.53,49.5899,48.83,48.83,14443677,12227071.3,34.04050122740762,44.072369485135894,NaN,NaN,-168.39602735138502,-142.03379854049768,-0.16237195045393327,-0.7265233827582946,-0.5641514323043614,262836225,275415816.8,20.47248565191309,28.659321399920504,NaN,NaN,-17.131012436189245,-13.446279246350292
2015-09-29T09:30:00-04:00,49.09,49.33,48.81,49.15,15337797,12321619.25,36.74136569944802,43.49664189032598,NaN,NaN,-141.09452538809478,-150.2439440766138,-0.16986141875718963,-0.7764782057508484,-0.6066167869936587,278174022,273264192,19.832514269248023,28.402459890052484,NaN,NaN,-18.50517274704712,-14.16897831787841
2015-09-30T09:30:00-04:00,49.55,49.95,49.2727,49.89,17662407,12474389.25,42.59519575795733,43.326117563604114,NaN,NaN,-87.65087959292272,-141.75949654376285,-0.112895775461473,-0.7477365063204999,-0.6348407308590269,295836429,276239233.6,23.398177056768105,28.265800404353758,NaN,NaN,-17.977858027110816,-14.713103990625898
2015-10-01T09:30:00-04:00,49.82,50.13,49.31,49.78,10529662,12092212.15,41.97341080303949,42.98580062703856,NaN,NaN,-75.7359635606403,-119.38339221203492,-0.07250485200763579,-0.7254717958685717,-0.6529669438609359,285306767,279886669,27.647084685334946,28.36017109062164,NaN,NaN,-17.722814834291306,-15.1430626825781
2015-10-02T09:30:00-04:00,49.12,50.41,48.985,50.41,12274554,12160574.3,46.766314198012324,43.09105177366796,NaN,NaN,-55.45193393580093,-105.66586596576875,0.002770323653729645,-0.6495040392937739,-0.6522743629475035,297581321,283946952.8,32.15824950649605,28.67542480238904,NaN,NaN,-16.103374941487946,-15.280250148136648
2015-10-05T09:30:00-04:00,51.15,51.959,50.71,51.84,10410502,12170473.55,55.70898829938931,43.4352533227526,NaN,NaN,52.72675408666049,-61.441309678159634,0.14701204061015727,-0.46850931218480696,-0.6155213527949642,307991823,292978072.4,40.97376352184721,29.525708013898953,NaN,NaN,-11.683572509982737,-14.766439056971803
2015-10-06T09:30:00-04:00,51.75,52.11,51.72,51.79,11798622,12338516.65,55.35881237655794,43.596829116528134,NaN,NaN,76.36636384896624,-17.949131830747426,0.23213404776722668,-0.32535379308593093,-0.5574878408531576,296193201,296581908.2,44.09556268838645,30.10298702888846,NaN,NaN,-8.287417602432374,-13.840864563466171
2015-10-07T09:30:00-04:00,52.06,52.71,51.955,52.47,15540397,12672225.6,59.12214575830846,44.135130056462344,NaN,NaN,106.50917483777219,20.882879055391562,0.3217965440246827,-0.15524216082230424,-0.47703870484698696,311733598,299761342,46.77031304450115,30.791982598709918,NaN,NaN,-4.191682467789025,-12.462409978369436
2015-10-08T09:30:00-04:00,52.2,53.36,52.18,53.2,21823062,13278029.75,62.75237590779649,45.52239680378314,NaN,NaN,127.58417234385243,61.54690623629013,0.4120621184466107,0.03803894321127643,-0.3740231752353343,333556660,309411320.6,53.96893323195717,32.16035782961924,NaN,NaN,0.48444216696068426,-10.612859671893705
2015-10-09T09:30:00-04:00,53.76,53.76,53.205,53.38,33291022,14636576.4,63.61051233541764,46.85256812626615,NaN,NaN,141.88896435965742,101.0150858953818,0.4619349319912241,0.2033954897536958,-0.2585394422375283,366847682,323264592.8,61.92875173486494,34.112456193840444,NaN,NaN,4.538946949144411,-8.44831586888826
2015-10-12T09:30:00-04:00,53.34,53.44,53.12,53.39,9030828,14666273.15,63.66060194766035,48.46036803723801,NaN,NaN,118.7605374159993,114.22184256124956,0.4719740842599841,0.3314281630874518,-0.14054592117253228,375878510,336841930.2,67.80485520190057,36.663265647493304,NaN,NaN,7.834881733984729,-6.122144782763547
2015-10-13T09:30:00-04:00,53,53.31,52.8,52.82,10302451,14794039.5,58.70068465824723,49.83625722707116,NaN,NaN,93.74549704093842,117.697669199644,0.4184300309736506,0.382491617544531,-0.03593841342911963,365576059,350718501.8,72.47998099648213,39.88677985196427,NaN,NaN,9.313027742752283,-3.9171201362612855
2015-10-14T09:30:00-04:00,52.65,52.915,52.17,52.25,11827855,14419389.55,54.15666415297046,50.99516327526578,NaN,NaN,66.28930798330235,109.65369582875003,0.3268864373271111,0.3726696332297692,0.04578319590265814,353748204,359121423,74.86060362457562,43.524499910013795,NaN,NaN,9.276595185965789,-2.032303661657418
2015-10-15T09:30:00-04:00,52.63,52.85,52.2,52.82,13924821,14166760.35,57.684296862487074,52.347990713192864,NaN,NaN,74.82021244763875,99.10090384950729,0.28833143084293594,0.4061974844563281,0.11786605361339214,367673025,365944696,76.62857095750442,47.35856044084144,NaN,NaN,10.277709676973332,-0.27373032756731086
2015-10-16T09:30:00-04:00,53,53,52.32,52.55,13954707,13855873.1,55.50549991003543,53.88120490480913,NaN,NaN,67.3052625298218,84.18416348354016,0.2307457581204503,0.406298251263955,0.1755524931435047,353718318,363318823.2,74.45837687214646,51.214695528000966,NaN,NaN,10.484879097322471,1.2632138759883722
2015-10-19T09:30:00-04:00,52.35,52.68,52.27,52.62,8112310,13751230.8,55.969831744950255,55.25466676520215,NaN,NaN,56.93051685901149,71.8181593721426,0.18542285804517294,0.4073310656999709,0.22190820765479796,361830628,360509246.8,72.10534844510462,54.94846939770501,NaN,NaN,10.782654560369659,2.6231339737571275
2015-10-20T09:30:00-04:00,52.44,53.14,52.335,52.97,11314683,13682611.25,58.3123563640734,56.377321094210444,NaN,NaN,64.62977197027804,65.99501435801052,0.1676082572785399,0.43141852925297286,0.26381027197443296,373145311,362023097.2,72.60765587859693,58.46343217069278,NaN,NaN,11.681484285896218,3.917184018348426
2015-10-21T09:30:00-04:00,53.03,53.58,52.905,52.98,16097800,14088955,58.38048778456518,57.54925516431941,NaN,NaN,74.26721202937178,67.59059516722441,0.14588917758366804,0.44617174395401804,0.30028256637035,389243111,369122078.6,74.89102156241492,61.83799909048421,NaN,NaN,12.444849115545747,5.135421889376615
2015-10-22T09:30:00-04:00,53.19,54.665,53.11,54.46,20908787,14439812.8,66.9814099750534,58.99319057696521,NaN,NaN,110.60908259851894,74.74836919740045,0.21634085105148337,0.5707086301847042,0.3543677791332208,410151898,377617853.2,77.32686551035712,65.06432880504572,NaN,NaN,15.853188607036502,6.666531420470885
2015-10-23T09:30:00-04:00,54.78,54.86,54.31,54.66,13400850,14599339.7,67.94544055174953,59.86722288070523,NaN,NaN,128.14554524198044,86.91642573983218,0.2586904795709864,0.6777308785969538,0.4190403990259674,423552748,391584739.2,80.65022699732572,67.89836191043705,NaN,NaN,18.93446845201031,8.419093853547945
2015-10-26T09:30:00-04:00,54.54,54.82,54.42,54.54,11294926,14441902.15,66.68735063161446,60.67640418463783,NaN,NaN,125.86848213782798,100.70401879559547,0.26019499288523157,0.7442841401325069,0.4840891472472753,412257822,401670178,82.63012413045865,70.65083058487076,NaN,NaN,21.110664960177818,10.232175440209355
2015-10-27T09:30:00-04:00,54.09,54.2,53.83,53.94,14483647,14399194.65,60.6412648736258,60.784912692874784,NaN,NaN,91.55589215246712,106.08924283203328,0.20479419456287884,0.7400818904508739,0.5352876958879951,397774175,406595950.8,83.51720239734065,73.27560839578788,NaN,NaN,21.261536276599386,11.807798416836501
2015-10-28T09:30:00-04:00,54.14,54.4,53.705,54.37,13933239,14212736.25,63.21521955247475,60.817972953208944,NaN,NaN,97.19202209440175,110.67420484503927,0.18189587707651034,0.762657542233633,0.5807616651571227,411707414,411088811.4,84.30455990543408,75.44243887246479,NaN,NaN,22.14027318596001,13.283866240997002
2015-10-29T09:30:00-04:00,54.05,54.42,54.03,54.34,13466132,14359559.75,62.90612583022966,60.7676596314098,NaN,NaN,98.06067464271707,108.16452325387893,0.15079914968702357,0.7692606022659021,0.6184614525788785,398241282,408706688.2,82.06619291592202,76.88082752825458,NaN,NaN,22.77049252318355,14.639098567023652
2015-10-30T09:30:00-04:00,54.36,54.56,54.25,54.27,14763595,14484011.8,62.14260748787485,60.65923145571084,NaN,NaN,97.28992847343646,101.99339990017013,0.11329755131613317,0.760083391724045,0.6467858404079119,383477687,400691676,74.86380095661414,77.38503793930555,NaN,NaN,23.089711614118045,15.84632900232285
2015-11-02T09:30:00-05:00,54.28,55.01,54.28,54.9,15329028,14729938.1,66.1273716707328,61.18970909945981,NaN,NaN,115.87447834805333,99.9945991422152,0.11816153628730297,0.7944877607670406,0.6763262244797377,398806715,398001454.6,72.56188460439819,77.39088819701384,NaN,NaN,24.498537679191468,17.082358813304083
2015-11-03T09:30:00-05:00,54.85,55.09,54.73,54.94,7486369,14514325.45,66.3694135371389,62.06204834118612,NaN,NaN,117.60090445773186,105.20360160326814,0.11140273431475956,0.8155796423731871,0.7041769080584276,406293084,399705236.4,73.12548200788432,77.26695093867875,NaN,NaN,25.729135878819626,18.317612679806302
2015-11-04T09:30:00-05:00,54.91,55.1,54.68,54.79,9670911,14220851.15,64.50788228296364,62.54944729979159,NaN,NaN,100.65026858919691,105.89525090222716,0.08533403673316786,0.8108444539748874,0.7255104172417195,396622173,396688188.2,70.36903738086473,76.81984139749021,NaN,NaN,26.282643280603946,19.455474194205966
2015-11-05T09:30:00-05:00,54.77,55,54.47,54.86,11531053,13706250.7,65.00122269122048,63.22771321273338,NaN,NaN,85.07691339111247,103.29849865190624,0.06237422739124754,0.8034782014807789,0.7411039740895313,408153226,398670577,71.13885070283617,76.58273238539662,NaN,NaN,26.877804779510495,20.515807134963755
2015-11-06T09:30:00-05:00,54.54,54.87,54.285,54.86,15269296,12805164.4,65.00122269122048,63.8728125660384,NaN,NaN,69.59902528508836,97.76031801423662,0.03795720016530191,0.7885504742961587,0.7505932741308567,408153226,403605684.8,73.01818206364754,76.64793478672111,NaN,NaN,27.38093642240188,21.496539890312057
2015-11-09T09:30:00-05:00,54.59,54.69,53.92,54.44,13570630,13032154.5,59.268519322859866,63.94110992023742,NaN,NaN,39.64702438208239,82.51482722104244,-0.012983133025488591,0.734364357848996,0.7473474908744846,394582596,402760861,72.15203329211457,76.61539031625809,NaN,NaN,26.34478403649993,22.189146196910325
2015-11-10T09:30:00-05:00,54.22,54.61,53.98,54.43,18957346,13464899.25,59.134793148838305,63.994988874828366,NaN,NaN,35.279263220438935,66.05049897358386,-0.05168255076082673,0.6827443024234512,0.7344268531842779,375625250,396627294.2,66.02821007759664,75.98233235305678,NaN,NaN,25.435055087002834,22.65284746692354
2015-11-11T09:30:00-05:00,54.56,54.79,54.385,54.5,12916018,13519307.4,59.81823887596393,63.483333796321965,NaN,NaN,51.606028314811006,56.24165091870667,-0.07545770431628684,0.6401047227889194,0.7155624271052062,388541268,395011113.2,64.47536035325778,75.06436769897824,NaN,NaN,24.814409268877526,22.961642010059823
2015-11-12T09:30:00-05:00,54.12,54.48,53.75,53.76,19057064,13775919.55,50.250504300801985,62.21940977839714,NaN,NaN,-14.381129440004422,36.350042352483285,-0.14015260969952803,0.5403716649807961,0.6805242746803242,369484204,387277308.8,57.50588528278206,73.4112004336537,NaN,NaN,21.527822804636635,22.756810694999366
2015-11-13T09:30:00-05:00,53.55,53.96,53.43,53.52,13959103,13776139.35,47.59178959751849,60.85544113310458,NaN,NaN,-71.0000000000032,8.23023729546497,-0.19487554088134496,0.43692984857864303,0.631805389459988,355525101,376751683.8,49.64109672265053,71.054841333096,NaN,NaN,17.93090038081289,22.06739493582987
2015-11-16T09:30:00-05:00,53.24,54.245,53.24,54.21,13303898,14035718.75,54.968609819896265,60.450251486409606,NaN,NaN,-54.22488356620431,-10.54414429419237,-0.1806849772176834,0.4059491679378837,0.5866341451555671,368828999,371600964.4,46.30379103561284,68.396740521544,NaN,NaN,16.75117189185507,21.307934500976327
2015-11-17T09:30:00-05:00,54.28,54.48,53.94,54.1,15564418,14248205.5,53.67160167566692,59.76856449520904,NaN,NaN,-25.961302963513067,-22.79225753098277,-0.17468697629941188,0.36827542478130226,0.5429624010807141,353264581,367128830.6,43.5652075261215,65.48678678016454,NaN,NaN,15.40117140898762,20.464111202120797
2015-11-18T09:30:00-05:00,54.15,54.87,54.15,54.85,10434826,13965056.8,60.512872097908435,59.59761780004324,NaN,NaN,55.598265045601686,-21.993810184824632,-0.11885700227528528,0.3943911482366076,0.5132481505118929,363699407,362160458.4,40.68621370390166,62.53107397930594,NaN,NaN,16.291504336616352,19.868024507048734
2015-11-19T09:30:00-05:00,54.72,55.14,54.72,55.09,12257398,13532487.35,62.425025907873454,59.617790544328855,NaN,NaN,121.0250857245959,5.087432848095401,-0.06699612180366987,0.42950299825730553,0.4964991200609754,375956805,363454978.6,41.766046743140855,60.16694867834355,NaN,NaN,17.61958671650922,19.546819108400232
2015-11-20T09:30:00-05:00,55.31,55.56,55.16,55.37,9014059,13313147.8,64.58002457195312,59.507265751558876,NaN,NaN,173.88647692554758,54.06472823320555,-0.017636221060798374,0.47445384373497745,0.49209006479577583,384970864,369344131.2,46.53475933889454,58.30786830223615,NaN,NaN,19.39505506701948,19.525138531060126
2015-11-23T09:30:00-05:00,55.42,55.485,54.945,55.09,9955959,13246199.45,60.82335195577082,59.11111849574687,NaN,NaN,121.43598872570624,89.19690269158767,-0.00812910874284456,0.48192867886722013,0.4900577876100647,375014905,370581312.4,47.50725868084072,56.47799520744733,NaN,NaN,19.763980431919506,19.559258802611467
2015-11-24T09:30:00-05:00,54.73,55.1272,54.54,55,15131449,13278589.55,59.62278451994162,58.76218294124531,NaN,NaN,64.49317998813292,107.28779928191686,-0.01195544666174031,0.4751134792828893,0.4870689259446296,359883456,371905087.4,48.58489948118699,54.92198535747034,NaN,NaN,19.718942401015777,19.582070745240653
2015-11-25T09:30:00-05:00,55.15,55.16,54.9,55,6406759,12902265.55,59.62278451994162,58.378008786153956,NaN,NaN,80.81717390154883,112.33158105310629,-0.01816751129593641,0.4643595368247091,0.4825270481206455,359883456,371141897.2,47.97342436891713,53.267312047904696,NaN,NaN,19.682105191976344,19.59636138048861
2015-11-27T09:30:00-05:00,54.96,55.17,54.86,55.095,4454510,12451684.45,60.575434981090986,58.06188109257327,NaN,NaN,77.75150651804343,103.6768652117958,-0.01944517102717863,0.45822058433667223,0.47766575536385086,364337966,368818129.4,46.07208360933822,51.34259072973975,NaN,NaN,19.905084254507354,19.640464648205572
2015-11-30T09:30:00-05:00,55.1,55.14,54.705,54.74,11017794,12264394.4,55.32265001131195,57.780033284605565,NaN,NaN,40.80802873168037,77.06117557302235,-0.046236693566032216,0.41986988840631057,0.4661065819723428,353320172,362487991,41.27327599237402,49.136965208329705,NaN,NaN,18.64766161258912,19.498635643117506
2015-12-01T09:30:00-05:00,54.76,55.175,54.69,55,11475851,12071735.55,58.18273158510555,57.712028887196084,NaN,NaN,54.7599439306345,63.725966614007994,-0.048262109119430796,0.4057789455730543,0.45404105469248507,364796023,360444214.6,39.830765448286606,47.26571916337899,NaN,NaN,18.3444086714348,19.33374607573426
2015-12-02T09:30:00-05:00,54.91,55.06,54.325,54.44,13131576,12353995.9,50.66030169201508,57.05789051691403,NaN,NaN,-5.710728920535975,49.68518483227422,-0.08687891820480592,0.34544240693647765,0.4323213251412836,351664447,358800412.8,38.66041134939683,45.42179423453178,NaN,NaN,15.799862656026576,18.82890558720459
2015-12-03T09:30:00-05:00,54.58,54.61,53.5601,53.76,16001355,12670518.1,43.333803874141374,56.56384048643827,NaN,NaN,-107.63147096702197,11.995455858560064,-0.15386625194915593,0.2399885102048387,0.3938547621539946,335663092,353956340,35.36285766909346,43.84014940498259,NaN,NaN,11.080437055865001,17.721981511298935
2015-12-04T09:30:00-05:00,53.84,54.57,53.72,54.56,13891933,12788562.1,52.10885458100939,56.88648798525905,NaN,NaN,-48.80664418912479,-13.316174282873579,-0.1403232594328716,0.2184506878629051,0.3587739472957767,349555025,350999751.8,33.485499870211996,42.686178201236984,NaN,NaN,9.851760350964728,16.597664202679763
2015-12-07T09:30:00-05:00,54.39,54.565,54.1,54.29,9665464,12508370.5,49.33224441513314,56.483890456347396,NaN,NaN,-39.039258036571695,-29.285631636523995,-0.14498043978672082,0.17754839756237573,0.32252883734909654,339889561,348313629.6,31.83207575308603,41.652484252485074,NaN,NaN,7.933253478158771,15.359891242033907
2015-12-08T09:30:00-05:00,53.58,53.84,53.32,53.42,15508631,12605270.55,41.634000051257274,55.62406176888957,NaN,NaN,-147.44475435420145,-69.72657129349118,-0.19876115735164007,0.07407739065954644,0.2728385480111865,324380930,340230611,27.441096039113788,40.500762003413094,NaN,NaN,3.462084923139492,13.66020462504899
2015-12-09T09:30:00-05:00,53.22,53.9,52.91,53.26,16784101,12496608.3,40.385825855707026,54.18641560873232,NaN,NaN,-147.60748096752044,-98.10592170288808,-0.2347487240828284,-0.020597357092349,0.2141513669904794,307596829,331417087.4,23.615839724850133,39.281449576337984,NaN,NaN,-0.437520038151132,11.646243958877545
2015-12-10T09:30:00-05:00,53.21,53.86,53.21,53.51,13231598,12512387.3,43.248733441254856,52.816680432545276,NaN,NaN,-108.87117384249333,-98.35386227798236,-0.230997078875158,-0.07459498160346811,0.15640209727168988,320828427,328450154.4,22.479797851863907,37.90386036981821,NaN,NaN,-2.653797204482264,9.603380935540429
2015-12-11T09:30:00-05:00,53.07,53.21,52.525,52.61,24625522,12790810.2,36.46035725545447,50.80813276708109,NaN,NaN,-173.65601667677123,-123.32373677551163,-0.27539815726341504,-0.18784559930757894,0.08755255795583612,296202905,317779730.4,18.949253487696126,35.9334670947326,NaN,NaN,-7.02094542026841,7.22847717042488
2015-12-14T09:30:00-05:00,52.63,52.88,52.125,52.8,27426217,13464165.9,38.64965725023463,49.22429743097136,NaN,NaN,-172.4549199877925,-150.0068691657558,-0.2774639103609369,-0.25927732999533504,0.01818658036560189,323629122,314527642.6,18.02033541886253,33.827258290305586,NaN,NaN,-9.73165266410928,4.805601479777144
2015-12-15T09:30:00-05:00,52.9,53.15,52.68,52.81,17052125,13651577.25,38.76923799500999,47.73475839347624,NaN,NaN,-127.40217734668902,-145.9983537642533,-0.2637411946571838,-0.3114899129558779,-0.04774871829869408,340681247,317787706,22.14077769031738,31.93839244810062,NaN,NaN,-11.8121274916768,2.431640198140866
2015-12-16T09:30:00-05:00,53.11,53.87,52.96,53.75,19045713,13825642,48.85987498862071,46.96597914123903,NaN,NaN,-60.83090774576533,-128.6430391199023,-0.18089039313275468,-0.2738617097146374,-0.09297131658188275,359726960,328213732.2,33.62991725745729,30.91385622585349,NaN,NaN,-10.322265995442667,0.6096535990575045
2015-12-17T09:30:00-05:00,53.94,54.01,52.86,52.86,15902684,14099034.9,41.83088661762318,45.62708282956276,NaN,NaN,-76.23293797359052,-122.11539194612173,-0.1754286615598844,-0.3122571435317383,-0.13682848197185388,343824276,332812902,37.97772611960984,30.335687833730027,NaN,NaN,-11.489135105407067,-1.118744787294577
2015-12-18T09:30:00-05:00,52.43,52.43,51.7,51.74,19378215,14455075.75,35.005997101751575,44.17589333602273,NaN,NaN,-158.55191028311847,-119.0945706673912,-0.23303743802414378,-0.4281252795020336,-0.19508784147788982,324446061,338461533.2,42.92318164396582,30.453538237415156,NaN,NaN,-15.07757436674899,-3.112863298645207
2015-12-21T09:30:00-05:00,52.2,52.36,51.83,52.14,9394669,14474106.25,38.84365892377676,42.794531003070674,NaN,NaN,-130.31574154136655,-110.66673497810598,-0.2296236513283157,-0.4821174056382844,-0.25249375430996873,333840730,340503854.8,44.64190257187934,30.797190889100353,NaN,NaN,-16.48488668654459,-5.0231523540594045
2015-12-22T09:30:00-05:00,52.35,52.98,52.23,52.86,11833522,14567984.4,45.12464651669303,42.399127061976245,NaN,NaN,-79.0319583960185,-100.99269118797187,-0.16719604941573452,-0.4614888160796369,-0.29429276666390236,345674252,341502455.8,45.50596892409688,31.286159287293213,NaN,NaN,-15.365489227782597,-6.500629050305575
2015-12-23T09:30:00-05:00,53.1,53.521,52.96,53.48,9604802,14291652.05,49.89661318510474,42.86789915561649,NaN,NaN,-25.645570061589257,-93.95562365113668,-0.07705298222672796,-0.39060899444731234,-0.3135560122205844,355279054,340612874.6,44.83460565791807,31.962712715066402,NaN,NaN,-12.744638887401843,-7.392630455605041
2015-12-24T09:30:00-05:00,53.29,53.6,53.29,53.46,2040512,14073339.7,49.7463321680112,42.699147554688054,NaN,NaN,-9.34382649639008,-80.57780135569658,-0.014931532387239599,-0.3322204277046339,-0.3172888953173943,353238542,342495727.8,46.629368616585566,32.90156048266452,NaN,NaN,-10.80159298780597,-7.879625103062317
2015-12-28T09:30:00-05:00,53.25,53.45,52.985,53.34,4687580,14084993.2,48.796691363785925,42.66089376530611,NaN,NaN,-21.07843226211299,-53.083105751495474,0.02002226711597166,-0.2922610614224297,-0.31228332853840135,348550962,347316708,51.02311607828958,34.27234907732191,NaN,NaN,-9.551019460472366,-8.118395725549467
2015-12-29T09:30:00-05:00,53.59,53.95,53.53,53.85,5054667,13786836.85,52.91095221759704,43.46639034861609,NaN,NaN,41.90915512736502,-18.63812641774917,0.07627506719316746,-0.21693949454694206,-0.2932145617401095,353605629,351269687.8,54.34222443272121,36.19385824829387,NaN,NaN,-7.194628978444463,-7.986429047391609
2015-12-30T09:30:00-05:00,53.75,53.845,53.33,53.4,10957744,13760931.5,49.15766286844871,44.09295013524049,NaN,NaN,24.34029007644501,2.036323276743533,0.081489999894582,-0.19135206187188203,-0.27284206176646403,342647885,350664414.4,53.741668991129124,38.345703195885235,NaN,NaN,-6.36425546120125,-7.754689963650129
2015-12-31T09:30:00-05:00,53.15,53.45,52.92,53.01,6785353,13443620.35,46.105181764902724,44.296982158358205,NaN,NaN,-19.132493954492745,3.3389384981628383,0.058085338338750125,-0.20023538884302639,-0.2583207271817765,335862532,346781110,49.92921213516332,40.30637564469233,NaN,NaN,-6.60339805656078,-7.590219691208794
2016-01-04T09:30:00-05:00,52.11,52.32,51.71,52.3,16404580,13463781.6,41.101416049744955,44.628486357950386,NaN,NaN,-138.60733523655094,-22.513763249869335,-0.0025846600678952614,-0.2615515522666456,-0.25896689219875035,319457952,340024992,44.07145155006251,42.100818363432786,NaN,NaN,-8.403398421454794,-7.7063880812439365
2016-01-05T09:30:00-05:00,52.43,52.53,51.97,52.44,8726272,13205498.55,42.42823343876984,44.898384657131466,NaN,NaN,-98.59008105079215,-38.016093007605164,-0.029180522886064708,-0.2954425458063312,-0.2662620229202665,328184224,335951644.4,40.95191519660185,43.738788347557026,NaN,NaN,-9.451083535626442,-7.955630289012865
2016-01-06T09:30:00-05:00,51.72,52.06,51.31,51.63,9980000,13221225.35,37.205950776088876,44.78672128435138,NaN,NaN,-159.04963664602366,-78.2078513622829,-0.09358545087907777,-0.38324383651911376,-0.289658385640036,318204224,328871363.4,36.16062642300196,44.74020611417735,NaN,NaN,-12.050577502087238,-8.54062274802349
2016-01-07T09:30:00-05:00,50.8,51.1,50.09,50.23,17225551,13307071.35,30.270785492624682,43.45892917749452,NaN,NaN,-242.3249608810857,-131.54090155378904,-0.21575127717036552,-0.5593474821029929,-0.3435962049326274,300978673,320537521,31.490420202634425,44.58738489597572,NaN,NaN,-16.933322615912534,-9.739579872007639
2016-01-08T09:30:00-05:00,50.71,50.71,49.65,49.72,17198597,13327796.15,28.20804665416695,42.48586918010479,NaN,NaN,-224.74929246850985,-172.66426125659245,-0.3104269194164116,-0.7316298542031419,-0.42120293478673027,283780076,310121029.8,26.826739068790857,43.79088582091722,NaN,NaN,-21.580269593426436,-11.431106975067467
2016-01-11T09:30:00-05:00,50.05,50.09,49.28,49.75,18962436,13614338.05,28.51662211325356,42.02234239521208,NaN,NaN,-200.31489608183725,-185.00577342564972,-0.3477401290618535,-0.8558780961140471,-0.5081379670521936,302742512,306777941.8,25.520420042813015,42.547831420834875,NaN,NaN,-25.065127745079202,-13.378824227926286
2016-01-12T09:30:00-05:00,50.09,50.24,49.51,50.15,19297334,13347928.65,32.67194794121427,41.581505896457614,NaN,NaN,-150.51496001003534,-195.39074921749835,-0.32273855143420094,-0.9115611563449448,-0.5888226049107439,322039846,305549066.2,25.037781492377107,41.14753705801328,NaN,NaN,-26.653695346055027,-15.275234387658962
2016-01-13T09:30:00-05:00,50.38,50.48,48.795,48.94,18966894,12924962.5,27.469972436084504,40.320457747842724,NaN,NaN,-154.84223342398386,-194.5492685730904,-0.362000748698627,-1.0413235407840276,-0.6793227920854006,303072952,302522811.8,23.841981011826405,39.600109349993964,NaN,NaN,-29.860979400222025,-17.358912246596542
2016-01-14T09:30:00-05:00,49.1,49.865,48.6,49.52,19261231,13035417.8,32.978490596117865,39.112020420057945,NaN,NaN,-133.67644877220945,-172.81956615131517,-0.32442535464576294,-1.0848544853926043,-0.7604291307468414,322334183,306793913.8,28.996208815563435,38.46879528982578,NaN,NaN,-30.656145503457786,-19.25851699757672
2016-01-15T09:30:00-05:00,48.14,48.84,48.02,48.647,20434577,13104861,29.36358504511918,37.65610991127994,NaN,NaN,-146.84981533479444,-157.23967072457208,-0.33264704571270853,-1.176237937887727,-0.8435908921750185,301899606,310417819.8,33.13136657317523,37.50465228672504,NaN,NaN,-32.561061870925045,-21.158880550912194
2016-01-19T09:30:00-05:00,49.18,49.27,48.19,48.64,14844956,13051974.6,29.33581779581516,36.26604751356775,NaN,NaN,-117.97911494727603,-140.77251449765984,-0.3131182010934912,-1.2349886435418824,-0.9218704424483912,287054650,307280247.4,31.42494405637929,36.10478285658859,NaN,NaN,-34.0380142587182,-22.998756794884482
2016-01-20T09:30:00-05:00,47.95,48.43,46.82,48.01,26092675,13387697.6,26.872818991360262,34.40618085455083,NaN,NaN,-133.74366327521557,-137.41825515069587,-0.3162643374690359,-1.3172008642846862,-1.0009365268156503,260961975,295064673.2,25.843956668389097,34.06919230199344,NaN,NaN,-36.07232356068792,-24.86640918999926
2016-01-21T09:30:00-05:00,48.01,48.68,47.66,48.22,18593829,13847655.6,29.01231960530521,32.967227764326296,NaN,NaN,-103.17426170927267,-127.08466080775364,-0.2791301189715396,-1.3498491755300748,-1.0707190565585352,279555804,290361243.6,24.071311823527353,31.94988107573617,NaN,NaN,-37.066081808731425,-26.609219564103856
2016-01-22T09:30:00-05:00,48.84,48.99,48.22,48.64,12781561,13895057.55,33.22047335362112,32.04689144923476,NaN,NaN,-79.56778402439032,-116.2629278581898,-0.2046576880897384,-1.326541166670708,-1.1218834785809697,292337365,284361880,21.99862588529311,29.954839200745443,NaN,NaN,-36.63072172846821,-28.04086273044162
2016-01-25T09:30:00-05:00,48.56,48.65,47.96,48.04,14533951,14141515,30.44397972735925,31.28564599763578,NaN,NaN,-86.62984534076023,-104.21893385938297,-0.17531391775838134,-1.3410258757789464,-1.165711958020565,277803414,279542641.6,20.473571726949913,28.269276356237402,NaN,NaN,-37.09437039894479,-29.334220968799215
2016-01-26T09:30:00-05:00,48.15,48.9701,48.14,48.95,12038307,14641404.75,38.79860560581017,31.026386866710087,NaN,NaN,-64.7185837109194,-93.56682761211164,-0.07902991825604966,-1.264499355840627,-1.1854694375845773,289841721,280100055.8,21.154421593991003,26.85516967033663,NaN,NaN,-34.82412022511781,-30.118492291130444
2016-01-27T09:30:00-05:00,48.69,49.28,48.14,48.4,16437248,15228888.15,35.985261078298294,30.939194745439327,NaN,NaN,-63.47470567031524,-79.51303609113157,-0.03883011031674255,-1.2340070754805055,-1.195176965163763,273404473,282588555.4,24.2714706193498,26.005944255790045,NaN,NaN,-33.80605700215557,-30.64528724984832
2016-01-28T09:30:00-05:00,48.64,48.81,48.18,48.68,12553037,15603806.65,38.43283590114384,31.52219834604784,NaN,NaN,-61.75122186338354,-71.22842812195374,0.01716703516758189,-1.1737181712042855,-1.1908852063718673,285957510,283868896.6,25.89473106469832,25.6062521745089,NaN,NaN,-32.22081289389283,-30.870362341854676
2016-01-29T09:30:00-05:00,49,50.01,48.88,49.99,14570355,15784437.2,48.377554923770944,32.96287750816241,NaN,NaN,-2.9052148006433627,-55.89591427720435,0.14582324946916891,-1.0086061445354062,-1.1544293940045751,300527865,285506996.6,28.020599012662146,25.691527884785422,NaN,NaN,-27.415781789806186,-30.376850834419177
2016-02-01T09:30:00-05:00,49.59,50.1161,49.27,49.87,15940646,16242201.85,47.618774331674935,34.327316952335366,NaN,NaN,16.049260711280645,-35.36009306679618,0.22168476917552904,-0.8773234325351638,-1.0990082017106928,284587219,286863757.6,29.81644941422975,25.998387125600903,NaN,NaN,-23.8720009398826,-29.447586563771093
2016-02-02T09:30:00-05:00,49.38,49.42,48.705,48.87,15284769,16186211.3,41.74306775689036,34.97525408202652,NaN,NaN,-27.14413888095942,-27.84520410080418,0.2038140023038557,-0.8442406988308733,-1.048054701134729,269302450,282755903.4,27.573353379725347,26.179499403268636,NaN,NaN,-22.65933817251757,-28.47783679359202
2016-02-03T09:30:00-05:00,49.26,49.74,48.35,49.66,25732880,17036541.7,47.27769124130521,36.390091139542285,NaN,NaN,4.515849832306001,-14.247093000279941,0.24189955412571573,-0.7456802584775843,-0.9875798126033001,295035330,287082074.8,33.267186830334765,26.85272839030495,NaN,NaN,-19.79233286380148,-27.237050517907655
2016-02-04T09:30:00-05:00,49.59,50.91,49.55,50.52,18452296,17460156.5,52.56128512660154,37.78886217743398,NaN,NaN,121.9372432718039,22.49060002675755,0.31697683334288596,-0.5913587709246926,-0.9083356042675785,313487626,292588098,39.75834612272743,27.62145248367381,NaN,NaN,-15.577733173895906,-25.571433754477404
2016-02-05T09:30:00-05:00,50.25,50.54,49.8,50.04,15518119,17374784.9,49.57503936753384,39.232537486177876,NaN,NaN,106.07728808810963,44.28710060450815,0.32506601177002015,-0.5020030895550534,-0.8270691013250735,297969507,292076426.4,39.375043458001024,28.067429404018508,NaN,NaN,-13.127211064424332,-23.793687655898395
2016-02-08T09:30:00-05:00,49.49,49.76,48.97,49.62,20001178,17514913.95,47.055821835660765,40.49825206045256,NaN,NaN,39.8264729620661,49.04254305466524,0.2938324669313893,-0.4597785176608369,-0.7536109845922262,277968329,290752648.4,38.34505715843633,28.561723197022584,NaN,NaN,-11.926984261392068,-22.098444313826064
2016-02-09T09:30:00-05:00,49.04,50.26,49.04,49.92,15369951,17335289.7,49.047524652030376,42.082159607643284,NaN,NaN,71.36391907218464,68.74415464529406,0.28486852930933937,-0.397525322955552,-0.6823938522648914,293338280,295559814.4,44.06692402706199,29.863363722642077,NaN,NaN,-10.338321375755005,-20.418426751244485
2016-02-10T09:30:00-05:00,50.04,50.51,49.64,49.68,15079367,17124391.35,47.507790203019375,43.40326465033716,NaN,NaN,93.98984622715979,86.63895392426481,0.25522184301619044,-0.36336654849465333,-0.6185883915108438,278258913,292204531,41.193354058490506,31.08636673942516,NaN,NaN,-9.490091888963919,-18.857236056632978
2016-02-11T09:30:00-05:00,48.82,49.36,48.105,48.69,19180314,17135062.35,41.69339404254651,44.008473270974676,NaN,NaN,-36.99109987332612,54.85328529523881,0.16572078876218055,-0.41143740555811803,-0.5771581943202986,259078599,281322725.6,33.551805671569326,31.911593867016318,NaN,NaN,-10.545219042391667,-17.669805054598505
2016-02-12T09:30:00-05:00,48.98,49.68,48.875,49.67,19249081,17134454.85,48.422750474238946,45.29267118146608,NaN,NaN,38.261105290457444,41.29004873570837,0.1687390559209243,-0.3662343744191432,-0.5349734303400675,278327680,277394360.2,31.29485163221831,32.68454243167835,NaN,NaN,-9.300811957555878,-16.474234612163844
2016-02-16T09:30:00-05:00,50.3,50.73,49.87,50.67,15037927,16864622.35,54.22792141783602,46.39476516803936,NaN,NaN,130.0817508521055,59.34110431371626,0.23048018162766726,-0.24687320330548346,-0.4773533849331507,293365607,280473815.8,34.98679593334694,33.67256917020377,NaN,NaN,-6.2890082635039075,-15.019202276640996
2016-02-17T09:30:00-05:00,51,51.635,50.85,51.45,15619908,16903369.95,58.18161807000583,47.98021923887561,NaN,NaN,186.12636605749086,82.2935937107775,0.3112258885943942,-0.08832102419015797,-0.3995469127845522,308985515,283603262.8,38.597801180700245,34.69587849601452,NaN,NaN,-2.449702814126868,-13.223559496281835
2016-02-18T09:30:00-05:00,51.5,51.61,51.23,51.42,9587830,16078127.7,57.974198943030316,49.37603088472464,NaN,NaN,174.51239079731198,98.39810262480793,0.3472488210828667,0.034514113569031224,-0.3127347075138355,299397685,287831017.2,43.18860599244311,35.93115527656772,NaN,NaN,0.4784066961686456,-11.266135754503194
2016-02-19T09:30:00-05:00,50.98,51.375,50.89,51.32,12613634,15779117.95,57.24164678009613,50.00918030303359,NaN,NaN,136.8594849977946,133.16821959903208,0.3480933165346717,0.12238193815450416,-0.22571137838016753,286784051,293372107.6,48.611611799871376,37.401941904225524,NaN,NaN,2.620338782002227,-9.282353677859563
2016-02-22T09:30:00-05:00,51.8,52.44,51.8,52.19,12143817,15747230.75,61.767872427137156,51.01983016699517,NaN,NaN,183.53711467298817,162.22342147553823,0.3879541381471362,0.2592312943037527,-0.12872284384338348,298927868,297492145.2,52.260598036024504,39.005095377210864,NaN,NaN,5.903557581744651,-7.1129377836303895
2016-02-23T09:30:00-05:00,51.97,52.155,51.555,51.67,9727887,15506927.55,57.82766010668453,52.1687296205519,NaN,NaN,135.54175581208415,163.31542246753398,0.3605892883270081,0.3220137665653766,-0.038575521761631454,289199981,296659020,51.464784787495205,40.711626192051575,NaN,NaN,7.482335037106541,-5.0278988092393995
2016-02-24T09:30:00-05:00,51.06,51.83,50.735,51.7,17347268,15772375.6,57.99414292795222,52.9341904553124,NaN,NaN,95.35449877639994,145.16104901131578,0.3268010598483517,0.3699258030488082,0.04312474320045648,306547249,296171366.8,50.97547538064214,41.97650394564495,NaN,NaN,8.801202369603303,-3.052312926547585
2016-02-25T09:30:00-05:00,51.85,52.4,51.69,52.38,9312686,15416147.5,61.686206919026176,53.58597058334273,NaN,NaN,129.77833402294965,136.21423765644332,0.331494652598333,0.4574930589483728,0.12599840635003975,315859935,299463816.8,54.145401173395356,43.004150734978374,NaN,NaN,11.043379462338425,-1.0386425852781551
2016-02-26T09:30:00-05:00,52.51,52.85,52.44,52.45,8312343,15204112.8,62.05593044633695,54.47746280325724,NaN,NaN,137.89941658400144,136.42222397368465,0.3203775411933998,0.5264703328417895,0.2060927916483897,324172278,306941462.2,60.40699049471036,44.506432666171904,NaN,NaN,12.98007239457839,0.9640309832727794
2016-02-29T09:30:00-05:00,52.45,52.72,52.1,52.12,13823027,15166746.4,59.157694352560796,55.341882268750105,NaN,NaN,105.05748173390872,120.72629738586879,0.2736760933292414,0.5481879083099415,0.27451181498070004,310349251,309225738.8,62.10916606581622,46.20386901669904,NaN,NaN,13.832250267707865,2.802348023906363
2016-03-01T09:30:00-05:00,52.33,53.215,52.33,53.14,13424822,15040955.2,64.65280388796953,56.45654507131719,NaN,NaN,123.3968045524196,118.2973071339359,0.29264932280129174,0.6403234684823147,0.34767414568102295,323774073,316140557.2,66.76688860444213,47.82529505794041,NaN,NaN,16.25638150798561,4.724352807346255
2016-03-02T09:30:00-05:00,53,53.24,52.91,53.18,8877784,14720605.95,64.85251620255423,57.69545407128396,NaN,NaN,123.21468287352748,123.86934395336141,0.28858324211219283,0.708403198321264,0.41981995620907114,332651857,321361478.8,69.78675607059841,49.86768091594811,NaN,NaN,18.27845992560052,6.660653824239722
2016-03-03T09:30:00-05:00,53.15,53.61,53.06,53.56,9808973,13924410.6,66.77316157325052,59.486866037762816,NaN,NaN,129.36688659232075,123.7870544672356,0.29132998494315265,0.783982437388012,0.49265245244485933,342460830,326681657.8,72.52641196499425,52.651581365478464,NaN,NaN,20.556361272425992,8.645754888266332
2016-03-04T09:30:00-05:00,53.53,54.1,53.41,53.78,10006912,13502141.4,67.86791330792627,60.87580624016905,NaN,NaN,133.41124854488748,122.88942085941282,0.287328058595664,0.8518125256894393,0.5644844670937753,352467742,332340750.6,75.1116472191555,55.781352478831124,NaN,NaN,22.7814025860949,10.66513313081327
2016-03-07T09:30:00-05:00,53.5,53.955,53.42,53.94,11753981,13313934.5,68.67623197187896,61.907828422600694,NaN,NaN,119.02563073010838,125.68305065865275,0.27482204614749584,0.9080120247781451,0.6331899786306493,364221723,343115245,79.13693990663398,58.93493419120877,NaN,NaN,24.87748018802293,12.695468424700364
2016-03-08T09:30:00-05:00,53.5,53.54,53.1,53.18,12241121,12925931.65,60.846329467456165,62.098164950990004,NaN,NaN,84.68201111149537,117.94009197046792,0.19830279737447887,0.8810684753487479,0.682765677974269,351980602,348756550.8,80.88053070871308,61.95512915749539,NaN,NaN,24.560558884527843,14.39048134753286
2016-03-09T09:30:00-05:00,53.32,53.5,53.17,53.35,11060113,12710439.75,61.89291713358814,62.378073393172706,NaN,NaN,81.34388011978544,109.5659314197195,0.14457101284093987,0.8634794440254439,0.718908431184504,363040715,354834322.4,82.57057837140084,64.7681271845638,NaN,NaN,24.581979147229422,15.846409604632369
2016-03-10T09:30:00-05:00,53.47,53.71,52.815,53.27,12693338,12591138.3,61.06568741246175,62.65121915262739,NaN,NaN,71.51592330938107,97.99573876313157,0.0916547558225872,0.833476875962738,0.7418221201401508,350347377,356411631.8,82.99078659651559,67.22378252718124,NaN,NaN,24.376715517193748,17.06502473499828
2016-03-11T09:30:00-05:00,53.76,54.165,53.72,54.04,11059850,12185115.1,65.8032545203781,62.93946073071602,NaN,NaN,109.54706179491527,93.22290141313712,0.0960597278008708,0.8618967798912394,0.7658370520903686,361407227,358199528.8,83.47705855313399,69.45352970697478,NaN,NaN,25.52772496355868,18.273981910506908
2016-03-14T09:30:00-04:00,53.84,54.23,53.84,54.09,6946730,11569997.55,66.09178503726093,63.52975536861434,NaN,NaN,108.48758326426702,91.11529191996884,0.08999396220826861,0.8783295048507043,0.7883355426424357,368353957,359025975.6,83.70890600864715,71.75668122277135,NaN,NaN,26.55542145469622,19.457044702533953
2016-03-15T09:30:00-04:00,53.7,54.06,53.53,54.06,6948723,11165537.35,65.73341712142766,64.0825606681483,NaN,NaN,89.13218589206218,92.0053268760822,0.07237279106450978,0.8788015314730728,0.806428740408563,361405234,360910902,84.25167317421887,74.13355249374112,NaN,NaN,27.31776077632459,20.5800041416469
2016-03-16T09:30:00-04:00,53.94,54.565,53.81,54.25,11447932,10956938.55,66.95549238610539,64.4589382015111,NaN,NaN,106.88891835922803,97.11433452397071,0.06230758030519057,0.8843132157900513,0.8220056354848607,372853166,362873392.2,84.81878365090589,76.32450838499187,NaN,NaN,28.292903823034848,21.681846953273748
2016-03-17T09:30:00-04:00,54.59,55.62,54.26,55.44,17009423,11328018.2,73.36301640606234,65.26658719863435,NaN,NaN,165.23780363339458,115.85871058877342,0.1211815863501523,0.9734826184225511,0.8523010320723988,389862589,370776434.6,86.86942003522731,78.21468192360022,NaN,NaN,31.18652205477267,23.039657682059307
2016-03-18T09:30:00-04:00,55.3,55.75,55.24,55.63,17059773,11550325.15,74.22247220207562,66.34264275931397,NaN,NaN,185.49344375431443,131.04798698065326,0.1560852240664402,1.047407562155449,0.8913223380890088,406922362,379879461.6,88.75378370858155,80.11786889808346,NaN,NaN,33.83486918111199,24.58183075335255
2016-03-21T09:30:00-04:00,55.56,55.96,55.485,55.96,7150439,11300656.25,75.68962447666634,67.13098708707804,NaN,NaN,176.5413180795765,144.65873394371516,0.18271371606893694,1.11971448317518,0.937000767106243,414072801,389023230.4,90.26504287031705,81.7963084885031,NaN,NaN,36.5227127458378,26.2876710379933
2016-03-22T09:30:00-04:00,55.41,55.81,55.4,55.64,7570862,11192805,71.44327250901254,67.6017553946822,NaN,NaN,144.24332436028467,155.68096163735964,0.16086167450238642,1.138077860234226,0.9772161857318397,406501939,398042571.4,91.48109096022525,83.34590383776217,NaN,NaN,37.589230835736586,27.902179580528053
2016-03-23T09:30:00-04:00,55.52,55.59,55.23,55.28,10833202,10867101.7,66.89633320081026,67.61055336807932,NaN,NaN,114.46471064837071,157.19612009518818,0.10684915099860848,1.1107776244801002,1.0039284734814917,395668737,402605685.6,92.02393679255317,84.7385841825878,NaN,NaN,37.18120070686638,29.227754027147814
2016-03-24T09:30:00-04:00,54.96,55.12,54.74,55.12,10403597,10921647.25,64.9187704688644,67.39990030814633,NaN,NaN,76.14607614607728,139.3777745977247,0.04803048813722244,1.0639665836530199,1.0159360955157974,385265140,401686195.8,90.76877627777606,85.85695054391783,NaN,NaN,36.2769585568052,30.234783245670297
2016-03-28T09:30:00-04:00,55.13,55.275,54.89,55.14,6591652,10835612.7,65.05782099492869,67.14144238122131,NaN,NaN,74.42283150933957,117.16365214872977,0.0006605100264498454,1.0167617330488596,1.0161012230224098,391856792,398673081.8,86.60035628971217,86.39005171413771,NaN,NaN,35.56676841922911,30.996495413321558
2016-03-29T09:30:00-04:00,55.03,55.51,54.72,55.5,9271815,10608052.1,67.55101532670989,67.62034851402515,NaN,NaN,75.2449439379665,96.90437732040775,-0.015353941490723999,0.9969087961590049,1.0122627376497288,401128607,396084243,83.07050843330671,86.54647869446582,NaN,NaN,35.61181492925408,31.65582677274049
2016-03-30T09:30:00-04:00,55.99,56.0266,55.6,55.6,8197593,10346690.65,68.22915185413835,68.07293670835016,NaN,NaN,101.17558671853081,88.29082979205698,-0.027433450239522816,0.9779709248503252,1.005404375089848,409326200,396649095.2,83.23111195796666,86.5936596649348,NaN,NaN,35.82899284741855,32.25199335483735
2016-03-31T09:30:00-04:00,55.71,55.7899,55.4,55.47,12949115,10550257.2,66.28965178634812,68.44607702077062,NaN,NaN,78.09434813221407,81.01675728882563,-0.05102892158031014,0.9416182231144603,0.9926471446947704,396377085,396790764.8,83.27396982560313,86.61388703844105,NaN,NaN,35.502936320390454,32.7164137784878
2016-04-01T09:30:00-04:00,55.15,55.73,54.75,55.73,16184593,10869038.2,68.2345189421512,68.61973876518297,NaN,NaN,60.37167987320179,77.86187803425054,-0.05560026745186997,0.923146810379933,0.9787470778318029,412561678,402250072.4,84.87789506690122,86.71394678942443,NaN,NaN,35.725067245792694,33.14622141667421
2016-04-04T09:30:00-04:00,55.54,55.605,55,55.1,12014932,10969439.2,59.306039358513736,68.13504264527246,NaN,NaN,42.505244140003015,71.47836056038322,-0.10467901907492017,0.8478983039881527,0.9525773230630729,400546746,403988063.2,85.35923254727321,86.83182725646915,NaN,NaN,33.353294111515545,33.17580323022297
2016-04-05T09:30:00-04:00,54.73,55.01,54.56,54.76,11244897,10943985,55.11460090249972,67.37655577249188,NaN,NaN,0.24485825739591588,56.4783434242691,-0.16033565394641147,0.7521577556300585,0.91249340957647,389301849,401622711.6,81.55454900724978,86.63917553025706,NaN,NaN,30.059033993622748,32.730550482137225
2016-04-06T09:30:00-04:00,54.74,55.03,54.25,55.03,10962441,10880051,57.67290499561753,66.71351381602845,NaN,NaN,-8.056515780644512,34.63192292443405,-0.17790335351837705,0.6901142176784987,0.8680175711968757,400264290,399810329.6,78.66141525934631,86.19936350228853,NaN,NaN,27.967889048731504,32.05017027736498
2016-04-07T09:30:00-04:00,54.57,54.86,54.33,54.5,13364507,10995270.7,51.47123755519808,65.14981532668102,NaN,NaN,-39.94656248079023,11.023740801833197,-0.2213253718343957,0.591360856403881,0.8126862282382767,386899783,397914869.2,75.63925679470601,85.39720898510845,NaN,NaN,24.201870217206515,30.928984554485197
2016-04-08T09:30:00-04:00,54.84,55.315,54.67,54.71,9188866,10820047.1,53.60026029032939,63.676800190127715,NaN,NaN,-12.942637509017,-3.6391226746105607,-0.230946605789199,0.524002971001778,0.754949576790977,396088649,394620263.4,70.56450067642129,84.09797448281128,NaN,NaN,21.677782579415624,29.6073842723324
2016-04-11T09:30:00-04:00,54.98,55.34,54.71,54.73,7710122,10652560.7,53.808106558769445,62.11383462456365,NaN,NaN,-17.529750139716327,-15.64612153055443,-0.23047678404921568,0.46685359672945737,0.697330380778673,403798771,395270668.4,70.9784560570632,82.72036113900742,NaN,NaN,19.679512130562323,28.189116823508105
2016-04-12T09:30:00-04:00,54.75,55.33,54.66,55.05,10724259,10841437.15,57.117946043024666,61.09059701985023,NaN,NaN,-13.125499351719574,-18.320193052377526,-0.20403611057112658,0.44228524256476476,0.6463213531358913,414523030,400314904.6,74.0289354970336,81.47377860592232,NaN,NaN,18.869535628248684,26.857748081328186
2016-04-13T09:30:00-04:00,55.56,56.02,55.49,55.87,13215527,11154777.35,64.19746165502556,60.897820480865626,NaN,NaN,117.366199777368,6.764350059224974,-0.13032960268037264,0.4834093497854255,0.6137389524657981,427738557,405809758,76.8798466232436,80.39205787954306,NaN,NaN,20.34042679478446,25.926702183250512
2016-04-14T09:30:00-04:00,56.14,56.2,55.885,55.97,13195465,11242154,64.9572574469422,60.90056955072833,NaN,NaN,147.1111078206656,44.17588411951614,-0.076513272830246,0.5180973614279907,0.5946106342582367,440934022,416616605.8,81.24124328896036,79.71151980891338,NaN,NaN,21.760666757392606,25.33155426527081
2016-04-15T09:30:00-04:00,56.07,56.1,55.9,56.05,10781632,10930764.45,65.586455175151,60.93832913502991,NaN,NaN,126.95359570743584,72.1551307628067,-0.03908682622774662,0.5457521014735534,0.5848389277013,451715654,427742006.8,84.48586311274106,79.56048458198687,NaN,NaN,23.10687973756357,25.01374361845549
2016-04-18T09:30:00-04:00,55.8,56.29,55.71,56.1,8618994,10508725.5,65.99738351689606,60.82735543432892,NaN,NaN,117.58515646635439,99.17811208402085,-0.015720640226335347,0.5651881274183808,0.5809087676447161,460334648,439049182.2,86.95539117500958,79.83797620639423,NaN,NaN,24.333538663644504,24.91657148205392
2016-04-19T09:30:00-04:00,56.4,56.72,56.28,56.5,9318780,10617142.55,69.16912118518127,60.894496100831994,NaN,NaN,175.02238050565518,136.80768805549582,0.019979965597064053,0.6058837246410462,0.5859037590439822,469653428,450075261.8,88.8236535956492,80.23744346622868,NaN,NaN,26.350043011997613,25.121353129188734
2016-04-20T09:30:00-04:00,56.52,56.705,56.26,56.41,13632607,10920229.8,67.64029670434047,60.99097073783145,NaN,NaN,145.59998316723102,142.4544447334684,0.030223868403963072,0.6236835945489361,0.593459726144973,456020821,455731714.6,89.64314157074713,80.69238430516755,NaN,NaN,27.60972196327007,25.476834391200352
2016-04-21T09:30:00-04:00,56.39,56.6,56.21,56.27,11941761,10975657.75,65.22521890615263,60.776020735260126,NaN,NaN,113.11450146401872,135.65512346213902,0.020715231125386202,0.6193537650517058,0.5986385339263196,444079060,456360722.2,89.73329252496823,81.03919840931519,NaN,NaN,28.02450438463535,25.840787247405352
2016-04-22T09:30:00-04:00,56.31,56.5,56.14,56.41,14750155,11192985.65,66.51284153993367,61.29079231964726,NaN,NaN,99.4007822978359,130.14456078021902,0.017146274536901096,0.620071377097446,0.6029251025605449,458829215,457783434.4,89.94645336890078,81.36685703943145,NaN,NaN,28.727490726521026,26.25317345870759
2016-04-25T09:30:00-04:00,56.36,56.38,55.87,56.14,10224099,11374608,61.76306224955269,61.765682415865335,NaN,NaN,65.43000359987633,119.71353020692342,-0.00871703665722312,0.592028806739016,0.6007458433962392,448605116,455437528,86.74818468151966,81.73783101616502,NaN,NaN,28.042456884435435,26.508785376668712
2016-04-26T09:30:00-04:00,56.27,56.64,56.2401,56.64,10139889,11418011.7,66.52976060345364,62.39831495928219,NaN,NaN,99.35487197559459,104.58002850091131,0.0019612491345645244,0.6031974048144448,0.6012361556798803,458745005,453255843.4,83.7651371341182,82.10238257864873,NaN,NaN,28.807005731283237,26.837102570185074
2016-04-27T09:30:00-04:00,56.71,57.18,56.48,57.04,9258143,11471039.2,69.77586927698559,63.70578865369559,NaN,NaN,126.83621993237223,100.82727585393955,0.028597090137246095,0.6369825183514379,0.6083854282141918,468003148,455652308.8,84.39973082869845,82.72813072393389,NaN,NaN,30.470375498855528,27.356141559995137
2016-04-28T09:30:00-04:00,56.65,57.14,56.355,56.49,19554920,11801329.45,61.01357048538063,64.23531081048496,NaN,NaN,91.33583171407702,96.47154190395122,0.003146563618093623,0.6123186327368089,0.6091720691187152,448448228,456526142.4,84.63556459891748,83.7332067183979,NaN,NaN,29.151990274470446,27.612691376348753
2016-04-29T09:30:00-04:00,56.17,56.4,55.82,56.16,16369932,11810596.4,56.43434308702292,64.42289913393164,NaN,NaN,33.62473191537843,83.31633182745973,-0.03958381594306526,0.5596922991898836,0.5992761151329489,432078296,451175958.6,76.96396414338093,84.16074301027774,NaN,NaN,26.56921600068996,27.463623465540355
2016-05-02T09:30:00-04:00,56.27,56.49,56.02,56.45,10145145,11717107.05,59.323543225972244,64.58044178985647,NaN,NaN,49.46341422665947,80.12301395281636,-0.051247704428894814,0.5352164845968304,0.5864641890257252,442223441,449899623.6,75.2124900902026,84.2452826240755,NaN,NaN,25.31972659522015,27.15735248406604
2016-05-03T09:30:00-04:00,56.08,56.08,55.6,55.99,11171359,11713430.15,53.28686474561875,63.801113439184554,NaN,NaN,-2.633334810698333,59.72537259555778,-0.0905747218370827,0.4732457867293718,0.5638205085664545,431052082,444361039,67.982582653026,83.60976376905998,NaN,NaN,22.272640556096277,26.459536494356072
2016-05-04T09:30:00-04:00,55.69,55.73,55.06,55.3,22102900,12270453.1,45.76418403768942,62.43017962423793,NaN,NaN,-74.95764062808855,19.366600483465607,-0.15965048985819696,0.36425739624370834,0.5239078861019053,408949182,432550245.8,55.68903063772862,81.78460572254343,NaN,NaN,16.96320283316838,25.102917399900686
2016-05-05T09:30:00-04:00,55.45,55.59,55.15,55.27,12841127,12244284.1,45.46366378904761,60.9928373823734,NaN,NaN,-92.46686762171682,-17.39393938369316,-0.20126759865243804,0.2723233877863578,0.4735909864387958,396108055,422082211.2,47.49176834077063,79.14217038168839,NaN,NaN,12.752133988833988,23.338519769748302
2016-05-06T09:30:00-04:00,55.04,55.675,54.94,55.64,9934378,12281559.7,49.83870278154589,59.838645901276955,NaN,NaN,-91.10518124054131,-42.33992201487711,-0.19750671909726136,0.2267075875672191,0.42421430666448046,406042433,416875038.6,44.02059287009815,76.0753990741947,NaN,NaN,10.585566586137992,21.516669314946828
2016-05-09T09:30:00-04:00,55.52,55.63,55.27,55.39,7765106,12284308.9,47.089881316545025,58.26155733923151,NaN,NaN,-100.17203833568294,-72.2670125273456,-0.2046177408858617,0.1684421305571533,0.373059871443015,398277327,408085815.8,38.85795825957218,72.5064208359035,NaN,NaN,7.931266904500629,19.575897542025942
2016-05-10T09:30:00-04:00,55.55,56.35,55.55,56.34,14983063,12497249.1,56.833035839717745,57.4896101346156,NaN,NaN,-0.8977520941353961,-71.919895984033,-0.14112272649785773,0.19665646332069286,0.3377791898185506,413260390,404527477.4,36.96770726663299,68.74388981418106,NaN,NaN,8.844115212949161,18.042785780729258
2016-05-11T09:30:00-04:00,56.3,56.48,55.87,55.87,12801978,12476571.65,51.75525190288143,56.527469634381944,NaN,NaN,-5.077128872095241,-57.94379363283434,-0.1270011654565416,0.17902773299787356,0.30602889845441517,400458412,402829323.4,36.06602751822756,64.91051374227101,NaN,NaN,7.843732886360908,16.58577822439092
2016-05-12T09:30:00-04:00,55.88,56.13,55.41,55.75,13992392,12516418,50.514297703599375,55.38471650321521,NaN,NaN,-62.25977196732125,-51.90237450195523,-0.12194056033279199,0.15360319803842515,0.27554375837121714,386466020,400900916.4,35.021380963026786,60.987294284708575,NaN,NaN,6.656726593327987,15.167342277096216
2016-05-13T09:30:00-04:00,55.66,55.88,54.9,55.05,13017961,12628234.45,43.90154068279343,54.108893534160984,NaN,NaN,-132.70023415447116,-60.2213850847412,-0.1595607899323368,0.07609277095579614,0.23565356088813294,373448059,394382041.6,31.68077335697697,57.05390776152696,NaN,NaN,3.3589118563738483,13.48042364556445
2016-05-16T09:30:00-04:00,55.05,55.9,55.05,55.73,9210833,12657826.4,50.65884001074431,52.975256348967456,NaN,NaN,-74.4936637248188,-55.085710162568375,-0.13352837788671187,0.06874308852974309,0.20227146641645496,382658892,391258354.6,30.19449705953629,53.22743347048539,NaN,NaN,2.9164388059910373,11.97128295419682
2016-05-17T09:30:00-04:00,55.55,56.04,55.27,55.46,11830078,12783391.3,48.17739273911625,51.43250802483393,NaN,NaN,-62.02140651005372,-67.31044104575204,-0.12928682771400843,0.04066293177394442,0.16994975948795285,370828814,382772039.4,26.550243273476624,49.09532721654097,NaN,NaN,1.7313631519311596,10.508437268158868
2016-05-18T09:30:00-04:00,55.31,55.76,54.96,55.27,13609444,12782233.15,46.45299268204205,50.39246675316689,NaN,NaN,-92.5275145126089,-84.80051817385477,-0.13352563273517465,0.003042718568984526,0.13656835130415917,357219370,374124231,23.444955772530164,44.72456944322759,NaN,NaN,0.23230532643764265,9.04041841934155
2016-05-19T09:30:00-04:00,54.83,55.03,54.39,54.75,15143060,12942298.1,42.02010899621929,49.36287860382378,NaN,NaN,-161.2349390713516,-104.59555159466083,-0.16361305206993645,-0.0679479637832614,0.09566508828667505,342076310,365246289,20.760468285881004,40.710034024834734,NaN,NaN,-2.491973509305218,7.392933858106298
2016-05-20T09:30:00-04:00,54.97,55.32,54.96,55.03,9397852,12674682.95,45.06028290612002,48.3440742952629,NaN,NaN,-96.35820355008047,-97.3271454737827,-0.1568976115516384,-0.10045692615287294,0.056440685398765456,351474162,360851509.6,19.566132574857207,36.735294202310065,NaN,NaN,-3.753895679374585,5.800529638466172
2016-05-23T09:30:00-04:00,54.96,55.15,54.74,54.93,7617219,12544338.95,44.169503430564646,47.69283420133047,NaN,NaN,-107.28847982662914,-103.88610869414477,-0.15135999681289994,-0.13275931061735946,0.01860068619554047,343856943,353091119.8,17.636667430170405,33.13915740067753,NaN,NaN,-5.036037145958522,4.252448669262645
2016-05-24T09:30:00-04:00,55.16,55.66,55.14,55.5,7274461,12401067.55,50.21130639506379,48.010485798285785,NaN,NaN,-34.56900180768562,-98.39562775367115,-0.10374809656203177,-0.11108443450699923,-0.007336337944967471,351131404,349151637.8,16.734504316645186,30.35669123488586,NaN,NaN,-4.268353899474079,3.035191159443113
2016-05-25T09:30:00-04:00,55.6,56.025,55.6,55.88,11183819,12497351.35,53.80072149061528,48.605989919826335,NaN,NaN,38.50485100485832,-72.1891546501777,-0.044149636979820966,-0.06252338416974368,-0.018373747189922712,362315223,350170808.4,17.90448959706052,28.24331418176372,NaN,NaN,-2.4903513447902244,2.2458279445526363
2016-05-26T09:30:00-04:00,55.91,56.11,55.72,55.72,6108372,11825023.95,52.09765274121773,48.76734348837432,NaN,NaN,54.818395567183785,-28.97848772247063,-0.014523396468357031,-0.036527992775369,-0.02200459630701197,356206851,352996916.6,21.210544099899636,26.6140249838924,NaN,NaN,-1.5473984095228517,1.7039384653989953
2016-05-27T09:30:00-04:00,55.84,55.95,55.78,55.93,6250015,11319028.1,54.14917046307011,49.271578427411825,NaN,NaN,67.0396796879097,3.7010889251273995,0.018409418676150098,0.001007177038175655,-0.017402241637974443,362456866,355193457.4,23.779734162746863,25.537008976976303,NaN,NaN,-0.15331360088528856,1.4386167416440976
2016-05-31T09:30:00-04:00,56,56.16,55.71,55.92,11290310,11376286.35,54.030505393906225,49.07139768128243,NaN,NaN,85.05370471510113,42.16952583347345,0.03760649332398903,0.02960587501701184,-0.008000618306977186,351166556,356655380,25.520477746995212,24.719349725573608,NaN,NaN,0.9466870726655042,1.3683410746471556
2016-06-01T09:30:00-04:00,55.63,56,55.411,55.97,11013018,11368369.3,54.566623885025486,49.27220996572129,NaN,NaN,57.22582912528692,60.52849202006796,0.050931276583092,0.05566347742188782,0.004732200838795815,362179574,358865014,28.189978502197718,24.15677479585719,NaN,NaN,2.0072796334192273,1.4596180116145945
2016-06-02T09:30:00-04:00,55.85,56.07,55.72,56.04,6113502,10568899.4,55.35169456320788,49.61773831283618,NaN,NaN,81.47749493210574,69.12302080551744,0.06103718480301211,0.08102868184256096,0.019991497039548844,368293076,360060584.6,29.659043468614826,23.773750689113477,NaN,NaN,3.110517048419139,1.695460731158101
2016-06-03T09:30:00-04:00,55.92,56.13,55.5501,55.99,11948796,10524282.85,54.62561084009056,50.383743324071695,NaN,NaN,63.56784590650054,70.87291087338079,0.06079856035138346,0.09598969747877817,0.03519113712739471,356344280,360088070.4,29.6946526624738,23.63188492522039,NaN,NaN,3.8664605675844217,2.0056035649332897
2016-06-06T09:30:00-04:00,56.12,56.57,56.08,56.52,8888057,10471966.8,60.5351875198576,51.08919671757979,NaN,NaN,147.56988147650307,86.97895123109947,0.09096436511312354,0.14889659351879914,0.05793222840567559,365232337,360643164.6,30.460301568051506,23.650870961542903,NaN,NaN,6.218406172693381,2.607432508899017
2016-06-07T09:30:00-04:00,56.63,56.96,56.53,56.79,8372740,10502348.5,63.16700175112925,52.159883075580716,NaN,NaN,189.4090466780193,107.8500196236831,0.12180581696099482,0.21018949960691913,0.0883836826459243,373605077,365130868.8,36.48277687773695,24.3603376475615,NaN,NaN,9.02060296547847,3.523599716981796
2016-06-08T09:30:00-04:00,56.97,57.22,56.86,57.15,9201770,10213283.85,66.38578397483874,53.583653882209035,NaN,NaN,214.36212333434148,139.27727846549402,0.1569199610919965,0.2845336340109199,0.12761367291892342,382806847,369256323.4,41.49858450731376,25.649882557188903,NaN,NaN,12.447056100261712,4.798379200307498
2016-06-09T09:30:00-04:00,56.84,57.17,56.78,57.14,9984738,10072421.85,66.21269159579481,55.31169549646443,NaN,NaN,179.88208410290005,158.95819629965288,0.1689012165660323,0.3387401936264638,0.1698389770604315,372822109,370162130,42.57091733111658,27.20777177470573,NaN,NaN,15.211052198201788,6.285903914292397
2016-06-10T09:30:00-04:00,56.68,56.81,56.32,56.47,13734253,10059514.9,55.728403498849524,56.07370411023083,NaN,NaN,94.73966222552274,165.19255956345734,0.12325053022096144,0.3239021398366333,0.20065160961567186,359087856,370710845.2,43.249540682746336,28.8994437824121,NaN,NaN,14.6959265607889,7.487335720934754
2016-06-13T09:30:00-04:00,56.45,56.52,55.86,55.86,18830446,10350139.15,48.23917186623585,56.364394712778775,NaN,NaN,27.92540975142985,141.26366521844267,0.04741849061198061,0.2599247228806476,0.212506232268667,340257410,365715859.8,38.7595303324216,30.408219704001464,NaN,NaN,11.809794806226815,8.104829875976478
2016-06-14T09:30:00-04:00,55.79,56.04,55.54,55.87,12839024,10531548.7,48.36168638558133,56.23227899781574,NaN,NaN,-11.687224665315172,101.04441094977577,-0.003896520454959196,0.20763558169996799,0.21153210215492718,353096434,361614131.2,35.50029867080531,31.74863358644148,NaN,NaN,9.564564960567152,8.31336345948943
2016-06-15T09:30:00-04:00,56.03,56.325,55.84,55.89,10429620,10461525.8,48.62360397161019,55.86248488931538,NaN,NaN,14.843381684439256,61.14066261979533,-0.036507657734876575,0.16589752998633145,0.20240518772120802,363526054,357757972.6,32.715091443504804,32.80653371833036,NaN,NaN,7.819984519499151,8.242880753776534
2016-06-16T09:30:00-04:00,55.63,56.13,55.21,55.99,15040356,10533071.4,49.98947198986178,55.71190054993281,NaN,NaN,-25.35901039215756,20.092443720783802,-0.050497418133645,0.13928341505415176,0.18978083318779676,378566410,358906832.8,34.36721795453333,33.746296136518474,NaN,NaN,6.732871261203123,8.027165111980333
2016-06-17T09:30:00-04:00,55.57,55.92,55.46,55.73,15947789,10573307.85,46.52609524162268,55.16739517697228,NaN,NaN,-48.15855799459678,-8.48720032324008,-0.07494155904609551,0.09610388438017736,0.17104544342627287,362618621,359612985.8,35.41690727712911,34.57752278754578,NaN,NaN,4.803686665325727,7.566668191029675
2016-06-20T09:30:00-04:00,56.15,56.76,56.15,56.24,11778736,10692352.05,53.353035283511616,55.11900445480124,NaN,NaN,56.68816439164607,-2.7346493951968256,-0.05534649275907663,0.10186232747742707,0.1572088202365037,374397357,366440975.2,44.63705470882057,35.9429925705333,NaN,NaN,5.06954197049952,7.209935873811081
2016-06-21T09:30:00-04:00,56.28,56.39,56.1,56.2,8451422,10734062.2,52.78384210309168,54.991662898948825,NaN,NaN,20.86949013111343,3.776693564088906,-0.044149279581999934,0.1020222207590038,0.14617150034100374,365945935,369010875.4,47.665470186578105,37.334099119417615,NaN,NaN,5.1236620566603355,6.91189675707526
2016-06-22T09:30:00-04:00,56.18,56.41,56,56.04,10509050,10895791.65,50.46467158061287,54.64258982876346,NaN,NaN,-0.7719455415890072,0.6536281188832589,-0.046360148977509175,0.08822131411911727,0.13458146309662644,355436885,367393041.6,45.961005069112936,38.498524948024624,NaN,NaN,4.516363175900576,6.569677674050305
2016-06-23T09:30:00-04:00,56.6,56.73,56.38,56.69,8840642,10778632.8,58.45135709232213,54.91585741820858,NaN,NaN,78.44530601936795,21.414491401188332,-0.0050610754952769565,0.12825511872753026,0.13331619422280722,364277527,364535265,43.0336747928601,39.451312243052215,NaN,NaN,6.428899199371106,6.549566463381848
2016-06-24T09:30:00-04:00,54.72,55.48,54.23,54.38,34954049,12220916.65,36.14644758514263,53.173804565728936,NaN,NaN,-243.06633007205883,-17.56706301430408,-0.12754452810584085,-0.026114465909493845,0.10143006219634701,329323478,357876236.4,37.10353673893968,39.9258290409728,NaN,NaN,-0.9778768720134815,5.47421741546823
2016-06-27T09:30:00-04:00,53.84,54.12,52.78,53.1,40314346,13924133.2,29.442089924827854,50.764882292421696,NaN,NaN,-344.25651629301905,-97.75599915123709,-0.2802400165850576,-0.24886995853497496,0.031370058050082625,289009132,340798591.4,26.87511739328761,39.23956764922642,NaN,NaN,-10.096969270061752,3.249762174678233
2016-06-28T09:30:00-04:00,53.77,54,53.385,54,18523896,14285812.5,38.131290692365084,48.74670420081644,NaN,NaN,-219.4517333755823,-145.82024385257625,-0.30410604321189943,-0.3487624959647917,-0.04465645275289225,307533028,329116010,22.338408070547743,37.870983618028845,NaN,NaN,-13.185025281336449,0.9019353952475639
2016-06-29T09:30:00-04:00,54.57,55.04,54.42,54.96,14316349,14450979.05,45.798832794995725,47.28857142933078,NaN,NaN,-99.0559261054034,-165.47703996533915,-0.24145098342271792,-0.34647018203128965,-0.10501919860857173,321849377,322398508.4,20.224341670503648,36.274799642270786,NaN,NaN,-12.233015566100484,-0.9744861706593
2016-06-30T09:30:00-04:00,54.87,56.025,54.86,56.01,19397757,15115191.8,52.70314090357898,47.072481243954314,NaN,NaN,-19.044841535105576,-184.97506947623384,-0.12155675925136653,-0.2569651476727799,-0.13540838842141337,341247134,317792429.8,18.903312046956287,34.53578331114292,NaN,NaN,-8.531496007234995,-2.054059004455828
2016-07-01T09:30:00-04:00,56.03,56.46,55.99,56.19,23322746,15683889.3,53.78985853223898,47.46895886295454,NaN,NaN,33.295019157091396,-129.7027996304038,-0.02731550417766246,-0.16955276864349145,-0.142237264465829,364569880,324841710.2,26.785280468717687,33.68047974944979,NaN,NaN,-5.461644961745147,-2.540856998354302
2016-07-05T09:30:00-04:00,55.88,56.2701,55.42,55.68,14808577,15979915.3,50.26582842476827,47.604969008610745,NaN,NaN,-2.955764446824102,-61.442649261164796,0.0019347540541748143,-0.13981882189811046,-0.14175357595228527,349761303,336992144.4,37.97523661328908,33.857261031055764,NaN,NaN,-4.381885490292676,-2.8038610686312126
2016-07-06T09:30:00-04:00,55.52,56,55.0901,55.96,12776363,16200096.45,52.12047671851488,47.854745633389655,NaN,NaN,-8.336259090503171,-19.219554404148973,0.0393281124001979,-0.09259343545203791,-0.1319215478522358,362537666,347993072,46.01954504724584,34.8075791456087,NaN,NaN,-2.9045652298418623,-2.818247377375591
2016-07-07T09:30:00-04:00,56.05,56.38,55.87,56.11,8697860,16174900.95,53.128870153540674,48.07898835936671,NaN,NaN,41.7941376732149,8.950458351574698,0.07147925348592073,-0.042572480994834905,-0.11405173448075563,371235526,357870301.8,52.034632045040134,36.06953729493061,NaN,NaN,-1.4262677640676158,-2.619393146903023
2016-07-08T09:30:00-04:00,56.6,57.33,56.14,57.23,16226352,16486981.65,59.91702294454044,49.035483195289416,NaN,NaN,124.77590559370731,37.71460777733728,0.16039947663422996,0.08644761131203182,-0.07395186532219813,387461878,367113250.6,56.8771666539013,37.60241296470006,NaN,NaN,2.23628549222094,-1.925724769885314
2016-07-11T09:30:00-04:00,57.35,57.72,57.27,57.59,15259741,16563256.05,61.830535915001896,49.64101895468157,NaN,NaN,175.79608778011104,66.2148215019412,0.23137310823420673,0.2152645199705603,-0.016108588263646452,402721619,374743598.4,60.42890895409028,38.73040255364789,NaN,NaN,5.794469712260543,-0.8228398438644773
2016-07-12T09:30:00-04:00,57.89,58.205,57.78,58.12,13635142,16303490.85,64.51624555285227,50.47904777252162,NaN,NaN,191.45993745662196,105.09796188263041,0.29769926562146176,0.35601549376318076,0.058316228141719,416356761,388062690,65.73420821122374,40.02102669826543,NaN,NaN,9.613138395073937,0.6680141902695818
2016-07-13T09:30:00-04:00,58.27,58.31,57.9,58.26,13119818,16317530.55,65.21255514149429,51.53246802687029,NaN,NaN,169.30544004137656,140.62630170900636,0.33206814370610216,0.4734014077743467,0.14133326406824454,429476579,401450472.6,70.07688399395093,41.743589478611,NaN,NaN,12.863181246250122,2.4101809125525158
2016-07-14T09:30:00-04:00,58.64,58.87,58.46,58.7,11795390,16385819.05,67.37914859546281,52.17016741995177,NaN,NaN,174.98444770075096,167.2643637145136,0.36299359353348526,0.5950752559851011,0.23208166245161588,441271969,415457761.2,73.8159532674961,43.94232365537072,NaN,NaN,16.25781236357304,4.388413976984019
2016-07-15T09:30:00-04:00,58.89,58.92,58.55,58.69,6238040,15945703.25,67.27659499660528,54.39374937791339,NaN,NaN,150.08803442871832,172.3267894815158,0.36059432151400045,0.6828245643441164,0.322230242830116,435033929,424972171.4,76.00885952519114,46.72127528296011,NaN,NaN,18.946308777171833,6.468113234153707
2016-07-18T09:30:00-04:00,58.61,58.7475,58.45,58.64,5983637,15447495.65,66.729705874882,57.05715051720297,NaN,NaN,122.71538947309088,161.71064982011177,0.3340589592997562,0.7398039419548113,0.40574498265505504,429050292,430237906,77.14948000520265,50.312301183811186,NaN,NaN,21.003956643557807,8.544662292640007
2016-07-19T09:30:00-04:00,58.45,58.75,58.35,58.67,7393898,15228253.75,66.90354705728436,59.11231168612578,NaN,NaN,104.90296875520465,144.3992560798283,0.29813061604407054,0.7784082527101432,0.4802776366660727,436444190,434255391.8,78.00854172625905,54.28873930207628,NaN,NaN,22.759295373808122,10.575324161378308
2016-07-20T09:30:00-04:00,58.65,58.99,58.6,58.78,5491553,15080260.3,67.57260571207897,60.66758118020315,NaN,NaN,100.6255626987017,130.66328061129332,0.2626242704919556,0.8085579747810172,0.5459337042890616,441935743,436747224.6,78.54725827356121,58.45466191658039,NaN,NaN,24.42612611853046,12.554010155257187
2016-07-21T09:30:00-04:00,58.55,58.69,58.07,58.18,7583267,14933971.15,60.40020709977798,61.21737162278878,NaN,NaN,70.32031024867771,109.73045312087865,0.18333461108385962,0.7751019681438862,0.5917673570600266,434352476,435363326,77.41305589509811,62.63392933430481,NaN,NaN,24.01959813533409,14.191951295268172
2016-07-22T09:30:00-04:00,57.92,58.295,57.7,58.29,8747793,14929328.7,61.21304795270672,61.74759943853648,NaN,NaN,55.19313231086647,90.75147269730829,0.12565159838779483,0.7488318550447701,0.6231802566569753,443100269,436976594,77.81521843316585,66.27892490319395,NaN,NaN,23.888714583277526,15.577203193555222
2016-07-25T09:30:00-04:00,58.15,58.16,57.8001,57.98,11063247,13734788.6,57.623296344156024,62.273132861349886,NaN,NaN,45.206665130252,75.2497278287405,0.05744524788987415,0.694986816519318,0.6375415686294439,432037022,437573940,77.9716163239954,69.13580916824442,NaN,NaN,22.811480307796188,16.610671352732503
2016-07-26T09:30:00-04:00,58.06,58.55,57.98,58.46,9375992,12187870.9,61.39809157085532,62.93581963651707,NaN,NaN,56.130264456359036,65.49518696897137,0.036503587803463744,0.6831710533837736,0.6466674655803099,441413014,438567704.8,78.24637393211837,71.43772551716388,NaN,NaN,22.87410396641863,17.505447440401948
2016-07-27T09:30:00-04:00,58.46,58.6425,58.01,58.23,10760694,11799710.8,58.69988759746448,63.33374945394019,NaN,NaN,49.91486488238753,55.35304740570855,0.0008905760528914453,0.6477806856464241,0.6468901095935327,430652320,436311020.2,75.93029104130075,73.14455830261106,NaN,NaN,22.18544427999855,18.174018417487176
2016-07-28T09:30:00-04:00,58,58.34,57.82,58.21,6505645,11409175.6,58.45930710374665,63.22962689388349,NaN,NaN,34.54367897572444,48.1977211511179,-0.028651582167047218,0.6110756318847237,0.6397272140517709,424146675,434269860,73.80239101716968,74.35350289998738,NaN,NaN,21.54904540753027,18.656165130350473
2016-07-29T09:30:00-04:00,58.03,58.24,57.83,58.04,10712399,10974907.7,56.34540319304425,62.837831699457944,NaN,NaN,23.1829601739697,41.79568672373854,-0.06234734507724815,0.5617930327052107,0.6241403777824589,413434276,428336661.4,67.85011300341016,74.88358890351023,NaN,NaN,20.445674617363,18.911809342780835
2016-08-01T09:30:00-04:00,57.93,58.18,57.75,57.97,7949577,10206249.25,55.45617083130124,62.19068350506144,NaN,NaN,12.06442621012772,35.167238939713684,-0.09035625077446996,0.5111950643143715,0.6015513150888414,405484699,423026196.8,62.95595581878501,74.68514230405033,NaN,NaN,19.277666161005534,18.96407460252722
2016-08-02T09:30:00-04:00,57.84,57.96,57.27,57.43,13473845,10139512.65,49.028079306591216,61.03464951685408,NaN,NaN,-42.429066026902,15.455372843061479,-0.1431208332457633,0.4226502735316373,0.5657711067774006,392010854,413145764.8,55.00598742471246,73.60864969196186,NaN,NaN,16.422556741290524,18.601000622350547
2016-08-03T09:30:00-04:00,57.43,57.73,57.396,57.71,6087911,9805090.05,52.126740717121116,59.94519181125825,NaN,NaN,-60.782875602491735,-6.684175253914374,-0.15597910205957788,0.37079722920292824,0.5267763312625061,398098765,406635053.8,50.48218248476699,71.94195177890978,NaN,NaN,14.76387082951579,18.052839223374153
2016-08-04T09:30:00-04:00,57.75,57.955,57.64,57.73,8028720,9771633.05,52.34956710647064,58.87897553339148,NaN,NaN,-61.62181714992478,-25.917274479044217,-0.15938789955582344,0.32754145681772684,0.4869293563735503,406127485,403031215.8,48.12296587887163,69.95010223274411,NaN,NaN,13.440095124450405,17.39387578067076
2016-08-05T09:30:00-04:00,58.06,58.37,57.98,58.31,7380052,9329318.05,58.39712035340475,58.283790853285964,NaN,NaN,10.983530971636261,-28.3571603195109,-0.12059408769754265,0.33618674675162197,0.4567808344491646,413507537,403045868,48.13357888065172,67.87753786670476,NaN,NaN,13.907337674845005,16.89579890840994
2016-08-08T09:30:00-04:00,58.42,58.63,58.27,58.39,6052662,8868964.1,59.166909491086074,57.731173884271804,NaN,NaN,50.678228748876414,-20.634399811761163,-0.0890161072068924,0.3455107004405491,0.4345268076474415,419560199,405860968,50.239878746872584,65.89406193960572,NaN,NaN,14.508866931135719,16.554808625942194
2016-08-09T09:30:00-04:00,58.35,58.54,58.265,58.37,4579816,8416197.8,58.87362180318554,57.10981789077942,NaN,NaN,37.49563322656579,-4.649459961067604,-0.06979512060837945,0.34728290688696717,0.4170780274953466,414980383,410454873.8,53.554618202078785,64.10887336307125,NaN,NaN,14.933532100133707,16.323197693683838
2016-08-10T09:30:00-04:00,58.39,58.53,58.18,58.34,5293289,8024871.35,58.40594274052601,56.967370436547135,NaN,NaN,25.245234391245848,12.556162037679911,-0.05980595370557762,0.3423205853633746,0.40212653906895224,409687094,412772539.6,55.176889083521814,62.52057573367295,NaN,NaN,15.174113988984237,16.15904287872675
2016-08-11T09:30:00-04:00,58.5,58.82,58.48,58.72,8172109,7843707.3,62.47247415728071,57.05732945115956,NaN,NaN,101.6378237876148,45.20809022518783,-0.029825209142109177,0.36484502764131577,0.39467023678342494,417859203,415118883.2,56.82117427250753,61.02100115076878,NaN,NaN,16.487603789849185,16.205980151744242
2016-08-12T09:30:00-04:00,58.62,58.675,58.46,58.56,4357395,7749675.05,59.8205311831096,57.21427479679911,NaN,NaN,79.86262622839958,58.98390927654049,-0.02327933194988424,0.36557107184606963,0.38885040379595387,413501808,415117737.4,56.8200781000985,59.51017699191901,NaN,NaN,16.92058068929715,16.30806594282323
2016-08-15T09:30:00-04:00,58.73,59.02,58.69,58.95,8643489,7882667.65,63.84887557791751,57.38933079730356,NaN,NaN,147.79278564343346,78.4068206554519,0.0033876520900625318,0.39308496890853206,0.38969731681846953,422145297,415634757,57.22111194540937,58.00837256429694,NaN,NaN,18.445355606230425,16.613393037595685
2016-08-16T09:30:00-04:00,58.87,58.9,58.64,58.69,4725200,7749232.75,59.561592802767336,57.45088116911091,NaN,NaN,110.16389535347021,92.94047308083277,-0.00022097390278713602,0.3894210994399856,0.38964207334277273,417420097,416122699.8,57.62114418272421,56.7005763601129,NaN,NaN,18.566001147566997,16.892337053305873
2016-08-17T09:30:00-04:00,58.57,58.92,58.55,58.86,8260516,7887680.9,61.387252536900206,57.66002012862187,NaN,NaN,118.09777755608508,111.51098171380063,0.004825503495190231,0.39567395271176053,0.3908484492165703,425680613,419321403.6,60.24560698570654,55.732234643579815,NaN,NaN,19.18036015406456,17.2191974962714
2016-08-18T09:30:00-04:00,58.77,59.04,58.73,59.04,9830163,8000025.7,63.27769720470932,58.15518398659795,NaN,NaN,134.47978580603362,118.07937411748439,0.015659465676815976,0.41042278131259025,0.39476331563577427,435510776,422851718.2,62.97116429025176,55.38373830692564,NaN,NaN,20.236311258446865,17.65021374801075
2016-08-19T09:30:00-04:00,58.7,59.1,58.67,59.02,8334304,7979351.25,62.90915326053285,58.68753987440021,NaN,NaN,117.98904109948201,125.70465709170087,0.01675375314538624,0.4157055070675071,0.39895175392212084,427176472,425586651,64.9745817528773,55.52792587364652,NaN,NaN,21.015647366102748,18.13098997916675
2016-08-22T09:30:00-04:00,58.96,59.1,58.765,58.97,6624650,7757421.4,61.93792798039844,59.609671922529294,NaN,NaN,107.93055126714093,117.73221021644238,0.009733321728463307,0.4111184060827,0.4013850843542367,420551822,425267956,64.53640489146076,56.20866997841426,NaN,NaN,21.42460423715311,18.60150630173623
2016-08-23T09:30:00-04:00,59.15,59.34,59.02,59.02,8327265,7704985.05,62.56040308403209,60.35493352016579,NaN,NaN,123.07103280382773,120.31363770651387,0.004354346510628271,0.40682801749252206,0.4024736709818938,428879087,427559754,66.29661780396516,57.33827250121413,NaN,NaN,21.932172575885488,19.077315769471838
2016-08-24T09:30:00-04:00,58.94,59.01,58.74,58.84,8569679,7595434.3,58.83032445100892,60.81784475906138,NaN,NaN,69.78245145496759,110.65057248629037,-0.014401808107205594,0.38447141084788683,0.3988732189550924,420309408,426485513,64.67616358972148,58.52064376627483,NaN,NaN,21.42199716620788,19.412270254719843
2016-08-25T09:30:00-04:00,58.83,58.98,58.65,58.83,8623173,7701310.7,58.621209347700585,60.833851115796804,NaN,NaN,56.855152341370484,95.12564579335773,-0.02967746351292544,0.36177638956393565,0.3914538530768611,411686235,421720604.8,57.914267998219614,59.21926441752968,NaN,NaN,20.936561371372093,19.63002612852731
2016-08-26T09:30:00-04:00,58.94,59.25,58.481,58.66,15676881,7949534.8,55.03948527530191,60.53903510038365,NaN,NaN,48.33835985256065,81.19550954397349,-0.05211401961112766,0.32631132856295153,0.3784253481740792,396009354,415487181.2,50.47907294006179,59.2363497170432,NaN,NaN,19.583039734995058,19.62331378659413
2016-08-29T09:30:00-04:00,58.67,59.09,58.67,59.08,7628192,7933465.55,61.32639297595344,60.714233041295635,NaN,NaN,69.51592520010172,73.51258433056564,-0.04009152814365058,0.32831093799451594,0.3684024661381665,403637546,412104326,46.95586639338813,58.76501030213672,NaN,NaN,20.03186484778868,19.68167822390764
2016-08-30T09:30:00-04:00,59.04,59.08,58.77,58.92,5953765,7557461.55,57.99916233593484,60.68517729811055,NaN,NaN,61.76198577145778,61.25077492409165,-0.044023880425574646,0.3133726156061982,0.35739649603177287,397683781,405865264.8,41.23903078269639,57.769448994934905,NaN,NaN,19.48730012016231,19.65390992337259
2016-08-31T09:30:00-04:00,58.77,58.82,58.37,58.59,9592234,7732677.7,51.76151130988709,59.920108523296726,NaN,NaN,-24.565036168542825,42.38127739938956,-0.06849894278880508,0.27177281754576654,0.3402717603345716,388091547,399421692.6,36.32075526909684,56.30513335183414,NaN,NaN,17.150343375381418,19.296257559373853
2016-09-01T09:30:00-04:00,58.69,58.81,58.19,58.64,9397627,7801123.05,52.593425770220826,59.40388670809038,NaN,NaN,-58.39560875601778,19.331125179911915,-0.08015991944312606,0.24007186103066402,0.3202317804737901,397489174,396582280.4,34.3752318283681,54.70193004671054,NaN,NaN,15.453324328290602,18.74726709779053
2016-09-02T09:30:00-04:00,58.91,59.13,58.735,58.93,11405371,8002389,57.203480755908195,58.92921564937543,NaN,NaN,64.81759307880479,22.626971825160744,-0.06767904777279332,0.23563297075779843,0.30331201853059175,408894545,399159318.6,37.64008894549298,53.30328554671651,NaN,NaN,15.283580229001295,18.252454687963496
2016-09-06T09:30:00-04:00,58.84,58.99,58.48,58.76,11028371,8251174.45,53.89483489411759,58.52444722732902,NaN,NaN,-13.079160025702157,6.107954779999976,-0.0699226723106971,0.21590867814222037,0.28583135045291747,397866174,398005044.2,36.7579825802656,51.813059717969466,NaN,NaN,14.168983369574608,17.66910164247937
2016-09-07T09:30:00-04:00,58.56,58.905,58.56,58.83,6686796,8356523.45,55.04779073116881,58.07162852691964,NaN,NaN,-13.595597309798762,-8.96356183625133,-0.06580210407500514,0.20357872035916103,0.26938082443416617,404552970,399378882,38.60229105426408,50.267108580009285,NaN,NaN,13.567493091681776,17.083157563794
2016-09-08T09:30:00-04:00,58.73,58.81,58.6,58.78,8202826,8502000.3,54.00886432761981,57.409569035698965,NaN,NaN,-46.11212418756978,-13.272979440056721,-0.06541673345209414,0.1876099076190485,0.25302664107114264,396350144,401030601.4,40.83621948410994,48.686041093856296,NaN,NaN,12.779100839511818,16.468292317467974
2016-09-09T09:30:00-04:00,58.25,58.37,57.12,57.12,19609082,9073848.95,32.24817050721889,55.21949883903368,NaN,NaN,-444.17918788966506,-90.42969526678618,-0.1699900548733677,0.040539072479433,0.21052912735280072,376741062,396880979,37.176540009692324,46.7004666836288,NaN,NaN,3.008171540207688,14.545417920716504
2016-09-12T09:30:00-04:00,56.81,58.03,56.709,57.85,18644858,9788222.1,43.10454305708672,53.874257058797134,NaN,NaN,-300.0809475118889,-163.40940338492493,-0.18195588652732883,-0.01691573080636033,0.1650401557209685,395385920,394179254,34.978593548752684,44.58919444486394,NaN,NaN,-0.5891891762613601,12.38333119257681
2016-09-13T09:30:00-04:00,57.41,57.61,56.88,57,21760619,10444078.6,35.89264023381675,51.969416855210326,NaN,NaN,-260.76950092280833,-212.94747156434613,-0.2356670635930659,-0.1295436737703639,0.106123389822702,373625301,389331079.4,31.39194991153579,42.09600388111898,NaN,NaN,-6.654391822503455,9.663656476136772
2016-09-14T09:30:00-04:00,56.99,57.37,56.78,56.95,13591690,10887403.1,35.51620596861474,50.30412267789645,NaN,NaN,-205.36978667030692,-251.30230943644779,-0.26113652180327707,-0.22029726243139436,0.040839259371882736,360033611,380427207.6,26.099027377831447,39.34049415169826,NaN,NaN,-11.087755421848296,6.699169062138905
2016-09-15T09:30:00-04:00,56.84,57.51,56.75,57.4,15587525,11253753.55,41.46621398727294,49.07876586643733,NaN,NaN,-142.1570744959055,-270.5112994981149,-0.2350654518176814,-0.25299255540021903,-0.017927103582537615,375621136,376281406,24.06447905423113,36.92265208427051,NaN,NaN,-12.350058401109157,3.9778508531034675
2016-09-16T09:30:00-04:00,56.83,57.05,56.5,56.61,15706422,11547566.5,35.30697881381765,47.669301119188454,NaN,NaN,-157.83076885679677,-213.24161569154126,-0.25665460725431816,-0.3387453626504353,-0.08209075539611715,359914714,372916136.4,22.529206079851235,34.92623302282691,NaN,NaN,-15.813314491609901,1.150541518144415
2016-09-19T09:30:00-04:00,56.87,57.235,56.74,56.86,8811033,11571402.95,38.42401176607829,46.03341674705452,NaN,NaN,-114.55026455025941,-176.1354790992154,-0.24002919131503905,-0.382127244539916,-0.14209805322487692,368725747,367584101.8,20.317455096485787,33.02348935876245,NaN,NaN,-17.291106276221477,-1.4839795953364265
2016-09-20T09:30:00-04:00,57.16,57.33,56.9,56.91,8007515,11640546.2,39.056461920346415,44.68036671736962,NaN,NaN,-91.8910283126301,-142.3597845771797,-0.21253961183595665,-0.40777256801982276,-0.1952329561838661,376733262,368205694,21.287587135353604,31.598386241095113,NaN,NaN,-18.191227996155792,-3.8707293668820504
2016-09-21T09:30:00-04:00,57.14,57.73,56.98,57.65,14979817,11973173.8,47.62972525016401,44.38523914167512,NaN,NaN,-51.38753336341374,-111.56333391580111,-0.13516302550271395,-0.36418673806225854,-0.2290237125595446,391713079,374541587.6,30.567001626968803,31.187403838085967,NaN,NaN,-15.910185685124114,-5.590651698059488
2016-09-22T09:30:00-04:00,58.03,58.255,57.95,58.06,9377155,12013547.6,51.68514662650288,44.32036205998098,NaN,NaN,5.415056784923577,-82.04890765963526,-0.051326203443586016,-0.29318146686402713,-0.2418552634204411,401090234,379635407.2,36.99764600503965,31.374719136419646,NaN,NaN,-12.635744523178438,-6.597093530219338
2016-09-23T09:30:00-04:00,57.99,57.99,57.67,57.72,11269594,12145868.65,48.34199951946464,43.68739911452072,NaN,NaN,-16.593727206415604,-53.80149932955904,-0.01558136059653567,-0.2613319641661107,-0.24575060356957504,389820640,385616592.4,43.602684846732004,31.800618843651005,NaN,NaN,-11.120920349885438,-7.243354504457352
2016-09-26T09:30:00-04:00,57.5,57.69,57.34,57.47,9560417,11840045.45,45.986588501646914,43.12252437220138,NaN,NaN,-38.684789412216844,-38.62840430195054,-0.006074339534570206,-0.2533435279877878,-0.2472691884532176,380260223,387923487.6,45.95605863598745,32.457624276202566,NaN,NaN,-10.670084419124045,-7.732887349409737
2016-09-27T09:30:00-04:00,57.38,57.95,57.29,57.87,6882690,11802770.35,50.17006273926578,42.77411522992259,NaN,NaN,-14.790142851793988,-23.20822720978332,0.027984275519901958,-0.21228884405334014,-0.2402731195732421,387142913,390005417.8,48.06244002230906,33.13334920249149,NaN,NaN,-8.926024898620632,-7.90333557072558
2016-09-28T09:30:00-04:00,57.92,58.35,57.81,58.32,7366551,11873409.65,54.444811044375385,42.80525428111942,NaN,NaN,38.378840900868965,-5.254952356926779,0.07877304653144673,-0.1418068114089337,-0.22057985794038043,394509464,390564694.8,48.641531978892175,33.690871523547365,NaN,NaN,-6.052195788630018,-7.638887030426214
2016-09-29T09:30:00-04:00,58.19,58.52,57.75,57.86,11584232,11973009.55,49.746786894048206,44.05515545160723,NaN,NaN,30.18312303950596,-0.3013391060103018,0.07913191009774434,-0.1216649703182,-0.20079688041594435,382925232,386931694.4,45.12205574149228,34.25840836153308,NaN,NaN,-5.163982548242671,-7.2853292472571365
2016-09-30T09:30:00-04:00,58.12,58.6,58.06,58.38,11206774,12063466.9,54.52396603727997,44.870828521621036,NaN,NaN,67.75676342972696,16.56875902121821,0.11022442535733692,-0.0630163487192732,-0.17324077407661012,394132006,387793967.6,46.1185486306153,35.054119438808975,NaN,NaN,-2.8244527951316405,-6.64806118266778
2016-10-03T09:30:00-04:00,58.2,58.4999,58.08,58.43,12590041,12122700.4,54.96725554474114,46.23330104382992,NaN,NaN,74.39521427773259,39.1847597592081,0.12870475130486014,-0.012359834945534942,-0.14106458625039509,406722047,393086332.4,51.89256652126409,36.518449196646706,NaN,NaN,-0.8500648759185511,-5.8197759959893185
2016-10-04T09:30:00-04:00,58.59,58.62,57.84,57.94,11208615,12131712.6,49.83990687968285,47.25642253747764,NaN,NaN,56.29300150550912,53.40138863066871,0.10355634948277351,-0.011619149396928208,-0.11517549887970172,395513432,394760436.2,53.58689178451146,38.48186808283814,NaN,NaN,-0.7600426659853228,-5.09695694884589
2016-10-05T09:30:00-04:00,58.1,58.4293,57.97,58.31,8430857,12218915.65,53.37649167062071,48.107156657716764,NaN,NaN,77.88601896461643,61.302824243418215,0.10702779211830553,0.0186092412681802,-0.08841855085012533,403944289,396647401.2,55.489768271375496,40.72653159834845,NaN,NaN,0.42539960281797184,-4.308048870036767
2016-10-06T09:30:00-04:00,58.26,58.38,58.03,58.31,7474346,12182491.65,53.37649167062071,49.39783614748841,NaN,NaN,86.34711681256631,72.53562299803028,0.10439914644184392,0.04208038220217958,-0.06231876423966434,403944289,400851212.6,59.47586440346089,43.36557862146343,NaN,NaN,1.3659667619363018,-3.497475208326329
2016-10-07T09:30:00-04:00,57.92,57.94,57.31,57.56,12646117,11834343.4,45.78723763795963,49.923780852622784,NaN,NaN,-9.243539522253858,57.13556240763412,0.049983686903994975,0.00016084439032937325,-0.0498228425136656,391298172,400284445.8,58.712443703042744,46.10807780764606,NaN,NaN,-0.16602196909616412,-3.021553317007734
2016-10-10T09:30:00-04:00,57.84,58,57.545,57.62,8706382,11337419.6,46.443288690097035,50.451411336176406,NaN,NaN,7.186213862723269,43.69376232463226,0.01754018878058533,-0.02789760653793394,-0.04543779531851927,400004554,398940947.2,56.84963462265362,48.64822405673892,NaN,NaN,-1.1960157448194673,-2.760762235266553
2016-10-11T09:30:00-04:00,57.5,57.55,56.77,57.02,13409076,10919842.45,41.088513828561055,49.98418194891905,NaN,NaN,-84.39914508411363,15.555333006707707,-0.04159060357181441,-0.09742604978328728,-0.05583544621147287,386595478,397157356.4,54.38278691985783,50.34935157765956,NaN,NaN,-3.790336174402461,-2.9078442265716826
2016-10-12T09:30:00-04:00,57.08,57.29,56.86,57.13,8374281,10658972,42.399714034148374,49.32093676375087,NaN,NaN,-88.53661191453799,-17.729193169123175,-0.06894340637503714,-0.1420147041802693,-0.07307129780523215,394969759,395362450.4,51.9402031162207,51.416677085601066,NaN,NaN,-5.502303986274144,-3.2784813351006057
2016-10-13T09:30:00-04:00,56.64,57.25,56.51,57.11,12265969,10492894.2,42.215736246785106,48.883346529988046,NaN,NaN,-103.90151997989464,-55.77892052761537,-0.08308366217683803,-0.1769258755262797,-0.09384221334944166,382703790,391114350.6,46.604920055929405,51.631122457686594,NaN,NaN,-6.9414044617565285,-3.801756067480023
2016-10-14T09:30:00-04:00,57.49,57.66,57.21,57.23,7633396,10089242.9,43.791673962534446,48.72656692005143,NaN,NaN,-52.36404851754763,-64.40302232667412,-0.0790774565062449,-0.1926890339822478,-0.1136115774760029,390337186,390922153.4,46.37283110708995,51.660891919908195,NaN,NaN,-7.718791600701291,-4.361332572225918
2016-10-17T09:30:00-04:00,57.23,57.38,57.05,57.08,5911197,9944251.1,42.240869607684076,48.16019598208131,NaN,NaN,-88.19400968730073,-83.47906703667891,-0.08095794797300526,-0.21480901244225947,-0.1338510644692542,384425989,387806440.4,42.663667786558946,51.27526533164034,NaN,NaN,-8.80057296290611,-4.995509770894516
2016-10-18T09:30:00-04:00,57.45,57.6,57.1425,57.2,6044195,9846085.1,43.95091891282214,47.41063225839894,NaN,NaN,-68.92422415983575,-80.38408285182334,-0.0690142399208189,-0.22011886437027783,-0.15110462444945894,390470184,388581381.6,43.86629775051797,50.934177172470754,NaN,NaN,-9.27086389798157,-5.6062746461926665
2016-10-19T09:30:00-04:00,57.35,57.55,57.1737,57.38,7374089,9465798.7,46.50917055232763,47.179373948276044,NaN,NaN,-58.403629264450785,-74.35748632180591,-0.04504554309955927,-0.20741155332390804,-0.16236601022434877,397844273,389156284.4,44.79146173394498,50.9105633147888,NaN,NaN,-9.003107033553471,-6.091536415815638
2016-10-20T09:30:00-04:00,57.15,57.32,56.96,57.07,8215257,9407703.8,42.87926003968136,46.34760923416185,NaN,NaN,-90.25775878598094,-71.62873408302316,-0.045964282340507034,-0.21982136314998257,-0.17385708080947554,389629016,390541329.6,47.05543163543166,50.977483529418535,NaN,NaN,-9.74655994752603,-6.613682634631409
2016-10-21T09:30:00-04:00,56.61,57.03,56.4,56.99,9850732,9336760.7,41.968931387554356,45.41915750864852,NaN,NaN,-123.4651469830396,-85.84895377612156,-0.047650997951195206,-0.23342082824846955,-0.18576983029727434,379778284,388429549.2,44.08688864940967,50.419935110000374,NaN,NaN,-10.61634560951246,-7.1854916310429875
2016-10-24T09:30:00-04:00,57.28,57.515,57.09,57.1,9737612,9345620.45,43.73763986654631,44.98328129342447,NaN,NaN,-54.651677611638874,-79.14048736098918,-0.0374966834642981,-0.23264068462764698,-0.19514400116334887,389515896,389447530.6,45.859966767434074,49.86801189449484,NaN,NaN,-10.9030253237219,-7.71656787285426
2016-10-25T09:30:00-04:00,56.87,57.125,56.81,56.95,8777485,9440360.2,41.863861452559505,44.160950563562956,NaN,NaN,-85.27678559672536,-82.4109996483671,-0.036960076721891666,-0.24134409706571347,-0.2043840203438218,380738411,387501176,43.04907064203064,48.979390635255925,NaN,NaN,-11.639356482163924,-8.276966245612783
2016-10-26T09:30:00-04:00,56.73,57.45,56.6,57.15,10043765,9574220.9,45.232900527309226,43.579265481897856,NaN,NaN,-64.90205747867343,-83.71068529121165,-0.02005937085263132,-0.22945823390961095,-0.20939886305697963,390782176,386088756.6,41.081269066269,47.66549096831364,NaN,NaN,-11.403238114727191,-8.723576512629128
2016-10-27T09:30:00-04:00,57.3,57.37,56.61,56.76,8155419,9402780.25,40.32542528919835,43.18913602841491,NaN,NaN,-81.4603939426289,-81.95121232254124,-0.03139462989334679,-0.2486421504236631,-0.21724752053031632,382626757,384688304.8,39.16941900647446,46.26956063284448,NaN,NaN,-12.549472621465426,-9.270133099605742
2016-10-28T09:30:00-04:00,56.85,57.47,56.81,57.1,11514203,9418151.7,45.841951427496056,43.14618336680055,NaN,NaN,-45.613065258040116,-66.38079597754134,-0.013174982409650093,-0.23371624854237893,-0.22054126613272884,394140960,387560840,44.83986448140562,45.411719908469614,NaN,NaN,-11.980049986824934,-9.657264083494198
2016-10-31T09:30:00-04:00,57.32,57.43,57.17,57.21,9590906,9268194.95,47.53188736430697,43.606424333639545,NaN,NaN,-14.344683409736763,-58.31939713716091,0.0079659696540956,-0.21058380406510935,-0.21854977371920495,403731866,390404034,49.82532833343312,45.086187152296425,NaN,NaN,-11.024616024556549,-9.852600075074534
2016-11-01T09:30:00-04:00,57.26,57.33,56.38,56.72,19622479,9688888.15,41.34318938119782,43.53095828700022,NaN,NaN,-105.7404019163405,-62.41212040108394,-0.008479059154193613,-0.22914859766194695,-0.22066953850775334,384109387,391078229.2,50.95725645650587,45.01597667660251,NaN,NaN,-12.001862022025497,-10.159637496067528
2016-11-02T09:30:00-04:00,56.68,56.9269,56.37,56.51,14355944,9985142.5,38.99959613655997,43.301233993412716,NaN,NaN,-152.80236064532838,-79.99218103441493,-0.029731905667474967,-0.25783442059209705,-0.22810251492462208,369753443,386872482.6,44.250740216837116,44.8478209738102,NaN,NaN,-13.529192470448095,-10.64100249240761
2016-11-03T09:30:00-04:00,56.75,56.77,56.27,56.42,13887707,10305810.55,38.00526748844638,42.88791924526356,NaN,NaN,-183.3382863390563,-100.3677595137004,-0.04515820515716751,-0.28455027137108146,-0.23939206621391396,355865736,381520278.4,37.48886053595084,44.21325164730026,NaN,NaN,-15.0780767011781,-11.27487023651768
2016-11-04T09:30:00-04:00,56.41,56.945,56.3,56.47,8438088,10095409.1,38.9367230239076,42.65190877499381,NaN,NaN,-138.5057355633546,-118.9462935747633,-0.047086468122849834,-0.29825015136747624,-0.2511636832446264,364303824,375552851.2,31.676831540420636,43.428477629718955,NaN,NaN,-16.10277842857519,-11.96457140681161
2016-11-07T09:30:00-05:00,57.35,57.88,57.31,57.86,13794054,10349792.7,57.882108261711366,43.6469937284859,NaN,NaN,182.7740919379968,-79.52253850521659,0.04516964853638625,-0.19470162257414358,-0.23987127111052983,378097878,370426053.6,27.7031071669079,42.27396401660395,NaN,NaN,-10.390231693138908,-11.739665733429796
2016-11-08T09:30:00-05:00,57.89,58.39,57.755,58.21,12073896,10283033.7,61.1505874028021,44.69280921780551,NaN,NaN,246.42217144566294,-9.090023832815906,0.12514917047233165,-0.08343480802011527,-0.20858397849244692,390171774,371638531,29.941463522547053,41.21324985864696,NaN,NaN,-4.609437898404288,-10.72106175699758
2016-11-09T09:30:00-05:00,58.1,59.96,58.08,59.67,36607517,11694695.5,71.19314678256747,46.71522969944023,NaN,NaN,344.8629810799671,90.44304451224318,0.2637936685361281,0.12115810717771325,-0.14263556135841488,426779291,383043700.6,46.66812383985413,41.1855850161057,NaN,NaN,5.179634646436702,-8.44953369936411
2016-11-10T09:30:00-05:00,60.3,61.035,60.13,60.94,41589801,13160887.1,76.80899196400264,49.203805454900824,NaN,NaN,358.0261021491237,198.71592220987918,0.4192136681638123,0.3813815238463505,-0.03783214431746179,468369092,405544371.8,64.61656065916102,42.65199015965937,NaN,NaN,15.942037102300874,-4.965023584840542
2016-11-11T09:30:00-05:00,60.78,61.075,60.53,61.05,24055139,13981974.25,77.22316922296443,51.595628980359265,NaN,NaN,252.00184975818303,276.8174392741867,0.502016891199974,0.5896889696825056,0.0876720784825317,492424231,431168453.2,74.95404525500328,44.730138623057165,NaN,NaN,23.670686266099114,-0.8742078918491627
2016-11-14T09:30:00-05:00,61.5,61.54,61.2,61.31,17076979,14540263.35,78.21358541784406,54.19203783502245,NaN,NaN,208.96509642928132,282.0556401724436,0.5433930952419432,0.7669134475349608,0.22352035229301753,509501210,457449119.6,81.06440242931312,47.44551946500592,NaN,NaN,29.862508105580517,3.516751536355077
2016-11-15T09:30:00-05:00,61.45,61.54,60.97,61.54,12828377,14879472.45,79.08019069779058,56.609701418628255,NaN,NaN,163.3239406832093,265.4359940199529,0.553481604670558,0.915372358131215,0.361890753460657,522329587,483880682.2,85.02216110315325,50.58415461049765,NaN,NaN,34.946741735359495,8.006750136212851
2016-11-16T09:30:00-05:00,61.4,61.48,60.98,61.19,14472901,15234413.05,74.24067010775669,59.03221890566813,NaN,NaN,129.24324749679323,222.3120473033181,0.5051549953750675,0.9933344976794913,0.48817950230442386,507856686,500096161.2,86.8394940744688,53.98915997249724,NaN,NaN,37.397829073307534,12.205475698654947
2016-11-17T09:30:00-05:00,61.14,61.35,61.1363,61.32,10382833,15342791.85,74.85616733812891,61.10466289928477,NaN,NaN,111.0270224655204,172.91223136659744,0.4522294102830945,1.053466265158292,0.6012368548751975,518239519,510070246.6,87.81856006049986,57.059066799575405,NaN,NaN,39.52417749093968,16.108147383267053
2016-11-18T09:30:00-05:00,61.38,61.38,61.11,61.3,9246448,15312577.65,74.56099573910615,63.03531349748471,NaN,NaN,96.1536211716146,141.74258564928377,0.38859235100946343,1.0869772936370268,0.6983849426275633,508993071,513384014.6,88.13439697842529,59.79542884564627,NaN,NaN,41.11826835506331,19.681021807809373
2016-11-21T09:30:00-05:00,61.49,61.656,61.365,61.63,11767769,15414085.5,76.22672574406369,65.52699466626085,NaN,NaN,93.63608318494808,118.67678300041715,0.34302800880097317,1.1271699536287798,0.7841419448278066,520760840,515635940.6,88.3553537237621,62.46672150759314,NaN,NaN,42.965813772469325,23.00742065990365
2016-11-22T09:30:00-05:00,61.8,61.96,61.71,61.91,8901275,15420275,77.56882693488754,68.28193972328424,NaN,NaN,93.03649280102371,104.61929342398003,0.30720714022189843,1.1681508701051797,0.8609437298832813,529662115,517102446.2,88.50546835508041,65.62777351746766,NaN,NaN,44.919467211379484,26.1377130244002
2016-11-23T09:30:00-05:00,62.05,62.44,61.99,62.37,15506832,15693428.35,79.60580909376394,71.25340698080691,NaN,NaN,95.86198501689564,97.9430409280005,0.2901580735463827,1.2236413218162596,0.9334832482698769,545168947,524564898.4,89.26391524457557,69.32599171094087,NaN,NaN,47.235272735970405,29.151650126053084
2016-11-25T09:30:00-05:00,62.55,62.71,62.45,62.71,4172535,15494284.15,80.98060345193686,74.25654129709471,NaN,NaN,97.4377136184674,95.2251791585899,0.2774491002804862,1.2802946236204846,1.0028455233399984,549341482,530785291,89.86427246591178,73.48223749133308,NaN,NaN,49.61396091969882,32.07483738228819
2016-11-28T09:30:00-05:00,62.59,62.61,62.2142,62.28,15898466,15713497.3,74.17074443714193,75.42001530962547,NaN,NaN,82.2501813635754,92.44449119698206,0.2183546751000116,1.275788867215013,1.0574341921150014,533443016,535675280,90.32241999371087,77.95504555039044,NaN,NaN,49.57512924782429,34.57487907736478
2016-11-29T09:30:00-05:00,62.24,62.53,62.06,62.33,12692440,15868574,74.43990155323894,76.36925203465668,NaN,NaN,75.04294957627503,88.72586447524745,0.1634193788712044,1.2617084157040068,1.0982890368328024,546135456,540750203.2,90.78781257983925,82.30121334019702,NaN,NaN,49.62033468377814,36.72422987828097
2016-11-30T09:30:00-05:00,62.68,62.85,62.39,62.41,14903778,15632638.95,74.89075184178421,76.6333666817436,NaN,NaN,80.13356176925681,86.14527826889407,0.11551280719190826,1.2426800458226879,1.1271672386307796,561039234,547025627,91.3422541592752,85.4922226487271,NaN,NaN,49.78094616897961,38.589475062666494
2016-12-01T09:30:00-05:00,62.53,63.005,62.41,62.82,24438467,16136765.1,77.1183447229115,76.65546330737993,NaN,NaN,86.9669010603735,84.36626147758963,0.09531959754690678,1.2463167355644131,1.1509971380175064,585477701,555087377.8,92.007732649119,87.44873493372408,NaN,NaN,50.551945909234455,40.29839946931906
2016-12-02T09:30:00-05:00,62.92,63.025,62.67,62.81,11902466,16037503.05,76.93905731023104,76.63516959932755,NaN,NaN,91.97668185987462,83.27405512587109,0.06653447629784837,1.2341652333898168,1.1676307570919684,573575235,559934128.4,92.38662214166119,88.6939189970568,NaN,NaN,51.13383021649057,41.846318147486414
2016-12-05T09:30:00-05:00,63.08,63.19,62.63,62.76,9448801,16088038.7,75.98781589536878,76.47618606200788,NaN,NaN,96.24793308432115,86.07360547002023,0.031168722846656838,1.2065916606502896,1.1754229378036327,564126434,566070812,92.84888006408939,89.53566739954081,NaN,NaN,51.369805046432646,43.20681627590731
2016-12-06T09:30:00-05:00,62.72,62.95,62.51,62.88,10543579,15925514.95,76.73136676959354,76.30841292427954,NaN,NaN,85.69644223447646,88.20430400166052,0.0043102508791026395,1.180810751402511,1.1765005005234084,574670013,571777723.4,93.2587975368242,90.12399857337446,NaN,NaN,51.76228130456112,44.429025565714994
2016-12-07T09:30:00-05:00,62.9,64.07,62.86,64.05,10416830,15842661.65,82.44060208659197,76.8941223513392,NaN,NaN,145.17811031485036,101.21321371077923,0.051190666689036934,1.2404888338847044,1.1892981671956675,585086843,576587245.2,93.59216202993503,90.6063319987649,NaN,NaN,53.9593634570111,45.790502407328724
2016-12-08T09:30:00-05:00,64.05,64.05,63.56,63.69,10688158,14546693.7,76.24188233608189,76.99310199405012,NaN,NaN,146.3016431212146,113.08016212294744,0.04407394041006585,1.2443905927082497,1.2003166522981839,574398685,574371442,91.35081870994465,90.85863618801098,NaN,NaN,53.842913109154054,46.94084679330377
2016-12-09T09:30:00-05:00,63.69,64.04,63.6636,63.98,7939580,12864182.65,77.69670499440713,77.21708122657162,NaN,NaN,145.97450610263493,123.87972697149951,0.04486695017566866,1.2564003400177697,1.211533389842101,582338265,576124048,91.5237253680813,91.10073107298639,NaN,NaN,54.19362330880472,47.97695772408962
2016-12-12T09:30:00-05:00,63.75,63.87,63.32,63.75,9519567,12137404.05,73.83503604395015,77.0462462479921,NaN,NaN,113.41777677050294,127.31369570873588,0.01728861233437584,1.2331441552600708,1.215855542925695,572818698,577862500.8,91.70095172123453,91.33970235852014,NaN,NaN,53.298008361248804,48.73710781511236
2016-12-13T09:30:00-05:00,63.93,64.01,63.45,63.66,8280852,11697597.7,72.3203168937529,76.67135267362532,NaN,NaN,108.08608482569129,131.79162422697885,-0.017731565812062033,1.1936910856606175,1.2114226514726796,564537846,575836067.4,89.3556463582557,91.40042935874695,NaN,NaN,52.12193409616337,49.22065442669108
2016-12-14T09:30:00-05:00,63.5,63.81,62.95,63.02,19782911,12045324.4,62.50104957674137,75.44958413669515,NaN,NaN,61.3230856371989,115.02061929144854,-0.09063963095732563,1.0981231127760225,1.1887627437333481,544754935,567769685.8,80.52692553732493,90.77635866537192,NaN,NaN,47.94861548324164,49.03893457762687
2016-12-15T09:30:00-05:00,62.95,63.54,62.92,63.09,12262075,11934783.1,63.09131866639251,74.17177808058484,NaN,NaN,48.134835477866595,95.38725776277894,-0.13795600104931993,1.0163177424216983,1.1542737434710182,557017010,564293350.8,76.99613270398476,89.85720582523426,NaN,NaN,44.75907805121575,48.42752650242528
2016-12-16T09:30:00-05:00,62.58,63.0299,62.47,62.58,9523742,11891828.55,56.15575135575024,72.88499286048543,NaN,NaN,-11.436280936344684,63.90510035498302,-0.2034514055508525,0.8999594865324525,1.103410892083305,547493268,557324351.4,70.33796952326361,88.42974507734516,NaN,NaN,39.756068291499815,47.188746758007355
2016-12-19T09:30:00-05:00,62.73,62.97,62.61,62.93,5982939,11728653.1,59.45020640232449,71.81430034970582,NaN,NaN,-4.370580232237518,40.34742895443492,-0.2215608015134376,0.8264598901915079,1.0480206917049455,553476207,553455853.2,66.8806261979166,86.72208890720783,NaN,NaN,36.51249736838864,45.66356827377611
2016-12-20T09:30:00-05:00,63.04,63.32,63.04,63.29,5011417,11390835.5,62.56591819965002,70.93395508955338,NaN,NaN,37.31889287968922,26.19399056523452,-0.20787708236066782,0.7881743387541107,0.9960514211147785,558487624,552245808.8,65.79128324313479,84.89701955605496,NaN,NaN,34.717119742894845,44.09978991222164
2016-12-21T09:30:00-05:00,63.25,63.28,63.03,63.05,4648984,11178220.95,59.29492544314629,69.66085371242728,NaN,NaN,16.08927079955035,17.147227597704806,-0.21280018212853546,0.7300511934541092,0.9428513755826446,553838640,554062549.8,66.66906822778611,83.08711495453119,NaN,NaN,32.22094190510341,42.402811625490465
2016-12-22T09:30:00-05:00,63.01,63.08,62.78,62.93,4642675,10635013.1,57.67140784369481,68.28459303624614,NaN,NaN,-19.793469680834853,3.561566565964519,-0.22098446417876083,0.6666207953591936,0.8876052595379544,549195965,552498340.8,65.11971548563595,81.1394787648151,NaN,NaN,29.695011068074777,40.58741154585965
2016-12-23T09:30:00-05:00,62.92,63.06,62.87,62.99,5101030,10681437.85,58.28640314935893,67.02020641153113,NaN,NaN,-16.134534293553198,2.621915894522816,-0.21879291073341134,0.6141141211211902,0.8329070318546016,554296995,553859086.2,65.86293796859229,79.21191147227958,NaN,NaN,27.793175216540206,38.759663498814014
2016-12-27T09:30:00-05:00,63.1,63.23,62.99,63.12,3499380,10061483.55,59.65417408874785,65.80040693432787,NaN,NaN,1.7836592880216224,3.8527637985746437,-0.20524695969769935,0.5763483322324774,0.7815952919301767,557796375,554723119.8,66.35319195141432,77.29008250189317,NaN,NaN,26.562064521605468,37.017149359212794
2016-12-28T09:30:00-05:00,63.2,63.24,62.45,62.46,8982414,9875982.25,50.585442419101675,63.52503838665,NaN,NaN,-81.39685771894801,-19.890386321152818,-0.23524254843810266,0.48754210638254847,0.7227846548206511,548813961,552788387.2,64.13220422952017,75.18579980186352,NaN,NaN,22.652956990564096,34.96512187797727
2016-12-29T09:30:00-05:00,62.5,62.75,62.33,62.44,7757161,9518651.4,50.335722740712974,61.67459841555222,NaN,NaN,-122.25344746545653,-47.558929974154196,-0.2495772422473701,0.4108131020114385,0.6603903442588086,541056800,550232019.2,61.21652260161083,73.03335007983969,NaN,NaN,19.422940105335396,32.74481019617129
2016-12-30T09:30:00-05:00,62.6,62.75,62.02,62.22,6932299,8643343,47.55473939024867,59.52160087239804,NaN,NaN,-144.750852537906,-72.55040654556842,-0.26553923792348044,0.32846629685445805,0.5940055347779385,534124501,547217726.4,57.87531072745265,70.62989189122335,NaN,NaN,15.85763447597073,30.332356521856923
2017-01-03T09:30:00-05:00,62.68,63.06,62.35,62.59,21592200,9127829.7,52.32534351255183,57.985194263012446,NaN,NaN,-78.15203960220082,-84.95390760729795,-0.24342680140565276,0.2897220330208725,0.5331488344265253,555716701,547501667.6,58.107264659459865,68.23034281538231,NaN,NaN,14.097930826944996,28.01315285115522
2017-01-04T09:30:00-05:00,62.76,63.08,62.68,62.96,8889278,9099853.55,56.57890384815047,56.860807616897986,NaN,NaN,-34.81416916854026,-92.27347329861033,-0.19805439995374058,0.28558083448434957,0.48363523443809014,564605979,548863588.4,59.26585980629878,66.0810723473854,NaN,NaN,13.840567970136705,25.988497868152574
2017-01-05T09:30:00-05:00,62.91,63.27,62.44,62.78,9850871,9065218.15,54.05231381301103,56.25732649091725,NaN,NaN,-49.76231054888434,-85.9465638645976,-0.17512990841993337,0.26472284891317344,0.4398527573331068,554755108,550051817.8,60.297536377001094,64.63611597879084,NaN,NaN,12.884829398592323,24.116545229643968
2017-01-06T09:30:00-05:00,62.79,63.31,62.58,63.14,12124458,9150599.55,58.08389871263278,55.899653637077265,NaN,NaN,-11.125030649480014,-63.72088050140229,-0.13261637671366788,0.27408228644102195,0.40669866315468983,566879566,555216371,64.50542416365167,63.743922511624184,NaN,NaN,13.27132008998615,22.567227352549995
2017-01-09T09:30:00-05:00,63.07,63.07,62.62,62.65,5970451,8914714.2,51.46477491291411,55.5645838911604,NaN,NaN,-52.235695898145174,-45.21784917345012,-0.1339961984093499,0.23920341514300247,0.37319961355235237,560909115,560573293.8,68.2627843697075,63.595695000655894,NaN,NaN,11.545922366684515,20.99275521171207
2017-01-10T09:30:00-05:00,62.76,63.15,62.63,62.91,8237838,8929627.1,54.432103733705254,55.20614798625903,NaN,NaN,-18.28050819277259,-33.24354289156448,-0.11464653882441156,0.22989144002183792,0.3445379788462495,569146953,563259344.2,69.97884149672757,63.81699609342811,NaN,NaN,11.02820039790869,19.56924738116873
2017-01-11T09:30:00-05:00,62.95,63.3,62.88,63.24,11113720,9009334.75,57.946390369599605,54.876181712683994,NaN,NaN,58.859847502566325,-14.508739557343157,-0.07858984397897917,0.24630067387252552,0.3248905178515047,580260673,566390283,71.88700316378808,64.25240465918907,NaN,NaN,11.690761937573397,18.44374946065511
2017-01-12T09:30:00-05:00,63.18,63.24,62.37,62.98,11844617,9187523,54.387447853287284,54.525647599122635,NaN,NaN,-12.61833971718881,-7.079945391004051,-0.07142495412688632,0.2356093251928968,0.3070342793197831,568416056,569122472.6,73.47160320566763,64.73830001475203,NaN,NaN,11.154954303166626,17.402493009585324
2017-01-13T09:30:00-05:00,63.02,63.28,63,63.22,7130190,8554886.95,57.01205238096737,54.478550780356386,NaN,NaN,99.73137919547558,15.091336577987068,-0.05067285945574157,0.24369320500010616,0.29436606445584773,575546246,570855808.6,74.45531892395267,65.40512883177465,NaN,NaN,11.50926377063155,16.560603118306215
2017-01-17T09:30:00-05:00,62.88,62.985,62.55,62.73,10689396,8476253,50.609134489651964,53.93017444752017,NaN,NaN,-44.85666962323198,16.567141832969707,-0.06896382801591361,0.20816127943595575,0.27712510745186936,564856850,571645355.6,74.9116815532042,66.05146765924692,NaN,NaN,9.802928140604148,15.595220978634492
2017-01-18T09:30:00-05:00,62.64,63.09,62.51,62.97,8098636,8404997.7,53.37138833615201,53.48140403662047,NaN,NaN,-9.638152409525302,18.295612989619162,-0.06402331232244185,0.19709596704881704,0.2611192793712589,572955486,572407062.2,75.36886286060883,66.69544415276083,NaN,NaN,9.247726050387817,14.688435988884967
2017-01-19T09:30:00-05:00,63.64,63.75,63.055,63.43,8833174,8547509.45,58.1970329149884,54.02508907204095,NaN,NaN,176.55503794206518,41.834651077518934,-0.030594934244642158,0.2228756115654562,0.25347054581009837,581788660,572712659.6,75.56127922330326,67.51180665231676,NaN,NaN,10.315921150956678,14.063791012038068
2017-01-20T09:30:00-05:00,63.41,63.51,63.08,63.44,11620318,8877954.5,58.29807117101718,54.59382824563411,NaN,NaN,144.97668503605297,73.3536560281673,-0.00971150341664695,0.24133116653928965,0.2510426699559366,593408978,577711244,78.51742551705891,68.74758543199162,NaN,NaN,11.191719771850256,13.653495120582667
2017-01-23T09:30:00-05:00,63.37,63.5,62.74,63.09,14303720,9360691.3,53.43041382507935,55.013519276693444,NaN,NaN,66.2018931020995,66.64775880949207,-0.020737970934692818,0.22512020628757057,0.24585817722226339,579105258,578423046.4,78.908670261309,70.24996825583851,NaN,NaN,10.477848035039056,13.199831251219294
2017-01-24T09:30:00-05:00,63.1,63.87,63.02,63.72,9199687,9588541.9,59.91786172647768,55.55584200625958,NaN,NaN,171.75239755886423,109.96957224591131,0.011401657681025995,0.2601102493235459,0.24870859164251988,588304945,583112665.4,81.32219041620843,71.9081772384634,NaN,NaN,11.943097831928123,13.02029790560627
2017-01-25T09:30:00-05:00,64.15,64.47,64.03,64.39,12955643,9981272.55,65.43295318508552,56.18827410175496,NaN,NaN,283.28372469042387,168.55394766590115,0.07143886651541509,0.33800717478678877,0.2665683082713737,601260588,588773685.8,83.74090769780834,73.65639494499979,NaN,NaN,15.14290913607618,13.323528081387686
2017-01-26T09:30:00-05:00,64.46,64.845,64.265,64.54,10141825,10313394.8,66.5428730416892,57.0804569038034,NaN,NaN,251.57988047240548,183.5589161719692,0.11246647965847423,0.40715140784446646,0.29468492818599223,611402413,594696436.4,85.8111441427014,75.47879549969267,NaN,NaN,18.039970952223896,13.997305634364286
2017-01-27T09:30:00-05:00,64.62,64.77,64.38,64.49,8697845,10299166.35,65.78461485443798,57.63050805678949,NaN,NaN,197.3097396058223,194.02552708592307,0.12640864460309587,0.45269573393986207,0.3262870893367662,602704568,596555554.4,86.3966583692916,77.04245508580982,NaN,NaN,20.104879150534998,14.869816136674388
2017-01-30T09:30:00-05:00,64.17,64.24,63.44,63.94,13354578,10579037.2,57.96066134632486,58.09449994489025,NaN,NaN,86.50665567879513,198.0864796012622,0.09044636124480687,0.4393450408927748,0.34889867964796795,589349990,598604500.8,87.03181048460824,78.38309980830273,NaN,NaN,19.44312260325259,15.523145631899846
2017-01-31T09:30:00-05:00,63.72,63.72,63.06,63.38,19335161,11199180.3,51.274002503024974,57.86892128555595,NaN,NaN,13.165245694581452,166.36904922840566,0.02424581662771058,0.3792059504326062,0.3549601338048956,570014829,594946477.6,79.86252730552991,79.08907736607432,NaN,NaN,16.649070702341746,15.683992070534403
2017-02-01T09:30:00-05:00,63.48,63.71,62.95,63.27,15358829,10887511.75,50.052509367459244,57.305072642545916,NaN,NaN,-2.8569222453803964,109.1409198412448,-0.02877445479646873,0.3189920653093097,0.3477665201057784,554656000,585625560,65.1383409229459,78.60703006315703,NaN,NaN,14.041598001461656,15.449364346381154
2017-02-02T09:30:00-05:00,63.17,63.335,62.89,63.15,9568357,10921465.7,48.68979449355599,56.898097402565114,NaN,NaN,-33.79567604486198,52.065808537791305,-0.07132676992297282,0.2586080577020624,0.32993482762503523,545087643,572362606,50.78919984627258,76.98685839462881,NaN,NaN,11.511531327816705,14.886816772300518
2017-02-03T09:30:00-05:00,63.3,63.7,63.24,63.62,9874215,10922632.9,53.9751348621932,56.68117472265267,NaN,NaN,23.57894170500764,17.319648957628367,-0.06727232037781361,0.24584442715276822,0.31311674753058183,554961858,562814064,43.38016124759832,74.76720427488921,NaN,NaN,10.921789942382388,14.320384368026499
2017-02-06T09:30:00-05:00,63.58,63.8675,63.49,63.71,7109341,10671877.05,54.932466327008136,56.98998413960668,NaN,NaN,45.066153989938776,9.031548619857102,-0.0583155796291262,0.2402222729941741,0.2985378526233003,562071199,557358305.8,39.80699958630401,72.2597269915392,NaN,NaN,10.727804445823702,13.80715866485467
2017-02-07T09:30:00-05:00,63.93,64.16,63.72,63.82,13347366,11040722.8,56.13345280972341,57.1872744591475,NaN,NaN,69.20147566346111,20.238794613633033,-0.045346438599229655,0.2418548043742632,0.28720124297349287,575418565,558439053,40.846431721176025,69.79383905300828,NaN,NaN,10.912087600846911,13.393577084282134
2017-02-08T09:30:00-05:00,63.77,63.79,63.52,63.73,7808374,11019249.6,54.84564520590917,56.9478896227847,NaN,NaN,29.020564489960464,26.614291960701216,-0.043202445666785716,0.23319818589001073,0.27640063155679645,567610191,561029891.2,43.37101544271167,67.49453449725175,NaN,NaN,10.709823647558693,13.010183736178785
2017-02-09T09:30:00-05:00,63.89,64.38,63.79,64.22,8176718,10872399.5,60.19938506017583,57.0836977577246,NaN,NaN,90.6777110404552,51.50896937776464,-0.010843125369279671,0.2628467248451969,0.27368985021447656,575786909,567169744.4,48.933251497500535,65.38137921014044,NaN,NaN,12.103245836108279,12.880621179025855
2017-02-10T09:30:00-05:00,64.52,64.79,64.37,64.73,7445764,10652456.85,64.868296265265,57.900689360595024,NaN,NaN,145.63222938963423,75.91962691468996,0.040059314663657475,0.3237639935440484,0.2837046788803909,583232673,572823907.4,53.4661371857563,63.564055419029536,NaN,NaN,14.808286950494118,13.156002003521321
2017-02-13T09:30:00-05:00,64.99,65.5,64.97,65.38,17349579,11163426.3,69.74040340557231,58.602299480530355,NaN,NaN,195.63625946909997,106.03364801052219,0.10875900254119364,0.419653432056883,0.31089442951568935,600582252,580526118,58.827503814485055,61.957292090335,NaN,NaN,18.86474888408849,13.971537272173773
2017-02-14T09:30:00-05:00,65.29,65.41,65.05,65.41,8578572,11057885.1,69.94755581976781,58.92477109729337,NaN,NaN,167.46960651022349,125.68727417987466,0.14519747408493416,0.49239127212185707,0.3471937980369229,609160824,587274569.8,62.86459040424958,60.466126569366516,NaN,NaN,22.119082685419638,15.135472331208897
2017-02-15T09:30:00-05:00,65.43,65.83,65.29,65.76,7845404,11045223.5,72.32770166325209,59.337973141690725,NaN,NaN,172.02453878798147,154.28806903947887,0.1795957933520041,0.571688539726928,0.3920927463749239,617006228,597153777.2,67.83653551105999,59.18222595282071,NaN,NaN,25.646434708805238,16.637038385151232
2017-02-16T09:30:00-05:00,65.76,65.79,65.34,65.78,10062432,11106686.4,72.46191760401368,59.81492333808899,NaN,NaN,146.62896288357896,165.47831940810363,0.18944300375849576,0.6288965010730436,0.43945349731454786,627068660,607410127.4,72.02423492131885,58.15562427796551,NaN,NaN,28.512161664987733,18.333484567985018
2017-02-17T09:30:00-05:00,65.61,65.89,65.41,65.89,5194723,10785406.65,73.23094064522374,60.90565757372462,NaN,NaN,133.87635403600234,163.12714433737725,0.1886976585415917,0.6753255704915375,0.4866279119499458,632263383,617216269.4,75.3313417669983,57.31987651242194,NaN,NaN,31.11671714653038,20.159660650634354
2017-02-21T09:30:00-05:00,65.99,66.28,65.9,66.22,9573858,10548913.55,75.4462268093899,62.632245024179255,NaN,NaN,147.11494246798787,153.42288093715484,0.19496198280618793,0.7303303904576808,0.5353684076514929,641837241,625467267.2,77.71811500221838,57.16670420504254,NaN,NaN,34.055822917834085,22.144826688805743
2017-02-22T09:30:00-05:00,66.03,66.14,65.845,66.04,10614742,10619666.3,71.94868562161226,64.1962576137616,NaN,NaN,120.31200094138485,143.99135982338709,0.17230007953009774,0.7507435070641151,0.5784434275340173,631222499,629879602.2,78.89413697574537,58.14926106595679,NaN,NaN,35.549837517018915,24.059828235693338
2017-02-23T09:30:00-05:00,66.15,66.22,65.39,65.61,16800135,10811890.9,64.2821944373446,65.31000046688936,NaN,NaN,87.42842397387615,127.07213686056605,0.11634862895402431,0.7238792137265477,0.6075305847725234,614422364,629362829.4,78.37241087184177,60.11949042492602,NaN,NaN,34.59776438874233,25.56524768612891
2017-02-24T09:30:00-05:00,65.26,65.9,65.17,65.89,12662950,10937947.15,66.7655373671139,66.22360064581227,NaN,NaN,72.30851713627546,112.20804771110534,0.0875103618008517,0.716918537023588,0.6294081752227363,627085314,629366160.2,78.37340357546127,62.61900773405909,NaN,NaN,34.51735545512392,26.844120224556768
2017-02-27T09:30:00-05:00,65.95,66.1846,65.73,66.13,10705384,11038324.1,68.76984318110986,67.21198470681954,NaN,NaN,87.010717842142,102.83492047233327,0.07442570199588039,0.7224403027175867,0.6480146007217064,637790698,630471623.2,78.72247392823411,65.39868447276838,NaN,NaN,35.041077359638585,28.015114100997028
2017-02-28T09:30:00-05:00,66.16,66.26,65.74,65.86,9629948,10852092.6,64.087272718875,67.78011470033036,NaN,NaN,75.21319050584876,88.45457007990544,0.0391843777903792,0.6969950729596803,0.6578106951693011,628160750,627736325,75.47623724043981,67.87224200985865,NaN,NaN,34.0881942725834,28.882696982652224
2017-03-01T09:30:00-05:00,66.43,67.19,66.42,66.97,16452551,10707962.1,72.40582277819749,69.03441309835095,NaN,NaN,124.51757716706088,89.29568532504065,0.07988216097815137,0.7576633963919903,0.677781235413839,644613301,630414485.4,76.4981190260788,70.23846369438488,NaN,NaN,36.03243881064759,29.904088672365848
2017-03-02T09:30:00-05:00,66.87,67.05,66.23,66.25,8453854,10362713.35,62.321807630110186,69.18601471048912,NaN,NaN,95.88891325705693,90.9877831816768,0.0490752680607387,0.7391253204897623,0.6900500524290236,636159447,634761902,78.09384757776226,72.32136341440358,NaN,NaN,34.01142671605047,30.49085125003508
2017-03-03T09:30:00-05:00,66.26,66.43,66.01,66.32,5862845,10177437.75,62.86332604288261,69.04280255174753,NaN,NaN,74.92753750098674,91.51158725461906,0.025369679622206265,0.7217621519567814,0.6963924723345751,642022292,637749297.6,79.14188688801885,74.15534553599376,NaN,NaN,32.656302271214045,30.800201395917792
2017-03-06T09:30:00-05:00,66,66.24,65.89,66.16,7164681,10041961.05,60.71535542316562,68.3981562672899,NaN,NaN,58.40912486969882,85.79126866013044,-0.007378147936181856,0.6871697874143479,0.6945479353505297,634857611,637162680.2,78.34921581710684,75.54975353618103,NaN,NaN,30.882095031650923,30.81190048673681
2017-03-07T09:30:00-05:00,66.14,66.24,65.8838,65.97,8790796,10126033.8,58.17336747356579,67.55714281398976,NaN,NaN,49.02455423511768,80.55354140598422,-0.04597449418672728,0.6370798176171206,0.6830543118038479,626066815,636743893.2,77.75051094218982,76.61303357460534,NaN,NaN,28.64033417048562,30.501676727272354
2017-03-08T09:30:00-05:00,66.06,66.1,65.63,65.74,10728959,9995113.45,55.162590951930994,66.33106347746681,NaN,NaN,21.25651107133714,59.901328186839464,-0.08866121578176167,0.5722277920766459,0.6608890078584075,615337856,630888804.2,69.72799961496904,76.74813815345598,NaN,NaN,25.852167414768516,29.837461111200376
2017-03-09T09:30:00-05:00,65.7,65.86,65.16,65.44,9976098,10103499.65,51.4240776585995,64.82836062422295,NaN,NaN,-40.55926458908192,32.611692617611695,-0.1359391565386483,0.49096506218509717,0.6269042187237455,605361758,624729266.4,62.4300617874157,76.0628400724629,NaN,NaN,22.340544883488985,28.766473078670177
2017-03-10T09:30:00-05:00,65.79,65.84,65.3201,65.84,9780496,10183688.55,55.731997543689104,63.57843611697048,NaN,NaN,-29.715110797354207,11.683162957943505,-0.138634199234145,0.45361146968106425,0.5922456689152092,615142254,619353258.8,56.838513298146175,74.74192375325917,NaN,NaN,20.630774918500077,27.604230484360162
2017-03-13T09:30:00-04:00,65.77,65.93,65.61,65.8,11620274,10392414.05,55.204758263598066,62.132616935128205,NaN,NaN,-22.34000596761824,-4.466663209519913,-0.1410080632444971,0.4159855898595879,0.556993653104085,603521980,613086132.6,51.093426327003236,72.84016027645809,NaN,NaN,19.101602759994076,26.389569380879294
2017-03-14T09:30:00-04:00,65.58,65.66,65.05,65.18,10810671,10065468.65,47.676060052405354,60.39885796589914,NaN,NaN,-131.9457216721841,-40.66071839098027,-0.17974903591831304,0.3323073582061937,0.5120563941245068,592711309,606415031.4,45.78801033440504,70.47543694493379,NaN,NaN,15.335939127447453,24.810479344674746
2017-03-15T09:30:00-04:00,65.33,66.135,65.25,65.92,14737224,10373401.25,55.48014259937468,59.77013997747272,NaN,NaN,-33.003340629191605,-51.512688731086016,-0.15205163474606148,0.3219918506919299,0.4740434854379914,607448533,604837166.8,44.608163462553954,68.06370498712752,NaN,NaN,14.54575751468547,23.344090511819136
2017-03-16T09:30:00-04:00,66.03,66.15,65.57,65.62,14152405,10688751.3,52.08829906456005,58.72176581300459,NaN,NaN,-32.85698328337351,-49.972232469944345,-0.15018770544742444,0.28630885362871084,0.43649655907613527,593296128,602424040.8,42.79209437718555,65.5221829015364,NaN,NaN,12.787778876055675,21.836045992424356
2017-03-17T09:30:00-04:00,65.52,65.85,65.39,65.68,10880067,10729633.05,52.71099084753312,57.57470493203482,NaN,NaN,-68.01348278458434,-57.63190686739038,-0.14129673896055878,0.2598756353754368,0.40117237433599556,604176195,600230829,41.15227094991594,62.83859697451367,NaN,NaN,11.5912024817989,20.37249691947786
2017-03-20T09:30:00-04:00,65.74,65.82,65.49,65.56,5752608,10757527.3,51.275642429575065,56.65958848279911,NaN,NaN,-69.59838875328056,-67.08358342452284,-0.1396325764930194,0.22663165371972127,0.3662642302127407,598423587,599211150.4,40.3775576632613,60.331548433286635,NaN,NaN,10.188728844096179,18.91767290870905
2017-03-21T09:30:00-04:00,65.74,65.79,64.47,64.56,12661009,10911884.85,41.205888178421915,54.43102172567228,NaN,NaN,-204.30755936278806,-81.55595096264362,-0.1984265661977177,0.11823102246559358,0.3166575886633113,585762578,597821404.2,39.291865457502006,57.67395889267401,NaN,NaN,5.446066071406095,16.9931576462372
2017-03-22T09:30:00-04:00,64.58,64.92,64.33,64.79,12266304,10994462.95,43.933147633765,53.117546011647626,NaN,NaN,-221.93916586373342,-119.34311600955198,-0.2130844955444844,0.0503019692327058,0.2633864647771902,598028882,595937474,37.807770339643,54.79638194709406,NaN,NaN,2.509654556276793,14.924085776242856
2017-03-23T09:30:00-04:00,64.86,65.13,64.57,64.7,10682508,10688581.6,43.09082820117044,51.70522473723962,NaN,NaN,-163.26456203599074,-145.42463176007544,-0.21924639419281,-0.010671527963822314,0.2085748662289877,587346374,594747523.2,36.86072272421583,51.7762987925367,NaN,NaN,-0.09123567866335963,12.779039854113398
2017-03-24T09:30:00-04:00,64.68,64.95,64.25,64.53,9924626,10551665.4,41.47332750286697,50.330794171504,NaN,NaN,-166.97243421894882,-165.21642204694834,-0.22436583470965984,-0.07188242715808713,0.15248340755157272,577421748,589396633.8,32.87310819012873,48.52800539060969,NaN,NaN,-2.718703362101078,10.565076537511331
2017-03-27T09:30:00-04:00,63.91,64.42,63.5501,64.3,11711951,10601993.75,39.32269357611225,48.98431746454303,NaN,NaN,-191.0267525324044,-189.50209480277312,-0.23188119784133618,-0.1373680897500975,0.09451310809123867,565709797,582853875.8,28.774167307701475,45.029695131003386,NaN,NaN,-5.5667850054257135,8.260524888520324
2017-03-28T09:30:00-04:00,64.1,65.195,64.1,64.98,8972986,10569145.65,47.92122243177372,48.46707685596037,NaN,NaN,-91.75790663026905,-166.9921642562693,-0.18190173286862182,-0.1328640579945386,0.04903767487408321,574682783,580637916.8,27.522457535222543,42.01501355387864,NaN,NaN,-5.457346936539528,6.300828913511774
2017-03-29T09:30:00-04:00,64.91,65.03,64.74,64.97,8300971,10161566.65,47.813915459885486,48.2092081274808,NaN,NaN,-63.840523282975305,-135.37243574011768,-0.14212522683105616,-0.128618858664737,0.013506368166319165,566381812,574308502.8,24.274319954003445,39.28960342292062,NaN,NaN,-5.402064098483639,4.628987054655286
2017-03-30T09:30:00-04:00,64.94,65.41,64.9,65.33,12838010,10380774.45,51.98248381346704,47.94138571817923,NaN,NaN,-19.755631716110894,-106.67064967614172,-0.08689242021048424,-0.09510915709678613,-0.008216736886301899,579219822,572683192.4,23.50712760133031,36.908790158862345,NaN,NaN,-4.093094708415716,3.3829753742165716
2017-03-31T09:30:00-04:00,65.16,65.38,65.06,65.06,7736081,10474436.25,48.83196306628126,47.486186061228025,NaN,NaN,-20.141233380600603,-77.30440950847208,-0.06487438161664894,-0.08930971390711306,-0.024435332290464132,571483741,571495591,22.93669145713187,34.897594811014386,NaN,NaN,-3.9153624328920866,2.3403556874867633
2017-04-03T09:30:00-04:00,65.09,65.295,64.51,64.92,10474812,10639942.8,47.233422409829956,47.454569086758355,NaN,NaN,-51.048132746737274,-49.30868555133865,-0.05638477997643027,-0.09491630726100198,-0.0385315272845717,561008929,570555417.4,22.471783428564592,33.232150032025785,NaN,NaN,-4.228008110039053,1.4020180021259323
2017-04-04T09:30:00-04:00,64.91,65.09,64.7726,65.09,9239723,10662389.15,49.39952808016822,47.0202394782436,NaN,NaN,-33.99132717842443,-37.75536966096972,-0.036907591373225086,-0.08466601650110306,-0.04775842512787797,570248652,569668591.2,22.018429115763567,31.618597578683612,NaN,NaN,-3.8731754143245514,0.6484189426330061
2017-04-05T09:30:00-04:00,65.32,65.875,64.79,64.88,11422628,10697072.6,46.84149298843045,46.64546761566292,NaN,NaN,3.3133576211903737,-24.32459348013658,-0.03573121492198919,-0.09242244378036446,-0.05669122885837527,558826024,568157433.6,21.232371040447916,30.07861734034521,NaN,NaN,-4.287629159669432,-0.05673078626734207
2017-04-06T09:30:00-04:00,64.92,65.36,64.8025,65.06,7633721,10579953.75,49.266518211595766,46.39943385595311,NaN,NaN,-12.251990614011918,-22.82386525971679,-0.021116773024034363,-0.08308719513841822,-0.06197042211438386,566459745,565605418.2,19.93786195894586,28.56330241241878,NaN,NaN,-3.9610235871263804,-0.6144869006757762
2017-04-07T09:30:00-04:00,65.09,65.4,65,65.13,7522655,10467061.7,50.217625072918224,46.32386118762047,NaN,NaN,11.413778447508685,-16.512862894094933,-0.005817538858912827,-0.0692423456880249,-0.06342480682911207,573982400,566105150,20.954166736951237,27.175917346253772,NaN,NaN,-3.428871333197442,-1.0165418196074427
2017-04-10T09:30:00-04:00,65.17,65.67,65.15,65.29,6330948,10202595.4,52.413584271561994,47.12441090855906,NaN,NaN,56.054662093235464,4.907696073899638,0.01486574778833237,-0.044842622093696605,-0.059708369882028975,580313348,569966033.8,28.50518873995003,26.4054404378572,NaN,NaN,-2.375089583885351,-1.2106200716471438
2017-04-11T09:30:00-04:00,65.18,65.4,64.77,65.38,10172904,10170707.05,53.65205667195875,47.818618697001455,NaN,NaN,19.21385817115158,15.548733143814838,0.03333828364791128,-0.018035515322139872,-0.051373798970051156,590486252,574013553.8,35.46516724754872,26.23811164556475,NaN,NaN,-1.1483272843586096,-1.201721102034496
2017-04-12T09:30:00-04:00,65.32,65.4399,64.44,64.48,11281502,9997920.95,41.90658856608748,47.734030151638386,NaN,NaN,-57.09251330829213,3.4675589579183397,-0.013798668982596289,-0.06862213519829652,-0.05482346621570023,579204750,578089299,41.62749009836465,26.578595029432517,NaN,NaN,-3.5324610704011707,-1.5346839546583066
2017-04-13T09:30:00-04:00,64.43,64.635,64.02,64.02,10118274,9796214.4,37.399929129873556,47.44307312499599,NaN,NaN,-166.15127126497254,-27.31229717227378,-0.07147615894710481,-0.14416866489958124,-0.07269250595247644,569086476,578614645.2,42.391085325356144,27.258450539091623,NaN,NaN,-7.07166448393563,-2.3256811731264957
2017-04-17T09:30:00-04:00,64.22,64.745,64.14,64.72,8852403,9694831.2,46.77937706753532,47.97569337438336,NaN,NaN,-88.36945507253624,-47.26894387628276,-0.05854530552407901,-0.1458741378575752,-0.08732883233349618,577938879,579405941,43.58811090141018,28.316589367213673,NaN,NaN,-7.026787818296973,-2.997267836722278
2017-04-18T09:30:00-04:00,64.4,64.769,64.24,64.51,7502841,9782342.85,44.61948075821313,47.73985468341475,NaN,NaN,-84.98105999175671,-75.47608829328121,-0.05997700456062029,-0.16230008803427154,-0.10232308347365125,570436038,577430479,41.28195584483941,29.299410675043447,NaN,NaN,-7.702769928950415,-3.6694824213262978
2017-04-19T09:30:00-04:00,64.74,64.97,64.45,64.57,9455266,9622055.7,45.39523762517292,47.56709198093528,NaN,NaN,-42.35596046707474,-87.79005202092647,-0.052968352244396055,-0.16853352377914632,-0.11556517153475027,579891304,575311489.4,38.90422829110756,30.344404127693743,NaN,NaN,-7.994839432019813,-4.287390565711085
2017-04-20T09:30:00-04:00,64.91,65.57,64.88,65.35,9492503,9483365.65,54.34798952161532,47.73605667437444,NaN,NaN,92.07091353782803,-57.95736665170243,0.005032587185174853,-0.1092744375532817,-0.11430702473845655,589383807,577347300.8,42.340340212334596,31.689633599908337,NaN,NaN,-5.218677205880748,-4.420431514306752
2017-04-21T09:30:00-04:00,65.37,65.615,65.22,65.41,10211435,9459812,54.95973156442813,48.17375442424207,NaN,NaN,112.3850009378748,-2.2501122111329637,0.04599381097280411,-0.05681476102245142,-0.10280857199525553,599595242,583449054,51.19932152308342,33.70839289033345,NaN,NaN,-2.8510804460587935,-4.196238504557043
2017-04-24T09:30:00-04:00,66.31,66.425,66.1,66.34,10498252,9488493.3,63.192735830396664,49.313705382853975,NaN,NaN,249.42979244732038,65.30973729283836,0.12954415439663863,0.059121621000542746,-0.07042253339609587,610093494,589879977,58.445842402508404,36.27796853132943,NaN,NaN,2.2662272120530123,-3.2730291164698926
2017-04-25T09:30:00-04:00,66.62,66.84,66.44,66.66,11815057,9493648.6,65.52769558571858,50.46571734753614,NaN,NaN,270.6882603003683,136.44360135126334,0.19618465359667275,0.1748082835997451,-0.02137636999692767,621908551,600174479.6,66.9151762843317,39.484879043370015,NaN,NaN,7.189819001754401,-1.7783365281521364
2017-04-26T09:30:00-04:00,66.77,67.0357,66.61,66.67,12033107,9646654.65,65.60113423647849,51.80569172239671,NaN,NaN,232.08401511703994,191.3315964680863,0.22850236465597953,0.26425158582304675,0.03574922116706721,633941658,610984550.4,73.11237089390289,43.1905933186168,NaN,NaN,11.018737030224226,0.049816837330201036
2017-04-27T09:30:00-04:00,66.62,66.87,66.385,66.65,8111444,9637178.3,65.30149946799665,52.95104752642534,NaN,NaN,167.0709683447526,206.3316074294712,0.2351777362105158,0.32972139143021195,0.09454365521969617,625830214,618273831.8,76.33175781501613,47.21872873690753,NaN,NaN,13.976128452286313,2.039289925181074
2017-04-28T09:30:00-04:00,66.75,66.89,66.26,66.34,10386329,9514594.25,60.675450272453475,53.69803504067787,NaN,NaN,124.28915395133885,208.71243803216402,0.20638791199121365,0.35252854520871324,0.1461406332174996,615443885,621443560.4,77.58841079528894,51.26403188393165,NaN,NaN,15.14023845537212,3.9108540009226522
2017-05-01T09:30:00-04:00,66.48,66.48,65.99,66.14,11234074,9689493.9,57.829111441262576,54.084858409942186,NaN,NaN,80.18840463852176,174.8641604704043,0.16342794351490902,0.3504255626111359,0.18699761909622686,604209811,620266823.8,75.97566565735963,54.65478023517519,NaN,NaN,15.283292477708068,5.535488069034854
2017-05-02T09:30:00-04:00,66.32,66.5,66.18,66.46,9450916,9638299.1,60.98290449633779,54.60849039739784,NaN,NaN,84.86534432812155,137.69957727595494,0.14665113551898634,0.3703115384949598,0.22366040297597345,613660727,618617259,73.66413436525627,57.38327788644002,NaN,NaN,16.335744310731954,7.078381817848726
2017-05-03T09:30:00-04:00,66.27,66.61,66.14,66.51,8729178,9612771.85,61.467800880776494,56.00571984844705,NaN,NaN,77.87081849533276,106.8569379516135,0.12959987642447557,0.3856602485065679,0.2560603720820923,622389905,616306908.4,70.43200661856166,59.44074335216838,NaN,NaN,17.333434183563366,8.543389298665103
2017-05-04T09:30:00-04:00,66.69,66.755,66.2,66.58,8143571,9448819,62.17651049054998,57.77547565992394,NaN,NaN,76.49176568548837,88.74109741976066,0.11425142081858197,0.3988746481053198,0.28462322728673783,630533476,617247560.8,70.99010976968044,61.48353081247725,NaN,NaN,18.358471785423298,9.945543939630559
2017-05-05T09:30:00-04:00,66.67,66.94,66.53,66.92,7110794,9422672.65,65.49605739053084,59.112381397280764,NaN,NaN,90.10432703376594,81.90413203624607,0.1177452079875983,0.4318047372712357,0.3140595292836374,637644270,621687637.8,73.52988064714516,63.62222865145832,NaN,NaN,20.20886933741231,11.41173328217081
2017-05-08T09:30:00-04:00,66.9,66.97,66.64,66.74,6078185,9350449.15,62.37497063215969,60.38063067399123,NaN,NaN,80.44433112233264,81.95531733300825,0.09941224746481958,0.43832483861466187,0.3389125911498423,631566085,627158892.6,76.28506983725285,66.12245107948785,NaN,NaN,20.92024621382312,12.770092272406853
2017-05-09T09:30:00-04:00,66.79,67,66.75,66.83,5968980,9332350.75,63.316251176177005,61.66070307049152,NaN,NaN,78.9659074041171,80.77542994820737,0.08536393703734024,0.4456175124465176,0.36025357540917735,637535065,631933760.2,78.39828108444146,68.94345485044028,NaN,NaN,21.773905529979313,14.056351309202919
2017-05-10T09:30:00-04:00,66.87,66.87,66.41,66.69,7471407,9197275.9,60.76943475811589,62.11937773024156,NaN,NaN,58.0774149605097,76.81674924124276,0.059864973570561364,0.43508479237237907,0.3752198188018177,630063658,633468510.8,79.0446452082535,71.56519092157734,NaN,NaN,21.820661151453848,15.16553842952448
2017-05-11T09:30:00-04:00,66.48,66.76,66.08,66.67,8400034,9053202.5,60.395690061584034,62.50766048003841,NaN,NaN,41.90524325292979,69.89944475473104,0.03604733568862967,0.4202789884126048,0.38423165272397514,621663624,631694540.4,76.20625063550301,73.35140014389302,NaN,NaN,21.762641046626175,16.107981660539007
2017-05-12T09:30:00-04:00,66.5,66.5,66.14,66.3,7186375,8906607.55,53.80313405630275,61.83697463903171,NaN,NaN,19.188825473698845,55.71634444271763,-0.00788626146068555,0.3743738258981182,0.38226008735880374,614477249,627061136.2,69.21523149196996,74.1206422217117,NaN,NaN,19.885215345761495,16.647586472713648
2017-05-15T09:30:00-04:00,66.3,66.66,66.3,66.61,8413529,8884663.85,57.945122697301045,61.29536228985903,NaN,NaN,38.029858639074476,47.23344994606599,-0.018711094627407776,0.358871219074544,0.3775823137019518,622890778,625326074.8,66.7459304938673,74.10855323667853,NaN,NaN,19.371226258677044,17.03667787070842
2017-05-16T09:30:00-04:00,66.69,66.75,66.28,66.54,5848784,8801961,56.70869960351107,60.66018838750421,NaN,NaN,32.99138590504068,38.03854564625071,-0.03242460619260468,0.33705155596119596,0.36947616215380064,617041994,621227460.6,61.19231139598231,73.2571204153985,NaN,NaN,18.599497242142256,17.259937780913255
2017-05-17T09:30:00-04:00,65.91,66.01,65.19,65.21,15221012,9090248.3,39.47411258525095,58.81537503873666,NaN,NaN,-183.42740656729757,-10.262418659310754,-0.12756615465211663,0.21001846883865483,0.33758462349077145,601820982,615578925.4,54.4662303110079,71.69529702225505,NaN,NaN,11.556168888863915,16.445113653477634
2017-05-18T09:30:00-04:00,65.01,65.69,64.65,65.3,15260085,9378627.4,40.78557030928154,57.39466932708152,NaN,NaN,-232.36529658361545,-65.1165266266198,-0.17784591023805796,0.11527723569319903,0.293123145931257,617081067,614662414,53.43982942325238,69.97039835282386,NaN,NaN,6.541825936955897,15.0303582654031
2017-05-19T09:30:00-04:00,65.51,66.455,65.51,66.16,10322281,9384169.7,51.58160240854431,56.94841868188736,NaN,NaN,-82.71898822436066,-85.4980893662317,-0.14782646735346472,0.10834006173942612,0.25616652909289084,627403348,617247633.8,55.960830915168444,68.54076729981021,NaN,NaN,5.888306581525909,13.724350881992073
2017-05-22T09:30:00-04:00,66.66,66.76,66.47,66.67,6506192,9184566.7,56.631342264498144,56.63759280818453,NaN,NaN,49.34327625714004,-83.23540584261858,-0.09104996723717429,0.14235407004642298,0.23340403728359727,633909540,619451386.2,58.04618591434691,67.42519955331667,NaN,NaN,7.205704178675079,12.793115638661074
2017-05-23T09:30:00-04:00,66.78,66.87,66.5,66.81,7856044,8986616.05,57.928489402821896,56.38478484547348,NaN,NaN,69.27577402294506,-75.97852821903771,-0.043883994292893996,0.17854904441747976,0.22243303871037376,641765584,624396104.2,62.353698997661525,66.84817758039524,NaN,NaN,8.66743480372299,12.203732662241348
2017-05-24T09:30:00-04:00,66.89,67.13,66.67,66.89,7889472,8779434.3,58.68886302680549,56.13566716949174,NaN,NaN,105.08560344100178,-18.275926217377837,-0.008943271162248995,0.2112539497575625,0.2201972209198115,649655056,633962919,68.98800353407486,66.7051699921377,NaN,NaN,10.055547098528695,11.896849010282398
2017-05-25T09:30:00-04:00,67.04,67.415,66.99,67.33,6840816,8715902.9,62.683582228179965,55.93477608646668,NaN,NaN,164.70423692514802,61.137980484374864,0.039497994282706034,0.26956971377319405,0.23007171949048802,656495872,641845880,73.18181723028502,66.68030831950483,NaN,NaN,12.554611628481005,11.990815098596485
2017-05-26T09:30:00-04:00,67.24,67.5,67.215,67.41,5991008,8496136.85,63.3770000813872,56.00634961855435,NaN,NaN,166.61885180580734,111.00554849040846,0.07079738402835092,0.31856844952592667,0.24777106549757574,662486880,648862586.4,76.25933706134383,66.67847026408276,NaN,NaN,14.75775747001477,12.386092580227668
2017-05-30T09:30:00-04:00,67.22,67.48,67.125,67.39,6092540,8239060.15,63.06151114194464,55.988153901823466,NaN,NaN,138.90014254632626,128.9169217482457,0.08316868450792597,0.3517319211324832,0.2685632366245572,656394340,653359546.4,78.00167179479392,66.65014102910794,NaN,NaN,16.43215294921778,12.964101204369113
2017-05-31T09:30:00-04:00,67.47,67.535,67.06,67.52,10518804,8292454.55,64.30532096150023,56.240717202065206,NaN,NaN,127.98006523595365,140.65777999084742,0.09241079263715724,0.38407672742100374,0.2916659347838465,666913144,658389058.4,79.78829590774164,66.70325893621423,NaN,NaN,18.18747740778798,13.710297804857523
2017-06-01T09:30:00-04:00,67.7,68.12,67.48,67.94,16117970,8661894.15,68.04862444116257,56.7873553720351,NaN,NaN,175.72559366754606,154.78577803615627,0.11750359666165505,0.43854543061091533,0.3210418339492603,683031114,665064270,81.89049552495956,67.10927642831828,NaN,NaN,20.87650575713584,14.73404179804014
2017-06-02T09:30:00-04:00,68.06,68.58,68.05,68.21,17769606,9143195.9,70.21135057074427,57.95937083735236,NaN,NaN,197.7956021170931,161.4040510745453,0.14137543950545728,0.49776113333108185,0.35638569382562457,700800720,673925239.6,84.2345997384689,68.18208844592534,NaN,NaN,23.827132041269316,16.033054689930022
2017-06-05T09:30:00-04:00,68.13,68.32,67.94,67.97,16550717,9615192.05,65.93881888742291,58.53034913664677,NaN,NaN,143.35067917873863,156.75041654913156,0.1303613743159796,0.5193374117205991,0.3889760374046195,684250003,678277864.2,85.24493633703281,69.50344600615145,NaN,NaN,25.0785373062695,17.325266492264234
2017-06-06T09:30:00-04:00,67.72,67.85,67.51,67.51,15201411,10071353.35,58.58074523880747,58.66406668202509,NaN,NaN,80.84111518034453,145.13861107593522,0.0837218673393621,0.4936283715788221,0.40990650423946,669048592,680808714.6,85.81420176320624,71.26215246095316,NaN,NaN,23.91885309770979,18.267207435899312
2017-06-07T09:30:00-04:00,67.65,67.65,67.1299,67.43,8342447,10190026.7,57.38148999364937,59.94316506833927,NaN,NaN,51.90911363750852,129.92442075624618,0.04125783683376649,0.4614788002816681,0.4202209634479016,660706145,679567314.8,84.10024113505274,73.37886751981351,NaN,NaN,22.620716080655978,18.88913724229312
2017-06-08T09:30:00-04:00,67.39,67.8,67.34,67.65,7040075,10168460.1,59.817669221985675,61.30260070496099,NaN,NaN,64.82975864484852,107.74525375170666,0.02268821292491474,0.448581229604045,0.42589301667913027,667746220,676510336,79.86976249559098,75.26671988212341,NaN,NaN,22.225224911709123,19.365721195066836
2017-06-09T09:30:00-04:00,67.72,68.01,67.555,67.91,10433658,10270141.3,62.54276657382294,62.085541002480895,NaN,NaN,79.32068305832001,84.05026993995202,0.022569586055575352,0.4541049992485995,0.43153541319302413,678179878,671986167.6,73.94170073602587,76.55106772647036,NaN,NaN,22.683377418430428,19.839672084118778
2017-06-12T09:30:00-04:00,68.07,68.245,67.71,68.16,13889236,10605284.35,65.00063381352626,62.68334754169721,NaN,NaN,91.9473121151871,73.7695965272417,0.033332288001742594,0.4732007731952024,0.4398684851934598,692069114,673549989.8,74.64230597285501,77.73650487350666,NaN,NaN,23.79951568094498,20.40536402652252
2017-06-13T09:30:00-04:00,68.26,68.465,68.16,68.44,6723498,10520782.8,67.567514389988,63.37184932649478,NaN,NaN,113.01449764049296,80.20427301927138,0.05218955631030264,0.505105430581338,0.4529158742710354,698792612,679498793.8,77.15815961978186,78.79396634651526,NaN,NaN,25.525983400316164,21.13688107992161
2017-06-14T09:30:00-04:00,68.6,68.6,68.14,68.37,8892757,10672981.45,66.25918745681966,63.912586785781514,NaN,NaN,106.66176653031405,91.15480359783251,0.05267667994024211,0.518761724196338,0.4660850442560959,689899855,685337535.8,79.32621296139297,79.53240987703798,NaN,NaN,26.572477519938374,21.913394857066862
2017-06-15T09:30:00-04:00,67.97,68.78,67.95,68.78,20188089,10921335.3,69.93165799568148,64.4303064834602,NaN,NaN,115.73884766355067,101.33662140157293,0.0721366347723299,0.5562558377215083,0.48411920294917843,710087944,693805880.6,81.99543892125445,80.16195428353579,NaN,NaN,28.610876954505336,22.870178013843788
2017-06-16T09:30:00-04:00,68.59,68.725,68.43,68.68,12871568,10801909.45,67.98793026615269,64.75965863951487,NaN,NaN,122.7296478849555,110.01841436690002,0.06975684711938657,0.5713152618484116,0.5015584147290251,697216376,697613180.2,83.05473386603744,80.64733976958533,NaN,NaN,29.735020001635643,23.850869726385483
2017-06-19T09:30:00-04:00,69.02,69.185,68.815,69.1,6867011,10629145.95,71.56296226602612,65.36690514837782,NaN,NaN,158.4805180155704,123.32505554697669,0.08683927960433413,0.6101075142344428,0.5232682346301086,704083387,700016034.8,83.7062865780778,81.05481225410561,NaN,NaN,31.825989132772953,24.99017249872655
2017-06-20T09:30:00-04:00,68.95,69.01,68.35,68.36,7242771,10665974.9,59.050165017307975,64.99153686664981,NaN,NaN,93.02069398450838,119.32629481577976,0.04099835097514437,0.5745161733490391,0.5335178223738948,696840616,699625635.6,83.14689834499298,81.294712428195,NaN,NaN,29.59377458720312,25.64782993993749
2017-06-21T09:30:00-04:00,68.46,68.49,67.82,67.9,7530233,10649684.35,52.86252809299129,63.90681569892329,NaN,NaN,21.095112586808487,102.21296402707864,-0.024103161811069418,0.503388870110058,0.5274920319211274,689310383,699507741.2,82.96658519228794,81.37157597586132,NaN,NaN,25.57359933010751,25.637225567104636
2017-06-22T09:30:00-04:00,67.89,67.99,67.76,67.76,6921726,10601297.05,51.10726885547795,62.54223843354712,NaN,NaN,-20.759082542047242,74.91337798595907,-0.07738751832898727,0.4307576340098933,0.5081451523388806,682388657,693967883.8,74.76207271787953,80.69496690296207,NaN,NaN,21.808933699812677,25.090326728920072
2017-06-23T09:30:00-04:00,67.82,68.16,67.67,68.01,6979349,10608223.7,54.04189071519398,61.692457849816485,NaN,NaN,-9.75681743613074,48.41608492174182,-0.09540658552036563,0.38888692043842354,0.48429350595878917,689368006,692398209.8,72.5722169245656,79.78977265921442,NaN,NaN,19.6253720570755,24.30961891865656
2017-06-26T09:30:00-04:00,68.21,68.52,67.98,68.03,7161714,10666759,54.278321858912044,61.385141894109665,NaN,NaN,24.558362263584602,21.631653771344663,-0.10483807505767151,0.35324591213669976,0.45808398719437127,696529720,690887476.4,70.43386704742467,78.69117732237287,NaN,NaN,17.96141198239217,23.402732213475932
2017-06-27T09:30:00-04:00,67.95,68.02,67.5,67.52,7417217,10732992.85,47.55934347052404,60.68355999960072,NaN,NaN,-73.80250035117298,-11.732985095791577,-0.14197703766784597,0.2806126901095638,0.4225897277774098,689112503,689341853.8,68.21916608661427,77.55681481891297,NaN,NaN,14.342134849329536,22.10836116145502
2017-06-28T09:30:00-04:00,67.84,68.29,67.82,68.13,7314279,10572766.6,54.771044768629885,60.32308682436102,NaN,NaN,-3.475547383637212,-16.647117089880716,-0.12273624396424587,0.26916942282210243,0.3919056667863483,696426782,690765133.6,69.18019178773004,76.79327405406578,NaN,NaN,13.503646825237645,20.879116256281108
2017-06-29T09:30:00-04:00,68.2,68.255,67.17,67.55,9543636,10244049.9,48.01040464704208,59.2850609724481,NaN,NaN,-89.06481408361702,-30.30826339819467,-0.14482962467644,0.2108686359407983,0.3556982606172383,686883146,691664031.4,69.80129356111453,76.49753068442924,NaN,NaN,10.4422588817642,19.38813663135012
2017-06-30T09:30:00-04:00,67.81,68.44,67.81,68.11,6748532,9692996.2,53.92405642503407,58.49387687327009,NaN,NaN,8.798308651782365,-26.597238180612045,-0.11859006084912949,0.20746068455582645,0.32605074540495593,693631678,692516765.8,70.41049192940068,76.19525825275393,NaN,NaN,9.934987688316282,18.037686782345286
2017-07-03T09:30:00-04:00,68.42,68.77,68.32,68.53,5553136,9143117.15,57.80098312884,57.7962674974738,NaN,NaN,86.76980924089382,-14.154948785150205,-0.07209604724133667,0.23593068635328507,0.30802673359462174,699184814,693047784.6,70.80545177762488,75.7414934068856,NaN,NaN,10.875602563978365,17.014531894007156
2017-07-05T09:30:00-04:00,68.71,68.82,68.42,68.73,7235950,8744844.1,59.5465415846948,57.31679279232202,NaN,NaN,97.57073127040628,20.11969753916565,-0.02921979449076162,0.27150199048116974,0.30072178497193136,706420764,696509436.8,73.30679949753389,75.31153530232423,NaN,NaN,12.203623166176678,16.3272592186028
2017-07-06T09:30:00-04:00,68.56,68.65,68.05,68.13,5599858,8607714.65,52.52683106697167,56.07359086884275,NaN,NaN,16.80850499747866,24.176508015388823,-0.041846261408572005,0.24841395821121637,0.2902602196197884,700820906,697388261.6,73.91777047130502,74.7345589844707,NaN,NaN,10.949466872345658,15.559003169137496
2017-07-07T09:30:00-04:00,68.3,68.87,68.24,68.66,4166680,8464044.9,57.31378858528925,55.311152177352504,NaN,NaN,75.22164335983896,57.033799504080015,-0.016389521279750796,0.26977331802009985,0.28616283929985065,704987586,701009149.6,76.32243470262686,74.25368047279851,NaN,NaN,11.553162577400483,14.98674022746078
2017-07-10T09:30:00-04:00,68.61,69.18,68.53,68.86,7919515,8338337.75,58.99412501641044,54.41337808809425,NaN,NaN,119.87110633727221,79.24835904117798,0.010580076823178353,0.2993879353288236,0.2888078585056452,712907101,704864234.2,78.58608488261224,73.88795178026525,NaN,NaN,12.587229681969013,14.643953006676242
2017-07-11T09:30:00-04:00,68.86,68.91,68.315,68.8,7683534,8028052.65,58.253267214378475,54.35645681645643,NaN,NaN,73.38765510997371,76.57192821499396,0.020467407369838708,0.3143921177179436,0.2939247103481049,705223567,706071984.8,79.25521300326619,73.60997425585619,NaN,NaN,13.173969454945771,14.433955356429031
2017-07-12T09:30:00-04:00,69.19,69.495,69.1,69.18,5821774,7982966.45,61.54689514179059,54.976768748513514,NaN,NaN,166.14901960784468,90.28758588248164,0.04716271606371508,0.3528781054277488,0.3057153893640337,711045341,706996900.2,79.77638541361384,73.38210284309376,NaN,NaN,14.701620022462075,14.472193165862324
2017-07-13T09:30:00-04:00,69.25,69.4,68.97,69.13,3938756,7735266.4,60.86643761913486,55.67385223163188,NaN,NaN,128.58589749076415,112.64306438113874,0.055444438830413334,0.3750209379020504,0.31957649907163704,707106585,708254036,80.49370404832567,73.79150508098277,NaN,NaN,15.7292056163865,14.651766373080063
2017-07-14T09:30:00-04:00,69.24,69.575,69.11,69.43,5519169,7001820.4,63.47567169890446,56.347693730468336,NaN,NaN,141.9987165276236,125.99847901469566,0.07396055432091653,0.4120271919727827,0.3380666376518662,712625754,709781669.6,81.3589610804357,74.41912966354492,NaN,NaN,17.382052993640738,15.041807318874445
2017-07-17T09:30:00-04:00,69.38,69.5,69.19,69.39,5113416,6613912.8,62.87372742689775,56.96165127103875,NaN,NaN,124.57329679311536,126.9389171058643,0.07605416676512727,0.4331343461082753,0.357080179343148,707512338,708702717,78.70354565466909,75.0098209926338,NaN,NaN,18.563181377043836,15.544860755755787
2017-07-18T09:30:00-04:00,69.28,69.37,69.025,69.23,6891118,6615118.15,60.40612803578222,57.87927873998576,NaN,NaN,99.73585775319629,132.20855763450882,0.059913259344485104,0.4319717535237544,0.3720584941792693,700621220,707782247.6,76.41224688075133,75.59504104935789,NaN,NaN,18.886928604378063,16.022299019844684
2017-07-19T09:30:00-04:00,69.11,69.3,69.0008,69.3,8864581,6696208.65,61.124978941813744,58.33313118092746,NaN,NaN,88.81583861866298,116.74192143667247,0.04773094941327949,0.43172218094586867,0.3839912315325892,709485801,707470339.6,75.60897490358789,76.05423984334773,NaN,NaN,19.350758661805664,16.49779325441054
2017-07-20T09:30:00-04:00,69.36,69.4,68.82,68.91,7428029,6691098.45,55.12050096200039,58.84099520342448,NaN,NaN,61.70453094327195,103.36564812717401,0.00920351466976499,0.3954956248697954,0.3862921102000304,702057772,706460577,72.93585656977936,76.2781372011095,NaN,NaN,18.092316094243728,16.725582231529565
2017-07-21T09:30:00-04:00,68.57,68.81,68.34,68.78,7643811,6727202.7,53.242990343653396,58.792347626183,NaN,NaN,2.6171383825933336,75.48933249816797,-0.02724524620242541,0.35223555244699867,0.3794807986494241,694413961,702818218.4,64.12852781190475,75.82942547843122,NaN,NaN,16.508620416146172,16.694587686474794
2017-07-24T09:30:00-04:00,68.71,68.81,68.53,68.63,7551671,6755818.8,51.080964290133885,58.31234628056114,NaN,NaN,-0.678027739764779,50.43906759159194,-0.06169468613813872,0.3023624409767507,0.3640571271148894,686862290,698688208.8,55.887674188807324,74.76386993637281,NaN,NaN,14.561456458483327,16.389854653904585
2017-07-25T09:30:00-04:00,68.98,68.98,68.34,68.54,9077140,6851590.1,49.77495784985979,57.61437601378721,NaN,NaN,-10.514814284016037,28.388933184149487,-0.08911541937940182,0.25266285289063717,0.341778272270039,677785150,694120994.8,48.469834394673974,72.98980100045426,NaN,NaN,12.559103981758224,15.842604557883677
2017-07-26T09:30:00-04:00,68.74,68.74,68.47,68.63,6803993,6820928.9,51.120802648820344,57.513945412490685,NaN,NaN,-21.39966254590514,6.345832951235864,-0.09900296373199768,0.21802456760504185,0.31702753133703954,684589143,689141663.2,41.934897864273374,70.705310099952,NaN,NaN,11.192812158716993,15.178348500859865
2017-07-27T09:30:00-04:00,68.56,68.56,67.91,68.24,9900940,6950261.95,45.43872006987322,56.66572623281811,NaN,NaN,-93.68886461656973,-24.73284616073247,-0.1277895544020281,0.15729058833450438,0.2850801427365325,674688203,683667749.4,36.16268779259293,67.83675674923529,NaN,NaN,8.349013960460098,14.202729280802755
2017-07-28T09:30:00-04:00,68.17,68.45,68.02,68.4,11435656,7044862.95,47.99268185816084,55.879908864371714,NaN,NaN,-96.45834926948615,-44.54794369114836,-0.131521687174586,0.1206780337683,0.252199720942886,686123859,682009729,34.608765675499114,64.69551966301292,NaN,NaN,6.600966642584247,13.116763189628683
2017-07-31T09:30:00-04:00,68.72,68.75,68.29,68.31,6787348,7046803.75,46.66934988181622,55.05248619776012,NaN,NaN,-70.37700168143253,-58.48773847948191,-0.13500917798075074,0.08343824846694758,0.21844742644769832,679336511,680504573.2,33.21349214008799,61.406825315643054,NaN,NaN,4.761586561017458,11.923166528398507
2017-08-01T09:30:00-04:00,68.37,68.49,67.905,68.11,16893671,7613830.5,43.78036458881783,53.78344830111921,NaN,NaN,-119.92680038081997,-80.3701356988427,-0.14487274170480938,0.03735649931668661,0.18222924102149599,662442840,677436111.2,30.512775979134915,57.88799607032313,NaN,NaN,2.356844507008943,10.556549096771427
2017-08-02T09:30:00-04:00,68.11,68.43,68,68.41,17642855,8134175.75,48.891128442256786,52.92806907419934,NaN,NaN,-89.72727772093207,-94.03565873384808,-0.12597661390764786,0.024758473636936174,0.15073508754458403,680085695,676535421.6,29.74812528593951,54.26331187300983,NaN,NaN,1.6342883050347892,9.281940412237622
2017-08-03T09:30:00-04:00,68.28,68.75,68.28,68.75,13298775,8519121.6,53.995480642353286,52.250912570159976,NaN,NaN,-33.95747907693372,-82.08938162592088,-0.08720520213802979,0.04172858487204678,0.12893378701007657,693384470,680274675,36.82616566294739,51.0823979146178,NaN,NaN,2.491883850772453,8.311932332028313
2017-08-04T09:30:00-04:00,68.72,68.91,68.6,68.88,12746046,8948089.9,55.81263397075577,51.74654875186412,NaN,NaN,4.5030860416126615,-61.897094563701124,-0.05121176000064334,0.0649190870092724,0.11613084700991574,706130516,684276006.4,43.39806231000183,48.560577675713,NaN,NaN,3.739661047289053,7.658750719922704
2017-08-07T09:30:00-04:00,68.83,68.966,68.72,68.88,7753092,8939768.75,55.81263397075577,51.41844203293366,NaN,NaN,16.40066477684893,-44.54156127204483,-0.027025905459881844,0.08234846518506345,0.10937437064494529,706130516,689634807.4,50.782550244043314,46.72988505880528,NaN,NaN,4.761140927058897,7.2448064637993035
2017-08-08T09:30:00-04:00,68.78,69.07,68.57,68.67,9136464,9012415.25,51.96703226934533,50.7643029849002,NaN,NaN,-1.8702188511792743,-20.93024496611669,-0.02484879243035218,0.07831338010700506,0.10316217253735724,696994052,696545049.8,58.331805420373634,45.49580152428998,NaN,NaN,4.601148221191865,6.86714100056967
2017-08-09T09:30:00-04:00,68.53,68.78,68.5,68.69,8088193,9125736.2,52.3040930931474,50.563130994267844,NaN,NaN,-20.315283165018034,-7.0478460549338875,-0.021845761959995408,0.07585497008736297,0.09770073204735838,705082245,701544359.8,62.77980842482109,44.77036951393582,NaN,NaN,4.557907855077362,6.537250551213626
2017-08-10T09:30:00-04:00,68.38,68.56,67.78,67.82,10779707,9467783.75,39.36389639656284,49.571767140904235,NaN,NaN,-139.49965562637001,-28.156281364821144,-0.07523041614521231,0.0036627118658429936,0.0788931280110553,694302538,701727973.4,62.93629916028673,44.68521032453453,NaN,NaN,0.3147245123976738,5.648318259954205
2017-08-11T09:30:00-04:00,67.85,68.18,67.78,67.86,10501194,9716885,40.097690454666655,48.78724758122801,NaN,NaN,-152.89289558665382,-59.63547769047443,-0.10291372746518901,-0.04974903132043096,0.05316469614475805,704803732,701462616.6,62.52714339550564,45.15945812501298,NaN,NaN,-2.83336050666255,4.43664986472324
2017-08-14T09:30:00-04:00,68.31,68.65,68.24,68.57,6680893,9795258.85,51.35141241525886,48.89985147875651,NaN,NaN,-22.41416780641254,-67.39844420712673,-0.07004433411105673,-0.03439072149406286,0.03565361261699387,711484625,702533438.4,63.55676134305047,46.23709576418274,NaN,NaN,-1.9624320329752425,3.5224953079091708
2017-08-15T09:30:00-04:00,68.53,68.62,68.31,68.42,5055014,9703453.65,49.24644632228988,48.76596888400434,NaN,NaN,-23.987486331460165,-71.8218977031829,-0.05566829215897286,-0.03393175258172221,0.02173653957725065,706429611,704420550.2,65.36295869077465,47.910528680361374,NaN,NaN,-1.9552176517413575,2.7399648851019522
2017-08-16T09:30:00-04:00,68.42,68.765,68.42,68.61,7725838,9646516.5,51.93412056501944,49.22992606222907,NaN,NaN,26.308073805726394,-62.49722630903402,-0.03181225546798282,-0.018028779757727875,0.013783475710254943,714155449,706235191,67.05390532471455,50.117044218370054,NaN,NaN,-1.0855437194620199,2.193463655878528
2017-08-17T09:30:00-04:00,68.24,68.43,67.38,67.42,10766247,9813427.4,38.26617431120606,48.53517552316087,NaN,NaN,-194.6081354020833,-73.51892226417667,-0.09126078409944939,-0.1002925044140568,-0.009031720314607404,703389202,708052523.8,68.70182704244364,52.55226288743752,NaN,NaN,-5.446050352383533,1.1021045118410908
2017-08-18T09:30:00-04:00,67.08,67.61,67,67.15,14111125,10136793.1,35.95410700155524,47.769801031713655,NaN,NaN,-246.12730369688123,-92.16580388622215,-0.14088635779314906,-0.18513966755604372,-0.04425330976289466,689278077,704947392.8,62.911625421337675,54.6735581218125,NaN,NaN,-9.674225048183981,-0.4373711395910622
2017-08-21T09:30:00-04:00,67.22,67.31,66.95,67.26,7447304,10131574.75,37.608076168669136,47.32892328741733,NaN,NaN,-210.39380064716948,-129.76173045437355,-0.1571818183002045,-0.24073058263815028,-0.08354876433794578,696725381,701995544,57.91459187861929,56.63083068606138,NaN,NaN,-12.349935678992468,-2.139166073791263
2017-08-22T09:30:00-04:00,67.44,68.09,67.44,68.03,6559150,10005675.25,47.775151394598794,47.24921064115603,NaN,NaN,-74.16993984590835,-139.79822115726319,-0.1092544673285392,-0.2201168484986198,-0.11086238117008058,703284531,701366528,56.87783556762522,58.56866713475322,NaN,NaN,-10.99088918431131,-3.403697946722698
2017-08-23T09:30:00-04:00,67.75,67.75,67.39,67.39,7027114,10016831.3,41.69364147439508,46.370507843444734,NaN,NaN,-117.24651558676852,-168.50913903576216,-0.11331982621072625,-0.2525121639334884,-0.13919233772276215,696257417,697786921.6,51.254675543682616,59.599274983377164,NaN,NaN,-12.11843344022082,-4.648660160079572
2017-08-24T09:30:00-04:00,67.56,67.58,67.15,67.18,7917391,9917653.85,39.89893015329248,45.233814713625925,NaN,NaN,-128.2373222524498,-155.23497640583545,-0.1220602212850615,-0.29176761432908904,-0.16970739304402754,688340026,694777086.4,47.04327050226354,59.85964699711015,NaN,NaN,-13.620023216642721,-5.930283453874308
2017-08-25T09:30:00-04:00,67.49,67.755,67.41,67.5,7846272,9738184.65,43.86426234410085,44.38035959743628,NaN,NaN,-80.17437474851003,-122.04439061616122,-0.09917109076359965,-0.2936712564985271,-0.19450016573492745,696186298,696158730.6,49.11036826426164,59.74020542712575,NaN,NaN,-13.460978061415108,-7.006096969237279
2017-08-28T09:30:00-04:00,67.65,67.72,67.365,67.46,5999215,9698778,43.478106430072565,43.774007751773944,NaN,NaN,-76.9174696462365,-95.34912441597463,-0.08040540040712632,-0.29500691624383535,-0.21460151583670903,690187083,694851071,47.231256832363684,58.94730909941075,NaN,NaN,-13.460612820558584,-7.92817066228318
2017-08-29T09:30:00-04:00,67.24,68.01,67.08,67.95,8150182,9261603.55,49.35938321719681,43.56367133206319,NaN,NaN,-49.71189470425538,-90.45751538764405,-0.031201308963837993,-0.2536031520415065,-0.22240184307766853,698337265,693861617.8,45.80315246235399,57.734690816377395,NaN,NaN,-11.529062196751259,-8.442583738635763
2017-08-30T09:30:00-04:00,68,68.26,67.86,68.23,5463266,8652624.1,52.40689629564473,44.495314181997614,NaN,NaN,9.675927492583423,-65.07302677177366,0.021171027504276824,-0.1959380586973225,-0.21710908620159933,703800531,695370240.6,48.36663840031439,56.69400076209366,NaN,NaN,-8.956466953145751,-8.515995626422905
2017-08-31T09:30:00-04:00,68.36,68.6,68.241,68.46,8635037,8419437.2,54.81247533650864,45.54637024498633,NaN,NaN,54.54962392221449,-28.515637536840803,0.06954457791098029,-0.13017836381287395,-0.19972294172385424,712435568,700189349,55.59241859073346,56.198663276038495,NaN,NaN,-6.085017443392282,-8.168713028847101
2017-09-01T09:30:00-04:00,68.61,68.8,68.52,68.52,14501865,8507228.15,55.44514747854214,45.838779892363696,NaN,NaN,82.0840053292162,3.936038478704444,0.10186843622843064,-0.07238739643831593,-0.17425583266674657,726937433,706339576,62.75585607519712,56.14145575690612,NaN,NaN,-3.5873724762396497,-7.514235807046036
2017-09-05T09:30:00-04:00,68.34,68.42,67.68,67.83,16031137,8921130.4,47.25180534681691,45.69630553697277,NaN,NaN,-1.1466504181704522,19.09020232431765,0.07434276177764462,-0.08132738044469079,-0.1556701422223354,710906296,710483418.6,66.65839823141658,56.23398715266626,NaN,NaN,-3.8941161367012924,-6.997075854139645
2017-09-06T09:30:00-04:00,67.97,68.12,67.83,67.9,19701442,9449379.3,48.089880962225415,45.42171699391606,NaN,NaN,1.178178092715352,29.268216883711794,0.05907948331390675,-0.08182078807995197,-0.14090027139385872,730607738,716937513.2,71.64237706916752,56.5617351344129,NaN,NaN,-3.885692543213173,-6.5525925240072915
2017-09-07T09:30:00-04:00,67.95,68.04,67.64,68.04,13887023,9739320.8,49.80750866571268,46.246098019237955,NaN,NaN,0.19954105557083332,27.372939596309276,0.05663474574542843,-0.07010683921207317,-0.1267415849575016,744494761,725076359.2,76.42763246073827,57.1135783785768,NaN,NaN,-3.3754151592119848,-6.098710043322248
2017-09-08T09:30:00-04:00,67.71,68.37,67.61,68.27,8066996,9603685.25,52.583336259515875,47.433900109092285,NaN,NaN,32.8395291779213,23.030920647450646,0.06796708615876353,-0.04178272725904719,-0.10974981341781072,752561757,733101597,80.00970420981052,58.33486972061058,NaN,NaN,-2.133505421666406,-5.532252240228556
2017-09-11T09:30:00-04:00,68.53,68.88,68.53,68.86,8005620,9478906.55,58.867502621362355,48.952430569998945,NaN,NaN,135.26230696325612,33.66658097425863,0.1101600203711573,0.027950212046135903,-0.0822098083250214,760567377,739827585.8,82.42079332158694,60.085312680822554,NaN,NaN,0.9581366768644557,-4.605053823500983
2017-09-12T09:30:00-04:00,69.02,69.21,68.9,69.19,7606229,9525173.35,61.90833997340258,49.9619440399135,NaN,NaN,172.92746113989463,68.48140328587165,0.15264028401370777,0.10859054669211332,-0.04404973732159445,768173606,751281047.8,85.60481859618389,62.13724004000532,NaN,NaN,4.531347891623367,-3.2998535784832184
2017-09-13T09:30:00-04:00,69.14,69.19,68.94,69.09,5528446,9548844.95,60.449946287521875,51.30168009799399,NaN,NaN,150.95044802104172,98.43585727153693,0.16528426103632884,0.1625555889738166,-0.002728672062512233,762645160,757688532.2,87.02110302679897,64.6919848602279,NaN,NaN,7.002877262783019,-1.828034886873756
2017-09-14T09:30:00-04:00,68.99,69.44,68.9,69.42,6864883,9505797.2,63.505251589923134,52.987845914896184,NaN,NaN,158.58141352227943,130.11223176487866,0.1856294926389144,0.22930819373613076,0.04367870109721637,769510043,762691588.6,88.01280975857219,67.61838052139281,NaN,NaN,10.056407019458804,-0.1302574716833904
2017-09-15T09:30:00-04:00,69.15,69.42,69,69.39,9989759,9466972.8,63.02856062156952,54.3567243632868,NaN,NaN,135.3883970444203,150.62200533817844,0.18633774461755284,0.27660088186915743,0.09026313725160459,759520284,764083294,88.2810541321427,70.4162866548129,NaN,NaN,12.39692689950312,1.6593402956289682
2017-09-18T09:30:00-04:00,69.54,69.85,69.48,69.78,6143732,9068603.15,66.54436421682045,56.00431420519737,NaN,NaN,155.37641836622478,154.64482761877218,0.2010795078515396,0.3416125220660291,0.1405330142144895,765664016,765102621.8,88.48431521366099,73.3629336820484,NaN,NaN,15.514090066878254,3.6385902629502946
2017-09-19T09:30:00-04:00,69.84,69.935,69.77,69.85,7160002,9054238.05,67.148222784213,57.27494560284138,NaN,NaN,147.39090936317302,149.53751726342784,0.2029644631835205,0.3942385931938901,0.1912741300103696,772824018,766032704.2,88.67729338165975,76.42537231914169,NaN,NaN,18.25154256784757,5.7261548779356195
2017-09-20T09:30:00-04:00,69.89,70.375,69.89,70.36,6676220,9060091.55,71.22352941567371,58.618990825700585,NaN,NaN,154.68248976300555,150.28392561182062,0.22430938293972597,0.47166085868502705,0.24735147574530109,779500238,769403719.8,89.37243937067777,79.35435810273907,NaN,NaN,21.98325502512175,8.048597756105067
2017-09-21T09:30:00-04:00,70.32,70.635,70.2,70.57,4377660,8927618.85,72.72396207869784,59.89838273585696,NaN,NaN,153.88761168515103,149.34516524439493,0.2370759498282865,0.5436964130306592,0.3066204632023727,783877898,772277290.8,89.93945264906972,81.80771767833453,NaN,NaN,25.57076458117472,10.551764445400732
2017-09-22T09:30:00-04:00,70.62,70.82,70.55,70.75,3533893,8708443.95,73.97647715999337,61.22204914167491,NaN,NaN,151.61319133676878,152.59012410286462,0.2413416528379616,0.6082975292498247,0.3669558764118631,787411791,777855592.2,90.94898794697731,83.8215128120331,NaN,NaN,28.953694895971022,13.180611652625059
2017-09-25T09:30:00-04:00,70.83,70.85,70.26,70.75,6917087,8661984.7,73.97647715999337,63.13095427118751,NaN,NaN,128.17356635506752,147.14955370063316,0.22801831792454685,0.6519787738175467,0.4239604558929998,787411791,782205147.2,91.65236901647579,85.60679643953733,NaN,NaN,31.707624904403676,15.827327831450576
2017-09-26T09:30:00-04:00,70.77,70.88,70.7,70.75,3997786,8561913.25,73.97647715999337,64.97999685674236,NaN,NaN,126.21216817234829,142.91380546246822,0.20384924615925337,0.6787720135920665,0.47492276743281314,787411791,785122701.8,92.09607490959678,87.06777485671087,NaN,NaN,33.98733101973293,18.4216140012052
2017-09-27T09:30:00-04:00,70.93,71.1068,70.6501,70.83,6943694,8501588.85,74.62333341772052,66.75255576760006,NaN,NaN,117.96870691361113,135.57104889258932,0.1787900587704161,0.6984103408958333,0.5196202821254172,794355485,788093751.2,92.53143127641378,88.21804620068768,NaN,NaN,36.106137437827556,20.94797449215125
2017-09-28T09:30:00-04:00,70.73,70.85,70.5,70.79,6124550,8534653.05,73.63774214726207,68.25644190243908,NaN,NaN,94.35945976407643,123.66541850837443,0.14642098979685358,0.7026465193714841,0.5562255295746306,788230935,788964358.6,92.65903183916004,89.12156960278409,NaN,NaN,37.666157028789996,23.336286283099643
2017-09-29T09:30:00-04:00,70.75,71.01,70.62,71,6527169,8429259.65,75.46951777257709,69.44230012752585,NaN,NaN,94.88317181303823,112.31941460362832,0.12678776164560923,0.714710231631642,0.5879224699860328,794758104,790433621.2,92.88011217337007,89.86866380648287,NaN,NaN,39.53976840044553,25.651069442720484
2017-10-02T09:30:00-04:00,70.97,71.49,70.8575,71.49,16764672,8542400,79.11593369470347,70.67141396476163,NaN,NaN,110.73964644141867,108.83263062089853,0.13374628896326057,0.7551053311901086,0.621359042226848,811522776,795255818.2,93.56507994191239,90.43725390260634,NaN,NaN,42.370720373307535,28.039591004232918
2017-10-03T09:30:00-04:00,71.53,71.8,71.43,71.8,11793428,8330514.55,81.03649841915814,72.14188197416422,NaN,NaN,126.11658009842976,108.81351300611485,0.14521522160665212,0.8028780692351631,0.657662847628511,823316204,802436700.8,94.42517385498827,90.96611610461984,NaN,NaN,45.44250888516002,30.525722130079647
2017-10-04T09:30:00-04:00,71.78,71.9,71.65,71.78,14772483,8084066.6,80.5220030862111,73.35736422389907,NaN,NaN,122.13361276343566,109.64649417607976,0.1375191646025915,0.8295618033817505,0.692042638779159,808543721,805274348,94.72520972005633,91.44557324472586,NaN,NaN,47.80802577522824,32.99462265081516
2017-10-05T09:30:00-04:00,71.74,72.02,71.61,71.95,15061346,8142782.75,81.5918334428243,74.68331228256012,NaN,NaN,120.74374695259408,114.92335161378328,0.13002622553229715,0.8545754206945304,0.7245491951622333,823605067,812349174.4,95.39120520774368,91.95344117869736,NaN,NaN,50.14670737539697,35.44492046861256
2017-10-06T09:30:00-04:00,71.84,72.02,71.66,71.94,4445370,7961701.45,81.30892584575665,75.73792382748414,NaN,NaN,115.97902391183604,119.14252203354283,0.11126985353861829,0.8636365120855061,0.7523666585468878,819159697,817229493,95.78642100895364,92.4750201640754,NaN,NaN,52.007078342438916,37.810943022016325
2017-10-09T09:30:00-04:00,71.97,72.11,71.63,71.74,7813987,7952119.8,75.65863142918899,76.34581015926814,NaN,NaN,106.039838789906,118.2025605032403,0.07405805738173021,0.8449392302740506,0.7708811728923204,811345710,817194079.8,95.7222761837087,92.9782332213646,NaN,NaN,52.10950928224813,39.85359534490658
2017-10-10T09:30:00-04:00,72.17,72.19,71.72,71.85,6264262,7885021.45,76.6209249297907,76.73133841027649,NaN,NaN,106.79162722393113,114.33756992834057,0.04684414523472624,0.8294363544357282,0.7825922092010019,817609972,816052833.4,93.54811541744928,93.276495796134,NaN,NaN,52.449660564921174,41.653033233480095
2017-10-11T09:30:00-04:00,71.76,71.85,71.65,71.81,7294426,7973320.45,75.45279836348008,76.92625528776094,NaN,NaN,85.28194619038368,106.9672366137302,0.017643894482293865,0.8046470773038692,0.7870031828215753,810315546,816407198.4,93.59674888710663,93.53773124170807,NaN,NaN,52.429009054733044,43.19245835080194
2017-10-12T09:30:00-04:00,71.7,72.27,71.69,72.19,12112126,8235682.6,78.76490959721474,77.2682861761339,NaN,NaN,99.68502503066311,102.75549222934399,0.015492575368230455,0.8063689020318634,0.790876326663633,822427672,816171719.4,93.09456929776364,93.6909870524785,NaN,NaN,53.326732958650794,44.64021186620892
2017-10-13T09:30:00-04:00,72.49,72.62,71.995,72.06,5759041,8024146.7,75.03489409619502,77.34388738586259,NaN,NaN,106.18600070278306,100.79688758753339,-0.0021745409770439483,0.7881581504423281,0.790332691419372,816668631,815673506.2,91.9702404703792,93.71369215632876,NaN,NaN,53.0341886320918,45.83935140419219
2017-10-16T09:30:00-04:00,72.12,72.19,71.92,72.14,7215685,8077744.35,75.79455919103594,77.47375038807992,NaN,NaN,85.16266961974931,96.62145375350204,-0.015233853383090912,0.7712903746905084,0.7865242280735993,823884316,818181227.4,92.4636193236768,93.73994532876306,NaN,NaN,52.991326646285906,46.861062153062726
2017-10-17T09:30:00-04:00,71.94,72.05,71.8,71.95,5235976,7981543.05,70.3215580238249,77.16648071708737,NaN,NaN,63.41264127668285,87.94565656405238,-0.041916541009638486,0.7341285518115512,0.7760450928211897,818648340,818388901,92.50469211250937,93.73803538848416,NaN,NaN,51.404004275311024,47.510053884812486
2017-10-18T09:30:00-04:00,72,72.19,71.89,71.98,7887734,8042118.75,70.68154019993595,76.9553234351355,NaN,NaN,68.10239367040835,84.50974606005732,-0.061603923403638516,0.6990401885666415,0.76064411197028,826536074,821633006.6,93.1341730628588,93.77197404731979,NaN,NaN,50.17568633380787,47.890858520383254
2017-10-19T09:30:00-04:00,71.69,72.18,71.554,72.18,6962546,8171363.05,73.03015490720338,76.78108323046595,NaN,NaN,57.91933614173405,76.15660828227152,-0.06488532823086701,0.6795374516816963,0.7444227799125633,833498620,823847196.2,93.53335998705894,93.81863460544041,NaN,NaN,49.71686468080722,48.151716543300964
2017-10-20T09:30:00-04:00,72.2,72.96,72.01,72.96,9043395,8446838.15,79.81978020183627,76.83135798097544,NaN,NaN,142.64015249855265,83.44743864142544,-0.020549635690299994,0.7187357352996884,0.7392853709899884,842542015,829021873,94.3588373751026,93.875331564954,NaN,NaN,51.50092281099036,48.630174581542306
2017-10-23T09:30:00-04:00,72.95,72.96,72.48,72.5,6800578,8441012.7,68.8168128889494,75.95852330024624,NaN,NaN,142.32596851746254,94.88009842096808,-0.027779685637709828,0.704560763942851,0.7323404495805609,835741437,831393297.2,94.69316537576535,93.89447381643808,NaN,NaN,49.1375741713365,48.70266023722719
2017-10-24T09:30:00-04:00,72.86,73.2,72.82,72.91,7921908,8637218.8,72.46068508244691,75.38271487140594,NaN,NaN,187.33024506741188,119.66361917911388,-0.01136644977262824,0.7181323873647756,0.7294988371374038,843663345,836396298.2,95.32293736829705,93.93716864845528,NaN,NaN,48.45127896631334,48.666748627096645
2017-10-25T09:30:00-04:00,72.86,72.86,71.835,72.19,11078774,8843972.8,59.345763951260786,73.79370990772283,NaN,NaN,68.5979266457306,119.76272577417834,-0.053082523028198714,0.6631456833521554,0.7162282063803541,832584571,837605997.6,95.46313328608957,93.94230636833711,NaN,NaN,42.69945076342141,47.81427750371447
2017-10-26T09:30:00-04:00,72.43,72.63,72.13,72.29,8323251,8953907.85,60.417333783660354,72.30145333185881,NaN,NaN,70.89860412578219,122.35857937098797,-0.07659462545817941,0.6204849245576298,0.6970795500158092,840907822,839087838,95.63571085523306,93.93154135735709,NaN,NaN,38.77649682860413,46.52316597869871
2017-10-27T09:30:00-04:00,72.19,72.52,72.15,72.32,7534191,9004258.95,60.75156190718367,71.23666265171558,NaN,NaN,57.602114295618215,105.35097173040108,-0.09175695020523578,0.5823833622592645,0.6741403124645002,848442013,840267837.6,95.77357969583466,93.93520589393752,NaN,NaN,35.90033563590289,45.005618786870734
2017-10-30T09:30:00-04:00,72.15,72.205,71.765,71.82,9082134,8620132.05,52.75609194546876,69.53203172426402,NaN,NaN,-43.7417784389252,68.1374223391235,-0.1345051911182269,0.5060088235667166,0.6405140146849435,839359879,840991526,95.85995938635189,94.10033760600199,NaN,NaN,30.60096990904445,42.947811804324125
2017-10-31T09:30:00-04:00,71.89,72.08,71.5,71.53,8793310,8470126.15,48.748696225589235,67.62459585727181,NaN,NaN,-100.14680302488648,10.642012720663843,-0.17859454248937612,0.4172708365732234,0.5958653790625995,830566569,838372170.8,88.78677909147443,93.75676833488538,NaN,NaN,24.893375518345053,40.36860662061283
2017-11-01T09:30:00-04:00,71.75,71.92,71.45,71.49,9104783,8186741.15,48.204786958770626,65.44172995452581,NaN,NaN,-116.41235218726746,-26.360043045935765,-0.20485177021830459,0.33980066628971883,0.5446524365080234,821461786,836147613.8,83.17374632514884,93.04813812255577,NaN,NaN,20.279109003389756,37.49867838958096
2017-11-02T09:30:00-04:00,71.45,71.94,71.28,71.9,6924338,7779890.75,53.88441301349443,63.93098130576148,NaN,NaN,-91.81333712858222,-58.90243129680864,-0.18937087370881595,0.3079388443720035,0.4973097180808194,828386124,833643274.2,77.25271456015494,91.99688627182546,NaN,NaN,18.13663568919459,34.732672289525766
2017-11-03T09:30:00-04:00,71.89,71.97,71.65,71.83,6974984,7906371.45,52.81947803751278,62.28990408050983,NaN,NaN,-64.59312299545637,-83.34147875502356,-0.17874172781003367,0.27388255831827735,0.452624286128311,821411140,828237099.6,66.28301111259972,90.12684282817712,NaN,NaN,16.103755368739858,32.07139844369921
2017-11-06T09:30:00-05:00,71.88,72,71.7724,71.87,7134560,7872400.1,53.38639475431549,61.08024956125916,NaN,NaN,-50.462439305090065,-84.68561092825652,-0.1642834310185084,0.24726999735517552,0.4115534283736839,828545700,826074263.8,62.46169414424345,87.9809144018724,NaN,NaN,14.634798768591903,29.580455632969596
2017-11-07T09:30:00-05:00,71.87,72.09,71.84,71.98,5181067,7818240.35,54.98816640863236,59.95929429045176,NaN,NaN,-30.090736710829674,-70.67439766544517,-0.14334135280176186,0.23237673737148157,0.3757180901732434,833726767,826706303.4,63.13062621524443,85.83780391275707,NaN,NaN,13.869413279532457,27.336021011050004
2017-11-08T09:30:00-05:00,71.88,71.945,71.72,71.86,5622722,7734655.15,52.8544215937699,58.51817048234937,NaN,NaN,-62.12556978403025,-59.81704118479772,-0.13378454308471488,0.20848741131734982,0.3422719544020647,828104045,828034755.2,64.56013112497922,83.76828756546567,NaN,NaN,12.625897538704772,25.23457480071497
2017-11-09T09:30:00-05:00,71.47,71.54,70.67,70.96,10441957,7651146.7,40.2419941507644,55.691185764415664,NaN,NaN,-210.24667422972712,-83.5037086050267,-0.1813376385934813,0.1155999061602131,0.2969375447536944,817662088,825889948,60.48277417246203,81.34856876527705,NaN,NaN,7.117394587801305,22.64640619887016
2017-11-10T09:30:00-05:00,70.81,71.15,70.69,71.06,5344848,7630437.05,41.90092672668608,53.76862246711114,NaN,NaN,-197.29245855744955,-110.04357571742534,-0.19796233547387346,0.04948462541135257,0.24744696088522602,823006936,826209107.2,60.87871585467759,78.9332509423422,NaN,NaN,3.276440693171908,19.879268269484697
2017-11-13T09:30:00-05:00,70.84,71,70.63,70.82,5256847,7532495.15,39.09576274182277,51.38541372849513,NaN,NaN,-189.01507649792424,-137.75410315599217,-0.2155770266869797,-0.022024322473498614,0.19355270421348109,817750089,824049985,56.737129925257065,76.17712183926791,NaN,NaN,-0.8185243181134955,16.92244075697067
2017-11-14T09:30:00-05:00,70.63,70.73,70.41,70.63,7062101,7623801.4,36.98477988260112,49.788200580733736,NaN,NaN,-183.9209644497875,-168.52014870378375,-0.22920660910671722,-0.09295555716991544,0.1362510519368018,810687988,819442229.2,49.06570328059752,72.86301969601848,NaN,NaN,-4.866553251340372,13.809727327211949
2017-11-15T09:30:00-05:00,70.3,70.465,70.04,70.23,10669233,7762876.35,32.95097936471922,47.826318122237936,NaN,NaN,-186.69826410258665,-193.43468756749502,-0.2525032184827116,-0.1793779711665877,0.0731252473161239,800018755,813825171.2,41.66917658085529,69.00826724784865,NaN,NaN,-9.702504068129281,10.450837127877488
2017-11-16T09:30:00-05:00,70.55,70.98,70.4301,70.89,6038903,7716694.2,43.83576445473659,46.61804687563458,NaN,NaN,-106.37465006479839,-172.66028273450928,-0.21241545675636342,-0.19239407362933036,0.02002138312703304,806057658,811504285.2,39.04979853817469,64.95656859373007,NaN,NaN,-10.320252064872136,7.483538671770399
2017-11-17T09:30:00-05:00,70.64,70.75,70.45,70.5,7745062,7651777.55,39.73122246620935,45.68769905568748,NaN,NaN,-111.19286071342427,-155.44036316570424,-0.20122547510933586,-0.23151046075963677,-0.030284985650300925,798312596,806565417.2,34.13266744273473,60.54747631204314,NaN,NaN,-12.243547071832419,4.6653835655414255
2017-11-20T09:30:00-05:00,70.57,70.91,70.51,70.82,6485659,7636031.6,44.336704452470684,45.37255678617901,NaN,NaN,-80.45276286690155,-133.7279004394997,-0.16296548462945282,-0.23399184143711693,-0.07102635680766413,804798255,803975050.4,31.86623745861762,56.481723338267656,NaN,NaN,-12.232994125828375,2.251329609631454
2017-11-21T09:30:00-05:00,71.05,71.34,70.88,71.33,7387930,7609332.7,50.79078030385769,45.557270596542374,NaN,NaN,-26.945655864122593,-102.33283872236672,-0.097247401539596,-0.19258560873215913,-0.09533820719256313,812186185,804274689.8,32.425195505242655,52.856826851131494,NaN,NaN,-9.948740751755507,0.5084624151476027
2017-11-22T09:30:00-05:00,71.38,71.629,71.3,71.41,7037442,7407266.1,51.73612850085339,45.4038217027823,NaN,NaN,8.5159545496433,-63.28999499192072,-0.04498411740536766,-0.1515683539492727,-0.10658423654390504,819223627,808115664.2,39.29960693008769,50.14589059184099,NaN,NaN,-7.863366299150343,-0.6875131154663896
2017-11-24T09:30:00-05:00,71.59,71.6,71.37,71.41,3387498,7160478.45,51.73612850085339,45.326439593020915,NaN,NaN,16.867850176709105,-38.641494943619215,-0.008896653511548253,-0.11770505343334037,-0.10880839992179211,819223627,810748858,43.54010512304364,48.5213973068727,NaN,NaN,-6.231310017628224,-1.4794841014895088
2017-11-27T09:30:00-05:00,71.59,71.62,71.4,71.53,4739301,7020733.95,53.29694287981293,45.320050173413584,NaN,NaN,32.0347844852325,-9.995965903887852,0.022838752075353394,-0.08025995982760037,-0.10309871190295376,823962928,815878924.4,50.75764279205677,47.68539363885937,NaN,NaN,-4.4235586202678885,-1.9000661756007058
2017-11-28T09:30:00-05:00,71.69,72.62,71.61,72.62,10065320,7069893.25,64.52061791903981,46.00093956701412,NaN,NaN,134.0585755824777,32.906301785988,0.11203382919506606,0.036943574590878825,-0.07509025460418724,834028248,821724923,57.43523160158574,47.27857973788375,NaN,NaN,1.3749173149925966,-1.432211391230234
2017-11-29T09:30:00-05:00,72.64,73.3,72.49,73.26,12393505,7249903,69.20084322077338,47.16854111180008,NaN,NaN,201.37382335519865,78.57019762985225,0.20359446544544776,0.17940282720262246,-0.024191638242825296,846421753,828572036.6,63.65236891686228,47.21373958016111,NaN,NaN,8.054562989798821,-0.0769579082260834
2017-11-30T09:30:00-05:00,73.51,74.66,73.3001,74.51,19672720,7778299.85,75.89037704112309,49.714854175397136,NaN,NaN,265.2118509609655,129.90937691211667,0.3303027704404936,0.3886868248077917,0.058384054367298106,866094473,837946205.8,70.09293349959769,47.900179532099344,NaN,NaN,16.910293960113602,2.349792358679586
2017-12-01T09:30:00-05:00,74.38,74.49,72.76,73.59,29693745,8916770.2,64.74432136733179,51.34652522115754,NaN,NaN,172.26867661787875,160.98954220035063,0.33316153724627806,0.4748359759251457,0.14167443867886764,836400728,841381626,72.04770946223069,48.697964789781715,NaN,NaN,19.549323343240065,4.806868213616797
2017-12-04T09:30:00-05:00,74.36,75.1,74.21,74.21,19276385,9531840.25,68.14029841739945,53.421134912270155,NaN,NaN,196.46410764131937,193.875406831568,0.35576381134362256,0.5863792028583958,0.23061539151477328,855677113,847724463,75.26259609614759,50.021212373416745,NaN,NaN,22.94723340574717,7.398348955349707
2017-12-05T09:30:00-05:00,74.34,74.55,73.52,73.58,16523904,10001307.45,61.642727100024935,55.18241685637186,NaN,NaN,128.81198866628847,192.82608944833015,0.30897314729760517,0.6168318256367797,0.3078586783391746,839153209,848749455.2,75.7480156136477,51.927091825777474,NaN,NaN,23.069523554500307,9.637088183799793
2017-12-06T09:30:00-05:00,73.44,73.96,73.361,73.69,15569280,10520718.1,62.31836435506281,57.280087212824974,NaN,NaN,99.80716748104845,172.51275827350008,0.2676620368386679,0.6424362243875095,0.37477418754884156,854722489,850409602.4,76.55062655766562,54.41862396697822,NaN,NaN,23.400754639859272,11.603326248951147
2017-12-07T09:30:00-05:00,73.6,74.53,73.58,74.37,10918707,10785517.35,66.27330982894148,58.88276902526816,NaN,NaN,108.8496633240371,141.24032074611443,0.26771701353680666,0.7094204544698499,0.44170344093304326,865641196,850318947,76.40193239999441,57.086633528536765,NaN,NaN,25.089633653491116,13.529941592456856
2017-12-08T09:30:00-05:00,74.75,74.75,74.38,74.69,6804481,10603643.55,67.97665698845739,60.900300062571596,NaN,NaN,114.07190502527749,129.6009664275942,0.2701120300995712,0.7793434785575073,0.5092314484579361,872445677,857527936.8,79.76751197437362,60.34626528079668,NaN,NaN,27.002910023953902,15.454651368385004
2017-12-11T09:30:00-05:00,74.75,74.83,74.41,74.54,5911620,10631982.15,66.28667662911445,62.46815521804616,NaN,NaN,99.96710005608283,110.30156491054686,0.24323824564062535,0.8132792555087178,0.5700410098680925,866534057,859699325.6,80.66213448892888,63.83168649724748,NaN,NaN,27.956098853681905,17.240572437713134
2017-12-12T09:30:00-05:00,74.67,74.825,74.55,74.62,9259710,10832125.3,66.76130018990192,63.60890663847789,NaN,NaN,92.28901059104197,102.99696929549756,0.213551785434549,0.8369807416612787,0.6234289562267297,875793767,867027437.2,83.33955344541735,67.4684263501171,NaN,NaN,28.85663920116957,18.90001054677834
2017-12-13T09:30:00-05:00,74.81,75.31,74.495,74.91,8626629,10910351.7,68.49290500062337,64.80581924560433,NaN,NaN,93.688975988438,101.77333099697549,0.19657358954491622,0.869145943157875,0.6725723536129588,884420396,872967018.6,85.1359174877116,70.74244853280452,NaN,NaN,30.126345116079793,20.503772628107118
2017-12-14T09:30:00-05:00,75.23,75.23,74.39,74.4,9214301,10837605.1,62.34195708121125,65.5633784299156,NaN,NaN,77.55963142124128,95.51532461641632,0.13694855058508137,0.8437580418443105,0.7068094912592291,875206095,874879998.4,85.67176312256781,73.75185267562767,NaN,NaN,29.350496881692155,21.767590378619268
2017-12-15T09:30:00-05:00,74.44,74.71,74.0301,74.52,8934953,10982407.6,63.17982972162477,66.26929891861644,NaN,NaN,60.471844413706954,84.7953124941022,0.09361193441995364,0.8238244092841711,0.7302124748642175,884141048,877219072.6,86.32110141890213,76.29209972040235,NaN,NaN,28.96151850558316,22.795294396756965
2017-12-18T09:30:00-05:00,74.91,75.1367,74.85,75.05,6017304,10896019.7,66.7035212152808,66.42522058263366,NaN,NaN,85.77778865278712,81.95745021344307,0.08870824476405204,0.8410977808192825,0.7523895360552305,890158352,881943931.6,87.54861283346064,78.44305552267913,NaN,NaN,29.673300989343243,23.777866767126433
2017-12-19T09:30:00-05:00,75.28,75.415,74.87,75.07,6211569,10882315.2,66.83251341740477,66.25605416810733,NaN,NaN,89.38587411038532,81.37682291731173,0.07540143580868264,0.8466413308160838,0.7712398950074012,896369921,886059162.4,88.5152961808328,80.21897889867702,NaN,NaN,30.284011090595136,24.70731595619339
2017-12-20T09:30:00-05:00,75.49,75.58,75.205,75.32,5778942,10801865.8,68.47648563511925,65.72649049624991,NaN,NaN,101.27591373262479,82.89421046614909,0.07203148693949679,0.8612792536817722,0.7892477667422754,902148863,889604855.8,89.2870308638211,81.5899858532644,NaN,NaN,31.267004430203126,25.644414309623354
2017-12-21T09:30:00-05:00,75.6,75.67,75.1935,75.38,9456432,10922815.3,68.87522041731222,66.02155471410565,NaN,NaN,101.79790838703664,87.74186585930818,0.06277689729709202,0.8677188883636404,0.8049419910665484,911605295,896884695.8,90.67283878956195,82.92035223378807,NaN,NaN,32.19030631008207,26.579541738260314
2017-12-22T09:30:00-05:00,75.54,75.54,75.2,75.4,3730530,10939966.9,69.01590668674595,66.08409816191612,NaN,NaN,98.18151535471291,95.28380004750936,0.047623281903913184,0.8644710934464399,0.8168478115425267,915335825,903123651.2,91.66763925841411,84.09214103109282,NaN,NaN,32.99692247451411,27.496310414868
2017-12-26T09:30:00-05:00,75.49,75.73,75.32,75.48,4983944,10952199.05,69.60767810312925,66.65302323356643,NaN,NaN,111.00207482466848,100.32865728188564,0.033287165748723035,0.8584567687284306,0.8251696029797075,920319769,909155934.6,92.5005016489861,85.28874717647412,NaN,NaN,33.83584801349407,28.40195864324315
2017-12-27T09:30:00-05:00,75.54,75.69,75.445,75.66,4730298,10685447.95,70.95198626357595,67.26971051274595,NaN,NaN,119.16580948346551,106.28464435650167,0.02652086337421211,0.8583206821974727,0.8317998188232606,925050067,914891963.8,93.19685433798475,86.47776344649692,NaN,NaN,34.9137940224651,29.332220840274857
2017-12-28T09:30:00-05:00,75.87,75.88,75.525,75.81,4629635,10297254.45,72.06103026990885,67.68311911567217,NaN,NaN,124.40796288477405,110.91105418693152,0.02287889805025667,0.8603984413860815,0.8375195433358248,929679702,920398131.6,93.79268594069089,87.71996012797524,NaN,NaN,36.136466796225555,30.304255976839244
2017-12-29T09:30:00-05:00,75.97,76,75.6,75.67,4825920,9554914.45,69.39785443519871,67.78463321901084,NaN,NaN,112.26201541468204,113.0038755924606,0.0028268563577440453,0.8410531137830048,0.8382262574252608,924853782,923047829,94.06219372258155,88.7410088242758,NaN,NaN,36.53424740960328,31.194254752948392
2018-01-02T09:30:00-05:00,75.92,76.13,75.57,76.12,14903889,8815421.65,72.86872727390384,68.25477969363865,NaN,NaN,123.24935702896569,118.01744392731116,0.011186436548349499,0.8522093031106976,0.8410228665623481,939757671,927932198.2,94.53337074124858,89.7318114137272,NaN,NaN,37.838454400535696,32.14342613117515
2018-01-03T09:30:00-05:00,76.24,76.58,76.06,76.53,18155013,8759353.05,75.58571041770166,68.88509470991006,NaN,NaN,154.81400134381556,126.77982923114057,0.03433744519919035,0.8839446730613361,0.8496072278621457,957912684,935450781.2,95.16887510656154,90.5767629609518,NaN,NaN,39.79027090639911,33.235832527635715
2018-01-04T09:30:00-05:00,76.86,77.15,76.72,77.09,16482955,8757305.6,78.72023989567488,69.61561863098517,NaN,NaN,194.83644544268483,141.91395642298443,0.07504020811190215,0.9434074880020233,0.8683672798901212,974395639,945319895.6,95.85073744233125,91.34210724342462,NaN,NaN,42.533009941549324,34.56400072962337
2018-01-05T09:30:00-05:00,77.46,77.66,77.03,77.62,16996216,8828652.4,81.18264433983322,70.96138200660103,NaN,NaN,216.6250359745573,160.3573710409411,0.1225248027440683,1.0215232833202066,0.8989984805761383,991391855,957662326.2,96.51348376005721,92.11651586038816,NaN,NaN,45.75292822839936,36.16241894373423
2018-01-08T09:30:00-05:00,77.7,77.99,77.595,77.94,5727464,8569090.25,82.49939773114306,72.34135115013804,NaN,NaN,212.12970702448837,180.33090936290236,0.15808992898549934,1.0966108918080124,0.9385209628225131,997119319,972115433.6,97.09802515238611,92.88629612706559,NaN,NaN,48.87744832688001,37.97885171275506
2018-01-09T09:30:00-05:00,78.04,78.64,78.01,78.44,8967679,8677250.15,84.34296915846998,73.6013117175087,NaN,NaN,206.32816071274942,196.94667009965912,0.19544664123264588,1.1828292643633205,0.9873826231306746,1006086998,985381299,97.51057926414259,93.59786515782858,NaN,NaN,52.19024115135724,40.00905020398394
2018-01-10T09:30:00-05:00,78.29,78.685,78.06,78.43,11669537,8965146,84.15203384017641,74.83842031913524,NaN,NaN,167.48274303447482,199.48041843779097,0.1989755133171882,1.2361020147771598,1.0371265014599715,994417461,992682254.4,97.7040348852856,94.25420363671807,NaN,NaN,54.74525245859445,42.11422195464258
2018-01-11T09:30:00-05:00,78.78,79.46,78.58,79.43,9448279,8974574.45,87.25836197625559,76.1799829149307,NaN,NaN,175.0214278176118,195.51741491277636,0.2451190962484997,1.3435253717705962,1.0984062755220965,1003865740,998576274.6,97.84933702726637,94.86579693410702,NaN,NaN,58.250899302362704,44.41946157574546
2018-01-12T09:30:00-05:00,79.79,80.245,79.65,80.17,7436215,8915053.75,88.97975983203175,77.61602144455352,NaN,NaN,181.37132447655844,188.46667261317657,0.29840256289306666,1.4714094791384298,1.1730069162453631,1011301955,1002558294.6,97.94400546033475,95.38516598201936,NaN,NaN,61.897061472240466,46.91626156095903
2018-01-16T09:30:00-05:00,80.47,80.5954,79.09,79.45,13343749,9121526.15,77.94573824289483,78.253866555707,NaN,NaN,139.61376021233795,173.9634832507465,0.25951405398306515,1.4973994837241946,1.2378854297411295,997958206,1002726072,97.94810375267483,95.83377058875227,NaN,NaN,60.936903418955545,48.919210397815675
2018-01-17T09:30:00-05:00,79.59,79.9662,79.34,79.89,7814286,9065492.8,79.60979826174908,78.96830370989413,NaN,NaN,122.7019941681072,157.23824994181805,0.23832954136580375,1.5357973564483842,1.2974678150825805,1005772492,1002663170.8,97.86933793568585,96.2172588949451,NaN,NaN,60.74930903115256,50.60922448829238
2018-01-18T09:30:00-05:00,79.89,80.115,79.39,79.46,7790367,9154145.95,73.75304560840236,79.16837937738173,NaN,NaN,105.08042827410664,144.7577869897444,0.17328750904331658,1.5140772013867263,1.3407896923434097,997982125,1003376103.6,97.89004834122606,96.55248703803377,NaN,NaN,58.54876137221624,51.743444043138645
2018-01-19T09:30:00-05:00,79.78,79.79,79.33,79.69,8657709,9276452.95,74.82010440040682,79.36545610098872,NaN,NaN,92.29979269008076,128.2134599642382,0.12589074467624384,1.4981531231887146,1.3722623785124708,1006639834,1003930922.4,97.90709778532973,96.84637359836513,NaN,NaN,57.15543098879559,52.51658503537535
2018-01-22T09:30:00-05:00,79.47,79.71,79.1,79.69,12175309,9596271.3,74.82010440040682,79.75275966993216,NaN,NaN,79.33051314035816,107.80529769699815,0.0770733159752719,1.4686040234815607,1.3915307075062888,1006639834,1002998498.2,96.49588160347804,97.02020844700057,NaN,NaN,56.07040817463109,53.024274055269025
2018-01-23T09:30:00-05:00,79.68,79.81,79.35,79.73,8953776,9571138.5,75.02489886296213,79.90677192629346,NaN,NaN,77.38072116734044,95.35868988799864,0.03230157354742191,1.4319076744405663,1.3996061008931444,1015593610,1006525579,96.69022272127317,97.17426930271662,NaN,NaN,55.256742401280945,53.3431981046993
2018-01-24T09:30:00-05:00,79.71,80.075,79.17,79.66,9660029,9867613.45,73.89227410888165,79.78581218994918,NaN,NaN,70.9990481450155,85.0181006833803,-0.014680967222551189,1.3812548918649554,1.3959358590875066,1005933581,1006557796.8,96.69202745434548,97.2830658989869,NaN,NaN,54.26928119326089,53.475495688779525
2018-01-25T09:30:00-05:00,79.86,79.98,79.07,79.74,12499163,10243374.4,74.36851968001444,79.47497503168772,NaN,NaN,64.02563675993123,76.8071423805452,-0.05098018067433685,1.3322106332445856,1.3831908139189224,1018432744,1010647920.6,96.92152354831771,97.35955062084307,NaN,NaN,53.57006721547917,53.48900590687948
2018-01-26T09:30:00-05:00,79.98,80.66,79.71,80.66,8008280,10407273.5,79.09195395984761,79.3256400045459,NaN,NaN,93.13346711042028,76.97387726461311,-0.02495739503196437,1.351994070128967,1.3769514651609314,1026441024,1014608158.6,97.12919937613678,97.4035303077059,NaN,NaN,54.3184894824131,53.607503560527135
2018-01-29T09:30:00-05:00,80.52,80.96,80.09,80.12,12866344,10819108.95,70.84005854152468,78.49283006243029,NaN,NaN,89.72597198833955,79.05296903420938,-0.05435345138127112,1.3090096509343425,1.3633631023156136,1013574680,1015995127.8,97.20043078548974,97.41084499578474,NaN,NaN,52.35809406831879,53.42901649021166
2018-01-30T09:30:00-05:00,79.59,79.865,79.12,79.49,16742441,11414935,62.6301831571634,76.94191677662268,NaN,NaN,36.79377566619767,70.93557993398083,-0.12256368163438958,1.2101585002726267,1.3327221819070163,996832239,1012242853.6,90.64748326690714,96.92062385312506,NaN,NaN,47.934599317518945,52.64409975125556
2018-01-31T09:30:00-05:00,80.22,80.52,79.47,79.73,15991881,11469334.6,64.32632020055391,75.52579437379252,NaN,NaN,59.723031949269604,68.68037669483166,-0.15572547620906807,1.1380653366456812,1.2937908128547493,1012824120,1013620961.4,90.89039111044384,96.43393501206494,NaN,NaN,44.87442559097325,51.534146299786656
2018-02-01T09:30:00-05:00,79.22,80.27,79.11,79.59,14169294,11270048.65,62.543036620505234,73.76041399123892,NaN,NaN,36.71416657732935,63.218082658311275,-0.18907697662308243,1.0574445920758961,1.2465215686989786,998654826,1009665377.8,84.13570110205588,95.45438958883561,NaN,NaN,41.852789246025615,50.151095292106504
2018-02-02T09:30:00-05:00,79.11,79.2435,77.975,77.99,17929518,11342376.8,46.63216663114342,70.73558590546118,NaN,NaN,-96.68358232419348,25.254672771388524,-0.3135418847172542,0.8545942128024109,1.168136097519665,980725308,1000522234.6,71.00096530727238,93.52988672075973,NaN,NaN,32.94490572486048,47.693068211071356
2018-02-05T09:30:00-05:00,77.17,78.175,73.95,74.45,30309055,12008018.75,29.03343553693084,67.24184999789232,NaN,NaN,-321.19594454612576,-56.92971053550455,-0.6116818978625143,0.4035337251915223,1.0152156230540366,950416253,987890549.2,57.61806719828434,90.64916982401756,NaN,NaN,14.643425785543036,42.97169072171017
2018-02-06T09:30:00-05:00,73.05,76.0299,72.64,75.81,31980611,13320676.1,38.61770877054624,64.31384360566355,NaN,NaN,-286.92908849931655,-121.67428336860739,-0.6889484105834784,0.15403010982468857,0.842978520408167,982396864,985003474.2,55.06342215217399,87.59160441090957,NaN,NaN,5.689286377861137,37.64563295830317
2018-02-07T09:30:00-05:00,75.75,77.15,75.49,75.95,22666820,14005633.15,39.523166662698046,61.86885225239896,NaN,NaN,-160.68819996754863,-165.75652975197104,-0.70001255106547,-0.03203716842367044,0.6679753826417996,1005063684,983451387,53.68535480495265,84.43412630117577,NaN,NaN,0.003851101640988062,32.26823555020857
2018-02-08T09:30:00-05:00,76.04,76.16,72.985,73.02,27282131,14786262.85,29.661632544758575,58.64324711985266,NaN,NaN,-212.24260472235392,-215.54788401190768,-0.8633270843728498,-0.4111834728242627,0.45214361154858707,977781553,979276732.4,50.056599360223245,81.01623355652531,NaN,NaN,-9.610195887120444,26.285602487733
2018-02-09T09:30:00-05:00,73.87,74.43,71.49,73.81,40362454,16331971.6,34.41336777303384,55.75705164646888,NaN,NaN,-187.97652231714682,-233.80647201049834,-0.8741385901623586,-0.6405296261543612,0.2336089640079974,1018144007,986760472.2,55.821544926143716,78.11092379385856,NaN,NaN,-14.397891538869887,20.473674769646877
2018-02-12T09:30:00-05:00,74.41,75.54,73.91,75,20776899,16999005.8,40.89102456858448,53.31891776829904,NaN,NaN,-109.82894732566096,-191.5330725664054,-0.7612779915855172,-0.7179885254738991,0.043289466111618075,1038920906,1004461402.8,65.85956848073567,75.90873420524873,NaN,NaN,-15.34192007016339,15.357161221102555
2018-02-13T09:30:00-05:00,74.58,75.375,74.49,75.17,12974634,16980550.05,41.775719174434144,51.02487813012421,NaN,NaN,-89.16268014789762,-151.9797908961216,-0.6401773635498456,-0.7569322383256889,-0.11675487477584334,1051895540,1018361138,71.36222143650008,74.09946234683123,NaN,NaN,-15.688845160613822,10.92201745228593
2018-02-14T09:30:00-05:00,74.8,76.21,74.72,76.12,13482821,17263976.8,46.58685344955652,49.04047339937721,NaN,NaN,-60.918447297945335,-132.02584036220094,-0.4690234682323249,-0.7030342100662494,-0.23401074183392456,1065378361,1030424073.4,75.11138963689152,72.54159563887221,NaN,NaN,-14.198870298904767,7.333319202115831
2018-02-15T09:30:00-05:00,76.72,77.27,76.07,77.27,10800393,17414478.1,51.78106763184975,47.089695804520225,NaN,NaN,-22.353488688028616,-94.04801715533588,-0.26163679256509553,-0.561056732540294,-0.29941993997519845,1076178754,1050103513.6,79.76546357816338,71.30132879615981,NaN,NaN,-11.090175953914539,4.701391322682921
2018-02-16T09:30:00-05:00,77.09,78.07,77.03,77.29,11161691,17539677.2,51.86873053433797,45.73460094686404,NaN,NaN,-1.5208782457513867,-56.7568883410568,-0.11392930128900786,-0.4418315665864583,-0.3279022652974504,1087340445,1063942801.2,82.2755621554593,70.23526675115764,NaN,NaN,-8.720904633065981,2.7839204718616495
2018-02-20T09:30:00-05:00,76.93,77.28,76.24,76.51,11838869,17522855.2,48.18916181323431,44.703099422297676,NaN,NaN,-22.250099332234175,-39.24111874237143,-0.06216510051006252,-0.4056086409350286,-0.34344354042496605,1075501576,1071258935.2,83.44475394864214,69.7207860855673,NaN,NaN,-7.960118506161525,1.249057760715482
2018-02-21T09:30:00-05:00,76.59,77.925,76.51,76.53,8650501,17507691.45,48.29045543240341,43.55768051028692,NaN,NaN,-8.4666779943083,-23.101918311653566,-0.02205404253253801,-0.37101109359063855,-0.34895705105810054,1084152077,1077710242.6,84.42067078719063,69.25866320533491,NaN,NaN,-7.334240259654109,0.022872329234111977
2018-02-22T09:30:00-05:00,76.87,77.74,76.8,77.04,10545190,17551949.5,50.92523658785,42.72783765081156,NaN,NaN,2.7708169052783456,-10.364065471008818,0.03997128425106111,-0.29899294574427415,-0.33896422999533526,1094697267,1083574023.8,85.27058922269246,69.33972664252325,NaN,NaN,-6.02102475269181,-0.8405415396124482
2018-02-23T09:30:00-05:00,77.4,77.72,76.97,77.68,6603270,17257154.85,54.08682712665642,43.26031340049105,NaN,NaN,17.30134379625856,-2.4330989741513913,0.12068577370450395,-0.18810701286470533,-0.3087927865692093,1101300537,1088598380.4,85.97653479451877,70.40941017732656,NaN,NaN,-3.958022478579036,-1.2858959594648178
2018-02-26T09:30:00-05:00,78.05,78.88,77.7728,78.75,8623340,17287907.85,58.858946552890096,45.39070704448814,NaN,NaN,63.62739107314162,10.596554889627203,0.23604960948973358,-0.013730774707042315,-0.2497803841967759,1109923877,1093115066.8,86.59835950137779,72.47943105611895,NaN,NaN,-0.6589882515826254,-1.1963377154816475
2018-02-27T09:30:00-05:00,78.78,79.275,77.75,77.76,11019325,17195556.9,53.335311998143624,46.44196441788796,NaN,NaN,63.46532437696158,27.739639631466353,0.23508102911243384,0.044070902193766415,-0.19101012691866742,1098904552,1097795662,87.23027638421068,74.77706350126445,NaN,NaN,0.47065993319297605,-0.9581951942424155
2018-02-28T09:30:00-05:00,78.16,78.265,76.65,76.65,16203886,17168629.15,47.90678561823876,47.04079434328372,NaN,NaN,23.15809844848995,34.064594920026,0.15305440172629506,0.0003078752392013939,-0.15274652648709366,1082700666,1097505379.8,86.95642956530087,77.15356884128933,NaN,NaN,-0.2913708278301321,-0.8629345704692322
2018-03-01T09:30:00-05:00,76.68,77.235,74.75,75.15,35549373,18146503.75,41.726208866408754,47.902549794830165,NaN,NaN,-38.7725602860769,25.755919481754955,-0.0007155986496505673,-0.15364102479915687,-0.1529254261495063,1047151293,1087996185,78.28614446302734,79.16996492006103,NaN,NaN,-3.040442103599977,-1.1740070752021958
2018-03-02T09:30:00-05:00,74.5,75.35,73.98,75.13,27076367,18791857.4,41.6490544948089,48.41938456067124,NaN,NaN,-75.6515020211896,7.165350318265323,-0.09694030435869244,-0.27410080659787184,-0.1771605022391794,1020074926,1071751062.8,66.15130542878015,79.90780495596366,NaN,NaN,-5.195664063826589,-1.7485295021485376
2018-03-05T09:30:00-05:00,74.66,76.22,74.38,76.03,23038366,19047299.8,46.44778384096224,48.81629593726965,NaN,NaN,-31.54689121288151,-11.869506138939304,-0.09311927885620111,-0.2935596008094308,-0.20044032195322967,1043113292,1058388945.8,58.164969229802054,79.3581907237541,NaN,NaN,-5.528888977056973,-2.2885808557068854
2018-03-06T09:30:00-05:00,76.43,76.57,75.79,76.37,18536277,18458660.9,48.181524294950435,49.27385344587795,NaN,NaN,6.2231757481721255,-23.317935864697194,-0.062317485774287584,-0.27833717917108913,-0.21601969339680155,1061649569,1050937949.2,54.23311424385419,78.13468306713654,NaN,NaN,-5.276324404520957,-2.715401362680324
2018-03-07T09:30:00-05:00,75.43,76.53,75.2411,76.36,13625412,17540900.95,48.13216740121564,49.384233013853596,NaN,NaN,-9.409848884302722,-29.831525331255722,-0.038413499349395114,-0.26403656758354543,-0.22562306823415032,1048024157,1044002647.4,50.79149613707945,76.39754781714997,NaN,NaN,-5.087275351031142,-3.054240503873298
2018-03-08T09:30:00-05:00,76.68,76.83,76.02,76.76,10849065,16950013.2,50.324247472385636,49.28017443103473,NaN,NaN,19.580923311153775,-18.160828611809585,0.006166783328257597,-0.21791458907382832,-0.22408137240208592,1058873222,1046347033.2,51.90263370366167,74.40734568325699,NaN,NaN,-4.312314408660881,-3.2339653474143812
2018-03-09T09:30:00-05:00,77.27,78.45,77.0346,78.45,13092642,16240538.75,58.336048683297335,49.742125727388974,NaN,NaN,98.89705949971669,16.74888369237167,0.1436803268254862,-0.04448096387022815,-0.18816129069571436,1071965864,1056725220.8,56.57701817887423,72.5717353992152,NaN,NaN,-1.0902751026004556,-2.9277238838695347
2018-03-12T09:30:00-04:00,78.58,78.58,77.26,77.48,11093605,14777096.3,53.047678964251276,50.08916266674733,NaN,NaN,81.35110341522844,39.32848261799366,0.16215148832414789,0.014528069709470515,-0.14762341861467737,1060872259,1060277014.2,58.07860258093172,70.75986744437874,NaN,NaN,0.034151649060750466,-2.504598807736637
2018-03-13T09:30:00-04:00,77.7,78.1,76.95,77.1,11518752,14314188.95,51.0935751233739,50.289385501816646,NaN,NaN,47.88643445619135,47.66113435959751,0.14232374782302978,0.030281266164109866,-0.11204248165891992,1049353507,1057817801.8,56.61870278502995,68.77401258708156,NaN,NaN,0.36211060963639496,-2.0950688909690607
2018-03-14T09:30:00-04:00,77.54,77.54,76.04,76.26,11627074,14246810.95,46.974290037302374,50.00717503392038,NaN,NaN,-19.96014008099967,45.55107612025812,0.06984989047579286,-0.024730118564178838,-0.0945800090399717,1037726433,1055758257,55.36356663906399,66.63779668825096,NaN,NaN,-0.6178985951900577,-1.8840445630006317
2018-03-15T09:30:00-04:00,76.5,76.92,75.991,76.48,8362982,13990819,48.1532662353204,49.58334925596781,NaN,NaN,-38.287318536008996,33.97742775082556,0.03566518799084312,-0.0499985240514178,-0.08566371204226092,1046089415,1053201495.6,53.76998442597597,64.33732880478361,NaN,NaN,-1.0712354571939884,-1.7679289764568256
2018-03-16T09:30:00-04:00,76.09,76.85,76.09,76.58,10839980,13992798.35,48.71148022081973,48.8585302322485,NaN,NaN,-31.920797831004183,7.813856284681387,0.019531996745296668,-0.06124871611064009,-0.08078071285593676,1056929395,1050194201.8,51.87847732882351,61.85733722102974,NaN,NaN,-1.286280574623995,-1.6991220619092784
2018-03-19T09:30:00-04:00,76.36,76.39,75.3701,75.99,10845665,13976997.05,45.59252156177764,48.30547377250808,NaN,NaN,-76.50015198338392,-23.756394795041082,-0.028519833833038924,-0.11643050514723541,-0.08791067131419648,1046083730,1047236496,50.014966817002495,59.19910082337201,NaN,NaN,-2.3518895232558723,-1.7923745563873632
2018-03-20T09:30:00-04:00,76.14,76.7,76.09,76.25,7111751,13740641.15,47.19703235437373,48.25477711080343,NaN,NaN,-36.59953824461376,-40.653589335202106,-0.03974867610226741,-0.13759651644203075,-0.09784784033976333,1053195481,1048004890.8,50.51230973512448,56.59594940693084,NaN,NaN,-2.8094853811841793,-1.9376761027869083
2018-03-21T09:30:00-04:00,76.26,77.125,76.02,76.34,13818748,13999053.5,47.771212057385156,48.68656305301603,NaN,NaN,-21.76085496964017,-41.01373231293021,-0.03806735578848795,-0.14543203507537328,-0.10736467928688533,1067014229,1053862450,54.24936907355287,54.87903687911123,NaN,NaN,-3.040064256415831,-2.0951601247338973
2018-03-22T09:30:00-04:00,75.58,75.84,73.72,73.82,18793875,14411487.75,35.97519532173263,48.28128739779629,NaN,NaN,-174.0193896746324,-68.16014654065489,-0.1948596726282088,-0.3509392700721463,-0.1560795974439375,1048220354,1054288637.8,54.518483362634896,54.04812101724371,NaN,NaN,-7.092899903428887,-2.809122950261753
2018-03-23T09:30:00-04:00,73.93,74.5,72.68,72.74,15457050,14854176.75,32.29468476780886,47.2703517497139,NaN,NaN,-223.52421124467932,-106.4808292233899,-0.35041932224803285,-0.5941037502539785,-0.24368442800594572,1032763304,1049455419.6,50.864437542634626,53.52665446816032,NaN,NaN,-11.796115989121555,-4.0929790986702965
2018-03-26T09:30:00-04:00,73.95,74.6,73.1299,74.5,12196957,15032857.6,42.600585701633904,46.871713278762726,NaN,NaN,-146.47633932617592,-120.47606669194832,-0.3150108242918375,-0.6374479583707426,-0.3224371340789051,1044960261,1049230725.8,50.69432788800969,53.27388401417143,NaN,NaN,-12.379317193281242,-5.276741683614717
2018-03-27T09:30:00-04:00,74.85,75.249,73.04,73.47,14726013,15218192,38.87148922980402,46.21023626651903,NaN,NaN,-136.77219895920933,-140.5105988348674,-0.3390966717380295,-0.746307973751442,-0.4072113020134125,1030234248,1044638479.2,47.21859366488342,53.01867669472886,NaN,NaN,-14.156401214677672,-6.545264473766568
2018-03-28T09:30:00-04:00,73.72,73.81,72.64,73.22,21892349,15502615.15,38.00196523255181,45.33007324938804,NaN,NaN,-153.0666215945091,-166.7717521598412,-0.3486591546774628,-0.843035245360241,-0.4943760906827782,1008341899,1032904013.2,39.72378389506086,52.14875885125737,NaN,NaN,-15.82545464142916,-7.871005926289795
2018-03-29T09:30:00-04:00,73.61,74.85,73.5,74.29,14057057,14427999.35,43.796785864775835,44.29155447663651,NaN,NaN,-82.33395591000698,-148.4346654069161,-0.2635834119721262,-0.823855355647936,-0.5602719436758098,1022398956,1027739733.6,36.94452649498749,50.746438016694036,NaN,NaN,-15.32098509825586,-8.93528866514209
2018-04-02T09:30:00-04:00,74.07,74.2,71.78,72.76,27498816,14449121.8,38.28621219300573,43.23716399297611,NaN,NaN,-136.34098183703173,-130.9980195253866,-0.2889752399059644,-0.9214909935582654,-0.632515753652301,994900140,1020167100.8,33.26884617330052,48.974312559006094,NaN,NaN,-16.767102791227913,-10.054119254582922
2018-04-03T09:30:00-04:00,73.13,73.82,72.63,73.77,20149088,14304657.9,43.353143472188926,42.68427601789148,NaN,NaN,-96.4407947368022,-120.99091060751186,-0.21951942030335536,-0.9069150290314951,-0.6873956087281398,1015049228,1014184894.2,30.672646611288073,47.121022832310246,NaN,NaN,-16.230594187074036,-10.936472816367367
2018-04-04T09:30:00-04:00,72.19,74.17,72.01,74.09,19987579,14377223,44.89680776444021,42.53588442697275,NaN,NaN,-84.46376918968588,-110.52922465360719,-0.1377897804341719,-0.8596328342708546,-0.7218430538366827,1035036807,1015145406,31.595664130966142,45.423315510303254,NaN,NaN,-15.308194153425358,-11.56100443594708
2018-04-05T09:30:00-04:00,74.5,75.02,74.28,74.84,16496058,14520755.3,48.44298759274634,42.556578809646034,NaN,NaN,-25.04221943565784,-84.92434422183693,-0.024895904355864085,-0.7529629342815127,-0.7280670299256486,1051532865,1023783599.2,39.40871063868746,44.39751023978265,NaN,NaN,-13.411203588895756,-11.825318600654034
2018-04-06T09:30:00-04:00,74.1,74.55,72.11,72.77,18353352,14895969.65,40.66452954628688,41.981796618607966,NaN,NaN,-85.01314497641678,-85.46018203511889,-0.0782960414694388,-0.8259370817624472,-0.7476410402930084,1033179513,1025939710.6,41.213583972954844,43.635732142934884,NaN,NaN,-14.342267613605545,-12.184882745361392
2018-04-09T09:30:00-04:00,73.18,73.72,72.43,72.55,10279198,14755297.45,39.930681179459135,41.57737944844236,NaN,NaN,-89.37535673760347,-76.06705701523325,-0.1148855903953826,-0.8912480282872366,-0.776362437891854,1022900315,1031539745.6,45.734866431141135,43.330010686801934,NaN,NaN,-15.305011544295091,-12.63061543092335
2018-04-10T09:30:00-04:00,73.64,74.0878,73.14,73.66,18495350,15125384.7,45.29486503773167,41.4415103543965,NaN,NaN,-51.622767793721174,-67.10345162661703,-0.05388116332752102,-0.8437138920512552,-0.7898327287237342,1041395665,1036809033,49.65823344125605,43.26900523723991,NaN,NaN,-14.379447581295784,-12.88044859526227
2018-04-11T09:30:00-04:00,73,73.7,72.99,73.12,10633910,15081142.6,43.27045770678754,41.120027900782375,NaN,NaN,-65.72562324722784,-63.35582243812543,-0.040081014917066726,-0.8399339973700677,-0.799852982453001,1030761755,1035954022.6,49.038676827987665,42.896812933985245,NaN,NaN,-14.259665293187219,-13.07747955210869
2018-04-12T09:30:00-04:00,73.61,74.465,73.56,74.17,8921533,14945865.55,48.125398392741474,41.98789954871159,NaN,NaN,-15.917424181575885,-61.53086338730903,0.04497041775708566,-0.7436399602566439,-0.7886103780137296,1039683288,1033584107.2,47.27794016632553,42.37963127710601,NaN,NaN,-12.615632756290957,-13.011501438420442
2018-04-13T09:30:00-04:00,74.67,74.709,73.63,73.99,9904130,15022922.95,47.37686893945985,43.06519841811523,NaN,NaN,-6.658110397052358,-45.859856471436146,0.0916240152249661,-0.6740803589825219,-0.765704374207488,1029779158,1032904036.2,46.75910671912122,42.08639336114077,NaN,NaN,-11.522260027127182,-12.798752665378547
2018-04-16T09:30:00-04:00,74.53,74.96,74.4101,74.73,8232689,14892558.4,50.76713340295357,43.64852325392378,NaN,NaN,48.647807392917606,-18.255223645331927,0.17026835585248856,-0.5528689293918774,-0.7231372852443659,1038011847,1035926342.6,49.41586861671581,41.99507484176263,NaN,NaN,-9.575202514752124,-12.338245501003344
2018-04-17T09:30:00-04:00,75.31,75.67,75.1,75.36,8676816,14784115.95,53.51301487633071,44.69434651438997,NaN,NaN,111.31922504649043,14.33317492271039,0.2574331891947875,-0.4013457987508815,-0.658778987945669,1046688663,1036984942.2,50.35041495862891,42.21877636274445,NaN,NaN,-7.11346296113106,-11.591847995307305
2018-04-18T09:30:00-04:00,75.85,76.41,75.735,76.14,10138184,14935437.6,56.73071190814184,46.032114134074966,NaN,NaN,177.6525702857677,63.0088136293095,0.35435508496558643,-0.21583513173868596,-0.5701902167042724,1056826847,1042197960.6,54.78089442906174,43.29428425803024,NaN,NaN,-4.040854230089459,-10.513134600276183
2018-04-19T09:30:00-04:00,76.04,76.24,75.42,75.93,12515388,14870269.6,55.61458936760508,46.87624295570563,NaN,NaN,167.19205482257067,99.63070943013881,0.3883245784119224,-0.08478449368936936,-0.47310907210129177,1044311459,1043123594.8,55.53954849899818,44.62250011545957,NaN,NaN,-1.8332799146972403,-9.273155359479192
2018-04-20T09:30:00-04:00,76.25,76.35,75.33,75.6,11612759,14511213.8,53.82259113989525,47.98598430905488,NaN,NaN,138.0892330007924,128.58017810970776,0.3725127987712971,-0.0074680736371703915,-0.3799808724084675,1032698700,1043707503.2,56.040578585653,46.24905243062761,NaN,NaN,-0.47376433326217987,-8.016099498591048
2018-04-23T09:30:00-04:00,75.89,75.91,75.15,75.51,14427793,14459750.95,53.31800423136746,48.69776007756763,NaN,NaN,102.30038307757616,139.31069324663946,0.3407951684960157,0.046013088211552144,-0.29478208028446357,1018270907,1039759315.2,51.79067305184897,47.757482890667674,NaN,NaN,0.5218306484800064,-6.796395191866612
2018-04-24T09:30:00-04:00,75.89,76.04,72.48,73.4,21104818,14905144,43.113169844508086,48.570357369001044,NaN,NaN,-18.525646369871644,113.34171896336707,0.17108232774393206,-0.08092917060454852,-0.2520114983484806,997166089,1029854800.4,42.98413994281303,48.57094544865674,NaN,NaN,-1.6222012248222117,-6.057224625145984
2018-04-25T09:30:00-04:00,73.48,73.84,72.48,73.61,14949377,14916312.2,44.25669652374956,48.27133657835842,NaN,NaN,-65.95483239989271,64.62023842623498,0.07144043885153933,-0.16271094978405642,-0.23415138863559576,1012115466,1020912524.2,36.88579334335859,48.39073707041896,NaN,NaN,-3.0345256878502695,-5.625410491246596
2018-04-26T09:30:00-04:00,73.53,73.72,72.68,73.34,19955376,14819463.55,43.05824614866718,48.4423163356713,NaN,NaN,-70.91634644480442,16.998558172759964,-0.009854248292515189,-0.24646919900123976,-0.23661495070872457,992160090,1010482250.4,31.306592722255118,47.68309483822612,NaN,NaN,-4.550060901018652,-5.471789121214033
2018-04-27T09:30:00-04:00,73,73.33,72.723,73.19,11555792,14694400.3,42.37176316498756,48.61667933463762,NaN,NaN,-76.03151969653936,-25.82559236670639,-0.06770708350858495,-0.32124880509445575,-0.2535417215858708,980604298,1000063370,26.925463484412234,46.33956605631692,NaN,NaN,-5.998967354971304,-5.547100297465072
2018-04-30T09:30:00-04:00,73.39,73.53,72.21,72.22,15867537,14112836.35,38.13738615338412,48.1054308428985,NaN,NaN,-105.1803072871526,-67.32173043965214,-0.16001044505247075,-0.45355477790145926,-0.2935443328489885,964736761,989356540.8,23.31465999980378,44.45788223907032,NaN,NaN,-8.526071053298281,-5.9726675482983875
2018-05-01T09:30:00-04:00,72.11,72.14,70.79,71.89,21829489,14196856.4,36.790366326379484,47.642567172869356,NaN,NaN,-160.92248073506883,-95.80109731269158,-0.22786003333044935,-0.5783693745120502,-0.3505093411816008,942907272,978504777.4,20.33773810296256,42.40781518728282,NaN,NaN,-11.038058172240264,-6.696294780290084
2018-05-02T09:30:00-04:00,71.61,72.99,71.18,71.26,14789338,13936944.35,34.29965118761352,46.6550138010745,NaN,NaN,-132.00522901723315,-109.01117663615969,-0.2954516427780093,-0.7198238946541125,-0.42437225187610317,928117934,961705271,16.76824292397417,40.22855109854344,NaN,NaN,-13.941244422781457,-7.73128758636028
2018-05-03T09:30:00-04:00,70.91,71.8,70.03,71.43,25826562,14403469.55,35.567272462997565,45.81147119561291,NaN,NaN,-153.3204615177261,-125.49199965074402,-0.30761076712372304,-0.808885710780757,-0.501274943657034,953944496,954062152.2,15.440471044999953,37.99150569324906,NaN,NaN,-16.021337433904456,-8.915580421723734
2018-05-04T09:30:00-04:00,70.9,72.495,70.82,72.26,11695457,14070574.8,41.50170140052774,45.14965462401106,NaN,NaN,-100.38852959284152,-130.36340163000446,-0.2415677170418944,-0.803234589959402,-0.5616668729175076,965639953,951069283.2,14.941548310498177,35.529054242804946,NaN,NaN,-16.21085863226173,-9.95776302322916
2018-05-07T09:30:00-04:00,72.5,72.95,72.41,72.74,11812606,14147245.2,44.67521235392685,44.51838301526793,NaN,NaN,-53.466983392764284,-120.02073685112677,-0.15175674551793905,-0.7513628048149315,-0.5996060592969924,977452559,953612442.8,17.384445348511036,33.17434212779653,NaN,NaN,-15.474016897919999,-10.745799291042138
2018-05-08T09:30:00-04:00,72.7,73.36,72.55,73.26,10341591,13739557.25,47.96835906284715,43.89250066917545,NaN,NaN,-31.903318437876063,-94.21690439168823,-0.048857949955103175,-0.6606784967408714,-0.6118205467857682,987794150,962589818.4,25.51663405156968,31.084037815118517,NaN,NaN,-13.899127432986935,-11.196274739891395
2018-05-09T09:30:00-04:00,73.49,74.29,73.41,74.05,14973378,13956530.65,52.58586619784109,43.67616329990659,NaN,NaN,12.121996785056032,-65.3914592312304,0.07419204164806659,-0.5190804947256851,-0.5932725363737517,1002767528,977519737.2,36.67965261262559,29.736902394663336,NaN,NaN,-11.146907339946472,-11.189222254184978
2018-05-10T09:30:00-04:00,74.33,74.71,74.2,74.55,7213729,13871140.45,55.290259186056105,43.780996731775225,NaN,NaN,40.74050253260825,-26.579266421163517,0.1847457074679072,-0.36234040203886764,-0.5470861095067748,1009981257,988727089.4,43.522376614787994,28.842745111030123,NaN,NaN,-8.00224354307645,-10.733939581169475
2018-05-11T09:30:00-04:00,74.65,75.03,74.51,74.71,8060037,13778935.8,56.15213577907702,43.98343469946876,NaN,NaN,51.58464040613764,3.8153675786323165,0.2595524340017472,-0.22264556700459082,-0.48219800100633803,1018041294,999207357.6,49.065468874573256,28.648087669796137,NaN,NaN,-5.151959624002165,-9.936513873002717
2018-05-14T09:30:00-04:00,74.89,75.14,74.4149,74.58,5856613,13660132,55.22070004585325,44.84825828527913,NaN,NaN,49.568029443865456,24.422370145958276,0.2889334843009916,-0.12103114563009854,-0.4099646299310901,1012184681,1006153782,52.400154067928284,29.320660107304374,NaN,NaN,-3.017453861526147,-8.948076728506065
2018-05-15T09:30:00-04:00,74.18,74.39,74.01,74.33,10180484,13735315.4,53.38669310194832,45.50040089800761,NaN,NaN,29.793284177499128,36.761690669033314,0.2799857400573339,-0.059982454859422774,-0.33996819491675667,1002004197,1008995791.4,53.7347396204963,30.524156269957068,NaN,NaN,-1.674309182019643,-7.908967079008004
2018-05-16T09:30:00-04:00,74.32,74.85,74.24,74.6,6281408,13542476.6,55.12032623216949,46.3619780468292,NaN,NaN,54.359351589300786,45.20916162988226,0.2800303465333225,0.010069738249896432,-0.26996060828342605,1008285605,1010099406.8,54.27091919930609,32.164465304032134,NaN,NaN,-0.056306231483714844,-6.787158386504535
2018-05-17T09:30:00-04:00,74.57,75.21,74.52,74.89,7519490,13292681.7,56.97139873434516,47.40480915892617,NaN,NaN,78.16883482267816,52.69482808789625,0.28634695335671234,0.08797308341246435,-0.19837386994424797,1015805095,1011264174.4,54.86544490510572,34.1601782626531,NaN,NaN,1.8370908931701537,-5.555122775122436
2018-05-18T09:30:00-04:00,74.89,75.465,74.86,75.33,7482934,13086190.45,59.68812627219255,48.94414773884106,NaN,NaN,102.81125845830259,62.94015169832924,0.305183608465563,0.18310564063770585,-0.1220779678278572,1023288029,1012313521.4,55.42766719175301,36.45396449064946,NaN,NaN,4.24330327243558,-4.1553476254712916
2018-05-21T09:30:00-04:00,76.1,76.81,76,76.47,13744056,13052003.6,65.72607660456967,51.01098418728321,NaN,NaN,166.88870365459414,86.40428654047497,0.37485692819555627,0.34649319241658816,-0.028363735778968127,1037032085,1017283002.2,58.09017744270043,39.15056730063075,NaN,NaN,8.323953597858283,-2.3725903078527812
2018-05-22T09:30:00-04:00,76.6,76.68,75.495,75.53,8754854,12434505.4,58.010461456568216,52.704613492208544,NaN,NaN,120.2815152738723,104.50193275974962,0.33914617838443134,0.3955689872015711,0.05642280881713972,1028277231,1022537609,60.75934629030518,42.29278896965439,NaN,NaN,9.61552053806074,-0.6600030441508498
2018-05-23T09:30:00-04:00,75.07,75.46,74.77,75.46,12908999,12332486.5,57.469427418941024,54.269053131918795,NaN,NaN,75.74974635671124,108.78001171323169,0.29400313670654954,0.42392672970032663,0.1299235929937771,1015368232,1023954134.4,61.471721271825025,45.5807354144276,NaN,NaN,10.498092395703672,0.9340105901140818
2018-05-24T09:30:00-04:00,75.27,75.94,75.18,75.83,9371754,11803305.4,59.61351580031966,55.562754160475365,NaN,NaN,88.31201501537582,110.80864775177122,0.27272426952104023,0.4708289298950774,0.19810466037403718,1024739986,1025741112.6,62.399085634522876,48.9705595090008,NaN,NaN,11.865890703515394,2.4957077491714124
2018-05-25T09:30:00-04:00,75.68,75.935,75.47,75.69,8111816,11631106.6,58.413557632416364,56.54406453751032,NaN,NaN,82.84954027714788,106.81630411554029,0.23434987563729653,0.49104200492065786,0.2566921292833613,1016628170,1024409140.8,61.216320599399985,52.101407741207154,NaN,NaN,12.665499153274848,3.94853509261476
2018-05-29T09:30:00-04:00,75.06,75.25,74.13,74.48,18470390,11761249.25,49.19640540619207,56.631782133463524,NaN,NaN,26.003992586344648,78.6393619018904,0.11845295489695551,0.4047583229045557,0.2863053680076002,998157780,1016634279.8,54.69882783163657,54.18585015406908,NaN,NaN,10.566482410753595,4.893956138063165
2018-05-30T09:30:00-04:00,74.97,75.605,74.72,75.53,11431713,11241360.45,55.72513865641444,56.85601588050448,NaN,NaN,57.055464964154154,65.99415183994677,0.10399986626275942,0.4163052008360495,0.31230533457329007,1009589493,1012896732.2,51.841440106275066,55.268834975044044,NaN,NaN,10.792060264017193,5.736542441770883
2018-05-31T09:30:00-04:00,75.38,75.425,74.21,74.44,14117049,11207746,48.724977866449755,56.387067214818316,NaN,NaN,16.499205680880998,54.144043704780714,0.01708062378585723,0.3336561143056116,0.31657549051975437,995472444,1008917574.6,48.91192970962833,55.65380305324692,NaN,NaN,8.601317202591591,6.145795979030984
2018-06-01T09:30:00-04:00,74.87,75.39,74.82,75.26,9717092,10402272.5,53.46131891344261,56.194866010130134,NaN,NaN,43.30595279358312,45.14283126042217,0.011150257995995061,0.3305133130147482,0.3193630550187531,1005189536,1005007484.6,46.152055240419735,55.44570207937881,NaN,NaN,8.370745852697807,6.463645960983388
2018-06-04T09:30:00-04:00,75.51,75.85,75.04,75.15,8788678,10256933.55,52.75730182192327,56.01890899413514,NaN,NaN,53.17666536364403,39.208256277721404,-0.0030828103714028443,0.31550954205449955,0.3185923524259024,996400858,1000962022.2,43.422124088608484,54.80441422371312,NaN,NaN,7.965205751928828,6.678154502547022
2018-06-05T09:30:00-04:00,75.15,75.39,74.915,75.24,7906097,10061608.1,53.29918109262896,56.012658136326614,NaN,NaN,27.575015923823937,39.52246094521726,-0.0090031717895101,0.3073383876890148,0.3163415594785249,1004306955,1002191857.2,44.49695663515253,54.14457258190284,NaN,NaN,7.803694407202774,6.838945917497844
2018-06-06T09:30:00-04:00,75.41,75.95,75.17,75.87,6751882,9882122.65,57.01588966859817,56.14805552464295,NaN,NaN,79.74987517370924,44.06134298712828,0.025079124103972394,0.3476904646084904,0.322611340504518,1011058837,1002485726,44.766969438144784,53.46571902753418,NaN,NaN,8.791915997061652,7.117941643149816
2018-06-07T09:30:00-04:00,76.05,76.29,75.71,76.19,9952435,9631075.5,58.80909277796578,56.27931938490156,NaN,NaN,126.77870681859666,66.1172432146714,0.06260702417073755,0.4008701207179399,0.3382630965472024,1021011272,1007593491.6,49.376745075572195,53.07366903971035,NaN,NaN,10.146243116168531,7.550556139295347
2018-06-08T09:30:00-04:00,76.08,76.5401,75.92,76.44,6557887,9598283.4,60.20583310283972,56.3162984442335,NaN,NaN,141.07243784322742,85.67054022460027,0.09571735710806545,0.4579097929322842,0.36219243582421873,1027569159,1012069416.2,53.07282861696391,52.90546628436827,NaN,NaN,11.67781923503733,8.140165152972774
2018-06-11T09:30:00-04:00,76.45,76.82,76.3501,76.59,5225259,9456544.5,61.05904489163155,55.9829390361665,NaN,NaN,152.24121440944987,105.48345003376144,0.11772322058607831,0.5093464615568166,0.3916232409707383,1032794418,1019348128.2,58.392879990230384,52.92708789490613,NaN,NaN,13.189511938320814,8.861500408022494
2018-06-12T09:30:00-04:00,76.71,76.78,76.315,76.51,5802797,9453853.7,60.31627320383337,56.147639875256864,NaN,NaN,126.20596202773952,125.20963925454456,0.11666905629911584,0.5374595613446331,0.4207905050455173,1026991621,1023885061.4,61.33526197836204,52.96822472976733,NaN,NaN,14.250932244319062,9.631419241779145
2018-06-13T09:30:00-04:00,76.54,76.59,75.85,75.9,8553710,9372515,54.838369429392614,55.95970716171769,NaN,NaN,69.07956627220656,123.07557747424403,0.06712730018747337,0.504699630279859,0.4375723300923856,1018437911,1025360876.2,62.269963149662416,53.02524200675572,NaN,NaN,13.678384599767327,10.209557150063171
2018-06-14T09:30:00-04:00,76.14,76.345,75.41,75.61,10501482,9583518.7,52.40179914261938,55.44458454331053,NaN,NaN,23.16456575032302,102.35274926058928,0.010060177326210673,0.450147551750149,0.4400873744239383,1007936429,1022745907.6,59.52415460937794,52.81988979067393,NaN,NaN,12.510326720562743,10.538238517277396
2018-06-15T09:30:00-04:00,74.81,75.26,74.29,75.12,14780933,9946590.85,48.48205102123152,54.73519121394019,NaN,NaN,-98.23504134115468,54.49125342371288,-0.061518608686434884,0.3631891135658947,0.42470772225232956,993155496,1015863175,52.910891194823584,52.22664483320419,NaN,NaN,10.366662760083477,10.513727694821121
2018-06-18T09:30:00-04:00,74.55,74.94,74.34,74.81,8330311,9988959.7,46.131035671711395,54.516236232905854,NaN,NaN,-114.18671282197903,1.2056679774270833,-0.12681335294329932,0.2661910310732054,0.3930043840165047,984825185,1006269328.4,45.34785929506939,51.55871850916368,NaN,NaN,7.863965631811068,10.135190257248256
2018-06-19T09:30:00-04:00,73.95,74,72.95,73.23,17955385,10199526.15,36.433604666337274,53.13826951932891,NaN,NaN,-231.05058922274944,-70.24564227267071,-0.2655059229467366,0.061121980333084025,0.3266279032798206,966869800,994244964.2,38.01377509310653,50.57102815108021,NaN,NaN,2.1738408313132296,8.997854624971824
2018-06-20T09:30:00-04:00,73.48,73.52,73.02,73.28,11975928,10360579.85,36.88576081975296,52.29261115885057,NaN,NaN,-203.58444096495367,-124.77844372010277,-0.3383044007502517,-0.09625259765799399,0.24205180309225768,978845728,986326527.6,34.102346797423024,49.513200800208395,NaN,NaN,-2.1881832624324,7.399849212485506
2018-06-21T09:30:00-04:00,73.01,73.14,72.11,72.36,15497833,10490021.55,32.32900547020557,50.78316019861935,NaN,NaN,-216.23092520642942,-172.65754191145325,-0.4271175913851764,-0.29184518613921284,0.13527240524596357,963347895,977408820.8,30.318755856220903,48.382250844194196,NaN,NaN,-7.563595117660735,5.2622143081789
2018-06-22T09:30:00-04:00,72.87,73.08,72.53,72.61,13657361,10704301.9,34.69009724405258,49.49264558591431,NaN,NaN,-162.5748271816096,-185.5254990795442,-0.44567260550194876,-0.4218183516314724,0.023854253870476377,977005256,974178772.8,29.061070543246615,47.35646130523978,NaN,NaN,-11.205652812912927,2.9096618623086394
2018-06-25T09:30:00-04:00,72.04,72.22,71.225,71.69,23091537,11453287.95,30.47603219916205,47.86242066495239,NaN,NaN,-189.49454395718416,-200.58706530658526,-0.4928693598519158,-0.5922324459444184,-0.09936308609250258,953913719,967996479.6,26.77196329987582,46.09039035272002,NaN,NaN,-15.808103497839374,0.23569538228749476
2018-06-26T09:30:00-04:00,72.01,72.32,71.803,71.96,11351851,11097361,33.04659948985231,46.15032850932768,NaN,NaN,-142.23015410740211,-182.8229782835158,-0.47847770133402584,-0.6974602127600349,-0.21898251142600905,965265570,967675633.6,26.654619880572127,44.79665109860769,NaN,NaN,-18.743614263311724,-2.475634567083822
2018-06-27T09:30:00-04:00,72.25,73.01,71.35,71.38,19853403,11518445.5,30.442687343662357,44.124156692591725,NaN,NaN,-123.59013505976498,-166.82411710247806,-0.479392520094584,-0.818223161544239,-0.338830641449655,945412167,960988921.4,24.26734980656606,43.003122865107244,NaN,NaN,-22.058631577701,-5.273205568600561
2018-06-28T09:30:00-04:00,71.24,71.8,70.815,71.48,15329838,11579084.95,31.445664782370045,42.06985895541532,NaN,NaN,-125.33931457550798,-148.64579497629376,-0.4453645420459842,-0.8955363190071353,-0.45017177696115107,960742005,960467743.4,24.086275497406064,40.93265478513882,NaN,NaN,-24.430182734547103,-8.00991659230721
2018-06-29T09:30:00-04:00,71.78,72.4301,71.6,71.63,14907976,11838629.15,33.00614855767708,40.066080645847144,NaN,NaN,-90.96718139122908,-134.32426581821764,-0.38701293967956585,-0.9339379515606083,-0.5469250118810425,975649981,960196688.4,23.986033674236424,38.47502290542497,NaN,NaN,-25.93897419540902,-10.571210535607468
2018-07-02T09:30:00-04:00,71.07,71.8,70.89,71.79,14098693,12104129.9,34.71326325879785,38.23729422120175,NaN,NaN,-94.50676378022881,-115.32670978282658,-0.31495439082276655,-0.9406180004095006,-0.6256636095867341,989748674,967363679.4,32.039784258739274,36.38248878259477,NaN,NaN,-26.725265306467783,-12.87893264573037
2018-07-03T09:30:00-04:00,72.07,72.4,71.37,71.56,7083332,12062991.65,33.395876950666405,36.70568761557846,NaN,NaN,-75.9252125301281,-102.0657214673718,-0.26225306577913743,-0.9534799418106559,-0.6912268760315184,982665342,970843633.8,35.607275845650165,34.47801111802247,NaN,NaN,-27.752314822832048,-15.003701528173465
2018-07-05T09:30:00-04:00,71.81,71.96,71.22,71.91,8465722,12148683.65,37.295657877597925,35.62667752521978,NaN,NaN,-72.5236031015557,-91.85241507572994,-0.18683519135397786,-0.9247708652239908,-0.7379356738700129,991131064,979987413.2,43.93517653927339,33.364512684443575,NaN,NaN,-27.569206804554486,-16.79877371051361
2018-07-06T09:30:00-04:00,71.85,72.375,71.425,72.16,9757529,12138938.35,39.99812587440559,35.020682871875074,NaN,NaN,-57.286943148544296,-78.2419407903372,-0.10708848465644638,-0.8717962796905709,-0.7647077950341246,1000888593,988016730.8,50.04483229502856,33.15979419160107,NaN,NaN,-26.66840401475558,-18.208720896833892
2018-07-09T09:30:00-04:00,72.48,73.52,72.405,73.5,13033985,12462743.25,51.951538320401724,35.43643306106724,NaN,NaN,-6.019070941773988,-61.252318700446175,0.04099632598527969,-0.713462387552525,-0.7544587135378047,1013922578,995671250.2,55.07141671702159,33.8543340074548,NaN,NaN,-21.966065536718666,-18.74548441681743
2018-07-10T09:30:00-04:00,73.53,73.9,73.34,73.73,9880441,12695502.35,53.65804943017115,36.66675054419824,NaN,NaN,26.32636978939682,-37.085691986521056,0.15322024002051948,-0.5629334135121553,-0.7161536535326748,1023803019,1002482119.2,59.022426292943294,35.35495195030029,NaN,NaN,-17.58898022817239,-18.580269532725282
2018-07-11T09:30:00-04:00,73.09,73.1,72.36,72.52,14207965,13115760.75,44.66961492167743,37.222740122907126,NaN,NaN,-16.144512256879523,-25.12955193187134,0.14483761997118116,-0.5351066285686983,-0.6799442485398794,1009595054,1007868061.6,61.87745882245371,37.33888852351676,NaN,NaN,-16.475872898432343,-18.279641442112005
2018-07-12T09:30:00-04:00,73.06,73.45,72.61,73.37,12705631,13323356.8,50.89279835951399,38.548725329286306,NaN,NaN,24.430593445528125,-5.7387126224545755,0.19243486491990058,-0.4394006673900037,-0.6318355323099043,1022300685,1014101985.8,64.92369230885143,39.81066969870466,NaN,NaN,-13.380525777524909,-17.57976777574242
2018-07-13T09:30:00-04:00,73.34,73.88,73.3,73.75,18494295,13722997.45,53.41535570516359,39.88624379079424,NaN,NaN,75.9309808795021,20.9048721831547,0.24219117853126382,-0.3290965591458246,-0.5712877376770884,1040794980,1022083263.2,68.40465969820583,42.62092606691603,NaN,NaN,-10.04876290254101,-16.503909936713647
2018-07-16T09:30:00-04:00,73.89,74.055,73.26,73.45,9576084,13462755,51.18013885601707,41.36510855199816,NaN,NaN,83.36661169123929,38.782008709757356,0.24674443229220577,-0.2628571973118312,-0.509601629604037,1031218896,1025542526.8,69.80340916134577,45.69460077130673,NaN,NaN,-8.064186586878442,-15.298235172451475
2018-07-17T09:30:00-04:00,73.39,73.83,73.19,73.74,7326022,13412540.55,53.21808615511272,42.8059290280882,NaN,NaN,94.75181825949595,52.467098403777186,0.25981663596161486,-0.18483083465201844,-0.4446474706136333,1038544918,1028490906.6,70.98253672682912,48.86088054603937,NaN,NaN,-5.807899177614102,-13.942472887474707
2018-07-18T09:30:00-04:00,74,74.76,73.91,74.55,13821348,13205838.7,58.436945265524734,44.8055188796498,NaN,NaN,154.94764072117533,86.68552899938815,0.3101360963933545,-0.05697735012194016,-0.36711344651529465,1052366266,1037045149,74.13790069472097,52.42306275233615,NaN,NaN,-2.1454252290249625,-12.25718036483903
2018-07-19T09:30:00-04:00,74.27,74.68,73.97,74.52,8790004,13046542.5,58.17807756056215,46.71497693523495,NaN,NaN,138.53784767121584,109.5069798445257,0.32684988599504894,0.04144891097851655,-0.2854009750165324,1043576262,1041300264.4,75.5614729607283,56.09986257114489,NaN,NaN,0.6793566432577179,-10.409103649396638
2018-07-20T09:30:00-04:00,74.42,74.72,74.12,74.44,7922415,12667771.6,57.44725313968124,48.46077011966382,NaN,NaN,121.61746260812885,118.64427619025105,0.3176882875053507,0.11170938436515598,-0.2059789031401947,1035653847,1040272037.8,74.49438200123069,59.70760173735875,NaN,NaN,2.7729490612266505,-8.52595326216474
2018-07-23T09:30:00-04:00,74.26,74.285,73.84,73.98,7822045,12376005.8,53.301126167377944,49.78847461313382,NaN,NaN,82.60916881901319,118.49278761580584,0.26781397506151955,0.12878856568670471,-0.13902540937481483,1027831802,1039594619,73.75537627759996,62.68728688156309,NaN,NaN,3.3962750561598294,-6.822777788118373
2018-07-24T09:30:00-04:00,74.36,74.72,73.96,74.29,12140416,11828449.75,55.62544594426995,51.37630096981979,NaN,NaN,92.82284950990177,118.10699386588699,0.24356541503652074,0.1654313594208361,-0.07813405561568465,1039972218,1039880079,73.872997736804,65.42055273093122,NaN,NaN,4.589969787178814,-5.192385277361632
2018-07-25T09:30:00-04:00,74.07,75.42,73.95,75.42,17967872,12159250.8,62.878437209923675,53.2036423507002,NaN,NaN,121.32793182879536,111.38305208741099,0.28842507924107946,0.28239729343566466,-0.006027785805414784,1057940090,1040994843.8,74.35633357707046,67.5934925193453,NaN,NaN,8.009311415682161,-3.3064286069268047
2018-07-26T09:30:00-04:00,75.26,76.1499,75.25,76,15115428,11922352.05,65.95438246879215,55.057660678870675,NaN,NaN,158.6048417415353,115.39645090147489,0.3384917276215445,0.41708687372151587,0.07859514609997136,1073055518,1046890695,76.8007811628589,69.50463172419032,NaN,NaN,11.899187416211118,-1.13419774647853
2018-07-27T09:30:00-04:00,76.15,76.34,75.651,76.01,11281629,11719941.6,66.00668257734853,56.06159955436687,NaN,NaN,157.78045171016055,122.62904872188123,0.3520498768749575,0.5186574921936682,0.1666076153187107,1084337147,1056627355,80.16365409469812,71.29693439402436,NaN,NaN,14.996916139954394,1.1702470944404593
2018-07-30T09:30:00-04:00,76.11,76.5,75.18,75.26,13423598,11645722.7,58.72084302569191,56.42322766833264,NaN,NaN,122.43618015390695,130.59445098885996,0.2927106481918599,0.5324959255585355,0.23978527736667568,1070913549,1065243704.4,82.57133631465146,72.97899939557495,NaN,NaN,15.488261200226356,3.2156776809813015
2018-07-31T09:30:00-04:00,75.83,76.985,75.695,76.92,17709453,11826260.7,67.31920646544279,58.041055635744456,NaN,NaN,158.2293143150583,143.67574394989128,0.3439248387200927,0.6696913257667916,0.32576648704669886,1088623002,1074973861.2,84.81309108059504,74.61725884258503,NaN,NaN,18.98423971840627,5.46832940061344
2018-08-01T09:30:00-04:00,76.63,76.68,75.685,75.88,14214593,12182823.75,59.02406110271755,58.62186011740185,NaN,NaN,118.24247531316422,143.05865264676507,0.28865547155546156,0.6865858264910258,0.3979303549355643,1074408409,1078267525,85.4932916678559,76.08651593965679,NaN,NaN,18.926178405243547,7.3908792584177405
2018-08-02T09:30:00-04:00,75.34,75.88,75.11,75.78,10812428,12300159.05,58.28042736535298,58.96936523598681,NaN,NaN,80.6032511156635,127.4583345215907,0.22887228469325283,0.6840207108021303,0.4551484261088775,1063595981,1076375617.6,83.18847663263924,77.14250286354489,NaN,NaN,18.631021087460212,8.996613805423808
2018-08-03T09:30:00-04:00,75.72,75.9,75.375,75.85,11021674,12363366.3,58.67293426168844,59.50456490782047,NaN,NaN,78.01595741414629,111.50543566238784,0.17972121315026457,0.6797999425467083,0.5000787293964437,1074617655,1074431719.2,80.77879439366737,77.92645895156787,NaN,NaN,18.522222446949694,10.357415039927506
2018-08-06T09:30:00-04:00,75.81,75.99,75.5,75.96,5460333,11984683.7,59.32061524401087,59.94045984274177,NaN,NaN,75.90697752291109,102.19959513618868,0.14195381145370212,0.6775209937135713,0.5355671822598692,1080077988,1076264607,81.32799936552084,78.66542056861728,NaN,NaN,18.625861455675054,11.538621670748585
2018-08-07T09:30:00-04:00,76.22,76.61,76.005,76.5,8381937,11909758.5,62.433169215377475,60.22590441058839,NaN,NaN,101.11273870724501,90.77628001462602,0.14041935707416442,0.7110913786025748,0.5706720215284103,1088459925,1076231991.6,81.28349242890225,79.17581997820164,NaN,NaN,19.64359738297827,12.696475343924254
2018-08-08T09:30:00-04:00,76.45,76.51,76.06,76.16,4745182,11436619.35,59.35380592778477,60.30988500824715,NaN,NaN,84.89684973113953,84.10715489822107,0.10519586247999002,0.7021668496283979,0.5969709871484079,1083714743,1078093258.4,81.89249188892653,79.6280356159301,NaN,NaN,19.58628536508809,13.68073391837623
2018-08-09T09:30:00-04:00,76.14,76.34,75.685,75.74,13085874,11455631.5,55.69912887459463,60.18501898931239,NaN,NaN,56.748972718472665,79.33629921878291,0.04535802818019352,0.6536685223736498,0.6083104941934563,1070628869,1079499836,82.35962395649196,80.18983861273448,NaN,NaN,18.455835166843347,14.362891239585819
2018-08-10T09:30:00-04:00,75.3,75.43,74.86,75.07,10684816,11065157.55,50.37081713379343,59.97571120119921,NaN,NaN,-8.590329832128266,62.015041769528,-0.04282859531236549,0.5547747500529994,0.5976033453653649,1059944053,1076565115.6,77.84718221468283,80.48211046538324,NaN,NaN,15.834227223828263,14.573082094477597
2018-08-13T09:30:00-04:00,75.38,75.41,74.51,74.71,13471775,11259942.1,47.72880870324303,59.411665683983,NaN,NaN,-36.68673391512206,39.49629948192138,-0.12427971132314664,0.44225370621143156,0.5665334175345782,1046472278,1069843973.6,68.57984858318257,80.10402838298171,NaN,NaN,12.836227595301061,14.324960023166662
2018-08-14T09:30:00-04:00,75,75.53,74.94,75.23,8500515,11318666.75,51.67193036961866,58.6112009096755,NaN,NaN,-14.05585597801665,16.46258054486905,-0.14079653687909333,0.3905377464357116,0.5313342833148049,1054972793,1063146547.2,60.81120697765009,79.13651934016598,NaN,NaN,11.432605036936042,13.911766453705145
2018-08-15T09:30:00-04:00,74.61,74.99,73.99,74.87,20329384,11644068.55,48.92053610467841,57.39449759795309,NaN,NaN,-78.65307933307325,-16.247405267973516,-0.1715866082475822,0.3168510230053272,0.4884376312529094,1034643409,1053332280.4,51.58890267091438,77.33567087645565,NaN,NaN,9.429063671558001,13.271380341969838
2018-08-16T09:30:00-04:00,75.46,75.995,75.25,75.82,10447180,11726927.35,55.634101324619834,56.6535989370439,NaN,NaN,26.578150915766344,-22.281569628514784,-0.12571658696359878,0.33129189754841093,0.4570084845120097,1045090589,1048224624.4,47.54750127564485,75.00594567509471,NaN,NaN,9.723790292730731,12.764581763507108
2018-08-17T09:30:00-04:00,75.64,76.44,75.61,76.28,13993103,12030461.75,58.4797774132755,56.63637996472845,NaN,NaN,68.87335389452274,-6.788832883184591,-0.0651862088092745,0.3755257235004166,0.4407119323096911,1059083692,1048052552.2,47.412746376258276,72.49461782235234,NaN,NaN,10.860700801526665,12.492598768938473
2018-08-20T09:30:00-04:00,76.44,76.945,76.4,76.79,8239331,12051326.05,61.43333406503877,56.21596050755672,NaN,NaN,139.59939539441342,28.4683929787225,0.004699350315097217,0.4465861202035626,0.44188676988846537,1067323023,1052222701.2,51.03460638488291,70.08186891551576,NaN,NaN,12.744217239145698,12.528544264682361
2018-08-21T09:30:00-04:00,76.88,77.46,76.88,77.36,10033984,11946004.45,64.4749843101539,56.60531216523077,NaN,NaN,193.15197688490758,69.90995955130734,0.08060338820089669,0.5426410051395862,0.46203761693868955,1077357007,1056699544,54.645976085434725,67.8784892310571,NaN,NaN,15.304008380391002,12.925039138355025
2018-08-22T09:30:00-04:00,77.16,77.25,76.61,76.61,7149661,11405093.9,57.99386089704988,56.58484313178055,NaN,NaN,123.08069165230758,110.2567137483835,0.0718776492201964,0.5518846784639351,0.48000702924373867,1070207346,1063812331.4,59.728019329276876,66.20274228081693,NaN,NaN,15.446609779692222,13.28526351568891
2018-08-23T09:30:00-04:00,76.65,76.65,76.21,76.39,8336522,11066148.6,56.20897358696582,56.40884594072894,NaN,NaN,62.02688571950896,117.34646070913205,0.0442245614282214,0.5352877310290154,0.491063169600794,1061870824,1067168378.4,61.897467426202645,64.85407606885516,NaN,NaN,15.012252269980708,13.531976194873453
2018-08-24T09:30:00-04:00,76.57,76.77,76.36,76.72,6411553,10822644.8,58.28301596075205,56.334731706210455,NaN,NaN,79.17811006000076,119.40741194222764,0.04115671702014534,0.5425090658759757,0.5013523488558304,1068282377,1069008115.4,63.071867347814276,63.55006663901899,NaN,NaN,15.27284547631237,13.780671806507584
2018-08-27T09:30:00-04:00,77.1,77.71,77.01,77.69,9767530,10639841.4,63.722005774026265,56.42679146039965,NaN,NaN,157.78927256628145,123.04538737660125,0.09440874870308691,0.619363284734689,0.5249545360316021,1078049907,1071153492.2,64.4479952062496,62.347531123115225,NaN,NaN,17.241066356829972,14.275013885125068
2018-08-28T09:30:00-04:00,77.84,77.92,77.47,77.53,8440645,10176401,62.279610918796415,56.6357775311862,NaN,NaN,156.55386509991732,115.7257650196032,0.10784029137775963,0.6597549002538017,0.551914608876042,1069609262,1069603943.2,62.63253047802535,60.97181959376513,NaN,NaN,18.387929795306544,14.862573300865279
2018-08-29T09:30:00-04:00,77.59,77.73,77.36,77.59,6339043,9782623.5,62.62130293931981,57.130218535809426,NaN,NaN,126.95437540976364,116.5005017710944,0.10940311553352233,0.6886685032929449,0.5792653877594226,1075948305,1070752135,63.45403812510111,59.621420605808645,NaN,NaN,19.41429391156506,15.512819102393818
2018-08-30T09:30:00-04:00,77.42,77.61,76.86,77.05,10145635,9749283.85,57.567019312314706,57.644232977132376,NaN,NaN,82.25678283572682,120.54648119433799,0.06490498091136321,0.6603966138986266,0.5954916329872634,1065802670,1071538504.2,64.03717229596957,58.63499132590056,NaN,NaN,18.828811592335104,15.986532315242574
2018-08-31T09:30:00-04:00,76.86,77.24,76.791,77.1,7192428,9557821.55,57.90580158825842,58.371161040347765,NaN,NaN,64.05402578324598,117.52166433898701,0.03137388549482556,0.6347089898557954,0.6033351043609698,1072995098,1072481048.4,64.76292532142267,58.36235395006057,NaN,NaN,18.4442619483366,16.33763654854172
2018-09-04T09:30:00-04:00,76.81,77.1,76.65,77.04,8597691,9714689.45,57.31444806918013,58.77419801888787,NaN,NaN,49.12188136547094,95.78818609882492,-0.0006169772364990056,0.6025638828153461,0.6031808600518451,1064397407,1069750548.4,60.9270015603877,58.37062499168468,NaN,NaN,17.965406397189728,16.570175098348578
2018-09-05T09:30:00-04:00,76.91,77.61,76.71,77.59,10761284,9833656.8,61.2236504274978,59.65299189908926,NaN,NaN,75.01521826306164,79.48045673145377,0.00896474307145767,0.6143867888911672,0.6054220458197095,1075158691,1070860434.2,61.914472408176785,59.10816568720342,NaN,NaN,18.618416336213375,16.86278098947212
2018-09-06T09:30:00-04:00,77.64,78.06,77.5,77.83,8082965,10000545.95,62.823605382760995,60.16652790324219,NaN,NaN,105.14750496055572,75.11908264161218,0.024297155175769247,0.6357934897894211,0.6114963346136518,1083241656,1072319104.4,63.229721356141,60.228324264381705,NaN,NaN,19.616636227026085,17.25618888055126
2018-09-07T09:30:00-04:00,77.62,77.95,77.18,77.59,11039720,9898238.25,60.150802429045946,60.28588683294008,NaN,NaN,80.2077579296987,74.70927766040657,0.011742382346559554,0.6261743125468513,0.6144319302002917,1072201936,1073598957.6,64.3916710131638,61.441104595589245,NaN,NaN,19.74499042523058,17.61173195836259
2018-09-10T09:30:00-04:00,77.89,78.3,77.89,77.99,9550246,9841509.75,62.97788652041827,60.396212008324326,NaN,NaN,114.2372322327473,84.74591895030683,0.02318314578176761,0.6434108624275012,0.6202277166457336,1081752182,1075350374.4,65.97615487406023,62.50835805910191,NaN,NaN,20.640880625658394,18.04446748226199
2018-09-11T09:30:00-04:00,77.65,78.201,77.4701,77.97,6945629,9515202.45,62.738220738867305,60.27215746751814,NaN,NaN,94.80840595367448,93.88322386794755,0.022207844870362092,0.6479875227336862,0.6257796778633241,1074806553,1077432203.6,67.80973960540379,63.44862688195685,NaN,NaN,21.320417649645364,18.51246036331676
2018-09-12T09:30:00-04:00,77.93,78.525,77.765,78.21,10906171,9635485.25,64.48483773692264,60.7357986703662,NaN,NaN,117.06340542416964,102.29286130016915,0.030043498672964186,0.6633340512045294,0.6332905525315652,1085712724,1079543010.2,69.5986885282947,64.1536746818867,NaN,NaN,22.375379149436593,19.06430590419102
2018-09-13T09:30:00-04:00,78.59,78.955,78.39,78.68,8848986,9061465.35,67.6798917200912,61.55514996558944,NaN,NaN,167.7313576543269,114.80963183892338,0.0576005177410116,0.7052911997078297,0.6476906819668181,1094561710,1081807021,71.43252276026561,64.83475006289119,NaN,NaN,24.212358274787118,19.79974195713332
2018-09-14T09:30:00-04:00,78.7,79.13,78.44,79.07,8478536,8963033.15,70.08484727083385,62.398137916309565,NaN,NaN,173.63832949735252,133.49574615245416,0.09083722567902719,0.7612372140656021,0.6703999883865749,1103040246,1087974683,75.7279046410627,65.73875272669464,NaN,NaN,26.5126906235604,20.75873462376576
2018-09-17T09:30:00-04:00,79.03,79.44,78.96,79.1,8368638,8681809.9,70.26812004284622,62.86571750693957,NaN,NaN,183.91402441518164,147.431104588941,0.10271013402954388,0.7987876559235048,0.6960775218939609,1111408884,1093906023.4,78.99830684322427,66.77806070076427,NaN,NaN,28.467574802121938,21.859997506388073
2018-09-18T09:30:00-04:00,79.28,80,78.93,79.82,8701175,8704902.1,74.3324347114462,63.72663349212883,NaN,NaN,189.9360028555051,166.45662396930715,0.14437032007202277,0.8765404219839894,0.7321701019119666,1120110059,1102966724.6,82.8088901128087,68.21922924610594,NaN,NaN,31.497632348929127,23.23680248389394
2018-09-19T09:30:00-04:00,79.74,80.25,79.6509,79.75,7938275,8600116.65,73.28356446483232,64.488223601094,NaN,NaN,179.04677122333447,178.8532971291401,0.15177169532531298,0.9218847210686079,0.7701130257432949,1112171784,1108258536.6,84.5697958227225,69.72749765307888,NaN,NaN,33.70138101815493,24.731742274502654
2018-09-20T09:30:00-04:00,80.12,80.41,79.535,79.87,11466861,8815976.65,73.96186349591252,65.65928389992243,NaN,NaN,153.87133801676913,176.08129320162854,0.14909175708986955,0.9564777221056318,0.8073859650157622,1123638645,1114073923.6,86.23808027854585,71.31327679469149,NaN,NaN,35.74369485413585,26.3048783573074
2018-09-21T09:30:00-04:00,79.75,80,79.63,80,15150665,9156683.8,74.71093327142177,66.8596504487198,NaN,NaN,128.76567716208436,167.10676273457491,0.14053190002347782,0.9830508400451095,0.8425189400216316,1138789310,1121223736.4,87.96143224822248,72.97031300374861,NaN,NaN,37.6835252149268,27.930399336967312
2018-09-24T09:30:00-04:00,79.5,79.6,78.55,78.63,11999602,9436086.25,56.32213393444951,66.78877086766762,NaN,NaN,49.72022259856352,140.26800237125127,0.03268854924539444,0.8833796265783747,0.8506910773329802,1126789708,1124299901.2,88.6216308424059,74.94850080960705,NaN,NaN,33.71266856813555,28.756437798562775
2018-09-25T09:30:00-04:00,78.73,78.83,78.31,78.39,12354320,9565425.75,53.82287385028464,66.26014396929526,NaN,NaN,14.269878404179613,105.13477748098619,-0.059690989001784045,0.7760773410807502,0.8357683300825343,1114435388,1123164967,86.73179587156035,76.72116677127731,NaN,NaN,29.675082838333495,28.887672804244307
2018-09-26T09:30:00-04:00,78.56,78.84,78.19,78.34,11426216,9714704.3,53.29230674925064,65.57933692404451,NaN,NaN,7.105596723861225,70.74654258109153,-0.1252740171300195,0.6791758086700099,0.8044498258000294,1103009172,1121332444.6,83.63071394486184,78.17838052761451,NaN,NaN,26.280127373880514,28.515166314192335
2018-09-27T09:30:00-04:00,78.54,78.815,78.19,78.45,8504177,9822961,54.35827159069946,65.16558472130548,NaN,NaN,5.934017480594914,41.15907847385671,-0.16012719010887666,0.6042908381639336,0.7644180282728102,1111513349,1118907385.4,79.57587099377695,79.26296624051544,NaN,NaN,23.7818044956311,27.83897176868359
2018-09-28T09:30:00-04:00,78.27,78.58,78.13,78.4,7545351,9692946.8,53.75771045017708,64.50700071628826,NaN,NaN,-9.78765528492483,13.448411984454873,-0.18373828825080762,0.5347451679593007,0.7184834562101083,1103967998,1111943123,69.19943426484258,79.49320048271419,NaN,NaN,21.55001217693472,26.940548969862324
2018-10-01T09:30:00-04:00,79.36,79.55,78.81,79.09,16832131,10174931.95,60.279542365886215,64.3313808325039,NaN,NaN,55.37603689249474,14.579574843241115,-0.1514214909496101,0.5292065925230958,0.6806280834727059,1120800129,1110745207.2,67.56736100728634,79.47588772570579,NaN,NaN,21.392708094284245,26.14800027335117
2018-10-02T09:30:00-04:00,79.05,79.41,78.796,79.27,8524037,10171249.25,61.79337226167725,64.1391332985578,NaN,NaN,49.100617067966155,21.545722575998422,-0.11794616054328999,0.5331953827935934,0.6511415433368833,1129324166,1113722962.8,69.49345538803846,79.46837107283035,NaN,NaN,21.70346578485716,25.513066774994883
2018-10-03T09:30:00-04:00,79.6,80.02,79.43,79.6,10534891,10159929.6,64.46711388070125,63.9096491671728,NaN,NaN,94.75984588419925,39.07657240806604,-0.07565804343585636,0.5565689890420629,0.6322270324779192,1139859057,1121092939.8,73.66245896180106,79.62765223008289,NaN,NaN,22.760053014363617,25.1197790949047
2018-10-04T09:30:00-04:00,79.43,79.75,78.74,79.34,12521034,10381833.05,60.85374632611151,63.25028481397835,NaN,NaN,45.06417190243944,46.90260329243495,-0.0675430370001705,0.5477982362277061,0.6153412732278766,1127338023,1124257874.6,75.22806503699692,79.59194940122104,NaN,NaN,22.606656686719163,24.760761608021053
2018-10-05T09:30:00-04:00,79.39,79.7528,78.52,78.93,14165540,10538124.05,55.56480332774708,62.20004790575698,NaN,NaN,13.85915082658453,51.63196451473682,-0.09069118166590318,0.5019772961454976,0.5926684778114008,1113172483,1126098771.6,76.11734653245713,79.38616652188054,NaN,NaN,20.88957496088207,24.207734944144054
2018-10-08T09:30:00-04:00,78.9,79.2,78.31,79.13,9359667,10528595.1,57.505019085724214,60.99808964677685,NaN,NaN,-16.85250050006678,37.18625703622452,-0.09308552130353287,0.4763115761819847,0.5693970974855176,1122532150,1126445175.8,76.2898319162808,78.92051950784283,NaN,NaN,20.015844154499828,23.608893402766306
2018-10-09T09:30:00-04:00,78.9,79.02,77.9,77.91,11606904,10761658.85,44.68705217534259,58.955481626099,NaN,NaN,-108.30497390934174,5.705138840762939,-0.17275518466605944,0.3534531166529433,0.5262083013190028,1110925246,1122765391.8,70.46767970695356,77.91322549957361,NaN,NaN,14.738819706649892,22.341740017606817
2018-10-10T09:30:00-04:00,77.77,77.77,75.19,75.4,34050401,11918870.35,29.913630517838584,55.809179270522286,NaN,NaN,-332.478940437972,-79.74261842367132,-0.37861415078035676,0.05294061284355678,0.43155476362391354,1076874845,1110168549.4,54.99503835735169,75.68157964805974,NaN,NaN,2.6255857491971524,19.52514655069115
2018-10-11T09:30:00-04:00,74.91,75.57,73.2,73.41,54550493,14203945.7,23.328667289395,52.139017414663236,NaN,NaN,-361.48922786327387,-161.05329837681398,-0.6187265365763259,-0.3418534070964938,0.27687312947983206,1022324352,1089165815.2,39.444131791064414,72.21605818683416,NaN,NaN,-10.697135440146269,15.207677694857235
2018-10-12T09:30:00-04:00,74.7,74.81,73.05,73.9,29409772,15250507.5,27.557360530511957,50.08439074295341,NaN,NaN,-263.1252378835137,-216.45017611883364,-0.7080432049992458,-0.6081808767692252,0.09986232823002059,1051734124,1076878143.4,33.47943032045956,68.27732957812371,NaN,NaN,-18.205080993484497,10.434426453665559
2018-10-15T09:30:00-04:00,73.85,74.63,73.79,74.04,15201219,15592136.55,28.766219951155875,48.29462975015849,NaN,NaN,-185.5146676522892,-250.18260954927808,-0.7188843204732988,-0.7987430723616029,-0.07985875188830413,1066935343,1065758782,29.17934755797087,64.16644041286732,NaN,NaN,-23.0672302090522,5.648475501848735
2018-10-16T09:30:00-04:00,74.32,75.36,74,75.29,12547323,15784443.95,38.615547509534835,47.24628980446452,NaN,NaN,-123.07228278814533,-253.13607132503884,-0.6074940808765448,-0.8392263529839852,-0.23173227210744035,1079482666,1059470266,27.06236395994516,60.125843985373265,NaN,NaN,-23.175305404126146,1.5307925152808952
2018-10-17T09:30:00-04:00,75.31,75.55,74.34,74.74,15610606,16168060.5,36.24111668873714,45.952207311467205,NaN,NaN,-103.50335807033402,-207.34095485151124,-0.538818049337632,-0.9052548337794804,-0.36643678444184835,1063872060,1056869709,26.215331298199345,56.31437686426058,NaN,NaN,-24.138643574364547,-2.1362697832398823
2018-10-18T09:30:00-04:00,74.28,74.58,73,73.45,19139368,16551685.85,31.369077475945886,44.35301924187927,NaN,NaN,-123.52679676951384,-159.74846863275923,-0.546511562851626,-1.049576238006381,-0.5030646751547548,1044732692,1061351377,30.266090502824383,53.53342373840214,NaN,NaN,-26.79221057994601,-5.658547039912186
2018-10-19T09:30:00-04:00,73.41,73.89,72.92,73.18,17152370,16651771.1,30.446494909192694,42.22208728068687,NaN,NaN,-115.83737655704299,-130.29089636746508,-0.5353290934958228,-1.1722260420245334,-0.6368969485287106,1027580322,1056520616.6,28.452845452247857,50.73952977018511,NaN,NaN,-29.117774343022596,-9.009865226070815
2018-10-22T09:30:00-04:00,73.29,73.47,72.59,72.93,13675531,16735567.55,29.57903691383244,39.92106332726938,NaN,NaN,-109.83393692669435,-115.15475022234611,-0.5104052507212069,-1.2749035119302192,-0.7644982612090123,1013904791,1045914506.2,24.922500683012387,47.55589014839752,NaN,NaN,-31.209207241588,-12.181199799716127
2018-10-23T09:30:00-04:00,71.24,72.25,70.67,71.73,25139942,17374848.65,25.781932501355115,37.15783608588752,NaN,NaN,-131.83773847354587,-116.90784135942621,-0.5376385941412771,-1.4365465038856087,-0.8989079097443315,988764849,1027770942.8,20.285577356836512,43.74325574804292,NaN,NaN,-34.32840354387366,-15.34508604888149
2018-10-24T09:30:00-04:00,71.95,72.15,69.17,69.3,22170917,17912083.7,20.142944432289596,34.24992166490023,NaN,NaN,-146.4089264879221,-125.48895504294383,-0.6734057739390944,-1.7406651271681994,-1.067259353229105,966593932,1008315317.2,16.697940314789918,39.56253255359955,NaN,NaN,-39.424954477935934,-18.785067253032125
2018-10-25T09:30:00-04:00,69.6,70.31,69.25,69.79,23871513,18680450.5,23.763881484876634,31.978427247552336,NaN,NaN,-138.57259755124142,-128.49811519928932,-0.6822003134966619,-1.9200097450999323,-1.2378094316032704,990465445,997461867.8,15.094185148444794,35.203735311884394,NaN,NaN,-41.95052104427723,-22.094417794638566
2018-10-26T09:30:00-04:00,69.08,69.86,68.12,69.1,34330876,20019726.75,22.23497138107213,29.459138125791476,NaN,NaN,-140.76058137944167,-133.48275616376904,-0.6846998085200173,-2.093684192253292,-1.4089843837332747,956134569,983172717.2,13.285084254945218,30.703396193217568,NaN,NaN,-44.48026456090676,-25.29239590410545
2018-10-29T09:30:00-04:00,70.06,70.22,66.99,67.95,23645624,20360401.4,19.93313897188797,27.691001468401854,NaN,NaN,-141.40134472450634,-139.79623772333144,-0.7109182199172281,-2.29763215862981,-1.5867139387125817,932488945,966889548,11.581597406472184,26.497247457468898,NaN,NaN,-47.38714328005052,-28.448788386383317
2018-10-30T09:30:00-04:00,67.88,69.43,67.61,69.35,23445831,21106491.1,29.501389959268195,27.661555714218256,NaN,NaN,-121.53914524850202,-137.7365190783227,-0.5862734069742908,-2.319555697430445,-1.7332822904561545,955934776,960323533.4,10.970715827263618,23.35265299103404,NaN,NaN,-46.353647081152225,-31.006625342778875
2018-10-31T09:30:00-04:00,70.01,70.74,69.84,69.88,14205471,21290020.1,32.776553913589865,28.3364047588036,NaN,NaN,-81.63822664733351,-124.78237911020497,-0.4277896666175065,-2.2680193737280376,-1.8402297071105311,970140247,961032796.4,11.513659707961097,21.35761927081237,NaN,NaN,-44.411522243852914,-32.92161061436088
2018-11-01T09:30:00-04:00,70.17,71.35,70.019,71.11,22653848,21796660.8,39.76982756596246,29.20872383276435,NaN,NaN,-58.17759139031447,-108.7033778780196,-0.21075693782260574,-2.1036758793887884,-1.8929189415661827,992794095,961498526.4,11.89362243824111,19.815775850653917,NaN,NaN,-40.33666836600274,-33.980904578881145
2018-11-02T09:30:00-04:00,71.75,71.93,70.55,70.99,23216442,22249205.9,39.33984268259996,29.96398259929607,NaN,NaN,-42.755685844655524,-89.10239877106235,-0.05407754009091592,-1.9605158666798275,-1.9064383265889115,969577653,964187143.2,14.184541115069408,18.744718247589525,NaN,NaN,-37.33285355851543,-34.45975443311461
2018-11-05T09:30:00-05:00,71.06,71.64,70.86,71.36,17524352,22657440.15,41.44211991577973,30.165880628313566,NaN,NaN,-32.11116939148137,-67.24436370445736,0.08795407496244212,-1.7964957328858588,-1.884449807848301,987102005,975109755.2,22.949684598583588,18.4509554360637,NaN,NaN,-34.25170797541127,-34.43003351058556
2018-11-06T09:30:00-05:00,71.29,72.16,71.19,72.11,15588995,22856544.7,45.56066204271937,30.8315624393123,NaN,NaN,-7.85467070050236,-44.50746879485742,0.23740945877311992,-1.5876879843819012,-1.825097443155021,1002691000,984461000,29.58115731134005,18.691371579859467,NaN,NaN,-30.36904268966109,-33.84989196473921
2018-11-07T09:30:00-05:00,72.79,73.34,72,73.28,14217774,21864913.35,51.313427285582875,32.25615885428637,NaN,NaN,36.946718807470624,-20.79047970389659,0.409945533459783,-1.3126655263302922,-1.7226110597900752,1016908774,993814705.4,35.55588070054809,19.069213736839725,NaN,NaN,-25.136348883382375,-32.605100095973945
2018-11-08T09:30:00-05:00,73.12,73.54,72.86,73.16,11967438,19735760.6,50.72140890175622,33.704366996612336,NaN,NaN,51.732915517975634,1.1916216777614281,0.5046443767838067,-1.0918055888103169,-1.5964499655941236,1004941336,996244153.6,37.04982532313451,19.683283727617347,NaN,NaN,-21.143974662982746,-30.96779646268949
2018-11-09T09:30:00-05:00,72.65,72.9,71.91,72.42,23409062,19435725.1,47.11173147704612,34.956702322556175,NaN,NaN,25.87326734005054,14.917412314702649,0.504874943417319,-0.9653562863224749,-1.470231229739794,981532274,998635077.8,38.55938269884184,20.657346728748028,NaN,NaN,-18.809092345927905,-29.230838731723548
2018-11-12T09:30:00-05:00,72.37,72.42,70.875,70.99,10822335,19216780.9,41.034384780334904,36.04616319962616,NaN,NaN,-8.872259431120224,19.565194306774877,0.4006976375360285,-0.9693591828197583,-1.3700568203557868,970709939,995356664.6,37.24066252878042,21.868424241029736,NaN,NaN,-18.635530444263217,-27.717223262086357
2018-11-13T09:30:00-05:00,71.06,72.225,70.86,71.31,16032159,19391022.7,42.81220135192426,37.66539583674292,NaN,NaN,0.1564272347133744,21.16741389381802,0.34730828711035566,-0.9359214614678422,-1.2832297485781978,986742098,992166884.2,35.95232019364681,23.243737089519517,NaN,NaN,-17.95419807533648,-26.322505378264946
2018-11-14T09:30:00-05:00,71.79,72.27,70.6,71.07,18374116,19529198.2,41.7944248591237,38.95329179204628,NaN,NaN,1.6583516301329733,14.109740458350462,0.292021123631631,-0.918203344038659,-1.21022446767029,968367982,982458725.8,32.2908605600809,24.472071047493525,NaN,NaN,-17.695374614952755,-25.090058126363203
2018-11-15T09:30:00-05:00,70.53,72.39,70.27,72.01,24411606,19792810.1,47.09899364853395,40.72929338257927,NaN,NaN,22.794841415418745,8.322125637839083,0.313081960259572,-0.818872017345825,-1.131953977605397,992779588,980026376.2,31.427270148138746,25.767941468435914,NaN,NaN,-15.881186177648358,-23.77450499083251
2018-11-16T09:30:00-05:00,71.8,72.34,71.36,71.99,15156011,19692992.15,47.000846427968554,42.66270105801359,NaN,NaN,49.90640117104612,13.128752404038199,0.31891366600803384,-0.7333118950953548,-1.0522255611033886,977623577,979244636.8,31.13903033615503,27.164900963413263,NaN,NaN,-14.445098291350222,-22.441732605192186
2018-11-19T09:30:00-05:00,71.87,71.95,70.57,70.85,14365307,19727480.95,41.6705087851149,43.53192383128835,NaN,NaN,7.47092692320229,16.3973896749027,0.2426916876765326,-0.7488609515077229,-0.9915526391842555,963258270,977754303,30.563515079580043,28.56438662429301,NaN,NaN,-14.730904501863115,-21.340185733288035
2018-11-20T09:30:00-05:00,69.68,70.06,69.08,69.38,18024908,19371729.25,36.00082699761214,43.762229051575666,NaN,NaN,-88.31215955735978,-1.2963276835119308,0.09742275935519107,-0.8697741899902667,-0.9671969493454577,945233362,969452555.8,27.513081154785013,29.70720244192329,NaN,NaN,-16.800053471785244,-20.69159541021621
2018-11-21T09:30:00-05:00,69.91,70.42,69.74,69.87,10846049,18805485.85,38.98111070299969,43.705892132792606,NaN,NaN,-55.404819542030175,-12.70896191794456,0.04135235261752046,-0.9155065085735572,-0.9568588611910777,956079411,966994841.6,26.66460425705823,30.762272571838796,NaN,NaN,-17.5835938003339,-20.247595180233024
2018-11-23T09:30:00-05:00,69.35,70.205,69.34,69.73,6205521,17922186.25,38.4304609123634,43.64093629206143,NaN,NaN,-70.88910708145963,-31.445751617320234,0.0038297759376274554,-0.9520716412690433,-0.9559014172066708,949873890,958413702,23.89392324271229,31.45579986667043,NaN,NaN,-18.37828162834418,-19.980550387106046
2018-11-26T09:30:00-05:00,70.27,70.66,69.73,70.24,12896350,16850459.95,41.663341349058065,43.656737823009884,NaN,NaN,-49.793258267457254,-51.385683505020914,0.021372367926900115,-0.9291859572980457,-0.9505583252249458,962770240,955443034.6,23.00282357585587,31.459595507904165,NaN,NaN,-18.11591503199893,-19.71417390780503
2018-11-27T09:30:00-05:00,69.91,70.2,69.43,70.12,14442513,16390304.4,41.11628338519036,43.33928220461495,NaN,NaN,-81.91084606857014,-69.26203810337539,0.03225528903375274,-0.9102392139327549,-0.9424945029665076,948327727,952456926,22.110201212471694,30.925955786556422,NaN,NaN,-18.052071479462047,-19.476730703756033
2018-11-28T09:30:00-05:00,70.5,71.8,69.98,71.8,14139681,15924996.9,50.84694710089853,43.30596219142321,NaN,NaN,3.342587962078148,-50.93108859948781,0.15319183528668823,-0.7510047088581473,-0.9041965441448355,962467408,955903735.2,25.69449762886272,30.22157128143604,NaN,NaN,-14.988647626732865,-18.83557597846701
2018-11-29T09:30:00-05:00,71.64,72.18,71.13,71.84,12997957,15864621.2,51.05434140255123,43.329743084337146,NaN,NaN,43.63730361258976,-31.122663968563824,0.23175804425429536,-0.6144989888269663,-0.8462570330812617,975465365,959780926,29.617962638634594,29.690723946828903,NaN,NaN,-12.473009736096746,-17.926637943842685
2018-11-30T09:30:00-05:00,71.76,72.6464,71.6,72.54,16428124,15553335,54.659738272386036,43.86888642686142,NaN,NaN,84.23314639973829,-0.09821327232423868,0.32124021081969256,-0.444706769556646,-0.7659469803763386,991893489,968184845.8,37.34089775745275,29.603689308158255,NaN,NaN,-9.230081343159167,-16.684272715173613
2018-12-03T09:30:00-05:00,73.91,74.46,73.07,73.38,19558093,15370417.55,58.600663632786784,45.12362063060799,NaN,NaN,172.4054648776536,44.34153135669793,0.4210757866103313,-0.23960224711342448,-0.6606780337237558,1011451582,977921114.2,44.88619371413037,30.149798678540396,NaN,NaN,-5.207836259877312,-15.044781792988427
2018-12-04T09:30:00-05:00,73.14,73.14,70.16,70.26,20580524,15523226.15,43.482767544298106,45.171518215777546,NaN,NaN,-18.37513361389108,57.04867384763374,0.2684894672605428,-0.32506619964807726,-0.59355566690862,990871058,986429780.4,50.49644287986612,31.18866458469892,NaN,NaN,-6.557390449045271,-13.832297315282263
2018-12-06T09:30:00-05:00,68.96,69.88,67.8,69.87,28326215,16160087.15,42.02336745407919,45.18787125827437,NaN,NaN,-147.38275016430964,26.90360622235619,0.1392991016752425,-0.41943178981456697,-0.5587308914898095,962544843,986445267.4,50.50631844594948,32.48976871940382,NaN,NaN,-8.104947141663912,-13.014104433336785
2018-12-07T09:30:00-05:00,69.7,70.5,67.8,68.03,19238288,16411112.85,35.90121383542288,44.38802984305215,NaN,NaN,-150.31007850291337,-11.885870200744435,-0.06130786427012769,-0.6353657218274691,-0.5740578575573414,943306555,980013505.4,46.369159843626065,33.55704655479577,NaN,NaN,-11.676113342942292,-12.822962848994715
2018-12-10T09:30:00-05:00,67.96,68.44,66.7,68.2,25360052,17080743.55,36.81707341438879,43.6606174849393,NaN,NaN,-177.72225402255333,-64.27695028520276,-0.16774798581208827,-0.7837428398224517,-0.6159948540103635,968666607,975368129,43.59177153148718,34.446528068748066,NaN,NaN,-14.103625482832651,-13.005914653828706
2018-12-11T09:30:00-05:00,69.3,69.44,67.39,67.8,18475738,16834077.35,35.530666990183065,43.222057356729884,NaN,NaN,-131.96303822779856,-125.15065090629318,-0.24558012332619517,-0.9229700081681074,-0.6773898848419122,950190869,963115986.4,37.253756497541886,34.924402455745344,NaN,NaN,-16.4585740057352,-13.499151704101061
2018-12-12T09:30:00-05:00,68.7,69.2,68.13,68.18,14776421,17031781.65,37.75570175206905,43.34740555347681,NaN,NaN,-102.34185423814229,-141.94399503114343,-0.25106373686582173,-0.9912195559241894,-0.7401558190583677,964967290,957935232.8,34.940401836789135,35.454925361602776,NaN,NaN,-17.692463656240356,-14.098196268692389
2018-12-13T09:30:00-05:00,68.7,68.81,67.72,67.99,15917813,17026064.35,37.066852765257615,43.210672843638086,NaN,NaN,-106.99311727750408,-133.86606845378233,-0.24671708045384955,-1.0485521696256797,-0.8018350891718301,949049477,955236159.6,33.76406084472734,35.962029403579145,NaN,NaN,-18.89658053016196,-14.783679734616614
2018-12-14T09:30:00-05:00,67.26,67.935,66.83,67.05,14806200,16847668.55,33.78289697417647,42.87870399091046,NaN,NaN,-134.95964276542333,-130.79598130628432,-0.28373778992298737,-1.1565073265755643,-0.872769536652577,934243277,953423504,32.961464544588054,36.6097109251417,NaN,NaN,-20.93683757271341,-15.662702282916156
2018-12-17T09:30:00-05:00,66.88,67.3,65.54,65.95,19796763,16616926.4,30.389851488217218,42.07345471513611,NaN,NaN,-159.9349902739615,-127.23852855656597,-0.3543102065364845,-1.3156572948231826,-0.9613470882866981,914446514,942579485.4,28.583978276529905,37.008364832332695,NaN,NaN,-23.782151345474958,-16.822623577567413
2018-12-18T09:30:00-05:00,66.63,67.141,65.9,66.28,15665189,16642385.3,32.577627039234216,41.463550690424945,NaN,NaN,-134.4238389738947,-127.7306887057852,-0.35014585659968334,-1.3990294090363022,-1.048883552436619,930111703,938563652.2,27.14618266142766,37.368077792972414,NaN,NaN,-25.465066494314343,-18.057258279959832
2018-12-19T09:30:00-05:00,66.2,67.6,64.59,65.03,23553264,17101783.15,28.875581930961744,39.89416746400089,NaN,NaN,-143.07234848714282,-135.87678755558528,-0.3993901069833572,-1.5481211861658153,-1.148731079182458,906558439,926881882,23.45087053665634,37.20781871495767,NaN,NaN,-28.118060471796376,-19.49451573593648
2018-12-20T09:30:00-05:00,64.6,65.18,63.13,63.84,25709873,17486031.4,25.86247853991334,38.094748688098186,NaN,NaN,-174.80015329259405,-149.4381947586033,-0.474789017702832,-1.7422173513109982,-1.2674283336081662,880848566,913241699.8,20.02338214866535,36.522491537102724,NaN,NaN,-31.396504841984964,-21.194799893943408
2018-12-21T09:30:00-05:00,63.61,64.22,62.11,62.25,28766269,18382042.4,22.486227469870016,35.79664077363275,NaN,NaN,-181.64770006074284,-158.7758062176672,-0.5870735526458586,-2.0012702744154893,-1.4141967217696307,852082297,896809503.8,16.83178964542718,35.05755524338661,NaN,NaN,-35.43119722293248,-23.228570940941847
2018-12-24T09:30:00-05:00,61.67,61.95,60.29,60.34,15800225,18861777.6,19.237366435492362,32.98497668811172,NaN,NaN,-200.30479221272344,-166.84976660541957,-0.7356747344382231,-2.3337901398174097,-1.5981154053791866,836282072,881176615.4,14.468944988911943,32.88489462015672,NaN,NaN,-40.134323221586705,-25.643678409605396
2018-12-26T09:30:00-05:00,60.58,63.22,59.92,63.15,17549022,19094411.2,34.28129235658669,32.327728460418044,NaN,NaN,-141.5364396761355,-168.27228674586775,-0.5963524426531674,-2.343555958695646,-1.7472035160424784,853831094,865920493.6,12.608719981912458,30.178628698874316,NaN,NaN,-38.55042016471539,-27.487498660335394
2018-12-27T09:30:00-05:00,62.22,63.97,61.53,63.94,13980668,19071318.95,37.789764357872336,32.02532823926041,NaN,NaN,-101.14690358349056,-159.8871977651373,-0.41142127345411583,-2.261480107860123,-1.8500588344060074,867811762,858171158.2,11.780229794231829,27.412479509465914,NaN,NaN,-36.0467616443643,-28.710250515196666
2018-12-28T09:30:00-05:00,64.17,64.7,63.55,63.77,15917228,19160196.3,37.32794766530319,32.12723779853757,NaN,NaN,-72.52470402983431,-139.43210791258534,-0.26792498591723213,-2.1849650668025475,-1.9170400808853154,851894534,852380351.8,11.188598251552392,24.89958225288922,NaN,NaN,-34.30111222425349,-29.508945045061925
2018-12-31T09:30:00-05:00,64.15,64.54,63.73,64.41,10068931,19013745,40.28652888422077,32.37505604638271,NaN,NaN,-60.45415853832119,-115.193399608101,-0.10561862905733443,-2.0490633672069833,-1.943444738149649,861963465,854356585.4,12.798158111507234,22.700038437176367,NaN,NaN,-31.93060051799037,-29.854895826908844
2019-01-02T09:30:00-05:00,63.46,64.79,63.09,64.74,14702051,18927441.35,41.81185511890048,32.8237123412911,NaN,NaN,-54.77878920721821,-86.08819900699999,0.04042639785409219,-1.8929117408320337,-1.933338138686126,876665516,862433274.2,19.240060598546847,21.413345872962434,NaN,NaN,-29.558367464058954,-29.812534632216003
2019-01-03T09:30:00-05:00,64.29,64.29,62.49,62.77,25976240,19248348.7,35.91403416861742,32.69216465675884,NaN,NaN,-73.81909877480697,-72.54473082673427,0.02175044983072305,-1.9061500763977222,-1.9279005262284452,850689276,861804910.6,19.121708074353634,20.283439175645615,NaN,NaN,-29.346878488308054,-29.74601232594344
2019-01-04T09:30:00-05:00,63.69,65.27,63.69,65.15,19883639,19213504.45,45.85146797005304,33.319637171387086,NaN,NaN,-24.208693135721074,-57.157088737180366,0.17836687388172856,-1.7049419338762846,-1.8833088077580131,870572915,862357141.2,19.58984845301005,19.27099543338009,NaN,NaN,-25.654600021829793,-29.161524853927205
2019-01-07T09:30:00-05:00,65.42,66.105,64.8,65.68,15209099,18557648.65,47.79290986971145,34.32035237821102,NaN,NaN,7.691677750384842,-41.11381238113654,0.31817385677809407,-1.4855914867853954,-1.8037653435634895,885782014,869134637.2,25.30428366461304,18.724053941953308,NaN,NaN,-22.10748798550052,-28.15380530129482
2019-01-08T09:30:00-05:00,66.58,66.99,65.95,66.58,23069774,18749222.95,51.00536840324426,35.79288930071295,NaN,NaN,47.42622710095648,-19.537735253281006,0.4630034475811886,-1.2250110340870037,-1.6880144816681923,908851788,878512301.8,32.456730242378626,19.00067908237107,NaN,NaN,-18.15437921721906,-26.72531586071257
2019-01-09T09:30:00-05:00,66.84,67.34,66.6,67.03,10036734,17983057.05,52.576653278089736,37.22139117491692,NaN,NaN,67.66978072955328,4.95197873407331,0.5736156780157231,-0.9709948841485385,-1.5446105621642616,918888522,886956903,38.195854946815054,19.78994138847017,NaN,NaN,-14.483893948335872,-24.976541301801614
2019-01-10T09:30:00-05:00,66.79,68.02,66.49,67.94,8900490,17504294.65,55.672591843565826,39.135463311531495,NaN,NaN,88.91242739256784,37.49828396754826,0.6850313931696712,-0.6883213207021726,-1.3733527138718438,927789012,902376850.2,47.044260909695495,21.475183557972965,NaN,NaN,-10.439747972627732,-22.899856540491058
2019-01-11T09:30:00-05:00,67.48,67.905,67.24,67.87,10691276,17300037.4,55.3731306550485,41.24336703404115,NaN,NaN,99.86882434620006,62.313787463932485,0.7270074854316062,-0.46459335708233596,-1.1916008425139422,917097736,911681814.4,51.55181979368227,23.727214818331316,NaN,NaN,-7.28791868665646,-20.669579704228973
2019-01-14T09:30:00-05:00,67.37,68.165,67.16,67.86,10105477,17009420.6,55.327345406068936,43.58916117234107,NaN,NaN,104.23428065842765,81.62230804554106,0.7254317739265557,-0.28481112510574746,-1.0102428990323031,906992259,915923863.4,53.49526030059672,26.346034150843423,NaN,NaN,-4.737003342360414,-18.39349736681918
2019-01-15T09:30:00-05:00,67.8,68.09,67.27,67.65,12517456,16894983.4,54.31174185280293,46.09447370214897,NaN,NaN,100.02883340061025,92.1428293054718,0.6822242984437683,-0.1574625259775928,-0.8396868244213611,894474803,913048466.4,51.97337637311577,29.024922106857982,NaN,NaN,-2.866938047210298,-16.17541746401791
2019-01-16T09:30:00-05:00,67.74,68.06,67.62,67.72,12029894,16506639.95,54.61083057864056,47.546583575152816,NaN,NaN,97.74210965493407,98.15729509054796,0.6315018657958242,-0.05030949217658076,-0.681811357972405,906504697,910571701.4,50.63706872888925,31.74123273164204,NaN,NaN,-1.2211959067677958,-14.039100098696467
2019-01-17T09:30:00-05:00,67.44,69.26,67.35,68.88,22922580,16869509.5,59.35878711408922,49.08722805773973,NaN,NaN,113.17802453008082,103.01041451805057,0.6468500903893284,0.12675125501425555,-0.5200988353750728,929427277,910899354.4,50.8172263212249,34.52958962642726,NaN,NaN,1.5867837878015287,-11.806830972053897
2019-01-18T09:30:00-05:00,69.48,70.44,69.27,70.19,20020208,16692856.7,63.94559754038503,50.98848876310273,NaN,NaN,141.40883364050944,111.31841637691245,0.7109038910178411,0.3685310283972285,-0.34237286262061256,949447485,917369304.2,54.35943456904116,37.61322079196217,NaN,NaN,5.479979734269613,-9.337286585436253
2019-01-22T09:30:00-05:00,69.59,69.61,68.28,68.74,15935259,16204126,56.36297513295914,52.13680635229832,NaN,NaN,95.44378920482157,109.56031808619123,0.6243705511429924,0.43809032630812794,-0.18628022483486445,933512226,922673297.6,57.08795394569401,40.776777637261226,NaN,NaN,6.702361967971214,-7.045908220663758
2019-01-23T09:30:00-05:00,69.19,69.55,68.07,68.84,13243826,15428003.85,56.74392912525458,53.203383067037905,NaN,NaN,85.39610359312228,106.63377212469365,0.5454826417583071,0.49557307736301937,-0.04990956439528768,946756052,933129547.4,61.920983071210536,43.8254149567372,NaN,NaN,7.800238119612281,-4.925030172052896
2019-01-24T09:30:00-05:00,69.09,69.5,68.8,69.19,10361834,15156084.3,58.12195239132778,54.78966294008865,NaN,NaN,90.70442512905862,105.22623521951857,0.4902333253283433,0.5628820922651414,0.07264876693679814,957117886,943252185.2,65.92238199813183,47.16832023700707,NaN,NaN,9.105300426201014,-2.9206972294451945
2019-01-25T09:30:00-05:00,69.85,70.36,69.66,70.07,13065935,14931929.95,61.44748709541474,55.90366430618591,NaN,NaN,113.1304790850464,105.21672613051169,0.4854025023801082,0.6794018949119334,0.1939993925318252,970183821,951403494,68.76840628417011,50.68107436780422,NaN,NaN,11.202273785185463,-0.903129941640815
2019-01-28T09:30:00-05:00,69.07,69.435,68.78,69.4,13143954,14890094.25,57.6911783487795,56.6106834832622,NaN,NaN,79.44525676813187,92.82401075603616,0.4124025446920402,0.7095025733968754,0.2971000287048352,957039867,952921970.4,69.28305719340665,53.822415334146626,NaN,NaN,11.927546098268525,0.9298237783462335
2019-01-29T09:30:00-05:00,69.7,70.49,69.68,70.36,12384037,14713434.7,61.33806184856609,57.3487330150709,NaN,NaN,110.59815335206696,95.85488358548523,0.4035851156163724,0.8015814232253007,0.3979963076089283,969423904,960104306,71.66172775130417,56.62277229906988,NaN,NaN,13.629827289608865,2.7441099942408953
2019-01-30T09:30:00-05:00,71.09,71.795,70.29,71.46,16892656,15054620.95,65.05497528965493,58.2400417301827,NaN,NaN,141.97742757580366,107.17114838202151,0.44347289707409865,0.9523374289515516,0.508864531877453,986316560,968016407.6,74.0460784855916,59.18350255183963,NaN,NaN,16.250471658032435,4.673590231925401
2019-01-31T09:30:00-05:00,71.59,72.11,71.3,71.77,13867112,15012874,66.04568737476148,58.980977125268105,NaN,NaN,147.4751634323351,118.52529604267679,0.4603704586482509,1.0843276051877666,0.6239571465395157,1000183672,976629564.8,76.3763131094511,61.278649137536455,NaN,NaN,18.69696371198784,6.6769293005057495
2019-02-01T09:30:00-05:00,71.98,72.41,71.685,71.88,11844953,14306309.65,66.4095965483856,59.769296117649326,NaN,NaN,148.59656777195798,125.61851378005913,0.4481595875321842,1.184156630954746,0.7359970434225618,1012028625,984998525.6,78.40512252447039,63.19674218973561,NaN,NaN,20.80616931370643,8.695392159534418
2019-02-04T09:30:00-05:00,71.98,72.85,71.79,72.81,7688416,13696548.5,69.39601705277215,60.774201235270986,NaN,NaN,154.37415437415197,140.60429330126314,0.46965326674848806,1.323063626858172,0.8534103601096839,1019717041,997533960.4,81.03267932272627,65.1637006913163,NaN,NaN,23.53818307574826,10.815790861850681
2019-02-05T09:30:00-05:00,72.93,73.48,72.7,73.44,9079205,13390053.8,71.2600921078843,61.984797682062506,NaN,NaN,161.40590044742459,150.76584272033466,0.49092983702501614,1.467072656390954,0.9761428193659378,1028796246,1009408428.8,83.12704269094672,67.38896257116136,NaN,NaN,26.42346560286982,13.045458681996273
2019-02-06T09:30:00-05:00,73.32,73.81,73.21,73.46,15557618,13014446,71.31981509482102,63.178296576075404,NaN,NaN,149.46176588172938,152.2627103815198,0.4709072713201823,1.5647769085161656,1.0938696371959833,1044353864,1021015889.6,84.88410675088522,69.8351795727325,NaN,NaN,28.80253617761227,15.296469752798558
2019-02-07T09:30:00-05:00,72.99,73.38,72.395,72.96,15611371,13293177.85,67.5410602747902,63.76274465898261,NaN,NaN,112.9290673399015,145.35349116303308,0.39179034514815747,1.5836075686311801,1.1918172234830227,1028742493,1026727653.8,85.67463917130186,72.32499477630942,NaN,NaN,29.8288146961905,17.372519030425977
2019-02-08T09:30:00-05:00,72.5,73.07,72.15,73.07,15977037,13647005.2,67.94346442861675,64.04830657957059,NaN,NaN,94.44412902085989,134.52300341281347,0.3178174641689153,1.5890890536941669,1.2712715895252515,1044719530,1033265834.8,86.54225884748892,74.6237679390557,NaN,NaN,30.794455359989314,19.28993850607788
2019-02-11T09:30:00-05:00,73.28,73.64,73.235,73.46,7909836,13507933.2,69.3922882997118,64.9789718057672,NaN,NaN,105.84114361450104,124.81640126088328,0.26809112729534146,1.6063854986444284,1.338294371349087,1052629366,1039848299.8,87.37151979441585,76.78687978539298,NaN,NaN,32.012471441625095,21.107443211156056
2019-02-12T09:30:00-05:00,74.02,74.755,73.87,74.6,8909762,13448147.45,73.20456755365743,66.15473169351027,NaN,NaN,125.37872037069843,117.61096524553804,0.28342100523626,1.692570627894412,1.409149622658152,1061539128,1046396876.2,88.15359521025074,78.66063779532442,NaN,NaN,34.219967990432096,22.980661036766918
2019-02-13T09:30:00-05:00,74.87,75.27,74.67,75.04,8134248,13228987.05,74.52351029019925,67.32627154342967,NaN,NaN,132.11928335690575,114.1424687405733,0.29340490226802274,1.7759057504931803,1.4825008482251576,1069673376,1051460778.6,88.73458417645719,80.29008080806194,NaN,NaN,36.47810878827662,24.90886785841116
2019-02-14T09:30:00-05:00,74.61,75,74.4115,74.69,11703773,13212681,71.50827289776406,68.04489910074032,NaN,NaN,111.64735222753578,113.88612571810017,0.24842998611684375,1.7930383308712123,1.5446083447543686,1057969603,1057306200.6,89.38193811548807,81.76247593887037,NaN,NaN,37.56005279285717,26.71617999190345
2019-02-15T09:30:00-05:00,75.15,75.7,74.99,75.69,9593226,12546213.3,74.66260107293873,69.25714358103743,NaN,NaN,127.13201880944132,120.42370367581645,0.2569532339771716,1.8657998872258332,1.6088466532486616,1067562829,1061874860.4,89.8718116431633,83.23310125671013,NaN,NaN,39.45388083469635,28.535851540873864
2019-02-19T09:30:00-05:00,75.46,75.9,75.22,75.66,7994791,11944942.45,74.39650005116181,70.1898891669371,NaN,NaN,118.50669641840676,122.95681423659762,0.2322434497426915,1.899150965427026,1.6669075156843345,1059568038,1063262594.8,90.02239167611462,84.54457725133945,NaN,NaN,40.925919268971796,30.305861216316426
2019-02-20T09:30:00-05:00,75.63,76.06,75.54,76.02,8911369,11593747.95,75.52383439757378,70.93766481750275,NaN,NaN,118.92613437003001,121.66629703646393,0.21235873163146413,1.9323559302236646,1.7199971985922005,1068479407,1064650650.6,90.17966218801647,85.69697608722694,NaN,NaN,42.49474961086397,32.047130986966074
2019-02-21T09:30:00-05:00,75.84,76.028,75.46,75.71,6782680,11270690.65,72.561044832931,71.40304749308629,NaN,NaN,106.05512216557264,116.4534647981973,0.1532988180075756,1.91162072110167,1.7583219030940944,1061696727,1063055320.8,88.45395799011129,86.5596650072741,NaN,NaN,43.02771524828955,33.61578588144086
2019-02-22T09:30:00-05:00,75.98,76.25,75.68,76.21,9816903,11243444.1,74.31149065182272,71.96746850047465,NaN,NaN,108.62036633906997,115.84806762050414,0.12412357772695204,1.9134763752527846,1.7893527975258325,1071513630,1065764126.2,88.84431849437031,87.30532186226695,NaN,NaN,43.96848778324008,35.094743295983605
2019-02-25T09:30:00-05:00,77,77.13,76.48,76.51,10108504,11095572.55,75.32847221658136,72.39121529788959,NaN,NaN,121.13617091284647,114.64889804118518,0.10216245053609652,1.9170558606959531,1.8148934101598566,1081622134,1068575987.2,89.25059155615115,87.89231559322586,NaN,NaN,45.04708786570586,36.516506805943926
2019-02-26T09:30:00-05:00,76.31,76.76,76.28,76.3,11731052,11024927.45,73.14551803650224,72.52588857850516,NaN,NaN,101.47237610982188,111.24203397946819,0.05309437080855828,1.8812613736705543,1.828167002861996,1069891082,1070640596,89.55147986519368,88.35120396281494,NaN,NaN,45.380151113268546,37.7827417069903
2019-02-27T09:30:00-05:00,76.17,76.67,75.89,76.6,8033257,10807388.45,74.29167951808653,72.73816460873842,NaN,NaN,91.93041299508423,105.84288970447903,0.022034403936487035,1.855710007782605,1.833675603846118,1077924339,1072529582.4,89.8319170316349,88.7046189828685,NaN,NaN,45.96752707873145,38.95199676009618
2019-02-28T09:30:00-05:00,76.61,76.65,76.29,76.34,8531259,10389318.6,71.44563614493961,73.01706288517765,NaN,NaN,87.18168784496018,102.06820284035655,-0.03189832448684937,1.7938026982375561,1.8257010227244055,1069393080,1074068853,90.06589783884948,89.01828031626475,NaN,NaN,45.719743742092426,39.91881775752422
2019-03-01T09:30:00-05:00,76.91,77.1,76.005,76.41,12786614,10335293.7,71.75931549699649,73.28962367577621,NaN,NaN,84.5903919417557,97.26220796089369,-0.07620748219424311,1.7304416699816016,1.8066491521758448,1082179694,1076202065.8,90.39574204469378,89.29352911606509,NaN,NaN,45.58801414895801,40.728702956300474
2019-03-04T09:30:00-05:00,76.77,77.095,75.48,76.07,19150433,10700567.7,67.85996193695752,73.18017179272235,NaN,NaN,65.30113117970971,86.09520001426634,-0.13815356285012492,1.6339571986131887,1.7721107614633136,1063029261,1072483491.2,85.09184392417964,89.13069512533393,NaN,NaN,44.452770932572236,41.26071266719644
2019-03-05T09:30:00-05:00,76.11,76.2755,75.56,75.58,13820552,11007174.5,62.58200719071575,72.42141748108364,NaN,NaN,38.2115615726074,73.44303710682344,-0.21716457887443164,1.500655037870274,1.7178196167447057,1049208709,1068347016.6,79.50363383392275,88.5128407413105,NaN,NaN,42.00035295466912,41.36637556540682
2019-03-06T09:30:00-05:00,75.47,75.61,74.85,74.87,18468355,11476632,55.808698106635696,71.08464518225767,NaN,NaN,-9.241226562800975,53.2087091952464,-0.31627460180219513,1.322476364491962,1.638750966294157,1030740354,1058910219.6,68.4580593583865,87.06451754001975,NaN,NaN,37.80072431725936,40.856996815671465
2019-03-07T09:30:00-05:00,74.68,74.795,73.77,74.42,19104699,11653986.05,51.969514240521214,69.68901956388319,NaN,NaN,-66.41192029422206,22.48998756740995,-0.40547333531526664,1.1319092971500737,1.5373826324653403,1011635655,1047358734.6,57.86100440660131,84.81302227509926,NaN,NaN,33.015115386814415,39.73672804012046
2019-03-08T09:30:00-05:00,73.71,74.3,73.61,74.27,14463285,11596581.75,50.71708068101732,67.97862525017452,NaN,NaN,-95.6457819864246,-13.55724721822611,-0.4637144647368152,0.9577395515443214,1.4214540162811367,997172370,1030357269.8,46.46147756860771,81.71228412691673,NaN,NaN,28.651994554764755,38.15319468506964
2019-03-11T09:30:00-04:00,73.21,74.93,73.04,74.9,15298295,11562644.65,55.56107431562833,66.63323769763642,NaN,NaN,-93.8095336345714,-45.37938018108233,-0.4486641945763761,0.8606237730606665,1.3092879676370426,1012470665,1020245550.6,41.25545994458578,78.22893186037894,NaN,NaN,26.10374393187895,36.43184457747097
2019-03-12T09:30:00-04:00,74.8,74.89,74.14,74.28,17995791,12066942.4,50.31930837425317,64.83291441025638,NaN,NaN,-92.41870302666847,-71.50543310093751,-0.467214738396702,0.725269544641165,1.192484283037867,994474874,1009298783.6,36.488765203814665,74.39386779007882,NaN,NaN,22.267296922456133,34.408337769611705
2019-03-13T09:30:00-04:00,74.55,75.18,74.46,74.93,13387866,12290847.6,55.10168110010383,63.585817000768714,NaN,NaN,-59.014133057568905,-81.4600143998911,-0.42373986135879393,0.6628094563393745,1.0865493176981684,1007862740,1004723260.8,34.68485338799859,70.55321746135648,NaN,NaN,20.357728792285076,32.401107915707904
2019-03-14T09:30:00-04:00,74.92,75.11,74.49,74.68,9636528,12365961.6,52.9889115838806,62.06277563877285,NaN,NaN,-65.66557525121566,-81.3107453912898,-0.40013778563028135,0.5863770856603168,0.9865148712905981,998226212,1002041372.2,33.63522593905125,66.60971085026226,NaN,NaN,18.143044773634724,30.36424175255459
2019-03-15T09:30:00-04:00,74.34,74.52,73.85,73.99,24900046,13025775.25,47.56773547964816,60.07986587184905,NaN,NaN,-115.80990548073478,-85.34357009015184,-0.4173966336994025,0.464769079166345,0.8821657128657475,973326166,997272131.4,31.792690706031706,62.50557507525373,NaN,NaN,14.50526651258284,28.098673861130056
2019-03-18T09:30:00-04:00,73.88,74.77,73.8,74.71,10313893,13061808.6,52.974193754093065,58.6390569945341,NaN,NaN,-78.98640043351298,-82.37894344994015,-0.3684273425207878,0.4216315347147628,0.7900588772355506,983640059,991506010.2,29.676051812782944,58.228758785795826,NaN,NaN,13.047534329440422,25.948511070888678
2019-03-19T09:30:00-04:00,74.96,75.22,74.155,74.44,10778218,13200979.95,50.85643678291762,56.96511108487918,NaN,NaN,-58.4521299166584,-75.58562882793815,-0.34285435461616665,0.36149093396534226,0.7043452885815089,972861841,987183403.6,28.162367608487102,53.8237909698567,NaN,NaN,11.201113578573713,23.84174000055797
2019-03-20T09:30:00-04:00,74.25,74.53,73.52,73.93,11259449,13318383.95,47.03176528441555,55.22126316627032,NaN,NaN,-95.04309464164338,-82.79142114475304,-0.34782109951504625,0.2695689141877011,0.6173900137027474,961602392,977931334,25.199581199640264,49.1904826384846,NaN,NaN,8.442190083653367,21.641804298143025
2019-03-21T09:30:00-04:00,73.71,74.8,73.65,74.64,10638633,13511181.6,52.39885068540994,53.83837282258556,NaN,NaN,-61.67816356392954,-81.99393880729582,-0.29301888780713736,0.2511164039438256,0.544135291750963,972241025,972734296.6,23.691824320384512,44.42591708674822,NaN,NaN,7.749970376050361,19.65725659498693
2019-03-22T09:30:00-04:00,74.22,74.27,72.9,72.95,18004399,13920556.4,41.595027626961425,51.962306086157284,NaN,NaN,-123.40706395147045,-83.51337050144295,-0.35612201835474566,0.09898276880753087,0.45510478716227654,954236626,968916388.6,22.621033266605394,39.96371632549291,NaN,NaN,3.206254862681522,17.307113490371872
2019-03-25T09:30:00-04:00,72.97,73.51,72.79,73.12,12372760,14033769.2,42.871051593885824,50.554380686383716,NaN,NaN,-133.24055160521777,-94.36420073578391,-0.37030543402901756,-0.007777005373995394,0.36252842865502216,966609386,965510254,21.679622882998913,35.83342982899835,NaN,NaN,0.13667008915924692,14.854193004484355
2019-03-26T09:30:00-04:00,73.64,73.91,73.155,73.61,10523982,13973415.7,46.49932583399572,49.88942552405229,NaN,NaN,-96.36568599821297,-101.94691195209484,-0.33181774865550745,-0.05224375716436214,0.2795739914911453,977133368,966364559.4,22.550230979304843,32.554299230492525,NaN,NaN,-1.1734477279600473,12.564530042706583
2019-03-27T09:30:00-04:00,73.63,74.03,73.14,73.69,10556131,14099559.4,47.09015100305487,49.54089957851898,NaN,NaN,-87.24391427668365,-100.38707587910288,-0.2877433880154492,-0.08010524352816617,0.20763814448728302,987689499,971581980.8,27.826796792737355,30.4089986866451,NaN,NaN,-2.0229001571947123,10.480611442720683
2019-03-28T09:30:00-04:00,73.9,74.335,73.69,74.23,10030122,14174502.55,51.02193635796251,49.56267498401507,NaN,NaN,-40.912752874920116,-96.233993741301,-0.21246590762246403,-0.05794424004079701,0.15452166758166702,997719621,976677700,32.65277332009245,29.422662668894002,NaN,NaN,-1.5166354444868886,8.766719030262458
2019-03-29T09:30:00-04:00,74.72,75.09,74.66,75.03,10138768,14042110.25,56.21324607201486,49.60925868089982,NaN,NaN,63.29214135267742,-58.894152680471414,-0.1045002408120736,0.02389636656657501,0.1283966073786486,1007858389,987402052.6,41.51608358011125,29.44127864286011,NaN,NaN,0.603623727634341,7.600562558458441
2019-04-01T09:30:00-04:00,75.72,76.7,75.67,76.58,15530976,13861137.4,64.14323869350619,50.59668227513218,NaN,NaN,228.57379611367173,13.46871686330648,0.0663954343606282,0.21139090032943386,0.14499546596880566,1023389365,998758048.4,49.14783941668973,30.345498229494044,NaN,NaN,5.406277307866519,7.287093236945309
2019-04-02T09:30:00-04:00,76.62,76.82,76.36,76.55,10397617,13689990.65,63.902015629415004,51.22527759865441,NaN,NaN,235.79351457098164,79.9005569771454,0.16679254847646152,0.35348615156438257,0.18669360308792105,1012991748,1005929724.4,53.293076746298944,31.67465704080121,NaN,NaN,9.000804019923274,7.531909063085019
2019-04-03T09:30:00-04:00,76.86,76.96,76.12,76.32,12726012,13402873.5,61.97762110437009,51.867328278689364,NaN,NaN,188.49153647404702,135.04764712729155,0.2045958609654547,0.4424384292947394,0.23784256832928471,1000265736,1008444971.8,54.68814845256756,33.17843722033809,NaN,NaN,11.297523859228034,8.069854033962592
2019-04-04T09:30:00-04:00,76.28,77.06,76.27,76.79,9236642,12909470.65,64.34084724118361,53.065407690227616,NaN,NaN,169.0921266882123,177.04862303991803,0.24539092845024008,0.5445812288920848,0.29919030044184475,1009502378,1010801523.2,56.01375029144159,34.90851290501022,NaN,NaN,13.960032761465161,8.911308137891531
2019-04-05T09:30:00-04:00,77.08,77.25,76.885,77.01,7531373,12562875.05,65.42414641671047,53.954690023271716,NaN,NaN,160.39044196188462,196.46828316175947,0.2694089136404204,0.6359514424923702,0.3665425288519498,1017033751,1012636595.6,57.067052427796305,36.86501294893975,NaN,NaN,16.46761851011883,9.990781048209715
2019-04-08T09:30:00-04:00,76.43,76.7,76.095,76.68,8819137,12238917.15,62.36369712336237,54.776637190446344,NaN,NaN,103.65469694635395,171.48446332829593,0.24593853369321,0.6739656959684623,0.42802716227525234,1008214614,1009601645.4,54.73270243572875,38.76289400802845,NaN,NaN,17.687188130433707,11.090267774241713
2019-04-09T09:30:00-04:00,76.15,76.18,75.505,75.64,9814477,11829851.45,53.819167129670674,55.26145160796456,NaN,NaN,50.9468482697115,134.51513006804188,0.14806263760312155,0.6131054592791543,0.4650428216760327,998400137,1006683323.2,52.50848927600881,40.71353029919762,NaN,NaN,16.13238831819447,11.810570709092106
2019-04-10T09:30:00-04:00,75.7,75.78,75.16,75.62,13974689,11859192.6,53.666886709422066,55.35202560967971,NaN,NaN,32.0378204542886,103.2243868640902,0.07343817406728287,0.5568405392601363,0.48340236519285346,984425448,1003515265.6,50.12701512314653,42.601758213680625,NaN,NaN,14.84779861322788,12.244460409682931
2019-04-11T09:30:00-04:00,75.64,76.35,75.59,76.27,9532153,11853973.85,57.84188518007833,56.51251543490235,NaN,NaN,58.91066268424529,81.1880940632968,0.059889649995084115,0.5582644276867086,0.49837477769162447,993957601,1000406310.2,47.83424064332637,44.402701597732126,NaN,NaN,14.975081685091455,12.63454916331272
2019-04-12T09:30:00-04:00,77.01,77.28,76.74,77.28,11175121,11167727.6,63.365769906500695,57.9764238858034,NaN,NaN,105.1895097766638,70.14790762625263,0.10817043590845865,0.6335878225771978,0.5254173866687392,1005132722,998026104.4,46.095893792075245,46.146720948380434,NaN,NaN,16.856514184584075,13.237687023494342
2019-04-15T09:30:00-04:00,77.17,77.33,76.735,76.85,7368111,11020438.5,59.774787863590845,58.92467117363162,NaN,NaN,88.29977402273097,67.07692304152803,0.10052969870871187,0.6510795100546289,0.5505498113459171,997764611,995936103.8,44.56444445840749,47.71916476831633,NaN,NaN,17.291144147912213,13.81675232698261
2019-04-16T09:30:00-04:00,77.11,77.42,76.93,77.32,7101573,10836606.25,62.29029600100234,60.01039581634216,NaN,NaN,92.44449121330044,75.37645163024581,0.11544574418878695,0.6948569915819007,0.5794112473931138,1004866184,997229313.2,45.76512145488834,49.00047367275569,NaN,NaN,18.43568314202676,14.47659958627463
2019-04-17T09:30:00-04:00,77.78,77.99,77.4,77.42,10363901,10791828.85,62.823003135971234,60.85332915762849,NaN,NaN,103.61720156762934,89.69232785291396,0.11984236048760732,0.729214198002623,0.6093718375150157,1015230085,1003390240.6,51.189083817503,50.32449585114216,NaN,NaN,19.516732570191955,15.196618583977106
2019-04-18T09:30:00-04:00,77.74,78.42,77.739,78.31,13192661,10919530.25,67.25639907195537,61.64212580048139,NaN,NaN,121.83894161331362,102.27798363872762,0.16755793391416574,0.8188192549077229,0.6512613209935572,1028422746,1010283269.6,56.4382682218447,51.39036618269455,NaN,NaN,21.8657388043452,16.149350044029692
2019-04-22T09:30:00-04:00,78.01,78.25,77.69,78.07,6477790,10343199.8,65.00518832535974,61.703693631328065,NaN,NaN,108.87233441107591,103.01454856561004,0.16742780269662327,0.8605460743643363,0.693118271667713,1021944956,1013645716.4,58.76766159414439,52.07749633822703,NaN,NaN,23.120496138676316,17.14522805755064
2019-04-23T09:30:00-04:00,78.3,78.91,78.0611,78.75,13760481,10412585.85,68.2480965733886,62.01412798446904,NaN,NaN,137.3223665500382,112.81906707107149,0.1956463813096898,0.9376762483048253,0.7420298669951355,1035705437,1021233881.6,63.50985562357878,52.807266258032726,NaN,NaN,25.211256915981835,18.297517894469383
2019-04-24T09:30:00-04:00,78.75,78.95,78.485,78.52,7718026,10272288.05,66.01962221091634,62.30284234922234,NaN,NaN,135.8645052041602,121.50306986924345,0.18163412576664384,0.9690725242034404,0.7874383984367965,1027987411,1025858127,66.07081977804188,53.620314209852324,NaN,NaN,26.27219115914818,19.43675693228064
2019-04-25T09:30:00-04:00,77.64,77.66,76.59,76.94,12555935,10372278.25,53.17459035169199,61.50525257140151,NaN,NaN,22.667514316821357,105.31313241908185,0.0553191200442098,0.8565872984920588,0.801268178447849,1015431476,1025898405.2,66.09314158433548,54.34027073077332,NaN,NaN,22.975952666480186,19.942356322880578
2019-04-26T09:30:00-04:00,76.98,77.52,76.84,77.52,12262594,10483901.85,56.518984246591415,60.86916955925016,NaN,NaN,32.60384765710378,87.46611362783987,0.002956637882442492,0.8049639758009022,0.8020073379184597,1027694070,1025752670,65.92414436421716,54.972920154803376,NaN,NaN,21.358207513161545,20.144620778635
2019-04-29T09:30:00-04:00,77.52,77.95,77.43,77.7,8759251,10414926,57.53270794718679,60.52409890380905,NaN,NaN,62.392306346784835,78.17010801498166,-0.025842711673015106,0.7697039483271908,0.7955466600002059,1036453321,1028654343,67.69530325892549,55.898820213603145,NaN,NaN,20.388413714795263,20.179448340943612
2019-04-30T09:30:00-04:00,78.02,78.22,77.35,78.01,9546653,10115709.85,59.29291515005584,60.91508090526513,NaN,NaN,70.59405308281384,64.82444532153679,-0.030008239648572355,0.7580363604394904,0.7880446000880628,1045999974,1030713250.4,68.9293568691152,57.07173932739646,NaN,NaN,20.12506123915067,20.171678754973193
2019-05-01T09:30:00-04:00,78.25,78.5,77.5,77.5,16918680,10441763,55.23662053935767,61.02720475026052,NaN,NaN,61.22384657687005,49.89631359607877,-0.07077749111686471,0.6995727361919819,0.7703502273088466,1029081294,1030932027,69.06458685923863,58.424423022831604,NaN,NaN,18.666047800112214,19.95658861856448
2019-05-02T09:30:00-04:00,77.31,77.63,76.81,77.46,16360969,10623510.85,54.91927966185838,60.818447213244816,NaN,NaN,5.444957614328809,46.45180225558027,-0.10219643759509767,0.6426046803149745,0.7448011179100722,1012720325,1030389796.8,68.27148378686556,59.88422610451297,NaN,NaN,17.3975788273235,19.59101579124434
2019-05-03T09:30:00-04:00,77.73,78.47,77.73,78.4,12904073,10806882.4,60.641792493019075,60.623877397996125,NaN,NaN,87.65608546521537,57.46224981720259,-0.06333352406453552,0.6656342128294028,0.7289677368939383,1025624398,1029975862.4,67.63297743500902,61.42258922186539,NaN,NaN,17.985535608470794,19.36166147941955
2019-05-06T09:30:00-04:00,76.76,77.79,76.7,77.65,11928825,11026755,54.67794901215474,60.2598174800364,NaN,NaN,4.242551785278286,45.83229890490128,-0.09016406235100738,0.6162626589551792,0.7064267213061866,1013695573,1025424312.8,60.8895444167157,62.588667790315974,NaN,NaN,16.62762858370629,18.971085351460513
2019-05-07T09:30:00-04:00,76.7,76.845,75.49,76.08,18356220,11503609.15,44.75540991899438,59.00732561703584,NaN,NaN,-116.75707796606707,8.362072695125093,-0.20888846458446986,0.4453161405755992,0.6542046051600691,995339353,1015292188.6,49.14300023401131,62.82994484596761,NaN,NaN,11.902034693022587,17.961220971683666
2019-05-08T09:30:00-04:00,75.94,76.615,75.83,76.08,16464956,11836133.1,44.75540991899438,57.71678324439463,NaN,NaN,-118.6258219868854,-27.607861017626,-0.278316599853765,0.3063088553428628,0.5846254551966278,995339353,1008543800.4,43.16950288231895,62.25711763631161,NaN,NaN,8.279758312804866,16.578154877558124
2019-05-09T09:30:00-04:00,75.28,76.1,74.835,75.97,14923662,11883581.75,44.10503885371033,56.06311465737713,NaN,NaN,-175.71528931171505,-63.83991040283477,-0.31959285563313944,0.18513438565520346,0.5047272412883429,980415691,1002082873.6,38.361723154686885,60.965935845800345,NaN,NaN,5.189893696057673,14.95126042305806
2019-05-10T09:30:00-04:00,75.47,76.46,74.59,76.27,17419836,12277965.9,46.39300901194616,54.73367327784759,NaN,NaN,-156.41421404388976,-112.65397030465579,-0.3141666302768328,0.11201895344230195,0.42618558371913473,997835527,996525099.4,34.77404491765668,59.25210608319407,NaN,NaN,3.293861832833685,13.28591776731172
2019-05-13T09:30:00-04:00,74.5,74.7893,73.595,74.1,20011033,12719761.5,35.176582722890174,52.371422288526276,NaN,NaN,-240.68932086889956,-161.64034483549136,-0.436666226551531,-0.11964719947027902,0.31701902708125196,977824494,989350883.6,30.7732444922448,56.91377671667021,NaN,NaN,-2.5736592801500366,11.020263903388612
2019-05-14T09:30:00-04:00,74.37,75.435,74.27,74.87,11318011,12917256.5,40.659004774469565,50.559949614494364,NaN,NaN,-151.8751588096072,-168.6639610041994,-0.44430643594909675,-0.23836401785511896,0.20594241809397779,989142505,988111514,30.128365346788883,54.346458543009284,NaN,NaN,-5.472464920791396,8.66415978564861
2019-05-15T09:30:00-04:00,74.2,75.28,74.03,74.97,12289963,13176676,41.35272181601099,49.71553043337429,NaN,NaN,-130.83211850778812,-171.10522030837996,-0.42129966496306276,-0.32068216310985065,0.10061750185321211,1001432468,989330137,31.645162535346046,51.8858886109386,NaN,NaN,-7.4878635339818675,6.356727882844257
2019-05-16T09:30:00-04:00,75.31,75.905,75.16,75.66,7450005,13030981.2,46.04012436396521,48.96704044175813,NaN,NaN,-72.53477642330803,-150.46911773069854,-0.341677364546198,-0.32647920382953544,0.015198160716662593,1008882473,995023493.4,38.37587532206522,49.91815510792775,NaN,NaN,-7.6596909902471815,4.35438232954548
2019-05-17T09:30:00-04:00,74.84,75.64,74.73,74.82,16305654,13186630.85,41.673377934923806,47.83423115516792,NaN,NaN,-89.7325619517775,-137.1327873122761,-0.3276057534776425,-0.3943090311303905,-0.06670327765274803,992576819,993971751.8,37.6385651475491,47.77124524282944,NaN,NaN,-9.229196016796779,2.4138711372108714
2019-05-20T09:30:00-04:00,74.35,74.91,74.28,74.63,11638491,13444665.9,40.732313074399826,46.508473864049634,NaN,NaN,-102.14695087296477,-109.42431331308913,-0.3131295404076705,-0.4581152031623361,-0.14498566275466565,980938328,994594518.6,38.39334559383191,45.590101580309216,NaN,NaN,-10.771208849318713,0.5302882819923596
2019-05-21T09:30:00-04:00,75.27,75.6,75.07,75.51,10612265,13287255.1,46.732154080561294,45.901011974135606,NaN,NaN,-54.580663192991196,-89.96541418976592,-0.23016001180451284,-0.43268567751030673,-0.2025256657057939,991550593,995076136.2,39.00815134143657,43.44321332903764,NaN,NaN,-10.191435632543017,-1.0013865629412655
2019-05-22T09:30:00-04:00,75.25,75.34,74.89,74.89,9114746,13357091.1,43.39871633724775,45.078114593806276,NaN,NaN,-69.06535344085445,-77.6120611763792,-0.20381151425419708,-0.4572900585235402,-0.25347854426934313,982435847,991276812,35.95946850147699,41.13521223722416,NaN,NaN,-10.754060594670998,-2.394625710331227
2019-05-23T09:30:00-04:00,74.07,74.18,73.2946,73.75,16205768,13539582.75,38.02750515968393,43.46280835571091,NaN,NaN,-130.5413597569423,-89.21337784310603,-0.2470538713339569,-0.5622958834367893,-0.31524201210283237,966230079,982746333.2,30.24404417937022,38.46457414753568,NaN,NaN,-13.018891139960564,-3.912377914563989
2019-05-24T09:30:00-04:00,74.24,74.37,73.58,73.78,11127434,13482824.75,38.24411330917524,42.288962948355234,NaN,NaN,-110.4351846909743,-93.35390239094541,-0.25641783967091364,-0.6357643116914744,-0.37934647202056077,977357513,979702472,28.50318090302862,36.1512624679866,NaN,NaN,-14.72273187540364,-5.45671419468394
2019-05-28T09:30:00-04:00,73.87,74.15,73.09,73.1,11263080,13608016.2,35.23765521108993,41.60912332636206,NaN,NaN,-127.08318623950444,-98.34114946425333,-0.2887827287698404,-0.7403248829828613,-0.45154215421302085,966094433,976733693,26.878149093045167,34.56091595791759,NaN,NaN,-17.1064227253751,-7.1209582704969625
2019-05-29T09:30:00-04:00,72.78,73.095,72.08,72.77,14257069,13843537,33.84705848845165,40.82995536703758,NaN,NaN,-157.32978806570884,-118.89097443879689,-0.3108731518436756,-0.8401335940176153,-0.5292604421739397,951837364,968791047.2,23.08597123952285,33.12637798343216,NaN,NaN,-19.487576116245695,-8.88761796274678
2019-05-30T09:30:00-04:00,73.09,73.405,72.795,73.05,10103505,13502778.25,36.149493195819225,40.26170210575964,NaN,NaN,-121.92899157951284,-129.46370206652858,-0.28572840445723047,-0.8864209477454779,-0.6006925432882474,961940869,964692051.6,21.407362636058195,31.91535223210153,NaN,NaN,-20.787900402249214,-10.587658311247129
2019-05-31T09:30:00-04:00,72.27,72.545,71.99,72.05,13718389,13370649.25,31.88167469738667,39.22517822614825,NaN,NaN,-156.44559158766438,-134.644548432673,-0.3133310733872914,-0.9923563850223616,-0.6790253116350702,948222480,961090531.8,20.029326285335628,30.8621580440786,NaN,NaN,-23.262921526770743,-12.398410199179073
2019-06-03T09:30:00-04:00,71.93,72.945,71.91,72.54,17514954,13601193.3,35.876533934539864,39.27517474126608,NaN,NaN,-127.58928889428036,-138.0753692733342,-0.2767453594757645,-1.0249570109797759,-0.7482116515040114,965737434,958766516,19.171703776461385,30.033476564379786,NaN,NaN,-24.126703109739907,-14.073880614973477
2019-06-04T09:30:00-04:00,73.24,74.3,73.11,74.27,16424739,13825989,47.5679928666311,39.76867389070619,NaN,NaN,-34.586638052226,-119.57605963587851,-0.12208083252504287,-0.900812692160315,-0.7787318596352721,982162173,961980064,24.016542023180904,29.59691775555064,NaN,NaN,-20.967191737085113,-15.05863934670371
2019-06-05T09:30:00-04:00,74.66,75.085,74.4,74.99,12865641,13551460.05,51.52899284239019,40.49555039259042,NaN,NaN,31.730296538448776,-81.764042715047,0.03430784325403258,-0.7358470555677314,-0.770154898821764,995027814,970618154,35.25131777656874,29.854500272780832,NaN,NaN,-17.024819481117614,-15.339522223048554
2019-06-06T09:30:00-04:00,75.07,75.315,74.435,75.12,11387334,13297578.95,52.23069501066715,40.937734010211976,NaN,NaN,47.629286932395594,-47.852387012665304,0.1458484131450566,-0.5878443823904433,-0.7336927955354999,1006415148,979513009.8,44.37231297687638,30.282817248124484,NaN,NaN,-13.703081785790664,-15.105745017725999
2019-06-07T09:30:00-04:00,75.4,76.025,75.35,75.72,9234296,13013110.65,55.43722691030012,41.92086607988172,NaN,NaN,101.00811696420135,3.638354697707874,0.2530938020905493,-0.4173255429223133,-0.6704193450128626,1015649444,992998402.6,54.77409856879096,31.50678392107033,NaN,NaN,-9.903795552459517,-14.362609379830788
2019-06-10T09:30:00-04:00,76.44,76.65,75.795,75.82,9513873,12617812.5,55.96773390192606,43.00911042470502,NaN,NaN,126.18901757687101,54.39401599193815,0.31953939044833746,-0.2709951069524408,-0.5905344974007782,1025163317,1004883579.2,61.59086139621,33.16374933552591,NaN,NaN,-6.691844940452898,-13.26678588849109
2019-06-11T09:30:00-04:00,76.27,76.45,74.87,75.17,11936562,12214088.95,51.66254017053079,43.361280859702845,NaN,NaN,76.13328282592174,76.5380001675677,0.30833772391314085,-0.20511234250935217,-0.513450066422493,1013226755,1011096495.6,64.59506464820845,34.991386000295336,NaN,NaN,-5.189407143916033,-12.112874639266082
2019-06-12T09:30:00-04:00,75.11,75.37,74.93,75.33,5612474,11928812.1,52.628509495552834,44.02055179958178,NaN,NaN,54.4657239698567,81.08508565384929,0.3000450158071885,-0.13839379666350737,-0.4384388124706959,1018839229,1015858778.6,66.74235424950905,37.19016355372619,NaN,NaN,-3.678858724905591,-10.908015222928869
2019-06-13T09:30:00-04:00,75.46,75.76,75.26,75.71,6987036,11663665.75,54.93204878501173,45.22801920139091,NaN,NaN,74.05210373955082,86.36964901528033,0.3073663267067354,-0.0542309040872766,-0.361597230794012,1025826265,1019741002,68.42363027530855,39.91727684629321,NaN,NaN,-1.7376018166971763,-9.59795616489577
2019-06-14T09:30:00-04:00,75.62,75.71,75.09,75.41,5966596,11589495.3,52.751162840850455,46.26423702508199,NaN,NaN,63.69472796962767,78.90697121636559,0.2799938455814931,-0.011604923817145618,-0.2915987693986387,1019859669,1020583047,68.7921416897794,42.79505975963256,NaN,NaN,-0.6964566332850558,-8.326313374665668
2019-06-17T09:30:00-04:00,75.45,75.57,75.09,75.15,7708766,11159650.9,50.866323734075166,47.38057049100951,NaN,NaN,53.78472249465358,64.42611219992212,0.23422542237870453,0.0011830085747419616,-0.23304241380396257,1012150903,1017980564.2,66.2198843577313,45.60518370711014,NaN,NaN,-0.32719942608047364,-7.1835828105820685
2019-06-18T09:30:00-04:00,75.54,76.705,75.54,76.61,12506299,11203041.3,59.596539890181404,49.219819162561635,NaN,NaN,107.57992906826586,70.71544144839092,0.28855857009321373,0.12765579881255462,-0.1609027712806591,1024657202,1020266653.6,67.37394895895252,48.7686106870694,NaN,NaN,2.7234885233908424,-5.768286905728796
2019-06-19T09:30:00-04:00,76.74,76.76,76.19,76.55,11171676,11231011.85,59.13154514793931,50.86139430199879,NaN,NaN,112.78081145314293,82.37845894504818,0.305124677431023,0.22050307550811965,-0.08462160192290336,1013485526,1019195913,66.23260493774907,51.97041370861875,NaN,NaN,5.0420014113777185,-4.223960003285008
2019-06-20T09:30:00-04:00,77.45,77.93,76.955,77.83,14503224,11500435.75,65.34382518679064,53.25154790838479,NaN,NaN,154.64211081367588,98.4964603598732,0.38197094146448657,0.39284207490770484,0.010871133443218287,1027988750,1019628410,66.4796163721056,55.28829157195946,NaN,NaN,9.176159474449097,-2.309657220751564
2019-06-21T09:30:00-04:00,77.49,77.81,77.05,77.08,11526835,11266489.1,59.62475542449107,54.9478494433813,NaN,NaN,127.43395432059525,111.24430563006672,0.36215078516076943,0.46355961489418007,0.10140882973341066,1016461915,1018948859.2,65.66680661598528,58.60937034621117,NaN,NaN,10.870786905074853,-0.4267366313477905
2019-06-24T09:30:00-04:00,77.11,77.39,76.895,76.93,8388348,11129534.8,58.52156258892919,55.73024728068831,NaN,NaN,104.59671995446992,121.40670512202999,0.3202461780698211,0.501716552320687,0.18147037425086593,1008073567,1018133392,64.64538005061155,61.51143020531335,NaN,NaN,11.892231702837027,1.333115987821469
2019-06-25T09:30:00-04:00,76.93,76.96,76.285,76.35,9267637,11029762.65,54.33528350823191,55.930696613962716,NaN,NaN,71.58746208290937,114.20821172495869,0.2385246725595706,0.4796262149503292,0.2411015423907586,998805930,1012963137.6,58.43879639616113,63.167678678141385,NaN,NaN,11.483909246632908,2.7832293105088173
2019-06-26T09:30:00-04:00,76.56,76.76,76.346,76.54,7262692,10680043.8,55.45931744213507,56.16131250192471,NaN,NaN,67.84534538965325,105.22111851226074,0.184726638021101,0.47200983991713485,0.28728320189603385,1006068622,1011479756.8,56.755169069792004,64.05216839906393,NaN,NaN,11.47627182486638,4.0250925268456115
2019-06-27T09:30:00-04:00,76.6,76.87,76.29,76.61,7573783,10553557.7,55.890105640340984,56.19366098264192,NaN,NaN,64.74861810493422,87.24241997051243,0.14317152695524327,0.4662476105900879,0.32307608363484464,1013642405,1008610487.8,53.54193710210698,63.96415686572936,NaN,NaN,11.589572849487292,5.10573257293728
2019-06-28T09:30:00-04:00,76.72,77.47,76.72,77.42,11152333,10425254.9,60.63463241944901,56.52701087675071,NaN,NaN,97.19705249796745,81.19503960598686,0.15836718508032888,0.5210350649852558,0.3626678799049269,1024794738,1010277052.4,55.13092059689653,63.50273252292125,NaN,NaN,13.074890659387462,6.244183728144448
2019-07-01T09:30:00-04:00,78.05,78.44,77.1605,77.49,10319402,10065477.3,61.02479267151012,57.19574319824924,NaN,NaN,127.06519491270588,85.68873459763405,0.16075052230636888,0.563606032787888,0.40285551048151913,1035114140,1015685167,59.92140266539933,63.168899524149175,NaN,NaN,14.401058697658936,7.409451580932232
2019-07-02T09:30:00-04:00,77.57,77.675,77.21,77.39,9237308,9706105.75,60.10825675533656,57.73001085966236,NaN,NaN,98.76283482280623,91.12380914561342,0.14376302072732577,0.5825592863906763,0.43879626566335056,1025876832,1021099347.4,64.05853450475287,62.97719811380944,NaN,NaN,15.26105541785792,8.531109271921615
2019-07-03T09:30:00-04:00,77.64,77.85,77.365,77.82,8091385,9467392.95,62.702306445913806,58.28502926401251,NaN,NaN,110.65279621000123,99.68529930968302,0.14902046238288896,0.6250718436419618,0.4760513812590728,1033968217,1026679266.4,67.75303362585113,62.929298353133916,NaN,NaN,16.72453143739798,9.701598152703953
2019-07-05T09:30:00-04:00,77.46,77.51,76.45,77.51,6388987,9217475.6,59.68884015683849,58.78057764372594,NaN,NaN,60.062220045908006,98.74801969787777,0.12038028072007267,0.6265267321591637,0.506146451439091,1027579230,1029466631.4,69.44279008464878,62.97577323848173,NaN,NaN,17.16828940025421,10.768268330925418
2019-07-08T09:30:00-04:00,77.04,77.27,76.67,76.87,6039855,9057753.55,53.92663033329184,58.999170972241416,NaN,NaN,34.85236471315575,86.27908214091542,0.05066089104577909,0.5694725652463148,0.5188116742005358,1021539375,1028815558.8,68.53935793421942,63.1414499225166,NaN,NaN,15.92607315544758,11.505097591571442
2019-07-09T09:30:00-04:00,76.4,76.79,76.28,76.7,10137495,9088934.65,52.477450483245406,58.4906645860317,NaN,NaN,-1.2848509535268644,60.60907296766887,-0.011272509185062729,0.5047210377192073,0.51599354690427,1011401880,1024073106.8,62.19242273957053,62.771340906846454,NaN,NaN,14.479107138955966,11.929956098340659
2019-07-10T09:30:00-04:00,76.92,77.26,76.45,76.52,10124841,8998348.6,50.91720886214426,57.90392627990348,NaN,NaN,8.485538786959255,42.55361376049948,-0.0656916352018021,0.4338790029020174,0.4995706381038195,1001277039,1019153148.2,56.36134819910402,62.066251139800386,NaN,NaN,12.82510973734598,12.057835189627133
2019-07-11T09:30:00-04:00,76.5,77.05,76.38,77.04,7393867,9087418.25,55.07289805070639,57.17028862732603,NaN,NaN,9.541384100417696,22.33133133858278,-0.06772613001064698,0.41491297559051077,0.48263910560115775,1008670906,1014093686,51.059632965926795,60.96482375364475,NaN,NaN,12.493106200281662,12.12001676257778
2019-07-12T09:30:00-04:00,77.3,78.41,77.3,78.39,12152773,9345705.1,63.67227708496225,57.45939731735969,NaN,NaN,143.77324137078602,39.073535603558376,0.016302721260940067,0.5030175071773328,0.4867147859163928,1020823679,1012742575.8,49.71472922164182,59.8253896540488,NaN,NaN,14.897702344454562,12.516828988560178
2019-07-15T09:30:00-04:00,78.39,78.39,77.96,78.07,4452546,9270002.6,60.70613361721899,57.61543810509467,NaN,NaN,144.46301336430807,60.995665333788835,0.04325682352195892,0.5407858153188414,0.4975289917968825,1016371133,1011708927.4,48.65878370534192,58.683489915100964,NaN,NaN,15.957795542737271,13.008395639156905
2019-07-16T09:30:00-04:00,78.06,78.78,78.06,78.57,8115339,9290331.25,63.562384976882704,58.274516781426875,NaN,NaN,172.46281732856346,95.7451989902069,0.08525649352443554,0.6040996087024268,0.5188431151779913,1024486472,1014325845.8,51.46923214638588,58.18566389725987,NaN,NaN,17.74380209459486,13.684882275648041
2019-07-17T09:30:00-04:00,78.12,78.1873,76.86,76.89,11235096,9226771.1,50.32555009022681,57.907819113433426,NaN,NaN,13.593160487987697,96.76672333041259,-0.004832082113379377,0.512803012536267,0.5176350946496464,1013251376,1016720713.2,53.953411260242945,57.98553833943494,NaN,NaN,14.772765528630321,13.840294168931225
2019-07-18T09:30:00-04:00,76.94,77.135,76.56,77.03,6647874,9000581,51.23688672719189,57.57544633392278,NaN,NaN,-48.66202727952943,85.12604105442317,-0.056829257704019476,0.44659852251962207,0.5034277802236415,1019899250,1018966382,56.216616696845534,58.176586881916265,NaN,NaN,12.773887895230201,13.687950415545364
2019-07-19T09:30:00-04:00,77.53,77.92,77.395,77.45,7601729,8655506.25,53.96545933878629,57.09907682816115,NaN,NaN,51.71911002435657,66.71521478513728,-0.06422723258977714,0.42314373948642015,0.4873709720761973,1027500979,1020301842,57.552738512553276,58.34957387589174,NaN,NaN,12.013771089117045,13.448781940341318
2019-07-22T09:30:00-04:00,77.59,77.91,77.2631,77.51,8448168,8501572.9,54.358368265669505,56.622903656315394,NaN,NaN,44.51620508971437,46.72585313021854,-0.06611145055518763,0.40473165888221274,0.4708431094374004,1035949147,1024217444.8,61.28340418439614,58.44685969867724,NaN,NaN,11.529450691066083,13.174591761873428
2019-07-23T09:30:00-04:00,78.08,78.515,77.76,78.49,10284179,8596364.45,60.31611184932042,56.63775044874281,NaN,NaN,124.45458105834456,37.12420587617475,-0.005578046601832309,0.46387055118511,0.4694485977869423,1046233326,1028566815.6,64.96665080945542,58.511725149013124,NaN,NaN,13.002865582383095,13.150059450517666
2019-07-24T09:30:00-04:00,77.85,79.02,77.83,78.83,8692520,8567608.6,62.16151764010803,56.59912267689954,NaN,NaN,144.59115796714576,63.32380537200636,0.050073661131188774,0.5320406742009283,0.4819670130697395,1054925846,1036901709.6,70.71604068255436,58.72336851020622,NaN,NaN,14.788250340733317,13.384086720548474
2019-07-25T09:30:00-04:00,78.83,79.07,78.32,78.67,8759039,8642425.95,60.7302898347597,56.673511939608204,NaN,NaN,141.9172892387286,101.43966867565798,0.06772530185663367,0.5666236403905316,0.4988983385338979,1046166807,1042155221,73.65122155653862,59.023970758198345,NaN,NaN,15.811382996796016,13.73084333144098
2019-07-26T09:30:00-04:00,78.52,78.705,78.24,78.5,6148092,8571141.4,59.17140980023624,57.04813904438995,NaN,NaN,105.55902870657007,112.20765241210067,0.05984137229003783,0.5737000538964452,0.5138586816064074,1040018715,1044658768.2,74.94027849912457,59.48117936997728,NaN,NaN,16.207642387014047,14.084671767951418
2019-07-29T09:30:00-04:00,78.41,78.545,78.23,78.36,5387503,8282899.9,57.85434506884845,57.432202943361595,NaN,NaN,83.17203399881245,119.9388181939203,0.038143669908481836,0.5615382689920096,0.5233945990835278,1034631212,1044395181.2,74.52687190790871,60.362211453430014,NaN,NaN,16.170875867251855,14.382700924994337
2019-07-30T09:30:00-04:00,77.87,78.7,77.6,78.7,7071716,8120515.6,60.17285995898905,58.09332087885052,NaN,NaN,69.90443242970491,109.02878846819235,0.0394707332494274,0.5727330156453121,0.5332622823958847,1041702928,1043489101.6,73.03537483603075,61.553213356067644,NaN,NaN,16.782145098717336,14.725478664097622
2019-07-31T09:30:00-04:00,78.74,78.9,77.22,77.82,12485267,8282913.55,52.17285711695762,57.88617509786845,NaN,NaN,27.638687062520745,85.63829428726736,-0.02278780481452969,0.5047775263777226,0.5275653311922522,1029217661,1038347464.6,65.07647114091702,62.554416082852654,NaN,NaN,14.952019178323217,14.75784159470128
2019-08-01T09:30:00-04:00,77.68,78.28,76.165,76.31,18665734,8811631,41.883059272098485,56.32980239694962,NaN,NaN,-80.80487711574868,41.093861016371896,-0.16179006072706192,0.32532775528342484,0.48711781601048676,1010551927,1031224488.6,55.97595091061688,63.00164620349374,NaN,NaN,9.669399493843244,14.030921294578702
2019-08-02T09:30:00-04:00,76.05,76.21,75.3,75.82,12992427,9141803,39.18247401443496,54.7923981396079,NaN,NaN,-173.93509668955724,-14.804964062853566,-0.2761442948997381,0.14193744738581415,0.4180817422855522,997559500,1022732645.6,47.455643736606696,62.915707634298364,NaN,NaN,4.450572549748895,12.662300045317302
2019-08-05T09:30:00-04:00,74.62,74.63,73.085,73.72,14505160,9565068.25,30.19619951864736,52.409099178305375,NaN,NaN,-275.1932703697729,-86.47802493657063,-0.47117203868078916,-0.17088330606543423,0.30028873261535494,983054340,1012417271.2,39.57529169351715,62.066140459093454,NaN,NaN,-4.0262481749275905,10.27822172813946
2019-08-06T09:30:00-04:00,74.23,74.89,73.88,74.83,11758586,9646122.8,38.256766044107586,51.54704317501115,NaN,NaN,-187.06636019943807,-137.87218346239925,-0.5006121015425476,-0.3254763943128296,0.17513570722971802,994812926,1003039270.8,34.04091286661469,60.64381914526287,NaN,NaN,-7.840780028299394,7.689792905791052
2019-08-07T09:30:00-04:00,73.86,74.93,73.32,74.79,15604345,9920098,38.086089211616624,50.6077004953272,NaN,NaN,-166.62206366358458,-176.72433360762028,-0.4969710343754091,-0.44607808573954344,0.050892948635865715,979208581,993037454.8,29.329952828108873,58.723343154638826,NaN,NaN,-10.722666387486662,5.05944157817995
2019-08-08T09:30:00-04:00,75.12,76.11,75.03,76.06,9353090,10018059.15,46.28064672892132,50.05878530890827,NaN,NaN,-78.94535092346584,-176.35242836916373,-0.3880523894362594,-0.43417253815945855,-0.04612014872319914,988561671,988639403.6,27.526030193739274,56.57857827472353,NaN,NaN,-10.224531188561356,2.8760168972169065
2019-08-09T09:30:00-04:00,75.78,75.86,74.98,75.42,8213556,9821098.3,43.179143546576285,49.260269257544465,NaN,NaN,-83.89828109208592,-158.34506524966946,-0.3398647816637365,-0.4709511258028698,-0.13108634413913328,980348115,985197126.6,26.169373130063647,54.07043319941407,NaN,NaN,-10.90756603299264,0.9069336214726855
2019-08-12T09:30:00-04:00,74.89,75.15,74.14,74.38,15316497,10364295.85,38.64678525294443,47.712460214946184,NaN,NaN,-110.77540015398732,-125.46149120651235,-0.35702073039931415,-0.5773622571382759,-0.22034152673896182,965031618,981592582.2,24.791471988659836,51.20077756935724,NaN,NaN,-13.072455938377908,-1.090122029934542
2019-08-13T09:30:00-04:00,74.29,76.03,74.15,75.27,14380814,10677569.6,44.058395152626886,46.419380037268965,NaN,NaN,-72.493186634782,-102.54685649358112,-0.290251597626992,-0.5831560237727018,-0.29290442614570983,979412432,978512483.4,23.645756196646914,47.838614391792426,NaN,NaN,-12.94552761296007,-2.783751398938189
2019-08-14T09:30:00-04:00,74.12,74.27,72.885,72.97,13653813,10798505.45,35.374702112668075,44.60826662854813,NaN,NaN,-131.3066098553525,-95.48376573193471,-0.37729680341070737,-0.764525430409094,-0.38722862699838667,965758619,975822491,22.66079131609247,44.19644080318913,NaN,NaN,-16.166335276862455,-4.6955490957845125
2019-08-15T09:30:00-04:00,73.09,73.1,72.19,72.89,11981828,11065203.15,35.115450854595,42.88998384671662,NaN,NaN,-135.2475958444954,-106.74421471614062,-0.4136516537903896,-0.9042931942363737,-0.49064154044598407,953776791,968865515,20.30505904875689,40.29392512816286,NaN,NaN,-18.636283298183255,-6.687082553270047
2019-08-16T09:30:00-04:00,73.49,74.45,73.41,74.3,9575517,11163892.55,43.03899582563507,41.83174461505852,NaN,NaN,-77.12306636311978,-105.38917177034742,-0.32029787522730613,-0.8910138844801168,-0.5707160092528106,963352308,965466353.6,19.251977118685687,36.345718357504076,NaN,NaN,-17.869330145409588,-8.284546495004268
2019-08-19T09:30:00-04:00,75.18,75.32,74.87,75,4260525,10954510.4,46.53001254556021,40.857255514099315,NaN,NaN,-35.87267796954156,-90.40862733345826,-0.1951195179120151,-0.8146154066428295,-0.6194958887308144,967612833,965982596.6,19.931162764113978,32.55256035236716,NaN,NaN,-16.042111893980344,-9.392770123429422
2019-08-20T09:30:00-04:00,74.86,75.025,74.5,74.56,4695401,10675071.5,44.67651137335621,40.321802246699214,NaN,NaN,-45.72027577309508,-85.05404516112085,-0.128863607419461,-0.7805753980051406,-0.6517117905856796,962917432,962683596.6,18.840567982308357,29.249995841037965,NaN,NaN,-15.206383553450356,-10.223286327718126
2019-08-21T09:30:00-04:00,75.13,75.35,74.9,75.02,5399205,10510405.75,47.05119468143604,40.690954775937605,NaN,NaN,-25.059269270826494,-63.80457704421567,-0.045282785725009655,-0.7083152727419417,-0.6630324870169321,968316637,963195200.2,19.57551331618245,26.64996458429265,NaN,NaN,-13.7725980592845,-10.730330860799036
2019-08-22T09:30:00-04:00,75.23,75.54,74.565,75.13,7692406,10457074.1,47.630086661991996,41.294355679334544,NaN,NaN,-19.92304457263882,-40.73966678984435,0.02254253617976265,-0.6348543167922287,-0.6573968529719914,976009043,967641650.6,25.859511152575436,25.10738368543327,NaN,NaN,-12.456647676738417,-10.976947548790376
2019-08-23T09:30:00-04:00,74.66,75.215,72.77,73.12,26477615,11473550.25,39.197068890454105,41.93727492017788,NaN,NaN,-86.05271213491748,-42.525595944203886,-0.05840772569245645,-0.7304065100875619,-0.6719987843951054,949531428,964877474.6,24.574043155589777,24.035865932724175,NaN,NaN,-14.009855562165544,-11.410220122129685
2019-08-26T09:30:00-04:00,73.97,74.09,73.02,73.66,14039905,11906170.35,42.159940033451605,42.216073062273885,NaN,NaN,-88.66477571174084,-53.08401549264374,-0.06549592896619338,-0.7538686956028471,-0.6883727666366537,963571333,964069174.6,24.19528390300495,23.332606721037767,NaN,NaN,-14.312994290534059,-11.824902146187453
2019-08-27T09:30:00-04:00,74.05,74.085,73.105,73.28,9943314,12049750.25,40.65847956357219,42.39981523027071,NaN,NaN,-89.49519613568216,-61.83899956516116,-0.08448022176963277,-0.7939730438486947,-0.709492822079062,953628019,962211292,23.306109821923926,22.90233222059598,NaN,NaN,-15.022049540517266,-12.28163748823457
2019-08-28T09:30:00-04:00,73.08,74.18,72.77,74.18,11921308,12021552.3,45.5999563816896,42.35119449118274,NaN,NaN,-68.63514350609974,-70.55417441221581,-0.028046407825304542,-0.7445508318606926,-0.716504424035388,965549327,961657830,23.034534850057497,22.581511124618714,NaN,NaN,-14.084721499297077,-12.539220918386356
2019-08-29T09:30:00-04:00,75,75.62,74.7,75.45,10651035,11620817.35,51.71071042542728,42.96059212538638,NaN,NaN,72.78318810865417,-52.01292787595721,0.09637611960674475,-0.5960342745269571,-0.6924103941337019,976200362,961696093.8,23.101249960346564,22.362359469638925,NaN,NaN,-11.282195603680732,-12.35964587342841
2019-08-30T09:30:00-04:00,75.95,76.26,75.605,75.76,7500225,11346207.25,53.09571352665474,43.99265843065141,NaN,NaN,127.90495814746167,-9.221393819481381,0.19540560306975263,-0.44815339029651113,-0.6435589933662638,983700587,968529925.6,34.08983079542918,23.026527955836734,NaN,NaN,-8.59830224069815,-11.822311068752658
2019-09-03T09:30:00-04:00,75.04,75.8003,74.26,74.73,12787100,11260304.25,48.15384575166326,44.285190616296866,NaN,NaN,38.31790413839424,16.175142150545636,0.18736689094482217,-0.409350379685236,-0.5967172706300582,970913487,969998356.4,36.199527878483124,23.923225933110746,NaN,NaN,-7.825539492390424,-11.251343700700911
2019-09-04T09:30:00-04:00,75.33,75.76,74.73,75.68,9265735,11135661.7,52.54135512246994,45.511380116996996,NaN,NaN,73.5944475056468,48.79307087881143,0.23857323796802876,-0.2985007231700223,-0.5370739611380511,980179222,975308597,43.271121143246184,25.395392349336014,NaN,NaN,-5.775174410722173,-10.46903380213252
2019-09-05T09:30:00-04:00,76.59,77.6,76.54,77.04,14267050,11068796.95,58.018558224420346,47.147316357698806,NaN,NaN,188.03516071956386,100.12713172394415,0.3498504044698413,-0.09976095555074949,-0.44961136002059077,994446272,981087986,49.79349625063907,27.501709292327597,NaN,NaN,-2.1802672095372797,-9.284924288904628
2019-09-06T09:30:00-04:00,77.33,77.46,76.97,77.2,6940300,10948157.45,58.62356788389013,48.2605000761456,NaN,NaN,179.83166561502514,121.53682722521835,0.415566887490417,0.06984724934243047,-0.3457196381479865,1001386572,986125228,54.68395035277737,30.032564523334145,NaN,NaN,0.8499997627372244,-7.837077995812935
2019-09-09T09:30:00-04:00,77.38,77.78,77.245,77.43,8080968,10941528.05,59.526526758658875,49.18882251993836,NaN,NaN,174.55535465232452,130.86690652619092,0.45280192560088867,0.22028276885312437,-0.2325191567477643,1009467540,991278618.6,59.0758627513941,32.82861452242558,NaN,NaN,3.5789326796935708,-6.206219327883434
2019-09-10T09:30:00-04:00,77.23,78.16,76.955,78.14,9487356,10650071,62.26421221609767,50.44508686584846,NaN,NaN,164.17890685574528,156.03910706966113,0.4998338750448691,0.39227318705832204,-0.10756068798654704,1018954896,1000886900.4,65.74234350770377,36.17874134566811,NaN,NaN,6.730576856562013,-4.35810558724837
2019-09-11T09:30:00-04:00,78.3,78.9157,77.88,78.87,14262632,10644161.9,64.89356578071983,51.719541944368736,NaN,NaN,172.52007698716102,175.82423296596397,0.550677976977657,0.5807867832355242,0.03010880625786723,1033217528,1011494561.6,71.3007063869233,39.873397993578166,NaN,NaN,10.219074064523156,-2.275651351281009
2019-09-12T09:30:00-04:00,79.09,79.3,78.565,78.92,18667744,10894858.45,65.07307540673337,52.965469711850254,NaN,NaN,158.54847471687845,169.92689576542688,0.5565950125013079,0.7258525718845021,0.1692575593831942,1051885272,1022982361.6,75.8673415954922,43.44538588235793,NaN,NaN,13.101337868416854,-0.07893860560988575
2019-09-13T09:30:00-04:00,79.28,79.79,79.25,79.35,9357681,10763651.1,66.65232133069293,54.926559171867325,NaN,NaN,153.9923619664462,164.7590350357111,0.5570245720316533,0.8655382744227609,0.30851370239110754,1061242953,1034953637.8,79.52381505283914,47.37036958930431,NaN,NaN,16.001985892965244,2.2183363227579895
2019-09-16T09:30:00-04:00,79.12,79.41,78.94,79.28,8011684,10685459.45,66.1281298880446,56.63857273290968,NaN,NaN,122.51410711829725,154.35078552890565,0.5208137661161025,0.9595309100362357,0.43871714392013317,1053231269,1043706383.6,81.70628250633192,51.47829806097053,NaN,NaN,18.270307858088778,4.511475113519531
2019-09-17T09:30:00-04:00,79.09,79.31,78.67,79.24,6250776,10784972,65.80962894374173,58.43508340292179,NaN,NaN,102.18585974865599,141.9521761074878,0.4642632092542698,1.0190461554879704,0.5547829462337006,1046980493,1049311503,82.95890838452976,55.7392122440138,NaN,NaN,20.090611323120868,6.737066000605436
2019-09-18T09:30:00-04:00,78.78,79.155,78.24,79.12,8089653,10954684.6,64.80127277972306,59.80660600278133,NaN,NaN,83.77880435813795,124.20392158168315,0.3917650013117395,1.044489197873375,0.6527241965616355,1038890840,1050446165.4,83.20954718238386,60.037427410608544,NaN,NaN,21.395170994101445,8.831080999676294
2019-09-19T09:30:00-04:00,79.09,79.345,78.68,78.72,5076787,10938563.7,61.42282116240081,60.50032819827943,NaN,NaN,78.33370353592737,108.16096734549296,0.2943097329342663,1.0206113627294684,0.7263016297952021,1033814053,1046831921.6,79.21301866889917,64.04541088979087,NaN,NaN,21.697315930057545,10.66911456115933
2019-09-20T09:30:00-04:00,78.39,78.66,77.59,77.81,10493363,11078611.55,54.46578842801742,60.59819069123391,NaN,NaN,42.82700308747045,85.92789556969782,0.15310282881923742,0.9176801658192488,0.7645773370000114,1023320690,1039247469,71.4568844766537,66.71448615273547,NaN,NaN,20.083864737364955,12.014078872045847
2019-09-23T09:30:00-04:00,77.5,77.94,77.22,77.66,14480280,10478744.8,53.3922755279284,60.972364246681416,NaN,NaN,23.24652411026954,66.07437896809226,0.04002801846600734,0.8146123600825206,0.7745843416165132,1008840410,1030369297.2,63.60580311914239,68.672077241354,NaN,NaN,18.432091186930926,12.930937774172287
2019-09-24T09:30:00-04:00,78,78.19,76.83,77.22,11885629,10371031,50.262768170422405,60.80960803582088,NaN,NaN,9.229675357048126,47.4831420897707,-0.06808492657860055,0.6894781833932626,0.7575631099718632,996954781,1020364154.8,56.12229497437087,69.59001822929147,NaN,NaN,16.131949054338204,13.388225099910276
2019-09-25T09:30:00-04:00,77.34,77.87,77.07,77.72,10003012,10374015.9,53.591630738743916,60.49339892970113,NaN,NaN,7.551283869919686,32.23763799212704,-0.10727662803921678,0.6234673249228422,0.730743952962059,1006957793,1013977545.4,51.922788383340226,69.74211052448442,NaN,NaN,14.984567434296617,13.61627400482261
2019-09-26T09:30:00-04:00,77.85,78.085,77.42,77.83,9600984,10257999.7,54.31604224627723,60.185718527014494,NaN,NaN,10.449659815862763,18.660829248114123,-0.12585971924972983,0.5734193038998967,0.6992790231496265,1016558777,1010526490.2,49.75620060620874,69.3901283997295,NaN,NaN,14.204914753880216,13.700365540402268
2019-09-27T09:30:00-04:00,78.09,78.18,77.155,77.52,10226850,10236790.45,51.859247172883244,59.638055699459095,NaN,NaN,-8.36846372357551,8.421735885904933,-0.15706813550669785,0.5029438537662543,0.6600119892729521,1006331927,1007128737.6,47.648113634160325,68.57386060564139,NaN,NaN,12.875166858603714,13.582480014431047
2019-09-30T09:30:00-04:00,77.61,77.89,77.61,77.63,6225132,10173035.8,52.6771975285419,58.95326893606226,NaN,NaN,-9.168607935201093,1.9387094768108004,-0.16739245530409885,0.45077142014282856,0.6181638754469274,1012557059,1007872067.4,48.16552326330259,67.31837344532701,NaN,NaN,11.948787021576916,13.349095301166171
2019-10-01T09:30:00-04:00,77.91,78.24,75.695,75.77,15975632,10332462.4,40.23005556336405,57.191589634822556,NaN,NaN,-115.27813288500143,-22.96285217159911,-0.28942508658403976,0.25638251721687766,0.5458076038009174,996581427,1007797396.6,48.11408002470763,65.6621858480259,NaN,NaN,7.079159889029498,12.453390242289503
2019-10-02T09:30:00-04:00,75.12,75.13,73.79,74.34,12499799,10494165.6,33.64733487474065,54.94689388253737,NaN,NaN,-281.92073536472503,-80.85725601852805,-0.4469759174119707,-0.012912292964045946,0.43406362444792473,984081628,1003222163.6,44.94644959928891,63.45355070543995,NaN,NaN,0.3229485373732085,10.720469998730032
2019-10-03T09:30:00-04:00,74.17,74.85,73.18,74.83,16635180,10612572.1,37.42563106116693,52.85927314899978,NaN,NaN,-245.3194297829703,-132.01107393829466,-0.4949811296626835,-0.18466278763042965,0.31031834203225384,1000716808,1000053769.8,42.84290440797508,60.83348565937822,NaN,NaN,-3.929208575557196,8.627658773831856
2019-10-04T09:30:00-04:00,74.88,75.7,74.8,75.61,9178987,10724506.45,42.99065323631295,51.20659624530468,NaN,NaN,-145.70339578724102,-159.47806035102775,-0.4521734732634344,-0.25489849954703914,0.19727497371639524,1009895795,1000766543.4,43.48371137310991,58.10330200700522,NaN,NaN,-5.674452269971841,6.584500053288471
2019-10-07T09:30:00-04:00,75.38,75.87,75.07,75.23,7305680,10685742.05,41.0741368206116,49.439775379366814,NaN,NaN,-121.64313211346214,-181.97296518667997,-0.4276880134344129,-0.3373350430766209,0.09035297035779201,1002590115,998773154.6,42.063390597599444,55.182193593653054,NaN,NaN,-7.701193413156149,4.54368670093924
2019-10-08T09:30:00-04:00,74.47,74.87,74.02,74.07,11582450,10790496.75,35.82398913915351,47.369969405040415,NaN,NaN,-146.93237889646343,-188.3038143889724,-0.4647731100029719,-0.4906134171459229,-0.025840307142950977,991007665,997658402.2,41.2519157867782,52.185219922538366,NaN,NaN,-11.248659143775527,2.2876372945514163
2019-10-09T09:30:00-04:00,74.68,75,74.275,74.7,6271933,10390961.8,40.288064012592486,45.86034389433981,NaN,NaN,-110.42063689342545,-154.00379469471244,-0.423212446294058,-0.5548558650105235,-0.1316434187164655,997279598,1000297996.2,44.00647416886095,49.67046674396421,NaN,NaN,-12.695530787409167,0.14718471141419043
2019-10-10T09:30:00-04:00,74.55,75.65,74.55,75.38,9322265,9923687.85,44.75495287315649,45.16671278327832,NaN,NaN,-76.15496700094965,-120.17090213830834,-0.33038135236908983,-0.5446201091778278,-0.21423875680873797,1006601863,1001475007.2,45.23944884255723,47.79779277010017,NaN,NaN,-12.429782872761262,-1.649524943468017
2019-10-11T09:30:00-04:00,76.38,77.48,76.18,76.8,16252274,10268417.5,52.710543581594344,45.11801764425446,NaN,NaN,-0.8342805096054815,-91.19707908278123,-0.16230322824124127,-0.41711779211028954,-0.25481456386904827,1022854137,1004066675.6,47.95690800849761,46.68001454791126,NaN,NaN,-9.413771111963728,-2.7587029675388326
2019-10-14T09:30:00-04:00,76.65,76.87,76.405,76.65,4863349,10111000.75,51.860957839907165,45.232174049217654,NaN,NaN,-3.352351877959417,-67.53892303568068,-0.05569646666818834,-0.3244351472042837,-0.26873868053609534,1017990788,1007146810.2,51.06497234191078,46.31877721702126,NaN,NaN,-7.3432611936168835,-3.413639856978554
2019-10-15T09:30:00-04:00,76.79,77.57,76.63,77.27,8985775,10247750.7,55.08351477353081,45.33873719455958,NaN,NaN,28.48034842839277,-32.45637757070945,0.05605927780612163,-0.19866458327844327,-0.2547238610845649,1026976563,1014340589.8,57.45557330263677,46.71397613982816,NaN,NaN,-4.581700338663664,-3.580505640076427
2019-10-16T09:30:00-04:00,77.13,77.62,77.09,77.23,8797300,10283133.05,54.82850165801731,45.3753414382553,NaN,NaN,42.64716663000747,-1.8428168660228734,0.12293645566420047,-0.1010532915043143,-0.22398974716851477,1018179263,1018520522.8,60.6695837282044,47.49350350568499,NaN,NaN,-2.4705616611335897,-3.4219422145131646
2019-10-17T09:30:00-04:00,77.67,78.19,77.54,77.61,7978942,10428240.8,56.87125523770842,45.73334201431423,NaN,NaN,73.84459429052892,28.157095392272844,0.1847020269904062,0.00688778656949296,-0.17781424042091323,1026158205,1022431791.2,63.45187557007169,48.62234364396437,NaN,NaN,-0.09775692399183186,-2.9470586015815456
2019-10-18T09:30:00-04:00,77.44,77.6,76.86,76.94,9694811,10388313.2,52.37404214218857,45.71168805814614,NaN,NaN,40.68227102537079,36.460405699268094,0.172596368769574,0.037931220541054245,-0.13466514822851974,1016463394,1021153642.6,61.91057482451033,49.60413304119349,NaN,NaN,0.6255012647843694,-2.436692906386415
2019-10-21T09:30:00-04:00,77.23,77.57,77.11,77.4,8428017,10085700.05,55.00482103388891,46.76702844889791,NaN,NaN,55.05342815328565,48.14156170551711,0.18654483167665498,0.09851589136729899,-0.08802894030935599,1024891411,1022533767.2,62.95691219666232,50.66433533919025,NaN,NaN,2.016176715351144,-1.800568674709621
2019-10-22T09:30:00-04:00,77.49,78.24,77.2,78.01,11366748,10059756,58.2947606711361,48.52755886292615,NaN,NaN,79.74083140239648,58.39365830031786,0.22523978764730743,0.1935207942497783,-0.03171899339752912,1036258159,1024390086.4,64.37449171914047,52.05205263346537,NaN,NaN,4.197940875499903,-0.9436387389654034
2019-10-23T09:30:00-04:00,77.98,78.05,77.67,78,7390190,9929114.9,58.21960771479706,50.012842909614015,NaN,NaN,83.04887834907845,66.47400064413206,0.23733659391427567,0.2649517489953155,0.02761515508103981,1028867969,1026527827.6,65.98866829600026,53.705321482610024,NaN,NaN,5.942905795758195,0.0401533374236821
2019-10-24T09:30:00-04:00,78.13,78.215,77.55,78.11,8414560,9869793.7,58.8480769872003,51.14551603467741,NaN,NaN,85.03977528571245,68.71303684316877,0.2392452422175528,0.32667170785298083,0.08742646563542802,1037282529,1028752692.4,67.63240979506773,55.43022851274986,NaN,NaN,7.567754760845327,1.11552496934106
2019-10-25T09:30:00-04:00,78.09,78.78,78.05,78.6,7718550,9744378.7,61.61775918453559,52.61291763210055,NaN,NaN,109.40475858672724,82.45753435544006,0.25837351993802976,0.41039336555796524,0.15201984561993548,1045001079,1034460229.4,71.44501327051815,57.52891584652978,NaN,NaN,9.763028345824974,2.350882594553048
2019-10-28T09:30:00-04:00,78.77,79.23,78.76,78.82,8138157,9840029.95,62.82744746488092,54.54173608393821,NaN,NaN,126.9943709440276,96.84572291358845,0.2694723371051485,0.4888602670013711,0.2193879298962226,1053139236,1040109794.4,74.63048916733746,59.91309965942687,NaN,NaN,11.958237145437144,3.7233618161079187
2019-10-29T09:30:00-04:00,78.5,79.29,78.4044,79.08,10429211,9562708.9,64.26102310753046,56.254090305005214,NaN,NaN,112.154829224684,103.32852247804594,0.27689515020589883,0.5655068676535961,0.2886117174476973,1063568447,1045571852,77.27051352510728,62.289102470587316,NaN,NaN,14.231951484132116,5.224588911539946
2019-10-30T09:30:00-04:00,79.23,79.43,78.795,79.36,9208262,9398132.05,65.79107790955243,57.75667066474778,NaN,NaN,118.09776679357458,110.33830016694517,0.28227005226443386,0.6414492827782396,0.3591792305138058,1072776709,1054353600,80.74065195727424,64.82490269306712,NaN,NaN,16.610204872709424,6.8511054774213
2019-10-31T09:30:00-04:00,79.12,79.12,78.11,78.51,10693182,9101032.15,57.71339059640844,58.11401688009164,NaN,NaN,82.05601427604788,109.74154796501224,0.2133222914483871,0.6258320948242897,0.4125098033759026,1062083527,1059313799.6,82.37722136319425,67.28349650411687,NaN,NaN,16.52594639116885,8.233225607956665
2019-11-01T09:30:00-04:00,79.06,80.22,79.01,80.22,19657946,9624980.1,66.59825913335857,59.16668125819531,NaN,NaN,139.44490019140636,115.74957628594807,0.26429189568489886,0.7428746729820261,0.4785827772971273,1081741473,1066661878.4,84.4810677190656,69.67036045962793,NaN,NaN,19.361384695073806,9.82296262040197
2019-11-04T09:30:00-05:00,80.66,81.18,80.66,81.15,15294167,10024404.45,70.25829638002268,60.250594230087586,NaN,NaN,182.2250432867622,126.79571075449499,0.33737131780479224,0.9002969245531176,0.5629256067483254,1097035640,1075441159.2,86.5474640154328,71.74835265339907,NaN,NaN,23.034341212490926,11.710302419271821
2019-11-05T09:30:00-05:00,81.3,81.68,81.085,81.32,14923911,10191477.5,70.88630327580628,61.39758005992966,NaN,NaN,182.46551609295935,140.85784812815007,0.37120743939218304,1.0269349059885542,0.6557274665963712,1111959551,1085119380,88.38374516903046,73.72793561345807,NaN,NaN,26.13010607611294,13.770274370249124
2019-11-06T09:30:00-05:00,81.25,81.38,80.9,81.37,12253192,10490540.45,71.07972566595515,62.41247080480442,NaN,NaN,153.48480032204677,147.9352548338445,0.3701686985696738,1.1184383398084634,0.7482696412387896,1124212743,1095406586.8,89.95351438808513,75.62090981474475,NaN,NaN,28.64946556824208,15.895873112819546
2019-11-07T09:30:00-05:00,81.8,82.18,81.515,81.65,10296960,10539275.2,72.19382361729456,63.828169481597705,NaN,NaN,160.64188650477578,163.65242927959008,0.3611598954739542,1.1997195105812324,0.8385596151072782,1134509703,1109891822,91.66210777024907,77.74601931086895,NaN,NaN,31.07362299939166,18.06412309661556
2019-11-08T09:30:00-05:00,81.48,81.76,81.23,81.76,6323390,10042831,72.63974716935063,65.08780706270213,NaN,NaN,130.3334831608857,161.83014587348595,0.33595570878984016,1.2585042510945783,0.9225485423047382,1140833093,1121710146,92.7460673683246,79.87381610884482,NaN,NaN,33.19671413187026,20.22592181593766
2019-11-11T09:30:00-05:00,81.26,81.925,81.13,81.8,5801492,10089738.15,72.81050173338089,66.12464571000531,NaN,NaN,114.43804943307933,148.27274710274938,0.2966888670587542,1.293409626128181,0.9967207590694267,1146634585,1131629935,93.50886397721739,81.95484269870747,NaN,NaN,35.00075913589606,22.336612861646003
2019-11-12T09:30:00-05:00,81.93,82.17,81.62,81.79,8293520,10055125.4,72.68836626165329,67.15812846335218,NaN,NaN,108.81876916116242,133.54339771639002,0.2467991611791427,1.305219710543355,1.0584205493642123,1138341065,1136906237.8,93.87764270902855,83.94691229963806,NaN,NaN,36.47746150961832,24.35673409707062
2019-11-13T09:30:00-05:00,81.46,81.75,81.2,81.45,9892093,10109865.05,68.48217573815182,67.84627837413443,NaN,NaN,81.27860540531952,119.10215873304455,0.17124421640086385,1.2724758198652921,1.1012316034644283,1128448972,1137753483.6,93.93720649983936,85.82582634997888,NaN,NaN,36.685658512796806,26.118009013602933
2019-11-14T09:30:00-05:00,81.29,81.88,81.28,81.71,7355029,10078669.4,69.91581976303362,68.43899698688429,NaN,NaN,79.16076866292424,102.80593516467427,0.12146381023537645,1.253061366258649,1.1315975560232725,1135804001,1138012343.2,93.95655235613906,87.43379342752324,NaN,NaN,37.23586531280033,27.70627419920256
2019-11-15T09:30:00-05:00,82.17,82.48,82.1,82.31,6150737,9901465.7,72.971258054794,69.1635548861638,NaN,NaN,97.63583515493731,96.26640556348458,0.11186912179089781,1.2714339582618948,1.159564836470997,1141954738,1138236672.2,93.97449615436892,88.8155082123112,NaN,NaN,38.57022020613059,29.258266485906564
2019-11-18T09:30:00-05:00,82.16,82.16,81.83,82,5119374,9736033.55,69.06816947225752,69.50692248364429,NaN,NaN,77.62000281966245,88.9027962408012,0.06963598567851514,1.2466098185691408,1.1769738328906256,1136835364,1136276828,91.42065001477371,89.82623224728738,NaN,NaN,38.64806029601411,30.599665601636215
2019-11-19T09:30:00-05:00,82.26,82.33,81.745,81.93,9192815,9627336.9,68.18133391555537,69.67765505550165,NaN,NaN,72.2353973193635,81.58612187244142,0.02431715848062943,1.2073702809914124,1.183053122510783,1127642549,1134137124.8,88.59000050315632,90.38690000056467,NaN,NaN,38.475807413586985,31.724828717629183
2019-11-20T09:30:00-05:00,81.67,81.86,80.96,81.28,14726652,9994160,60.42301633734304,69.87119975128269,NaN,NaN,37.52026460154566,72.83445371168665,-0.05762970103962606,1.1110159962112505,1.1686456972508765,1112915897,1131030509.8,84.49915801971984,90.5384669046022,NaN,NaN,36.10329131999929,32.35032337511063
2019-11-21T09:30:00-05:00,81.29,81.51,81,81.25,6094774,9878170.7,60.08319732259319,69.40583819337088,NaN,NaN,26.462045045984368,62.29470898829868,-0.11854021051692265,1.0204704341047233,1.139010644621646,1106821123,1125233934.2,77.32430768151362,90.02726975906278,NaN,NaN,34.04797052367212,32.592844396333696
2019-11-22T09:30:00-05:00,81.45,81.6917,81.195,81.67,5205115,9752498.95,63.203286620155026,68.90190892480891,NaN,NaN,38.96329736832432,50.56020143097608,-0.13408438793653388,0.9714051597009785,1.1054895476375124,1112026238,1119248234.2,70.65288452927413,88.89194265290858,NaN,NaN,33.067700206719365,32.6606809406745
2019-11-25T09:30:00-05:00,81.97,82.42,81.76,82.26,9190238,9805103,67.09435681329535,68.63105560605813,NaN,NaN,83.26143312324292,51.68848749169217,-0.10922436755682385,0.9689590881914825,1.0781834557483063,1121216476,1116124456.6,67.38536726796538,87.39205851711823,NaN,NaN,33.30047606661878,32.75208024438083
2019-11-26T09:30:00-05:00,82.34,82.65,82.18,82.5,6069444,9587114.65,68.55118467617011,68.4504455353592,NaN,NaN,111.8322006414377,59.607848156107,-0.08243022001212563,0.9751456807331493,1.057575900745275,1127285920,1116053130.8,67.30882325634482,85.77458057913677,NaN,NaN,33.91329840972111,32.917968553715156
2019-11-27T09:30:00-05:00,82.44,82.45,82.1,82.42,9186238,9586013.45,67.4787561630628,68.11365500291406,NaN,NaN,101.62096130945767,72.42798749768941,-0.07606216979653291,0.9624981884996089,1.0385603582961418,1118099682,1117089887.8,67.87995561256815,84.0758554250167,NaN,NaN,34.12516068524662,33.09042457250536
2019-11-29T09:30:00-05:00,82.32,82.32,81.9,82.04,5645448,9333626.75,62.478819574503056,67.38787446042495,NaN,NaN,71.3078068372436,81.39713985594126,-0.10180256345711625,0.9113071539747466,1.0131097174318628,1112454234,1118216510,68.52350021979355,82.34567205726448,NaN,NaN,32.89850270053189,33.063007162223435
2019-12-02T09:30:00-05:00,82.03,82.15,80.65,80.69,18275953,9264527.1,48.678987055616176,65.66419484058461,NaN,NaN,-100.66324680277545,53.4718310217213,-0.20798965899414523,0.7531226436891814,0.9611123026833266,1094178281,1114646918.6,64.13872129925193,80.2478047231241,NaN,NaN,27.055983784667593,32.204860965429745
2019-12-03T09:30:00-05:00,79.84,79.88,79.26,79.81,20416279,9520632.7,42.14444801513065,63.48248639440443,NaN,NaN,-315.91074956587823,-26.36260551610294,-0.3285643332427023,0.5504068861299487,0.878971219372651,1073762002,1105156023.8,54.20676135601573,77.41417034076606,NaN,NaN,19.627540707554296,30.408100928590397
2019-12-04T09:30:00-05:00,80.23,80.9,80.04,80.12,16090298,9578952.05,44.94800993425432,61.801474551268896,NaN,NaN,-174.4868807374988,-83.62642179189024,-0.37514425490939474,0.4100409007359076,0.7851851556453023,1089852300,1097669299.8,47.90496280383224,74.12615293390841,NaN,NaN,14.617018560718082,28.152232018894352
2019-12-05T09:30:00-05:00,80.27,80.33,79.79,80.14,18539367,9893260.8,45.13273736483789,60.0312543799692,NaN,NaN,-178.66940293924785,-139.68449464163137,-0.390555995577217,0.2969901611737811,0.6875461567509981,1108391667,1095727696.8,46.39846681336434,70.72914682371021,NaN,NaN,10.75998041085781,25.667624646317705
2019-12-06T09:30:00-05:00,80.89,81.26,80.86,81.11,8966740,9826749.8,53.31481943857958,58.62722305023959,NaN,NaN,-50.34773527592526,-164.01560306426512,-0.32410727856838606,0.28241205854051543,0.6065193371089015,1117358407,1096708531.4,47.30007428600189,67.39525954739827,NaN,NaN,9.98352164172656,23.427038502804685
2019-12-09T09:30:00-05:00,80.88,81.0995,80.76,80.8,7266513,9873905.95,50.712046298609025,57.316071394978984,NaN,NaN,-65.45175425104752,-156.97330455391955,-0.2907812677739303,0.24304275239148865,0.533824020165419,1110091894,1099891254,50.22579149875308,64.45276965339679,NaN,NaN,8.514684273955329,21.296702184397635
2019-12-10T09:30:00-05:00,80.79,81.03,80.56,80.7,9046866,10036174.65,49.86634135611659,56.007857640733356,NaN,NaN,-70.8273441080025,-107.9566234623444,-0.2658984733656952,0.20145092845829993,0.46734940182399515,1101045028,1105347859.2,54.85339236979926,62.04301192958557,NaN,NaN,7.084021928638052,19.266319290717696
2019-12-11T09:30:00-05:00,80.78,81.28,80.58,81.21,9070298,10075013.55,54.072941424842156,55.554280861269,NaN,NaN,-38.327787157129684,-80.72480474627056,-0.208077309280509,0.2072527652233589,0.4153300745038679,1110115326,1109400464.4,57.978195610982695,60.148657471818616,NaN,NaN,7.159964475361439,17.53684003138109
2019-12-12T09:30:00-05:00,81.25,82.19,81.04,81.93,15561888,10358503.3,59.26899854807176,55.49612380594605,NaN,NaN,35.2085782214776,-37.949208514125466,-0.1187661344910772,0.2668724063900214,0.3856385408810986,1125677214,1112857573.8,60.49044745768355,58.94623888440218,NaN,NaN,8.910795404600625,16.304547941841022
2019-12-13T09:30:00-05:00,81.89,82.535,81.445,81.71,11754864,10578495.05,57.14167702007473,55.063151691654596,NaN,NaN,51.42651904366683,-17.59435765020705,-0.07411738236147186,0.2929918129292588,0.36710919529073066,1113922350,1112170362.4,59.72605877160918,58.16575133028324,NaN,NaN,9.678088821207599,15.357910924607676
2019-12-16T09:30:00-05:00,81.99,82.12,81.66,81.67,8046880,10673302.2,56.74289184475666,54.32376133675898,NaN,NaN,47.37197895202521,4.97038899040749,-0.04814662487135046,0.3069259142015426,0.35507253907289305,1105875470,1111327077.6,58.745062350990985,57.54858669335651,NaN,NaN,10.178372236323822,14.617976826281412
2019-12-17T09:30:00-05:00,81.68,81.86,81.54,81.59,5949606,10714813.8,55.902595118850414,53.42029065409328,NaN,NaN,33.46988769069615,25.82983535014722,-0.03768727324619492,0.30796344751514937,0.3456507207613443,1099925864,1111103244.8,58.470541825036136,56.91728087683446,NaN,NaN,10.35590781396393,14.009109824521772
2019-12-18T09:30:00-05:00,81.6,81.62,81.1,81.25,6679406,10589143.35,52.35409001082034,52.33995735750453,NaN,NaN,-0.5577773100508645,33.38383731956298,-0.054005162480305124,0.2781442676609629,0.332149430141268,1093246458,1107729471.2,54.3480102270784,55.95071334929948,NaN,NaN,9.512507149400106,13.366738013790105
2019-12-19T09:30:00-05:00,81.26,81.56,81.17,81.47,5743972,10140009.35,54.372318418191576,51.76092156062514,NaN,NaN,8.1883686223195,27.979795399731366,-0.050390116378648264,0.2691617846679577,0.31955190104660597,1098990430,1102392114.4,48.519732282180854,54.521872782327144,NaN,NaN,9.35650835364205,12.793848062340382
2019-12-20T09:30:00-05:00,81.34,81.63,81.16,81.44,8913222,10280931.75,54.03618428156077,52.143578505335476,NaN,NaN,8.449761191818826,19.384443829361764,-0.05031056595021044,0.2566636936088429,0.30697425955905333,1090077208,1097623086,43.98123213293039,53.08205212758988,NaN,NaN,9.137602166694588,12.271527220105268
2019-12-23T09:30:00-05:00,81.93,82.2,81.79,82.11,5675994,10304475.7,59.98577880240186,53.41795927585485,NaN,NaN,75.15401005685595,24.940850050327914,-0.007664133251772121,0.29739409299433817,0.3050582262461103,1095753202,1095598632.4,42.17763799480667,52.222829030360664,NaN,NaN,10.651578674226672,12.040105999265469
2019-12-24T09:30:00-05:00,82.09,82.1999,81.6901,81.78,4451649,10067546.25,56.13184349758178,54.21680453037823,NaN,NaN,61.71531415077572,30.589935342343825,-0.00437339558367833,0.2995914817665124,0.30396487735019073,1091301553,1093873770.2,40.64815883764374,51.70448588991862,NaN,NaN,10.85075426361427,11.870198608458155
2019-12-26T09:30:00-05:00,81.96,81.98,81.585,81.97,3914175,9959782.8,57.81244526648341,55.12249795192434,NaN,NaN,62.86448937023723,43.27438867840144,0.007272602018024543,0.3130556298727214,0.30578302785469685,1095215728,1094267624.2,41.172731352308,51.33121907127174,NaN,NaN,11.496650248375882,11.816834557017831
2019-12-27T09:30:00-05:00,82.23,82.23,81.79,81.9,5300722,9765507,56.94685120161795,55.381928792141366,NaN,NaN,82.42080302666238,58.12087555927002,0.006935843915770568,0.31445283274941005,0.3075169888336395,1089915006,1092452539.4,39.44258420895243,50.76996978005393,NaN,NaN,11.798762653340756,11.814252856492535
2019-12-30T09:30:00-05:00,81.99,81.99,81.355,81.52,7716351,9869052.15,52.3634155563769,55.49988373912479,NaN,NaN,43.52924198144437,65.13677171719513,-0.020693103875713992,0.28165060898899696,0.30234371286471096,1082198655,1090876828.8,37.951617746500816,49.893243083464476,NaN,NaN,10.785783914774493,11.667328721961386
2019-12-31T09:30:00-05:00,81.32,81.69,81.175,81.47,6458168,9278162.9,51.77294884896285,55.63606998861381,NaN,NaN,19.305662699791508,53.967102245782236,-0.042872919499586104,0.24875256349022834,0.29162548298981444,1075740487,1086874285.8,34.394963862843866,48.43192676153909,NaN,NaN,9.782946796132363,11.398131303985812
2020-01-02T09:30:00-05:00,82.05,83.01,81.83,83.01,16058043,9060251.1,64.90094129495935,56.40949855076502,NaN,NaN,168.12295447183328,75.24863030999376,0.04109317946329205,0.3429919573189295,0.30189877785563746,1091798530,1086973681.2,34.55897614023385,46.759125370771315,NaN,NaN,13.135739935399782,11.646361108473522
2020-01-03T09:30:00-05:00,82.06,82.95,81.99,82.85,17571308,9134301.6,62.98265887621907,56.67476000277554,NaN,NaN,151.88260917346946,93.05225427064019,0.07860415148770966,0.4001539672152745,0.32154981572756486,1074227222,1082775980,31.03071383169683,44.65485868320083,NaN,NaN,15.188379114908198,12.152363680821333
2020-01-06T09:30:00-05:00,82.46,82.89,82.2731,82.88,16153206,9014993.55,63.20227713828833,57.10766001121937,NaN,NaN,157.18749425140936,108.0055925155896,0.09697776415913484,0.4427720209264834,0.34579425676734854,1090380428,1082869064.4,31.198458310059962,42.61717293594732,NaN,NaN,16.884121925479484,12.828329144343925
2020-01-07T09:30:00-05:00,82.57,83.02,82.29,82.71,16689119,9401112.5,60.99395525437616,57.41130739762077,NaN,NaN,138.31509408610927,126.96276293652258,0.08940871089853308,0.4575551453905149,0.3681464344919818,1073691309,1081167595.2,29.773023644829763,40.54774159979295,NaN,NaN,17.646944631213216,13.516702785325252
2020-01-08T09:30:00-05:00,82.77,83.36,82.625,82.99,10677738,9571673.75,63.2703137677047,57.937573015396076,NaN,NaN,165.19705653615958,156.1410417037962,0.09449024768418435,0.4862592440972122,0.39176899641302787,1084369047,1082893307.2,33.11110644640597,38.736353358462225,NaN,NaN,18.963497143612326,14.294816265080549
2020-01-09T09:30:00-05:00,83.34,83.43,83.08,83.34,7407283,9489694.6,65.9456366792739,58.90839777742847,NaN,NaN,174.9144431736443,157.49933944415838,0.11148642075235643,0.5311270223534734,0.419640601601117,1091776330,1082888867.2,33.1067462207173,37.21912021515072,NaN,NaN,20.894395686067757,15.237613325221579
2020-01-10T09:30:00-05:00,83.51,83.51,82.61,82.75,8857680,9479063.7,58.24406566927019,59.18495115250551,NaN,NaN,111.81185351878358,149.48518831322122,0.0748167854476035,0.5131615834106213,0.43834479796301784,1082918650,1084627152.8,36.625375564749476,36.36952330676276,NaN,NaN,20.248643108334537,15.953474722809144
2020-01-13T09:30:00-05:00,83.01,83.52,82.85,83.43,7893866,9095662.6,63.53051924709248,59.86311793575778,NaN,NaN,128.08044569812878,143.6637786025651,0.08731065447106612,0.5474831160518505,0.4601724615807844,1090812516,1084713570.4,36.80334729665522,35.856817247028815,NaN,NaN,21.388407027717243,16.7298936235103
2020-01-14T09:30:00-05:00,83.48,83.98,83.33,83.44,9649517,8990395.25,63.60349551742173,60.12152627254492,NaN,NaN,139.2280803882655,143.84637586299635,0.08700747289225169,0.568931802696099,0.4819243298038473,1100462033,1090067715.2,46.776097436163724,36.18527863569717,NaN,NaN,22.30755057757791,17.526701759805672
2020-01-15T09:30:00-05:00,83.45,83.92,83.38,83.57,12014515,9188777,64.59533325920405,60.72606125551793,NaN,NaN,124.81479042640714,135.76992264104587,0.08615905322294448,0.5896231463325279,0.5034640931095834,1112476548,1095689215.4,54.834901953960554,37.198617429719796,NaN,NaN,23.353733838461462,18.359134913899357
2020-01-16T09:30:00-05:00,84,84.44,83.93,84.4,9493262,9365959.8,70.18228301732618,61.60962109486385,NaN,NaN,162.39001188248005,133.265036382813,0.12948935520441995,0.6653257871151084,0.5358364319106884,1121969810,1101727911.4,61.566912667398526,38.655344666511986,NaN,NaN,26.122950250990257,19.46825139062663
2020-01-17T09:30:00-05:00,84.46,84.805,84.3,84.41,7013382,9382658.6,70.24320961574463,62.55936098158718,NaN,NaN,166.55051025059402,144.21276772917508,0.1456129612387541,0.7178526334591311,0.572239672220377,1128983192,1110940819.8,69.12744931756738,40.77569217427019,NaN,NaN,28.332208187231906,20.734530932998812
2020-01-21T09:30:00-05:00,84.03,84.27,83.1101,83.48,13004981,9745709.05,58.310320525183066,62.98413990793048,NaN,NaN,79.01904449766242,134.40048748908183,0.0835182258816416,0.676637454572429,0.5931192286907874,1115978211,1115973958.8,72.32991641161345,43.23128493606395,NaN,NaN,26.45682361964468,21.552001316805363
2020-01-22T09:30:00-05:00,83.71,83.9,82.98,83.04,7490548,9674575.35,53.66528432879227,63.11930672791829,NaN,NaN,44.535020133794966,115.46187543818772,0.006733158455444865,0.6015356767600935,0.5948025183046486,1108487663,1117579084.8,73.28177970295646,46.008914638929134,NaN,NaN,23.350092857719307,21.808871536935925
2020-01-23T09:30:00-05:00,82.93,84.05,82.631,83.94,10758535,9928702.4,60.582174133218146,62.81082335922249,NaN,NaN,60.693835742943065,102.63768450149489,0.010265998888722594,0.6076350169155518,0.5973690180268292,1119246198,1118933014.8,74.09139716423874,48.83265899778662,NaN,NaN,22.992015102005347,21.977892046231556
2020-01-24T09:30:00-05:00,84.1,84.17,82.93,83.55,13402179,10376228.9,56.63661612325175,62.3575345911534,NaN,NaN,56.156130243882664,81.39090817377541,-0.018392833994224644,0.5743779755340483,0.592770809528273,1105844019,1115707856.6,68.74737838392582,51.52670646580299,NaN,NaN,21.35327825280882,21.888661504314022
2020-01-27T09:30:00-05:00,82.06,82.52,81.97,81.97,15013843,10931212.3,44.10451721474578,60.993408882328936,NaN,NaN,-89.28773151758438,30.22325982013975,-0.1416275396331097,0.4157363849868858,0.5573639246199955,1090830176,1108077253.4,58.07456972992787,53.44642871007927,NaN,NaN,14.933892367152593,20.895123056148105
2020-01-28T09:30:00-05:00,82.24,82.91,81.86,82.5,14918252,11412088.8,48.24174654801742,60.08253683187474,NaN,NaN,-65.86978381097049,1.245494158413166,-0.18270233470458686,0.328986006239262,0.5116883409438489,1105748428,1106031296.8,55.582924502635,55.28999305706535,NaN,NaN,11.463031331072113,19.54768138113725
2020-01-29T09:30:00-05:00,83.33,83.57,82.853,82.94,10355148,11544028.65,51.454263777827286,59.238533261169216,NaN,NaN,1.3819490701303176,-7.3851200543197635,-0.17545485506976793,0.29236977210663895,0.4678246271764069,1116103576,1107554479.4,57.059999300136255,57.00062826090323,NaN,NaN,9.891352808435254,18.16820587075125
2020-01-30T09:30:00-05:00,82.14,83.12,81.97,83.03,13158159,11879028.2,52.10904150509881,58.25020503444242,NaN,NaN,-64.63789218236623,-32.451465639381624,-0.1602361198960422,0.2675294773063541,0.4277655972023963,1129261735,1109557586.8,58.991366171980786,58.84952968599348,NaN,NaN,8.90643858823729,16.845096258963544
2020-01-31T09:30:00-05:00,82.58,82.7,80.801,81.11,19083574,12030304.75,39.78169740916241,56.931464444434724,NaN,NaN,-197.12676731519073,-83.10804515119631,-0.26872724116881375,0.09185654574137914,0.3605837869101929,1110178161,1110424415.2,59.83330855159366,60.50723918505378,NaN,NaN,3.2093190279661834,14.897128083106779
2020-02-03T09:30:00-05:00,81.55,82.23,80.99,81.08,15676592,11935568.95,39.62396567359037,55.22385347489887,NaN,NaN,-181.13258931065434,-101.4770167098103,-0.32784215159791386,-0.04921890258719941,0.27862324901071445,1094501569,1111158693.8,60.57176824002417,62.20498353815156,NaN,NaN,-1.0479926889063838,12.619253687104898
2020-02-04T09:30:00-05:00,82.32,82.81,82.24,82.61,13597203,11807768.8,50.42067157589067,54.282223193360934,NaN,NaN,-55.11018011187475,-99.32509596999115,-0.2526073342242346,-0.03713591876957878,0.2154714154546558,1108098772,1111628762.6,61.065263753113044,63.225638275076506,NaN,NaN,-0.7655418858296527,10.707140033828534
2020-02-05T09:30:00-05:00,83.54,84,83.11,83.99,12835799,11615102.8,57.75807974566099,53.793847942393576,NaN,NaN,65.07704165306517,-86.58607745340417,-0.10610555005762118,0.08283947788262935,0.18894502794025053,1120934571,1112594961.6,62.114889103025405,63.745637357152575,NaN,NaN,2.359069465159698,9.5145585240187
2020-02-06T09:30:00-05:00,84.33,84.4,83.72,84.26,8627569,11512594.35,59.03545795825165,52.99764615245967,NaN,NaN,100.23174950957439,-53.61214911501605,0.006789351789415532,0.19743171767701995,0.19064236588760441,1129562140,1112655042.6,62.18316030652644,63.78965504566171,NaN,NaN,5.161568727083461,8.892702838742236
2020-02-07T09:30:00-05:00,83.94,84.15,83.58,83.65,12394524,11761956.4,54.98963006431997,51.908104755929344,NaN,NaN,60.99497465838292,-1.9878007203013213,0.0365269551016075,0.2363010597646138,0.1997741046630063,1117167616,1114052933.6,63.816945881575926,63.41033337166232,NaN,NaN,5.978841187104287,8.476436888508244
2020-02-10T09:30:00-05:00,83.52,84.14,83.42,84.12,8074222,11722783.5,57.41144038758694,51.84389903181533,NaN,NaN,65.3955376864603,47.3178246791216,0.08142410501583341,0.30155423593279806,0.22013013091696465,1125241838,1120200987.4,69.96322360279659,63.24128388531825,NaN,NaN,7.4510829913025445,8.329957760336
2020-02-11T09:30:00-05:00,84.55,84.84,84.23,84.44,6291531,11642666.75,59.02785600499042,52.226939865829486,NaN,NaN,112.56427159070745,80.85271501963803,0.12371115068507865,0.374769069273313,0.25105791858823434,1131533369,1124887906.8,73.63940309285053,63.266828413167836,NaN,NaN,9.148492170465262,8.446891247497323
2020-02-12T09:30:00-05:00,84.9,85.325,84.695,85.23,7808960,11550638.9,62.78328785729477,52.384162274692095,NaN,NaN,147.49515050522209,97.33633679006941,0.19185781602737667,0.4908801886224552,0.2990223725950785,1139342329,1128569458.4,76.11250537723505,63.41119328552471,NaN,NaN,11.818934013053918,8.928611642576836
2020-02-13T09:30:00-05:00,84.79,85.11,84.46,84.75,8231457,11361486,59.230915592711526,52.56946937965352,NaN,NaN,109.33063435702071,99.15611375955868,0.191154713372382,0.537965764310556,0.346811050938174,1131110872,1128879204.8,76.31385061471397,63.95165558772386,NaN,NaN,12.881882736204043,9.493364655952151
2020-02-14T09:30:00-05:00,84.73,84.89,84.3,84.64,5319331,11152789.45,58.41520435237886,53.59166131805588,NaN,NaN,93.00686013186856,105.5584908542558,0.1705116231354718,0.5599505798575137,0.38943895672204193,1125791541,1130603989.8,77.45348005426564,65.33586346803371,NaN,NaN,13.484904029087094,10.0635845664
2020-02-18T09:30:00-05:00,84.29,84.5264,83.765,84.16,10399658,11322103.25,54.86451420908104,54.06471615098899,NaN,NaN,58.68299268825838,104.21598185461542,0.11445151379267904,0.5325033489628908,0.4180518351702117,1115391883,1128633998.8,73.12581280446844,66.58892691816466,NaN,NaN,12.935603510235596,10.473872986947942
2020-02-19T09:30:00-05:00,84.33,84.57,84.09,84.13,4638710,10903789.7,54.640966641487466,54.29233778410758,NaN,NaN,63.26070133824126,94.35526780412218,0.06758855714952478,0.5025375316071177,0.4349489744575929,1110753173,1124477959.6,64.88858115228382,67.1481113361752,NaN,NaN,12.428178438076683,10.753059479966334
2020-02-20T09:30:00-05:00,83.98,84.59,83.4,84.01,9518717,11005198.15,53.69845894012436,54.40586760089512,NaN,NaN,39.35083658377641,72.72640501983305,0.023049193527564626,0.4637604663670487,0.4407112728394841,1101234456,1116856385,53.08014408478571,66.72588118708984,NaN,NaN,11.74916558785529,10.895360352521898
2020-02-21T09:30:00-05:00,83.56,83.84,83.21,83.59,13184752,11126509,50.420337700631165,55.16577047885717,NaN,NaN,3.946078154084432,51.6494937792458,-0.036896792885049046,0.3945902817331728,0.43148707461822183,1088049704,1108244151.4,43.45658865229627,65.55611547999717,NaN,NaN,10.255612803743606,10.80396784555357
2020-02-24T09:30:00-05:00,81.21,81.72,80.71,81.21,18010144,11356907.25,36.73499850786623,54.95941568130545,NaN,NaN,-145.960755877956,3.855970577280891,-0.22835541015133765,0.14604281192904978,0.3743982220803874,1070039560,1097093755.2,34.687803315517016,63.70726084253238,NaN,NaN,3.957987381486379,9.825970636401115
2020-02-25T09:30:00-05:00,81.38,81.62,77.69,77.9,33000782,12256254.2,26.11758811345112,53.223481148274054,NaN,NaN,-235.89594233704676,-55.05981642778014,-0.551036978705338,-0.31439800130128503,0.23663897740405293,1037038778,1081423134.2,26.57261368659313,61.243500123495245,NaN,NaN,-6.8729870390064525,7.440405254200034
2020-02-26T09:30:00-05:00,78.39,79.39,77.14,77.31,32619780,13141330.6,24.744716990253863,50.86538380860212,NaN,NaN,-231.62079660647612,-114.0361160167236,-0.7642110795640157,-0.7186248720509667,0.04558620751304898,1004418998,1060156299.2,19.80195081471919,58.221147388616224,NaN,NaN,-15.440194568046692,4.171748136736216
2020-02-27T09:30:00-05:00,75.79,77.4,74.39,74.44,42597284,14753437.4,19.402042435551337,48.03442555698066,NaN,NaN,-250.90014584789023,-172.08631250305694,-1.0413355644328777,-1.2560832480280482,-0.2147476835951705,961821714,1032273750.8,14.562842697169643,54.81969613080503,NaN,NaN,-25.32540053629941,-0.04213024512601571
2020-02-28T09:30:00-05:00,72.17,73.67,71.3,73.08,79119620,18051510.45,17.476422954717748,45.35491076343765,NaN,NaN,-246.48906914236247,-222.17334196234634,-1.2452775008946504,-1.7713445597134836,-0.5260670588188332,882702094,991204228.8,10.25781386407931,50.99404384384098,NaN,NaN,-33.65198900157739,-4.843538638904783
2020-03-02T09:30:00-05:00,73.95,75.83,72.59,75.65,44798853,19337274.4,31.343464154156806,43.492912461049784,NaN,NaN,-157.59915412336773,-224.50102161142868,-1.1390174023673172,-1.9498388117779797,-0.8108214094106625,927500947,962696506.2,8.40127982764514,46.59676214561588,NaN,NaN,-34.575481553453216,-9.090959055268844
2020-03-03T09:30:00-05:00,75.85,77.53,73.35,73.8,53823948,21244642.2,27.731065981285468,41.25742745935657,NaN,NaN,-127.68042765824312,-202.85791867566792,-1.1233770308867306,-2.215042698019076,-1.0916656671323453,873676999,930024150.4,6.867250679917774,41.827322687549255,NaN,NaN,-36.785168011868144,-13.047274620497316
2020-03-04T09:30:00-05:00,74.96,76.95,74.26,76.85,32387758,22184169.95,40.00717477837769,39.63056223943393,NaN,NaN,-91.5773611118239,-174.84923157673748,-0.8500882866449513,-2.1542760254385342,-1.304187738793583,906064757,910353302.2,6.140299813083743,36.82930800439558,NaN,NaN,-33.26696006087875,-15.935801111980378
2020-03-05T09:30:00-05:00,74.67,75.22,72.77,73.09,28762273,22980493.65,32.64510625555958,37.731575858208785,NaN,NaN,-113.88016017994187,-147.44523444314783,-0.8622975488341271,-2.382059674836242,-1.5197621260021148,877302484,893449456.2,5.592438655758571,31.777778578755914,NaN,NaN,-33.677945963198674,-18.470393233582993
2020-03-06T09:30:00-05:00,70.66,72.74,70.45,72.45,40681434,24583186.9,31.579862447910344,35.81476572217533,NaN,NaN,-123.77718809349027,-122.9028582333734,-0.8517349390901408,-2.5844307998647906,-1.7326958607746499,836621050,884233247.4,5.314046042408918,26.62496186362329,NaN,NaN,-34.39624652138439,-20.745515131840335
2020-03-09T09:30:00-04:00,66.7,68.35,65.085,65.77,24792494,25203085.4,23.105208183012863,33.54624386317046,NaN,NaN,-174.418950778599,-126.26681756441965,-1.210970483883845,-3.246408965629456,-2.035438481745611,811828556,861098769.2,4.683752953470389,21.736243302837718,NaN,NaN,-38.97836989062717,-23.350208668809884
2020-03-10T09:30:00-04:00,68.04,69.23,65.35,69.18,18385685,25718658.55,32.9909212856777,31.999812052041193,NaN,NaN,-133.97713720335952,-127.52615947344293,-1.1364763522871644,-3.4560339221045666,-2.3195575698174022,830214241,852406217.6,4.469254308932591,17.420577099741198,NaN,NaN,-37.925549826787105,-25.43240026280663
2020-03-11T09:30:00-04:00,67.04,67.65,64.4,65.12,28414929,26824828.45,28.322232742611078,30.187224466504528,NaN,NaN,-142.36992307123344,-137.68467186532484,-1.2681616569687346,-3.9047596410283205,-2.636597984059586,801799312,831553128.6,3.9964194965068174,13.914596772006997,NaN,NaN,-39.19691617362645,-27.398759678638033
2020-03-12T09:30:00-04:00,59.59,63,54.1,58.38,23659804,27617370.65,22.603553636497452,28.200311319066405,NaN,NaN,-198.7585497284268,-154.6603497750218,-1.6903140187713843,-4.7494905075238165,-3.059176488752432,778139508,811720533.4,3.6057059108638896,11.068105147618974,NaN,NaN,-42.90883443757385,-29.614484644200292
2020-03-13T09:30:00-04:00,61.83,62.99,58.59,62.94,18660276,28138811.6,32.52949749302185,27.899918389434664,NaN,NaN,-146.02482660212172,-159.10987747674812,-1.5474034116123527,-4.993430753267873,-3.4460273416555203,796799784,803756280.2,3.459439896432798,8.837507760541527,NaN,NaN,-41.14747956206595,-31.26205534675253
2020-03-16T09:30:00-04:00,56.22,59.89,55.57,55.8,18656361,28805663.1,26.745593386827892,27.944775908961578,NaN,NaN,-164.73782215063162,-157.17365175115464,-1.8009537140569383,-5.697219484226693,-3.8962657701697547,778143423,797019253.6,3.336155723298262,7.177760763163325,NaN,NaN,-42.43263121871506,-32.857851899890036
2020-03-17T09:30:00-04:00,56.68,58.67,54.61,58.37,24962191,29533789.75,31.468949738991924,28.42507824815715,NaN,NaN,-140.06457499824623,-158.391139310132,-1.665932254611409,-5.978681088434016,-4.3127488338226065,803105614,791597528.2,3.2362037588969343,5.994493116318874,NaN,NaN,-41.32214267677857,-34.0670362965884
2020-03-18T09:30:00-04:00,54.3,54.99,50.36,54.07,26018892,30602798.85,28.193398463639028,29.05303225016342,NaN,NaN,-150.37385468038656,-159.9919256319626,-1.7290699445512958,-6.474086264511726,-4.74501631996043,777086722,786655010.2,3.143736789776696,5.178842694362236,NaN,NaN,-41.82532256174535,-35.175362905896534
2020-03-19T09:30:00-04:00,53.4,54.96,51.29,54.11,16868077,30970266.85,28.26819648727276,29.823873216774494,NaN,NaN,-128.84898008483034,-146.01001170324335,-1.6321906071813697,-6.785254578937142,-5.153063971755772,793954799,789818068.4,5.0142164116409305,4.8043000191880685,NaN,NaN,-42.15521552872826,-36.17248470915821
2020-03-20T09:30:00-04:00,54.51,55.16,51.18,51.4,22341667,31428112.6,26.27153183698279,29.46159233697635,NaN,NaN,-121.18691715816936,-141.04242981445287,-1.6118727550356695,-7.167904915550359,-5.55603216051469,771613132,784780738,4.853464886811793,4.550884666271399,NaN,NaN,-43.127220063816175,-37.166018331252204
2020-03-23T09:30:00-04:00,50.83,50.83,47.71,48.77,34346563,32244933.55,24.46547342286881,29.228335725660873,NaN,NaN,-131.77529601959228,-134.44992458824498,-1.631828056806734,-7.595817231523107,-5.963989174716373,737266569,776605367.2,4.595940629933025,4.388648234129632,NaN,NaN,-44.52979685335834,-38.21798669155308
2020-03-24T09:30:00-04:00,51.74,55.12,51.61,54.94,29349664,32062377.65,35.64323190781029,28.916625520620347,NaN,NaN,-83.97835965455624,-123.23268151950697,-1.110664993516993,-7.3523204166126135,-6.2416554230956205,766616233,769307491,4.372887524899497,4.262404499259327,NaN,NaN,-41.67681051480548,-38.71210438058914
2020-03-25T09:30:00-04:00,55.99,60.05,54.64,57.83,27752993,31819038.3,40.11351853049989,29.450083540258937,NaN,NaN,-49.65911649177336,-103.08973388178433,-0.4844501583079772,-6.8472181209805925,-6.362767962672615,794369226,772763991.8,6.682929198183189,4.340296680861086,NaN,NaN,-37.829934783850206,-38.586080152483575
2020-03-26T09:30:00-04:00,58.93,61.83,58.41,61.48,22110197,30794683.95,45.28295806069497,30.42887608402927,NaN,NaN,-20.183926956135195,-81.35672325604533,0.22438746032280044,-6.082283637269114,-6.306671097591915,816479423,777268916.6,9.7431619225341,4.656662100870027,NaN,NaN,-32.88094864569639,-37.77106136579969
2020-03-27T09:30:00-04:00,59.13,61.5668,57.97,58.89,22486658,27963035.85,42.48076184852102,31.812844202994135,NaN,NaN,-25.407167648243316,-62.200773354060104,0.5491193530325562,-5.62027190630122,-6.169391259333776,793992765,781744843.2,12.80284038132693,5.236596917145495,NaN,NaN,-29.851872992933487,-36.63974874110452
2020-03-30T09:30:00-04:00,58.92,60.04,57.98,59.75,15759040,26511045.2,43.72600698901651,32.5796360389469,NaN,NaN,-22.527471751797687,-40.351208500501194,0.8349976217796131,-5.125644232109259,-5.960641853888872,809751805,796241890.4,22.023095633476203,6.490442726041467,NaN,NaN,-27.078121958492023,-35.273802057874164
2020-03-31T09:30:00-04:00,59.25,60.25,58.76,59.01,12884417,24464068.65,42.866056953115496,33.6184806254115,NaN,NaN,-15.740218020758167,-26.703580173741567,0.9775255899165067,-4.738734866493239,-5.716260456409746,796867388,802292121.4,25.560783298490023,8.030754426183124,NaN,NaN,-25.116553427433953,-33.82276653923985
2020-04-01T09:30:00-04:00,56.38,57.06,55.54,56.35,16057429,23647552.2,39.83345132667189,34.8491876032811,NaN,NaN,-45.846376542990406,-25.941032183984976,0.8979749220993112,-4.5937918037856065,-5.491766725884918,780809959,799580268,25.01301304768151,9.559847793098669,NaN,NaN,-24.360286643926557,-32.47098369705224
2020-04-02T09:30:00-04:00,55.85,57.87,55.63,57.1,23895129,23404195,41.09874477670503,35.46127669497276,NaN,NaN,-31.98630977770309,-28.301508748298556,0.8989714122315684,-4.368052460595457,-5.267023872827026,804705088,797225401,24.52158750589632,11.06428690806035,NaN,NaN,-23.378128196170262,-31.172004339783385
2020-04-03T09:30:00-04:00,56.94,57.525,55.72,56.34,15912379,22165742.25,40.176709500322524,36.42064213165095,NaN,NaN,-29.769974937982507,-29.174070206246387,0.8519874527930549,-4.202039556835707,-5.054027009628762,788792709,796185389.8,24.294571087520993,12.561316576933402,NaN,NaN,-22.821448055768137,-29.979067727781207
2020-04-06T09:30:00-04:00,58.88,60.59,58.81,60.24,19306715,21891453.3,46.77552605086353,37.51396901107035,NaN,NaN,43.43699777525525,-15.981176300835802,1.0728417155364927,-3.712974865208146,-4.785816580744639,808099424,795854913.6,24.217847116345126,14.060005388179702,NaN,NaN,-20.3879311985182,-28.60890536645792
2020-04-07T09:30:00-04:00,62.5,63.19,60.06,60.1,18390972,21891717.65,46.57690990861794,38.82707697142599,NaN,NaN,86.17466270128078,4.401799843571988,1.1897256565509293,-3.298659510055977,-4.488385166606906,789708452,794423126.4,23.866183224180872,15.540180133494287,NaN,NaN,-18.4641818339205,-27.159659147524
2020-04-08T09:30:00-04:00,60.93,62.62,60.43,62.28,11986736,21070308,50.12803127762507,40.388493742165444,NaN,NaN,114.2956936174208,36.430213875654225,1.380661119444894,-2.7625587673007885,-4.143219886745682,801695188,798600172.2,27.187963254199545,17.124019193677047,NaN,NaN,-15.791405935446583,-25.53562297437008
2020-04-09T09:30:00-04:00,63.47,64.33,62.65,63.22,21132445,20943940.05,51.62132928470149,42.19919355985963,NaN,NaN,136.4380904583416,70.11509392286317,1.5257207800616235,-2.236068911668653,-3.7617896917302764,822827633,802224681.2,30.040331789509096,18.92308111529828,NaN,NaN,-13.130362710013216,-23.763442936604815
2020-04-13T09:30:00-04:00,62.82,62.86,60.795,61.37,11086605,20565256.5,48.540799205986644,43.9188596872252,NaN,NaN,96.059286902183,95.28094629089627,1.4528934011330916,-1.9456729403139121,-3.3985663414470038,811741028,806814345,33.588173668551235,20.99395490377101,NaN,NaN,-11.657419413705728,-22.03401100476209
2020-04-14T09:30:00-04:00,62.72,63.18,61.92,62.54,15293751,20397126,50.550613783857855,44.983672678371455,NaN,NaN,101.74321434774129,106.94218960539347,1.436734285314011,-1.6026484848044902,-3.039382770118501,827034779,810601416,36.45186737294818,23.28531060720306,NaN,NaN,-9.854813068767397,-20.294125585334275
2020-04-15T09:30:00-04:00,61.17,61.29,59.79,60.81,12758394,19786936.15,47.590822477336765,45.517765817431226,NaN,NaN,55.44617037619998,100.79649114037731,1.268594993389235,-1.4536390283819571,-2.7222340217711922,814276385,815515002.6,40.06309845832287,25.66960841149875,NaN,NaN,-9.089489068348588,-18.69346322576489
2020-04-16T09:30:00-04:00,60.72,60.74,59.365,60.27,16123063,19292144.7,46.67222447272246,45.61699913257605,NaN,NaN,40.280523217915025,85.99345706047616,1.0870632462891074,-1.363404963909808,-2.4504682101989155,798153322,814806629.4,39.71272566678511,27.81029153608811,NaN,NaN,-8.688645406661204,-17.264203537321507
2020-04-17T09:30:00-04:00,62.33,63.31,62.11,63.1,18372543,19367368,51.91095216405738,46.29058415511436,NaN,NaN,94.81390303967859,77.66861957674357,1.1192414519269693,-1.0514163952902038,-2.170657847217173,816525865,813546275.8,39.0582202331414,29.685675811217713,NaN,NaN,-6.877307031622723,-15.780361179364538
2020-04-20T09:30:00-04:00,61.9,62.64,61.22,61.42,10475108,18774040.05,48.84344109310903,46.65611516254954,NaN,NaN,67.00000203059359,71.85676260242568,0.9933134394938308,-0.9290160478498848,-1.9223294873437156,806050757,812408221.6,38.44212734332876,30.858463790492895,NaN,NaN,-6.159827510481115,-14.405999226666907
2020-04-21T09:30:00-04:00,60.09,60.77,59.73,59.97,9553361,17534379.95,46.300389382654274,46.90142462180231,NaN,NaN,13.052599562298543,54.118639645337126,0.7873029675209626,-0.9382007779425123,-1.725503745463475,796497396,806300745,35.230425747340234,31.549152536839337,NaN,NaN,-6.250175137052011,-13.240881499579064
2020-04-22T09:30:00-04:00,61.14,61.3,60.23,60.6,9184950,16526144.25,47.5774867421726,47.45457000862378,NaN,NaN,24.69065575165536,47.96753672042821,0.6728440887433729,-0.8844486345342588,-1.5572927232776317,805682346,804581937.2,34.36039205223514,32.21682246573602,NaN,NaN,-5.9835444110388245,-12.20411905835903
2020-04-23T09:30:00-04:00,61.07,62.35,61.055,61.08,14256485,15851318.85,48.58086119748299,47.989006895822214,NaN,NaN,52.18935088728001,50.349302254301215,0.6106619011380743,-0.793965346855039,-1.4046272479931132,819938831,808939039,38.506158922214034,33.215720424044434,NaN,NaN,-5.495882765809943,-11.245799587994874
2020-04-24T09:30:00-04:00,61.61,61.78,60.58,61.57,7139275,15102772.75,49.640519796757026,48.66499334556754,NaN,NaN,41.390467274891044,39.66461510134371,0.5837517784585042,-0.6749375249199829,-1.2586893033784872,827078106,811049487.2,40.46750685605997,34.37093012179722,NaN,NaN,-4.808725844663693,-10.326217624661847
2020-04-27T09:30:00-04:00,62,63.49,61.88,63.1,9323242,14444601.95,52.90417036919327,49.10275365401966,NaN,NaN,97.16285041125056,45.6971847774751,0.6454000578250869,-0.4519392310971284,-1.0973392889222153,836401348,817119605.4,45.82014622448585,35.91395148666441,NaN,NaN,-3.3440816603008585,-9.328769629753134
2020-04-28T09:30:00-04:00,64.34,65.01,63.61,64.28,9938791,14153589.5,55.30970123239293,49.72652446286073,NaN,NaN,142.52985258441268,71.59263538189792,0.7355161436405193,-0.17794410937156613,-0.9134602530120854,846340139,827088154,53.25346568941358,38.013043091323894,NaN,NaN,-1.4265772007861817,-8.19988499704357
2020-04-29T09:30:00-04:00,65.57,66.22,64.92,65.51,12757415,14147239.4,57.73316218398118,50.269748099029016,NaN,NaN,169.80150269062867,100.61480476969258,0.8402657580167292,0.136871944508826,-0.7033938135079032,859097554,837771195.6,59.6435374199872,40.33129838888015,NaN,NaN,0.9011495714768343,-6.899737201540655
2020-04-30T09:30:00-04:00,64.6,64.72,63.735,64.21,14309963,14059866.1,54.376869006156305,50.46657236484722,NaN,NaN,113.67015816468746,112.91096622517406,0.7853224116306381,0.27825920103039437,-0.5070632106002437,844787591,842740947.6,62.2301202908007,42.630568996115265,NaN,NaN,2.05247610367724,-5.620849586509527
2020-05-01T09:30:00-04:00,63.08,63.25,61.855,62.27,9019235,13316071.4,49.730629802474795,50.551560264596375,NaN,NaN,32.93696519008771,111.22026580821341,0.5905336187388401,0.2311038128233065,-0.35942980591553364,835768356,844478997.6,63.12037050602104,44.74001162736311,NaN,NaN,1.796071718404921,-4.561289400093178
2020-05-04T09:30:00-04:00,61.39,61.49,60.6,61.48,8563539,12948629.4,47.93446852805298,50.36469274632459,NaN,NaN,-44.33382699796926,82.92093032636944,0.3903479274509108,0.12850510339810484,-0.26184282405280596,827204817,842639691.4,61.46916824582726,46.52696168971162,NaN,NaN,1.0834608613455687,-3.7548965056019283
2020-05-05T09:30:00-04:00,62.05,62.56,61.65,61.72,8691228,12417855.05,48.54251774861613,50.43267097998741,NaN,NaN,-7.448103851212891,52.92533903924433,0.2621161413783453,0.06580235267012569,-0.19631378870821964,835896045,840550872.6,59.5635209911339,47.91984901348383,NaN,NaN,0.6435100033422355,-3.126552718609905
2020-05-06T09:30:00-04:00,62.06,62.11,60.79,60.87,7048130,11850712.95,46.47248738528198,50.41840404517023,NaN,NaN,-50.53091755975086,8.858854989168425,0.11554712196677533,-0.051879886249750484,-0.1674270082165258,828847915,834500944.8,54.311669494248186,48.96263071544548,NaN,NaN,-0.28757589626175195,-2.7209846011315975
2020-05-07T09:30:00-04:00,61.69,62.37,61.34,61.58,8144529,11658602.6,48.44994707649464,50.1711893960586,NaN,NaN,-20.481939594797858,-17.971564562728638,0.06446027043275368,-0.0868516701755837,-0.1513119406083374,836992444,832941915.4,53.01444514454023,49.95950392340253,NaN,NaN,-0.5845253029369257,-2.41577612996093
2020-05-08T09:30:00-04:00,62.33,63.24,62.3145,63.11,8661556,11035058.15,52.52050926903862,50.43383712291071,NaN,NaN,48.9367570456158,-14.771606191623027,0.12808141543702597,0.00878982868794509,-0.11929158674908089,845654000,834919044.2,54.49870862620546,51.10640258646516,NaN,NaN,0.23644515625956702,-2.0368873747865734
2020-05-11T09:30:00-04:00,62.48,62.8,61.89,62.32,8407655,10901110.65,50.31142520396572,50.720339681575815,NaN,NaN,13.425285671051299,-3.2197836578189127,0.11191528134727588,0.02060251493501397,-0.09131276641226191,837246345,836927349.8,56.01854135115351,52.591267986737535,NaN,NaN,0.35490666927571013,-1.6952025113491045
2020-05-12T09:30:00-04:00,62.47,62.71,60.56,60.57,12328985,10752872.35,45.723479905601955,50.58791062182076,NaN,NaN,-46.92784368203607,-11.115731623983548,-0.014932552909184008,-0.10997845754874191,-0.09504590463955791,824917360,834731612.8,53.898783575362366,53.98686738124662,NaN,NaN,-0.821655860711657,-1.570410132686612
2020-05-13T09:30:00-04:00,60.21,60.28,58.5,59.05,15434459,10886675.6,42.12986221460175,50.127124980186395,NaN,NaN,-156.63661215612882,-32.33687054325914,-0.18979186250475438,-0.3322857327705009,-0.1424938702657465,809482901,830858610,50.28435615127277,54.82816718332224,NaN,NaN,-2.8954679020756453,-1.7597040997421882
2020-05-14T09:30:00-04:00,58.18,59.67,56.97,59.67,14221433,10791594.1,44.061115274298295,49.728596085725044,NaN,NaN,-173.00318022067086,-62.84111866843374,-0.24857504614033066,-0.4532126779411598,-0.20463763180082917,823704334,828200988,47.91015139442845,55.35978465034856,NaN,NaN,-4.113806716884838,-2.0960044736197094
2020-05-15T09:30:00-04:00,58.97,59.83,58.7,59.46,17398235,10742878.7,43.53121065832994,49.059098963520526,NaN,NaN,-127.13340666627045,-98.05515141081098,-0.2839245593286018,-0.5595433309615814,-0.2756187716329796,806306099,820331407.8,41.64048923799775,55.06123772274226,NaN,NaN,-5.275324710987966,-2.550193078958032
2020-05-18T09:30:00-04:00,61.82,63.78,61.65,63.38,22117648,11325005.7,54.52538670884971,49.00307649755315,NaN,NaN,56.99495848105637,-89.34121684880998,-0.038519148902808664,-0.32376770776149044,-0.2852485588586818,828423747,818566888.2,40.36498759058239,54.14063214425432,NaN,NaN,-3.040965667262728,-2.6203034487158456
2020-05-19T09:30:00-04:00,63.26,63.865,62.56,62.57,12447793,11469727.3,52.26117508287371,48.612220276045484,NaN,NaN,53.86607425943924,-69.18243326051491,0.06822369446423876,-0.19996894077838334,-0.2681926352426221,815975954,816778607,39.0591708623381,52.67032024727939,NaN,NaN,-1.8706506507067981,-2.5132101918574103
2020-05-20T09:30:00-04:00,63.56,64.35,63.47,63.74,8644016,11442680.6,55.157790207691995,48.66800036186946,NaN,NaN,87.46067490492479,-20.36297584830419,0.2086633696647667,-0.007363423161663718,-0.21602679282643042,824619970,819806020.8,42.453227126433205,51.25768502125313,NaN,NaN,-0.006262952584926816,-2.1550748719613413
2020-05-21T09:30:00-04:00,63.75,64.4,63.41,63.89,7682314,11113972.05,55.53033033052765,49.0822646853018,NaN,NaN,80.90285662200267,30.418231520230517,0.2972918832810911,0.1555880612749334,-0.14170382200615766,832302284,821525610.8,44.34914840640121,49.916883442708865,NaN,NaN,1.6184365340512237,-1.6160018139595462
2020-05-22T09:30:00-04:00,64.01,64.06,63.27,63.84,7113025,11112659.55,55.36521535312869,49.61303231566436,NaN,NaN,66.29158967512856,69.10323078851032,0.33535899032849603,0.2774949159044624,-0.05786407442403364,825189259,825302242.8,48.37212940223963,48.981380668166885,NaN,NaN,2.9117890227091627,-0.9691745515783021
2020-05-26T09:30:00-04:00,65.85,67.03,65.82,66.52,14907992,11391897.05,61.903846173534255,50.56741291744423,NaN,NaN,168.14631548385762,91.33350218907057,0.5131975178684983,0.5836328229115892,0.07043530504309094,840097251,827636943.6,50.74272667699947,48.351323931443,NaN,NaN,6.084873346133639,0.03854657666626071
2020-05-27T09:30:00-04:00,67.96,68.79,67.29,68.74,21918456,11990880.3,66.30692881490921,51.98415873384615,NaN,NaN,210.4983592363866,122.65995918446004,0.738793668164459,0.9939273902486647,0.2551337220842057,862015707,836844894.2,58.78138228917021,48.67058913108029,NaN,NaN,10.306837576369736,1.505445290909614
2020-05-28T09:30:00-04:00,69.43,69.65,67.97,68.09,17490476,12227533.35,63.97543629203861,53.09312224924215,NaN,NaN,198.93612222954712,144.9550486493845,0.7976566928374417,1.2522045881310078,0.4545478952935661,844525231,840825946.4,61.692230107146536,49.29043091412359,NaN,NaN,13.073504818318387,3.1580252233965815
2020-05-29T09:30:00-04:00,67.46,68.13,66.75,67.67,18881501,12456110.25,62.44748096962636,53.80219165642699,NaN,NaN,141.99105447718205,157.17268822042038,0.7617889692331908,1.4067841068350546,0.6449951376018638,825643730,839494235.6,60.16169644980237,49.69493004438051,NaN,NaN,14.905753450856125,4.836272113033659
2020-06-01T09:30:00-04:00,67.6,68.335,67.34,67.82,12921166,12651206.8,62.789296610072384,54.69346818543461,NaN,NaN,127.43401500772688,169.40117328694004,0.7030658904093998,1.5238275006136135,0.8207616102042137,838564896,842169363,62.1909105183823,50.13581355632543,NaN,NaN,16.507774563314975,6.50362960593099
2020-06-02T09:30:00-04:00,68.33,68.88,68.04,68.7,10836373,12764848.5,64.8128428507402,56.05699411008734,NaN,NaN,126.72200341647445,161.11631087346342,0.6780803437500721,1.6683620398918038,0.9902816961417317,849401269,844030166.6,63.58054697291044,50.82736808472172,NaN,NaN,18.455137116259156,8.210987821692157
2020-06-03T09:30:00-04:00,69.7,71.57,69.67,71.38,16253340,13142954.1,70.13871306968394,58.05762631402178,NaN,NaN,154.05364131479726,149.82736728914557,0.7888769248962182,1.9763778522620044,1.1875009273657862,865654609,844757947,64.13574925560093,51.81675330645944,NaN,NaN,21.912363569096115,10.168327214178436
2020-06-04T09:30:00-04:00,71.22,72.17,71.04,72.14,17880621,13684578.65,71.4580436181852,60.014549767156566,NaN,NaN,145.5997016585572,139.16008317494757,0.8546430487323646,2.255804738281242,1.4011616895488772,883535230,852559946.8,69.5031400007662,53.35910963548356,NaN,NaN,25.19005014656363,12.314287633090608
2020-06-05T09:30:00-04:00,75.16,76.21,74.49,74.79,19564238,14255564.1,75.51950443744106,62.299427894235926,NaN,NaN,176.62190034088053,146.0862523476873,1.0074048656574928,2.660417771620743,1.6530129059632503,903099468,868051094.4,76.89649632249325,55.87739585580467,NaN,NaN,29.492743525180842,14.76835276053207
2020-06-08T09:30:00-04:00,75.75,76.53,75.72,76.29,18906203,14767796.45,77.4734948031234,63.938578472398326,NaN,NaN,164.28964499026975,153.45737834419586,1.1309994778977974,3.0667622533354972,1.9357627754376998,922005671,884739249.4,81.96802808674734,58.849041605530736,NaN,NaN,33.756414752389965,17.480933045083198
2020-06-09T09:30:00-04:00,74.9,75,74.061,74.39,15074726,15101150,69.86641934095238,65.19609591940396,NaN,NaN,121.45375685870468,152.4037290326419,1.0102757839324075,3.198607505353209,2.1883317214208016,906930945,896245184.6,84.4951548105605,62.09446903040378,NaN,NaN,34.91936004550762,19.972136902286685
2020-06-10T09:30:00-04:00,74.04,74.14,72.38,72.61,16694249,15319413.2,63.56902074126261,65.79689810037328,NaN,NaN,90.28273790635765,139.64954835095398,0.748102141182307,3.123459397898685,2.375357256716378,890236696,901161602,85.43449082943205,65.1645592949037,NaN,NaN,33.81071237057791,21.94907625489972
2020-06-11T09:30:00-04:00,69.52,70.09,67.41,67.51,26054817,15850431.1,49.736464004458476,65.38305050565405,NaN,NaN,12.058680149105214,112.94134404906359,0.19743426646928608,2.622150089802986,2.4247158233337,864181879,897290931.8,81.2604666677639,67.80108202785817,NaN,NaN,27.500729685689357,22.742169602155382
2020-06-12T09:30:00-04:00,69.95,70.14,67.14,68.82,29161890,16597453.95,52.590181851528094,65.1848338269683,NaN,NaN,11.092959735278848,79.83555592794326,-0.09656805140697378,2.3040057590749825,2.4005738104819563,893343769,895339792,79.16094860471895,70.00028339946384,NaN,NaN,23.590478562050272,22.86335659642608
2020-06-15T09:30:00-04:00,66.63,69.93,66.36,69.5,18116394,16633361.9,54.04859017603639,64.62374411286132,NaN,NaN,0.19145936302819644,47.01591880249496,-0.2542703134594815,2.0827359186576047,2.337006232117086,911460163,893230690.4,76.84954699314514,71.86505627918852,NaN,NaN,21.040396525989635,22.602933729220872
2020-06-16T09:30:00-04:00,72.41,72.49,69.59,70.86,20564174,16555688.2,56.90396323267077,63.95210371412999,NaN,NaN,44.85248690320199,31.69566481139442,-0.27429978305114755,1.9941315033031515,2.268431286354299,932024337,898249368.8,78.4611686907949,73.27075530787602,NaN,NaN,19.89528037053517,22.216126106551485
2020-06-17T09:30:00-04:00,71.02,71.155,70.18,70.35,9448239,16405710.5,55.510939405962034,63.34749679369595,NaN,NaN,28.289176315150275,19.29695249315295,-0.3257024822487544,1.861303183543356,2.1870056657921104,922576098,904717249.2,80.35886809643677,74.60408659282531,NaN,NaN,18.544470493234957,21.691603876077696
2020-06-18T09:30:00-04:00,69.69,70.72,69.55,70.09,8632812,16405150.3,54.77475882235565,62.79944521174804,NaN,NaN,11.215803027658035,19.12837706886352,-0.3773779417377314,1.7152832386199464,2.092661180357678,913943286,914669530.6,82.86113028810118,76.22547472413237,NaN,NaN,17.239198514711774,21.055545967311136
2020-06-19T09:30:00-04:00,71.13,71.21,68.755,69.23,15601474,16801108.3,52.303890711095384,62.05048764753541,NaN,NaN,-6.874592745823569,15.534866572643043,-0.4639459267426993,1.5127287719293037,1.976674698672003,898341812,915669139.2,83.09409849454696,77.7185595795727,NaN,NaN,15.419351497130995,20.25037532871397
2020-06-22T09:30:00-04:00,68.51,69.26,67.94,69.04,7931957,16842054.9,51.74848978000557,61.11731957105436,NaN,NaN,-46.3107467507354,6.234425349890267,-0.5240305725682703,1.3216364829616651,1.8456670555299355,890409855,911459077.6,78.26856849949125,78.76770397432847,NaN,NaN,13.76969355229386,19.32456364636824
2020-06-23T09:30:00-04:00,69.74,69.83,68.88,69.05,8849797,16539145.15,51.77751351434248,59.805805317101395,NaN,NaN,-36.747177916409086,-10.085507614031949,-0.5504083336054966,1.1576566385230649,1.7080649721285615,899259652,904906140.6,71.32549359541463,79.28125714145803,NaN,NaN,12.414871399532432,18.337464753963125
2020-06-24T09:30:00-04:00,68.11,68.34,66.48,66.65,16922786,16289361.65,44.81089648711958,57.90243766488243,NaN,NaN,-101.99297991271155,-36.14193885960431,-0.7068225843196334,0.8245367417290197,1.531359326048653,882336866,896858294.2,63.83590674943932,78.87645476636325,NaN,NaN,9.125680758315765,17.021495611727786
2020-06-25T09:30:00-04:00,66.21,67.45,65.63,67.39,11623662,15996020.95,47.171141737845055,55.87755461491128,NaN,NaN,-106.34704025272892,-59.6545075156817,-0.7345432380204513,0.6131802785230889,1.3477235165435402,893960528,892861742.6,60.44168606992385,77.701111176894,NaN,NaN,7.003518697168344,15.590356052505008
2020-06-26T09:30:00-04:00,67.12,67.37,65.85,66.14,21429906,16123441.2,43.76622964133533,53.469892817640705,NaN,NaN,-113.98744315357132,-81.07707759723125,-0.8054710542242685,0.3408846987632046,1.146355752987473,872530622,887699504.6,56.279133531263376,75.86619013721658,NaN,NaN,4.169230655684041,13.958766710102013
2020-06-29T09:30:00-04:00,67.12,68.31,66.69,68.31,10864777,16020621.75,50.45252351566718,52.08318597297749,NaN,NaN,-73.40581398199977,-86.49609104348413,-0.6796698877760476,0.29676839326741344,0.9764382810434611,883395399,886296613.4,55.16721023138417,73.7713369529897,NaN,NaN,3.6209117033418075,12.48193028056484
2020-06-30T09:30:00-04:00,67.79,69.09,67.59,68.7,8868517,15922228.95,51.56712110361195,51.22590742743101,NaN,NaN,-52.05706275556281,-89.55806801131487,-0.5492038477351604,0.28993347137451053,0.8391373191096709,892263916,884897466.2,54.02087111633527,71.52750697348279,NaN,NaN,3.49709390298275,11.198382226624542
2020-07-01T09:30:00-04:00,69.38,69.935,68.325,68.39,9789179,15599020.9,50.59287717735964,51.28707979692395,NaN,NaN,-35.984478222263654,-76.3563676732253,-0.46607381871473574,0.25654504571625125,0.722618864430987,882474737,884925040.4,54.041139799568036,69.58326934004023,NaN,NaN,3.12244439800005,10.04467682253533
2020-07-02T09:30:00-04:00,69.49,69.995,68.81,68.98,8280163,15118998,52.43474986039992,51.27597751184336,NaN,NaN,-21.399276313070168,-59.36681488529355,-0.35847272389231866,0.27452795956558873,0.6330006834579074,890754900,884283914.8,53.451147007004224,67.74685494020346,NaN,NaN,3.3128922029456795,9.082993305451094
2020-07-06T09:30:00-04:00,70.05,70.34,69.4587,69.97,10815524,14681562.3,55.43677627782868,51.37513366197138,NaN,NaN,9.436643834972115,-34.68199748758486,-0.2148301689251293,0.3644629723014958,0.5792931412266251,901570424,890091875.2,57.931800339242635,66.39558732206756,NaN,NaN,4.318000473938309,8.40228004380641
2020-07-07T09:30:00-04:00,69.29,69.59,68.55,68.63,6111978,14041851.05,50.76636545901842,50.93673382099621,NaN,NaN,-18.876780094209696,-23.776190710026846,-0.204333020352246,0.3238768657863176,0.5282098861385636,895458446,892504484.6,59.6685002578959,65.05325386257478,NaN,NaN,3.8824442567338706,7.756589217081762
2020-07-08T09:30:00-04:00,68.6,69.06,68.05,68.63,8576514,13716940.45,50.76636545901842,50.59783568192881,NaN,NaN,-26.984026603654847,-18.761583479645253,-0.1918577251246985,0.28838772973269045,0.48024545485738895,895458446,893143390.6,60.137817558863205,63.60889310989096,NaN,NaN,3.525329446533675,7.152123535574892
2020-07-09T09:30:00-04:00,68.51,68.59,66.92,67.14,16782931,13721374.55,45.79138135233849,49.95616586264186,NaN,NaN,-88.39650268435959,-29.24398837206444,-0.27344757801127445,0.1384359823432959,0.41188356035457035,878675515,892383546.2,59.254702283406324,61.92271968098417,NaN,NaN,1.7933540296452302,6.386585034727798
2020-07-10T09:30:00-04:00,67.08,68.07,67.08,68.01,9255405,12881403.95,48.93791129655392,49.71573876160319,NaN,NaN,-71.04541395013528,-39.17321589947746,-0.25848563952914894,0.08877651094313421,0.34726215047228315,887930920,891818750.2,58.56625793644833,60.17073106969142,NaN,NaN,1.190162686956509,5.644238985046185
2020-07-13T09:30:00-04:00,68.6,69.46,67.93,68.29,14570112,12151815.05,49.94492437832435,49.5869126614831,NaN,NaN,-10.168787118288721,-43.09430209012963,-0.2208545188684929,0.07119400188666702,0.2920485207551599,902501032,892004871.8,58.73639659987766,58.77557593400473,NaN,NaN,0.9630499225294338,4.9754976904009345
2020-07-14T09:30:00-04:00,68.05,69.85,67.77,69.77,12689525,11880471.6,54.99696367906222,49.81687338753451,NaN,NaN,28.138632662851975,-33.6912195387173,-0.09390291081689434,0.174669882234042,0.26857279305093634,915190557,895951294,62.27379094513563,58.12902574469909,NaN,NaN,2.2124594607300274,4.58077794330509
2020-07-15T09:30:00-04:00,71.06,71.87,70.66,71.55,15472277,11625876.75,60.199870561501086,50.9160858214189,NaN,NaN,180.16132119889323,7.737850021792326,0.10173735810794782,0.39574449068587114,0.2940071325779233,930662834,902992171.6,67.60897018834066,58.398530276049186,NaN,NaN,4.929455695618028,4.630589050778367
2020-07-16T09:30:00-04:00,71.22,71.92,70.89,71.57,13017245,11804327.05,60.255470750918306,51.850680750924134,NaN,NaN,175.79073601335534,60.57529776133531,0.2176235944328206,0.5660366256189491,0.3484130311861285,943680079,915993084.4,74.71849412592425,59.41830228004921,NaN,NaN,7.137474636858984,4.988715563075598
2020-07-17T09:30:00-04:00,71.89,72.15,71.52,72,8605427,11802957.8,61.500751243897376,53.11743229396428,NaN,NaN,182.345664232415,111.25351339784538,0.3031158341881207,0.7273078239212794,0.42419198973315864,952285506,928864001.6,79.51273709532776,61.0778453917681,NaN,NaN,9.347062266797424,5.611336520750144
2020-07-20T09:30:00-04:00,71.59,71.76,70.91,71.12,9404591,11493113.65,57.5281999564206,53.6228377540181,NaN,NaN,129.41014531567188,139.1692998846375,0.28078405934470635,0.7751720639140416,0.49438800456933524,942880915,936939978.2,81.8397992590601,62.98303032231638,NaN,NaN,10.163706651737234,6.261675110891157
2020-07-21T09:30:00-04:00,71.76,72.58,71.63,72.06,9345028,11563767.2,60.46579525206729,54.25845733605062,NaN,NaN,146.37923990256172,162.81742133257944,0.307549134068025,0.8788244221543664,0.5712752880863414,952225943,944347055.4,83.67169840575421,65.10094655727487,NaN,NaN,11.715063104172172,7.04073053850273
2020-07-22T09:30:00-04:00,71.78,72.74,71.76,72.64,7620158,11502285.25,62.20293285689662,55.08774702744612,NaN,NaN,134.17836564119906,153.62083022104062,0.3400087678298398,0.9962862478736412,0.6562774800438014,959846101,950183708.8,84.95921581954785,67.30938055870202,NaN,NaN,13.527168512687696,7.967364534814868
2020-07-23T09:30:00-04:00,72.55,73.09,72.135,72.42,7537995,11033045.7,61.106137958992534,55.707131891631306,NaN,NaN,121.06494638668421,142.6756722957064,0.3225069734235462,1.059411196823234,0.7369042233996879,952308106,951909314.2,85.3275789456172,69.58626855431723,NaN,NaN,14.745875937352796,8.935723306606
2020-07-24T09:30:00-04:00,72.31,72.71,71.63,71.84,10061444,10954934.8,58.19290896941697,55.90399851245904,NaN,NaN,89.93177159778783,124.19289376878096,0.25089837913507385,1.0505271973185302,0.7996288181834563,942246662,949901545.4,82.78704532538285,71.36164319618437,NaN,NaN,15.012883902190891,9.803889105975271
2020-07-27T09:30:00-04:00,71.82,72.24,71.4,72.14,6198394,10193359.2,59.27442983954242,56.511717396782174,NaN,NaN,75.72824199656782,113.45651310496014,0.20471822774550863,1.055526602865342,0.8508083751198334,948445056,951014373.6,83.08761113985557,73.03443683061008,NaN,NaN,15.526372912532416,10.621386792626291
2020-07-28T09:30:00-04:00,71.8,72.24,71.585,71.64,5964528,9948346.75,56.64431497124316,56.93157093336965,NaN,NaN,64.22149868537532,97.02496486152286,0.12537624627370236,1.0075286829619614,0.882152436688259,942480528,949065290.6,80.43829426670537,74.48447088117021,NaN,NaN,15.276121070607385,11.286348832337875
2020-07-29T09:30:00-04:00,72.01,72.885,71.96,72.73,6935404,9851691.1,60.73464232109277,57.9989467168521,NaN,NaN,85.18524379274307,87.22634049183165,0.13059263757672812,1.0453932336591691,0.914800596082441,949415932,946979256.8,77.58687180959825,75.7939115616125,NaN,NaN,16.175156833152794,11.984749975311436
2020-07-30T09:30:00-04:00,72.22,72.41,71.475,72,9118700,9818167.15,56.865272970160035,58.5651868363954,NaN,NaN,56.4620440619273,74.30576002688026,0.0720893317299689,1.0049122607449021,0.9328229290149332,940297232,944577082,74.31970982288705,76.91915812492957,NaN,NaN,15.879243463803217,12.541106187953119
2020-07-31T09:30:00-04:00,71.71,71.88,70.525,71.73,9836277,9895972.85,55.45795211050197,58.95897453155094,NaN,NaN,28.033165420153217,61.92603879135332,0.005906413316960624,0.940205945661134,0.9342995323441734,930460955,942219940.6,71.15346710043245,77.80609173211204,NaN,NaN,15.245032361431488,12.927381355592885
2020-08-03T09:30:00-04:00,71.82,72.28,71.3675,72.03,12736977,9992045.5,56.73905546389838,59.08340965903924,NaN,NaN,47.415796412754204,56.26354967459061,-0.025257913063072124,0.9027271410153332,0.9279850540784054,943197932,941170515.8,69.72915561530135,78.33861777998102,NaN,NaN,15.044038794505651,13.22976098972328
2020-08-04T09:30:00-04:00,71.77,72.245,71.75,72.21,6560913,10014492.25,57.52836776828125,58.892588030952105,NaN,NaN,52.342082388220945,53.88766641515973,-0.040440130659362694,0.877434890754202,0.9178750214135647,949758845,942626179.2,70.60804006243602,78.55283705670213,NaN,NaN,15.07761422796891,13.49374002375837
2020-08-05T09:30:00-04:00,72.7,73.68,72.61,73.59,8522262,10011779.65,63.08873048576711,59.094963726298445,NaN,NaN,113.70414037034494,59.59144573068011,0.03186417265808361,0.9577052372361692,0.9258410645780856,958281107,944399214.2,71.68635125525941,78.3362554230832,NaN,NaN,16.676504540230194,13.94842066896863
2020-08-06T09:30:00-04:00,73.5,73.88,73.4,73.87,5880586,9466662.4,64.11527416166908,59.281715363282146,NaN,NaN,144.37287640964882,77.17361220022441,0.08494096623723635,1.032017272374631,0.9470763061373947,964161693,949172106.4,74.40820799873772,77.9716462018982,NaN,NaN,18.309149047659186,14.571381865924424
2020-08-07T09:30:00-04:00,73.82,75.16,73.71,75.13,12952115,9651497.9,68.37728716840928,60.05665016413848,NaN,NaN,221.1653903090111,115.80005717799597,0.18553166888397843,1.1789908922423677,0.9934592233583893,977113808,958502677,78.71582849439986,77.7485054329939,NaN,NaN,21.06531685213733,15.499086863954838
2020-08-10T09:30:00-04:00,75.4,77.05,75.36,76.98,15627249,9704354.75,73.37702846135629,60.97888110765912,NaN,NaN,291.6147461542481,164.63984712629477,0.34785959583575443,1.4282837181530823,1.0804241223173279,992741057,968411302,82.15161079140036,77.63992774625433,NaN,NaN,25.261825314939344,16.893763785524055
2020-08-11T09:30:00-04:00,78.06,78.67,77.23,77.39,17263672,9933062.1,74.3451173869418,61.84618000266236,NaN,NaN,273.6456087333083,208.90055239531222,0.4476834424870253,1.6400284254261095,1.1923449829390842,1010004729,980460478.8,85.26626838704325,77.66186007250401,NaN,NaN,28.983780306473918,18.620909002802605
2020-08-12T09:30:00-04:00,78.12,78.21,77.34,77.64,12587384,9788817.45,74.94342060988268,62.83455733486879,NaN,NaN,203.29639533602008,226.81900338844724,0.49186682418535876,1.8071785131707827,1.315311688985424,1022592113,993322680,87.72813470828473,77.83332834126597,NaN,NaN,32.19906366738264,20.560645383456897
2020-08-13T09:30:00-04:00,77.22,77.75,76.93,77.23,13298769,9802893.65,71.97869955374657,63.81925666232091,NaN,NaN,150.0596682226173,227.95636175104096,0.4556189524015115,1.8848353794873134,1.4292164270858019,1009293344,1002349010.2,89.10406608502181,78.2845441098116,NaN,NaN,34.03330112733603,22.485310489725347
2020-08-14T09:30:00-04:00,76.84,77.92,76.72,77.53,5909652,9668104.9,72.82578915126543,64.78721089887254,NaN,NaN,127.5331618712886,209.22991606349646,0.41513059603879854,1.9481296721343,1.5329990760955015,1015202996,1009966847.8,90.11172153833932,78.78626628113189,NaN,NaN,35.80745380802012,24.388473820910313
2020-08-17T09:30:00-04:00,77.68,77.84,77.025,77.17,5898815,9492816.1,70.0876926268918,65.7474521599903,NaN,NaN,107.57900502722427,172.4227678380917,0.3310410279179494,1.9468003609929383,1.6157593330749889,1009304181,1013279472.6,90.5221909293186,79.50654461417568,NaN,NaN,36.55144164561065,26.12604065301036
2020-08-18T09:30:00-04:00,77.12,77.36,76.64,76.75,5145531,9282841.25,66.92620680400842,66.18970676591286,NaN,NaN,82.41852615228552,134.17735132188713,0.2194476097808673,1.890068845301073,1.6706212355202057,1004158650,1012110256.8,89.11606823922942,80.33005864486361,NaN,NaN,36.313835136152804,27.58143986488785
2020-08-19T09:30:00-04:00,76.84,77.24,76.38,76.55,6297947,9216730.7,65.41306590686095,66.80026340424862,NaN,NaN,68.28601697610482,107.1752756499041,0.11000494321736687,1.8081274145419144,1.6981224713245475,997860703,1007163974.8,83.22630731705604,80.96624418016141,NaN,NaN,35.70328533309103,28.74170350320259
2020-08-20T09:30:00-04:00,75.95,76.32,75.705,76.14,10529483,9366305.1,62.303265521990326,67.28921436221208,NaN,NaN,43.89633275605545,85.94260855659172,-0.006004941419128773,1.6906162945506367,1.6966212359697654,987331220,1002771550,78.27869811796585,81.47518925284236,NaN,NaN,34.32995027239712,29.54002447023038
2020-08-21T09:30:00-04:00,76.07,76.66,76.02,76.45,7113646,9218915.2,63.708146952661714,67.78700661140947,NaN,NaN,47.92329099958649,70.02063438225129,-0.07408719684083875,1.6040122399187169,1.6780994367595556,994444866,998619924,73.81225499908959,81.76683920882724,NaN,NaN,33.511826986970036,30.107424829764618
2020-08-24T09:30:00-04:00,76.96,77.83,76.61,77.83,10171239,9417557.45,69.20934139931528,68.62136187076904,NaN,NaN,72.06250129959156,62.91733363672476,-0.04010659846059328,1.6279661886838142,1.6680727871444074,1004616105,997682308.8,72.80195040610909,81.92354709051816,NaN,NaN,34.32140022886664,30.70942131535062
2020-08-25T09:30:00-04:00,78.36,78.36,77.32,77.73,12076135,9723137.8,68.40022504435952,69.00075433923993,NaN,NaN,77.41204812967399,61.91603803220246,-0.038295031120239686,1.6202039982441079,1.6584990293643476,992539970,995358572.8,70.23610148064972,81.81995782090318,NaN,NaN,34.75923596868762,31.287966265827336
2020-08-26T09:30:00-04:00,77.58,78.04,77.2,77.77,6538934,9703314.3,68.55856600786669,69.31813232825404,NaN,NaN,68.40839887001344,61.94051441098418,-0.047719599514753464,1.5988495299709058,1.6465691294856593,999078904,995602213,70.35407916198872,81.53037718970681,NaN,NaN,35.16449616518153,31.841756251449365
2020-08-27T09:30:00-04:00,78.21,78.71,77.79,78.05,10260073,9760382.95,69.70300227286685,69.41282626428672,NaN,NaN,82.2878757054493,69.61882300086295,-0.04826770672293912,1.5862344960819854,1.6345022028049245,1009338977,1000003764.4,72.476607597436,81.0847185542094,NaN,NaN,35.81566147280639,32.40945699735751
2020-08-28T09:30:00-04:00,78.32,78.83,77.95,78.79,10323992,9784768.7,72.54704867493284,69.3535419938279,NaN,NaN,94.67479397824265,78.96912359659419,-0.01375735011631618,1.6173055151595293,1.6310628652758454,1019662969,1005047385,74.7109153772231,80.5532403103396,NaN,NaN,37.192094194746886,33.09269088269885
2020-08-31T09:30:00-04:00,78.57,78.86,77.81,77.81,9908268,9643333.25,63.98123294144215,68.61326453343507,NaN,NaN,78.60316276757915,80.2772558901917,-0.06881714348749712,1.545041435916474,1.613858579403971,1009754701,1006075104.2,75.1535267135367,79.83090161937484,NaN,NaN,35.92131449255469,33.49677996982111
2020-09-01T09:30:00-04:00,77.56,78.665,77.28,78.6,14432260,10036900.6,67.32999211681667,68.0694482125018,NaN,NaN,79.37224189490047,80.669294643237,-0.06401733310454216,1.5338369130232934,1.5978542461278356,1024186961,1012404502.4,77.73775573486125,79.11730312127317,NaN,NaN,35.80643904482507,33.82673126625025
2020-09-02T09:30:00-04:00,78.88,80.12,78.66,79.9,15333576,10377466.3,71.95133519516733,68.06749361546044,NaN,NaN,166.3688144307214,100.26137775537859,0.010742620245209444,1.6112825214343474,1.600539901189138,1039520537,1020492829,80.5252786246046,78.50453258838624,NaN,NaN,37.194013936721795,34.307771647746186
2020-09-03T09:30:00-04:00,79.96,80.26,77.16,77.66,19994389,11083156.45,56.991729204002226,66.93648933351305,NaN,NaN,81.20339044709252,100.04448070370724,-0.10050581895527633,1.4749076274950426,1.5754134464503189,1019526148,1022530263.2,81.16504823500175,77.8654844952907,NaN,NaN,32.98881803387205,34.11934970290702
2020-09-04T09:30:00-04:00,78.35,78.875,76.81,77.84,21632419,11517171.65,57.75187673525375,66.05535962696749,NaN,NaN,26.766821836654117,86.46288627538954,-0.16784106848226044,1.3656121108474935,1.533453179329754,1041158567,1026829382.8,82.47341716524254,77.29057208357096,NaN,NaN,30.03901108959594,33.53644418671973
2020-09-08T09:30:00-04:00,77.31,77.4,76.17,76.38,14912110,11481414.7,50.02817333785243,64.84835723652778,NaN,NaN,-101.957410195733,50.35077168272711,-0.30840098133046423,1.1479519526666735,1.4563529339971377,1026246457,1030127734,83.42474039514269,76.8840486661362,NaN,NaN,24.71489168615056,32.276222400924134
2020-09-09T09:30:00-04:00,77.08,78.2,76.88,77.56,16222083,11429335.25,55.23863970683867,64.12161250795475,NaN,NaN,-4.396200814104488,33.59708314092611,-0.31830677095700777,1.058469470300878,1.3767762412578857,1042468540,1033784049.8,84.43342503086828,76.97027135997993,NaN,NaN,22.145901449562096,30.829033693586698
2020-09-10T09:30:00-04:00,77.82,78.06,76.33,76.57,16547281,11627330.1,50.4827452647958,63.277289632440855,NaN,NaN,-59.2982456140296,-11.536328868024095,-0.38356065444492016,0.8973254232017354,1.2808860776466555,1025921259,1031064194.2,80.50856663233884,77.12954768243516,NaN,NaN,18.362951848716495,29.04816485860524
2020-09-11T09:30:00-04:00,76.86,77.98,76.8,77.61,16124073,11768595.3,54.877781904813475,62.64654927188026,NaN,NaN,-10.079500283923839,-29.79290701422737,-0.34966086462730983,0.8438099968625181,1.193470861489828,1042045332,1035568031,82.00063350165748,77.71443186119,NaN,NaN,16.80059058358791,27.29851139074562
2020-09-14T09:30:00-04:00,78.34,78.91,77.97,78.66,9641860,11955205.7,58.84902700797699,61.906526815356095,NaN,NaN,90.07429668587459,-17.131412044383268,-0.25395543182888747,0.8760265717037186,1.129982003532606,1051687192,1037673756,82.668640232731,78.41919542023443,NaN,NaN,16.905086642085042,25.813736426651253
2020-09-15T09:30:00-04:00,78.98,79.175,78.58,78.71,13583735,12339451.7,59.033922372951984,61.237505195969845,NaN,NaN,106.92446749980907,24.644963494725143,-0.18776730433600242,0.895272873112603,1.0830401774486054,1065270927,1045478650,84.90484350056315,79.4669627073711,NaN,NaN,17.045284124124613,24.56110038343316
2020-09-16T09:30:00-04:00,79.33,80.305,78.89,79.51,10298419,12597096.1,61.977599126943176,60.767436133046736,NaN,NaN,155.20035520036117,56.56427469761827,-0.09525853544602958,0.9639670081410685,1.059225543587098,1075569346,1052098811.2,86.49637503091498,80.61998384086584,NaN,NaN,18.109792947027167,23.639485035375163
2020-09-17T09:30:00-04:00,78.37,80.16,78.01,79.67,19265682,13245482.85,62.55709447740236,60.25701414765642,NaN,NaN,115.77727058653717,91.57937793773162,-0.03172815234482407,1.019565353156068,1.051293505500892,1094835028,1065881565,89.07818637916641,81.80581089670372,NaN,NaN,19.136767095889677,22.996239615448665
2020-09-18T09:30:00-04:00,79.92,80.22,78.72,78.78,13359047,13386961.05,57.323524762446006,59.16961958247879,NaN,NaN,104.73900040083075,114.54307807468254,-0.05662745984395623,0.9805091806959467,1.037136640539903,1081475981,1073767694.8,90.22928631684938,82.91426596381987,NaN,NaN,18.420826421738912,22.342609159204414
2020-09-21T09:30:00-04:00,77.06,77.23,75.1128,75.87,23188120,14190684.75,44.27949527409853,57.76235260623996,NaN,NaN,-182.71758488855352,59.98470175979692,-0.2644301368764479,0.7065989694443431,0.971029106320791,1058287861,1075087828.6,90.41146980895081,84.00411904206375,NaN,NaN,13.045501484838068,21.01445092000922
2020-09-22T09:30:00-04:00,75.84,76.77,75.77,76.62,7512454,14057745.5,47.589654361924886,56.35232848089055,NaN,NaN,-138.76601714312008,10.846604831211085,-0.341804403454369,0.5437736020028296,0.8855780054571987,1065800315,1075193706.2,90.42688705271831,84.91048556476782,NaN,NaN,9.90609891181741,19.427543490267535
2020-09-23T09:30:00-04:00,76.78,77.59,75.165,75.25,16388806,14273379.05,42.610101153671,54.256526049355095,NaN,NaN,-145.3799139689759,-49.26944900265633,-0.4678869881866893,0.30071927022383704,0.7686062584105263,1049411509,1069962138.8,83.29981490009288,85.10866672730272,NaN,NaN,5.530368317071329,17.442232751239505
2020-09-24T09:30:00-04:00,75.13,76.205,74.35,75.36,12111131,14551988.9,43.1246876940339,53.26602308435735,NaN,NaN,-164.42335885464001,-105.30957489089175,-0.5223729941279639,0.11564001575057148,0.6380130098785354,1061522640,1063299661.2,75.17395052910219,84.68073117688131,NaN,NaN,2.326755022965237,15.282878790057467
2020-09-25T09:30:00-04:00,74.9,76.75,74.9,76.49,7346850,14406327.75,48.2573433412882,52.58784212764552,NaN,NaN,-101.08937027448549,-146.475249025955,-0.46284279426112185,0.05945951705213304,0.5223023113132549,1068869490,1060778363,72.29963288897524,83.95403230000508,NaN,NaN,1.2880046356443078,13.283611053712729
2020-09-28T09:30:00-04:00,77.45,78.49,77.45,77.87,7409620,14260609.15,53.74698173564823,52.85347129891665,NaN,NaN,14.8437128899505,-106.9629894702542,-0.3179607885947127,0.124851325569864,0.4428121141645767,1076279110,1064376612.8,73.8370973682783,83.26920065522904,NaN,NaN,2.237976697030351,11.70566328847239
2020-09-29T09:30:00-04:00,77.73,78.05,76.96,77.18,10631519,14296771.7,50.84244970396161,52.53945772728258,NaN,NaN,-16.237743574439154,-82.45733475651801,-0.25855474588409655,0.119618681809456,0.37817342769355256,1065647591,1064346068,73.7996514456146,82.50964539913949,NaN,NaN,2.0734952668455815,10.329639285382846
2020-09-30T09:30:00-04:00,77.48,78.39,76.41,76.98,12184070,14184362.2,49.99901946887595,52.50490588471688,NaN,NaN,-22.09327726017008,-57.80000741475684,-0.2239775898955476,0.09820144032411804,0.32217903021966565,1053463521,1065156470.4,74.17388023704338,82.05716779947554,NaN,NaN,1.6853374810227886,9.094739027617123
2020-10-01T09:30:00-04:00,77.52,77.87,76.21,76.75,14045460,14119956.4,48.9924712880281,52.08452655494649,NaN,NaN,-36.64952338168104,-32.24524032016504,-0.20817933042301923,0.061954867190891605,0.27013419761391083,1039418061,1060735554.6,68.43161649835653,81.08795229923976,NaN,NaN,1.0760719915171468,7.949215165317127
2020-10-02T09:30:00-04:00,75.5,78.055,75.47,77.61,17895028,14014988.35,52.81729330394704,51.653688433230066,NaN,NaN,-26.049128021245124,-17.23719186951698,-0.13494375398035827,0.10145450513846299,0.23639825911882126,1057313089,1058424274.4,65.5734646002213,79.86686832548905,NaN,NaN,1.6837758929045141,7.054152412115325
2020-10-05T09:30:00-04:00,78.27,79.025,78.27,78.86,8880823,13377408.55,57.77359057951706,51.563664733699,NaN,NaN,84.3157328319774,-3.3427878811115876,-0.0043502569392041834,0.23096043794481602,0.2353106948840202,1066193912,1056407234.8,63.09671684563694,78.30914499299433,NaN,NaN,3.7523292298745132,6.582463386080923
2020-10-06T09:30:00-04:00,79.19,79.715,77.82,77.9,12587435,13261174.8,53.155439731241216,50.933510491148866,NaN,NaN,60.92607476046813,12.089975785869871,0.014321024693572715,0.2532119757509861,0.23889095105741337,1053606477,1053999012,60.17436767576272,76.42900161048347,NaN,NaN,4.104314095125931,6.2284420588016385
2020-10-07T09:30:00-04:00,78.82,79.855,78.79,79.62,10050059,12952573.6,59.415029688903346,50.70907729197036,NaN,NaN,105.98614322746506,37.70585988339689,0.1328615490852147,0.40496788741393175,0.27210633832871706,1063656536,1056037615,61.787790413522046,74.47968761293744,NaN,NaN,6.4772032642382324,6.263979373864009
2020-10-08T09:30:00-04:00,80.15,80.415,79.44,80.41,16341775,12942298.3,61.931195651708066,51.03819664120336,NaN,NaN,126.39244344686946,70.314253249107,0.24813084418590986,0.5822698935611044,0.3341390493751945,1079998311,1064153665,67.44275488432964,72.85207822490032,NaN,NaN,9.247900161900635,6.690253772154955
2020-10-09T09:30:00-04:00,80.91,81.26,80.46,80.71,12603583,12766273.8,62.87253918980398,52.3662712066109,NaN,NaN,142.8072052253722,104.08551989843045,0.3234709935623425,0.7384777913281226,0.41500679776578014,1092601894,1071211426,71.40566840980229,71.49452098210399,NaN,NaN,11.765830083333595,7.415336102323332
2020-10-12T09:30:00-04:00,81.07,81.455,80.83,81.17,8662235,12717292.55,64.3290536495889,53.561942584301185,NaN,NaN,139.4800199184086,115.1183773157167,0.3793084432159535,0.889142351785722,0.5098339085697685,1101264129,1078225469.4,74.70138512620099,70.37127084449563,NaN,NaN,14.284966664693341,8.396711896947618
2020-10-13T09:30:00-04:00,80.6,81.09,80.03,80.27,11004596,12588335.6,59.4176629950516,54.76248271582837,NaN,NaN,98.73049444469787,122.67926125256265,0.33233834367520587,0.9252568381637758,0.5929184944885699,1090259533,1085556080.6,77.60641126450827,69.96459915623957,NaN,NaN,14.987011571213065,9.33818327898554
2020-10-14T09:30:00-04:00,80.4,81.33,80.39,80.72,10052448,12576037.05,61.02014167795954,56.04072942896592,NaN,NaN,106.86045045307391,122.85412269768442,0.3087890940884579,0.9789048620991423,0.6701157680106844,1100311981,1092887169.6,80.07103705878343,70.3143910512168,NaN,NaN,16.040866859465165,10.295709504768343
2020-10-15T09:30:00-04:00,79.85,81.045,79.72,81.01,12063852,12215945.55,62.059880056884154,57.02662490865134,NaN,NaN,91.18934315305557,115.81350263892163,0.2902394510743683,1.0329150818536448,0.7426756307792765,1112375833,1099362674,81.95972512479696,71.00439763948978,NaN,NaN,17.210895817290496,11.283593263700078
2020-10-16T09:30:00-04:00,81.51,82.1,81.39,81.6,9422372,12019111.8,64.15473661940825,57.77003597177707,NaN,NaN,121.47705311089426,111.54747221602604,0.29427965226707165,1.110525196113116,0.8162455438460443,1121798205,1105201936.2,83.48010424415877,71.6931838449098,NaN,NaN,18.809336393608163,12.35869942511552
2020-10-19T09:30:00-04:00,81.66,82.125,80.285,80.59,8530955,11286253.55,58.22767940208106,58.2975523787856,NaN,NaN,86.1169053909995,100.87484931054423,0.2094879511855139,1.0781054828279366,0.8686175316424227,1113267250,1107602560.4,84.0743377466833,72.42709000927185,NaN,NaN,18.503427448497945,13.236517714170152
2020-10-20T09:30:00-04:00,81.01,82.04,80.82,81.01,9806477,11400954.7,59.88728558789292,59.00385710157253,NaN,NaN,87.19743365412849,98.56823715243034,0.16424484964416464,1.0739235936976286,0.9096787440534639,1123073727,1114165399.2,85.59938439918301,73.24319744942468,NaN,NaN,18.718629801331296,14.019676583764602
2020-10-21T09:30:00-04:00,80.71,81.38,80.19,80.19,8009008,10981964.8,55.27030990222358,59.45227414544364,NaN,NaN,55.473379931747445,88.29082304816505,0.06665351188485269,0.9929956339095298,0.9263421220246771,1115064719,1117115946.8,86.23747075015605,74.51504418169608,NaN,NaN,17.563459007113355,14.525931215671566
2020-10-22T09:30:00-04:00,80.37,80.99,80.12,80.85,6878189,10720317.7,58.07213168670518,59.82761974421208,NaN,NaN,52.95632578603018,80.64421957475997,0.035665438619299605,0.9709239202988016,0.935258481679502,1121942908,1119029361.8,86.65056810438536,76.02055157485066,NaN,NaN,17.381256299420958,14.933834799064336
2020-10-23T09:30:00-04:00,81.27,81.52,80.55,81.17,8038326,10754891.5,59.400018861561485,59.94379319292953,NaN,NaN,66.27852270054265,69.60451349268965,0.026268152777727982,0.968093672651662,0.941825519873934,1129981234,1120665967.6,87.00973134906086,77.72862403938093,NaN,NaN,17.60360957710839,15.315231195927772
2020-10-26T09:30:00-04:00,80.1,80.19,78.28,79.14,10692126,10919016.8,48.833998921571734,59.63511884938172,NaN,NaN,-26.410638826743956,47.09900464914096,-0.11913520494265717,0.7929065136956126,0.9120417186382698,1119289108,1121870339.2,87.28092880057874,79.6648069768678,NaN,NaN,14.457528204039383,15.192702197086573
2020-10-27T09:30:00-04:00,78.91,79,77.39,77.41,8736126,10824247.15,41.98056986859386,58.38980029078817,NaN,NaN,-93.11752920401821,11.03601207751162,-0.3227454169859063,0.5086099474058869,0.8313553643917933,1110552982,1119366190.2,83.38303919039326,81.2073247466443,NaN,NaN,9.315945325985329,14.353165501214967
2020-10-28T09:30:00-04:00,75.83,76.68,74.7825,74.87,17321346,11081110.95,34.356787681530506,56.42019972148978,NaN,NaN,-198.7401790787394,-39.80669972458575,-0.6031216795016545,0.07745326501472505,0.6805749445163796,1093231636,1114999573.6,76.93121744296096,81.88507207226083,NaN,NaN,1.8003809331243217,12.559910562916304
2020-10-29T09:30:00-04:00,74.82,76.61,74.64,75.96,14272860,11092480.95,39.439430226527236,54.746406224112874,NaN,NaN,-173.29910859085433,-85.05778659996265,-0.6838828723024675,-0.17427864586170472,0.5096042264407628,1107504496,1112111891.2,72.91330497168013,81.99276039810924,NaN,NaN,-2.3862840513643166,10.424739903733359
2020-10-30T09:30:00-04:00,75.56,76.18,74.72,75.87,15379779,10966718.5,39.169748685064604,52.94931301236114,NaN,NaN,-166.83219401213296,-131.67992994249775,-0.709041707317924,-0.37669790770664235,0.3323437996112817,1092124717,1104540587.8,63.542666003366925,81.19570903219253,NaN,NaN,-5.6607007790572155,8.126819806191849
2020-11-02T09:30:00-05:00,77,78.065,76.44,77.92,14166821,11231018.4,47.90736466415455,52.12714884586849,NaN,NaN,-80.72294018542378,-142.54239021423373,-0.5598453439205071,-0.36746288028935226,0.19238246363115488,1106291538,1101941073.8,60.660147663740965,79.98526163213772,NaN,NaN,-5.490227564797942,6.181527324621879
2020-11-03T09:30:00-05:00,78.98,80.669,78.8,80.22,16355906,11419441.95,55.61117602844724,51.74079415661761,NaN,NaN,14.567774205223715,-121.00532953238535,-0.2919572231457151,-0.172564065300989,0.11939315784472611,1122647444,1104359966.2,62.3707206929307,78.72095332029109,NaN,NaN,-2.4931595824202675,4.942286337901573
2020-11-04T09:30:00-05:00,79.56,81.19,78.87,79.39,23229805,12078429.25,52.58874066433638,51.06428420000706,NaN,NaN,10.434500844246696,-79.17039354778812,-0.1628024044242578,-0.08410984768559615,0.07869255673866166,1099417639,1105597166.8,63.25088555815611,77.3846076369596,NaN,NaN,-1.2003859960237682,4.064761718769381
2020-11-05T09:30:00-05:00,80.47,81.79,80.42,81.26,12159024,11869291.7,58.112419459255854,50.63269011713903,NaN,NaN,62.74074051399622,-31.96242372681802,0.04530531118418604,0.1353241957188942,0.09001888453470816,1111576663,1106411600.2,63.85032139769398,75.98248029078354,NaN,NaN,1.876893038568341,3.7522090501692325
2020-11-06T09:30:00-05:00,81.11,81.7,80.76,81.34,10091581,11743691.6,58.33605477163839,50.64043121496455,NaN,NaN,65.74694406752388,14.55340388911335,0.1776529444535691,0.31208506510166956,0.13443212064810045,1121668244,1112320305.6,67.93659058140523,74.82978406469226,NaN,NaN,4.290358653583632,3.8290875649427183
2020-11-09T09:30:00-05:00,86.87,87.88,84.05,84.11,25393922,12580275.95,65.25343233009133,51.02372741083587,NaN,NaN,206.19717006105847,71.9374259384098,0.42684235287307454,0.6679850617394436,0.24114270886636907,1147062166,1120474431.2,72.54829622020111,73.89756348047926,NaN,NaN,8.948595526023006,4.560445845097045
2020-11-10T09:30:00-05:00,84.39,85.93,84.13,85.59,18983786,12979235.45,68.28337675028912,51.95323218569769,NaN,NaN,174.19108790968045,103.86208867930114,0.6529053554116964,1.0572744031309895,0.40436904771929316,1166045952,1129154132.8,76.43384748858715,73.19730467608149,NaN,NaN,13.826107368191543,5.884111776967687
2020-11-11T09:30:00-05:00,86.13,86.14,84.44,84.87,11081533,13030689.7,65.30010973088535,52.469516331710565,NaN,NaN,151.19299017794603,132.013786546041,0.710735614859612,1.2927885662938081,0.5820529514341961,1154964419,1140263488.8,80.28098218134916,72.74233425300747,NaN,NaN,16.675976278591087,7.42580670577103
2020-11-12T09:30:00-05:00,84.01,84.805,83.325,83.9,10777133,12966353.75,61.40765499069917,52.61291891236326,NaN,NaN,103.63648276445518,140.1929349961328,0.6425149662001646,1.3851966591844018,0.7426816929842373,1144187286,1146785613.4,82.12582590186256,72.39348386392189,NaN,NaN,17.722401815553603,8.896748864311398
2020-11-13T09:30:00-05:00,84.61,85.86,84.55,85.76,9283097,12959390,65.63746403186042,53.81316642024103,NaN,NaN,129.78596126417125,153.00073843546227,0.6780038565115298,1.5901865136236495,0.9121826571121197,1153470383,1153146041.2,83.72493788162942,72.13948451256836,NaN,NaN,20.038782408429494,10.488467942042554
2020-11-16T09:30:00-05:00,87.66,87.99,86.43,87.85,14364363,13251060.4,69.66125351109113,55.790358108990844,NaN,NaN,156.1382400866357,142.98895244057772,0.7897682451324095,1.8993929635276317,1.1096247183952221,1167834746,1157300557.2,84.68852026012763,72.23273316040654,NaN,NaN,23.412285662862484,12.3347276164454
2020-11-17T09:30:00-05:00,87.19,87.905,86.32,87.62,11029736,13312223.35,68.70775063494969,58.24399831994935,NaN,NaN,129.6829693427125,134.08732872718411,0.793624742816998,2.1016556469164698,1.3080309040994718,1156805010,1155452368.8,82.3526210067864,72.61997627210836,NaN,NaN,25.723589991756572,14.247422241489854
2020-11-18T09:30:00-05:00,88.31,88.68,87.17,87.23,11882719,13505908.9,67.03228245544292,60.21491633630047,NaN,NaN,117.326787988706,127.31408828933613,0.7176248434713071,2.2050619584386055,1.4874371149672985,1144922291,1153443943.2,79.7774624576609,73.1102732353927,NaN,NaN,27.06556695999141,16.07858577270436
2020-11-19T09:30:00-05:00,87.01,87.53,86.435,87.45,8451878,13584593.35,67.51353786974312,62.23947270663465,NaN,NaN,93.28950233067269,125.24469220257961,0.6328497046000232,2.2784992457173274,1.6456495411173042,1153374169,1155281319.8,80.38184488344702,74.31307172682698,NaN,NaN,28.291391993708352,17.82327237570493
2020-11-20T09:30:00-05:00,87.24,87.59,86.46,86.66,7289289,13547141.5,63.905948277975575,63.38222867905044,NaN,NaN,79.44733846354383,115.17696764245413,0.48112023551769045,2.2470498355144173,1.7659295999967268,1146084880,1153804219.2,78.35445876294709,75.57695109105599,NaN,NaN,28.291460736225094,19.31872785577924
2020-11-23T09:30:00-05:00,87.4,88.28,87.4,88.11,11399478,13582509.1,67.35405786088577,64.221005952796,NaN,NaN,87.56641127444072,101.46260188001513,0.4372339954845621,2.3124720943524295,1.8752380988678674,1157484358,1151734141.6,75.4811758441547,76.51341217328627,NaN,NaN,29.31092207765974,20.74618417319074
2020-11-24T09:30:00-05:00,89.46,90.155,89.02,89.65,13977133,13844559.45,70.5697654357451,65.50536486503948,NaN,NaN,106.08826451162237,96.74366091379711,0.46798943639458956,2.4602248943611045,1.992235457966515,1171461491,1154665437.8,76.77967234056227,77.4797540863153,NaN,NaN,31.18886597742777,22.237995859510317
2020-11-25T09:30:00-05:00,89.58,89.6,88.53,88.97,9382875,13447635.9,67.4121558382098,66.16963174925048,NaN,NaN,92.19753577100573,91.71781047025706,0.4011747295713808,2.493703869930741,2.09252914035936,1162078616,1158096702.8,78.23286016082444,78.50707828368175,NaN,NaN,31.802702584395252,23.60438253449388
2020-11-27T09:30:00-05:00,89.21,89.495,88.555,88.82,5023075,12985146.65,66.70314463450691,66.76728102516965,NaN,NaN,87.49504053954945,90.55891811203243,0.3096164851999452,2.4795497468592913,2.169933261659346,1157055541,1158832977.2,78.5431654522572,79.26469077445688,NaN,NaN,32.09964480824719,24.817991430744353
2020-11-30T09:30:00-05:00,88.62,88.72,87.53,88.03,10379834,12735149.4,62.948076175077055,66.60261272838292,NaN,NaN,68.13154196646188,88.29575881261603,0.16580012187601412,2.3771834140043637,2.2113832921283496,1146675707,1158951142.6,78.59590301275581,79.6966626882108,NaN,NaN,31.285762451498407,25.741958719423504
2020-12-01T09:30:00-05:00,89.01,89.43,87.77,87.81,14520646,12752840.65,61.90296314708214,66.14686889958243,NaN,NaN,68.68542366379117,84.51956129048612,0.03276664977175603,2.2523416043430444,2.2195749545712884,1132155061,1153885283.2,70.58611289091122,79.27896735980536,NaN,NaN,30.322145866605933,26.396271169020995
2020-12-02T09:30:00-05:00,87.48,88.15,87.38,87.93,13219788,12596034.75,62.270922826006654,65.93049840637681,NaN,NaN,49.570158749334674,73.21594013802859,-0.0649111567050702,2.1384360086899505,2.2033471653950207,1145374849,1148667954.8,63.41787159548347,78.07445946081496,NaN,NaN,29.612618953903937,26.855749424004273
2020-12-03T09:30:00-05:00,88.05,88.96,87.985,88.16,11677460,12018417.5,63.0083914091525,66.04483672198062,NaN,NaN,62.800512002662586,67.33653538435996,-0.12814039622300388,2.0431716701162657,2.1713120663392695,1157052309,1147662693.4,62.10909928804548,76.64469327411373,NaN,NaN,29.19563485148714,27.19001877078754
2020-12-04T09:30:00-05:00,88.45,89.375,88.42,89.21,11754059,11998169.25,66.2515440891124,66.0886995832129,NaN,NaN,85.03345413255498,66.84421810296107,-0.11384081792023215,2.0290110439389792,2.1428518618592114,1168806368,1150012858.8,63.98061235892631,75.23438430820637,NaN,NaN,29.67755430063157,27.545380989336685
2020-12-07T09:30:00-05:00,89.16,89.26,88.515,88.78,7598800,11873530.2,63.78523131536398,65.66898371208953,NaN,NaN,78.08444138369701,68.83479798640808,-0.1458879623122682,1.9604919089688764,2.1063798712811446,1161207568,1152919231,66.20373839392963,73.91404274633508,NaN,NaN,29.439515277984928,27.81597160200072
2020-12-08T09:30:00-05:00,88.5,89.37,88.47,89.21,5038277,10855747.95,65.18112260061295,65.4170817096369,NaN,NaN,81.02315742596544,71.30234473884293,-0.15008867128036263,1.9187690321806912,2.068857703461054,1166245845,1159737387.8,70.76269569595503,73.08619093841855,NaN,NaN,29.597965886990774,28.070542214142154
2020-12-09T09:30:00-05:00,89.52,89.7325,88.77,89.41,12047127,10508915,65.8406334022769,65.33196392012505,NaN,NaN,92.12495883603574,79.81330475618316,-0.1509515461307882,1.8801682707975687,2.031119816928357,1178292972,1166321012.4,74.359422286974,72.69918806908377,NaN,NaN,29.901530190933805,28.33211192511239
2020-12-10T09:30:00-05:00,88.79,89.22,88.17,88.56,11627998,10536238.25,60.58810810039709,64.83729036517175,NaN,NaN,47.896527522855365,76.8325078602217,-0.21634159579590784,1.7606928221834721,1.97703441797938,1166664974,1168243545.4,75.31442958832046,72.33722983371759,NaN,NaN,28.78162671427505,28.396328323564198
2020-12-11T09:30:00-05:00,88.01,88.96,88,88.77,6577523,10326257.75,61.4072606947865,64.65881268065824,NaN,NaN,34.64725259359132,66.75526755242898,-0.25060836417544374,1.6637739627600752,1.914382326935519,1173242497,1169130771.2,75.76307319132118,72.15213086431574,NaN,NaN,28.037151964359424,28.345017415106373
2020-12-14T09:30:00-05:00,89.63,89.695,87.6,87.62,6841929,10204199.35,54.70216098615165,63.75510576103438,NaN,NaN,-1.0277698062526146,50.932825314439036,-0.3497921778189226,1.4771421046618656,1.8269342824807882,1166400568,1170169371.2,76.30594408954032,72.21104288184327,NaN,NaN,25.493455811297277,27.937651471705074
2020-12-15T09:30:00-05:00,88.26,89.19,87.725,88.84,7351349,9853548.65,59.72621846694378,62.980566691834284,NaN,NaN,24.163524697072273,39.5608987686604,-0.3324202480002296,1.4114089724805012,1.7438292204807309,1173751917,1171670585.6,77.10422091644732,72.23422492297793,NaN,NaN,24.618858649411422,27.463538211377408
2020-12-16T09:30:00-05:00,88.92,88.97,88.1,88.29,6805143,9642319,56.67444739487797,62.213587517310586,NaN,NaN,2.7760503992283496,21.69111708129892,-0.35510371347663505,1.299949578634937,1.6550532921115721,1166946774,1169401346,73.09531406473963,71.86725734468615,NaN,NaN,22.992767255864823,26.82485664630418
2020-12-17T09:30:00-05:00,88.81,88.94,88.32,88.83,9088519,9502609,58.89517596836141,61.65587546972876,NaN,NaN,28.781989663010414,17.868209509329926,-0.33133341322478405,1.240886525580592,1.5722199388053761,1176035293,1171275409.8,74.28445216526737,71.56306353847259,NaN,NaN,22.236064305434358,26.169314883322777
2020-12-18T09:30:00-05:00,88.96,89.06,88.14,88.84,8639999,9512015.05,58.93715103275765,61.36938081670595,NaN,NaN,19.015003261587438,14.741759642929145,-0.3127610569439647,1.1812686176254203,1.494029674569385,1184675292,1173561968.8,75.69590553716047,71.35592086164435,NaN,NaN,21.626153123482627,25.520291774774183
2020-12-21T09:30:00-05:00,86.71,88.35,86.39,87.94,9071138,9601107.5,53.62919798310856,60.77839759070783,NaN,NaN,-176.96514745307198,-20.445715886434694,-0.35578149320912944,1.0493028080579734,1.4050843012671028,1175604154,1175402686,76.79985889057312,71.79975986162019,NaN,NaN,19.58040015628528,24.671735829275768
2020-12-22T09:30:00-05:00,87.9,87.99,86.88,87.53,11452194,9603743.3,51.35991697849344,59.99904003017118,NaN,NaN,-177.28199350874482,-60.734819527598106,-0.40307034297364375,0.9012463725500481,1.3043167155236919,1164151960,1173482694.6,73.07151236069325,72.48930563056375,NaN,NaN,17.199938097497288,23.604336153307415
2020-12-23T09:30:00-05:00,87.98,88.46,87.87,87.99,8939370,9351855.15,53.72575483673782,59.335994560713,NaN,NaN,-65.58826129230607,-74.407681865905,-0.394115545615098,0.8116722835048193,1.2057878291199173,1173091330,1174711605.8,73.94343686422971,73.33461545743405,NaN,NaN,15.802066664630562,22.48972622635358
2020-12-24T09:30:00-05:00,88.12,88.14,87.5,88,2367367,9001079.75,53.77838837973869,58.4450548671863,NaN,NaN,-92.98416318785559,-98.7609124360782,-0.37819742480309393,0.7330410481160499,1.1112384729191438,1175458697,1174596286.6,73.70227224210986,74.0290197348043,NaN,NaN,14.6567958392442,21.37073617105224
2020-12-28T09:30:00-05:00,88.58,88.87,88.01,88.11,4849963,8992424.15,54.39290417283216,57.77417435700545,NaN,NaN,-13.091952754156226,-105.18230363922694,-0.35150552713450045,0.6718565640010183,1.0233620911355188,1180308660,1173722960.2,71.79262371263658,74.42822582899767,NaN,NaN,13.842485441771352,20.29527178115497
2020-12-29T09:30:00-05:00,88.56,88.68,86.99,87.58,6729491,8809907,50.88274836954456,56.75286191192913,NaN,NaN,-107.60567345932125,-91.3104088404768,-0.3595022208817067,0.5739843150333854,0.9334865359150921,1173579169,1173317963.2,70.87549858348865,74.43628317810722,NaN,NaN,12.195612213160642,19.138177557155778
2020-12-30T09:30:00-05:00,87.73,88.38,87.68,88.14,5019408,8334845.1,54.24276019415987,55.92444239706363,NaN,NaN,-50.1140037433954,-65.8768108874069,-0.3184412199560356,0.5354350109700476,0.8538762309260832,1178598577,1176207286.6,73.4785080711762,74.37336073412165,NaN,NaN,11.626251209482556,18.06504522177389
2020-12-31T09:30:00-05:00,88.11,88.72,87.66,88.55,6761620,8011936.7,56.58446638634071,55.63846798891674,NaN,NaN,-15.285471199437303,-55.816252868833146,-0.25763114955182687,0.5318372939862996,0.7894684435381265,1185360197,1178661060,75.48258723657433,74.38537199471122,NaN,NaN,11.760691040209988,17.16442319583619
2021-01-04T09:30:00-05:00,88.66,88.74,85.92,86.41,16200761,8238101.75,43.94346488242706,54.39105400231964,NaN,NaN,-193.30930597910535,-75.88128142708311,-0.3497783586077844,0.352245495278396,0.7020238538861804,1169159436,1177401207.8,72.45527805977974,74.14910091388683,NaN,NaN,7.877910167235481,15.83777847746466
2021-01-05T09:30:00-05:00,86.25,87.59,86.235,87.26,16004573,8450627.45,48.832963813952404,53.97182563287684,NaN,NaN,-161.31175734833172,-105.5252423459182,-0.3413536877427237,0.27533174420777584,0.6166854319504995,1185164009,1178372277.6,73.34272280139436,73.93744225044783,NaN,NaN,6.141167478276112,14.452548334723438
2021-01-06T09:30:00-05:00,87.82,90.065,87.55,89.34,19500573,9045716.1,58.396116135821046,53.87681832351093,NaN,NaN,98.95142756122098,-64.21382214180974,-0.19106040551327985,0.37785992505889965,0.5689203305721795,1204664582,1184589360.2,78.18800603996968,74.01485547355658,NaN,NaN,7.958259204715739,13.524792744722339
2021-01-07T09:30:00-05:00,89.84,90.18,89.1,89.83,10115165,9299560.5,60.2795169822616,54.134323294038325,NaN,NaN,179.82042578158115,-18.226936236814435,-0.0607598684930819,0.4929704949558271,0.553730363448909,1214779747,1191825594.2,82.2353543338849,74.66771549278123,NaN,NaN,10.040844881998808,13.027085907190406
2021-01-08T09:30:00-05:00,90.03,90.28,88.71,89.61,11043317,9249370,58.9883383430255,54.14097774937148,NaN,NaN,154.33891532266927,15.697941067606877,0.00500697641199177,0.5599890839638988,0.554982107551907,1203736430,1195500840.8,83.87220401098979,75.35255491033284,NaN,NaN,11.265840403520105,12.775479406666078
2021-01-11T09:30:00-05:00,88.67,89.84,88.6,89.58,11911730,9263556.6,58.80336803160557,54.131421820717755,NaN,NaN,119.5550351288122,78.27080928919038,0.038991690853504735,0.603721721118788,0.5647300302652832,1191824700,1200033893.6,85.63082790800912,76.06219222253631,NaN,NaN,12.179757433451678,12.690376267635449
2021-01-12T09:30:00-05:00,89.56,90.69,89.05,90.47,10408097,9455085.3,62.554708767775274,54.76895830533681,NaN,NaN,171.8346915415337,144.90009906716347,0.10989782751612254,0.7021023146604364,0.5922044871443138,1202232797,1203447651.2,86.79831947847879,76.77636797881529,NaN,NaN,14.138248658676117,12.897215180641258
2021-01-13T09:30:00-05:00,90.32,90.45,89.55,89.69,9230222,9574499.95,57.60400689231425,55.21496472775258,NaN,NaN,131.2373466714381,151.35728288920689,0.09340260153496804,0.708957739063024,0.6155551375280559,1193002575,1201115249.8,81.90197804145569,77.40711552744118,NaN,NaN,14.285917179457183,13.095601180472103
2021-01-14T09:30:00-05:00,90.15,90.65,89.84,90,10669716,9740418.3,58.993050888818715,55.591200160044075,NaN,NaN,132.62541243938492,141.91828022076766,0.09233897183643713,0.7309788523236023,0.6386398804871651,1203672291,1198893758.6,77.42224508274361,77.6556018287636,NaN,NaN,14.823967642487004,13.342510675045661
2021-01-15T09:30:00-05:00,89.4,89.61,88.08,88.83,12924796,10046400.95,52.060284343142776,55.46847844314436,NaN,NaN,21.84703010578189,115.41990317739017,0.006342723309293974,0.6465682846237826,0.6402255613144886,1190747495,1196295971.6,72.43296780239453,77.56493722592678,NaN,NaN,13.130540242052291,13.312229184618037
2021-01-19T09:30:00-05:00,89.59,89.885,89.09,89.12,8933417,10038645.85,53.51837276775154,55.406011914210026,NaN,NaN,59.42213101404443,103.39332235443662,-0.03522024700713,0.5962002525555761,0.6314204995627061,1199680912,1197867214,73.5434937402774,77.68999937075829,NaN,NaN,12.18879850862425,13.151739088047496
2021-01-20T09:30:00-05:00,89.59,89.88,89.085,89.67,8374347,10025363.25,56.2369717468255,55.788456441158665,NaN,NaN,66.7286706349257,82.37211817311501,-0.030081633113364536,0.5938184581710004,0.623900091284365,1208055259,1199031706.4,74.36764210862745,77.93943819398248,NaN,NaN,12.206024080467271,13.016636944107464
2021-01-21T09:30:00-05:00,89.47,89.68,88.835,88.97,9602304,10051921.55,52.06332435472238,55.63278245262742,NaN,NaN,33.62719140861705,62.8500871205508,-0.07564426327346263,0.5293447621925367,0.6049890254659993,1198452955,1200121782.4,75.14807880413116,78.05869324633639,NaN,NaN,10.96346377295266,12.723326491085349
2021-01-22T09:30:00-05:00,88.39,88.88,87.765,88.51,9728752,9965749.45,49.46532425263397,55.1242723002198,NaN,NaN,-32.07968401167287,29.90906783033925,-0.13510833470502526,0.43610360708471774,0.571211941789743,1188724203,1197132164.8,68.9477755753621,77.59192098482124,NaN,NaN,9.147289617177726,12.212464080527116
2021-01-25T09:30:00-05:00,88.1,88.35,87.04,87.91,18249331,10431247.5,46.22518253824392,55.28725213277814,NaN,NaN,-79.8034120893449,9.57897939131389,-0.2087948890357907,0.3102183304950046,0.5190132195307953,1170474872,1193077640.2,61.53278504021236,76.811742911995,NaN,NaN,6.628353041572807,11.414733932105072
2021-01-26T09:30:00-05:00,88.67,88.81,87.05,87.1,10480810,10836919.65,42.20584738722236,54.813886673726,NaN,NaN,-86.71495188013787,-19.648437187522568,-0.300458872787957,0.14343962854584902,0.44389850133380604,1159994062,1185140270.2,50.159948596994184,75.15583046882355,NaN,NaN,3.209748878925335,10.242593210222253
2021-01-27T09:30:00-05:00,85.93,86.15,84.715,85.37,23139044,11751373.7,35.17165612985619,53.154996673299934,NaN,NaN,-212.45970462552722,-75.48611223961316,-0.4566130276895142,-0.12686778327808668,0.3297452444114275,1136855018,1170900222,36.961310971452036,72.21106653535801,NaN,NaN,-2.328610176057113,8.446707012182344
2021-01-28T09:30:00-05:00,86.2,87.67,86.11,86.64,17928311,12311314.7,42.71900465210666,51.90067436400316,NaN,NaN,-110.61924710490399,-104.33539994231737,-0.45250880874641586,-0.23589076652159235,0.2166180422248235,1154783329,1162166296.8,31.488540370723513,68.58629410941792,NaN,NaN,-4.518245435595594,6.594570948214067
2021-01-29T09:30:00-05:00,86.08,86.51,84.51,84.77,20895030,13105095.8,36.06170243640263,50.26305751353009,NaN,NaN,-174.01694997202176,-132.72285313438715,-0.5475290010162215,-0.4677932090454533,0.07973579197076813,1133888299,1151199116,26.235412292435782,64.46938041523548,NaN,NaN,-8.870903119979943,4.385217509900638
2021-02-01T09:30:00-05:00,85.61,85.89,84.935,85.65,11318739,13332951.75,40.74176449719254,48.97294297535774,NaN,NaN,-135.00060701711317,-143.7622921199408,-0.5229508335374978,-0.5739527499511041,-0.051001916413606324,1145207038,1146145549.2,24.229561154420068,60.083575647121975,NaN,NaN,-10.692577894100422,2.2312467379004866
2021-02-02T09:30:00-05:00,86.66,87.86,86.57,87.47,10443798,13045103.6,49.04834433810293,48.00820265895256,NaN,NaN,-48.44299161894068,-136.10790006770134,-0.3635186446060553,-0.5054002221711755,-0.14188157756512018,1155650836,1145276904,23.891432410602945,55.59022657084513,NaN,NaN,-9.17680812078321,0.6015246152313871
2021-02-03T09:30:00-05:00,87.37,87.6877,86.79,87.53,9662886,12728019.25,49.30065778618757,47.41510629422924,NaN,NaN,-48.088565345518,-103.23367221169951,-0.23941082217337073,-0.4411451052818336,-0.20173428310846286,1165313722,1150968644.8,30.71430832691179,51.93396444837771,NaN,NaN,-7.951278723651452,-0.620304433180447
2021-02-04T09:30:00-05:00,87.83,88.62,87.705,88.47,7113897,12108685.45,53.20993969163746,47.002026923002006,NaN,NaN,0.0061965157957150725,-81.10858348755957,-0.0872443555946476,-0.31078972760177237,-0.22354537200712477,1172427619,1154497502.8,34.62725898601367,48.877179727182714,NaN,NaN,-5.621824163630178,-1.3348072518161227
2021-02-05T09:30:00-05:00,89.16,89.415,88.76,88.99,7481924,11977023.4,55.26489915234804,47.230927980802385,NaN,NaN,42.738833127490025,-37.75742686765722,0.047927336658007025,-0.16363620118461597,-0.211563537842623,1179909543,1163701751.6,43.577807007518786,46.816096813263016,NaN,NaN,-3.0782733735480585,-1.5838738406349706
2021-02-08T09:30:00-05:00,89.35,89.79,89.15,89.75,8847603,11867237.7,58.157336169950305,47.56228250953086,NaN,NaN,69.00919121241667,3.044532778248751,0.18056811335935746,0.014146603856573847,-0.16642150950278362,1188757146,1172411773.2,50.486447380212475,45.16916493040123,NaN,NaN,-0.03809472686940149,-1.363048252954175
2021-02-09T09:30:00-05:00,89.67,90.28,89.055,89.98,8298515,11686576.95,59.02086570631949,47.76113207806615,NaN,NaN,77.65946530251361,28.2650241625396,0.27043439945307524,0.1716214898135604,-0.0988129096395148,1197055661,1180692738.2,56.002371609967234,43.85735989478264,NaN,NaN,2.6700922245793635,-0.786885327592241
2021-02-10T09:30:00-05:00,90.38,90.41,89.43,89.84,10982436,11715293.9,58.23307209121499,48.20182834495847,NaN,NaN,84.80444744530234,54.843626720703675,0.30455061398734695,0.2818753578446689,-0.022675256142678055,1186073225,1184844638.8,58.49872640712165,42.668120437853396,NaN,NaN,4.6461094949358,-0.010743210088235089
2021-02-11T09:30:00-05:00,90.07,90.2,88.74,89.65,8868551,11697210.35,57.11878753836703,48.748504293939405,NaN,NaN,67.8044843494756,68.40328428743965,0.2980503197418456,0.349887643534629,0.05183732379278336,1177204674,1185800049.8,59.07416967683342,41.96286287367277,NaN,NaN,5.977938745594202,0.8447827835806846
2021-02-12T09:30:00-05:00,89.45,90.37,89.35,90.3,7982582,11562853.65,59.942707836795485,49.728327529550235,NaN,NaN,93.50105491251298,78.55572864444424,0.3193606614700558,0.45103815063035313,0.1316774891602973,1185187256,1186855592.4,59.73837537564179,41.834690754774876,NaN,NaN,7.934163159189554,1.8575514086676659
2021-02-16T09:30:00-05:00,90.51,90.88,90.01,90.21,8227185,11327973.1,59.35981096574621,50.95361064230194,NaN,NaN,103.14641615305412,85.38317363257173,0.30903208894538825,0.5179676003420326,0.20893551139664437,1176960071,1184496177.4,57.49228154045774,42.35842882216513,NaN,NaN,9.402327981581262,2.935376633369608
2021-02-17T09:30:00-05:00,89.82,90.03,89.255,89.96,7265980,11244601.25,57.681869237289035,52.56148300711857,NaN,NaN,70.46839791984841,83.94496015603869,0.2684991259012592,0.5445594187732183,0.27606029287195916,1169694091,1179023863.4,52.5565379107152,43.47237360354107,NaN,NaN,10.21480051242315,3.975294330377257
2021-02-18T09:30:00-05:00,89.5,89.715,88.835,89.51,6409712,11146369.5,54.68537956847075,53.416224072573144,NaN,NaN,51.83589608756771,77.35124988449176,0.19778394435287627,0.5232902233130545,0.32550627896017825,1163284379,1174466094.2,48.798866602417036,44.70882547723347,NaN,NaN,10.134240602928156,4.855143797884528
2021-02-19T09:30:00-05:00,90.15,91.25,90.08,90.98,8733841,11102946.35,61.68714393822143,55.24661275127449,NaN,NaN,111.9660438687496,86.18356178834657,0.2339372645539911,0.6179278596526672,0.38399059509867606,1172018220,1173428803.4,47.95845868154838,46.26047164788438,NaN,NaN,12.103305612865274,5.8905954857389204
2021-02-22T09:30:00-05:00,90.52,91.94,90.44,91.27,10552494,11144133.45,62.90487485358909,56.82969206244568,NaN,NaN,115.90646397661142,90.66464360116626,0.25934044082787644,0.7081661461335216,0.44882570530564514,1182570714,1172905495,47.513885955291634,47.92363770508949,NaN,NaN,14.095016296449824,7.062655601554764
2021-02-23T09:30:00-05:00,91.44,91.78,90.19,91.55,16570879,11060210.85,64.09159320206263,57.904209838442796,NaN,NaN,102.70269858971689,90.5759000884988,0.2754446927140457,0.7931315711982023,0.5176868784841566,1199141593,1177341799.4,51.60921308844871,49.90347918207846,NaN,NaN,16.10351668894925,8.354207185468262
2021-02-24T09:30:00-05:00,91.77,93.66,91.36,93.28,16795918,11375966.25,70.39372331553935,59.410857376253645,NaN,NaN,151.21498494823453,106.72521749417601,0.37678416581338703,0.9886670857508904,0.6118829199375033,1215937511,1186590483.4,58.8227011867345,51.91122152920866,NaN,NaN,20.018906829425546,10.02059284889073
2021-02-25T09:30:00-05:00,93.27,93.38,91.18,91.56,19945608,11216294.45,59.25828461559781,59.84288201367938,NaN,NaN,118.58245402379217,120.0745290814209,0.3052053341526717,0.993389587628343,0.6881842534756712,1195991903,1193131988.2,63.02140680862909,53.93937494510976,NaN,NaN,19.83896789049475,11.423217854834162
2021-02-26T09:30:00-05:00,91.78,92.05,90.36,90.61,18163355,11228046.65,54.1620616181174,59.764107904091475,NaN,NaN,69.91033279659412,111.6633868669898,0.17744091613304602,0.9099853986419788,0.7325444825089328,1177828548,1194294053.8,63.72895384911173,55.37874257665211,NaN,NaN,17.959605041937184,12.356987452991737
2021-03-01T09:30:00-05:00,91.93,93.62,91.8,92.93,11493983,10757994.3,62.61719234855703,60.082669059706234,NaN,NaN,145.88768504008354,117.65963107968423,0.22943741993592137,1.0193412574288345,0.7899038374929132,1189322531,1195644417.2,64.57714395979755,56.38522090376541,NaN,NaN,19.357423191324028,13.357049701324922
2021-03-02T09:30:00-05:00,92.98,93.125,92.26,92.66,11530656,10768590.15,61.202299813965986,60.238485781680986,NaN,NaN,128.39562648623118,122.79821665898707,0.22556816076164654,1.0718640384449714,0.8462958776833248,1177791875,1191374473.6,59.81401600041661,56.65748121736893,NaN,NaN,19.934732141462895,14.296718621344633
2021-03-03T09:30:00-05:00,92.74,93.85,92.53,92.76,17496722,11121236.35,61.54884523967837,60.47532672085695,NaN,NaN,131.49384320354767,118.85398831004973,0.2099845767589783,1.1087765986320477,0.8987920218730694,1195288597,1187244690.8,55.546639504119106,56.44661786715447,NaN,NaN,20.49265652156982,15.181852607091088
2021-03-04T09:30:00-05:00,92.89,93.23,89.85,91.28,27729527,12024568.4,53.87848189210187,60.24387631755229,NaN,NaN,41.55085168555618,103.44766784240251,0.086565091964253,1.0069983868283856,0.9204332948641326,1167559070,1181558124.2,50.23230698766895,55.81505624649986,NaN,NaN,18.41372077302569,15.64354805936746
2021-03-05T09:30:00-05:00,92.15,93.75,90.27,93.44,22816324,12809689.75,61.43273582909467,60.35030688843081,NaN,NaN,91.51792299749587,107.76918588258286,0.13412500395699545,1.0880895498103769,0.9539645458533814,1190375394,1184067493.4,52.39665704336934,55.29064779419468,NaN,NaN,19.248758216917167,16.15857808187456
2021-03-08T09:30:00-05:00,94.07,95.89,93.81,94.42,16782386,13274712.85,64.29051447611667,60.70249999631444,NaN,NaN,190.3274499640863,116.65713886738342,0.21074777893951468,1.2173992695277747,1.00665149058826,1207157780,1187634543.2,55.36801830674009,55.13891470607199,NaN,NaN,20.923088489166375,16.83922242577339
2021-03-09T09:30:00-05:00,94.9,95.385,94.02,94.03,12485073,13456586.35,62.311711083915824,61.0332029853592,NaN,NaN,151.3447473682493,121.24696304378703,0.2136593646767846,1.2737256964342407,1.0600663317574561,1194672707,1191010709.6,58.03779917837077,55.53043336804739,NaN,NaN,21.577003555498532,17.51604830144841
2021-03-10T09:30:00-05:00,94.29,95.91,94.16,95.42,17275318,13905426.5,66.29371358490556,61.86236970081883,NaN,NaN,157.13606661589145,126.3754077262558,0.2833260435671705,1.4142238862164191,1.1308978426492486,1211948025,1194342595.2,60.54604942991426,56.36951785572576,NaN,NaN,23.477277407542083,18.36765245946179
2021-03-11T09:30:00-05:00,95.7,96.31,94.92,95.49,12211107,13966860.05,66.48575393324867,62.205127557606495,NaN,NaN,152.43556079524387,148.55234954819335,0.30629640555512094,1.5137683495931498,1.2074719440380288,1224159132,1205662607.6,67.6262708546335,57.7743615823747,NaN,NaN,25.01476801228617,19.31724039557956
2021-03-12T09:30:00-05:00,95.84,96.845,95.75,96.77,10112770,14029071,69.86660651269023,62.70239410468515,NaN,NaN,165.2662761731664,163.30202018332744,0.3753155381882076,1.6766163667732883,1.3013008285850807,1234271902,1214441909.2,71.8460813230932,59.51237553721767,NaN,NaN,27.43114845413304,20.476370118230058
2021-03-15T09:30:00-04:00,97.16,97.61,96.19,97.58,11393412,14199612.5,71.80494432996035,63.25334775667784,NaN,NaN,166.72183916743398,158.58089802399698,0.43872932914303275,1.8497124900138715,1.4109831608708387,1245665314,1222143416,74.93285955135535,61.17835028456814,NaN,NaN,30.05431433058098,21.84464786285162
2021-03-16T09:30:00-04:00,97.37,97.43,96.08,96.19,12538754,14415190.95,64.17593578863041,62.80922007618434,NaN,NaN,124.90141375616875,153.29223130158087,0.35390673153347296,1.85336657528768,1.499459843754207,1233126560,1229834186.6,77.57675281677425,62.51792540099955,NaN,NaN,29.84296900138577,22.987265168356497
2021-03-17T09:30:00-04:00,96.38,97.5,96.13,97.3,14844047,14794094.3,67.17516188422474,63.37471130965769,NaN,NaN,120.0139470013981,145.8678073786822,0.339356512632232,1.923655484544497,1.584298971912265,1247970607,1237038703,79.73322307045812,63.71162656255877,NaN,NaN,30.637713393140093,24.080186343325582
2021-03-18T09:30:00-04:00,97.2,98.52,97.02,97.21,16893366,15318277,66.68765136845101,64.26939629182438,NaN,NaN,123.51668756270803,140.08403273217505,0.2922597471028181,1.9496236557907878,1.6573639086879697,1231077241,1238422324.8,80.12847447463474,64.88302089295327,NaN,NaN,31.11484323616803,25.08513732801736
2021-03-19T09:30:00-04:00,97.27,97.31,95.93,96.47,18430203,15803095.1,62.660978639667356,64.27252388404654,NaN,NaN,81.46503884572915,123.32378526668758,0.18508472638782214,1.8887198166727472,1.703635090284925,1212647038,1234097352,75.19206247438495,65.64122935828094,NaN,NaN,30.296091895646484,25.829559409107237
2021-03-22T09:30:00-04:00,96.36,96.53,95.45,96.12,12319893,15891465.05,60.79131510626743,64.24316783349664,NaN,NaN,57.92125809845752,101.5636690528923,0.07033915427459303,1.7915590331281663,1.7212198788535733,1200327145,1225029718.2,66.01019878668865,66.08381384301467,NaN,NaN,29.073444131345322,26.292971512284105
2021-03-23T09:30:00-04:00,95.47,96.34,94.09,94.44,16949009,15910371.55,52.66790711609143,63.60881511038328,NaN,NaN,16.10551011350183,79.8044883243589,-0.1281741503291065,1.5610021909421903,1.6891763412712968,1183378136,1215080033.4,57.686220096556816,66.23664102818879,NaN,NaN,25.409742048492433,26.16679587459958
2021-03-24T09:30:00-04:00,94.93,96.62,94.89,95.13,14581915,15799671.4,55.30933085652086,63.71101860784179,NaN,NaN,34.0667025972718,62.61503944353363,-0.21724505328872223,1.417620024660394,1.6348650779491163,1197960051,1205077922.2,50.75702039613094,66.27412055736464,NaN,NaN,23.158609315274802,25.737054937553182
2021-03-25T09:30:00-04:00,94.88,96.8,93.95,96.65,18519532,15728367.6,60.53427481565904,63.646842821167816,NaN,NaN,39.214674810171324,45.7546368930263,-0.1795865288443914,1.410381916893627,1.5899684457380183,1216479583,1202158390.6,48.91023295838938,66.02509026558035,NaN,NaN,22.829531702649824,25.32169447542413
2021-03-26T09:30:00-04:00,97.19,98.38,96.81,98.32,14395368,15539968.25,65.33021244436006,63.721106961756625,NaN,NaN,117.85233653534097,53.03209643094866,-0.054488612940891246,1.5218576795619043,1.5763462925027956,1230874951,1205803973.2,51.293361120956966,65.7340433237387,NaN,NaN,24.137378539035613,25.152506484511484
2021-03-29T09:30:00-04:00,98.21,98.919,97.84,98.34,12712826,15600910.4,65.38446531108511,63.94058940655443,NaN,NaN,130.53682401163874,67.5552096135849,0.01368182535218998,1.593448574193033,1.5797667488408431,1243587777,1214456099.6,56.48167502172091,65.6228915982637,NaN,NaN,25.172914917919993,25.155421974998415
2021-03-30T09:30:00-04:00,98.34,99.01,98.15,98.77,10180494,15533402.3,66.59480874010097,63.96209620335411,NaN,NaN,132.13433362328092,90.76097431554072,0.06873167504366773,1.6656813426454278,1.59694966760176,1253768271,1228534126.6,63.32692125972192,65.82152530039284,NaN,NaN,26.385970276725196,25.331214589530813
2021-03-31T09:30:00-04:00,99,99.26,98.12,98.45,12291304,15273131.4,64.77953711591411,63.84022357354449,NaN,NaN,119.77011762782355,107.90165732165107,0.06465208864764449,1.6777647784113157,1.6131126897636712,1241476967,1237237509.8,66.80341396206708,65.76274980806666,NaN,NaN,26.863546701438896,25.550119176946254
2021-04-01T09:30:00-04:00,98.62,98.86,98.14,98.78,11189257,14446117.9,65.814423784629,63.55078195011155,NaN,NaN,113.26861259938136,122.71244487949306,0.06505930219326217,1.6944368175052489,1.6293775153119867,1252666224,1244474838,69.40103356961349,65.58810353996097,NaN,NaN,27.552846743914223,25.836223115084536
2021-04-05T09:30:00-04:00,99.74,100.335,99.56,100,10789214,13844762.4,69.39476210561077,63.37862607694371,NaN,NaN,167.27674756471166,132.59732708536723,0.12490684569947907,1.7855110724363357,1.6606042267368566,1263455438,1250990935.4,71.55889050788329,65.34710575114154,NaN,NaN,29.224033279209564,26.320195995673824
2021-04-06T09:30:00-04:00,99.91,100.57,99.66,99.76,8203259,13415806.05,67.88845616350329,63.64380610372035,NaN,NaN,147.62592372378109,136.01514702779568,0.1254146522092765,1.817372541998452,1.6919578897891756,1255252179,1253323815.8,72.31172816033435,64.97103256139583,NaN,NaN,30.1807644487347,26.87170577468252
2021-04-07T09:30:00-04:00,99.78,100.03,98.985,99.3,8865776,13234841.2,64.97721063027961,63.48680958558141,NaN,NaN,106.70057350234313,130.92839500360813,0.07437710971406974,1.7849292769317628,1.710552167217693,1246386403,1251847442.2,71.03032126632597,64.34939671824353,NaN,NaN,30.184021429593628,27.344893725384107
2021-04-08T09:30:00-04:00,99.16,99.575,98.61,99.54,9151639,12828657.25,65.80121899837138,63.42349298771858,NaN,NaN,87.37433705375294,124.449238888794,0.03821025756939678,1.7583149891794392,1.7201047316100424,1255538042,1254659657.2,72.04645786955027,63.77210981788035,NaN,NaN,30.409143921616543,27.78264375341731
2021-04-09T09:30:00-04:00,99.72,100.5575,99.58,100.51,9656077,12700905.75,68.97805694808258,63.874712866891095,NaN,NaN,121.63319145298499,126.12215465951473,0.05975979787635355,1.7948044789554842,1.7350446810791307,1265194119,1257165236.2,72.95660963803748,63.61243461528411,NaN,NaN,31.504156876405588,28.31428848527278
2021-04-12T09:30:00-04:00,100.37,100.94,100.31,100.88,7704966,12580515.55,70.11831764211098,64.54092733373707,NaN,NaN,128.3656527873525,118.33993570404293,0.07792838934972268,1.832455167766284,1.7545267784165612,1272899085,1259053965.6,73.65300267625224,64.15834917882437,NaN,NaN,32.748659396209604,28.94777004397804
2021-04-13T09:30:00-04:00,100.41,100.7,99.68,100.39,10612155,12541452.7,66.62566226148726,65.53790984412248,NaN,NaN,96.13361303438418,108.04147356616356,0.03796463456104715,1.8019825716178701,1.764017937056823,1262286930,1260460915.8,74.1862612689217,65.336923548279,NaN,NaN,32.860426566424564,29.506720975756114
2021-04-14T09:30:00-04:00,100.46,101.195,100.4,100.52,9332090,12381119.5,67.09397038192185,66.37966981022255,NaN,NaN,105.97623531799039,107.89660592929302,0.0031400398943313146,1.7679429869247372,1.7648029470304059,1271619020,1265507439.2,76.05808068138136,67.14414214008261,NaN,NaN,33.07813628444667,30.016923162711908
2021-04-15T09:30:00-04:00,100.86,101.06,100.19,100.92,12631230,12270478.65,68.55600634107608,66.95265063346663,NaN,NaN,97.81680519185146,109.98509955691273,-0.009414253527974648,1.7530351301204377,1.7624493836484123,1284250250,1271249880.8,78.01192198102467,69.22283421312798,NaN,NaN,33.65345980102171,30.536428396756165
2021-04-16T09:30:00-04:00,101.52,101.8,100.7,101.14,10222064,11936913.55,69.36228708041448,67.24065596461337,NaN,NaN,107.57496416425055,107.17345409916584,-0.018817559270618345,1.7389274345601393,1.7577449938307577,1294472314,1277105519.8,79.82036954948562,71.2604776723086,NaN,NaN,34.35510590793252,31.081953755495643
2021-04-19T09:30:00-04:00,100.98,101,100.22,100.72,8141102,11422458.5,65.8887560219726,67.27667672967677,NaN,NaN,76.2615700075958,96.75263754321449,-0.06655336597448436,1.6745532863626522,1.7411066523371366,1286331212,1279791945.2,80.60835548781888,72.98381199131559,NaN,NaN,34.06328279970134,31.507857904667887
2021-04-20T09:30:00-04:00,100.5,100.68,99,99.61,13622380,11487582.85,57.669171499026945,66.63913121245719,NaN,NaN,33.095920683274336,84.14509907299252,-0.17969535124059277,1.5164874632863956,1.6961828145269884,1272708832,1281876325.6,81.22107657741296,74.26196594257924,NaN,NaN,31.4652929240322,31.501777193148502
2021-04-21T09:30:00-04:00,99.48,101.01,99.28,100.97,11352809,11207772.85,63.652155386956835,66.55860394610309,NaN,NaN,60.104864060666706,74.97082482152778,-0.16986238059159575,1.4838548387874937,1.6537172193790894,1284061641,1284364849.8,81.95419481496697,75.34416457492922,NaN,NaN,30.85068574140919,31.408764128614315
2021-04-22T09:30:00-04:00,101.06,101.7,100.355,100.46,11778735,11067613.85,60.21513071782317,66.15865444133125,NaN,NaN,80.4856952329026,71.50460282973799,-0.20241843117947833,1.4006941804047415,1.6031126115842198,1272282906,1281971381,78.76904758190622,76.01330843295014,NaN,NaN,29.296361783025276,31.10699236495874
2021-04-23T09:30:00-04:00,100.58,101.82,100.4,101.56,8126824,10547978.45,64.64895959253457,65.81966854754009,NaN,NaN,109.04613361830121,71.79883672054814,-0.15662866580256374,1.4073267793310151,1.5639554451335789,1280409730,1279158864.2,75.0765949732586,76.26457303761981,NaN,NaN,29.301237650346994,30.84902740572849
2021-04-26T09:30:00-04:00,101.91,102.42,101.2023,101.26,7824948,10219457.45,62.599930631568014,65.44191672383043,NaN,NaN,131.50148247162159,82.8468192133533,-0.15312137688728678,1.3725537240244705,1.5256751009117573,1272584782,1276409578.2,71.54595139413192,76.20987469717679,NaN,NaN,28.685507717861558,30.53995316460464
2021-04-27T09:30:00-04:00,101.66,102.26,101.31,102.1,13774879,10272560.1,65.86250843521704,65.50515228132596,NaN,NaN,143.5276646934151,104.93316801538144,-0.10319865160760355,1.396676786402253,1.4998754380098565,1286359661,1279139744,72.9084526333839,76.34402693768092,NaN,NaN,29.153564948905224,30.341897705219008
2021-04-28T09:30:00-04:00,102.06,102.41,101.76,101.89,7877873,10157429.05,64.35114320048802,65.40157543862001,NaN,NaN,141.8889581755753,121.28998683836316,-0.09357399819028078,1.3829079402720055,1.4764819384622863,1278481788,1278023773.4,71.4033713017221,76.29809218283606,NaN,NaN,29.090102006723008,30.163069748291008
2021-04-29T09:30:00-04:00,102.5,102.74,101.8599,102.61,11035209,10094624.3,67.13568434378979,65.26997739545622,NaN,NaN,161.1091210235129,137.41467199648523,-0.0501482343286519,1.4137966455514714,1.4639448798801233,1289516997,1281470591.6,73.24078030662737,76.31839008773532,NaN,NaN,29.86705539384192,30.12078198336971
2021-04-30T09:30:00-04:00,102.01,102.33,101.57,101.93,9861181,10028220.5,62.194604813511056,64.70399790769909,NaN,NaN,110.98705206215213,137.80285568525542,-0.07704347095090558,1.3676405411914914,1.444684012142397,1279655816,1281319808.8,73.01975120293632,76.27315783964134,NaN,NaN,29.0496348924811,29.967760970385623
2021-05-03T09:30:00-04:00,102.7,103.26,102.32,102.98,9445321,9961025.85,66.31695464198597,64.68194736344903,NaN,NaN,163.22414267684726,144.14738772630056,-0.03602449952712239,1.399653387733494,1.4356778872606164,1289101137,1284623079.8,74.81303653535663,76.31792750152954,NaN,NaN,29.612239132669632,29.916972136426196
2021-05-04T09:30:00-04:00,102.65,103.45,102.18,103.43,11677405,10134733.15,67.93088904776039,64.74172726815178,NaN,NaN,150.31184549009876,145.5042238856373,0.007203008351206686,1.4446816476996247,1.437478639348418,1300778542,1287506856,76.29438330895566,76.334806260642,NaN,NaN,30.57289550722671,30.010675475111984
2021-05-05T09:30:00-04:00,103.69,104.02,103.42,103.53,5695830,9976235.85,68.29445393836527,64.72304495367244,NaN,NaN,171.9679652007579,151.5200252906738,0.02719612725051812,1.4714737984115658,1.4442776711610477,1306474372,1293105372.8,78.89013154021256,76.3975355148697,NaN,NaN,31.45694154293308,30.21728491337214
2021-05-06T09:30:00-04:00,103.8,104.28,103.34,104.25,18276352,10432471.5,70.85632089844907,64.82976165496062,NaN,NaN,166.44153578936337,152.5865082438439,0.07108327502464706,1.5331317649418565,1.4620484899172095,1324750724,1300152118.2,81.61844264620409,76.52596930749246,NaN,NaN,32.98830166438954,30.61314444923177
2021-05-07T09:30:00-04:00,104,105.6,103.62,105.35,19343026,10916818.95,74.27613451588248,65.42886011881133,NaN,NaN,189.7544379745442,168.33998542632233,0.15173479947513813,1.651716989261132,1.499982189785994,1344093750,1313039705,85.34810739999531,76.86452301550506,NaN,NaN,35.42970269923594,31.301224199232365
2021-05-10T09:30:00-04:00,105.92,106.805,105.4,105.45,16335516,11348346.45,74.56829770091616,66.63594056180342,NaN,NaN,204.48325559241806,176.5918080094365,0.18703813868155672,1.73377986313794,1.5467417244563832,1360429266,1327305330.8,88.20179981771315,77.36314610409794,NaN,NaN,37.48375255803648,32.18444253620438
2021-05-11T09:30:00-04:00,104.4,104.67,102.84,103.89,25425759,12089026.65,62.619871297428176,66.56220598397995,NaN,NaN,83.13115700422051,163.15567031226084,0.08570383485081168,1.6538715180198977,1.568167683169086,1335003507,1334150323.8,89.28062203773574,77.8864623342957,NaN,NaN,35.55412501775956,32.665825747855116
2021-05-12T09:30:00-04:00,103.58,103.96,101.325,101.4,18125642,12528704.25,49.096952211258895,65.76805037636821,NaN,NaN,-1.1775006199433302,128.5265771481206,-0.15550594859693634,1.3737852474229157,1.529291196019852,1316877865,1336231022.4,89.59216320699649,78.65954202180214,NaN,NaN,28.697320106062186,32.098896370456124
2021-05-13T09:30:00-04:00,101.46,103.79,101.4,103.3,16458269,12720056.2,56.76871792059463,65.20517597122964,NaN,NaN,26.221037631876182,100.48247751662312,-0.1912283837296489,1.290255716357791,1.48148410008744,1333336134,1337948104.4,89.85422142596568,79.71508676842407,NaN,NaN,25.769709375205974,31.194726799706103
2021-05-14T09:30:00-04:00,104.1,104.995,103.74,104.73,11217721,12769839.05,61.474839297015905,65.12481230447591,NaN,NaN,103.58328197474988,83.24824631666425,-0.1258411546380651,1.3241826567898585,1.4500238114279236,1344553855,1338040125.4,89.86894362348379,81.0238719276635,NaN,NaN,25.20490813903691,30.339038419610503
2021-05-17T09:30:00-04:00,104.41,104.7799,103.65,104.41,11547805,12940174.2,59.90333830888418,64.69915729545214,NaN,NaN,83.43353452835464,59.03830210385157,-0.11190214766107665,1.3101461268515777,1.4220482745126544,1333006050,1332555482.2,82.21178807893455,81.68839588805997,NaN,NaN,24.222197338391275,29.46520397943633
2021-05-18T09:30:00-04:00,104.39,104.56,102.85,102.89,11195517,12818831.05,52.97588270568298,63.88663868868035,NaN,NaN,32.04899945607202,48.82187059422186,-0.20726674431788839,1.1629648441152938,1.3702315884331822,1321810533,1329916887.4,78.73610043705709,82.21216225486963,NaN,NaN,20.899789047125385,28.241573274820478
2021-05-19T09:30:00-04:00,101.75,102.32,100.67,102.31,16656477,13084014.45,50.5725881920818,62.70356039212978,NaN,NaN,-73.09414645831029,34.43854142654849,-0.30568054560573943,0.988130906426008,1.2938114520317474,1305154056,1327572125.6,75.67437528904523,82.38599046789946,NaN,NaN,17.468390739944212,26.702547198409583
2021-05-20T09:30:00-04:00,102.48,102.9,101.92,102.54,11635350,13076845.2,51.51198212320533,61.9405159142508,NaN,NaN,-38.252970080286545,21.543739884115944,-0.34845749971024165,0.8582395773939453,1.206697077104187,1316789406,1324262780,71.45128450889129,82.27395713261055,NaN,NaN,15.088962516317281,25.043463672396395
2021-05-21T09:30:00-04:00,103.12,103.88,102.68,103.04,13420164,13341512.2,53.57752868109934,61.03055691704461,NaN,NaN,4.996887077446724,1.8264609046553109,-0.3360949428870461,0.7865783984953794,1.1226733413824255,1330209570,1321393923,67.91305267178683,81.78110114235554,NaN,NaN,13.792014992533593,23.436113860987422
2021-05-24T09:30:00-04:00,103.67,103.9,103.12,103.68,7097853,13305157.45,56.15231884539404,60.18923047401845,NaN,NaN,25.520306485815187,-9.756184703852579,-0.28011957320669745,0.7725238748740537,1.0526434480807512,1337307423,1322254197.6,68.41809462495301,81.21850909349823,NaN,NaN,13.500523569797423,22.01674381938885
2021-05-25T09:30:00-04:00,103.96,104.45,103.23,103.37,8574746,13045150.8,54.5733957898497,59.20915489198162,NaN,NaN,28.98147965394142,-10.369688664278698,-0.2597311901787238,0.7279794603573464,0.9877106505360702,1328732677,1323638626.4,69.25671899283057,80.53040819725665,NaN,NaN,12.798121924470108,20.699797834400457
2021-05-26T09:30:00-04:00,103.52,103.84,103.12,103.7,7615787,13032046.5,55.99200186034164,58.14741781783109,NaN,NaN,13.644776505337406,6.978095928450841,-0.221281548914542,0.7111087143928927,0.9323902633074347,1336348464,1329877508,72.7663095164451,79.89811297370242,NaN,NaN,12.620728951596568,19.545645136857043
2021-05-27T09:30:00-04:00,104.64,105.3,104.542,105.12,11467445,13053658.3,61.555465291826536,57.23879858754138,NaN,NaN,122.55034287724915,39.13875851995798,-0.10346145565083187,0.8030634437438948,0.9065248993947267,1347815909,1336082808.6,75.73355304110257,79.21135909092438,NaN,NaN,14.159221795797002,18.77615608813418
2021-05-28T09:30:00-04:00,105.44,105.45,104.76,105.12,7606332,12940915.85,61.55546529182654,56.309310558320696,NaN,NaN,120.28304549254933,62.1959902029785,-0.032455097747892014,0.8659560272098616,0.8984111249577537,1347815909,1339604076.4,77.24843529320691,78.4289759106025,NaN,NaN,15.393466878744924,18.292914772507142
2021-06-01T09:30:00-04:00,106.14,106.31,105.32,105.53,9456949,12941497.25,63.116838225943184,56.344808196071774,NaN,NaN,145.40916028466938,86.17376096274934,0.031726261047953175,0.9380689512676952,0.906342690219742,1357272858,1343597163.4,78.86008385815501,77.68465175491816,NaN,NaN,16.880341502211774,18.091118591036377
2021-06-02T09:30:00-04:00,105.62,105.73,105.07,105.23,7547855,12735019.75,61.15953420529155,57.20642119564553,NaN,NaN,102.05213593499357,100.78789221895977,0.042882497865903146,0.959945812552121,0.9170633146862178,1349725003,1347795628.6,80.42979894311385,77.03019716464084,NaN,NaN,17.600277870640273,18.020998488122647
2021-06-03T09:30:00-04:00,104.68,105.59,104.25,105,10342322,12967344.35,59.63271059105563,57.41099210067846,NaN,NaN,65.58715411504485,111.17636774090127,0.024588285706988233,0.9477986718199531,0.9232103861129649,1339382681,1348402472,80.65340973731603,76.37299632973728,NaN,NaN,17.801630387954205,17.989660188098583
2021-06-04T09:30:00-04:00,105.39,105.565,104.8,105.34,7118239,12409438.7,61.17570393842365,57.38962528935044,NaN,NaN,76.48573475011163,101.96344611547376,0.025114142209740398,0.9546030638751404,0.9294889216654,1346500920,1348139474.2,80.2255804504691,75.68418467452196,NaN,NaN,18.385166699448053,18.046161118291366
2021-06-07T09:30:00-04:00,105.54,105.56,104.33,104.61,8298808,11857227.8,56.207941996314,57.12566840988114,NaN,NaN,50.28625625391243,87.96408826774638,-0.030933653617561285,0.8908218546434483,0.9217555082610096,1338202112,1346216714.8,77.00933871516119,75.31258114853816,NaN,NaN,17.554387458637052,17.975907738340748
2021-06-08T09:30:00-04:00,104.67,105.11,104.16,104.88,8848088,11482856.4,57.580017078649824,57.45453515080735,NaN,NaN,49.29827340960783,68.74191089273407,-0.05561443276820499,0.8522374673007533,0.9078519000689583,1347050200,1344172183.2,73.62916323053963,74.9477999195012,NaN,NaN,17.21410106922721,17.86707821418167
2021-06-09T09:30:00-04:00,104.81,104.81,103.77,103.81,10967076,10759922.25,50.78869575183928,57.46997140507574,NaN,NaN,7.338971391146681,49.79927798396469,-0.14473007929364834,0.7269393009518978,0.8716693802455462,1336083124,1341443807.4,69.2602354860822,74.48964707643242,NaN,NaN,14.956891030179847,17.451337187895696
2021-06-10T09:30:00-04:00,104.48,104.68,103.25,103.3,10645173,10385898.8,47.889397177467835,57.211215337523065,NaN,NaN,-27.475253497897082,31.18679646137631,-0.23349290206680018,0.579803252662046,0.8132961547288462,1325437951,1338654861.4,65.01355568760329,74.02980930348326,NaN,NaN,12.185411975575455,16.69906215756423
2021-06-11T09:30:00-04:00,103.7,104.02,102.97,103.51,10113527,10068661.7,49.175953846543884,56.89681713505481,NaN,NaN,-50.872519720961634,5.715145567161651,-0.27090059240069897,0.4746704142279725,0.7455710066286715,1335551478,1336464973,61.80888770341145,73.59379752002789,NaN,NaN,10.221333622731809,15.773672366873885
2021-06-14T09:30:00-04:00,103.41,103.55,102.47,103.04,11312072,10073379.25,46.414008099444146,56.20122351034411,NaN,NaN,-79.86016426670862,-20.314138536962556,-0.31693748184371107,0.3493991543240327,0.6663366361677437,1324239406,1333672431.8,57.89015091528397,72.84180154076581,NaN,NaN,7.749607083270449,14.62737732635911
2021-06-15T09:30:00-04:00,103.19,103.7,102.77,103.48,8948621,9943420.05,49.28566523717841,55.823528470867586,NaN,NaN,-52.12218527161089,-40.5982302732063,-0.30717321759092475,0.28237011417908775,0.5895433317700125,1333188027,1330899997.2,54.21511210167104,71.76740104854012,NaN,NaN,6.406378534095823,13.452948927464355
2021-06-16T09:30:00-04:00,103.38,103.5,102.18,102.5,13977906,10082539.5,43.67204621329586,54.94353163893574,NaN,NaN,-90.41481532342335,-60.148987616120316,-0.3528667028398752,0.14845995322016847,0.5013266560600437,1319210121,1327525396.6,50.050173634649525,70.14481991412616,NaN,NaN,3.535338216368183,12.03614739730776
2021-06-17T09:30:00-04:00,102.44,102.7,99.97,100.92,20842876,10291859.45,36.46143937333551,53.151101216186376,NaN,NaN,-193.55609976494512,-93.36515686952991,-0.4684110467769297,-0.0841871524111184,0.3842238943658113,1298367245,1322111255.4,44.18530882074126,67.89137389838606,NaN,NaN,-1.5038053177572501,10.101868438012758
2021-06-18T09:30:00-04:00,99.73,100.46,99.49,99.61,21546056,10787394.75,31.77678905970801,51.0240529138922,NaN,NaN,-248.24274367243868,-132.8392016598253,-0.6033811575103365,-0.37000255252210934,0.23337860498822716,1276821189,1310365197.6,34.68837155898851,64.85136934594189,NaN,NaN,-7.530595365325005,7.582945037535935
2021-06-21T09:30:00-04:00,100.1,101.61,100.01,101.48,15499880,10891380.55,43.029310286138866,49.58922948962047,NaN,NaN,-153.11307132542467,-147.48978307156852,-0.5391362076502861,-0.44054165457463057,0.0985945530756556,1292321069,1303981530.2,30.8122936032195,61.41938432773221,NaN,NaN,-8.830786524067118,5.238126243021213
2021-06-22T09:30:00-04:00,101.52,101.97,100.895,101.59,10646409,11068808.35,43.61841262371413,48.336292233793515,NaN,NaN,-110.71886113567382,-159.20911824438113,-0.46448523152454213,-0.48201198633002207,-0.017526754805479938,1302967478,1297937420.4,27.66077606337896,57.65016840775115,NaN,NaN,-9.62011830594658,3.115519878882957
2021-06-23T09:30:00-04:00,101.79,102.07,101.33,101.36,9136320,11096887.05,42.625907536338744,47.12152058702802,NaN,NaN,-92.53202046603577,-159.63255927290362,-0.407864637156769,-0.5273575512514412,-0.1194929140946722,1293831158,1292861627.8,25.31873793597417,53.69769185051244,NaN,NaN,-10.5574135260403,1.1622436781796348
2021-06-24T09:30:00-04:00,101.96,102.31,101.42,102.15,11687382,11300466.8,47.0800702933755,46.114689612381724,NaN,NaN,-66.66909840325577,-134.25515900056575,-0.29948965878154954,-0.49385498757160917,-0.1943653287900596,1305518540,1294291886.8,27.189502366487403,49.90940055879947,NaN,NaN,-9.926420385497174,-0.4218511880599092
2021-06-25T09:30:00-04:00,102.23,102.72,102.07,102.35,13039342,11379061.65,48.17695447374681,45.541047646484074,NaN,NaN,-42.259015089189454,-93.0584132839159,-0.20132705474663617,-0.4460241472233548,-0.24469709247671864,1318557882,1302639225.4,37.09370637905797,47.05828396336352,NaN,NaN,-9.084043722582496,-1.6593072644202786
2021-06-28T09:30:00-04:00,102.31,102.39,101.345,101.81,11997625,11598626.3,45.438449908447936,44.67379284861251,NaN,NaN,-60.124043747915294,-74.46060776841402,-0.16147742115419528,-0.44654386891946274,-0.28506644776526746,1306560257,1305487063,40.087979535003186,44.66248512796806,NaN,NaN,-9.185123324389973,-2.734423844415949
2021-06-29T09:30:00-04:00,102.14,102.57,101.51,101.61,11134253,11682491.5,44.4310960078272,44.219678581183075,NaN,NaN,-51.75149669586964,-62.66713488045318,-0.13820016596210366,-0.45781665521789705,-0.3196164892557934,1295426004,1303978768.2,39.02839951947068,42.5030682732101,NaN,NaN,-9.555940813468448,-3.708926268566306
2021-06-30T09:30:00-04:00,101.53,102.59,101.51,102.4,13677293,11988963.4,49.219968865141475,44.31471941601691,NaN,NaN,-32.82058156550609,-50.724847100347255,-0.0630359153593188,-0.39841138345494187,-0.3353754680956231,1309103297,1307033196,42.35144532271041,40.88434610428918,NaN,NaN,-8.464875778936033,-4.388347627190552
2021-07-01T09:30:00-04:00,103,103.19,102.59,103.13,13858573,12164775.95,53.23086372289465,44.604355835756245,NaN,NaN,16.975105454375342,-33.996006328821025,0.03702447630202205,-0.28909487271809553,-0.3261193490201176,1322961870,1310521862,45.97330285210092,39.753232900624134,NaN,NaN,-6.310770256369336,-4.66297943135895
2021-07-02T09:30:00-04:00,103.15,103.465,102.7,103.29,9911819,12304454.95,54.0868507895683,45.152416027907975,NaN,NaN,37.09309502724927,-18.125584305533284,0.11098350114077643,-0.18738997259414703,-0.29837347373492346,1332873689,1313385023.4,48.81548962301745,39.105042808319375,NaN,NaN,-4.296235428499723,-4.610587430950489
2021-07-06T09:30:00-04:00,103.05,103.19,101.18,102.3,11564061,12467717.6,48.20758463642127,45.07541027071103,NaN,NaN,-15.963361597403617,-9.293447875430948,0.09106237339002266,-0.18454550699739514,-0.2756078803874178,1321309628,1316334897.6,51.63833928731537,38.920987607293974,NaN,NaN,-4.231734294912334,-4.55646555437361
2021-07-07T09:30:00-04:00,102.07,103.47,101.971,103.32,14971963,12773911.35,53.78191877434653,45.797544025071794,NaN,NaN,45.34981736443819,10.126814936630618,0.14140923789629395,-0.09884633301705037,-0.24025557091334432,1336281591,1324506015,58.47064135236896,39.52244958713108,NaN,NaN,-2.434907386826296,-4.253385816152566
2021-07-08T09:30:00-04:00,101.69,102.53,101.03,101.88,17419365,13096525.8,46.21892599397713,46.494507355117626,NaN,NaN,-37.52875991922549,9.185179265886736,0.07584569955158416,-0.14544844647386412,-0.22129414602544828,1318862226,1326457800.8,59.92695067915329,40.64685257701766,NaN,NaN,-3.310224363435089,-4.1186484657643545
2021-07-09T09:30:00-04:00,102.97,103.65,102.87,103.49,13341932,13231363.75,54.006495912979354,48.08234355892272,NaN,NaN,101.31471574940022,26.053101324891713,0.13553972222878646,-0.051869493239465214,-0.18740921546825168,1332204158,1328306258.4,61.310681175941546,42.548446121085725,NaN,NaN,-1.3510183394629225,-3.7232727334355786
2021-07-12T09:30:00-04:00,102.97,103.75,102.6,103.63,10846541,13268014.45,54.621823478769954,48.910380215539234,NaN,NaN,102.40083188061422,39.1146486955647,0.17649260994808302,0.0332065469668521,-0.14328606298123092,1343050699,1330341660.4,62.832583847064726,44.83560970993182,NaN,NaN,0.3643371490221226,-3.13932846451305
2021-07-13T09:30:00-04:00,103.41,103.5,102.58,102.63,14881697,13446495.7,49.525091379327755,49.3322858409402,NaN,NaN,64.61329756895852,55.22998052883713,0.13039770019520222,0.01971106226277186,-0.11068663793243036,1328169002,1331713535.2,63.86434851073083,47.42157917045695,NaN,NaN,0.1431957433471413,-2.6703964348187372
2021-07-14T09:30:00-04:00,102.89,103.29,102.255,102.62,10140051,13506067.2,49.47537501178702,49.82153351775794,NaN,NaN,52.73871831361248,56.70776071867199,0.09504157316432511,0.008115328522976029,-0.08692624464134908,1318028951,1328063007.2,59.15826533066266,49.83868827007756,NaN,NaN,-0.04493299775117462,-2.2953302295233713
2021-07-15T09:30:00-04:00,102.04,103.24,101.99,102.82,11071559,13360749.85,50.54468049893605,50.06900567529799,NaN,NaN,49.40440186141004,74.0943930747991,0.08145482413250568,0.014892285524283011,-0.06656253860822267,1329100510,1330110664,60.89877961782134,52.24649378802999,NaN,NaN,0.11567434203795293,-1.9509010050146107
2021-07-16T09:30:00-04:00,103.17,103.19,101.781,101.91,17307422,13183977.15,45.79551083974727,49.898902558583735,NaN,NaN,6.8604510079362075,55.2035401265063,0.011201680464442962,-0.052560438027668965,-0.06376211849211193,1311793088,1326028450,55.79392249858386,53.58222351085326,NaN,NaN,-1.175396865482089,-1.8401146993671076
2021-07-19T09:30:00-04:00,100.28,100.49,98.77,99.78,23792682,13296308.45,37.02605630796713,49.298017301406524,NaN,NaN,-260.3616028930754,-17.34894682823164,-0.16876915642543142,-0.2747235640239012,-0.10595440759846977,1288000406,1315018391.4,44.86937276869892,53.923751598974384,NaN,NaN,-5.397944732790593,-2.34837613271332
2021-07-20T09:30:00-04:00,100.08,102.695,99.94,102.57,20937090,13568168.95,50.418956172995145,49.725721598918526,NaN,NaN,-56.30790646381454,-41.53318763478625,-0.09370698415541873,-0.22308813779274317,-0.12938115363732444,1308937496,1311172090.2,41.790890742067205,54.12107240058843,NaN,NaN,-4.234935504818753,-2.6178846144426675
2021-07-21T09:30:00-04:00,102.94,103.9,102.9,103.55,14449609,13758328.95,54.11070127183765,50.07505962796825,NaN,NaN,115.78410689171855,-28.924109919165033,0.02197366000269682,-0.10191407863395341,-0.12388773863665023,1323387105,1312243721,42.9650162578914,54.1648988959585,NaN,NaN,-1.952751724970743,-2.5228656302323924
2021-07-22T09:30:00-04:00,103.74,103.75,103.01,103.17,6318687,13617447.3,52.478988542338456,50.02135425792852,NaN,NaN,90.94356030960815,-20.616278229525413,0.0702068997017675,-0.036129114009440855,-0.10633601371120835,1317068418,1309837302.6,40.96669575257234,53.807284103135025,NaN,NaN,-0.7663263683082239,-2.271931449957511
2021-07-23T09:30:00-04:00,103.54,103.81,103.1,103.61,8055920,13435874.2,54.201130930288414,50.029517125122815,NaN,NaN,99.99293550113818,-1.989781330885026,0.1258074154372547,0.05092325558536004,-0.07488415985189467,1325124338,1312503552.6,44.07057577034563,53.46836168508704,NaN,NaN,0.7389944224238821,-1.841799182474455
2021-07-26T09:30:00-04:00,103.33,103.91,102.89,103.56,7488801,13158347.15,53.961814818015675,50.44053356666527,NaN,NaN,85.40038071680313,67.16261539109068,0.15155353033551675,0.11455775306750127,-0.03699577726801548,1317635537,1318430578.8,50.32345291392119,53.3744412298446,NaN,NaN,1.8457341622531236,-1.3150087046562295
2021-07-27T09:30:00-04:00,102.9,103.54,102.4,102.99,12402166,13178574.2,51.18712850086772,50.25519140427393,NaN,NaN,35.57153567170692,85.53850381819498,0.12370722494150435,0.11763825390886495,-0.006068971032639391,1305233371,1317689753.8,49.57737100963186,52.73920763393481,NaN,NaN,1.9352207136356558,-0.8506902163288174
2021-07-28T09:30:00-04:00,103.32,103.55,102.21,102.75,11996632,13221693.15,50.020857316012254,50.526757927276435,NaN,NaN,17.817464852102454,65.94517541027176,0.08450785337939185,0.09956584569160043,0.015057992312208578,1293236739,1311659680.6,43.87535589283576,51.59266514919784,NaN,NaN,1.6711627534646716,-0.49042550635831894
2021-07-29T09:30:00-04:00,103.55,103.855,102.975,103.56,9767658,13026211.4,53.84322691099719,50.51509585570627,NaN,NaN,80.42699300816552,63.841861949983226,0.10706343223624758,0.14888728260751805,0.04182385037127047,1303004397,1308846876.4,41.47887776319666,50.17610776257321,NaN,NaN,2.5604901435818377,-0.054580413509725145
2021-07-30T09:30:00-04:00,103.04,103.58,102.86,103.36,12824379,12974501.7,52.770074893579704,50.38282809962125,NaN,NaN,56.01519019067999,55.0463128878916,0.1024435572338822,0.16987829691362322,0.06743473967974102,1290180018,1301858012.4,36.18968503704375,48.27304356185742,NaN,NaN,2.9922986398950755,0.38068802269096064
2021-08-02T09:30:00-04:00,103.76,104.63,102.5584,102.65,15925534,13275187.45,49.03380053962026,50.34773589678501,NaN,NaN,56.30204011870389,49.22664476827175,0.04825231757406455,0.1277501366473217,0.07949781907325716,1274254484,1293181801.8,30.91869983964736,45.91978294249431,NaN,NaN,2.3033519602830093,0.6553542994898247
2021-08-03T09:30:00-04:00,102.85,104.04,101.97,103.99,14814300,13437699.4,55.44550772373352,50.774173947638324,NaN,NaN,58.03391326979469,53.719120287889304,0.0965477352676288,0.20018248815779316,0.10363475289016436,1289068784,1289948884.4,29.21140456042626,43.780721458906,NaN,NaN,3.6161881076566336,1.0783305577993687
2021-08-04T09:30:00-04:00,103.28,103.805,102.56,102.58,16181019,13498152.2,48.52753758422127,50.63009231087299,NaN,NaN,18.298344644362842,53.81529624634138,0.030829451377071562,0.1421715671115038,0.11134211573443224,1272887765,1285879089.6,27.176938125347718,41.37201849515789,NaN,NaN,2.5821737986668025,1.2931653064947164
2021-08-05T09:30:00-04:00,103,103.41,102.67,103.06,12561508,13255259.35,50.77902408181615,50.98605754244932,NaN,NaN,20.960665159359205,41.922030676580114,0.017639767241415485,0.1333918247862016,0.11575205754478611,1285449273,1282368064.8,25.525299594900957,39.209974002037676,NaN,NaN,2.431980949729201,1.4558532555282142
2021-08-06T09:30:00-04:00,103.48,103.98,103.35,103.54,8677160,13022020.75,52.99333462885521,52.12657742251276,NaN,NaN,89.90890341594512,48.70077332163314,0.038025212223666394,0.16328357282436912,0.12525836060070272,1294126433,1283157347.8,26.605150017165116,37.90538666264241,NaN,NaN,2.976556517833529,1.6730965787146876
2021-08-09T09:30:00-04:00,103.08,103.38,102.63,103.13,7469683,12853177.85,50.88748853007621,52.16004401944712,NaN,NaN,20.911080352995132,41.62258136849139,0.02150187101927442,0.15213569937479576,0.13063382835552134,1286656750,1285637801,30.038340590833755,37.065918794697154,NaN,NaN,2.809224231159119,1.8354005290638922
2021-08-10T09:30:00-04:00,103.32,104.47,103.195,104.18,12731195,12745652.75,55.73839261160246,52.27630768657318,NaN,NaN,120.14192326830607,54.04418336819367,0.07583578058492377,0.22542855408667606,0.1495927735017523,1299387945,1287701633.2,32.852758155461274,36.343614644523576,NaN,NaN,4.135328070628657,2.163961606430287
2021-08-11T09:30:00-04:00,104.39,105.54,104.01,105.53,12817434,12879521.9,61.063373118222096,52.889478013422014,NaN,NaN,214.82316674607728,93.34914778853656,0.19070582293954838,0.3879750521761878,0.1972692292366394,1312205379,1295565156,42.36611478453969,36.44357314680696,NaN,NaN,7.018405484450827,2.8574535890046495
2021-08-12T09:30:00-04:00,105.53,105.73,104.785,105.33,9265287,12789208.3,59.91337914080179,53.297495742744395,NaN,NaN,205.76832955626438,130.31068066791758,0.23814502704886953,0.4949505130477263,0.2568054859988568,1302940092,1299063319.8,46.02939831471916,36.58348904283365,NaN,NaN,8.985703468807502,3.732917857547914
2021-08-13T09:30:00-04:00,105.34,105.5,104.86,105,8909471,12369310.75,57.97333467226565,53.58403287519082,NaN,NaN,171.01328220413924,146.5315564255564,0.2319939696447565,0.5467979480548024,0.3148039784100459,1294030621,1299044157.4,46.01214551565279,36.27553851438591,NaN,NaN,10.043249315658942,4.634393780135204
2021-08-16T09:30:00-04:00,104.69,105.37,104,105.36,10231215,11691237.4,59.513513686854346,54.17877467418987,NaN,NaN,137.89045142023312,169.92743063900403,0.23608144998298275,0.6099057908887744,0.37382434090579164,1304261836,1302565174.6,49.73992590574127,36.28714957839372,NaN,NaN,11.369368146657079,5.5965329753526145
2021-08-17T09:30:00-04:00,104.73,104.78,103.23,104.22,15570022,11422884,52.901939186784524,54.38456623638789,NaN,NaN,40.955146793736276,154.09007534409005,0.15010740184573584,0.5614585932129614,0.4113511913672256,1288691814,1300425948.4,47.58990665052885,36.55247463251466,NaN,NaN,10.580474619320078,6.308524638776538
2021-08-18T09:30:00-04:00,103.81,104.395,103.045,103.08,11955198,11298163.45,47.249089568801345,53.91355642623104,NaN,NaN,-20.876655899766014,106.95011081492139,0.011849308978121309,0.4261628275898772,0.4143135186117559,1276736616,1293332195.8,41.226144375752476,36.534422247697215,NaN,NaN,8.115384801346691,6.566647519143703
2021-08-19T09:30:00-04:00,102.31,103.06,101.78,102.36,17529721,11858715.15,44.047748933177104,53.290533143345144,NaN,NaN,-129.87725298807413,39.82099430605369,-0.12515528069603177,0.25786941774171623,0.383024698437748,1259206895,1284585556.4,35.00975713576959,36.45014168332049,NaN,NaN,5.036819503661253,6.3481006597890675
2021-08-20T09:30:00-04:00,102.41,102.9381,102.135,102.63,11752950,12043566.65,45.537961717701286,53.04083037035093,NaN,NaN,-102.89141631272088,-14.959945397318341,-0.19072745049236106,0.14461538532229667,0.33534283581465774,1270959845,1279971401.2,32.24730697261219,36.545042192817974,NaN,NaN,2.9648434027536004,5.864778194498286
2021-08-23T09:30:00-04:00,103.11,103.92,103.06,103.47,8470964,12092674.8,49.999694763329515,52.65184373032207,NaN,NaN,-12.43491043484302,-45.02501776833357,-0.1712789870756527,0.12124410197009183,0.29252308904574453,1279430809,1275005195.8,29.54516059385331,36.56888190949134,NaN,NaN,2.5090044402803846,5.385381943895728
2021-08-24T09:30:00-04:00,103.67,104.45,103.65,103.99,7593172,11852225.1,52.58908083172257,52.94195396228645,NaN,NaN,36.32955432698261,-45.9501362616843,-0.11959203143770791,0.14303304974860964,0.26262508118631755,1287023981,1274671629.2,29.367160618507157,36.72532637328844,NaN,NaN,2.8954855115307834,5.0296824535578795
2021-08-25T09:30:00-04:00,104.07,105,103.745,104.66,9404193,11722603.15,55.76757243779939,53.298278844856675,NaN,NaN,69.90115199528759,-27.794574682673566,-0.040562905058768806,0.21192144986285655,0.25248435492162535,1296428174,1278609940.8,34.39286414716203,37.35872384130709,NaN,NaN,4.174181532200584,4.907468036221123
2021-08-26T09:30:00-04:00,104.54,104.61,103.985,104.2,9951097,11731775.1,53.133782467929514,53.308310833361986,NaN,NaN,45.38424983588733,7.257725882118725,-0.02056058220777429,0.22678362716190748,0.24734420936968177,1286477077,1284063977.2,40.68695571148044,38.36456710518676,NaN,NaN,4.480857913229643,4.8465237329366255
2021-08-27T09:30:00-04:00,104.55,105.21,104.32,104.92,10484388,11614775.55,56.58961276238058,53.71560542138372,NaN,NaN,86.86799853109886,45.209608850882674,0.03674803394566539,0.2932792518017635,0.2565312178560981,1296961465,1289264301.2,46.00589885199111,39.50510698098371,NaN,NaN,5.768709398112587,4.978264542247477
2021-08-30T09:30:00-04:00,105.1,105.28,104.55,104.8,6528165,11144907.1,55.85042894690967,53.72360801676281,NaN,NaN,83.49764361626598,64.39611966110446,0.060744705831764834,0.33246210014580413,0.2717173943140393,1290433300,1291464799.4,48.12573543931573,40.59603392983046,NaN,NaN,6.615633529731621,5.212174397602355
2021-08-31T09:30:00-04:00,104.73,104.95,104.275,104.51,9621180,10885251.1,54.014207028271244,53.22009615319489,NaN,NaN,51.71674499373374,67.4735577944547,0.05161669889680426,0.33623826793504463,0.2846215690382404,1280812120,1290222427.2,47.00370774707697,40.92729057001169,NaN,NaN,6.824562144694769,5.442515504329842
2021-09-01T09:30:00-04:00,104.73,104.73,103.72,104.11,13116827,10732041.5,51.499163499945475,52.61908075027658,NaN,NaN,11.927303535737463,55.878788102544675,0.015067702297616614,0.30345619691026116,0.28838849461264454,1267695293,1284475851,42.11287091748691,40.64753861306652,NaN,NaN,6.313770936124515,5.566980566014795
2021-09-02T09:30:00-04:00,104.54,105.24,104.52,105.23,9633661,10585649.15,57.470487308765584,52.58316308145515,NaN,NaN,82.44684150750906,63.29130643686902,0.06021622606725924,0.3636587771967186,0.30344255112945934,1277328954,1282646226.4,40.662166042452135,40.265397222123624,NaN,NaN,7.589186400966487,5.855867113865036
2021-09-03T09:30:00-04:00,104.94,105.14,104.52,104.59,9855160,10644549.15,53.422906392653005,52.1481197032979,NaN,NaN,53.01356073956496,56.52041887856224,0.04174807936090413,0.3556276503305895,0.3138795709696854,1267473794,1276748692.2,36.3191354926201,39.306769335472104,NaN,NaN,7.49677705195878,6.090282819307
2021-09-07T09:30:00-04:00,104.23,104.3,102.71,102.78,17849895,11163559.75,43.98745324569336,51.51137070750567,NaN,NaN,-97.61104063347439,20.298682028614166,-0.09038745215687782,0.20089525577358813,0.29128270793046596,1249623899,1268586812,31.33156651146537,38.145459325539,NaN,NaN,4.300799987086963,5.834642414704137
2021-09-08T09:30:00-04:00,102.57,103.12,102.14,102.92,13561573,11205078.65,44.79955781086849,51.33640415336762,NaN,NaN,-131.8929896025006,-16.423264890632698,-0.16219027973410427,0.08854485826283565,0.2507351379969399,1263185472,1265061482.4,29.450352905394936,37.3043313633706,NaN,NaN,2.019316567201924,5.289595865060964
2021-09-09T09:30:00-04:00,102.75,103.48,102.17,102.42,9406169,11034515.4,42.43331015801449,51.22108709799886,NaN,NaN,-117.26693614899466,-42.26211282757912,-0.23288735483800957,-0.04037405555057205,0.19251329928743752,1253779303,1262278284.4,28.019968695682394,36.80506076050723,NaN,NaN,-0.6088024854474055,4.446967529274054
2021-09-10T09:30:00-04:00,102.91,103.12,101.915,101.96,9547823,11048642.2,40.32315917873115,50.84860120235813,NaN,NaN,-126.93819203823273,-84.13911953672748,-0.29610180427265226,-0.17761395605337782,0.11848784821927444,1244231480,1255658789.6,24.919883452677524,36.28167336622619,NaN,NaN,-3.443673601698437,3.3197330819922692
2021-09-13T09:30:00-04:00,102.74,103,101.46,102.23,12451026,11225719.95,42.14186178227232,50.287327417996906,NaN,NaN,-118.15165552698757,-118.37216279003796,-0.3040507125099908,-0.261575542418214,0.042475170091776746,1256682506,1253500532,23.98799680459807,35.884733095565096,NaN,NaN,-5.267485639887257,2.0929875502951942
2021-09-14T09:30:00-04:00,102.51,102.6,100.77,101,11493627,11288840.55,36.66058990919457,49.14957806638777,NaN,NaN,-154.32333518829856,-129.7146217010028,-0.37197705794111474,-0.4224961523346167,-0.050519094393501954,1245188879,1252613528,23.59743580065009,35.47260989428959,NaN,NaN,-8.629931884922186,0.5611419166927112
2021-09-15T09:30:00-04:00,101.05,102.37,100.83,102.11,9175030,10969090.95,43.76861506453681,48.292509682583294,NaN,NaN,-115.72828102483032,-126.48167998546876,-0.32375414348718323,-0.455211773752481,-0.13145763026529778,1254363909,1250849215.4,22.802181661550662,34.64470400246021,NaN,NaN,-9.314139897582061,-0.8496126282036847
2021-09-16T09:30:00-04:00,102.1,102.35,101.24,101.41,10516239,10897143,40.66906354916225,47.40217261695706,NaN,NaN,-106.86241905019628,-124.40077656570907,-0.3200311183108888,-0.5314965281539088,-0.21146540984301998,1243847670,1248862888.8,21.907054134902992,33.303282461276105,NaN,NaN,-10.871478621903846,-2.2813077701608506
2021-09-17T09:30:00-04:00,101.06,101.3,100.175,100.33,16250702,10833192.05,36.38753284041657,45.959166908245344,NaN,NaN,-154.7270451989274,-129.95854719784802,-0.3679162253559031,-0.6713606915378989,-0.3034444661819958,1227596968,1245535986.4,20.45843254672647,31.47846343947149,NaN,NaN,-13.616755455063176,-3.900657439432611
2021-09-20T09:30:00-04:00,98.54,99.06,97.78,98.86,21453561,11318222.6,31.52300430982642,44.221493719882254,NaN,NaN,-219.20802600450332,-150.16982129335116,-0.46968842681338085,-0.8905549996987219,-0.420866572885341,1206143407,1235428166.6,16.81941622507263,29.242297781311265,NaN,NaN,-17.701787059606847,-5.872247385171788
2021-09-21T09:30:00-04:00,99.34,99.4,97.8921,98.34,14345231,11611935.95,29.995391232373336,42.50586402017526,NaN,NaN,-181.02466500039492,-155.51008725577043,-0.5382036525513884,-1.0936211385745764,-0.5554174860231881,1191798176,1224750026,13.98861599151256,26.8840769416281,NaN,NaN,-21.483059407247964,-8.102363388325527
2021-09-22T09:30:00-04:00,98.63,99.79,98.63,99.12,13080094,11886282.05,35.07764095452818,41.33289812407402,NaN,NaN,-133.7577119242629,-159.11597343565694,-0.4980927308993729,-1.1780333996474042,-0.6799406687480313,1204878270,1214852898.2,11.976605361657988,24.731486544783177,NaN,NaN,-22.958409880378955,-10.224655744333159
2021-09-23T09:30:00-04:00,99.59,101.19,99.55,100.64,11440233,11988084.05,43.66125539952279,40.346524416270974,NaN,NaN,-75.23664301934416,-152.79081822948655,-0.34363939998204396,-1.1094899187255862,-0.7658505187435423,1216318503,1209347064.8,11.02645970305926,22.61465037768369,NaN,NaN,-21.302720677210925,-11.807236449029983
2021-09-24T09:30:00-04:00,100.38,101.13,100.31,100.85,8254497,11903254.05,44.748139428555056,39.726898204549684,NaN,NaN,-57.246761883004105,-133.2947615663019,-0.20843307684397594,-1.0263918647985122,-0.8179587879545362,1224573000,1208742271.2,10.923940650269572,20.80070788894437,NaN,NaN,-19.654508404226863,-12.928275299772395
2021-09-27T09:30:00-04:00,100.99,101.85,100.89,100.95,9337978,11845933.55,45.289408041823854,39.819894975701864,NaN,NaN,-33.48471298753028,-96.1500989629073,-0.09892302605834546,-0.941612570527468,-0.8426895444691226,1233910978,1214295785.4,18.42418314148358,19.87875193394567,NaN,NaN,-18.1806746355783,-13.678618062030381
2021-09-28T09:30:00-04:00,100.67,100.93,99.545,99.78,17057306,12372390.6,40.313350674753984,39.49945160883654,NaN,NaN,-73.8415999265048,-74.71348594812926,-0.0920825662446203,-0.9577927522748979,-0.8657101860302776,1216853672,1219306884.6,24.59397027701894,19.531867460490243,NaN,NaN,-18.42880628033775,-14.357216378931433
2021-09-29T09:30:00-04:00,100.22,100.41,99.74,99.89,12148155,12498739.35,40.970029192926454,39.39493153990168,NaN,NaN,-70.11036328896944,-61.984016221070576,-0.06805552073688526,-0.9507795869513842,-0.882724066214499,1229001827,1224131596,30.07736557582946,19.678824380500746,NaN,NaN,-18.43210085024439,-14.939342731976142
2021-09-30T09:30:00-04:00,100.21,100.29,97.73,97.84,24624757,13074135.85,33.559671513877944,38.91182527812645,NaN,NaN,-119.71819806847364,-70.88032723089648,-0.1722068352521272,-1.097982610279658,-0.9257757750275307,1204377070,1221743309.4,28.954919148141073,19.967041215891005,NaN,NaN,-20.881588104114364,-15.788234927995887
2021-10-01T09:30:00-04:00,98.46,99.71,97.48,99.18,17051802,13445042.9,41.063652663117075,38.83481034104393,NaN,NaN,-102.81395233654145,-79.99376532160393,-0.13450370404024248,-1.0939054050778338,-0.9594017010375914,1221428872,1221114483.8,28.65173588561923,20.300165435963944,NaN,NaN,-20.430452673986316,-16.451408891708805
2021-10-04T09:30:00-04:00,99.01,99.64,98.02,98.64,20182941,13961431.95,39.14494295588373,39.01226413009316,NaN,NaN,-96.65651609353475,-92.62812594280483,-0.12953606169187482,-1.121321778152435,-0.9917857164605601,1201245931,1214581474.4,25.64711837251258,20.446571333954118,NaN,NaN,-20.69370658399315,-17.057451419177998
2021-10-05T09:30:00-04:00,98.82,100.25,98.39,99.74,12987951,13718334.75,44.80280450668716,39.08613480453247,NaN,NaN,-55.38180846127838,-88.93616764975954,-0.04039059404388623,-1.042273959015418,-1.0018833649715317,1214233882,1214057516.4,25.416905919440424,20.633337352374816,NaN,NaN,-19.04135831586576,-17.340866690133392
2021-10-06T09:30:00-04:00,98.67,100.22,98.205,100.18,14702544,13775383.3,46.92831471736568,39.53322417368985,NaN,NaN,-45.29378337485033,-83.97285166693572,0.05481515120077218,-0.9333644259705665,-0.9881795771713386,1228936426,1214044436.2,25.4107737984,20.883603042624603,NaN,NaN,-17.03289224356526,-17.29687034062366
2021-10-07T09:30:00-04:00,100.95,101.69,100.87,100.96,9669765,13788563.1,50.56267327471065,40.545734204710854,NaN,NaN,54.91399707791471,-49.04641263765806,0.17040158943062933,-0.775177590383052,-0.9455791798136813,1238606191,1220890260.4,34.33947752964748,21.875106255690387,NaN,NaN,-14.199343485173612,-16.854366504130795
2021-10-08T09:30:00-04:00,100.86,101.2,100.52,100.95,8565137,13739428.8,50.514912146681745,41.90229905020052,NaN,NaN,45.122434100715914,-19.459135350206584,0.24189868498745326,-0.6432058235793647,-0.885104508566818,1230041054,1222612696.8,36.402272410059425,23.27388169747516,NaN,NaN,-11.963958491611049,-16.155736788056544
2021-10-11T09:30:00-04:00,100.82,101.46,100.13,100.14,9984044,13616079.7,46.66946314974624,43.09330418715573,NaN,NaN,32.87954886665973,6.448077641832308,0.23040797172862348,-0.5970945439060387,-0.8275025156346622,1220057010,1226374912.6,40.77865394172831,25.187455836776284,NaN,NaN,-11.171048371465888,-15.443638442829307
2021-10-12T09:30:00-04:00,100.26,100.61,99.61,99.81,10048788,13543837.75,45.16110115696763,43.813551344472835,NaN,NaN,-1.8888485743911245,17.146669619209757,0.1976118020798474,-0.5804877630348528,-0.7780995651147002,1210008222,1225529780.6,40.11092260768823,27.19704992577844,NaN,NaN,-10.948200975511439,-14.801433090355326
2021-10-13T09:30:00-04:00,99.99,100.44,98.93,100.02,12416671,13705919.8,46.34943138064295,44.005563914552845,NaN,NaN,-11.407716826480709,23.923882928883707,0.18719215571907122,-0.5441093704658613,-0.7313015261849325,1222424893,1224227474,39.04981071447633,29.198717855165373,NaN,NaN,-10.431834409845603,-14.177204707425366
2021-10-14T09:30:00-04:00,100.83,101.935,100.62,101.91,9752931,13667754.4,55.66168498542263,44.785102882900524,NaN,NaN,128.63893044737335,38.66886960277544,0.2981309221555053,-0.3586378734905509,-0.6567687956460562,1232177824,1222941800.6,37.98155943147137,31.131404910965504,NaN,NaN,-7.023938145958223,-13.155309484358632
2021-10-15T09:30:00-04:00,102.61,103.33,102.47,102.89,11775253,13443981.95,59.57939453363679,45.80581620374431,NaN,NaN,207.22738961013258,71.08986070465878,0.42056562242451956,-0.13106176761540667,-0.5516273900399262,1243953077,1225724205.2,41.69868432099913,32.7938692809309,NaN,NaN,-2.8533064054139112,-11.6835947587951
2021-10-18T09:30:00-04:00,102.3,103.07,101.895,102.96,6780227,12710315.25,59.85227387052081,47.20145357487051,NaN,NaN,161.22941298637286,96.75983352860139,0.4847548938054279,0.05431622721685869,-0.4304386665885692,1250733304,1231859464,48.96261971790897,34.53448709813733,NaN,NaN,0.551366355586421,-9.935743171026312
2021-10-19T09:30:00-04:00,103.47,103.605,102.86,103.57,6911171,12338612.25,62.24430477580827,48.7210446879335,NaN,NaN,179.29441400198377,132.99648604387636,0.5424288350899341,0.24759737727384845,-0.29483145781608566,1257644475,1241386714.6,57.76307759369784,36.512037956556505,NaN,NaN,4.155984409070428,-7.922639231012491
2021-10-20T09:30:00-04:00,103.59,104.325,103.35,104.22,9258586,12147536.85,64.66051258960287,50.94253333619958,NaN,NaN,182.0241974753831,171.68286890424912,0.5943121319046084,0.4480587070646749,-0.14625342483993356,1266903061,1250282348.2,64.00420006213261,39.015558021841564,NaN,NaN,7.9544963142476925,-5.654477010261036
2021-10-21T09:30:00-04:00,104,104.48,103.74,104.43,7824899,11966770.15,65.43024320127975,52.683004088925486,NaN,NaN,161.32734287250375,178.22055138927522,0.6104118271515346,0.6167613590994847,0.006349531947950099,1274727960,1258792375.4,68.7599679938026,41.880431743854665,NaN,NaN,11.307915336875395,-3.231278103527261
2021-10-22T09:30:00-04:00,104.64,105.185,104.48,104.8,9826276,12045359.1,66.80224396878307,54.658525589846874,NaN,NaN,157.0137480160195,168.17782307045258,0.6120586557341516,0.7714228516156396,0.159364195881488,1284554236,1266912607.2,72.49430576647835,45.226659414852215,NaN,NaN,14.534568757652695,-0.6932999805015534
2021-10-25T09:30:00-04:00,104.64,105.44,104.3,105.04,8093601,11983140.25,67.69778308524039,56.29388120260067,NaN,NaN,135.08000670604366,162.94794181438675,0.5948690762351525,0.9029505411754286,0.3080814649402761,1292647837,1275295513.8,75.72090814461295,48.819802430935965,NaN,NaN,17.498683548518876,1.9055548093585077
2021-10-26T09:30:00-04:00,104.93,105.37,104.3801,104.39,12313960,11745972.95,62.75985710401985,57.42470565879025,NaN,NaN,110.06256884609546,149.1015727832091,0.5086207594821047,0.943857414292907,0.4352366548108023,1280333877,1279833394.2,77.27497704898123,52.52438837740606,NaN,NaN,18.745785703828734,4.311302079997111
2021-10-27T09:30:00-04:00,104.59,104.66,103.145,103.17,9015191,11589324.75,54.69577296838253,57.7199270654811,NaN,NaN,65.59924164118729,125.81658161636994,0.3460737254207561,0.8678288115867474,0.5217550861659913,1271318686,1280716519.2,77.57579838727264,55.61269701009356,NaN,NaN,17.484322748344265,6.193162175475275
2021-10-28T09:30:00-04:00,103.32,104.52,103.32,104.46,9260446,10821109.2,60.47836519415535,58.431602283157794,NaN,NaN,72.56027100797772,108.06316724346475,0.3036186817826697,0.9012784383943284,0.5976597566116587,1280579132,1281886753.6,77.99154547878805,58.583359372145615,NaN,NaN,18.14668299433639,7.900808006741149
2021-10-29T09:30:00-04:00,104.27,104.87,104.07,104.49,6831642,10310101.2,60.60430090053562,59.4269478367856,NaN,NaN,78.31540576991794,92.32349879424443,0.25755826991276376,0.9196075940026134,0.6620493240898496,1287410774,1282458061.2,78.20400236238461,61.25659854504964,NaN,NaN,18.71086772730259,9.44510225253564
2021-11-01T09:30:00-04:00,104.7,104.99,104.27,104.78,10775227,9839715.5,61.86918715068176,60.620382550622324,NaN,NaN,79.8930453359777,81.28610652023124,0.2276582111809604,0.9466220880660501,0.7189638768850897,1298186001,1283565694,78.63463026138106,64.00829194888483,NaN,NaN,19.54130573655686,10.887417035967243
2021-11-02T09:30:00-04:00,104.93,105.225,104.63,105.13,8833899,9632012.9,63.39667555189972,61.83804284856924,NaN,NaN,86.06743453452034,76.48707965791621,0.21276473991953948,0.984919801784514,0.7721550618649745,1307019900,1288902898.6,80.62141244742773,66.97769207266708,NaN,NaN,20.671857235305737,12.285194207301313
2021-11-03T09:30:00-04:00,104.54,104.97,103.99,104.9,11567268,9475249.1,61.648954769450995,62.26570497599983,NaN,NaN,66.14808253376104,76.59684783643095,0.17055866843806244,0.9853533974125526,0.8147947289744901,1295452632,1293729687.8,82.2307192859438,70.13834634798654,NaN,NaN,21.140498828205736,13.550237724573373
2021-11-04T09:30:00-04:00,105.2,105.695,105.0801,105.32,10201177,9501819.7,63.62119637480387,62.55440510751176,NaN,NaN,92.206541732555,80.5261019813464,0.1545388440565606,1.007968284045191,0.8534294399886303,1305653809,1298744623.2,83.74146013277458,73.14140176311336,NaN,NaN,22.083265104142814,14.769241635940435
2021-11-05T09:30:00-04:00,106.54,107.05,106.04,106.39,12906652,9718895.45,68.11930430517438,63.1449072814156,NaN,NaN,134.72162331701534,91.80734549076587,0.19690109390688826,1.0995558073722407,0.9026547134653524,1318560461,1304974560.6,85.40188739665943,75.74420659730983,NaN,NaN,24.265779024529213,16.12588983431026
2021-11-08T09:30:00-05:00,107.33,107.58,106.415,106.83,8928874,9666136.95,69.77435253577485,63.68276783569892,NaN,NaN,149.64887204027337,105.75851083162502,0.23298149207240626,1.1938815785558603,0.960900086483454,1327489335,1310835227.4,86.77064063839876,77.81617538621704,NaN,NaN,26.598421948440908,17.62196585061464
2021-11-09T09:30:00-05:00,107.03,107.36,106.505,107.1,10637515,9695573.3,70.77689994813795,64.11965264702285,NaN,NaN,149.2779214761361,118.40060821994817,0.2518531384129643,1.2757165094996594,1.0238633710866951,1338126850,1317056617.4,88.05140802900071,79.53383309813617,NaN,NaN,28.837080355234757,19.224125065560372
2021-11-10T09:30:00-05:00,106.95,107.29,106.205,106.5,10325814,9591030.45,65.57191648112959,64.12977216701212,NaN,NaN,129.74525678513925,131.1200430702238,0.20285399784499636,1.2774308683929405,1.0745768705479442,1327801036,1323526298.2,89.22016368317047,80.99527564737674,NaN,NaN,29.294902923051808,20.662807616630577
2021-11-11T09:30:00-05:00,106.71,106.71,105.95,106.06,5921237,9399445.75,61.972650057048284,63.78480117331679,NaN,NaN,94.3012757541862,131.53898987455005,0.12363185975083235,1.2291166952364847,1.1054848354856524,1321879799,1326771496.2,89.76116765652911,82.2286229252375,NaN,NaN,28.650183883606456,21.803861369055703
2021-11-12T09:30:00-05:00,106.36,107.08,106.02,106.9,7929022,9207134.2,65.82890953808763,63.65131020566302,NaN,NaN,107.46457859205505,126.087580929558,0.11102431538135038,1.2442652297123402,1.1332409143309898,1329808821,1329021168.2,90.13093371250578,83.25791046580127,NaN,NaN,29.207750180886165,22.861559770745767
2021-11-15T09:30:00-05:00,107.33,107.45,106.86,107.1,7672636,9251754.65,66.69490624663726,63.93238514442141,NaN,NaN,119.84698365936147,120.12720325337561,0.09973406441224064,1.2579084948462906,1.15817443043405,1337481457,1331019592.6,90.46050927606262,84.19973419630709,NaN,NaN,29.915422830705534,23.86925449359716
2021-11-16T09:30:00-05:00,107.11,107.6459,107.02,107.12,6624957,9237443.95,66.78555650929775,64.79594111162963,NaN,NaN,111.84395760519767,112.64041047918792,0.07814682744420476,1.255857964739306,1.1777111372951012,1344106414,1332215505.4,90.66148936271681,85.13442640883882,NaN,NaN,30.520602171477524,24.819447019008642
2021-11-17T09:30:00-05:00,107.14,107.275,106.11,106.48,8164384,9182733.85,61.05840679790211,64.83737265475442,NaN,NaN,64.33299471372872,99.55795806490582,0.0089395072240257,1.1888855213251333,1.1799460141011076,1335942030,1333843704.2,90.94131380944523,86.05940986102861,NaN,NaN,29.43854020459358,25.479317474092205
2021-11-18T09:30:00-05:00,106.83,106.83,105.71,106.26,9806241,9281800.95,59.17971203557795,64.73561630725744,NaN,NaN,37.258472094575126,88.14939733298361,-0.059704152680491784,1.1053158232504927,1.1650199759309845,1326135789,1334694902.2,91.09159881459026,86.97995246475759,NaN,NaN,28.0022439970275,25.839735548797247
2021-11-19T09:30:00-05:00,106.21,106.285,105.58,105.73,8935617,9237268,54.80481958467149,64.23101862397098,NaN,NaN,8.664303975554096,68.38934240968341,-0.14404350508121655,0.9849655945794638,1.1290090996606803,1317200172,1332173172.4,86.51248075718371,87.54265607160063,NaN,NaN,25.49366764197464,25.790297276394018
2021-11-22T09:30:00-05:00,106.07,107.01,105.81,106.02,11911854,9428180.65,56.691400700993064,63.752070420334796,NaN,NaN,32.5137005828436,50.92268579437984,-0.18114061662987724,0.9025833288733338,1.083723945503211,1329112026,1330499286.2,83.51150899740853,87.74909153945642,NaN,NaN,23.868715806230487,25.515785637799226
2021-11-23T09:30:00-05:00,106.14,106.575,105.6546,106.2,14090394,9517002.35,57.86701478459862,63.48193184998819,NaN,NaN,19.505645971887237,32.45502346771775,-0.1932896018729724,0.8421119431619957,1.035401545034968,1343202420,1330318487.4,83.17589895753923,87.81660437314179,NaN,NaN,22.80860700735701,25.129045833450338
2021-11-24T09:30:00-05:00,105.85,106.3,105.71,106.08,10760392,9604262.4,56.760817199312214,62.991904766024504,NaN,NaN,3.2441165847277382,20.237247841917554,-0.2078694680357298,0.7755647099903058,0.9834341780260356,1332442028,1329618487,81.80515384251629,87.67829678098049,NaN,NaN,21.61769344891132,24.62742406423048
2021-11-26T09:30:00-05:00,103.35,103.78,102.48,103.21,14694053,9875942.75,38.03414468806119,60.84296479337356,NaN,NaN,-219.84764486686765,-31.18397555037099,-0.39823346152186756,0.48564235112370113,0.8838758126455687,1317747975,1327940924.2,78.46769970017057,87.18299765980271,NaN,NaN,13.544338928387337,23.044126187681456
2021-11-29T09:30:00-05:00,104.26,104.28,102.84,103.39,11693132,10119017.25,39.384873865234944,58.67228774547785,NaN,NaN,-175.53772877673345,-68.0243821008285,-0.49324481615267246,0.26731979245472814,0.7605646086074006,1329441107,1330389111.2,79.76513423255881,86.68260434509986,NaN,NaN,7.72698460024878,20.8559631037625
2021-11-30T09:30:00-05:00,102.61,102.93,100.665,100.77,21058879,10633199.85,29.35472604022688,55.71356103776992,NaN,NaN,-252.19132967082822,-124.96538815156286,-0.7010755858082611,-0.11577987365292586,0.5852957121553353,1308382228,1326243151.6,71.86757032117893,85.5266159373983,NaN,NaN,-1.9882000463367764,17.592511225176892
2021-12-01T09:30:00-05:00,102.3,102.712,99.33,99.37,19783746,11180692.2,25.60263048006317,52.85861203769375,NaN,NaN,-231.93746957605038,-175.2540112611504,-0.8892691038260802,-0.526290667627265,0.3629784361988152,1288598482,1315322364,56.108735366695846,83.16151391479296,NaN,NaN,-11.395812904201613,13.451322063837107
2021-12-02T09:30:00-05:00,100.13,102.67,99.79,102.32,21919304,11698294,42.32990515496372,51.45555883040199,NaN,NaN,-151.09553539676642,-206.1219416574492,-0.7756552959894857,-0.6065906837880419,0.16906461220144375,1310517786,1310937515.6,51.24951893345459,80.41068186314479,NaN,NaN,-12.403539634279406,9.757770392677605
2021-12-03T09:30:00-05:00,102.52,102.78,101.17,102.2,19584876,12167478.95,41.91704574454165,49.747568559434434,NaN,NaN,-110.69414530082922,-184.29124174424155,-0.6729826794333277,-0.6721637370902158,0.0008189423431118337,1290932910,1305574502.6,46.002028061062006,77.25861717375595,NaN,NaN,-13.269570339031855,6.468150288147683
2021-12-06T09:30:00-05:00,103.22,104.575,103.05,103.93,14457481,12245020.4,49.55569510766832,48.52333919236521,NaN,NaN,-41.641614892993395,-157.51201896749353,-0.46295351610445656,-0.5778729527874589,-0.11491943668300232,1305390391,1300764359.4,41.8618921993289,73.78728738256068,NaN,NaN,-10.935658397644922,3.9818919044630254
2021-12-07T09:30:00-05:00,104.72,105.855,104.675,104.99,10563313,12326742.35,53.58363899768507,47.58034508439288,NaN,NaN,7.208611151312875,-105.63203080306532,-0.2383480949476115,-0.4128545553675167,-0.1745064604199052,1315953704,1302278654.6,43.58329519392437,70.42455922764694,NaN,NaN,-7.573665813045101,2.3310979448190077
2021-12-08T09:30:00-05:00,105.04,105.44,104.725,105.25,10419574,12315845.3,54.54244232969685,47.114919050949645,NaN,NaN,9.58848827958932,-57.32683923193737,-0.06689163262599371,-0.25812100120239734,-0.19122936857640363,1326373278,1309833613.8,51.32649619018094,67.5949293976995,NaN,NaN,-4.710978610176515,1.325087008391076
2021-12-09T09:30:00-05:00,104.83,105.46,104.56,104.92,7325762,12165842.7,53.04473818752234,46.67670663323139,NaN,NaN,7.086365778215562,-25.69045899694097,0.024764098799996248,-0.1602742450764083,-0.18503834387640455,1319047516,1311539559.8,52.89854133375633,64.86685386335421,NaN,NaN,-2.974492874278503,0.7108613108668504
2021-12-10T09:30:00-05:00,105.39,105.57,104.84,105.35,8304248,12284993.25,54.78692489122239,46.67542844084217,NaN,NaN,19.78422660665383,0.4052153845556461,0.11004251531337936,-0.04748519973468035,-0.1575277150480597,1327351764,1318823330.6,58.98898090972339,62.90088958853561,NaN,NaN,-1.0245261864415125,0.46294881125137005
2021-12-13T09:30:00-05:00,105.11,105.31,104.08,104.26,12690151,12523049.7,49.748095925017665,46.179478099701065,NaN,NaN,-3.601644925330658,8.013209378088193,0.08959966072459186,-0.0455281391423199,-0.13512779986691176,1314661613,1320677575,60.3930268688078,61.24956943649271,NaN,NaN,-0.969095821702945,0.2583710065436108
2021-12-14T09:30:00-05:00,103.7,104.71,102.86,103.27,13174192,12798127.5,45.64215918603984,45.306274128375435,NaN,NaN,-35.37766950533986,-0.5040467532423613,0.010141960418915158,-0.12245034934326782,-0.13259230976218297,1301487421,1317784318.4,57.10768922511234,59.38755445560508,NaN,NaN,-2.2425446836100322,-0.0989026634783382
2021-12-15T09:30:00-05:00,103.55,104.31,102.86,104.17,16908591,13312309.2,49.70606301781645,44.80236311541146,NaN,NaN,-22.425432641232483,-6.906830937406721,0.01845247110918119,-0.10952672087570647,-0.12797919198488766,1318396012,1316188865.2,55.32053758045321,57.495796151171994,NaN,NaN,-2.0068349519740245,-0.3714644189777219
2021-12-16T09:30:00-05:00,104.84,105.295,103.85,104.22,11866226,13497401.3,49.93002319029491,45.65206872271386,NaN,NaN,12.93554114016337,-5.73699586501716,0.02705167423681254,-0.09416459918887199,-0.12121627342568453,1330262238,1318431809.6,57.34164787657435,55.98679244948654,NaN,NaN,-1.7531751956446688,-0.5688516727872858
2021-12-17T09:30:00-05:00,104.2,104.32,102.41,102.44,19378570,13976017.75,42.64891007206394,45.88521416605879,NaN,NaN,-46.98188652311906,-19.09021849097174,-0.08146694127007362,-0.22304995001327654,-0.14158300874320293,1310883668,1315138190.4,53.51353054134806,54.11167790011434,NaN,NaN,-3.866671102713797,-1.0399687342053587
2021-12-20T09:30:00-05:00,100.81,100.8252,99.56,100.42,17968338,14427653.8,36.19780271039003,46.37400535678473,NaN,NaN,-159.6892671089346,-50.30774292769253,-0.27283457108250775,-0.4826262225963376,-0.20979165151382984,1292915330,1310788933.8,48.87355852121911,52.469248485831486,NaN,NaN,-7.993263232554327,-2.0332965196837827
2021-12-21T09:30:00-05:00,101.17,102.626,101.13,102.42,10497409,14356931.55,45.05889100131469,47.763738251159836,NaN,NaN,-69.28228438633813,-57.088665903892185,-0.24892969691149658,-0.5209537726532005,-0.27202407574170395,1303412739,1311173997.4,49.29276099827538,51.98239317380145,NaN,NaN,-8.379507806928151,-2.939898132147264
2021-12-22T09:30:00-05:00,102.37,102.885,102.2,102.71,8296959,14067259.8,46.225119283996015,48.041967831804996,NaN,NaN,-37.323138369332376,-60.06820704951216,-0.1999101647657146,-0.5219117816988472,-0.3220016169331326,1311709698,1309836734.6,47.82615740935244,51.7378673506513,NaN,NaN,-8.28393692804856,-3.703332245847449
2021-12-23T09:30:00-05:00,103.08,104.26,103.06,103.92,7047147,13881597.55,50.90756525849807,48.68414779708759,NaN,NaN,27.298964228944165,-57.195522431756004,-0.07855105001373464,-0.42019042945030094,-0.3416393794365663,1318756845,1307535656,45.327041792303895,51.68965404574,NaN,NaN,-6.629376348563404,-4.121338546235442
2021-12-27T09:30:00-05:00,104.08,105.06,103.93,105.02,5196036,13406696.7,54.76386521235256,49.05615994742219,NaN,NaN,69.81391828899702,-33.83636146933279,0.07494635904576646,-0.24795643062935824,-0.3229027896751247,1323952881,1310149498.6,48.611896117884164,52.171797182779656,NaN,NaN,-3.97037128124301,-4.099771794093666
2021-12-28T09:30:00-05:00,104.92,105.815,104.86,105.55,5368611,13090470.65,56.53543960846695,49.26700284819231,NaN,NaN,97.18974107749273,17.53944016795267,0.20399395424122868,-0.06791034687358888,-0.27190430111481756,1329321492,1317430731,56.45965348214349,53.091537060509594,NaN,NaN,-1.266757140091829,-3.6950554149505463
2021-12-29T09:30:00-05:00,105.39,105.97,105.26,105.74,5922255,12333639.45,57.18281242279343,49.45560071198492,NaN,NaN,102.62221582172309,51.92034020956491,0.28878904241368125,0.08908200190228399,-0.19970704051139726,1335243747,1323796932.6,61.933428190232135,53.849175060513254,NaN,NaN,1.0884054553955544,-3.0117038620439605
2021-12-30T09:30:00-05:00,105.85,106.37,105.275,105.36,6190484,11653976.35,55.40540900658627,49.62422005620378,NaN,NaN,98.06014252164188,78.99699638775976,0.3043681408386521,0.18075313553691785,-0.12361500530173423,1329053263,1327265645.6,64.5486048550942,54.68132245489458,NaN,NaN,2.5148640054939464,-2.2221941666814025
2021-12-31T09:30:00-05:00,105.18,106.23,105.06,105.81,7726054,10944313.85,57.10573927835229,49.78984965528449,NaN,NaN,91.84519729961126,91.90624300189319,0.3280222601521281,0.28641281988842593,-0.041609440263702197,1336779317,1330870140,67.07955523073906,55.259220620681404,NaN,NaN,4.196914850121749,-1.305178592852381
2022-01-03T09:30:00-05:00,106.03,106.26,104.395,104.94,10188348,10474487.45,52.90577492882317,50.01539815555632,NaN,NaN,58.23451766107918,89.59036287630963,0.270510712776084,0.29652895070640284,0.026018237930318808,1326590969,1331397757.6,67.44592135461986,55.762998798239416,NaN,NaN,4.453237695716739,-0.48254769448536383
2022-01-04T09:30:00-05:00,105.62,107.25,105.5,107.05,14572846,10480255.7,60.49453628490079,51.07628223404638,NaN,NaN,128.45077220542856,95.84256910189679,0.3547010378496202,0.4693945352423441,0.11469349739272387,1341163815,1333766222.2,69.10791421960035,56.620157726417126,NaN,NaN,7.099868267733539,0.6006545858316222
2022-01-05T09:30:00-05:00,107.33,107.88,105.985,106.03,16196111,10761895.6,55.812476708165526,51.51245464049988,NaN,NaN,120.72071124214452,99.46226818598107,0.3227362322316462,0.5181137876822817,0.19537755545063545,1324967704,1331711013.6,65.96100161189554,57.38019087152015,NaN,NaN,7.852035731233581,1.6365661780319019
2022-01-06T09:30:00-05:00,106.4,106.905,105.98,106.52,10437826,10762808.2,57.513658443701445,52.05414287288607,NaN,NaN,103.45147690068958,100.54053506179062,0.31527238013346587,0.5894680306174678,0.2741956504840019,1335405530,1332981467,66.9625029835268,58.06739480773104,NaN,NaN,8.987117996202569,2.6866450091991396
2022-01-07T09:30:00-05:00,106.55,107.2,106.45,106.49,11614853,10977262.75,57.36803513821255,53.10550894903953,NaN,NaN,105.56648515384732,103.28479263263782,0.2896527637870133,0.6362616052177685,0.3466088414307552,1323790677,1330383739,62.888109799169285,58.73700761186113,NaN,NaN,9.855157891744508,3.710718278134192
2022-01-10T09:30:00-05:00,106.23,106.32,104.47,105.29,15670966,11345598.65,51.726261506830596,54.214684577356714,NaN,NaN,37.409175673343576,99.1197242350907,0.1786696448625853,0.5699458975089868,0.39127625264640153,1308119711,1326689487.4,57.52738662377613,59.35513819061521,NaN,NaN,8.94034826515082,4.457808276279424
2022-01-11T09:30:00-05:00,105.4,106.04,104.26,105.92,11966568,11309419.5,54.26899261497799,54.87254897833267,NaN,NaN,36.8218493339493,80.79393966079485,0.13637935529758743,0.5617504467683858,0.4253710914707984,1320086279,1322473980.2,52.07266384804211,59.55370267988427,NaN,NaN,8.91447855880358,5.09447545949716
2022-01-12T09:30:00-05:00,106.37,106.8,105.92,106.26,9938019,11147610.85,55.62739209905442,55.54413989369398,NaN,NaN,74.98124733498379,71.6460468793627,0.12054336858966141,0.5760503022078751,0.4555069336182137,1330024298,1323485299,53.21868695475573,59.938883361698785,NaN,NaN,9.279993692770248,5.6924066356790295
2022-01-13T09:30:00-05:00,106.55,107.44,106.115,106.49,10995428,10851952.7,56.567261594224384,55.94840391767444,NaN,NaN,85.1713020102763,67.99001190128004,0.11482388925811327,0.5990367951908553,0.484212905932742,1341019726,1324608138.2,54.519018447111925,60.595453122756496,NaN,NaN,9.843432745010691,6.2854103655835525
2022-01-14T09:30:00-05:00,105.52,105.94,104.775,105.85,14758641,10996573.45,53.191062223393374,55.836060847034496,NaN,NaN,26.356645705455797,52.14804401160173,0.059961990926849396,0.5591653945913038,0.49920340366445437,1326261085,1325102219.8,55.11029979110492,61.059624813700836,NaN,NaN,9.396316817595217,6.72982557301379
2022-01-18T09:30:00-05:00,104.86,105.07,104.03,104.63,13878211,10721555.5,47.38515877043851,55.182469358603896,NaN,NaN,-26.023396193557705,39.46152963822148,-0.05997638274169648,0.4242329252373338,0.4842093079790303,1312382874,1325954852.4,56.16928724962609,61.03888436852102,NaN,NaN,7.290485434557856,6.809919838948657
2022-01-19T09:30:00-05:00,104.91,105.05,103.375,103.46,13367047,10491490.95,42.58457375287599,54.13973802503836,NaN,NaN,-86.39580432654566,14.817998906122492,-0.2110884811752169,0.22034870651000915,0.43143718768522604,1299015827,1321740762,49.90316581479,60.179579913132294,NaN,NaN,3.9594240228961826,6.40270615094116
2022-01-20T09:30:00-05:00,103.66,104.725,102.005,102.14,16726064,10802923.7,37.917312361416414,52.890588264669084,NaN,NaN,-166.73655909179092,-33.525562379232454,-0.38290965668047056,-0.047199883165362166,0.3357097735151084,1282289763,1312193855,39.2267447961168,58.37087562320534,NaN,NaN,-0.4647595836961376,5.421639617421547
2022-01-21T09:30:00-05:00,102.15,102.915,100.8,101.2,33329845,12054568,34.977390228090044,51.309991903936066,NaN,NaN,-241.29134780242305,-98.81809234177231,-0.5335802897388269,-0.33126558865842526,0.20231470108040164,1248959918,1293781893.4,27.158859490750146,55.51939735606328,NaN,NaN,-5.152582283511129,3.9110364887168787
2022-01-24T09:30:00-05:00,99.51,101.93,98.05,101.78,37364348,13570428.05,38.16327166008195,50.25695595616883,NaN,NaN,-247.32630730402278,-153.55468294366804,-0.5648767825738712,-0.5037812771369374,0.06109550543693382,1286324266,1285794529.6,23.745937835325932,52.397969961828,NaN,NaN,-8.05378123206957,2.201776814318815
2022-01-25T09:30:00-05:00,100.01,101.62,98.365,100.78,28146277,14717940.1,34.98088668274667,48.434552413157824,NaN,NaN,-201.96379033433678,-188.74276177182384,-0.6192557034905426,-0.7129741239262444,-0.09371842043570183,1258177989,1274953552.6,20.061094305556523,48.89462568225344,NaN,NaN,-11.537277591100986,0.23905475640170049
2022-01-26T09:30:00-05:00,101.36,102.49,98.88,99.9,27633726,15831195.85,32.418922528761755,46.76358425748612,NaN,NaN,-156.01847330160192,-202.6672955668351,-0.6761820815875392,-0.9389460224201258,-0.26276394083258664,1230544263,1261259239.8,16.56437160213889,45.366294967270825,NaN,NaN,-15.290262887385989,-1.9794191927108262
2022-01-27T09:30:00-05:00,100.73,101.56,98.36,99.01,23186076,16694386.9,30.023942108717108,44.800033090701525,NaN,NaN,-150.14908866456528,-199.34980148139,-0.7308180025831561,-1.1762864440615317,-0.44546844147837567,1207358187,1246272924.6,13.741559887210457,41.56479903181965,NaN,NaN,-19.22145413596362,-4.44256704174694
2022-01-28T09:30:00-05:00,98.59,99.71,96.94,99.7,22967164,17533220.9,34.08933789294538,43.137269001753864,NaN,NaN,-147.0303459676388,-180.4976011144331,-0.678656613291929,-1.293789208093287,-0.615132594801358,1230325351,1242546011.2,13.141768954537582,38.011488971488816,NaN,NaN,-21.263892726898344,-6.84561356819714
2022-01-31T09:30:00-05:00,99.03,100.85,98.8,100.74,12183184,17756077.4,39.769237419287286,42.28319585264363,NaN,NaN,-94.53125690887963,-149.9385910354045,-0.538408147103878,-1.2881427786812054,-0.7497346315773274,1242508535,1233782865,11.833837723932888,34.74766405007144,NaN,NaN,-21.25112025760606,-8.903543095255557
2022-02-01T09:30:00-05:00,101.37,102.46,100.76,102.13,17200877,18106703.85,46.41567441670974,41.72224455276732,NaN,NaN,-45.46311091939699,-118.63845515241655,-0.3267371405821322,-1.1581560573049927,-0.8314189167228605,1259709412,1234089149.6,12.162885477389764,31.896965595024852,NaN,NaN,-19.08651086804527,-10.358252777082658
2022-02-02T09:30:00-05:00,102,103.05,101.58,102.84,14199158,18088019.45,49.48217736243757,41.28330064300898,NaN,NaN,-22.520283687937724,-91.93881722968372,-0.12404732475590097,-0.9864780726677367,-0.8624307479118357,1273908570,1242762011,21.13812448843221,29.605496847430317,NaN,NaN,-16.320876126131292,-11.210056112661034
2022-02-03T09:30:00-05:00,102.14,102.62,101.06,101.2,14007507,17978589.25,43.315898922515494,40.33677473788691,NaN,NaN,-40.99644128113342,-70.10828775299731,-0.0873008613638786,-0.9715568246166839,-0.8842559632528053,1259901063,1253270586.2,30.41590434105987,27.883845839855173,NaN,NaN,-15.89499189676503,-11.87933265324732
2022-02-04T09:30:00-05:00,100.64,101.1,99.28,100.11,16025205,18257958.2,39.768718643160625,39.37803591072743,NaN,NaN,-75.86711468253003,-55.875641495975536,-0.12119209533040576,-1.0357460824158125,-0.9145539870854067,1243875858,1255980687.6,32.6175633711518,26.27722180985852,NaN,NaN,-16.70238874919369,-12.568340666953944
2022-02-07T09:30:00-05:00,100.37,100.97,99.84,100.19,10452097,18199820.4,40.156069226191754,38.861672371852656,NaN,NaN,-65.42283033152407,-50.053956180504414,-0.1226381470679756,-1.0678516709203763,-0.9452135238524006,1254327955,1258344571.6,34.56244181414857,24.733875707324408,NaN,NaN,-17.216924049656768,-13.232424007340061
2022-02-08T09:30:00-05:00,100.45,101.39,100.05,101.19,10376506,17935097.4,44.92409354258292,39.028780928260296,NaN,NaN,-43.82587040114467,-49.72650807685397,-0.0446806148739155,-1.001064292444795,-0.9563836775708795,1264704461,1259343581.4,35.41090542024547,23.698714250571225,NaN,NaN,-16.17451261449332,-13.652722379790527
2022-02-09T09:30:00-05:00,102.04,102.72,102.01,102.58,13166307,17995084.35,50.79284949270373,39.948462151923685,NaN,NaN,13.601943908152712,-42.502062557635874,0.10394960781725004,-0.826446667799317,-0.930396275616567,1277870768,1260136021,36.118464300767116,23.476694215189106,NaN,NaN,-13.376642008894294,-13.61328232680535
2022-02-10T09:30:00-05:00,101.37,102.76,100.38,100.9,15559990,18276182.9,44.60615900597441,40.636231350344,NaN,NaN,-19.397726540465314,-38.18231960950225,0.09292751177791359,-0.8142368858941751,-0.9071643976720887,1262310778,1260617964,36.57354458546762,24.14917172195464,NaN,NaN,-12.970877144772963,-13.521510157943581
2022-02-11T09:30:00-05:00,100.93,101.4,98.87,99.36,18726857,18662754.35,39.81836597596065,40.75445237290676,NaN,NaN,-77.23651107098938,-38.45619888719413,-0.008861095836950161,-0.9182407674682764,-0.9093796716313263,1243583921,1260559576.6,36.5395832776353,25.06300353926245,NaN,NaN,-14.248289803378203,-13.625335821577098
2022-02-14T09:30:00-05:00,99.5,99.775,98.2,98.99,15297367,18689690.65,38.74241395949521,41.02313289267452,NaN,NaN,-114.75649847602703,-48.32293251609472,-0.08751760456244839,-1.0187766773343867,-0.9312590727719383,1228286554,1255351296.4,33.547096885356325,26.026289437819578,NaN,NaN,-15.603437997086257,-13.907921846649835
2022-02-15T09:30:00-05:00,99.97,100.91,99.91,100.48,10542100,18522885.1,45.16800054803007,41.933781322622245,NaN,NaN,-31.224152191882727,-45.80258887424233,-0.028651732661568174,-0.9670737385988986,-0.9384220059373304,1238828654,1250176135,30.844046249836694,27.04626619836942,NaN,NaN,-14.656457934588934,-14.014855573498277
2022-02-16T09:30:00-05:00,100.21,101.36,99.96,101.01,8222551,18265660.3,47.286128070143775,43.166794605581295,NaN,NaN,-0.05595553398932928,-48.53416876267074,0.0521250027178245,-0.8732657525400498,-0.9253907552578743,1247051205,1244012222.4,27.95487038714775,28.06150266265065,NaN,NaN,-13.220888839379766,-13.901431754338489
2022-02-17T09:30:00-05:00,100.21,100.43,98.99,99.16,10912273,17974970.75,41.2903309815558,43.681151254767755,NaN,NaN,-88.52479186317025,-62.35958182721173,-0.009604250415274795,-0.9373960682769678,-0.927791817861693,1236138932,1238777853.2,25.749114281085667,28.962027328832654,NaN,NaN,-13.930890956523504,-13.905640211793491
2022-02-18T09:30:00-05:00,98.98,99.73,98.02,98.34,11969702,16906963.6,38.93383264319835,43.62147948504712,NaN,NaN,-142.35129385786868,-75.38253838458759,-0.09166346313459939,-1.0423711467799421,-0.9507076836453427,1224169230,1234894915,24.222266986431364,29.846915133296836,NaN,NaN,-15.272873206122501,-14.10095921098335
2022-02-22T09:30:00-05:00,98.27,98.84,96.86,97.39,16809514,15879221.9,36.34581283623247,42.90220365787017,NaN,NaN,-185.97986974539938,-89.62721263846205,-0.19025079786083965,-1.1885211809713923,-0.9982703831105526,1207359716,1230709547.4,22.662368222837316,30.596878186543087,NaN,NaN,-17.21528814843451,-14.545863344904944
2022-02-23T09:30:00-05:00,97.81,97.97,95.445,95.6,16296321,15286724.1,32.02606734776421,41.65533865682206,NaN,NaN,-221.10116784619458,-127.60261576932444,-0.34720274581861643,-1.432273815383823,-1.0850710695652066,1191063395,1221156495.6,19.565234896392283,30.484528929968807,NaN,NaN,-20.348943242494666,-15.374874758846333
2022-02-24T09:30:00-05:00,94.19,97.03,93.4,96.82,27356090,15272842.3,37.480051464017265,41.23849240978648,NaN,NaN,-201.74593300072422,-167.94061126267144,-0.3396263087959337,-1.5096039555601237,-1.16997764676419,1218419485,1215430151.6,17.979091870825883,29.596185182094953,NaN,NaN,-21.165502788298753,-16.202107334482392
2022-02-25T09:30:00-05:00,97.05,99.46,97,99.13,13511738,14789125.4,46.270675131547236,41.70291787324267,NaN,NaN,-60.46854394537942,-162.32936167911325,-0.15898850624185323,-1.3687132795665065,-1.2097247733246532,1231931223,1214588609.8,17.751335127255572,28.53431173610236,NaN,NaN,-18.824270127718716,-16.57670201923044
2022-02-28T09:30:00-05:00,98.21,100.09,98.16,99.89,18310701,14556302.25,48.820349330338296,42.32179502353885,NaN,NaN,-22.866144739345845,-138.43233185540868,0.022096463420212986,-1.182104194049387,-1.2042006574696,1250241924,1219803148.6,24.162165838306876,27.7914348806851,NaN,NaN,-16.10541177126601,-16.509374840949807
2022-03-01T09:30:00-05:00,99.53,100.16,97.76,98.4,21884815,15041383.8,44.37441255951515,42.28253209617686,NaN,NaN,-46.98975489459658,-110.63430888524813,0.05032882952456341,-1.1412896205638958,-1.1916184500884592,1228357109,1224002627.2,28.96421693355373,27.330957131635692,NaN,NaN,-15.304594047968026,-16.337263299095266
2022-03-02T09:30:00-05:00,98.88,100.98,98.74,100.5,16881399,15025409.9,51.129444195259616,42.306574574930856,NaN,NaN,17.92927445770098,-62.82822042446902,0.21026686120543747,-0.9287848735816624,-1.1390517347870999,1245238508,1234837649.8,39.59224480927241,27.57908431081464,NaN,NaN,-12.27488380581454,-15.756923371483733
2022-03-03T09:30:00-05:00,101.24,101.51,100.17,100.61,14831560,15057030,51.46194539491697,42.79627360271247,NaN,NaN,59.14895817176787,-10.649242189970598,0.31689484489470265,-0.7429331786687214,-1.059828023563424,1260070068,1243167766.4,46.25043789280684,28.270290975624587,NaN,NaN,-9.83126635224166,-14.910400940163436
2022-03-04T09:30:00-05:00,99.59,100.51,99,100.39,17167408,15215025.05,50.71870589716618,43.57486931137,NaN,NaN,23.61808585568388,6.1680837702420614,0.362737411678118,-0.6064062589657766,-0.9691436706438946,1242902660,1245362053.8,47.880088380308436,29.08032705438695,NaN,NaN,-8.10745848451205,-13.938552017927524
2022-03-07T09:30:00-05:00,100.07,100.795,97.67,97.7,16533896,15240459.6,42.614440498289895,43.851442635569626,NaN,NaN,-40.23778721520109,2.6937552750710068,0.20962133208705014,-0.7071170055350819,-0.9167383376221321,1226368764,1240587421.8,44.703969789703315,29.87724654755459,NaN,NaN,-9.181499717357362,-13.258973117846072
2022-03-08T09:30:00-05:00,97.94,99.71,97.01,97.1,22316849,15833697.2,41.03926579952863,43.55653301067667,NaN,NaN,-73.92787043432466,-2.6938678328746093,0.07272957328350205,-0.8258263710177545,-0.8985559443012565,1204051915,1235726383,41.67307292143274,30.65074845266859,NaN,NaN,-10.545294191575339,-12.871304699807396
2022-03-09T09:30:00-05:00,98.81,99.61,98.41,98.86,18757368,16252740.3,47.204059756847876,43.55067098829839,NaN,NaN,-15.918958031828941,-9.463514330780587,0.10362691783212108,-0.7690222970111051,-0.8726492148432262,1222809283,1231240538,39.04243076235226,31.442717050897482,NaN,NaN,-9.731841184839363,-12.42280991195482
2022-03-10T09:30:00-05:00,97.62,98.92,97.53,98.73,13317230,16260286.45,46.814698014007845,43.94526863347353,NaN,NaN,-40.60953150617944,-29.415212266370048,0.11721996056740336,-0.726124264133972,-0.8433442247013754,1209492053,1221124935,33.85283540668229,32.02155427415438,NaN,NaN,-9.207494583110092,-11.963479150691288
2022-03-11T09:30:00-05:00,99.3,99.91,97.88,97.94,10695301,16017052,44.417015260014445,44.33692453467468,NaN,NaN,-22.86223448591869,-38.71127633469057,0.07686760628354783,-0.7472597168469406,-0.8241273231304884,1198796752,1212303753.4,30.095977489303777,32.44110502435956,NaN,NaN,-9.485340694671006,-11.609459371259819
2022-03-14T09:30:00-04:00,98.53,99.34,97.58,98.27,12988137,15730116,45.668801886495466,45.00285232397919,NaN,NaN,-31.14976395848292,-36.89367168334693,0.07611924598710829,-0.7289782656466031,-0.8050975116337113,1211784889,1209386978.4,28.951869083057645,32.89035508580387,NaN,NaN,-9.35453884672202,-11.287327867754419
2022-03-15T09:30:00-04:00,99.17,100.03,98.57,99.83,11204860,15525490.65,51.257279899036355,46.37651036335576,NaN,NaN,42.79376727068506,-13.549344142344983,0.17855536748524514,-0.5819033022771549,-0.7604586697624001,1222989749,1213174545.2,32.53826542014832,33.81700012321501,NaN,NaN,-7.569383852411934,-10.756193008419778
2022-03-16T09:30:00-04:00,100.46,101.33,99.15,101.15,15840898,15790430.55,55.43440946394295,47.6589645062076,NaN,NaN,115.5292606861274,12.740299601246283,0.3245724492832551,-0.3547431081583312,-0.6793155574415863,1238830647,1216378818,35.504391680350196,35.06880725246675,NaN,NaN,-4.746995245790499,-9.897736185187025
2022-03-17T09:30:00-04:00,100.5,102.5,100.5,102.45,10897923,15924199.15,59.147542237696854,48.57874072807544,NaN,NaN,188.42839201422004,58.54788430532618,0.4882346564415594,-0.06902223688963716,-0.5572568933311965,1249728570,1224426121.4,42.3588105434506,36.82648406790925,NaN,NaN,-1.1682552411072256,-8.650667478889911
2022-03-18T09:30:00-04:00,102.27,102.925,101.51,102.84,14921779,16124674.45,60.2183932974239,49.3928867257244,NaN,NaN,187.5551714846047,100.63136549943086,0.5951901833787788,0.18673083589227701,-0.4084593474865018,1264650349,1237596840.8,51.4526949276129,38.77580757428825,NaN,NaN,2.073056153051589,-7.118706960041125
2022-03-21T09:30:00-04:00,102.26,103.11,102.085,102.73,10821413,16067260,59.742720150180574,50.49062298220051,NaN,NaN,163.89154627690948,139.63962754650933,0.6277308855553453,0.37620425945767977,-0.2515266260976655,1253828936,1246005650.2,56.20348403969489,40.72146951044119,NaN,NaN,4.582056841164891,-5.447169274154552
2022-03-22T09:30:00-04:00,103.05,103.545,102.75,103.29,8292013,15641384.95,61.413778997413274,51.22521832521148,NaN,NaN,161.0306135162799,163.2869967956283,0.6532510889403575,0.5650372350777815,-0.0882138538625761,1262120949,1253831890.2,60.11556149608865,42.18742070235664,NaN,NaN,7.182665709411654,-3.642907133645094
2022-03-23T09:30:00-04:00,102.86,103.07,102.28,102.3,10475497,15350343.75,56.9158519293867,51.614783077673614,NaN,NaN,117.2943844898172,163.64002155636626,0.5726268981727283,0.6275697688533342,0.05494287068060594,1251645452,1256394851.2,61.33363840028748,43.26479216717668,NaN,NaN,8.203526773654293,-1.9505594326023248
2022-03-24T09:30:00-04:00,102.82,103.13,102.29,103.08,7698944,14367486.45,59.43657587705025,52.237488076236765,NaN,NaN,115.7012094738574,149.09458504829374,0.5413520432398623,0.7316329247304338,0.19028088149057154,1259344396,1258318016.4,62.26490902703915,44.29227935622888,NaN,NaN,9.7934116157897,-0.27284928283203547
2022-03-25T09:30:00-04:00,103.3,103.76,102.84,103.72,7350294,14059414.25,61.43055768426931,53.58149644666387,NaN,NaN,123.18021443497774,136.21959363836837,0.5324795517822687,0.8558803212184074,0.3234007694361387,1266694690,1258726884.6,62.471852223538036,45.561413815788505,NaN,NaN,11.712235909419272,1.439305744632437
2022-03-28T09:30:00-04:00,103.63,103.78,102.795,103.75,7941015,13540929.95,61.52603045886673,55.04483677947373,NaN,NaN,107.78581653950667,124.99844769088779,0.4979711348715643,0.9458646880255941,0.4478935531540298,1274635705,1262888238.4,64.59973756869057,47.19903271916406,NaN,NaN,13.322103479755112,3.1368482782213905
2022-03-29T09:30:00-04:00,104.43,104.77,103.695,104.71,12157505,13054564.45,64.55006206260407,56.2838369441706,NaN,NaN,125.59440728455606,117.91120644454301,0.5074190551790153,1.082167372127799,0.5747483169487836,1286793210,1267822690.6,66.98989746503126,49.19528034078399,NaN,NaN,15.587705447339758,4.915542159524014
2022-03-30T09:30:00-04:00,104.6,105.23,104.13,104.59,8731245,12647056.75,63.87422859664187,57.50237484293017,NaN,NaN,117.49901911328536,117.95213336923663,0.47384309289442517,1.167052183066815,0.6932090901723899,1278061965,1273105993.2,69.37418868112741,51.73251986038721,NaN,NaN,17.304080722855595,6.685333382857097
2022-03-31T09:30:00-04:00,104.32,104.96,102.96,102.98,9441929,12377575.2,55.48120863516073,58.292674369726335,NaN,NaN,75.07855312121852,109.82760209870887,0.31889239859122975,1.091824588411427,0.7729321898201973,1268620036,1274961121.2,70.18842491759668,54.59626610526527,NaN,NaN,16.510027802969045,8.088861157158803
2022-04-01T09:30:00-04:00,103.42,103.505,101.43,102.18,11182296,12078319.6,51.83638836946553,58.73321626136705,NaN,NaN,31.1778290993132,91.42712503157595,0.14695463252796692,0.9566254804801559,0.809670847952189,1257437740,1273109731.2,68.23857366969717,57.40245929002525,NaN,NaN,14.763391280244425,9.042365460456748
2022-04-04T09:30:00-04:00,101.98,102.125,100.79,102.05,10436502,11773449.9,51.24722115245455,58.73249777946835,NaN,NaN,3.1555827195485424,70.50107826758432,0.015805856214923586,0.8294281682208435,0.81362231200592,1247001238,1267582837.8,62.6438069288986,59.55285511207883,NaN,NaN,13.157173828319133,9.630195227294232
2022-04-05T09:30:00-04:00,101.65,102.465,100.39,100.6,15332847,11424249.8,45.091139367059405,57.9936927725481,NaN,NaN,-23.023683789397488,40.777460052793614,-0.16717747695215734,0.6046504658157232,0.7718279427678806,1231668391,1256557874,53.26266505013896,60.821303209920885,NaN,NaN,9.853562350937782,9.662104816386167
2022-04-06T09:30:00-04:00,99.76,100.105,99.14,99.82,15573205,11265041.65,42.15741494491536,56.780112251635124,NaN,NaN,-85.25913600787848,0.2258290285608581,-0.329918551418526,0.35942975349472306,0.689348304913249,1216095186,1244164518.2,45.088557742712425,61.0162851527253,NaN,NaN,6.141357601363079,9.159140928525726
2022-04-07T09:30:00-04:00,99.46,100.52,98.56,100.16,12381318,11218246.05,43.87168450369721,55.61249019494037,NaN,NaN,-90.06868119502556,-32.803617834687955,-0.39921327965846265,0.19033170534017074,0.5895449849986334,1228476504,1236135811.8,40.72791088313997,60.250229149548666,NaN,NaN,3.534324263864557,8.355595690716989
2022-04-08T09:30:00-04:00,100,100.49,99.37,99.6,12923244,11329643.2,41.68059977274174,54.32233873940902,NaN,NaN,-93.74075769476863,-57.78733519350432,-0.46283111390082005,0.011006092622608321,0.47383720652342837,1215553260,1227758915.8,36.73585214604419,58.8596840142879,NaN,NaN,0.6784577751506891,7.258861702778946
2022-04-11T09:30:00-04:00,99.28,100.4,99.1,99.28,11246438,11242558.25,40.437778200333476,52.82405296818904,NaN,NaN,-111.67832981367584,-80.75411770014918,-0.5031847039248086,-0.1551436733825824,0.34804103054222624,1204306822,1219220032.6,33.167110868206095,56.93479468372486,NaN,NaN,-2.0750587273135443,5.925444498480019
2022-04-12T09:30:00-04:00,99.58,100.555,98.69,99.12,11473939,11256012.2,39.798780528183464,51.60140501096023,NaN,NaN,-118.07353294639009,-99.7640875315477,-0.515483628570956,-0.2963135051714687,0.21917012339948724,1192832883,1211452931,30.285094304476587,54.717041534024084,NaN,NaN,-4.557995398910082,4.42781022742429
2022-04-13T09:30:00-04:00,99.32,100.155,99.31,100.05,7661232,10847028.9,45.217554712734035,50.58576064208051,NaN,NaN,-95.65115686014165,-101.84249170200033,-0.4388175574921043,-0.3293518234656432,0.10946573402646115,1200494115,1208332716.8,29.18785558404393,52.354394859524426,NaN,NaN,-5.301638268543742,3.0378890137145715
2022-04-14T09:30:00-04:00,100.37,100.91,99.92,99.94,8252406,10714753.05,44.70499293763108,49.39107744589206,NaN,NaN,-68.74005528311359,-97.57676651961795,-0.3757791291550149,-0.3602581774173075,0.015520951737707414,1192241709,1201085757.8,26.762604796696024,49.803734329035706,NaN,NaN,-6.0595629492641025,1.7382530190033325
2022-04-18T09:30:00-04:00,99.66,100.6,99.17,99.59,8701060,10403717.1,43.03349515240545,48.070182066859104,NaN,NaN,-79.62406274834183,-94.75342753033257,-0.3390465845252447,-0.40828727891884853,-0.06924069439360378,1183540649,1194683235.6,24.8018699659647,46.96102950026957,NaN,NaN,-7.1557330381998465,0.4676835822600214
2022-04-19T09:30:00-04:00,99.92,101.54,99.87,101.4,10920149,10408653.9,52.85130591765942,47.23455662793449,NaN,NaN,-28.645098346652983,-78.146781236928,-0.1821087292663342,-0.29687660597652155,-0.11476787671018734,1194460798,1192714030.8,24.214263953156177,43.90562710656421,NaN,NaN,-5.290018837043515,-0.354845334783341
2022-04-20T09:30:00-04:00,102.26,102.65,101.81,101.95,8622957,10425201.1,55.36843779146263,46.62700014185026,NaN,NaN,24.55760983170179,-49.62055268130964,-0.03805064954858772,-0.162331188645922,-0.12428053909733427,1203083755,1194764205.2,26.175311097629844,40.819992993457234,NaN,NaN,-2.9604181554363467,-0.727070023448056
2022-04-21T09:30:00-04:00,102.96,103.12,100.67,100.91,11117443,10457298.4,49.93926368935056,46.231146931435255,NaN,NaN,2.0996202814472182,-30.070397252991874,-0.011000486543713522,-0.13803114727697618,-0.12703066073326266,1191966312,1193058644.6,25.58224880532248,37.633837556866226,NaN,NaN,-2.5498368708545933,-0.9874652873632757
2022-04-22T09:30:00-04:00,100.4,100.455,98.34,98.43,12030414,10673871.9,39.8936163035528,45.378091783870055,NaN,NaN,-98.32744225563123,-35.98787464749541,-0.15057899672086036,-0.3152544066343381,-0.16467540991347776,1179935898,1190597482.4,24.71213416159523,34.52480616343037,NaN,NaN,-5.633757791401942,-1.6512213593687994
2022-04-25T09:30:00-04:00,97.86,98.58,96.185,98.43,16391125,11125913.45,39.893616303552804,44.5671200089485,NaN,NaN,-141.8221233384613,-48.427486765519305,-0.2286691887082785,-0.4505118957988259,-0.2218427070905474,1179935898,1189876532.2,24.449795257662387,31.796662472627784,NaN,NaN,-8.004419445466729,-2.558821085954218
2022-04-26T09:30:00-04:00,97.7,98.07,96.25,96.28,14594110,11458568.2,33.182419296486245,43.71649714676471,NaN,NaN,-160.1038001742643,-74.71922713104156,-0.40081287105104846,-0.722858795904358,-0.3220459248533095,1165341788,1184052730.2,22.382741621122634,29.590953656269473,NaN,NaN,-12.525199896556433,-3.98258948746882
2022-04-27T09:30:00-04:00,96.23,97.51,95.78,96.64,13363061,11518846,35.14966026957292,43.2159432413831,NaN,NaN,-158.9803295889796,-111.42681501517784,-0.4617875329557166,-0.8992803410479553,-0.43749280809223867,1178704849,1179176949,20.797450900342355,27.855874596100186,NaN,NaN,-15.427712896218654,-5.617607117290225
2022-04-28T09:30:00-04:00,96.91,98.11,95.73,97.73,13461571,11755362.3,40.830032857438816,42.9986824095075,NaN,NaN,-131.29156485500684,-138.10505204246866,-0.4022478122341955,-0.940302573384983,-0.5380547611507875,1192166420,1179216970.6,20.84700708916408,26.435810039387626,NaN,NaN,-15.991073842390104,-7.099530935161637
2022-04-29T09:30:00-04:00,97.58,98.08,94.95,95.14,15135409,12040036.3,33.354010688987486,42.403926046382196,NaN,NaN,-167.33982735406542,-151.90752906215548,-0.5042253804976567,-1.1683364867728585,-0.6641111062752018,1177031011,1178635993.2,20.645066093950177,25.286468178523762,NaN,NaN,-19.21618603758751,-8.830481664079619
2022-05-02T09:30:00-04:00,95.04,96.19,93.495,95.34,19101390,12435991,34.35358883979873,41.96934109205829,NaN,NaN,-176.1830386000808,-158.7797121144794,-0.5228925100609774,-1.3177267438514235,-0.7948342337904462,1196132401,1181875293.8,25.00699165665931,24.70360252055613,NaN,NaN,-21.339558778302216,-10.617492680397133
2022-05-03T09:30:00-04:00,95.54,96.6,95.14,95.97,13316026,12579967.2,37.53189900129372,41.80742098299474,NaN,NaN,-117.99879822370355,-150.35871172436723,-0.459730335618457,-1.3694971533135174,-0.9097668176950604,1209448427,1190696621.6,35.4178019018493,25.070224491797042,NaN,NaN,-22.016594604739165,-12.245935812445994
2022-05-04T09:30:00-04:00,95.92,98.98,95.66,98.75,18468928,12736771.25,49.21612730124839,42.09303331074576,NaN,NaN,-37.92766760346948,-126.14817932726521,-0.2103344086402309,-1.172684828495349,-0.9623504198551182,1227917355,1200539122.8,44.65059149133218,26.174705628031916,NaN,NaN,-18.418603184236574,-13.127745436987505
2022-05-05T09:30:00-04:00,97.8,98.28,95.4,96.17,24943696,13205295.8,41.46472747173656,41.86158577746759,NaN,NaN,-75.182510556007,-114.92636846746525,-0.1988678035185063,-1.210935174253251,-1.0120673707347447,1202973659,1202700570.6,46.460748998116344,27.58171592813337,NaN,NaN,-18.220661907771255,-13.855304932813755
2022-05-06T09:30:00-04:00,95.78,95.82,93.96,95.52,24154018,13793930.8,39.76547762604154,41.62815595415588,NaN,NaN,-116.06823191750027,-104.6720493801522,-0.21351043514850643,-1.2789554146703779,-1.0654449795218714,1178819641,1203058296.6,46.77102055099759,29.150940969921432,NaN,NaN,-18.6735302092946,-14.543622829453875
2022-05-09T09:30:00-04:00,94.41,94.78,92.825,93.21,21188753,14207206.25,34.37417174142389,40.308360655853335,NaN,NaN,-147.54256778956199,-98.94395521804844,-0.3492009280755606,-1.5019461396163223,-1.1527452115407617,1157630888,1195357994,41.23185313629759,30.366483054431534,NaN,NaN,-21.044445764697073,-15.472311820202904
2022-05-10T09:30:00-04:00,94.22,94.5,91.68,92.6,22935012,14791634.95,33.09804827947464,38.717618547854194,NaN,NaN,-149.954423522665,-105.33508027784073,-0.44436282747849387,-1.708198745888879,-1.2638359184103851,1134695876,1180407483.8,33.048182682160544,30.857402453326586,NaN,NaN,-23.31614457381618,-16.592859356433372
2022-05-11T09:30:00-04:00,92.53,94.14,91.61,91.76,21838671,15309871.55,31.370930383260045,37.39130902599059,NaN,NaN,-142.95264038441584,-126.34007483403002,-0.5227989155244539,-1.9173345628159524,-1.3945356472914985,1112857205,1157395453.8,24.86691235098094,30.80630699230219,NaN,NaN,-25.709881856464023,-17.895291142152036
2022-05-12T09:30:00-04:00,91.29,92.51,90.19,91.93,18517540,15852686.95,32.14266980705332,36.83766999052633,NaN,NaN,-151.70708378532416,-141.64498947989347,-0.5209924347641217,-2.0457761907466505,-1.5247837559825288,1131374745,1143075671,21.328561397113162,30.564623223410614,NaN,NaN,-27.342993476174787,-19.244962904155287
2022-05-13T09:30:00-04:00,92.75,93.63,92.15,93.1,12837803,16081956.8,37.363190560938556,36.65692529462531,NaN,NaN,-102.01401255427012,-138.83414560724742,-0.40398105417701546,-2.029760073703798,-1.6257790195267827,1144212548,1136154252.4,19.857764303736687,30.23662101241592,NaN,NaN,-27.08835307363067,-20.36544721408034
2022-05-16T09:30:00-04:00,92.83,93.71,92.2,92.97,10865945,16190201.05,37.02237181813251,36.931207617600045,NaN,NaN,-91.57753391674214,-127.64113883268347,-0.30293761261431684,-2.0044510352946787,-1.7015134226803619,1133346603,1131297395.4,18.874195957375534,29.98601060786256,NaN,NaN,-26.98482249337164,-21.3110722539791
2022-05-17T09:30:00-04:00,94.47,95.22,93.675,95.08,9490472,16118717.2,45.68282255414162,37.68357635221209,NaN,NaN,-38.46432271189291,-105.34311867052904,-0.07355740700612778,-1.7934601814380216,-1.7199027744318938,1142837075,1132925635.2,20.299420859812074,29.950437033538968,NaN,NaN,-24.140062077143025,-21.71521365728823
2022-05-18T09:30:00-04:00,94.23,94.4,91.27,91.54,11172989,16246218.8,36.59128484334908,37.38080863691997,NaN,NaN,-97.41625776252296,-96.23584214615047,-0.13616484176140498,-1.89010882663365,-1.7539439848722451,1131664086,1136687011.4,23.636918170246076,30.149716396473394,NaN,NaN,-24.656081002389296,-22.13533756373124
2022-05-19T09:30:00-04:00,90.58,91.88,89.68,90.72,14481966,16414444.95,34.86061307452569,37.48842309302984,NaN,NaN,-139.07889690756775,-93.71020477059918,-0.20460809477040587,-2.0097041033352525,-1.8050960085648466,1117182120,1133848486.4,22.858976797807713,30.30785287532036,NaN,NaN,-25.65048091627326,-22.63750089980867
2022-05-20T09:30:00-04:00,91,91.19,88.035,89.74,15695078,16597678.15,32.860267406411566,37.38175727635933,NaN,NaN,-154.3746835510965,-104.18233896996443,-0.2828657001572983,-2.1586781337614696,-1.8758124336041713,1101487042,1125303385.2,20.655076263845658,29.99700177583367,NaN,NaN,-27.115061894588543,-23.27715247049151
2022-05-23T09:30:00-04:00,90.61,91.435,90.16,91.21,11989105,16377577.15,38.555710280508386,37.4548866534461,NaN,NaN,-101.61770795762023,-106.19037377814007,-0.20617437398832106,-2.1335304010895726,-1.9273560271012515,1113476147,1121329294,19.7036248084885,28.87456055487933,NaN,NaN,-26.460056090742096,-23.731852987670166
2022-05-24T09:30:00-04:00,90.74,91.37,89.24,91.16,9916954,16143719.35,38.436276671242595,36.684897322731395,NaN,NaN,-102.30982223837698,-118.95947368343688,-0.13291728132369585,-2.0935026287558713,-1.9605853474321755,1103559193,1113473717.6,17.944059306471914,26.966951113103594,NaN,NaN,-25.984636926107598,-24.0536792645898
2022-05-25T09:30:00-04:00,90.86,92.04,90.54,91.69,9460135,15948573.05,40.53889933505693,36.61876674153999,NaN,NaN,-69.63159467838474,-113.40254106660923,-0.028335767151733693,-1.9960050563718426,-1.9676692892201089,1113019328,1109744766,17.16065398523493,24.874087183612065,NaN,NaN,-24.967469200827164,-24.18422068405228
2022-05-26T09:30:00-04:00,92.52,94.01,92.33,93.55,8028139,15676901.45,47.33667041049308,37.159566226143674,NaN,NaN,-1.4177722830057342,-85.87031614169683,0.17533902760304487,-1.7484955047163027,-1.9238345323193475,1121047467,1110517835.4,17.96031555018365,22.81617968355393,NaN,NaN,-21.94074905773337,-23.863724737435295
2022-05-27T09:30:00-04:00,94.29,95.49,94.17,95.47,8669562,15353609.1,53.274897739524484,38.50961808315086,NaN,NaN,67.12685789887169,-41.5700078517032,0.43387602829129746,-1.3814894969552256,-1.815365525246523,1129717029,1116163832.8,23.749521605501087,21.567441717068466,NaN,NaN,-17.359370837154888,-22.93453132310952
2022-05-31T09:30:00-04:00,94.47,95.355,93.8,94.7,14498307,15123454.95,50.80092828104291,39.774109511834304,NaN,NaN,52.29357945865523,-10.787750368448116,0.5405882531108002,-1.1396302088580228,-1.680218461968823,1115218722,1116512347.8,24.105538489403514,20.928681417585818,NaN,NaN,-14.381184849023812,-21.71262468395442
2022-06-01T09:30:00-04:00,95.26,95.49,93.35,94.12,8713684,14893337.85,48.9567363430469,41.030238508961936,NaN,NaN,46.154863453027,18.905186769832675,0.5574388647385851,-0.9834198810455916,-1.5408587457841767,1106505038,1117101516.8,24.745222060239158,20.919989253961408,NaN,NaN,-12.49653343575285,-20.396040219925624
2022-06-02T09:30:00-04:00,94.77,95.97,93.93,95.92,8432476,14391515.25,54.479661395643326,42.625737908146945,NaN,NaN,98.41896134931086,52.5152979753718,0.6676981451757107,-0.7062360643145382,-1.373934209490249,1114937514,1117485154,25.187398276817262,21.195620459654556,NaN,NaN,-9.100956478723262,-18.782456828325287
2022-06-03T09:30:00-04:00,95.06,95.8,94.95,95.55,6828753,13485768.1,53.20528020768735,43.75731574005757,NaN,NaN,113.07016779466831,75.41288599090662,0.6907180463019285,-0.5105366516128385,-1.201254697914767,1108108761,1114897412.8,24.15635358689434,21.502662551308674,NaN,NaN,-6.731043042760801,-17.06082628753036
2022-06-06T09:30:00-04:00,96.24,96.535,95.745,95.95,8334562,12694795.3,54.44589073482322,45.00185280553548,NaN,NaN,135.62099738121768,89.11171388737581,0.7054165683222808,-0.31948398751191576,-1.0249005558341966,1116443323,1112242671.6,23.1111479781963,21.8053019813673,NaN,NaN,-4.41918612462389,-15.254877692829437
2022-06-07T09:30:00-04:00,95.1,97.34,94.78,97.24,7427686,12006741.95,58.28673904601301,45.90213255495486,NaN,NaN,132.19846657885938,105.09269131141664,0.7693188240659108,-0.0632520257518081,-0.8325708498177189,1123871009,1113973129,25.377683279081694,22.16803501131513,NaN,NaN,-1.259883874518414,-13.255592861642148
2022-06-08T09:30:00-04:00,96.51,96.75,95.255,95.48,7028755,11211429.1,51.861986762892606,46.99289697777941,NaN,NaN,93.98167138949093,114.65805289870941,0.6643138571719007,-0.0021785283528430455,-0.6664923855247438,1116842254,1116040572.2,28.104513480342987,22.487148962036336,NaN,NaN,-0.41535310482156496,-11.421272896382064
2022-06-09T09:30:00-04:00,95.08,95.46,93.6,93.6,6737824,10456386.75,46.02593526044307,47.79041999105921,NaN,NaN,30.035940172959112,100.98144866343907,0.44977342396686826,-0.10427560556615845,-0.5540490295330267,1110104430,1115073955.4,27.596760010590188,22.82556204866366,NaN,NaN,-1.541272780740422,-10.009844308433259
2022-06-10T09:30:00-04:00,91.94,92.15,90.81,90.84,10416664,10051342.95,39.074162597013604,48.23426964753079,NaN,NaN,-80.05917620492906,62.35557986351961,0.12064017777999614,-0.4032488073080316,-0.5238889850880277,1099687766,1113389756.4,26.691902677187144,23.256763935330905,NaN,NaN,-4.950722341206136,-9.287112598829385
2022-06-13T09:30:00-04:00,89.05,89.18,87.56,88.11,18353288,10327117.2,33.65877556438798,47.884488596379335,NaN,NaN,-160.66225727473534,3.0989289323289997,-0.2614243483737999,-0.8506694205552776,-0.5892450721814777,1081334478,1106367987.4,23.26664262819007,23.511265208166737,NaN,NaN,-9.869123473358462,-9.370257009476395
2022-06-14T09:30:00-04:00,88.49,89.15,87.16,87.89,10512795,10309459.7,33.25874752942832,47.51466508624974,NaN,NaN,-141.04139555171443,-51.54904349378576,-0.49585854641589366,-1.2090682552013448,-0.7132097087854511,1070821683,1095758122.2,19.24747750850831,23.60436650831219,NaN,NaN,-13.766554690071645,-9.998299535275716
2022-06-15T09:30:00-04:00,88.58,89.8,87.37,88.74,13335168,10501694.5,36.40363656537478,47.219289174129585,NaN,NaN,-109.661470850781,-92.27767194184015,-0.5560564246127495,-1.408280239551388,-0.8522238149386385,1084156851,1089221041.6,17.268195229007134,23.612048025724487,NaN,NaN,-15.922845233535696,-10.844663206455714
2022-06-16T09:30:00-04:00,87.01,87.06,85.33,85.78,13500719,10618081,30.9367171805696,46.04786394342077,NaN,NaN,-151.94429262565086,-128.67371850156215,-0.7457686148766478,-1.7844345835344484,-1.0386659686578006,1070656132,1081331382,15.23228724239226,23.41718886088225,NaN,NaN,-19.74127099247422,-12.115607175886929
2022-06-17T09:30:00-04:00,85.68,86.41,84.57,85.56,14253473,10606656.35,30.56926690546385,44.42603316955929,NaN,NaN,-144.91805701826922,-141.64549466423017,-0.8301526839496507,-2.076356823594864,-1.2462041396452133,1056402659,1072674360.6,13.36965805388597,22.67577003576688,NaN,NaN,-22.828134611031807,-13.645968238050482
2022-06-21T09:30:00-04:00,86.53,87.07,85.93,86.74,9161658,10279985.35,35.0268772256579,43.29931523703179,NaN,NaN,-112.12592612122886,-131.93822843352888,-0.7528587596320464,-2.187277589185271,-1.4344188295532248,1065564317,1069520328.4,12.757573153573247,21.865201083207577,NaN,NaN,-23.996321539780343,-15.124590138297606
2022-06-22T09:30:00-04:00,85.52,86.955,85.35,86.26,11136961,10237378.15,34.06869145776709,42.235883459511804,NaN,NaN,-107.32229715920315,-125.19440875502661,-0.6825014810517918,-2.2875456808679644,-1.6050441998161726,1054427356,1066241463,12.135568489492542,20.96451154243996,NaN,NaN,-25.232097934243193,-16.56851982343269
2022-06-23T09:30:00-04:00,86.22,86.56,84.75,85.82,9744542,10228757.55,33.17285794086921,40.71396892702794,NaN,NaN,-104.39595214619602,-124.14130501410963,-0.6160719369537255,-2.3751341210083297,-1.7590621840546041,1044682814,1058346655.6,10.773538762214528,19.934950148539766,NaN,NaN,-26.507477506770883,-17.988370921052432
2022-06-24T09:30:00-04:00,86.64,88.83,86.6,88.82,9633954,10237448.5,43.98745664519826,40.055552958278724,NaN,NaN,-55.3523098936258,-104.82290846770464,-0.3346496511118364,-2.1773742479443996,-1.8427245968325632,1054316768,1055078782.8,10.26021517895775,18.94236883368715,NaN,NaN,-24.24838734303469,-18.882658981335613
2022-06-27T09:30:00-04:00,89.29,89.29,88.21,88.61,6361269,10154105,43.4573014780002,39.27065372564851,NaN,NaN,-40.22711307130987,-83.88471967831276,-0.13731866770575984,-2.014372931464763,-1.877054263759003,1047955499,1053389350.8,9.995072854970942,18.005506324885342,NaN,NaN,-22.606086300402996,-19.41457716977381
2022-06-28T09:30:00-04:00,89.2,90.2,87.505,87.58,6476287,10044441.25,40.856327054681266,38.02562429769625,NaN,NaN,-40.361802819247444,-69.53189501791648,-0.05505640708138637,-1.9458747726107362,-1.8908183655293498,1041479212,1048572329.8,9.260273274481676,16.854262753128197,NaN,NaN,-21.988666742229505,-19.782304251553196
2022-06-29T09:30:00-04:00,87.75,87.76,86.38,87.07,6818421,9660446.95,39.59273618949201,37.149249256739054,NaN,NaN,-59.34117934392413,-59.93567145486069,-0.01591864640516194,-1.910716673535802,-1.8947980271306402,1034660791,1044619016.8,8.695291515360069,15.467889755629416,NaN,NaN,-21.841904333587237,-20.076532834700917
2022-06-30T09:30:00-04:00,86.01,87.72,85.61,87.34,8708532,9660189.35,40.639439080661376,36.76449952961179,NaN,NaN,-58.08348478676775,-50.673177982975034,0.04395190667016169,-1.839858143792938,-1.8838100504630997,1043369323,1044356318.6,8.657492253863396,14.115084915863216,NaN,NaN,-21.428947953908033,-20.269734994587647
2022-07-01T09:30:00-04:00,87.18,88.39,86.51,88.1,11717967,9824463.9,43.60177436488058,37.08790037017372,NaN,NaN,-39.48167363463158,-47.49905073117619,0.14484933902150687,-1.7027483766862161,-1.847597715707723,1055087290,1044510423,8.907655597520503,12.844781553029884,NaN,NaN,-20.25203626129198,-20.267206604116836
2022-07-05T09:30:00-04:00,86.62,86.82,85.27,86.78,10994645,10032758.5,39.87932313772152,37.53222519684041,NaN,NaN,-66.11095593027407,-52.67581930296903,0.13310153266699154,-1.6812207998739837,-1.8143223325409752,1044092645,1043737852.2,8.77786372132634,11.809868773968189,NaN,NaN,-20.26067766600227,-20.266273898671898
2022-07-06T09:30:00-04:00,86.98,87.82,86.16,87.28,9781667,10105113.75,41.90263147613039,38.1496454787477,NaN,NaN,-44.92303642682892,-53.58806602448533,0.16721049524553022,-1.6053092134840625,-1.7725197087295927,1053874312,1046216872.2,13.150830588666949,11.374393993979519,NaN,NaN,-19.704376978032936,-20.18600291000919
2022-07-07T09:30:00-04:00,87.89,88.53,87.31,88.31,5865558,10027007.35,45.93885624659831,38.83073259883509,NaN,NaN,-6.794896472499718,-43.078809450200445,0.26171579929878375,-1.445374959606113,-1.7070907589048967,1059739870,1051232688,21.364561882228074,11.66699161206673,NaN,NaN,-18.076957845992663,-19.88471075800683
2022-07-08T09:30:00-04:00,88.08,88.47,87.23,87.91,4912841,9921211.65,44.64177324261451,39.809665174695446,NaN,NaN,1.8576628593041713,-31.090579920986062,0.29726647341022927,-1.3355076671421102,-1.6327741405523395,1054827029,1053524229.2,24.86088584338492,12.354748654994777,NaN,NaN,-17.061774368585457,-19.48143413094663
2022-07-11T09:30:00-04:00,87.4,87.91,87.12,87.32,7984977,9983569.3,42.725525285058765,40.677969344666515,NaN,NaN,-2.9343883943168123,-23.781122872923106,0.281199015984416,-1.2812753705718194,-1.5624743865562354,1046842052,1051875181.6,24.03277682461072,13.116399995760831,NaN,NaN,-16.710046991979524,-19.08552168252276
2022-07-12T09:30:00-04:00,86.92,88.225,86.735,87.05,8018045,9863638.35,41.840404422313384,41.16464985871334,NaN,NaN,3.1068793272150566,-9.937555821425283,0.2534013393723993,-1.2457227123407364,-1.4991240517131357,1038824007,1050821454,23.494243930251557,13.883305051237855,NaN,NaN,-16.64700772441656,-18.737162545650445
2022-07-13T09:30:00-04:00,85.66,86.72,85.44,85.99,9498557,9420901.8,38.470841026119416,41.47908911359565,NaN,NaN,-89.88201173289605,-18.92935088263867,0.1687150814418803,-1.2882301999107852,-1.4569452813526655,1029325450,1045911681.6,21.119535310962718,14.525016967057152,NaN,NaN,-17.511409778834917,-18.562055007533942
2022-07-14T09:30:00-04:00,84.76,85.595,84.275,85.5,6825170,9236520.55,36.987937915476415,41.75159482606758,NaN,NaN,-142.6931074077359,-46.10899306968591,0.08880308901192868,-1.3459414200877546,-1.4347445090996833,1022500280,1038463763.6,18.126445702317625,15.050224605635943,NaN,NaN,-18.65487147429885,-18.57531450278607
2022-07-15T09:30:00-04:00,86.7,86.97,85.79,86.84,7855588,8962541.55,43.41185537398129,41.710480449552094,NaN,NaN,-31.780025117308508,-52.836530665008446,0.13265655697975642,-1.2689238128749878,-1.4015803698547442,1030355868,1033569531.4,16.474201967539187,15.494080804820332,NaN,NaN,-17.881222229952098,-18.47615846380979
2022-07-18T09:30:00-04:00,87.61,87.95,86.05,86.32,6281975,8601604.35,41.63787799836232,41.58052162957796,NaN,NaN,-16.280033140001294,-55.50565961414534,0.1327817407063343,-1.2356031939718264,-1.3683849346781607,1024073893,1029015899.6,15.095509916234036,15.858397737767698,NaN,NaN,-17.71705593833094,-18.367715245884238
2022-07-19T09:30:00-04:00,87.03,89.555,87.01,89.4,7326897,8255275.55,53.70504783601099,42.49828739967294,NaN,NaN,125.75135698588107,-30.97676408241214,0.3349332739878714,-0.9497183421933215,-1.284651616181193,1031400790,1027531256.2,14.66460429611081,16.244421382169776,NaN,NaN,-13.643905427074207,-17.692885271768517
2022-07-20T09:30:00-04:00,89.43,90.33,89.11,90.09,8260587,8210222,55.90467925614011,43.6634261901478,NaN,NaN,185.3034564093375,24.060329546034573,0.49982629464981265,-0.6598687478689271,-1.1596950425187398,1039661377,1029598441.6,18.16730620268669,16.920993859835963,NaN,NaN,-9.610072703661828,-16.53819776203899
2022-07-21T09:30:00-04:00,89.83,90.76,89.48,90.74,5899263,7948337.1,57.932421451667544,44.89863921664824,NaN,NaN,185.78947944367553,89.75684691631686,0.6290305250205548,-0.3734068862430462,-1.002437411263601,1045560640,1034210513.6,25.51335360617928,18.124983956429954,NaN,NaN,-5.651990489973087,-14.983025294601005
2022-07-22T09:30:00-04:00,91.04,91.33,90.03,90.45,5969790,7759599.5,56.680087741332095,45.83280445782334,NaN,NaN,175.2130210725187,131.1554561542823,0.6676703219927174,-0.16784950877270433,-0.8355198307654217,1039590850,1036057510,28.28963489605485,19.509411049182408,NaN,NaN,-2.7877354492682893,-13.240841030982045
2022-07-25T09:30:00-04:00,90.55,91.14,90,90.88,6154858,7585644.7,58.125536776810236,47.13610543204397,NaN,NaN,151.70627831015818,164.7527184443142,0.6919474868578399,0.029414527806878255,-0.6625329590509617,1045745708,1040391873,34.46291626385798,21.34405765936324,NaN,NaN,0.02014212911097736,-11.34641486525447
2022-07-26T09:30:00-04:00,90.59,91.22,90.18,90.39,5522198,7543691.15,55.83906593186048,48.131565036024696,NaN,NaN,130.4006608839453,165.68257922392704,0.64566044406897,0.14454259603525088,-0.5011178480337192,1040223510,1042156417,36.84646321319852,23.036602846829783,NaN,NaN,1.7562894125059496,-9.474599968431553
2022-07-27T09:30:00-04:00,90.98,92.24,90.38,91.79,8662123,7652982.95,60.60704059594573,49.1792924895495,NaN,NaN,145.6517212973907,157.75223220153768,0.6767153601068376,0.34477635209982793,-0.3319390080070097,1048885633,1044001268.2,39.33084358256035,24.319908682567803,NaN,NaN,4.728616832467387,-7.445568996874561
2022-07-28T09:30:00-04:00,92.25,93.805,91.99,93.71,8668535,7745488.65,66.02475558539695,50.706648371176826,NaN,NaN,176.2095726114984,155.83625083510225,0.7862615815540815,0.6508879689355922,-0.13537361261848932,1057554168,1046399973.8,42.49823597317658,25.579719406124347,NaN,NaN,9.161604165181982,-5.0731156880093415
2022-07-29T09:30:00-04:00,93.74,95.84,93.74,95.64,9000633,7760093.7,70.42752537034502,52.68536266298299,NaN,NaN,197.20787188440548,160.23522099747964,0.9381081661073002,1.0372615950156359,0.0991534289083357,1066554801,1051792764,48.95095551532053,27.35958931260362,NaN,NaN,14.562984230170532,-2.2679585568407883
2022-08-01T09:30:00-04:00,95.04,96.05,94.86,95.74,8599365,7604163.6,70.63982508023508,54.742464138548826,NaN,NaN,173.71140274373298,164.63624588419458,0.9895832868276118,1.3361325374428503,0.3465492506152386,1075154166,1057674455.6,54.89593927026806,29.60256755117623,NaN,NaN,18.866909429902936,0.7513082984083153
2022-08-02T09:30:00-04:00,95.38,95.91,94.545,94.73,10039931,7556427.9,65.52342627400681,56.67479165625507,NaN,NaN,139.8935078681098,166.5348152810275,0.9023560403286536,1.4744943010260556,0.572138260697402,1065114235,1062652600.6,59.224218987543544,32.32433067093201,NaN,NaN,20.926556305919167,3.6334865851955795
2022-08-03T09:30:00-04:00,95.14,95.92,94.48,95.62,5509486,7342818.85,67.74071776404536,58.87141878829569,NaN,NaN,129.51261779514553,163.30699458057845,0.8519623428755254,1.6370911892918087,0.7851288464162833,1070623721,1067000218.2,62.59975398042681,35.5009955479398,NaN,NaN,23.33833220199677,6.448464530452892
2022-08-04T09:30:00-04:00,95.64,96.25,95.42,95.97,5339358,7316508.85,68.59607080083016,60.6702913187849,NaN,NaN,125.57267039906,153.17961413809076,0.7908935882968093,1.773745831787295,0.9828522434904856,1075963079,1070682000.4,65.22516241159062,38.9832070082292,NaN,NaN,25.561593982299996,9.178911595002479
2022-08-05T09:30:00-04:00,94.99,96.19,94.99,96.12,7857349,7463734.25,68.97573539213833,62.62299541834033,NaN,NaN,107.52010233918597,135.24206022904687,0.7117691005157654,1.8725636191351924,1.160794518619427,1083820428,1074135125.8,67.5275399880041,42.72835201335563,NaN,NaN,27.487574957017046,11.79443493243313
2022-08-08T09:30:00-04:00,96.87,97.14,95.84,96.09,5605927,7344781.75,68.79659326866748,63.700962949244364,NaN,NaN,105.53753647013971,121.60728697432822,0.6123660201143355,1.9262520437623465,1.313886023648011,1078214501,1074747192.8,67.9328092356065,46.533223794748174,NaN,NaN,29.026034011224354,14.25609194368902
2022-08-09T09:30:00-04:00,96.08,96.23,95.535,95.74,4397963,7163777.65,66.62261825742695,64.46653002076485,NaN,NaN,84.31592257162937,110.49176991503211,0.4836462260001091,1.9184438061481472,1.4347975801480382,1073816538,1076487653.4,69.11326672528293,50.17222097493362,NaN,NaN,29.763820952108723,16.471481802034692
2022-08-10T09:30:00-04:00,97.26,98.15,97.045,97.84,5967009,6987200.25,72.28217801405164,65.49151263236372,NaN,NaN,109.81988208292091,106.55322277258719,0.4985499367693176,2.057985001109685,1.5594350643403676,1079783547,1078319618.6,70.35048065363775,53.37487290689494,NaN,NaN,32.141892457754736,18.710111895708984
2022-08-11T09:30:00-04:00,98.48,99.23,98.17,98.36,5711598,6931521.65,73.48126824961875,66.6915969543842,NaN,NaN,118.77111141167997,105.1929109751112,0.5007245958199822,2.1853408091153455,1.6846162132953633,1085495145,1080226031.8,71.62428895844205,56.4702053399226,NaN,NaN,34.483321573788466,20.963427564006054
2022-08-12T09:30:00-04:00,98.81,99.87,98.46,99.84,7808155,6929150,76.58592016358038,68.01019576772491,NaN,NaN,125.5711558677469,108.8031216808234,0.5549306372601965,2.378279509870609,1.8233488726104123,1093303300,1082122606.2,72.87290040414621,59.21377563565748,NaN,NaN,37.535583855628,23.33087846280919
2022-08-15T09:30:00-04:00,99.15,100.22,99,100.08,6558471,6942974.8,77.05503775841217,69.52562232676432,NaN,NaN,126.48919326077888,112.99345303895123,0.5585086685961054,2.521484708355544,1.9629760397594387,1099861771,1086452060.2,75.52093312056516,61.97623777189795,NaN,NaN,40.15795736150746,25.73474687690894
2022-08-16T09:30:00-04:00,99.6,100.97,99.6,100.53,5564228,6854841.35,77.94722069682867,70.76420661968453,NaN,NaN,133.89325056296244,122.90891863721784,0.54229523288243,2.6408450808624764,2.0985498479800464,1105425999,1092773952.4,78.77850885343452,64.79392814838896,NaN,NaN,42.61217618446063,28.14580820655918
2022-08-17T09:30:00-04:00,99.35,100.19,99.2,99.73,6578822,6770753.1,72.54657557912921,71.23005090495111,NaN,NaN,111.77898781321862,123.30073978327736,0.43351874383519595,2.6404482777740412,2.2069295339388453,1098847177,1096586678.4,80.46679609744598,67.50596815726534,NaN,NaN,43.16661085683898,30.29163715659915
2022-08-18T09:30:00-04:00,99.91,100.275,99.565,100.13,7003420,6825960.95,73.5339652327264,71.45193946654977,NaN,NaN,109.99416476580122,121.54535045410162,0.3480208891754746,2.6419556454081885,2.293934756232714,1105850597,1100657768.8,82.1039429292602,69.87403868683246,NaN,NaN,43.90679683485455,32.23665996777849
2022-08-19T09:30:00-04:00,99.51,99.54,98.575,98.84,6893443,6872143.6,65.36859968580484,71.07542336694762,NaN,NaN,74.19012425569257,111.26914413169075,0.1729505085318479,2.510122891897524,2.337172383365676,1098957154,1101788539.6,82.54163260183729,71.84873106765885,NaN,NaN,42.121897378961755,33.648836740804676
2022-08-22T09:30:00-04:00,97.63,97.78,96.83,96.96,5804820,6854641.7,55.66709634548476,70.37139980062462,NaN,NaN,17.94418055944208,89.56014159142339,-0.08713132829253123,2.2282582230000116,2.315389551292543,1093152334,1100446652.2,80.03989572254409,73.33556512015888,NaN,NaN,37.309250323146394,34.17175296685349
2022-08-23T09:30:00-04:00,97,97.78,96.84,97.14,9874698,7072266.7,56.335286102662764,69.55672611052587,NaN,NaN,11.251603445123056,65.03181216785552,-0.25519980186778835,1.9963897989578072,2.2515896008255956,1103027032,1099966858.8,79.11656165648293,74.51533709702004,NaN,NaN,33.666876029808584,34.09962769013279
2022-08-24T09:30:00-04:00,97.24,97.75,97.05,97.46,6443810,6961351.05,57.55993565255074,68.76843074279161,NaN,NaN,7.930034884299661,44.26202158207174,-0.3472695299442301,1.817502688395308,2.164772218339538,1109470842,1102091591.8,80.2055674211259,75.58536602627255,NaN,NaN,31.02586814699103,33.66051918396968
2022-08-25T09:30:00-04:00,97.9,98.98,97.81,98.95,6045854,6830217,62.79269113335231,68.3267847243069,NaN,NaN,46.48058812463408,31.559306253838294,-0.3114201052277865,1.7754970868048048,2.0869171920325913,1115516696,1104024811.6,81.16782261787279,76.55967192840603,NaN,NaN,30.242229970204697,33.17219215343183
2022-08-26T09:30:00-04:00,99.14,99.19,95.45,95.52,8006169,6780493.8,48.092465917749735,66.84791848495563,NaN,NaN,-38.059253794180314,9.109430643863714,-0.5105458363978563,1.4487348965352709,1.9592807329331272,1107510527,1105735486.2,82.00160340141676,77.56458579739248,NaN,NaN,24.086158186347966,31.874187300991277
2022-08-29T09:30:00-04:00,94.91,95.85,94.54,95.09,6386888,6669869.95,46.61901062349867,65.41908936824647,NaN,NaN,-105.69734467645547,-15.618874403315804,-0.6538943144978049,1.141912839810871,1.795807154308676,1101123639,1107329747.2,82.76734161820472,78.5398768611726,NaN,NaN,18.81971328670094,30.009262441806943
2022-08-30T09:30:00-04:00,95.3,95.43,93.325,93.72,9546674,6645207.1,42.184463791024456,63.26925263803025,NaN,NaN,-144.08618346260857,-46.68643178486214,-0.8132663734408652,0.7792241875075945,1.5924905609484596,1091576965,1105039733.8,77.65655321678766,79.06173918711188,NaN,NaN,12.879836188925283,27.562201548538134
2022-08-31T09:30:00-04:00,94.1,94.27,92.83,92.93,9683939,6853929.75,39.83155720060947,60.865701848815306,NaN,NaN,-165.14258619521019,-81.3009560007641,-0.9354593121622292,0.4231664207456731,1.3586257329079023,1081893026,1099524170.6,66.93583024665674,78.72684927912721,NaN,NaN,7.299550350265238,24.667537091642007
2022-09-01T09:30:00-04:00,92.32,93.12,91.92,93.06,8790104,7026467.05,40.4204688949016,58.282455329623964,NaN,NaN,-168.44145662412384,-124.28536495051569,-0.9670991911372133,0.14975174398638558,1.116850935123599,1090683130,1094557457.4,59.032645886509734,77.7382596707246,NaN,NaN,3.10163643552678,21.586694140768405
2022-09-02T09:30:00-04:00,94.1,94.215,91.73,92.16,9839321,7125565.65,37.6714508317199,55.46934197771736,NaN,NaN,-148.05109452148514,-146.28373309597666,-1.0038515308807217,-0.13796347847730317,0.8658880524034185,1080843809,1089224113.8,51.94068551390906,76.05395627024917,NaN,NaN,-1.294167585161773,18.317999608492666
2022-09-06T09:30:00-04:00,92.2,92.765,91.51,92.31,11438690,7417203.8,38.42312106450451,52.64619200397993,NaN,NaN,-140.3918282658916,-153.22262981386388,-0.9725851159036651,-0.3498433424761629,0.6227417734275023,1092282499,1087455885.8,49.80437240316246,73.98437509522975,NaN,NaN,-4.616308375957692,15.04166989642833
2022-09-07T09:30:00-04:00,91.98,94.025,91.96,93.79,7934256,7594018.45,45.417496284655336,50.70840062580322,NaN,NaN,-97.91987314023774,-143.98936774938971,-0.8132306892580539,-0.39379658814506513,0.41943410111298873,1100216755,1089183843.8,51.88694323156437,71.94295703338106,NaN,NaN,-5.438115254544726,12.115986303432178
2022-09-08T09:30:00-04:00,93.22,94.105,92.63,94.07,6979878,7644661.9,46.65210556334803,48.788267792276194,NaN,NaN,-77.75275571885102,-126.51140165411789,-0.6566744800819192,-0.4014089989894103,0.2552654810925089,1107196633,1094244565.2,57.454350370239226,70.18227185059384,NaN,NaN,-5.742071458265706,9.564835194618194
2022-09-09T09:30:00-04:00,94.68,95.49,94.635,95.29,7439941,7731079.05,51.77094299172745,47.8170065998421,NaN,NaN,-32.914590884760514,-99.40602850624522,-0.4485937766267635,-0.30547673969094546,0.143117036935818,1114636574,1099035254,61.943731242358155,68.71099318205962,NaN,NaN,-4.446036381992027,7.5632821122453056
2022-09-12T09:30:00-04:00,95.84,96.35,95.36,95.86,5874020,7634372.3,53.99213373174108,47.69736641314613,NaN,NaN,-9.691609503575428,-71.73413150266327,-0.25958549818837884,-0.18136483579965557,0.07822066238872329,1120510594,1106968611,67.97097472150469,67.8489273962711,NaN,NaN,-2.69677476536867,6.097559701157595
2022-09-13T09:30:00-04:00,93.8,94.54,91.8982,92.25,11236335,7868265.5,41.086185110559036,46.60814491371014,NaN,NaN,-84.2486595925842,-60.50549776800178,-0.35860575943206063,-0.3700365369013525,-0.011430777469291872,1109274259,1110366963,70.15173378523264,67.20858254832466,NaN,NaN,-5.445674299490618,4.448526272493565
2022-09-14T09:30:00-04:00,92.2,92.48,90.92,92.07,8889388,8034523.5,40.56551053258148,45.39425740514091,NaN,NaN,-105.58707897999143,-62.03893893595252,-0.41325400163195347,-0.5279982795092337,-0.11474427787728024,1100384871,1110400586.2,70.17337210261266,66.49199716843086,NaN,NaN,-7.7336421632189385,2.7082164959632076
2022-09-15T09:30:00-04:00,92,92.65,90.82,91.11,10688763,8240020.55,37.81320019992429,43.610008052753194,NaN,NaN,-105.79283690237668,-67.64695517265766,-0.48606185908134736,-0.7223216017289644,-0.23625974264761707,1089696108,1106900481.2,64.89901877047923,65.32993975075989,NaN,NaN,-10.517816457645294,0.8187832168762788
2022-09-16T09:30:00-04:00,89.07,89.61,88.44,89.21,19141355,8846917.3,33.03579317125222,42.534531428003376,NaN,NaN,-163.53101398333118,-93.77023979237178,-0.6253158740537186,-1.0179045852147652,-0.3925887111610467,1070554753,1098084117,53.90788907986804,63.32324587064927,NaN,NaN,-14.569584269397653,-1.3795549954485684
2022-09-19T09:30:00-04:00,88.17,90.115,88.11,89.99,8455445,8925017.4,36.57831296416171,41.817338738050736,NaN,NaN,-142.7008242126712,-120.37208273419094,-0.626460567317582,-1.1756644203080242,-0.5492038529904422,1079010198,1089784037.8,46.00809376299325,60.697585309562726,NaN,NaN,-16.688995140202824,-3.566617873270605
2022-09-20T09:30:00-04:00,89.32,89.38,88.13,88.87,6652570,8967404.9,33.81231082106163,41.219327811624815,NaN,NaN,-147.3522695177083,-132.99280471921577,-0.6608067375450354,-1.3752122749217364,-0.714405537376701,1072357628,1082400711.6,40.34438268550408,58.032430271613904,NaN,NaN,-19.352629090492076,-5.821762332873672
2022-09-21T09:30:00-04:00,89.66,90.36,87.68,87.69,10846671,9016003.55,31.14051481164057,40.59853906955561,NaN,NaN,-139.98464485091492,-139.87231789340046,-0.7164854149228217,-1.610012306030228,-0.8935268911074064,1061510957,1074625928.8,35.402207992016955,55.78002868199677,NaN,NaN,-22.449986249339315,-8.197222892368764
2022-09-22T09:30:00-04:00,87.48,87.61,86.24,86.37,8925684,9140097.25,28.43381447508834,39.74234946814038,NaN,NaN,-172.0454424727522,-153.12283900747556,-0.7899175839740733,-1.880923871074998,-1.0910062871009247,1052585273,1067203761.8,31.44236988851769,53.8092946821402,NaN,NaN,-25.94724947465877,-10.73294097555305
2022-09-23T09:30:00-04:00,85.51,85.6,83.71,84.75,13831576,9529383.35,25.50394956425218,38.87324223474983,NaN,NaN,-195.118924084676,-159.44042102774455,-0.8879727792089169,-2.200972261112071,-1.3129994819031539,1038753697,1060843550.6,28.500490188519535,52.13499501604094,NaN,NaN,-29.91024614171467,-13.472555999290423
2022-09-26T09:30:00-04:00,84.49,85.21,83.48,83.86,9241612,9591155.5,24.038472537578485,37.845767339969406,NaN,NaN,-171.8879106906879,-165.27783832334788,-0.9477102306964706,-2.497637270273742,-1.5499270395772715,1029512085,1050943928,24.63661985238764,50.33729840527131,NaN,NaN,-33.619328790775675,-16.35066639807403
2022-09-27T09:30:00-04:00,84.62,84.89,82.87,83.58,12179578,9880790,23.579425176144213,36.28590511793289,NaN,NaN,-151.60684183991532,-166.12875278778927,-0.939210528576244,-2.7239402002975766,-1.7847296717213326,1017332507,1039938903.8,21.196378395807315,48.145115202717236,NaN,NaN,-36.71789892675075,-19.260271045027846
2022-09-28T09:30:00-04:00,83.94,85.89,83.67,85.42,11920112,9999461.9,32.677607652158855,35.28772669570509,NaN,NaN,-109.35487414625878,-160.00279864685803,-0.7509525709074103,-2.7234203853555954,-1.972467814448185,1029252619,1033487236.2,19.47909400876223,45.43259689118317,NaN,NaN,-36.53762208732951,-21.72846405107094
2022-09-29T09:30:00-04:00,84.67,84.75,83.16,83.94,9357400,9983134.95,29.622703362920006,33.7057095793617,NaN,NaN,-115.44493836134014,-148.68269782457563,-0.670057485442813,-2.810039671251701,-2.139982185808888,1019895219,1026949225.4,17.896709309531587,42.28638103883842,NaN,NaN,-37.36212074261728,-23.961843578434703
2022-09-30T09:30:00-04:00,83.7,84.45,82.75,82.84,8935651,9990412.3,27.560417787726124,31.81772986907492,NaN,NaN,-113.47921060679178,-132.35475512899876,-0.6349181135654605,-2.9336298277657136,-2.298711714200253,1010959568,1021390399.6,16.65768432673903,38.621146010640864,NaN,NaN,-38.70301932762362,-26.067725828318835
2022-10-03T09:30:00-04:00,83.76,86.01,83.495,85.34,8612659,9929079.2,38.106707709076545,31.60491005468332,NaN,NaN,-75.17076473784344,-113.01132593842988,-0.39910890391287124,-2.7975978440913423,-2.398488940178471,1019572227,1019402428,16.225065774197006,34.769241152709746,NaN,NaN,-36.27730087296968,-27.526236548983242
2022-10-04T09:30:00-04:00,86.64,88.33,86.64,88.31,9676136,9840951.5,47.82495084161082,32.12344150532827,NaN,NaN,-18.660009847516093,-86.42195953995002,-0.018981284072011828,-2.422215545268486,-2.403234261196474,1029248363,1021785599.2,18.94282952100123,31.109916682594644,NaN,NaN,-30.56614410148626,-27.960509056483673
2022-10-05T09:30:00-04:00,87.35,88.575,86.93,87.83,7055835,9797030.45,46.55274056371134,32.74769438845592,NaN,NaN,-13.743277834359114,-67.29964027757009,0.2115477234144354,-2.13879960692843,-2.3503473303428652,1022192528,1020373581,18.55866775557452,27.79989161010145,NaN,NaN,-26.603182973944516,-27.76660533040665
2022-10-06T09:30:00-04:00,87.38,88.03,86.6,86.82,8813313,9888702.2,43.90610525858489,33.52414525183683,NaN,NaN,-21.5670440941918,-48.52406142414041,0.3019209855035756,-1.972946098463396,-2.2748670839669716,1013379215,1019070380.2,18.191972901923222,25.248754740248256,NaN,NaN,-24.26374656235784,-27.266196934971106
2022-10-07T09:30:00-04:00,85.99,86.13,84.635,85.16,7415187,9887464.5,39.89185471530886,33.7608268054902,NaN,NaN,-56.87380728648783,-37.20298076007964,0.2575402054324547,-1.952941827176403,-2.2104820326088577,1005964028,1018071272.2,17.899964088459782,23.24103119206729,NaN,NaN,-23.6182270690256,-26.745058382693177
2022-10-10T09:30:00-04:00,85.87,86.33,84.74,85.46,7564257,9971976.35,40.94272904862083,34.270142393172996,NaN,NaN,-45.11529654487695,-31.191887121486342,0.25552035104141657,-1.8910815938070868,-2.1466019448485034,1013528285,1016862483.8,17.533271900718532,21.611666136011184,NaN,NaN,-22.779264256801916,-26.17851636470871
2022-10-11T09:30:00-04:00,85.12,86.6,84.89,85.44,8661731,9843246.15,40.89140240246257,34.96663436394599,NaN,NaN,-34.85993261217843,-34.431871674418815,0.2591533533158481,-1.8226602532036935,-2.0818136065195416,1004866554,1011986122,16.10037237574008,20.23296359199141,NaN,NaN,-22.12720407468626,-25.599757466134076
2022-10-12T09:30:00-04:00,85.39,85.785,84.73,84.77,6727367,9735145.1,39.12203887623424,35.73007896402785,NaN,NaN,-46.009008655227035,-40.88501783859239,0.2240668642566641,-1.8017300261987117,-2.025796890455376,998139187,1007175453.8,14.814129248687422,19.045232117717813,NaN,NaN,-22.086235769805707,-25.097825795230023
2022-10-13T09:30:00-04:00,82.85,87.085,82.76,86.64,18956141,10148514,46.12845580088927,37.2032579809305,NaN,NaN,-25.064032199041783,-41.584415459562386,0.328137212274084,-1.6156253751127707,-1.9437625873868547,1017095328,1007918676.4,15.931554167332905,18.147450973347336,NaN,NaN,-19.927559292461126,-24.359216294834464
2022-10-14T09:30:00-04:00,87.25,87.4,84.56,84.74,9433052,9663098.85,40.96916857673179,38.41259341229859,NaN,NaN,-16.77868886638859,-33.56539177554254,0.2726323465693081,-1.6029721541752195,-1.8756045007445277,1007662276,1008258326,16.470799004313463,17.564178055627753,NaN,NaN,-19.633591989858722,-23.68412710840936
2022-10-17T09:30:00-04:00,86.24,87.06,86.14,86.59,9541174,9717385.3,47.165583818870275,40.09731902963616,NaN,NaN,41.65340504354085,-16.211651457859,0.35871334021734214,-1.42721282547285,-1.7859261656901921,1017203450,1008993359,17.701088962231594,17.31451452465806,NaN,NaN,-17.373674933758263,-22.78263394060206
2022-10-18T09:30:00-04:00,88.46,88.91,87.44,88.68,10160563,9892784.95,53.14888403621702,41.5595530570689,NaN,NaN,136.7029373251154,18.100922529599767,0.5435237586583015,-1.1065214673673154,-1.6500452260256169,1027364013,1013492850.8,24.984907407397614,17.707786910274876,NaN,NaN,-13.415672551387242,-21.444496599285657
2022-10-19T09:30:00-04:00,88.25,88.85,87.35,88.05,7705459,9735724.35,51.26429015585056,43.10538068513536,NaN,NaN,127.44863967622221,52.79245219588961,0.6057049541596757,-0.8929140333260221,-1.4986189874856979,1019658554,1017796724.2,31.252524878702715,18.661773736644243,NaN,NaN,-10.844353577401325,-19.93019045330218
2022-10-20T09:30:00-04:00,87.79,88.31,86.17,86.32,8773288,9728104.55,46.39886069770727,44.450983750134014,NaN,NaN,63.50985462821134,70.50722956134024,0.5161849331161297,-0.8533878210905357,-1.3695727542066654,1010885266,1016554711.8,30.46156017598753,19.647764868733425,NaN,NaN,-10.213795854441473,-18.542134082036366
2022-10-21T09:30:00-04:00,86.4,88.865,86.09,88.69,13148218,9693936.65,52.98232264658332,45.513527674241644,NaN,NaN,99.29902605063138,93.72277254474423,0.5967502476874817,-0.6236349445973133,-1.220385192284795,1024033484,1019828953.4,35.12312161453448,20.997626000186102,NaN,NaN,-7.450899793395979,-16.957672040802024
2022-10-24T09:30:00-04:00,89.32,90.205,89.07,89.87,9388681,9701290.1,55.88742264780753,46.089418517541404,NaN,NaN,161.92890580240288,117.77787269651662,0.7023952541363774,-0.3423911246143234,-1.0447863787507008,1033422165,1023072696.4,39.45340755961811,22.462667288658736,NaN,NaN,-4.240526276630787,-15.140936931634704
2022-10-25T09:30:00-04:00,89.77,91.15,89.72,91.08,9807949,9582708.65,58.70505820853779,46.95744120645759,NaN,NaN,176.68582066842922,125.77444936517941,0.818535268821984,-0.02161729272322077,-0.8401525615452048,1043230114,1026245916.6,43.43119943403308,24.23927669426292,NaN,NaN,-0.6831567715521845,-13.07553976590863
2022-10-26T09:30:00-04:00,91.91,92.71,91.07,91.4,10250443,9499225.2,59.44285882331304,48.06720931822388,NaN,NaN,187.20483515777667,137.72568846149028,0.8765017716181503,0.2554746529774832,-0.6210271186406672,1053480557,1033010317.2,50.84489533417548,26.57162829656665,NaN,NaN,2.3805259879379412,-10.867530372501976
2022-10-27T09:30:00-04:00,92.29,93.58,92.28,92.47,9223889,9492549.65,61.894454359786096,49.63882357854368,NaN,NaN,192.87905878198902,163.59952929224582,0.9408330673361877,0.5550142155295674,-0.38581885180662023,1062704446,1043374153.2,59.58433225329005,29.5490831654831,NaN,NaN,5.704390057843757,-8.500113168166871
2022-10-28T09:30:00-04:00,92.66,94.7,92.42,94.62,9161737,9503853.95,66.30225274682243,51.45021812841522,NaN,NaN,198.9375068283728,183.5272254477941,1.0725600671788142,0.9548812321668976,-0.11767883501191662,1071866183,1052940693,65.65453576721326,32.98631629880413,NaN,NaN,10.04912948115639,-5.850221361120692
2022-10-31T09:30:00-04:00,94.16,94.95,93.89,94.35,9144913,9530466.65,65.28100674826462,53.19233272454394,NaN,NaN,173.91366525803397,185.92417733892032,1.0827407139062426,1.2357470573708866,0.15300634346464403,1062721270,1058800514,68.75059587882306,36.74704654902434,NaN,NaN,13.229003431141088,-3.1246178193690093
2022-11-01T09:30:00-04:00,95.05,95.17,93.67,94.26,9673189,9530319.3,64.92203716502371,55.035189745171756,NaN,NaN,141.13675102961406,178.81436341115727,1.0252241693053141,1.4345365550962867,0.40931238579097257,1053048081,1060764107.4,69.73512984868037,40.66997516330955,NaN,NaN,15.702705811328268,-0.4350001578408267
2022-11-02T09:30:00-04:00,93.79,95.72,92.545,92.6,13884866,9871770.85,58.52919980074569,55.92095717373293,NaN,NaN,105.26907341636122,162.4272110628742,0.8257610235447571,1.441513665221919,0.6157526416771618,1039163215,1057900639,66.44742634925956,44.27825174773289,NaN,NaN,16.027104710228315,1.916729109026193
2022-11-03T09:30:00-04:00,91.66,94.41,91.601,93.57,13330964,10097653.4,60.949013106606856,57.34808892586686,NaN,NaN,84.48170626908482,140.74774056029338,0.713743065271501,1.507931473266538,0.7941884079950371,1052494179,1055858585.6,64.12558906440019,47.68216532345337,NaN,NaN,17.004506644901852,4.072125899865573
2022-11-04T09:30:00-04:00,94.87,95.34,93.5,95.07,11497477,10301767.9,64.40761622560434,58.579662669205014,NaN,NaN,102.93924174872183,121.54808754436317,0.6946028198962948,1.6624419328654056,0.9678391129691108,1063991656,1054283680.2,62.31703110288322,50.86901833349991,NaN,NaN,18.888408635363792,6.188737719222461
2022-11-07T09:30:00-05:00,95.5,96.24,94.895,96.09,8286935,10337901.8,66.57545891506787,59.53870373198008,NaN,NaN,112.13214828952394,109.19178415066115,0.7024642699528771,1.8459194504102072,1.14345518045733,1072278591,1056195144.4,63.65677237990016,53.63129440296438,NaN,NaN,21.12978666951711,8.323173283550268
2022-11-08T09:30:00-05:00,96.4,97.38,95.77,96.93,8951572,10352393.85,68.28843822588625,60.7547143084112,NaN,NaN,118.36805399400377,104.63804474353908,0.7137495117416337,2.0356420701343723,1.3218925583927386,1081230163,1061831560.8,67.34369829266888,56.20923536110481,NaN,NaN,23.521324368497915,10.494337724257075
2022-11-09T09:30:00-05:00,96.35,97,95.455,95.58,9217726,10476911.8,62.724726653918644,61.920847590997724,NaN,NaN,96.03219290651026,102.79066864156889,0.5852016655610739,2.053394640344081,1.468192974783007,1072012437,1068401405.2,71.03252500944625,59.10716142063758,NaN,NaN,23.93691700894899,12.414706193498777
2022-11-10T09:30:00-05:00,98.3,99.72,97.84,99.59,18633783,10460793.9,70.43106956904802,63.16718665688807,NaN,NaN,144.90777065284485,114.87588151832088,0.7164767244632013,2.3637888803620086,1.6473121558988073,1090646220,1076031813.4,74.6185626133525,61.92826434912458,NaN,NaN,26.951898887702754,14.491448006956487
2022-11-11T09:30:00-05:00,99.83,100.24,99.12,99.53,9975360,10487909.3,70.19721871530425,64.18931494742354,NaN,NaN,145.98944446550675,123.48592206167787,0.7423512040343403,2.5752511609417326,1.8328999569073923,1080670860,1079367654.2,76.01641261202174,64.5399075671534,NaN,NaN,29.20830765761375,16.593856528478952
2022-11-14T09:30:00-05:00,99.24,100.26,98.89,98.92,8854133,10453557.25,67.73486623358534,64.83430123492694,NaN,NaN,130.64941330842407,127.1893750654579,0.6640145757987663,2.6629181766558503,1.998903600857084,1071816727,1079275281.4,75.89177115388034,66.85851983285679,NaN,NaN,30.29315198289148,18.55089873625217
2022-11-15T09:30:00-05:00,99.99,100.18,98.74,99.6,10514104,10471234.3,69.03867418984093,65.51971661825037,NaN,NaN,122.8107029383221,128.0779048543216,0.605278342382058,2.7555015288346567,2.1502231864525987,1082330831,1079495415,75.99279494535834,68.65479837651272,NaN,NaN,31.576307561979196,20.411671425641742
2022-11-16T09:30:00-05:00,99.48,99.675,98.655,98.88,9612086,10566565.65,65.99766994043341,65.81280344543946,NaN,NaN,103.83244606835842,129.6379554866912,0.47118202600555126,2.7392007189595375,2.2680186929539863,1072718745,1079636676.6,76.06211622656934,69.83178294603265,NaN,NaN,31.76236616081143,22.033199244951696
2022-11-17T09:30:00-05:00,97.61,98.75,97.1,98.71,8754393,10565620.9,65.26667032285124,65.73883327229866,NaN,NaN,75.212721175635,115.69894559124923,0.3309068160374986,2.6816522130008593,2.3507453969633607,1063964352,1074300303,68.06628174642556,70.00405051597639,NaN,NaN,31.710329255360765,23.415646389295848
2022-11-18T09:30:00-05:00,99.6,99.89,98.8,99.44,7661541,10291287.05,66.95905701793302,65.8586940058464,NaN,NaN,94.37278948775615,105.3756145956991,0.250793947438229,2.664237831261147,2.413443883822918,1071625893,1072491309.6,65.55064572966603,69.77548264817946,NaN,NaN,32.128173618022906,24.660293136256858
2022-11-21T09:30:00-05:00,99.18,100.06,99.15,99.76,7072582,10175482.1,67.70197513610435,66.05726100378072,NaN,NaN,92.38431952650596,97.72259583931549,0.1858524655210232,2.645759465724197,2.4599070002031738,1078698475,1073867659.2,66.56319691511172,69.54891601006742,NaN,NaN,32.67783360793272,25.80565606078198
2022-11-22T09:30:00-05:00,100.2,100.76,100.1,100.53,7470202,10058594.75,69.48023463468058,66.83947777763322,NaN,NaN,102.61416382327977,93.68328801630702,0.16211880800530043,2.662555510209799,2.5004367022044987,1086168677,1074635228.4,67.14320567384235,69.5986145332519,NaN,NaN,33.633597435927484,26.923933400088483
2022-11-23T09:30:00-05:00,100.65,101.29,100.575,100.91,5649134,9828529.3,70.34789984763906,67.5108268305641,NaN,NaN,104.17332290615809,93.75146338386695,0.14019918359557337,2.6756856816989654,2.535486498103392,1091817811,1078455041.6,69.93792399336866,70.01378131389251,NaN,NaN,34.676588810393696,28.031455601560655
2022-11-25T09:30:00-05:00,101.13,101.5,101.01,101.3,2665905,9500630.1,71.25124905859508,67.99965774720629,NaN,NaN,103.83400814398131,99.47572077753622,0.12088425726443841,2.6865918196839402,2.565707562419502,1094483716,1084558914.4,73.77635656998092,70.83230456154233,NaN,NaN,35.80655205406568,29.14218366620423
2022-11-28T09:30:00-05:00,100.85,100.94,99.14,99.46,7870228,9436054.65,61.70070262829208,67.65146086957945,NaN,NaN,59.891965081472826,92.57955589627956,-0.038374484405810705,2.5177394569122384,2.556113941318049,1086613488,1087556433.4,75.43514252656205,71.67361671487534,NaN,NaN,34.155318502302876,29.858345785646893
2022-11-29T09:30:00-05:00,99.68,100.23,99.38,100.07,5563377,9256977.85,63.44983153283447,67.30584610579004,NaN,NaN,56.85687848338118,85.4740676876546,-0.12055795240184164,2.405416500815747,2.5259744532175885,1092176865,1090252111.4,76.85315445945722,72.35286358393164,NaN,NaN,33.22969969054462,30.339967772060856
2022-11-30T09:30:00-05:00,100.05,101.74,98.94,101.72,18295432,9688090,67.74139365414045,67.66417946294874,NaN,NaN,80.41459053203799,81.03415302940626,-0.08347879253068635,2.4216259625542307,2.505104755084917,1110472297,1095112835.4,79.18625520756447,72.93527288379723,NaN,NaN,33.64627977077311,30.81229805759118
2022-12-01T09:30:00-05:00,102.1,102.3593,100.965,101.75,13848743,9686283.85,67.81538761870712,67.47734503792438,NaN,NaN,108.7221512442145,81.94391869701752,-0.07678622917471944,2.4091219686165175,2.485908197791237,1124321040,1101613481.2,81.82478212927023,73.45000284921993,NaN,NaN,34.00499856965637,31.26839813074335
2022-12-02T09:30:00-05:00,100.66,102.69,100.66,102.33,10768068,9558139.05,69.2823858798485,67.41199983539184,NaN,NaN,121.13876057243687,85.40486918270865,-0.05421550461005964,2.4181388170286624,2.472354321638722,1135089108,1109734559.6,84.47293243047481,74.05403997910943,NaN,NaN,34.717921210778286,31.76118714217691
2022-12-05T09:30:00-05:00,101.4,101.52,100.44,100.62,11070756,9536803,60.523336445377524,66.89689056480556,NaN,NaN,72.8399486003503,87.99446588648414,-0.1688947329297008,2.261235905476596,2.430130638406297,1124018352,1117215532.4,86.43380793959432,74.80704260666043,NaN,NaN,32.756117122861575,31.903319996560434
2022-12-06T09:30:00-05:00,100.85,100.9,98.675,99.43,8854732,9565192.85,55.28518066645949,65.91449817027832,NaN,NaN,-1.5468052675776078,76.31372913629238,-0.33001776765139557,2.0176084288420526,2.347626196493448,1115163620,1121812883.4,87.48019511969319,75.6275711905415,NaN,NaN,29.441860021951495,31.551682857330587
2022-12-07T09:30:00-05:00,99.25,100,99.11,99.3,7173701,9476299.3,54.72793628946824,65.10951719520938,NaN,NaN,-26.293605602208018,54.972089909443184,-0.44340564384161585,1.7933691416914286,2.2367747855330444,1107989919,1121316407.8,86.70244386912043,76.38759459358086,NaN,NaN,26.591295523207826,30.84305609531305
2022-12-08T09:30:00-05:00,99.66,100.5,99.53,99.89,6462406,9338533.3,56.853508160595005,64.5085770407625,NaN,NaN,-4.856414727956236,32.256376715009026,-0.473970738510753,1.6443113623946033,2.1182821009053563,1114452325,1119342664.8,83.52325899426334,77.49166439699783,NaN,NaN,24.76784511883373,29.97516881295886
2022-12-09T09:30:00-05:00,99.84,100.26,99.04,99.07,7208049,8767246.6,53.120538219647784,63.52011141231356,NaN,NaN,-52.33417435864933,-2.4382102712082157,-0.5399244762928295,1.4433765055393195,1.983300981832149,1107244276,1113773698.4,75.15021539795646,78.17734794473287,NaN,NaN,22.10898279025828,28.85142795257306
2022-12-12T09:30:00-05:00,99.3,100.8,99.22,100.77,7043316,8620644.4,59.11416683664646,62.90669653378085,NaN,NaN,16.13871395932253,-13.778457199413765,-0.46255061615076243,1.4051127116436959,1.8676633277944583,1114287592,1111827546.4,72.4180342199106,78.59555060936135,NaN,NaN,21.49946364081859,27.801147336608135
2022-12-13T09:30:00-05:00,103.23,103.31,100.405,101.15,17589507,9057413.1,60.334939217425145,62.253461146834034,NaN,NaN,118.38188686217713,10.20728122653718,-0.38258292977045416,1.3894346655813905,1.7720175953518447,1131877099,1115170242.2,74.15600959496811,79.09646517515606,NaN,NaN,21.358878317316655,26.880823190995066
2022-12-14T09:30:00-05:00,101.27,102.28,100.38,100.96,10428901,9053152.95,59.38025749677634,61.47005812177242,NaN,NaN,75.23341576849661,30.512685500678106,-0.3406856061057202,1.3461605877196945,1.6868461938254147,1121448198,1117861898,75.49500875847586,79.49339980123514,NaN,NaN,20.973102246000757,26.03686305599588
2022-12-15T09:30:00-05:00,99.6,100.045,98.01,98.52,11588870,9151992.15,48.71898853931676,59.86061094182397,NaN,NaN,-113.1788421673137,8.848200012806611,-0.467659627364001,1.1022716596204134,1.5699312869844144,1109859328,1116943298.6,74.08429722229432,79.51539556211468,NaN,NaN,17.2033655220097,24.774934836854996
2022-12-16T09:30:00-05:00,97.59,98.305,97.135,98.1,17357140,9582129.5,47.149745106540614,58.821256833127435,NaN,NaN,-189.23694494760053,-18.532354104983632,-0.5638451762291659,0.865124816697957,1.428969992927123,1092502188,1113994881,69.58948919704238,79.09784889572042,NaN,NaN,13.654116541895819,23.186246509003684
2022-12-19T09:30:00-05:00,97.37,98.27,96.65,97.12,8814778,9639791.35,43.61927929040689,57.40478881581118,NaN,NaN,-196.99232272986993,-61.15856144282212,-0.6701436761866835,0.5912903976937685,1.261434073880452,1083687410,1107874844.6,61.27866709778963,77.98538551274416,NaN,NaN,9.52959620878075,21.235296466114693
2022-12-20T09:30:00-05:00,96.91,97.87,96.8,97.24,9294162,9750870.35,44.170538620769065,55.721156313427514,NaN,NaN,-170.61342442476771,-118.95762370021109,-0.7054816117571594,0.3795820591840027,1.085063670941162,1092981572,1100095739.2,52.668499298299466,76.0912600906538,NaN,NaN,6.358892405069612,19.110095885965396
2022-12-21T09:30:00-05:00,98.38,99.2399,98.05,99.07,8220939,9788407.2,51.89502865840968,54.58398781626341,NaN,NaN,-70.36073062123467,-148.07645297815733,-0.583754226902984,0.35537088731243216,0.9391251142154161,1101202511,1096046601.8,48.82306917745254,73.73399487980967,NaN,NaN,5.860938181444301,17.217359071033812
2022-12-22T09:30:00-05:00,98.39,98.47,96.3,97.81,11024801,10057190.55,47.066423273889434,52.99713334440919,NaN,NaN,-127.8106692419861,-151.00281839309181,-0.5658285799586917,0.2318393892670514,0.7976679692257431,1090177710,1092110278.2,45.35615438485147,70.9399393051223,NaN,NaN,3.899533596366695,15.314812574652795
2022-12-23T09:30:00-05:00,97.8,98.53,97.37,98.39,6142448,10231017.7,49.40034170692591,52.20263372023408,NaN,NaN,-85.420132831652,-130.23945596990214,-0.4951894041824525,0.17868121399767745,0.6738706181801299,1096320158,1092873872.2,46.15492208913177,68.06287603008926,NaN,NaN,3.013742309971343,13.557516822555444
2022-12-27T09:30:00-05:00,98.54,99.18,98.16,98.69,5213773,10098194.95,50.61329050778445,51.86892728032872,NaN,NaN,-48.1745191771296,-100.47589525935406,-0.41195374113529915,0.15892844176100596,0.5708821828963051,1101533931,1096443176.4,49.84550401984359,65.37468380867143,NaN,NaN,2.653196318612744,11.99975675056363
2022-12-28T09:30:00-05:00,98.87,99.1,97.38,97.4,6803903,10160221.25,45.55625461591067,51.2138071607889,NaN,NaN,-78.43333411488564,-82.03987719737765,-0.4257173544629437,0.038735489817625535,0.4644528442805692,1094730028,1096792867.6,50.20559744444572,62.767766206908945,NaN,NaN,0.793868658972724,10.398915594622073
2022-12-29T09:30:00-05:00,97.85,98.9,97.77,98.6,8308994,9660899.35,50.509911405259615,50.760693106836364,NaN,NaN,-48.68990700523266,-77.70571247417723,-0.33968044480955983,0.03985228826861942,0.37953273307817925,1103039022,1097160169.8,50.60673796993801,60.41658613374285,NaN,NaN,0.733894311973019,9.018198268529352
2022-12-30T09:30:00-05:00,98.01,98.395,97.285,98.21,6874386,9312181.5,48.951048362773136,50.4628724027739,NaN,NaN,-66.63818496281179,-65.47121561834237,-0.29629658280844107,0.009162004567627946,0.305458587376069,1096164636,1098357555,51.9652594269458,58.760517850099234,NaN,NaN,0.21893438699545198,7.761160571167366
2023-01-03T09:30:00-05:00,98.78,98.94,97.51,98.42,11407708,9344163.5,49.848588514062904,49.801045379732216,NaN,NaN,-43.06311333484615,-56.999811718981206,-0.2429551603459939,0.0017646369435766474,0.24471979728957055,1107572344,1100607992.2,54.498310860375774,57.48053761013246,NaN,NaN,0.05692770488924774,6.660555875984778
2023-01-04T09:30:00-05:00,98.74,99.61,98.52,99.29,12235998,9402425.6,53.49644585307487,49.312581567992915,NaN,NaN,17.003016647539503,-43.96430455404739,-0.143495375329537,0.06535057812764933,0.20884595345718632,1119808342,1104262874.4,58.340621831707665,56.350867055613854,NaN,NaN,0.9838638043108909,5.849599865745651
2023-01-05T09:30:00-05:00,98.73,98.96,97.95,98.22,9649569,9442167.45,48.795515628471904,48.55652857739973,NaN,NaN,-32.257133532186366,-34.729064437507525,-0.14382255322520981,0.029067761925674063,0.17289031515088388,1110158773,1107348623.4,61.31108034339639,55.3377293116796,NaN,NaN,0.4064834735210285,5.072011809713562
2023-01-06T09:30:00-05:00,99.21,101.1898,99.03,100.91,16270435,9897004.15,58.6363315730333,49.26491022266521,NaN,NaN,100.98114969161249,-4.7948530981384945,0.03360510157197888,0.2148966921158575,0.1812915905438786,1126429208,1112026660.6,65.34530888431897,54.713515858967085,NaN,NaN,3.179743535936223,4.801687770602514
2023-01-09T09:30:00-05:00,101.16,102.065,100.325,100.46,12846692,10216218.45,56.67408951090705,49.945220537262806,NaN,NaN,128.05150355886278,34.143084606196425,0.11268093375635996,0.32214275773932854,0.2094618239829686,1113582516,1115510236.6,68.0195738995254,54.60137905200158,NaN,NaN,4.766053061127959,4.796597097820435
2023-01-10T09:30:00-05:00,100.13,101.07,100.07,101.01,9166198,10314125.9,58.5019713348766,51.00826996901064,NaN,NaN,101.45133826497582,63.04597492616082,0.1895273043053703,0.44637095436468144,0.25684365005931115,1122748714,1118545510.6,70.17892378822364,55.23711167274687,NaN,NaN,6.6343209034446,5.0591290700524585
2023-01-11T09:30:00-05:00,101.6,102,101.035,101.98,7395403,10331730.25,61.58051739854835,52.25183988170916,NaN,NaN,141.89550817937558,88.02447323252804,0.2873193255058695,0.615992806941648,0.3286734814357785,1130144117,1120612665.6,71.58604121822698,56.588364667027406,NaN,NaN,9.185599767554507,5.648624883981323
2023-01-12T09:30:00-05:00,102.35,102.98,101.49,102.58,9883217,9946415.75,63.3897129985759,53.07288876314961,NaN,NaN,170.1726845131008,128.51043684158546,0.3688458609309521,0.7897308075994687,0.42088494666851656,1140027334,1126586377.8,75.22426577024905,58.474164423655736,NaN,NaN,11.855513477027356,6.53532325441647
2023-01-13T09:30:00-05:00,101.71,102.54,101.45,102.46,14206882,10135314.8,62.75323294950014,54.19337516855038,NaN,NaN,150.0405450309248,138.32231590944792,0.3891143570080249,0.9072778929285477,0.5181635359205228,1125820452,1126464626.6,75.0134464000725,60.59254242474295,NaN,NaN,13.83548564745867,7.578203596279641
2023-01-17T09:30:00-05:00,102.4,102.54,101.48,101.59,9275086,10019625.6,58.19132083434969,54.821302249080645,NaN,NaN,114.25780034944863,135.5635752675651,0.32117487453812055,0.9196321290931735,0.5984572545550529,1116545366,1127057196.6,75.37517003642779,62.67970299240695,NaN,NaN,14.228414655307617,8.528233747569352
2023-01-18T09:30:00-05:00,101.94,102.165,99.62,99.68,15025986,9903067.9,49.65664582662061,54.75297048614037,NaN,NaN,46.75504946312121,124.62431750719418,0.13440744704677554,0.7664665633635224,0.6320591163167468,1101519380,1122811329.8,67.80126720295206,63.962257505486136,NaN,NaN,11.893577021131195,9.0089970723639
2023-01-19T09:30:00-05:00,99.07,99.32,97.62,97.63,17155790,10320118.5,42.45881238539186,54.53172461253188,NaN,NaN,-57.25132983418916,84.79494990448123,-0.1262891918306256,0.47419762652846487,0.6004868183590905,1084363590,1113655224.4,54.97295290874628,64.30278289579331,NaN,NaN,7.350868340612528,8.772121539256561
2023-01-20T09:30:00-05:00,97.71,99.02,97.31,98.99,12816602,10496240.5,47.85860171390297,54.34234534886355,NaN,NaN,-50.11409054506589,40.737594892847895,-0.2017510073351585,0.34829805919014234,0.5500490665253008,1097180192,1105085796,46.16848425193364,63.985764773078714,NaN,NaN,5.3585822400965615,8.28447306794799
2023-01-23T09:30:00-05:00,99.3,100.61,98.875,100.07,11113556,10640871.35,51.73228628421494,54.54100520039511,NaN,NaN,12.927567809059358,13.314999448474817,-0.17456450559417114,0.3318434345325869,0.506407940126758,1108293748,1101580455.2,43.12581675211676,63.35437601059093,NaN,NaN,5.013401827044199,7.817177176390306
2023-01-24T09:30:00-05:00,99.51,101.025,98.99,100.73,11341177,10656690.15,53.98223177179588,54.836265433090325,NaN,NaN,26.396459077554,-4.257268805904104,-0.11087073956127397,0.3678195156751656,0.47869025523643954,1119634925,1102198367,43.82857387107672,62.59225193992672,NaN,NaN,5.462524763962288,7.480798260329161
2023-01-25T09:30:00-05:00,99.63,100.435,98.795,100.17,11728321,10935983.8,51.776870031405586,54.71343858868538,NaN,NaN,0.17501571164534604,-13.573275556199286,-0.10523871301311033,0.34714186397005165,0.452380576983162,1107906604,1103475811.8,45.332476836747915,61.66309872600102,NaN,NaN,5.141528006273989,7.146616795464136
2023-01-26T09:30:00-05:00,100.88,100.88,99.47,100.72,14985518,11424571.05,53.77430123976672,55.06906613234929,NaN,NaN,25.650255467937686,3.007041504226077,-0.06521643291712464,0.3708600358367562,0.43607646875388084,1122892122,1111181518.2,53.431801390548195,61.100293086511854,NaN,NaN,5.482882039548885,6.908940401761957
2023-01-27T09:30:00-05:00,100.5,101.615,100.42,101.14,14187326,11793742.2,55.29703524766014,54.8305449662512,NaN,NaN,57.562084583962736,24.542276530031803,-0.013884697057345963,0.41872059743219836,0.4326052944895443,1137079448,1119161369.4,60.035155026676286,60.72099638239452,NaN,NaN,6.212675153327278,6.8094739376998605
2023-01-30T09:30:00-05:00,100.51,101.49,100.065,100.15,10057928,11881188.9,51.029904904797945,54.4273889229577,NaN,NaN,25.57655494819631,27.072073957859192,-0.048106567790566046,0.37247208475133675,0.4205786525419028,1127021520,1122906923.8,62.708132216668695,60.3416076907619,NaN,NaN,5.581162827316375,6.634000921930792
2023-01-31T09:30:00-05:00,100.45,101.88,100.09,101.85,10367547,12055846.95,57.14537899530221,54.330489470130956,NaN,NaN,63.50811935888315,34.494406014125026,0.03762134559377961,0.46760533453412734,0.42998398894034773,1137389067,1126457752.2,65.09178514072609,59.97824064451208,NaN,NaN,6.931633797611182,6.676519904170847
2023-02-01T09:30:00-05:00,101.44,103.325,100.98,102.59,16673662,12319144.65,59.51542228429738,54.1829826762559,NaN,NaN,121.50254376913435,58.75991162562283,0.1326867570496707,0.5958424352524361,0.4631556782027654,1154062729,1135688977.2,70.39053873737959,59.89284761016584,NaN,NaN,8.789549319370742,6.978381249199404
2023-02-02T09:30:00-05:00,102.97,103.99,102.33,103.39,13459841,12380336.8,61.96443713123789,54.08117725716032,NaN,NaN,161.12899243025242,85.8556590180858,0.23214788531272612,0.753340534843673,0.5211926495309469,1167522570,1144615066.8,74.43192776029925,59.836252038026565,NaN,NaN,11.103149215703137,7.567633815842794
2023-02-03T09:30:00-05:00,102.72,103.7,102.58,102.85,13567815,12576249.1,59.354420183161594,53.83840491670757,NaN,NaN,133.96682173713995,101.13660644872125,0.2431054655110746,0.8250744814197901,0.5819690159087155,1153954755,1147990128.2,75.77813772762644,59.890872847137565,NaN,NaN,12.250295056596029,8.236585421664685
2023-02-06T09:30:00-05:00,102.35,102.9923,102.185,102.6,10260898,12275772.25,58.13357998930474,53.83428057063293,NaN,NaN,93.29329420603703,114.67995430028938,0.21596935789661675,0.8519307132794864,0.6359613553828697,1143693857,1151324595.6,77.06306818000797,60.01143700025044,NaN,NaN,12.8449700874833,8.894926088210202
2023-02-07T09:30:00-05:00,102.3,103.185,101.25,102.92,10946134,12180744.35,59.287894017959374,54.52222687001427,NaN,NaN,75.73525435717373,117.1253812999475,0.20226321488321886,0.8887903739868932,0.6865271591036743,1154639991,1154774780.4,78.34323409216057,60.76443463519389,NaN,NaN,13.663842183204189,9.576199816066486
2023-02-08T09:30:00-05:00,102.39,102.83,102,102.34,7429670,12093917.95,56.26013294930013,55.508035481722004,NaN,NaN,65.48930872924134,105.92273429196891,0.13979631594894626,0.8612725540398571,0.7214762380909109,1147210321,1153404298.8,76.5163922305625,62.303251729609336,NaN,NaN,13.531717613717428,10.141273787159477
2023-02-09T09:30:00-05:00,102.84,103.08,101.135,101.42,8882518,12168273.7,51.74597579171641,55.78570505870868,NaN,NaN,36.078401839962694,80.91261617391095,0.028025108140130817,0.7565076232660743,0.7284825151259435,1138327803,1147565345.4,69.12108087436826,63.942722916926094,NaN,NaN,12.131895471243793,10.425648313457236
2023-02-10T09:30:00-05:00,101.19,102.22,101.08,102.14,7710516,12059638.65,54.802446252546666,56.0050021993038,NaN,NaN,34.66022824817862,61.05129747611868,-0.0041927601109224,0.7232415649872905,0.7274343250982129,1146038319,1145982058.2,67.22378817516102,65.66400659000068,NaN,NaN,11.78597624093232,10.619980874525105
2023-02-13T09:30:00-05:00,102.34,103.13,102.16,103.07,5781413,11638365.2,58.462303990653425,56.325007357793616,NaN,NaN,85.77861748713191,59.54836213233766,0.028552043109871028,0.7631243789855517,0.7345723358756807,1151819732,1147607233.2,68.18900780464108,67.40403758525528,NaN,NaN,12.544907944945697,10.89497045601376
2023-02-14T09:30:00-05:00,102.71,103.26,101.725,102.79,7722300,11560725.9,56.96665474019007,56.69570626556395,NaN,NaN,71.1191326527615,58.62513779145521,0.02301320447894739,0.7633388414743649,0.7403256369954175,1144097432,1145498721.4,65.49418200597717,68.84415938305737,NaN,NaN,12.755683330234518,11.16078658090244
2023-02-15T09:30:00-05:00,102.22,103.455,102.02,103.43,6005678,11109710.5,59.51608403319022,57.10583360795134,NaN,NaN,82.49291469451167,62.025858984509284,0.05242907485045767,0.8058619805584897,0.753432905708032,1150103110,1146077279.2,65.89249246410911,69.73420874545458,NaN,NaN,13.657463655220534,11.517454734376454
2023-02-16T09:30:00-05:00,102.1,103.14,101.915,102.36,8838672,10693854.6,53.779622327653236,56.997446970807985,NaN,NaN,51.29699395885253,65.06957740828724,-0.007035850487949857,0.7446380925980947,0.7516739430860445,1141264438,1146664606.2,66.31755312421022,70.18295146670701,NaN,NaN,12.784548577002584,11.6984681404659
2023-02-17T09:30:00-05:00,102.29,103.09,101.89,103.03,8778990,10491974,56.600414199428904,57.39534049185306,NaN,NaN,59.39234217101332,70.0160001928542,-0.008033515853604012,0.7416320482690395,0.7496655641226435,1150043428,1147465628,66.92300007135668,70.48401345632757,NaN,NaN,12.858975287498552,11.864254875756279
2023-02-21T09:30:00-05:00,102.26,102.58,100.57,100.67,9805042,10426548.3,45.96037951808891,56.5964119577664,NaN,NaN,-46.99712973778694,43.460850747870424,-0.16568194746023968,0.5425631297973439,0.7082450772575836,1140238386,1145149358.8,63.375493610192756,70.36142120414662,NaN,NaN,9.414856348673505,11.51434080045874
2023-02-22T09:30:00-05:00,100.76,101.25,100,100.42,8867098,10302844.35,44.99543013871275,55.55926966165321,NaN,NaN,-104.96257532019251,8.244509153279616,-0.27821895990302636,0.36047137737880064,0.638690337281827,1131371288,1142604130,59.63465489863505,69.59314378709344,NaN,NaN,6.371480794207585,10.779646513851432
2023-02-23T09:30:00-05:00,100.93,101.5,99.82,100.89,8995627,10166209.65,47.238191824303115,54.50739499687216,NaN,NaN,-100.64721250424519,-28.383516286471757,-0.3099987973802265,0.25119184055654387,0.5611906379367704,1140366915,1140656891,56.86898574859184,68.33864792911434,NaN,NaN,4.540927206774344,9.888400898554705
2023-02-24T09:30:00-05:00,99.85,100.47,99.4,100.31,9288384,9881352.95,44.81004706603321,53.46851120279156,NaN,NaN,-152.41886456188962,-69.1266879906202,-0.35579764756424376,0.11644357848146569,0.47224122604570945,1131078531,1138619709.6,54.045063884021125,66.78628551171396,NaN,NaN,2.277187613543084,8.801084714981616
2023-02-27T09:30:00-05:00,101.52,101.97,100.97,101.2,8677659,9605869.6,49.1310153137333,52.825470868822165,NaN,NaN,-47.50155715639784,-90.50546785610243,-0.3133595912925776,0.08054173692998745,0.3939013282225651,1139756190,1136562262,51.27574518466194,64.94433386918925,NaN,NaN,1.6245449244696528,7.775864744908479
2023-02-28T09:30:00-05:00,101.07,101.6,100.87,100.97,10854248,9645685.6,48.083312895075,52.025143645759,NaN,NaN,-72.13662081361774,-95.53336607126859,-0.2886025981038727,0.03314808059272423,0.3217506786965969,1128901942,1134294973.2,48.33637857836206,62.80098704677506,NaN,NaN,0.7864692909577538,6.777379680058376
2023-03-01T09:30:00-05:00,100.88,101.9,100.695,101.37,10365100,9645563.25,50.077188596078265,51.58350476338601,NaN,NaN,-57.412172598741236,-86.02328552697834,-0.23536264330387657,0.02754737456675116,0.26291001787062773,1139267042,1135874124,50.4662078807787,60.940259593219075,NaN,NaN,0.647186798285333,5.901637839805084
2023-03-02T09:30:00-05:00,100.76,102.755,100.76,102.56,10570469,9340403.6,55.5469045155232,51.85499967222935,NaN,NaN,4.875664815803,-64.9187100629687,-0.11610865288904818,0.11777420175931752,0.2338828546483657,1149837511,1137768243.2,52.97057507343312,59.78665203600942,NaN,NaN,2.1563622635279978,5.3665984717655
2023-03-03T09:30:00-05:00,102.97,103.84,102.39,103.67,12097384,9272280.75,59.95430278145768,52.22298942429442,NaN,NaN,116.58076584342362,-11.118783981906038,0.03342938691022687,0.2756695882861493,0.24224020137592242,1161934895,1143939516,60.05647395243632,59.274701020100515,NaN,NaN,4.8497993132982,5.292770020555886
2023-03-06T09:30:00-05:00,103.74,104.18,103.33,103.48,9714963,9079638.15,58.8782088473005,52.25269691405492,NaN,NaN,140.60532577039066,26.502592603451667,0.1110706957201717,0.38107857102613707,0.2700078753059654,1152219932,1146432264.4,62.513387440287396,58.86929956550382,NaN,NaN,6.725951634362742,5.4975102510997225
2023-03-07T09:30:00-05:00,103.49,103.64,102.07,102.15,11034151,9118300.8,51.86115606250574,51.88801843707747,NaN,NaN,52.00545644887911,51.331008055951045,0.06657315137816705,0.3532243145286742,0.28665116315050715,1141185781,1148889032.2,64.81072161981615,58.82048096649232,NaN,NaN,6.257776730418711,5.606119748145292
2023-03-08T09:30:00-05:00,102.23,102.64,101.65,102.39,11508799,9146434.05,52.95082960899758,51.41907169249229,NaN,NaN,19.938869368998088,66.80121644949891,0.04789597342180668,0.3465211299277655,0.29862515650595883,1152694580,1151574539.8,67.17856259225633,58.91234311850284,NaN,NaN,6.198564414470014,5.690754700477395
2023-03-09T09:30:00-05:00,102.97,103.3,100.73,100.88,11018125,9325856.8,45.90951365088435,50.856921072723075,NaN,NaN,-27.462772050388274,60.33352907626065,-0.06540848686930406,0.21686454791932874,0.2822730347886328,1141676455,1149942328.6,64.34463241606832,58.77142021077842,NaN,NaN,3.923325566914109,5.438264824254069
2023-03-10T09:30:00-05:00,100.72,101.23,98.685,99,27407158,10252088.8,38.96256364241539,49.59707460436497,NaN,NaN,-165.61561561560353,3.8942527844552104,-0.2555473438977191,-0.03716114508351609,0.21838619881420301,1114269297,1140409209,50.85167689225546,57.623468555128326,NaN,NaN,-0.502875263656664,4.5895305259811074
2023-03-13T09:30:00-04:00,97.99,99.36,97.59,98.44,28616509,11297388.45,37.1588459696841,48.96839363662177,NaN,NaN,-202.9685772935319,-64.82052782832929,-0.3990553588684761,-0.28043299977139213,0.11862235909708398,1085652788,1127095780.2,38.6593014241494,55.85802625612523,NaN,NaN,-4.656518729684098,3.268666346600364
2023-03-14T09:30:00-04:00,99.7,100.49,98.32,99.48,15383970,11777516.3,42.48408453177976,48.78901180755513,NaN,NaN,-125.05263157893653,-100.23214543389243,-0.402795348154799,-0.3848718260964148,0.017923522058384225,1101036758,1119065975.6,33.45000597210924,53.98769418994481,NaN,NaN,-6.417901108709378,1.8848709958418295
2023-03-15T09:30:00-04:00,97.67,97.82,95.495,97.03,34251561,13103979.35,34.966696776925474,47.91247644702815,NaN,NaN,-228.67917396830447,-149.95575410135294,-0.540540984928386,-0.6577527091020983,-0.11721172417371227,1066785197,1101884099,25.52442291777784,51.74879684488667,NaN,NaN,-10.722044814871305,0.08388302288281024
2023-03-16T09:30:00-04:00,96.4,98.57,96.13,98.28,24116803,14009535.6,40.729186791135554,47.6209864273926,NaN,NaN,-153.54517337311069,-175.17223436589742,-0.5177005531624346,-0.7643374156267555,-0.24663686246432093,1090902000,1091729208,22.17956683837278,49.472689913054644,NaN,NaN,-12.19206645848183,-1.669824045883567
2023-03-17T09:30:00-04:00,97.85,98.02,96.21,96.67,23170459,14726124.95,36.271217685541004,46.70242945395029,NaN,NaN,-155.93792456264717,-173.23669615530616,-0.5767437921180374,-0.9675666026118677,-0.3908228104938303,1067731541,1082421656.8,19.639232562126125,47.21293901144494,NaN,NaN,-15.012540154945967,-3.5759263471781955
2023-03-20T09:30:00-04:00,96.71,97.79,96.71,97.55,14477060,15011028.45,40.128596024511296,46.13423539176716,NaN,NaN,-120.46399391482531,-156.73577947956483,-0.5237944867097099,-1.0455659188809676,-0.5217714321712578,1082208601,1081732819.4,19.46157578555463,45.15045309767298,NaN,NaN,-15.919945472439368,-5.339357650786934
2023-03-21T09:30:00-04:00,98.69,99.09,98.17,98.68,11495161,15095534.4,44.752901803279826,45.75392919228157,NaN,NaN,-62.142433779918505,-144.15373991976122,-0.3862778646919355,-1.0046187630361771,-0.6183408983442417,1093703762,1080266220.2,19.06611905289762,42.90758960996719,NaN,NaN,-15.078213689503169,-6.730622799174968
2023-03-22T09:30:00-04:00,98.65,99.14,96.75,96.79,14178407,15361099.85,39.287196803735576,44.59252149858245,NaN,NaN,-91.401481481476,-116.69820142239553,-0.3948138748658848,-1.1118582419265977,-0.7170443670607128,1079525355,1082814251.8,22.030432647331835,40.69757943667424,NaN,NaN,-16.266459019758642,-8.092885116401208
2023-03-23T09:30:00-04:00,96.94,98.15,95.91,96.51,15857521,15704194.55,38.536307366486135,43.06266468322734,NaN,NaN,-102.59826782144714,-106.50882031206281,-0.39079907419962523,-1.2055432098102443,-0.8147441356106191,1063667834,1077367418.6,20.317326444057628,37.85906890036148,NaN,NaN,-17.432602889855147,-9.427130512608914
2023-03-24T09:30:00-04:00,95.79,96.98,95.19,96.91,15993229,16039436.8,40.29198285145488,41.73507711209551,NaN,NaN,-104.89961081470761,-96.3011575624749,-0.33484140939677176,-1.2332958973565837,-0.898454487959812,1079661063,1079753323,23.13683345745001,35.046457901587374,NaN,NaN,-17.815140874756043,-10.625417707201361
2023-03-27T09:30:00-04:00,97.69,98.05,97.08,97.72,7668573,15988982.5,43.79323886475481,41.15879731225615,NaN,NaN,-60.34774477362004,-84.27790773423384,-0.2223319434395068,-1.1763694172591954,-0.9540374738196886,1087329636,1080777530,24.3739204880206,32.15811496360198,NaN,NaN,-17.051561574693494,-11.543438259700237
2023-03-28T09:30:00-04:00,97.53,98.61,97.53,98.22,9909054,15941722.8,45.90206873951809,40.65531439300762,NaN,NaN,-40.72606168529665,-79.99463331530947,-0.09955157253890001,-1.0784769394933136,-0.9789253669544136,1097238690,1081484515.6,25.268040597497162,29.164506249690614,NaN,NaN,-15.78925293928299,-12.149983213926344
2023-03-29T09:30:00-04:00,99.11,99.7,98.92,99.65,9387900,15892862.8,51.505987396562695,41.055062517698936,NaN,NaN,3.517104094406075,-61.01091620013305,0.0828073781935812,-0.8754161442124371,-0.9582235224060183,1106626590,1086904762.6,31.91424545418596,26.848050038127585,NaN,NaN,-12.933933173111594,-12.261976065238523
2023-03-30T09:30:00-04:00,100.14,100.34,99.54,99.86,8160225,15772350.6,52.28763331616772,42.00685320868124,NaN,NaN,24.689186019241024,-35.55342543199542,0.21490318638185713,-0.6895945394286969,-0.904497725810554,1114786815,1097128558.8,42.332120130338225,26.23951026941921,NaN,NaN,-10.393342279194357,-11.995028381517928
2023-03-31T09:30:00-04:00,100.45,101.24,100.24,101.18,12006462,15767804.5,56.98136139687292,43.422747167766154,NaN,NaN,67.9430423650846,-0.9848947960369856,0.3789181490444975,-0.43085003950493217,-0.8097681885494297,1126793277,1106555001.6,49.93802955959815,27.04513370766555,NaN,NaN,-6.716743312777607,-11.240987657412168
2023-04-03T09:30:00-04:00,100.96,101.77,100.63,101.36,11174147,15840763.7,57.59399050847017,44.50202616610119,NaN,NaN,93.40275291607294,29.765204741901606,0.48072571612916826,-0.2088610433879694,-0.6895867595171377,1137967424,1116682559.2,56.566105892440994,28.696283701974956,NaN,NaN,-3.550910155260387,-10.14240515710477
2023-04-04T09:30:00-04:00,101.42,101.42,98.7201,99.09,18801870,16229149.65,48.26001862018904,45.45154915490572,NaN,NaN,41.54060002116217,46.218537083193375,0.3807570244263362,-0.21364047898421745,-0.5943975034105536,1119165554,1121067932,59.0917762362229,31.093951796149604,NaN,NaN,-3.520420466747039,-9.196407344196523
2023-04-05T09:30:00-04:00,98.58,99.02,97.5,97.8,16606921,16484055.75,43.90534830070733,45.67841783416085,NaN,NaN,-26.38811720580571,40.237492823151015,0.2212328950441408,-0.3178563846053777,-0.5390892796495185,1102558633,1120254340.6,58.41313085906369,33.682063511913235,NaN,NaN,-4.897089504582472,-8.582219081394516
2023-04-06T09:30:00-04:00,97.83,98.17,97.34,97.77,10886017,16477450.35,43.80635151185261,46.216641678897396,NaN,NaN,-38.46693541536101,27.60626853623062,0.11264911146003143,-0.39827789032447924,-0.5109270017845107,1091672616,1115631500.8,54.57766616982686,36.1776659124633,NaN,NaN,-6.013263609442854,-8.215225442544279
2023-04-10T09:30:00-04:00,97.39,98.68,97.39,98.66,10568933,15635539.1,47.58237312364825,46.749054328835754,NaN,NaN,-6.955148762582878,12.62663031069712,0.10014139170603026,-0.38575026215197283,-0.4858916538580031,1102241549,1110721155.2,50.76474674528411,38.41360669530111,NaN,NaN,-5.833330761271786,-7.874954773791066
2023-04-11T09:30:00-04:00,98.95,99.71,98.87,99.25,9753250,14692376.15,49.98187628042034,47.12255250577436,NaN,NaN,51.43755234234245,4.233590195951004,0.12913442116207408,-0.3244736274054105,-0.4536080485674846,1111994799,1105526630.2,47.022225204187045,40.41047142039322,NaN,NaN,-4.975915290400462,-7.4608062761638365
2023-04-12T09:30:00-04:00,99.79,100.17,99.31,99.58,11277162,14487035.75,51.324038834908706,47.98232693657243,NaN,NaN,73.68515164062345,10.66250051984326,0.16573253764743995,-0.24644237650818468,-0.4121749141556246,1123271961,1106347911.6,47.67898875759094,42.242511142554584,NaN,NaN,-3.882249538458981,-6.949583885063143
2023-04-13T09:30:00-04:00,99.62,100.14,98.56,99.95,12289364,13388925.9,52.851663165343965,49.00485235077657,NaN,NaN,58.33824221417024,27.607772403838453,0.20735381018125476,-0.1529826514290562,-0.36033646161031097,1135561325,1112948450,52.74888899538542,44.559051324792286,NaN,NaN,-2.537191396628314,-6.319242101001025
2023-04-14T09:30:00-04:00,99.61,100.38,99.24,99.83,9254961,12645833.8,52.278616066121074,49.86104043753844,NaN,NaN,66.43638725873443,48.58843693865754,0.21819838718198092,-0.08758847763283484,-0.30578686481481576,1126306364,1119875199.6,57.41267346278565,47.00732561088768,NaN,NaN,-1.5693596045528753,-5.64068745865129
2023-04-17T09:30:00-04:00,100.08,100.645,99.94,100.62,8007231,11887672.4,55.6851409150098,50.710462012556654,NaN,NaN,89.89667371955055,67.95880143508423,0.26676099283275445,0.027664376226127274,-0.23909661660662715,1134313595,1126289608.8,61.22899823640055,49.63983116434339,NaN,NaN,0.21941841149391594,-4.803529477201975
2023-04-18T09:30:00-04:00,101.11,101.7,100.73,101.1,9924810,11660059.9,57.66266106878305,51.55050432178986,NaN,NaN,120.73223849014317,81.81773866464437,0.31602731804125317,0.15593753094493934,-0.16008978709631383,1144238405,1132738330,64.65792792633735,52.45339454497485,NaN,NaN,2.2991100065377172,-3.788866693810591
2023-04-19T09:30:00-04:00,100.74,101.19,100.57,101.02,7734385,11472021.1,57.20448221904067,51.95753966625257,NaN,NaN,96.01255425676764,86.2832191878732,0.326693916937611,0.24827760907569996,-0.07841630786191106,1136504020,1135384741.8,65.98734307272176,54.88718723201312,NaN,NaN,3.9224853297109967,-2.6872449761646497
2023-04-20T09:30:00-04:00,100.43,101.2301,100.43,100.84,9265132,11226357.35,56.12390589888427,52.23155913644661,NaN,NaN,85.03275558883217,91.62212186280559,0.3054814265407658,0.30343547531404624,-0.0020459512267195917,1127238888,1133720254.4,64.34784690760948,56.459739144675346,NaN,NaN,5.035562489731849,-1.5839867667508643
2023-04-21T09:30:00-04:00,101.02,101.17,100.22,100.61,10668592,10966910.9,54.70200717773352,52.068748120793806,NaN,NaN,71.44190715426063,92.62322584191084,0.2615125972195871,0.3248447952977642,0.06333219807817717,1116570296,1131773040.8,62.394785822123275,57.34950744914143,NaN,NaN,5.641864393937458,-0.5517223152239612