time,open,high,low,close,Volume,Volume MA,RSI,RSI-based MA,Upper Bollinger Band,Lower Bollinger Band,CCI,Smoothing Line,Histogram,MACD,Signal,OnBalanceVolume,Smoothing Line,RSI,RSI-based MA,Upper Bollinger Band,Lower Bollinger Band,True Strength Index,Signal
2000-05-26T09:30:00-04:00,45.53125,45.71875,45.28125,45.71875,76800,NaN,NaN,NaN,NaN,NaN,NaN,NaN,NaN,NaN,NaN,NaN,NaN,NaN,NaN,NaN,NaN,NaN,NaN
2000-05-30T09:30:00-04:00,46.375,47.40625,46.375,47.40625,57600,NaN,NaN,NaN,NaN,NaN,NaN,NaN,NaN,NaN,NaN,57600,NaN,NaN,NaN,NaN,NaN,NaN,NaN
2000-05-31T09:30:00-04:00,47.5625,48.1875,47.5625,47.578125,36000,NaN,NaN,NaN,NaN,NaN,NaN,NaN,NaN,NaN,NaN,93600,NaN,NaN,NaN,NaN,NaN,NaN,NaN
2000-06-01T09:30:00-04:00,48.554685,48.65625,48.554685,48.65625,7000,NaN,NaN,NaN,NaN,NaN,NaN,NaN,NaN,NaN,NaN,100600,NaN,NaN,NaN,NaN,NaN,NaN,NaN
2000-06-02T09:30:00-04:00,50.859375,51.1875,50.859375,51.1875,29400,NaN,NaN,NaN,NaN,NaN,NaN,NaN,NaN,NaN,NaN,130000,NaN,NaN,NaN,NaN,NaN,NaN,NaN
2000-06-05T09:30:00-04:00,51.0625,51.5625,50.9375,51,48400,NaN,NaN,NaN,NaN,NaN,NaN,NaN,NaN,NaN,NaN,81600,92680,NaN,NaN,NaN,NaN,NaN,NaN
2000-06-06T09:30:00-04:00,51.804685,52.40625,51.34375,51.5,151800,NaN,NaN,NaN,NaN,NaN,NaN,NaN,NaN,NaN,NaN,233400,127840,NaN,NaN,NaN,NaN,NaN,NaN
2000-06-07T09:30:00-04:00,51.1875,51.5625,50.71875,51.5625,131000,NaN,NaN,NaN,NaN,NaN,NaN,NaN,NaN,NaN,NaN,364400,182000,NaN,NaN,NaN,NaN,NaN,NaN
2000-06-08T09:30:00-04:00,52.125,52.125,51.4375,51.4375,91400,NaN,NaN,NaN,NaN,NaN,NaN,NaN,NaN,NaN,NaN,273000,216480,NaN,NaN,NaN,NaN,NaN,NaN
2000-06-09T09:30:00-04:00,51.9375,52.34375,51.90625,52.34375,41600,NaN,NaN,NaN,NaN,NaN,NaN,NaN,NaN,NaN,NaN,314600,253400,NaN,NaN,NaN,NaN,NaN,NaN
2000-06-12T09:30:00-04:00,52.5,52.5,50.75,50.78906,85200,NaN,NaN,NaN,NaN,NaN,NaN,NaN,NaN,NaN,NaN,229400,282960,NaN,NaN,NaN,NaN,NaN,NaN
2000-06-13T09:30:00-04:00,50.66406,51.4375,50.1875,51.4375,168200,NaN,NaN,NaN,NaN,NaN,NaN,NaN,NaN,NaN,NaN,397600,315800,NaN,NaN,NaN,NaN,NaN,NaN
2000-06-14T09:30:00-04:00,51.859375,51.859375,51.1875,51.1875,43200,NaN,NaN,NaN,NaN,NaN,NaN,NaN,NaN,NaN,NaN,354400,313800,NaN,NaN,NaN,NaN,NaN,NaN
2000-06-15T09:30:00-04:00,50.875,51.25,50.38281,51.25,26800,NaN,NaN,NaN,NaN,NaN,NaN,NaN,NaN,NaN,NaN,381200,335440,NaN,NaN,NaN,NaN,NaN,NaN
2000-06-16T09:30:00-04:00,51.46875,51.5,50.96875,50.96875,30200,NaN,76.12751421336773,NaN,NaN,NaN,NaN,NaN,NaN,NaN,NaN,351000,342720,NaN,NaN,NaN,NaN,NaN,NaN
2000-06-19T09:30:00-04:00,51.25,52.25,51.015625,52.25,59200,NaN,79.01019031425352,NaN,NaN,NaN,NaN,NaN,NaN,NaN,NaN,410200,378880,NaN,NaN,NaN,NaN,NaN,NaN
2000-06-20T09:30:00-04:00,52.328125,52.671875,52.125,52.59375,47000,NaN,79.71782048005338,NaN,NaN,NaN,NaN,NaN,NaN,NaN,NaN,457200,390800,NaN,NaN,NaN,NaN,NaN,NaN
2000-06-21T09:30:00-04:00,52.125,52.9375,52.125,52.84375,66800,NaN,80.23958656869718,NaN,NaN,NaN,NaN,NaN,NaN,NaN,NaN,524000,424720,NaN,NaN,NaN,NaN,NaN,NaN
2000-06-22T09:30:00-04:00,53,53,51.34375,51.34375,139200,NaN,68.80281677824574,NaN,NaN,NaN,NaN,NaN,NaN,NaN,NaN,384800,425440,NaN,NaN,NaN,NaN,NaN,NaN
2000-06-23T09:30:00-04:00,51.75,51.75,50.5,50.90625,235800,78630,65.85451630002225,NaN,NaN,NaN,17.196774542246636,NaN,NaN,NaN,NaN,149000,385040,88.75808675363241,NaN,NaN,NaN,NaN,NaN
2000-06-26T09:30:00-04:00,51.109375,51.53125,50.875,51.53125,93600,79470,67.96634488112473,NaN,NaN,NaN,22.998892941548217,NaN,NaN,NaN,NaN,242600,351520,81.004995942193,NaN,NaN,NaN,NaN,NaN
2000-06-27T09:30:00-04:00,51.609375,52.0625,50.71875,50.71875,112800,82230,62.550293434098755,NaN,NaN,NaN,-2.2620652885407453,NaN,NaN,NaN,NaN,129800,286040,68.43012305085614,NaN,NaN,NaN,NaN,NaN
2000-06-28T09:30:00-04:00,50.9375,52.1875,50.9375,52,170600,88960,67.01416364097066,NaN,NaN,NaN,42.183312681483244,NaN,NaN,NaN,NaN,300400,241320,61.41777178135121,NaN,NaN,NaN,NaN,NaN
2000-06-29T09:30:00-04:00,51.75,51.84375,51.03125,51.1875,212200,99220,61.969681617347064,NaN,NaN,NaN,-28.258192325670084,10.371744510213455,NaN,NaN,NaN,88200,182000,53.57511065960688,NaN,NaN,NaN,NaN,NaN
2000-06-30T09:30:00-04:00,51.21875,51.679685,50.796875,51.679685,1171800,156340,63.74980463560871,NaN,NaN,NaN,-26.410922893641203,1.6502050230358862,NaN,NaN,NaN,1260000,404200,69.35866169434719,NaN,NaN,NaN,NaN,NaN
2000-07-03T09:30:00-04:00,51.5625,52.40625,51.5,52.40625,15800,154710,66.26047556667382,NaN,NaN,NaN,86.62408842990122,14.375244120706487,NaN,0.6212956252043185,NaN,1275800,610840,77.14174844822985,NaN,NaN,NaN,NaN,NaN
2000-07-05T09:30:00-04:00,52.109375,52.125,51.63281,51.8125,138800,154060,62.45374812370541,NaN,NaN,NaN,43.81925685106333,23.5915085486273,NaN,0.5982448452583569,NaN,1137000,812280,81.95393680815441,NaN,NaN,NaN,NaN,NaN
2000-07-06T09:30:00-04:00,51.828125,52.421875,51.34375,52.421875,154600,155240,64.69552645931935,69.02946307239202,NaN,NaN,69.81430268962515,29.117706550255683,NaN,0.6219786234174052,NaN,1291600,1010520,85.24582329210267,NaN,NaN,NaN,NaN,NaN
2000-07-07T09:30:00-04:00,52.429685,52.953125,52.429685,52.75,71800,154260,65.8769701720309,68.29728135515367,NaN,NaN,147.30751082258263,64.23084717990623,NaN,0.6596606020500815,NaN,1363400,1265560,88.22242074857544,NaN,NaN,NaN,NaN,NaN
2000-07-10T09:30:00-04:00,52.71875,53.28125,52.71875,53.09375,44800,154420,67.11840587017025,67.4478681805763,NaN,NaN,171.31359916735087,103.77575159210464,NaN,0.7090876724654223,NaN,1408200,1295200,88.51247952272257,NaN,NaN,NaN,NaN,NaN
2000-07-11T09:30:00-04:00,53,53.296875,52.84375,53.03125,253200,162820,66.64366403525237,66.5139998630905,NaN,NaN,149.46615045690098,116.3441639975046,NaN,0.734746059002056,NaN,1155000,1271040,86.63943121482664,NaN,NaN,NaN,NaN,NaN
2000-07-12T09:30:00-04:00,53.3125,54.09375,53.25,54.09375,35000,156160,70.46789317573892,65.8160217635935,NaN,NaN,197.54670231464524,147.089653090221,NaN,0.8312334437928399,NaN,1190000,1281640,86.77169540483231,NaN,NaN,NaN,NaN,NaN
2000-07-13T09:30:00-04:00,54.140625,54.265625,54,54.265625,102600,159130,71.04617555569618,65.97626167626852,NaN,NaN,190.92638562381785,171.31206967705953,NaN,0.9110670535999503,NaN,1292600,1281840,86.77435578057182,78.8433315072859,NaN,NaN,NaN,NaN
2000-07-14T09:30:00-04:00,54.546875,54.546875,53.875,54.3125,54800,160530,71.2117426997794,66.35892070482261,NaN,NaN,163.57965709351973,174.56649893124694,0.22760648773904935,0.9669715393052343,0.7393650515661849,1347400,1278640,86.47469321851752,78.6802319690634,NaN,NaN,NaN,NaN
2000-07-17T09:30:00-04:00,54.359375,54.59375,54.21875,54.5,46600,161350,71.90382865846695,66.64016954606133,NaN,NaN,152.63649425280627,170.83107794833802,0.22027515580202572,1.014708996318717,0.7944338405166913,1394000,1275800,86.19021298929421,79.05060461528491,NaN,NaN,NaN,NaN
2000-07-18T09:30:00-04:00,54.140625,54.140625,53.5625,53.5625,235400,170160,63.662738481996676,66.71962990662546,NaN,NaN,89.55000601988985,158.8478490609358,0.1370610698118393,0.9657601777814904,0.8286991079696511,1158600,1276520,86.20260549082658,80.32006764671137,NaN,NaN,NaN,NaN
2000-07-19T09:30:00-04:00,53.390625,53.390625,52.625,52.625,35400,169580,56.66823314507543,65.98063487120437,NaN,NaN,24.63608847884332,124.26572629377543,0.010334973664029912,0.8416178250496884,0.8312828513856585,1123200,1263160,84.68404450632758,81.98194426992397,NaN,NaN,NaN,NaN
2000-07-20T09:30:00-04:00,53.125,53.5,53.125,53.5,150400,173760,60.9775433394622,65.90976785135545,NaN,NaN,54.875893202051785,97.0556278094222,-0.021374455943867887,0.8045647814558237,0.8259392373996916,1273600,1259360,84.22954010183189,84.17154637294004,NaN,NaN,34.48126654354619,NaN
2000-07-21T09:30:00-04:00,53.1875,53.1875,52.03125,52.03125,150600,174330,51.68580169270298,65.04805335543362,NaN,NaN,-12.477218581226653,61.84425267447292,-0.14139095190982165,0.6492005475124145,0.7905914994222362,1123000,1214480,78.84713528504305,84.84929448656119,NaN,NaN,29.637536661374696,NaN
2000-07-24T09:30:00-04:00,52.3125,52.3125,51.16406,51.273435,37000,164390,47.65119675381636,63.71881915451524,NaN,NaN,-74.70497888012325,16.37595804788701,-0.2647726738343764,0.4596256571292656,0.724398330963642,1086000,1152880,72.04237976358809,84.48505386622962,NaN,NaN,24.23223912214849,NaN
2000-07-25T09:30:00-04:00,51.679685,51.679685,51.0625,51.375,36800,161550,48.23442209326285,62.70315300948362,NaN,NaN,-90.38960468677473,-19.611964093445913,-0.32834868603931455,0.3139624734144988,0.6423111594538133,1122800,1145720,71.27242512865425,83.72208874626533,NaN,NaN,20.117457505079443,NaN
2000-07-26T09:30:00-04:00,51,51.28125,50.46875,51.28125,15800,156700,47.70607995977744,61.489621116659194,NaN,NaN,-114.98201221335262,-47.535584231885096,-0.3628230523419249,0.18878234402640715,0.5516053963683321,1107000,1142480,70.90314219210255,82.69761152483674,NaN,NaN,16.629037507475715,NaN
2000-07-27T09:30:00-04:00,51.179685,51.179685,49.875,49.875,275000,161920,40.53388144804828,59.679400493517576,NaN,NaN,-148.93801084165815,-88.29836504062709,-0.4601836041705907,-0.02362410884490629,0.4365594953256844,832000,1054160,61.54238910973365,80.7918949792052,NaN,NaN,11.078681392462208,NaN
2000-07-28T09:30:00-04:00,50.16406,50.16406,48.875,49,171600,159890,36.824157528035116,57.515525611936496,NaN,NaN,-187.5979767301578,-123.32251667041332,-0.5569042123489645,-0.2595707701105212,0.29733344223844327,660400,961640,53.564570117919274,78.29561573600496,NaN,NaN,5.105468633625018,NaN
2000-07-31T09:30:00-04:00,49.25,50.09375,48.6875,50.09375,166000,109600,43.7538064262671,55.880535782723264,NaN,NaN,-152.42633782135775,-138.8667884586602,-0.5212431391500587,-0.3542204816991301,0.1670226574509286,826400,909720,49.673090576437126,75.65516283326284,NaN,NaN,2.192118330248274,NaN
2000-08-01T09:30:00-04:00,49.875,50.0625,49.640625,49.921875,263400,121980,42.9564222372887,53.9154307156911,NaN,NaN,-119.96743142184226,-144.78235380567372,-0.4840584173259117,-0.43805036420646104,0.046008053119450665,563000,797760,42.50236483975975,72.49306779290052,NaN,NaN,-0.3694040213289207,NaN
2000-08-02T09:30:00-04:00,49.625,50.28125,49.5,50,388600,134470,43.46080864448679,51.945047364890435,NaN,NaN,-104.07369622646071,-142.60069060829534,-0.430810303621837,-0.49250482640784554,-0.06169452278600858,951600,766680,40.744002305381684,69.20518540181551,NaN,NaN,-2.2780102812227754,NaN
2000-08-03T09:30:00-04:00,49.03125,50.0625,49.03125,50.0625,1079800,180730,43.888258364376696,49.99336991236167,NaN,NaN,-99.34831095754274,-132.68275063147226,-0.37030056836698916,-0.524570233244745,-0.1542696648777559,2031400,1006560,55.9064185632368,67.0217372121526,NaN,NaN,-3.717625502256662,NaN
2000-08-04T09:30:00-04:00,50.5625,50.578125,49.921875,50.21875,570400,205660,45.00760038280118,48.07221074981411,NaN,NaN,-69.20232386039875,-109.00362005752045,-0.301584513832435,-0.5312503071682997,-0.22966579333586468,2601800,1394840,69.50731279827711,65.83010148422281,NaN,NaN,-4.6205244504596,NaN
2000-08-07T09:30:00-04:00,50.40625,51.148435,50.40625,51.148435,88200,207830,51.24022832690118,47.18488859587872,NaN,NaN,-37.76469405404771,-86.07129130405843,-0.18128091955667047,-0.45626694278170277,-0.2749860232250323,2690000,1767560,76.87969712422532,65.16417945803701,NaN,NaN,-3.654017227436996,9.91032493948116
2000-08-08T09:30:00-04:00,51,51.15625,50.90625,50.90625,49600,197650,49.66122846915728,46.684388261884564,NaN,NaN,-30.549938053414195,-68.18779263037283,-0.10932259780501602,-0.41163927048130233,-0.3023166726762863,2640400,2183040,82.08068444122455,64.9782251676725,NaN,NaN,-3.282803712933694,8.025592274850467
2000-08-09T09:30:00-04:00,51.28125,51.28125,50.53906,50.53906,23000,197050,47.28221377641511,45.70615043595263,NaN,NaN,-35.0849361068873,-54.390040606458136,-0.07916668915105246,-0.4012750341151019,-0.32210834496404944,2617400,2516200,84.99544457901956,65.03293263032876,NaN,NaN,-3.6235364472347134,6.3614310288382985
2000-08-10T09:30:00-04:00,50.546875,50.59375,50.09375,50.25,43000,194070,45.43690011603766,45.259800323333685,NaN,NaN,-52.5793832613984,-45.03625506722927,-0.07162603476889512,-0.4116408884251683,-0.3400148536562732,2574400,2624800,85.80593846475975,65.52999000030853,NaN,NaN,-4.41983746799144,4.821249815005479
2000-08-11T09:30:00-04:00,49.75,51.125,49.75,51.125,176000,200130,51.59525949079895,45.54151909026101,NaN,NaN,-29.334060711877225,-37.06260243752496,-0.004204637231798036,-0.34527065019602077,-0.34106601296422273,2750400,2654520,86.0283604168769,66.52898861840058,NaN,NaN,-3.3581613978396443,3.652762498884747
2000-08-14T09:30:00-04:00,50.96875,51.65625,50.9375,51.65625,56800,200640,54.921909254388964,46.01919674462716,NaN,NaN,27.110565360406177,-24.087550554634184,0.0752867702460176,-0.24695755015670073,-0.32224432040271833,2807200,2677960,86.21187461655919,67.59609215325092,NaN,NaN,-1.461439735799894,2.9221621796440838
2000-08-15T09:30:00-04:00,51.546875,51.625,50.90625,50.90625,189200,198330,49.72612830179851,46.16348591191438,NaN,NaN,20.544836916842815,-13.868595560582776,0.07623837964168934,-0.2269463458506067,-0.303184725492296,2618000,2673480,85.97942868717139,68.67296976004157,NaN,NaN,-1.3436351602762981,2.3127625596554577
2000-08-16T09:30:00-04:00,51.125,51.53125,50.9375,51.15625,219400,207530,51.377356890270384,46.938019872073106,NaN,NaN,36.22649621442738,0.3936909036801623,0.09155678136025547,-0.18873874879197672,-0.2802955301522322,2837400,2717480,86.36817667247168,70.44624030023715,NaN,NaN,-0.7625913483749989,1.8734262870796783
2000-08-17T09:30:00-04:00,51.34375,51.84375,51.21875,51.625,358800,217950,54.40149372688327,48.193543886276544,NaN,NaN,86.7989740973228,28.2693623754244,0.12882843178060321,-0.11925999042647817,-0.24808842220708138,3196200,2841840,87.42909444413701,72.86513489496699,NaN,NaN,0.6223848650026056,1.6947060839258108
2000-08-18T09:30:00-04:00,51.8125,51.9375,51.4375,51.546875,52200,213030,53.8008930836762,48.91119293323434,NaN,NaN,104.49981814455724,55.0361381467113,0.1427122007229844,-0.06969817130335088,-0.21241037202633528,3144000,2920560,88.06242846550958,75.60723045847215,NaN,NaN,1.5936381073625143,1.6802678015596255
2000-08-21T09:30:00-04:00,51.875,51.921875,51.40625,51.734375,129200,217640,55.082590747235436,49.777347826801964,NaN,NaN,108.21207803803388,71.25644068223684,0.15783538552214083,-0.01511614012365925,-0.17295152564580007,3273200,3013760,88.7829709760037,78.91298803963242,NaN,NaN,2.7648351598752283,1.8352059956047115
2000-08-22T09:30:00-04:00,51.765625,52.09375,51.65625,51.65625,195600,225580,54.405313060549226,50.559098142234994,NaN,NaN,114.68451105029537,90.08437550892735,0.15563132410981667,0.02158762949147075,-0.13404369461834592,3077600,3105680,89.45876435121365,82.392613900049,NaN,NaN,3.571247245444678,2.0832118884389925
2000-08-23T09:30:00-04:00,51.59375,51.75,51.375,51.578125,153000,232440,53.69431987511586,51.2595311072878,NaN,NaN,83.87201749461383,99.61347976496464,0.14232770572932396,0.04386593754330903,-0.09846176818601493,2924600,3123120,89.58694877036156,84.79836605770076,NaN,NaN,4.0747280734091635,2.367714200577588
2000-08-24T09:30:00-04:00,51.859375,52.625,51.859375,52.34375,276200,232500,59.30682169667424,52.280904058278736,NaN,NaN,136.96122315904455,109.64592957730899,0.17628625794889263,0.12189605425010086,-0.05439020369879177,3200800,3124040,89.5941374285469,86.23313924557718,NaN,NaN,6.096493504631522,2.9003969582995786
2000-08-25T09:30:00-04:00,52.375,52.6875,52.21875,52.5625,208600,234350,60.76986983457735,52.96159273739846,NaN,NaN,145.17226420159824,117.78041878871718,0.2027855827177838,0.19909177469843797,-0.0036938080193458234,3409400,3177120,90.02212925263797,87.17188439760666,NaN,NaN,8.22434370661693,3.6609607794877714
2000-08-28T09:30:00-04:00,52.8125,53.125,52.5625,52.65625,156000,233850,61.41021953452269,53.80080638492456,NaN,NaN,156.840634230315,127.50613002717341,0.21478107249787115,0.2647825326029931,0.050001460105121964,3565400,3235560,90.48608914709635,87.77227044802608,NaN,NaN,10.191392463421838,4.593879591478352
2000-08-29T09:30:00-04:00,52.78125,53.15625,52.625,53.15625,140200,227690,64.71798182568897,55.046218388444125,NaN,NaN,156.02473345862325,135.774174508839,0.2424934125130335,0.3531182257464138,0.11062481323338033,3705600,3361160,91.41051831619804,88.23049000068168,NaN,NaN,12.878291462176955,5.777367001578153
2000-08-30T09:30:00-04:00,53.109375,53.40625,52.921875,53.21875,619000,239210,65.12044634452238,56.452185976193036,NaN,NaN,156.76188416871264,150.35214784365874,0.2501311236547724,0.42328871780184585,0.17315759414707343,4324600,3641160,93.03522427818584,88.74686755878353,NaN,NaN,15.241891167808319,7.129441882468177
2000-08-31T09:30:00-04:00,53.40625,54.15625,53.40625,53.75,151200,192780,68.41817564289302,57.653822844199745,NaN,NaN,184.10479380250334,159.7808619723505,0.2741304953774638,0.5158207133689032,0.24169021799143942,4475800,3896160,94.12509608178259,89.32520582056252,NaN,NaN,18.30948301222335,8.726590615290345
2000-09-01T09:30:00-04:00,54,54.28125,53.742185,54.1875,186600,173590,70.86146858858875,58.792362796642585,NaN,NaN,172.87643988451552,165.32169710893396,0.3005192474186976,0.6173392772648114,0.3168200298461138,4662400,4146760,94.95981511807676,89.95005871352805,NaN,NaN,21.720520912488556,10.582866372032946
2000-09-05T09:30:00-04:00,54.117185,54.28125,53.8125,53.8125,110400,174700,66.1383426206196,59.96466381941553,NaN,NaN,138.60097088009013,161.67376443888898,0.2744854787607431,0.6599268782970427,0.3854413995362996,4552000,4344080,95.50176197919808,90.63022537724426,NaN,NaN,23.34806848515831,12.406466673907998
2000-09-06T09:30:00-04:00,54.0625,54.0625,53.5,53.578125,217600,183100,63.298604971731905,60.81618153951992,NaN,NaN,105.52426218286298,151.57367018373694,0.2253077739389125,0.6670761169599402,0.4417683430210277,4334400,4469840,95.81092296940659,91.30470725559675,NaN,NaN,23.931880868193936,14.052954415948847
2000-09-07T09:30:00-04:00,53.8125,54.40625,53.8125,54.375,213800,192640,68.28466809969359,61.80783685186351,NaN,NaN,121.94389890230917,144.61007313045624,0.22950031867125953,0.7286437413601021,0.4991434226888426,4548200,4514560,95.91835202383321,91.91108279700362,NaN,NaN,25.97391485003874,15.755948763675974
2000-09-08T09:30:00-04:00,54.10156,54.21875,53.4375,53.4375,128600,196920,58.25721425005528,62.12614550660487,NaN,NaN,80.9242562931343,123.97396562858242,0.15571768341473813,0.6937905269572653,0.5380728435425272,4419600,4503320,95.25712578377903,92.42498974830858,NaN,NaN,24.551209340813546,17.012414560409912
2000-09-11T09:30:00-04:00,53.710935,53.91406,53.3125,53.5,314600,203850,58.69271364767714,62.384011428064994,NaN,NaN,65.39677884634216,102.47803342094774,0.10039227535034656,0.6635631877304604,0.5631709123801139,4734200,4517680,95.30168761936801,92.89061236569174,NaN,NaN,23.556201488435917,17.947241264413627
2000-09-12T09:30:00-04:00,53.8125,53.8125,53.25,53.328125,93000,205660,56.9336068569608,62.5646038420944,NaN,NaN,52.094461828888505,85.1767316107074,0.044349669765650135,0.6186079995871765,0.5742583298215264,4641200,4535520,95.36001376137978,93.31213018070362,NaN,NaN,22.211863305942185,18.55647298463199
2000-09-13T09:30:00-04:00,53.09375,53.6875,53.09375,53.59375,81200,200260,58.97980037577961,62.94213816357039,NaN,NaN,46.38134582642985,73.34814833942077,0.018614530712226407,0.5975264932118094,0.578911962499583,4722400,4613120,95.61501430025845,93.74270628998195,NaN,NaN,21.66915863306059,19.001142362978936
2000-09-14T09:30:00-04:00,53.828125,54.109375,53.585935,53.90625,114000,194990,61.308884690382975,63.08514266312101,NaN,NaN,72.37172088322107,63.43371273560316,0.01617362975252301,0.5991289996902367,0.5829553699377137,4836400,4670760,95.79966675589107,94.18595838479226,NaN,NaN,21.877846525874638,19.412100100535465
2000-09-15T09:30:00-04:00,53.625,53.6875,52.8125,52.90625,67000,180400,51.27579865725349,62.406994721883585,NaN,NaN,6.308823218773357,48.510626120730976,-0.05533648472720021,0.5137847640287134,0.5691212487559136,4769400,4740720,96.0188015042973,94.61429211705364,NaN,NaN,18.84147503811317,19.330582234475138
2000-09-18T09:30:00-04:00,53.140625,53.140625,51.50781,51.65625,201400,187860,42.019162229766,61.021919200115256,NaN,NaN,-93.67520757167088,16.69622883712838,-0.18221745869465233,0.34134942538759816,0.5235668840822505,4568000,4707480,93.52226222695317,94.8311616227577,NaN,NaN,12.717453841466591,18.38584960690249
2000-09-19T09:30:00-04:00,51.984375,52.6875,51.63281,52.5,53600,184080,48.7452612029554,59.881010584205725,NaN,NaN,-84.37327510008568,-10.597318548666449,-0.20311896029556975,0.26966818371278833,0.4727871440083581,4621600,4703560,93.21445760676451,94.96001442922673,NaN,NaN,9.970052633956666,17.183592896481656
2000-09-20T09:30:00-04:00,52.3125,52.3125,51.625,51.90625,40400,176320,44.806211072235236,58.429993779042356,NaN,NaN,-119.15861124282027,-43.70530996251647,-0.2477738330693346,0.16306985267168983,0.4108436857410244,4581200,4675320,90.89355701658943,94.80703819625558,NaN,NaN,6.344062591954298,15.635088567263463
2000-09-21T09:30:00-04:00,52,52,50.9375,50.9375,206200,178980,39.23527041322296,56.34550054835164,NaN,NaN,-179.63046561825325,-94.10574726281133,-0.3283428737420505,0.00041509356346125514,0.32875796730551177,4375000,4583040,83.57109803881083,94.05318119318618,NaN,NaN,1.2396290028967625,13.578594343782505
2000-09-22T09:30:00-04:00,50,51.59375,50,51.59375,127600,171550,44.288589800293714,54.447437777759134,NaN,NaN,-177.1630526559941,-130.80012243776483,-0.3227465933047868,-0.07467527432547172,0.24807131897931506,4502600,4529680,79.57887705652107,92.9545427602179,NaN,NaN,-1.0839375401667164,11.48394693178976
2000-09-25T09:30:00-04:00,52.179685,52.179685,51.625,51.65625,113800,166810,44.75975817649249,52.92039603175006,NaN,NaN,-101.24830919148371,-132.3147427617274,-0.30059305828406885,-0.127670003875771,0.17292305440829786,4616400,4539360,79.7676970608938,91.83068098033903,NaN,NaN,-2.7032293584620932,9.45720746175378
2000-09-26T09:30:00-04:00,51.625,51.625,50.65625,50.921875,64800,162250,40.432749129014,51.28712061441307,NaN,NaN,-138.71933431623222,-143.1839546049567,-0.3193926702416807,-0.22631778339380304,0.09307488684787768,4551600,4525360,78.63523686957248,90.6038462589223,NaN,NaN,-5.51901596086462,7.317746972808295
2000-09-27T09:30:00-04:00,51.15625,51.40625,50.5,50.6875,43600,157420,39.13253135615165,49.2048251327315,NaN,NaN,-128.45035497012717,-145.04230335041808,-0.330238622196496,-0.3197233908977424,0.01051523129875366,4508000,4510720,77.39780230114937,89.28094985015919,NaN,NaN,-8.181007289368099,5.103639221068811
2000-09-28T09:30:00-04:00,50.8125,52.15625,50.78125,52.0625,121000,132520,49.41073647490002,48.57293386307755,NaN,NaN,-67.79521284534492,-122.67525279583643,-0.23207157809906065,-0.27957424132507214,-0.0475026632260115,4629000,4561520,78.65310121929528,88.09494809555319,NaN,NaN,-7.050239932107201,3.367370770615095
2000-09-29T09:30:00-04:00,52.015625,52.19531,51.8125,51.8125,130000,131460,47.829313016413955,47.79697667513018,NaN,NaN,-45.41757281358077,-96.32615682735374,-0.1738981443076576,-0.2648753436105835,-0.09097719930292592,4499000,4560800,78.5864822664691,86.90100485606042,NaN,NaN,-6.677424817235892,1.9323999723506686
2000-10-02T09:30:00-04:00,52.203125,52.203125,50.96875,50.96875,169600,130610,42.84520408112683,46.79066219114204,NaN,NaN,-73.68286671571272,-90.81306833219955,-0.18133686702236168,-0.317648283080878,-0.13631141605851632,4329400,4503400,73.25917148923082,85.32237326519262,NaN,NaN,-8.02145796915225,0.5104202664216804
2000-10-03T09:30:00-04:00,51.585935,51.585935,50.22656,50.22656,151000,132640,38.99577006356135,45.36323145455503,NaN,NaN,-109.55230730356209,-84.97966292966552,-0.22261544284184134,-0.414580719610818,-0.19196527676897665,4178400,4428760,66.90761513753964,83.27184475356987,NaN,NaN,-10.43791011242023,-1.0536269305557353
2000-10-04T09:30:00-04:00,50.453125,50.578125,49.8125,50.578125,99800,126750,41.669194156547285,43.96039641642391,NaN,NaN,-122.7641969437583,-83.84243132439174,-0.2126320173328215,-0.4577552984350035,-0.245123281102182,4278200,4382800,63.27006089735261,80.94830147795997,NaN,NaN,-11.516117796010082,-2.548268482763499
2000-10-05T09:30:00-04:00,50.625,50.8125,50.03125,50.0625,408800,136500,38.97164328341918,43.08152817543574,NaN,NaN,-117.56676401200396,-93.79674155772355,-0.22589931867061563,-0.5274974294404515,-0.3015981107698359,3869400,4230880,53.010763840670414,77.8762987877009,NaN,NaN,-13.26760515389362,-4.079602292924945
2000-10-06T09:30:00-04:00,50.15625,50.15625,48.78125,48.84375,185600,139350,33.45820490674511,42.470031223791395,NaN,NaN,-170.26061270673117,-118.76534953635363,-0.29740115592506583,-0.6733495556761682,-0.37594839975110234,3683800,4067840,44.64418107346905,74.38500727673775,NaN,NaN,-16.6931480290981,-5.881537398092538
2000-10-09T09:30:00-04:00,48.875,48.875,48.3125,48.734375,361800,141710,33.006903476353784,41.34586281474842,NaN,NaN,-185.02753477102516,-141.03428314741612,-0.33017946945142873,-0.7886727365653883,-0.45849326711395955,3322000,3866360,36.89473141100324,70.36216969132623,NaN,NaN,-19.515168636610845,-7.8291990035951535
2000-10-10T09:30:00-04:00,48.796875,49.054685,47.5625,47.5625,420400,158080,28.56166113467428,40.18553781920834,NaN,NaN,-192.82646102091988,-157.68911389088765,-0.4040220571526494,-0.9635208385547713,-0.559498781402122,2901600,3611000,29.827774245621328,66.00032806482852,NaN,NaN,-23.50963938408898,-10.069261915094271
2000-10-11T09:30:00-04:00,47.71875,47.8125,47,47.40625,168200,162430,28.01981088354094,39.3844335670882,NaN,NaN,-195.4989982874455,-172.2360741596251,-0.433996323084771,-1.1019941852580857,-0.6679978621733147,2733400,3302040,23.870323276459615,61.735987010374856,NaN,NaN,-26.83198617913468,-12.463936809957186
2000-10-12T09:30:00-04:00,47.84375,47.84375,45.96875,45.96875,161400,164800,23.586468711591735,37.90571063218092,NaN,NaN,-196.65725493588783,-188.05417234440188,-0.5156806906099867,-1.312598725435798,-0.7969180348258114,2572000,3042560,20.218036137768408,57.49592694474966,NaN,NaN,-31.365397056524063,-15.164145416609596
2000-10-13T09:30:00-04:00,46.09375,48.140625,46.0625,47.75,378800,180390,36.90769368493198,37.34484888278375,NaN,NaN,-136.91521872804833,-181.38509354866534,-0.41890547248144405,-1.3205498754276164,-0.9016444029461723,2950800,2895960,18.49615621420213,53.11938831284311,NaN,NaN,-30.530900474415652,-17.35939613915332
2000-10-16T09:30:00-04:00,48,48.53125,47.71875,48.125,1098000,225220,39.30656357933657,37.26440705780679,NaN,NaN,-86.0820604693598,-161.59599868833226,-0.304137179685531,-1.2818158775530861,-0.9776786978675551,4048800,3041320,25.29032552601703,49.309037502589135,NaN,NaN,-29.04872473585916,-19.02930022439701
2000-10-17T09:30:00-04:00,48.125,48.25781,46.57031,46.91406,265800,235830,34.716280019554375,36.94896053376412,NaN,NaN,-107.44321113091826,-144.5193487103319,-0.28462531542772185,-1.3334603421522075,-1.0488350267244857,3783000,3217600,32.62528968796387,46.11100088736161,NaN,NaN,-29.406148231432873,-20.51170708254499
2000-10-18T09:30:00-04:00,45.82031,46.8125,45.625,46.53125,343600,250990,33.388821790202186,35.80453805628571,NaN,NaN,-126.21615883269497,-130.6627808193818,-0.2723431387151696,-1.3892639501184476,-1.116920811403278,3439400,3358800,37.88580569774836,43.19905120725112,NaN,NaN,-30.129689387807453,-21.885704554725343
2000-10-19T09:30:00-04:00,47.28125,48.09375,47.28125,47.96875,150600,248210,42.30956001248799,35.41026998457671,NaN,NaN,-62.56284547697445,-103.84389892759914,-0.14844758536584468,-1.3024802931105839,-1.1540327077447392,3590000,3562400,44.60241420034795,40.771617773956756,NaN,NaN,-27.619503164287373,-22.704818641805634
2000-10-20T09:30:00-04:00,48.34375,49.03125,48.32031,48.578125,264800,255070,45.633451990007885,35.609430549496786,NaN,NaN,-25.264827102241696,-81.51382060243782,-0.013600400259389911,-1.1710332080689767,-1.1574328078095868,3854800,3743200,49.79421776745484,39.09554965097276,NaN,NaN,-24.477958900639933,-22.958124393067678
2000-10-23T09:30:00-04:00,48.84375,49.125,48.66406,49.0625,143200,256540,48.18879112243704,36.266074910845056,NaN,NaN,-7.748004456278663,-65.84700939982159,0.11309593328244505,-1.0160628912065306,-1.1291588244889756,3998000,3733040,49.51339643401284,37.8531054578637,NaN,NaN,-21.116236737988352,-22.694997585199204
2000-10-24T09:30:00-04:00,49.21875,49.53125,48.34375,48.34375,73800,256990,44.82219708850988,36.49128940598524,NaN,NaN,-12.694582666471954,-46.89728370693234,0.15100344452224634,-0.9404045188361678,-1.0914079633584142,3924200,3761280,50.35152902527336,36.93035318128661,NaN,NaN,-19.40332620781686,-22.224758817001725
2000-10-25T09:30:00-04:00,48.25,48.5,47.265625,47.265625,33000,256460,40.276764362141115,36.584512340179664,NaN,NaN,-57.30057332372243,-33.114166605137825,0.10799402736068986,-0.956415429157552,-1.0644094565182418,3891200,3851640,53.03798372540187,36.93229745876742,NaN,NaN,-19.423075880004294,-21.824518397430662
2000-10-26T09:30:00-04:00,47.710935,48,46.84375,48,105800,255700,44.41196748387699,37.36692395283194,NaN,NaN,-55.80107852906696,-31.761813215556334,0.1319454472520878,-0.8994776474531321,-1.0314230947052199,3997000,3933040,55.38023655979535,37.69915856493359,NaN,NaN,-18.09727088381854,-21.292054466914646
2000-10-27T09:30:00-04:00,47.625,48.25,47.625,48.03125,138800,256140,44.58779053279881,38.19413017114944,NaN,NaN,-29.66284296856631,-32.641416388821256,0.15143852431682636,-0.842124939309187,-0.9935634636260133,4135800,3989240,56.97573750944995,39.13351614339406,NaN,NaN,-17.001340705186827,-20.679095358096387
2000-10-30T09:30:00-05:00,47.9375,48.53125,47.53125,48.25,73600,251340,45.87826361161771,39.431030348073975,NaN,NaN,-13.261502079310976,-33.74411591342771,0.17873599209579205,-0.7701434735062733,-0.9488794656020654,4209400,4031520,58.18707104437595,41.15918020044796,NaN,NaN,-15.728986489534421,-19.97193694830182
2000-10-31T09:30:00-05:00,48.4375,49.679685,48.4375,49.5,285000,258040,52.662424341261506,41.19121702362544,NaN,NaN,79.14973487129814,-15.375252405873699,0.2748987127417679,-0.6052560746748554,-0.8801547874166233,4494400,4145560,61.3480972587334,43.83616405632466,NaN,NaN,-12.48011138526013,-18.90167615358158
2000-11-01T09:30:00-05:00,49.34375,49.71875,49.28125,49.53125,528200,279460,52.82164225109371,43.27944370501844,NaN,NaN,113.3298282181309,18.75082790249697,0.3307795034750951,-0.46668040807275446,-0.7974599115478496,5022600,4371840,66.72368951406625,47.15799644034593,NaN,NaN,-9.832484705639345,-17.606077375304118
2000-11-02T09:30:00-05:00,49.890625,50.8125,49.875,50.71875,211800,269610,58.529734716017096,44.8238752072388,NaN,NaN,191.43071749773398,68.19718710785716,0.4315182579319149,-0.2580620891329559,-0.6895803470648708,5234400,4619320,71.40737839617455,50.93736945334397,NaN,NaN,-5.682626468866562,-15.902727245813038
2000-11-03T09:30:00-05:00,50.796875,50.8125,50.375,50.65625,224200,271540,58.13108843452782,46.16848412546675,NaN,NaN,179.6431723628172,110.05839017413386,0.47433662586684755,-0.09665956473131132,-0.5709961905981589,5010200,4794200,74.1736834006613,54.429037872961416,NaN,NaN,-2.457781155419359,-13.982020661471084
2000-11-06T09:30:00-05:00,51.09375,51.09375,50.21875,50.265625,68200,256860,55.5829812109516,47.65896278199512,NaN,NaN,146.83105120043885,142.07690083008384,0.4565857279741069,-0.0002640306305252693,-0.4568497586046322,4942000,4940720,76.2471772976046,57.54488698793575,NaN,NaN,-0.45447773614860293,-12.049514529282158
2000-11-07T09:30:00-05:00,50.296875,50.6875,50.0625,50.6875,79400,239810,57.73760659290976,49.39816169647423,NaN,NaN,122.58807617618575,150.76456909106136,0.45261291970176576,0.108916391022575,-0.34369652867919076,5021400,5046120,77.63802275445613,60.384331063414876,NaN,NaN,1.861796147723776,-10.062184432567024
2000-11-08T09:30:00-05:00,50.71875,50.75,49.78125,49.78125,192600,241030,51.9120254893883,50.0840520876814,NaN,NaN,89.19254222634014,145.9371118927032,0.3716947810959156,0.12092194769070375,-0.25077283340521184,4828800,5007360,75.87843926041238,62.618332853419474,NaN,NaN,2.2291104013634833,-8.306285170576952
2000-11-09T09:30:00-05:00,49.375,49.6875,48.53125,49.25,249000,245410,48.80341508595937,50.310478023106505,NaN,NaN,27.259935854707944,113.10295556409801,0.2698751189917664,0.08657106533449621,-0.1833040536572702,4579800,4876440,70.09938794787155,64.06870215202068,NaN,NaN,1.629850892841285,-6.886837161517205
2000-11-10T09:30:00-05:00,49.375,49.375,48,48,189000,235920,42.37371627770093,49.89511553419678,NaN,NaN,-21.876781048725082,72.79896488178954,0.11380829596995162,-0.04104368369483069,-0.1548519796647823,4390800,4752560,65.05079179686882,65.17851610651039,NaN,NaN,-0.934867251617175,-6.036555745817201
2000-11-13T09:30:00-05:00,47.5,47.890625,46.3125,47.515625,160800,189060,40.16545962608235,49.562491429737676,NaN,NaN,-96.68543201719172,24.095668238263407,-0.019477309089076078,-0.1791986160261274,-0.15972130693705133,4230000,4610160,59.72587976676826,65.84811258804574,NaN,NaN,-3.750015591093176,-5.709907152285197
2000-11-14T09:30:00-05:00,48.4375,48.8125,48.375,48.65625,129600,182250,47.1500852613996,50.053442922541855,NaN,NaN,-13.31317294271309,-3.084581585516365,-0.027748939982376264,-0.19440748191502166,-0.1666585419326454,4359600,4477800,55.20262516240104,66.00272983354567,NaN,NaN,-4.030962891943834,-5.470057972236431
2000-11-15T09:30:00-05:00,48.71875,49.4375,48.5625,49.28125,542200,192180,50.55594728183029,50.49229862239566,NaN,NaN,11.290413856070666,-18.66500725957026,0.00992664130917334,-0.15425024029617873,-0.16417688160535207,4901800,4492400,55.602047365230305,66.01857346250532,NaN,NaN,-3.193608729531033,-5.144850937564231
2000-11-16T09:30:00-05:00,48.640625,49.242185,47.85156,47.85156,165400,192920,43.629513666580614,50.42385027480865,NaN,NaN,-52.36767351892132,-34.590529134296105,-0.056722111667492636,-0.23507952118971787,-0.17835740952222523,4736400,4523720,56.498116017808506,65.98445764167379,NaN,NaN,-4.759278047238307,-5.089769096089099
2000-11-17T09:30:00-05:00,48.5,48.898435,48.03125,48.15625,215400,190450,45.3479938831174,50.38597386563005,NaN,NaN,-46.81978084101331,-39.57912909275375,-0.0744521375641134,-0.271422581477367,-0.19697044391325358,4951800,4635920,59.640638643909355,66.08828389878332,NaN,NaN,-5.4633424708608995,-5.143136721056499
2000-11-20T09:30:00-05:00,47.6875,47.84375,46.875,46.90625,79800,187280,39.96516186539215,49.47902654592509,NaN,NaN,-119.31589993895717,-44.10522267710685,-0.1596384080642718,-0.3965184539935933,-0.23688004592932152,4872000,4764320,62.940019039180996,66.2019925973867,NaN,NaN,-7.862676560694035,-5.53164241243329
2000-11-21T09:30:00-05:00,47.0625,47.0625,46.4375,46.63281,84400,187810,38.87800202457993,48.48305224403125,NaN,NaN,-134.4959359306719,-68.3417752746986,-0.21995371477275144,-0.5118221893952608,-0.29186847462250937,4787600,4849920,64.99457012225521,66.0784840694002,NaN,NaN,-10.120917274843634,-6.187253107063339
2000-11-22T09:30:00-05:00,46.28125,46.5,45.46875,45.65625,123400,192330,35.1956724042975,46.81633350747985,NaN,NaN,-169.7017999265145,-104.54021803121563,-0.30588871193871936,-0.6742293645459085,-0.3683406526071892,4664200,4802400,62.90952476454831,65.47149452428405,NaN,NaN,-13.247780314122936,-7.1958998509289955
2000-11-24T09:30:00-05:00,46.210935,47.09375,46.1875,46.9375,82200,191150,42.84452345259769,45.72443600877055,NaN,NaN,-110.81967868079656,-116.2306190635907,-0.25859143840167914,-0.6915799506092881,-0.432988512207609,4746400,4804400,62.96337753530899,64.6707583910446,NaN,NaN,-13.45089605247517,-8.089470736864163
2000-11-27T09:30:00-05:00,47.90625,48.054685,47.0625,47.07031,235600,195990,43.58779389152254,44.867636914525626,NaN,NaN,-69.23768944831603,-120.71420078505123,-0.20296753559882086,-0.686697931706135,-0.48373039610731416,4982000,4810440,63.13744703892638,63.7343490868533,NaN,NaN,-13.379259505338739,-8.845154846646246
2000-11-28T09:30:00-05:00,46.875,47.21875,45.5,45.65625,171000,200860,37.93174021830486,43.45293217348241,NaN,NaN,-125.48290057605378,-121.94760091247056,-0.24329558534471218,-0.7878498777882044,-0.5445542924434922,4811000,4798240,62.49849472210875,62.65295422739991,NaN,NaN,-15.166721439604796,-9.748235788497468
2000-11-29T09:30:00-05:00,46,46,45.0625,45.53125,526800,212950,37.46888384456033,42.421279198851835,NaN,NaN,-135.059684762712,-122.06035067887858,-0.2588310794698836,-0.8680931417808466,-0.609262062310963,4284200,4697560,57.34126190270828,61.32887013042104,NaN,NaN,-16.721872189403157,-10.744469560055423
2000-11-30T09:30:00-05:00,45,45.28125,43.96875,44.5625,214600,197270,34.005656293236655,41.364296427943074,NaN,NaN,-151.49734613345632,-118.41945992026695,-0.3112689092302714,-0.9983481988488023,-0.6870792896185309,4069600,4578640,51.894199230908356,60.02849950778081,NaN,NaN,-19.154552747483386,-11.945910015402275
2000-12-01T09:30:00-05:00,45.1875,46.25,45.125,45.5625,309200,202140,40.15477328723947,41.20580050005297,NaN,NaN,-95.45414913858323,-115.34635401182427,-0.2577370599159392,-1.009250614513455,-0.7515135545975158,4378800,4505120,48.8073485468846,58.86825356135337,NaN,NaN,-19.28595227882284,-12.994487481605212
2000-12-04T09:30:00-05:00,45.734375,45.734375,45,45.0625,528200,217340,38.23638062064947,41.06800914252206,NaN,NaN,-102.8261589435977,-122.06404791088062,-0.23573075756175377,-1.046177001549708,-0.8104462439879543,3850600,4278840,40.769225904897155,57.514206856934,NaN,NaN,-19.98769485860727,-13.99351710689122
2000-12-05T09:30:00-05:00,45.75,47.25,45.75,47.25,392400,233550,49.584569340064654,41.241900862426704,NaN,NaN,-31.235651232434044,-103.21459804215667,-0.06259041443406643,-0.8886842620305373,-0.8260938475964709,4243000,4165240,37.435922844369685,56.24515669136034,NaN,NaN,-16.72320918677403,-14.38347311830305
2000-12-06T09:30:00-05:00,47.09375,47.53125,46.15625,46.15625,310800,245120,45.120579775473395,40.85366032625836,NaN,NaN,-31.880913433104787,-82.57884377623523,-0.013057538576558558,-0.8424157708171691,-0.8293582322406106,3932200,4094840,35.49889365615836,54.80921714071234,NaN,NaN,-15.546349211608593,-14.549598274489556
2000-12-07T09:30:00-05:00,45.71875,46.40625,45.71875,46.03125,236200,247300,44.62610714355212,40.924845574613464,NaN,NaN,-56.960339514682055,-63.67144245248037,0.018257098863985854,-0.8065368586606283,-0.8247939575246142,3696000,4020120,33.51664967033385,53.16768383017843,NaN,NaN,-14.79195396581151,-14.584220516106978
2000-12-08T09:30:00-05:00,46.96875,47.875,46.65625,46.65625,359600,252830,47.71162068351471,41.09367606035613,NaN,NaN,12.195630781046837,-42.14148646855436,0.08433296861299644,-0.7193777467583686,-0.8037107153713651,4055600,3955480,31.85925087688304,51.18329898967655,NaN,NaN,-13.19835731326302,-14.38624005855784
2000-12-11T09:30:00-05:00,47.96875,48.78125,47.78125,48.78125,250800,255920,56.572059568237705,42.27988303913081,NaN,NaN,106.52811331276794,-0.2706320172812198,0.2642669828907448,-0.47337698675793405,-0.7376439696486788,4306400,4046640,36.619296607835444,49.30324738743759,NaN,NaN,-8.676332188786747,-13.570538934304826
2000-12-12T09:30:00-05:00,48.78125,48.78125,47.71875,47.71875,323200,264040,51.84180159265189,43.20586872256452,NaN,NaN,74.67611680265705,20.911721589737,0.30211151667647784,-0.3600045738030815,-0.6621160904795593,3983200,3994680,35.11362787144081,47.16889436952228,NaN,NaN,-6.549093495382255,-12.567475300173031
2000-12-13T09:30:00-05:00,47.890625,47.890625,46.59375,46.617185,525400,283830,47.41523858704449,44.07869487847502,NaN,NaN,13.393981917893997,29.966700659936755,0.2457316335298929,-0.35495154856719324,-0.6006831820970862,3457800,3899800,32.48688410149765,44.9958486078758,NaN,NaN,-6.286437964975762,-11.670184252287708
2000-12-14T09:30:00-05:00,46.5,46.84375,45.875,45.875,593800,286410,44.64902763000756,44.207588034004296,NaN,NaN,-39.92138607594346,33.37449134768447,0.1556239578418912,-0.4061532347947221,-0.5617771926366133,2864000,3733400,28.46510568933327,42.53168633316325,NaN,NaN,-6.98759839884347,-11.001243416081389
2000-12-15T09:30:00-05:00,45.34375,45.703125,45,45.625,389000,297590,43.72369738794696,44.21729542660604,NaN,NaN,-89.7906110680233,12.977242977870446,0.08015534684697756,-0.4615830090778914,-0.541738355924869,2475000,3417280,22.7125660760516,39.64419483581504,NaN,NaN,-7.833368746245757,-10.548689891819155
2000-12-18T09:30:00-05:00,45.84375,46.46875,45.8125,46.3125,239600,298800,46.978002109354186,44.86345699025242,NaN,NaN,-22.14555760830885,-12.757491206344913,0.07746477687003783,-0.44490738483732173,-0.5223721617073596,2714600,3098920,18.62940118211597,36.51068815438699,NaN,NaN,-7.54216203755599,-10.119185912638702
2000-12-19T09:30:00-05:00,46.25,46.75,45.5,45.5,453800,317500,43.757521246023806,45.312645376071245,NaN,NaN,-42.277567130685405,-36.14822799301341,0.024628063559862468,-0.49158708225753145,-0.5162151458173939,2260800,2754440,15.402705999628509,33.51507701845273,NaN,NaN,-8.282502771710396,-9.8568026067918
2000-12-20T09:30:00-05:00,44.734375,45,43.90625,44.0625,261400,326350,38.70238283258363,45.648125843167456,NaN,NaN,-161.82696178537935,-71.19241673366807,-0.09681166530374175,-0.6372297274470711,-0.5404180621433293,1999400,2462760,13.301841108200108,30.758480009687855,NaN,NaN,-10.554763694268855,-9.956511333574237
2000-12-21T09:30:00-05:00,44.0625,44.953125,43.75,44.40625,404600,340410,40.47335320165962,45.67088155134032,NaN,NaN,-140.7564190652399,-91.35942333152737,-0.1409884969548686,-0.716653683336915,-0.5756651863820464,2404000,2370760,12.712848520745865,28.180301436392234,NaN,NaN,-11.852678383035268,-10.2273923406401
2000-12-22T09:30:00-05:00,45.125,46.34375,45.0625,46.25,885600,380580,48.98661274036871,46.43875527417742,NaN,NaN,-20.61092745584906,-77.52348660909252,-0.038374781920271106,-0.6236336637823854,-0.5852588818621143,3289600,2533680,19.50977355526122,26.66176912570395,NaN,NaN,-10.253162526593524,-10.231073795776302
2000-12-26T09:30:00-05:00,46.25,46.609375,46.015625,46.515625,514000,394500,50.09397328851754,46.475141270495484,NaN,NaN,23.916739904688605,-68.31102710649303,0.05024043664641109,-0.5224583360541004,-0.5726987727005115,3803600,2751480,27.623626542953687,25.960890818459948,NaN,NaN,-8.634490986862502,-10.002990537360045
2000-12-27T09:30:00-05:00,46.5,47.75,46.1875,47.75,741200,423010,54.98423776168912,47.17968826951089,NaN,NaN,84.79541892782385,-42.89642989479118,0.18714516634161593,-0.33876731477349153,-0.5259124811151075,4544800,3208280,41.0465248328689,26.35715018822498,NaN,NaN,-5.677182259784344,-9.385017926277802
2000-12-28T09:30:00-05:00,47.71875,49.375,47.71875,49.28125,1201000,456720,60.19499354092313,48.291751583608814,NaN,NaN,172.85566804916675,24.04009607211804,0.3656593811901308,-0.06883825462744397,-0.4344976358175748,5745800,3957560,55.59415743739797,27.934115028729565,NaN,NaN,-1.3723628025851107,-8.240352908607418
2000-12-29T09:30:00-05:00,49.46875,49.609375,47.8125,47.875,1803800,536180,54.01163344045272,48.74175249481868,NaN,NaN,129.94700956902676,78.18078179897138,0.37259780594052627,0.03124962160808309,-0.3413481843324432,3942000,4265160,59.96213771932932,29.941464088904297,NaN,NaN,0.24068935449617435,-7.028775442449763
2001-01-02T09:30:00-05:00,47.875,47.875,45.84375,46.203125,826000,562020,47.733719021783465,48.11044245578622,NaN,NaN,5.97110486951434,83.49718826404406,0.2538313330221432,-0.02405901805476418,-0.2778903510769074,3116000,4230440,59.25364773628023,31.55820345522178,NaN,NaN,-0.5333539249777624,-6.100858082810905
2001-01-03T09:30:00-05:00,45.75,48.75,45.71875,48.117185,1409800,606100,54.284960476009296,48.28495380459747,NaN,NaN,61.44482786745114,91.00280585659657,0.29076886166543126,0.08557072600488169,-0.20519813566054956,4525800,4374880,61.30214750082487,33.428812000177786,NaN,NaN,1.1179125605819962,-5.069605133754776
2001-01-04T09:30:00-05:00,47.9375,48.28125,47.3125,47.5,506600,611810,52.02071842689385,48.613916650301,NaN,NaN,66.43939975158057,87.3316020213479,0.261161452209567,0.1212536796014092,-0.1399077726081578,4019200,4269760,58.978226051417494,35.32105071088634,NaN,NaN,1.6530471256098245,-4.109226239559833
2001-01-05T09:30:00-05:00,47.4375,47.4375,45.8125,46.03125,263200,609430,46.99694385656106,48.781624952197674,NaN,NaN,-18.744154966312554,49.01163741825205,0.1364569054044437,0.030663359147396818,-0.10579354625704687,3756000,3871800,51.0830577140684,36.936618712653136,NaN,NaN,0.3931021699613306,-3.4660364667710954
2001-01-08T09:30:00-05:00,45.875,46.25,45.34375,46.1875,423400,618790,47.57695042073935,49.056857311682855,NaN,NaN,-51.573342232422,12.707567057962295,0.06207722446841324,-0.028197015671530323,-0.09027424013994356,4179400,3919280,51.91019701761464,39.02216377990764,NaN,NaN,-0.4050733808814432,-3.0287560259297166
2001-01-09T09:30:00-05:00,46.1875,46.5625,45.84375,46.117185,327600,617190,47.32596751857856,49.08171198377031,NaN,NaN,-32.13222853893202,5.086900376273024,0.008538964731379745,-0.07960053422571889,-0.08813949895709863,3851800,4066440,54.479358944188725,41.58287504862712,NaN,NaN,-1.113914190809027,-2.7552071923410466
2001-01-10T09:30:00-05:00,45.6875,47.59375,45.6875,47.59375,1021800,655740,52.94015948829542,49.73761471536114,NaN,NaN,27.455733042406443,-1.7109185887359175,0.06956907385804308,-0.0011781566345447914,-0.07074723049258787,4873600,4136000,55.68452898420727,44.46014811895418,NaN,NaN,-0.01392684783365922,-2.363595714554277
2001-01-11T09:30:00-05:00,47.25,48.4375,47.25,48.242185,431200,661140,55.19846229202939,50.915906105321554,NaN,NaN,102.56406499483188,5.514014459914347,0.1462012339334097,0.11200431192417426,-0.03419692200923544,5304800,4393120,59.90966427554164,47.78927834519286,NaN,NaN,1.5817938895415318,-1.799968628254876
2001-01-12T09:30:00-05:00,48.0625,48.72656,47.8125,48.375,1014200,685580,55.66772613385784,52.00121845762143,NaN,NaN,113.24896517334795,31.912638487846444,0.19535638681841097,0.20999856151377827,0.0146421746953673,6319000,4905720,66.72165952961379,51.647050560112,NaN,NaN,3.010313856834248,-1.1127854160992867
2001-01-16T09:30:00-05:00,48.25,49.34375,48.03125,49.34375,445200,678150,59.03792402463209,52.71916926364024,NaN,NaN,130.97069718259837,68.42144637085052,0.27761485165663696,0.3616607392661635,0.08404588760952654,6764200,5422680,71.90617866702581,55.38965092523804,NaN,NaN,5.236356301185105,-0.2057651707729451
2001-01-17T09:30:00-05:00,50.09375,50.1875,48.96875,49.3125,1089600,713180,58.88241914232019,53.34691539605471,NaN,NaN,144.90143060480503,103.82817819959791,0.3118593022366272,0.4738700154053106,0.16201071316868337,5674600,5787240,74.87845953806166,58.76499613917432,NaN,NaN,7.00881196602323,0.8248887059122227
2001-01-18T09:30:00-05:00,49.4375,49.5,48.765625,49.5,916200,747010,59.57051211897478,53.67450642157512,NaN,NaN,115.10407326278141,121.35784624367292,0.32746367170757956,0.5713403028031578,0.24387663109557828,6590800,6130680,77.31353489231198,61.35549685770597,NaN,NaN,8.678651016802213,1.9468547503250786
2001-01-19T09:30:00-05:00,49.90625,49.90625,48.390625,48.625,590800,753860,54.94913024248311,53.29980190025797,NaN,NaN,90.00278802015342,118.84559084873722,0.2620141688719197,0.5713943421854779,0.3093801733135582,6000000,6269720,78.2334125103539,62.97258650577425,NaN,NaN,8.904809475647228,2.940848282513957
2001-01-22T09:30:00-05:00,48.5,49.09375,48.265625,48.96875,237600,752670,56.380783100976366,53.46902687600966,NaN,NaN,73.20333470102895,110.83646475427342,0.22637323472464882,0.5923467167193692,0.3659734819947204,6237600,6253440,77.8354519837178,64.24925181037342,NaN,NaN,9.480195090470403,3.875040683650592
2001-01-23T09:30:00-05:00,49,50.1875,48.875,50.1875,3197400,892310,61.10068627521094,54.42381025125447,NaN,NaN,120.73880487222429,108.79008629219861,0.2666085960530904,0.6992342270610834,0.432625631007993,9435000,6787600,81.21237560314256,65.81773237229217,NaN,NaN,11.341579611620778,4.941689101932047
2001-01-24T09:30:00-05:00,50.25,50.40625,49.8125,50,938800,894970,60.02457873961555,54.833782984369215,NaN,NaN,127.65043023365166,105.33988621796793,0.26194130062760995,0.7600522567925054,0.4981109561648955,8496200,7351920,83.9879237765639,67.43814496341638,NaN,NaN,12.597713003926502,6.035406802216969
2001-01-25T09:30:00-05:00,50.023435,50.15625,49.609375,49.8125,772000,907870,58.90729532814949,55.3256813344589,NaN,NaN,104.33490752727386,103.18605307086641,0.2287775399869174,0.7840828811485423,0.5553053411616249,7724200,7578600,84.94974260147704,69.29325328842063,NaN,NaN,13.359442080487009,7.081697556255547
2001-01-26T09:30:00-05:00,49.53125,50,49.171875,49.8125,435200,892570,58.90729532814949,56.17642072528663,NaN,NaN,84.395437695717,102.06458300597913,0.19093562782615192,0.7939748759443148,0.6030392481181629,7724200,7923440,86.29812971026058,71.80861557386294,NaN,NaN,13.997191180027798,8.06962521679444
2001-01-29T09:30:00-05:00,49.695,50.824995,49.695,50.824995,596800,862360,63.197451533019624,57.29217080473523,NaN,NaN,119.5149058110295,111.32689722797925,0.21632516109866795,0.8734456994914979,0.6571205383928299,8321000,8340120,87.72876413312132,74.36708465354198,NaN,NaN,15.74102597284277,9.16553961051563
2001-01-30T09:30:00-05:00,51,51.155,50.425005,51.155,1381400,841240,64.49842464087402,58.51877488489915,NaN,NaN,126.80260331677806,112.53965691689,0.23596801190459604,0.952080553273575,0.716112541368979,9702400,8393600,87.90334139163724,76.75451197121687,NaN,NaN,17.584818436326465,10.368293728488606
2001-01-31T09:30:00-05:00,51.225,51.525,50.449995,50.449995,922400,846060,59.64735017258838,58.99785993377723,NaN,NaN,112.0767844335936,109.42492775687838,0.18438950371621554,0.9465994210142483,0.7622099172980328,8780000,8450360,88.09689238168379,79.06968078532235,NaN,NaN,17.905160348859912,11.444988959970221
2001-02-01T09:30:00-05:00,50.475,50.82,50.25,50.82,702800,810710,61.29278555537103,59.433168738301625,NaN,NaN,94.44381391803083,107.44670903502978,0.15905902392939075,0.9610336972097713,0.8019746732803805,9482800,8802080,89.24523207616598,81.16507848536693,NaN,NaN,18.622610450527542,12.470363458621266
2001-02-02T09:30:00-05:00,50.9,50.9,49.685,49.685,858600,828310,54.01652315978996,59.315225668725354,NaN,NaN,60.65154707795811,102.69793091147798,0.05509973461913931,0.8708493415543046,0.8157496069351653,8624200,8982080,89.78819794327897,82.81268837205731,NaN,NaN,17.179451691831098,13.143090349079813
2001-02-05T09:30:00-05:00,49.5,49.995005,49.455,49.785005,541600,842230,54.52873144535169,58.993140484491036,NaN,NaN,36.61092833565907,86.11713541640391,-0.01400330101459546,0.798245480666921,0.8122487816815165,9165800,9151040,90.28405077906692,84.12539352291739,NaN,NaN,16.127989715483597,13.569504544280354
2001-02-06T09:30:00-05:00,49.875,50.745005,49.875,50.574995,424800,842300,58.46465934088481,58.96330049867422,NaN,NaN,72.51187654362887,75.25899006177407,-0.013571469681640913,0.7952844445794653,0.8088559142611063,9590600,9128680,89.66355483338987,85.18147175829797,NaN,NaN,16.3014466345172,13.959781985742762
2001-02-07T09:30:00-05:00,50.025,50.800005,50.025,50.699995,406600,846250,59.06838830452162,58.927434511927565,NaN,NaN,77.97716905443818,68.43906698594299,-0.011986344297722717,0.7938729838889529,0.8058593281866756,9997200,9372120,90.43436353234978,86.11867380401496,NaN,NaN,16.610378956239604,14.338438695813739
2001-02-08T09:30:00-05:00,50.824995,50.9,49.875,49.94,2393800,914850,53.93525679468285,58.85501497994183,NaN,NaN,50.48289497907884,59.646883198152594,-0.06621244552466521,0.7230937712808441,0.7893062168055093,7603400,8996240,80.45770710961624,86.27755198967655,NaN,NaN,15.4291304995537,14.494251810633733
2001-02-09T09:30:00-05:00,49.875,49.975,49.125,49.300005,985000,942540,49.99516949773954,58.398899722567776,NaN,NaN,-39.880004798965444,39.54057282276788,-0.1447682893025919,0.6083458551772694,0.7531141444798612,6618400,8595080,71.40398671423753,85.81816161328511,NaN,NaN,13.255249587568848,14.317251493053035
2001-02-12T09:30:00-05:00,49.324995,50.449995,49.254995,50.4,443200,913990,55.95130963652615,58.03108710551886,NaN,NaN,17.386264653026945,35.695640086241454,-0.12308346414678384,0.5992598142963814,0.7223432784431653,7061600,8174240,63.35034206780661,84.54230207504682,NaN,NaN,13.07709372003411,14.140086096907474
2001-02-13T09:30:00-05:00,50.824995,51.25,49.925005,49.925005,913000,937380,53.01478939493456,57.530387866613076,NaN,NaN,54.60317637014135,32.11390005154398,-0.1399381342790913,0.5474206105943011,0.6873587448733924,6148600,7485840,52.84959496801473,82.31813573157902,NaN,NaN,12.045358474935584,13.840839293768633
2001-02-14T09:30:00-05:00,50.199995,50.449995,49.65,50.449995,336000,899700,55.77736417795402,57.30682135588483,NaN,NaN,25.361728659186504,21.59081197249364,-0.11592940989722789,0.5424469825018576,0.6583763923990855,6484600,6783320,44.705628861912984,79.44355617875303,NaN,NaN,11.988434740144001,13.576210071822258
2001-02-15T09:30:00-05:00,51,51.074995,50.515,50.699995,1262000,916990,57.071767253953944,57.175712207728004,NaN,NaN,102.43827365032287,31.98188770674244,-0.08485187129197791,0.5523115532841132,0.6371634245760911,7746600,6811960,45.077203395643764,76.49920429913753,NaN,NaN,12.314051526953175,13.395901708269532
2001-02-16T09:30:00-05:00,49.550005,50.199995,49.449995,49.605005,675400,921220,50.14812752741916,56.243617635899405,NaN,NaN,-61.55559052856676,27.646770560822183,-0.13661359788376637,0.4663964272213832,0.6030100251051496,7071200,6902520,46.305886201385334,73.54042730401353,NaN,NaN,10.493787187725676,12.98131391962041
2001-02-20T09:30:00-05:00,49.85,50,48.76,49.03,631000,940890,46.92856706596473,54.98862780912017,NaN,NaN,-155.93037151819553,-7.016556673422313,-0.20408833785376168,0.3478996027879475,0.5519879406417092,6440200,6778240,44.823892955708956,70.46332384430437,NaN,NaN,7.966539160988533,12.264917525530143
2001-02-21T09:30:00-05:00,48.6,49.074995,48.025,48.175005,399600,801000,42.55378250803077,53.76765869022319,NaN,NaN,-248.0443861197011,-67.54606917139081,-0.29527770191912756,0.18289081324279977,0.4781685151619273,6040600,6756640,44.556984088958664,67.35333039482401,NaN,NaN,4.396564516094204,11.140867095610723
2001-02-22T09:30:00-05:00,48.175005,48.245005,47.125,47.5,526600,780390,39.42871036516428,52.20593903377986,NaN,NaN,-265.01860535934753,-125.62213597509762,-0.38439109686951967,-0.0023203559249722616,0.3820707409445474,5514000,6562520,42.129053081089594,63.98788903803284,NaN,NaN,0.3843617020581476,9.604223467960356
2001-02-23T09:30:00-05:00,47.4,47.75,46.225,47.6,380800,760830,40.130177841408944,51.214057225324076,NaN,NaN,-234.8759303669281,-193.0849767785478,-0.4171967295695412,-0.13942517101737906,0.2777715585521621,5894800,6192160,37.88723584917248,60.28067745988237,NaN,NaN,-2.642513365456893,7.854689634615035
2001-02-26T09:30:00-05:00,48.074995,48.745005,47.855005,48.65,903200,784230,47.06249142315365,50.68075436659564,NaN,NaN,-109.1763755789481,-202.6091337886241,-0.3514123659151052,-0.16149389884171939,0.18991846707338583,6798000,6137520,37.29069250922032,56.495437583464756,NaN,NaN,-3.215929055606085,6.273172678869161
2001-02-27T09:30:00-05:00,48.65,48.65,47.625,47.775,448400,776810,42.63239295703873,49.549878196320925,NaN,NaN,-119.20052756319343,-195.26316499762365,-0.3493302905812606,-0.24674439615318988,0.10258589442807069,6349600,6119400,37.082173120504,52.7396246039729,NaN,NaN,-5.107907159928097,4.647304130469553
2001-02-28T09:30:00-05:00,47.9,47.9,46.925005,47.074995,316200,723550,39.43430483363977,48.1474436626865,NaN,NaN,-144.2032818278235,-174.49494413924813,-0.3753207548035647,-0.3665650490763852,0.0087557057271795,6033400,6117960,37.06443562214719,48.927486896101286,NaN,NaN,-7.717277784094023,2.880935285531899
2001-03-01T09:30:00-05:00,47.025,47.4,46.35,47.4,541600,704510,41.62387838258489,47.268059490393796,NaN,NaN,-135.99019047811393,-148.68926116300142,-0.3512749043729321,-0.4303379247389856,-0.07906302036605352,6575000,6330160,41.50476562068493,46.1451339326062,NaN,NaN,-9.183361802978087,1.1574642728876152
2001-03-02T09:30:00-05:00,46.65,48.15,46.625,47.525,1030800,720910,42.48510572880485,46.73162636404131,NaN,NaN,-97.81663575787078,-121.27740224118995,-0.3090910097849785,-0.46542678259727666,-0.15633577281229816,7605800,6672360,47.88977282734299,44.46554722639945,NaN,NaN,-10.12413968087525,-0.4541934347927943
2001-03-05T09:30:00-05:00,48,48.025,47.300005,47.35,522200,704090,41.560667688110826,45.703723367725935,NaN,NaN,-80.25427743082933,-115.4929826115662,-0.27619070818271885,-0.5015741580406967,-0.22538344985797787,7083600,6729480,48.89258070008197,43.43284998584769,NaN,NaN,-11.163330225004083,-1.9840701191086927
2001-03-06T09:30:00-05:00,48,48.199995,47.815,48.050005,522000,703110,46.56888451347686,45.24330159047896,NaN,NaN,-48.95451681190888,-101.44378046130929,-0.19436360156561355,-0.4683379518149948,-0.27397435024938127,7605600,6980680,53.16146325855199,43.45512629231463,NaN,NaN,-10.635809955171966,-3.2200329528320175
2001-03-07T09:30:00-05:00,48.4,48.6,48.125,48.300005,394600,701600,48.27383476126298,44.70733520357245,NaN,NaN,-26.678680450139442,-77.93886018577247,-0.1144349074192641,-0.4170179845234614,-0.3025830771041973,8000200,7374040,58.94451042524921,44.47218926112436,NaN,NaN,-9.71011962002557,-4.147188191002525
2001-03-08T09:30:00-05:00,48.295,48.4,47.9,47.9,830400,722790,45.75793144682283,43.89920407449166,NaN,NaN,-38.07561987965458,-58.355946066080605,-0.08110707592226574,-0.40396692200702944,-0.3228598460847637,7169800,7493000,60.531589253770484,45.57607396527628,NaN,NaN,-9.612042973272153,-4.9278817313267576
2001-03-09T09:30:00-05:00,47.300005,47.775,46.955,46.955,246600,615430,40.40089930581956,43.202973487234544,NaN,NaN,-85.14579666971048,-55.82177824844854,-0.11333031058386256,-0.4645227343145919,-0.35119242373072934,6923200,7356480,57.77151341671936,46.395047337800136,NaN,NaN,-11.102861057218897,-5.810021635025635
2001-03-12T09:30:00-05:00,46.625,46.625,45.33,45.625,1006400,616500,34.31236166329097,42.30181595847214,NaN,NaN,-158.57777993341702,-71.48647874896608,-0.20926198623876113,-0.6127699065291807,-0.4035079202904196,5916800,7123120,53.2978486446849,47.000329887012704,NaN,NaN,-14.439170190566578,-7.042757142960055
2001-03-13T09:30:00-05:00,45.9,46.1,45.004995,46.1,672200,627950,37.911196421383714,41.970202666568774,NaN,NaN,-152.44503235483975,-92.18458185755226,-0.22442814792638305,-0.6840431051983984,-0.45961495727201535,6589000,6919800,49.68760800006149,47.36680302352004,NaN,NaN,-16.061103600555757,-8.331092351188012
2001-03-14T09:30:00-05:00,44.875,46.15,44.85,45,655800,615090,33.353887424493465,41.536286742235156,NaN,NaN,-162.06552190706455,-119.26195014893729,-0.28817831825732676,-0.8198378550936738,-0.531659536836347,5933200,6506400,43.269803934636485,47.44828522734482,NaN,NaN,-18.983261104317076,-9.852830744492163
2001-03-15T09:30:00-05:00,45.525,45.699995,44.75,44.824995,561600,626370,32.68079294891493,41.004187821342725,NaN,NaN,-161.45774019125514,-143.93837421125738,-0.31935027808353045,-0.9308473844407601,-0.6114971063572296,5371600,6146760,38.598952220772716,47.49912211103055,NaN,NaN,-21.519049126793817,-11.519433370535257
2001-03-16T09:30:00-05:00,44.925005,45.175005,43.824995,44,301400,578340,29.643767007428607,39.7599932202195,NaN,NaN,-186.79450845762997,-164.2681165688413,-0.36922174049003975,-1.0730242819697793,-0.7038025414797395,5070200,5776160,34.469705480374884,47.29762303754159,NaN,NaN,-24.668169167352364,-13.397824198651985
2001-03-19T09:30:00-05:00,44.5,45.199995,43.754995,45.15,784600,583800,38.25715064711668,39.44747591236793,NaN,NaN,-139.22871601162274,-160.3983037844824,-0.30131824639225846,-1.0804503494700626,-0.7791321030778041,5854800,5763760,34.33734358832956,47.101563785243414,NaN,NaN,-24.58958984329077,-14.996647862171812
2001-03-20T09:30:00-05:00,45.050005,45.58,44.1,44.1,625200,583510,34.146643774531114,39.06978583671731,NaN,NaN,-122.82838218401118,-154.4749737503167,-0.3028673997683844,-1.1577163527882846,-0.8548489530199002,5229600,5491880,31.48278598981183,46.70287452579089,NaN,NaN,-25.899178561606295,-16.55415224780531
2001-03-21T09:30:00-05:00,44.125,44.300005,43.074995,43.425005,494800,588270,31.78253613132975,38.366832818770504,NaN,NaN,-148.5521018664631,-151.7722897421964,-0.32324467879216434,-1.2589048015101056,-0.9356601227179413,4734800,5252200,29.179788452689465,45.82251901379122,NaN,NaN,-27.755084402380398,-18.154285412744606
2001-03-22T09:30:00-05:00,43.125,43.375,41.574995,43,1193000,621590,30.35738240892782,37.50056686735072,NaN,NaN,-162.98134161299075,-152.07701002654352,-0.3376643337857783,-1.3577405399501643,-1.020076206164386,3541800,4886240,26.046784521288927,44.26230556335879,NaN,NaN,-29.71068850014443,-19.80520013951601
2001-03-23T09:30:00-05:00,43.875,44.25,43.5,44.125,297200,617410,38.250519353607984,37.26412770060052,NaN,NaN,-93.15593942062681,-133.3492962191429,-0.24790665998865835,-1.3299595311502088,-1.0820528711615505,3839000,4640000,24.16658574624013,42.4961630666558,NaN,NaN,-28.790141584624962,-21.088763203103003
2001-03-26T09:30:00-05:00,44.5,44.975,44.300005,44.725,1011600,622830,42.024522820884506,36.939530436843924,NaN,NaN,-57.38131785971095,-116.97981658876056,-0.13049714441351656,-1.2451743016784462,-1.1146771572649297,4850600,4439160,22.72565736263543,40.32217693123318,NaN,NaN,-26.802560971138483,-21.905020027108073
2001-03-27T09:30:00-05:00,44.800005,45.300005,44.050005,45.085,633200,632070,44.22708541714441,36.650476912264025,NaN,NaN,-46.18110373701656,-101.65036089936163,-0.016929600860844607,-1.1358391583409855,-1.1189095574801409,5483800,4490000,23.961604946220504,37.82339796844542,NaN,NaN,-24.497965887287833,-22.27544086427661
2001-03-28T09:30:00-05:00,44.449995,44.5,43.775,43.875,1233200,677920,38.88042626869191,36.159226542397526,NaN,NaN,-74.23602660372902,-86.78714584681482,-0.011878675443850018,-1.1337579017849535,-1.1218792263411035,4250600,4393160,23.200412682365823,35.15688535620223,NaN,NaN,-24.18801349517746,-22.548665525833876
2001-03-29T09:30:00-05:00,43.875,44.699995,43.75,43.949995,591800,680430,39.36965934268798,36.08556654503099,NaN,NaN,-64.65973286771154,-67.12282409775898,0.006923811006847913,-1.1132244625825436,-1.1201482735893915,4842400,4653280,29.663811307928995,33.14919234843149,NaN,NaN,-23.793347834077686,-22.72647728415442
2001-03-30T09:30:00-05:00,44.225,44.925005,43.949995,44.800005,231400,640460,44.76621552258545,36.832270392123455,NaN,NaN,-40.542597305078594,-56.60015567464933,0.08280371804990372,-1.0166436260270117,-1.0994473440769155,5073800,4900240,35.236560708236354,31.85910035297088,NaN,NaN,-21.76891164490866,-22.589682192833596
2001-04-02T09:30:00-04:00,44.775,45,43.675005,43.75,340200,631360,40.026753219609894,36.98338159199675,NaN,NaN,-57.35509431749932,-56.59491096620701,0.0690376514926423,-1.0131502797111125,-1.0821879312037548,4733600,4876840,34.95396791001865,30.80669748939639,NaN,NaN,-21.509276221607127,-22.435338482658388
2001-04-03T09:30:00-04:00,43.65,43.65,42.125,42.265,507400,630630,34.46869266949827,37.06301053806852,NaN,NaN,-134.10133145327785,-74.17895650945925,-0.028112850074910822,-1.1173289937973934,-1.0892161437224825,4226200,4625320,31.98468858333152,30.00061782144604,NaN,NaN,-23.15643834686644,-22.538352748973825
2001-04-04T09:30:00-04:00,42.324995,42.925005,42.199995,42.4,356400,628720,35.34761292382335,37.25349767913342,NaN,NaN,-144.98386768167043,-88.32852472504753,-0.0689856199996135,-1.1754481687219993,-1.1064625487223858,4582600,4691720,33.588589422088006,29.64273476439713,NaN,NaN,-24.165831708212714,-22.77084974315081
2001-04-05T09:30:00-04:00,43,44.449995,43,44.449995,950000,634700,46.97725974556036,38.49160430328568,NaN,NaN,-37.31612065436093,-82.8598022823774,0.049925759431922234,-1.0440553494324831,-1.0939811088644054,5532600,4829760,36.91895025366513,29.81768081963215,NaN,NaN,-21.031140671463028,-22.52231987576684
2001-04-06T09:30:00-04:00,43.75,43.89,43.125,43.199995,405000,642620,42.014501995418655,38.759986542450115,NaN,NaN,-76.20035462390143,-89.99135374614198,0.05204145473037469,-1.0289292904514369,-1.0809707451818116,5127600,4840520,37.18338293796168,30.020969344605874,NaN,NaN,-20.154250045768126,-22.184024185767022
2001-04-09T09:30:00-04:00,43.800005,44.300005,43.550005,44.15,569800,620790,46.629164645766686,39.6515951761098,NaN,NaN,-14.938439002540074,-81.50802268315013,0.12112153616400545,-0.9295688249768048,-1.0506903611408103,5697400,5033280,41.883463235675826,30.763874862167587,NaN,NaN,-17.83276290275543,-21.56241543105108
2001-04-10T09:30:00-04:00,44.375,45.375,44.35,45.199995,769000,625630,51.24728644764665,41.04193448441815,NaN,NaN,93.94807328462073,-35.89814173557041,0.2346573732170848,-0.7573686446194543,-0.9920260178365391,6466400,5481320,51.05111470106974,32.3261124513376,NaN,NaN,-14.32069584043864,-20.527884060963586
2001-04-11T09:30:00-04:00,45.9,45.9,44.56,44.9,526800,619180,49.9182639740342,42.43914031049717,NaN,NaN,112.57106597137742,15.612844995039158,0.28341744085685905,-0.6377542167654653,-0.9211716576223243,5939600,5752720,55.61821806792223,34.438357704668555,NaN,NaN,-11.998429534416971,-19.309390557171213
2001-04-12T09:30:00-04:00,44.625,45.5,44.525,45.449995,492000,615700,52.35766871477335,43.4467938362947,NaN,NaN,115.84940060377262,46.24594924666587,0.3426196382169,-0.4928971098511994,-0.8355167480680994,6431600,5932520,58.388212728707074,36.88275963198762,NaN,NaN,-9.330318526211338,-17.88380883846266
2001-04-16T09:30:00-04:00,45.25,45.4,44.629995,44.629995,262400,613750,48.559952276870725,43.913610226008004,NaN,NaN,79.80048414648304,77.44611700074277,0.31705250337313173,-0.43920111885168467,-0.7562536222248164,6169200,6140840,61.39462114398214,39.64482847351238,NaN,NaN,-8.276961218149445,-16.51140203556077
2001-04-17T09:30:00-04:00,44.375,45.550005,44.375,45.35,295400,589290,51.861667550416044,44.45893752124169,NaN,NaN,96.33905999388595,99.70161680002798,0.3372507593942812,-0.3346901729819649,-0.6719409323762461,6464600,6294280,63.48714176295191,42.46808110327891,NaN,NaN,-6.367889820770839,-15.062328862019353
2001-04-18T09:30:00-04:00,46.074995,48,46,46.675005,688600,592460,57.29408322262499,45.77419873223691,NaN,NaN,224.81619143028405,125.87524042916064,0.42291607374015805,-0.14329584020104846,-0.5662119139412065,7153200,6431640,65.30037267160367,45.475221102510204,NaN,NaN,-2.9388049420395785,-13.330396873450814
2001-04-19T09:30:00-04:00,46.65,47.245005,46.35,47.195,251200,580280,59.238196971200196,47.19337999141635,NaN,NaN,189.49297812484866,141.2596228598549,0.49278638577402223,0.04977106827632127,-0.44301531749770096,7404400,6724600,68.85304832498247,48.27445231801403,NaN,NaN,0.4710702640806215,-11.358758710946324
2001-04-20T09:30:00-04:00,47,47,46,46.644995,504000,545830,56.31786669528522,48.018497932323484,NaN,NaN,145.13042108096934,147.11582695529424,0.4796859190082081,0.1565920812625592,-0.3230938377456489,6900400,6818360,69.914692919929,50.75146176170636,NaN,NaN,2.402836594411089,-9.392816524466694
2001-04-23T09:30:00-04:00,46,46.225,45.75,45.800005,305200,546230,52.07075548238857,48.87878380823624,NaN,NaN,87.96450995417759,148.74863211683314,0.39534916881605964,0.17109262327442565,-0.224256545541634,6595200,6903560,70.88581736319409,53.31802243693317,NaN,NaN,2.7462383722722614,-7.658665824932558
2001-04-24T09:30:00-04:00,46.1,46.515,45.75,46.15,319200,511610,53.63057413916167,50.24748962749792,NaN,NaN,92.06042817243522,147.892905752543,0.3461440383238812,0.2084235023632175,-0.1377205359606637,6914400,6993520,71.91659442194802,56.17030142540578,NaN,NaN,3.4886487679351097,-6.066192311665748
2001-04-25T09:30:00-04:00,46.25,47.199995,45.955,47.15,390200,499460,57.85124177711485,51.85489168844731,NaN,NaN,117.80035453775464,126.48973837403712,0.362231008983812,0.3150682252691013,-0.04716278371471069,7304600,7023800,72.27244107589685,58.93343368639212,NaN,NaN,5.4135915798350025,-4.4262231843084985
2001-04-26T09:30:00-04:00,47.25,47.949995,47.175005,47.824995,323600,453980,60.466982195153385,52.818443291989674,NaN,NaN,149.55962760726965,118.5030682705213,0.3968318405728948,0.4488770170014078,0.052045176428513015,7628200,7068560,72.82068089738624,61.497843018086485,NaN,NaN,7.829213297008349,-2.6754465441203776
2001-04-27T09:30:00-04:00,48.125,48.449995,47.949995,48.449995,1761400,512460,62.77084784599654,54.3010394241738,NaN,NaN,155.33054639966178,120.5430933342598,0.43712794461416793,0.598455107196223,0.161327162582055,9389600,7566400,78.0250804203474,64.41510712397118,NaN,NaN,10.558237587607449,-0.784920239587831
2001-04-30T09:30:00-04:00,48.824995,49.050005,48.254995,48.5,1112800,556530,62.956852222776774,55.46730282253167,NaN,NaN,144.50845315419932,131.85188197426413,0.4411902061182043,0.7128149202298104,0.2716247141116061,10502400,8347840,83.39867914705098,67.3804796890694,NaN,NaN,12.822536410870597,1.1590021390490872
2001-05-01T09:30:00-04:00,48.324995,49.1,48.015,49.1,563400,567690,65.20332065858648,56.464162409027374,NaN,NaN,131.45031695906383,139.72985973158987,0.4564226809135251,0.8421530652535125,0.3857303843399874,11065800,9178120,87.02821637915027,69.95027266607516,NaN,NaN,15.414684926314573,3.1955282515155847
2001-05-02T09:30:00-04:00,49.199995,49.300005,48.5,48.975,590200,571830,64.32806212997389,57.4934337058802,NaN,NaN,127.00734088959535,141.571257001958,0.4305498316151547,0.9239176738589308,0.49336784224377606,10475600,9812320,89.00550567929902,72.33507892403064,NaN,NaN,17.326839082409776,5.214286941643326
2001-05-03T09:30:00-04:00,48.574995,48.625,48.15,48.370005,385600,573290,60.12153989578439,58.04799593309527,NaN,NaN,94.65520654837955,130.59037279017997,0.34865578932871855,0.9291875789046742,0.5805317895759556,10090000,10304680,90.24828172915936,74.61079813834866,NaN,NaN,17.842986560289397,7.018386887164193
2001-05-04T09:30:00-04:00,48.074995,49.25,47.735,49.050005,754000,563490,63.04650101338105,59.08274941427459,NaN,NaN,98.9977429295567,119.32381209615896,0.3171524914560463,0.9769724038960135,0.6598199124399672,10844000,10595560,90.90254608690911,76.71850706284344,NaN,NaN,19.111471262829017,8.745970369402025
2001-05-07T09:30:00-04:00,49.300005,49.5,48.699995,48.75,269000,556690,60.923402571050886,59.73001620146279,NaN,NaN,104.40563765742198,111.30324899680352,0.25562010657118084,0.9793450456539432,0.7237249390827624,10575000,10610080,90.93523992202951,78.67908550277755,NaN,NaN,19.59971432722918,10.29650522052019
2001-05-08T09:30:00-04:00,49.050005,49.25,48.525,49,437800,550090,62.06968539987441,60.07113064269489,NaN,NaN,91.47250268069433,103.30768614112962,0.21300912525880034,0.9899863456562628,0.7769772203974624,11012800,10599480,90.67904126084554,80.49184754486626,NaN,NaN,20.320069316946952,11.728442948581156
2001-05-09T09:30:00-04:00,48.550005,49.199995,48.550005,48.699995,237000,523490,59.802597990769335,60.111445001235545,NaN,NaN,77.64158060214706,93.43453408363996,0.148905926117044,0.9631096280437674,0.8142037019267234,10775800,10659520,90.83652094395352,82.06209558907848,NaN,NaN,20.33355633908457,12.957744861510214
2001-05-10T09:30:00-04:00,49.425005,49.425005,48.75,48.75,562600,525280,60.06442729987024,60.37905647299162,NaN,NaN,78.37804891147829,90.1791025562597,0.09668965062443713,0.9350657652072698,0.8383761145828327,11338400,10909200,91.48109866478416,83.60255314228242,NaN,NaN,20.41132396129895,14.022541875765748
2001-05-11T09:30:00-04:00,48.824995,49.175005,48.324995,48.46,1009600,551160,57.71647472226073,60.782322132982486,NaN,NaN,56.618278687698194,81.703209707888,0.0327424319733578,0.8793041545495299,0.8465617225761721,10328800,10806160,88.7078814708225,84.87555772139874,NaN,NaN,19.875509784968855,14.85868014850905
2001-05-14T09:30:00-04:00,48.46,48.660005,48.15,48.449995,249400,550510,57.63277090592837,61.06819333060868,NaN,NaN,38.019527396021935,68.425987655608,-0.017411295558806827,0.8247976031276636,0.8422088986864704,10079400,10707040,86.00687389840569,85.88200625543142,NaN,NaN,19.400448232478848,15.507504160504736
2001-05-15T09:30:00-04:00,48.5,49.1,48.425005,48.925005,435000,557490,60.55746610923536,61.26149506861729,NaN,NaN,59.217737238014614,61.975034567072065,-0.02529818072858203,0.8105861727757429,0.8358843535043249,10514400,10607360,83.26126901018878,86.66692253645228,NaN,NaN,19.70404397269034,16.107009847959823
2001-05-16T09:30:00-04:00,48.550005,49.875,48.550005,49.865,633200,554720,65.61589602677947,61.62927462801916,NaN,NaN,98.34473975283225,66.11566639720907,0.02345233168407046,0.865199768109413,0.8417474364253426,11147600,10681720,83.67981763493157,87.44257516056267,NaN,NaN,21.377715802939107,16.85996784152829
2001-05-17T09:30:00-04:00,49.875,50.425005,49.75,50.379995,173600,550840,68.03465440474399,62.005260810786844,NaN,NaN,149.51865905842234,80.34378842659788,0.0779705255052543,0.9392105933069104,0.8612400678016561,11321200,10678280,83.57570410330587,87.83904828077398,NaN,NaN,23.527752916052023,17.812508566460252
2001-05-18T09:30:00-04:00,50.125,50.675005,50.125,50.574995,309000,541090,68.92600418215116,62.43162880788501,NaN,NaN,167.42408403692565,102.50494949644337,0.11264681255482023,1.0020485834951813,0.8894017709403611,11630200,10938560,85.08753409278998,87.9596807768982,NaN,NaN,25.58785475834678,18.923272308158328
2001-05-21T09:30:00-04:00,50.425005,51.449995,50.35,51.449995,376000,544630,72.61598422662202,62.961104777030414,NaN,NaN,218.20051264317138,138.54114654587323,0.17620805509865722,1.1096618398136826,0.9334537847150254,12006200,11323920,86.99607383928311,87.9573848811934,NaN,NaN,28.559426658210224,20.299865786737172
2001-05-22T09:30:00-04:00,51.6,51.9,51.15,51.699995,896200,573480,73.58126910894637,63.622048132671296,NaN,NaN,223.54857047578,171.40731319342632,0.21425418910076965,1.2012715210909874,0.9870173319902178,12902400,11801520,88.89330018713136,87.94937020318142,NaN,NaN,31.33093734012527,21.8757331515069
2001-05-23T09:30:00-04:00,51.324995,51.475,50.5,50.5,659000,586920,62.24021188117953,63.77338184591382,NaN,NaN,129.78473116099013,177.6953114750579,0.14128988408265175,1.1636296870935325,1.0223398030108808,12243400,12020680,89.64022459220975,87.90593755054216,NaN,NaN,30.393592795314188,23.09257024347937
2001-05-24T09:30:00-04:00,50.800005,51.175005,50.160005,51.025,540200,597750,64.79664740388242,63.89839230237817,NaN,NaN,107.8687215425752,169.36532397188847,0.11233441872441197,1.1627578264163958,1.0504234076919838,12783600,12313160,90.55327058993885,87.88098930075857,NaN,NaN,30.385703222396376,24.134446383324654
2001-05-25T09:30:00-04:00,51.050005,51.1,50.65,50.65,339600,526660,61.589151126901285,63.9459457706532,NaN,NaN,93.97839443404382,154.6761860513121,0.054788804513711264,1.1189094133341229,1.0641206088204116,12444000,12475920,91.02719257329314,87.88755734727741,NaN,NaN,29.39636882089535,24.886149588691897
2001-05-29T09:30:00-04:00,50.75,50.75,50,50,753600,508700,56.37957712646044,63.539509465409346,NaN,NaN,47.689986477480765,120.57408081817398,-0.03533465724592144,1.0199522872630098,1.0552869445089312,11690400,12412760,89.1579545841856,87.77890829894456,NaN,NaN,26.919211576902146,25.176587015579074
2001-05-30T09:30:00-04:00,49.949995,49.949995,49.15,49.35,849400,523000,51.672591029883726,62.95879468248894,NaN,NaN,-10.360022275966909,73.7923622678246,-0.14107232709270856,0.8789465356430455,1.020018862735754,10841000,12000480,77.91117839875577,86.85566954571615,NaN,NaN,23.305744124001578,24.909323745353717
2001-05-31T09:30:00-04:00,49.574995,50.1,49.4,49.550005,972000,542090,52.97358461931893,62.452305919592426,NaN,NaN,1.7165294456698497,48.17872192476056,-0.19648687099169193,0.7744102739961392,0.9708971449878311,11813000,11914400,75.76228103918747,85.73289685817352,NaN,NaN,20.74561445401017,24.31450813230464
2001-06-01T09:30:00-04:00,49.875,50.25,49.25,50.135,538200,549720,56.64954865135829,62.37609691452796,NaN,NaN,11.55233263778288,28.915444143802084,-0.19243793679081067,0.7303497239993177,0.9227876607901284,12351200,11827920,73.56696600919265,84.65140289662854,NaN,NaN,19.640777885537304,23.646832382766448
2001-06-04T09:30:00-04:00,50.375,50.79,50.15,50.79,417800,532910,60.38358372819376,62.57258354468978,NaN,NaN,61.2479594701574,22.369357151024804,-0.14642453779759457,0.7397569885431352,0.8861815263407298,12769000,11892920,74.17273165890165,83.80610702237824,NaN,NaN,19.83008496772812,23.101582752046685
2001-06-05T09:30:00-04:00,50.800005,51.725,50.725,51.5,1191600,579040,64.00310810343092,62.81870082998946,NaN,NaN,108.78520044430373,34.588399944389394,-0.0726770210178429,0.7953352500684261,0.868012271086269,13960600,12346960,77.97049433437887,83.42819454553468,NaN,NaN,21.13012004606711,22.81994522262103
2001-06-06T09:30:00-04:00,51.5,51.625,51.074995,51.175005,1081200,611210,61.2447648787048,62.50647717655556,NaN,NaN,96.90553231532887,56.04151086264856,-0.051297580531244114,0.8038902954222138,0.8551878759534579,12879400,12754640,80.71286990589628,83.21626970774646,NaN,NaN,21.360405856512422,22.611439598891227
2001-06-07T09:30:00-04:00,51,51.574995,51,51.39,262800,612500,62.39922877860474,62.103946774688474,NaN,NaN,92.00654032017015,74.09951303754862,-0.029284363477753872,0.8185824216062656,0.8478667850840195,13142200,13020480,82.26339329281699,83.12253322128296,NaN,NaN,21.889863371277613,22.50835728066071
2001-06-08T09:30:00-04:00,51.25,51.300005,50.525,50.949995,545400,611640,58.55484486926072,61.36314968091058,NaN,NaN,54.43851646051164,82.67674980209436,-0.049761701576071404,0.7856646581139302,0.8354263596900016,12596800,13069600,82.54265514598816,82.94075615365428,NaN,NaN,21.210936871948686,22.323011507987566
2001-06-11T09:30:00-04:00,50.949995,50.949995,50.25,50.275,513400,586830,53.14553410462414,59.972403243625024,NaN,NaN,10.762929948632385,72.57974389778937,-0.11068093640125576,0.6970751891884319,0.8077561255896877,12083400,12932480,78.81220133129773,82.35619383165532,NaN,NaN,18.974525879470388,21.8446564181994
2001-06-12T09:30:00-04:00,50,50.75,49.730005,50.4,690200,608870,53.99314356993804,58.57325141941014,NaN,NaN,-20.810374707757795,46.66062886737704,-0.142448805442976,0.6296951187859676,0.7721439242289436,12773600,12695080,72.68720548346354,81.19861563853617,NaN,NaN,17.389223422084303,21.208165990182955
2001-06-13T09:30:00-04:00,50.625,51,50.199995,50.33,759400,625090,53.410445317512476,57.94255380771964,NaN,NaN,-6.590139897361594,25.961494424838953,-0.16639961378075563,0.5641444070029991,0.7305440207837547,12014200,12522040,68.50790585857298,79.68916430041926,NaN,NaN,15.92074068103819,20.45281951744799
2001-06-14T09:30:00-04:00,49.875,50.025,49.074995,49.074995,865200,636690,44.20037132412855,56.47139123059436,NaN,NaN,-157.15205578282612,-23.8702247957603,-0.2594402912942949,0.406243656665886,0.6656839479601809,11149000,12123400,59.955408425869166,77.50360271727143,NaN,NaN,11.636668865388291,19.193369424296602
2001-06-15T09:30:00-04:00,49,49.574995,48.925005,49.375,817800,668900,46.572140474959554,55.39874761259853,NaN,NaN,-150.97152451344928,-64.95223299055247,-0.29107939193998356,0.3018347080352015,0.5929140999751851,11966800,11997400,57.51151953635751,75.10962607177603,NaN,NaN,8.802687659085949,17.708986314980795
2001-06-18T09:30:00-04:00,49.25,49.5,48.75,49,685600,687730,44.05161879325622,54.518179160226794,NaN,NaN,-146.43337275012206,-96.39149353030336,-0.3249884131658427,0.1866785835178817,0.5116669966837244,11281200,11836960,54.46703603153194,72.63170331801506,NaN,NaN,5.65850705820915,15.987489278299131
2001-06-19T09:30:00-04:00,49.5,49.550005,48.589995,48.85,763600,707110,43.048015564961545,53.90213805558949,NaN,NaN,-133.578783979974,-118.9451753847466,-0.34344292102004664,0.08236334540866608,0.4258062664287127,10517600,11385760,46.941209861206,70.41956270819009,NaN,NaN,2.777360837394852,14.100328072455664
2001-06-20T09:30:00-04:00,48.5,49.550005,48.5,49.425005,861400,705370,47.9439586596695,53.54287905847168,NaN,NaN,-104.24218570632007,-138.4755845465383,-0.3041925222557361,0.04556561360904254,0.34975813586477866,11379000,11258720,45.05362595078795,68.22608734473297,NaN,NaN,1.6783231086628911,12.325755934770982
2001-06-21T09:30:00-04:00,49.324995,49.800005,49.275,49.495005,776800,711260,48.52411154103891,52.96249069344886,NaN,NaN,-60.94618770760004,-119.23441093149309,-0.26236629974038983,0.021800261189291348,0.2841665609296812,12155800,11460080,48.58283600209332,66.44150662994015,NaN,NaN,0.9405644952406998,10.699300014838084
2001-06-22T09:30:00-04:00,49.625,49.625,48.5,48.6,673400,717920,42.06846059770497,51.65426761269968,NaN,NaN,-106.68062594828274,-110.3762312184598,-0.2821045793027145,-0.06846416319871196,0.21364041610400253,11482400,11363200,47.01807182452493,64.50188807034182,NaN,NaN,-1.6843230981146096,8.930210998701984
2001-06-25T09:30:00-04:00,48.85,48.885,48.125,48.26,1857600,793820,39.896957919804954,49.93239974244067,NaN,NaN,-134.49513958110916,-107.9885845846572,-0.3033334869268599,-0.16552644255457238,0.13780704437228752,9624800,11031920,42.03268423568961,61.93490163472115,NaN,NaN,-4.5393715046200045,7.005984926798843
2001-06-26T09:30:00-04:00,48,49.050005,47.925005,49,1007600,806520,46.383852501872745,48.87090600123838,NaN,NaN,-101.92466482550262,-101.65776075376293,-0.25476940162728273,-0.1806547076618159,0.07411469396546684,10632400,11054880,42.48783489907027,59.20454199137644,NaN,NaN,-5.0641048299666584,5.2816863901180575
2001-06-27T09:30:00-04:00,49.1,49.6,48.949995,49.475,989000,813500,50.10633262048244,47.99284198994393,NaN,NaN,-43.03150941720339,-89.41562549593961,-0.18133723998865656,-0.15255685602035385,0.0287803839683027,11621400,11103360,43.49667287450133,56.43549053292531,NaN,NaN,-4.351390683041869,3.9055325225237825
2001-06-28T09:30:00-04:00,49.75,50.375,49.75,50.1,922600,811030,54.57523213430401,47.708583937447024,NaN,NaN,16.949628108866555,-73.83646233264628,-0.0861817313060548,-0.07894678016426582,0.007234951141788994,12544000,11181000,45.155875445410935,53.76500626859837,NaN,NaN,-2.3204283650434867,3.016109538585601
2001-06-29T09:30:00-04:00,50.449995,51.199995,50.225,50.949995,2283200,898280,59.84311613932786,48.18698265421158,NaN,NaN,69.23005133237818,-38.654326876514084,0.03215642231944062,0.04743047904108977,0.01527405672164915,14827200,11849960,56.89960301048149,52.19982067425435,NaN,NaN,1.2024840536849692,2.7570201835997965
2001-07-02T09:30:00-04:00,50.800005,50.800005,49.655,49.800005,2142000,984490,51.19309362039794,47.98697908638729,NaN,NaN,15.606875416135475,-8.633923877065154,0.031113865753691718,0.0541663889137638,0.02305252316007208,12685200,12462040,64.40905294087958,51.60852406406978,NaN,NaN,1.3631284229631366,2.5578927892231307
2001-07-03T09:30:00-04:00,49.625,49.769995,49.300005,49.5,1084800,979150,49.19532147548294,47.6858988119566,NaN,NaN,-24.815706716683728,6.78786774469862,0.009473587552994482,0.03489450760131518,0.0254209200483207,11600400,12655640,66.40298083969813,51.458172277007286,NaN,NaN,0.8320460943368169,2.3113432613822287
2001-07-05T09:30:00-04:00,49,49.495005,48.775,48.85,849600,967570,45.08967777528621,47.74942070132501,NaN,NaN,-62.420076973870316,2.910154233365229,-0.04629997985237116,-0.03245405476714325,0.01384592508522791,10750800,12481520,62.985258251454674,51.67459012169197,NaN,NaN,-0.9673823058415786,1.8429538946359705
2001-07-06T09:30:00-04:00,48.550005,48.725,47.775,47.949995,588600,983860,40.09953430262427,47.28709168901535,NaN,NaN,-143.17472860436658,-29.1147171092814,-0.13639309711780928,-0.1566454463120337,-0.020252349194224417,10162200,12005160,54.69168228355758,51.4731731750634,NaN,NaN,-4.202823323954423,0.9792714348373429
2001-07-09T09:30:00-04:00,48.125,48.475,47.625,48.4,895400,1001360,43.46840425019263,47.24543350736794,NaN,NaN,-133.5616546951338,-69.67305831478379,-0.1568088614882004,-0.2162634260544749,-0.059454564566274515,11057600,11251240,44.66711798659205,50.77317902899627,NaN,NaN,-5.72010575424099,0.02221755068329545
2001-07-10T09:30:00-04:00,48.550005,48.550005,47.29,47.5,775600,1014470,38.77183957219279,46.939992365027315,NaN,NaN,-158.3076835423433,-104.45597010647955,-0.21827874896253457,-0.33230300076944275,-0.11402425180690817,10282000,10770600,39.67443180378108,50.254123453465915,NaN,NaN,-8.599691364183295,-1.2094837228690745
2001-07-11T09:30:00-04:00,47.4,47.620005,46.745005,47.5,1103400,1035130,38.77183957219279,46.28484100163613,NaN,NaN,-183.98567650859468,-136.28996406486175,-0.24432481351427823,-0.41943026869975597,-0.17510545518547774,10282000,10506920,37.21674420933804,49.69434618621949,NaN,NaN,-10.832932504397284,-2.5842621202302474
2001-07-12T09:30:00-04:00,47.9,48.75,47.875,48.665,1254200,1059870,47.31716371208138,46.19863044242487,NaN,NaN,-61.404987768775456,-136.08694622384274,-0.17189809036933876,-0.3899780681471512,-0.21807997777781243,11536200,10664000,39.61647651874447,49.053891937408864,NaN,NaN,-10.004909055409913,-3.644354539541628
2001-07-13T09:30:00-04:00,48.550005,49.074995,48.35,48.9,241200,1028670,48.86741360703912,46.68426994309159,NaN,NaN,-21.484774190905878,-111.74895534115062,-0.10050589696885442,-0.3437123489888805,-0.24320645202002605,11777400,10987040,44.32914559230246,48.8618257779644,NaN,NaN,-8.85144919510967,-4.388225204622777
2001-07-16T09:30:00-04:00,48.85,48.995005,48.074995,48.074995,547200,1015140,43.975115088184936,46.97556688369017,NaN,NaN,-57.65976885441981,-96.56857817300784,-0.10092259298367562,-0.3693596932496206,-0.268437100265945,11230200,11021560,44.824701155620666,49.06125555795946,NaN,NaN,-9.424425987587547,-5.10768245933203
2001-07-17T09:30:00-04:00,48.050005,49.025,47.949995,49.025,558400,1008780,50.16245822399969,47.24546729241352,NaN,NaN,-25.30804175301866,-69.96864981514291,-0.03281885136404161,-0.30946066447099696,-0.27664181310695535,11788600,11322880,49.08510870293638,49.53248940109277,NaN,NaN,-7.861066529961386,-5.50102304085051
2001-07-18T09:30:00-04:00,48.35,48.945,48.074995,48.1,877800,1014490,44.956332752424096,46.87761015898078,NaN,NaN,-51.23527642262846,-43.418569797949644,-0.04492157551401332,-0.332793782499472,-0.2878722069854587,10910800,11448640,50.79289498094633,50.05364812298169,NaN,NaN,-8.279163149053453,-5.897900199165216
2001-07-19T09:30:00-04:00,48.6,49.085,48.25,48.5,431000,992970,47.49407257956955,46.37181304792832,NaN,NaN,-24.444111676097556,-36.02639457941407,-0.02200092383647212,-0.3153733617810488,-0.2933724379445767,11341800,11409760,50.23192843652478,50.41622333663268,NaN,NaN,-7.788727712709352,-6.168018415385807
2001-07-20T09:30:00-04:00,48.25,48.800005,48.25,48.5,629600,985610,47.494072579569554,45.48973850794558,NaN,NaN,-30.543531261432175,-37.83814599351931,-0.003806758112619657,-0.2981308855853513,-0.2943241274727316,11341800,11322640,48.927959069968736,49.84682019802462,NaN,NaN,-7.403956703706213,-6.344581028003008
2001-07-23T09:30:00-04:00,48.824995,48.824995,48,48.15,1452000,1024540,45.37132377420243,45.07389780464592,NaN,NaN,-47.55692142463349,-35.81757650756206,-0.011856336413378354,-0.30914454798945457,-0.2972882115760762,9889800,11054560,45.0523807746504,48.46420075757969,NaN,NaN,-7.709579750071074,-6.539580845441303
2001-07-24T09:30:00-04:00,48,48.175005,46.9,47.35,588200,961070,40.874384289617,44.47954514851263,NaN,NaN,-126.56418555536878,-56.06880526803208,-0.06462393857610599,-0.3780681347962087,-0.3134441962201027,9301600,10557160,38.89618440381661,46.49942958358815,NaN,NaN,-9.350362835946566,-6.941121129799197
2001-07-25T09:30:00-04:00,47.449995,47.65,46.955,47.625,603600,940870,42.966998689168015,44.327925213789904,NaN,NaN,-118.81348650676574,-69.58444728485954,-0.07390248723164716,-0.4058223052596617,-0.3319198180280145,9905200,10356040,36.711773923444056,44.62275213158739,NaN,NaN,-10.085457930794238,-7.390312101369918
2001-07-26T09:30:00-04:00,47.504995,48.550005,47.230005,48.324995,622800,922560,48.01096541951534,44.89302743642498,NaN,NaN,-54.834625075922546,-75.66254996482454,-0.02814591606773842,-0.36710221311268754,-0.3389562970449491,10528000,10193280,34.99877459002502,43.216115867763634,NaN,NaN,-9.200546786485411,-7.648917056386416
2001-07-27T09:30:00-04:00,48.324995,48.54,48.085,48.25,592200,906040,47.52601267530719,45.182856609647445,NaN,NaN,-23.942624252949603,-74.34236856312802,0.000313065875995,-0.33856496469995534,-0.33887803057595034,9935800,9912080,32.2030099457463,42.325822436274656,NaN,NaN,-8.621646708679831,-7.787878435285475
2001-07-30T09:30:00-04:00,48.449995,48.5,47.85,48.175005,378000,810780,47.01459426478617,45.771624801975555,NaN,NaN,-28.642853412442378,-70.5595549606898,0.016437673606323533,-0.31833093856804595,-0.3347686121743695,9557800,9845680,31.561877080033753,41.74635424172127,NaN,NaN,-8.284203877496878,-7.858782069887105
2001-07-31T09:30:00-04:00,48.295,48.835,48.06,48.115,652200,736290,46.582668455377366,46.329541150774446,NaN,NaN,8.56451868681008,-43.53381411225402,0.02490521795183237,-0.30363708973457904,-0.3285423076864114,8905600,9766480,30.774850656179126,41.2862189879242,NaN,NaN,-8.116270478267378,-7.895566128227144
2001-08-01T09:30:00-04:00,48.525,48.9,48.225,48.85,439000,704000,52.356507055135964,46.68949424670692,NaN,NaN,79.43220786099477,-3.884675238701925,0.07880817843700305,-0.23003208464015756,-0.3088402630771606,9344600,9654360,29.647754706002473,40.5741674298712,NaN,NaN,-6.34450414654438,-7.673985845129606
2001-08-02T09:30:00-04:00,49.225,49.25,48.449995,48.699995,553000,689170,51.14155412824309,46.851932855364346,NaN,NaN,112.0096544587591,29.484180668234405,0.10170492392230884,-0.18170910817427455,-0.2834140320965834,8791600,9307080,26.42014177905577,39.29495287178215,NaN,NaN,-5.183226753900981,-7.318163117811231
2001-08-03T09:30:00-04:00,48.75,48.894995,48.050005,48.574995,303000,674890,50.09827499767702,47.289301420328066,NaN,NaN,49.98279537068843,44.26926459296201,0.105331243891848,-0.15174997723177341,-0.2570812211236214,8488600,9017640,24.068347297231654,37.81235616761152,NaN,NaN,-4.475322089020842,-6.912042970841176
2001-08-06T09:30:00-04:00,48.5,48.5,47.800005,47.9,236800,641960,44.785305028783775,46.90521904924121,NaN,NaN,-34.13470969847935,43.170893335754606,0.06134966957071794,-0.18039413416022398,-0.24174380373094193,8251800,8756440,22.151990846635243,35.88856203501858,NaN,NaN,-5.304080461077083,-6.682334040874877
2001-08-07T09:30:00-04:00,47.9,48.050005,47.65,47.949995,427400,624550,45.24845502792654,46.92608492606281,NaN,NaN,-71.56109051359905,27.14577149567278,0.03596131601285116,-0.19679215871487798,-0.23275347472772914,8679200,8711160,21.82753717817947,33.819607906249516,NaN,NaN,-5.869220507954156,-6.566174964743345
2001-08-08T09:30:00-04:00,47.5,48.160005,46.875,46.875,1126400,625700,37.889013726939055,46.240009293732065,NaN,NaN,-185.329287010147,-25.806527478555573,-0.048318464267027184,-0.29315155506151314,-0.24483309079448595,7552800,8352800,19.40509464109988,31.617691206576314,NaN,NaN,-8.616059602920528,-6.859015627340085
2001-08-09T09:30:00-04:00,47.1,47.35,46.725,47.35,535200,589750,42.35077579104258,45.872630951694426,NaN,NaN,-174.02204107459542,-83.01286658522648,-0.06606497716878762,-0.32741431225547046,-0.26134933508668284,8088000,8212080,18.53519932973896,29.446779796559902,NaN,NaN,-9.642274769725118,-7.2566240762522325
2001-08-10T09:30:00-04:00,47.175005,47.6,46.754995,47.300005,425400,598960,42.00872146180997,45.63244507223783,NaN,NaN,-136.87387369801596,-120.38420039896737,-0.07453280447990812,-0.354515340686568,-0.27998253620665986,7662600,8046880,17.5410628089909,27.481685656155655,NaN,NaN,-10.573889898393677,-7.73051919370101
2001-08-13T09:30:00-04:00,47.574995,47.81,47.305,47.699995,1614800,652340,45.78172052670508,45.98296908917269,NaN,NaN,-69.01702094324989,-127.36066264792146,-0.047854167129924075,-0.3398002451190649,-0.29194607798914085,9277400,8252000,23.059148069422932,26.35046877512753,NaN,NaN,-10.2993857450124,-8.097500129602636
2001-08-14T09:30:00-04:00,47.775,48.199995,47.71,47.85,4667800,857810,47.16990346674677,46.28317657328546,NaN,NaN,-17.44901152997136,-116.53824685119594,-0.016389334247438714,-0.31243274579843927,-0.29604341155100056,13945200,9305200,43.840068134014224,26.859632647311116,NaN,NaN,-9.682358486351895,-8.323908466281102
2001-08-15T09:30:00-04:00,47.875,48.115,47.51,47.79,931600,860500,46.6553475241694,46.18634672361789,NaN,NaN,-31.06062082269944,-85.68451361370641,0.0030612808558744264,-0.29221681048115755,-0.295278091337032,13013600,10397360,56.853997492384906,28.420719997479676,NaN,NaN,-9.304967666067878,-8.464059780536356
2001-08-16T09:30:00-04:00,47.625,48.25,47.25,48.1,1579400,917920,49.707895821574475,46.34219551977984,NaN,NaN,-16.549828178695055,-54.190071034526326,0.037567541959174444,-0.2483186638880639,-0.28588620584723834,14593000,11698360,66.74103736002907,30.88772195564274,NaN,NaN,-8.148024355119105,-8.418911862619606
2001-08-17T09:30:00-04:00,47.699995,48,47.300005,47.35,2412000,1007040,43.258392333193335,46.073895381808924,NaN,NaN,-62.565178247926326,-39.32833194450841,0.011969167399028091,-0.2709247465984532,-0.2828939139974813,12181000,12602040,71.60786369885582,33.74814957127289,NaN,NaN,-8.935374022488116,-8.49269217117225
2001-08-20T09:30:00-04:00,47.300005,47.875,47.275,47.875,2469600,1057920,48.313821704424534,46.1975491853123,NaN,NaN,-36.905996204700784,-32.906126996798605,0.03138052193298613,-0.24366826158124866,-0.2750487835142348,14650600,13676680,76.08882404072136,36.98486195588305,NaN,NaN,-8.120033182387457,-8.439455172774423
2001-08-21T09:30:00-04:00,47.85,48,47,47.050005,910400,1074030,41.98367774241646,45.456632805832335,NaN,NaN,-91.18785550231173,-47.65389579126669,-0.008239522223290385,-0.2853481862933478,-0.2771086640700574,13740200,13635680,75.59860256270507,40.26706537421895,NaN,NaN,-9.385414944641909,-8.574592283041207
2001-08-22T09:30:00-04:00,47.449995,47.675005,46.89,47.675005,1277800,1107740,47.5864055379789,45.20269362081347,NaN,NaN,-80.3524715075763,-57.51226592824207,0.009771717718457473,-0.26489401692198555,-0.274665734640443,15018000,14036560,77.14882900186768,43.89054303299123,NaN,NaN,-8.663916857289559,-8.587352936505258
2001-08-23T09:30:00-04:00,47.6,47.995005,47.050005,47.050005,842200,1118710,43.10362191784239,44.70307554368242,NaN,NaN,-79.48498357022221,-70.0992970065475,-0.016833400423951372,-0.29570748517038226,-0.2788740847464309,14175800,13953120,76.0656171006067,47.60463373323231,NaN,NaN,-9.51561249511462,-8.719961444878024
2001-08-24T09:30:00-04:00,47.5,48.050005,47.425005,48.050005,2401000,1209150,51.04926036432902,45.1505009247928,NaN,NaN,3.0740991430881834,-56.9714415283446,0.033733567233193595,-0.2367071257049389,-0.2704406929381325,16576800,14832280,79.35475729844889,51.69054562264756,NaN,NaN,-7.519418812894868,-8.548455354594715
2001-08-27T09:30:00-04:00,48.050005,48.225,47.675005,47.875,249400,1202720,49.74012019429941,45.471334150962285,NaN,NaN,20.495653107577066,-45.49111166588902,0.054956739497824036,-0.20174476856585244,-0.2567015080636765,16327400,15167640,80.4579666270349,55.87843344042295,NaN,NaN,-6.378485027544599,-8.238459593587555
2001-08-28T09:30:00-04:00,47.824995,47.85,47.25,47.35,985000,1219360,45.93446944932694,46.046009559704274,NaN,NaN,-53.11962769536802,-37.87746610450026,0.0342141147606799,-0.2139338646128266,-0.2481479793735065,15342400,15488080,81.47651303680499,60.31210618297332,NaN,NaN,-6.658277437148286,-8.012719285524803
2001-08-29T09:30:00-04:00,47.525,47.525,46.9,47.15,653000,1230060,44.53651286444615,46.202133636375954,NaN,NaN,-100.14019608905205,-41.83501102079541,0.008918263992092335,-0.2370001493833911,-0.24591841337548342,14689400,15422360,80.54923915086547,64.74168045591092,NaN,NaN,-7.31857440924968,-7.913555731771214
2001-08-30T09:30:00-04:00,46.9,47.1,46.305,46.555,959400,1250380,40.5797833954672,46.10006663163718,NaN,NaN,-194.01690378766048,-64.74139506428307,-0.04313371408125116,-0.29983555597704736,-0.2567018418957962,13730000,15333200,79.23179480639325,69.14816131286823,NaN,NaN,-9.136374944005695,-8.088244190661854
2001-08-31T09:30:00-04:00,46.699995,47.07,46.629995,46.945,995600,1285010,44.086260529992586,45.97896234615772,NaN,NaN,-135.86880456390276,-92.52997580568125,-0.046268554374621185,-0.31453753486407265,-0.26826898048945147,14725600,14962960,73.83158089265109,72.77476365738453,NaN,NaN,-9.565602727649427,-8.299295410231506
2001-09-04T09:30:00-04:00,46.85,47.245005,46.5,46.5,697400,1308040,41.105565808372106,45.54579537055953,NaN,NaN,-146.88574632290715,-126.0062556917781,-0.07176104077485723,-0.357970281458023,-0.2862092406831658,14028200,14503120,67.66318812975078,74.47641508565142,NaN,NaN,-10.849772393201519,-8.663649264941508
2001-09-05T09:30:00-04:00,46.6,46.675005,45.699995,46.175005,569200,1315130,39.030101504494326,45.00113494058274,NaN,NaN,-221.28889708548283,-159.64010956980104,-0.10210851167972057,-0.4138448802828165,-0.31173636860309595,13459000,14126440,63.01858114664009,74.9167424895268,NaN,NaN,-12.550408409007746,-9.218900571236684
2001-09-06T09:30:00-04:00,45.75,45.9,45.1,45.1,305400,1274080,33.08029897634671,43.8134494516379,NaN,NaN,-269.0811329435129,-193.4282969406932,-0.181539288331098,-0.5386604790169685,-0.35712119068587045,13153600,13819280,59.4357912318511,74.39493919465694,NaN,NaN,-16.07149335200457,-10.197842397060668
2001-09-07T09:30:00-04:00,44.65,45.050005,44.085,44.265,4950200,1494830,29.33910361897675,42.819214543479575,NaN,NaN,-274.68688368211167,-209.56229291958343,-0.271840314393253,-0.6969215836774367,-0.4250812692841837,8203400,12713960,48.70494782331586,72.75901663211837,NaN,NaN,-20.377856811862618,-11.652130170603805
2001-09-10T09:30:00-04:00,43.925005,44.300005,43.550005,43.925005,4777800,1712450,27.95286490151679,41.36486048612902,NaN,NaN,-238.08093790963855,-230.00471958873064,-0.33201123145059996,-0.8400953085974336,-0.5080840771468337,3425600,10453960,34.85025587108825,69.81340462000172,NaN,NaN,-24.301972720168152,-13.459250534827282
2001-09-17T09:30:00-04:00,41,42.495005,41,41.75,1337000,1698560,21.088393584121604,39.87234018910795,NaN,NaN,-281.17203959818875,-256.86197824378695,-0.4864922515276813,-1.1161993915564352,-0.6297071400287539,2088600,8066040,26.328250401634477,66.29409375135381,NaN,NaN,-30.79569469363109,-15.935885414656397
2001-09-18T09:30:00-04:00,41.870005,41.925005,40.800005,41.074995,4303400,1680340,19.488842111877133,37.865371372957824,NaN,NaN,-224.44614966057006,-257.49342875880444,-0.5951515567720056,-1.373646585993761,-0.7784950292217554,-2214800,4931280,19.56465941815253,62.18093878108845,NaN,NaN,-36.493221518105216,-18.872647715149085
2001-09-19T09:30:00-04:00,41.254995,41.35,38.800005,40.08,1636000,1715560,17.394424083791264,36.02900009909703,NaN,NaN,-207.75512659080954,-245.22822748826374,-0.6884591420017356,-1.639068956723925,-0.9506098147221893,-3850800,1530400,15.048092222324556,57.82254414692544,NaN,NaN,-41.933621293950324,-22.16707251212069
2001-09-20T09:30:00-04:00,39.550005,39.65,38.300005,38.555,732000,1673190,14.773807961580587,33.437896356043574,NaN,NaN,-194.83641581027356,-229.2581339138961,-0.7995077720034396,-1.9499945297264887,-1.150486757723049,-4582800,-1026840,12.678061838166556,53.059923042619566,NaN,NaN,-47.56945435532269,-25.79598420400669
2001-09-21T09:30:00-04:00,37.25,38.025,36.75,37.83,1011200,1603150,13.715848832215414,30.864734115894716,NaN,NaN,-183.40287607639112,-218.32252154724665,-0.8629784214928935,-2.229209784589166,-1.3662313630962726,-5594000,-2830760,11.323263789410731,48.12172998278926,NaN,NaN,-52.35170274975904,-29.58965828197131
2001-09-24T09:30:00-04:00,38.25,39.29,38.25,39,1702800,1564810,23.26573739004988,29.245538968803494,NaN,NaN,-127.95888351323063,-187.67989033025503,-0.7703995028897648,-2.3292307417084785,-1.5588312388187138,-3891200,-4026720,10.520578365381425,43.053448934830435,NaN,NaN,-52.70577014198646,-32.89195997625919
2001-09-25T09:30:00-04:00,39.120005,39.75,38.875,39.475,924600,1565520,26.807553179475164,27.979184705591283,NaN,NaN,-100.88757126073413,-162.96817465028784,-0.6274622581317018,-2.343159061483341,-1.7156968033516393,-2966600,-4177080,10.4205633295131,38.04425780473383,NaN,NaN,-51.724924817478666,-35.58238352500483
2001-09-26T09:30:00-04:00,39.6,39.800005,38.675005,38.89,990600,1551160,25.26110312812189,26.884993257923764,NaN,NaN,-92.94893339945851,-140.0069360120176,-0.5266710069433214,-2.374035562030791,-1.8473645550874696,-3957200,-4198360,10.4054864294379,33.128092920665594,NaN,NaN,-51.45971824067727,-37.85057419867232
2001-09-27T09:30:00-04:00,38.89,39.525,38.315,39.515,1879400,1603020,29.91294925815356,25.872613881363833,NaN,NaN,-82.4503776993998,-117.52972838984286,-0.37915992897898465,-2.3213144663112004,-1.9421545373322158,-2077800,-3697360,13.575833752026412,28.824110982049543,NaN,NaN,-49.6938328649303,-39.54246829385203
2001-09-28T09:30:00-04:00,39.800005,40.39,39.64,40.1,2264800,1596210,34.05056601663277,25.368685324811022,NaN,NaN,-57.74345629777363,-92.39784443411936,-0.2117870675407223,-2.2068883717581187,-1.9951013042173964,187000,-2541160,20.561922154860554,25.459734840985956,NaN,NaN,-46.90245984397407,-40.59389565815518
2001-10-01T09:30:00-04:00,40.1,40.144995,39.025,39.75,906000,1629040,32.802835700503024,24.92388062452593,NaN,NaN,-59.77419002300274,-78.76090573607378,-0.09992599707730099,-2.1200088005640225,-2.0200828034867215,-719000,-1906720,24.183556191727178,22.685804487063603,NaN,NaN,-45.02763237007453,-41.22728661700081
2001-10-02T09:30:00-04:00,39.5,40.185,39.5,40.185,1107200,1635150,35.94449266527802,25.12846588802102,NaN,NaN,-48.34187682822363,-68.25176684957167,0.02160203374701153,-1.993080261302957,-2.0146822950499685,388200,-1235760,27.92591750943477,20.43509922117672,NaN,NaN,-42.51850680772396,-41.411746644246975
2001-10-03T09:30:00-04:00,39.5,41.375,39.5,41.1,1441200,1674560,42.07875347501172,26.038440877737806,NaN,NaN,-28.23727696260416,-55.309435562200804,0.17340167108194704,-1.7979302061975346,-1.9713318772794817,1829400,-78440,33.979374383429146,19.383272546899097,NaN,NaN,-38.41619727370795,-40.98381101988426
2001-10-04T09:30:00-04:00,41.25,41.97,41.025,41.51,2346200,1743900,44.637171340700014,27.230177051965175,NaN,NaN,-1.7143577202610285,-39.162231566373045,0.3035942393813056,-1.5918390780528497,-1.8954333174341553,4175600,1172240,39.85804715005989,19.740971923968505,NaN,NaN,-34.248603543520204,-40.02163852326082
2001-10-05T09:30:00-04:00,41.449995,41.449995,40.504995,41.300005,503800,1719310,43.57551039196126,28.836399681096584,NaN,NaN,-6.010655609955465,-28.815671428809406,0.3731604206833887,-1.4289827915799194,-1.802143212263308,3671800,1869200,42.908854204878644,20.925300767057372,NaN,NaN,-31.140847033297682,-38.75295402469466
2001-10-08T09:30:00-04:00,40.75,41.394995,40.75,40.925005,348000,1701840,41.66954532750363,30.420735625069902,NaN,NaN,1.323440083427561,-16.596145407523345,0.389699641267792,-1.315018660678568,-1.70471830194636,3323800,2677760,46.311432408490816,22.835784552081538,NaN,NaN,-29.058453064825912,-37.36802531614198
2001-10-09T09:30:00-04:00,40.824995,40.975,40.5,40.585,1017200,1724240,39.96280618259885,32.03276291784187,NaN,NaN,-1.2151658580191065,-7.170803213482446,0.3734806717392154,-1.237867462272341,-1.6113481340115563,2306600,3061440,47.89827217128414,25.182225977007224,NaN,NaN,-27.772691558404183,-35.99726335075087
2001-10-10T09:30:00-04:00,40.550005,42,40.550005,42,638600,1740900,49.27453363076566,34.497100465640806,NaN,NaN,52.39759101102107,8.956170381242607,0.4487288095527442,-1.0504371220706261,-1.4991659316233703,2945200,3284600,48.84531270237348,27.76560103873629,NaN,NaN,-23.687706452437236,-34.23875522242035
2001-10-11T09:30:00-04:00,42.5,43.199995,42.5,42.675005,1523400,1569560,53.0180213082588,37.30439849964391,NaN,NaN,132.66651650469254,35.83234522623333,0.5291146306479022,-0.8377726433134924,-1.3668872739613946,4468600,3343200,49.10691476648352,30.464433251384346,NaN,NaN,-19.053379969575676,-32.0694159005854
2001-10-12T09:30:00-04:00,42.56,42.89,41.9,42.54,573800,1359360,52.18845266725993,39.37030673373034,NaN,NaN,125.04318819669727,62.04311398756388,0.5556077893763631,-0.6723775372409406,-1.2279853266173038,3894800,3387800,49.31934672958947,33.235773848827776,NaN,NaN,-15.547267268535702,-29.709108953149727
2001-10-15T09:30:00-04:00,42.375,42.785005,42.15,42.699995,590600,1322040,53.12453836543861,41.25009138987059,NaN,NaN,124.29583292896604,86.63759255667158,0.5644931245356557,-0.5223689209477342,-1.08686204548339,4485400,3620120,50.47889239416478,36.09708306773147,NaN,NaN,-12.390943740056775,-27.235085351279306
2001-10-16T09:30:00-04:00,42.949995,43.4,42.865,43.275,966400,1155190,56.42638075555301,43.4761826489728,NaN,NaN,143.63130661046213,115.60688705036782,0.5870748076955838,-0.3530185358639102,-0.940093343559494,5451800,4249160,53.57605523486489,39.18069512526197,NaN,NaN,-8.694651665763226,-24.58645196763415
2001-10-17T09:30:00-04:00,43.65,43.725,42.050005,42.050005,797400,1113260,48.576168246200695,44.8092697195476,NaN,NaN,100.4403558863415,125.21544002543189,0.500847470182695,-0.3140340058311253,-0.8148814760138203,4654400,4591000,55.21525941816895,42.15493981570072,NaN,NaN,-7.68719987781563,-22.172273097660078
2001-10-18T09:30:00-04:00,42.275,42.275,41.65,41.78,969400,1125130,47.023300392287716,45.73589360352296,NaN,NaN,58.44497690180526,110.37113210485445,0.41074462408311396,-0.3014506959099279,-0.7121953199930419,3685000,4434280,54.26917378142332,44.562600646169486,NaN,NaN,-7.323529789618438,-20.051024053654128
2001-10-19T09:30:00-04:00,41.725,42.475,41.725,42.300005,519200,1100530,50.31739452226899,46.98693351936338,NaN,NaN,66.17136841850684,98.59676814921636,0.37241644687211894,-0.24667476140289324,-0.6190912082750122,4204200,4496160,54.5999529872882,46.735200417280986,NaN,NaN,-6.044325359829897,-18.050067097393523
2001-10-22T09:30:00-04:00,42.375,42.875,42.339995,42.68,369600,1033870,52.63512304757302,48.17912140381303,NaN,NaN,84.5531936004834,90.64824028351984,0.3587649319365509,-0.17063504335432356,-0.5293999752908745,4573800,4513840,54.70077064541922,48.64768992699417,NaN,NaN,-4.2953676897672075,-16.085110039161194
2001-10-23T09:30:00-04:00,43.004995,43.144995,42.4,42.4,851600,1030220,50.75618689383706,48.79893807658626,NaN,NaN,78.31920438952707,77.58581983933283,0.3183588689378915,-0.13145138911851006,-0.44981025805640157,3722200,4167920,52.25569647420358,49.953141504906625,NaN,NaN,-3.36430472188279,-14.26785213669285
2001-10-24T09:30:00-04:00,42.5,42.69,42.300005,42.675005,527600,1007070,52.54786258717569,49.36398745133452,NaN,NaN,67.18284050517124,70.93431676309879,0.297995244372708,-0.07731620259051653,-0.37531144696322455,4249800,4087000,51.67381569709009,50.797124972551636,NaN,NaN,-2.0806394437017985,-12.526821751979844
2001-10-25T09:30:00-04:00,42.199995,43.625,42,43.625,1195000,972850,58.20500851316552,50.408951602849115,NaN,NaN,94.85328528229273,78.21597843919628,0.3336584202401816,0.04176157833700245,-0.29189684190317916,5444800,4438960,54.069468930752834,51.594311738685505,NaN,NaN,0.7601430195717638,-10.628683927472471
2001-10-26T09:30:00-04:00,43.199995,43.824995,43.199995,43.625,951600,907190,58.20500851316552,51.59005611611068,NaN,NaN,118.83360142745441,88.7484250409858,0.34118165001942596,0.1345802206211033,-0.20660142939832266,5444800,4687080,55.73537823410159,52.267450726229136,NaN,NaN,3.062340557439547,-8.672823286770754
2001-10-29T09:30:00-05:00,43.504995,43.51,42.699995,42.75,516400,887710,51.62995289052687,52.42342373810554,NaN,NaN,73.34017878714633,86.50582207831839,0.27405484878054015,0.13596713157735252,-0.13808771720318763,4928400,4758000,56.224116612128064,52.86215390057513,NaN,NaN,3.21353934662237,-6.974771482000308
2001-10-30T09:30:00-05:00,42.4,42.4,41.675005,41.85,887200,876710,45.888026810079324,52.1815303937708,NaN,NaN,-19.020114407552484,67.03795831890247,0.16143768412223064,0.06370938794960068,-0.09772829617262996,4041200,4821800,56.687425170870476,53.42230479118206,NaN,NaN,1.5663096706871782,-5.754617031616381
2001-10-31T09:30:00-05:00,42.324995,42.885,42.205,42.550005,1531200,881210,50.49919969107315,52.00161456397183,NaN,NaN,29.071367389657002,59.415663695799616,0.12795225088882806,0.0622120174384051,-0.06574023345042294,5572400,5086320,58.641850238963436,54.10337161064491,NaN,NaN,1.5741000651023414,-4.707657446370849
2001-11-01T09:30:00-05:00,42.67,43.300005,42.25,43.300005,786000,803200,54.93063373940905,52.1974846405539,NaN,NaN,66.79094954887361,53.80319654911578,0.1487193506590213,0.12015895487335371,-0.02856039578566761,6358400,5269040,59.98504686021538,54.86520733426105,NaN,NaN,2.9750069845064853,-3.6101339562455155
2001-11-02T09:30:00-05:00,43.225,43.35,42.925005,43,369600,796490,52.89093861947063,52.18079894441333,NaN,NaN,80.01911311406747,46.04029888643839,0.13505441380383987,0.14025762146913223,0.005203207665292357,5988800,5377840,60.80139718297784,55.60252910489055,NaN,NaN,3.4949149279209197,-2.5951269727931674
2001-11-05T09:30:00-05:00,43.6,43.65,43.31,43.625,304800,794330,56.51369679124887,52.1870358041059,NaN,NaN,133.54694356806758,58.08165184262265,0.15924832381335569,0.20426361243198699,0.045015288618631286,6293600,5650880,62.8497200357848,56.26493373352769,NaN,NaN,5.048469530462285,-1.5031846151852457
2001-11-06T09:30:00-05:00,43.375,44.25,43.25,44.25,1671200,827030,59.83965658361962,52.99157068535011,NaN,NaN,175.64658677249366,97.01499207863188,0.2055401817060877,0.3019405157512409,0.09640033404515322,7964800,6435600,68.02169478481153,57.179679116859305,NaN,NaN,7.399633952937496,-0.23135339116771125
2001-11-07T09:30:00-05:00,43.85,44.324995,43.805,43.949995,584200,824310,57.563788765001306,53.74446271197251,NaN,NaN,169.3800084749383,125.07672029568815,0.20375578376894918,0.3510950637563397,0.14733927998739052,7380600,6797240,70.0884081743665,58.309624430640966,NaN,NaN,8.655355276703897,1.038176418528233
2001-11-08T09:30:00-05:00,44.175005,44.449995,43.475,43.85,483200,772300,56.788518800605296,54.20668587471082,NaN,NaN,132.07171124095052,138.13287263410353,0.18423143145134427,0.37762856930157085,0.19339713785022658,6897400,6905040,70.69636575560955,59.45936819980677,NaN,NaN,9.457568975350537,2.240946783788562
2001-11-09T09:30:00-05:00,43.53,43.745005,43.415,43.699995,421400,764680,55.57923485955915,54.41697957556697,NaN,NaN,83.25854192397495,138.78075839608502,0.1510000961530578,0.3821472580415488,0.23114716188849102,6476000,7002480,71.26489105882114,60.64251965790691,NaN,NaN,9.790604084618648,3.3194692553357172
2001-11-12T09:30:00-05:00,43.35,43.89,42.53,43.875,230200,746660,56.736723030141654,54.84416072816015,NaN,NaN,53.3547993924043,122.74232956095236,0.1313167501334498,0.39529309955530323,0.26397634942185344,6706200,7085000,71.76450025040302,62.03600564192114,NaN,NaN,10.3820040893838,4.328402803056872
2001-11-13T09:30:00-05:00,44.25,44.675005,44.125,44.675005,442200,720450,61.65553415238118,55.494708697103405,NaN,NaN,160.74348286749418,119.76170877995246,0.1607435972989203,0.4649058460455038,0.3041622487465835,7148400,6921720,69.20068673938879,63.28792500208534,NaN,NaN,12.324731587582377,5.470735486560516
2001-11-14T09:30:00-05:00,45,45.120005,44.21,45.120005,285600,694860,64.10054390734902,55.91581836811646,NaN,NaN,164.66098904056335,118.81790489307745,0.1963872012593602,0.5496462503207837,0.3532590490614235,7434000,6932400,69.2779991488205,64.37424858909017,NaN,NaN,14.705102374674702,6.789930756291113
2001-11-15T09:30:00-05:00,44.9,45.199995,44.699995,44.949995,363400,664560,62.46187188505242,56.21988003753696,NaN,NaN,157.14311525201475,123.8321856952903,0.19436274374121276,0.5962124787379395,0.4018497349967267,7070600,6967040,69.54502769915895,65.36065212230855,NaN,NaN,16.23744031107966,8.139574978403763
2001-11-16T09:30:00-05:00,44.83,45.074995,44.64,44.995005,423200,659760,62.733495926819494,57.012990254415,NaN,NaN,137.10189588387595,134.6008564872705,0.18211388251379806,0.6294920881389743,0.4473782056251762,7493800,7170600,71.13288276656357,66.42556399048252,NaN,NaN,17.582797818331112,9.488606812679098
2001-11-19T09:30:00-05:00,45.074995,45.69,45.004995,45.5,316200,657090,65.72973083217961,58.43025482742217,NaN,NaN,158.71878430355366,155.67365346950038,0.19303876238192985,0.6886766586025885,0.4956378962206587,7810000,7391360,72.78978632007673,67.57573264399724,NaN,NaN,19.60703994915088,10.934097260746496
2001-11-20T09:30:00-05:00,45.5,45.824995,45.050005,45.24,457000,637360,62.92462782448008,59.317785408379805,NaN,NaN,134.7006453421507,150.4650859644317,0.1686556258441998,0.7064574285259084,0.5378018026817086,7353000,7432280,73.09801851989558,68.60831609263526,NaN,NaN,20.580288920176578,12.312124640665079
2001-11-21T09:30:00-05:00,45.15,45.225,44.68,45.085,384800,630220,61.24655178512619,59.76892241164531,NaN,NaN,93.02846831001672,136.13858181832236,0.12973676737578121,0.6999727619014351,0.5702359945256539,6968200,7339120,71.12271906739029,69.40386410743346,NaN,NaN,20.95808803913225,13.547262269017532
2001-11-23T09:30:00-05:00,45.025,45.775,45.025,45.74,224600,581700,65.44075537235763,60.66533789399438,NaN,NaN,119.11276261216386,128.53251129035215,0.1351440022326239,0.7391659973164337,0.6040219950838098,7192800,7363560,71.34151386390987,70.15672958464289,NaN,NaN,22.47654341374542,14.822873861121515
2001-11-26T09:30:00-05:00,45.74,46.074995,45.449995,45.975,549200,561580,66.827904977025,61.40206705012125,NaN,NaN,123.91294832319953,125.89472177821688,0.14093907813904893,0.780195842757621,0.6392567646185721,7742000,7413200,71.80872233130765,70.7966583200374,NaN,NaN,24.152905355054532,16.155735503111945
2001-11-27T09:30:00-05:00,45.949995,46.17,45.555,45.824995,420800,556800,65.03350691594312,61.77305635957293,NaN,NaN,111.13817774307347,116.37860046612082,0.12178210952046165,0.7914844015191491,0.6697022919986875,7321200,7315440,69.40885922263293,70.89574149416748,NaN,NaN,25.082373881722837,17.430969557199216
2001-11-28T09:30:00-05:00,45.6,45.870005,45.025,45.025,641400,544510,56.34435175749683,61.68595371617975,NaN,NaN,67.11067581807883,102.86060656130647,0.046231513378974354,0.7274916837224055,0.6812601703434311,6679800,7180800,66.13084426600115,70.61305835785568,NaN,NaN,23.38788082837895,18.281956881653464
2001-11-29T09:30:00-05:00,45.175005,46.35,45.1,46.35,507000,493300,64.74596208338238,62.254342522092394,NaN,NaN,106.99316824729308,105.65354654876174,0.07480181667698726,0.7747624411896652,0.6999606245126779,7186800,7224520,66.68111599948003,70.32625480384642,NaN,NaN,24.508011088150166,19.171393196867278
2001-11-30T09:30:00-05:00,46.199995,46.285005,45.699995,45.800005,740200,491010,59.617105814537084,62.54276187601939,NaN,NaN,100.11971176481644,101.85493637929224,0.04730709103671349,0.7590944883085697,0.7117873972718562,6446600,7075280,62.92298494859834,69.73040436740195,NaN,NaN,23.736032471052376,19.823484521750864
2001-12-03T09:30:00-05:00,45.449995,45.705,45.300005,45.5,210800,483070,56.966286159865895,62.559159242428265,NaN,NaN,59.70518579452893,89.01338387355811,0.0019591657170445753,0.714236354418162,0.7122771887011174,6235800,6774040,56.055476656189356,68.60833125352954,NaN,NaN,22.25653279890641,20.1710628470588
2001-12-04T09:30:00-05:00,45.5,46.675005,45.480005,46.550005,680400,501850,63.14323573084481,62.665423640889955,NaN,NaN,119.6234317914801,90.71043468323944,0.03394843288694305,0.7547127298097962,0.7207642969228532,6916200,6693040,54.338154306443066,67.54672179403342,NaN,NaN,23.015266876617087,20.57737770842427
2001-12-05T09:30:00-05:00,47.050005,47.99,46.9,47.574995,600400,448310,67.97559526191014,62.942213023358605,NaN,NaN,207.66281863765116,118.8208632471539,0.11106044958809647,0.8595898589079738,0.7485294093198773,7516600,6860400,57.252215799793895,66.68773726910294,NaN,NaN,25.376007677859857,21.262896275486497
2001-12-06T09:30:00-05:00,47.800005,48.25,47.675005,48.25,738000,456000,70.70005780860397,63.53065487504086,NaN,NaN,224.4175945304887,142.30574850379304,0.1898238378844168,0.9858092066753983,0.7959853687909815,8254600,7073960,60.698910150137024,66.0558717298871,NaN,NaN,28.26093800924469,22.26261652316624
2001-12-07T09:30:00-05:00,48.074995,48.24,47.78,47.885,526800,458180,67.36279482415452,63.861319081993365,NaN,NaN,183.9500821729814,159.07182258542602,0.1986900305567405,1.044347906986907,0.8456578764301665,7727800,7330200,64.4071175876835,65.57545993139566,NaN,NaN,29.4329223658651,23.28694592926608
2001-12-10T09:30:00-05:00,47.875,48.089995,47,47.055,674600,470840,60.38281842586976,63.479396767256944,NaN,NaN,122.73601314428662,171.67798805537754,0.13315316622936302,1.0120993342168703,0.8789461679875072,7053200,7493680,66.57405097022055,65.13147883497736,NaN,NaN,28.039263582934876,23.965848451218765
2001-12-11T09:30:00-05:00,47.425005,47.699995,47.03,47.324995,429000,480780,61.77051531072757,63.396960159131766,NaN,NaN,106.34277795871263,169.02185728882404,0.09431308603505517,0.9968375255313262,0.902524439496271,7482200,7606880,68.02566258705163,64.76916769691708,NaN,NaN,27.378893875566607,24.453426368982743
2001-12-12T09:30:00-05:00,47.449995,47.565,46.865,47.4,249400,471140,62.16697702884287,63.462704819397246,NaN,NaN,86.56204585782949,144.80170273285972,0.06158332924821153,0.9795036010565354,0.9179202718083239,7731600,7649880,68.58378221933403,64.58781506491306,NaN,NaN,26.97603703832328,24.813799321745677
2001-12-13T09:30:00-05:00,46.975,47.269995,46.550005,46.555,796400,496680,55.21922515728679,62.73259551832076,NaN,NaN,43.996430851403964,108.71746999704278,-0.024453777934289156,0.8873530493904624,0.9118068273247516,6935200,7386000,61.49036477808697,63.88416155878285,NaN,NaN,24.407505981939266,24.755757416059048
2001-12-14T09:30:00-05:00,46.65,46.949995,46.365,46.949995,1147400,535880,57.604424379810034,62.07377547566254,NaN,NaN,35.32653403061544,78.99276036856959,-0.060203373129728566,0.8365526109125909,0.8967559840423195,8082600,7456960,62.61026239107411,63.22712870590902,NaN,NaN,23.016099612886208,24.507234872748644
2001-12-17T09:30:00-05:00,46.83,47.85,46.83,47.85,799200,554680,62.50497330809749,61.89316593224499,NaN,NaN,82.58194616499586,70.96194697271144,-0.030193903119315135,0.8590136051431756,0.8892075082624907,8881800,7822680,67.80658133041999,63.11268028503666,NaN,NaN,23.365019256621668,24.344061213301934
2001-12-18T09:30:00-05:00,48.25,48.324995,47.815,48.275,1727800,625260,64.58667995548338,62.48190366067261,NaN,NaN,115.34854533975009,72.76310044891892,0.009214037602182978,0.9007250552652195,0.8915110176630365,10609600,8448160,74.367729665774,63.701029242163294,NaN,NaN,24.309450739317327,24.339116859875563
2001-12-19T09:30:00-05:00,47.875,48.19,47.565,47.9,1551600,679990,61.35008713198145,62.23934116414397,NaN,NaN,88.20853480866602,73.09239823908624,0.0013717966059674236,0.8932257634204959,0.8918539668145284,9058000,8713440,76.55056468524828,64.40598986257531,NaN,NaN,24.09077656811062,24.303639675337713
2001-12-20T09:30:00-05:00,47.9,47.915,46.975,47.15,5581600,939830,55.373394359970234,61.93621891738918,NaN,NaN,43.28629564665786,72.950371198137,-0.05960959020464307,0.8173419790587246,0.8769515692633677,3476400,8021680,61.77669871845784,64.32411227470813,NaN,NaN,22.008953106907935,23.975827308419174
2001-12-21T09:30:00-05:00,47.449995,48.24,47.205,48.1,1577800,1007490,60.60817912274978,62.19635412902375,NaN,NaN,76.08074479282261,81.10121335057849,-0.04207492826792436,0.8243579089284623,0.8664328371963866,5054200,7416000,52.26553556609119,64.05340219684398,NaN,NaN,21.892058785984357,23.678146090928486
2001-12-24T09:30:00-05:00,48.225,48.425005,48.105005,48.324995,319000,995980,61.752485037728114,62.09701479380113,NaN,NaN,103.14089036413426,85.21300219040617,-0.02241935212210966,0.8384086470437495,0.8608279991658592,5373200,6714280,43.84346119687895,63.303781260446534,NaN,NaN,22.15599303841872,23.460695654855662
2001-12-26T09:30:00-05:00,48.300005,48.870005,48.300005,48.75,963000,1023090,63.886565246975564,61.8049412213058,NaN,NaN,124.35819499712538,87.01493212188123,0.0103504633587852,0.8737660783643406,0.8634156150055554,6336200,5859600,36.19350890984249,61.799587911164295,NaN,NaN,23.032159322413904,23.399476178792554
2001-12-27T09:30:00-05:00,48.75,49.074995,48.730005,48.949995,1705200,1076280,64.87962735873157,61.38919618917206,NaN,NaN,145.33342203546215,98.43990956724046,0.03523897877752391,0.9074643384774603,0.8722253596999364,8041400,5656280,34.64485666484576,59.93858409078634,NaN,NaN,24.04288901761812,23.491392298624778
2001-12-28T09:30:00-05:00,49.15,49.265,48.875,49,2017600,1151810,65.13775938424408,61.23026508632131,NaN,NaN,142.9845602111874,118.37956248014636,0.04423062274212508,0.9275136381275928,0.8832830153854677,10059000,6972800,49.66370167026361,58.885482953827776,NaN,NaN,24.939003995332097,23.698193969582967
2001-12-31T09:30:00-05:00,49.125,49.199995,48.175005,48.175005,2346600,1232130,57.6140234071819,61.032494013557894,NaN,NaN,84.82937103900471,120.12928772938278,-0.013154207558371045,0.8668402559375039,0.879994463495875,7712400,7504440,54.237158828288415,58.0042763722612,NaN,NaN,23.5218822018958,23.673006574199086
2002-01-02T09:30:00-05:00,48.550005,48.644995,47.64,48.4,1807400,1311960,59.00474611405661,60.83493907093854,NaN,NaN,50.137386838084026,109.52858702417275,-0.04209642844219741,0.8273739279431283,0.8694703563853257,9519800,8333760,60.29717669121485,57.45224166541572,NaN,NaN,22.742261541369064,23.540042998080512
2002-01-03T09:30:00-05:00,48.5,49.295,48.5,49.295,1013400,1328610,64.05682007839619,60.96992786019234,NaN,NaN,131.81468098098023,111.01988422094371,-0.00884007360327621,0.8584202643812304,0.8672603379845066,10533200,9173160,65.30510407594139,57.21805036945913,NaN,NaN,23.572598342135183,23.544693761516893
2002-01-04T09:30:00-05:00,49.375,49.92,49.15,49.725,1304400,1363810,66.21127787278029,61.75507448272759,NaN,NaN,169.52419063012837,115.85803793987695,0.03200272507852264,0.9072637443326599,0.8752610192541372,11837600,9932400,69.10147920759678,57.7617014001384,NaN,NaN,24.925885569160116,23.742006876894497
2002-01-07T09:30:00-05:00,49.675005,49.9,48.925005,48.925005,1661800,1410000,59.112197415607255,61.86277255671312,NaN,NaN,114.42196724422857,110.14551934648519,-0.00310883530056949,0.8713749751284254,0.8744838104289949,10175800,9955760,69.21310072521479,58.233332709719875,NaN,NaN,23.894261060977428,23.76375747462063
2002-01-08T09:30:00-05:00,49.125,49.620005,48.65,49.5,743600,1420840,62.24548663339008,61.84423779423401,NaN,NaN,101.61472967107754,113.50259107289976,0.003769224792753656,0.8791953414199369,0.8754261166271833,10919400,10597160,72.18435716329095,58.54603098349637,NaN,NaN,24.0007719928406,23.797616691509198
2002-01-09T09:30:00-05:00,49.875,50.065,49,49,868800,1430550,58.07768868013918,61.379309845995145,NaN,NaN,99.65746368406495,123.40660644209595,-0.03200725409289029,0.8354170490110704,0.8674243031039607,10050600,10703320,72.65476280041807,58.42367620739952,NaN,NaN,22.789102477986738,23.65354323243456
2002-01-10T09:30:00-05:00,49.074995,49.300005,48.980005,49.300005,365200,1427360,59.81625925746005,61.26975071210076,NaN,NaN,76.8735286888909,112.41837598367809,-0.04151590836486985,0.8155294176478733,0.8570453260127432,10415800,10679840,72.36327291889441,58.12458393837425,NaN,NaN,22.31557475518242,23.4624048785414
2002-01-11T09:30:00-05:00,49.375,49.475,48.550005,48.699995,802800,1455030,54.91142330392472,61.23675277952608,NaN,NaN,45.77901289382435,87.66934043641729,-0.09140417123997924,0.7427901119627691,0.8341942832027484,9613000,10234920,66.88718010050681,58.48961832280632,NaN,NaN,20.401337884939565,23.02510959374114
2002-01-14T09:30:00-05:00,48.629995,48.629995,47.85,47.975,781000,1454260,49.61723921354756,60.451685643154484,NaN,NaN,-36.18969877079223,57.54700723341314,-0.1717542874449861,0.6195014238965157,0.7912557113415019,8832000,9966160,63.74889325800219,59.30985815794282,NaN,NaN,17.06878876603313,22.17420661835428
2002-01-15T09:30:00-05:00,48.095,48.300005,47.730005,48.300005,1170000,1455390,51.85802309758709,59.744938361715846,NaN,NaN,-53.782135066501965,26.467634285897237,-0.1995852075373159,0.541774201919857,0.7413594094571729,10002000,9782680,61.62318967021569,60.57983876318116,NaN,NaN,15.002258248893362,21.149642565574148
2002-01-16T09:30:00-05:00,47.75,47.925005,47.1,47.32,4382800,1634570,45.3136244757142,58.41829973519718,NaN,NaN,-131.6227406459565,-19.78840658010706,-0.2758669645512425,0.3965257037681198,0.6723926683193623,5619200,8896400,52.514137417244974,61.745597942281336,NaN,NaN,11.042534069107173,19.705769923221723
2002-01-17T09:30:00-05:00,47.75,48,47.26,47.550005,813400,1588850,47.00402773279922,57.14147119048772,NaN,NaN,-105.05840740135315,-56.174793798155875,-0.30066918373626195,0.2965561886490349,0.5972253723852968,6432600,8099760,45.94056840296013,62.552434495003794,NaN,NaN,8.361490775197396,18.085158616361106
2002-01-18T09:30:00-05:00,47.550005,47.83,46.9,46.949995,991000,1560820,43.24836353387645,55.57794291546146,NaN,NaN,-135.95696867760793,-92.52199011244234,-0.34418918496586537,0.16698889117796512,0.5111780761438305,5441600,7265480,40.2572326337932,61.88054384954162,NaN,NaN,4.900215377784523,16.201595296564452
2002-01-22T09:30:00-05:00,47.375,47.545,46.555,46.65,1331400,1348310,41.46447362736014,54.42440364547419,NaN,NaN,-160.71054331502697,-117.42615902128928,-0.37722900579435825,0.0396418189008827,0.41687082469524095,4110200,6321120,34.981784633041784,60.505159978452575,NaN,NaN,1.504285079716935,14.101979551300522
2002-01-23T09:30:00-05:00,46.824995,47.425005,46.4,47.300005,1752600,1357050,46.603690825703474,53.5386139820204,NaN,NaN,-134.45792565087737,-133.56131713816436,-0.3404814887421563,-0.008731036232454414,0.33175045250970187,5862800,5493280,31.130583527088547,58.42183189530069,NaN,NaN,0.13685688019394177,12.106962026856724
2002-01-24T09:30:00-05:00,47.550005,47.89,47.550005,47.675005,956600,1388930,49.36567824056282,52.48924670788944,NaN,NaN,-64.72106123451988,-120.18098125587703,-0.27869313633102,-0.01661596790407316,0.26207716842694684,6819400,5733320,33.41946554575381,56.14428628600158,NaN,NaN,-0.16893076430242265,10.353263056691132
2002-01-25T09:30:00-05:00,47.675005,47.785005,47.33,47.64,770400,1379300,49.11031014904329,51.2677490133368,NaN,NaN,-68.14252839006429,-112.79780545361925,-0.22997908419434204,-0.02539668681598073,0.2045823973783613,6049000,5656600,33.04148777625734,53.56857261233448,NaN,NaN,-0.4885857240610451,8.804427516583678
2002-01-28T09:30:00-05:00,47.800005,48,47.5,47.949995,617600,1324920,51.502891214115316,50.724227141801656,NaN,NaN,-43.139986459122404,-94.23440900992215,-0.16947215841760346,-0.007257800643643009,0.16221435777396045,6666600,5901600,35.54841948213432,51.16395252354301,NaN,NaN,-0.08154110584682658,7.535003427665035
2002-01-29T09:30:00-05:00,47.925005,48.015,46.824995,47.105005,1519000,1299990,45.25687656412531,49.510754993997026,NaN,NaN,-80.65527759974073,-78.2233558668649,-0.17806774405608944,-0.06037032229615136,0.11769742175993808,5147600,6109080,37.67647784792924,48.699104001017176,NaN,NaN,-1.5698591697414472,6.23430877089268
2002-01-30T09:30:00-05:00,47.199995,47.795,46.5,47.695,1250600,1245190,49.831776086491026,48.92176123730788,NaN,NaN,-72.31304564835285,-65.79437986636,-0.13754160758733983,-0.054229587724236694,0.08331201986310313,6398200,6216160,38.79958485788069,46.280877005121646,NaN,NaN,-1.4633644376040436,5.134641169678862
2002-01-31T09:30:00-05:00,47.800005,48.1,47.504995,48.1,2674000,1288520,52.75080107231437,48.41708565265462,NaN,NaN,-20.533843961958894,-56.95693641184782,-0.0798438379600744,-0.01649277758698986,0.06335106037308454,9072200,6666720,43.41980375695991,44.21348635069775,NaN,NaN,-0.48903094242224376,4.331259439378704
2002-02-01T09:30:00-05:00,47.75,48.185,47.615,47.824995,768400,1276270,50.59795822434556,48.108981004113254,NaN,NaN,-18.9592913528416,-47.12028900440328,-0.05762218399063764,-0.008676669615212518,0.048945514375425124,8303800,7117680,47.67742809423031,42.84136120739229,NaN,NaN,-0.3060270949637222,3.6687899344726436
2002-02-04T09:30:00-05:00,47.625,47.705,46.555,46.699995,2787200,1350410,42.887042096112395,47.62825263858217,NaN,NaN,-97.43720808102064,-57.97973332878293,-0.11291453039319738,-0.0921976486160716,0.020716881777125776,5516600,6887680,45.785078585395446,41.55823158792038,NaN,NaN,-2.5917421343733076,2.7744282103517937
2002-02-05T09:30:00-05:00,46.574995,46.85,46.195,46.519995,1805200,1357580,41.7896880175824,46.90908584715326,NaN,NaN,-137.53537490650987,-69.35575279013675,-0.1533275870057818,-0.17094260198010147,-0.017615014974319675,3711400,6600440,43.46486161672489,40.26120815552817,NaN,NaN,-4.7708579586631865,1.6965301862067965
2002-02-06T09:30:00-05:00,46.525,46.725,45.775,46,1278600,1384330,38.7083674093321,46.4372817709831,NaN,NaN,-163.10068711985707,-87.5132810844376,-0.20364429585462607,-0.27217038479260225,-0.0685260889379762,2432800,5807360,37.77313048154778,39.20827908869266,NaN,NaN,-7.575047710142928,0.3720190581568361
2002-02-07T09:30:00-05:00,45.949995,46.050005,45.375,45.4,1973000,1439540,35.45946473722941,45.6126701284424,NaN,NaN,-202.0613214467241,-123.81877658139065,-0.26217232268772594,-0.3962414922976336,-0.13406916960990767,459800,4084880,28.916419612537283,37.99226846080531,NaN,NaN,-10.996059453019637,-1.251992157725517
2002-02-08T09:30:00-05:00,45.605005,46.6,45.455,46.6,1737800,1508170,45.34068750877035,45.76212184093482,NaN,NaN,-124.7985265899442,-144.98662362881117,-0.2073095700469203,-0.39320613216855804,-0.18589656212163774,2197600,2863640,24.52564244822142,36.86858344755019,NaN,NaN,-10.812259469520285,-2.6177446308390553
2002-02-11T09:30:00-05:00,46.4,47,46.375,46.805,1031600,1519610,46.838081450746174,46.145950971176674,NaN,NaN,-58.75541865508338,-137.25026574362371,-0.14727774478016897,-0.36999374309684896,-0.22271599831668,3229200,2406160,23.110003001547383,36.02059904530059,NaN,NaN,-10.187760389466488,-3.699175453500117
2002-02-12T09:30:00-05:00,46.65,47.120005,46.480005,46.905,394600,1500290,47.5923010621578,46.21656598806627,NaN,NaN,-39.23013529395672,-117.58921782111307,-0.093518191340695,-0.33961373749254875,-0.24609554615185375,3623800,2388640,23.055118932393825,35.44378014567955,NaN,NaN,-9.459587429594743,-4.522091450085063
2002-02-13T09:30:00-05:00,47.125,47.394995,47.004995,47.35,359200,1459750,50.92863856080344,46.328206010940605,NaN,NaN,19.81987855268176,-81.0051046866053,-0.02427790010126729,-0.27644292127843784,-0.25216502117717055,3983000,2698680,26.386850545605043,34.941450502811776,NaN,NaN,-7.834769228083767,-4.995331132656307
2002-02-14T09:30:00-05:00,47.47,47.589995,46.75,46.75,1958000,1338510,46.6192460411881,46.15027286037952,NaN,NaN,-7.3947267025144,-42.07178573776336,-0.015598397245701778,-0.2716630177342978,-0.256064620488596,2025000,3011720,29.69687860057168,34.702549847405656,NaN,NaN,-7.727304138241227,-5.38561299059701
2002-02-15T09:30:00-05:00,46.870005,46.945,46.4,46.68,847800,1340230,46.128837562137946,45.76641188523828,NaN,NaN,-51.498424692611394,-27.411765358296826,-0.011473303447671335,-0.27040624979818517,-0.25893294635051384,1177200,2807640,28.78806656848508,34.21966749643071,NaN,NaN,-7.78134383029524,-5.727860253411043
2002-02-19T09:30:00-05:00,46.25,46.4,45.625,45.775,981400,1339750,40.23578367964003,45.407762393489335,NaN,NaN,-134.55993083167866,-42.57266779361588,-0.06368066855500154,-0.33853378204426576,-0.2748531134892642,195800,2200960,26.21928042999602,33.401296252292624,NaN,NaN,-9.636344364420744,-6.286215126412428
2002-02-20T09:30:00-05:00,45.699995,46.550005,45.44,46.550005,1388200,1342590,46.53489046666255,45.172270563501584,NaN,NaN,-90.68814958937097,-52.86427065269872,-0.04110019578872104,-0.3262283582251655,-0.28512816243644445,1584000,1793000,24.627860735704814,32.38903024356578,NaN,NaN,-9.26190119559156,-6.7113131362951615
2002-02-21T09:30:00-05:00,46.449995,46.550005,45.555,45.555,665600,1288240,40.6159996284786,44.30549903179904,NaN,NaN,-109.67797588824084,-78.76384154088325,-0.08569208829330721,-0.39224327280307847,-0.30655118450977126,918400,1180080,22.425552954525045,30.889440900534712,NaN,NaN,-10.891830885775608,-7.308529957649511
2002-02-22T09:30:00-05:00,45.6,46.375,45.39,46.375,1361800,1308500,46.639572981120644,44.02275722871154,NaN,NaN,-83.34966096989643,-93.95482839435965,-0.054024048794673596,-0.3740812455031133,-0.3200571967084397,2280200,1231120,23.042705707252637,29.129817872893447,NaN,NaN,-10.240313740968892,-7.727356212409423
2002-02-25T09:30:00-05:00,46.375,46.665,46.175005,46.665,740600,1307010,48.62434643078954,44.432564681188474,NaN,NaN,-28.013667619366164,-89.2578769797106,-0.009918082364510195,-0.3324547996640774,-0.32253671729956723,3020800,1599840,27.528233403278193,27.825757502742217,NaN,NaN,-9.07679695063875,-7.920133460727898
2002-02-26T09:30:00-05:00,46.644995,47.01,46.355005,46.885,994200,1325840,50.1395033443036,45.02898006166856,NaN,NaN,8.196847606184656,-60.706521292137936,0.035226996910424524,-0.27850297116153655,-0.3137299680719611,4015000,2363680,35.86757561459896,27.283094216876076,NaN,NaN,-7.668838331005087,-7.884234156481782
2002-02-27T09:30:00-05:00,47.125,47.295,46.815,47.1,1247600,1312270,51.640509358704534,45.952704486623745,NaN,NaN,52.61995434608207,-32.04490050504733,0.07825741456046015,-0.21590819987138588,-0.294165614431846,5262600,3099400,42.706153200771936,27.635452982534947,NaN,NaN,-6.067277388598277,-7.624668903926996
2002-02-28T09:30:00-05:00,47.15,47.24,46.480005,46.6,1466200,1323050,48.020042315522446,46.84988859935896,NaN,NaN,17.724142682705082,-6.564476790858149,0.07189868356695023,-0.20429225997315825,-0.2761909435401085,3796400,3675000,47.4292335713753,28.957796836737664,NaN,NaN,-5.768253715535118,-7.359466734156728
2002-03-01T09:30:00-05:00,46.824995,47.75,46.65,47.75,1445200,1261610,55.71103097999852,47.5906274187324,NaN,NaN,112.32872220033073,32.57119984318727,0.14005239987215004,-0.10112544369992094,-0.24117784357207098,5241600,4267280,51.82959748559938,30.90807933940752,NaN,NaN,-3.010075552835407,-6.7381251368251105
2002-03-04T09:30:00-05:00,47.75,48.74,47.625,48.5,1448800,1295630,59.88023142322743,48.522209559623924,NaN,NaN,233.0404129966152,84.78201596638355,0.2254900708947301,0.040684745046341675,-0.18480532584838844,6690400,5001200,56.66957729671879,33.305191789062626,NaN,NaN,0.7124919915674129,-5.673751261340464
2002-03-05T09:30:00-05:00,48.49,48.915,48.35,48.61,1330800,1222810,60.468020980277615,49.44190383948962,NaN,NaN,230.62467533970755,129.26758151308815,0.27592496366743924,0.1601008787359106,-0.11582408493152863,8021200,5802440,61.247435206890245,36.03321438009808,NaN,NaN,3.8474845634847066,-4.313574714936868
2002-03-06T09:30:00-05:00,48.61,49.32,48.199995,49.199995,846600,1174880,63.55243255602499,50.343603410576875,NaN,NaN,206.7819317472677,160.09997699332524,0.3317801834688483,0.29890114440453175,-0.03287903906431655,8867800,6523480,64.84672333760105,38.780348150954936,NaN,NaN,7.485324357616845,-2.628017704572052
2002-03-07T09:30:00-05:00,49.550005,49.65,49.074995,49.25,1150200,1168460,63.8101597338808,51.57152581719778,NaN,NaN,196.81908289175604,195.91896503513544,0.3528876418890469,0.4082305132969921,0.05534287140794519,10018000,7767800,70.02141726680725,41.66067234140034,NaN,NaN,10.481331032299034,-0.7552535993047542
2002-03-08T09:30:00-05:00,49.85,49.879995,49.345,49.69,1206800,1130150,66.08282399880068,52.9968105626737,NaN,NaN,180.42680152879592,209.5385809008285,0.3751936562855684,0.5243349417649057,0.1491412854793373,11224800,8964440,73.98714578117354,44.88917799944951,NaN,NaN,13.715942459136285,1.3120601233296798
2002-03-11T09:30:00-05:00,49.69,49.99,49.269995,49.699995,1110600,1098790,66.1348495190818,54.846743836919536,NaN,NaN,148.9436839033409,192.7192350821736,0.36878452744809986,0.6101219447894621,0.24133741734136227,12335400,10093440,77.06923706058099,48.52131775877701,NaN,NaN,16.364150515262466,3.462358750748649
2002-03-12T09:30:00-05:00,49.275,49.75,49.074995,49.620005,818000,1088110,65.27194864842106,56.18510513561658,NaN,NaN,115.84838104626571,169.76397622348526,0.3381301132464449,0.6640000588994184,0.3258699456529735,11517400,10792680,78.74866262989443,52.3870893226477,NaN,NaN,18.34744603419738,5.588799791241325
2002-03-13T09:30:00-05:00,49.25,49.525,49.025,49.199995,1581200,1147440,60.787073186142074,57.6258961040211,NaN,NaN,89.05680085153487,146.2189500443387,0.27141622995815895,0.6651402331006722,0.3937240031425132,9936200,11006360,79.24882075967037,56.44589416587236,NaN,NaN,18.8855172660566,7.488330859072078
2002-03-14T09:30:00-05:00,49.375,49.615,48.754995,49.425005,1402200,1199590,62.28226293400752,58.74323110065588,NaN,NaN,79.5665292830504,122.76843932259757,0.22614327906154824,0.6764031019694485,0.4502598229079003,11338400,11270440,79.87908844136166,60.5056357897373,NaN,NaN,19.745684818786255,9.239381424745531
2002-03-15T09:30:00-05:00,49.305,49.800005,49.050005,49.625,1414800,1172430,63.610410144043314,59.813664223031154,NaN,NaN,81.59256818531978,103.00159265390236,0.19457054696669807,0.6934730066162729,0.4989024596495748,12753200,11576120,80.6131063911933,64.29741243173123,NaN,NaN,20.834628891669766,10.89584534859185
2002-03-18T09:30:00-05:00,49.745005,50.18,49.550005,49.905,1362400,1198160,65.44498424220917,60.90691285859584,NaN,NaN,91.11813343722265,91.43648256067871,0.17790220794694545,0.7212802195832566,0.5433780116363112,14115600,11932160,81.46141161460797,67.55411500316045,NaN,NaN,22.271099546210095,12.520881662537313
2002-03-19T09:30:00-05:00,50.15,50.324995,49.949995,50.225,621200,1180150,67.46382131670691,62.03714942702459,NaN,NaN,97.66399480893406,87.7996053132124,0.17359666707000865,0.760373845473822,0.5867771784038134,14736800,12576040,82.91718624461248,70.42633164914905,NaN,NaN,24.07387995313333,14.171309989765316
2002-03-20T09:30:00-05:00,49.975,50.025,49.425005,49.435,1805600,1201020,58.393611947353094,62.77811868644106,NaN,NaN,65.46362782220382,83.0809707073462,0.10603232337226753,0.7193175826191478,0.6132852592468803,12931200,13175040,84.1631166196305,73.05018043831015,NaN,NaN,23.123710874574083,15.450224401880854
2002-03-21T09:30:00-05:00,49.775,50.31,49.5,50.265,1001600,1217820,63.88705872342258,63.3621206681142,NaN,NaN,82.62003681897417,83.69167221453094,0.10550336840604968,0.7451644697544424,0.6396611013483927,13932800,13693920,85.17200167389957,75.43178073747445,NaN,NaN,23.942661966872087,16.663429768308173
2002-03-22T09:30:00-05:00,50.275,50.555,49.879995,49.9,1018600,1200660,60.12733187328796,63.37977070026138,NaN,NaN,84.34629565558603,84.2424177085842,0.07051605331900701,0.7278061679971515,0.6572901146781445,12914200,13726120,85.23486293311352,77.4721582829312,NaN,NaN,23.470567639673963,17.635878035646144
2002-03-25T09:30:00-05:00,50.025,50.07,49.225,49.295,1873600,1257310,54.411478014694524,62.94716048843402,NaN,NaN,42.360143453304836,74.49081971180064,0.00028803888256700994,0.6576501632813532,0.6573621243987862,11040600,13111120,78.39868651071721,78.697247661776,NaN,NaN,21.25380733062872,18.152725077786513
2002-03-26T09:30:00-05:00,49.4,49.93,49.4,49.85,843600,1249780,58.32532380235596,62.57379557745766,NaN,NaN,53.879682717501595,65.73395729351414,-0.014318861087610046,0.6394635480392736,0.6537824091268837,11884200,12540600,72.58287152829367,79.2498296753969,NaN,NaN,20.587509984256965,18.50055149299658
2002-03-27T09:30:00-05:00,49.85,50.315,49.735,50.315,976400,1236220,61.32146878110871,62.396031937973945,NaN,NaN,90.03482880866738,70.64819749080685,0.0009912396000454349,0.6550214586269405,0.6540302190268951,12860600,12526480,72.43964396315288,79.4225601537073,NaN,NaN,20.968194375483858,18.853071904780474
2002-03-28T09:30:00-05:00,50.449995,50.714995,50.050005,50.050005,1783000,1252060,58.730148470266755,61.87084082879295,NaN,NaN,110.53462604023731,76.23111533505949,-0.012338678799507452,0.6386068705275108,0.6509455493270182,11077600,11955440,66.70669100192065,78.90252766947495,NaN,NaN,20.483828898265575,19.08603718956406
2002-04-01T09:30:00-05:00,50.050005,50.415,49.53,50.1,1304000,1245000,59.08146790270152,61.367027856194355,NaN,NaN,74.78999385049163,74.3198549740406,-0.02279078169362836,0.6224570722099827,0.6452478539036111,12381600,11848920,65.66276302830816,78.08777952431261,NaN,NaN,20.194456269668382,19.244382772436104
2002-04-02T09:30:00-05:00,49.695,50.199995,49.65,49.78,5878800,1466500,55.806819853697846,60.69094722799984,NaN,NaN,45.18994706601657,74.88581569658294,-0.05445148079914386,0.5771835029046812,0.6316349837038251,6502800,10941360,57.418001780257896,76.56416089219572,NaN,NaN,18.997953854852454,19.209178641352725
2002-04-03T09:30:00-05:00,49.875,49.955,49.26,49.425005,6075400,1703730,52.34095266049366,60.087652904739244,NaN,NaN,-33.81951459700676,57.34597623368127,-0.09985480417339476,0.5068164784870817,0.6066712826604764,427400,8650000,42.80458212021314,73.96100098937734,NaN,NaN,16.960152471186525,18.88788918847184
2002-04-04T09:30:00-05:00,49.199995,49.9,49.175005,49.620005,2093200,1766060,54.02982888199718,59.49819332959565,NaN,NaN,-41.27643725833185,31.08372302028141,-0.11616463565504032,0.461465488091676,0.5776301237467163,2520600,6582000,34.31588753941975,70.70648663923863,NaN,NaN,15.720455966363836,18.435398728170696
2002-04-05T09:30:00-05:00,49.800005,49.949995,49.35,49.550005,815400,1749320,53.29965718976111,58.76171097571835,NaN,NaN,-33.386231570949775,2.2995514980439937,-0.1300311599453503,0.41509117381502847,0.5451223337603788,1705200,4707520,28.75033254025483,67.00200279274303,NaN,NaN,14.49014959390971,17.871791708990557
2002-04-08T09:30:00-04:00,49.004995,50.17,49,50.17,1162200,1747090,58.63213805502375,58.27507910520511,NaN,NaN,7.9908202803605874,-11.06028321598222,-0.0973091242442281,0.4234859284550936,0.5207950526993217,2867400,2804680,24.42047595613738,62.92765024570941,NaN,NaN,14.892350282403779,17.44615721947816
2002-04-09T09:30:00-04:00,50.17,50.345,49.964995,49.985,954600,1739290,56.556922419782985,57.49601489828198,NaN,NaN,82.8986638660732,-3.5185398559708916,-0.08825273800006367,0.4104791301992421,0.49873186819930576,1912800,1886680,22.648358655453706,58.62273398934093,NaN,NaN,14.645717869877592,17.046094455249506
2002-04-10T09:30:00-04:00,50.25,50.949995,50.17,50.949995,2098000,1803290,63.7618765158404,57.87946236745963,NaN,NaN,195.21755921120337,42.28887490567113,-0.02091313294399566,0.47259045201931116,0.4935035849633068,4010800,2603360,27.096262809569467,54.546530145765146,NaN,NaN,16.666108549766793,16.99181075446626
2002-04-11T09:30:00-04:00,50.824995,50.975,50.01,50.135,1505600,1799510,55.40449547674827,57.27356499269719,NaN,NaN,112.40377407194161,73.02491717172582,-0.034119926999204686,0.45085367621430095,0.48497360321350563,2505200,2600280,27.089053563762576,50.39774813789821,NaN,NaN,15.712439101716097,16.80904337550195
2002-04-12T09:30:00-04:00,50.5,51.25,50.125,51.25,2963400,1877570,62.622595006889135,57.451798073668705,NaN,NaN,197.6722440367552,119.2366122932668,0.02612621668841819,0.5176313740740284,0.4915051573856102,5468600,3352960,31.86022966225488,46.58527433283689,NaN,NaN,17.417126104495427,16.895912336786733
2002-04-15T09:30:00-04:00,51.5,51.625,50.79,50.875,2844000,1949030,59.15472878265898,57.79060169995188,NaN,NaN,207.8623084707435,159.2109099313434,0.034105170308294186,0.5341366202709779,0.5000314499626837,2624600,3304400,31.716029909954926,43.25079886135387,NaN,NaN,17.58673820530815,16.99460174657551
2002-04-16T09:30:00-04:00,51.449995,52.15,51.375,52.15,1361400,1948980,66.04054711721612,58.34168907958474,NaN,NaN,269.1814882970526,196.46747481753928,0.11412720456134495,0.6426904556643649,0.5285632511030199,3986000,3719040,34.444395960178994,40.526622035059965,NaN,NaN,20.277696469249584,17.46361527838609
2002-04-17T09:30:00-04:00,52.375,52.375,51.625,51.71,6833400,2259590,62.14686766072481,58.400646142414466,NaN,NaN,204.13086795845396,198.2501365669894,0.12540214635112323,0.6853159340419239,0.5599137876908007,-2847400,2347400,30.152399274689856,37.506104557312604,NaN,NaN,21.017591850073714,17.97132621719861
2002-04-18T09:30:00-04:00,51.775,51.865,51.074995,51.49,2359200,2287270,60.23459329520216,58.508106487052714,NaN,NaN,127.46247003181708,201.2618757589645,0.10675076053995747,0.6933522383657476,0.5866014778257901,-5206600,805040,26.199117558902103,34.61270645423985,NaN,NaN,20.956043272851783,18.397714368006206
2002-04-19T09:30:00-04:00,51.800005,51.82,51.449995,51.449995,761200,2275250,59.87381189064518,58.56470248619155,NaN,NaN,116.79080603320804,185.08558815825506,0.08156342264412997,0.6885557561309525,0.6069923334868226,-5967800,-1482240,21.663099756468412,31.469873363394154,NaN,NaN,20.795470736781745,18.740250992116998
2002-04-22T09:30:00-04:00,51.4,51.445,50.754995,50.769995,1507000,2299670,53.957767102111795,58.43262728964969,NaN,NaN,52.16577015084416,153.9462804942752,0.012570953182904132,0.6227060249654528,0.6101350717825487,-7474800,-3502120,18.60041897434742,28.697188877257695,NaN,NaN,18.768343556258422,18.744264215565774
2002-04-23T09:30:00-04:00,50.800005,51.04,50.699995,50.949995,1798200,2295900,55.21911670883023,58.63821043595944,NaN,NaN,37.44144683204336,107.59827220127333,-0.025406485705244952,0.5783769646509924,0.6037834503562374,-5676600,-5434640,16.23543513098315,26.799392663741262,NaN,NaN,17.51175432703768,18.568191374347474
2002-04-24T09:30:00-04:00,51,51.324995,50.385,50.519995,1095400,2308490,51.58355905650045,58.46347687699539,NaN,NaN,17.94615649791361,70.36132990916526,-0.08082433259856836,0.5027530346080269,0.5835773672065953,-6772000,-6219560,15.380073167076588,25.446834494288186,NaN,NaN,15.339853728317113,18.107000282057424
2002-04-25T09:30:00-04:00,50.300005,50.769995,50.105005,50.655,1388200,2329080,52.63789415834317,58.416208089036964,NaN,NaN,-8.491256393365633,43.170584624128715,-0.10802688009651529,0.4485437670859511,0.5565706471824664,-5383800,-6255000,15.340773735636105,24.489008865386847,NaN,NaN,13.869000440716183,17.50157173329439
2002-04-26T09:30:00-04:00,50.81,50.945,49.685,49.685,2200800,2349970,45.04751894047154,57.445878152283235,NaN,NaN,-50.188836486519264,9.774656120183266,-0.18639124456020528,0.3235815914822098,0.5099728360424151,-7584600,-6578360,14.965037616843844,23.813620412580168,NaN,NaN,10.118240291524982,16.446810098755904
2002-04-29T09:30:00-04:00,50,50.089995,49.550005,49.835,3547600,2462150,46.33621426726245,56.71582756996033,NaN,NaN,-77.53551364132994,-16.16560063825155,-0.2208142484275526,0.2339550255079743,0.4547692739355269,-4037000,-5890800,19.480928393918063,23.587375393899055,NaN,NaN,7.466351649277597,15.163887463116147
2002-04-30T09:30:00-04:00,49.9,50.83,49.81,50.65,1444200,2240420,52.81138484568216,55.933649593520464,NaN,NaN,-18.37578751381883,-27.32904750742399,-0.18294912123764784,0.22608287238846714,0.409031993626115,-2592800,-5274040,23.410157583112237,23.324082163437826,NaN,NaN,7.130213386417999,14.016219737873556
2002-05-01T09:30:00-04:00,50.75,51,49.980005,51,1435200,2008410,55.305514184947064,55.92657950124896,NaN,NaN,0.5964142111994196,-30.798995964766828,-0.1310183821124437,0.24525901598556032,0.37627739809800403,-1157600,-4151160,30.098196814184874,23.539020967039423,NaN,NaN,7.624106594431381,13.103060717381815
2002-05-02T09:30:00-04:00,50.949995,51.300005,50.82,51.175005,932200,1950360,56.54235836290257,55.49227688382134,NaN,NaN,46.754356673861956,-19.749873351321305,-0.08386303976344017,0.27144859839370383,0.355311638157144,-225400,-3119480,35.657518331980384,23.810255872019816,NaN,NaN,8.396461559182658,12.43068940906765
2002-05-03T09:30:00-04:00,51.25,51.25,50.65,50.949995,1494800,1984330,54.45575050883305,55.15663557854806,NaN,NaN,21.204597881141233,-5.471186477789206,-0.06750966652604445,0.27092455499958845,0.3384342215256329,-1720200,-1946600,41.36666574715632,24.49958700324849,NaN,NaN,8.439229920030606,11.860480910633786
2002-05-06T09:30:00-04:00,50.995005,51.160005,49.975,49.975,2717000,2062070,46.455724346462425,53.75771966635137,NaN,NaN,-68.23117325387923,-3.6103184002990645,-0.11902806405474997,0.18964914145719547,0.30867720551194544,-4437200,-2026640,41.09866295081842,24.974891788294165,NaN,NaN,5.973735163968635,11.019517232538764
2002-05-07T09:30:00-04:00,50.24,50.269995,49.6,49.615,1302400,2079460,43.89174064984588,52.453782022717164,NaN,NaN,-142.6403546572097,-28.463231828977246,-0.17086765988194436,0.09509263065951501,0.26596029054145937,-5739600,-2656000,38.961203369509214,25.60409208078126,NaN,NaN,3.129295490764731,9.892342697999617
2002-05-08T09:30:00-04:00,50.449995,50.81,50.24,50.800005,2224000,2085760,53.072980980682786,51.94223828596578,NaN,NaN,-27.8432783864925,-34.15117034851562,-0.12120300765940492,0.11445653096720321,0.23565953862660813,-3515600,-3127600,37.391899352414896,26.403576494603602,NaN,NaN,3.5845494958237065,8.991229383403057
2002-05-09T09:30:00-04:00,50.800005,50.800005,49.85,49.875,1718000,2096380,46.655222026105406,50.998053295641505,NaN,NaN,-87.93236410677225,-61.08851450464247,-0.14490062502041628,0.054533757351087786,0.19943438237150407,-5233600,-4129240,34.23761544400783,27.301756186570703,NaN,NaN,1.756664477484518,7.957720111128981
2002-05-10T09:30:00-04:00,49.995005,50.019995,48.949995,49.065,1788600,2037640,41.87951984777973,50.135321348903496,NaN,NaN,-170.99081650663652,-99.52759738219802,-0.2056684151703711,-0.05765113659145982,0.14801727857891128,-7022200,-5189640,31.233689095961537,28.20413262382885,NaN,NaN,-1.442630757046885,6.614812844246714
2002-05-13T09:30:00-04:00,49.074995,49.725,49,49.699995,2245000,2007690,46.50268032441621,49.51271875001678,NaN,NaN,-135.40060065733357,-112.9614828628889,-0.1938005584333545,-0.09423341946278185,0.09956713897057265,-4777200,-5257640,31.045580159657874,29.262000125877044,NaN,NaN,-2.462116233893857,5.318108690226633
2002-05-14T09:30:00-04:00,50.35,51.199995,50.11,51.199995,9461398,2412689.9,55.50624469794595,49.7929105815486,NaN,NaN,31.26706711139827,-78.17999850916729,-0.08138390910967412,-0.0021627474165200056,0.07922116169315412,4684198,-3172880.4,42.48269378308399,31.197901598449,NaN,NaN,-0.024220981786417257,4.554918737081912
2002-05-15T09:30:00-04:00,50.875,51.410005,50.58,51.15,2409400,2191489.9,55.17294981073401,49.9739859852908,NaN,NaN,68.39255218648634,-58.93283239457152,-0.010569860501668887,0.066008836066068,0.07657869656773689,2274798,-2014800.8,47.674677840029716,33.50746617733426,NaN,NaN,1.6936165763817008,4.14616128555331
2002-05-16T09:30:00-04:00,51.175005,51.175005,50.375,50.545,1452200,2146139.9,51.16884099796501,50.41122327511176,NaN,NaN,27.99955309504103,-35.74644895420886,-0.004938737145619515,0.07040527513571249,0.075344012281332,822598,-803561.2,52.50381835254895,36.18880765845605,NaN,NaN,1.7703236681724497,3.8067559116417584
2002-05-17T09:30:00-04:00,50.6,50.889505,50.26,50.699995,1620400,2189099.9,52.127388811016175,50.82487859966559,NaN,NaN,25.1093431614543,3.4735829794093056,0.008054160468375066,0.08541171286680083,0.07735755239842576,2442998,1089478.4,58.889725876649706,39.00372176436546,NaN,NaN,2.1334602873900472,3.5677136796057995
2002-05-20T09:30:00-04:00,50.625,50.625,50.004995,50.06,1856400,2206569.9,47.94252589969501,50.477102960666514,NaN,NaN,-31.904270697455267,24.17284897138496,-0.02577259521600081,0.04514180837842474,0.07091440359442555,586598,2162238,62.00713211257266,41.760648516469765,NaN,NaN,1.121135026647002,3.2182024434688286
2002-05-21T09:30:00-04:00,50.175005,50.32,49.135,49.300005,2511000,2242209.9,43.47866825803376,49.63232825160127,NaN,NaN,-120.01727224828277,-6.084018900551254,-0.09477112681169897,-0.04754950492019816,0.04722162189150081,-1924402,840518,56.33859760514089,43.634962858680915,NaN,NaN,-1.1794433159013522,2.5899673349873744
2002-05-22T09:30:00-04:00,49.15,49.589995,48.675005,49,2344600,2304669.9,41.82324302356122,48.58096287021975,NaN,NaN,-164.2731683747518,-52.61716301279888,-0.15262613936944716,-0.14356105232030814,0.009065087049139019,-4269002,-468242,51.33431155679796,44.754733803310735,NaN,NaN,-3.562786349445779,1.7110025229254955
2002-05-23T09:30:00-04:00,49.35,49.995005,48.75,49.975,2384600,2354489.9,48.66416690756254,48.16727832727186,NaN,NaN,-86.3976773420086,-75.49660910020881,-0.11874804842035039,-0.13936997347629898,-0.020621925055948585,-1884402,-1009642,49.38027571141168,45.32713451504326,NaN,NaN,-3.464130456169096,0.9716978116262681
2002-05-24T09:30:00-04:00,49.75,49.824995,49.185,49.185,1608400,2324869.9,44.13559380180756,48.00155471693937,NaN,NaN,-97.34613766468674,-99.98770526543703,-0.14151689668269676,-0.19751804590931954,-0.056001149226622776,-3492802,-2196802,45.30767142891977,45.62777797776479,NaN,NaN,-4.853246558973221,0.1395629015406269
2002-05-28T09:30:00-04:00,49.4,49.4,48.5,49.06,2984200,2296699.9,43.44666219092439,47.969763398444975,NaN,NaN,-130.97959872067784,-119.80277087008153,-0.15583607628734167,-0.25079624458579985,-0.09496016829845819,-6477002,-3609522,40.97668298623968,45.77174080753125,NaN,NaN,-6.167146402522933,-0.7613955704684531
2002-05-29T09:30:00-04:00,48.949995,48.949995,48.339995,48.435,1952000,2322089.9,40.078068654733286,47.04155537516287,NaN,NaN,-148.32698908563984,-125.46471423755295,-0.19566218218699166,-0.33953789603219775,-0.1438757138452061,-8429002,-4910442,37.42856808655709,45.77436000282712,NaN,NaN,-8.328914811988287,-1.8424697478284293
2002-05-30T09:30:00-04:00,48.435,48.824995,48.019995,48.61,3009400,2400799.9,41.44700736723686,46.669540042386544,NaN,NaN,-136.5125717214229,-119.91259490688716,-0.1978877003105811,-0.39123533923343246,-0.19334763892285137,-5419602,-5140562,36.82120646220288,45.95890221841248,NaN,NaN,-9.681874213727854,-2.962384671528347
2002-05-31T09:30:00-04:00,48.775,49.120005,48.25,48.25,6645800,2686479.9,39.4503733957572,46.49602958152779,NaN,NaN,-119.30186267096538,-126.49343197267851,-0.21012065716790881,-0.4559984603827374,-0.24587780321482858,-12065402,-7176762,31.89003717608537,46.00578422413561,NaN,NaN,-11.402476465135415,-4.168112070615071
2002-06-03T09:30:00-04:00,48.475,48.4795,47.125,47.125,2000800,2711779.9,33.946864751478046,45.59918561203221,NaN,NaN,-183.3600948516038,-143.69622341006192,-0.27632641627456245,-0.5912858235580316,-0.31495940728346916,-14066202,-9291442,27.735715016062287,45.76936528530735,NaN,NaN,-14.705721211420734,-5.67348480501588
2002-06-04T09:30:00-04:00,47.050005,47.4,46.504995,47.135,5450800,2848469.9,34.034956361964774,44.06552215946211,NaN,NaN,-197.0220214384182,-156.90470795361,-0.29982781468112735,-0.6897441756348783,-0.389916360953751,-8615402,-9719122,26.970483504118235,44.66135026538122,NaN,NaN,-17.30828139807176,-7.335598604023863
2002-06-05T09:30:00-04:00,47.275,47.425005,46.86,47.300005,1600400,2863369.9,35.56204638936937,42.66474334365035,NaN,NaN,-153.51782923941644,-157.94287598436534,-0.28475553976448736,-0.7458607856593602,-0.46110524589487284,-7015002,-9436322,28.377655424152906,43.28299152139003,NaN,NaN,-19.029562803738045,-9.006164918268746
2002-06-06T09:30:00-04:00,47.275,47.300005,46.275,46.379995,1874600,2845899.9,31.222024025959584,41.239970702792824,NaN,NaN,-162.3214642272643,-163.10465448553362,-0.3148902542938554,-0.8547180637621921,-0.5398278094683366,-8889602,-10130322,27.0026034250873,41.46147616942848,NaN,NaN,-21.900611526286866,-10.848228719414191
2002-06-07T09:30:00-04:00,45.625,47,45.605005,46.800005,2509000,2885449.9,35.11516553861129,40.02481189762104,NaN,NaN,-148.21403091280146,-168.88708813390085,-0.28554547801794994,-0.8967596569907741,-0.6112141789728242,-6380602,-8993362,32.75163555494525,39.59446971787816,NaN,NaN,-23.168849304327864,-12.608317374401858
2002-06-10T09:30:00-04:00,46.9,47.225,46.6,46.75,2447000,2918369.9,34.86215216484187,39.09049948798867,NaN,NaN,-108.19255095199233,-153.85357935397855,-0.24980285423178994,-0.9234677467625616,-0.6736648925307717,-8827602,-7945642,37.62660064438937,37.853003184436496,NaN,NaN,-24.271303551676038,-14.274458256869599
2002-06-11T09:30:00-04:00,47,47.095,46,46,2877200,2949979.9,31.227832575131984,38.21543979635283,NaN,NaN,-117.69858851825863,-137.98889276994663,-0.2560265653231866,-0.9936980991847548,-0.7376715338615683,-11704802,-8563522,35.970525083583766,36.39814086146813,NaN,NaN,-26.326967620461716,-15.996245308811329
2002-06-12T09:30:00-04:00,46.004995,46.345,45.475,46.15,4146000,2684210,32.73809617637163,37.566500735839284,NaN,NaN,-121.71202066369587,-131.62773105480252,-0.23020827110609954,-1.0254318727441927,-0.7952236016380931,-7558802,-8672282,35.672897421003526,35.279468423197095,NaN,NaN,-27.595033653265528,-17.653215072304786
2002-06-13T09:30:00-04:00,46.1,46.295,45.385,45.5,1413200,2634400,29.694907993794885,36.211553670570176,NaN,NaN,-118.70111887048905,-122.90366198344748,-0.2361895462019611,-1.0904605343905445,-0.8542709881885834,-8972002,-8688762,35.624796698196945,34.296934207967475,NaN,NaN,-29.60772118476746,-19.361001659799452
2002-06-14T09:30:00-04:00,44.800005,45.800005,44.254995,45.75,3394200,2731500,32.30145787463,35.36625824720035,NaN,NaN,-125.93047394060923,-118.44695058900902,-0.20381440577111054,-1.1090389954024715,-0.905224589631361,-5577802,-8528202,36.522836458375934,33.66944599578577,NaN,NaN,-30.54676894438058,-20.958968414739612
2002-06-17T09:30:00-04:00,45.875,46.9,45.875,46.815,1479000,2724430,42.14234730195338,35.273092897988136,NaN,NaN,-59.74266964149232,-108.75697432690902,-0.09661943526456729,-1.0259988837120702,-0.9293794484475029,-4098802,-7582442,41.68340309267755,33.71992600338848,NaN,NaN,-28.351258020533383,-22.015009786995865
2002-06-18T09:30:00-04:00,46.765,47.275,46.574995,46.945,1905600,2726890,43.227207363500405,35.49803137718578,NaN,NaN,-33.969463145912414,-92.01114925243978,-0.0075974826852496236,-0.9388763018040649,-0.9312788191188153,-2193202,-5680122,50.41540742071694,34.647557384399896,NaN,NaN,-26.24825575019888,-22.61975921031058
2002-06-19T09:30:00-04:00,46.35,47.185,46,46,2966800,2749680,37.69420741100966,35.22997423745527,NaN,NaN,-58.80310881915664,-79.42936688353194,-0.0032193759330034766,-0.9353030390350696,-0.9320836631020661,-5160002,-5200362,52.353085803874336,35.756977337376426,NaN,NaN,-26.060919920488846,-23.111353597478903
2002-06-20T09:30:00-04:00,46.120005,46.58,45.660005,45.9,1984200,2731660,37.15227912106819,35.06582464640606,NaN,NaN,-74.81261351861744,-70.65166581315762,0.0018093640230887331,-0.9298219580732052,-0.931631322096294,-7144202,-4834802,53.83349329901327,37.324367060442704,NaN,NaN,-26.07055353392601,-23.534096445542776
2002-06-21T09:30:00-04:00,45.9,46.32,45.6,45.800005,1713200,2698090,36.58585288802632,35.25432379901664,NaN,NaN,-80.43109325621128,-61.551789676278034,0.00697848859010719,-0.92290821135866,-0.9298866999487672,-8857402,-5490722,50.78451261565036,38.97070974612757,NaN,NaN,-26.238719981397562,-23.920471236379175
2002-06-24T09:30:00-04:00,45.625,46.195,44.93,45.655,2586600,2747000,35.73502567384547,35.37575732129384,NaN,NaN,-99.37505499109814,-69.47826674619918,0.009076291024644023,-0.9185413361679622,-0.9276176271926062,-11444002,-6959762,44.68084445498421,40.23573552833228,NaN,NaN,-26.612709870866308,-24.30507675559162
2002-06-25T09:30:00-04:00,45.949995,46.175005,44.725,45.01,1502800,2672930,32.15313049570263,35.13226332888907,NaN,NaN,-116.79052657207656,-86.04247943143203,-0.02279012154583937,-0.9561052791249054,-0.933315157579066,-12946802,-9110482,37.562912666866154,40.89182533138323,NaN,NaN,-27.97718438498757,-24.829663559791044
2002-06-26T09:30:00-04:00,44,45.155,43.949995,44.985,6941400,2922400,32.019164754859034,35.18920195238188,NaN,NaN,-158.5160961322361,-105.98507689404789,-0.03465526121765994,-0.9766342341011409,-0.941978972883481,-19888202,-12056122,30.416045947123607,41.135642654385826,NaN,NaN,-29.133116345729725,-25.444442529210857
2002-06-27T09:30:00-04:00,45.65,45.85,44.74,45.85,4792200,3011540,41.154864842290195,35.62060904550181,NaN,NaN,-81.46752262880106,-107.31605871608463,0.023514706850237044,-0.9125855893206847,-0.9361002961709217,-15096002,-13646482,27.386400315376292,40.75241156584519,NaN,NaN,-27.503812156872375,-25.73863819030536
2002-06-28T09:30:00-04:00,45.730005,46.324995,45.324995,45.324995,5306800,2944590,37.831761015136244,35.832723963379976,NaN,NaN,-56.778487054615,-102.58553747576536,0.03377149122812395,-0.8938859321357668,-0.9276574233638908,-20402802,-15955562,23.69586133658514,39.75735875814489,NaN,NaN,-27.07863213197021,-25.93006589625748
2002-07-01T09:30:00-04:00,45.449995,45.815,44.300005,44.4,1844600,2936780,32.8056507013395,35.94542525810908,NaN,NaN,-134.2410037570819,-109.55872722896213,-0.01214385669409146,-0.9428372442315052,-0.9306933875374137,-22247402,-18116242,20.862756247751705,38.67823241272831,NaN,NaN,-28.29161856731126,-26.267430563550878
2002-07-02T09:30:00-04:00,44.28,44.300005,43,43.065,1720600,2750270,27.19095221482354,35.54920068942708,NaN,NaN,-236.8649537054899,-133.5736126556448,-0.11699773344508047,-1.0769405543437642,-0.9599428208986838,-23968002,-20320482,18.440520199270168,37.44734832546165,NaN,NaN,-31.366731873724678,-26.995902179289992
2002-07-03T09:30:00-04:00,42.9,43,42,42.550005,2908600,2815680,25.385950410179618,35.24141800488313,NaN,NaN,-262.39073249652006,-154.34853992850157,-0.20069905983526026,-1.2108166456927592,-1.010117585857499,-26876602,-21718162,17.08590391011404,36.12314169774144,NaN,NaN,-34.47141818935823,-28.06383303787117
2002-07-05T09:30:00-04:00,43.074995,43.96,42.9,43.96,1063400,2775120,37.59946793644247,35.6198472950126,NaN,NaN,-143.86651557391428,-166.82833851752423,-0.14344881718604485,-1.189428607340055,-1.0459797901540102,-25813202,-23861602,15.237316929503251,34.6027474456791,NaN,NaN,-32.774463493212785,-28.736780245777116
2002-07-08T09:30:00-04:00,43.875,44.120005,43.025,43.050005,1810000,2740170,33.75874833905908,35.021018797663004,NaN,NaN,-134.82708286925916,-182.43805768045306,-0.1485834070790848,-1.2317090490028662,-1.0831256419237814,-27623202,-25305682,14.128256744719508,32.634522706539244,NaN,NaN,-32.77579146130966,-29.31378184799605
2002-07-09T09:30:00-04:00,43.1,43.435,42.65,42.885,1619000,2698770,33.0985377413557,34.29754239608124,NaN,NaN,-136.93419904700488,-182.97669673843765,-0.14466826472027305,-1.2639609728241226,-1.1192927081038495,-29242202,-26704642,13.131136237868034,29.971360479192892,NaN,NaN,-32.99983770974123,-29.84036125681679
2002-07-10T09:30:00-04:00,42.945,42.945,41.675005,41.705,2447800,2677300,28.765975177073813,33.65981152222868,NaN,NaN,-159.42357575124194,-167.48842114758807,-0.19973104518829787,-1.3689565145892217,-1.1692254694009239,-31690002,-28249042,12.114633551235144,27.09718531829009,NaN,NaN,-34.71585882748857,-30.536860909769903
2002-07-11T09:30:00-04:00,41.5,41.620005,40.550005,41.379995,3428800,2641440,27.69083568103642,32.98399413365498,NaN,NaN,-172.58677439900055,-149.52762952808416,-0.23385455222367324,-1.4615436596805154,-1.2276891074568421,-35118802,-29897482,11.12472820962057,24.04655924047633,NaN,NaN,-36.423418845166225,-31.377797757683663
2002-07-12T09:30:00-04:00,41.5,42.089995,40.949995,41.025,3394800,2740520,26.52468974059842,32.26533962312442,NaN,NaN,-137.3012270961351,-148.21457183252832,-0.2544458076168534,-1.5457463669779088,-1.2913005593610554,-38513602,-32437562,9.79639075180431,21.11883625020161,NaN,NaN,-38.17097799410244,-32.348252077172056
2002-07-15T09:30:00-04:00,40.949995,40.949995,39.425005,40.769995,3691200,2755370,25.68782490846702,31.547682425597383,NaN,NaN,-150.70666795794014,-151.39048885026452,-0.25851482054105146,-1.6144440850373698,-1.3559292644963183,-42204802,-35353882,8.536150016060262,18.537072361707043,NaN,NaN,-39.8408217619254,-33.418619174993964
2002-07-16T09:30:00-04:00,40.475,41.25,40.22,40.5,2598200,2811330,24.795804248264034,31.02215912220891,NaN,NaN,-123.80955357284205,-148.76555975543198,-0.25238212680595185,-1.671406923003758,-1.4190247961978062,-44803002,-38466042,7.436692038543313,16.385199459683992,NaN,NaN,-41.4789440218937,-34.5700941531225
2002-07-17T09:30:00-04:00,41.495005,41.5,40.06,40.875,2669000,2849500,28.509092149182862,30.7714396503749,NaN,NaN,-107.89511021143007,-138.4598666474696,-0.19843938292337704,-1.6670740248520275,-1.4686346419286505,-42134002,-40554842,6.803322356431465,14.698576346063126,NaN,NaN,-41.76772748482671,-35.5983274862231
2002-07-18T09:30:00-04:00,40.65,40.949995,39.449995,39.449995,1829400,2792630,23.71680770514854,29.52586414057907,NaN,NaN,-125.92865660925656,-129.1282430895208,-0.23177782407970682,-1.758356922028284,-1.5265790979485772,-43963402,-42323762,6.3129711008484435,13.193331402168283,NaN,NaN,-43.58187714876309,-36.73883458087167
2002-07-19T09:30:00-04:00,39.025,39.335,38.324995,38.625,2860400,2836440,21.466977643493976,28.356951042604617,NaN,NaN,-148.9486878278822,-131.4577352358702,-0.27925525991415157,-1.8756481728412666,-1.596392912927115,-46823802,-43985802,5.883862959597749,11.921045803812037,NaN,NaN,-45.863291701573324,-38.04232845525762
2002-07-22T09:30:00-04:00,38.300005,38.894995,37.300005,37.855005,3325800,2917070,19.598304845254944,27.413569195741438,NaN,NaN,-153.48288932554334,-132.01297950939085,-0.3289594473209605,-2.0075922220783156,-1.678632774757355,-50149602,-45574762,5.4990275507257,10.823636611167322,NaN,NaN,-48.39806830743685,-39.52171986271179
2002-07-23T09:30:00-04:00,38.074995,38.074995,35.875,35.875,3187000,2947090,15.791583367702657,26.59932856380423,NaN,NaN,-173.36906059459844,-141.92488091374213,-0.4539239901117571,-2.2460377623970516,-1.7921137722852944,-53336602,-47281482,5.11225223791034,9.871617471070191,NaN,NaN,-52.14301192776437,-41.324761586290734
2002-07-24T09:30:00-04:00,35.199995,38,34.75,38,6628200,3203360,31.230179758055982,27.016773517223974,NaN,NaN,-143.67689127058813,-149.08123712557372,-0.35650300414197567,-2.237742527462764,-1.8812395233207884,-46708402,-48196362,4.912778125871554,9.002108486481442,NaN,NaN,-49.34685226141781,-42.47077453988032
2002-07-25T09:30:00-04:00,37,38.6,36.699995,37.699995,6251600,3168870,30.383262543417118,26.50133027486502,NaN,NaN,-109.51815512045934,-145.79913682781427,-0.2787476575203456,-2.2296740952212204,-1.9509264377008748,-52960002,-49995682,4.537765992161795,8.23785484809991,NaN,NaN,-47.5714564440509,-43.19944338333326
2002-07-26T09:30:00-04:00,37.975,38.300005,37.324995,38.300005,2480400,3053280,34.225119771699084,26.53464252005359,NaN,NaN,-91.24861332146013,-134.25912192652987,-0.15932223941272006,-2.150079236966775,-1.9907569975540549,-50479602,-50726842,4.391083406890431,7.542342466826406,NaN,NaN,-44.82937703848065,-43.432291048354315
2002-07-29T09:30:00-04:00,39.15,40.15,38.75,39.775,2366800,2906280,42.60972473309471,27.214013019463522,NaN,NaN,-36.15271335449742,-110.79308673232069,0.03616332064723071,-1.9455528467450165,-1.9817161673922472,-48112802,-50319482,6.210126760545521,7.047984647017655,NaN,NaN,-39.464730634485704,-42.865496703515944
2002-07-30T09:30:00-04:00,39.85,40.214995,38.76,39.894995,3403200,2984210,43.2435868064608,28.248128135848305,NaN,NaN,-27.43159329763663,-81.60559327292833,0.18251887007440137,-1.7535675797992454,-1.9360864498736468,-44709602,-48594082,13.699636231543977,7.161199124182572,NaN,NaN,-35.162859107324714,-41.76511990406006
2002-07-31T09:30:00-04:00,39.894995,39.949995,39.175005,39.275,1834800,2989920,40.73986666660402,29.18020177767456,NaN,NaN,-27.502913703454997,-58.37079775950171,0.24276805042825744,-1.632626386838325,-1.8753944372665825,-46544402,-48561282,13.840490294152787,7.355182130220588,NaN,NaN,-32.456167548317964,-40.435269567525474
2002-08-01T09:30:00-04:00,39.15,39.375,38.5,38.699995,2009800,2944980,38.512780280377605,30.03649395908736,NaN,NaN,-45.80237173127355,-45.627641081664564,0.24820690441464177,-1.5651358067482803,-1.8133427111629221,-48554202,-47680122,17.725461635841185,7.921544336223223,NaN,NaN,-30.934256172520303,-39.077981939667595
2002-08-02T09:30:00-04:00,38.625,38.675005,37.43,37.485,2652400,3024430,34.251984215428635,30.648219623870336,NaN,NaN,-79.48556051506891,-43.27503052038632,0.17759821356420757,-1.5913449442076626,-1.7689431577718702,-51206602,-47825522,17.58456180662347,8.567859464120597,NaN,NaN,-30.997658605924457,-37.92365003484715
2002-08-05T09:30:00-04:00,37.485,37.644995,36.485,36.485,1793400,3023600,31.19315408661153,31.1051731837523,NaN,NaN,-112.34099410480832,-58.5126866704485,0.07634151552486923,-1.6735162633657836,-1.7498577788906529,-53000002,-48802962,16.627686964182374,9.224359101666241,NaN,NaN,-32.05745717206121,-37.085622483020586
2002-08-06T09:30:00-04:00,37.15,38.074995,37,38.074995,3461000,3115700,40.319237413352404,31.94875498833584,NaN,NaN,-67.08983878650677,-66.44433576822253,0.12629671620332705,-1.591986883636494,-1.7182835998398212,-49539002,-49768842,15.717511504209313,9.86108689793609,NaN,NaN,-29.858819086429683,-36.053221997793315
2002-08-07T09:30:00-04:00,38.375,38.675005,37.405,38.22,3205600,3153590,41.08666654097438,33.18945919089482,NaN,NaN,-42.78050822344047,-69.49985467221963,0.17590612956687957,-1.4984009378812218,-1.6743070674481013,-46333402,-49726642,15.934026255689943,10.54830512328191,NaN,NaN,-27.905106951082846,-34.889205562548966
2002-08-08T09:30:00-04:00,38.22,38.9,37.85,38.835,2317200,3098010,44.35486155927516,34.824308042022054,NaN,NaN,-14.70921238697267,-63.28122280335945,0.2522912599708236,-1.3589429924845717,-1.6112342524553953,-44016202,-48819042,20.65504965730939,11.603389887404173,NaN,NaN,-25.267495100599213,-33.514675496556144
2002-08-09T09:30:00-04:00,38.300005,39.095,38.22,38.504995,4054000,3130970,42.977138429156724,36.49422472658647,NaN,NaN,-2.6189369901902415,-47.90789809838372,0.28057162211687126,-1.2605197248093063,-1.5410913469261776,-48070202,-48191762,23.83853483850399,12.91335469367405,NaN,NaN,-23.533935068359742,-32.08885543538523
2002-08-12T09:30:00-04:00,38.25,38.879995,38.105005,38.6,1342000,3013510,43.52103717825007,38.47489999876843,NaN,NaN,-1.8567521035902879,-25.811049698140113,0.30370200996685326,-1.161463834467611,-1.4651658444344642,-46728202,-46937402,29.895754179947446,14.683604832390985,NaN,NaN,-21.97374348269467,-30.64383944214372
2002-08-13T09:30:00-04:00,38.550005,38.910005,37.449995,37.5,2996800,3033440,38.89514645125461,39.022397619711185,NaN,NaN,-36.51862711409028,-19.69680736365679,0.24543733488365382,-1.1583691758298968,-1.4038065107135507,-49725002,-46974602,29.820009660112703,16.462692799122497,NaN,NaN,-21.95571417724019,-29.402678690014643
2002-08-14T09:30:00-04:00,37.775,38.955,37.074995,38.839995,6681200,3234050,46.37296760002697,40.16451940946904,NaN,NaN,-0.2762800339669978,-11.195961725762098,0.29436552107773073,-1.0358496093663874,-1.330215130444118,-43043802,-46316682,33.050751397111455,18.499334613761757,NaN,NaN,-19.59691897063233,-28.001855872960025
2002-08-15T09:30:00-04:00,39.15,39.25,38.695,38.879995,3498400,3317500,46.583112783087664,41.04723319599679,NaN,NaN,69.17333519357342,5.580547790347123,0.32428165723809,-0.9248630588965057,-1.2491447161345957,-39545402,-45422522,37.27688652014398,20.848320550422727,NaN,NaN,-17.657394993619548,-26.524075747339957
2002-08-16T09:30:00-04:00,38.824995,39.665,38.64,39.475,2472000,3298080,49.73825229912397,41.55641373642745,NaN,NaN,94.70432651737337,25.045200491859845,0.3753931744851806,-0.7799032480281198,-1.1552964225133004,-37073402,-43223162,46.26237882700126,23.709195698026708,NaN,NaN,-15.081031856178043,-24.889355191459682
2002-08-19T09:30:00-04:00,39.705,40.14,39.535005,40.025,3215600,3292570,52.5294525115642,42.21968985822055,NaN,NaN,133.97218223686482,52.21098735995086,0.4333824848437968,-0.6135683164585544,-1.0469508013023512,-33857802,-40649082,54.48129527449265,26.622171343951614,NaN,NaN,-12.077481406466951,-23.05908750788929
2002-08-20T09:30:00-04:00,39.905,39.945,39.525,39.824995,2326600,3249550,51.41136603666995,42.98193981322526,NaN,NaN,113.39986775392899,82.19468633355471,0.443791433909149,-0.4922115089159149,-0.9360029428250639,-36184402,-37940962,61.2041265229954,30.005288217440373,NaN,NaN,-9.903891681427032,-21.179773818394683
2002-08-21T09:30:00-04:00,39.945,40.65,39.685,40.64,2511600,3043720,55.56214590663347,44.19975164367211,NaN,NaN,145.55266578146333,111.36047549664079,0.4875963564945901,-0.32650749720682626,-0.8141038537014164,-33672802,-36066762,65.0511745791528,33.38569628481973,NaN,NaN,-6.785611715519253,-19.123464946555337
2002-08-22T09:30:00-04:00,40.6,41.125,40.324995,40.9,1878800,2825080,56.82916516998294,45.812407426140275,NaN,NaN,160.97893744153842,129.72159594623378,0.513506448634591,-0.1722207929081776,-0.6857272415427687,-31794002,-34516482,67.8877342288181,36.97878002926221,NaN,NaN,-3.823967569321435,-16.93782246409335
2002-08-23T09:30:00-04:00,40.6,40.85,39.824995,39.824995,3484600,2875290,50.427154138453744,47.18626457270044,NaN,NaN,97.88137278508992,130.3570051997771,0.4404748725344779,-0.13513365087467122,-0.5756085234091491,-35278602,-34157522,68.52474846973828,40.68571299394477,NaN,NaN,-3.0223895506006944,-14.949903476451542
2002-08-26T09:30:00-04:00,40,40.675005,39.625,40.550005,2490800,2881490,54.17646880768865,48.17606681515302,NaN,NaN,99.5676861299903,123.47610597840219,0.4231258323015747,-0.04670123303218077,-0.46982706533375546,-32787802,-33943522,68.9205738012532,44.485931729447906,NaN,NaN,-1.2190651697677906,-12.988355146925292
2002-08-27T09:30:00-04:00,40.875,40.894995,39.660005,39.775,2726800,2847670,49.83728905833327,48.801111280678654,NaN,NaN,81.7998693090658,117.15610628942954,0.34489514980436603,-0.03870812807829793,-0.38360327788266396,-35514602,-33809562,69.18184232804688,48.28934716318769,NaN,NaN,-0.9729651497454448,-11.271870861613886
2002-08-28T09:30:00-04:00,39.35,39.525,38.835,39,2720800,2891970,45.87996256265738,48.91004706663453,NaN,NaN,9.276189213604379,89.90081097585775,0.23182024833268466,-0.0938279674668081,-0.32564821579949277,-38235402,-34722082,65.16329509128664,51.46850755132892,NaN,NaN,-1.9760274489769025,-9.943893231237174
2002-08-29T09:30:00-04:00,38.425005,39.61,38.425005,39.29,2405600,2911760,47.558022657091406,49.23725308291558,NaN,NaN,7.442995259898811,59.19362253952984,0.17027068536250145,-0.11280985909636598,-0.28308054445886743,-35829802,-35529242,61.74670658096163,54.176234104361605,NaN,NaN,-2.311645206590777,-8.853572084859117
2002-08-30T09:30:00-04:00,39.175005,39.589995,38.875,39.025,1380800,2848180,46.149861430093694,49.42502624376156,NaN,NaN,7.138600350117056,41.045068052535264,0.10843585139713674,-0.14753573021244648,-0.2559715816095832,-37210602,-35915642,60.12159821719986,56.33522296416535,NaN,NaN,-2.9956972600762524,-8.01673282417585
2002-09-03T09:30:00-04:00,38.324995,38.65,37.58,37.875,3985200,2957770,40.540035709608205,49.542518333643955,NaN,NaN,-97.0843183539517,1.7146671557468665,-0.007062080445987218,-0.2647991821670672,-0.25773710172108,-41195802,-37597242,53.51992141905895,58.028073804090084,NaN,NaN,-5.330533985896955,-7.632990132993151
2002-09-04T09:30:00-04:00,37.85,38.9,37.725,38.675005,1916400,2880540,45.5028948171308,49.4803702777228,NaN,NaN,-67.90930494779714,-28.227167695625717,-0.025679550530813444,-0.2898365398845968,-0.26415698935378334,-39279402,-38350202,50.828598753234495,59.297920043813164,NaN,NaN,-5.835732902174497,-7.376239100019058
2002-09-05T09:30:00-04:00,38.125,38.555,37.9,37.9,1483200,2794420,41.85802113897407,49.142863731714684,NaN,NaN,-97.1273470790075,-49.5078749541481,-0.08305319532557526,-0.36797348351075243,-0.2849202881851772,-40762602,-38855642,49.045672491299165,60.13854761318139,NaN,NaN,-7.402583264530693,-7.380002552092149
2002-09-06T09:30:00-04:00,38.4,39.199995,38.4,39.15,2753400,2816230,48.95949667387195,49.08723832991097,NaN,NaN,-25.813407399004124,-56.15915548592868,-0.032290454979891636,-0.32528335691004173,-0.2929929019301501,-38009202,-39291522,47.49833293094881,60.22683004917764,NaN,NaN,-6.50258870409189,-7.254657716663541
2002-09-09T09:30:00-04:00,39.050005,39.425005,38.370005,39.03,1222600,2674660,48.34897376733154,48.78863270532292,NaN,NaN,-25.518695959180423,-62.690614747788175,-0.0037675930600684082,-0.2977023932552356,-0.2939348001951672,-39231802,-39695762,46.04740085035053,59.62440901888177,NaN,NaN,-5.974318145109062,-7.07175206358433
2002-09-10T09:30:00-04:00,39.324995,39.445,38.795,39.275,1767800,2695950,49.727345499232094,48.66834552407736,NaN,NaN,-6.754492251666859,-44.62464952733121,0.03262256276696579,-0.25315659673645996,-0.28577915950342575,-37464002,-38949402,49.136747203759384,58.76245335322206,NaN,NaN,-5.136935148648577,-6.795349647164937
2002-09-11T09:30:00-04:00,40,40,39.125,39.15,1719400,2632080,49.00874160492525,48.20024521681249,NaN,NaN,11.946017156734008,-28.65358510642498,0.04834926486795327,-0.22534257841848415,-0.2736918432864374,-39183402,-38930202,49.21730499130697,57.63146266837593,NaN,NaN,-4.650975132781212,-6.489010430824404
2002-09-12T09:30:00-04:00,39,39.17,38.485,38.5,1948400,2395440,45.3396349527996,47.379564487013674,NaN,NaN,-67.50316900530245,-22.72874949168397,0.016685623520841353,-0.25283481388538576,-0.2695204374062271,-41131802,-39004042,48.89656222654286,56.27495038249913,NaN,NaN,-5.275543475757778,-6.315658008672029
2002-09-13T09:30:00-04:00,38.199995,38.86,38.125,38.85,2655200,2353280,47.61390575375796,47.178618173821114,NaN,NaN,-75.74054969613239,-32.71417795110962,0.02075812731159088,-0.2435727782667385,-0.2643309055783294,-38476602,-39097522,48.465948907636395,54.84217898520613,NaN,NaN,-5.167938671739688,-6.15169810339598
2002-09-16T09:30:00-04:00,38.800005,38.875,38.31,38.4,1133000,2286330,45.020281793509994,46.5246048156655,NaN,NaN,-77.12338232336003,-43.03511522394554,-0.004085575852852574,-0.2694378753943951,-0.26535229954154255,-39609602,-39173082,48.097236977914875,53.354797783539105,NaN,NaN,-5.8053072757438695,-6.102213699445679
2002-09-17T09:30:00-04:00,38.699995,38.879995,37.72,37.875,2629600,2257030,42.13649541470848,45.97454812683515,NaN,NaN,-106.2531457839072,-62.934845930393614,-0.050528062297159115,-0.32851237741299144,-0.2779843151158323,-42239202,-40128122,43.58396503322583,51.52637797676618,NaN,NaN,-7.178774931129284,-6.2560081611147655
2002-09-18T09:30:00-04:00,37.324995,37.85,37.1,37.775,2376400,2259520,41.590021542566575,45.66812376825724,NaN,NaN,-147.78923506017725,-94.88189637377586,-0.08083598498407535,-0.3790292963459265,-0.2981933113618512,-44615602,-41214562,39.090220651949096,49.66401551681349,NaN,NaN,-8.469544419645644,-6.572227626619177
2002-09-19T09:30:00-04:00,36.75,37.285005,36.300005,36.394995,1405200,2204200,34.869252495656426,44.76178304244045,NaN,NaN,-205.41535892036148,-122.46433435678766,-0.18094497151130196,-0.5243745257509786,-0.3434295542396767,-46020802,-42192362,35.538716433693665,47.792016220580074,NaN,NaN,-11.752255607115405,-7.312231623832924
2002-09-20T09:30:00-04:00,36.875,36.964995,36.4,36.550005,1485600,2184540,36.11799277202234,44.04522099543534,NaN,NaN,-183.00510032279655,-143.9172444821205,-0.22118255266975106,-0.6199077450768655,-0.39872519240711446,-44535202,-43404082,31.69562703351866,45.76158970745998,NaN,NaN,-14.079372230367335,-8.278965996194982
2002-09-23T09:30:00-04:00,36.300005,36.445,35.4,35.65,2234800,2122050,32.251590136187374,43.453189168762435,NaN,NaN,-210.74956326341524,-170.64248067013153,-0.2886090491655683,-0.7594865038640748,-0.4708774546985065,-46770002,-44836162,27.860984426135715,43.92880849367975,NaN,NaN,-17.338517828562505,-9.573187686533199
2002-09-24T09:30:00-04:00,35.345,35.93,35.25,35.375,2243400,2109680,31.15417198392757,42.42828039496221,NaN,NaN,-193.41269686685868,-188.07439088672186,-0.3289982653177017,-0.8821252863456337,-0.553127021027932,-49013402,-46191002,24.803627390527154,42.0698819677721,NaN,NaN,-20.363546757108463,-11.114667553758236
2002-09-25T09:30:00-04:00,35.625,36.449995,35.495005,36.449995,2974800,2122080,39.780337005475694,42.2798743854266,NaN,NaN,-128.63143331771505,-184.2428305382294,-0.2634203878371759,-0.8824025058244018,-0.6189821179872259,-46038602,-46475602,24.20280383568428,40.295391349513885,NaN,NaN,-20.432530688266816,-12.445790858688033
2002-09-26T09:30:00-04:00,36.699995,37.065,36.405,36.93,4840000,2228040,43.202445481325306,41.86865644310184,NaN,NaN,-72.66293542439735,-157.6923458390366,-0.17223257313780516,-0.8342728344094823,-0.6620402612716771,-41198602,-45511162,30.359121157488005,39.071161937123826,NaN,NaN,-19.43858057941036,-13.444760818791222
2002-09-27T09:30:00-04:00,36.625,37.019995,36.019995,36.025,2526000,2234060,38.73327269196735,41.1818206520044,NaN,NaN,-88.511576262225,-138.79364102692227,-0.15776839246639174,-0.8592507518546668,-0.7014823593882751,-43724602,-45349042,31.3682325370296,38.02264991474376,NaN,NaN,-19.97119793652268,-14.377108978467145
2002-09-30T09:30:00-04:00,35.65,36.29,35.24,35.775,3999800,2365010,37.576853373674155,40.31392835732169,NaN,NaN,-109.31560153572079,-118.50684868138339,-0.14999117959135688,-0.8889713338774712,-0.7389801542861143,-47724402,-45539922,30.802297622392757,36.71304637321758,NaN,NaN,-20.75449387872147,-15.288163964217762
2002-10-01T09:30:00-04:00,36.25,36.925005,35.475,36.925005,3433400,2337420,45.619818743196156,40.07186243862676,NaN,NaN,-62.47753281222399,-92.31981587045645,-0.05712601426172059,-0.810387672113265,-0.7532616578515444,-44291002,-44595442,36.87133825366246,35.83119160624297,NaN,NaN,-18.8745175131014,-15.800500185486854
2002-10-02T09:30:00-04:00,36.574995,36.865,35.9,36.025,3492000,2416200,41.15111070909514,39.772682135505015,NaN,NaN,-65.40386324306442,-79.67430185552631,-0.04649416144103047,-0.8113793596528325,-0.764885198211802,-47783002,-44944322,35.62828072766024,34.88345721346564,NaN,NaN,-18.71268987008128,-16.21652728328606
2002-10-03T09:30:00-04:00,35.97,36.335,35.455,35.635,2119800,2448030,39.35223088394533,39.18256250194697,NaN,NaN,-82.04191597722738,-81.55009796609231,-0.05530859783606146,-0.8340209455068788,-0.7787123476708173,-49902802,-46685162,30.163725992303085,33.57615557665611,NaN,NaN,-19.14788423121605,-16.635292561561773
2002-10-04T09:30:00-04:00,35.875,35.875,34.425005,34.65,4060200,2513370,35.17050552120364,38.47900705392509,NaN,NaN,-116.58551174366723,-87.16488506238075,-0.11369497474255019,-0.9208310660990051,-0.8071360913564549,-53963002,-48732842,25.25664250835665,31.944684543116242,NaN,NaN,-20.883152991790027,-17.242129765880094
2002-10-07T09:30:00-04:00,34.475,34.800005,33.550005,33.72,2920000,2598240,31.74095261137367,37.736468282258315,NaN,NaN,-156.94772311145906,-96.6913093775284,-0.1963222678816463,-1.0525389262085127,-0.8562166583268664,-56883002,-50564562,21.834736357933508,30.391168209166796,NaN,NaN,-23.497656200682393,-18.13577639942328
2002-10-08T09:30:00-04:00,34.254995,34.254995,33.225,33.975,5766800,2798190,33.65138928089553,37.169423120710384,NaN,NaN,-158.8185370265802,-115.95951022039962,-0.2137404486649347,-1.1233922191580348,-0.9096517704931001,-51116202,-51929602,19.69340328135489,29.00568125412435,NaN,NaN,-24.988994708205887,-19.11480758639222
2002-10-09T09:30:00-04:00,33.574995,33.745005,32.49,32.550005,7756000,3100020,28.80041462132165,36.735934701115035,NaN,NaN,-190.77369585351988,-141.03347674249073,-0.29609992972279897,-1.2797766826465988,-0.9836767529237999,-58872202,-54147442,16.809047125485222,27.667847732109465,NaN,NaN,-27.957913544948614,-20.378108437614564
2002-10-10T09:30:00-04:00,32.535005,33.54,32.300005,33.5,5369400,3271070,35.478098108652944,36.6902279394458,NaN,NaN,-157.78892709424022,-156.18287896589328,-0.2626047545560588,-1.3119326961188733,-1.0493279415628145,-53502802,-54867442,15.990260719387976,26.546035852528696,NaN,NaN,-28.203252243230448,-21.495986124131118
2002-10-11T09:30:00-04:00,33.885,34.745005,33.885,34.35,6104000,3443510,40.82575325908238,37.30266816250973,NaN,NaN,-82.3907844016548,-149.3439334974908,-0.16403291571413714,-1.254369086205486,-1.0903361704913488,-47398802,-53554602,23.32439300452758,26.221993608128116,NaN,NaN,-26.60618247967989,-22.2260141749238
2002-10-14T09:30:00-04:00,34.050005,34.615,34.050005,34.58,3476800,3560700,42.221215934186844,38.09317130181397,NaN,NaN,-67.43498263277793,-131.4413854017546,-0.0690326708710125,-1.1766270090801143,-1.1075943382091018,-43922002,-50962402,35.329515736754786,26.973842775715806,NaN,NaN,-24.89742142389162,-22.607643781919204
2002-10-15T09:30:00-04:00,35.379995,36.025,35.214995,35.975,5130200,3685730,49.93320388369407,38.81837607882955,NaN,NaN,17.715612374235715,-96.1345555215914,0.09325381600016658,-0.9910270682088935,-1.08428088420906,-38791802,-48497522,44.26555415202417,28.406896369740082,NaN,NaN,-20.785634519421624,-22.34735674441955
2002-10-16T09:30:00-04:00,35.5,35.665,34.86,35.074995,2821800,3708000,45.69553420444875,38.99645384476695,NaN,NaN,-9.30711953596376,-59.84124025808016,0.142532288156078,-0.9061155240139627,-1.0486478121700407,-41613602,-45045802,53.87685713873748,30.086734654115045,NaN,NaN,-18.759759857929325,-21.834842903492376
2002-10-17T09:30:00-04:00,35.935,36.195,35.675005,36.125,5284000,3901940,50.927958162085645,39.86750280691825,NaN,NaN,47.98087897074596,-18.687279045082963,0.2425164897833456,-0.7455021999408586,-0.9880186897242043,-36329602,-41611162,61.07076397859026,32.20834404279795,NaN,NaN,-15.281238322598888,-20.89861367765045
2002-10-18T09:30:00-04:00,35.835,36.36,35.78,36.199995,2923200,3973820,51.2889690718761,40.846939642504104,NaN,NaN,59.0440194915801,9.599681733564017,0.3062651187095675,-0.6051872913372449,-0.9114524100468124,-33406402,-38812682,65.75718254392063,34.705121537192795,NaN,NaN,-12.456739590295546,-19.692631665171177
2002-10-21T09:30:00-04:00,35.9,36.81,35.870005,36.675005,3279600,4026060,53.61654786900774,41.41813458006208,NaN,NaN,78.71751233148218,38.83018072641604,0.36879016683396293,-0.4504647015043588,-0.8192548683383217,-30126802,-36053642,69.63794317152116,37.045593317039845,NaN,NaN,-9.407834969731441,-18.22337499439407
2002-10-22T09:30:00-04:00,36.35,36.615,36.050005,36.205,3722400,4100010,51.01883003892229,42.122971675049726,NaN,NaN,62.904427290785264,47.86794370972595,0.3661214349146026,-0.36160307469506847,-0.727724509609671,-33849202,-35065122,70.90999079384908,39.56571546462476,NaN,NaN,-7.6441100964704525,-16.71205143754784
2002-10-23T09:30:00-04:00,36,36.870005,35.800005,36.78,3681000,4135320,53.957826060645864,43.16622847338548,NaN,NaN,73.60823488089487,64.45101459309768,0.38858571698315736,-0.24199236338072438,-0.6305780803638817,-30168202,-32776042,73.66180084577447,42.67272081130129,NaN,NaN,-5.273069464825665,-15.077911155730385
2002-10-24T09:30:00-04:00,36.949995,37.07,36.385,36.425005,5673400,4176990,51.88780750355822,44.3603214721251,NaN,NaN,84.19849558073362,71.69453791509521,0.36538949681152466,-0.1738412093494759,-0.5392307061610006,-35841602,-32678442,73.77570823353999,46.1383683631001,NaN,NaN,-3.8969914629996385,-13.480636913911708
2002-10-25T09:30:00-04:00,36.324995,37.22,36.324995,37.22,4374800,4269430,55.96228064103207,46.09041633138641,NaN,NaN,99.63981915947082,79.81369784867336,0.3873470212577451,-0.05504692958881918,-0.4423939508465643,-31466802,-32290522,74.252337450281,49.88248272683921,NaN,NaN,-1.485561808648597,-11.767054756016979
2002-10-28T09:30:00-05:00,37.699995,37.699995,36.675005,36.800005,2487600,4193820,53.38987405267428,47.50030810079918,NaN,NaN,99.33397873115261,83.93699112860745,0.35803432276696234,0.0051489526121386575,-0.3528853701548237,-33954402,-33056042,71.49095203479854,53.582307637799474,NaN,NaN,-0.20768942570547344,-10.115716851686763
2002-10-29T09:30:00-05:00,36.775,36.89,36.089995,36.695,4680000,4256150,52.73717703345045,49.21007684452267,NaN,NaN,67.79612978960135,84.91533162837065,0.31740895518181056,0.043875823822439486,-0.2735331313593711,-38634402,-34013082,68.08210058956877,57.24466859951973,NaN,NaN,0.6602290708673065,-8.57629600560761
2002-10-30T09:30:00-05:00,37,37.365,36.72,37.324995,3422800,4252690,56.197107194580674,50.690006064946076,NaN,NaN,97.53616162006341,89.70091697620437,0.31800521836206536,0.12397339159321064,-0.19403182676885472,-35211602,-35021762,64.5866149546006,60.71583675917777,NaN,NaN,2.398566610297798,-7.008458489049694
2002-10-31T09:30:00-05:00,37.525,37.685,37.165,37.25,5474000,4420400,55.674609064065876,51.750638622444896,NaN,NaN,100.9726099370163,93.0557398474609,0.29869153097589396,0.17933258695101273,-0.11935894402488123,-40685602,-35990562,61.329668663057234,63.4304993062156,NaN,NaN,3.6948898885118058,-5.479408720826623
2002-11-01T09:30:00-05:00,37.135,38.225,36.975,38.125,4799800,4457380,60.31120376334742,53.042780610242076,NaN,NaN,112.49447378804692,95.62667077317613,0.32785681082195295,0.2904620695025599,-0.03739474131939299,-35885802,-36874362,58.434702694502676,65.08086980319759,NaN,NaN,6.192894413093373,-3.8119368445523376
2002-11-04T09:30:00-05:00,38.695,39.15,38.4,38.455,4515800,4537170,61.928669839254596,53.899599607067834,NaN,NaN,149.72932680214737,105.70574038737507,0.3503509972015284,0.40054400518251754,0.05019300798098912,-31370002,-36357482,59.63475681337377,66.178669993294,NaN,NaN,8.765110934241616,-2.0152157332960585
2002-11-05T09:30:00-05:00,38.525,38.625,38.165,38.519995,2669800,4382320,62.25494052772655,55.08241434444482,NaN,NaN,129.5699644551304,118.06050732048088,0.34977416822563134,0.4874107182630283,0.13763655003739694,-28700202,-34370642,63.944038397300154,66.89775436890561,NaN,NaN,10.98698915484569,-0.15775789213295188
2002-11-06T09:30:00-05:00,38.85,39.25,38.525,39.175005,3383400,4163690,65.4668877103397,56.120909312177254,NaN,NaN,155.76316612579038,129.70590822162626,0.3716232849487956,0.6021656562233915,0.23054237127459587,-25316802,-32391682,67.64869462371504,67.36760655784308,NaN,NaN,13.870861760749106,1.846330629707342
2002-11-07T09:30:00-05:00,38.925005,38.925005,38.15,38.245005,3318400,4061140,57.92939391921561,56.595225372701506,NaN,NaN,112.23532318145351,131.9584508705137,0.3043845432050879,0.6110230502809557,0.3066385070758678,-28635202,-29981602,71.49053272653995,67.77713157088732,NaN,NaN,14.286612501419842,3.623513754237699
2002-11-08T09:30:00-05:00,38.324995,38.495005,37.67,37.725,2176200,3864750,54.17359620769887,56.63501453975088,NaN,NaN,72.832669368891,124.02608998668252,0.21030319277422727,0.5695174980436519,0.35921430526942466,-30811402,-28966722,72.94741334545859,68.01352229759713,NaN,NaN,13.530324877424107,5.038772486121472
2002-11-11T09:30:00-05:00,37.725,37.725,36.79,36.81,2235800,3802700,48.24619245160007,56.43696899779929,NaN,NaN,3.4130617984698395,94.76283698594702,0.07864233346170468,0.45751722209655554,0.37887488863485086,-33047202,-29302162,71.64424355436178,68.06596892334804,NaN,NaN,11.01785737437178,5.89292747015723
2002-11-12T09:30:00-05:00,37.175005,39.89,37.025,37.4,2507000,3671540,51.900718287882334,56.29003272831618,NaN,NaN,74.27494765358146,83.70383362563724,0.0261955880825524,0.41161937373804136,0.38542378565548896,-30540202,-29670162,70.16336591692091,67.8160807141442,NaN,NaN,9.99187992478377,6.47849210653245
2002-11-13T09:30:00-05:00,37.36,38,37.025,37.6,2486400,3654770,53.10946847170201,56.37729422604074,NaN,NaN,21.17096176349083,56.78539275317733,0.0011994658083960275,0.386923117915984,0.38572365210758797,-28053802,-30217562,67.91460787921125,67.39743068883502,NaN,NaN,9.506564776900237,6.911073916584991
2002-11-14T09:30:00-05:00,37.9,38.550005,37.859495,38.415,2136600,3497400,57.76706169935189,56.50620715877786,NaN,NaN,76.91038156111236,49.720404429109095,0.03396432974590624,0.42817906428997077,0.3942147345440645,-25917202,-29673962,68.97792426322896,67.02068688975989,NaN,NaN,10.488737343815584,7.422168691903647
2002-11-15T09:30:00-05:00,38.175005,38.75,38.175005,38.4,1922800,3447380,57.65355517445548,56.81075581033367,NaN,NaN,82.953449775361,51.7445605104031,0.04816899996922641,0.45442598450559757,0.40625698453637116,-27840002,-29079682,70.14285416724822,66.92439418493485,NaN,NaN,11.246266832305796,7.968468426246812
2002-11-18T09:30:00-05:00,38.875,38.875,38.035005,38.105005,3105800,3438690,55.350164801831916,56.99739779378948,NaN,NaN,66.265375515569,64.31502325382293,0.032017454382848864,0.44627880251493224,0.4142613481320834,-30945802,-28659402,70.97301671240383,67.13088819370878,NaN,NaN,11.235682460619257,8.435213288300018
2002-11-19T09:30:00-05:00,38.015,38.3505,37.775,37.97,2249400,3365040,54.281327031688846,56.86055635358292,NaN,NaN,32.13066384134985,55.886166491376606,0.007823125312560464,0.42404025477278395,0.4162171294602235,-33195202,-29190402,68.38586629435282,67.40226328940537,NaN,NaN,10.933947570345529,8.792175328592233
2002-11-20T09:30:00-05:00,37.85,38.975,37.76,38.975,2492400,3305610,60.410156664406806,57.19880975360728,NaN,NaN,80.12195007549408,67.67636415377726,0.05259066743368379,0.48195546375232823,0.42936479631864444,-30702802,-29720202,65.80829224178727,67.72216497360037,NaN,NaN,12.44928751250232,9.314619926293673
2002-11-21T09:30:00-05:00,39.01,39.78,38.879995,39.735,3331200,3188500,64.30688879111426,57.48421582701919,NaN,NaN,161.71697879900384,84.63768360135556,0.1224801934668619,0.5824650381522218,0.45998484468535994,-27371602,-30011082,64.37366321733481,68.14637643951696,NaN,NaN,14.973842188513329,10.12308024946791
2002-11-22T09:30:00-05:00,39.4,40.07,39.335,40.01,3888400,3164180,65.62532509598717,57.74826263107152,NaN,NaN,177.50932504419933,103.54885865512324,0.17322124379311843,0.676511399426758,0.5032901556336395,-23483202,-29139722,66.71455733682816,68.65207647690656,NaN,NaN,17.456602361977385,11.170726265540692
2002-11-25T09:30:00-05:00,40,40.445,39.800005,40.275,2283800,3153990,66.89436290591766,58.07964994379945,NaN,NaN,189.1749444853899,128.1307724490874,0.20826748791834826,0.7636245155315748,0.5553570276132266,-21199402,-27190442,71.26345750682091,69.17489212758662,NaN,NaN,19.899656889708226,12.417716354707482
2002-11-26T09:30:00-05:00,40.275,40.4,39.6,39.824995,2437000,3041840,62.66370253157135,57.879422431030285,NaN,NaN,151.90276871602194,152.08519342402184,0.18553471709638503,0.7872754239837079,0.6017407068873228,-23636402,-25278682,74.88817506135275,69.69199787313217,NaN,NaN,20.780405442892086,13.612386224448139
2002-11-27T09:30:00-05:00,40.199995,40.975,40.08,40.910005,2575000,2999450,67.93013852075984,58.59376133114061,NaN,NaN,183.21938469964527,172.70468034885207,0.225317068556652,0.8833870425831378,0.6580699740264858,-21061402,-23350402,77.91421041235003,70.15083199354717,NaN,NaN,23.229267493937332,14.986226405803738
2002-11-29T09:30:00-05:00,40.925005,41.115,40.4,40.405,958000,2773650,63.44448177876829,59.25596744335985,NaN,NaN,150.58736091286522,170.47875677162435,0.20021264503224334,0.90833578031679,0.7081231352845466,-22019402,-22279962,79.39834965973247,70.61161315885245,NaN,NaN,23.898771486141936,16.259447131566336
2002-12-02T09:30:00-05:00,41.25,41.379995,40.46,40.714995,3044000,2685860,64.97347069509189,60.45077303218069,NaN,NaN,140.75147977133602,163.12718771705167,0.18730953427191688,0.9422600531244427,0.7549505188525258,-18975402,-21378402,80.58189667930023,71.25001695349091,NaN,NaN,24.910781699911162,17.495352069901312
2002-12-03T09:30:00-05:00,40.449995,40.595,39.964995,40,2852800,2602710,58.85851018829961,60.94775816792479,NaN,NaN,81.40761617975038,141.57372205592378,0.11689098880695392,0.9010642548612182,0.7841732660542643,-21828202,-21504162,79.89241673144086,71.94494915452805,NaN,NaN,23.89572422873166,18.40969094973422
2002-12-04T09:30:00-05:00,39.67,40.074995,39.324995,39.605005,2808000,2609620,55.737614557996814,61.13548288837442,NaN,NaN,41.20952751374814,119.43507381546904,0.03426957385620688,0.8270102333745228,0.792740659518316,-24636202,-21704122,78.73880868335473,72.71810635482402,NaN,NaN,22.091520748413483,18.935666635259828
2002-12-05T09:30:00-05:00,40.04,40.04,39.225,39.42,4337200,2657310,54.2857295857465,60.88681630883118,NaN,NaN,31.35763081481871,89.06272303850372,-0.03834624824800148,0.7448078492083141,0.7831540974563156,-28973402,-23286522,70.11106716108814,72.79904513324252,NaN,NaN,20.181214208208452,19.113602002823917
2002-12-06T09:30:00-05:00,39,39.79,38.925005,39.58,1557000,2569240,55.368524669514784,60.723599844192556,NaN,NaN,19.863211690516586,62.917893194033994,-0.07877930524806875,0.6846799658962297,0.7634592711442985,-27416402,-24365922,64.88802351929624,72.42370008696024,NaN,NaN,18.899360251376386,19.082996038331412
2002-12-09T09:30:00-05:00,39.265,39.42,38.449995,38.53,2156400,2568250,47.42903213982495,60.1578046540492,NaN,NaN,-26.907807822565335,29.386035675253716,-0.17396108015151923,0.5460079209548994,0.7199690011064186,-29572802,-26485402,56.05721993271916,71.35828603126848,NaN,NaN,15.252650637053646,18.535803838148873
2002-12-10T09:30:00-05:00,38.74,39.455,38.735,39.28,2678800,2590400,52.65168292774475,60.04140150376748,NaN,NaN,-10.093687027767892,11.08577503375005,-0.1832004174948606,0.4909684792378428,0.6741688967327034,-26894002,-27498562,52.38699593479062,70.21550957701403,NaN,NaN,13.70153759068075,17.845194374224857
2002-12-11T09:30:00-05:00,39.1,39.5795,39.050005,39.324995,3124400,2621270,52.953649335450564,59.508793837413464,NaN,NaN,-2.145348763848977,2.414799778230625,-0.1826625798970677,0.4458406718613688,0.6285032517584365,-23769602,-27325242,52.95445539871039,69.29737837393711,NaN,NaN,12.551855628510685,17.089003124837117
2002-12-12T09:30:00-05:00,39.5,39.68,38.58,39.485,1891200,2591510,54.07529187349565,58.77796548615499,NaN,NaN,-17.95122818318907,-7.4469720213709305,-0.16826879831303776,0.41816725386713927,0.586436052180177,-21878402,-25906242,57.42799944372938,68.8012595329653,NaN,NaN,11.921525589947638,16.350792048424335
2002-12-13T09:30:00-05:00,38.975,39.949995,38.480005,38.525,2011200,2585240,46.85713058062169,57.43738016362888,NaN,NaN,-50.52802099121479,-21.5252185577172,-0.2170375092233836,0.31513916565094746,0.5321766748743311,-23889602,-25200882,59.49008944884224,68.28522611239488,NaN,NaN,9.123946160924042,15.31838549306715
2002-12-16T09:30:00-05:00,38.65,39.265,38.65,39.214995,2857200,2631960,51.83370336366953,56.36161876775402,NaN,NaN,-49.68773499549295,-26.081203992302722,-0.1970452117594581,0.28587016017500844,0.48291537193446654,-21032402,-23492802,64.0333311088929,67.76878851254287,NaN,NaN,8.247706497343428,14.308288493678047
2002-12-17T09:30:00-05:00,39.225,39.269995,38.74,38.800005,2077200,2580530,48.869553853392226,55.37632243359836,NaN,NaN,-67.78124151846158,-37.61871489044147,-0.20507133099522362,0.226576208190437,0.4316475391856606,-23109602,-22735922,65.86044618025706,67.12395073532176,NaN,NaN,6.601036907119573,13.207252552741123
2002-12-18T09:30:00-05:00,38.75,38.75,38.01,38.18,2486200,2592370,44.751971599939495,53.720739082111194,NaN,NaN,-144.57716964917287,-66.10507906750624,-0.24285428788111801,0.12807967933426312,0.37093396721538113,-25595802,-23101162,64.1664604235192,66.1419685932624,NaN,NaN,3.898677073592348,11.877456055719868
2002-12-19T09:30:00-05:00,38.125,38.65,37.86,38.085,6629200,2799210,44.13830476191429,52.341726438050195,NaN,NaN,-151.47573087846658,-92.80997960656175,-0.26324950244799833,0.04187208915538321,0.30512159160338154,-32225002,-25170482,55.462471860272196,64.4322630361581,NaN,NaN,1.5388661841018552,10.400514645488723
2002-12-20T09:30:00-05:00,38.370005,38.625,38.185,38.515,2046200,2734960,47.638272049523685,51.103497963366756,NaN,NaN,-109.05715739737275,-104.51580688779333,-0.23757299376652016,0.008155349395231326,0.2457283431617515,-30178802,-26428322,50.93927568997367,62.31493296549191,NaN,NaN,0.555720855813281,8.994115532677945
2002-12-23T09:30:00-05:00,38.449995,38.855005,38.355005,38.775,1882400,2634660,49.69078992558723,50.44866080174444,NaN,NaN,-77.84841729579469,-110.14794334785367,-0.19467315246420777,0.0023869025814917677,0.19706005504569954,-28296402,-27881122,46.24786940628175,59.91175101369483,NaN,NaN,0.3261465290062553,7.755834246439132
2002-12-24T09:30:00-05:00,38.665,38.85,38.54,38.699995,673400,2554140,49.09293810850641,49.97404105535227,NaN,NaN,-68.37050826792547,-110.26579669774647,-0.16416247749068835,-0.008143041817660901,0.15601943567302745,-28969802,-29053162,42.821505417953546,57.34622935188047,NaN,NaN,-0.02806342431095442,6.643848864903406
2002-12-26T09:30:00-05:00,38.75,39.245005,38.525,38.699995,1086200,2486600,49.0929381085064,49.60312737840654,NaN,NaN,-50.289305854979624,-91.40822393890781,-0.13785570858513863,-0.01630020005839583,0.1215555085267428,-28969802,-29727962,40.940822194197764,55.26264042567401,NaN,NaN,-0.3211820021232806,5.648844455328165
2002-12-27T09:30:00-05:00,38.625,38.625,38.07,38.07,2351200,2475410,43.94277072717582,48.7870020968109,NaN,NaN,-107.47710259048861,-82.60849828131222,-0.15545351892729647,-0.07276139013237781,0.08269212879491866,-31321002,-29547162,41.67988295023978,53.60491609931284,NaN,NaN,-2.0200684650595777,4.553285466701345
2002-12-30T09:30:00-05:00,38.15,38.32,37.65,37.949995,3471000,2601060,43.01702938818887,48.47185904312261,NaN,NaN,-134.68478945671745,-87.73402469318117,-0.1667466822867149,-0.125741224063475,0.04100545822323993,-34792002,-30469802,38.9979202797559,52.386394695529745,NaN,NaN,-3.6987802449468274,3.374418936465892
2002-12-31T09:30:00-05:00,38.07,38.574995,37.800005,37.905,5448200,2721270,42.65419075224275,47.75775245915819,NaN,NaN,-114.41655101860921,-95.04765143774407,-0.16832919639301802,-0.1694060372680326,-0.0010768408750145772,-40240202,-32858562,33.06556550734082,51.00629252214048,NaN,NaN,-5.202492590078749,2.1491458612452288
2003-01-02T09:30:00-05:00,38.25,39.025,38.035005,38.949995,4014200,2779340,52.64448563220007,47.735669337497434,NaN,NaN,-23.76337112840674,-86.12622400984031,-0.09379803399687657,-0.11832438337111029,-0.02452634937423372,-36226002,-34309802,30.07256026595408,49.37187144122931,NaN,NaN,-3.7306195311121644,1.309179376622744
2003-01-03T09:30:00-05:00,39,39.054495,38.665,38.885,3222200,2800050,52.037271932951896,47.59009648460145,NaN,NaN,17.180753735390383,-72.63221209176632,-0.04609052439376499,-0.08213950486643995,-0.03604898047267496,-39448202,-36405482,26.361694405358435,47.15284965277425,NaN,NaN,-2.6936704978257926,0.7373436802729532
2003-01-06T09:30:00-05:00,38.885,39.61,38.885,39.339995,2919200,2729150,55.87427289860737,48.234178078743284,NaN,NaN,97.85949727938853,-31.56489211779088,0.015593129449658474,-0.016557568660601873,-0.03215069811026035,-36529002,-37447082,24.728410299283468,44.6698725706629,NaN,NaN,-0.6655238137215012,0.5369340382737454
2003-01-07T09:30:00-05:00,39.35,39.449995,38.82,39.135,3013800,2801990,53.78650283301258,48.37366375512493,NaN,NaN,76.50600020188482,10.67326581392957,0.04064864083892093,0.01866010293839082,-0.02198853790053011,-39542802,-38397242,23.30966356300935,41.76103917452837,NaN,NaN,0.46140516439904866,0.5261441991487887
2003-01-08T09:30:00-05:00,38.949995,39.015,38.6,38.745005,3288400,2858590,49.96170498379514,48.45167455015371,NaN,NaN,8.351679970202863,35.22691201169198,0.02953397655254858,0.014928932790155613,-0.014605043762392966,-42831202,-38915442,22.549798137014037,38.667421457153864,NaN,NaN,0.35739271697452785,0.5020368445524658
2003-01-09T09:30:00-05:00,38.99,39.53,38.99,39.315,3828600,2916080,54.99854779740121,49.18357284997241,NaN,NaN,102.08491819039511,60.39656987545235,0.05752820113508981,0.05730520765646929,-0.0002229934786205142,-39002602,-39470762,21.732208946561485,35.63640349451402,NaN,NaN,1.7662035142402288,0.682632083079289
2003-01-10T09:30:00-05:00,38.915,39.625,38.855005,39.4,2698000,2894760,55.71444481180453,50.01043999639314,NaN,NaN,105.56687943362085,78.07379501509845,0.0774852498143029,0.0966335687892581,0.01914831897495521,-36304602,-38842042,25.045713713754452,33.463777912619896,NaN,NaN,3.127872380275978,1.031952125535959
2003-01-13T09:30:00-05:00,39.660005,39.815,39.089995,39.49,1759000,2888150,56.50346292288855,50.6436679159192,NaN,NaN,132.98552506361582,85.0990005719439,0.09150105463517169,0.13352463726891983,0.04202358263374814,-34545602,-38445362,27.141525642712807,31.763938623529835,NaN,NaN,4.48072017863636,1.5246332759788732
2003-01-14T09:30:00-05:00,39.449995,39.725,39.26,39.515,1566400,2865910,56.734059686592595,51.146758613133876,NaN,NaN,126.44114795355398,95.08603012227773,0.09670157369749692,0.1629005497556193,0.06619897605812237,-32979202,-37132642,33.74387288758267,30.870796015051326,NaN,NaN,5.669692078819797,2.116784533527577
2003-01-15T09:30:00-05:00,39.585,39.699995,39.074995,39.425005,2381600,2842130,55.591523001055194,51.61094324831593,NaN,NaN,100.84149341999837,113.58399281223683,0.08854510792624731,0.17688036096593152,0.0883352530396842,-35360802,-35638562,40.36738832372723,30.695501936892306,NaN,NaN,6.391929438474318,2.72751951994854
2003-01-16T09:30:00-05:00,39.5,39.75,39.19,39.370005,2323000,2854420,54.86433714933299,52.0231860369464,NaN,NaN,96.56866533209502,112.48074224057682,0.07447580517626018,0.18143000951000943,0.10695420433374925,-37683802,-35374802,41.479605296693,30.733986444213397,NaN,NaN,6.827178642019481,3.313185108815817
2003-01-17T09:30:00-05:00,38.94,39.485,38.449995,38.629995,2416600,2850940,46.12238901995081,52.178873057858894,NaN,NaN,-0.08337393176690497,91.35069156749927,0.013552503540623734,0.12389483375952892,0.11034233021890519,-40100402,-36133962,39.21265991150263,30.55775622716074,NaN,NaN,4.790809635417521,3.5242743269017747
2003-01-21T09:30:00-05:00,38.699995,38.769995,38.04,38.07,2134600,2626210,40.82161256584047,52.02205757054829,NaN,NaN,-96.59413390253286,45.43475977426952,-0.06208702888583233,0.032733544111614776,0.0948205729974471,-42235002,-37671842,35.0354357549856,30.274721618248577,NaN,NaN,1.3459146328765428,3.21308008489817
2003-01-22T09:30:00-05:00,37.885,38.175005,37.730005,37.74,3337600,2690780,38.04664128660987,51.69294689443166,NaN,NaN,-151.33797542222072,-10.121064900885411,-0.1281660079055299,-0.06538693688446529,0.06277907102106461,-45572602,-40190522,29.493913215462044,30.019603597400096,NaN,NaN,-2.4484984871915683,2.4042831460282077
2003-01-23T09:30:00-05:00,37.975,38.269995,37.785005,37.975,2213000,2707310,41.11638021422185,50.869510793147505,NaN,NaN,-116.03432859035725,-53.496229302956536,-0.1484395516837048,-0.12277036858356638,0.025669183100138417,-43359602,-41790282,26.61448550959979,29.772598257660498,NaN,NaN,-4.7513672696405305,1.3820473723612452
2003-01-24T09:30:00-05:00,38,38,37.19,37.19,3565000,2851890,34.89622147638042,49.64515004624953,NaN,NaN,-161.77256500991837,-105.1644753713592,-0.203696056715441,-0.22895088779416284,-0.02525483107872184,-46924602,-43638442,23.73193842338847,29.584758544662645,NaN,NaN,-8.888233567199407,-0.08513561900456224
2003-01-27T09:30:00-05:00,37,37.305,36.565,36.625,3477400,2971450,31.233750394432548,47.88511272452276,NaN,NaN,-190.94166089936272,-143.33613276487836,-0.26347841627090024,-0.35460285141734715,-0.0911244351464469,-50402002,-45698762,21.0011880929475,29.318528387067225,NaN,NaN,-13.677593964023535,-2.026915382578701
2003-01-28T09:30:00-05:00,36.9,37.225,36.345,36.925005,2633200,2985550,35.127103700024264,46.552298500737884,NaN,NaN,-161.5474479797405,-156.3267955803199,-0.2671604847904069,-0.4250750411344555,-0.1579145563440486,-47768802,-46805522,19.690472744832903,29.06001475719748,NaN,NaN,-16.364754890088847,-4.075178169365865
2003-01-29T09:30:00-05:00,36.769995,37.4,36.24,37.205,4012400,3012620,38.61997058930164,45.742174615416914,NaN,NaN,-134.3768434052455,-152.93456917692487,-0.23615503628284767,-0.4531083516976082,-0.21695331541476054,-43756402,-46442282,21.42379950092399,28.979586283191047,NaN,NaN,-17.484737971610688,-5.990829569686554
2003-01-30T09:30:00-05:00,37.335,37.405,36.485,36.6,3417600,2911090,34.32008513878098,44.26514156837261,NaN,NaN,-126.75142392352468,-155.07798824355834,-0.24097354924981762,-0.5181702519770326,-0.27719670272721497,-47174002,-47205162,20.426655497802187,28.886332465422527,NaN,NaN,-19.85491595390232,-7.971413338860234
2003-01-31T09:30:00-05:00,36.425005,37.120005,36.324995,37.120005,5831000,3001930,40.45651821125771,43.17528966833356,NaN,NaN,-107.84221032649711,-144.29191730687407,-0.19564881448574323,-0.521757720834394,-0.32610890634865075,-41343002,-46088842,25.864243161703797,28.944798854561764,NaN,NaN,-19.845848623942068,-9.667761236729067
2003-02-03T09:30:00-05:00,37.199995,37.24,36.625,36.800005,2648800,2973260,38.09762405333206,41.86058689193667,NaN,NaN,-93.22760784800909,-124.74910669660335,-0.17443249444315267,-0.5441495244025916,-0.3697170299594389,-43991802,-44806802,31.641586621841753,29.2662317816424,NaN,NaN,-20.59176623976795,-11.228333380020336
2003-02-04T09:30:00-05:00,36.525,37,36.225,36.800005,4471200,3050860,38.09762405333206,40.529412918132344,NaN,NaN,-96.07049438183401,-111.65371597702206,-0.14861983688476255,-0.555491826065392,-0.4068719891806295,-43991802,-44051402,34.86258897890569,29.346140073879756,NaN,NaN,-21.180058412319276,-12.65000838463447
2003-02-05T09:30:00-05:00,36.96,37,36.345,36.525,3436600,3072000,36.00522070158039,39.130391325312715,NaN,NaN,-90.03477989683961,-102.78530327534091,-0.13849086814714734,-0.5799855743645637,-0.4414947062174163,-47428402,-44785802,33.22356369018114,28.835866885769324,NaN,NaN,-22.294463230742174,-14.027787648364141
2003-02-06T09:30:00-05:00,36.415,36.61,36.135,36.324995,6960800,3255620,34.52028767139443,37.677244934031386,NaN,NaN,-96.52185937891745,-96.73939036641944,-0.13362113550874943,-0.6085211256033531,-0.4748999900946037,-54389202,-46228842,30.217394509505496,28.031423258113072,NaN,NaN,-23.657637128118736,-15.403480431186226
2003-02-07T09:30:00-05:00,36.519995,36.6,35.64,35.660005,8105600,3469470,30.078511448703196,36.53125367894228,NaN,NaN,-109.71620993704822,-97.11419028852967,-0.16167277641441347,-0.6769909606126205,-0.5153181841982071,-62494802,-50459202,23.50339333564402,26.909332788408882,NaN,NaN,-26.26876700808237,-16.955664227885677
2003-02-10T09:30:00-05:00,35.699995,36.06,35.445,36.03,2130400,3441090,35.0834968010178,36.12138826716923,NaN,NaN,-108.51582759912701,-100.17183423875325,-0.14246957334827393,-0.6934051508835495,-0.5509355775352756,-60364402,-53733722,19.830466104664026,25.823263527671628,NaN,NaN,-26.932143178862766,-18.38087550659669
2003-02-11T09:30:00-05:00,36.14,36.225,35.524,35.93,3132400,3509760,34.367471199156725,35.858590403779715,NaN,NaN,-99.55804347950767,-100.86934405828798,-0.12432387912528076,-0.7063404264418764,-0.5820165473165957,-63496802,-57634722,16.51863043897974,24.896457615065753,NaN,NaN,-27.681192431976914,-19.709492210222436
2003-02-12T09:30:00-05:00,35.8135,35.94,35.335,35.425005,7479200,3805400,30.93399920576678,35.13127747460435,NaN,NaN,-117.25127081137418,-106.31264224119491,-0.13335471372249919,-0.7487099394697196,-0.6153552257472205,-70976002,-62344242,13.571780269864803,23.96483581222754,NaN,NaN,-29.383676293966477,-21.091518507900155
2003-02-13T09:30:00-05:00,35.42,35.445505,34.97,35.33,3506600,3861650,30.32028901337111,34.804425155817974,NaN,NaN,-140.43398377756205,-115.09506712092382,-0.1324773124589702,-0.7809518663209332,-0.648474553861963,-74482602,-66362922,11.660241818616711,23.10257176902956,NaN,NaN,-30.950698582365693,-22.499972804252373
2003-02-14T09:30:00-05:00,35.379995,35.795,35.254995,35.65,2653800,3878190,34.99808841517704,35.07330644301401,NaN,NaN,-111.53604489561853,-115.4590341126379,-0.09864902357128058,-0.7717858333260637,-0.6731368097547831,-71828802,-68229722,10.892735058623018,22.380539409434952,NaN,NaN,-30.922893623059245,-23.703247206939068
2003-02-18T09:30:00-05:00,35.925005,36.375,35.925005,36.365,1881000,3851410,44.03809039939727,35.709805492969224,NaN,NaN,-43.0778662555711,-102.3714418439267,-0.02050827320028692,-0.6987721512551417,-0.6782638780548548,-69947802,-70146402,10.15374688633726,21.699344705256692,NaN,NaN,-28.029302345967285,-24.3212550839431
2003-02-19T09:30:00-05:00,36.275,36.275,35.665,35.925005,4073800,3948370,40.32180746054185,35.83136526948638,NaN,NaN,-62.202723622532176,-94.9003778725316,0.007648062179423154,-0.6687038003305759,-0.676351862509999,-74021602,-72251362,9.399547116066316,20.840469534909715,NaN,NaN,-26.727807980666956,-24.66504835490365
2003-02-20T09:30:00-05:00,35.96,35.985,35.699995,35.85,2898200,3926400,39.70667175541432,36.21612145638876,NaN,NaN,-66.83905156197595,-84.81793402265195,0.02627451061095709,-0.6435087242463027,-0.6697832348572598,-76919802,-73440122,8.993278634363094,20.023799758949785,NaN,NaN,-25.86785808870934,-24.836878316875893
2003-02-21T09:30:00-05:00,35.85,36.405,35.574995,36.160005,2668800,3949190,43.5404874866885,36.43640497606239,NaN,NaN,-36.2833533209515,-63.98780793132985,0.062461935144401126,-0.5917058159267583,-0.6541677510711594,-74251002,-73393802,9.158038623726284,18.83049943480853,NaN,NaN,-23.980162421913313,-24.71449033188124
2003-02-24T09:30:00-05:00,36.097,36.097,35.6,35.605005,2530000,3897440,38.78558815526992,36.48554526905795,NaN,NaN,-66.8187404756067,-55.04434704732747,0.05241427301940804,-0.5886499097968994,-0.6410641828163074,-76781002,-74384242,8.791527686721082,17.1983523680142,NaN,NaN,-23.778445459073367,-24.58076963576583
2003-02-25T09:30:00-05:00,35.449995,36.025,35.175005,35.93,2659400,3856540,42.7296715828995,36.81640580688419,NaN,NaN,-68.53180327406524,-60.1351344510263,0.06995383169165126,-0.5536218932017434,-0.6235757248933946,-74121602,-75219002,8.483371359712478,15.314122538071826,NaN,NaN,-22.384768921843904,-24.267055248062697
2003-02-26T09:30:00-05:00,35.894995,35.949995,35.504995,35.75,1955600,3822660,41.1483319510774,37.18377089613398,NaN,NaN,-59.683964490004975,-59.63138262452086,0.0714780331857432,-0.5342281834112157,-0.6057062165969589,-76077202,-75630122,8.328537078582798,13.53590635152909,NaN,NaN,-21.70837153702807,-23.90152900362918
2003-02-27T09:30:00-05:00,35.935,36.15,35.65,35.947,2940800,3769080,43.60808142018322,37.83289902104747,NaN,NaN,-27.18494609372623,-51.700561530870914,0.0867805642717615,-0.49723051125725704,-0.5840110755290185,-73136402,-74873442,11.529107489026387,12.201028707209153,NaN,NaN,-20.419838821631583,-23.404144691915235
2003-02-28T09:30:00-05:00,36.045,36.269995,35.835,36.004995,1458600,3671130,44.345545780668125,38.85197290190211,NaN,NaN,0.1505409015838503,-44.41378268636385,0.10084813663078662,-0.45795090474053524,-0.5587990413713219,-71677802,-74358802,13.735096433381614,11.503293214190409,NaN,NaN,-19.153511755946404,-22.79691141534826
2003-03-03T09:30:00-05:00,36.25,36.375,35.629995,35.894995,2962200,3527690,43.191794411332076,39.43113701692455,NaN,NaN,-5.688123696716396,-32.18765933058579,0.10245331366032162,-0.4307323992959198,-0.5331857129562414,-74640002,-73930602,15.620344393162782,11.202570234797463,NaN,NaN,-18.40087643378765,-22.16890641798246
2003-03-04T09:30:00-05:00,35.824995,35.824995,35.4,35.43,1724800,3481490,38.617852678628545,39.73473569402968,NaN,NaN,-98.4149121443045,-38.164281104633645,0.0732746933087769,-0.4415923463202702,-0.5148670396290471,-76364802,-74379242,15.244436262363024,11.111556365039124,NaN,NaN,-19.025863547095017,-21.719900293569967
2003-03-05T09:30:00-05:00,35.385,35.635,35.292,35.5,1838200,3349840,39.65388460730278,40.35758465128225,NaN,NaN,-111.05398341384725,-48.43828488940209,0.06030609984037605,-0.43948441482857703,-0.4997905146689531,-74526602,-74069122,16.736077724031958,11.337577611765353,NaN,NaN,-19.25857726594532,-21.36828271819502
2003-03-06T09:30:00-05:00,35.252,35.43,35.074995,35.21,1848200,3270420,36.87691999795402,40.82591543589531,NaN,NaN,-161.54714874107546,-75.31072541887194,0.03506566350655571,-0.4559584352857584,-0.4910240987923141,-76374802,-74716802,16.098833323205284,11.65461986209311,NaN,NaN,-20.24270979363458,-21.207486586114957
2003-03-07T09:30:00-05:00,34.875,35.42,34.76,35.225,2813200,3063040,37.122198733007366,40.97763760145462,NaN,NaN,-167.7255012364045,-108.88593384646961,0.02284108491445941,-0.4624727426492399,-0.4853138275636993,-73561602,-75093562,15.723775554848089,11.999694183252043,NaN,NaN,-20.9910332181658,-21.176564676407935
2003-03-10T09:30:00-05:00,34.995005,35.07,34.525,34.620005,2209200,2768220,31.761536648957218,40.100740904994616,NaN,NaN,-217.65790676750692,-151.2798904606277,-0.020203265525664205,-0.5105679094707796,-0.49036464394511536,-75770802,-75319722,15.490481130807538,12.38088948642849,NaN,NaN,-23.277478427450728,-21.476695212271192
2003-03-11T09:30:00-05:00,34.665,34.9,34.375,34.375,2102800,2766840,29.87975341466027,39.35487990171736,NaN,NaN,-207.31820658319924,-173.06054934840668,-0.05728862777788646,-0.5619754286674734,-0.504686800889587,-77873602,-75621482,15.167124818970876,12.792859322350248,NaN,NaN,-25.78629997208473,-22.0923530351017
2003-03-12T09:30:00-05:00,34.443,34.54,34.115,34.449995,4736200,2847030,31.222992772501556,38.74890283150931,NaN,NaN,-195.42886785325706,-189.9355262362886,-0.06814271091614621,-0.5898651895347697,-0.5217224786186235,-73137402,-75343642,16.887412275143234,13.356726010977397,NaN,NaN,-27.48460057314736,-22.862674111965365
2003-03-13T09:30:00-05:00,34.9,35.42,34.620005,35.379995,3975600,2671850,45.233665045471824,38.86984408570812,NaN,NaN,-58.95724842354996,-169.41754617278352,-0.007266814842021185,-0.5308059971711501,-0.5235391823291289,-69161802,-73901042,25.351738178157802,14.513418836293935,NaN,NaN,-24.614824848371118,-23.11298136002333
2003-03-14T09:30:00-05:00,35.550005,35.629995,35.175005,35.425005,3235600,2658300,45.809043066798296,39.37151943653157,NaN,NaN,-17.698525981174157,-139.41215112173745,0.03891539573591396,-0.4748949376592364,-0.5138103333951504,-65926202,-72373962,33.116771853141586,16.250936276752544,NaN,NaN,-22.16093908765484,-22.976975321113546
2003-03-17T09:30:00-05:00,35.275,36.3415,35.089995,36.245005,2270200,2639120,55.070170912824224,40.25298367438334,NaN,NaN,56.377666063345764,-84.60503655556693,0.12283629634124038,-0.3602649629685999,-0.48310125930984027,-63656002,-69951002,43.21068202272943,18.73145846696804,NaN,NaN,-16.731540700842487,-22.084770375360538
2003-03-18T09:30:00-05:00,36.449995,36.72,36.115,36.72,3548000,2722470,59.398668725079595,41.55657915824064,NaN,NaN,148.68634122890126,-13.404126993146821,0.2037144225813673,-0.22845823108313112,-0.4321726536644984,-60108002,-66397882,54.140640416097895,22.003751562504835,NaN,NaN,-10.673440800755994,-20.454580436131316
2003-03-19T09:30:00-05:00,36.725,36.730005,36.300005,36.629995,3538600,2695710,58.25345535835857,42.60267729668173,NaN,NaN,140.79808003577148,53.84126258465888,0.2419243453422129,-0.1297672219867323,-0.3716915673289452,-63646602,-64499722,58.71235958615518,25.373983855156887,NaN,NaN,-6.274355703179434,-18.428834045709618
2003-03-20T09:30:00-05:00,36.550005,36.995005,36.03,36.870005,4423200,2771960,60.443604985861526,43.75253866848126,NaN,NaN,135.99516066393883,92.83174440215664,0.27189702929817394,-0.03182028070622778,-0.3037173100044017,-59223402,-62512042,62.884899796689446,28.884684095393162,NaN,NaN,-1.954142831043831,-16.07530672932879
2003-03-21T09:30:00-05:00,37.165,37.5,36.89,37.385,7680000,3022520,64.72054779945054,45.29030676763258,NaN,NaN,191.03586543836497,134.57862268606445,0.3120647458885971,0.08636362235634465,-0.22570112353225244,-51543402,-59635482,67.93523476501124,32.621461979096615,NaN,NaN,3.2046327304034348,-13.321029663652759
2003-03-24T09:30:00-05:00,36.85,36.97,36.405,36.585,5340800,3163060,54.80709043407188,46.446680893021394,NaN,NaN,104.6292980249343,144.2289490783822,0.2718856858340293,0.11415598376028413,-0.15772970207374512,-56884202,-58281122,70.0047445162655,36.532912568661075,NaN,NaN,4.428561265412162,-10.785373816643485
2003-03-25T09:30:00-05:00,36.56,37.125,36.5,36.975,2976600,3178920,58.1708238746776,47.7693194121196,NaN,NaN,111.69796660842341,136.83127415428663,0.258776412943104,0.16574081410513486,-0.09303559883796912,-53907602,-57041042,71.79946580955783,40.46601171762721,NaN,NaN,6.567420608675426,-8.30640318445507
2003-03-26T09:30:00-05:00,36.964995,37.050005,36.519995,36.519995,2660600,3214170,53.1961174990146,48.93497637648107,NaN,NaN,84.22417779381743,125.5164937058958,0.2088051191599825,0.16797080011200904,-0.04083431904797348,-56568202,-55625362,73.7317693425986,44.58265000472674,NaN,NaN,6.651317489130039,-6.169585945371482
2003-03-27T09:30:00-05:00,36.35,36.870005,36.300005,36.7685,1205600,3127410,55.43759559205166,50.24321900926994,NaN,NaN,72.3047688906901,112.77841535124605,0.1827694581802798,0.18762750367737624,0.0048580454970964665,-55362602,-54853202,74.74810885128868,48.798673811615345,NaN,NaN,7.446388253909721,-4.224446774045596
2003-03-28T09:30:00-05:00,36.595,36.945,36.595,36.75,2776000,3193280,55.225557441749345,51.91922049446939,NaN,NaN,76.2212300826236,89.81548828009778,0.1556448166086496,0.19941406625790847,0.04376924964925887,-58138602,-56172242,69.78124719560323,52.67658567338646,NaN,NaN,8.006331057296386,-2.4771927981395985
2003-03-31T09:30:00-05:00,36.324995,36.655,35.975,36,1859200,3138130,47.32318014454071,53.1651795466037,NaN,NaN,25.72244667768405,74.03411801064773,0.08222217452820352,0.14654696780951326,0.06432479328130974,-59997802,-56794962,67.50084934222201,56.414708853618684,NaN,NaN,5.919428212206799,-1.2776755109472562
2003-04-01T09:30:00-05:00,36.35,36.675005,36.11,36.625,2088800,3156330,53.31793158750603,54.743389461961165,NaN,NaN,44.09259544982761,60.513043778928555,0.07119166567487575,0.15331437537490444,0.08212270970002869,-57909002,-57595242,64.58003466302405,59.82132473846732,NaN,NaN,6.116932251925112,-0.2213029733940608
2003-04-02T09:30:00-05:00,37.235,37.6,37.065,37.355005,2799400,3204390,59.16354590166336,55.73838095168913,NaN,NaN,107.7074913982075,65.20970649980656,0.10638448827547922,0.2151033200443777,0.10871883176889849,-55109602,-57303522,65.17164620390619,62.66560388316363,NaN,NaN,8.315120284707307,0.998186063477563
2003-04-03T09:30:00-05:00,37.699995,37.699995,37.300005,37.375,3017200,3262840,59.31382796709875,56.703008444567736,NaN,NaN,108.85032553433598,72.51881782853573,0.1231506823672236,0.262657184727928,0.1395065023607044,-52092402,-56649482,66.52177057017073,65.05167522009428,NaN,NaN,10.051084387206878,2.2914572525817505
2003-04-04T09:30:00-05:00,37.54,37.655,37.165,37.265,1385600,3191460,58.04820631680561,56.91572525913784,NaN,NaN,94.88622875330103,76.25181756267122,0.11891184856971124,0.28814631307284344,0.1692344645031322,-53478002,-55717362,68.40176209871882,66.85103808266496,NaN,NaN,11.054521527837409,3.543323577618273
2003-04-07T09:30:00-04:00,38.074995,38.22,37.29,37.29,3368400,3249420,58.26616203858206,56.83483192438801,NaN,NaN,113.3105214930412,93.76943252574264,0.11007403735732885,0.3068270111997933,0.19675297384246443,-50109602,-53739722,71.99502280902192,68.12635111073095,NaN,NaN,11.924336906475135,4.740611196026396
2003-04-08T09:30:00-04:00,37.35,37.5,37.18,37.32,2013600,3244960,58.54449578900064,56.85562052657673,NaN,NaN,87.44596772528189,102.4401069808335,0.09888517618811651,0.3203594440776101,0.22147426788949356,-48096002,-51777122,75.02973965130732,69.29187825824182,NaN,NaN,12.714045154807183,5.879673190137937
2003-04-09T09:30:00-04:00,37.365995,37.800005,36.910005,37.115,4016000,3208950,55.80561737717174,56.52433569738459,NaN,NaN,77.36066779395665,96.37074225998333,0.07158673072847593,0.3109576813000885,0.23937095057161256,-52112002,-51177602,75.88924833015413,70.22076029634644,NaN,NaN,12.643731700013166,6.845967262977255
2003-04-10T09:30:00-04:00,37.175005,37.28,36.985,37.125,1569000,3088620,55.91396479070883,55.895294053903044,NaN,NaN,49.56577768489247,84.51383269009463,0.049179776630597194,0.30084567135985907,0.2516658947292619,-50543002,-50867722,76.34253193729425,70.8212815229381,NaN,NaN,12.613381865527842,7.669883634770196
2003-04-11T09:30:00-04:00,37.385,37.495005,36.885,36.92,1953200,3024500,53.043061244735455,55.76929196895044,NaN,NaN,36.57807559724802,72.85220205888402,0.01718043573410627,0.2731414393968947,0.25596100366278846,-52496202,-50671362,76.64219652414688,71.29538523778676,NaN,NaN,11.829187178756193,8.264069855339624
2003-04-14T09:30:00-04:00,37.01,37.625,37.01,37.589995,1662400,2994110,60.23017301312695,55.916388335982546,NaN,NaN,81.7046753978315,66.53103283984208,0.03664721001769772,0.3017700161849106,0.2651228061672129,-50833802,-50816202,75.878699732199,71.58675908940398,NaN,NaN,13.147359396263713,8.961682646900208
2003-04-15T09:30:00-04:00,37.574995,37.995005,37.324995,37.995005,1262600,2879840,63.833773887530405,56.67622093516224,NaN,NaN,132.62234332358562,75.56630795950284,0.07035721770524783,0.3530693282987727,0.28271211059352486,-49571202,-51111242,74.25596443330795,71.62420159588322,NaN,NaN,15.381936591489117,9.878861781841481
2003-04-16T09:30:00-04:00,38.06,38.324995,37.53,37.6,2042800,2805050,58.28658303527812,56.87972003824984,NaN,NaN,128.54052378099385,85.80227915691027,0.06001202719694787,0.35772714458970967,0.2977151173927618,-51614002,-51011642,74.45457577484368,71.60323494756572,NaN,NaN,15.638418640280921,10.701655618761402
2003-04-17T09:30:00-04:00,37.685,38.275,37.625,38.175005,3477400,2757760,63.28791162538251,57.45560247993792,NaN,NaN,148.07250504266457,105.50362462846469,0.08436319646216406,0.40316911297046687,0.3188059165083028,-48136602,-50530362,75.44055797196957,72.00747143159188,NaN,NaN,17.45408297039496,11.666288097566197
2003-04-21T09:30:00-04:00,38.24,38.435,38.089995,38.435,1799600,2463740,65.31304599770999,58.740592898021454,NaN,NaN,168.76432085496046,131.9408736800072,0.10888936025310192,0.45491761682468024,0.3460282565715783,-46337002,-49298522,77.8021655480723,72.74327973200977,NaN,NaN,19.58958876966202,12.798188193579886
2003-04-22T09:30:00-04:00,38.1,39.074995,38.1,38.964995,1848600,2289130,69.05983194626829,59.86501435221875,NaN,NaN,199.10731144614692,155.42140088967028,0.14922209354176086,0.5325558734987794,0.38333377995701856,-44488402,-48029442,79.94207154816145,73.84056808094816,NaN,NaN,22.661606035232992,14.207247885244616
2003-04-23T09:30:00-04:00,38.975,39.42,38.975,39.375,2297600,2255180,71.6142671643455,60.754351585267486,NaN,NaN,221.45758380568802,173.18844898609075,0.189350181024595,0.6200215062377623,0.4306713252131673,-42190802,-46553362,82.10313105360304,75.0499598559265,NaN,NaN,26.0820301192494,15.903645347245298
2003-04-24T09:30:00-04:00,39.1555,39.35,39.019995,39.175005,2505200,2247410,68.63747711404751,61.42032652433526,NaN,NaN,174.08519397803428,182.29738302549885,0.18788607753368292,0.6655289221302709,0.477642844596588,-44696002,-45169762,83.85865117467323,76.28830847053382,NaN,NaN,27.936379556835977,17.622607377186824
2003-04-25T09:30:00-04:00,39.125,39.125,38.615,38.625,1117000,2242980,61.11395462431303,61.63930854630007,NaN,NaN,114.29426704625274,175.54173542621646,0.13766449435040018,0.6497234625345882,0.5120589681841881,-45813002,-44705042,84.41173631524009,77.43187805742821,NaN,NaN,27.12067985512808,18.979474874035574
2003-04-28T09:30:00-04:00,38.904505,39.46,38.775,39.31,1924800,2200420,66.09811867228437,62.19873402013595,NaN,NaN,133.044039235964,168.39767910241716,0.13801673453684526,0.6845798863552446,0.5465631518183993,-43888202,-44215282,84.99525842972434,78.36046631604981,NaN,NaN,28.07109523395817,20.278277782595946
2003-04-29T09:30:00-04:00,39.433,39.775,39.375,39.575995,3254800,2270200,67.82282081737067,62.86147152216238,NaN,NaN,145.96582121767793,157.76938105672338,0.1429947141371921,0.7253065444898894,0.5823118303526973,-40633402,-43444282,85.89066808962399,79.13624691878671,NaN,NaN,29.39920008746671,21.58126668329177
2003-04-30T09:30:00-04:00,39.425005,39.949995,39.300005,39.699995,2215200,2276520,68.62416392687562,63.777081989998365,NaN,NaN,132.06562160501883,139.89098861658954,0.14122336061816743,0.7588410311254066,0.6176176705072391,-38418202,-42689762,86.7255243208293,79.91026663240636,NaN,NaN,30.709072835895295,22.88523899080656
2003-05-01T09:30:00-04:00,39.75,39.925005,39.245005,39.65,2613600,2267230,67.89004536061809,64.63251631642046,NaN,NaN,111.78204405107988,127.43035863119867,0.12388868211337256,0.7724785231489548,0.6485898410355823,-41031802,-41956922,87.49921207642669,80.70717235663012,NaN,NaN,31.546185747802653,24.122517098948858
2003-05-02T09:30:00-04:00,39.75,40.675005,39.75,40.65,3410400,2286890,73.90356163988025,66.1225520589308,NaN,NaN,147.78360449368708,134.12822612068553,0.1644337860642151,0.8541320736158511,0.689698287551636,-37621402,-40318602,89.03748314507409,81.59254997241064,NaN,NaN,34.32693698096354,25.580291367808098
2003-05-05T09:30:00-04:00,40.765,40.92,40.629995,40.835,3975800,2416400,74.84224078030364,67.16627118515771,NaN,NaN,155.27568486121567,138.57455524573587,0.18674520112244275,0.9231297889546894,0.7363845878322467,-33645602,-38270082,90.5957622383857,82.64376872285254,NaN,NaN,36.858406365470344,27.19145065318842
2003-05-06T09:30:00-04:00,40.93,41.285005,40.894995,41.225,3060200,2400990,76.74154426904538,68.08825478383734,NaN,NaN,155.97917104193493,140.57722521058727,0.20911548297741644,0.9977789415540173,0.7886634585766008,-30585402,-36260482,91.82362509885508,83.89860162753448,NaN,NaN,39.59361858419578,28.963188929046613
2003-05-07T09:30:00-04:00,41.04,41.195,40.86,40.975,3449000,2472760,72.94009815953316,69.13493443556986,NaN,NaN,131.14956672533896,140.39401423465128,0.18903005293144548,1.0249510247409077,0.8359209718094622,-34034402,-35383722,92.29621681371862,85.17300455888268,NaN,NaN,40.67470567204856,30.636262749475463
2003-05-08T09:30:00-04:00,40.69,40.879995,40.535005,40.635,4200400,2481980,68.00619763775924,69.47195486502532,NaN,NaN,101.08858619143803,138.25532266272293,0.137212689131322,1.0074368332236148,0.8702241440922928,-38234802,-34824322,92.59048382285202,86.39799926251715,NaN,NaN,40.06464397682149,31.98317435338204
2003-05-09T09:30:00-04:00,40.86,41.24,40.745005,41.22,2168600,2511960,71.56962759245205,69.91885355036405,NaN,NaN,114.78672509792254,131.65594678357002,0.12694131939588638,1.0289007933371508,0.9019594739412644,-36066202,-34513282,92.75616923919605,87.46614238331169,NaN,NaN,40.65131602293564,33.22148030617541
2003-05-12T09:30:00-04:00,41.18,41.725,41.15,41.67,2536600,2541130,73.97121094061721,70.26966633567467,NaN,NaN,128.7916123771354,126.35913228675398,0.13434390647482553,1.0698893570347963,0.9355454505599707,-33529602,-34490082,92.769157164433,88.38236278447394,NaN,NaN,41.91356251016603,34.463206335316926
2003-05-13T09:30:00-04:00,41.685,41.99,41.375,41.915,3012400,2608630,75.19953563148005,70.52575694047,NaN,NaN,128.40890894769032,120.84507986790504,0.139047313416245,1.109354592330277,0.970307278914032,-30517202,-34476442,92.77735650135774,89.14480745931358,NaN,NaN,43.32896628626601,35.72974347116679
2003-05-14T09:30:00-04:00,42.045,42.045,41.705,41.89,3340200,2712510,74.81157591885486,70.96676399795625,NaN,NaN,119.45752315176475,118.5066711531902,0.1242646799909688,1.125638128902743,1.0013734489117743,-33857402,-34441042,92.8001749088579,89.78348772604105,NaN,NaN,44.34596705647832,36.96063255478273
2003-05-15T09:30:00-04:00,42.018995,42.199995,41.85,42.055,1187200,2669730,75.70254152174078,72.00880591920108,NaN,NaN,115.94949421444916,121.47885275779245,0.10988563582597832,1.138730493694247,1.0288448578682687,-32670202,-33328122,93.495876939012,90.43235491345332,NaN,NaN,45.4489147912237,38.173244302845724
2003-05-16T09:30:00-04:00,42.055,42.365,41.525,41.535005,3475200,2669620,67.58857622387421,72.11526717288608,NaN,NaN,94.10662726877693,117.34283319196331,0.05254809462747079,1.0945299761526073,1.0419818815251365,-36145402,-33343962,93.35760726132138,91.02966554428168,NaN,NaN,44.00504297772933,39.00635839925767
2003-05-19T09:30:00-04:00,41.300005,41.595,40.765,40.815,4013600,2780320,58.274823919655454,71.43326739447784,NaN,NaN,41.32496296716497,99.84950330996924,-0.04159321028904328,0.9899903686638325,1.0315835789528758,-40159002,-34669842,82.37593287010081,90.77861302860147,NaN,NaN,39.691886719619,39.104291016452144
2003-05-20T09:30:00-04:00,40.870005,41.055,40.43,40.805,4261000,2900940,58.15496031871789,70.6854671367523,NaN,NaN,15.662758085309543,77.30027313749306,-0.10846169879321765,0.8960064554613538,1.0044681542545715,-44420002,-37450402,65.0851865545769,89.2328746167263,NaN,NaN,36.24422585305154,38.69571027882348
2003-05-21T09:30:00-04:00,40.685,41.050005,40.585,40.96,2802600,2926190,59.543972232944746,70.08931905620419,NaN,NaN,18.83118476115402,57.17500545937092,-0.14395363698904795,0.8245261080182615,0.9684797450073095,-41617402,-39002402,57.793372866091616,87.11102895884524,NaN,NaN,33.781812756489366,37.99372491849004
2003-05-22T09:30:00-04:00,40.975,41.455,40.925005,41.375,3453000,2973580,63.07783906450703,69.31605315796325,NaN,NaN,46.57293408480403,43.2996934334419,-0.14099812321841365,0.7922320909842924,0.933230214202706,-38164402,-40101242,53.24496519113326,84.55442053356374,NaN,NaN,32.660524121503556,37.23183909034911
2003-05-23T09:30:00-04:00,41.385,41.824995,41.195,41.699995,1370600,2986260,65.61120086435366,68.65669316396682,NaN,NaN,72.0272165332931,38.883811286345136,-0.11952196990983788,0.7838277518154086,0.9033497217252465,-36793802,-40230922,52.71766162808413,81.8488419185422,NaN,NaN,32.4509093652129,36.54884912961537
2003-05-27T09:30:00-04:00,41.635,42.695,41.635,42.68,2582600,3019150,71.87737261853813,68.30925233178773,NaN,NaN,143.96889146775007,59.412596986462155,-0.04548963126395433,0.8464876826453036,0.8919773139092579,-34211202,-39041362,56.93116474187496,79.35652332161506,NaN,NaN,34.33728806032448,36.23291183400239
2003-05-28T09:30:00-04:00,42.800005,43.175005,42.800005,42.97,2116200,2962220,73.42078447693042,68.34358706874468,NaN,NaN,188.39288781653408,93.95862293270707,0.013672181593142652,0.9090675409006863,0.8953953593075437,-32095002,-36576362,64.07534266061717,77.34074659639349,NaN,NaN,36.377151598926226,36.25351751470579
2003-05-29T09:30:00-04:00,43.185,43.485,42.57,43.245005,4168000,3059860,74.83141112031777,68.83110231749886,NaN,NaN,174.42778555616968,125.0779430917102,0.05942396944916961,0.9696753211190057,0.9102513516698361,-27927002,-33838282,70.02351718463751,75.72882040794958,NaN,NaN,38.501037623833376,36.57459181600973
2003-05-30T09:30:00-04:00,43.574995,44.074995,43.435,44.015,6961800,3277270,78.30350529918138,69.31209358226525,NaN,NaN,213.88048296484854,158.5394528677191,0.1258258952757153,1.0675337207644802,0.9417078254887649,-20965202,-30398442,75.5096142437517,74.49692362256071,NaN,NaN,41.56705267488584,37.287800510134886
2003-06-02T09:30:00-04:00,44.375,44.725,44.07,44.245005,6354800,3424490,79.22543666219534,69.68739541952083,NaN,NaN,212.84350198759284,186.70270995857905,0.16694234589452717,1.1503857578569239,0.9834434119623967,-14610402,-25961762,80.47340874877503,73.61865587858514,NaN,NaN,44.33237641264945,38.29416849620839
2003-06-03T09:30:00-04:00,44.21,44.385,44,44.385,2427800,3347090,79.78838679304928,70.01517050249005,NaN,NaN,167.00952845395312,191.31083735581964,0.18393023493555427,1.2133562056318397,1.0294259706962854,-12182602,-21556042,83.95186277264246,72.98826346939119,NaN,NaN,46.73284613510505,39.49969387319363
2003-06-04T09:30:00-04:00,44.375,45.125,44.345,44.99,2709200,3329540,82.05190463400915,70.53233683928678,NaN,NaN,167.29133164835318,187.09052612218346,0.21416059436570167,1.2971267136534124,1.0829661192877107,-9473402,-17031722,86.59310964109929,72.54490166455129,NaN,NaN,49.57066764026231,40.9384044113463
2003-06-05T09:30:00-04:00,44.824995,45.725,44.674005,45.725,2841000,3299140,84.34560129339457,71.14969825154778,NaN,NaN,164.95722287049924,185.19641358504938,0.2589145332733498,1.406609285879398,1.1476947526060481,-6632402,-12772802,88.51014364448022,72.18877785779902,NaN,NaN,52.841929054619094,42.63890793181384
2003-06-06T09:30:00-04:00,46.199995,46.54,45.199995,45.199995,4320000,3305120,76.79611109485586,71.80737931376075,NaN,NaN,150.2567996957616,172.47167693123203,0.22942480090615192,1.434475753738738,1.2050509528325861,-10952402,-10770242,89.28590474695623,71.8979419639158,NaN,NaN,53.05242716382341,44.12655353638664
2003-06-09T09:30:00-04:00,45.1,45.199995,44.339995,44.36,3422400,3367810,66.53481774542992,72.39737887274464,NaN,NaN,88.48668083020374,147.60031269975417,0.13432164276791236,1.3729530062924766,1.2386313635245643,-14374802,-10723122,89.30420389808046,72.39281846591435,NaN,NaN,49.63085669013664,44.91288255835092
2003-06-10T09:30:00-04:00,44.49,45.095,44.480005,45.025,2932800,3387620,69.95723108618468,73.24039821327798,NaN,NaN,89.08805407406476,132.0160178237765,0.09881784396272675,1.3621536684779727,1.263335824515246,-11442002,-10575002,89.3656901268651,74.12714014964922,NaN,NaN,47.97189891435522,45.349884894922965
2003-06-11T09:30:00-04:00,45,45.525,44.64,45.449995,3112200,3392610,71.93277037862141,74.12531236654058,NaN,NaN,93.3600443296566,117.2297603600372,0.08698915249690264,1.3720722651363744,1.2850831126394717,-8329802,-10346282,89.46638728420098,76.38949832237132,NaN,NaN,47.308572844572836,45.62969745915866
2003-06-12T09:30:00-04:00,45.74,45.805,45.4,45.705,2266400,3338920,73.07676129261573,74.83952109711979,NaN,NaN,100.10806580573603,104.25992894708455,0.07957300865396455,1.3845493734569274,1.3049763648029629,-6063402,-10232482,89.5195626040393,78.98054099472175,NaN,NaN,47.153333886735815,45.8473598059554
2003-06-13T09:30:00-04:00,45.675005,45.695,44.785005,44.82,2896400,3424380,63.41619729412117,74.68273512781745,NaN,NaN,69.86797358978775,88.18216372588977,0.0023775118675062323,1.3079482546373455,1.3055707427698393,-8959802,-9833962,89.71536331363521,81.6232339722611,NaN,NaN,43.69786877470372,45.54028965863373
2003-06-16T09:30:00-04:00,45.1,45.620005,44.925005,45.574995,3104400,3405840,67.37821489969505,74.36136671932867,NaN,NaN,75.10834066614507,85.50649569307805,-0.009852385250008977,1.293255261207328,1.303107646457337,-5855402,-8130082,90.52999038829044,84.02315008986223,NaN,NaN,42.15162098301297,45.05619413354505
2003-06-17T09:30:00-04:00,45.815,45.85,45.32,45.67,3670200,3388670,67.85005501253768,73.96345747187205,NaN,NaN,80.72027214483252,83.83293930723161,-0.02281855603609606,1.2745844514122169,1.297403007448313,-2185202,-6278722,91.33326147332642,85.97014429077002,NaN,NaN,41.107473807450226,44.49209122981722
2003-06-18T09:30:00-04:00,45.49,45.765,45.285005,45.64,2160400,3283640,67.51795728264125,73.441067912038,NaN,NaN,74.71188614208221,80.10330766971673,-0.04349201975606709,1.2430379827532292,1.2865300025092963,-4345602,-5481882,91.66111846706187,87.5156872395146,NaN,NaN,40.18427056526315,43.87668827773807
2003-06-19T09:30:00-04:00,45.75,45.92,44.83,45.019995,3827600,3334890,60.88531079406118,72.19691116167228,NaN,NaN,55.46765261599582,71.17522503176869,-0.1054661418726266,1.154697325168513,1.2601634670411397,-8173202,-5903842,89.725457555613,88.53110461893327,NaN,NaN,37.310196832058764,42.93861807121245
2003-06-20T09:30:00-04:00,45.15,45.199995,44.625,44.635,2780400,3301260,57.132186218449974,70.61882184426189,NaN,NaN,21.970361396766847,61.5957025931645,-0.17483976281199687,1.0416137635261435,1.2164535263381404,-10953602,-6302602,87.83768360426023,89.05712425146794,NaN,NaN,33.74212119380532,41.62483280301144
2003-06-23T09:30:00-04:00,44.675005,44.85,43.695,43.839995,3962800,3430870,50.24456859591109,68.50854911589488,NaN,NaN,-45.715410543818216,37.43095235117185,-0.27098195157325167,0.8777260868715757,1.1487080384448274,-14916402,-8114802,79.6373703887203,88.74894622404493,NaN,NaN,28.350948441427487,39.72856360849944
2003-06-24T09:30:00-04:00,43.71,44.1155,43.49,43.824995,3491000,3476290,50.1217905138667,66.22782667874183,NaN,NaN,-91.0657298662114,3.07375194896305,-0.3284665081018918,0.7381249033174626,1.0665914114193544,-18407402,-11359242,67.48940679397121,87.38439602067862,NaN,NaN,24.063839671410932,37.49074590320108
2003-06-25T09:30:00-04:00,43.835,44.519995,43.835,44.120005,4250200,3582990,52.57626026150694,63.95858803360701,NaN,NaN,-69.43604942778333,-25.75583516501006,-0.33817501865393784,0.6438726381019322,0.98204765675587,-14157202,-13321562,61.38985473006285,85.44723252679168,NaN,NaN,21.19130974146452,35.162255022953
2003-06-26T09:30:00-04:00,44.275,44.97,44.199995,44.875,6290800,3689130,58.23995465833282,62.63314828814108,NaN,NaN,-23.011353658763372,-41.4516364199619,-0.2873035556335276,0.6229182122139605,0.9102217678474881,-7866402,-13260202,61.507005254284174,83.46302542017224,NaN,NaN,20.373434958931156,33.04956644237845
2003-06-27T09:30:00-04:00,45,45.445,44.585,44.589995,6459200,3664000,55.54327959355024,61.84803842014968,NaN,NaN,-5.064319174623851,-46.85857253424004,-0.2668440524112039,0.5766667023334833,0.8435107547446872,-14325602,-13934602,59.37464432828604,81.32519973661549,NaN,NaN,18.881145424440557,31.02550629695875
2003-06-30T09:30:00-04:00,44.845,45.155,44.050005,44.449995,8802398,3786379.9,54.21530508913282,60.723615134645975,NaN,NaN,-54.30519621085908,-48.57652966764821,-0.2566566254650715,0.5226899729133478,0.7793465983784194,-23128000,-15576921.6,54.42619732527726,78.82952167935922,NaN,NaN,17.27328932742068,29.060903872739026
2003-07-01T09:30:00-04:00,44.405,44.85,43.875,44.754995,5613600,3945669.9,56.6471313537417,59.631783775726,NaN,NaN,-66.26001121320728,-43.615385937047385,-0.2244577459155055,0.4987744159840375,0.723232161899543,-17514400,-15398321.2,54.86672599304236,76.35811730141931,NaN,NaN,16.60998514503063,27.282201197352112
2003-07-02T09:30:00-04:00,44.935,45.875,44.935,45.875,4177000,4019059.9,64.17258234956782,58.99577099407973,NaN,NaN,85.06567500020591,-12.715041051449537,-0.12762713307314255,0.5636982455581148,0.6913253786312573,-13337400,-15234360.8,55.29396050812921,73.91343143742574,NaN,NaN,18.412057399813676,26.015037797703766
2003-07-03T09:30:00-04:00,45.51,45.824995,45.405,45.480005,1816000,3967809.9,60.203477340789384,58.76629099741316,NaN,NaN,83.11748096329971,8.510725872963079,-0.0917554952889662,0.5766310095200495,0.6683865048090157,-15153400,-16691760.4,50.699858834962804,71.12660968894913,NaN,NaN,18.658436346494803,24.964094733245343
2003-07-07T09:30:00-04:00,45.925005,46.495005,45.925005,46.425005,3659800,3934799.9,65.67359088305886,58.644532139082,NaN,NaN,167.27656003732824,42.9789017153535,-0.010247732866038417,0.6555768387264678,0.6658245715925062,-11493600,-16125360,52.35660212568661,68.39993909876314,NaN,NaN,20.72270877714339,24.358182453802208
2003-07-08T09:30:00-04:00,46.4,47.379995,46.344,47.25,3650400,3946199.9,69.60186948816585,58.769661744484026,NaN,NaN,214.8759205109966,96.81512505972464,0.08795601468006797,0.7757695899425912,0.6878135752625232,-7843200,-13068400,60.14188956722248,66.17198396261286,NaN,NaN,23.85344292312838,24.286076806563088
2003-07-09T09:30:00-04:00,47.26,47.699995,46.870005,47.6,7547600,4176939.9,71.11225879865435,59.026397567056385,NaN,NaN,212.3812011920809,152.54336754078227,0.160962938751829,0.8890172487023094,0.7280543099504804,-295600,-9624640,66.7362279014764,64.39163463649962,NaN,NaN,26.868154067615595,24.654944986713446
2003-07-10T09:30:00-04:00,47.35,47.355005,46.58,46.67,3662000,4204429.9,62.26006014371145,59.12459394917426,NaN,NaN,136.4100625982792,162.81224506039695,0.13229636163192082,0.8934247619903815,0.7611284003584606,-3957600,-7748680,69.67910370714262,62.959752218751724,NaN,NaN,26.45539972351279,24.91215280625621
2003-07-11T09:30:00-04:00,46.86,47.35,46.800005,47.315,2477400,4214979.9,65.47045859793221,59.72018483342301,NaN,NaN,140.23064338778124,174.23487754529324,0.1416168433938806,0.9381494546008113,0.7965326112069308,-1480200,-5014040,73.37673067095164,61.92682700922968,NaN,NaN,27.210628691934946,25.240506504210316
2003-07-14T09:30:00-04:00,47.735,48.15,47.300005,47.705,5055000,4322909.9,67.28273446959679,60.93719668154342,NaN,NaN,156.22259055411,172.0240836486496,0.1576620049702886,0.9936101174197915,0.835948112449503,3574800,-2000360,76.74278028634893,61.72007057334601,NaN,NaN,28.418031277196665,25.694438614636937
2003-07-15T09:30:00-04:00,48.15,48.15,47.245005,47.574995,3240400,4329709.9,66.03847581272996,62.07410277431937,NaN,NaN,127.42336341293733,154.53357222903773,0.14353610381792037,1.0153682422219035,0.8718321384039831,334400,-364840,78.34307279071793,62.4953324302565,NaN,NaN,28.987710308548376,26.164905999481427
2003-07-16T09:30:00-04:00,47.83,47.870005,47.050005,47.315,3465200,4319459.9,63.50899213120588,62.85501219358357,NaN,NaN,96.52838128738462,131.36300824809848,0.10261726220349332,1.0001037161583497,0.8974864539548564,-3130800,-931880,76.38076072258819,63.56611142972258,NaN,NaN,28.693803015312675,26.526177001743033
2003-07-17T09:30:00-04:00,46.885,46.94,45.79,45.815,6555200,4539199.9,51.30037834242659,62.35932817101884,NaN,NaN,23.09468491853152,108.69993271214894,-0.03231794985454839,0.8570890166366709,0.8894069664912193,-9686000,-2077560,72.43310823742434,64.34654735708975,NaN,NaN,24.262674183611274,26.20281945629564
2003-07-18T09:30:00-04:00,46.1,46.4,45.769995,46.125,4134000,4554519.9,53.298478625941556,62.19898524476108,NaN,NaN,16.057848805729446,83.86537379573859,-0.10352364406599335,0.7600024114087276,0.8635260554747209,-5552000,-2891920,69.67647559094095,65.08239244727939,NaN,NaN,21.369114854549498,25.51229022747476
2003-07-21T09:30:00-04:00,46.055,46.175005,45.410005,45.725,4103600,4620679.9,50.42366882501018,61.92815408303803,NaN,NaN,-5.872206585827877,51.44641436775102,-0.17612678096975776,0.6433675792625237,0.8194943602322815,-9655600,-5538000,61.487994984340226,65.5868065657839,NaN,NaN,18.081234804040093,24.45071088126981
2003-07-22T09:30:00-04:00,45.86,46.35,45.56,46.26,3774600,4611269.9,53.99765408993921,61.73890570705213,NaN,NaN,6.053746400103794,27.172490965184313,-0.18572888724249137,0.5873332511791673,0.7730621384216587,-5881000,-6781080,58.03731072714856,65.81327690393434,NaN,NaN,16.442932833645127,23.306742588751998
2003-07-23T09:30:00-04:00,46.275,46.574995,45.839995,46.574995,4282600,4650849.9,56.00851289947846,61.155757889188614,NaN,NaN,17.5964351623818,11.386101740183753,-0.16895670119602157,0.5618662619266317,0.7308229631226533,-1598400,-6474600,58.65339830811062,66.05323674679015,NaN,NaN,15.713730933466508,22.22202663799693
2003-07-24T09:30:00-04:00,46.83,47.22,46.335,46.485,3961800,4636429.9,55.26523195238301,60.80302607573101,NaN,NaN,37.1636871021002,14.19990217689747,-0.1619932745571686,0.5283313699261925,0.6903246444833611,-5560200,-5649440,60.341639934618875,66.74193539676558,NaN,NaN,14.908011083538547,21.177167273074303
2003-07-25T09:30:00-04:00,46.475,46.93,46.144995,46.824995,2761000,4459939.9,57.556865848436,60.22326000182939,NaN,NaN,27.68451540268443,16.525235496288467,-0.13373264991313916,0.5231588320919371,0.6568914820050763,-2799200,-5098880,61.47201419748391,67.39303625903683,NaN,NaN,14.885478086242218,20.27835453209829
2003-07-28T09:30:00-04:00,46.82,47.449995,46.79,47.4,3708800,4322419.9,61.178893270695006,59.62161884343861,NaN,NaN,70.40243723315915,31.780164260085876,-0.07830222986279733,0.5590136946765796,0.6373159245393769,909600,-2985840,65.53255891433966,67.7780840695452,NaN,NaN,15.937199884591704,19.658189582454494
2003-07-29T09:30:00-04:00,47.475,47.625,46.800005,47.425005,4928000,4128700,61.333425797114316,58.923130771900034,NaN,NaN,70.60313084330109,44.690041148725335,-0.043669311110589026,0.5827292856511406,0.6263985967617296,5837600,-642120,69.38648893980017,67.96738842942547,NaN,NaN,16.835911489028312,19.255006997679324
2003-07-30T09:30:00-04:00,47.475,47.475,46.92,47.245005,2509400,3973490,59.49739372161574,58.72579745603605,NaN,NaN,57.94294803194867,52.75934372263871,-0.036870787064201105,0.5803101129314783,0.6171808999956794,3328200,343200,70.8615742019937,68.05185060762912,NaN,NaN,17.09660559197549,18.946663939721635
2003-07-31T09:30:00-04:00,47.5,47.870005,47.235,47.339995,5325200,4030900,60.174925552275056,58.34754509563197,NaN,NaN,81.36640641512972,61.599887585244616,-0.030241456886987983,0.5793790788869444,0.6096205357739324,8653400,3185920,74.65580658806329,68.14321317313708,NaN,NaN,17.495622648090826,18.739372326631518
2003-08-01T09:30:00-04:00,47.375,47.476995,46.525,46.675005,4639000,4172050,53.435835669108826,57.35848089559711,NaN,NaN,3.6777964320803838,56.798543791123805,-0.07249691634217259,0.5189993903462167,0.5914963066883893,4014400,4548640,76.2521949213538,68.10817136135172,NaN,NaN,15.978353746120685,18.344941100844256
2003-08-04T09:30:00-04:00,46.57,46.752,45.835,46.205,7828000,4380460,49.23859932909012,56.158489718194275,NaN,NaN,-81.66714540809001,26.38462726287397,-0.13056859155825973,0.42828556724056455,0.5588541587988243,-3813600,3604000,72.82766592905898,67.71421372837608,NaN,NaN,13.438531146444166,17.644025393072816
2003-08-05T09:30:00-04:00,46.22,46.324995,45.405,45.405,6021600,4499020,43.04147565219248,54.6965242554076,NaN,NaN,-132.4912671540604,-14.234252336598328,-0.21627126896858706,0.2885150725880905,0.5047863415566776,-9835200,469440,62.75605236908179,66.7410202745542,NaN,NaN,9.223429158999354,16.441083073919465
2003-08-06T09:30:00-04:00,45.485,45.730005,45.074995,45.199995,4478600,4345570,41.596693290218994,54.00340389453563,NaN,NaN,-153.54733388046324,-56.53230871908071,-0.2763357304336269,0.15936667851464392,0.43570240894827084,-14313800,-3058960,53.74586843639143,65.40621743162328,NaN,NaN,5.315303514768534,14.85168599404076
2003-08-07T09:30:00-04:00,45.254995,45.35,44.815,45.35,5006600,4412800,43.101707084720836,53.27506307016273,NaN,NaN,-145.64297210426432,-101.93418442295952,-0.29389624265859665,0.06833210562502501,0.36222834828362166,-9307200,-6651080,46.43627646978439,63.746203208683525,NaN,NaN,2.5048742971554665,13.087855751628576
2003-08-08T09:30:00-04:00,45.43,45.475,45.07,45.25,4139800,4495920,42.31879095037971,52.69614322197484,NaN,NaN,-119.37132115881494,-126.54400794113857,-0.29918043792663923,-0.011747199124677365,0.28743323880196187,-13447000,-10143360,40.64822319101171,62.25764808058863,NaN,NaN,-0.049399576260142665,11.211104990501616
2003-08-11T09:30:00-04:00,45.22,45.875,45.22,45.875,4535400,4469940,48.60264697529259,52.31078557092865,NaN,NaN,-75.17538263396682,-125.24565538631393,-0.2495433703063743,-0.02449597408100601,0.2250473962253683,-8911600,-11162960,39.115276712154,60.906074222374734,NaN,NaN,-0.5541306087854369,9.530357047746323
2003-08-12T09:30:00-04:00,45.845,46.644995,45.757005,46.644995,5286600,4572250,55.0933938935272,52.245419927646424,NaN,NaN,-0.10369625710108495,-98.76814120692208,-0.1582627742318019,0.027218928435615908,0.1854817026674178,-3625000,-9920920,41.98547943666853,59.715508588700295,NaN,NaN,0.997552016565021,8.311384900434708
2003-08-13T09:30:00-04:00,46.65,46.800005,46.4,46.800005,7627000,4780340,56.29010730296103,52.318625309830566,NaN,NaN,42.019998123478175,-59.6546748061338,-0.08455209407871464,0.0797915850690245,0.16434367914773915,4002000,-6257760,49.54074991512386,58.944016444450654,NaN,NaN,2.625174842506546,7.499069177873542
2003-08-14T09:30:00-04:00,46.714995,47.14,46.515,47.105005,2902600,4597710,58.62640402298268,52.39502089372676,NaN,NaN,65.14106233246812,-17.497867918787307,-0.01595320977257131,0.144402166932025,0.16035537670459632,6904600,-3015400,55.11292373732112,58.48979569729617,NaN,NaN,4.696910215345391,7.098760754655235
2003-08-15T09:30:00-04:00,47.025,47.335,47.019995,47.120005,1488000,4465410,58.74319785940712,52.22104265006334,NaN,NaN,82.37317520316284,22.85103135360824,0.027374871143988677,0.19457396563458218,0.1671990944905935,8392600,1352520,61.31115473133327,58.18826682708143,NaN,NaN,6.418506183014629,7.001581530135148
2003-08-18T09:30:00-04:00,47.33,48.155,47.160005,48.055,3762000,4448330,65.31571991967726,52.50549223024641,NaN,NaN,134.15233159432378,64.71657419926636,0.11124191123009672,0.3062514835282144,0.1950095722981177,12154600,5565760,66.1645396394236,57.958127591340244,NaN,NaN,10.096240278512408,7.443675637046185
2003-08-19T09:30:00-04:00,48.275,48.955,48.050005,48.955,5248200,4522010,70.23168361910905,53.272227222924506,NaN,NaN,192.79631864248495,103.29657717918357,0.21363469476558047,0.4620529407550933,0.24841824598951281,17402800,9771320,70.1850841432253,57.909806872856784,NaN,NaN,15.06721413727598,8.532752565650442
2003-08-20T09:30:00-04:00,48.504995,48.99,48.375,48.93,4613200,4538540,69.9351637760345,53.96938709605018,NaN,NaN,171.3652749853817,129.16563255156427,0.26275320076829833,0.5768597469498857,0.3141065461815874,12789600,11528840,71.6985829765966,57.69857661489487,NaN,NaN,18.88405895763203,10.011510621647812
2003-08-21T09:30:00-04:00,49.199995,49.4,49.050005,49.33,4576200,4569260,71.974018050358,55.293542980425116,NaN,NaN,177.87082396936125,151.71158487894292,0.302429187887046,0.6921430310403949,0.3897138431533489,17365800,13621080,73.42788382058964,57.49684010769743,NaN,NaN,22.753073550276195,11.831733897166153
2003-08-22T09:30:00-04:00,49.894995,49.894995,48.445,48.46,7130400,4787730,62.108452300403755,56.21281819266181,NaN,NaN,132.11614538631588,161.6601789155735,0.2523691759523185,0.705175313093747,0.45280613714142853,10235400,13989640,73.73236796233482,57.561461681502855,NaN,NaN,23.046821557475088,13.433889277210286
2003-08-25T09:30:00-04:00,48.370005,48.545,47.96,48.415,4681600,4836370,61.63783104345161,57.54112929203745,NaN,NaN,81.03725762170662,151.03716412105007,0.20076297908048646,0.7037598609920366,0.5029968819115501,5553800,12669480,70.61121347917262,58.12254461793791,NaN,NaN,23.13490838890976,14.81974915031021
2003-08-26T09:30:00-04:00,48.160005,48.625,47.555,48.6,5046000,4842270,62.88302583375053,59.061581616575424,NaN,NaN,71.47346098542404,126.77259258963791,0.16511342879842872,0.709388667909586,0.5442752391111573,10599800,11308880,67.44252541780455,59.100877259467424,NaN,NaN,23.573580665939318,16.070296509685797
2003-08-27T09:30:00-04:00,48.595,49.1,48.495005,49.074995,2389000,4836250,65.9399290094922,60.692883182630524,NaN,NaN,97.38626024456936,111.97678964147542,0.15946448031666105,0.7436058395069836,0.5841413591903225,12988800,11348720,67.4885315734592,60.60460976687277,NaN,NaN,24.869739407259605,17.327359780767768
2003-08-28T09:30:00-04:00,49.15,49.495005,48.644995,49.4,4292200,4784600,67.88866568299326,62.51930280638864,NaN,NaN,101.01895248796147,96.60641534519547,0.16297999184594414,0.7878663489977527,0.6248863571518085,17281000,11331760,67.44483924802918,62.51865377094544,NaN,NaN,26.546166311084125,18.644332142241534
2003-08-29T09:30:00-04:00,49.445,49.925005,49.335,49.605005,3550000,4730150,69.09000486151076,63.98268551254707,NaN,NaN,108.66991254041929,91.91716877601615,0.16402573641457263,0.8299185276700243,0.6658927912554516,20831000,13450880,70.05359964594251,64.72853398050175,NaN,NaN,28.293924326790616,20.02284531146283
2003-09-02T09:30:00-04:00,49.875,50.75,49.550005,50.75,6344600,4655980,74.76786945908364,65.38800519580111,NaN,NaN,127.8527545836678,101.2802681684084,0.22308277722099212,0.9447462627816918,0.7216634855606997,27175600,17775240,74.53759141108235,67.05368483581704,NaN,NaN,31.82676460050848,21.70911949561221
2003-09-03T09:30:00-04:00,50.89,51.175005,50.74,50.964995,5528200,4631310,75.67154008402512,66.7723932515914,NaN,NaN,141.279697332338,115.2415154377912,0.255545428852762,1.0410952716266522,0.7855498427738902,32703800,22196040,78.14100477308762,69.09656018281444,NaN,NaN,34.96612986787011,23.60297812022048
2003-09-04T09:30:00-04:00,51.074995,51.275,50.78,51.175005,4888200,4651790,76.55483520277481,68.05299547871941,NaN,NaN,135.74151542282604,122.91256647344252,0.2687369159502617,1.1214709877117173,0.8527340717614555,37592000,27116680,81.31129623029163,70.9678725037409,NaN,NaN,37.807556867622374,25.632203655563607
2003-09-05T09:30:00-04:00,50.9,51.49,50.625,50.85,6292200,4716070,72.18682252981151,69.01325438374829,NaN,NaN,123.39234908031578,127.38724579191339,0.23440217771188665,1.1457367939013139,0.9113346161894272,31299800,29920440,82.8386006838807,72.50554721463716,NaN,NaN,38.8950863189384,27.526901178902865
2003-09-08T09:30:00-04:00,51.074995,51.699995,50.985,51.555,4607400,4739450,75.45800576319718,69.73770337257115,NaN,NaN,135.25014855956996,132.70329299574354,0.23727706872570686,1.2079309520965609,0.970653883370854,35907200,32935680,84.32245176427033,73.8025409378405,NaN,NaN,40.88613564510401,29.43536324550303
2003-09-09T09:30:00-04:00,51.525,51.620005,51.055,51.175005,4377400,4731550,70.63572886715218,69.76656374743138,NaN,NaN,117.12323446736761,130.5573889724835,0.19354087935733189,1.2125799825675188,1.0190391032101869,31529800,33806520,84.73302605530749,74.84167964584637,NaN,NaN,41.0517230598302,31.09484321897834
2003-09-10T09:30:00-04:00,50.955,50.955,50.115,50.165,7439600,4839200,59.71268356064871,69.03638658918953,NaN,NaN,63.96629343378948,115.09470819277378,0.08223560593428614,1.1218336106280447,1.0395980046937585,24090200,32083800,80.25538966336659,75.4528801234728,NaN,NaN,37.513988520496156,32.01186397633803
2003-09-11T09:30:00-04:00,50.19,50.775,50.095,50.6,5449200,4730310,62.40890001573941,68.35316387243105,NaN,NaN,60.210613461410524,99.98852780049067,0.02644355773690532,1.07265245186489,1.0462088941279848,29539400,30473280,76.20128893862898,75.65098048904703,NaN,NaN,35.48806657656265,32.508464347798686
2003-09-12T09:30:00-04:00,50.355005,50.9,49.9,50.705,5092000,4839780,63.05168508033724,68.42053764242631,NaN,NaN,54.002996295614956,86.11065724355052,-0.012749264277316819,1.0302723137813388,1.0430215780586556,34631400,31139600,76.72514116327399,75.86475000339983,NaN,NaN,34.08128291092798,32.73315271396002
2003-09-15T09:30:00-04:00,50.81,51.15,50.525,50.58,6256800,5078220,61.699098851775084,68.42491391444942,NaN,NaN,62.06371653677119,71.47337083899076,-0.05413246493320045,0.975355996892155,1.0294884618253555,28374600,29633080,72.82216688011388,76.02267524632421,NaN,NaN,32.53632676096645,32.70503472067522
2003-09-16T09:30:00-04:00,50.725,51.449995,50.71,51.335,4066000,5093420,66.38907231143688,68.67534580571272,NaN,NaN,81.78168366370078,64.40506067825739,-0.038436253729113856,0.9814431446639631,1.019879398393077,32440600,29815240,73.00100839372352,76.41970974460413,NaN,NaN,32.604946821637846,32.69073644938417
2003-09-17T09:30:00-04:00,51.285005,51.550005,51.089995,51.32,3757800,5018900,66.21559181803778,68.69503600632312,NaN,NaN,85.37420355667322,68.68664270283413,-0.036838591453736136,0.9738311590759068,1.010669750529643,28682800,30733760,73.93248804829011,76.8799923499492,NaN,NaN,32.60853650998935,32.6789936008992
2003-09-18T09:30:00-04:00,51.375,51.870005,51,51.855005,2872400,4931860,69.29723790924889,68.79564830819852,NaN,NaN,96.89167494456247,76.02285499946451,-0.008977381819442298,0.99944802325534,1.0084254050747823,31555200,31136920,74.35077430106841,77.37327342516629,NaN,NaN,33.53840110566006,32.80176610157932
2003-09-19T09:30:00-04:00,51.949995,51.949995,51.545,51.800005,2665200,4836310,68.60443742130519,68.76096491961242,NaN,NaN,103.98865711603624,86.01998716354878,-0.0037474996291797513,1.0037410305383077,1.0074885301674874,28890000,29988640,70.86299832678291,77.43108761665489,NaN,NaN,34.09489327361534,32.98649855472732
2003-09-22T09:30:00-04:00,51.1,51.449995,50.870005,51.089995,4317400,4695660,60.232776958787014,67.72274402673409,NaN,NaN,53.44795985557764,84.29683582731006,-0.054769320773051966,0.9390268792011724,0.9937961999742244,24572600,29228240,68.56911859593208,77.00476812985845,NaN,NaN,32.056936795292,32.85370401766513
2003-09-23T09:30:00-04:00,51.15,51.785005,51.15,51.785005,4706000,4696880,64.7653113502812,66.94372768860953,NaN,NaN,84.69982918717469,84.88046493200486,-0.04858404723843035,0.9330661409261864,0.9816501881646168,29278600,28595840,66.63714175113665,76.18306362829051,NaN,NaN,31.674911049321796,32.685305022187514
2003-09-24T09:30:00-04:00,51.9,51.925005,50.504995,50.504995,5422200,4715690,52.823952955065494,65.248664670916,NaN,NaN,23.064242294706347,72.41847267961148,-0.13279714682623933,0.8156537546318177,0.948450901458057,23856400,27630560,63.68747137693386,74.92421899590782,NaN,NaN,27.11786112153091,31.889955893522284
2003-09-25T09:30:00-04:00,50.665,50.85,49.14,49.14,7514800,4971980,43.593282813981475,63.206268976928136,NaN,NaN,-134.03647391052436,26.2328429085941,-0.2743764781435666,0.6054803037785987,0.8798567819221653,16341600,24587840,55.36777359705498,72.96201706113456,NaN,NaN,19.546868864428184,30.12665774650884
2003-09-26T09:30:00-04:00,49.21,49.305,48.24,48.300005,10653602,5290050.1,39.06885800750812,60.60704413723606,NaN,NaN,-248.36372947405076,-44.23763440942329,-0.41036039664533697,0.36690628611549414,0.7772666827608311,5687998,19947439.6,45.587009253115255,70.1951997389092,NaN,NaN,11.708298295325678,27.49546353919696
2003-09-29T09:30:00-04:00,48.625,49.165,47.879995,49.165,13243796,5774739.9,45.358007353272235,58.80149260053035,NaN,NaN,-209.81773933772396,-96.89077424808362,-0.4259649441010305,0.24481050263454307,0.6707754467355735,18931794,18819278.4,43.5717934590652,67.25511169632047,NaN,NaN,7.701203868346113,24.66771215764684
2003-09-30T09:30:00-04:00,48.94,49.15,48.074995,48.525,14310398,6173029.8,41.91107727134586,57.52994929415157,NaN,NaN,-183.5188235203478,-150.5345047895881,-0.46037442244390103,0.09530741868069725,0.5556818411245983,4621396,13887837.6,36.06644097331251,64.09875821845945,NaN,NaN,3.2724011355345826,21.611239154487947
2003-10-01T09:30:00-04:00,48.685,49.97,48.65,49.835,10303000,6411769.8,50.24568662970917,56.66114833800656,NaN,NaN,-90.0626039374491,-173.1598740360192,-0.3792729345637348,0.08159067291992983,0.4608636074836646,14924396,12101436.8,33.79545859043671,61.06977033644573,NaN,NaN,2.646850311900124,18.902040748403973
2003-10-02T09:30:00-04:00,49.85,50.375,49.754995,50.315,7725200,6553619.8,52.91168396799717,55.93686254426798,NaN,NaN,-31.53327716470848,-152.65923468685602,-0.28212710611456204,0.10820472484046206,0.3903318309550241,22649596,13363036,36.82104857749902,58.21947800889037,NaN,NaN,3.1230278767494517,16.647896052453326
2003-10-03T09:30:00-04:00,50.83,51.35,50.75,51.11,8542204,6666120,57.01950023163029,55.60260549997192,NaN,NaN,43.76551023882585,-94.23338674428071,-0.15927195183458914,0.1912418911617877,0.35051384299637683,31191800,18463796.4,47.306306858901685,56.39691657880379,NaN,NaN,4.975136341939897,14.980358950951409
2003-10-06T09:30:00-04:00,51.1,51.6,50.894995,51.550005,2976800,6584590,59.143870609921315,55.085091092720816,NaN,NaN,67.07010183035564,-38.855818510664804,-0.049034898963468854,0.2892202192920408,0.33825511825550963,34168600,21511157.6,52.38999223595422,54.92470113896312,NaN,NaN,7.166927730248461,13.864154490850988
2003-10-07T09:30:00-04:00,51.32,51.955,51.1,51.839995,8096800,6770560,60.52855838551715,54.67887441896935,NaN,NaN,87.2427244140947,15.296491076223706,0.03805271754409956,0.38582101518563405,0.3477682976415345,42265400,29039958.4,62.11471344141358,54.080574381329086,NaN,NaN,9.357097792716937,13.220289248260409
2003-10-08T09:30:00-04:00,51.93,52.1,51.22,51.435,5081400,6652650,57.592839594942596,53.84284596794747,NaN,NaN,75.71527793447105,48.45206745060774,0.06162639012643634,0.42480128529957994,0.3631748951731436,37184000,33491879.2,66.47534622071322,53.51804380416086,NaN,NaN,10.232755363575249,12.793498693305386
2003-10-09T09:30:00-04:00,52.01,52.595,51.449995,51.975,10419000,6901140,60.35394438713127,53.253525036935045,NaN,NaN,97.83816242840122,74.32635536922967,0.10432189646613343,0.4935772657558104,0.38925536928967697,47603000,38482560,70.5654422188644,53.49678979645239,NaN,NaN,11.827909924306208,12.655557440591219
2003-10-10T09:30:00-04:00,51.925005,52.08,51.26,51.910005,9808000,7136940,59.8488524959483,53.226101861017995,NaN,NaN,72.68227257677755,80.10970783682002,0.11791729053459327,0.5366519824579186,0.4187346919233253,37795000,39803200,71.55443495525864,53.71002667926143,NaN,NaN,12.958843662304009,12.698884043693045
2003-10-13T09:30:00-04:00,52.06,52.845,51.949995,52.725,5230400,7085620,63.92568197993209,53.16612833456448,NaN,NaN,114.58678372413901,89.61304421557669,0.16845075359747252,0.629298133920166,0.46084738032269346,43025400,41574560,72.87109865518784,54.155309315265086,NaN,NaN,15.202201982455673,13.056500892087707
2003-10-14T09:30:00-04:00,52.675005,53.125,52.44,53.07,7338800,7249260,65.52163492819074,54.073105618359136,NaN,NaN,127.45160031585156,97.65481939592806,0.20910931881287254,0.7222340288387841,0.5131247100259115,50364200,43194320,74.05376741202716,54.89575903205747,NaN,NaN,17.546251910435203,13.697893894708777
2003-10-15T09:30:00-04:00,53.33,53.4,52.385,52.405,8170200,7469880,60.010553593849124,55.24576781692111,NaN,NaN,108.59292474188112,104.23034875741007,0.17651465730047688,0.7337680316515076,0.5572533743510307,42194000,44196320,74.78604153258698,56.282778170309754,NaN,NaN,17.927252354707733,14.302087960422913
2003-10-16T09:30:00-04:00,52.405,52.964995,52.375,52.875,4426400,7547580,62.41662633433168,56.913465554551365,NaN,NaN,101.60715866414012,104.98414800455785,0.17174569426634645,0.7719354921839638,0.6001897979176174,46620400,43999800,74.34287957181341,58.33676890735962,NaN,NaN,18.9693136304743,14.968834484715968
2003-10-17T09:30:00-04:00,52.85,52.955,51.845,51.85,8651796,7846909.8,54.68856469995476,57.579933936457266,NaN,NaN,67.89887039304767,104.02746756781187,0.08886848630240052,0.7112754057956181,0.6224069194932176,37968604,44034520.8,74.37177493179172,60.53676758398295,NaN,NaN,17.47085872724092,15.32626651936239
2003-10-20T09:30:00-04:00,51.97,52.275,51.754995,52.11,5974400,7929759.8,56.170967861066366,58.59849755000873,NaN,NaN,53.393936513823164,91.78889812574872,0.0431822525633363,0.676384735197388,0.6332024826340517,43943004,44218041.6,74.53502138949406,63.28452332799592,NaN,NaN,16.698489414361195,15.522298361505076
2003-10-21T09:30:00-04:00,51.99,52.574995,51.99,52.345,8582602,8123589.9,57.5236172370129,59.11834973624472,NaN,NaN,64.41743873594942,79.18206580976828,0.02150768614115106,0.6600870903104905,0.6385794041693394,52525606,44650322.8,74.93994490291496,66.22341520745864,NaN,NaN,16.457775195331486,15.655937909194563
2003-10-22T09:30:00-04:00,51.833,51.945,51.144995,51.199995,7309400,8217949.9,49.50663425249632,58.87513189942323,NaN,NaN,14.249107045125989,60.31330227041725,-0.0720983313267124,0.548456490010949,0.6205548213376614,45216206,45254764,75.52595859755104,68.98805163746236,NaN,NaN,13.713323491560264,15.378421563818234
2003-10-23T09:30:00-04:00,50.824995,51.251,50.435,50.75,9797204,8332070.1,46.74908740179492,58.14153098300642,NaN,NaN,-25.019286667426666,34.9880132041039,-0.1613643654429482,0.41884936453397614,0.5802137299769243,35419002,43014484.4,69.07832444524122,70.54319575077234,NaN,NaN,10.575953999735962,14.692354768949338
2003-10-24T09:30:00-04:00,50.425005,50.915,50.14,50.625,8896398,8244209.9,45.982886365357906,57.20146067982331,NaN,NaN,-51.724405368821955,11.06335805172999,-0.2221225053784156,0.3025605982539048,0.5246831036323204,26522604,40725284.4,63.14610878901605,71.31148979027674,NaN,NaN,7.8113857243251354,13.70935919114588
2003-10-27T09:30:00-05:00,50.800005,51.555,50.775,51.365,7502400,7957140.1,51.093175290116235,56.527504744437536,NaN,NaN,-17.55471846641754,-3.1263729443181503,-0.2061188661147756,0.26703452098885094,0.47315338710362653,34025004,38741684.4,58.461232285132894,71.05052685054241,NaN,NaN,6.91943111758054,12.739369466350832
2003-10-28T09:30:00-05:00,51.655,52.6,51.53,52.6,6610600,7572150.2,58.20048505296111,56.57090799143885,NaN,NaN,57.348444066681395,-4.540171878171753,-0.11078183780771067,0.3346760898439882,0.4454579276516989,40635604,36363684,53.351043129849,70.11307662976641,NaN,NaN,8.417246943785278,12.12192339169861
2003-10-29T09:30:00-05:00,52.385,53.125,52.29,52.949995,9492398,7531620.1,59.97565358869271,56.54388722012182,NaN,NaN,102.09092753178133,13.028192219159314,-0.026944360101922027,0.4117774775242964,0.4387218376262184,50128002,37346043.2,55.097208721161905,69.00820280850193,NaN,NaN,10.195526348710187,11.846723814128836
2003-10-30T09:30:00-05:00,53.5,53.625,52.815,53.1,8193398,7555030,60.745121590515154,56.60790644116231,NaN,NaN,132.8736419254321,44.60677793773107,0.03258904001415874,0.47945813764391687,0.4468690976297581,58321400,41926522.8,62.2018114214378,68.34015827037187,NaN,NaN,11.861617794373416,11.848851525592348
2003-10-31T09:30:00-05:00,53.135,53.28,52.028505,52.75,4893400,7372589.8,57.94590773731992,56.180779709547146,NaN,NaN,73.14003687889243,69.57966638727393,0.04178484792544729,0.4991001575365672,0.45731530961111994,53428000,47307602,68.50609917111376,68.028372592938,NaN,NaN,12.441857479668275,11.933566661888909
2003-11-03T09:30:00-05:00,53.095,53.751,53.094,53.644995,5433422,7495420.9,62.681614161608934,55.97792108336274,NaN,NaN,145.38703388478672,102.1680168575148,0.09830540504196839,0.5801970659135804,0.48189166087161206,58861422,52274885.6,72.98529035480104,67.95205280313613,NaN,NaN,14.417497638373195,12.288413944243807
2003-11-04T09:30:00-05:00,53.6,53.995005,53.46,53.72,5420946,7361628.2,63.05707280134043,56.19552959818355,NaN,NaN,149.97888600215907,120.69410524461031,0.1289713930706673,0.6431059022099461,0.5141345091392788,64282368,57004238.4,76.42341407109369,68.06900798445804,NaN,NaN,16.12160759040362,12.836013036552352
2003-11-05T09:30:00-05:00,53.675005,53.985,53.032,53.985,8291000,7522108.2,64.41913244914912,56.33856574924194,NaN,NaN,127.32458055193771,125.74083584864161,0.15365576145975113,0.7062042109639677,0.5525484495042166,72573368,61493311.6,79.13751996405855,68.41148229818984,NaN,NaN,17.94126680403384,13.565335003335422
2003-11-06T09:30:00-05:00,54.019995,54.410005,53.525,54.410005,6670600,7334688.2,66.54924981700938,57.185757543317266,NaN,NaN,147.45650042814285,128.65740754918374,0.18315790389942088,0.7814958293784926,0.5983379254790717,79243968,65677825.2,81.29869866965277,68.90626256517992,NaN,NaN,20.1195218233552,14.50164740619539
2003-11-07T09:30:00-05:00,54.629995,54.695,53.995005,53.995005,5796400,7134108.2,62.607815515180064,57.64553237575395,NaN,NaN,139.8339337685741,141.99618692712008,0.1601085721143649,0.7984736406220279,0.638365068507663,73447568,69681738.8,83.1024358088702,69.5182207379925,NaN,NaN,20.878227555983546,15.412587427593698
2003-11-10T09:30:00-05:00,54.135,54.26,53.11,53.125,4527000,7098938.2,55.22375276117243,57.48125634176535,NaN,NaN,70.81204737522415,127.08118962520757,0.07592700248804152,0.7332738216177148,0.6573468191296733,68920568,71693568,83.94058665768718,70.16112372047623,NaN,NaN,19.344777804183238,15.974328909963631
2003-11-11T09:30:00-05:00,53.155,53.245005,52.5,52.76,6615800,7062788.2,52.42991134729347,57.69006184853658,NaN,NaN,17.006411339278728,100.48669469263152,-0.010102946186568151,0.6447181363964631,0.6548210825830313,62304768,71298048,83.06822803956445,70.69985725204862,NaN,NaN,17.223600695414234,16.152796307885147
2003-11-12T09:30:00-05:00,52.839995,53.980005,52.839995,53.980005,8923602,7100458.3,59.75825845631136,58.61928835243061,NaN,NaN,72.78545761204767,89.57887010465349,0.008392751924983233,0.6653120224892604,0.6569192705642771,71228370,71029048.4,82.44070077589262,71.654312704238,NaN,NaN,17.603998689971867,16.360110933897534
2003-11-13T09:30:00-05:00,53.786005,54.25,53.625,54.125,7083000,7233288.3,60.536375872428266,59.658823317221355,NaN,NaN,93.12473932963131,78.7125178849512,0.02280976982616767,0.6854314828469867,0.6626217130208191,78311370,70842528.8,81.97826238019634,72.99946653217945,NaN,NaN,18.14631761849181,16.615283317411002
2003-11-14T09:30:00-05:00,54.115,54.47,53,53.1,6241800,7112788.5,52.76855670518377,59.77849341829761,NaN,NaN,53.18580553522133,61.38289223828063,-0.040803749570437864,0.6116170260577718,0.6524207756282097,72069570,70566929.2,81.25300785249831,74.62745050127697,NaN,NaN,16.125426363539262,16.54530375257218
2003-11-17T09:30:00-05:00,52.716005,52.75,51.945,52.455,9323398,7280238.4,48.54706266973786,59.08896324806737,NaN,NaN,-32.36120348064156,40.7482420671075,-0.12564685998971314,0.4953622006410683,0.6210090606307814,62746172,69332050,77.92636091004138,76.3828303427193,NaN,NaN,13.054893014386195,16.04667364711704
2003-11-18T09:30:00-05:00,52.775,53.095,51.85,51.879995,11543398,7428278.2,45.084372874148556,58.025300339885646,NaN,NaN,-40.29944713845009,29.287070371561743,-0.2145953587431324,0.352764862201866,0.5673602209449984,51202774,67111651.2,72.20223598082688,77.60461800412394,NaN,NaN,9.373388902608463,15.093347255044385
2003-11-19T09:30:00-05:00,52.047995,52.65,51.785005,52.425005,7253200,7425468.2,48.81123089938549,57.17287957623353,NaN,NaN,-44.89239942806602,5.751498963539002,-0.2294883611132208,0.28049976955347233,0.5099881306666931,58455974,64557172,66.17936736394495,77.88872914287444,NaN,NaN,7.475086552351451,14.005024297516822
2003-11-20T09:30:00-05:00,52.001,52.870005,51.89,52.07,6618600,7266538,46.59311941277195,56.3619661244801,NaN,NaN,-56.31821098590294,-24.137091099567847,-0.25409790155501477,0.19236575372292464,0.4464636552779394,51837374,59262372.8,55.790971845352615,76.98050576246293,NaN,NaN,5.229248194004707,12.751341997015093
2003-11-21T09:30:00-05:00,52.425005,52.65,52.15,52.644995,7275200,7185478.1,50.515477812065555,55.492956385227,NaN,NaN,-53.58731735152768,-45.49171567691765,-0.22357793917744384,0.16699123130613458,0.3905691704835784,59112574,56670973.6,51.52776250630723,75.44782520185622,NaN,NaN,4.530010795194419,11.576866111040712
2003-11-24T09:30:00-05:00,53.025,53.945,52.9,53.85,7889600,7204838.1,57.551425980860515,55.09969589804986,NaN,NaN,46.69263880902651,-29.680947218984034,-0.11938843359800294,0.24133362848607476,0.3607220620840777,67002174,57522174,52.80350968998576,73.76068917463422,NaN,NaN,6.2242838950823645,10.812211508760948
2003-11-25T09:30:00-05:00,53.894995,54.42,53.754995,54.175005,7972400,7272928.1,59.234978998535745,54.72939922300605,NaN,NaN,98.87582533144524,-1.8458927250049668,-0.03037350537290301,0.3227551803679489,0.35312868574085193,74974574,62276534,59.25411197391385,72.34044574676675,NaN,NaN,8.129273193594363,10.428934606594293
2003-11-26T09:30:00-05:00,54.550005,54.745005,53.775,54.464995,5508200,7073718.2,60.73150946438516,54.31384634067575,NaN,NaN,110.8661577538133,29.305818711370897,0.04229863398325945,0.40600197821992623,0.3637033442366668,80482774,66681894,64.14427258765662,71.11512959805275,NaN,NaN,10.145032563718475,10.388377171897748
2003-11-28T09:30:00-05:00,54.333,54.730005,54.32,54.725,1156400,6721868.3,62.075813573067805,54.27584620195345,NaN,NaN,124.56082145564402,65.4816251996803,0.09890785646618527,0.4873381648193984,0.3884303083532131,81639174,72642254,69.48110862489128,70.14217765633997,NaN,NaN,12.207297780967735,10.64822297319346
2003-12-01T09:30:00-05:00,54.935,55.43,54.875,55.43,5149400,6734668.3,65.52235146308954,55.01146039494753,NaN,NaN,176.06196690092224,111.41148205017028,0.17065471515716812,0.6017487022996733,0.43109398714250513,86788574,78177454,73.43544315793122,69.39181026350026,NaN,NaN,15.063749931632506,11.279012538684754
2003-12-02T09:30:00-05:00,55.425005,55.71,55.175005,55.345,4948800,6710437.2,64.75820591888717,55.892052864347086,NaN,NaN,163.4555376143481,134.7640618112346,0.19732355103827653,0.6777484259403508,0.48042487490207425,81839774,81144974,75.28437646451776,68.83582086528263,NaN,NaN,17.161927577641112,12.119428972821376
2003-12-03T09:30:00-05:00,55.542,55.680495,54.324995,54.35,4838000,6681289.9,56.457798867244655,55.65630575084232,NaN,NaN,95.12345808898434,134.0135883627424,0.13581651672218653,0.6501955208048074,0.5143790040826208,77001774,81550414,75.53491984651015,68.34255079889817,NaN,NaN,16.535930246495422,12.750357726203383
2003-12-04T09:30:00-05:00,54.404,54.504995,53.555,54.475,7718800,6652679.9,57.199997235089505,55.41799299103241,NaN,NaN,40.32373012703286,119.90510283738631,0.09343308575269549,0.6311703612734902,0.5377372755207948,84720574,82397974,76.08078679164053,67.92130254257276,NaN,NaN,16.244238770709707,13.249483589704287
2003-12-05T09:30:00-05:00,54.155,54.25,53.574995,53.800005,6813800,6659839.9,52.04137631320747,55.36605153446267,NaN,NaN,16.7004258515202,98.33302371656156,0.013991003493989296,0.5552260298882814,0.5412350263942921,77906774,81651494,74.50407403085345,67.4392358410267,NaN,NaN,14.437547222282188,13.419206965786843
2003-12-08T09:30:00-05:00,53.699995,54.275,53.475,54.199995,6082200,6674129.9,54.65134490147232,55.80207169387228,NaN,NaN,27.14268849480452,68.54916803533801,-0.015943095211607305,0.521306157379783,0.5372492525913903,83988974,81091574,73.27736956641778,67.10716503076786,NaN,NaN,13.682596277787983,13.456834010358435
2003-12-09T09:30:00-05:00,54.425005,54.475,53.199995,53.285005,7100600,6802809.9,48.19059729163741,56.02394486655005,NaN,NaN,-1.3937385495528214,35.579312802557844,-0.09715996806525862,0.41579929250981706,0.5129592605750757,76888374,80101294,71.04926173656489,67.0248097276063,NaN,NaN,10.988493750646004,13.104213973256659
2003-12-10T09:30:00-05:00,53.5,53.5,52.445,52.805,9320398,6938039.8,45.17356222790574,55.76411139001579,NaN,NaN,-64.90913107456018,3.5727949698489256,-0.17828119384658053,0.29010776826685003,0.46838896211343056,67567976,78214534.4,66.87686602335157,67.07463106042105,NaN,NaN,7.7904713027551695,12.345107877470731
2003-12-11T09:30:00-05:00,52.9,54.305,52.823,54.28,8991000,6941409.7,54.58306748469942,56.33482196658205,NaN,NaN,10.16037118484178,-2.4598768185892963,-0.1299197704388183,0.30598924906490765,0.43590901950372596,76558976,76582214.8,63.4075777038165,67.61867433602562,NaN,NaN,7.994407715855662,11.723579282954292
2003-12-12T09:30:00-05:00,54.181,54.480005,53.769995,54.480005,8462602,7010389.8,55.69346395660233,56.70467811976324,NaN,NaN,46.166990811061716,3.433436173319012,-0.08400740558590813,0.3308997625213408,0.4149071681072489,85021578,78005175.6,65.10690262846833,68.58861291617998,NaN,NaN,8.512132353210419,11.264801150133739
2003-12-15T09:30:00-05:00,54.504995,55.449995,53.175005,53.205,7393200,7067959.8,47.688969137539964,56.00021691666892,NaN,NaN,19.099453689367493,1.8247892122316123,-0.1359770876586257,0.2449358085339668,0.3809128961925925,77628378,76733056.4,62.32054986333221,69.26840149999043,NaN,NaN,6.252778570025316,10.548797924403964
2003-12-16T09:30:00-05:00,53.32,53.585,52.625,53.56,8356204,7019600.1,49.85019470751379,55.32987518159592,NaN,NaN,-45.56996051587395,-7.010455181032614,-0.1422399734446529,0.2031129293867764,0.3453529028314293,85984582,78552298,64.65046460288167,69.65385525920242,NaN,NaN,5.152215914051742,9.77785763721079
2003-12-17T09:30:00-05:00,53.6,53.655,53.015,53.550005,6908000,6787830.2,49.787825660589675,54.54818348132482,NaN,NaN,-40.80021370490425,-2.1886717071014288,-0.14249534851759904,0.16723371718443047,0.3097290657020295,79076582,80854019.2,67.39731999507616,69.88621578830382,NaN,NaN,4.269635864872404,8.99096881259102
2003-12-18T09:30:00-05:00,53.585,54.5,53.46,54.375,9741796,6912260,54.813185620065134,54.02942434182462,NaN,NaN,22.785229509799724,0.3362999578901594,-0.08536005824287257,0.2030289928984388,0.28838905114131136,88818378,83305899.6,70.06572687040884,69.92797423441222,NaN,NaN,5.070345094536964,8.430879710011869
2003-12-19T09:30:00-05:00,54.4,54.4625,53.835,54.199995,7819200,6972290,53.58797895951584,53.176969162997935,NaN,NaN,21.093462887994857,-4.678405626723213,-0.05887164807633327,0.2147994910458948,0.27367113912222807,80999178,82501419.6,68.09637466348175,69.5466121990944,NaN,NaN,5.354506014782173,7.991397753550483
2003-12-22T09:30:00-05:00,54.125,54.805,54.03,54.805,4387400,6827900,57.15357461233734,52.63378121253009,NaN,NaN,64.47459313490727,4.396622262384741,-0.0030680785149281853,0.26983604097856784,0.272904119493496,85386578,84053059.6,69.85622524775212,69.15888711218257,NaN,NaN,6.676929172709685,7.803616527716084
2003-12-23T09:30:00-05:00,54.745005,55.245005,54.620005,55.105005,5988400,6732840,58.8421053645473,52.80408881948028,NaN,NaN,114.7374680823736,36.45810798203425,0.04872695500588442,0.33381281325085155,0.2850858582449671,91374978,85131138.8,71.0510731162124,68.83861234573273,NaN,NaN,8.275529576263297,7.871032677508543
2003-12-24T09:30:00-05:00,55.050005,55.18,54.935,55.04,1266600,6397550,58.30592608089094,52.88308373703752,NaN,NaN,106.62152239539036,65.94245520209317,0.07188919049330733,0.3749473463616013,0.303058155868294,90108378,87337498,73.37693176169697,68.6454798435939,NaN,NaN,9.433572245228595,8.094252615754264
2003-12-26T09:30:00-05:00,55.175005,55.375,55.1,55.235,1510000,6197640,59.49818037183493,53.415712598368046,NaN,NaN,113.10994140425522,84.00739758098428,0.09231980189893985,0.4184579082419688,0.326138106343029,91618378,87897498,73.94903080984878,68.60583389923643,NaN,NaN,10.7374163912303,8.47184744082227
2003-12-29T09:30:00-05:00,55.480005,56.125,55.455,56.074995,4843200,6381980,64.2416758609169,54.100736238328345,NaN,NaN,159.6458305289097,111.71787110916723,0.15091893641176873,0.5147867768577399,0.36386784044597115,96461578,90989978,76.90098815273748,68.86466379825926,NaN,NaN,13.317569709082411,9.164093479145148
2003-12-30T09:30:00-05:00,56,56.375,55.905,56.22,5734000,6411210,65.0036455974838,55.301668260174516,NaN,NaN,169.43082174202263,132.7091168305903,0.18567288533888465,0.595958947119577,0.4102860617806923,102195578,94351778,79.60637997021576,69.47588652923433,NaN,NaN,15.673444698339761,10.09400079617295
2003-12-31T09:30:00-05:00,56.324995,56.495005,55.339995,55.4,12727796,6800159.8,57.537033483971,56.18477334989346,NaN,NaN,124.29089000043135,134.61980121420186,0.14165172373213542,0.5873507164458616,0.44569899271372615,89467782,93970338.8,78.48319424740274,70.30490997380942,NaN,NaN,15.61810536006144,10.883158591014162
2004-01-02T09:30:00-05:00,55.583505,56.3145,55.58,55.995005,11182204,7117370,61.03452964110288,56.64559207535085,NaN,NaN,126.60051133255762,138.6155990016353,0.14054297146193762,0.6213777070411481,0.4808347355792105,100649986,96078660.4,80.15026712036308,71.5008163607056,NaN,NaN,16.6183532092387,11.70247210790338
2004-01-05T09:30:00-05:00,56.375,56.775,56.155,56.65,8686602,7165760.1,64.50083708603867,57.274690156024874,NaN,NaN,145.05232089499253,145.00407489978278,0.16989710443004147,0.6932061161167624,0.523309011686721,109336588,99622302.4,82.59163109809397,72.74972553710742,NaN,NaN,18.5514303221746,12.680894709942127
2004-01-06T09:30:00-05:00,56.685,57.065,56.5,56.574995,6196800,7134910.1,63.80091295917903,58.42554328614195,NaN,NaN,135.36808320758678,140.1485254355182,0.16983186709121534,0.7355988455507401,0.5657669784595247,103139788,100957944.4,83.4193889469774,74.25678547165352,NaN,NaN,19.9110262538523,13.713770644786436
2004-01-07T09:30:00-05:00,56.661005,57.275,56.481005,57.175005,5919600,7126780.1,66.89564922976052,59.64307575201672,NaN,NaN,132.77186129805904,132.81673334672547,0.1940213574043499,0.8082936752149621,0.6142723178106122,109059388,102330706.4,84.24839899330235,75.65663792811213,NaN,NaN,22.022547587873117,14.900738779513105
2004-01-08T09:30:00-05:00,57.64,57.865,57.205,57.61,6270800,7085290.1,68.96702950219046,61.01301888355964,NaN,NaN,148.39155527793707,137.63686640222662,0.22117210234923523,0.8907374457471562,0.669565343397921,115330188,107503187.6,86.90513622522383,77.05005337312268,NaN,NaN,24.43925258336656,16.263383608635028
2004-01-09T09:30:00-05:00,57.329,58.004995,57.06,57.15,9598000,7099170.2,64.37948284325863,61.696325828073455,NaN,NaN,124.22302675756309,137.16136948722772,0.1911350314255168,0.908484132679817,0.7173491012543002,105732188,108519628,87.35643196159626,78.28510373677894,NaN,NaN,25.148859575603527,17.532737318201956
2004-01-12T09:30:00-05:00,57.44,58.25,57.25,58.22,5907400,6944990.2,69.46713248558119,62.830551079935276,NaN,NaN,134.84081059800425,135.11906742783003,0.22403372856095372,0.9973912619554923,0.7733575333945386,111639588,108980228,87.5655604316541,79.67575986307695,NaN,NaN,27.418542627671737,18.944995219554784
2004-01-13T09:30:00-05:00,58.153505,58.160005,57.210505,57.975,8131000,6928410.1,67.10376711661758,63.541279115955284,NaN,NaN,114.68623410873954,130.98269760806062,0.210223895676091,1.0361374029896524,0.8259135073135614,103508588,109053988,87.60092874291735,80.94323868416018,NaN,NaN,28.537330091044012,20.315328772624675
2004-01-14T09:30:00-05:00,58.188005,58.39,57.885,58.275,6592000,6888350.1,68.51623322408699,64.23228824877955,NaN,NaN,123.89080588212286,129.20648652487336,0.20216347932705248,1.078617856472377,0.8764543771453245,110100588,109262228,87.70723664788771,82.13296465070843,NaN,NaN,29.887295351042088,21.68275256954145
2004-01-15T09:30:00-05:00,58.375,58.5515,57.64,58.425005,6338000,6787439.9,69.2277101925771,65.01241568532855,NaN,NaN,113.96771320113741,122.32171810951343,0.18809612427499267,1.1115745324890653,0.9234784082140727,116438588,109483908,87.82689003305619,83.16510452723409,NaN,NaN,31.20183237071591,23.042621112566373
2004-01-16T09:30:00-05:00,58.85,59.06,58.56,58.75,6732200,6778649.9,70.76896343440885,65.81747161836955,NaN,NaN,131.99465746099045,123.8760442501989,0.1817399142909557,1.1506533010777673,0.9689133867868116,123170788,112971628,89.55026754815977,84.27947857997059,NaN,NaN,32.76036388940845,24.43087008068667
2004-01-20T09:30:00-05:00,59.050005,59.565,58.655,59.455,7429800,6663050.1,73.83092466502752,66.50241796152031,NaN,NaN,140.23780676117397,124.95544348283283,0.2043869129885063,1.2243970280224445,1.0200101150339382,130600588,116763828,91.03621841138224,85.28913788415949,NaN,NaN,35.067196006043936,25.950345212880567
2004-01-21T09:30:00-05:00,59.425005,59.685,58.75,59.375,8255602,6684870.2,72.89776652861244,67.06628374231522,NaN,NaN,128.73579089045896,127.76535483917671,0.1934626626932432,1.2618384434004923,1.0683757807072491,122344986,120531107.6,92.21983108512407,86.19009867808153,NaN,NaN,36.68751903637609,27.484227187665642
2004-01-22T09:30:00-05:00,59.754995,59.865,58.83,59.04,7190400,6825020.2,68.96682421174998,67.882697365728,NaN,NaN,115.34374417849727,126.0559424984516,0.14535482634914887,1.2500693136436851,1.1047144872945363,115154586,121541907.2,92.50576618503177,87.19171095934074,NaN,NaN,36.96397504194905,28.8384768811347
2004-01-23T09:30:00-05:00,59.095,59.410005,58.69,59.36,8256204,6938410.4,70.59781642639604,68.56578927896324,NaN,NaN,101.21690542111256,123.50578094244663,0.11793220766006729,1.2521297468696204,1.1341975392095531,123410790,122936347.6,92.89377109035544,88.10196124291163,NaN,NaN,37.656497388189955,30.09819409642831
2004-01-26T09:30:00-05:00,59.35,60.03,58.955,59.949995,4996200,7124890.4,73.37612204092535,69.19973820431228,NaN,NaN,118.5846633788065,120.82378212600983,0.12187388042926184,1.2865398897461304,1.1646660093168686,128406990,123983588,93.17937570463721,88.85822871480757,NaN,NaN,39.078672258114665,31.38111954809779
2004-01-27T09:30:00-05:00,59.910005,59.949995,59.144995,59.199995,6648800,7381830.4,64.97145282521615,69.2833481947435,NaN,NaN,98.07845743225583,112.39191226022619,0.05947432880393455,1.2390089203217869,1.1795345915178523,121758190,122215108.4,86.83268128772744,89.10203531057543,NaN,NaN,37.7745167886044,32.294462011027306
2004-01-28T09:30:00-05:00,59.597,59.67,57.94,58.275,12830000,7781170.4,56.39223006169218,68.53310396845289,NaN,NaN,44.51718605811624,95.54819129375765,-0.05253885552774773,1.1138610221081677,1.1663998776359155,108928190,119531749.2,78.13620085720339,88.6654497294255,NaN,NaN,33.79578495845284,32.508936717802385
2004-01-29T09:30:00-05:00,58.35,58.495005,57.08,57.725,17243796,8356660.2,51.99578646611321,67.32087232301882,NaN,NaN,-16.43056198591565,69.19333006087507,-0.16572593592573903,0.9592424577287417,1.1249683936544808,91684394,114837710.8,65.73390098336996,87.15321864072166,NaN,NaN,29.01567089666073,32.009898743353574
2004-01-30T09:30:00-05:00,57.804495,58.19,57.375,57.800005,8859204,8163230.6,52.53919882428304,66.47513775023484,NaN,NaN,-24.534002843959115,44.043148407860734,-0.2334512559434616,0.8331543237251537,1.0666055796686154,100543598,110264272.4,56.349234620391385,84.93841883063558,NaN,NaN,25.383562125902188,31.063279226574803
2004-02-02T09:30:00-05:00,57.92,58.375,57.32,57.949995,10311398,8119690.3,53.66868660455122,65.34667733016127,NaN,NaN,-27.72535428526243,14.781144875046952,-0.2638143019533665,0.7368377022269073,1.0006520041802738,110854996,106753873.6,50.401259693347754,82.28382592075657,NaN,NaN,22.737662618370987,29.87390542540283
2004-02-03T09:30:00-05:00,57.800005,57.910005,57.555,57.625,4679200,7919320.2,50.84513989962453,64.18534681466177,NaN,NaN,-51.789036678817006,-15.192353947167618,-0.298878864288451,0.6270534238197101,0.9259322881081611,106175796,103637394.8,45.781073455695015,79.29669340024068,NaN,NaN,19.66530268244539,28.415533604980336
2004-02-04T09:30:00-05:00,57.394995,57.405,56.15,56.199995,11440398,8181500.1,40.72737058838338,62.20042805496865,NaN,NaN,-151.84141546000617,-54.46407425079208,-0.40457096666097825,0.4202185797819382,0.8247895464429165,94735398,100798836.4,42.00422621172027,76.03219265480017,NaN,NaN,13.292044348470068,26.255035139764583
2004-02-05T09:30:00-05:00,56.567495,56.935,56.295,56.725,9356796,8353359.9,45.06466440537538,60.47449621302567,NaN,NaN,-141.7919613381725,-79.53635412124345,-0.4236233065014643,0.2952604133160861,0.7188837198175504,104092194,103280396.4,46.18412248286234,73.05770925835775,NaN,NaN,9.419645664121944,23.849979500387064
2004-02-06T09:30:00-05:00,56.725,58.315,56.725,58.160005,11459398,8612789.8,54.80049459289193,59.33389129577446,NaN,NaN,-46.43727106893053,-83.91700776623773,-0.3283331692612841,0.30846725824094534,0.6368004275022294,115551592,106281995.2,50.80284325731085,70.29003609472568,NaN,NaN,9.368749552910117,21.781232365033215
2004-02-09T09:30:00-05:00,58.3955,58.65,58.095,58.275,8758000,8570789.8,55.481378613588774,58.023209434957415,NaN,NaN,4.2012626735574745,-77.53168437447376,-0.24986226573068904,0.3244725953388681,0.5743348610695571,124309592,108972914.4,54.56738177096259,67.68511919183857,NaN,NaN,9.558063094665673,20.03506532640928
2004-02-10T09:30:00-05:00,58.300005,59.025,58.18,58.975,4896200,8520229.8,59.48253470387686,57.06497859033344,NaN,NaN,36.689172544650695,-59.83604252978021,-0.148143767409452,0.3891551518077421,0.5372989192171941,129205792,113578913.6,60.18357325827898,65.39681506134961,NaN,NaN,11.064381282214908,18.753539034381514
2004-02-11T09:30:00-05:00,59.007005,59.464995,58.75,59.335,8204204,8523890,61.40375845459054,56.524759607679194,NaN,NaN,71.59762447819804,-15.148234542139368,-0.058546734903724085,0.46411550058753903,0.5226622354912631,137409996,122113833.2,68.06203807381206,63.650834481976794,NaN,NaN,12.907757442115647,17.918427378343534
2004-02-12T09:30:00-05:00,59.365,59.550005,58.905,58.93,5122400,8450410,58.06788990671788,55.62976485627361,NaN,NaN,60.48398124043066,25.306953973581265,-0.029931099804243466,0.4852483607359588,0.5151794605402022,132287596,127752913.6,72.00365321436693,62.15868320512046,NaN,NaN,13.376187082798955,17.26953590755145
2004-02-13T09:30:00-05:00,59.113505,59.370005,58.199995,58.324995,7421800,8504600,53.400758551249446,54.202953178439614,NaN,NaN,14.188286757103002,37.43206553878797,-0.05373313489098375,0.4480130419264725,0.5017461768174563,124865796,129615754.4,73.18114890309778,60.73023843358193,NaN,NaN,12.29777695552255,16.55928462869018
2004-02-17T09:30:00-05:00,58.71,59.35,58.68,59.35,6605200,8498250,59.36033987010102,53.80215939593139,NaN,NaN,56.48252020327032,47.88831704473054,-0.004995909258230347,0.49550129024466827,0.5004971995028986,131470996,131048035.2,74.08369251671135,59.819596378509345,NaN,NaN,13.327596218133634,16.09761485575353
2004-02-18T09:30:00-05:00,59.4,59.435,58.74,58.915,5221200,8387820,56.08232535768659,53.78002334564528,NaN,NaN,49.26120356339087,50.40272324847858,-0.006510087801970432,0.4923595897504356,0.498869677552406,126249796,130456836,72.99176887835884,59.45213695144901,NaN,NaN,13.109389174617522,15.6707254727341
2004-02-19T09:30:00-05:00,59.4,59.47,57.875,57.875,9321602,8441120,49.101060270204684,53.57325718879468,NaN,NaN,-3.035552614596443,35.47608782991968,-0.07803634601346504,0.40132424503557473,0.4793605910490398,116928194,126360475.6,65.75946113188675,59.453962676343075,NaN,NaN,10.567424815604424,14.941682521715574
2004-02-20T09:30:00-05:00,58.07,58.25,57.28,57.775,10968000,8630000,48.47619273162412,53.28304246789047,NaN,NaN,-56.24005978063487,12.131279625706576,-0.12952883014804334,0.3174495533639856,0.44697838351202895,105960194,121094995.2,57.82779914745694,59.55957442827633,NaN,NaN,8.380060227386537,14.004307908239998
2004-02-23T09:30:00-05:00,57.956,57.980005,56.79,56.905,12405398,8837459.7,43.311927477797056,52.5432739588366,NaN,NaN,-95.03206903584274,-9.712791532882571,-0.21460959043899097,0.1787163954632902,0.3933259859022812,93554796,114832795.2,50.08979708090317,59.537327098816,NaN,NaN,4.80254132723751,12.689769825239642
2004-02-24T09:30:00-05:00,56.75,57.495005,56.300005,56.9,14174398,9296369.6,43.283388610865785,52.003148866782404,NaN,NaN,-112.3152769559519,-43.47235096472701,-0.26059133959801783,0.06758681140475886,0.3281781510027767,79380398,104414675.6,40.403491562937006,59.15321410647614,NaN,NaN,1.983493330747994,11.160301754597977
2004-02-25T09:30:00-05:00,57.07,57.730005,56.839995,57.699995,10497796,9488819.4,49.066178689769565,52.59877801688142,NaN,NaN,-58.51973489375376,-65.02853865615593,-0.2276893061210692,0.04356651835144021,0.2712558244725094,89878194,97140355.2,35.274236627031925,58.6725005647127,NaN,NaN,1.3112253718979168,9.753290842783683
2004-02-26T09:30:00-05:00,57.589995,58.245005,57.4,58.050005,8306000,9262619.4,51.40089073862669,53.051365612113656,NaN,NaN,-9.68807401375406,-66.35904293598746,-0.1752672663511401,0.05217174153358428,0.22743900788472438,98184194,93391555.2,32.95252330979805,57.727386338065244,NaN,NaN,1.4673484862029857,8.569584791843583
2004-02-27T09:30:00-05:00,58.185,58.550005,57.975,58.35,9046398,8852749.5,53.37366150499452,52.949448962978124,NaN,NaN,27.04481651069253,-49.70206767772198,-0.1161508856530972,0.08225040081835289,0.19840128647145008,107230592,93645634.8,33.27308691353517,56.47526088493841,NaN,NaN,2.184021303718517,7.657361436397146
2004-03-01T09:30:00-05:00,58.501,59.295,58.4,59.275,11023796,8960979.1,58.911957524987635,53.194490313792336,NaN,NaN,86.0138849009283,-13.492876890367771,-0.015786509775948615,0.1786681492515143,0.19445465902746292,118254388,98585553.2,39.345095264300625,55.387954705891126,NaN,NaN,4.5614673520359315,7.215090852916973
2004-03-02T09:30:00-05:00,59.199995,59.449995,58.800005,58.805,14427204,9166769.4,55.31660733448567,52.89692407312153,NaN,NaN,79.78138320397309,24.92645514161723,0.016180383568673518,0.2146801384883048,0.1984997549196313,103827184,103474910.4,44.70811502088301,54.28256483179142,NaN,NaN,5.455660996264277,6.963743730538016
2004-03-03T09:30:00-05:00,58.695,59.160005,58.285005,58.865,8672204,9366419.6,55.68839357625338,52.488683724668874,NaN,NaN,52.50609835989823,47.13162179234763,0.03738778602568077,0.24523448745173226,0.2078467014260515,112499388,107999149.2,49.18535908772603,52.934230618499555,NaN,NaN,6.284175288311092,6.866662524505598
2004-03-04T09:30:00-05:00,58.875,59.65,58.685,59.61,4835200,9036159.7,60.12487748099541,52.63561140854584,NaN,NaN,97.74897171255925,68.61903093761029,0.09436950634791824,0.3258085843609493,0.23143907801303104,117334588,111829228,52.67878946418474,51.55388320777225,NaN,NaN,8.36171743476494,7.08024179739979
2004-03-05T09:30:00-05:00,59.18,60.214995,59.1,59.745005,9174398,9027039.8,60.88906144027808,53.1704901863336,NaN,NaN,127.10324771155466,88.63071717778273,0.13164325707284202,0.3959931493540836,0.26434989228124156,126508986,115684906.8,55.961084869920484,50.32387863397388,NaN,NaN,10.283186802411604,7.537805369544334
2004-03-08T09:30:00-05:00,59.905,60.165,58.865,58.9,7698400,8838989.9,53.923330380145664,52.7821323656225,NaN,NaN,80.61171848656976,87.55028389491102,0.09176849232652307,0.37906050768939537,0.2872920153628723,118810586,115796146.4,56.055788526841035,49.036171206126006,NaN,NaN,9.911988134530102,7.876974335970872
2004-03-09T09:30:00-05:00,58.949995,59.15,58.19,58.4,11062796,8954229.7,50.25945568138171,52.3662131030293,NaN,NaN,1.050534122617095,71.80411407863981,0.027437087904422952,0.321588375243401,0.29415128733897805,107747790,116580267.6,56.76163118191802,47.87687565638023,NaN,NaN,8.485718428708466,7.9639377777905285
2004-03-10T09:30:00-05:00,58.535005,58.879995,57.11,57.175005,17782398,9598539.6,42.619046317090174,51.90321210637827,NaN,NaN,-81.54626532380418,44.99364134189932,-0.09518092779297926,0.175175127597754,0.27035605539073326,89965392,112073468.4,51.62868206837559,46.86753429470087,NaN,NaN,4.665060922340411,7.492669655583369
2004-03-11T09:30:00-05:00,56.96,58,56.54,56.6,21168000,10246729.4,39.5776641531614,51.26760292220236,NaN,NaN,-129.41930384131146,-0.4400137688748259,-0.2062062433465072,0.012598251207599276,0.21880449455410647,68797392,102366029.2,42.676616992434596,45.78530699791355,NaN,NaN,0.4962921245338482,6.4931871511477235
2004-03-12T09:30:00-05:00,57,58.47,56.910005,58.125,13307204,10655969.6,49.80789792412624,51.731600811225874,NaN,NaN,-48.7141097654071,-35.60348526426718,-0.16965794969059395,0.0067320574408640255,0.17639000713145797,82104596,93485151.2,36.44983492809006,44.811023986998336,NaN,NaN,0.29149290029749153,5.6072308295976905
2004-03-15T09:30:00-05:00,57.910005,57.94,56.410005,56.625,21095204,11339639.8,42.23345411240084,51.65660548990695,NaN,NaN,-111.96484119972713,-74.11879720152655,-0.2351910469675476,-0.11759880157797653,0.11759224538957107,61009392,81924912.4,30.260483668677622,44.086523423122664,NaN,NaN,-2.6949364833499976,4.42120692774802
2004-03-16T09:30:00-05:00,57.015,57.265,56.01,56.65,34804608,12749610.2,42.39069973636825,51.179785564663995,NaN,NaN,-125.4677580105806,-99.42245562816609,-0.2634134438962498,-0.2116745594807412,0.05173888441550861,95814000,79538154.4,29.159561007947048,43.64976087890231,NaN,NaN,-4.876384403988864,3.0929795946427507
2004-03-17T09:30:00-05:00,56.925005,57.82,56.9,57.699995,18236796,13400390,48.706085936229876,50.98729950734994,NaN,NaN,-50.61821685574544,-93.23684593455434,-0.20075759314626285,-0.19920810701731995,0.0015494861289429007,114050796,84355235.2,34.35079543899988,43.74963745955959,NaN,NaN,-4.54197747320565,2.0022714420929795
2004-03-18T09:30:00-05:00,57.47,57.615,56.675005,57.35,17929000,13830759.9,46.86197438443309,50.522178998738404,NaN,NaN,-66.61190024693829,-80.6753652156797,-0.17331206458991827,-0.21509059460845492,-0.041778530018536666,96121796,89820116,39.74541637358037,44.21194670670567,NaN,NaN,-4.882009570210711,1.018802726049595
2004-03-19T09:30:00-05:00,57.375,57.56,56.65,56.85,14281000,13996409.9,44.28251281278029,49.47721866215217,NaN,NaN,-76.82958566749299,-86.29846039609689,-0.17855237921410477,-0.26496900403616763,-0.08641662482206286,81840796,89767356,39.71148851822542,44.238117653414584,NaN,NaN,-5.9850082993381095,0.01825829385135158
2004-03-22T09:30:00-05:00,56.315,56.574995,55.550005,55.754995,18560796,14304179.8,39.19433207972259,48.32562757252623,NaN,NaN,-148.5125597329336,-93.60800410273819,-0.24156971323220194,-0.3883787663623153,-0.14680905313011333,63280000,90221477.6,40.18478478878641,43.91502263683626,NaN,NaN,-8.628412590462938,-1.2169804039078327
2004-03-23T09:30:00-05:00,56.160005,56.574995,55.635,55.85,15123602,14351640,39.8402117494746,47.19361458489918,NaN,NaN,-134.5716249322017,-95.42877748706242,-0.26100284653844563,-0.4730626113031704,-0.21205976476472477,78403602,86739398,37.73835526880584,43.097379506913384,NaN,NaN,-10.504824082499601,-2.5438152151352282
2004-03-24T09:30:00-05:00,56.01,56.18,55.36,55.775,13165398,14485020.1,39.48365848058318,45.71924179915545,NaN,NaN,-134.85136173770664,-112.27540646345464,-0.2623539738997576,-0.5400022321394218,-0.27764825823966416,65238204,76976879.6,31.87861506836046,41.61165276435451,NaN,NaN,-12.11493549910113,-3.911118112844642
2004-03-25T09:30:00-05:00,56.175005,57.125,56,57.06,19901398,15064790,48.060495105219026,44.80291563236552,NaN,NaN,-63.97653243891993,-111.748332901851,-0.1649108413452391,-0.48378680992121303,-0.31887596857597394,85139602,74780440.8,30.722774968489233,39.8089163428237,NaN,NaN,-10.885418392371392,-4.907446724205606
2004-03-26T09:30:00-05:00,56.83,57.495005,56.795,57.1,11659796,15195459.9,48.30609904313763,44.40168482257923,NaN,NaN,-34.45935467863498,-103.27428670407937,-0.08973063695153727,-0.43103926476539556,-0.3413086278138583,96799398,77772161.2,34.22118673532914,38.24930192914428,NaN,NaN,-9.834085656422591,-5.611252285950889
2004-03-29T09:30:00-05:00,57.5,58.25,57.46,58.195,15617398,15425140,54.63076749502012,44.713921380696256,NaN,NaN,24.585850586055685,-68.65460464028152,0.03508667443172647,-0.2974502847742002,-0.3325369592059267,112416796,87599520.4,44.190964345210396,37.35139715509373,NaN,NaN,-6.9012228966740405,-5.7955338017684825
2004-03-30T09:30:00-05:00,58.055,58.74,58,58.67,9919000,15199729.8,57.08369629070893,45.74711066452617,NaN,NaN,62.846718895860455,-29.170935874669095,0.1448255119366666,-0.15150506928509344,-0.29633058122176004,122335796,96385959.2,51.29826391713619,37.327795858576636,NaN,NaN,-3.7019332465571764,-5.496448008166867
2004-03-31T09:30:00-05:00,58.675005,58.9,58.155,58.800005,13496204,15440929.8,57.756875464875485,47.04562575822003,NaN,NaN,74.55056551426821,12.709449575725884,0.21701390137074572,-0.025063204508327885,-0.2420771058790736,135832000,110504718.4,60.092912034709606,38.571816933024856,NaN,NaN,-0.910512358552707,-4.841314343936273
2004-04-01T09:30:00-05:00,58.79,59.47,58.695,59.445,9812796,15689809.6,61.02345111390368,47.84673670034699,NaN,NaN,117.52713460298709,49.01018298410729,0.29425300287811995,0.1257391477185763,-0.16851385515954362,145644796,122605757.2,65.79433058429122,40.66785233703922,NaN,NaN,2.4862713291467062,-3.7945163906387043
2004-04-02T09:30:00-05:00,60.28,60.47,59.805,60.199995,12827204,15872449.9,64.48536639768889,49.436159006438984,NaN,NaN,179.50251493936386,91.80255690770706,0.37695807243702406,0.30268373538673643,-0.0742743370502876,158472000,134940277.6,70.43144013697218,43.537206370488825,NaN,NaN,6.508489118645847,-2.3226584607409113
2004-04-05T09:30:00-04:00,60.235,60.449995,59.9,60.375,7328000,15853929.9,65.25571534384028,51.069374406972706,NaN,NaN,172.78119016789194,121.44162482407432,0.4208807979318383,0.45182666036451025,0.030945862432671972,165800000,145616918.4,73.74881956264954,46.72215341011044,NaN,NaN,10.026890263607187,-0.5584372144054688
2004-04-06T09:30:00-04:00,60.025,60.24,59.504995,59.64,10185204,15810050.3,59.42562263847243,51.83505559999003,NaN,NaN,130.40706202169673,134.95369344924157,0.37915933402051816,0.5048950299583197,0.12573569593780154,155614796,152272718.4,75.58758382425586,49.66763829477158,NaN,NaN,11.395090044044665,1.149209536801693
2004-04-07T09:30:00-04:00,59.625,60.245005,59.175005,60.089995,10876000,15464730.4,61.68275100820463,52.89368250168799,NaN,NaN,114.02988567069747,142.8495574805274,0.3607042911901237,0.5766160599254562,0.21591176873533247,166490796,158404477.6,77.1738613777182,52.34109865220999,NaN,NaN,13.218247381825371,2.873357800376504
2004-04-08T09:30:00-04:00,60.545,60.574995,59.47,59.555,9078204,14860240.6,57.58151994435333,53.84361158251464,NaN,NaN,101.28880435659904,139.6018914312498,0.2941177554620985,0.5835589630629556,0.2894412076008571,157412592,160758036.8,77.77091684957051,55.05962924730607,NaN,NaN,13.57167580436928,4.401688943804043
2004-04-12T09:30:00-04:00,59.69,60.15,59.56,59.71,7693000,14579530.4,58.44361455015441,55.218560330402624,NaN,NaN,86.41530476695121,120.98444939676729,0.24421742376696498,0.5947129873095633,0.35049556354259837,165105592,162084755.2,78.11837311689544,57.76917127074243,NaN,NaN,14.106498745683185,5.788090344072492
2004-04-13T09:30:00-04:00,60.074995,60.074995,58.1,58.32,16764398,14362990.1,48.85461671119367,55.86244639909684,NaN,NaN,34.392685425441165,93.30674844827715,0.1082366278308452,0.4857913483311549,0.3775547205003097,148341194,158592994,74.8043471842719,60.41674212184715,NaN,NaN,11.595065687790623,6.617658250317939
2004-04-14T09:30:00-04:00,57.964995,58.67,57.574995,58.14,15333204,13389419.9,47.761770727142114,56.453740130993914,NaN,NaN,-4.393796602647951,66.3465767234082,0.0024032826353024284,0.38055882379443773,0.3781555411591353,133007990,154071632.8,70.62625296351344,63.1844305429295,NaN,NaN,9.231760542412577,6.9911014349028875
2004-04-15T09:30:00-04:00,58.125,58.475,57.199995,57.69,13483796,13151769.9,45.04870477522318,56.23861225027992,NaN,NaN,-23.346681497122052,38.87126328984429,-0.09622251245079133,0.2578774005956461,0.35409991304643745,119524194,144678312.4,62.78088299987109,65.47429540231391,NaN,NaN,6.419738358488447,6.909478138272253
2004-04-16T09:30:00-04:00,57.949995,58.42,57.28,58.129995,13355796,12923109.7,48.150037010605914,56.22746496224194,NaN,NaN,-17.562635009165394,15.100975416691407,-0.1281439153328202,0.19392001888041221,0.32206393421323243,132879990,139771792,59.08863890047254,67.25054198553845,NaN,NaN,4.940475002393947,6.628191976003924
2004-04-19T09:30:00-04:00,58.015,58.620005,57.585,58.56,11097204,12763919.9,51.05720150334686,55.972210248550994,NaN,NaN,-4.096602069974872,-3.001405950693804,-0.11692839733112759,0.17590343754932292,0.2928318348804505,143977194,135546112.4,56.03224951243825,68.09634806891187,NaN,NaN,4.529088096651314,6.3283199932392655
2004-04-20T09:30:00-04:00,58.725,59.115,57.135,57.265,16267000,12649230.1,43.20125580900835,54.98060735700095,NaN,NaN,-36.48526238711331,-17.176995513204716,-0.18908271471104704,0.05647844149164172,0.24556115620268876,127710194,131419912.4,53.14171186271563,68.22802292216754,NaN,NaN,1.6389709883744639,5.658412992544294
2004-04-21T09:30:00-04:00,57.5,58.199995,57.019995,58.199995,12280602,12507080.1,49.270395648713766,54.37443022727512,NaN,NaN,-47.92627393929471,-25.883490980534066,-0.16696515224024205,0.036854715902386204,0.20381986814262826,139990796,132816473.6,54.00654239211736,67.79328223341096,NaN,NaN,1.1148088580173352,5.009326687611871
2004-04-22T09:30:00-04:00,58.06,59.26,58.050005,59,14381000,12567860.2,53.81749070498735,53.85971876949538,NaN,NaN,8.6087133333888,-19.492412014431896,-0.09515344008428675,0.08487806803726983,0.18003150812155658,154371796,139785994,58.156991571686355,67.2477580182249,NaN,NaN,2.171820631798475,4.603968679638529
2004-04-23T09:30:00-04:00,59.245005,59.28,58.345,58.875,9105204,12028050.5,53.01784678630524,53.04061022582512,NaN,NaN,5.96092949411998,-14.78769911377482,-0.05477367043792872,0.11156442007414569,0.1663380905120744,145266592,142263314.4,59.55412301384207,66.47080679514417,NaN,NaN,2.7603448832696107,4.340593851585826
2004-04-26T09:30:00-04:00,59.035005,59.53,58.595,59,10511796,11970650.5,53.757786759883764,52.21932961268537,NaN,NaN,17.124097060423548,-10.543559287695135,-0.020132351439017204,0.1411726512133029,0.16130500265232012,155778388,144623553.2,60.89385468507101,65.55259501817427,NaN,NaN,3.454590240485099,4.214021907142865
2004-04-27T09:30:00-04:00,59,59.355005,58.43,58.85,6833800,11531470.6,52.68547661311087,51.73789061087383,NaN,NaN,-2.7090711271544485,-3.7883210357033628,-0.008407709166221217,0.1507953661945436,0.1592030753607648,148944588,148870432,63.25253742358629,64.6715202752693,NaN,NaN,3.7233925458723114,4.143931998389928
2004-04-28T09:30:00-04:00,58.574995,58.65,57.300005,57.620005,15351796,11803110.4,44.79496741210056,50.531620354009256,NaN,NaN,-97.61616145347564,-13.726298538539549,-0.08056501598240426,0.058496805382759476,0.13906182136516373,133592792,147590831.2,62.03838195402331,63.59041460214824,NaN,NaN,1.5362412499320843,3.7714047486102364
2004-04-29T09:30:00-04:00,57.65,57.935,56.125,56.475,16088398,11932720.1,38.947328919609696,49.200606709384715,NaN,NaN,-164.9758059334522,-48.44320239190775,-0.19590781095064605,-0.10582294232314382,0.09008486862750223,117504394,140217350.8,55.43504493987369,61.99499518002704,NaN,NaN,-2.3385845375361174,2.8985491363036147
2004-04-30T09:30:00-04:00,56.800005,56.9,55.555,55.555,18905204,12387340.5,34.99443299541869,47.525665169760735,NaN,NaN,-190.6621883609737,-87.76782596292648,-0.31746616636696867,-0.30674783933120864,0.010718327035760061,98599190,130883870.4,48.41078042530398,59.8730242734848,NaN,NaN,-6.974135761982659,1.4881655794055757
2004-05-03T09:30:00-04:00,55.800005,56.685,55.745005,56.285005,14628000,12477380.3,40.18231394562819,46.90621497222035,NaN,NaN,-152.2294064878301,-121.6385266725772,-0.33052499080273423,-0.4024379114676577,-0.0719129206649235,113227190,122373630.8,43.053901643658094,57.6051353062981,NaN,NaN,-9.124646115860674,-0.02795037706103143
2004-05-04T09:30:00-04:00,56.33,57.46,56.225,56.6,14691398,12845550.2,42.32134497365216,46.517613132685355,NaN,NaN,-106.52291898341637,-142.4012962438296,-0.3006254813980928,-0.4476947724125395,-0.1470692910144467,127918588,118168430.8,40.65968577614646,55.464666221486176,NaN,NaN,-10.174615990017005,-1.4774740360547418
2004-05-05T09:30:00-04:00,56.800005,57.199995,56.644995,56.85,9045000,12788540,44.03194594530743,46.44498750197708,NaN,NaN,-88.53834922421198,-140.58573379797684,-0.2488305450505377,-0.45810747232761884,-0.20927692727708114,136963588,118842590,41.22398753320806,53.924887973867385,NaN,NaN,-10.50577394863644,-2.7672311664235556
2004-05-06T09:30:00-04:00,56.44,56.44,55.35,56.019995,22126204,13351050.2,39.8105406683577,45.84930919181649,NaN,NaN,-143.60329852752344,-136.31123231679112,-0.2543834162964684,-0.5272561976476666,-0.27287278135119825,114837384,118309188,40.89264013178426,52.62517377610394,NaN,NaN,-12.103665903407625,-4.10100755742128
2004-05-07T09:30:00-04:00,55.6,56.58,54.425005,54.425005,21522204,13973250.2,33.219623990484564,44.57519651232633,NaN,NaN,-170.23268213051438,-132.22533107069927,-0.3438294559372808,-0.7026596012727993,-0.35883014533551844,93315180,117252386,40.203166749928826,51.49452500735327,NaN,NaN,-15.813767217226243,-5.774258937393418
2004-05-10T09:30:00-04:00,54,54.379995,53.074995,53.46,33150000,15246100.2,29.985105695092827,43.63118578990379,NaN,NaN,-216.25318957744977,-145.03008768862318,-0.4401813712269064,-0.9090568593691515,-0.46887548814224506,60165180,106639984,34.00310904584565,50.12748194900541,NaN,NaN,-20.036359326719452,-7.81170185015428
2004-05-11T09:30:00-04:00,53.93,54.800005,53.75,54.625,24260398,15620900.2,37.85231815076686,42.81560882576473,NaN,NaN,-147.19830728154267,-153.16516534824845,-0.398875623566187,-0.9674700175999789,-0.5685943940337919,84425578,97941382,29.928872208590136,48.407648364467754,NaN,NaN,-20.870956863011948,-9.677309709133947
2004-05-12T09:30:00-04:00,54.53,55.050005,53.15,55.04,31081000,16408290,40.42054749440756,41.85868431072331,NaN,NaN,-127.17973577519753,-160.89344265844557,-0.3204081648200795,-0.9691046000588912,-0.6486964352388117,115506578,93649980,28.137648359149807,46.26340956357228,NaN,NaN,-20.673083303422874,-11.24813450831808
2004-05-13T09:30:00-04:00,54.699995,55.175005,54.214995,54.285005,20447602,16756480.3,37.393071733057674,40.74262894977705,NaN,NaN,-105.82400152858615,-153.33758325865807,-0.2966979319152412,-1.0195688501328632,-0.7228709182176221,95058976,89694298.4,26.559711312312444,43.906665870605885,NaN,NaN,-21.500655539576,-12.712780369926353
2004-05-14T09:30:00-04:00,54.370005,54.9,53.824995,54.074995,20056796,17091530.3,36.572505244406265,39.51510884152866,NaN,NaN,-104.68550985978771,-140.22814880451276,-0.2730954928138155,-1.0642402842348915,-0.791144791421076,75002180,86031698.4,25.15318547228145,41.35376092683521,NaN,NaN,-22.413256175282868,-14.098562627834426
2004-05-17T09:30:00-04:00,53.24,53.925005,52.754995,53.56,19714398,17522390,34.56914525230722,38.221085172899826,NaN,NaN,-125.32602607905355,-122.04271610483352,-0.26963888596869723,-1.1281933988819475,-0.8585545129132502,55287782,85056218.8,24.776842586705712,38.60549700991516,NaN,NaN,-23.7845592379025,-15.482276429272721
2004-05-18T09:30:00-04:00,53.785005,54.195,53.515,54.165,13970398,17407559.9,38.80971131364105,37.79356688015272,NaN,NaN,-92.08583322539127,-111.02022129360323,-0.20690047158387948,-1.1171801023930996,-0.9102796308092201,69258180,82022739.2,23.594588833401318,35.859511787013595,NaN,NaN,-23.648361991324347,-16.648860080994382
2004-05-19T09:30:00-04:00,54.6,55.21,53.72,53.78,18790204,17733040,37.1592759489429,37.66584881081938,NaN,NaN,-73.25285936662945,-100.23484601188963,-0.17300213921808516,-1.1265323048318265,-0.9535301656137414,50467976,69015018.8,19.334308465267725,33.28088775311316,NaN,NaN,-24.0224459863599,-17.7022294960466
2004-05-20T09:30:00-04:00,53.9,54.300005,53.49,53.89,12400602,17634020.1,37.970928260248655,37.87845561545008,NaN,NaN,-79.32860279016893,-94.93576626420618,-0.12697316767378253,-1.1122466252059695,-0.985273457532187,62868578,62576939.2,17.636894694316595,31.08275305804264,NaN,NaN,-24.097155166586425,-18.615790306123717
2004-05-21T09:30:00-04:00,54.199995,54.595,53.92,54.394995,12021796,17779849.7,41.69415930723334,37.98644456985045,NaN,NaN,-55.974518131215255,-85.1935679184917,-0.05025680559672352,-1.0480944645280914,-0.9978376589313679,74890374,62554578,17.631104914403863,29.26683900595305,NaN,NaN,-23.100501852137082,-19.256463384125627
2004-05-24T09:30:00-04:00,54.879995,55.21,54.595,55.1,10802602,17794390,46.52033558979882,38.28637247100378,NaN,NaN,-18.87942112517008,-63.90424692771501,0.054550936250888915,-0.9296489886177568,-0.9841999248686457,85692976,68635616.8,24.855545462096458,28.137971840663763,NaN,NaN,-20.813989738127795,-19.47896714898308
2004-05-25T09:30:00-04:00,54.975,56.46,54.81,56.25,14969204,18201160.2,53.30941326450865,38.949048708089585,NaN,NaN,40.27446979466475,-37.43218632370379,0.19974582439630084,-0.7345176443732697,-0.9342634687695706,100662180,74916416.8,31.534866439587447,27.445891762548005,NaN,NaN,-16.621558656526542,-19.070765935775004
2004-05-26T09:30:00-04:00,56.22,56.635,56.03,56.635,12890602,18078100.5,55.35285999532274,40.05921437430137,NaN,NaN,87.22816833507567,-5.335980783362766,0.3133674634936243,-0.5425541394025402,-0.8559216028961645,113552782,87533378,42.57684532128847,27.566192133226874,NaN,NaN,-12.525875789937627,-18.135781629226805
2004-05-27T09:30:00-04:00,56.824995,57.129995,56.185,56.65,19803204,18263840.8,55.434696311697635,41.646005254388015,NaN,NaN,103.49905496029797,31.229550766730615,0.37691660424119744,-0.38477584759466765,-0.7616924518358651,133355986,101630859.6,51.90955400171739,28.402362651211767,NaN,NaN,-9.197656134065985,-16.858906558489544
2004-05-28T09:30:00-04:00,56.635,56.85,56.39,56.75,6848400,17661000.6,56.01354468632366,43.50517946804736,NaN,NaN,98.30282740439183,62.085019873852026,0.41031535436171285,-0.2487982588837241,-0.6591136132454369,140204386,114693662,58.62052207938753,30.16074929646476,NaN,NaN,-6.278599239031174,-15.347434084281206
2004-06-01T09:30:00-04:00,56.5,57.300005,56.44,57.29,11926602,17525930.7,59.10270849404316,45.023064492567094,NaN,NaN,113.16033742422448,88.49297158373095,0.4502101864661133,-0.09635088016279525,-0.5465610666289086,152130988,127981264.4,64.10741030237455,32.60207344602077,NaN,NaN,-2.8438483652634705,-13.561207552992958
2004-06-02T09:30:00-04:00,57.405,57.46,56.86,57.1,12855602,17434140.9,57.57067651716565,46.24807370847839,NaN,NaN,117.52874998443549,103.94382762168509,0.44447226921598526,0.009029269891073,-0.43544299932491226,139275386,135703905.6,66.85798785727393,35.36781198160106,NaN,NaN,-0.3547638741988341,-11.674572741736654
2004-06-03T09:30:00-04:00,57.025,57.08,56,56,11824602,17573121,49.5608523780281,47.11720089740485,NaN,NaN,74.35318133260918,101.3688302211918,0.3513463035442893,0.0037398801054493447,-0.34760642343883996,127450784,138483506,67.81405107357389,38.31455053597688,NaN,NaN,-0.36086694163073213,-10.058329056007237
2004-06-04T09:30:00-04:00,56.57,57.050005,56.32,56.699995,11023000,17017960.8,53.951458360250875,48.35855469139375,NaN,NaN,88.75199667204568,98.41941856354133,0.3223997056013158,0.05539320856280483,-0.267006497038511,138473784,139507065.6,68.17809133368473,41.38775809750568,NaN,NaN,0.9460305834796101,-8.486277678937688
2004-06-07T09:30:00-04:00,56.945,57.769995,56.800005,57.725,9933796,16438540.4,59.50954275110321,50.14001165559346,NaN,NaN,113.85587390776857,101.53002786421669,0.3552034852594509,0.1769978595358026,-0.17820562572364826,148407580,141147704.4,68.78748286912548,44.53137526053566,NaN,NaN,3.868080441820582,-6.721369375972221
2004-06-08T09:30:00-04:00,57.555,57.795,57.415,57.67,6248200,15093450.4,59.097351600417284,51.58912881893462,NaN,NaN,110.76762143705643,101.05148466678307,0.3552586003544143,0.26586762471936964,-0.08939097563504467,142159380,139153382.8,67.10522175308171,47.6392776119414,NaN,NaN,6.078186514080661,-4.892861391678952
2004-06-09T09:30:00-04:00,57.525,57.754995,56.625,56.625,10326204,14396740.7,51.7614016040376,52.63213779429852,NaN,NaN,70.88342163084502,91.72241899606499,0.2707954043327704,0.24910327978091829,-0.02169212455185207,131833176,137664940.8,65.81159843677199,50.95908403847743,NaN,NaN,5.76495962338841,-3.370315532383615
2004-06-10T09:30:00-04:00,56.97,57.074995,56.54,56.85,9060602,13295720.8,53.11101713287339,53.713572713771725,NaN,NaN,56.384425933702985,88.12866791628373,0.21821670414496797,0.2510787556293579,0.03286205148438993,140893778,140353539.6,67.047321103422,54.488400210556385,NaN,NaN,5.9140277071996445,-2.0439807838717208
2004-06-14T09:30:00-04:00,56.46,56.550005,55.615,55.735,11227000,12834690.7,46.21117118781129,54.03621641952729,NaN,NaN,7.496669804417982,71.8776025427582,0.10236582106139441,0.16081932781113295,0.05845350674973854,129666778,138592138.4,65.38005669142305,57.89903962320061,NaN,NaN,3.8345271111810653,-1.2041939417213228
2004-06-15T09:30:00-04:00,56.14,56.915,56.105005,56.75,20003796,12832040.7,52.287767327561774,54.44817582936749,NaN,NaN,38.644963534512534,56.835420468106996,0.0886285657693326,0.1692392139614043,0.08061064819207168,149670574,138844737.2,65.51250377340466,60.803108074008335,NaN,NaN,4.0136721637953015,-0.4587844980760909
2004-06-16T09:30:00-04:00,56.655,56.955,56.46,56.86,8662796,12279460.6,52.90866582158073,54.4195510120155,NaN,NaN,44.253421872400395,43.532580555175784,0.08165729554532884,0.18268226762373274,0.1010249720784039,158333370,142079535.2,67.24091988718837,63.35354046312269,NaN,NaN,4.347068367979954,0.22776591136048696
2004-06-17T09:30:00-04:00,56.76,57.04,56.33,56.714995,17147602,12438320.8,51.948950082162945,54.176414589646946,NaN,NaN,35.32841965285117,36.42158015957701,0.06283232233175394,0.17956537499309633,0.11673305266134239,141185768,143950053.6,68.2323702035518,65.18607795471293,NaN,NaN,4.332893684317944,0.814212736068695
2004-06-18T09:30:00-04:00,56.53,57.18,56.5,56.910005,11470796,12072350.4,53.178978870950424,54.01529191530786,NaN,NaN,45.618560618090214,34.26840709645446,0.059120269322047725,0.19063338931390206,0.13151311999185433,152656564,146302610.8,69.48331875717986,66.4413468658174,NaN,NaN,4.670782298841374,1.3651512450362207
2004-06-21T09:30:00-04:00,56.93,57.195,56.65,56.685,6144400,11759540.3,51.53962167591235,53.69572598599277,NaN,NaN,38.82858639652121,40.534790414875104,0.03813617074189066,0.17918333341921766,0.141047162677327,146512164,149671688,71.23051686304193,67.34206077893556,NaN,NaN,4.497693142173086,1.812657230341487
2004-06-22T09:30:00-04:00,56.725,57.144995,56.205,57.125,9991204,11658010.7,54.49388081725194,53.36652400907911,NaN,NaN,29.086927983937137,38.623183304760026,0.049778455215241796,0.20327023169637926,0.15349177648113746,156503368,151038246.8,71.93247468183236,67.90099394889684,NaN,NaN,5.170264259682813,2.292315377390248
2004-06-23T09:30:00-04:00,56.985,58.050005,56.975,57.985,16378602,11936810.7,59.66911490736531,53.516412465521945,NaN,NaN,177.41234067697195,65.25496706567432,0.1079499803532446,0.2884292519226932,0.1804792715694486,172881970,153947966.8,73.41960149281402,68.3696806371497,NaN,NaN,7.308194127238648,3.0088694845114476
2004-06-24T09:30:00-04:00,57.96,58.300005,57.685,57.775,8302000,11603450.5,57.93643827377431,54.11466860093238,NaN,NaN,193.9404054056995,96.977364216244,0.12370474452087393,0.335110202220541,0.21140545769966707,164579970,158626807.2,75.65344673624215,68.92963747019743,NaN,NaN,8.58944897003677,3.8060951253007795
2004-06-25T09:30:00-04:00,57.365,58.5,57.365,58.300005,12696204,11593730.6,60.9865197767446,54.6171729878248,NaN,NaN,178.37114428744698,123.52788095011536,0.1586719677489516,0.40974541738585657,0.251073449636905,177276174,163550729.2,77.770709737808,69.61482449906337,NaN,NaN,10.588155425593833,4.774960882485502
2004-06-28T09:30:00-04:00,58.35,58.705,58.04,58.18,15509204,11379030.6,59.91703090414126,54.646279284470374,NaN,NaN,176.12269126479342,150.9867019237698,0.1623234716371545,0.4539777891833481,0.2916543175461936,161766970,166601690.4,78.98991103546459,70.3435693680876,NaN,NaN,11.945319120819587,5.799297773676085
2004-06-29T09:30:00-04:00,58.07,58.865,58.07,58.665,7803000,11426760.6,62.759434642576856,54.90785664462463,NaN,NaN,168.3413986583699,178.83759605865635,0.18439550913326141,0.5221487039627704,0.33775319482950894,169569970,169215010.8,80.00168584699786,71.26474537479591,NaN,NaN,13.937873055480043,6.961951385362365
2004-06-30T09:30:00-04:00,58.72,58.995005,58.519995,58.995005,10925204,11376690.7,64.5989583432962,55.8248249831431,NaN,NaN,165.42673034836272,176.4404739929345,0.20654443408378798,0.5959337374342439,0.38938930335045596,180495174,170737651.6,80.58824296092376,72.32021998366388,NaN,NaN,16.162114703567653,8.276260430820264
2004-07-01T09:30:00-04:00,58.910005,59.04,57.92,57.92,16748398,11571330.5,55.05814601846179,55.96390561782798,NaN,NaN,95.06404725493809,156.66520236278222,0.13744525497055476,0.5611958720636494,0.42375061709309464,163746776,170571012.8,80.31062135882345,73.2675985733354,NaN,NaN,15.325343259509053,9.28327226349009
2004-07-02T09:30:00-04:00,58.045,58.225,57.65,58.1,7557600,11357980.4,56.22399596715178,56.67910738778088,NaN,NaN,59.319966948311105,132.85496689495503,0.09455404679087304,0.5419431755816859,0.4473891287908129,171304376,169376653.2,78.2304409319543,74.1854831619448,NaN,NaN,14.980191443462651,10.097117860629028
2004-07-06T09:30:00-04:00,57.735,57.78,56.875,57.06,13059398,11459800.3,48.41001408155578,56.40212501306616,NaN,NaN,-17.878724666966484,94.05468370860305,-0.0077351425897936865,0.43772020055357075,0.44545534314336444,158244978,168672254.8,76.96429072430105,75.00346794415168,NaN,NaN,12.178606111146264,10.394473324988633
2004-07-07T09:30:00-04:00,56.980005,57.5,56.85,56.99,8704204,11398320.7,47.9271975732382,56.04630585247026,NaN,NaN,-28.467351325472944,54.692933711834485,-0.07997090366715093,0.34549171355942576,0.4254626172265767,149540774,164666415.6,70.02343963331234,75.20221935458912,NaN,NaN,9.791187999935842,10.308289707123949
2004-07-08T09:30:00-04:00,56.635,56.99,55.795,55.955,13588000,11765310.7,41.35902979935071,55.28988297512654,NaN,NaN,-103.33981501389133,0.9396246393836577,-0.19098481587418353,0.18673159738384726,0.3777164132580308,135952774,155757935.6,57.5859019462525,74.44175733621059,NaN,NaN,5.500931204921453,9.621524206809307
2004-07-09T09:30:00-04:00,56.15,56.355005,55.925005,56.324995,11440398,11821020.4,44.29785856852682,54.65551723923914,NaN,NaN,-99.26616926213914,-37.92641866403179,-0.2303857976288462,0.08973416622197306,0.32011996385081926,147393172,152487214.8,53.80709209703127,73.32202686048569,NaN,NaN,2.870733167085648,8.657125486848784
2004-07-12T09:30:00-04:00,56.1,56.375,55.58,56,13178204,12026900.5,42.292896887134724,53.99503689718359,NaN,NaN,-110.18207739350072,-71.82682753239416,-0.26666325971995486,-0.013209110799124346,0.2534541489208305,134214968,145069333.2,46.37451602170847,71.54659822896187,NaN,NaN,0.08010200349948142,7.431836417798884
2004-07-13T09:30:00-04:00,56.165,56.39,56.004995,56.074995,6838400,11807470.5,42.93474960601983,53.16938466780987,NaN,NaN,-96.98665823682724,-87.64841424636631,-0.27294702883033295,-0.0877296371170857,0.18521739171324725,141053368,141631011.2,43.383132605298854,69.50735950920948,NaN,NaN,-1.9996629998673452,6.08447935813228
2004-07-14T09:30:00-04:00,55.635,56.46,55.54,55.75,12582796,11436420.5,40.81606506009159,51.82273825014746,NaN,NaN,-110.99890337687053,-104.15472465664581,-0.28500625255479894,-0.17104042398025143,0.11396582857454751,128470572,137416970.8,39.979325168610735,67.11876834319496,NaN,NaN,-4.377982827397379,4.589841903056614
2004-07-15T09:30:00-04:00,55.955,56.29,55.765,55.875,7474400,11377000.7,42.001538570589695,50.68453112849142,NaN,NaN,-98.17434985245451,-103.12163162435846,-0.27068603837762845,-0.22439171939748803,0.0462943189801404,135944972,137415410.4,39.978074368600346,64.57052745979198,NaN,NaN,-6.033499456880999,3.0722217087798125
2004-07-16T09:30:00-04:00,56.285005,56.31,55.199995,55.25,13095602,11174400.7,37.91246667285497,49.036384478213584,NaN,NaN,-118.19893864163222,-106.90818550025708,-0.28782869249617615,-0.31349154664007983,-0.02566285414390365,122849370,132506650,36.146803229445894,61.597391280623256,NaN,NaN,-8.700657555313656,1.3903818139093171
2004-07-19T09:30:00-04:00,55.42,55.5,54.824995,55.18,19252204,11563471.1,37.47244478326923,47.433199755294154,NaN,NaN,-131.2106616207155,-111.11390234570004,-0.28771819343888794,-0.3853105959425136,-0.09759240250362564,103597166,126383089.6,32.023824717145274,58.242670829314726,NaN,NaN,-11.025811614031356,-0.3833601043679218
2004-07-20T09:30:00-04:00,55.335,56.455,55.22,56.275,9932000,11752851.1,47.698480576497836,46.357417322002796,NaN,NaN,-68.09503307998952,-105.33557731433248,-0.20179619845344238,-0.3498376505704286,-0.14804145211698622,113529166,120878249.2,28.839255909840176,54.588211548089184,NaN,NaN,-10.124146532832894,-1.7749010227200606
2004-07-21T09:30:00-04:00,56.379995,56.445,54.51,54.51,18339000,12170240.9,37.15151246512643,44.3968854735621,NaN,NaN,-108.8390711551975,-104.90361086999788,-0.24865197738473516,-0.45885642384790515,-0.21020444646317,95190166,114222168,25.532990704333642,50.655693529761315,NaN,NaN,-12.958471796772178,-3.3725539904417916
2004-07-22T09:30:00-04:00,54.53,54.765,53.605005,54.6,18692398,12285930.7,37.90549063358968,43.17169580321409,NaN,NaN,-140.1050537868593,-113.28975165687885,-0.25732554078166714,-0.5318613724402539,-0.27453583165858675,113882564,109809686.4,23.60129609168243,46.60502743925124,NaN,NaN,-14.889197323684861,-5.017788752333659
2004-07-23T09:30:00-04:00,54.335,54.435,53.699995,53.82,18983398,12820000.6,34.0885986873985,41.590595997517426,NaN,NaN,-143.27367055525548,-118.3046980396035,-0.2965474192307645,-0.6452201056970424,-0.34867268646627786,94899166,104219645.6,21.39314784159278,42.545220789939705,NaN,NaN,-17.809614951855472,-6.84519249512249
2004-07-26T09:30:00-04:00,53.94,54.120005,52.855005,53.115,16630602,13016720.5,31.04569422838084,40.35028743657636,NaN,NaN,-162.96439078351577,-124.65544387216353,-0.34739809771584923,-0.7829203086110894,-0.4355222108952402,78268564,99153925.2,19.603238181215673,38.4480027511479,NaN,NaN,-21.278893020358495,-8.907149713013347
2004-07-27T09:30:00-04:00,53.39,54.345,53.339995,54.105005,16332602,13057890.4,39.24694753361626,39.73026957660336,NaN,NaN,-123.40973254350158,-135.71838376486593,-0.29390875638788105,-0.8029081563800915,-0.5089993999922104,94601166,95368325.2,18.366544702749863,34.75822454182201,NaN,NaN,-21.421592081971525,-10.694927194293086
2004-07-28T09:30:00-04:00,54.01,54.35,53.20075,54.06,20419796,13688730.2,39.019745960315454,39.56317787381513,NaN,NaN,-115.23176354493657,-136.99692224281375,-0.2432071544230231,-0.8130083430209893,-0.5698011885979662,74181370,91166566,17.078681558176825,31.864851656959456,NaN,NaN,-21.60404730658133,-12.253372924619978
2004-07-29T09:30:00-04:00,54.4,54.839995,54.125,54.699995,11042796,13694609.8,43.98572274266515,39.54088245768215,NaN,NaN,-66.90426746472089,-122.35676497838608,-0.1526412972231166,-0.760602810126862,-0.6079615129037454,85224166,85434886.4,15.483710767437515,29.127467276274185,NaN,NaN,-20.15392337098928,-13.382022988387021
2004-07-30T09:30:00-04:00,54.6,55.085,54.5,55,12371000,13475739.9,46.19756417409941,39.81978726389392,NaN,NaN,-40.79414558406937,-101.86085998414886,-0.06318637615708289,-0.686944483100099,-0.6237581069430161,97595166,85974086.4,16.27585050314002,26.977562596376437,NaN,NaN,-18.281768469801726,-14.081986628589123
2004-08-02T09:30:00-04:00,54.6,55.095,54.165,54.800005,12630000,13729359.9,44.924033746909565,39.961878988243186,NaN,NaN,-45.28236817842857,-78.32445546313141,-0.010881960493167253,-0.6373605575594752,-0.6264785970663079,84965166,87313406.8,18.323601939490445,25.187596120247264,NaN,NaN,-17.130379128514534,-14.51747127143561
2004-08-03T09:30:00-04:00,54.714995,54.775,53.99,54.015,14361204,13794450.2,40.23549446336832,39.920409659905815,NaN,NaN,-69.66662778200383,-67.57583451083187,-0.021913815109270818,-0.6538708659528965,-0.6319570508436256,70603962,82513966,16.743239088879037,23.527875685980714,NaN,NaN,-17.550060162900113,-14.95069825593054
2004-08-04T09:30:00-04:00,53.685,54.495005,53.35,53.97,19376204,14328050.2,39.977919422826524,39.775865435065576,NaN,NaN,-85.86179902751951,-61.70184160734847,-0.02478997253044679,-0.6629445165066841,-0.6381545439762373,51227758,77923243.6,15.377098380591022,21.77066311540862,NaN,NaN,-17.96194767792257,-15.380876744786544
2004-08-05T09:30:00-04:00,53.99,54.06,52.865,52.975,15888796,14443090,34.68990326869469,39.545682334768415,NaN,NaN,-123.97323028578842,-73.11563417156198,-0.08297380329219473,-0.7418717980914806,-0.6588979947992859,35338962,67946202.8,12.911425077297594,20.110993247398028,NaN,NaN,-19.978261686888665,-16.037646022229705
2004-08-06T09:30:00-04:00,52.35,52.504995,51.685,51.865,18657602,14803950.2,29.9331598005638,39.007161978860886,NaN,NaN,-195.7411166410285,-104.10502838295379,-0.17992323692082857,-0.8838020409503216,-0.703878804029493,16681360,51763441.6,10.086346233870827,18.54403049859271,NaN,NaN,-23.361224732041048,-17.083871552202755
2004-08-09T09:30:00-04:00,51.949995,52.120005,51.550005,51.699995,10383000,14664190,29.290194252762717,37.69228438430838,NaN,NaN,-183.46488372847742,-131.7415314929636,-0.23537049522869913,-0.9980919230653669,-0.7627214278366677,6298360,36030080.4,8.206339361124023,17.07025074511299,NaN,NaN,-26.25144081823726,-18.393524304493397
2004-08-10T09:30:00-04:00,51.76,52.865,51.725,52.51,18174000,15230970,36.50090318482878,37.645812292858544,NaN,NaN,-129.50721374900218,-143.70964868636324,-0.19913903980546954,-1.0116452275935046,-0.8125061877880351,24472360,26803760,7.342093732001501,15.770900961374975,NaN,NaN,-26.449669913974272,-19.54440224870495
2004-08-11T09:30:00-04:00,52.15,52.705,51.56,52.44,13079602,15255810.3,36.15774474923648,37.520973301119035,NaN,NaN,-123.66416815242961,-151.27012251134525,-0.16305044058480844,-1.0163192385190456,-0.8532687979342372,11392758,18836760,6.687183290529191,14.56275004700689,NaN,NaN,-26.710100322832613,-20.56807340215176
2004-08-12T09:30:00-04:00,52.095,52.205,51.5,51.685,10003398,15382260.2,32.598023936964324,37.414503676088025,NaN,NaN,-135.55948889714483,-153.58737423361654,-0.1722866796483491,-1.0686271474946736,-0.8963404678463245,1389360,12046839.6,6.181142748137788,13.47617825461725,NaN,NaN,-28.035445548554954,-21.634840851637932
2004-08-13T09:30:00-04:00,51.785005,52.04,51.335,51.675005,9649204,15209940.3,32.55233434591564,37.52212082734051,NaN,NaN,-122.74733013125591,-138.98861693166202,-0.1615103155211196,-1.098228362247724,-0.9367180467266044,-8259844,7058598.8,5.831981806049484,12.492517084962524,NaN,NaN,-29.10718494203367,-22.702318578837325
2004-08-16T09:30:00-04:00,51.78,52.685,51.714995,52.56,16554204,15075040.3,40.503973449851145,37.61190839278586,NaN,NaN,-74.02854475392769,-117.10134913675206,-0.08127106861768951,-1.0383068824987163,-0.9570358138810268,8294360,7457798.8,6.288206656987882,11.629778653122381,NaN,NaN,-27.629831738193122,-23.406249030173868
2004-08-17T09:30:00-04:00,52.96,53.225,52.67,52.89,10361398,15096510.2,43.193321079330495,37.910020901286934,NaN,NaN,-29.685085169564,-97.13692342086445,0.0030666424527956426,-0.9532025108150322,-0.9562691532678278,18655758,6294478.4,6.194030205822756,10.852303556525658,NaN,NaN,-25.590432088833293,-23.718275181410927
2004-08-18T09:30:00-04:00,52.574995,54.06,52.5,54.019995,13410204,14850070.4,51.30948187311816,38.43314655346215,NaN,NaN,17.45354115360399,-68.91338155965772,0.1365988917543136,-0.7855205385749358,-0.9221194303292494,32065962,10429119.2,11.279849334304203,10.55202773987328,NaN,NaN,-21.094873467073946,-23.343503507934216
2004-08-19T09:30:00-04:00,53.86,54.04,53.365,53.56,10120000,14421450.5,48.285171929915755,38.582261393163314,NaN,NaN,30.10858927681196,-35.77976592486636,0.19218455960362024,-0.6818887308247241,-0.8740732904283444,21945962,14540439.6,16.14808548277105,10.542901666989783,NaN,NaN,-18.320449822086243,-22.625924409955935
2004-08-20T09:30:00-04:00,53.56,54.699995,53.455,54.51,11926000,14068580.6,54.27894247075993,39.25046915915262,NaN,NaN,70.96119337273774,2.9619387759323983,0.2855454871235983,-0.5171414315238465,-0.8026869186474448,33871962,22966800.8,25.206583054785128,11.034543175225116,NaN,NaN,-13.914061288538527,-21.381372535467733
2004-08-23T09:30:00-04:00,54.735,54.92,54.105005,54.31,12612000,13867650.5,52.88917265569604,40.15430331574746,NaN,NaN,79.51883246564869,33.67141421984768,0.3236479521691642,-0.39812697843598954,-0.7217749306051537,21259962,25559921.2,27.7918000471702,11.823726100817343,NaN,NaN,-10.822034839726754,-19.87289572179045
2004-08-24T09:30:00-04:00,54.625,54.75,54.06,54.46,11565602,13629300.5,53.843700123435696,41.14471622293382,NaN,NaN,74.49289282834299,54.50700981942907,0.34671661247699315,-0.28837916500891225,-0.6350957774859054,32825564,28393882.4,30.61445962468686,12.912109046824188,NaN,NaN,-8.03345483879205,-18.18154702421925
2004-08-25T09:30:00-04:00,54.43,54.875,54,54.675005,14259398,13321280.6,55.24349952838627,42.612830241483216,NaN,NaN,76.40325088852548,66.29695176641337,0.36251130787899,-0.18195664263716793,-0.5444679505161579,47084962,31397682.4,33.57822786511663,14.388309245954117,NaN,NaN,-5.316503760702998,-16.343683700859785
2004-08-26T09:30:00-04:00,54.675005,54.865,54.4,54.449995,9472000,13242740.8,53.417680260566335,44.29029598862626,NaN,NaN,79.97220201688782,76.26967431442854,0.3440118730217766,-0.11445310923893715,-0.45846498226071375,37612962,34531082.4,36.6195344303792,16.283536974276142,NaN,NaN,-3.5470131511027567,-14.515587908037352
2004-08-27T09:30:00-04:00,54.574995,55.125,54.574995,54.879995,8073200,13027850.8,56.38435684585695,46.22559331670442,NaN,NaN,99.2905700008553,81.93554964005205,0.3460044479820218,-0.025959422283186484,-0.3719638702652083,45686162,36893922.4,38.8917662177059,18.475353178317707,NaN,NaN,-1.171658979819802,-12.609312346863415
2004-08-30T09:30:00-04:00,54.699995,54.9,54.199995,54.254995,10043000,12898500.8,51.27302286107164,47.28074472215034,NaN,NaN,73.51616806888336,80.73501676069898,0.2926203141735669,-0.006188477548249693,-0.29880879172181657,35643162,39770562.4,41.63513731169353,20.924856291152853,NaN,NaN,-0.5513415329102102,-10.886745087727244
2004-08-31T09:30:00-04:00,54.4,54.75,53.94,54.705,24710398,13415960.5,54.47313625481665,48.588986972548916,NaN,NaN,73.0410349571787,80.44464518646612,0.27526298344666195,0.04526993758651088,-0.22999304586015107,60353560,45276161.6,46.578314453761145,23.77422280281228,NaN,NaN,0.9141446907287998,-9.200903690804951
2004-09-01T09:30:00-04:00,54.545,55.545,54.545,55.125,20114398,13452870.2,57.29229034037899,50.352863144221395,NaN,NaN,104.55605192472981,86.075205393707,0.27885422587234204,0.1185747364802765,-0.16027948939206554,80467958,51952760.8,51.898742049560255,27.03976561005674,NaN,NaN,2.991681229541118,-7.459105845041227
2004-09-02T09:30:00-04:00,55.004995,56.1,54.97,56.095,9651602,13141010.5,62.99201238614819,52.52712586138086,NaN,NaN,127.7423541442425,95.62923581917792,0.3298515191591079,0.2520349095568193,-0.07781660960228858,90119560,62454080.4,58.84190652517038,30.826188804279663,NaN,NaN,6.668516775474072,-5.440874042110471
2004-09-03T09:30:00-04:00,55.824995,56.105005,55.199995,55.475,10964398,12756350.3,57.69210344644892,53.75484943256642,NaN,NaN,109.92174433522251,97.75547068605138,0.3056667605303016,0.30426684106058843,-0.0013999194697131706,79155162,69147880.4,62.55245344711358,34.845063575002925,NaN,NaN,8.143619686485758,-3.500232080882438
2004-09-07T09:30:00-04:00,55.905,56.324995,55.705,56.175005,11445204,12809460.5,61.61853973535659,55.07093647942543,NaN,NaN,127.95820063080383,108.64387719843546,0.3191701122402955,0.39756272083065625,0.07839260859036072,90600366,80139321.2,67.70154898282853,39.23845777336047,NaN,NaN,10.662891515622151,-1.476928709953211
2004-09-08T09:30:00-04:00,56.019995,56.535005,55.56,55.875,11916602,12496590.6,59.08757931545505,55.626514868163774,NaN,NaN,115.56519961009307,117.14871012901835,0.2910420181191814,0.4421951312393375,0.15115311312015609,78683764,83805362,69.22167607327052,43.37715968328663,NaN,NaN,11.93516877524163,0.4390852165031949
2004-09-09T09:30:00-04:00,55.86,56.74,55.85,56.339995,12042000,12444710.5,61.71260888462128,56.58561750778561,NaN,NaN,129.53257422713506,122.14401458949938,0.286451830649028,0.5092179014314411,0.22276607078241306,90725764,85856923.2,70.07059868189718,47.2287677689385,NaN,NaN,13.809751081690802,2.3491803401014244
2004-09-10T09:30:00-04:00,56.5,56.96,56.074995,56.86,11722398,12530660.5,64.4589424786133,57.31276036548941,NaN,NaN,142.02357129305625,125.00025801926213,0.29971310029609394,0.5974074461525305,0.29769434585643656,102448162,88322643.6,71.10224601100465,50.50702940866847,NaN,NaN,16.24456912480535,4.334235880773413
2004-09-13T09:30:00-04:00,56.925005,57.44,56.879995,57.165,13555398,12725970.2,65.99943858834828,58.24920793210743,NaN,NaN,157.67063903767882,134.5500369597534,0.30906391616551204,0.6840242410633266,0.37496032489781456,116003560,95692323.2,73.9882220957726,53.8067738407115,NaN,NaN,18.724838214710054,6.390036214192933
2004-09-14T09:30:00-04:00,57.135,57.18,56.58,57.050005,9152000,12355860,64.85798692245956,59.035942703466276,NaN,NaN,126.56013549169046,134.27042393193074,0.28796603124857156,0.734917863958529,0.4469518327099574,106851560,98942562,75.1661637982865,56.98903842454005,NaN,NaN,20.4260781444809,8.395185061376928
2004-09-15T09:30:00-04:00,56.870005,56.89,56.425005,56.705,10729204,12374250.3,61.425588258832214,59.477520469926695,NaN,NaN,96.7708827075334,130.51156055141877,0.23355444286859695,0.7388948862957037,0.5053404434271067,96122356,102430280.4,76.40113194927076,60.04781728769392,NaN,NaN,20.89833841818058,10.181349826634593
2004-09-16T09:30:00-04:00,56.925005,57.415,56.835,57.315,9656398,12186560,64.95682501164123,60.301745095003476,NaN,NaN,118.44162920212595,128.29337154641695,0.2215286861411203,0.782251301103507,0.5607226149623867,105778754,105440878.4,77.4438639233335,62.963840822904935,NaN,NaN,22.344566472852406,11.91895220466571
2004-09-17T09:30:00-04:00,57.300005,57.44,56.775,57.214995,12210000,12291060,63.92366929581725,60.840267412857784,NaN,NaN,105.6031719046435,121.00929166873443,0.19088418849746647,0.7993278505842198,0.6084436620867534,93568754,103664996.8,75.32943945099554,65.56653176813991,NaN,NaN,23.242421209451663,13.536590633920845
2004-09-20T09:30:00-04:00,56.955,57.339995,56.81,56.96,10989602,12244240.1,61.24861913852477,61.55281000410444,NaN,NaN,89.28603610649735,107.33237108249811,0.13985009656404046,0.7832562827918039,0.6434061862277635,82579152,96980115.2,67.8228043994658,67.4370794172665,NaN,NaN,23.260195838935136,14.92567709178003
2004-09-21T09:30:00-04:00,57.185,57.675005,57.105005,57.39,9600602,12093670.2,63.98557733835138,62.23227008149978,NaN,NaN,103.65410852708625,102.75116568957728,0.12210752733879615,0.7960405954012586,0.6739330680624624,92179754,94045754,64.77161056608986,68.73660056814713,NaN,NaN,24.03910552649528,16.227595439596495
2004-09-22T09:30:00-04:00,57.015,57.055,56.39,56.42,14979204,12264350.3,54.61473235327201,62.041015939563565,NaN,NaN,44.85543718317507,92.36807658470562,0.0365384972807119,0.7196061896633523,0.6830676923826404,77200550,90261392.8,60.96252528378632,69.38401365630612,NaN,NaN,21.876020082460613,17.03451324571994
2004-09-23T09:30:00-04:00,56.545,56.71,56.295,56.365,9478000,12025280.4,54.130654098242154,61.4080617761417,NaN,NaN,27.397284225682597,74.15920758941694,-0.028747290691851668,0.6471335790178259,0.6758808697096775,67722550,82650152,54.07476244747104,69.04350336504189,NaN,NaN,19.98789057228939,17.456424292372716
2004-09-24T09:30:00-04:00,56.5,56.795,56.324995,56.335,10655204,12084440.6,53.8502805848595,61.13364585745675,NaN,NaN,24.25391935408996,57.88935707930623,-0.07623658410582101,0.5805851395774013,0.6568217236832223,57067346,75349870.4,48.42356094078622,68.03429675744708,NaN,NaN,18.363635117637912,17.586025838839173
2004-09-27T09:30:00-04:00,56.185,56.199995,55.545,55.735,15948204,12478190.8,48.445681789342615,60.19272743274146,NaN,NaN,-41.974717805007856,31.63720629700519,-0.14628422205258274,0.47396644611749394,0.6202506681700767,41119142,67057868.4,42.93495945425367,66.26525464826315,NaN,NaN,15.323071785688134,17.262746688389026
2004-09-28T09:30:00-04:00,55.79,56.4,55.57,56.4,13527000,12652390.8,53.96083981534458,59.82653175416215,NaN,NaN,-24.88070386467899,5.930243818652148,-0.14573622433367506,0.43808038775298286,0.5838166120866579,54646142,59551146,38.66256555529417,64.08246103983628,NaN,NaN,14.24456034966805,16.831577211428886
2004-09-29T09:30:00-04:00,56.28,56.925005,56.235,56.925005,16073204,12220531.1,57.799154218370454,59.54699927800137,NaN,NaN,32.18783321386048,3.3967230247892326,-0.10957096830170521,0.4468529017095264,0.5564238700112316,70719346,58254905.2,37.960127699751965,61.78885596968304,NaN,NaN,14.48020979447445,16.495667580435395
2004-09-30T09:30:00-04:00,56.67,57.300005,56.655,56.925005,17295796,12079601,57.799154218370454,59.071300116555456,NaN,NaN,62.28959117408764,10.37518441447024,-0.08623220545341748,0.4486336131944597,0.5348658186478772,70719346,58854264.4,38.5163686029887,59.4612932976819,NaN,NaN,14.669291608344489,16.234756727279553
2004-10-01T09:30:00-04:00,57.285005,58.375,57.214995,58.36,16467602,12420401,66.62073213729734,59.115678227194685,NaN,NaN,194.1629405050813,44.35698864466851,0.019618272573060258,0.5593886593642026,0.5397703867911423,87186948,64878184.8,43.95518271619304,57.31607619914051,NaN,NaN,17.788278875895596,16.45668846279613
2004-10-04T09:30:00-04:00,58.800005,59.089995,58.6,58.69,13371398,12540751,68.26370208306105,59.35894359580907,NaN,NaN,253.5058053790366,103.45309328147741,0.10107372474613341,0.666112542723809,0.5650388179776756,100558346,76766025.6,52.82414700858826,55.7202178570192,NaN,NaN,20.853398281753517,17.084789865504327
2004-10-05T09:30:00-04:00,58.615,58.89,58.375,58.635,10255796,12481280.6,67.66590179559753,59.8046802770066,NaN,NaN,195.8911596249924,147.60746597941167,0.1381686498892042,0.7377496303391808,0.5995809804499767,90302550,83897307.2,57.19970551301864,54.348687397286916,NaN,NaN,23.10582689601265,17.944938012719803
2004-10-06T09:30:00-04:00,58.595,59.129995,58.44,59.015,9339796,12352440.3,69.64386559886727,60.13946889037988,NaN,NaN,184.24525029286934,178.01894939521347,0.17296044828257928,0.8157815408032008,0.6428210925206215,99642346,89681907.2,60.40757210397093,53.13180941018959,NaN,NaN,25.609484276931667,19.039873193321498
2004-10-07T09:30:00-04:00,58.875,58.935,58,58.03,10364602,12268570.4,59.485855988828,59.82248222559493,NaN,NaN,110.24048937306335,187.6091290350086,0.11697952492667019,0.7890454986789592,0.672065973752289,89277744,93393586.8,62.35712130321379,52.20521525677661,NaN,NaN,24.61010743440687,19.835620942047978
2004-10-08T09:30:00-04:00,57.824995,58.185,57.300005,57.300005,15495602,12457230.6,53.283114375185036,59.2535175996421,NaN,NaN,34.03900289304418,155.58434151260116,0.023045834006564125,0.7008732662604942,0.67782743225393,73782142,90712625.6,60.056797531648066,51.650500480503915,NaN,NaN,21.683779790572782,20.099643634694377
2004-10-11T09:30:00-04:00,57.495005,57.61,57.205,57.57,7916600,12175290.7,55.14602257564298,58.622120830877215,NaN,NaN,19.36572482927299,108.75632540264846,-0.0259872575357597,0.6453433603342305,0.6713306178699902,81698742,86940704.8,56.877715225983025,51.08665081335342,NaN,NaN,19.912050328659348,20.072844590975087
2004-10-12T09:30:00-04:00,57.105005,57.675005,56.79,57.435,14074602,12421420.8,53.98679723672379,58.577268322552335,NaN,NaN,2.192318899447356,70.01655725753945,-0.07009373211649794,0.5837134527243677,0.6538071848408656,67624140,82405022.8,53.22890048742328,50.53424904218463,NaN,NaN,18.132982145556458,19.79572138448671
2004-10-13T09:30:00-04:00,57.865,57.975,56.585,56.6,18067602,12788340.7,47.35599563739831,58.09336414677777,NaN,NaN,-24.299059832707748,28.30769523242402,-0.15331277122849152,0.46216622080525127,0.6154789920337428,49556538,72387861.2,46.1824077661253,49.97050942208851,NaN,NaN,14.417569267912093,19.027413939261766
2004-10-14T09:30:00-04:00,56.660005,56.865,56.230005,56.230005,13528204,12981931,44.734123745598225,57.442210086830535,NaN,NaN,-77.77352466292768,-9.29510757477418,-0.22665936492803607,0.33215478587369773,0.5588141508017338,36028334,61737979.2,40.103900676921626,49.3762479746696,NaN,NaN,10.514829468469708,17.81133044343433
2004-10-15T09:30:00-04:00,56.504995,57.125,56.144995,56.81,16297796,13186320.8,49.45803466280085,57.51452100636327,NaN,NaN,-50.23904837852571,-26.150717829088173,-0.2288304064716017,0.2727761427122317,0.5016065491838334,52326130,57446776.8,37.93717358171963,49.019263269488604,NaN,NaN,8.657748870655627,16.50367593303737
2004-10-18T09:30:00-04:00,56.660005,57.225,56.36,57.050005,14040602,13338870.8,51.312599205005284,57.325360962767604,NaN,NaN,-32.08382774447016,-36.440628343836806,-0.20745199797557923,0.24229155171435934,0.44974354968993857,66366732,54380374.8,36.422824517555725,48.859281766793,NaN,NaN,7.703922561568913,15.246568308541878
2004-10-19T09:30:00-04:00,57.265,57.54,56.4,56.46,14657602,13591720.8,46.769305304568,56.53751461178172,NaN,NaN,-36.18365760992345,-44.11582364571096,-0.2249304160015959,0.16858052968794368,0.3935109456895396,51709130,51197372.8,34.86697428665353,48.638342237285976,NaN,NaN,5.469887317131351,13.849899595483231
2004-10-20T09:30:00-04:00,56.269995,56.945,56.035005,56.754995,14972602,13591390.7,49.19159470078075,55.92268893195388,NaN,NaN,-55.94489666481491,-50.444991012132405,-0.20885599815971823,0.1324409479898918,0.34129694614961004,66681732,54622411.6,37.93900914922024,48.59710227630251,NaN,NaN,4.350607283064322,12.492857836566245
2004-10-21T09:30:00-04:00,56.870005,57.574995,56.565,57.475,10626398,13648810.6,54.61957199537166,55.06546320753062,NaN,NaN,-2.7803152396138913,-35.446349127469645,-0.14499479000110538,0.1600534586482283,0.30504824864933366,77308130,62878370.8,44.708694124223484,48.650924519733245,NaN,NaN,5.06776366206436,11.43213009735169
2004-10-22T09:30:00-04:00,57.475,57.65,56.455,56.495005,16834000,13957750.4,47.22449335897735,53.562662584381776,NaN,NaN,-37.26792554481149,-32.8521245607268,-0.1626890135474343,0.10168698171504076,0.26437599526247507,60474130,64507970.8,45.961690091477735,48.16074902565392,NaN,NaN,3.2637672881572954,10.265221124609633
2004-10-25T09:30:00-04:00,56.394995,57.225,56.28,57.1,15370398,13928860.1,51.58269872825749,52.41386236528605,NaN,NaN,-44.78359330358214,-35.39207767254919,-0.129051881113701,0.10306114387034881,0.23211302498404981,75844528,66403530,47.453380266558455,47.46458293662105,NaN,NaN,3.199963868040302,9.255898659385442
2004-10-26T09:30:00-04:00,57.125,57.85,56.49,57.85,15696398,14037330,56.390540292264575,51.46719627195729,NaN,NaN,2.9911204593916514,-27.557122058686172,-0.05545654758673588,0.16279234050062996,0.21824888808736584,91540926,74369889.2,53.289194319612086,46.95612738059542,NaN,NaN,4.765109010466523,8.614357280968454
2004-10-27T09:30:00-04:00,57.68,58.589995,57.589995,58.415,18692000,14168269.8,59.64181082891536,51.4783359033921,NaN,NaN,79.86762643172906,-0.3946174393773731,0.02764595215585397,0.2528063282821833,0.22516037612632933,110232926,83080128,58.69118971482888,46.694275124282214,NaN,NaN,7.143659320717333,8.404257572361152
2004-10-28T09:30:00-04:00,58.475,58.54,57.925005,58.199995,10728398,13839899.9,57.873585580108966,51.80622670374381,NaN,NaN,72.70619341545232,14.702684291635865,0.06250988155784087,0.3032977280736304,0.24078784651578955,99504528,87519407.6,61.156770853197884,46.772844647250054,NaN,NaN,8.486281259197314,8.415975241909175
2004-10-29T09:30:00-04:00,58.245005,58.56,57.875,58.095,11972796,13615159.6,56.98509508616602,51.93758902592403,NaN,NaN,65.9713850394413,35.35054640848643,0.07218929334963808,0.3310244632028372,0.2588351698531991,87531732,92930928,63.979190367134194,47.28009287161799,NaN,NaN,9.298439583811936,8.542041576466712
2004-11-01T09:30:00-05:00,58.269995,58.625,57.86,58.555,13357796,13614479.5,59.890418120954614,52.35927623194051,NaN,NaN,88.78409682199982,62.064084433602815,0.10146825361468953,0.385670486871561,0.2842022332568715,100889528,97939928,66.4119930640033,48.221742341373705,NaN,NaN,10.86439045306892,8.873805701695598
2004-11-02T09:30:00-05:00,58.635,59.03,58.07,58.324995,12997000,13751539.7,57.78866243281249,53.10446671732724,NaN,NaN,104.5390834022412,82.37367702217273,0.09723120588072809,0.4057412406077816,0.3085100347270535,87892528,97210248.4,65.71570580003066,49.61697791522409,NaN,NaN,11.554843723378335,9.256811133364561
2004-11-03T09:30:00-05:00,59.21,59.550005,58.86,59.265,18907000,14229899.9,63.43613976573145,54.44032500447961,NaN,NaN,175.8882468464765,101.57780110512222,0.14665478194681592,0.49182851216057344,0.3451737302137575,106799528,96523568.8,65.02478622874227,51.39704116892556,NaN,NaN,13.946807271415167,9.926810581657504
2004-11-04T09:30:00-05:00,59.275,60.035005,58.915,59.99,12553602,14339349.9,67.0929836167054,55.6999642154728,NaN,NaN,189.1665482050296,124.86987206303768,0.2130655591833725,0.6115056791929732,0.39844012000960066,119353130,100493289.2,67.17347579810746,53.48534847009612,NaN,NaN,17.194775603395186,10.965091299048602
2004-11-05T09:30:00-05:00,60.199995,60.625,59.82,60.26,10656602,14097399.9,68.36201856890278,56.91777988432261,NaN,NaN,189.68149104510383,149.6118932641702,0.2571195657903237,0.7198395772475052,0.46272001145718156,130009732,108988889.2,71.24490531195566,55.97263995541039,NaN,NaN,20.237902242532414,12.289778576689146
2004-11-08T09:30:00-05:00,60.24,60.435,59.885,60.050005,5433200,13973229.9,66.22295588475683,58.3073263543361,NaN,NaN,150.65039005551156,161.98515191087253,0.25363321082258306,0.7797615249854104,0.5261283141628273,124576532,113726290,73.23818542391282,58.71344075092892,NaN,NaN,22.100867019456015,13.691362639941556
2004-11-09T09:30:00-05:00,60.074995,60.574995,60,60.265,6608800,13599939.8,67.34938555481611,59.60431141533862,NaN,NaN,138.1396007238755,168.70525537519939,0.24707602627170633,0.8349733470024603,0.587897320730754,131185332,122384850.8,76.45119923341886,61.46431147122882,NaN,NaN,23.975280087557117,15.160493703886635
2004-11-10T09:30:00-05:00,60.375,61.07,60.300005,60.699995,11236204,13258369.9,69.56120885788279,60.671571191232275,NaN,NaN,142.79382654512565,162.0863713149292,0.2524145934770273,0.9034155625770381,0.6510009691000108,142421536,129509252.4,78.71556474371238,63.893373658335165,NaN,NaN,26.23784850801365,16.742972961619067
2004-11-11T09:30:00-05:00,60.805,61.49,60.75,61.300005,8648796,13014399.5,72.34415563203312,62.46583278216484,NaN,NaN,146.62076082523743,153.57721383897078,0.27488489878778055,0.9946070925847366,0.719722193796956,151070332,135852692.8,80.51235828188663,66.36127852907866,NaN,NaN,29.062358645108965,18.502885202117625
2004-11-12T09:30:00-05:00,61.36,62.025,61.175005,61.925005,12643000,12831659.7,74.91672960488867,64.13254927335278,NaN,NaN,146.9892896988099,145.038773569712,0.30788340024225125,1.10457644409977,0.7966930438575188,163713332,142593412.8,82.22912384460125,68.84526021322458,NaN,NaN,32.32113310154677,20.476920616321788
2004-11-15T09:30:00-05:00,61.949995,62.275,61.675005,62.275,9392000,12599229.6,76.24910741327676,65.55101835342506,NaN,NaN,141.11193216746028,143.13108199210174,0.3274990299151377,1.2060668312514409,0.8785678013363032,173105332,152299172.8,84.36491981723633,71.0649548916263,NaN,NaN,35.45396981750925,22.61649907363428
2004-11-16T09:30:00-05:00,62.019995,62.135,61.525,61.725,11707796,12451739.3,69.96013881687638,66.28804178113657,NaN,NaN,114.52147497361186,138.40745684204904,0.2795162362208936,1.2279630966124202,0.9484468603915266,161397536,158341613.6,85.53082251281673,72.982071520054,NaN,NaN,36.24164592826478,24.56294862429578
2004-11-17T09:30:00-05:00,62.025,62.67,61.805,62.055,14989204,12452569.4,71.48008703171764,67.25993474196576,NaN,NaN,117.77844104344884,133.40437974171365,0.24720186780934972,1.2574491951532139,1.0102473273438641,176386740,165134654.4,86.72895240251717,74.80865591643395,NaN,NaN,37.35250004431845,26.390027398584735
2004-11-18T09:30:00-05:00,62.07,62.19425,61.629995,61.96,12536204,12548059.7,70.37613392895827,68.21643751645092,NaN,NaN,97.3868549381291,123.55759856429202,0.1987162072232178,1.2586425863728863,1.0599263791496685,163850536,167690695.2,87.1597965576448,76.46441350147042,NaN,NaN,37.94294760554566,28.040444571007725
2004-11-19T09:30:00-05:00,61.94,61.975,61.06,61.300005,11446204,12278669.9,63.08653024985961,68.44473123994415,NaN,NaN,69.96175894540288,108.1520924136106,0.10612681703764548,1.1925849004467253,1.0864580834090798,152404332,165428895.2,84.54420489568068,77.75957148944738,NaN,NaN,36.28702238247116,29.2185271155025
2004-11-22T09:30:00-05:00,61.074995,62.025,61.050005,61.949995,13930204,12206660.2,66.74034833712354,69.08413737596638,NaN,NaN,75.09564179577504,94.94883433927355,0.07410605025352579,1.179090646225987,1.1049845959724611,166334536,164074736,82.93942684933876,78.98983727868368,NaN,NaN,35.938958609748504,30.178588757537643
2004-11-23T09:30:00-05:00,61.964995,62.375,61.394995,62.335,21859398,12514810.2,68.715650583751,69.4612452915392,NaN,NaN,85.50260861440368,89.14506106743191,0.0646474783894686,1.1857939439592968,1.1211464655698282,188193934,169434015.6,84.21633690392844,80.36066232691125,NaN,NaN,36.24180580130035,31.044762620932314
2004-11-24T09:30:00-05:00,62.4,62.949995,62.324995,62.71,11408602,12150640.3,70.55027308073456,69.70819453896986,NaN,NaN,107.83556905900701,87.15648667054354,0.06904044675903931,1.2074470240186272,1.138406577259588,199602536,174077174.8,85.24660555629053,81.65160016678148,NaN,NaN,37.04630635094018,31.902126010933436
2004-11-26T09:30:00-05:00,62.824995,63.199995,62.75,62.800005,6176600,11923050.4,70.99000430313927,69.89590780570104,NaN,NaN,112.03052642231142,90.08522096738,0.0635399332938218,1.217831493876865,1.1542915605830433,205779136,182462894.8,86.9086362493215,82.77043809087903,NaN,NaN,37.828229221100756,32.74871218381448
2004-11-29T09:30:00-05:00,63.21,63.54,62.475,62.975,17324796,12190650.4,71.8694871394966,70.29923146675388,NaN,NaN,109.88131431983882,98.06913204226717,0.05740576597524738,1.2260487680521024,1.168643002076855,223103932,196602814.8,89.13190426358503,83.90570372228419,NaN,NaN,38.72865950167822,33.60299037208073
2004-11-30T09:30:00-05:00,63.230005,63.49,63.06,63.44,14477398,12246630.5,74.11511572436613,70.78249790743602,NaN,NaN,123.64322220997856,107.77864812510788,0.06957260212715854,1.2556087547358032,1.1860361526086447,237581330,210852173.6,90.82323845942167,84.93227795271297,NaN,NaN,40.1623538269017,34.54004229419802
2004-12-01T09:30:00-05:00,63.405,64.324995,63.339995,64.03,19120204,12552790.7,76.66093448743003,71.2896211666894,NaN,NaN,153.40278951466823,121.35868430516079,0.10039098499307131,1.3115248838499838,1.2111338988569125,256701534,224553693.6,92.09684324031029,85.88808355961282,NaN,NaN,42.19271772521568,35.633281641486256
2004-12-02T09:30:00-05:00,64.004995,64.405,63.775,63.94,12885204,12251700.9,75.4420296507783,71.51089788231407,NaN,NaN,152.0200256342871,130.19557562021683,0.09765942268619066,1.333208177214651,1.2355487545284602,243816330,233396452.4,92.79211822207445,86.76520926962624,NaN,NaN,43.51245587926523,36.75887796116897
2004-12-03T09:30:00-05:00,63.955,64.410005,63.82,63.82,13313796,12289710.6,73.75808146991362,71.4281373012444,NaN,NaN,136.30078595041374,135.04962752583725,0.07190548223197668,1.325430607318431,1.2535251250864543,230502534,238341132,93.15476151496924,87.54561196036681,NaN,NaN,44.151987417761255,37.81503645496787
2004-12-06T09:30:00-05:00,63.99,64.074995,63.425005,63.519995,6254600,12069610.5,69.57677878208366,70.95154239901633,NaN,NaN,99.29582093910543,132.93252884969058,0.021420239573081146,1.2803004245528058,1.2588801849797246,224247934,238569932.4,93.1718804371908,88.17468057607785,NaN,NaN,43.550003674168366,38.63431748628222
2004-12-07T09:30:00-05:00,63.735,63.86,62.355005,62.405,13218204,12458860.7,56.70949483313348,70.00506782874898,NaN,NaN,36.97883035940475,115.59965047957583,-0.0939791632332978,1.1414062309381023,1.2353853941714001,211029730,233259612.4,87.69051148979946,88.32894407443374,NaN,NaN,38.902869978397284,38.672682128012944
2004-12-08T09:30:00-05:00,62.5,63.1,62.300005,63.1,11617000,12709270.7,61.49018469392873,69.29150337604977,NaN,NaN,27.09352469391342,90.33779751542487,-0.1282922266955706,1.0750201108019368,1.2033123374975074,222646730,226448651.6,81.10030484432593,87.92689782027723,NaN,NaN,36.36432813561251,38.34291727195574
2004-12-09T09:30:00-05:00,62.685,62.964995,61.949995,62.620005,18757602,13085340.6,56.82296345131239,68.32341977050365,NaN,NaN,-6.963175093636445,58.541157369840164,-0.1846762280360108,0.9724670524524939,1.1571432804885047,203889128,218463211.2,74.07162920623398,86.9920287237479,NaN,NaN,32.71918888656701,37.5395275026145
2004-12-10T09:30:00-05:00,62.504995,63.300005,62.415,63.1,10605204,13183161,60.08558737887688,68.10906670829058,NaN,NaN,25.859649018884305,36.4529299835343,-0.19025288956477748,0.9193271685325328,1.1095800580973103,214494332,215261570.8,71.39981375965678,86.05314364260333,NaN,NaN,30.701274071465345,36.56263415530748
2004-12-13T09:30:00-05:00,63.425005,63.79,62.97,63.79,11161398,13109080.9,64.26577361326628,67.93231137087221,NaN,NaN,75.76144650827871,31.746055097368945,-0.1498565036794468,0.9222594284980019,1.0721159321774487,225655730,215543130,71.49718353992189,85.23584054907356,NaN,NaN,30.33401498204451,35.672831416269915
2004-12-14T09:30:00-05:00,63.730005,64.315,63.699995,64.135,11281796,13203570.7,66.1733401371928,67.75071776754662,NaN,NaN,117.35043560478981,47.82037614644596,-0.10443828835321556,0.9415680717359294,1.046006360089145,236937526,220724689.2,73.29879686263394,84.45601626040965,NaN,NaN,30.646130706962882,34.95473131494034
2004-12-15T09:30:00-05:00,64.155,64.745005,64.105005,64.67,10572796,13146820.7,68.94210863324798,67.63584887844044,NaN,NaN,142.92444418242695,70.98656004414866,-0.04588999340966815,0.9886438683270597,1.034533861736728,247510322,225697407.6,74.93614051633593,83.71955447184146,NaN,NaN,31.8029446930015,34.50447608323479
2004-12-16T09:30:00-05:00,64.625,64.714995,63.83,64.165,13787000,13086710.5,63.646404849599115,67.11130606033042,NaN,NaN,102.98909821805553,92.97701470648705,-0.04844699509411177,0.9739751178690881,1.0224221129631998,233723322,231664246.4,76.776378839175,82.99582179968813,NaN,NaN,31.07727864195094,34.01487644876567
2004-12-17T09:30:00-05:00,63.975,64.275,63.675005,63.905,19289000,13424350.3,61.04644779995633,66.33823182179184,NaN,NaN,69.42652745269709,101.69039039324961,-0.07342382250814805,0.9306423348280148,1.004066157336163,214434322,231652244.4,76.7641698788597,82.11241220077919,NaN,NaN,29.677292618524504,33.39522161587407
2004-12-20T09:30:00-05:00,64.045,64.47,63.51,63.83,11991602,13451620.2,60.2814701776632,65.35011428274163,NaN,NaN,61.96781873584757,98.9316648387634,-0.09917002023012833,0.8801036320485025,0.9792736522786308,202442720,227009642.4,71.99496790662253,80.76753573272211,NaN,NaN,28.32350668853011,32.67069091196779
2004-12-21T09:30:00-05:00,63.949995,64.53,63.805,64.504995,9145204,13212370.2,64.58301008626142,64.48740539694387,NaN,NaN,90.41682933429405,93.54494358466424,-0.07595982881672014,0.8843238662577306,0.9602836950744508,211587924,221939722,67.09280776973759,78.98153319910978,NaN,NaN,28.433459827669243,32.065372185639426
2004-12-22T09:30:00-05:00,64.51,64.925005,64.44,64.629995,7294400,12484120.3,65.33179365407248,63.76524568289346,NaN,NaN,124.51667983323972,89.86339071482679,-0.05820770591945379,0.8875240626751335,0.9457317685945873,218882324,216214122.4,61.961677561599764,76.77935886621871,NaN,NaN,28.743223529080364,31.590779520416703
2004-12-23T09:30:00-05:00,64.574995,64.85,64.535005,64.589995,8365000,12331940.2,64.85923994731351,63.12961414556488,NaN,NaN,114.41479475403673,92.14853002202304,-0.05520443763793126,0.8767262215471732,0.9319306591851044,210517324,211572922.8,58.08386735790288,74.27429499785684,NaN,NaN,28.864654820301126,31.201333134685907
2004-12-27T09:30:00-05:00,65,65,63.824995,64.175005,10337000,12539960.2,60.00959843260517,62.44624412060214,NaN,NaN,70.16468117617212,92.29616076671803,-0.08540806565765013,0.8251705771130418,0.9105786427706919,200180324,208722123.2,55.774871844008366,71.60308009834381,NaN,NaN,27.595118511304236,30.686159617059953
2004-12-28T09:30:00-05:00,64.230005,65.1,64.230005,65.025,8985204,12122980.6,65.67142968267146,63.08638232414056,NaN,NaN,117.71034727956842,103.44466647546221,-0.05391875914226962,0.8431801938428549,0.8970989529851245,209165528,210066684.8,56.65016535223575,69.38591251708927,NaN,NaN,28.15173012736953,30.324098261389892
2004-12-29T09:30:00-05:00,65.01,65.199995,64.805,65.019995,9263398,11862280.6,65.61252357973288,63.38083510169799,NaN,NaN,134.80748995909155,112.32279860042172,-0.03985344873756791,0.8472821420631647,0.8871355908007326,199902130,207729526,54.62631357664533,67.49491314082636,NaN,NaN,28.580719704909914,30.075044181892753
2004-12-30T09:30:00-05:00,65.105005,65.199995,64.79,64.79,7995000,11306020.4,62.82379046858702,63.8094656029319,NaN,NaN,110.63670531059202,109.54680369589218,-0.05171399046052516,0.8224931027250761,0.8742070931856013,191907130,202334487.2,50.170594502286875,65.78769637625872,NaN,NaN,28.15219497898811,29.800351438620662
2004-12-31T09:30:00-05:00,64.94,65.33,64.68,64.75,15082398,11415880.1,62.32762439465577,63.96961110405896,NaN,NaN,98.30846222321921,106.32553718972868,-0.06695970115218697,0.7905074667453675,0.8574671678975545,176824732,195595968.8,45.21029624993658,63.91701655413584,NaN,NaN,27.66334062233004,29.495064179150575
2005-01-03T09:30:00-05:00,65.095,65.21,63.57,63.910005,16097204,11555050.5,52.88234096652586,63.15650877214893,NaN,NaN,20.577337219581924,96.40806839841065,-0.13442916208733302,0.6894307152883883,0.8238598773757213,160727528,187705409.6,40.19846889453825,61.681394079465576,NaN,NaN,24.372521646345337,28.763272388749826
2005-01-04T09:30:00-05:00,64.035005,64.085,62.43,62.54,27452796,12614960.3,41.765482876028045,61.41309039635144,NaN,NaN,-101.73212274171539,52.51957439415389,-0.26461220605008595,0.49309461981311387,0.7577068258631998,133274732,172527250.4,32.691148760707335,58.78084778647081,NaN,NaN,17.30888628317439,27.126931516524763
2005-01-05T09:30:00-05:00,62.47,62.64,61.29,61.29,29937204,13450910.3,34.61536980594576,58.96118048011557,NaN,NaN,-205.64550674482962,-15.571024946630349,-0.4190169551191708,0.23393563196423628,0.6529525870834071,103337528,153214330,26.029829147388682,55.28753983154602,NaN,NaN,8.313074631962259,24.439237675872977
2005-01-06T09:30:00-05:00,61.67,62.199995,61.225,61.615,23061796,14023150.1,37.60622046516278,57.1011673097987,NaN,NaN,-185.4132011598202,-74.7810062407128,-0.47904140269658513,0.054150833712675706,0.5331922364092608,126399324,140112768.8,22.65701395908698,51.421870911539735,NaN,NaN,2.377352396252481,21.287539778784335
2005-01-07T09:30:00-05:00,61.754995,61.949995,60.894995,60.93,20906204,14130580.2,34.06893943931786,55.174202426895945,NaN,NaN,-194.08538262246614,-133.25977520984986,-0.5401275332205764,-0.1419671801164597,0.3981603531041167,105493120,125846446.4,19.66843520602842,47.343604149194654,NaN,NaN,-3.7699113719758786,17.707903900104306
2005-01-10T09:30:00-05:00,61,62.1,60.949995,61.550005,23451398,14772889.9,39.606160020287405,53.69739455851197,NaN,NaN,-151.22512616054692,-167.62026788587565,-0.5141634398700143,-0.24454394673340119,0.2696194931366131,128944518,119489844.4,18.497652450880693,43.52236733092737,NaN,NaN,-6.879486136654178,14.195419609138808
2005-01-11T09:30:00-05:00,61.245005,61.285005,60.625,60.800005,23338204,15381730.2,35.70023751082469,51.6343393745522,NaN,NaN,-156.05179387280768,-178.4842021120941,-0.521257669349521,-0.3819525935502881,0.13930507579923285,105606314,113956160.8,17.519935813931113,39.98144790551263,NaN,NaN,-10.824770989426698,10.621106666486593
2005-01-12T09:30:00-05:00,60.89,61.25,60.129995,61.050005,24793204,16057300.6,37.89872906783797,49.674834761249734,NaN,NaN,-132.88521749649993,-163.93214426242815,-0.4836946084150987,-0.46531318471964056,0.018381423695458143,130399518,119368558.8,21.869797277530722,37.11774217093627,NaN,NaN,-13.197976139943743,7.21838055128226
2005-01-13T09:30:00-05:00,61.144995,61.435,60.574995,60.865,18940602,16475690.9,36.893436021400284,47.67727733797022,NaN,NaN,-107.7877149268485,-148.40704701583383,-0.44676890572396755,-0.5400797084595013,-0.09331080273553374,111458916,116380477.2,21.204906648695967,34.4835306917072,NaN,NaN,-15.402447811747175,3.9868336422780546
2005-01-14T09:30:00-05:00,61.045,61.550005,60.915,61.445,13541000,16463390.9,42.080504853538486,46.39662779660831,NaN,NaN,-81.30970476847303,-125.8519114450352,-0.3623392845669259,-0.5462349084441911,-0.1838956238772652,124999916,120281836.4,24.43513720260033,32.24497821732091,NaN,NaN,-15.629427520505407,1.1845106190232744
2005-01-18T09:30:00-05:00,61.300005,62.405,61.21,62.175005,16796602,16338771,47.886542998397644,45.126278747731604,NaN,NaN,-48.523384901358106,-105.31156319319743,-0.24216225468946737,-0.4865984422390994,-0.24443618754963206,141796518,122852236.4,26.570990761754928,30.096465746572285,NaN,NaN,-13.933298860590776,-0.9751764494930186
2005-01-19T09:30:00-05:00,62.144995,62.375,61.285005,61.285005,20195000,16748940.9,42.31700812953978,43.4623133584321,NaN,NaN,-54.99736459841867,-85.10067733831963,-0.20871231776785004,-0.5053265847594446,-0.29661426699159454,121601518,126051277.2,29.251233909373823,28.283960056052887,NaN,NaN,-14.297992604982282,-2.878435900277199
2005-01-20T09:30:00-05:00,61.07,61.485,60.815,60.92,29673398,17775350.6,40.24944477716026,41.84986009475876,NaN,NaN,-72.36714904774502,-72.99706364856864,-0.19739509148848988,-0.5433581313522069,-0.345963039863717,91928120,118356997.6,26.72455594959267,26.60924301657473,NaN,NaN,-15.255421695331291,-4.646576728142069
2005-01-21T09:30:00-05:00,61.025,61.49,60.574995,60.78,22310000,18526130.6,39.45321183672438,40.215973483477946,NaN,NaN,-71.64775836047657,-65.76907233529425,-0.18573429037050604,-0.5781309028268495,-0.3923966124563435,69618120,109988838.4,24.269234116104087,25.113452864158123,NaN,NaN,-16.262430544571775,-6.305984416203455
2005-01-24T09:30:00-05:00,60.96,61.25,60.085,60.315,18551796,19035470.4,36.84597826939586,39.070519005111514,NaN,NaN,-83.60252125537426,-66.2276356326745,-0.1947868363857947,-0.6358801579385869,-0.4410933215527922,51066324,95202120,20.657595776457683,23.71767621286665,NaN,NaN,-17.903439663666628,-7.962763737269623
2005-01-25T09:30:00-05:00,60.58,61.1,60.230005,60.47,22059204,19621580.6,38.30943455441607,38.82365841071066,NaN,NaN,-77.20291916192207,-71.9635424847873,-0.17633664751085099,-0.6615141309413559,-0.48517748343050493,73125528,81467922,17.98102456135925,22.666953055770357,NaN,NaN,-18.81548174494128,-9.51315202407986
2005-01-26T09:30:00-05:00,60.71,61.449995,60.56,61.275,18353000,20089970.4,45.387573457003704,39.59310152864337,NaN,NaN,-50.36085496804406,-71.03624055871236,-0.09973207824115193,-0.6098425812319448,-0.5101105029907929,91478528,75443324,16.94392038590628,22.01795957280733,NaN,NaN,-17.454210299338225,-10.64758892054534
2005-01-27T09:30:00-05:00,61.19,61.865,61.074995,61.449995,21003796,20676990.3,46.81612127019546,40.25095158614571,NaN,NaN,-24.714069986346097,-61.50562474643258,-0.03067134579516606,-0.5484496852347505,-0.5177783394395844,112482324,79554164.8,20.3209835327921,21.851100256643413,NaN,NaN,-15.916599510007837,-11.400304719039983
2005-01-28T09:30:00-05:00,61.65,61.65,60.685,61.4,21107796,21332630.1,46.44235239584637,41.134766797326314,NaN,NaN,-34.9003784857085,-54.15614877147897,0.015752348184762344,-0.49808790420863147,-0.5138402523933938,91374528,83905446.4,23.850428642431254,22.149814073529324,NaN,NaN,-14.765376728520888,-11.88102929182297
2005-01-31T09:30:00-05:00,61.76,62.25,61.57,62.120005,22814602,21719240.3,52.34334272721092,42.04456556210656,NaN,NaN,55.61663195714788,-26.31231812897454,0.09465767660825042,-0.39551815663308076,-0.4901758332413312,114189130,96530007.6,33.108437522864094,23.193441578671003,NaN,NaN,-11.971327180557296,-11.893928990213587
2005-02-01T09:30:00-05:00,62.125,62.685,62.03,62.47,20307796,21929769.9,54.94221117252114,43.41899225222774,NaN,NaN,139.34902854575262,16.99807141256037,0.16595659874485047,-0.28273008481026807,-0.44868668355511854,134496926,108804287.2,40.66193229737015,24.846441327488076,NaN,NaN,-8.83228627088582,-11.456551458881048
2005-02-02T09:30:00-05:00,62.56,62.995005,62.46,62.945,17768602,21445560.2,58.26836671529829,44.873966369903485,NaN,NaN,203.15026255462843,67.70029491709487,0.2363496438745485,-0.15324962871193293,-0.3895992725864814,152265528,120961687.2,47.040849696471,26.64437364312667,NaN,NaN,-5.122680552658971,-10.55171275799218
2005-02-03T09:30:00-05:00,62.78,62.85,62.125,62.6,14928796,20695139.8,55.08756619731581,46.1735470967546,NaN,NaN,144.17980925527706,101.4790707654195,0.24961561012388633,-0.07757975993162347,-0.3271953700555098,137336732,125932568.8,49.43441884275189,28.660767371273526,NaN,NaN,-2.8951570648219205,-9.457919087539285
2005-02-04T09:30:00-05:00,62.605005,63.53,62.53,63.39,19564000,20520250,60.41617703584317,47.48323796691921,NaN,NaN,185.67930362543177,145.59500718764755,0.2982441301602168,0.04560979264476117,-0.2526343375154556,156900732,139037809.6,55.18515142294034,30.85719695844067,NaN,NaN,0.762264085414292,-7.997892919974488
2005-02-07T09:30:00-05:00,63.525,63.775,63.089995,63.375,12354398,20092659.7,60.26996027118191,48.3677677721181,NaN,NaN,173.33785418873185,169.13925163396434,0.31443504837415864,0.1404094729522427,-0.17402557542191593,144546334,145109250.4,57.59146846591213,33.07294536588047,NaN,NaN,3.6516053723582256,-6.333678878212671
2005-02-08T09:30:00-05:00,63.355005,63.730005,63.300005,63.53,10691000,19454639.8,61.31190900745258,49.724546406254724,NaN,NaN,150.58155974509788,171.3857578738334,0.31957829326969517,0.225447291165203,-0.09413100210449214,155237334,149257332,59.20321613600216,35.212372667782496,NaN,NaN,6.353905547754156,-4.5211668173602675
2005-02-09T09:30:00-05:00,63.74,63.75,62.175005,62.175005,27452602,19660359.7,49.171541041160594,50.36183899654046,NaN,NaN,73.0460272676479,145.36491081643732,0.22043471631126477,0.1814123932845888,-0.03902232302667595,127784732,144361172.8,56.47491487155784,37.337398305065726,NaN,NaN,5.115820433026936,-3.1444543530192384
2005-02-10T09:30:00-05:00,62.370005,62.615,61.905,62.285005,20380000,19439699.5,50.03646875448307,51.11778591923751,NaN,NaN,32.91840789048928,123.11263054347974,0.15411359301411753,0.15361966824097095,-0.0004939247731465674,148164732,146526772.8,57.40981231871169,39.70458246239484,NaN,NaN,4.388838525410134,-2.0682696561007567
2005-02-11T09:30:00-05:00,62.324995,63.370005,61.879995,63.300005,18049204,19395129.6,57.26307199631696,52.576149756874734,NaN,NaN,74.27405748092599,100.83158131457859,0.1692453403715042,0.2110627506912337,0.04181741031972949,166213936,148389413.6,58.24064520189663,42.389085992783336,NaN,NaN,6.081672389351436,-0.903992221036158
2005-02-14T09:30:00-05:00,63.199995,63.5,62.86,63.245005,8975000,19166829.6,56.78379473048323,53.8957469123081,NaN,NaN,92.80406280358837,84.72482303754987,0.16596629319989858,0.2492752768196027,0.08330898361970414,157238936,150927934,59.402988503681854,45.34779770294923,NaN,NaN,7.270570163145619,0.26380240527552434
2005-02-15T09:30:00-05:00,63.324995,63.68,62.915,63.300005,14453796,19049689.3,57.16984733949295,54.73733790391447,NaN,NaN,89.84458272874134,72.57742763427856,0.15796128203119608,0.28076058615869925,0.12279930412750317,171692732,154219013.6,60.921644228938156,48.48906369173722,NaN,NaN,8.341839964330639,1.4178077708548265
2005-02-16T09:30:00-05:00,63.199995,63.9,62.975,63.49,18863398,18983109.2,58.54742331261002,55.57528804980122,NaN,NaN,92.4558875288369,76.45939968651635,0.1556688039124034,0.31738530901800743,0.16171650510560404,190556130,166773293.2,66.12706862286545,51.760926912456746,NaN,NaN,9.62759725672846,2.5906348402653454
2005-02-17T09:30:00-05:00,63.699995,63.835,62.875,62.93,17347602,18366819.4,53.12384430973478,56.052537472221836,NaN,NaN,68.8487177011958,83.64546164865764,0.10885927686265809,0.29779060118392664,0.18893132432126855,173208528,171782052.4,67.96075546032532,54.911664542306326,NaN,NaN,9.187283887744723,3.5330132756195423
2005-02-18T09:30:00-05:00,62.86,63.205,62.5,62.775,15581398,18030389.3,51.69637547959141,56.00632552596329,NaN,NaN,34.01498468073307,75.59364708861906,0.062199200272788,0.26668032466225355,0.20448112438946556,157627130,170064691.2,66.62891770859662,57.305984555572934,NaN,NaN,8.415501927381337,4.2305116544426555
2005-02-22T09:30:00-05:00,62.449995,62.85,61.5,61.550005,27261602,18465879.6,42.074073160669386,55.08717281083102,NaN,NaN,-50.828430890089855,46.867148349883415,-0.05034755110281586,0.14154668551094574,0.1918942366137616,130365528,164690009.6,62.500778553320714,58.86590214528369,NaN,NaN,4.568065345141982,4.278733610256845
2005-02-23T09:30:00-05:00,61.74,62.285005,61.660005,61.915,17494204,18237629.6,45.338718404724595,54.1636265029329,NaN,NaN,-65.8530387312894,15.72762405787727,-0.096706707568642,0.0710108521529591,0.1677175597216011,147859732,159923409.6,59.00897129133826,59.72076797348849,NaN,NaN,2.4010379668874178,4.010491375489784
2005-02-24T09:30:00-05:00,61.839995,62.58,61.385,62.495005,16971796,18168569.4,50.14693853921079,53.81072452735397,NaN,NaN,-55.22677842560514,-13.808909133011138,-0.08520868817926647,0.061206699497518,0.14641538767678447,164831528,154778489.2,55.410550587888935,60.147634526712565,NaN,NaN,2.067246595368369,3.732884978329582
2005-02-25T09:30:00-05:00,62.4,63.545,62.4,63.535005,23738796,18305319.4,57.385442282698605,53.594243473557924,NaN,NaN,59.095053982540186,-15.759641876742261,-0.008499642915457406,0.13579083403246273,0.14429047694792013,188570324,157850848.4,57.09321638062942,60.28392488083322,NaN,NaN,4.219933119149628,3.8024632841610173
2005-02-28T09:30:00-05:00,63.449995,63.635,62.675005,63.14,18184398,18159149.5,54.16839898038428,53.158417667072385,NaN,NaN,52.580432861778775,-12.04655224053312,0.01350190084935643,0.16116785300961567,0.14766595216025924,170385926,160402607.6,58.49418087503348,60.348404338627596,NaN,NaN,4.908731849278572,3.9605016506063824
2005-03-01T09:30:00-05:00,63.33,63.79,63.14,63.625,19510204,17993929.6,57.33131906948086,52.87408981436012,NaN,NaN,99.11915071872386,17.942964081229622,0.056189574939720016,0.21790292083490925,0.16171334589518924,189896130,172308728,64.34407655476276,60.71560865425335,NaN,NaN,6.507734630878873,4.3243920763595955
2005-03-02T09:30:00-05:00,63.355005,64.129995,63.25,63.51,21113204,18034200,56.33850191901122,53.386015591349455,NaN,NaN,105.00210968755964,52.11399376499943,0.07118649064947632,0.25069645920703465,0.17950996855755832,168782926,176493366.8,66.14988496786806,61.40667794684695,NaN,NaN,7.47678251345182,4.77473356737277
2005-03-03T09:30:00-05:00,63.800005,63.97,63.14,63.565,17493398,18020439.8,56.724485745000656,53.86373109067214,NaN,NaN,85.17241762340309,80.19383297480108,0.07872796679993904,0.27791992705748214,0.1991919602575431,186276324,180782326,67.94195758290068,62.15897403714615,NaN,NaN,8.370145252567267,5.288363808114841
2005-03-04T09:30:00-05:00,64.074995,64.455,63.76,64.345,16206204,18084310.2,61.87235023345685,54.19296525046785,NaN,NaN,160.2614935688253,100.4271208920581,0.12728955053543173,0.35830389842683275,0.23101434789140102,202482528,183564766.8,69.0854088577698,62.93360001256566,NaN,NaN,10.755072805604,6.069322236327578
2005-03-07T09:30:00-05:00,64.449995,64.64,64.129995,64.185,13368602,17774540.3,60.28809022749996,54.443272071683324,NaN,NaN,156.9875416695123,121.3085426536048,0.1387373419277495,0.4044360253010879,0.2656986833733384,189113926,187310366.8,70.60535776458762,63.73376924548751,NaN,NaN,12.240589483717338,6.9509318430975435
2005-03-08T09:30:00-05:00,64.19,64.335,63.525,63.574995,15237000,17918670.4,54.5529244227026,54.256349006198306,NaN,NaN,85.82431926734834,118.6495763633297,0.09728833687944305,0.3873091044726422,0.29002076759319917,173876926,184106526,67.54620846495624,64.20695240520308,NaN,NaN,11.811037641391676,7.645232671425276
2005-03-09T09:30:00-05:00,63.435,63.57,62.855005,62.855005,23342204,18551230.6,48.668062692968725,53.55068039050963,NaN,NaN,-2.911277938150143,97.06689883818774,0.01761674438512184,0.31204169807460147,0.29442495368947963,150534722,180456885.2,64.1371343331097,64.0648142416491,NaN,NaN,9.576930158570502,7.921189455303166
2005-03-10T09:30:00-05:00,62.945,63.345,62.230005,62.585,23021204,18329660.7,46.63630288019405,53.087284574113866,NaN,NaN,-51.83488811100355,69.66543769130641,-0.05315866956713722,0.22797661673055813,0.28113528629769535,127513518,168704324,54.583587681846225,63.10930225747203,NaN,NaN,7.115618568317478,7.806107900019496
2005-03-11T09:30:00-05:00,62.775,63.050005,62.205,62.54,15533398,18087330.6,46.28945759957109,52.70107615411241,NaN,NaN,-72.71203982061462,23.070731013418424,-0.10016751419852143,0.15592589354954356,0.256093407748065,111980120,150603842.4,43.769917940278745,61.47651655973503,NaN,NaN,5.027918876866365,7.409223753854763
2005-03-14T09:30:00-05:00,62.730005,63.01,62.435,63.01,15182796,17944010.2,50.435664684451915,53.298332691525445,NaN,NaN,-42.42297083595767,-16.81137148767557,-0.0967212534077678,0.13519184098835524,0.23191309439612304,127162916,138213640.4,38.192176564514654,59.74018784624889,NaN,NaN,4.416161463762116,6.981643426698671
2005-03-15T09:30:00-05:00,63.265,63.410005,62.449995,62.585,18482398,18419380.1,46.909308039224285,53.410517665418276,NaN,NaN,-39.122925425711706,-41.80082042628757,-0.11872773051716451,0.08350343124966741,0.20223116176683192,108680518,125174358.8,33.372369580907105,57.90900200978952,NaN,NaN,2.848324676078734,6.391169319467251
2005-03-16T09:30:00-05:00,62.370005,62.64,61.975,62.235,21592000,18776290.3,44.17036339685443,52.983619440964254,NaN,NaN,-95.74210970595287,-60.36698677984812,-0.1504769454465245,0.014134979958676297,0.1646119254052008,87088518,112485118,29.47417468864876,56.05640373127236,NaN,NaN,0.7069246647319813,5.579134368790784
2005-03-17T09:30:00-05:00,62.26,62.620005,61.92,62.235,19603398,18813290.3,44.17036339685443,52.03968523483252,NaN,NaN,-88.12483630938091,-67.6249764195236,-0.1639892236503418,-0.040374604157726424,0.12361461949261536,87088518,104400118,27.287103075823794,53.927395638071964,NaN,NaN,-1.0334497817589523,4.634479490140822
2005-03-18T09:30:00-05:00,62.28,62.35,61.74,61.9,24141796,19153000,41.481755413419684,51.133496408620765,NaN,NaN,-105.62640412865011,-74.2078492811307,-0.1863677600379518,-0.10934508055482439,0.07702267948312741,62946722,94593438.4,24.875935382082105,51.52609238857543,NaN,NaN,-3.2998492575674465,3.5010039547539265
2005-03-21T09:30:00-05:00,62.04,62.135,61.574995,61.975,16590204,19203440.3,42.32812821417732,50.06183991895622,NaN,NaN,-104.44105108328,-86.61146533059517,-0.18654036344228078,-0.15615277481972356,0.030387588622557214,79536926,85068240.4,22.77122169549837,48.55660275577083,NaN,NaN,-4.9660434582151805,2.2914257529011968
2005-03-22T09:30:00-05:00,62.050005,62.754995,61.550005,61.550005,30872000,19383960.2,38.89513509154993,48.815885145566135,NaN,NaN,-98.33549409342451,-98.45397906413773,-0.20426901969642952,-0.22494868599797968,-0.020679666301550166,48664926,73065122,20.42591382091581,45.29060481670282,NaN,NaN,-7.407357421440067,0.9058852994238735
2005-03-23T09:30:00-05:00,61.5,61.515,61.004995,61.1,21580000,19588250,35.60250718949091,47.30717239160115,NaN,NaN,-163.61269890896176,-112.0280969047395,-0.23320261366034467,-0.312182933376981,-0.07898031971663633,27084926,61064403.6,18.38690121230124,41.75095793308857,NaN,NaN,-10.519399086955543,-0.7262981843446146
2005-03-24T09:30:00-05:00,61.15,61.625,61.004995,61.050005,16301796,19554750,35.245526040091406,45.40525637778933,NaN,NaN,-147.57681307627684,-123.91849225811868,-0.24158327906666735,-0.3809594185499705,-0.13937613948330316,10783130,45803326,16.175539304174734,37.9716815364032,NaN,NaN,-13.192266141324616,-2.507150749627472
2005-03-28T09:30:00-05:00,61.254995,61.504995,60.97,61.074995,12569398,18996280.1,35.593159095437244,43.64133272549913,NaN,NaN,-130.5867994642929,-128.91057132524725,-0.23130645401885233,-0.42850920700686856,-0.19720275298801623,23352528,37884487.2,15.15689511525926,34.01107706145118,NaN,NaN,-15.332948606977096,-4.339407586391704
2005-03-29T09:30:00-05:00,60.980005,61.545,59.925005,60.199995,21811602,19177640.3,29.600990667347375,41.859051742973755,NaN,NaN,-155.6178456104074,-139.14593023067272,-0.26678226862275917,-0.5306805887664652,-0.263898320143706,1540926,22285287.2,13.37064740064504,30.14139412828609,NaN,NaN,-19.19019579972657,-6.460948759725255
2005-03-30T09:30:00-05:00,60.275,61.120005,60.275,60.75,19367204,19170490.3,36.803052504183334,41.01155101520337,NaN,NaN,-125.92848332510117,-144.66452807700804,-0.23752670977871476,-0.5608067073670995,-0.3232799975883847,20908130,16733928,12.792843824870232,26.473944806268985,NaN,NaN,-20.411435262540575,-8.453875402984586
2005-03-31T09:30:00-05:00,61.175005,61.185,60.75,61.074995,20487796,19139219.9,40.66574818396865,40.585082822615846,NaN,NaN,-95.38419680926499,-131.0188276570687,-0.18305064596703596,-0.5520933050471797,-0.3690426590801437,41395926,19596128,14.836310632599591,23.634853588465653,NaN,NaN,-20.266910350865725,-10.141451824110463
2005-04-01T09:30:00-05:00,61.365,61.72,60.410005,60.82,24024602,19465780.1,38.6686777474446,40.04074140460681,NaN,NaN,-87.81947523013264,-119.06736008783987,-0.1522189809145572,-0.5593163852233403,-0.40709740430878305,17371324,20913766.8,15.814301643808548,21.6380238530035,NaN,NaN,-20.735129608967366,-11.654834364804307
2005-04-04T09:30:00-04:00,60.72,61.19,60.199995,61.045,30577602,20184350,41.40315542455082,39.39556217175674,NaN,NaN,-93.01372241007392,-111.55274467699607,-0.10684431637278291,-0.5406527997747617,-0.43380848340197875,47948926,25833046.4,19.52970366189942,20.304990074245268,NaN,NaN,-20.32411059808751,-12.893302398130478
2005-04-05T09:30:00-04:00,61.065,61.324995,60.875,61.155,17860398,20408939.8,42.7471091793609,39.09826225319506,NaN,NaN,-62.208750282158924,-92.87092561134638,-0.061828507918838316,-0.5110941183005266,-0.44926561038168833,65809324,38686726,28.419155068193817,19.95118903762289,NaN,NaN,-19.60079061231538,-13.851515000156892
2005-04-06T09:30:00-04:00,61.315,61.805,61.175005,61.345,19718602,20633019.9,45.0897676338213,39.16393398440698,NaN,NaN,-27.46555976602665,-73.17834089953148,-0.014151093791211988,-0.4669544776207033,-0.4528033838294913,85527926,51610685.2,36.06665652036951,20.422080597031513,NaN,NaN,-18.32752869285465,-14.490945527685144
2005-04-07T09:30:00-04:00,61.089995,61.754995,60.945,61.585,14995796,20215699.5,47.984994047821544,39.436407602333205,NaN,NaN,-22.860371180442336,-58.67357577376693,0.03591837077314691,-0.40790542036305766,-0.44382379113620457,100523722,63436244.4,42.15627128927062,21.48416404084914,NaN,NaN,-16.4154908180379,-14.765880569164109
2005-04-08T09:30:00-04:00,61.53,61.660005,60.57,60.65,19505000,20039889.3,39.292834943220136,39.28005614017609,NaN,NaN,-65.6835828680901,-54.24639730135842,0.009794781922909779,-0.43158031373256733,-0.4413750956554771,81018722,76165724,47.90810361350828,23.129318914522436,NaN,NaN,-17.258882617262703,-15.12202371889248
2005-04-11T09:30:00-04:00,60.675005,60.74,60.195,60.35,19160000,20221219.4,36.978301259769985,38.897925643432714,NaN,NaN,-117.0996858495298,-59.0635899892496,-0.02221380277319729,-0.4691423491219737,-0.44692854634877643,61858722,78947683.2,49.09934050912442,25.00989882978144,NaN,NaN,-18.67949486070374,-15.630233882008374
2005-04-12T09:30:00-04:00,60.26,61.055,59.65,60.915,32748398,21099499.5,43.70402968314012,39.24141811426058,NaN,NaN,-99.73402108898512,-66.56864415061484,-0.000980137000552772,-0.4481537175994674,-0.44717358059891466,94607120,84707242.4,51.56866185313781,27.234380832083012,NaN,NaN,-17.768012532496126,-15.935630832078052
2005-04-13T09:30:00-04:00,60.800005,60.9,59.725,59.824995,25951796,21472969.4,35.77240603492784,39.253553746077515,NaN,NaN,-145.99313217364724,-90.27415863213896,-0.05310468273073027,-0.5135544340123275,-0.4604497512815972,68655324,81332722,50.03703400425239,29.495104602936664,NaN,NaN,-19.709347009131125,-16.474733143085633
2005-04-14T09:30:00-04:00,59.865,60.125,58.625,58.625,37281792,22257459,29.438256267035385,38.8387487622878,NaN,NaN,-245.87868013355651,-134.87782042276177,-0.15537454795663475,-0.6546679362273906,-0.49929338827075587,31373532,67502684,44.23796198728544,31.499563366016,NaN,NaN,-23.853904358396292,-17.528900459558585
2005-04-15T09:30:00-04:00,58.655,58.975,57.5,57.82,51630016,23858789.9,26.099576509011712,38.16063572040026,NaN,NaN,-290.09114902640187,-179.75933365442415,-0.2581515844946082,-0.8219828688890161,-0.5638312843944079,-20256484,47247642.8,37.40124711133774,33.08844565145018,NaN,NaN,-28.50419813907758,-19.0968001280613
2005-04-18T09:30:00-04:00,57.71,58.379995,57.31,58.19,35345600,24418980.1,30.02765055537367,38.19111142668785,NaN,NaN,-234.52612058981492,-203.24462060248115,-0.28028462943362,-0.9141870711864328,-0.6339024417528129,15089116,37893721.6,34.73177952466712,34.61424080316605,NaN,NaN,-30.668584725872392,-20.749912213462885
2005-04-19T09:30:00-04:00,58.555,59.17,58.480005,59.15,32143204,25196630.1,39.076108406843744,38.353472562592174,NaN,NaN,-125.85574759089863,-208.46896590286389,-0.21242008496465425,-0.8994275479586307,-0.6870074629939764,47232320,28418761.6,32.22294423646598,36.00210511828003,NaN,NaN,-29.11895087920422,-21.945489165711646
2005-04-20T09:30:00-04:00,59.199995,59.300005,58.089995,58.225,31706000,25238330.1,34.45303508991677,37.90970734158846,NaN,NaN,-130.30494946732742,-205.3313293615999,-0.21151651451422038,-0.9514031061367518,-0.7398865916225315,15526320,17792960.8,29.63738789099196,37.059324922450905,NaN,NaN,-29.563593706639914,-23.033789814415684
2005-04-21T09:30:00-04:00,58.839995,59.69,58.025,59.65,32421398,25780400,45.2076987136034,38.37678026774267,NaN,NaN,-76.11396300452294,-171.3783859357932,-0.10217655309157103,-0.8676072829869952,-0.7654307298954242,47947718,21107798,31.48437402077151,38.178615806519694,NaN,NaN,-25.679530296739728,-23.411752740461974
2005-04-22T09:30:00-04:00,59.464995,59.56,58.04,58.685,30171000,26473860.2,40.37634951854697,38.3034369887424,NaN,NaN,-87.76628491567419,-130.91341311364766,-0.08289387951455485,-0.8690480792886177,-0.7861541997740629,17776718,28714438.4,35.65816312328472,39.33064862519007,NaN,NaN,-24.4648809261789,-23.562199624135822
2005-04-25T09:30:00-04:00,58.910005,59.324995,58.75,59.225,19042796,26797530.1,43.98395938731731,38.391783432167855,NaN,NaN,-57.6830421001801,-95.5447974157207,-0.024833682906896803,-0.8171963034076839,-0.7923626205007871,36819514,33060518,37.98273487233015,40.01376146834267,NaN,NaN,-22.189515187915113,-23.366101847532864
2005-04-26T09:30:00-04:00,58.980005,59.565,58.025,58.39,30992000,27256550,39.95789257309707,38.025220927830404,NaN,NaN,-76.54390675552332,-85.68242924864565,-0.03320478431779916,-0.833868600898036,-0.8006638165802369,5827514,24779556.8,35.36126399406761,39.96337628789253,NaN,NaN,-21.823451950305845,-23.145723290786147
2005-04-27T09:30:00-04:00,58.125,58.79,57.615,58.365,33194398,27947909.7,39.8403087522303,37.443457692431025,NaN,NaN,-90.50250688549282,-77.72194073227872,-0.031006921257667464,-0.8394224681523212,-0.8084155468946538,-27366884,16200916,32.83316556161378,39.29744016448847,NaN,NaN,-21.587518734293205,-22.923122639858583
2005-04-28T09:30:00-04:00,58.135,58.15,56.875,56.875,30459602,28446500,33.510913666754504,37.03046331554062,NaN,NaN,-131.4925260395388,-88.79765333928185,-0.1157220580826478,-0.9530681194979636,-0.8373460614153158,-57826486,-4953924.8,27.594053763170805,37.84643660375008,NaN,NaN,-23.64026027037805,-23.025570872789935
2005-04-29T09:30:00-04:00,57.49,57.714995,56.495005,57.620005,57493792,30119959.5,38.75052955827417,37.157051051148066,NaN,NaN,-121.28212111163467,-95.50082057847393,-0.10757512029417304,-0.9718149617830321,-0.864239841488859,-332694,-8575807.2,26.805417483741124,36.254013530508416,NaN,NaN,-23.460346599483884,-23.08768169088907
2005-05-02T09:30:00-04:00,57.78,58.24,57.535005,58.21,25063796,29844269.2,42.607764181824294,37.078746372482655,NaN,NaN,-74.94978441784365,-98.95416904200665,-0.05129829972539246,-0.9283627161455996,-0.8770644164202072,24731102,-10993489.6,26.265781184729605,34.446664911336406,NaN,NaN,-22.000271264633835,-22.93233734428118
2005-05-03T09:30:00-04:00,58.185,58.65,57.83,58.5,25112602,30206879.4,44.459247601076314,37.69923505577898,NaN,NaN,-51.68334049984612,-93.98205579087121,0.013167214156723395,-0.860605398724303,-0.8737726128810264,49843704,-2190251.6,31.660608695996146,33.134063103603815,NaN,NaN,-20.245051566397077,-22.548439376012023
2005-05-04T09:30:00-04:00,58.385,59.275,58.214995,59.15,23532204,30397559.5,48.47172268739246,39.058768371518774,NaN,NaN,-8.373326616826578,-77.55621973713797,0.10233020183422337,-0.7458598605882472,-0.8481900624224705,73375908,17958306.8,42.10199773291033,32.981494228291304,NaN,NaN,-17.490750979463172,-21.825912462219332
2005-05-05T09:30:00-04:00,59.199995,59.58,58.660005,59.14,41892000,31742369.7,48.41377436619767,40.65263964703205,NaN,NaN,21.920053602488426,-46.873703808732515,0.15994612711927159,-0.648257403523381,-0.8082035306426526,31483908,35820385.6,49.47236083585089,33.8437166371851,NaN,NaN,-15.338427050484475,-20.899128831971495
2005-05-06T09:30:00-04:00,59.644995,59.735,59.08,59.35,23372204,31935729.9,49.771787910083994,42.062935172368505,NaN,NaN,57.758212862994945,-11.06563701380659,0.20844397931805525,-0.5476485564950835,-0.7560925358131387,54856112,46858146.8,53.418500451361794,35.1784824176633,NaN,NaN,-13.17430634076205,-19.795582761798716
2005-05-09T09:30:00-04:00,59.33,60,59.035005,59.92,19380204,31946740.1,53.36069842969611,43.08326303114368,NaN,NaN,92.58940687651807,22.442201245065746,0.2711837353832438,-0.417112866584084,-0.6882966019673278,74236316,56759189.6,56.6862856067386,36.925863944111335,NaN,NaN,-10.253414576621765,-18.432415878202008
2005-05-10T09:30:00-04:00,59.574995,59.65,59.015,59.205,29722204,31795430.4,48.66354719950621,44.09829961040007,NaN,NaN,67.44768077879745,46.26840550079446,0.2569373386014355,-0.36712492871553337,-0.6240622673169689,44514112,55693271.2,56.22895763235041,38.825261782779805,NaN,NaN,-9.085955724072079,-17.097207284754877
2005-05-11T09:30:00-04:00,59.375,59.42,58.504995,59.235,32100398,32102860.5,48.86693027015144,44.35967329301064,NaN,NaN,50.896205113688836,58.12231184689754,0.24214287972152138,-0.3213836676650672,-0.5635265473865886,76614510,56340991.6,56.45883599848974,40.609151924045385,NaN,NaN,-8.083318862685292,-15.809508938744937
2005-05-12T09:30:00-04:00,59.4,59.574995,58.185,58.300005,30451602,31761351,43.13161402000704,44.55647790025778,NaN,NaN,8.498061042848924,55.43791333496963,0.16564483701832955,-0.3564705011136766,-0.5221153381320062,46162908,59276791.6,57.5471192671442,42.17264879146392,NaN,NaN,-8.879887716707882,-14.8195630498825
2005-05-13T09:30:00-04:00,58.5,58.605005,57.445,58.089995,37347200,31047210.2,41.94093209797881,44.41054737959075,NaN,NaN,-72.62785452495088,29.360699857380485,0.10037164809007981,-0.3966507780194064,-0.4970224261094862,8815708,50068710.8,53.06695988397122,43.250093435152564,NaN,NaN,-9.882081489583575,-14.114208541268368
2005-05-16T09:30:00-04:00,58.015,59,57.949995,58.985,31353000,30847580.2,48.46972216034673,45.01853520725144,NaN,NaN,-0.9548572353845655,10.651847034999957,0.11584641696323211,-0.3522144049054461,-0.4680608218686782,40168708,43255189.2,49.96710567431821,44.29336784088475,NaN,NaN,-8.822756648814488,-13.358286842346386
2005-05-17T09:30:00-04:00,58.754995,59.35,58.42,59.335,22691398,30374989.9,50.79973007446545,45.80135101598252,NaN,NaN,51.734774425088254,7.509265764258115,0.1460762451967091,-0.28546551537279186,-0.43154176056950094,62860106,46924388,51.60651809206008,45.63432159305949,NaN,NaN,-7.249716160817042,-12.485633887842194
2005-05-18T09:30:00-04:00,59.620005,60.56,59.605005,60.525,36759808,30627680.3,57.78834197698802,47.53545303814206,NaN,NaN,181.04252621166881,33.538529983854104,0.2372434615316586,-0.1349874336549277,-0.3722308951865863,99619914,51525468.8,53.657154168505116,47.49597162201194,NaN,NaN,-3.5849798516889764,-11.214111882677448
2005-05-19T09:30:00-04:00,60.455,60.870005,60.345,60.675005,26731000,30343160.4,58.5868966791136,48.952336403916306,NaN,NaN,194.4760354237866,70.73412486004165,0.29491513892796495,-0.0035869715266301228,-0.29850211045459507,126350914,67563070,60.01693360584419,49.86822277359073,NaN,NaN,-0.39905412677184154,-9.66910363183379
2005-05-20T09:30:00-04:00,60.65,60.72,60.185,60.6,23165204,29992870.6,57.996097080137496,50.0515030395101,NaN,NaN,152.8866835733556,115.83703247970293,0.31353743301448506,0.09341968081351126,-0.2201177522009738,103185710,86437070.4,65.94077415828488,52.70215084313039,NaN,NaN,2.0167375671157415,-7.999697746269572
2005-05-23T09:30:00-04:00,60.675005,61.25,60.620005,61,27477398,30414600.7,60.295594139417524,51.18267064939162,NaN,NaN,165.4915388652049,149.12631169982083,0.3363072128965628,0.20026626391972968,-0.1360409489768331,130663108,104535950.4,70.46041636733213,55.47356567679725,NaN,NaN,4.7412694145562195,-6.179559580437316
2005-05-24T09:30:00-04:00,60.78,61.125,60.629995,60.75,21964204,29963210.9,58.1528090714034,51.87417681967811,NaN,NaN,133.13806992596673,165.40697079999651,0.31823493339082815,0.26175271776170206,-0.05648221562912607,108698904,113703710,72.45438343283239,57.64159322679168,NaN,NaN,6.442601860257096,-4.376393660338115
2005-05-25T09:30:00-04:00,60.769995,60.800005,60.15,60.295,22454000,29426191,54.365974927810754,52.299334002650475,NaN,NaN,89.22973108895614,147.044411775454,0.26170307818957356,0.2706466321078409,0.00894355391826733,86244904,111028708,70.94948077016583,59.17567322209989,NaN,NaN,6.857195005742206,-2.771595279469498
2005-05-26T09:30:00-04:00,60.545,61.195,60.545,61.135,20049796,28905700.7,59.596839727573006,53.00112341818541,NaN,NaN,115.60751881451925,131.27070845360052,0.266076399683866,0.34153905352309977,0.07546265383923381,106294700,107017465.2,68.64695476066447,60.26341995847866,NaN,NaN,8.77796797556643,-1.1216576716072226
2005-05-27T09:30:00-04:00,61.300005,61.54,60.9,61.475,15095204,26785771.3,61.519530301929336,53.58389712334492,NaN,NaN,125.02812919847217,125.69899757862383,0.2758793754168476,0.4203118731102933,0.1444324976934457,121389904,110658304,69.61096020066783,61.18661100090217,NaN,NaN,10.955776025899503,0.6036899994651665
2005-05-31T09:30:00-04:00,61.519995,61.705,61.14,61.345,19278204,26496491.7,60.337228004014705,54.417731466524096,NaN,NaN,116.54212086460547,115.90911397850395,0.2579485781546438,0.46686822038675047,0.20891964223210668,102111700,104948022.4,66.17435057703236,61.89699621123659,NaN,NaN,12.42265853498519,2.292114075968027
2005-06-01T09:30:00-04:00,61.339995,62.25,61.32,62.04,26637796,26572751.4,64.28860505425322,55.51927966538851,NaN,NaN,133.01653867587513,115.88480772848564,0.27563640695557634,0.5534651509265771,0.27782874397100077,128749496,108958140.8,67.39183466793973,62.67792468762588,NaN,NaN,14.88871675897386,4.09162874496886
2005-06-02T09:30:00-04:00,62.04,62.339995,61.845,62.21,14414398,26116861.1,65.2018153479379,57.095722617383565,NaN,NaN,134.31978166400364,124.90281784349513,0.28058957068069434,0.6285657073218687,0.3479761366411743,143163894,120341938.8,70.62420725941936,63.61200240135982,NaN,NaN,17.195071748580713,5.963549174056268
2005-06-03T09:30:00-04:00,62.144995,62.415,61.555,61.754995,21798204,25112171.3,60.725823110334034,58.43750054683751,NaN,NaN,108.66312721184933,123.51393952296114,0.2367753606571893,0.6439453374626609,0.4071699768054716,121365690,123356136.8,71.43171826723355,64.92377085730712,NaN,NaN,17.921877299996687,7.671881763476327
2005-06-06T09:30:00-04:00,61.730005,62.06,61.525,61.985,18874398,24887281,62.14066657091143,59.41399657616357,NaN,NaN,95.99921345005828,117.70815637327834,0.20786759778812192,0.667004474040624,0.4591368762525021,140240088,127126173.6,72.45174475508276,66.52981650593316,NaN,NaN,18.928277121007188,9.279938243123594
2005-06-07T09:30:00-04:00,62.199995,62.875,61.97,62.11,25322204,25184381,62.92242053764453,60.27990303781922,NaN,NaN,113.83796724636126,117.16732564962952,0.1826433538151765,0.6874410685214727,0.5047977147062962,165562292,139816292,75.608691119795,68.24425743648565,NaN,NaN,19.982855213451163,10.808926381741818
2005-06-08T09:30:00-04:00,62.24,62.370005,61.625,61.714995,18085796,24602560.6,58.79112588454429,60.351530459787526,NaN,NaN,80.85798015172662,106.7356139447998,0.12744837925305008,0.6641081887726088,0.5366598095195587,147476496,143561692,76.46590238757344,69.87345373784768,NaN,NaN,19.769446259954513,12.089000650057917
2005-06-09T09:30:00-04:00,61.67,62.42,61.36,62.32001,21813808,24088231.1,62.81794709046149,60.653748346312376,NaN,NaN,82.7215061368861,96.4159588393763,0.11989020269354322,0.6865225628864877,0.5666323601929445,169290304,148786974,77.64622273825222,71.13268867587684,NaN,NaN,20.718931099339528,13.321847857098147
2005-06-10T09:30:00-04:00,62.45,62.55,62.08,62.45,19951504,23563226.2,63.64004477051747,61.056887467053805,NaN,NaN,98.64873688082164,94.41308077317076,0.1119978205702663,0.7066296359057773,0.594631815335511,189241808,162362197.6,80.39695223362527,72.16527282411543,NaN,NaN,21.73735769445114,14.524063548148575
2005-06-13T09:30:00-04:00,62.27,62.82001,62.13,62.73,22016096,22796671,65.41392427966152,61.42248247707122,NaN,NaN,106.93016261641728,96.59927060644256,0.11362771864808097,0.7366664636456122,0.6230387449975312,211257904,176565760.8,82.78401500856287,73.04552986991762,NaN,NaN,23.10128149966838,15.749380398365691
2005-06-14T09:30:00-04:00,62.7,63.27,62.47,63.27,15952500,22026646,68.59597104614488,62.16842261812418,NaN,NaN,135.43768776795517,100.91921471076134,0.13747416756546493,0.7948814544543623,0.6574072868888974,227210404,188895383.2,84.54351085869169,73.90903897176472,NaN,NaN,25.22887285785908,17.103593606864745
2005-06-15T09:30:00-04:00,63.42999,63.48,62.64,63.44,20577296,21920940.9,69.54589948972131,63.25270294397494,NaN,NaN,142.59957548432047,113.26753377728012,0.15006958283776173,0.8449942654360996,0.6949246825983378,247787700,208957624,86.89116819899354,75.04773093096671,NaN,NaN,27.281342499722683,18.55755773441588
2005-06-16T09:30:00-04:00,63.48,64.14,63.33,64.06,22024496,21184175.3,72.77978423463568,64.19434183733655,NaN,NaN,184.4285131530485,133.6089351805126,0.18332870549125135,0.924085564462402,0.7407568589711506,269812196,229062002.4,88.73729840189927,76.48275547676919,NaN,NaN,30.08080223620862,20.20373552038627
2005-06-17T09:30:00-04:00,64.32001,64.64999,63.88,64.02,20964800,20895865.3,72.24675614239584,64.96057225451274,NaN,NaN,187.83746755664353,151.44668131567695,0.18525844011809534,0.9723299091187698,0.7870714690006745,248847396,240983120,89.66659194909732,77.91530060165701,NaN,NaN,32.22557487479575,21.921141142444768
2005-06-20T09:30:00-04:00,63.72,64.00999,63.56,63.67999,17149104,20595060.3,67.70742354373994,65.48701479306455,NaN,NaN,132.69462731691885,156.59957425577727,0.14788218262216712,0.9719241972783834,0.8240420146562163,231698292,245071197.6,89.97215770432257,79.61514396789202,NaN,NaN,32.81598861372519,23.477547924056257
2005-06-21T09:30:00-04:00,63.85001,63.99001,63.53,63.86,13800000,19911190.4,68.82423633202657,65.81098845576263,NaN,NaN,119.02426919100428,153.3168905403871,0.12067842405734686,0.9748900447278999,0.854211620670553,245498292,248728775.2,90.24995425972935,81.247866795877,NaN,NaN,33.620775339642236,24.92658041199711
2005-06-22T09:30:00-04:00,63.97,64.22,63.49001,64.00999,15722301,19599095.25,69.7626027227866,66.13675898253754,NaN,NaN,112.14779374900854,147.22653419332474,0.09908579991756705,0.9780688705675118,0.8789830706499447,261220593,251415353.8,90.45902949759444,82.6646398128895,NaN,NaN,34.55536943967665,26.302121701665616
2005-06-23T09:30:00-04:00,63.91,64.11,62.88,62.88,19652000,19458995.25,56.07007929998157,65.80420585322665,NaN,NaN,56.96671645869701,121.73417485445444,0.00023087725285764193,0.8792716672160168,0.8790407899631592,241568593,245766633.2,86.27020649013076,83.72453182881074,NaN,NaN,31.19606905385051,27.001257037692028
2005-06-24T09:30:00-04:00,62.94,63.02,62.07001,62.21001,25167600,19714885.45,49.82565713570632,64.92456232214057,NaN,NaN,-18.796991725978693,80.40728299793,-0.1125128197715608,0.7383997652487082,0.850912585020269,216400993,239277352.6,81.59567215932321,84.3776695005422,NaN,NaN,26.201595224328628,26.88701963578297
2005-06-27T09:30:00-04:00,62.28,62.59,62.10001,62.37,21001296,20010190.05,51.22263218057791,64.08886315377866,NaN,NaN,-31.92676560847767,47.4830044128507,-0.17482769650558316,0.6323779643882901,0.8072056608938732,237402289,240418152,81.78255200565913,84.8186595638182,NaN,NaN,22.59663587298129,26.274107669668446
2005-06-28T09:30:00-04:00,62.77,63.86,62.72,63.34,20578192,20075189.45,58.7258663442504,64.08420175804339,NaN,NaN,47.83526382749161,33.24520334014816,-0.15017670328803845,0.6194847817838252,0.7696614850718636,257980481,242914589.8,82.20830334413024,85.22883106071512,NaN,NaN,21.772242994391192,25.630984144628837
2005-06-29T09:30:00-04:00,63.86,64.06,63.63,63.84,17134608,19600030.05,61.97303439252758,64.02385085104811,NaN,NaN,88.4392866149754,28.50350191334153,-0.10196145230191211,0.6422096696944735,0.7441711219963856,275115089,245693489,82.69317045581874,85.58932732625559,NaN,NaN,22.159636635534532,25.135077357615366
2005-06-30T09:30:00-04:00,64.07001,64.28999,63.39999,63.7,28373600,20297990.15,60.53691741612491,63.80219889716293,NaN,NaN,76.46739533849902,32.403637689301945,-0.08211501825942202,0.6415273491721081,0.7236423674315301,246741489,246728068.2,82.88022959445334,85.76670428060045,NaN,NaN,22.01583925681764,24.689471914644262
2005-07-01T09:30:00-04:00,63.7,64.05,63.44,63.98,14990199,19957589.9,62.41294834818567,63.58784347348608,NaN,NaN,72.36252928862365,50.635541892222406,-0.054099416408876944,0.6560180969204339,0.7101175133293108,261731688,255794207.2,84.4648332284766,85.88676272488,NaN,NaN,22.47125207300388,24.372583365838494
2005-07-05T09:30:00-04:00,63.81,65.05,63.75999,64.99001,26678800,20347810,68.27219000426086,63.56471625620865,NaN,NaN,136.28102999226454,84.27710101237085,0.024278673694798525,0.740465855447809,0.7161871817530104,288410488,265995847,86.03159129930057,85.9930541849235,NaN,NaN,24.83783269337277,24.439047555486248
2005-07-06T09:30:00-04:00,65.00999,65.14,64.38,64.39999,21094096,20136404.6,62.1748087603321,63.03820977553799,NaN,NaN,126.98180278416719,100.10640880370596,0.027948774108509267,0.751123149388647,0.7231743752801377,267316392,267863029.2,86.30385255304775,85.95110306735593,NaN,NaN,24.792549028017415,24.489547765847842
2005-07-07T09:30:00-04:00,63.69,64.69,63.47,64.58,33464304,20905330,63.25309693419322,62.35773211122068,NaN,NaN,81.91952099123587,98.80245567895805,0.033678775950460316,0.7652728452182131,0.7315940692677528,300780696,272996150.6,87.05107863164105,85.83065879805177,NaN,NaN,25.097937322527752,24.576460559659257
2005-07-08T09:30:00-04:00,64.64,66.02,64.55,65.97,24967504,21063014.8,70.29494856082854,62.21831728396587,NaN,NaN,194.61636984500683,122.43225058025959,0.11754148223559813,0.8785209220622505,0.7609794398266524,325748200,288797492.8,89.03436145410507,85.7854994769809,NaN,NaN,27.877679252420535,25.048063230053724
2005-07-11T09:30:00-04:00,66.00999,66.99001,65.98,66.78,35692192,21850049.2,73.48378707127024,62.63091467878946,NaN,NaN,267.1235748125565,161.38445968504615,0.20869788651522458,1.0218517979706832,0.8131539114554586,361440392,308739233.6,90.92371399258856,85.85346778328561,NaN,NaN,31.338817748216837,25.94674244693417
2005-07-12T09:30:00-04:00,66.67999,67.14,66.33,66.57001,25663808,22032434.8,71.34549487883187,62.81100457498984,NaN,NaN,215.39032396175097,177.20631847894347,0.23407822643824816,1.1057516945032688,0.8716734680650207,335776584,318212452.8,91.65893791842177,85.95410947319222,NaN,NaN,33.30692162127365,26.998196614696955
2005-07-13T09:30:00-04:00,66.64999,66.82001,66.14999,66.42,16982192,22083919.4,69.78330670485337,62.81248343085175,NaN,NaN,162.37846406488302,184.28565073508662,0.22019519600745974,1.1469174630743453,0.9267222670668855,318794392,328508052.8,92.38126376490723,86.09141192085742,NaN,NaN,34.36446528336952,28.05052071022161
2005-07-14T09:30:00-04:00,66.89999,67.07001,65.78,65.94,26050800,22357594.6,64.88740272611622,63.442292247004225,NaN,NaN,124.22957077930965,192.74766069270137,0.16086935681680092,1.1278089630878867,0.9669396062710858,292743592,326900632,91.0554565327941,86.43321549533336,NaN,NaN,33.704625203005484,28.858249923476446
2005-07-15T09:30:00-04:00,65.95,66.2,65.42,66,15694301,22041084.85,65.21591876665542,64.54159664921488,NaN,NaN,86.16740061650685,171.05786684700138,0.11026568864743713,1.1047717170803821,0.994506028432945,308437893,323438570.6,88.12205858323716,86.89938595418437,NaN,NaN,33.274416182320394,29.48913081759701
2005-07-18T09:30:00-04:00,65.91,66.08,65.37,65.62,14420699,21713879.8,61.30391838539478,65.26168852098752,NaN,NaN,66.9632678309825,131.02580545068662,0.03945054631309919,1.043819211324319,1.0043686650112198,294017194,309953931,77.63163547871551,86.60289191654554,NaN,NaN,31.747205763837478,29.811712952774222
2005-07-19T09:30:00-04:00,65.89,66.64999,65.75,66.53999,14059500,21559399.6,66.53738378663134,65.81965405258616,NaN,NaN,91.14746285202415,106.17723322874122,0.04255189932234282,1.0575585391641482,1.0150066398418054,308076694,304413953,73.74737524700812,85.99853990960824,NaN,NaN,31.995639155401932,30.123702410292466
2005-07-20T09:30:00-04:00,66.25,67.55,66.19,67.35001,23895200,22064159.6,70.34084086715824,66.41735451505977,NaN,NaN,113.41216056941438,96.3839725296475,0.08470508868704951,1.1208880007006172,1.0361829120135677,331971894,307049453.4,74.40350511924031,85.4064209569955,NaN,NaN,33.45353490220002,30.59939276627926
2005-07-21T09:30:00-04:00,67.45,67.45,66.22,66.3,41945904,23375339.75,60.70814273847105,66.42958489522735,NaN,NaN,84.122988165506,88.36265600688675,0.030229643416241014,1.0739699662838689,1.0437403228676279,290025990,306505933,73.99278695398006,84.77160362553312,NaN,NaN,31.421970855120108,30.716903921827953
2005-07-22T09:30:00-04:00,66.45,67.42,66.31,67.32001,27981504,23791814.95,65.63185003605112,66.6595064443606,NaN,NaN,92.80564417093915,89.69030471777322,0.05007987580481155,1.1063401676236424,1.0562602918188309,318007494,308419853.2,74.52604756950788,84.0616903641782,NaN,NaN,31.420568274334126,30.817427400757406
2005-07-25T09:30:00-04:00,67.3,67.67999,66.61,66.88,22612192,23664044.55,62.02130025745122,66.2130143195885,NaN,NaN,89.0932715452685,94.11630546063041,0.022186213345718908,1.0839930585009796,1.0618068451552607,295395302,308695474.8,74.60679659550115,83.24563359962112,NaN,NaN,30.18401123432725,30.72693937698167
2005-07-26T09:30:00-04:00,66.91,67.37,66.59,67.08,21967392,23712349.35,63.01718881655374,66.27318432360433,NaN,NaN,82.95112986929296,92.47703886408418,0.006623210579175254,1.0700858583792296,1.0634626478000544,317362694,310552674.8,75.17776483846839,82.45091304857974,NaN,NaN,29.530483153997405,30.55601705941249
2005-07-27T09:30:00-04:00,67.25,67.32001,66.45,67.27,26145296,23990704.55,63.98342078406085,66.32535031288059,NaN,NaN,78.20609846125942,85.43582644245319,-0.00104860752983571,1.0621518883877599,1.0632004959175956,343507990,312859894,75.90266523718569,81.65459780611864,NaN,NaN,29.30181303945268,30.376845056561088
2005-07-28T09:30:00-04:00,67.37,68,67.02,67.96001,21417104,24204829.35,67.32243059169582,66.11302760079967,NaN,NaN,113.26759104194372,91.26474701774073,0.028539645483365517,1.0988750527718025,1.070335407288437,364925094,327839714.8,79.98880268693225,81.0084864656063,NaN,NaN,30.149274950234535,30.34433504137158
2005-07-29T09:30:00-04:00,68,68.25999,67.44,67.89,24815808,24026939.75,66.64730095157174,65.62470716367835,NaN,NaN,123.0272648620497,97.30907115596285,0.03136297563347812,1.1095391268302848,1.0781761511968067,340109286,332260073.2,81.01199852653946,80.30050678945993,NaN,NaN,30.62817362555192,30.384883410540198
2005-08-01T09:30:00-04:00,67.94,68.25,67.72,67.86,22727904,24413825,66.34029228949424,65.26719269301138,NaN,NaN,126.4044754429638,104.77131193550193,0.01974442918771646,1.1028566876814523,1.0831122584937358,317381382,336657289.2,81.99807293783802,79.61044500513252,NaN,NaN,30.93107689934437,30.462911051797935
2005-08-02T09:30:00-04:00,68.03,68.52,68,68.37,16524398,23906104.9,68.95816793362835,65.20825420935245,NaN,NaN,147.10200302088745,117.60148656582082,0.0340995945942657,1.125736751736568,1.0916371571423023,333905780,339965906.4,82.72501776191001,78.92071314777557,NaN,NaN,31.94537997856253,30.67469232705002
2005-08-03T09:30:00-04:00,68.14999,68.31,67.87,68.03,17081696,23705484.9,65.31129690908116,65.23853236527852,NaN,NaN,118.77074202904701,125.71441527937834,0.009659323785285112,1.1037113118739086,1.0940519880886235,316824084,334629125.2,77.30258674509014,77.9383653057967,NaN,NaN,31.777787009920967,30.83227728174587
2005-08-04T09:30:00-04:00,67.56,67.8,66.78,66.89,19251104,22994824.9,54.83914401116463,64.49733416845774,NaN,NaN,27.044837214884144,108.46986451396643,-0.0888921220765615,0.9829368354929215,1.071828957569483,297572980,321158702.4,65.61221369259191,76.3305192421792,NaN,NaN,28.33556127744253,30.475603566845393
2005-08-05T09:30:00-04:00,66.75999,66.82001,65.66,65.97,33235808,23408240.1,48.1318427236724,63.55647162119186,NaN,NaN,-91.02231468184338,65.65994860518781,-0.21448629788174278,0.8037210852173047,1.0182073830990475,264337172,306004279.6,55.45216664753366,74.74627146852333,NaN,NaN,23.083851545938643,29.419638992430144
2005-08-08T09:30:00-04:00,66.17,66.37,65.52,65.74001,20287200,22637990.5,46.59748906884217,62.13219342706406,NaN,NaN,-110.99682572737026,18.179688371120992,-0.305922794810608,0.6358038895857874,0.9417266843963954,244049972,291337997.6,47.74638285770803,72.88905772643048,NaN,NaN,18.377420265984636,27.8421791743665
2005-08-09T09:30:00-04:00,65.89,66.07001,65.45,65.84,21264400,22418020.1,47.38282026240221,60.49233481243863,NaN,NaN,-107.34805069095087,-32.710322371246676,-0.34940085546561106,0.5049756150643816,0.8543764705299927,265314372,277619716,41.8835661411951,70.56620494228439,NaN,NaN,14.821139926037358,25.982030710319478
2005-08-10T09:30:00-04:00,66.03999,66.60001,64.87,65.75,27641696,22950995.3,46.71687946690408,59.492958864469564,NaN,NaN,-102.29157011904103,-76.92278480086428,-0.37186866831240806,0.38954063513948256,0.7614093034518906,237672676,261789434.4,36.338503132892086,67.87661324077811,NaN,NaN,11.721141641690046,23.944760843372418
2005-08-11T09:30:00-04:00,65.57001,66.39999,65.55,66.32001,23566608,22826785.7,51.37782222666494,58.474814020941984,NaN,NaN,-67.51906732671347,-95.83556570918378,-0.3370220047807655,0.3401317974759337,0.6771538022566992,261239284,254522695.2,34.10630316275456,64.98948864029575,NaN,NaN,10.334166260923288,22.000390188736827
2005-08-12T09:30:00-04:00,66.03999,66.07001,65.13,65.52,25524000,23318270.65,45.37813775078459,57.286016699037226,NaN,NaN,-111.67493740466249,-99.96609025374762,-0.3547417919667867,0.23372656229821587,0.5884683542650025,235715284,248798317.6,32.416982722457604,61.97593050650693,NaN,NaN,7.251403563402803,19.893392099403396
2005-08-15T09:30:00-04:00,65.64999,66.49001,65.25,66.22,23690896,23781780.5,50.79276977592525,56.4128439104209,NaN,NaN,-77.10916072604314,-93.18855725348219,-0.3079446493524973,0.20353754257438084,0.5114821919268782,259406180,251869559.2,34.29729941305757,59.055897261834716,NaN,NaN,6.2663763470541465,17.9466755633535
2005-08-16T09:30:00-04:00,66.07001,66.08,65.06,65.06,18779504,24017780.7,43.15781413942406,54.92530057866112,NaN,NaN,-119.13177243307187,-95.54530160190639,-0.3411617151386432,0.08503004800357417,0.42619176314221735,240626676,246932020,32.721129722650346,55.97150186793933,NaN,NaN,2.8071414172936735,15.78388497105924
2005-08-17T09:30:00-04:00,65,65.59,64.84,64.98,21168608,23881451.1,42.68131828348399,53.16522112807457,NaN,NaN,-122.81704221616498,-99.65039602133118,-0.353088189658459,-0.015168473930856408,0.3379197157276026,219458068,243289098.4,31.568420286048394,52.512903125019044,NaN,NaN,-0.04754202691301754,13.52225254277749
2005-08-18T09:30:00-04:00,64.77,65.14999,64.47,64.77,23391008,22953706.3,41.38949298566213,51.36109198765245,NaN,NaN,-128.2552844091168,-111.79763943781185,-0.35853646542761464,-0.1102508660569157,0.24828559937069894,196067060,230254653.6,27.795379020007033,48.71171601740959,NaN,NaN,-2.759598011307546,11.196273892193915
2005-08-19T09:30:00-04:00,65.05,65.16,64.71001,65.11,20513008,22580281.5,44.32748818619154,49.78874883741655,NaN,NaN,-101.64463927826561,-109.79157981253248,-0.3237218318758515,-0.15636669047411544,0.16735514140173607,216580068,226427610.4,26.78320146164843,44.7677966262532,NaN,NaN,-4.156268168745522,9.003053597773995
2005-08-22T09:30:00-04:00,65.24001,65.53999,64.87,65.48,22173504,22558347.1,47.41658743386956,48.250064516005196,NaN,NaN,-73.92569342149942,-109.15488635162373,-0.2628438699515817,-0.1611996960377411,0.10164417391384063,238753572,222297088.8,25.695601680872073,40.69426690617906,NaN,NaN,-4.4234915777988615,7.084975715549302
2005-08-23T09:30:00-04:00,65.50999,65.63,64.86,65.47,20685392,22494247.1,47.34013285907066,46.96640994100445,NaN,NaN,-66.83030996137173,-98.6945938572837,-0.21247287999738138,-0.16394692608288608,0.04852595391449529,218068180,217785389.6,24.524159962684408,36.92437927886437,NaN,NaN,-4.661593686625428,5.406894372381483
2005-08-24T09:30:00-04:00,65.24001,66.03,64.91,65.21001,28753104,22624637.5,45.29525569197748,46.28470363249109,NaN,NaN,-58.311871714081846,-85.79355975686707,-0.18679749615307892,-0.18497091627685336,0.0018265798762255522,189315076,211756791.2,23.0143525385014,33.88167491071505,NaN,NaN,-5.424834764475878,3.859504495687575
2005-08-25T09:30:00-04:00,65.34,65.67999,65.17999,65.57001,13913000,22249432.3,48.60567824779664,46.31854902707139,NaN,NaN,-48.61381010362186,-69.86526489576809,-0.13795472316345678,-0.17061682407809542,-0.03266210091463864,203228076,213188994.4,24.208129006468212,31.64995793635323,NaN,NaN,-5.1657697393741815,2.5701796049644665
2005-08-26T09:30:00-04:00,65.56,65.57001,64.44,64.5,19853296,22001306.7,40.71852169263929,45.898622785914036,NaN,NaN,-94.84181960729539,-68.50470096157403,-0.16809696906986743,-0.24278331225197292,-0.0746863431821055,183374780,206547936.8,22.468321622509734,29.84438213383907,NaN,NaN,-7.325010464003211,1.1565810236833698
2005-08-29T09:30:00-04:00,64.42999,65.37,64.2,65.37,23967600,22063291.5,48.09365689549386,45.94939683113487,NaN,NaN,-80.83934828695537,-69.88743193466523,-0.12197535531015771,-0.22715553731980265,-0.10518018200964493,207342380,200265698.4,20.935521331639094,28.34809321887078,NaN,NaN,-6.859193646058811,0.011470356577344187
2005-08-30T09:30:00-04:00,65.12,65.27,64.7,65.08,21959904,22335066.8,46.03763654141228,45.90087947931403,NaN,NaN,-75.389779348675,-71.5993258121259,-0.10422128651450929,-0.23545679015278154,-0.13123550363827224,185382476,193728557.6,19.448684589245744,27.14167760861033,NaN,NaN,-7.117853086862884,-1.007004421056974
2005-08-31T09:30:00-04:00,65.14999,66.53,64.92,66.53,25308704,22746417.2,56.135083937733825,46.24068388724752,NaN,NaN,67.12764785829778,-46.51142189764996,0.006102133481379862,-0.12360783678654741,-0.12970997026792727,210691180,198003778.4,23.285848778015065,26.36878800970037,NaN,NaN,-3.8217302802739086,-1.4091081152308218
2005-09-01T09:30:00-04:00,66.42,66.88,66.21001,66.53,21112192,22839471.6,56.135083937733825,47.00903718631532,NaN,NaN,167.34921817590194,-3.318816241745208,0.07611337293406198,-0.034568254100349805,-0.11068162703441178,210691180,199496399.2,24.635679037280468,25.81298060361629,NaN,NaN,-1.2970749135500133,-1.3931033721335635
2005-09-02T09:30:00-04:00,66.75999,66.8,65.89999,66.17,21928096,22274086,53.265176609686364,47.18563767444111,NaN,NaN,122.9118720959094,40.231922098895744,0.0940397769913732,0.00686809420480472,-0.08717168278656848,188763084,200574060,25.65282995922078,25.1955184997708,NaN,NaN,-0.11278587234193319,-1.2102008721633306
2005-09-06T09:30:00-04:00,66.37,67.19,66.27,67.16,26680800,22593766,59.410743747242165,48.34656121785669,NaN,NaN,184.24636242789515,93.24906424186585,0.1643201940309213,0.11822855975208313,-0.04609163427883815,215443884,202194360.8,27.24281750845209,24.80421048447092,NaN,NaN,2.9836237859473274,-0.6110830638618081
2005-09-07T09:30:00-04:00,67.13,67.47,66.88,67.36,14230199,22242055.95,60.53965985721058,49.62215704455144,NaN,NaN,190.28211828221126,146.3834437680431,0.21294040317116025,0.22008386968511218,0.007143466513951917,229674083,211052682.2,35.379378467898945,25.076421783174535,NaN,NaN,5.814626480355745,0.3068754424549851
2005-09-08T09:30:00-04:00,67.19,67.3,66.74001,66.98,13029301,21511436.2,57.27986090291066,50.75718332435491,NaN,NaN,136.5091812235149,160.2597504410865,0.20793608265737484,0.2670635698356705,0.05912748717829563,216644782,212243402.6,36.40882758625952,25.69166810933543,NaN,NaN,7.165783465163439,1.2867194456990498
2005-09-09T09:30:00-04:00,67.215,67.58,67.05,67.39,23016096,21483910.6,59.795293470129174,51.8620265589219,NaN,NaN,147.5565834219253,156.3012234902912,0.21952530660923236,0.3335341204398361,0.11400881383060373,239660878,218037342.2,41.30840391633249,26.729182570384292,NaN,NaN,9.068760545921538,2.398439602873691
2005-09-12T09:30:00-04:00,67.425,68.08,67.28,67.69,17628800,21089150.6,61.57800868945918,52.87355664860687,NaN,NaN,149.6597680054698,161.65080267220327,0.23338723089281443,0.4057428524466218,0.17235562155380735,257289678,231742661,50.93797655514571,28.53220934711812,NaN,NaN,11.18575189916992,3.6537699309160097
2005-09-13T09:30:00-04:00,67.55,67.55,66.91,67.17,23228896,21066050.6,56.870822695021104,53.55432020831761,NaN,NaN,97.1809898827315,144.23772816317054,0.19508455369905117,0.4162113136776213,0.22112675997857015,234060782,235466040.6,53.18520427035973,30.579426797666354,NaN,NaN,11.599729868798999,4.788907064899294
2005-09-14T09:30:00-04:00,67.19501,67.3,66.2515,66.39999,21257200,21189935.4,50.691402465795726,53.93975926359035,NaN,NaN,49.03263589718204,115.9878316861647,0.10969431323574425,0.35824465152325047,0.24855033828750622,212803582,232091940.4,50.90955026781005,32.57194092118841,NaN,NaN,10.034245581759969,5.538241138736533
2005-09-15T09:30:00-04:00,66.49001,66.64,66.06,66.17,23098608,21286435.4,48.97953496097589,53.96646331453172,NaN,NaN,17.95627249264974,92.27724993999166,0.03347959714461274,0.29039983471827213,0.2569202375736594,189704974,226703978.8,47.420309160242866,34.22995378931517,NaN,NaN,8.234752622769081,5.923457065026897
2005-09-16T09:30:00-04:00,66.57001,67.02,66.34,66.94,24336608,21333715.4,54.51745924712312,54.95210171128057,NaN,NaN,49.77635322741558,72.72120390108974,0.030751942193768422,0.29536016531586995,0.2646082231221015,214041582,221580119.6,44.310085060311806,35.790079749158174,NaN,NaN,8.3679767564279,6.272674163798468
2005-09-19T09:30:00-04:00,66.86,66.98,66.3,66.62,24514400,21533785,51.9917632057388,55.23053787629806,NaN,NaN,34.280215281236565,49.64529335624307,0.004596198206475055,0.27035347088019535,0.2657572726737203,189527182,208027620.4,37.334988697169855,36.961470275267516,NaN,NaN,7.707480112912873,6.477646442243383
2005-09-20T09:30:00-04:00,66.75999,66.92,65.56,65.66,29529200,21901569.8,45.22298018123787,55.172348136285606,NaN,NaN,-21.555069194641714,25.898081540768437,-0.07572647129996674,0.17109918354876186,0.2468256548487286,159997982,193215060.4,31.498712387821897,37.82218654659438,NaN,NaN,4.925979313789121,6.25597970960706
2005-09-21T09:30:00-04:00,65.53,65.61,64.60001,64.60001,28527200,22293660.2,39.16063101234651,53.95988721304365,NaN,NaN,-119.07620087246802,-7.7236858131615715,-0.19199780553077034,0.006828397935265684,0.19882620346603602,131470782,176948500.4,26.584073336941174,38.0577740150891,NaN,NaN,0.39823845911427946,5.419159530965234
2005-09-22T09:30:00-04:00,64.67,65.12,64.10001,64.92999,34380608,22575035.4,41.77727610174901,52.93432951047331,NaN,NaN,-128.9168530001355,-37.09831091171862,-0.23556369088718906,-0.09562841014295032,0.13993528074423875,165851390,172177783.6,25.335536029516362,38.10776380024881,NaN,NaN,-2.3799985364242064,4.3049940927667425
2005-09-23T09:30:00-04:00,64.61,65.3,64.24001,65.17999,27178400,23238305.4,43.75111240201327,52.25475349563951,NaN,NaN,-105.62876468904582,-68.1793344950109,-0.23584265317912156,-0.15486803572966323,0.08097461744945834,193029790,167975425.2,24.254913868305195,38.0079126508977,NaN,NaN,-4.005756799270425,3.1177439653328616
2005-09-26T09:30:00-04:00,65.62,65.85001,65.19,65.62,22874800,23389380.6,47.147309846395494,51.37879393129332,NaN,NaN,-58.75198553213926,-86.78577465768606,-0.19631205962233642,-0.16441545707846217,0.03189660254387424,215904590,173250906.8,28.3844818357571,38.08946010284806,NaN,NaN,-4.319124119589854,2.055334238915331
2005-09-27T09:30:00-04:00,65.52,65.85001,64.96001,65.39999,27077008,23544851,45.662723833353915,50.31615564387499,NaN,NaN,-76.03910033992672,-97.68258088674307,-0.1755753663134955,-0.18757260534799514,-0.011997239034499639,188827582,179016826.8,32.70302141354358,37.898291741822675,NaN,NaN,-5.016330616175015,1.045096402473853
2005-09-28T09:30:00-04:00,65.57001,65.64,64.74001,65.31,21580896,23525900.6,45.038034074402404,49.44173944183869,NaN,NaN,-94.08660656584041,-92.68466202541754,-0.15900763288607334,-0.21075678014209132,-0.05174914725601797,167246686,186172007.6,37.721847741765345,37.99207889578737,NaN,NaN,-5.76331528326514,0.072466161653997
2005-09-29T09:30:00-04:00,65.245,66.14999,64.81,66.03,24484608,23484695.8,50.833576839666016,48.80161682537703,NaN,NaN,-51.81082014722954,-77.26345545483636,-0.0938673506343549,-0.1690833355489616,-0.0752159849146067,191731294,191347988.4,41.14142985498678,37.98015217711982,NaN,NaN,-4.712715499248023,-0.611131218474863
2005-09-30T09:30:00-04:00,66.03999,66.44,65.78999,66.39,29016304,23879901.4,53.47520112395853,48.2228448564127,NaN,NaN,-2.291708802472141,-56.596044277521614,-0.024457913315905064,-0.10578837655948803,-0.08133046324358296,220747598,196891550,44.64700549809305,37.530797101616066,NaN,NaN,-3.043601642720699,-0.9586269933671252
2005-10-03T09:30:00-04:00,66.49001,67.06,66.44,66.78999,26406704,24103831.8,56.28554107609724,48.181039026489564,NaN,NaN,44.285533061108595,-35.988540558872046,0.04659660320106235,-0.02308470924225503,-0.06968131244331738,247154302,203141492.4,48.37985656345513,37.18755797969431,NaN,NaN,-0.78942501791905,-0.9344552825888287
2005-10-04T09:30:00-04:00,66.88,67.10001,65.72,65.78,17037600,23621671.8,48.34455328992239,48.01340694249861,NaN,NaN,-2.0102473040748383,-21.182769951701676,0.024869595607477507,-0.0385943179339705,-0.06346391354144801,230116702,211399316.4,52.89945420054961,37.32969397488999,NaN,NaN,-1.20204559737328,-0.9726824704151789
2005-10-05T09:30:00-04:00,65.77,65.77,64.05,64.10001,45606704,25190497.05,38.59144530442228,47.271400538459076,NaN,NaN,-125.18341767856998,-27.402132174247583,-0.0966866257783688,-0.184322195764409,-0.0876355699860402,184509998,214851978.8,54.685889143044236,37.84866397366152,NaN,NaN,-5.06536563251686,-1.5573514935725619
2005-10-06T09:30:00-04:00,64.09,64.53,62.86,63.53,59096496,27493856.8,35.941981681065656,45.94458071231211,NaN,NaN,-176.51821211537322,-52.34361056787632,-0.203384987506599,-0.34186680436928896,-0.13848181686268995,125413502,201588420.4,47.268903840971525,38.060008172280064,NaN,NaN,-9.095868546254001,-2.6342825010984816
2005-10-07T09:30:00-04:00,64,64.25999,63.60001,64.10001,24055104,27545807.2,40.35206707207267,45.11317384562168,NaN,NaN,-132.75632944509215,-78.43653469640033,-0.22196045758104507,-0.4159323888389963,-0.19397193125795123,149468606,187332622,40.85511379008806,38.31144567891708,NaN,NaN,-10.878286211630273,-3.8119973168887373
2005-10-10T09:30:00-04:00,64.245,64.28,63.3,63.38,16626199,27495677.15,36.8966449214618,44.51843561278053,NaN,NaN,-142.72664382370917,-115.83897007336387,-0.26614861945244916,-0.5266577055735127,-0.2605090861210635,132842407,164470243,33.09864598098477,38.42572664985729,NaN,NaN,-13.526728793943812,-5.199816099325177
2005-10-11T09:30:00-04:00,63.69,63.91,62.5,62.5,34322496,28050357.15,33.15925107221592,44.08976561705691,NaN,NaN,-168.18563098326737,-149.07404680920237,-0.33367748537323044,-0.6776059428376016,-0.3439284574643711,98519911,138150884.8,26.792437145472462,38.44060977903809,NaN,NaN,-17.03919760198932,-6.891156313991482
2005-10-12T09:30:00-04:00,62.44,62.8,61.25,61.62,63536608,30164327.55,29.89783359950222,43.241234009753576,NaN,NaN,-202.1242002014088,-164.46220331377015,-0.41153535918468914,-0.8583476564452326,-0.44681229726054345,34983303,108245545.8,21.727008768417633,38.182857831816754,NaN,NaN,-21.105239057988655,-8.921739563133935
2005-10-13T09:30:00-04:00,61.64,62.14,61.05,61.87,48558704,31437332.35,31.945689247264184,42.39798949870008,NaN,NaN,-179.89960122641946,-165.1384811359794,-0.4187338841940511,-0.9702296525031073,-0.5514957683090562,83542007,99871246.8,20.555063837257848,37.91858282959909,NaN,NaN,-23.63880660087866,-11.024177711383182
2005-10-14T09:30:00-04:00,62.5,63.02,61.32001,62.91,52777600,32859381.95,39.82137173252301,41.87470820485204,NaN,NaN,-120.70998484977514,-162.72921221691598,-0.3298968060581531,-0.9638667758817476,-0.6339699698235945,136319607,97241447,20.18682116850944,37.333035639081395,NaN,NaN,-23.18157204647926,-12.760948330682622
2005-10-17T09:30:00-04:00,62.86,63.33,62.23,63.02,32204400,33243881.95,40.60431711674253,41.5133934393798,NaN,NaN,-84.80523173878697,-151.14492979993156,-0.2441219846199727,-0.9391224505985605,-0.6950004659785878,168524007,104377767,24.15749539977365,36.722640923812115,NaN,NaN,-22.57568861278622,-14.16305408526885
2005-10-18T09:30:00-04:00,62.89999,63.03,62.10001,62.17,32724608,33403652.35,36.637633834218576,40.91336485079525,NaN,NaN,-94.71025176771506,-136.44985395682107,-0.22547153811130993,-0.9768398886177252,-0.7513683505064153,135799399,111833664.6,28.177797336741648,36.040923037739,NaN,NaN,-23.316895778694526,-15.470745755758232
2005-10-19T09:30:00-04:00,61.91,63.50999,61.38,63.50999,42623392,34108461.95,45.65148373927997,40.543215343624816,NaN,NaN,-68.3328548161585,-109.69158487977101,-0.10959709579001564,-0.8883647202439349,-0.7787676244539192,178422791,140521562.2,41.112405806040265,36.038849891385674,NaN,NaN,-20.899319619319233,-16.246256307695518
2005-10-20T09:30:00-04:00,63.39999,63.64999,61.88,62.33,47283104,34753586.75,40.22480253968306,39.59675830189085,NaN,NaN,-69.93504142018031,-87.6986729185232,-0.09942830869179653,-0.9030530103186649,-0.8036247016268684,131139687,150041098.2,44.67308436067653,36.040712667284495,NaN,NaN,-20.71715574685742,-16.88495622757579
2005-10-21T09:30:00-04:00,62.63,63.39,62.53,63.02,44329904,35611161.95,44.38778919933146,38.74691888212186,NaN,NaN,-48.202734059130535,-73.19722276039428,-0.036481832661193425,-0.8492269924533602,-0.8127451597921668,175469591,157871095,47.485740803685985,35.976847255872414,NaN,NaN,-19.143138859935224,-17.20755374648428
2005-10-24T09:30:00-04:00,63.14999,64.39999,62.92439,64.39999,30583904,35996617.15,51.641617881186825,38.98242349578361,NaN,NaN,0.5442535659311594,-56.12732569945065,0.10036161736454274,-0.6872931380864884,-0.7876547554510311,206053495,165376992.6,50.10433830015934,35.77719612013025,NaN,NaN,-15.204109671810462,-16.921347450102306
2005-10-25T09:30:00-04:00,64.21001,64.39999,63.27,63.85001,32327008,36259117.15,48.903854767865404,39.71902417174383,NaN,NaN,1.1380822345840755,-36.957658898990836,0.1529537782294893,-0.5964625326641695,-0.7494163108936588,173726487,172962410.2,52.67274819692591,35.63340033826466,NaN,NaN,-13.003657972444968,-16.361677524722687
2005-10-26T09:30:00-04:00,63.69,64.59,63.31,63.52,36712800,37015712.35,47.28400344426328,40.529168583400796,NaN,NaN,3.452957400233208,-22.600496455712495,0.16367125420021678,-0.5448272431433878,-0.7084984973436046,137013687,164680589.4,49.66668739442745,35.804670592082935,NaN,NaN,-11.782236594079738,-15.70747167748798
2005-10-27T09:30:00-04:00,63.265,63.33,61.94,62.19,27443696,37163666.75,41.34080519498466,40.599792735037376,NaN,NaN,-68.38229149985233,-22.289946471646886,0.08339059558989526,-0.6042602528562355,-0.6876508484461308,109569991,160366650.2,48.12596598864491,36.324017177694145,NaN,NaN,-12.713831740574848,-15.279808829357533
2005-10-28T09:30:00-04:00,62.435,63.27,62.02,63.06,38520096,37638856.35,46.11223403736496,41.258049100459026,NaN,NaN,-43.75357352030135,-21.400114363881052,0.09049131029616864,-0.57453671057592,-0.6650280208720887,148090087,154890749.4,46.16816834366797,37.25755448931437,NaN,NaN,-11.888693129946352,-14.79536372944165
2005-10-31T09:30:00-05:00,63.44501,64.55,63.41,63.78,35325504,38084796.35,49.75477994513531,42.44344401995327,NaN,NaN,52.434916788425994,-11.021981719382081,0.1422098481671663,-0.48726571066313085,-0.6294755588302972,183415591,150363168.6,44.554281406352025,38.52625765080577,NaN,NaN,-10.011296634957127,-14.111925573086719
2005-11-01T09:30:00-05:00,64.05,64.37,63.60001,64.10001,30224608,38744146.75,51.329475557353256,43.9742755883712,NaN,NaN,82.63568367254544,5.277538568210192,0.19333224963042162,-0.38781024679227016,-0.5811424964226918,213640199,158345911,48.0053955906962,40.403285280968525,NaN,NaN,-8.01204035893255,-13.240513399636123
2005-11-02T09:30:00-05:00,63.92,65.39,63.85001,65.39,33265008,38127061.95,57.158241670010675,45.77517218999594,NaN,NaN,160.80077922459006,36.747102933081564,0.30286229782776575,-0.2025646241379846,-0.5054269219657503,246905207,180324215,56.10609120463848,42.94264437863857,NaN,NaN,-4.34189985816197,-11.969282893711245
2005-11-03T09:30:00-05:00,65.77,66.16,65.27,65.62,43129904,37328732.35,58.12125096532411,47.08230642091031,NaN,NaN,196.1971035986355,89.66298195277912,0.37492301142798434,-0.03677315768076994,-0.4116961691087543,290035111,216417239,65.58786227276173,46.18557588608515,NaN,NaN,-1.1176102805977055,-10.41904394898074
2005-11-04T09:30:00-05:00,65.58,65.77,64.94,65.48,26502608,37451107.55,57.2772743410264,48.273231936930586,NaN,NaN,152.53787220340752,128.9212710975209,0.39525406932804374,0.0823714175513004,-0.31288265177674335,263532503,239505722.2,70.04549400188701,49.46329007195039,NaN,NaN,1.234156774273445,-8.754300988515856
2005-11-07T09:30:00-05:00,65.73,66.05,65.25999,65.72,20776800,37658637.6,58.392680634775104,49.82716385125605,NaN,NaN,147.5109472741971,147.93647719467512,0.4054460418296433,0.19392490051031075,-0.21152114131933253,284309303,259684464.6,73.3006820185217,52.6863532635061,NaN,NaN,3.4987692049626413,-7.0038623894475
2005-11-08T09:30:00-05:00,65.42999,65.57001,65.06,65.48,21210800,37003052.8,56.79579074204761,50.62318578002517,NaN,NaN,111.27116484800607,153.66357342976727,0.3771921798151382,0.25996908344959024,-0.11722309636554797,263098503,269576125.4,74.74927876743267,55.088987046462705,NaN,NaN,4.955776299105548,-5.295342576797065
2005-11-09T09:30:00-05:00,65.41499,66.10001,65.11,65.7,29763696,35314407.2,57.93150647455719,51.887950346801894,NaN,NaN,116.14536483701725,144.7324905522527,0.3548187557598214,0.32630034833422883,-0.0285184074255926,292862199,278767523.8,76.04961850055477,57.330168056454006,NaN,NaN,6.491513416795838,-3.6115060062837934
2005-11-10T09:30:00-05:00,65.64,66.25,64.74001,66.05,34588800,34615912,59.7445103860868,52.984859002998704,NaN,NaN,107.52590357057042,126.99825054663968,0.3447915207330643,0.4024709934907378,0.057679472757673475,327450999,286250701.4,77.08429688840337,59.444350633933816,NaN,NaN,8.301314528685074,-1.909674501288241
2005-11-11T09:30:00-05:00,66.05,66.49001,65.95,66.42999,19662800,32960172,61.675614917211355,53.701573077000454,NaN,NaN,125.1313602287645,121.51694815171106,0.3441563241512965,0.48787487794679407,0.14371855379549758,347113799,302966960.6,79.24166018917683,61.52558791172078,NaN,NaN,10.388911963064624,-0.15273357780926022
2005-11-14T09:30:00-05:00,66.50999,66.55,65.75,66.19,24330704,32566487.2,59.72686525609387,54.47464525473106,NaN,NaN,103.29054583338667,112.67286786354899,0.30909109627517395,0.530082424139465,0.2209913278642911,322783095,310661719,80.16723991475769,63.48948017728019,NaN,NaN,11.666656248475714,1.5357506830885932
2005-11-15T09:30:00-05:00,66.09,66.24001,65.14999,65.23,35159504,32688232,52.5711534520609,54.852298826716606,NaN,NaN,61.40665933633242,102.69996676121423,0.20763013173564593,0.4805289925338485,0.2728988607982026,287623591,315566736.6,80.75627428831898,65.71016495541531,NaN,NaN,10.837561549679048,2.864580806887229
2005-11-16T09:30:00-05:00,65.33,65.5,64.58,65.25,28430496,31978587.2,52.69829963250943,55.66354842939695,NaN,NaN,31.729363319062294,85.81676645762325,0.13194043664393967,0.43782440660312716,0.3058839699591875,316054087,320205114.2,81.32123197685696,68.08125538314474,NaN,NaN,10.187737422788597,3.9107460377302816
2005-11-17T09:30:00-05:00,65.42999,66.41,65.42,66.38,22203104,30724587.2,59.33187983968767,56.60780884384857,NaN,NaN,84.24791472523273,81.16116868855572,0.1469083407513685,0.4895193958983981,0.3426110551470296,338257191,322366352.6,81.59240413294629,70.61155793952176,NaN,NaN,11.498284378774791,4.994680086450925
2005-11-18T09:30:00-05:00,66.63,67.08,66.37,66.89,28896704,29952927.2,61.927040698818764,57.47725604054024,NaN,NaN,122.17978317817024,80.57085327843686,0.1780122440486268,0.5651263602078131,0.38711411615918634,367153895,326374371.8,82.1110762248336,73.29418614084186,NaN,NaN,13.381219818851614,6.192757191079595
2005-11-21T09:30:00-05:00,67.005,67.69,66.52,67.57001,30758608,29961662.4,65.12285083416687,58.462497131741216,NaN,NaN,141.0934236277527,88.13142883731007,0.22804327613749492,0.672168211331055,0.44412493519356006,397912503,341400253.4,83.93826386583959,75.8608195890664,NaN,NaN,15.97868874756712,7.590747413434956
2005-11-22T09:30:00-05:00,67.46001,68.11,67.28999,67.92999,21208704,29405747.2,66.7156190332107,59.145166943398365,NaN,NaN,160.60927570886454,107.97195211181649,0.2663714327927752,0.777089226184529,0.5107177933917538,419121207,367699776.6,86.5313432703686,78.03405187947568,NaN,NaN,18.6269349897875,9.167345638628177
2005-11-23T09:30:00-05:00,67.8,68.35001,67.7699,68.00999,21290896,28634652,67.07547393857448,59.78475429863054,NaN,NaN,163.37400805197842,134.30088105839974,0.2768804446500964,0.8568183492043744,0.579937904554278,440412103,392571379.8,88.43319754171134,79.66586154154352,NaN,NaN,20.900242574203677,10.84347377228182
2005-11-25T09:30:00-05:00,68,68.13,67.77,67.96001,5901000,27557517.2,66.59108526009273,60.450026507135284,NaN,NaN,144.53690295807482,146.35867870496813,0.26047596924403815,0.9055328661093256,0.6450568968652874,434511103,411822162.2,89.65126039591827,81.06627342683146,NaN,NaN,22.656420527418796,12.531037594444244
2005-11-28T09:30:00-05:00,68.12,68.14999,66.81,67.06,24596496,26861337.2,58.41095354801024,60.4513317152235,NaN,NaN,92.82711178720949,140.488144426776,0.17322198493238594,0.8615843780307699,0.688362393098384,409914607,420374304.6,90.14763341315245,82.26962709787652,NaN,NaN,21.933089887537843,13.874187922029044
2005-11-29T09:30:00-05:00,67.10001,67.57001,66.85001,67.16,23214608,26255792.4,59.01340682798537,60.609732864219055,NaN,NaN,73.3428696697354,126.93803363517252,0.10955839311120863,0.8253103844873948,0.7157519913761862,433129215,427417647,90.54966171007715,83.39822587949399,NaN,NaN,21.49823934943969,14.963338125944851
2005-11-30T09:30:00-05:00,67.13,67.78,67.07001,67.45,38382704,26663697.2,60.7874030745346,60.81372547850316,NaN,NaN,80.39029347979411,110.89423718935844,0.07589380334964724,0.8106192455632453,0.734725442213598,471511919,437895789.4,91.12955946401021,84.4753645197408,NaN,NaN,21.604714459487347,15.912106173593779
2005-12-01T09:30:00-05:00,67.78999,68.85001,67.4308,68.55,37393808,26870137.2,66.67871464935419,61.30902578302226,NaN,NaN,125.5886209598459,103.33715977093193,0.11431609068793325,0.8776205555735146,0.7633044648855813,508905727,451594514.2,91.83497066150817,85.52898407496257,NaN,NaN,23.460309102254197,16.990420877688123
2005-12-02T09:30:00-05:00,68.60001,68.82001,68.12,68.82001,23772192,25902251.6,67.95153036766442,61.75730545805461,NaN,NaN,129.05825222632507,100.241429624582,0.14267830395896008,0.9416523448342815,0.7989740408753214,532677919,471227877.4,92.72760550052985,86.49226588291636,NaN,NaN,25.378475143974338,18.18871434430044
2005-12-05T09:30:00-05:00,68.71001,68.75999,67.92,68.33,25918096,25873026,63.2310726591067,62.00760598684125,NaN,NaN,101.31092019230191,101.93819130560047,0.11442037004437733,0.9419995034307931,0.8275791333864158,506759823,490596920.6,93.48438545201583,87.44349056414907,NaN,NaN,25.640466767111153,19.25325040470197
2005-12-06T09:30:00-05:00,68.61,69.08,68.35001,68.53999,26482096,26158290.8,64.3732650064994,62.850613955015426,NaN,NaN,110.64311381241939,109.39824013413727,0.09656692988237903,0.9482877957393896,0.8517208658570106,533241919,510619461.4,94.16083950599048,88.40095950826847,NaN,NaN,26.18299574542395,20.24321402480511
2005-12-07T09:30:00-05:00,68.42,68.57001,67.75,68.12,23412400,26268370.8,60.336239055083816,63.39618105662788,NaN,NaN,71.44202312391455,107.60858606296135,0.045746784252123085,0.9089043461721644,0.8631575619200413,509829519,518282981.4,94.4004626999863,89.33519027420628,NaN,NaN,25.487006008744444,20.992327165367872
2005-12-08T09:30:00-05:00,68.25,68.81,67.7,68.3,33286000,26444486,61.45201232786972,63.54761909149802,NaN,NaN,74.7696845120564,97.44479877340345,0.01511351625486479,0.8820494572386224,0.8669359409837576,543115519,525124939.8,94.61301274718048,90.26523374665157,NaN,NaN,25.212078866221404,21.595148836918376
2005-12-09T09:30:00-05:00,68.39999,68.75999,67.92,68.64,22451696,25837630.8,63.53846303583466,63.66272068699915,NaN,NaN,80.93744414324068,87.82063715678657,0.008915218050782991,0.8780799635472363,0.8691647454964533,565567215,531702799,94.8167182258951,91.17277960387025,NaN,NaN,25.551742890036728,22.160376558792425
2005-12-12T09:30:00-05:00,68.88,68.97,68.28,68.85001,24178304,26063406,64.80560609579994,63.640060348544374,NaN,NaN,92.24696373642765,86.00784586561171,0.010041232858118754,0.8817162865691017,0.871675053710983,589745519,548299938.2,95.29968481651517,91.98430967177566,NaN,NaN,26.185687584940464,22.73542099109929
2005-12-13T09:30:00-05:00,68.67,69.03,68.31,68.86,24776896,26085715.6,64.86815243045656,63.50809844834765,NaN,NaN,88.0921433477876,81.49765177268537,0.002911262491026134,0.8753141318247657,0.8724028693337396,614522415,564556037.4,95.72030744209124,92.64066425547013,NaN,NaN,26.72933224540462,23.305979741714335
2005-12-14T09:30:00-05:00,68.75999,69.16,68.42,68.78,26972096,25676345.2,63.888970376990414,63.28049105109165,NaN,NaN,89.43959347749885,85.09716584340222,-0.014769221533083021,0.8539413424173858,0.8687105639504689,587550319,580100197.4,96.0814103887302,93.18696517311433,NaN,NaN,26.941761171413763,23.825377088814253
2005-12-15T09:30:00-05:00,68.82001,68.82001,67.73,68.08,31913808,25850510.8,55.93300626932111,62.51919969460796,NaN,NaN,29.951120779673943,76.13345309692572,-0.07766901245540525,0.7716242983812123,0.8492933108366175,555636511,582604395.8,96.13794611157972,93.65029986709017,NaN,NaN,24.936348938733175,23.984087353088384
2005-12-16T09:30:00-05:00,68.44,68.55,67.81,67.84,21479904,25814350.8,53.47428229741766,62.16658031956563,NaN,NaN,2.4774009732860014,60.44144446293478,-0.13608092917452508,0.6791921493684612,0.8152730785429863,534156607,576322274.2,92.53129530344796,93.82056143068269,NaN,NaN,22.530707574446993,23.776461670425327
2005-12-19T09:30:00-05:00,67.92,67.97,66.81,67,22946192,25516825.2,45.87353116833017,61.2280177724474,NaN,NaN,-125.10842689662513,16.97036633632425,-0.22659832641877498,0.5320251705195176,0.7586234969382926,511210415,560615253.4,84.04189066072986,93.35572064144358,NaN,NaN,17.97283183901594,22.9473716945097
2005-12-20T09:30:00-05:00,66.92,67.53,66.53999,66.98,28762608,25417025.2,45.70694874663691,60.150842463311854,NaN,NaN,-155.66257072631595,-31.78057647849646,-0.2796467975806829,0.40906499996243895,0.6887117975431218,482447807,534200331.8,72.06714966111682,91.99411994123692,NaN,NaN,14.221971366217973,21.700885933325168
2005-12-21T09:30:00-05:00,67.13,67.98,67.08,67.78999,30167392,25864959.6,53.130204198743954,59.18309171683969,NaN,NaN,-63.70095963718108,-62.40868710143245,-0.2528241888407259,0.37268156149221454,0.6255057503329404,512615199,519213307.8,66.29543686993767,90.1698675275533,NaN,NaN,12.985993644954313,20.45590132070076
2005-12-22T09:30:00-05:00,67.75,68.00999,67.39,67.97,20624192,25831624.4,54.615322560307426,58.23050544488562,NaN,NaN,-35.391508432383986,-75.47721294384404,-0.2169736344350378,0.3542887072891432,0.571262341724181,533239391,514733883.8,64.62938378703481,88.16285169087509,NaN,NaN,12.403325058446349,19.305533283235846
2005-12-23T09:30:00-05:00,68.10001,68.8,67.96001,68.13,15255301,26299339.45,55.95132989150956,57.71052381862869,NaN,NaN,33.48418480431475,-69.27585617763829,-0.17812634853949205,0.3486044060498159,0.526730754589308,548494692,517601500.8,65.23176510991811,86.14480738072527,NaN,NaN,12.300921837970357,18.304874505340777
2005-12-27T09:30:00-05:00,68.35001,68.42999,67.07001,67.11,26200400,26379534.65,46.54468848233362,56.43705406690255,NaN,NaN,-76.49109236256872,-59.55238927082701,-0.2143360656464316,0.25881067253126844,0.47314673817770003,522294292,519818276.2,65.71781692813633,84.11316291087853,NaN,NaN,9.215974793660061,17.00646026081496
2005-12-28T09:30:00-05:00,67.34,67.69,66.96001,67.50999,20488800,26243244.25,50.08840725634268,55.70506608127818,NaN,NaN,-102.04824756330034,-48.82952463822388,-0.20458292524131982,0.21741808162605025,0.4220010068673701,542783092,531885333.2,68.31453261161232,82.24988219028039,NaN,NaN,7.743601666376511,15.683194747323753
2005-12-29T09:30:00-05:00,67.5,67.72,67.14999,67.14999,20883600,25368289.05,47.06429444944127,54.677371947104724,NaN,NaN,-106.92744966264873,-57.47482264331741,-0.21456693238778363,0.15379234138264053,0.36835927377042416,521899492,533742191.8,68.70732295461518,80.39947577652573,NaN,NaN,5.570968992376481,14.238591068045572
2005-12-30T09:30:00-05:00,66.75999,66.99001,66.46001,66.72,33862096,25191703.45,43.67264615561877,53.2583850270893,NaN,NaN,-160.259286989135,-82.44837835466761,-0.24037597994433868,0.06788929884000083,0.3082652787843395,488037396,524701792.8,64.51409255554314,78.23500251435773,NaN,NaN,2.671528059079912,12.586153495336193
2006-01-03T09:30:00-05:00,67.21001,68.14999,66.05,68.05,40532000,26029693.85,54.57645545671499,52.5277314100118,NaN,NaN,-64.87601981279991,-102.12041927809055,-0.16188458770382635,0.10590954415455656,0.2677941318583829,528569396,520716733.6,62.697620914347944,75.90628366420292,NaN,NaN,3.729854530308848,11.320967928903714
2006-01-04T09:30:00-05:00,68.11,68.64999,67.88,68.42,29782704,26222924.25,57.06640702221106,51.970463880851405,NaN,NaN,47.64983318364441,-77.29223416884793,-0.08303033845960689,0.16400620878387429,0.24703654724348117,558352100,527928295.2,64.63801477103539,73.68611990198467,NaN,NaN,5.424525159354228,10.478618961825216
2006-01-05T09:30:00-05:00,68.42999,68.78999,68.25,68.78999,23712304,26084434.65,59.45956427299237,51.65407773056584,NaN,NaN,84.94573737004983,-39.89343718217788,-0.007893722761024652,0.23716939379220037,0.24506311655322502,582064404,535784557.6,66.67193892786145,71.58544336906547,NaN,NaN,7.592553829610371,10.06632394293738
2006-01-06T09:30:00-05:00,69.12,69.64999,68.67999,69.61,26874096,26257519.45,64.21982081525857,52.245993055275655,NaN,NaN,150.9753795366181,11.687128657675487,0.08971118316353627,0.35720209550764537,0.2674909123441091,608938500,553192359.2,70.69415172984782,69.76802948465605,NaN,NaN,11.097161674039615,10.213586475951985
2006-01-09T09:30:00-05:00,69.61,70.38,69.57001,70.07001,22286608,25707549.85,66.5898473778394,53.18281913244863,NaN,NaN,193.90039005333585,82.51906406616965,0.17310333875810147,0.48387008579173596,0.3107667470336345,631225108,581829901.6,75.85634746900543,68.57696178219588,NaN,NaN,14.759466655437189,10.862997930164157
2006-01-10T09:30:00-05:00,69.73,70.7,69.67999,70.7,27130704,25941500.25,69.56328945557885,54.87494472439497,NaN,NaN,191.97740244498706,133.88974851772704,0.2536688521687819,0.6278528122446119,0.37418396007583,658355812,607787184.8,79.39863869657842,68.24530092761363,NaN,NaN,18.837895080376605,12.002268951623078
2006-01-11T09:30:00-05:00,70.71001,70.73,70.03999,70.58,29591696,26212169.85,68.31608891040977,56.489883307521595,NaN,NaN,171.28159745968154,158.61610137293448,0.27979853136593735,0.7239321242832517,0.44413359291731436,628764116,621869588,81.02516648746762,68.88515927235296,NaN,NaN,21.668676919264705,13.383184375571881
2006-01-12T09:30:00-05:00,70.45,70.74001,70.05,70.33,24564000,26201525.05,65.67431773423144,57.385891417199275,NaN,NaN,142.52391893755035,170.1317376864346,0.2615051095679376,0.7710149798772363,0.5095098703092987,604200116,626296730.4,81.5191571539071,69.97256786406506,NaN,NaN,23.18876828262895,14.783982076580033
2006-01-13T09:30:00-05:00,70.27,70.47,70.02,70.36,20630304,25884435.45,65.84500157283514,58.18801134666554,NaN,NaN,118.77624059874907,163.69190989886079,0.23360004291096392,0.8015099239480037,0.5679098810370398,624830420,629475114.4,81.88380636730467,71.20502661979862,NaN,NaN,24.463396001825085,16.166755494472184
2006-01-17T09:30:00-05:00,69.98,70.05,69.53999,70.03,26981104,25637800.25,62.18217385124841,58.63307162950404,NaN,NaN,81.23546318437737,141.15892452506907,0.17762663244540078,0.7899431715937908,0.61231653914839,597849316,622799956,78.38572135392788,72.14459492294216,NaN,NaN,24.50657688738739,17.358158550602926
2006-01-18T09:30:00-05:00,69.39,70,69.3,69.88,30544304,26091020.25,60.533807745998594,59.63229443405154,NaN,NaN,64.87789863051931,115.73902376217552,0.11807707898473563,0.7599128878793096,0.6418358088945739,567305012,604589796,69.64478767493428,72.42509283342774,NaN,NaN,24.083331019122973,18.318897474677218
2006-01-19T09:30:00-05:00,70.05,71.17,69.94,71,26801904,26283805.85,67.46818566969253,60.873707177862244,NaN,NaN,105.68997969899468,102.62070021003817,0.14018706587041474,0.8170696412325924,0.6768825753621777,594106916,597658356,66.60045270150485,72.30265855413434,NaN,NaN,25.825600737321665,19.391283655054995
2006-01-20T09:30:00-05:00,71.03,71.12,69.83,70.19,43542608,27022805.85,59.34678139223293,61.75102767377594,NaN,NaN,79.37983383719748,89.99188318996758,0.0888330227412728,0.7879238537887687,0.6990908310474959,550564308,586931194.4,62.07786857996928,71.82912609880249,NaN,NaN,24.716719469645295,20.152060199996466
2006-01-23T09:30:00-05:00,70.25,70.56,69.99001,70.41,30482896,27038581.05,60.72946022543314,62.96937153590553,NaN,NaN,69.25260328063186,80.08715572634414,0.05965493793728727,0.773659503469105,0.7140045655318177,581047204,578174551.2,58.58081416439725,71.40532049943492,NaN,NaN,24.251259865149827,20.737660152161233
2006-01-24T09:30:00-05:00,70.45,71.42999,70.44,71.2,36770608,27845901.85,65.2942140100265,63.734925718284906,NaN,NaN,98.84385091714627,83.60883327289791,0.08214598031727738,0.8166870409284144,0.734541060611137,617817812,582168250.4,59.695972212448154,71.1909170207278,NaN,NaN,25.319033500496847,21.39214205906632
2006-01-25T09:30:00-05:00,71.39,71.60001,70.77,71.38,32586608,28712467.2,66.25664337570578,64.39137117210596,NaN,NaN,101.79933214299952,90.99311997539397,0.0967272107782482,0.8554500740839472,0.758722863305699,650404420,598788132,64.03553277631339,71.14788259253339,NaN,NaN,26.475241129200665,22.118299069085513
2006-01-26T09:30:00-05:00,71.62,72.45,71.41,72.41,38990896,29351992,71.18144348762623,65.22864825886552,NaN,NaN,137.62503177275133,97.3801303901453,0.15961090553755108,0.9582364952276379,0.7986255896900868,689395316,617845812,68.25621625462504,71.26104525873079,NaN,NaN,29.158308499955133,23.124014702066887
2006-01-27T09:30:00-05:00,72.53999,73.24001,72.25999,72.77,29044192,29779761.6,72.68215338825289,65.83310058550798,NaN,NaN,165.93703899000266,114.69157142070632,0.20635156165763224,1.056565041762127,0.8502134801044948,718439508,651420852,74.03709248674383,71.49982674136622,NaN,NaN,31.826959410210115,24.36729251751592
2006-01-30T09:30:00-05:00,72.7,72.98,72.47,72.56,28170304,30144096.8,70.37978949998929,66.10381073709011,NaN,NaN,152.79779573016,131.40060991061196,0.20367746614647764,1.104810312787592,0.9011328466411143,690269204,673265252,76.97502857777101,71.57973253484948,NaN,NaN,33.27248142724596,25.63946236176307
2006-01-31T09:30:00-05:00,72.48,72.96001,72.13,72.35001,38124704,30357227.2,68.05817307264577,65.99630242402345,NaN,NaN,136.47644595236773,138.92712891765626,0.16970775817267514,1.1132675443569582,0.943559786184283,652144500,680130589.6,77.82434954699897,71.46728330987952,NaN,NaN,33.76542405634803,26.800314032418065
2006-02-01T09:30:00-05:00,72.59,73.21001,72.47,73.10001,35012400,30081247.2,71.65460872320803,66.23476812493763,NaN,NaN,143.91715832302236,147.35069415366084,0.17878083560743607,1.1670358306935782,0.9882549950861421,687156900,687481085.6,78.7290385234636,71.30327416959351,NaN,NaN,35.318171665659996,28.017150837166913
2006-02-02T09:30:00-05:00,73,73.09,71.66,72,52251008,31204662.4,60.83553824350973,65.8891410184575,NaN,NaN,87.80655280571992,137.38699836025452,0.0958858774199447,1.108112341861073,1.0122264644411283,634905892,676583200.8,73.91441508033336,70.7600783071954,NaN,NaN,33.100151250968764,28.74329375342432
2006-02-03T09:30:00-05:00,71.81,72.49001,71.50999,71.78,42793600,32158727.2,58.919451153705886,65.39445884566256,NaN,NaN,58.575462808807586,115.91468312401553,0.015634265932816804,1.0317692968571492,1.0161350309243324,592112292,651317757.6,64.1236817851898,69.49149797990148,NaN,NaN,30.716891928270396,29.025236349830905
2006-02-06T09:30:00-05:00,71.89999,72.45,71.52,72.42,24744704,32052257.6,62.60895114847133,65.42494293832134,NaN,NaN,64.05878046295943,98.16688007057542,-0.003906067740388597,1.0112524462488466,1.0151585139892352,616856996,636635316,59.214906323565486,68.1221540491613,NaN,NaN,29.864874457401463,29.145184650912412
2006-02-07T09:30:00-05:00,72.27,72.59,71.14999,71.25,41861392,33030996.8,53.20198310122792,64.90124117798057,NaN,NaN,27.181279131465434,76.30784670639495,-0.09987048086416084,0.8903204129090341,0.9901908937731949,574995604,621205536.8,54.49375856733692,67.03993768433291,NaN,NaN,25.848335106374176,28.674206144549807
2006-02-08T09:30:00-05:00,71.44,71.84,70.88,71.7,36004608,33474692,55.94375936007659,64.07806787015086,NaN,NaN,10.071010772994116,49.53861719638932,-0.13509317288525635,0.8213244276666245,0.9564176005518809,611000212,605974199.2,50.235877240684935,65.8710394371315,NaN,NaN,23.517764389257483,27.937571608079473
2006-02-09T09:30:00-05:00,71.78,72.34,71.24001,71.33,33152400,33652727.2,53.18467508701914,63.637917419778454,NaN,NaN,18.509770024292802,35.67926064010387,-0.18242027882633394,0.7283922520189634,0.9108125308452973,577847812,594562583.2,47.25665078043024,64.81238102287871,NaN,NaN,20.736007806152426,26.908776779232753
2006-02-10T09:30:00-05:00,71.17999,71.42999,70.37,71.17999,31342400,33991647.2,52.063559613576246,63.01892451893154,NaN,NaN,-34.91203774585299,16.981760529171748,-0.22039821123470837,0.6353147668019119,0.8557129780366203,546505412,585441207.2,44.96141457856439,63.83956676674779,NaN,NaN,18.16608318466698,25.659820551437644
2006-02-13T09:30:00-05:00,71.03999,71.14999,70.35001,70.71001,29784496,34449356.8,48.606535917266086,61.8269475123058,NaN,NaN,-59.1322554887236,-7.656446661164855,-0.27044280261031806,0.5176594747737226,0.7881022773840407,516720916,565413991.2,40.32977121219514,62.456266695301146,NaN,NaN,14.932451101970715,24.1273392015138
2006-02-14T09:30:00-05:00,70.8,71.78,70.31,71.53,46126096,35406606.4,54.30725464766544,60.9734197460172,NaN,NaN,-28.131405241460286,-18.71898353575,-0.2424878562349131,0.4849924570903994,0.7274803133253125,562847012,562984272.8,39.79417841013229,60.724741383431066,NaN,NaN,13.883513688418681,22.663935556785926
2006-02-15T09:30:00-05:00,71.50999,72.16,71.17999,72.16,40853104,35922046.4,58.148316748654125,60.0424821218049,NaN,NaN,21.570978835749806,-16.41898992319886,-0.17868179425580322,0.5041280705055584,0.6828098647613616,603700116,561524253.6,39.45510054836246,58.66751883298374,NaN,NaN,14.219964460777376,21.457653971641847
2006-02-16T09:30:00-05:00,72.37,72.83,72.12,72.8,30262192,36095060.8,61.673095997808915,59.25612087963033,NaN,NaN,89.15733244056115,-2.2894774399451934,-0.09470433818037927,0.5644294420358875,0.6591337802162668,633962308,572747152.8,43.44431461368668,56.482320413479655,NaN,NaN,15.641581622181844,20.62678649314756
2006-02-17T09:30:00-05:00,72.83,72.89999,72.3,72.64999,17558400,34795850.4,60.389277156785525,58.54251285511578,NaN,NaN,85.43227393957277,21.77938489713996,-0.05268682233302213,0.5932752522999891,0.6459620746330113,616403908,586726852,48.0371432961266,54.41532860764791,NaN,NaN,16.39162058756766,20.02176279235043
2006-02-21T09:30:00-05:00,72.75,72.92999,71.85001,72.33,21177392,34330575.2,57.633259138557705,57.79787614553806,NaN,NaN,52.61049901907033,44.12793579869874,-0.049899254303050755,0.5835880067541979,0.6334872610572486,595226516,602427972,52.6846840816451,52.619638217265496,NaN,NaN,16.1971642777207,19.475391575974754
2006-02-22T09:30:00-05:00,72.47,73.00999,71.98,72.82001,28699296,33927009.6,60.598679202830205,57.0081668940825,NaN,NaN,73.70144348177791,64.49450554334638,-0.020040348290542354,0.6084368256940706,0.628477173984613,623925812,614643732,55.98323260953747,50.9949377948422,NaN,NaN,16.918893369263944,19.11017754644464
2006-02-23T09:30:00-05:00,72.75,73.27,72.38,72.77,38797904,34237574.4,60.136050407059955,56.95820347719324,NaN,NaN,91.62725675129695,78.50576112645581,-0.009196044089565758,0.6169821188726559,0.6261781629622216,585127908,610929290.4,54.733739175801055,49.62488951594704,NaN,NaN,17.373977002194056,18.862148897265985
2006-02-24T09:30:00-05:00,72.69,73.35001,72.45,73.35001,22995696,33437814.4,63.6062876857125,57.292977515193705,NaN,NaN,108.44311145603514,82.36291692955061,0.029389163927485584,0.6629146178715786,0.633525453944093,608123604,605761549.6,52.96266122443249,48.82767376160724,NaN,NaN,18.79020145162202,18.851870690745418
2006-02-27T09:30:00-05:00,73.41,73.88,73.32001,73.55,20584000,33014804.8,64.7458715995915,57.445614690273715,NaN,NaN,156.4417983499128,96.56482181161861,0.059020160209157235,0.7073006542055396,0.6482804939963823,628707604,608222288.8,53.730424999323155,48.43592509558993,NaN,NaN,20.297721904358866,19.05842086411877
2006-02-28T09:30:00-05:00,73.38,73.47,72.44,72.58,36401504,33426364.8,55.64479739827908,57.62010142577738,NaN,NaN,70.89841302023562,100.22240461185167,0.006684976885309557,0.6566367151030192,0.6499517382177097,592306100,607638205.6,53.50717538860962,48.36545486853798,NaN,NaN,18.91887951778522,19.03848638607112
2006-03-01T09:30:00-05:00,72.77,73.89999,72.62,73.89999,26244896,32832374.4,63.221180824405494,58.13991724465801,NaN,NaN,126.80786076021374,110.84368806753885,0.05184505247439053,0.7147580538106979,0.6629130013363074,618550996,606563242.4,53.07013238619636,48.56790166464594,NaN,NaN,20.18000990687803,19.20156117475782
2006-03-02T09:30:00-05:00,73.66,73.89,73.09,73.59,36546000,32909054.4,60.60315261685437,58.669808496789095,NaN,NaN,123.50586456401234,117.21940963008191,0.05160622073591359,0.7274207772561994,0.6758145565202858,582004996,605938660,52.80027818431475,48.96387505063768,NaN,NaN,20.346483005754806,19.365121436328817
2006-03-03T09:30:00-05:00,73.21001,74.14,73.14999,73.22,38377600,32215384,57.540323675590066,59.061005929790085,NaN,NaN,106.76142176581834,116.88307169203856,0.01897743434026966,0.6995363494456228,0.6805589151053532,543627396,593039418.4,47.435612699393886,49.14060348783979,NaN,NaN,19.518710783607688,19.38706277165437
2006-03-06T09:30:00-05:00,73.39999,73.46001,72.44,72.64999,29343296,31542868.8,53.08892123268356,59.38117630946277,NaN,NaN,43.432099307632555,94.2811318835825,-0.045049717589189964,0.6242467681188657,0.6692964857080557,514284100,570154717.6,39.72429822210366,49.097355417118976,NaN,NaN,17.411528629760067,19.104843608526615
2006-03-07T09:30:00-05:00,72.39,72.39999,71.44,71.60001,38899696,32250618.4,46.025624035869804,58.78963126576308,NaN,NaN,-48.3488141539178,70.43168644875182,-0.1559282343273789,0.474386192798832,0.6303144271262109,475384404,546770378.4,33.69632887786335,48.66179473624261,NaN,NaN,13.177997874532357,18.258151360813148
2006-03-08T09:30:00-05:00,71.45,72,70.88,71.85001,51667392,32740918.4,47.80622242182951,58.05091024241846,NaN,NaN,-68.51642172407968,31.366829951893134,-0.20704276520367748,0.371510970621614,0.5785537358252915,527051796,528470538.4,29.87566169332534,47.977549103739975,NaN,NaN,10.353726167775552,17.128947761807776
2006-03-09T09:30:00-05:00,71.87,72.39,71.22,71.22,31106800,32496028,43.87782385821745,56.77981937530478,NaN,NaN,-66.90454364717444,-6.71525169034422,-0.2737071693851105,0.23641977409390336,0.5101269434790139,495944996,511258538.4,26.797956445135384,46.788523520272015,NaN,NaN,6.70178672851193,15.639353328479798
2006-03-10T09:30:00-05:00,71.39999,72.35001,70.98,72.32001,40266304,32851723.2,51.38887413833613,56.136933445415536,NaN,NaN,-44.48833091088972,-36.96520222568583,-0.23559360591605571,0.21563493608394424,0.45122854199999995,536211300,509775319.2,26.544187998426125,45.25331242757913,NaN,NaN,5.980610271339517,14.259532891745472
2006-03-13T09:30:00-05:00,72.60001,73.08,72.2,72.47,35128896,33041048,52.32578880600536,55.75782842166179,NaN,NaN,13.31375988784194,-42.98887010964394,-0.1938963096834449,0.20885815489569381,0.4027544645791387,571340196,521186538.4,31.888225898523373,43.76785112878472,NaN,NaN,5.709715075774639,13.038130346606781
2006-03-14T09:30:00-05:00,72.28,73.27,72.00999,73.27,38079104,33455778.4,57.07761521717599,55.506323851257925,NaN,NaN,34.764194540202446,-26.366268370819892,-0.11021459178401127,0.2649862248491246,0.37520081663313587,609419300,547993517.6,42.47575888491028,42.803031577025635,NaN,NaN,7.017840127930344,12.178088886795862
2006-03-15T09:30:00-05:00,73.3,74.34,73.03999,73.94,31951392,32747043.2,60.617954019499614,55.54074553786075,NaN,NaN,134.63295241903978,14.263606457804002,-0.012649680634521654,0.3593887158399838,0.37203839647450543,641370692,570857296.8,49.66274688806743,42.44081784218751,NaN,NaN,9.27471494904145,11.763321181402375
2006-03-16T09:30:00-05:00,74.2,74.5,73.77,73.77,32565104,32332643.2,59.28184620555476,55.23185686070662,NaN,NaN,147.3354777484221,57.11161073692331,0.03492442679523944,0.4156939299685547,0.38076950317331526,608805588,593429415.2,55.565148310258486,42.62670977688937,NaN,NaN,10.671636252693805,11.607366191586864
2006-03-17T09:30:00-05:00,74.13,74.3,73.7,74.07001,31551600,32397113.6,60.91895626381818,54.95850576529425,NaN,NaN,128.3150264432882,91.6722822077589,0.07858669395011197,0.47900287061095526,0.4004161766608433,640357188,614258592.8,60.20259061256521,43.08900732069237,NaN,NaN,12.31850693249489,11.708957726002296
2006-03-20T09:30:00-05:00,74.19,74.33,73.71001,74.03,25640704,32801228.8,60.56920509362232,55.31024917210448,NaN,NaN,110.85343750093611,111.18021773037772,0.09562985018963904,0.5199534893978921,0.42432363920825306,614716484,622933850.4,61.982247043933654,43.694369581786944,NaN,NaN,13.55501182557671,11.972679740227212
2006-03-21T09:30:00-05:00,74,74.60001,73,73,44489904,33966854.4,52.252238129176625,54.52675326530241,NaN,NaN,54.78642226748327,115.1846632758339,0.03169842421739355,0.46394666947999497,0.4322482452626014,570226580,615095306.4,59.397675721270545,44.14633696286368,NaN,NaN,12.169903114406527,12.000854507967114
2006-03-22T09:30:00-05:00,72.99001,74.22,72.89,74.13,36222096,34342994.4,58.91721809813243,54.40632937110799,NaN,NaN,69.36464588023807,102.13100196807355,0.058138996569708,0.5049219909747364,0.44678299440502844,606448676,608110903.2,57.112442525356606,44.45434870150952,NaN,NaN,13.08092317660034,12.155150032057575
2006-03-23T09:30:00-05:00,74.03,74.45,73.75,74.45,25419600,33674079.2,60.59469571111592,54.624498802216976,NaN,NaN,103.26869703561474,93.31764582551207,0.08801210995584219,0.5567981318498312,0.468786021893989,631868276,612723440.8,58.25469987459764,45.2271406425955,NaN,NaN,14.348267679584689,12.468452553132877
2006-03-24T09:30:00-05:00,74.28,74.94,74.10001,74.89999,27560192,33902304,62.88942839045017,55.32453502777174,NaN,NaN,126.22027776218853,92.89869608929214,0.1265657363139564,0.6269931922864345,0.5004274559724781,659428468,616537696.8,59.22189541482021,46.619826156360965,NaN,NaN,16.11699407047237,12.989672769895662
2006-03-27T09:30:00-05:00,74.81,74.94,74.42,74.91,23334000,34039804,62.94112779149959,56.53278529603101,NaN,NaN,123.12999135633287,95.3540068603715,0.14017213059174172,0.6756426192121552,0.5354704886204135,682762468,630146893.6,62.55541533720799,48.681189474885585,NaN,NaN,17.545578552609143,13.640516453140446
2006-03-28T09:30:00-05:00,74.81,75.3,74.33,74.52,27179200,33578688.8,59.465236153086636,57.3655719911208,NaN,NaN,108.98661053608559,106.19404451409196,0.11158162909497815,0.6749475249891361,0.563365895894158,655583268,647218231.2,66.27927003631433,51.28144721367051,NaN,NaN,17.763067130642014,14.229452264212098
2006-03-29T09:30:00-05:00,74.66,75.96001,74.66,75.89999,33999104,33966399.2,66.5123648578516,58.9823249196661,NaN,NaN,151.1881866502301,122.55875266809035,0.1707440018257501,0.7767958981763456,0.6060518963505955,689582372,663844970.4,69.4644479940498,54.329053752878686,NaN,NaN,20.235035154032023,15.087392677043516
2006-03-30T09:30:00-05:00,76,76.24001,75.27,75.7,29735504,33625874.4,64.75534290401008,59.93707268864281,NaN,NaN,145.87731874970154,131.0804770109077,0.18058699413018986,0.8317856390133329,0.651198644883143,659846868,669440688.8,70.47522821087249,57.46698519662486,NaN,NaN,21.68776134110215,16.03030248619475
2006-03-31T09:30:00-05:00,75.92999,76,75.33,75.97,24722400,32943114.4,66.0589312783614,60.91801143666823,NaN,NaN,129.31496630130513,131.69941471873102,0.18858363786624344,0.8869281922159473,0.6983445543497039,684569268,674468848.8,71.39162195417859,60.28865634345737,NaN,NaN,23.275248863233998,17.065294825771783
2006-04-03T09:30:00-04:00,76.12,76.41,75.3,75.34,35542000,33253049.6,60.441427529530664,61.15828374469356,NaN,NaN,112.36944577561566,129.5473056025876,0.13713811111773466,0.8697671932468722,0.7326290821291376,649027268,667721808.8,68.32700074471506,62.135173619157705,NaN,NaN,22.954458736523424,17.90660395587916
2006-04-04T09:30:00-04:00,75.28,75.99001,75.07001,75.67999,30181200,32817124.8,62.304425867274965,61.27874601953466,NaN,NaN,99.27655220852536,127.60529393707554,0.11272217324864109,0.8735317986899389,0.7608096254412978,679208468,672446848.8,69.32025002254215,63.53928098590591,NaN,NaN,23.237171630786655,18.668113623723087
2006-04-05T09:30:00-04:00,75.83,76.2,75.27,76.07001,27473200,31607415.2,64.3769895891927,61.64268483265165,NaN,NaN,105.83112337362759,118.53388128175504,0.10946366293414878,0.8976392041089838,0.788175541174835,706681668,675866708,70.05226582556296,64.57407509414193,NaN,NaN,24.08478893251602,19.441924382122078
2006-04-06T09:30:00-04:00,75.94,76.23,75.55,76.23,25663696,31335260,65.22171647521485,61.950024847751415,NaN,NaN,106.06105346714445,110.57062822524362,0.10470756778047596,0.9190600009004299,0.814352433119954,732345364,690366407.2,72.99437218669382,65.48777377800826,NaN,NaN,25.02575528564675,20.239614511197033
2006-04-07T09:30:00-04:00,76.37,76.69,74.86,75.00999,51460496,31894969.6,54.59101128821289,61.523011004507886,NaN,NaN,67.13968039058798,98.13557104310021,0.010955112034170322,0.8280463231626669,0.8170912111284966,680884868,689629527.2,72.60400130526406,66.24647051096044,NaN,NaN,22.581863437898274,20.57422150072578
2006-04-10T09:30:00-04:00,75.03,75.46001,74.50999,74.92999,39135904,32095320,53.969810464437,61.645694742740766,NaN,NaN,18.636022751212792,79.38888643821966,-0.06093607372431298,0.7409211189731053,0.8018571926974183,641748964,688173866.4,71.78726186661159,67.13144094991337,NaN,NaN,20.43522053385041,20.554364219743583
2006-04-11T09:30:00-04:00,75,75.06,73.45,73.60001,49801296,32681429.6,44.83555349169085,60.639861556566366,NaN,NaN,-69.5187020588514,45.6298355847443,-0.19498830200628225,0.5581218151895655,0.7531101171958478,591947668,670721706.4,62.68296913024599,67.52933570740547,NaN,NaN,15.406097421639805,19.818897534300184
2006-04-12T09:30:00-04:00,73.62,74.39999,73.55,74.37,41327008,33150210.4,50.10103978547101,59.890314704734585,NaN,NaN,-66.03733088363532,11.25614473329172,-0.2265150308955659,0.4699663285763904,0.6964813594719563,633274676,656040308,56.22319586701223,67.38422827829223,NaN,NaN,12.86773886263287,18.82587486691914
2006-04-13T09:30:00-04:00,74.2,74.92999,73.75999,74.56,35418096,33292860,51.33541015557527,59.06502768795781,NaN,NaN,-40.27547783579772,-18.011161527296714,-0.2286254130536205,0.41069959315493065,0.6393250062085511,668692772,643309789.6,51.287560106706714,66.8174900419984,NaN,NaN,11.234611022300712,17.74140860340222
2006-04-17T09:30:00-04:00,74.63,74.92999,73.89999,74.61,38362896,33633424.8,51.67420290337619,58.260247338806145,NaN,NaN,-37.53385829899973,-38.945869265214256,-0.22060095862185547,0.36357380793123184,0.5841747665530873,707055668,648543949.6,53.11016231376633,66.14282911175256,NaN,NaN,10.030424834714408,16.639839493589676
2006-04-18T09:30:00-04:00,74.81,76.7,74.8,76.7,58649392,35283859.2,63.2052320793156,58.527389904965354,NaN,NaN,104.61234583493365,-21.750604648470087,-0.07595401172539806,0.4892322518963397,0.5651862636217377,765705060,673335168.8,60.62483356416327,65.7389407923132,NaN,NaN,12.870762203352495,16.10139988069865
2006-04-19T09:30:00-04:00,76.69,77.34,76.27,77.25999,44132400,35265984,65.57538723838363,58.46046293214622,NaN,NaN,166.36891572220082,25.426918907740365,0.049274085395338396,0.6267788703659107,0.5775047849705723,809837460,716913127.2,69.78992396301086,65.76218907581043,NaN,NaN,15.974398487691188,16.083256824554727
2006-04-20T09:30:00-04:00,77.33,77.33,76.23,76.85001,44624000,35686079.2,62.405938645904506,58.29264834228154,NaN,NaN,138.66238604926883,66.3668622943212,0.09375263492064434,0.6946955786213778,0.6009429437007334,765213460,743300884,73.77112644430616,65.99761037819853,NaN,NaN,17.425746789508807,16.275041105262453
2006-04-21T09:30:00-04:00,77.27,77.35001,76.25999,76.67999,40075808,36418889.6,61.087329712650956,57.93753394473079,NaN,NaN,124.26829430128255,99.27561672173725,0.10038729871889418,0.7264270670993511,0.6260397683804569,725137652,754589860,75.27246954793895,66.27481377775285,NaN,NaN,18.169656167605467,16.545700399882882
2006-04-24T09:30:00-04:00,76.53999,76.7,75.73,76.07001,39232800,37002520,56.47670560680512,57.65433952167897,NaN,NaN,64.26571422109099,119.6355312257554,0.05464832572849443,0.694350175541075,0.6397018498125806,685904852,750359696.8,73.57302811821131,66.64953001871687,NaN,NaN,17.36377019366698,16.66256751328061
2006-04-25T09:30:00-04:00,76.10001,76.21001,75.48,76.12,42941200,37982880,56.76471004185474,57.258645534148954,NaN,NaN,38.32477643483953,106.37801734573657,0.020473473390337338,0.6652936915505023,0.644820218160165,728846052,742987895.2,70.58236535006881,66.73968111354021,NaN,NaN,16.803381849451153,16.68268384701926
2006-04-26T09:30:00-04:00,76.06,76.75,75.78,76.06,31348608,38191350.4,56.283305913338026,56.680525271587896,NaN,NaN,59.31546796909544,84.9673277951155,-0.011727677956913984,0.6301606207140225,0.6418882986709364,697497444,720519892,62.273738180705244,66.18407199605038,NaN,NaN,16.21074100144245,16.615263440508286
2006-04-27T09:30:00-04:00,75.52,76.67,74.89,75.42999,92035680,41093179.2,51.35813291820107,55.690269303229776,NaN,NaN,2.9978810150205666,57.834426788265844,-0.07735369099890599,0.5451961849223039,0.6225498759212099,605461764,688569552.8,52.762183617107574,64.73891566965135,NaN,NaN,14.264776800091974,16.27947963473453
2006-04-28T09:30:00-04:00,75.24001,76.35001,75.10001,76.2,37919200,41502364,56.3820322000341,55.818199368359856,NaN,NaN,25.167423293633483,38.014252586736035,-0.07096722535162692,0.5338408442316762,0.6048080695833031,643380964,672218215.2,48.66551890302809,63.02902406949164,NaN,NaN,14.026283693124972,15.957594500218878
2006-05-01T09:30:00-04:00,76.28999,76.64,75.25999,75.25999,44221600,42477324,49.641470106870386,55.509032199962235,NaN,NaN,8.38652637346902,26.838415017211645,-0.12874725507754492,0.44387400073637195,0.5726212558139169,599159364,654869117.6,44.69980334653227,61.094205603771684,NaN,NaN,11.692996493778116,15.348366213584484
2006-05-02T09:30:00-04:00,75.71001,76.32001,75.41,76.28999,36132096,42506828.8,55.8674013911285,56.29702133563635,NaN,NaN,36.047150954423046,26.38288992112835,-0.09770179942193191,0.45049400653650196,0.5481958059584339,635291460,636158199.2,40.83493285054085,59.53363158379274,NaN,NaN,11.674518630492804,14.823530844571387
2006-05-03T09:30:00-04:00,76.24001,76.50999,75.69,76.16,35151904,42755364,54.94417055053459,56.64295924742661,NaN,NaN,44.20134362350293,23.36006505200985,-0.08641487413836291,0.4401772132854802,0.5265920874238431,600139556,616686621.6,37.22760852515996,58.176803916517585,NaN,NaN,11.373840688413203,14.330717965120218
2006-05-04T09:30:00-04:00,76.25,77.09,76.25,77.09,30352000,42899304,60.0329290651011,57.26421059810702,NaN,NaN,103.64408560220637,43.48930596944702,-0.020260849731602026,0.5012660252593406,0.5215268749909426,630491556,621692580,38.726252820234286,57.27956768176955,NaN,NaN,12.749803543738143,14.104873047779922
2006-05-05T09:30:00-04:00,77.52,78.02,77.32001,77.52,37838800,43508059.2,62.160928528097266,58.01326242844424,NaN,NaN,158.8891018536757,70.2336416814554,0.04495225284555093,0.5777171910478813,0.5327649382023304,668330356,626682458.4,40.25734665127104,56.36150942016274,NaN,NaN,14.55505484174945,14.169184732632711
2006-05-08T09:30:00-04:00,77.52,77.81,77.33,77.63,24715008,42170784.8,62.70793757386314,57.977741392340484,NaN,NaN,138.66330407976565,96.28899722271473,0.08563291755314417,0.6398060851437606,0.5541731675906164,693045364,645459658.4,45.7508093825925,55.29907912147911,NaN,NaN,16.16933014495868,14.45491979153642
2006-05-09T09:30:00-04:00,77.57001,77.78999,77.35001,77.52,21582304,41293104.8,61.74665263112676,57.704260348965,NaN,NaN,123.34165776729421,113.74789858528895,0.09456951703007455,0.6723850638782096,0.5778155468481351,671463060,652693978.4,47.744444658719075,53.72440202831542,NaN,NaN,17.21737028032647,14.849555575649285
2006-05-10T09:30:00-04:00,77.38,77.46001,76.73,77.05,26824096,40144244.8,57.678183257475176,57.36656353550576,NaN,NaN,77.44960908298407,120.39755167718518,0.059951178060436594,0.6527545194236808,0.5928033413632442,644638964,661593860,50.170550444141696,52.03864659973224,NaN,NaN,16.961537498864455,15.151267278965738
2006-05-11T09:30:00-04:00,77.12,77.16,75.23,75.31,46911296,40423459.2,45.678592837252346,56.26593947297728,NaN,NaN,-37.449467769734945,92.17884100279693,-0.08133687590535099,0.4911322464815555,0.5724691223869065,597727668,655041082.4,48.38919120016798,50.118412432034305,NaN,NaN,12.728474021734652,14.805153956504155
2006-05-12T09:30:00-04:00,74.81,74.85001,73.5,73.5,62645696,41784839.2,37.044888824359795,54.87795255994548,NaN,NaN,-218.13568216139393,16.77388419978301,-0.2863587407129222,0.21452069649575378,0.500879437208676,535081972,628391405.6,41.87697059186933,47.854408323009885,NaN,NaN,5.638884496576599,13.495686890800219
2006-05-15T09:30:00-04:00,72.94,73.71001,72.35001,73.17,61910608,42962224.8,35.71930414156495,53.374709281353354,NaN,NaN,-272.12950193350525,-65.38467700287117,-0.4254773265465774,-0.03096722097454574,0.39451010557203164,473171364,584416605.6,33.794811733298474,45.22672592181201,NaN,NaN,-0.30757912734020165,11.523791745351588
2006-05-16T09:30:00-04:00,73.46001,73.87,72.94,73.28999,35594496,41809480,36.6075486360477,51.96929804726119,NaN,NaN,-198.9249629415141,-129.83800114463284,-0.4863091282923791,-0.21337630479344227,0.2729328234989368,508765860,551877165.6,29.29012822719065,42.870753782275244,NaN,NaN,-4.644568815204403,9.214025950986446
2006-05-17T09:30:00-04:00,72.45,73.14,71.85001,71.95,76494816,43427600.8,31.39084516673897,50.54306320787104,NaN,NaN,-215.5139916750532,-188.43072129624028,-0.5869475028185684,-0.4607515550242738,0.12619594779429472,432271044,509403581.6,24.668002508098937,40.86402656020319,NaN,NaN,-10.296517383057434,6.426805474694463
2006-05-18T09:30:00-04:00,72.42,72.86,71.13,71.27,54127696,43902785.6,29.12280498841433,48.5959755498982,NaN,NaN,-189.95185445220142,-218.93119863273358,-0.6638034440631437,-0.7035583572846349,-0.03975491322149122,378143348,465486717.6,20.981214259336056,38.88657622851091,NaN,NaN,-15.690630385326882,3.2671717804057
2006-05-19T09:30:00-04:00,71.39,72.17999,70.58,71.89999,79031184,45850554.4,33.88858113763162,47.470769194952574,NaN,NaN,-157.98940674572336,-206.90194354959948,-0.6366106576834643,-0.8355182353258215,-0.19890757764235728,457174532,449905229.6,19.84779949178626,37.111433096029046,NaN,NaN,-18.545282840556222,0.15110683455399698
2006-05-22T09:30:00-04:00,71.24001,71.67,70.09,71.10001,89895872,48383708,31.03488687970453,45.69701815842228,NaN,NaN,-148.51710618391328,-182.17946439968108,-0.6354340156511071,-0.9932000972062411,-0.35776608155513406,367278660,428726688.8,18.393374125277035,35.50846461565307,NaN,NaN,-21.873753561522083,-2.9953017934568713
2006-05-23T09:30:00-04:00,71.88,72.39,70.10001,70.17999,73648320,49919064,28.10384136106981,43.779851787746225,NaN,NaN,-126.88629221648762,-167.7717302546758,-0.6568378601067308,-1.1788134066885476,-0.5219755465818168,293630340,385699584.8,15.851872394108128,33.98162632057793,NaN,NaN,-25.659075334686566,-6.232983727918256
2006-05-24T09:30:00-04:00,70.49001,71.37,69.11,70.72,124700192,54586643.2,32.15412168797859,41.788508403666036,NaN,NaN,-122.68333245553028,-149.2055984107712,-0.5965999210902373,-1.2677254479446134,-0.6711255268543761,418330532,382911482.4,15.700483740648721,32.33692852917896,NaN,NaN,-27.42913536953109,-9.261005391005803
2006-05-25T09:30:00-04:00,71.5,72.28,71.03999,72.21001,63333696,53151544,41.882844116092684,40.34007380280857,NaN,NaN,-71.47842690810117,-125.51091290195116,-0.4263617136326211,-1.2040776688951524,-0.7777159552625313,481664228,403615658.4,21.681961269968596,31.010115287657353,NaN,NaN,-25.644327341403788,-11.601479955348372
2006-05-26T09:30:00-04:00,72.64999,72.73,72.02,72.64,37483008,53129734.4,44.36229443814895,39.02967072168614,NaN,NaN,-48.69497187229769,-103.65202592726602,-0.26277787252618456,-1.106188295920262,-0.8434104233940775,519147236,416010199.2,25.107877247843447,29.535620135175275,NaN,NaN,-23.400024474125548,-13.286986315173683
2006-05-30T09:30:00-04:00,72.31,72.35001,70.56,70.64,46837696,53260539.2,36.55124248529357,37.229998568412334,NaN,NaN,-78.21285043335526,-89.59117477715441,-0.26641755556677116,-1.1764323678525415,-0.9100148122857703,472309540,437016375.2,30.645115365234034,28.314239471354917,NaN,NaN,-24.124595991517197,-14.835216268937042
2006-05-31T09:30:00-04:00,70.81,71.87,70.67,71.87,58723808,54390124.8,43.17760047457052,36.194242655347715,NaN,NaN,-64.29006497172067,-77.07192932820101,-0.16794063205447518,-1.1199406023538643,-0.9519999702993891,531033348,484496976.8,41.22340345707682,27.675157543707424,NaN,NaN,-22.32596796602294,-15.905323654235028
2006-06-01T09:30:00-04:00,71.88,73.34,71.64999,73.27,49503696,55107714.4,49.62618271920506,36.47621336120148,NaN,NaN,-23.612320236928507,-57.25772688448065,0.0006104525821732931,-0.9512369045716724,-0.9518473571538457,580537044,516938279.2,47.15423118082554,27.58694611375439,NaN,NaN,-18.466160827412967,-16.27115753611759
2006-06-02T09:30:00-04:00,73.74001,73.84,72.67999,73.22,49690000,56074614.4,49.41051225050447,37.359472177354675,NaN,NaN,-3.4426263865390694,-43.650566780168226,0.11170993359483583,-0.8122099401603009,-0.9239198737551367,530847044,526774842.4,48.83989922727313,28.084298159140378,NaN,NaN,-15.62661940636568,-16.179080660438746
2006-06-05T09:30:00-04:00,73.06,73.14999,70.86,71.09,66166880,57491018.4,41.196830066857586,37.7507240291613,NaN,NaN,-51.958152428221545,-44.30320289135301,0.04798049382462566,-0.8639442564743547,-0.9119247502989803,464680164,515881428,47.05000713521088,29.03109783070555,NaN,NaN,-16.015110566413927,-16.155656361292344
2006-06-06T09:30:00-04:00,71.03999,71.16,69.81,70.78999,94747872,60992661.6,40.18359972146864,38.0061562495485,NaN,NaN,-92.09202105276388,-47.07903701523473,-0.005311194593774937,-0.9185637435411991,-0.9132525489474241,369932292,495405978.4,43.800724502035315,30.067568993194453,NaN,NaN,-16.654827612205157,-16.226966539994173
2006-06-07T09:30:00-04:00,70.82001,71.82001,70.00999,70.10001,81940816,64010587.2,37.87633316682391,38.469405392411716,NaN,NaN,-87.94068327487447,-51.8091606758655,-0.0741419333826473,-1.0059299656757332,-0.9317880322930859,287991476,446797604,37.227814693221774,30.964698434988946,NaN,NaN,-17.92861418660682,-16.470059060938837
2006-06-08T09:30:00-04:00,69.78,70.42,68,70.16,140238688,69681316.8,38.20853685790419,39.118386240232425,NaN,NaN,-145.424308930576,-76.17155841459501,-0.10107370904068957,-1.058130168593948,-0.9570564595532584,428230164,416336228,33.804305486806626,31.880633522665416,NaN,NaN,-18.82707839445847,-16.8067761085845
2006-06-09T09:30:00-04:00,70.55,71.10001,69.42,69.53999,63031600,70487332,36.06217098039932,39.27364265757297,NaN,NaN,-115.361515361514,-98.55533620958998,-0.14349786211149573,-1.136428787192628,-0.9929309250811322,365198564,383206532,30.51728461682066,32.642739603025014,NaN,NaN,-20.22700408175964,-17.29538010475238
2006-06-12T09:30:00-04:00,69.7,69.75,67.83,67.94,108273808,72768737.6,31.192527444837822,39.284902697939636,NaN,NaN,-193.6739507904714,-126.89849588203995,-0.255621366534462,-1.3124576332492097,-1.0568362667147477,256924756,341655450.4,26.9745817475214,33.2556830046139,NaN,NaN,-23.055362115898408,-18.11823467777324
2006-06-13T09:30:00-04:00,67.64999,68.85001,66.60001,66.64999,139600496,76653232,27.91906970708183,39.271704722654775,NaN,NaN,-222.84114479618566,-153.0483206307243,-0.3851885624755873,-1.5383219698092319,-1.1531334073336446,117324260,291133844,23.415259441479165,33.79592493656897,NaN,NaN,-26.569947790888648,-19.325622265361158
2006-06-14T09:30:00-04:00,66.75999,67.67999,66.55,67.45,106701632,80208588.8,32.640179655696755,39.306423148920366,NaN,NaN,-195.0250807833709,-174.4652001324236,-0.3846388834272232,-1.6339320116176737,-1.2492931281904505,224025892,278340727.2,22.601974240447404,34.288888543697446,NaN,NaN,-27.94743270473767,-20.557309470986375
2006-06-15T09:30:00-04:00,68.03999,69.97,67.91,69.75999,96976128,81232654.4,44.037880496436905,39.46035431894495,NaN,NaN,-77.45336231275216,-160.8710108088588,-0.20532321717108282,-1.505947149654304,-1.3006239324832212,321002020,256895098.4,21.268375091928164,34.25934667383742,NaN,NaN,-25.194198775928477,-21.21972222883525
2006-06-16T09:30:00-04:00,69.60001,69.7,68.57001,68.85001,66852368,81868888,41.08842239580748,39.22650631592056,NaN,NaN,-76.76152067761,-153.15101187207802,-0.12838350675443588,-1.461103315926266,-1.3327198091718302,254149652,234685316,19.95519266741134,33.891297775235124,NaN,NaN,-23.976787460937853,-21.613588690564193
2006-06-19T09:30:00-04:00,69.10001,69.12,67.44,67.5,71714880,81503072.8,37.1167320955734,39.26689843094055,NaN,NaN,-111.86779330546676,-136.7897803750771,-0.14743344349147147,-1.5170116135361695,-1.369578170044698,182434772,219787319.2,19.10314502382022,33.066871322276995,NaN,NaN,-24.318713462080503,-22.000035086495092
2006-06-20T09:30:00-04:00,67.56,68.33,67.31,67.42,61106800,80063619.2,36.88917387772843,38.817725102594686,NaN,NaN,-110.5125541471335,-114.32406224526667,-0.14426410040817284,-1.5499082955549142,-1.4056441951467413,121327972,220588061.6,19.30258728866319,31.50109873881888,NaN,NaN,-24.65508647502171,-22.379328141998894
2006-06-21T09:30:00-04:00,67.37,69.06,67.25,68.60001,81045632,80433484.8,42.48993481477924,38.30799310942142,NaN,NaN,-74.64049627101201,-90.24714534279488,-0.04659458374064274,-1.4638874248225449,-1.4172928410819021,202373604,216257604,19.029352980274822,29.492178867350965,NaN,NaN,-23.13695853890969,-22.487561055843294
2006-06-22T09:30:00-04:00,68.39,68.61,67.86,68.24001,55491696,76973060,41.286149481818356,37.7276814830867,NaN,NaN,-69.75757486404365,-88.70798785305317,0.007012171527582822,-1.4085276266724236,-1.4155397982000064,146881908,181433581.6,16.951317367073003,27.214423020193813,NaN,NaN,-22.28263373524087,-22.45828572432866
2006-06-23T09:30:00-04:00,68.23,69.05,67.72,68.64999,42906096,75951680,43.257730106490094,37.87488862877473,NaN,NaN,-54.52669629969993,-84.26102297747116,0.07931342952513631,-1.316398011293586,-1.3957114408187223,189788004,168561252,16.245137616447295,25.014075197424983,NaN,NaN,-20.994242900171077,-22.249136749449008
2006-06-26T09:30:00-04:00,69.02,69.5,68.95,69.5,39936096,76074334.4,47.21529567742711,38.37715262562891,NaN,NaN,-14.129332417970963,-64.713330799972,0.18744280350468334,-1.1614079364378682,-1.3488507399425516,229724100,178019117.6,18.917882801132407,23.236729361646205,NaN,NaN,-18.70801066474564,-21.743261594491383
2006-06-27T09:30:00-04:00,69.53999,69.83,68.02,68.3,61548096,76809854.4,42.68865727776034,38.72089006212436,NaN,NaN,-37.62927625976223,-50.13667522249776,0.18110615694864918,-1.12246804375674,-1.3035742007053892,168176004,187388724,21.587480548446564,22.119562637019406,NaN,NaN,-18.081555656488966,-21.220160746205323
2006-06-28T09:30:00-04:00,68.35001,68.60001,67.5,68.60001,46418896,76194608.8,44.13078856608764,39.143908041280326,NaN,NaN,-56.400506446417374,-46.488677257578836,0.1986709601169463,-1.0552355005592062,-1.2539064606761525,214594900,189832983.2,22.30613163537329,21.29826450477417,NaN,NaN,-17.14590189439536,-20.63812376737533
2006-06-29T09:30:00-04:00,68.81,71.25,68.81,71.25,96609376,78549892.8,54.92103452148299,40.4909697227863,NaN,NaN,69.17883538892777,-18.70139520698455,0.3798133752310182,-0.7791397416373798,-1.158953116868398,311204276,222697456.8,31.408734573916178,21.36193950170956,NaN,NaN,-12.648654571217435,-19.49677102506706
2006-06-30T09:30:00-04:00,71.46001,71.89999,70.55,71.73,61004304,79115608,56.55767594562514,42.30276604427111,NaN,NaN,141.59120107472876,20.522184267901185,0.5146379199456035,-0.5156557169363936,-1.030293636881997,372208580,259181572,39.83584179044137,22.2806009333467,NaN,NaN,-8.518710922632662,-17.92847672471929
2006-07-03T09:30:00-04:00,72,72.63,71.75999,72.63,22967808,76955654.4,59.52492000832768,44.560326780074384,NaN,NaN,192.50548624599247,61.849148000693866,0.6389940502824549,-0.23155107402892838,-0.8705451243113833,395176388,292272029.6,46.282161905380384,23.913951109339646,NaN,NaN,-4.121744856172796,-15.956086457784076
2006-07-05T09:30:00-04:00,71.84,72.59,70.99001,71.57001,38621392,74149330.4,54.77922278318488,46.141687003466394,NaN,NaN,143.11008498951458,97.99702025054924,0.6237314478514172,-0.09088081449711183,-0.714612262348529,356554996,329947828,52.51993665453541,26.05094842463165,NaN,NaN,-1.891314209725023,-13.946833279489926
2006-07-06T09:30:00-04:00,71.71001,72.2,71.16,71.55,33832496,71743914.4,54.69057992747004,46.90259410568304,NaN,NaN,129.0589632634313,135.08891419251898,0.5867061033050317,0.01877036678276056,-0.5679357365222711,322722500,351573348,55.699780670748105,28.5103345374045,NaN,NaN,-0.14969404373795192,-11.975813388668216
2006-07-07T09:30:00-04:00,71.45,71.64,70.35001,70.49001,45330704,66998515.2,50.068554904129115,47.544032141991735,NaN,NaN,76.34411660230752,136.5219704351949,0.470274907452766,0.019907897793686402,-0.4503670096590796,277391796,344810852,54.471247204124936,30.975767004312615,NaN,NaN,-0.030349245007165293,-10.269318511002352
2006-07-10T09:30:00-04:00,70.66,71.24001,70.17999,70.5,40166800,65855275.2,50.111347628842104,48.47221896579664,NaN,NaN,63.24253077687816,120.85223637562481,0.3773889503196677,0.021369178240504993,-0.3560197720791627,317558596,333880855.2,52.45734887460379,33.35821013651144,NaN,NaN,0.07782704948026256,-8.791154859504836
2006-07-11T09:30:00-04:00,70.11,71.12,69.60001,71.12,63445200,63613844.8,52.814174608613946,49.60971901800275,NaN,NaN,55.03071453675872,93.35728203377805,0.3421991953780303,0.07172922214337518,-0.2704699732346551,381003796,331046336.8,51.92123241131994,35.68811335955835,NaN,NaN,0.9309827577957283,-7.402278057033326
2006-07-12T09:30:00-04:00,70.78,71.08,69.59,69.64999,50664800,59167060,46.3960160006374,49.88872481699262,NaN,NaN,25.084927403744594,69.75225051662406,0.21085751056959992,-0.006898085022655209,-0.21775559559225513,330338996,325803136.8,50.88526364561781,37.96353554993999,NaN,NaN,-0.22163290956924414,-6.376471607395601
2006-07-13T09:30:00-04:00,69.17999,69.6938,68.02,68.07001,80472128,57855584.8,40.67464970064449,49.84504626119449,NaN,NaN,-57.21411915957212,32.49763403202337,0.018636191633871257,-0.19446035604991607,-0.21309654768378733,249866868,311232010.4,48.01787855283054,40.18257563463696,NaN,NaN,-3.07768547007209,-5.905216444920813
2006-07-14T09:30:00-04:00,68.08,68.21001,66.95,67.53,79083680,56960962.4,38.90861305811585,49.534395043453465,NaN,NaN,-101.38656276172655,-3.0485018407834503,-0.1353407631790468,-0.38227250165759585,-0.24693173847854905,170783188,289910288.8,44.101694482027845,42.17232969646414,NaN,NaN,-5.971840269868409,-5.914734134199041
2006-07-17T09:30:00-04:00,67.60001,68.2,67.03,67.44,67429504,56989819.2,38.607745252568584,48.91957001310643,NaN,NaN,-93.35273545567422,-34.36755508729392,-0.22824810919961636,-0.5322418749780695,-0.30399376577845316,103353684,247069306.4,37.48631561865425,43.49864632628713,NaN,NaN,-8.390792157738545,-6.268456708990399
2006-07-18T09:30:00-04:00,67.82001,68.25,66.62,67.89999,74541632,57131156.8,41.114040820696566,48.80709740903045,NaN,NaN,-89.51142894382546,-63.275983783410766,-0.24238855040976343,-0.6069794537906574,-0.364590903380894,177895316,206447610.4,32.50709947432172,44.278619106706785,NaN,NaN,-9.720199420546788,-6.761562810641312
2006-07-19T09:30:00-04:00,67.84,70,67.78,69.5,97847632,58968198.4,48.92471451865763,49.14952069135688,NaN,NaN,-23.361518680852157,-72.96527300033013,-0.13311229071709313,-0.5309812667772604,-0.3978689760601673,275742948,195528400.8,31.303454724343368,44.92128504163322,NaN,NaN,-8.566858876148538,-7.019462248570916
2006-07-20T09:30:00-04:00,70.03999,70.37,67.62,67.72,74277312,58629782.4,42.216046654402206,48.24202155799396,NaN,NaN,-50.13979729366443,-71.55040862714858,-0.1676102280248638,-0.6073817610912471,-0.4397715330663833,201465636,185848154.4,30.234634361481326,44.83742074074502,NaN,NaN,-9.700105728729408,-7.402411317164986
2006-07-21T09:30:00-04:00,67.64999,67.64999,66.35001,66.75,109130320,61311713.6,39.07185884449872,46.99303462219922,NaN,NaN,-123.28920289138142,-75.93093665307956,-0.23834028245858657,-0.7376968861396165,-0.4993566036810299,92335316,170158580,28.534097595153952,44.030153298224484,NaN,NaN,-11.665850643056217,-8.01147407800659
2006-07-24T09:30:00-04:00,67.25999,68.91,67.25,68.88,72230368,62777927.2,48.195906582361715,46.18381937748735,NaN,NaN,-54.95869716029197,-68.25212899400312,-0.12969415609506374,-0.6614742987998596,-0.5317801427047959,164565684,182400980,31.759355942005072,42.992810015126246,NaN,NaN,-10.287729446794144,-8.336653416404811
2006-07-25T09:30:00-04:00,68.7,69.78,68.39,69.05,87433632,65152804,48.85422107898903,45.76060497004479,NaN,NaN,-19.911880389768207,-54.33221928319166,-0.03910094604155534,-0.58065632525674,-0.5415553792151847,251999316,197221780,35.55136292395285,41.78076903437035,NaN,NaN,-9.005277811386268,-8.432171187116447
2006-07-26T09:30:00-04:00,68.92999,69.60001,68.12,68.89999,59831600,65066979.2,48.271293967295314,45.30208454431803,NaN,NaN,-29.79920640971092,-55.61975682896342,0.015094828409793815,-0.5226868437029424,-0.5377816721127362,192167716,180506733.6,33.3036615125916,40.18104623735917,NaN,NaN,-8.16141899082755,-8.39349230193232
2006-07-27T09:30:00-04:00,69.41,69.89,67.97,68.24001,59016800,65696874.4,45.68836183463993,44.98921361078309,NaN,NaN,-39.64949857410855,-53.521697085052246,0.011056865125800841,-0.5239605907054852,-0.535017455831286,133150916,166843789.6,31.547866760675475,38.54366191996992,NaN,NaN,-8.223046597212653,-8.369142915543796
2006-07-28T09:30:00-04:00,68.75,69.7,68.48,69.67,62209808,63976896,51.716827125674456,45.103890717699684,NaN,NaN,-9.303920281722132,-30.72464056312038,0.10408260192884211,-0.4049142034202333,-0.5089968053490754,195360724,187448871.2,36.94675043518954,37.43576203144033,NaN,NaN,-6.401785231505426,-8.08809181782403
2006-07-31T09:30:00-04:00,69.42999,69.83,69.06,69.67999,37949200,62824140.8,51.75711406861343,45.02838639341393,NaN,NaN,7.815223637252441,-18.169856403611504,0.1622111147444949,-0.3062329119184568,-0.4684440266629517,233309924,201197719.2,40.3286411272069,36.60771979686083,NaN,NaN,-4.9382865753703395,-7.638119640330645
2006-08-01T09:30:00-04:00,69.17,69.23,68.17999,68.59,45004496,63925975.2,47.1358424605477,45.08123114055038,NaN,NaN,-32.61616376114955,-20.71071307788774,0.12485166515323343,-0.3123794452214099,-0.43723111037464335,188305428,188458941.6,38.27998091195854,35.70734245874231,NaN,NaN,-5.0338035755453605,-7.266074488218462
2006-08-02T09:30:00-04:00,69.00999,69.72,68.64,69.5,50137504,64501780.8,51.06428949577406,45.82334826877393,NaN,NaN,15.225763683215908,-11.705719059302375,0.15695078197460643,-0.24104263290638528,-0.3979934148809917,238442932,197713984.8,40.63932118804409,35.18030264697185,NaN,NaN,-3.934513824925871,-6.790137250605235
2006-08-03T09:30:00-04:00,68.78,70.34,68.53999,70.34,49316896,65276000.8,54.43060939710259,46.93206229298726,NaN,NaN,60.426258656465656,8.309432386812466,0.22607753479508574,-0.11539649638713456,-0.3414740311822203,287759828,228635767.2,47.81671386239031,35.4456611741406,NaN,NaN,-1.9807573448246514,-6.103082978350866
2006-08-04T09:30:00-04:00,71.13,71.31,68.97,69.62,76609184,66839924.8,51.18068347935829,47.830129309186525,NaN,NaN,86.2294167607014,27.416099795297168,0.2147179219177624,-0.0730766287850173,-0.2877945507027797,211150644,231793751.2,48.50155844413258,36.232464233103336,NaN,NaN,-1.2970554132942407,-5.416507611914205
2006-08-07T09:30:00-04:00,69.37,69.48,68.74001,69.35001,45881904,67125680,49.97567853235744,48.46310343144801,NaN,NaN,30.053070251066437,31.86366911805997,0.18173570529654234,-0.06062491908210177,-0.2423606243786441,165268740,218185514.4,45.71725018233415,37.17604642653281,NaN,NaN,-1.0814785134543718,-4.7972177407056575
2006-08-08T09:30:00-04:00,69.42999,69.96001,68.17999,68.39,76243312,67765585.6,45.84267774912234,48.24295794790978,NaN,NaN,7.127582033720872,39.812418277034055,0.09248016502270645,-0.12676041810026106,-0.21924058312296751,89025428,198329514.4,41.93449983687857,37.93540679171389,NaN,NaN,-2.1091241123102975,-4.413204365220606
2006-08-09T09:30:00-04:00,68.99001,69.28,67.60001,67.7,58126608,68138676,43.08471718504012,48.305005842955346,NaN,NaN,-52.95096540923803,26.177072458543268,-0.010346855007674322,-0.2321741518825604,-0.2218272968748861,30898820,156820692,35.34964803628391,38.30076491134264,NaN,NaN,-3.798517578297351,-4.325391967088713
2006-08-10T09:30:00-04:00,67.31,68.61,67.03,68.3,54416704,66835904.8,46.12022060328818,48.80846025429746,NaN,NaN,-68.85593427856176,0.32063387153778533,-0.03394148442233036,-0.26425415240279904,-0.23031266798046868,85315524,116331831.2,30.344327614942472,38.43006705561324,NaN,NaN,-4.357783640989055,-4.330019349074476
2006-08-11T09:30:00-04:00,68.06,68.07001,67.23,67.60001,42757200,65019580.8,43.22387241835475,48.45331495686838,NaN,NaN,-105.6449045803316,-38.054230396668814,-0.0895228822010169,-0.34221627073173977,-0.2526933885307229,42558324,82613367.2,26.925148820046132,38.084766546901896,NaN,NaN,-5.682108280023828,-4.523174910638669
2006-08-14T09:30:00-04:00,68.09,68.82001,67.67999,68,45030096,63899610.4,45.33638696552128,48.202041091620686,NaN,NaN,-56.55117080881039,-55.37507860864417,-0.09183710338481327,-0.36748976776173947,-0.2756526643769262,87588420,67077303.2,25.499433776916973,37.36677160782791,NaN,NaN,-6.197013770912122,-4.762294747820591
2006-08-15T09:30:00-04:00,69,69.45,68.69,69.42,48780192,62611538.4,52.14399133527851,48.478662332190915,NaN,NaN,49.86798608517566,-46.82699779835322,0.004660795668898987,-0.2698266697908025,-0.2744874654597015,136368612,76545940,28.00166930832529,36.98805787895174,NaN,NaN,-4.611483021248663,-4.740750215453173
2006-08-16T09:30:00-04:00,69.87,70.52,69.49001,70.42,47162704,60077292,56.27383579533071,49.2347676150974,NaN,NaN,143.98593876766196,-7.4396169629732185,0.1312195963554486,-0.11046297001539074,-0.24168256637083935,183531316,107072439.2,35.52072010883913,37.271833118106294,NaN,NaN,-1.964006746121859,-4.344072576977271
2006-08-17T09:30:00-04:00,70.22,71.10001,70.13,70.53,44653696,58596111.2,56.7163210033696,49.591874320647044,NaN,NaN,163.16930937920532,38.965431768580196,0.21288876954771346,0.024428395563802496,-0.18846037398391097,228185012,135646336.8,41.66213308896872,37.608646164804796,NaN,NaN,0.30285851864584584,-3.68022527760254
2006-08-18T09:30:00-04:00,70.8,70.94,70.00999,70.94,36413600,54960275.2,58.40584938166807,50.066783985865236,NaN,NaN,156.13375334375988,91.32116335339849,0.28080084344905704,0.16254068032741031,-0.11826016312164671,264598612,180054394.4,49.683295184339535,38.27683574031427,NaN,NaN,2.694147595188922,-2.769600581489474
2006-08-21T09:30:00-04:00,70.48,70.49001,69.85001,70.17999,25387600,52618136.8,54.183731387651335,50.5702046235155,NaN,NaN,99.04490791164335,122.44037909748924,0.2612228641351518,0.20826841704729304,-0.05295444708785875,239211012,210378912.8,54.30374420051212,39.42139026092524,NaN,NaN,3.5615452863102477,-1.8651511718037996
2006-08-22T09:30:00-04:00,70.10001,70.62,69.97,70.41,22658096,49379360,55.2383423421546,50.86835125539982,NaN,NaN,101.01487238275585,132.66975635700527,0.25041950824209125,0.2600699382147553,0.009650429972664062,261869108,235479012,57.761149476345096,40.644377995803886,NaN,NaN,4.577769456516641,-0.9447339391865939
2006-08-23T09:30:00-04:00,70.5,70.8,69.2,69.60001,37109696,48243264.8,50.8034471035745,50.609268234433536,NaN,NaN,51.88356483970385,114.24928157141365,0.17874111899981404,0.23307682872243163,0.05433570972261757,224759412,243724631.2,58.8622889133391,41.43334764230023,NaN,NaN,4.206770392137082,-0.20880474899749746
2006-08-24T09:30:00-04:00,69.72,69.87,68.91,69.48,32256800,46905264.8,50.160862690102334,50.53642389234381,NaN,NaN,7.580750774550026,83.13156985048259,0.11629046232173225,0.19969878762478288,0.08340832530305063,192502612,236588151.2,57.46596432056742,42.07366234775986,NaN,NaN,3.7224454429239535,0.35280242127699557
2006-08-25T09:30:00-04:00,69.38,70.09,69.23,69.60001,22449392,44917244,50.83061841667931,50.597491026938236,NaN,NaN,26.507451270677986,57.20630943586622,0.07794980244459851,0.18084557835879878,0.10289577591420027,214952004,226658829.6,55.49348943263647,42.77196515135288,NaN,NaN,3.492616154040546,0.801347240243217
2006-08-28T09:30:00-04:00,69.53999,70.47,69.52,70.34,26650400,44352304,54.858826211187434,51.24150163137146,NaN,NaN,65.55756790229375,50.5088414339963,0.0961187140660445,0.2230441684967559,0.1269254544307114,241602404,227137108,55.57259328267801,43.74611468319569,NaN,NaN,4.383535772726853,1.3130884591694507
2006-08-29T09:30:00-04:00,70.50999,71.25,69.88,71.25,53031104,44753634.4,59.2771313660568,52.39810264430122,NaN,NaN,114.75465488492384,53.25679793442991,0.15938485299404329,0.3261565206732655,0.16677166767922222,294633508,233689988,56.70791439718215,45.27170513754557,NaN,NaN,6.449510206306649,2.0468629944747647
2006-08-30T09:30:00-04:00,71.31,72,71.03999,71.8,43891104,44441314.4,61.716093656222235,53.51209357665365,NaN,NaN,161.44048115255896,75.16818119700093,0.22426291547977162,0.44710031202893674,0.22283739654916512,338524612,256443028,60.48392695087944,47.42453366154107,NaN,NaN,8.931108236131918,3.0303266004257865
2006-08-31T09:30:00-04:00,71.96001,72.24001,71.57001,71.77,33830000,43666969.6,61.499730561896854,54.81751201547809,NaN,NaN,155.408179337794,104.73366690964971,0.24922489961959549,0.5343685210736595,0.285143621454064,304694612,278881428,63.834058319860056,50.06088434009921,NaN,NaN,10.91348207780147,4.156491668622313
2006-09-01T09:30:00-04:00,72.08,72.2,71.46001,71.82001,24121008,41042560.8,61.740523673598695,55.98923606605505,NaN,NaN,134.04693140226547,126.24156293596722,0.2523977280216093,0.6006407814810757,0.3482430534594664,328815620,301654151.2,66.90103346595285,53.01814146074463,NaN,NaN,12.63471705352594,5.367666723608545
2006-09-05T09:30:00-04:00,71.92999,72.52,71.7,72.47,38075200,40652225.6,64.82022011980663,56.89468097923562,NaN,NaN,141.0297437657301,141.33599810865448,0.27946126728592435,0.6975696375668718,0.4181083702809475,366890820,326711834.4,69.92341718446201,56.012552023325824,NaN,NaN,15.018583924200152,6.746369180835917
2006-09-06T09:30:00-04:00,71.92,71.92999,70.84,70.92999,39718496,38825984.8,53.77549616572643,56.716228148549604,NaN,NaN,72.73866860127295,132.93280085192433,0.17968269331209957,0.642711736921072,0.4630290436089724,327172324,333219597.6,70.67242581204437,58.52338814498334,NaN,NaN,13.979267905985388,7.779640427285842
2006-09-07T09:30:00-04:00,70.53,71.12,70.06,70.3,44664192,38152864,50.020679396639025,56.23796803378314,NaN,NaN,20.562408277785654,104.75718627696965,0.06329831504791394,0.5421519374188648,0.47885362237095086,282508132,322016301.6,67.55350074823212,60.372771549216445,NaN,NaN,11.940582085117418,8.374060664118923
2006-09-08T09:30:00-04:00,70.53,70.67999,70.17,70.57001,27806496,36822353.6,51.58112938453386,55.750488033987835,NaN,NaN,11.9093275378679,76.05741591698444,-0.00010157044094016854,0.47872665931977565,0.4788282297607158,310314628,323140304.8,67.70748038624295,61.6602133493524,NaN,NaN,10.71195664855124,8.708045804752112
2006-09-11T09:30:00-04:00,70.13,70.84,69.64999,70.48,49544608,37161724,51.00938072740431,55.52374870111305,NaN,NaN,-12.226978387963296,46.80263395893869,-0.049943679405811625,0.4163986305034513,0.4663423099092629,260770020,309531184.8,63.76196005106891,62.335800195820745,NaN,NaN,9.541899147970865,8.82716771092622
2006-09-12T09:30:00-04:00,70.64,72.28999,70.58,72.14,43201696,37070304,59.84865173453045,55.85305651485419,NaN,NaN,101.71338524958627,38.939362255709895,0.023120150614376778,0.49524249817723387,0.4721223475628571,303971716,296947364,60.264929311316095,62.514641612604386,NaN,NaN,11.191486598789046,9.16492755204948
2006-09-13T09:30:00-04:00,72.16,72.88,72,72.75,35611904,36411889.6,62.5244764411432,56.69027289610909,NaN,NaN,157.44565426225165,55.88075938790564,0.10232767289624167,0.6000319386831592,0.4977042657869175,339583620,299429623.2,60.72254449258574,62.647517011122,NaN,NaN,13.417896700410047,9.772494573243847
2006-09-14T09:30:00-04:00,72.47,72.59,72.00999,72.49001,33680096,35737759.2,60.6686666206705,57.4408303197211,NaN,NaN,120.17907554129204,75.80409284060691,0.125479798452367,0.6545540138523762,0.5290742154000092,305903524,304108701.6,61.61983111217161,62.94422178195087,NaN,NaN,14.673094681544718,10.472580303001115
2006-09-15T09:30:00-04:00,73,73.02,72.17,72.66,40830192,35546584,61.47384205970074,58.201060579936915,NaN,NaN,120.83365474449374,97.58895828193208,0.13943813988127496,0.7033718902516028,0.5639337503703279,346733716,311392519.2,63.03548247471543,63.48293557067079,NaN,NaN,15.935062840231462,11.25293495117688
2006-09-18T09:30:00-04:00,72.35001,73.07001,72.14,72.64,37907504,35621279.2,61.31480128620933,58.6622016567242,NaN,NaN,106.02883638790317,121.24012123710538,0.1344597505347197,0.7320084385387275,0.5975486880040078,308826212,321003757.6,64.8764768981687,64.14749868606297,NaN,NaN,16.924169195420266,12.063111271783077
2006-09-19T09:30:00-04:00,72.71001,72.74001,71.14999,72.32001,64200704,37561934.4,58.698220478623654,58.6208508790504,NaN,NaN,61.42378676334407,113.18220153985695,0.09842203866094468,0.7205762363301886,0.622154197669244,244625508,309134516,60.84624952185,64.4430940521107,NaN,NaN,17.05934616791916,12.776859114088232
2006-09-20T09:30:00-04:00,72.78999,73.5,72.73,73.28999,54789696,39168514.4,63.74840250999999,58.76601579717738,NaN,NaN,124.6562916342944,106.6243290142655,0.1269046496121311,0.7807850096844078,0.6538803600722767,299415204,301100832.8,58.21040768357157,64.28069981873155,NaN,NaN,18.64868416562177,13.615691264307308
2006-09-21T09:30:00-04:00,73.35001,73.57001,72.09,72.5,68566624,40741360.8,57.573830103040294,58.48559433583049,NaN,NaN,86.99814635364542,99.98814317673616,0.08172782825647729,0.7560401453928733,0.6743123171363961,230848580,286089844,53.54308125980454,63.545630028727594,NaN,NaN,18.194311807930596,14.26977991339635
2006-09-22T09:30:00-04:00,72.16,72.17999,71.06,71.53999,59289904,42093016,51.09687656576256,57.725333828127894,NaN,NaN,-0.3971112617121612,75.74198997549499,-0.018285608076847537,0.6514553070403366,0.6697409151171841,171558676,251054836,44.56232379194758,61.95000790915579,NaN,NaN,15.743975038159142,14.480379216933892
2006-09-25T09:30:00-04:00,71.78,72.64999,71.11,72.39,61688304,44054961.6,55.83451216181546,57.08349754541424,NaN,NaN,30.829942590500202,60.70221121601438,-0.031873778256609864,0.6298986922964218,0.6617724705530317,233246980,235938989.6,41.34051045204276,59.90837171398299,NaN,NaN,15.134227661552668,14.573786137593718
2006-09-26T09:30:00-04:00,72.14,72.75,71.96001,72.39,42739904,44859436.8,55.83451216181546,57.230570116563456,NaN,NaN,55.199083147680106,59.45727049288159,-0.04475295724633921,0.6058312739951077,0.6505842312414469,233246980,233663284,40.86153253836256,57.77902219443429,NaN,NaN,14.652435727132287,14.585021793242085
2006-09-27T09:30:00-04:00,72.21001,72.99001,72.2,72.92,49884096,44702086.4,58.726008996826415,57.8523793737197,NaN,NaN,82.72528379641122,51.07106892530495,-0.022587243583604755,0.622350176761941,0.6449374203455458,283131076,230406458.4,40.144678484570065,55.82124917560129,NaN,NaN,15.103771295786492,14.659128865034143
2006-09-28T09:30:00-04:00,72.98,73.28,72.25,72.63,35641104,44289586.4,56.54459740157601,58.20691280350842,NaN,NaN,77.01666065985444,49.074771786546755,-0.03189703690942758,0.6050661242087614,0.636963161118189,247489972,233734736.8,41.278444596133916,53.93346090487921,NaN,NaN,14.842723391410859,14.68535665451653
2006-09-29T09:30:00-04:00,72.71001,72.99001,71.92999,72,33558704,44276021.6,52.0235951223151,58.279356688859195,NaN,NaN,31.363547022740082,55.42690344343721,-0.08207233938272807,0.5343727368897788,0.6164450762725069,213931268,242209255.2,44.17783973766978,52.534595168207844,NaN,NaN,13.270392989000104,14.483218988014183
2006-10-02T09:30:00-04:00,71.97,72.21001,71.14,71.32001,42194896,45179716,47.5997963450596,57.404438446754135,NaN,NaN,-43.92250146134453,40.47641463306826,-0.15823426457803413,0.41865224554996416,0.5768865101279983,171736372,229907133.6,41.01212484781135,51.15939484938607,NaN,NaN,10.55621904270141,13.922218995826645
2006-10-03T09:30:00-04:00,71.25,71.83,70.67999,71.22,45912096,45571560.8,46.967216413904666,56.293205587665675,NaN,NaN,-67.0218377030683,16.032230462918577,-0.2093179509231673,0.3152390714740392,0.5245570223972065,125824276,208422592.8,36.14130667793767,49.40359214833978,NaN,NaN,8.161681022622085,13.099284999654564
2006-10-04T09:30:00-04:00,71.19,72.95,71.09,72.95,51205904,46145931.2,57.491129248532445,56.066238632512956,NaN,NaN,33.55136689107702,6.197447081851737,-0.1247411508394542,0.3686305838478887,0.4933717346873429,177030180,187202413.6,32.08774737352455,47.294157595579286,NaN,NaN,9.270529446048526,12.552319920567987
2006-10-05T09:30:00-04:00,72.87,73.89999,72.85001,73.88,48048000,46315121.6,61.871438462960064,56.094638375602905,NaN,NaN,149.5884573862471,20.711806427130266,-0.010338462398237325,0.4804486566895463,0.4907871190877836,225078180,182720055.2,31.289435436626377,45.02658280714435,NaN,NaN,11.693213598768311,12.429590446025177
2006-10-06T09:30:00-04:00,73.61,73.86,73,73.5,34907104,46670152,59.187689323766335,55.94270180685698,NaN,NaN,138.00013101152425,42.0391232248871,0.033183760918325755,0.5322668202356908,0.4990830593173651,190171076,177968016.8,30.425213910407138,42.56577830801852,NaN,NaN,12.78044484622643,12.479712503196785
2006-10-09T09:30:00-04:00,73.36,74.14,73.06,74.06,25997200,45492781.6,61.81625787221148,56.16541876354182,NaN,NaN,166.2778825020606,84.07920001756813,0.08991094649931519,0.611471742441509,0.5215607959421938,216168276,186854397.6,34.091276814623654,40.65470882893093,NaN,NaN,14.523403072699177,12.771668298839984
2006-10-10T09:30:00-04:00,74.10001,74.36,73.64,74.10001,32951808,44980287.2,62.00454687660946,56.040857646871075,NaN,NaN,176.65768510855213,132.8151045798922,0.1185515415569165,0.6697502228883394,0.5511986813314229,249120084,211513559.2,43.057733461707954,39.572374955940674,NaN,NaN,15.96451002779501,13.227788545833558
2006-10-11T09:30:00-04:00,73.78,74.28999,73.11,73.81,52430000,45821192,59.70630480939612,56.19317726875363,NaN,NaN,120.83349766559775,150.27153073479636,0.10675531012604278,0.6846428189889764,0.5778875088629336,196690084,215445540,44.35760821750832,38.916269738633794,NaN,NaN,16.496374136440632,13.694729344491712
2006-10-12T09:30:00-04:00,74.08,75.39,74.08,75.3,40637392,46169056.8,66.56355908103517,57.29794030555882,NaN,NaN,199.20097319281987,160.1940338961109,0.18358520001358658,0.8073690088799168,0.6237838088663302,237327476,217895399.2,45.19703959513506,38.96160658171862,NaN,NaN,19.213782750002657,14.48316554527899
2006-10-13T09:30:00-04:00,75.3,75.91,75.13,75.89999,45517008,46403397.6,68.86157102339382,58.22844450995728,NaN,NaN,204.93298363819488,173.58060442144503,0.2547198892062892,0.9421836703741917,0.6874637811679025,282844484,236430080.8,51.19584648833877,39.66555915573976,NaN,NaN,22.218583497195606,15.588225252695649
2006-10-16T09:30:00-04:00,75.88,76.53999,75.69,76.35001,46459200,46830982.4,70.4992821809948,59.275928082755804,NaN,NaN,195.95411087924583,179.51585009688208,0.3084046457910776,1.0729695884067496,0.764564942615672,329303684,259057162.4,57.33564529944627,40.84228149581717,NaN,NaN,25.21278337050567,16.963162126668507
2006-10-17T09:30:00-04:00,75.94,76.24001,75.35001,75.97,48535104,46047702.4,67.28130535240004,59.887020679582484,NaN,NaN,148.5463448878439,173.89358205274044,0.2946643869583957,1.1328954263136666,0.8382310393552709,280768580,265386861.6,58.89356953721903,42.18148799957781,NaN,NaN,26.70853684227954,18.35535851461294
2006-10-18T09:30:00-04:00,76.52,76.8,75.60001,75.98,44729200,45544677.6,67.32357439583262,60.656947607743675,NaN,NaN,139.39249466902712,177.6053814534263,0.2636016490975355,1.1677331007271903,0.9041314516296548,325497780,291148400.8,64.56493692960632,43.84480888054012,NaN,NaN,27.92256474589994,19.722102261939657
2006-10-19T09:30:00-04:00,75.73,76.39999,75.58,76.35001,43892000,44310946.4,68.92334902912273,61.86407288680136,NaN,NaN,120.08376330369434,161.7819394756012,0.2456840726929821,1.2112365424958824,0.9655524698029003,369389780,317560861.6,69.24933945476918,45.63563028890436,NaN,NaN,29.410274484896,21.106126865219135
2006-10-20T09:30:00-04:00,76.37,76.41,75.48,75.60001,39507600,43321831.2,62.26868074642507,62.91185034404175,NaN,NaN,94.68077373824882,139.731497495612,0.16490851243678506,1.1716881103488817,1.0067795979120966,329882180,326968400.8,70.73337887189923,47.75857700491064,NaN,NaN,28.774095608220087,22.201550971362128
2006-10-23T09:30:00-04:00,75.35001,76.28,75.09,75.75,38995808,42187206.4,63.037296867812174,64.05971323360657,NaN,NaN,78.90505253277755,116.32168582631832,0.10602857340967664,1.1393153146741923,1.0332867412645157,368877988,334883261.6,71.95948726615615,50.317018475497676,NaN,NaN,28.464607740552356,23.09627336696073
2006-10-24T09:30:00-04:00,75.50999,75.95,75.34,75.89999,30506800,41575551.2,63.83076860545584,64.51254461624396,NaN,NaN,71.272874010641,100.86699165087774,0.06371730871237791,1.112933377154988,1.0492160684426102,399384788,358606503.2,75.29969874601193,53.403586430675354,NaN,NaN,28.421648248732478,23.857041207213836
2006-10-25T09:30:00-04:00,75.73,76.46001,75.48,76.39999,55892304,41875961.6,66.41872692257712,64.83735093478805,NaN,NaN,79.74885007155613,88.93826273138355,0.05620059038552161,1.1194668064245121,1.0632662160389905,455277092,384562365.6,78.33985243739431,56.76433050215877,NaN,NaN,29.101015583733904,24.60618040385956
2006-10-26T09:30:00-04:00,76.64,77.14999,75.87,77.03999,49381104,42562961.6,69.43352359857286,65.56919624013138,NaN,NaN,95.63309105474974,84.04812828159463,0.07969283885751621,1.1628822646108858,1.0831894257533696,504658196,411616048.8,80.96908274911024,60.37460684778042,NaN,NaN,30.571726646841462,25.45840129571412
2006-10-27T09:30:00-04:00,76.89,77.11,75.94,76.14,51799296,43474991.2,61.12334465769911,65.51970243909477,NaN,NaN,76.64884429728927,80.44174239340272,0.022929204288997918,1.111850931114617,1.088921726825619,452858900,436211392.8,82.9905581747941,63.867412659221166,NaN,NaN,29.371457980202564,26.01740939349818
2006-10-30T09:30:00-05:00,75.78,76.71001,75.53,76.47,51249808,43927736.8,62.87777491682754,65.58207587053893,NaN,NaN,65.11635472589356,77.68400283202593,-0.0027187914085300413,1.0855232375649564,1.0882420289734864,504108708,463257536.8,84.89110504827305,66.8555106296901,NaN,NaN,28.888693684291667,26.427592863611537
2006-10-31T09:30:00-05:00,76.60001,76.78999,75.7,76.23,46092400,43936752,60.73122381121644,65.65528437066895,NaN,NaN,61.91457664603594,75.8123433591049,-0.04388946885655143,1.033380192902797,1.0772696617593485,458016308,474983840.8,85.64026642891722,69.80427193050502,NaN,NaN,27.862278608799706,26.63254797006699
2006-11-01T09:30:00-05:00,76.45,76.58,74.58,74.58,47214496,43737181.6,48.478094995116955,64.36346550738908,NaN,NaN,-9.77618976725701,57.90733539134227,-0.18251410056376716,0.8491270360546395,1.0316411366184066,410801812,466088784.8,82.30639770296482,72.45494036677859,NaN,NaN,22.76375997603305,26.079863970919284
2006-11-02T09:30:00-05:00,74.11,74.89999,74.10001,74.47,47585296,43714046.4,47.78590046211724,62.85806046729789,NaN,NaN,-74.76087709482313,23.828541761427694,-0.2762588617101889,0.6863175594806705,0.9625764211908594,363216516,437800448.8,72.62378100918133,73.98550711826734,NaN,NaN,18.521413873861857,25.000085385625365
2006-11-03T09:30:00-05:00,74.82001,75.24001,74.21001,74.83,49053808,44421381.6,50.2876367485909,61.41437150784047,NaN,NaN,-65.02276016563935,-4.505779131158031,-0.3063355823499585,0.5796569432534113,0.8859925256033698,412270324,429682733.6,70.07612767130406,74.89554157340002,NaN,NaN,15.762317769809481,23.680404297651666
2006-11-06T09:30:00-05:00,75.21001,76.08,75,75.7,47702496,45506646.4,55.79931853002065,60.59422959195622,NaN,NaN,1.1276394150342364,-17.3035221933299,-0.26168452795519614,0.5588868656593746,0.8205713936145708,459972820,420855556,67.31096900174228,75.49678439229456,NaN,NaN,15.068007211716248,22.45006185680375
2006-11-07T09:30:00-05:00,75.83,76.83,75.77,76.2,49200608,46319086.4,58.63763320595333,59.973805221250565,NaN,NaN,69.83503684404275,-15.719430153728501,-0.19555233758011314,0.5761309716394294,0.7716833092195425,509173428,431086980,68.8454797377503,75.80253745001913,NaN,NaN,15.378940404797387,21.43990164937427
2006-11-08T09:30:00-05:00,75.61,76.8,75.41,76.59,52411808,46318176.8,60.75453329746615,59.39031838327509,NaN,NaN,66.49257778220667,-0.4656766438357721,-0.1259971857154616,0.6141868270752155,0.7401840127906771,561585236,461243664.8,72.88564685742426,76.06227369306592,NaN,NaN,16.28968902037144,20.70415698808815
2006-11-09T09:30:00-05:00,76.74001,76.8,75.33,75.89,49555392,46764076.8,55.285342195421954,58.89150848677486,NaN,NaN,21.844307374295983,18.855360249988053,-0.12721686438652502,0.5811629323075209,0.7083797966940459,512029844,491006330.4,76.17016861192458,76.45061581735344,NaN,NaN,15.371929993196245,19.942410274532165
2006-11-10T09:30:00-05:00,75.77,76.57001,75.61,76.52,43722400,46674346.4,58.873665805266356,58.594106268021584,NaN,NaN,54.49781690251459,42.759475663618844,-0.08756545228493395,0.5989229813378785,0.6864884336228124,555752244,519702714.4,78.83261100234691,76.94155322708136,NaN,NaN,15.718491968094863,19.33899337361255
2006-11-13T09:30:00-05:00,76.42999,76.99001,76.2,76.63,39373104,46320041.6,59.485021723238106,58.28369577643461,NaN,NaN,108.45986495868297,64.22592077234859,-0.05736103064162945,0.6147871453207756,0.6721481759624051,595125348,546733220,80.98743426709774,77.34782005001605,NaN,NaN,16.18006773755577,18.887718282747294
2006-11-14T09:30:00-05:00,76.91,78.11,76.42999,78.11,68602368,47323404.8,66.66507023168573,58.301291727085236,NaN,NaN,217.75262357072668,93.80943811768539,0.052899771530031,0.7382728903749438,0.6853731188449128,663727716,577644077.6,83.10546464826675,77.68822092222123,NaN,NaN,19.006884629307294,18.90474204654158
2006-11-15T09:30:00-05:00,78.14999,79.00999,77.98,78.7,65132496,48343569.6,69.02196712477075,58.271894836099364,NaN,NaN,282.91636561919853,137.09419568508375,0.15064001854230613,0.8736731420227954,0.7230331234804893,728860212,611099072.8,85.04703596084829,77.97950329448824,NaN,NaN,22.12469378949281,19.36473515267747
2006-11-16T09:30:00-05:00,79.10001,79.11,78.38,78.64,49327904,48615364.8,68.49161735667828,58.79820002888359,NaN,NaN,234.73987099054665,179.67330840833387,0.19358409833257728,0.9650132463962109,0.7714291480636336,679532308,644599565.6,86.6958414127267,78.244166382912,NaN,NaN,24.42015176688428,20.086937526135586
2006-11-17T09:30:00-05:00,78.35001,78.61,77.84,78.59,35970096,48438489.6,68.02255409109875,59.16568425561725,NaN,NaN,160.30839377474172,200.8354237827793,0.20012876178196715,1.0215901002910925,0.8214613385091254,643562212,662161559.2,87.47550905630052,78.42876666919967,NaN,NaN,26.1330665063473,20.9506702375944
2006-11-20T09:30:00-05:00,78.35001,78.85001,78.11,78.7,48400496,48908724,68.53312374367775,59.72296282222164,NaN,NaN,144.93203091687417,208.12985697441755,0.19327058645104567,1.0630495715729325,0.8697789851218868,691962708,681529031.2,88.29048503774318,78.61806799840153,NaN,NaN,27.69072635510817,21.913535397239226
2006-11-21T09:30:00-05:00,78.69,78.87,78.31,78.83,40727008,49419734.4,69.15982902150373,61.20022953839212,NaN,NaN,128.48169481368532,190.27567122300928,0.1792071388274249,1.093787908656168,0.914580769828743,732689716,695321431.2,88.84706246241112,79.08525833836198,NaN,NaN,29.16733655572329,22.949792705594092
2006-11-22T09:30:00-05:00,78.97,79.11,78.56,78.92,33281904,48289214.4,69.61107044724102,62.75917025161526,NaN,NaN,118.2036188645638,157.33312187208233,0.1584036394112579,1.1125853190928154,0.9541816796815575,765971620,702743712.8,89.14605246434442,80.26542058515933,NaN,NaN,30.530770242653492,24.03278949660258
2006-11-24T09:30:00-05:00,78.37,79.03,78.23,78.56,17933504,46716834.4,65.48373021472824,63.8446054991965,NaN,NaN,89.89104033356918,128.36335574068684,0.10538717726966229,1.0859156512686354,0.9805284739989731,748038116,716444874.4,89.6952270943281,81.66678482966107,NaN,NaN,30.64461993345793,24.977336701867628
2006-11-27T09:30:00-05:00,78.50999,78.53999,76.72,76.8,72824624,47768100.8,49.90503246059848,63.42358506566634,NaN,NaN,20.919456495302647,100.48556828479902,-0.05462546332780682,0.9122466448392146,0.9668721081670214,675213492,722775130.4,89.94828021044482,83.28373563028266,NaN,NaN,25.76049971250886,25.089217131959234
2006-11-28T09:30:00-05:00,76.59,77.16,76.28999,77.06,59174304,48164325.6,51.731884797549995,62.93031732220896,NaN,NaN,-8.196130069090676,69.85993608760604,-0.1442769253003099,0.7865259515416341,0.930802876841944,734387796,731260148,90.29239360721962,84.81565804953048,NaN,NaN,22.339655496492817,24.696422612606888
2006-11-29T09:30:00-05:00,77.52,78.21001,77.3,78.06,53282704,48523840.8,58.06601284741456,62.738280147205266,NaN,NaN,42.40485010579659,52.64456714602831,-0.13757377833255124,0.7588356539262548,0.8964094322588061,787670500,742256304.8,90.73506012331043,86.09061613995092,NaN,NaN,21.324399821481,24.214705071017477
2006-11-30T09:30:00-05:00,77.89999,78.60001,77.5,78.07001,58605008,49093366.4,58.12525045105914,62.94113073689363,NaN,NaN,47.75966925850661,38.55577722481688,-0.13369410975420748,0.7292917950660467,0.8629859048202542,846275508,758317082.4,91.35512024085236,87.1752555420172,NaN,NaN,20.54450146521417,23.690390270188434
2006-12-01T09:30:00-05:00,78.14999,78.37,76.85001,77.78,87109808,51069592,55.671513888337856,62.71240559997017,NaN,NaN,19.13942642560191,24.405454443223434,-0.1506293809471272,0.6746991786363452,0.8253285595834724,759165700,760542599.2,91.44060394006642,88.07582646614001,NaN,NaN,19.166182421462878,23.04407486322764
2006-12-04T09:30:00-05:00,77.96001,79.33,77.92999,79.32001,64395504,51836676.8,64.29187396788058,63.05575218887321,NaN,NaN,90.80205361626989,38.381973867416875,-0.06259236226815446,0.7470881067482793,0.8096804690164338,823561204,790212141.6,92.50469397096742,88.89848787355926,NaN,NaN,20.732149284127043,22.71379978049898
2006-12-05T09:30:00-05:00,79.39999,79.75999,79.07001,79.38,39559104,51429507.2,64.58082282403372,62.90687737404092,NaN,NaN,120.27059535081547,64.07531895139812,-0.007684550090782838,0.8000747814029552,0.807759331493738,863120308,815958644,93.2848525361541,89.62558700840837,NaN,NaN,22.047013005417675,22.618544526915937
2006-12-06T09:30:00-05:00,79.2,79.49001,78.78999,79.11,37812096,50860081.6,62.14346673134008,62.41555591736729,NaN,NaN,92.79557931694944,74.15346479362867,0.002538482786454299,0.8109324349768059,0.8083939521903516,825308212,823486186.4,93.49794296353888,90.22922322288626,NaN,NaN,22.386711146355864,22.585425472550213
2006-12-07T09:30:00-05:00,79.28999,79.50999,78.66,78.77,39545808,50216781.6,59.11771768712248,61.74599165525616,NaN,NaN,75.91558618144015,79.78464817821539,-0.020254968772765003,0.7830752412243953,0.8033302099971603,785762404,811383565.6,88.6283575646881,90.3672600908835,NaN,NaN,21.769072735535193,22.46880365297664
2006-12-08T09:30:00-05:00,78.62,79.34,78.16,78.78,43109600,49894492,59.180669620117456,61.114428478757496,NaN,NaN,53.06361378918897,86.5694856509328,-0.04016529523886758,0.7531235909485758,0.7932888861874434,828872004,825324826.4,89.31848619605162,90.49890131515144,NaN,NaN,21.286842136379416,22.299952007748466
2006-12-11T09:30:00-05:00,78.8,79.17999,78.53999,78.98,35233200,49470032,60.4910112241165,60.53999187021741,NaN,NaN,62.352056784177385,80.8794862845143,-0.045007901580597975,0.737029009211696,0.782036910792294,864105204,833433626.4,89.70966523373586,90.60027132915091,NaN,NaN,21.239898610051387,22.148515808077455
2006-12-12T09:30:00-05:00,78.94,79.02,77.89,78.55,47917600,49897256.8,56.30600137754975,59.621861324220696,NaN,NaN,10.153643035705384,58.85609582149228,-0.08025504152541973,0.6817181088855193,0.761973150410939,816187604,824047085.6,85.79289791596388,90.38211671869041,NaN,NaN,20.029021064570657,21.84573084471934
2006-12-13T09:30:00-05:00,78.91,79,78.14999,78.64999,47296496,48831963.2,57.050116997117165,58.72465036349757,NaN,NaN,20.071407120085993,44.311261382119596,-0.098705799659627,0.6385909008364052,0.7372967004960322,863484100,831682263.2,86.31624763704066,90.17998780245442,NaN,NaN,19.216303818714223,21.470098412432897
2006-12-14T09:30:00-05:00,78.62,79.59,78.56,78.97,52291504,48189913.6,59.4313446027755,58.29233710550095,NaN,NaN,77.42672885124884,44.613489916081335,-0.09139555896839568,0.6230522517855377,0.7144478107539334,915775604,857684903.2,87.94493932429276,90.0549672474519,NaN,NaN,19.15182350055585,21.138916282164747
2006-12-15T09:30:00-05:00,79.3,79.5,78.81,78.89999,38923808,47669708.8,58.66504335844989,58.91805216963319,NaN,NaN,77.11082576795722,49.422932311834984,-0.09300389445935076,0.598192942679745,0.6911968371390957,876851796,867280861.6,88.48942479695252,89.9507632893453,NaN,NaN,18.896718217068667,20.818602272865306
2006-12-18T09:30:00-05:00,79.06,79.21001,77.63,77.91,47013808,48221894.4,49.03653219985345,58.72552698408343,NaN,NaN,-33.13074131814614,30.326372691370285,-0.1586169087864222,0.49292570115606793,0.6515426099424901,829837988,860427418.4,85.51856308983278,89.60977539524622,NaN,NaN,15.8183632958554,20.104282419006747
2006-12-19T09:30:00-05:00,77.45,78.11,77.10001,77.86,54066000,48505169.6,48.602658181190364,58.04957307935313,NaN,NaN,-93.14783251736006,9.6660775807572,-0.20055778736789998,0.40084537573261514,0.6014031631005151,775771988,852344295.2,82.02095650980073,88.98733942285268,NaN,NaN,13.175090395805183,19.114397844263667
2006-12-20T09:30:00-05:00,77.62,78.25999,77.62,77.98,43288096,48633224,49.75176559330265,57.45146701808481,NaN,NaN,-54.53916602008035,-5.2560370472760685,-0.21415670509518447,0.3337072817315345,0.547863986826719,819060084,843459492,78.23342542355104,88.05007550733116,NaN,NaN,11.264868154076868,17.993036459951266
2006-12-21T09:30:00-05:00,77.99001,78.35001,77.31,77.62,49951392,49466698.4,46.400214145631985,56.78923132217725,NaN,NaN,-68.792198818344,-34.499822581194636,-0.23942292527780717,0.24858533022946006,0.48800825550726723,769108692,814126109.6,67.2002334924619,86.3186204753594,NaN,NaN,8.654630667130862,16.658978489548353
2006-12-22T09:30:00-05:00,77.59,77.75,77.05,77.11,31230304,50131538.4,42.07584646239108,55.20237221464229,NaN,NaN,-106.05196672522818,-71.13238107983172,-0.27970444388945426,0.1383777006454494,0.41808214453490367,737878388,786331428,58.74604879480663,83.9072886770622,NaN,NaN,5.068691684713221,15.003223231714763
2006-12-26T09:30:00-05:00,77.33,78.22,77.3,78.21001,21798192,47580216.8,52.383722933346874,54.33115079387894,NaN,NaN,-46.39115235132646,-73.78446328646778,-0.22390105696498247,0.1382058233286756,0.36210688029365806,759676580,772299146.4,54.98510146107626,81.17159217169952,NaN,NaN,4.928937835212679,13.564039603643037
2006-12-27T09:30:00-05:00,78.37,79.17,78.35001,79.14,39294000,46586201.6,59.02293691880031,54.108255807268954,NaN,NaN,56.5339816018553,-43.8481004626247,-0.12113878188064775,0.21068340294284837,0.3318221848234961,798970580,776938864.8,55.98840809063382,78.4923396807777,NaN,NaN,7.078292074571441,12.637504242347095
2006-12-28T09:30:00-05:00,79.03,79.28,78.64999,78.78,28257296,45334931.2,55.780634041305106,53.86989268971057,NaN,NaN,53.6520250679824,-22.209862245012154,-0.07637860206947539,0.23634893223665188,0.31272753430612726,770713284,767269504.8,53.32113442290718,75.97039517065049,NaN,NaN,7.754853353733311,11.93998268683084
2006-12-29T09:30:00-05:00,78.66,78.99001,77.99001,78.03,30795200,43944440.8,49.66016920723672,53.18985694593338,NaN,NaN,-20.655994024993866,-12.582621286342128,-0.09503422108155646,0.1939347579541817,0.28896897903573815,739918084,761431383.2,51.71906900204179,73.2847225139355,NaN,NaN,6.272785090970534,11.130383030279368
2007-01-03T09:30:00-05:00,78.67999,79.12,77.22,78.16,54097296,42293815.2,50.67052475023963,52.48839362637074,NaN,NaN,-48.813266949561324,-1.1348813312087558,-0.0960835294794789,0.16886456718638954,0.26494809666586844,794015380,772658781.6,54.5474002715596,70.77313215949435,NaN,NaN,5.427690732189549,10.315712701980823
2007-01-04T09:30:00-05:00,77.89,78.59,77.28,78.37,45577600,41352920,52.33479765910664,52.204736217910515,NaN,NaN,-54.7750300479205,-2.8116568705275666,-0.08071813009045728,0.16405043405279685,0.24476856414325412,839592980,788642061.6,58.29310829044038,68.80886147195696,NaN,NaN,5.2517660451189245,9.592291751000552
2007-01-05T09:30:00-05:00,78.02,78.3663,76.7,76.73,57486704,42249300,40.76730386255673,51.04167813687049,NaN,NaN,-147.1499910867165,-43.54845140824193,-0.17374849460900113,0.02758294588200272,0.20133144049100385,782106276,785269200.8,57.221462312784915,66.7306625202244,NaN,NaN,0.9819110403319139,8.362237363762175
2007-01-08T09:30:00-05:00,76.95,77.3,76.23,76.42999,46117200,42664555.2,39.066216400566965,49.58702612242702,NaN,NaN,-194.7174600510609,-93.2223484320506,-0.2439313792324928,-0.10358278354961215,0.14034859568288066,735989076,778324359.2,54.98021803974519,64.37603957132814,NaN,NaN,-2.9563048466954114,6.745302762268234
2007-01-09T09:30:00-05:00,77.12,77.31,76.19,77.14999,62798192,43827174.4,44.99786789584783,48.61079930366974,NaN,NaN,-144.8706570226163,-118.06528103157507,-0.23046417907714872,-0.14773162816355523,0.08273255091359348,798787268,790098196,57.98475461618854,62.197134558416415,NaN,NaN,-4.246813376800004,5.175000456687057
2007-01-10T09:30:00-05:00,76.75999,77.75,76.57001,77.75,49241200,44133754.4,49.41696027727108,48.637972737771,NaN,NaN,-81.17571490167128,-124.53777062199705,-0.17240490623877602,-0.13277358188487653,0.039631324353899475,848028468,800900813.6,60.58397221034618,60.41609235273881,NaN,NaN,-3.8133773898074637,3.890946478616411
2007-01-11T09:30:00-05:00,77.46001,78.53999,77.39999,78.23,49188304,44831509.6,52.69156983492657,48.930037855895016,NaN,NaN,2.906262761568858,-113.0015120600992,-0.09670556133476768,-0.08125062731456012,0.015454934020207554,897216772,812425572,63.19959910298023,59.07170968082306,NaN,NaN,-2.3688942380528366,2.9966835190922327
2007-01-12T09:30:00-05:00,78.25999,79.05,78.13,78.98,28392800,43855269.6,57.33878258469565,49.47196764099452,NaN,NaN,80.11472865304107,-67.54856811214769,0.003533135014451301,0.01987135278827168,0.016338217773820378,925609572,841126231.2,68.75948466933374,58.394999626950394,NaN,NaN,0.4249960223892878,2.629299590991812
2007-01-16T09:30:00-05:00,79.21001,79.36,78.3,78.45,34917200,43236304.8,53.35044976330988,49.968413042257225,NaN,NaN,76.89022538172402,-13.22703102559071,0.03220328092808212,0.056592318933923025,0.024389038005840906,890692372,872066890.4,73.42143101977354,58.83937087890123,NaN,NaN,1.41672573490447,2.456074754407906
2007-01-17T09:30:00-05:00,78.22,78.78,78.11,78.11,27482704,41995864.8,50.904288808572126,50.59901606698445,NaN,NaN,39.76798780265409,23.700697939463364,0.026564667852024475,0.0575948728208715,0.031030204968847026,863209668,884951370.4,75.0885626283102,60.006693295580064,NaN,NaN,1.443762923625625,2.3114587785818657
2007-01-18T09:30:00-05:00,78.13,78.13,77.02,77.46001,55947696,42847059.2,46.513538267052525,50.17971716224913,NaN,NaN,-52.613258939992015,29.413189131799214,-0.020125809131187392,0.005872943554862786,0.02599875268605018,807261972,876798071.2,72.01044675694766,61.22278938814231,NaN,NaN,0.0588925994130784,1.9896636101291818
2007-01-19T09:30:00-05:00,77.03999,77.96001,76.87,77.75999,49715808,42982159.2,48.712250249274064,49.44323954299727,NaN,NaN,-48.230883024966296,19.185759974492193,-0.029428470261928165,-0.01078683514136003,0.018641635120568135,856977780,868750272.8,69.0035998712934,62.15244594390371,NaN,NaN,-0.3873205571511161,1.6500944433748534
2007-01-22T09:30:00-05:00,77.82001,77.83,76.91,77.19,46306896,42594204,44.932647938069316,48.66838339276614,NaN,NaN,-71.42299466743219,-11.121784689602455,-0.07026189142525954,-0.06918572916100629,0.0010761622642532498,810670884,845762535.2,61.14924157180876,62.71159645453953,NaN,NaN,-1.9432913531261475,1.1367536153032818
2007-01-23T09:30:00-05:00,77.03999,78.28,77,77.92,47783392,42818968.8,50.256041369007285,48.710945690035466,NaN,NaN,-17.106164153790292,-29.92106259670532,-0.04559516086387581,-0.05591778881559151,-0.010322627951715702,858454276,839314916,59.11671113535031,63.23999946406157,NaN,NaN,-1.594332307437169,0.7465984834832174
2007-01-24T09:30:00-05:00,78.00999,78.82001,77.94,78.77,30403392,41841568.8,55.6340876632347,49.06548589810654,NaN,NaN,71.44880770198114,-23.584898616839908,0.02659476532657534,0.02292082870650347,-0.003673936620071867,888857668,844444516,60.24876074538392,63.64723949790617,NaN,NaN,0.47462034094390654,0.7077444631204588
2007-01-25T09:30:00-05:00,78.71001,78.95,77.53,77.78,57314096,43145758.4,48.99057614944837,48.826612933130946,NaN,NaN,17.252736502642758,-9.611699528312958,0.007301878366670152,0.005453411338265823,-0.0018484670284043287,831543572,849300836,61.34017102844304,63.864886836334925,NaN,NaN,0.02931516176973432,0.6108259914989267
2007-01-26T09:30:00-05:00,77.99001,78.32001,77.16,78.07001,56630192,44887358.4,50.842441838817436,49.546265645721,NaN,NaN,-11.768544458319516,-2.319231814983602,0.013351306860586543,0.014840666547328851,0.0014893596867423071,888173764,855540032.8,62.755023460531156,64.26014120403109,NaN,NaN,0.2735161040412438,0.5626388647192577
2007-01-29T09:30:00-05:00,78.12,78.94,78.03,78.75,59602192,45902768,54.97036609063006,50.68227633786836,NaN,NaN,81.8240219561495,28.330171509732736,0.05982486888745035,0.07627044579605524,0.016445576908604893,947775956,882961047.2,68.25397709813635,65.20826685105904,NaN,NaN,1.8205862845848069,0.7423456389857648
2007-01-30T09:30:00-05:00,78.89,79.35001,78.50999,79.17999,33835104,46181658.4,57.40609732228114,51.56857843975645,NaN,NaN,135.75750037683127,58.90290441585705,0.11310850481984612,0.15783120793341254,0.04472270311356642,981611060,907592404,72.22142968121581,66.22517221284669,NaN,NaN,3.865321234620203,1.1884850097906845
2007-01-31T09:30:00-05:00,79.06,79.77,78.63,79.35001,54269600,47355378.4,58.365089195534686,52.20773050534672,NaN,NaN,148.29400943926154,74.27194476331314,0.1510188716759197,0.23349629270846606,0.08247742103254635,1035880660,936997002.4,76.06677421858225,67.33108664200641,NaN,NaN,5.805031376862843,1.8479916336581357
2007-02-01T09:30:00-05:00,79.67,80.25,79.53999,80.2,50581200,47179573.6,62.86634485432079,52.93450014958916,NaN,NaN,196.0149752463713,110.02439251205885,0.22035614153972188,0.3579225979571987,0.13756645641747683,1086461860,987980660,80.98242413112831,68.60128842973128,NaN,NaN,8.931847678349845,2.859971068614094
2007-02-02T09:30:00-05:00,80.39999,80.45,80.02,80.25,26512608,46226324,63.11893728940489,53.34736834278268,NaN,NaN,177.90562877623734,147.95922715897024,0.2542006820102848,0.45531730893033284,0.20111662692004806,1112974468,1032940800.8,84.08646677971723,69.69607286618724,NaN,NaN,11.506066914443515,4.095127618018297
2007-02-05T09:30:00-05:00,80.22,80.47,79.87,80.24001,30910096,44897493.6,63.026689216709975,54.03852830373984,NaN,NaN,150.52095333180017,161.69861343410034,0.259617084142456,0.5256379820981181,0.2660208979556621,1082064372,1059798484,85.59864016984986,70.56587351976412,NaN,NaN,13.569271042436373,5.4485766786494505
2007-02-06T09:30:00-05:00,80.25999,80.46001,79.78999,80.44,31453600,44164313.6,64.15607082033685,54.98508416172303,NaN,NaN,137.25955697042264,161.99902475281863,0.2597400563572655,0.5906959684022439,0.33095591204497843,1113517972,1086179866.4,86.91403028229516,71.41054978076305,NaN,NaN,15.62276155154343,6.902031660491447
2007-02-07T09:30:00-05:00,80.55,81.21001,80.28,81.17999,30708608,42559834.4,68.0455062285708,56.52308187326005,NaN,NaN,163.84142037067895,165.1085069391021,0.2904083011770404,0.693966288516279,0.40355798733923853,1144226580,1107849050.4,87.89226624630271,72.54496545857413,NaN,NaN,18.61505125293435,8.575320173697577
2007-02-08T09:30:00-05:00,80.87,81.14,80.58,81.05,25426496,41369099.2,66.6767869235295,57.8062630642783,NaN,NaN,140.6727986956776,154.04007162896337,0.2824320606049827,0.756598063095467,0.47416600249048424,1118800084,1114316695.2,88.17636991049817,73.91444903280305,NaN,NaN,20.72412320431499,10.310863463785779
2007-02-09T09:30:00-05:00,80.98,81.14999,79.7,80.22,52164896,41517928.8,58.57501219971357,58.780717654395744,NaN,NaN,89.59407965577637,136.37776180487117,0.20533561032306724,0.7308355153943182,0.525499905071251,1066635188,1105048839.2,85.09505492802393,75.62486427253269,NaN,NaN,20.27263379632753,11.733973511291744
2007-02-12T09:30:00-05:00,80.28,80.3,79.60001,80.02,39561744,42076376,56.784521550913155,59.24703766738902,NaN,NaN,57.892971259263604,117.85216539036387,0.12869460180967762,0.686368157333348,0.5576735555236704,1027073444,1094050653.6,81.45724464599348,77.22061666615006,NaN,NaN,19.382076645113678,12.826559673266306
2007-02-13T09:30:00-05:00,80.23,80.67999,79.59,80.67999,42057152,42433373.6,61.01904187795809,59.63167725415497,NaN,NaN,71.51809065251385,104.7038721267821,0.1109459353597747,0.6963559747233887,0.585410039363614,1069130596,1085173178.4,78.53865984626596,78.52703803049879,NaN,NaN,19.834934895880803,13.827756133639806
2007-02-14T09:30:00-05:00,80.73,81.28999,80.52,80.75,64325984,44275537.6,61.450551487375556,60.52167549257835,NaN,NaN,93.59304032348705,90.65419611734373,0.09313624887669936,0.7018303504594883,0.6086941015827889,1133456580,1083019178.4,77.81017602173377,79.70346695859098,NaN,NaN,20.326492252294848,14.756147007733384
2007-02-15T09:30:00-05:00,80.71001,81.19,80.56,80.77,44101008,43683203.2,61.581389583531276,61.28874318862934,NaN,NaN,84.89648393350086,79.4989331649084,0.0728181316952794,0.6997167662018882,0.6268986345066088,1177557588,1094770679.2,78.9569490057439,80.86074735467761,NaN,NaN,20.766738139887963,15.614802883755466
2007-02-16T09:30:00-05:00,80.72,81.27,80.34,81.17,41861600,43290492.8,64.19855560960812,61.94789958284206,NaN,NaN,84.02124404139957,78.38436604203302,0.07607763302426707,0.7219956757869426,0.6459180427626755,1219419188,1125327479.2,81.6172634888639,81.81526781115814,NaN,NaN,21.869558643884407,16.508339420916744
2007-02-20T09:30:00-05:00,81,82.16,80.10001,81.89999,71903312,44570313.6,68.42585342383676,62.735025018667464,NaN,NaN,109.30618083373882,88.66700795692807,0.11483005498407528,0.7894556114927695,0.6746255565086943,1291322500,1178177290.4,85.12091398845232,82.73665954738932,NaN,NaN,24.11290025007566,17.594705253653732
2007-02-21T09:30:00-05:00,81.64999,82.49001,81.53,82.10001,39550000,44158644,69.48892144065545,63.52958446474752,NaN,NaN,150.67274015933577,104.49793785829247,0.1397141177721719,0.8492682037239092,0.7095540859517373,1330872500,1230525671.2,87.63485135257832,83.56295077124618,NaN,NaN,26.294951117103892,18.837597519860896
2007-02-22T09:30:00-05:00,82.25,82.45,81.63,82.39,58815904,45579269.6,71.01273206994358,64.11146926586343,NaN,NaN,149.5315337912061,115.68563655183627,0.16002453649390402,0.9095847565691173,0.7495602200752133,1389688404,1281772036,89.50437512866522,84.17166155678453,NaN,NaN,28.593314256236308,20.2312713393431
2007-02-23T09:30:00-05:00,82.25999,82.31,81.66,81.95,57987696,45612949.6,65.65483358008592,64.29260471519778,NaN,NaN,124.97101568560296,123.70054290225669,0.12945259331171188,0.9113759617148531,0.7819233684031413,1331700708,1312600660,90.44071363433994,84.62553633211473,NaN,NaN,29.07270162079618,21.49433280812211
2007-02-26T09:30:00-05:00,82.32001,82.41,81.19,81.75,78736368,46718258.4,63.31634060858154,64.31329410033148,NaN,NaN,101.30086644574202,127.15646738312519,0.0836123938931681,0.8864388607696014,0.8028264668764333,1252964340,1319309690.4,90.6364870425696,84.985382537309,NaN,NaN,28.81772732291819,22.54053202452155
2007-02-27T09:30:00-05:00,80.36,80.94,77.47,78.05,136739120,50575104.8,37.035332368442944,62.37609849662476,NaN,NaN,-154.987244862027,74.29778224397197,-0.19294702665873253,0.5616426835530177,0.7545897102117503,1116225220,1284290234.4,81.27935424288358,84.58290567735102,NaN,NaN,17.4691004828507,21.816041804282857
2007-02-28T09:30:00-05:00,78.37,79.22,77.50999,78.83,98091120,53787905.6,42.45772322670388,60.548399710777126,NaN,NaN,-173.29429913578852,9.504374384947113,-0.313276184218765,0.36299447993829403,0.676270664157059,1214316340,1260979002.4,75.67851815462822,83.71049509937427,NaN,NaN,10.949222107819427,20.26363899050237
2007-03-01T09:30:00-05:00,77.47,79.10001,76.75,78.42999,97677744,55958312.8,40.530056112819786,58.680776081440726,NaN,NaN,-190.3977374577373,-58.481479864841575,-0.4039668480332581,0.17131210411548636,0.5752789521487445,1116638596,1206369040.8,64.47058444532017,82.01722470900441,NaN,NaN,5.3227648591657175,18.12922840031142
2007-03-02T09:30:00-05:00,78.17999,78.38,76.75,76.8,96275504,58243028,33.796482487107426,56.91088110196886,NaN,NaN,-208.33885085363355,-125.14345317268888,-0.5489002516864003,-0.11084636245925594,0.4380538892271444,1020363092,1144101517.6,54.55029312241638,79.83545600860387,NaN,NaN,-2.188468649658172,15.226700250315764
2007-03-05T09:30:00-05:00,76.09,77.28999,75.14999,75.17,122223184,63028556.8,28.667356136363765,54.90251214378676,NaN,NaN,-230.40016239452714,-191.4836589407427,-0.7189838887752635,-0.4606759717419351,0.25830791703332845,898139908,1073136631.2,45.884716352196165,77.2945611304755,NaN,NaN,-10.508942292428054,11.550179887066648
2007-03-06T09:30:00-05:00,76.25999,77.71001,76.19,77.07001,94041440,66185124,40.08243723239751,53.40704038338958,NaN,NaN,-138.85796364707272,-188.25780269775186,-0.6689994384635559,-0.5779413810461165,0.09105805741743944,992181348,1048327856.8,43.29538025818027,74.77718401704081,NaN,NaN,-12.574329288489652,8.103821433415748
2007-03-07T09:30:00-05:00,77.3,77.62,76.8,76.97,55404896,67382688.8,39.72211153924763,51.8550089585233,NaN,NaN,-111.7644041583523,-175.9518237022646,-0.6098126608209081,-0.6712077686086957,-0.06139510778778759,936776452,992819879.2,38.11301039565975,71.94167218660695,NaN,NaN,-14.182787320765758,4.92002018281839
2007-03-08T09:30:00-05:00,77.73,78.17999,77.078,78.00999,76873872,69690952,45.23540845650827,50.68743887802166,NaN,NaN,-75.74586941324488,-153.02145009336613,-0.4738186882128965,-0.6536684680539082,-0.17984977984101172,1013650324,972222224.8,36.37314845556906,68.89997214730874,NaN,NaN,-13.421324928685321,2.299828024032146
2007-03-09T09:30:00-05:00,78.17999,78.28,77.42,78.25999,69129872,71876120.8,46.50214200790296,49.42340933504271,NaN,NaN,-59.674899283934685,-123.28865977942635,-0.3461478701719517,-0.6125346175559514,-0.2663867473839997,1082780196,984705645.6,38.214055053732935,65.79974297337083,NaN,NaN,-12.404020256765682,0.19927826963245598
2007-03-12T09:30:00-04:00,78.00999,78.50999,77.75,78.39999,35945392,71065145.6,47.238142672303724,47.910001424218926,NaN,NaN,-46.025950245724644,-86.41381734966585,-0.2366175614203862,-0.5621586991594825,-0.32554113773909626,1118725588,1028822781.6,44.342793783344206,62.887020101577384,NaN,NaN,-11.376745692550852,-1.4544394392508737
2007-03-13T09:30:00-04:00,77.84,78.06,76.25999,76.39,96385504,73906333.6,38.952476503532424,45.728826785853,NaN,NaN,-85.53054541962776,-75.74833370417684,-0.28086717197239586,-0.6766251027045911,-0.39575793073219523,1022340084,1034854528.8,45.143966806224306,59.85195691969496,NaN,NaN,-13.325104655795167,-3.1502487559000585
2007-03-14T09:30:00-04:00,76.41,77.28,75.53,77.2,129043008,78255626.4,43.27081764211736,43.7472614695797,NaN,NaN,-85.35871869383068,-70.46719661127253,-0.23857809213993147,-0.6939805459071096,-0.4554024537671781,1151383092,1077775856.8,50.59400185547868,57.072644543038784,NaN,NaN,-13.414912085302703,-4.616629231529007
2007-03-15T09:30:00-04:00,77.12,77.92,77.12,77.75,84037248,79241189.6,46.06088731664336,42.3476938793338,NaN,NaN,-48.808543094806176,-65.0797313475848,-0.16031392601295225,-0.6557948612833684,-0.49548093527041615,1235420340,1122129860,55.512752311981764,54.57779016287035,NaN,NaN,-12.56213840583453,-5.75170197071551
2007-03-16T09:30:00-04:00,77.81,78.06,76.53999,77.37,77107056,80891492,44.434823541008235,40.999014088792855,NaN,NaN,-54.66472112164926,-64.0776957151277,-0.12258904914845503,-0.648717246705985,-0.5261281975575299,1158313284,1137236477.6,57.080056693448654,52.180902280790285,NaN,NaN,-12.389204872517663,-6.699916670972961
2007-03-19T09:30:00-04:00,77.83,78.48,77.81,78.25,56720752,81634449.6,48.93102892982241,41.84870670031995,NaN,NaN,-18.57465146929404,-58.58743595984159,-0.031561352149295896,-0.5655798877441498,-0.5340185355948539,1215034036,1156498167.2,59.060542440646486,50.59384429491621,NaN,NaN,-10.812773056114482,-7.287467583136035
2007-03-20T09:30:00-04:00,78.19,78.89999,77.96001,78.84,46527216,80365644.8,51.7500255457486,42.51244258025172,NaN,NaN,3.3429305441033206,-40.81274076709538,0.06966850976883765,-0.4469328983838068,-0.5166014081526444,1261561252,1204342400.8,63.5586233424382,49.728137522616926,NaN,NaN,-8.627871899971836,-7.478953914112578
2007-03-21T09:30:00-04:00,78.96001,81.12,78.73,80.34,77683120,82272300.8,58.08482234597365,43.766354454048425,NaN,NaN,84.78030030785034,-6.784936966759162,0.22990153982106476,-0.22922448337631351,-0.4591260231973783,1339244372,1241914656.8,66.65685634514047,49.88429980117553,NaN,NaN,-4.590240120201657,-7.066280514982447
2007-03-22T09:30:00-04:00,80.56,80.60001,79.91,80.27,40940816,81378546.4,57.70407790534329,45.47403984106527,NaN,NaN,109.9341895961194,24.963609571425952,0.3179992080632762,-0.061627013118283,-0.3796262211815592,1298303556,1254491300,67.64836760510349,50.81987654993889,NaN,NaN,-1.5340561094173495,-6.275962742758861
2007-03-23T09:30:00-04:00,80.23,80.42439,80.05,80.24001,37200480,80339185.6,57.53008600249472,47.53566340293177,NaN,NaN,125.4184965304585,60.980253101847495,0.35809416388292936,0.0679914836721025,-0.29010268021082686,1261103076,1275049258.4,69.25763533650758,52.48937076310399,NaN,NaN,0.8656085757491325,-5.255738268686291
2007-03-26T09:30:00-04:00,80.32001,80.48,79.48,80.07001,46663024,78735518.4,56.4902774646011,48.7076519909463,NaN,NaN,128.86657909545227,90.46849921479676,0.35624882553978915,0.15520835171390956,-0.20104047382587958,1214440052,1274930461.6,69.23620274001617,54.3422866546637,NaN,NaN,2.564095317576026,-4.138619184934532
2007-03-27T09:30:00-04:00,80.00999,80.07001,79.35001,79.63,40786544,73937889.6,53.780809625195204,49.711844711371135,NaN,NaN,98.76821888578779,109.55355688313367,0.3101694884765911,0.18667138676985928,-0.12349810170673181,1173653508,1257348912.8,65.98182098166745,56.33291598223568,NaN,NaN,3.278892706234416,-3.0789746290532536
2007-03-28T09:30:00-04:00,79.22,79.5,78.61,79.22,67956256,72431146.4,51.31119919534754,50.14582976414537,NaN,NaN,57.534268440280975,104.10435050961978,0.23998892204806613,0.17648805085335084,-0.06350087119471529,1105697252,1210639488.8,58.16025643905418,57.889137981056045,NaN,NaN,3.2184070387309918,-2.1793486765126473
2007-03-29T09:30:00-04:00,79.69,79.75999,78.49001,79.17999,49856608,70040089.6,51.06477016152296,50.47173177511822,NaN,NaN,53.763969890819524,92.87030656855981,0.18144606736961705,0.16330671301730604,-0.018139354352311017,1055840644,1162146906.4,51.35412745934481,58.8277145814569,NaN,NaN,3.1034456004344415,-1.4246637798059205
2007-03-30T09:30:00-04:00,79.36,80.06,78.73,79.50999,54325504,67942589.6,53.066885781983686,50.888070568666805,NaN,NaN,63.53008891736201,80.49262504594051,0.15646603963476502,0.17744319519114526,0.020977155556380238,1110166148,1131959520.8,47.618333402639045,59.06168169712082,NaN,NaN,3.5235582926866655,-0.7177749123069798
2007-04-02T09:30:00-04:00,79.61,79.77,79.14999,79.75,36558704,63659365.6,54.52418292298666,52.00033531291353,NaN,NaN,63.54952237305284,67.42921370146061,0.1477324666184474,0.2056427388294395,0.05791027221099209,1146724852,1118416480.8,46.001537277678146,59.12293673079609,NaN,NaN,4.260223953182642,-0.006632217237033888
2007-04-03T09:30:00-04:00,80.07001,80.77,80,80.53,44410960,61177841.6,58.981730837151815,53.12254339827314,NaN,NaN,106.18648831953048,68.91286758820917,0.1837638731129097,0.2876151136021292,0.10385124048921951,1191135812,1121912941.6,46.50652297926785,58.830973953923895,NaN,NaN,6.142483470557744,0.8718128810193628
2007-04-04T09:30:00-04:00,80.48,80.59,80,80.49001,35764576,60195825.6,58.66424054769323,54.0227829147767,NaN,NaN,92.80462268145406,75.96693843644378,0.19321559446316372,0.34537073356817416,0.15215513910501044,1155371236,1131847738.4,47.99471900765446,58.29397157504337,NaN,NaN,7.634077655585796,1.8378507059574247
2007-04-05T09:30:00-04:00,80.45,80.81,80.35001,80.44,24667712,57585517.6,58.242019872546386,55.009011224172276,NaN,NaN,95.0273916324928,84.21962278477845,0.1844323788329648,0.38269561264621643,0.19826323381325164,1130703524,1146820314.4,50.241440964359924,57.8054990229656,NaN,NaN,8.791864818945424,2.8312812935271388
2007-04-09T09:30:00-04:00,80.78,80.83,80.32001,80.57001,38544912,56056269.6,59.0668151523641,55.732995954353825,NaN,NaN,90.19180362316756,89.55196572593955,0.17574838579200686,0.4179487160532602,0.24220033026125337,1169248436,1158636772,52.00376009578416,57.30144314118973,NaN,NaN,9.995839359306945,3.8547895886385395
2007-04-10T09:30:00-04:00,80.5,81.06,80.38,80.8,48521008,56685050.4,60.55123572787593,56.36165382450577,NaN,NaN,92.3916774087141,95.32039673307182,0.17356173671959285,0.45915250116074446,0.2855907644411516,1217769444,1172845690.4,54.108541619203145,56.62643730381579,NaN,NaN,11.422145790841094,4.935840474667476
2007-04-11T09:30:00-04:00,80.87,80.89999,79.8,80.3,61020144,54916782.4,55.81253872036056,56.199347851247694,NaN,NaN,62.62071695320635,86.60724245980698,0.1285802860136539,0.446316121958219,0.3177358359445651,1156749300,1165968388,52.89935871410478,55.64375890159896,NaN,NaN,11.513060980305646,5.875443404044357
2007-04-12T09:30:00-04:00,80.09,80.92,79.67,80.84,47137216,50821492.8,59.49900341323053,56.32755681609678,NaN,NaN,69.26600133826011,81.89951819116818,0.1252111945806596,0.4742498291703896,0.34903863458973,1203886516,1175671444,54.44613154014733,54.70074203981637,NaN,NaN,12.571390434686366,6.832007265564644
2007-04-13T09:30:00-04:00,80.95,81.39999,80.53,81.39999,31476992,48193480,62.95091533785179,56.71475891147943,NaN,NaN,116.50864916867387,86.19576969840439,0.14909087057431114,0.535402222807619,0.3863113522333078,1235363508,1196603440.8,57.675228880734416,53.87342729297543,NaN,NaN,14.474595819986439,7.923805630482043
2007-04-16T09:30:00-04:00,81.81,82.57001,81.8,82.45,44162768,46546265.6,68.39096731085769,57.56480818621204,NaN,NaN,219.1508147204755,111.98757191786599,0.21972985739165452,0.660973673972876,0.44124381658122147,1279526276,1218659008.8,60.82619612578396,53.27271253481599,NaN,NaN,17.911667734422927,9.35064307390217
2007-04-17T09:30:00-04:00,82.61,82.63,81.94,82.25999,56535968,46537026.4,66.4884037319631,58.47249347955261,NaN,NaN,206.08058998293492,134.72535443271013,0.23633767366159109,0.7366659086582104,0.5003282349966193,1222990308,1219703181.6,60.97432458691115,52.91503422090482,NaN,NaN,20.197681726761026,10.900220024310578
2007-04-18T09:30:00-04:00,81.91,82.22,81.66,81.78,49028816,46662106.4,61.81058187045044,59.222449384917105,NaN,NaN,150.26899934977,152.25501091202287,0.19916468229983753,0.7492840878714162,0.5501194055715787,1173961492,1223145620,61.491312004917596,53.15296676132363,NaN,NaN,20.802637605170705,12.314851107290595
2007-04-19T09:30:00-04:00,81.14,81.83,80.8,81.36,69360496,46245975.2,57.967462727629595,59.71549885392472,NaN,NaN,82.23402869675117,154.8486163837211,0.1336060773091503,0.7171270022080165,0.5835209248988662,1104600996,1203288516,56.815761090855915,53.543083449288716,NaN,NaN,20.18825011291698,13.43962239380865
2007-04-20T09:30:00-04:00,81.96001,82.38,81.75999,82.31,68702192,47634044,63.4961130849071,60.46044366127639,NaN,NaN,135.80265636232176,158.70741782245068,0.14081829417491232,0.7595437926175066,0.6187254984425943,1173303188,1190876452,54.049316254446,54.00243936727493,NaN,NaN,21.34242492150486,14.568594183479536
2007-04-23T09:30:00-04:00,82.21001,82.50999,81.88,82.21001,36066128,47577326.4,62.56335040192464,61.03466990977197,NaN,NaN,118.78337361202946,138.6339296007615,0.12593491384054045,0.7761441407432699,0.6502092269027294,1137237060,1162418608.8,48.248612648489264,54.162944750904295,NaN,NaN,21.995444923350227,15.62957286060392
2007-04-24T09:30:00-04:00,82.27,82.35001,81.37,82.28999,56640688,48076209.6,63.03116024737537,61.32391486764508,NaN,NaN,90.7225653132527,115.56232466682505,0.10918088644931623,0.7866853349643748,0.6775044485150585,1193877748,1156596096.8,47.13401530677384,54.207765631440445,NaN,NaN,22.662156810468844,16.634227710584625
2007-04-25T09:30:00-04:00,82.53999,82.92999,81.97,82.53,52989104,48686337.6,64.46614513645244,61.73833662398503,NaN,NaN,110.10094285855298,107.52871336858163,0.10209654293939274,0.8051251271892994,0.7030285842499067,1246866852,1171177168.8,50.23447109332054,54.36774792327373,NaN,NaN,23.62637993491622,17.63310659977485
2007-04-26T09:30:00-04:00,82.45,83.17,81.97,83.17,47381568,47657603.2,68.02977448762161,62.437461953633246,NaN,NaN,117.66103141148386,114.61411391152816,0.1267380716235268,0.8614511737793151,0.7347131021557883,1294248420,1209106653.6,57.25690076099465,54.86885219446193,NaN,NaN,25.526998242610176,18.760805405894185
2007-04-27T09:30:00-04:00,82.515,82.64,82.02,82.48,56760976,48002821.6,60.93452847865777,62.57087004836851,NaN,NaN,81.71772311729234,103.79712726252228,0.08480665813561261,0.8407214248253041,0.7559147666896915,1237487444,1221943504.8,59.34768996992263,55.39341861404325,NaN,NaN,25.068866438181814,19.661956981935276
2007-04-30T09:30:00-04:00,82.47,82.52,80.72,80.74001,86678624,49620477.6,47.48499625451352,61.63756722884262,NaN,NaN,-2.7033921716708456,79.49977410578224,-0.0638544721505635,0.6760966765014871,0.7399511486520506,1150808820,1224657856.8,59.795517777535416,55.79963119678127,NaN,NaN,19.853777543836248,19.6893599193497
2007-05-01T09:30:00-04:00,80.99001,81.16,80.13,81.07001,90312752,52308180,49.750313107079506,61.20455111360826,NaN,NaN,-55.49219024038711,50.256822995054264,-0.13937119594280345,0.5657371537235463,0.7051083496663497,1241121572,1234106621.6,61.38999825019294,56.406105449358996,NaN,NaN,16.47687455818913,19.230433439183905
2007-05-02T09:30:00-04:00,81.07001,82.44,80.92,82.14999,49862736,52580768.8,56.38165202136043,60.98188315704611,NaN,NaN,31.357147734778767,34.50806397029943,-0.11690408468317881,0.5589782438123763,0.6758823284955551,1290984308,1242930112.8,62.8708442857055,57.00787064547029,NaN,NaN,15.846201275551364,18.746971701522114
2007-05-03T09:30:00-04:00,82.21001,82.57001,81.97,82.28999,57487088,53666894.4,57.17070434450515,60.56901094323564,NaN,NaN,65.00700644434612,23.977258976871877,-0.09392124655184464,0.5584807703057493,0.6524020168575939,1348471396,1253774708,64.6646564937999,57.50711547497495,NaN,NaN,15.614764173664671,18.299513483256764
2007-05-04T09:30:00-04:00,82.49001,82.87,82.14999,82.87,47941104,54830564,60.369307628184906,59.996035251616156,NaN,NaN,91.21987194033733,25.87768874148088,-0.04352548338516793,0.597995162626134,0.6415206460113019,1396412500,1285559719.2,69.34013295909514,58.115253820211464,NaN,NaN,16.461892043436215,18.03699613471097
2007-05-07T09:30:00-04:00,82.7,83,82.47,82.59,40423760,54924506.4,58.11299167808825,59.397791533482234,NaN,NaN,91.51684829517981,44.721736834851015,-0.0333742847420927,0.599802790083686,0.6331770748257787,1355988740,1326595703.2,74.10415545290697,59.053098882068305,NaN,NaN,16.441556292764584,17.809076157290058
2007-05-08T09:30:00-04:00,82.19,82.62,81.53999,82.28999,59329760,55464944,55.71038722016307,58.962063344175995,NaN,NaN,31.993938278464064,62.21896253862125,-0.05018066678969535,0.5704512413386595,0.6206319081283549,1296658980,1337703184.8,75.22625313678768,60.034166105773316,NaN,NaN,15.69346619162971,17.50684616219572
2007-05-09T09:30:00-04:00,82,83.23,81.95,82.62,66099568,55718915.2,57.77824823458119,58.948548023243966,NaN,NaN,80.61872687903153,72.0712783674718,-0.042681743392423366,0.5672797288878257,0.6099614722802491,1362758548,1352058032.8,76.63530929409043,61.44984812029007,NaN,NaN,15.683112868105129,17.246312834468494
2007-05-10T09:30:00-04:00,82.32001,82.42,81.2485,81.53999,92494880,57986798.4,49.614115200978205,57.95697674582046,NaN,NaN,-47.35249948033605,49.59937718253536,-0.11022873337953043,0.472175555555836,0.5824042889353664,1270263668,1336416487.2,71.84049622780202,62.7206466898155,NaN,NaN,13.059759741428278,16.648233821177033
2007-05-11T09:30:00-04:00,81.75,82.45,81.64999,82.3,57249632,59275430.4,54.487722017889936,57.38014614696085,NaN,NaN,6.708218542339777,32.697046502935855,-0.10359511180565861,0.45291039917829323,0.5565055109839518,1327513300,1322636647.2,67.81501486655381,64.11824684824867,NaN,NaN,12.388771658175045,16.039739226462462
2007-05-14T09:30:00-04:00,82.28999,82.59,81.46001,81.7,72217872,60678185.6,50.347389828216265,56.474162545592336,NaN,NaN,-28.253191685911887,8.74303850671752,-0.13737081218080094,0.38479199575795064,0.5221628079387516,1255295428,1302497984.8,62.319090666644925,65.20289508823947,NaN,NaN,10.484850664272974,15.24618371757825
2007-05-15T09:30:00-04:00,81.62,82.28,80.78,80.98,115262816,63614528,45.84545926168407,55.144113554537455,NaN,NaN,-111.00517874784623,-19.856784898544536,-0.20204873845945837,0.2696018848644286,0.47165062332388696,1140032612,1271172711.2,54.87006784436168,65.53400914188526,NaN,NaN,7.39571054365941,14.124687549875558
2007-05-16T09:30:00-04:00,81.10001,81.5,80.46001,81.42999,97531248,66039649.6,48.919649576002364,53.77910463227894,NaN,NaN,-126.85559409500675,-61.351649093352194,-0.2075785190528719,0.21217747450779711,0.419755993560669,1237563860,1246133773.6,49.751055203912436,64.9978773163794,NaN,NaN,5.835267687113521,12.940484712338124
2007-05-17T09:30:00-04:00,81.3,81.41,80.71001,80.78,71780432,66160646.4,44.9503200311703,52.637375457458404,NaN,NaN,-141.39230489683993,-80.15961017665298,-0.24547054799694357,0.11291780856448952,0.3583883565614331,1165783428,1225237725.6,45.9023179440618,64.03749360024649,NaN,NaN,3.243060166181951,11.555138348601528
2007-05-18T09:30:00-04:00,81.19,82.05009,80.78,81.73,80552128,66753143.2,51.184676166399335,52.9016383083074,NaN,NaN,-57.32341832037948,-92.96593754919682,-0.1989931435113353,0.10964692717226399,0.3086400706835993,1246335556,1209002176.8,43.11171066112538,62.845793091931476,NaN,NaN,3.048125676357829,10.339850823995285
2007-05-21T09:30:00-04:00,81.73,83.23,81.64999,82.75999,148866816,72393177.6,56.885692789022045,53.41130828558901,NaN,NaN,76.82248021176295,-71.9508031696619,-0.09651271444792353,0.1879991776236949,0.2845118920716184,1395202372,1236983565.6,48.87993902434184,61.95221743294212,NaN,NaN,4.829045974926509,9.55259298841403
2007-05-22T09:30:00-04:00,82.81,83.64,82.62,83.33,69773632,73049824.8,59.6913133197519,53.647712664045535,NaN,NaN,139.51515019940592,-21.846737380211458,0.006562255025473085,0.2927147108534598,0.2861524558279867,1464976004,1301972244,59.22183894314255,61.69157419418762,NaN,NaN,7.221064318927195,9.219517464201626
2007-05-23T09:30:00-04:00,83.55,84.10001,82.97,83,59645152,73382627.2,57.36395756727013,53.6615164656716,NaN,NaN,143.18676837440762,32.16173511367141,0.04715501836742653,0.34509622878726987,0.29794121041984334,1405330852,1335525642.4,63.34496060395873,61.59731020205611,NaN,NaN,8.402193492744455,9.102756896850602
2007-05-24T09:30:00-04:00,82.98,83.56,81.56,82,89565312,75491814.4,50.88887603403075,52.98434278037489,NaN,NaN,37.52149619084872,67.94449533120914,0.003591895073776441,0.3024310792620639,0.2988391841882875,1315765540,1365522064.8,66.59663029941261,61.40134572636449,NaN,NaN,7.297703771923432,8.84489216471815
2007-05-25T09:30:00-04:00,82.24001,82.71001,82.03999,82.5,44084256,74857978.4,53.70281949109414,52.669330481303874,NaN,NaN,42.1421828303171,87.83761556134847,0.005283452386135923,0.3054434996709574,0.3001600472848215,1359849796,1388224912.8,68.84900296739781,61.02597769168527,NaN,NaN,7.299173318551413,8.62407518669433
2007-05-29T09:30:00-04:00,82.78,83.39,82.72,83.33,59404128,73494253.6,58.004435931252154,52.83319110352452,NaN,NaN,114.67644859484794,95.40840923796546,0.05629887954711271,0.37053364671871236,0.31423476717159965,1419253924,1393035223.2,69.3210314080903,60.604176139635456,NaN,NaN,8.70458849983425,8.635577088571463
2007-05-30T09:30:00-04:00,82.64,83.85001,82.42999,83.8,64385440,72197888,60.25633785125157,53.01019750471526,NaN,NaN,128.80755807561744,93.26689081320777,0.11245256426733358,0.4548004725057666,0.34234790823843303,1483639364,1396767895.2,69.7046534483927,60.10912929351418,NaN,NaN,10.574815552719524,8.912611154878329
2007-05-31T09:30:00-04:00,83.99001,84.45,83.78,84.2,69038752,73156688.8,62.11810174015177,53.90333940037051,NaN,NaN,187.40689068131692,102.11091527458963,0.16415960173049277,0.547547410401549,0.3833878086710562,1552678116,1426237348,72.61601638246317,60.16452359027569,NaN,NaN,12.690486478113252,9.452307629626175
2007-06-01T09:30:00-04:00,84.53999,85.17,84.19,84.7,71003056,73832487.2,64.36521790498426,54.60887482087725,NaN,NaN,198.63188442167927,134.33299292075574,0.21637661193649654,0.6538585735916769,0.43748196165518033,1623681172,1487820474.4,77.48526185044616,60.85525551769657,NaN,NaN,15.154476812672005,10.26690322720415
2007-06-04T09:30:00-04:00,84.49001,84.97,84.34,84.78999,52419808,74056422.4,64.7702710634913,55.639080623396886,NaN,NaN,165.5970699388319,159.0239703424587,0.23951691480940557,0.7368781051669373,0.49736119035753174,1676100980,1551070711.2,81.18559365156597,62.20286287376236,NaN,NaN,17.26505874027827,11.266639729071882
2007-06-05T09:30:00-04:00,84.59,84.72,83.83,84.45,84806256,76275547.2,61.90717779036354,56.78634623258828,NaN,NaN,116.45011886655524,159.37870439680017,0.21523322133476086,0.7664027170259828,0.551169495691222,1591294724,1585478871.2,82.83803049722532,64.20057449182406,NaN,NaN,18.23443883871485,12.262039601878021
2007-06-06T09:30:00-04:00,83.8,83.81,83,83.50999,95168320,78067475.2,54.706846531478575,57.19971744369372,NaN,NaN,47.789063998977376,143.17500558147213,0.12371564235130927,0.7058140486303586,0.5820984062790493,1496126404,1587976279.2,82.95504586996859,66.57228811082807,NaN,NaN,16.945808341506183,12.931149421824902
2007-06-07T09:30:00-04:00,83.25999,83.45,81.78,81.84,113906192,80457806.4,44.74908520010472,57.18534352718904,NaN,NaN,-26.365709494885543,100.42048554623166,-0.05201292202394081,0.5170822537491233,0.5690951757730641,1382220212,1553884698.4,75.39759057985178,68.67909329909878,NaN,NaN,12.365870391477143,12.850395274632366
2007-06-08T09:30:00-04:00,81.87,83.14,81.66,82.85001,86382128,80152168.8,50.60505735987513,57.14394218386588,NaN,NaN,-16.49811659155577,57.39448534358464,-0.10016143188088877,0.44389338592195315,0.5440548178028419,1468602340,1522868932,69.2191470319193,70.54391018272692,NaN,NaN,10.46224753862572,12.509231312345701
2007-06-11T09:30:00-04:00,82.74001,83.27,82.33,82.87,70164880,80797931.2,50.716392900070396,56.70327790608361,NaN,NaN,0.5781029142772863,24.390691938673704,-0.12877368612274476,0.383087710149411,0.5118613962721558,1538767220,1495402180,64.20175551470072,71.63832564632398,NaN,NaN,9.026699733942559,12.011726801145253
2007-06-12T09:30:00-04:00,82.33,82.8347,81.41,81.50999,115672880,82970681.6,43.52796828557649,55.54875326078537,NaN,NaN,-66.2431316589891,-12.14795816643515,-0.2314159669678159,0.22259143756238586,0.4540074045302018,1423094340,1461762103.2,58.599298645226085,71.59385848218709,NaN,NaN,5.318676583507198,11.055576770054103
2007-06-13T09:30:00-04:00,81.89,82.97,81.74001,82.59,120707808,83242931.2,49.63317406007967,54.9965544388432,NaN,NaN,-34.104410017641165,-28.526652969758857,-0.21883433644987893,0.18046448396785308,0.399298820417732,1543802148,1471297252,59.67347984106122,71.33160985626584,NaN,NaN,4.250174477953579,10.08337644261117
2007-06-14T09:30:00-04:00,82.88,83.67,82.88,83.34,79451936,82338965.6,53.40076585753999,55.17597514052243,NaN,NaN,26.947549853451328,-17.864001100091485,-0.1552538399276885,0.20523152050812143,0.3604853604358099,1623254084,1519504026.4,64.66507447377818,71.19364158300624,NaN,NaN,4.646853812020451,9.306730352526781
2007-06-15T09:30:00-04:00,84.28999,84.69,84.06,84.33,83709744,82935431.2,57.87965015980531,55.474320188287514,NaN,NaN,109.28267141453242,7.292156501126156,-0.04737114267368847,0.30127143209369933,0.3486425747673878,1706963828,1567176324,68.78052052581845,71.18874998003629,NaN,NaN,6.5069549009881715,8.906762430878409
2007-06-18T09:30:00-04:00,84.58,84.62,83.7,84.17,60139536,81914801.6,56.92733350842215,55.39738430094251,NaN,NaN,83.65091128353332,23.906718174977364,0.009341581491043971,0.3603195516311928,0.3509779701401488,1646824292,1588787738.4,70.46018411423347,71.27011803047507,NaN,NaN,7.660013907190131,8.72865549892294
2007-06-19T09:30:00-04:00,83.81,84.50999,83.49001,84.39,65576944,77750308,57.95178275993799,55.23277322299155,NaN,NaN,72.540401070759,51.66342472092698,0.05523840403337854,0.420025975181872,0.3647875711484935,1712401236,1646649117.6,74.42721001294741,71.60744349937184,NaN,NaN,8.900708596479546,8.753234512859597
2007-06-20T09:30:00-04:00,84.58,84.66,82.92999,82.92999,86929504,78608101.6,49.532140816069955,54.33377601412855,NaN,NaN,12.402805447361496,60.96486781392751,-0.01539017118763858,0.34554985716394526,0.36094002835158384,1625471732,1662983034.4,75.43030765847969,71.80846430480159,NaN,NaN,7.293048137570655,8.544636459246892
2007-06-21T09:30:00-04:00,82.82001,83.59,82.32001,83.49001,97110128,80481350.4,52.38948211343396,53.478366314732106,NaN,NaN,-21.344684251897615,51.306420992857724,-0.02640346887852041,0.32793569225343333,0.35433916113195374,1722581860,1682848589.6,76.63091727176293,71.7474396920385,NaN,NaN,6.881003893611708,8.30697466415615
2007-06-22T09:30:00-04:00,83.36,83.48,82.3,82.92,94013248,80703747.2,49.32818161104239,52.37535992527147,NaN,NaN,-46.96609075598175,20.056668558754886,-0.07152942608721008,0.2649273785229411,0.3364568046101512,1628568612,1667169546.4,73.57503844951384,71.20382860617764,NaN,NaN,5.580944907399485,7.9175418417623415
2007-06-25T09:30:00-04:00,82.67999,83.45,82,82.49001,108703680,83934718.4,47.09267586797907,51.317181216529725,NaN,NaN,-73.44758260551903,-11.363030219055583,-0.12657218084691535,0.17824157855150702,0.30481375939842237,1519864932,1641777674.4,68.79070220762779,70.20044801406354,NaN,NaN,3.8259225398058443,7.333024798625699
2007-06-26T09:30:00-04:00,82.84,82.92999,81.74001,81.74001,91434256,85536224.8,43.39830067666317,50.50942794118577,NaN,NaN,-110.67435551369736,-48.00598153594686,-0.20507896702818706,0.04846505061318851,0.2535440176413756,1428430676,1584983562.4,59.47493830305936,68.52329747357001,NaN,NaN,1.1855930550924738,6.454820263835238
2007-06-27T09:30:00-04:00,81.63,83.64999,81.49899,83.55,127655120,88699708.8,52.98416687156113,51.097648060575516,NaN,NaN,-38.00316307853035,-58.08717524112524,-0.1303371004270967,0.0906226421075047,0.2209597425346014,1556085796,1571106375.2,57.428498341990064,67.23979088515132,NaN,NaN,1.9553473551162277,5.812038419732522
2007-06-28T09:30:00-04:00,83.41,84.19,83.3,83.42,87872752,89641408.8,52.2990766415713,51.21864943783953,NaN,NaN,30.79196844030321,-47.65984470268507,-0.08696860434736059,0.11224898710040065,0.19921759144776124,1468213044,1520232612,50.56017577538061,65.90700722396998,NaN,NaN,2.3423863517646626,5.316373838594256
2007-06-29T09:30:00-04:00,83.78,84.19,82.66,82.96001,110203248,91601418.4,49.843249828461516,51.15628207558176,NaN,NaN,3.913975371865873,-37.483831477115544,-0.0863987491767022,0.09121915497688349,0.1776179041535857,1358009796,1466120848.8,44.46823565235233,64.4974700909451,NaN,NaN,1.908552606030301,4.829542233942262
2007-07-02T09:30:00-04:00,83.38,84.09,83.25,83.99001,56339856,91797420.8,54.94501096799585,51.971785124326,NaN,NaN,65.05296555959468,-9.7837218440928,-0.017399524592355137,0.15586849841314177,0.1732680230054969,1414349652,1445017792.8,42.32635029355499,63.33511663725431,NaN,NaN,3.1433300916139073,4.588654785038211
2007-07-03T09:30:00-04:00,84.12,84.50999,84.03,84.36,34591568,89286686.4,56.650739334373064,52.47303978677552,NaN,NaN,123.16876918302,36.98490309525067,0.048792210414587645,0.23425828602373144,0.1854660756091438,1448941220,1449119901.6,42.902072754973545,62.13715898824805,NaN,NaN,4.675437608644234,4.601052331267643
2007-07-05T09:30:00-04:00,84.45,84.67,83.86,84.47,47328496,86894695.2,57.1699019767817,52.742263795292786,NaN,NaN,113.52452902830423,67.29044151661758,0.09305122348567774,0.30178010496624097,0.20872888148056323,1496269716,1437156685.6,41.59790735485626,60.48950419403934,NaN,NaN,6.066423080639934,4.810391009749399
2007-07-06T09:30:00-04:00,84.56,84.92999,84.06,84.8,40975040,83248137.6,58.76537592442303,52.80552992133691,NaN,NaN,124.2754287879316,85.98713358614327,0.13507090423429755,0.37756751177343517,0.24249660753913763,1537244756,1450963028,43.724051012824894,58.69975637168266,NaN,NaN,7.68936296388201,5.221672717482629
2007-07-09T09:30:00-04:00,84.95,85.74001,84.42,85.74001,56558768,81756969.6,62.99414796097143,53.23887381080471,NaN,NaN,165.87162099520182,118.37866271081046,0.21210583295982177,0.5076288987389148,0.29552306577909304,1593803524,1498121773.6,50.37026662986039,57.26476226565601,NaN,NaN,10.398055703469208,5.961156001194997
2007-07-10T09:30:00-04:00,84.27,84.881,83.21001,83.21001,100761120,83286781.6,48.55967998815906,52.56800932710622,NaN,NaN,22.66474669606717,109.90101893810495,0.08511797877937433,0.40192053925331095,0.3168025604739366,1493042404,1513860324,52.39108397420841,55.69075326288894,NaN,NaN,8.113347313877954,6.268611903006848
2007-07-11T09:30:00-04:00,83.17,83.87,82.89999,83.83,82883376,81647306.4,51.492964286235356,52.70806814640374,NaN,NaN,-7.685540504358776,83.73015700062919,0.03774051176296356,0.36397820017764104,0.3262376884146775,1575925780,1539257236,55.53725453425649,54.26982089687299,NaN,NaN,7.259038941350572,6.410101479913094
2007-07-12T09:30:00-04:00,84.16,85.10001,84.03,84.82001,71638320,79193832,55.824769322274385,52.95344580417806,NaN,NaN,100.20092853950402,81.06543690286917,0.0662726919254294,0.40907855332146426,0.34280586139603486,1647564100,1569516112.8,59.01262161320419,53.01137120697594,NaN,NaN,8.000468329528651,6.637296744143888
2007-07-13T09:30:00-04:00,84.89999,85.2,84.63,84.94,43139104,77378190.4,56.33374875219912,53.453843457117834,NaN,NaN,114.11708978216494,79.03376910171583,0.0852141715489288,0.44932357583219584,0.36410940428326705,1690703204,1600207802.4,62.23684658689631,52.20150035964611,NaN,NaN,8.740918548416271,6.9378141447542285
2007-07-16T09:30:00-04:00,84.89,85.16,84.2166,84.48,77265440,77055975.2,53.775721805581256,53.93120388123227,NaN,NaN,80.18769725437595,61.89698435355067,0.05994361504455292,0.4390389230889582,0.3790953080444053,1613437764,1604134650.4,62.64176684196556,51.762290690670234,NaN,NaN,8.568007168957301,7.170698862497525
2007-07-17T09:30:00-04:00,84.62,85.06,84.46001,84.57001,57650928,76931544.8,54.21383701065974,54.70374219080346,NaN,NaN,81.69594012851985,73.70322304004121,0.043250264806585115,0.43315813905263667,0.38990787424605156,1671088692,1639743908,66.18289161843033,52.241430213196736,NaN,NaN,8.55544516913139,7.36851976344522
2007-07-18T09:30:00-04:00,84.07001,84.33,83.09,84.24001,97196688,78512532,52.25823364737647,54.651889817647415,NaN,NaN,5.920799066097916,76.42449095413255,0.005905401210063832,0.39728962575863136,0.3913842245485675,1573892004,1639337152.8,66.10581025070661,52.86123820667649,NaN,NaN,7.9906190969718,7.45739109680616
2007-07-19T09:30:00-04:00,84.75,84.95,84.47,84.58,61458736,77238993.6,54.09546199434441,54.7802030571312,NaN,NaN,73.15433733645376,71.01517271352249,0.0003179855631793571,0.39178170650254174,0.3914637209393624,1635350740,1636894480.8,65.61161211067625,53.93634080205475,NaN,NaN,8.022321457434286,7.538095434038749
2007-07-20T09:30:00-04:00,84.38,84.7686,82.59,83.2,154039808,80085477.6,46.306121510313226,54.52755103440633,NaN,NaN,-36.72692152282031,40.84637045252544,-0.09483804373506294,0.2729161662705337,0.36775421000559666,1481310932,1595016026.4,57.65370493519707,54.87816003654366,NaN,NaN,5.693744418402815,7.27461671751933
2007-07-23T09:30:00-04:00,83.63,83.85001,82.94,82.98,67726432,78771136.8,45.18899887522729,53.83069302778001,NaN,NaN,-65.11829615948152,11.78517176975395,-0.1669010634299497,0.15912788071815953,0.32602894414810923,1413584500,1555045373.6,51.262886272230304,55.51648403502047,NaN,NaN,3.4571786800905766,6.72926842645808
2007-07-24T09:30:00-04:00,82.10001,82.2,80.49001,81,158764064,81274156,36.625149127656805,52.40029372730028,NaN,NaN,-233.72296555236483,-51.29860936642298,-0.33265085655541726,-0.08978462654616237,0.2428662300092549,1254820436,1471791722.4,41.05488256316862,55.384541878462976,NaN,NaN,-1.532700968810776,5.548987084276814
2007-07-25T09:30:00-04:00,81.46001,81.77,79.83,80.7,164330816,84918984,35.526572446603254,50.85434161800181,NaN,NaN,-246.36376847657243,-101.75552287495705,-0.44046097240445714,-0.30770998549631656,0.13275098690814058,1090489620,1375111245.6,32.869318046493845,54.761071213579946,NaN,NaN,-5.87970824998683,3.916316322239151
2007-07-26T09:30:00-04:00,79.21001,80.8642,77.55,78.46001,245678320,90820144,28.622977631837983,48.70131316853145,NaN,NaN,-292.1700721673759,-174.820404775723,-0.6291057665715513,-0.6536312213062985,-0.024525454734747237,844811300,1217003357.6,24.32705710830814,53.37557164897161,NaN,NaN,-12.435960236285549,1.5802768138784797
2007-07-27T09:30:00-04:00,78.35001,79.2,76.42999,76.63,202031504,96528081.6,24.443866218415053,45.94772161549171,NaN,NaN,-264.75145329947605,-220.42531113105414,-0.830929274140484,-1.0631870474103522,-0.2322577732698682,642779796,1049297130.4,18.758322975412085,51.11757567365387,NaN,NaN,-19.660583377249676,-1.454131784854114
2007-07-30T09:30:00-04:00,77.31,78.42,76.55,77.96001,149169568,98476397.6,32.1926258887993,44.778646322680295,NaN,NaN,-188.24523874401604,-245.05069964796104,-0.8268740722787101,-1.2658503636182559,-0.43897629133954574,791949364,924970103.2,15.859862566167706,48.50820271593668,NaN,NaN,-22.7120230146722,-4.49097338911384
2007-07-31T09:30:00-04:00,78.92999,79.14999,76.74001,77.10001,187776320,105048220.8,30.046825648130877,43.2467792771014,NaN,NaN,-149.2483661878476,-228.1557797750576,-0.8318673729288412,-1.4788105075005973,-0.6469431345717561,604173044,794840624.8,13.50732052972036,45.50606457275553,NaN,NaN,-25.887638280876175,-7.547639802222745
2007-08-01T09:30:00-04:00,76.87,77.96001,76.11,77.52,185941120,112615698.4,32.41602602997196,41.574726184794095,NaN,NaN,-134.54944452423567,-205.79291498459025,-0.7586883770613444,-1.5953036058984367,-0.8366152288370923,790114164,734765533.6,12.579617764626505,42.18942144071427,NaN,NaN,-27.56956175684328,-10.407914367168537
2007-08-02T09:30:00-04:00,77.94,78.5,77.3,78.13,105762816,115537414.4,35.81615704824031,40.1091839202256,NaN,NaN,-98.74861986247336,-167.10862452360976,-0.6264934654913853,-1.619732060701324,-0.9932385952099386,895876980,744978669.6,13.665230029336414,38.72002025803142,NaN,NaN,-27.821064522133764,-12.895507246449284
2007-08-03T09:30:00-04:00,78.00999,78.21001,74.96001,75.38,158334368,121405380.8,28.78527447805547,38.32415196825947,NaN,NaN,-123.09362617595738,-138.77705909890602,-0.6772378420865204,-1.8397858978180892,-1.1625480557315688,737542612,763931232.8,15.755944980417041,35.37103298220652,NaN,NaN,-30.580552984565774,-15.421942351894497
2007-08-06T09:30:00-04:00,75.62,76.42999,73.92,76.03,208312880,128993086.4,32.174416315974995,36.74990763292486,NaN,NaN,-122.73580838548838,-125.67517302720046,-0.621461297295054,-1.9393746773503864,-1.3179133800553324,945855492,794712458.4,19.17916686204572,32.0136240710362,NaN,NaN,-31.569078311490145,-17.728676060408162
2007-08-07T09:30:00-04:00,75.88,77.67,75.5,77.2,179158256,132912943.2,37.90300586921638,35.72453422019914,NaN,NaN,-83.91424709793739,-112.60834920921843,-0.4672417800855766,-1.901965605162303,-1.4347238250767265,1125013748,898880599.2,29.604174480279255,29.40636437314853,NaN,NaN,-30.412455258835315,-19.540644517326328
2007-08-08T09:30:00-04:00,77.89,80.10001,77.82001,79.55,259603504,141748949.6,47.49523547579092,35.25308946887389,NaN,NaN,-29.71350237108832,-91.64116077858895,-0.18303477501462195,-1.663517293845004,-1.480482518830382,1384617252,1017781216.8,39.238387211701415,27.522562594650328,NaN,NaN,-25.885977524243746,-20.447120661171674
2007-08-09T09:30:00-04:00,77.64999,79.41,77.60001,77.69,204532256,148393646.4,41.96924750229515,34.94331275401545,NaN,NaN,-44.49041838985623,-80.78952048406552,-0.10050792305982226,-1.60611742265516,-1.5056094995953377,1180084996,1074622820,43.23779316578899,26.492854611121174,NaN,NaN,-24.140175664579928,-20.97469994737285
2007-08-10T09:30:00-04:00,76.91,79.77,76.42999,78.06,267042320,159588807.2,43.38048306866312,34.81413305354658,NaN,NaN,-42.966505328467534,-64.76409631456755,-0.006174009632297528,-1.5133270116357096,-1.507153002003412,1447127316,1216539760.8,51.772916493119794,26.529285341184707,NaN,NaN,-22.321703375959494,-21.167129008599513
2007-08-13T09:30:00-04:00,79.39,79.96001,77.53,77.67,116490688,161550069.6,42.21513134694726,35.21341749778161,NaN,NaN,-31.121170505100142,-46.441168738489914,0.04212784887967502,-1.4544931909038183,-1.4966210397834934,1330636628,1293495988,55.665900596413216,27.572929486416466,NaN,NaN,-21.266693343712518,-21.18135248504423
2007-08-14T09:30:00-04:00,77.97,78.17999,75.94,76.31,113158256,164325436,38.346580856047794,35.41484666988479,NaN,NaN,-70.26753888426444,-43.711827095755325,-0.002953507870880223,-1.5003129246220936,-1.4973594167512134,1217478372,1311988912.8,56.57308817876558,29.266055924435875,NaN,NaN,-21.62886421170893,-21.245282731710613
2007-08-15T09:30:00-04:00,75.97,77.39999,74.74001,75.2,145767568,166753980,35.48812230202486,35.90521414632671,NaN,NaN,-98.13066375675432,-57.39525937288853,-0.08824126800390886,-1.6076610017560995,-1.5194197337521906,1071710804,1249407623.2,52.64703050897556,31.28891116734069,NaN,NaN,-22.855258570595296,-21.47527928012271
2007-08-16T09:30:00-04:00,74.67,76.92999,73.24001,76.75,347695616,181065824,41.99084447222061,37.15856973588426,NaN,NaN,-103.8948165915308,-69.27613901322344,-0.02430259207795582,-1.5497979738496355,-1.5254953817716796,1419406420,1297271908,55.20741207709216,33.89241753174641,NaN,NaN,-21.759076188911806,-21.51582169566401
2007-08-17T09:30:00-04:00,79.21001,80.06,76.589,78.41,215541248,184140896,48.03240596438004,38.28998259842574,NaN,NaN,14.468626953785796,-57.78911255677277,0.13689188547080233,-1.3543805249331768,-1.4912724104039792,1634947668,1334835978.4,57.16491690714075,36.84277855610163,NaN,NaN,-18.790311247316573,-21.126463060185802
2007-08-20T09:30:00-04:00,78.67,79.07001,77.47,78.47,126893312,187099240,48.242230396153246,39.58965436614162,NaN,NaN,31.043248700065014,-45.356228715739746,0.24817406803876985,-1.1810548253555169,-1.4292288933942867,1761840980,1421076848.8,61.341896909032066,40.259534011766746,NaN,NaN,-16.416965618041765,-20.45367771130808
2007-08-21T09:30:00-04:00,78.47,79.09,78,78.69,92711808,183796627.2,49.054472728627275,40.778114844616994,NaN,NaN,60.649107766510475,-19.172899385584763,0.33198378248863913,-1.0142491652834877,-1.3462329477721269,1854552788,1548491732,66.5341551921835,44.11342954230654,NaN,NaN,-14.264976372264337,-19.569577520016118
2007-08-22T09:30:00-04:00,79.38,79.78999,78.92999,79.63,69815632,179070868,52.485514124097946,41.968783207178255,NaN,NaN,128.50329659864371,26.15389268549484,0.4393729021867818,-0.7970168200386496,-1.2363897222254314,1924368420,1719023255.2,71.96204766026511,48.27748794451573,NaN,NaN,-11.40260298398024,-18.402866872010993
2007-08-23T09:30:00-04:00,79.95,80.12,78.31,78.61,105471056,172060504.8,48.65624828924555,43.388138479406116,NaN,NaN,97.65721752311025,66.46429950842305,0.4298275803761662,-0.6991052467552237,-1.1289328271313899,1818897364,1798921444,74.08300094044898,52.44370622737516,NaN,NaN,-10.078146369654748,-17.2136210859601
2007-08-24T09:30:00-04:00,78.58,79.7,78.36,79.63,64734752,165195667.2,52.39649041265726,44.83257234345485,NaN,NaN,100.78987555596676,83.72854922885924,0.4766987677538481,-0.5330593674390798,-1.009758135192928,1883632116,1848658333.6,75.33387094806794,56.45475651923389,NaN,NaN,-7.819313644432091,-15.871577165741812
2007-08-27T09:30:00-04:00,79.36,79.47,78.49001,78.61,60380336,160756205.6,48.584966014600965,45.595569496696605,NaN,NaN,69.27722828558358,91.37534514596295,0.4251991379220408,-0.47825921279037686,-0.9034583507124176,1823251780,1860940493.6,75.64645759349457,59.743491027320694,NaN,NaN,-7.029399807957962,-14.60840897177269
2007-08-28T09:30:00-04:00,78.08,78.19,76.39999,76.55,86271872,155680983.2,41.94813322055342,45.19934790703678,NaN,NaN,-41.635866326463734,70.91835032736812,0.24740279610299876,-0.5942048555836692,-0.841607651686668,1736979908,1837425917.6,73.7202490745533,62.20648116038154,NaN,NaN,-8.446819134380808,-13.728181852145278
2007-08-29T09:30:00-04:00,76.98,78.56,76.77,78.56,70718128,149919833.6,49.23494210664658,45.71832609306188,NaN,NaN,12.257277024132687,47.669146412465906,0.25894051073808766,-0.5179320132640584,-0.776872524002146,1807698036,1814091840.8,71.76735013793217,64.24430665839178,NaN,NaN,-7.258470261834346,-12.803937339243717
2007-08-30T09:30:00-04:00,77.62,78.95,77.5,78.03,63330464,147798216,47.54041449907699,46.01546405237716,NaN,NaN,23.83853448630597,32.90540980510505,0.2258572739829463,-0.4945509315234631,-0.7204082055064094,1744367572,1799185882.4,70.4828609167323,65.58073126007838,NaN,NaN,-6.851819844263233,-11.953634839960792
2007-08-31T09:30:00-04:00,79.14,79.33,78.31,78.74001,47031296,142233062.4,50.02198979948527,46.573096798987024,NaN,NaN,59.595315177921286,24.666497729495955,0.24516053418295214,-0.41395753777771915,-0.6591180719606713,1791398868,1780739232.8,68.84079086322662,66.52179485056504,NaN,NaN,-5.747759839338672,-11.067081268443346
2007-09-04T09:30:00-04:00,78.67999,80.32001,78.58,79.75,61361056,134885471.2,53.39902000071698,47.64827102360625,NaN,NaN,110.69285187225267,32.94962244682978,0.3148719793262854,-0.2655280978028145,-0.5804000771290999,1852759924,1786640861.6,69.08891073113308,67.41578217573417,NaN,NaN,-3.7734531416037123,-10.02513439318054
2007-09-05T09:30:00-04:00,79.28,79.7979,78.46001,79.00999,67144944,129284805.6,50.69608499071054,48.73455407279808,NaN,NaN,71.02984067671825,55.482763847466174,0.3001253404622968,-0.205243401551229,-0.5053687420135258,1785614980,1796367876,69.51972135097337,68.620974378734,NaN,NaN,-2.9483400392813395,-9.01416377119494
2007-09-06T09:30:00-04:00,79.07001,79.37,78.2,79.03,65067088,119557984.8,50.76865183361229,49.36154031289749,NaN,NaN,54.58043200473344,63.94739484358632,0.2810337084391071,-0.15407660646464194,-0.435110314903749,1850682068,1804964682.4,69.91875558886645,69.67178462957501,NaN,NaN,-2.2642449342215984,-8.049889651627321
2007-09-07T09:30:00-04:00,77.77,77.92999,76.99001,77.66,107969440,114729844,45.798535278778324,49.2019781210688,NaN,NaN,-51.585677989564324,48.86255234841226,0.17087181022631898,-0.2215205521208503,-0.3923923623471693,1742712628,1804633693.6,69.8808232103851,70.58006365123533,NaN,NaN,-3.1268446561350625,-7.346597509414142
2007-09-10T09:30:00-04:00,77.91,77.96001,75.62,76.77,99763312,106365893.6,42.86287141503909,48.81773819384636,NaN,NaN,-95.9256973672356,17.758349839380884,0.039646729441508266,-0.342833950545284,-0.38248067998679225,1642949316,1774943783.2,66.40089267419364,70.94142049160402,NaN,NaN,-4.735574332195156,-6.973594198382858
2007-09-11T09:30:00-04:00,77.17999,78.06,77.03999,77.99001,84890560,104785887.2,47.80216972606584,48.72828797937768,NaN,NaN,-27.059799415853067,-9.792180418240264,0.03666423537193342,-0.33665038577187545,-0.37331462114380887,1727839876,1749959773.6,63.533714107367516,70.72710327126002,NaN,NaN,-4.657923264151917,-6.642784064921295
2007-09-12T09:30:00-04:00,77.67,78.16,77.38,77.56,62793296,102267639.2,46.28346766192204,48.28528466065084,NaN,NaN,-31.801724630578047,-30.358493479699526,0.008834070589901377,-0.3622720329064322,-0.37110610349633355,1665046580,1725846093.6,60.80471063545374,69.93015062663065,NaN,NaN,-5.037295992100722,-6.413428625946927
2007-09-13T09:30:00-04:00,78.02,78.53,77.17,77.7,72387376,98598629.6,46.87524196464941,48.15806992317969,NaN,NaN,-36.64526178753997,-48.603632238154205,0.0032453423286164518,-0.36704942558556297,-0.3702947679141794,1737433956,1703196471.2,58.27280271948606,68.80085075370472,NaN,NaN,-5.184307925750967,-6.2378399544903615
2007-09-14T09:30:00-04:00,76.89999,78.28,76.78,78.09,61830800,84305388.8,48.57483552686224,47.885094574194326,NaN,NaN,-62.11180039845448,-50.708856719932236,0.027837105123482586,-0.3354983865098262,-0.3633354916333088,1799264756,1714506896.8,59.186736373058764,67.64748399834693,NaN,NaN,-4.846380810767563,-6.039060076815676
2007-09-17T09:30:00-04:00,77.88,78.1192,77.19,77.25999,53422416,76199447.2,45.25641328715378,47.64734080794809,NaN,NaN,-73.26233172624923,-46.176183591734954,-0.007865360250240372,-0.37316719194610926,-0.3653018316958689,1745842340,1735085501.6,60.866194571455424,66.59175092534413,NaN,NaN,-5.467773162178616,-5.957447660438953
2007-09-18T09:30:00-04:00,77.81,80.60001,77.24001,80.52,138674320,76788497.6,57.52893367764746,48.760255126311954,NaN,NaN,99.04339403670842,-20.955544901222662,0.1815459505982252,-0.1383693934480874,-0.3199153440463126,1884516660,1766420858.4,63.33999038100953,65.85030387580528,NaN,NaN,-2.092577080358881,-5.405323291856085
2007-09-19T09:30:00-04:00,81.27,82.10001,77.25999,81.61,114738256,77889820,60.70121630051012,49.579274711587914,NaN,NaN,151.30758655945766,15.666317336784479,0.3632262126968082,0.13411742182469766,-0.22910879087211056,1999254916,1833262525.6,67.98851282324469,65.58038692475618,NaN,NaN,1.7600231629636462,-4.3817023697389805
2007-09-20T09:30:00-04:00,81.5,81.53999,80.25,80.78999,128454128,80821744.8,57.23754223116191,50.271926692451125,NaN,NaN,173.83586644330913,57.7625429829543,0.40781658158244305,0.28066193610594325,-0.1271546454764998,1870800788,1859935892,69.64275812070085,65.52037958218251,NaN,NaN,3.834410936247741,-3.207971897455163
2007-09-21T09:30:00-04:00,81.28,81.56,80.86,80.96001,57473840,78421884,57.77552630171652,50.82575072832479,NaN,NaN,166.28905867089384,103.44271479682398,0.4263960656828587,0.4058404366270736,-0.02055562905578512,1928274628,1885737866.4,71.19351636383989,65.68843140365489,NaN,NaN,5.654140029213355,-1.9419559079310893
2007-09-24T09:30:00-04:00,81.10001,81.37,80.09,80.34,87057680,79538030.4,55.05539417148611,50.94406316909401,NaN,NaN,119.00951646189642,141.8970844344531,0.3763087520261877,0.4498303109769495,0.0735215589507618,1841216948,1904812788,72.31929608731915,65.91917321481102,NaN,NaN,6.377037749823454,-0.7535282425375831
2007-09-25T09:30:00-04:00,79.64,80.07001,79.28,79.92,54940848,79266056,53.227229829540036,51.124859229010404,NaN,NaN,61.614798081729326,134.41136524345728,0.2977145667544141,0.44566476739377947,0.14795020063936534,1786276100,1885164676,69.3144004557027,65.9045074365774,NaN,NaN,6.453755818623744,0.2760837661997493
2007-09-26T09:30:00-04:00,80.5,80.92,79.82001,80.55,65424368,78223680.8,55.608408664537244,51.47055614550504,NaN,NaN,91.77879887906424,122.50560770737859,0.27170285897630536,0.48757877435974706,0.2158759153834417,1851700468,1855653786.4,64.9492849898366,65.54954525093243,NaN,NaN,7.193583883567775,1.2642980686808958
2007-09-27T09:30:00-04:00,80.92999,81.08,80.5343,81,63248704,77850209.6,57.28132174158039,52.290755178562335,NaN,NaN,104.42660216697918,108.6237548521126,0.26790596084076185,0.550758366434394,0.2828524055936322,1914949172,1864483463.2,65.64637998016151,65.24708502020216,NaN,NaN,8.285425906133836,2.2673163311741726
2007-09-28T09:30:00-04:00,80.97,81.25,79.92999,80.06,90417184,79204545.6,52.80474878938677,53.000889276730035,NaN,NaN,70.84443906153862,89.53483093024155,0.18891475010802694,0.5189958432286659,0.33008109312063894,1824531988,1843734935.2,62.500751095945354,64.96850347889873,NaN,NaN,7.9696342731511045,3.08193318002802
2007-10-01T09:30:00-04:00,80.13,82.24001,80.13,82.03,98829504,81794456,59.88103530314295,53.8636653893784,NaN,NaN,114.03741011111951,88.54040966008617,0.2522128775690711,0.6453471900819778,0.3931343125129067,1923361492,1860163844,63.97283609796941,64.99986933537029,NaN,NaN,9.862142569616157,4.050534521397754
2007-10-02T09:30:00-04:00,82.3,82.87,82.1778,82.56,53654544,81409130.4,61.551291861983444,54.95422426081135,NaN,NaN,146.5738951152105,105.5322290667824,0.30890473310786837,0.7792652288977422,0.4703604957898738,1977016036,1898311831.2,67.19331366384293,65.45619812311237,NaN,NaN,11.92971172112259,5.176131264215588
2007-10-03T09:30:00-04:00,82.32001,82.75999,81.96001,82.32001,56463952,80875080.8,60.3265517826083,55.915032104951266,NaN,NaN,120.57740009671433,111.29194931031243,0.30864100530964333,0.856161752426928,0.5475207471172847,1920552084,1912082154.4,68.29504213303633,66.1720723669374,NaN,NaN,13.266923364315364,6.331958707086985
2007-10-04T09:30:00-04:00,82.56,82.72,81.99001,82.50999,35783232,79410888,60.98831239793827,56.80170902431384,NaN,NaN,110.36951285492351,112.48053144790131,0.29942867196466894,0.9218065870731209,0.622377915108452,1956335316,1920359383.2,68.9696089355288,66.8708489785424,NaN,NaN,14.556920746519426,7.506953284148762
2007-10-05T09:30:00-04:00,83.47,84.42,82.98,84.13,92100880,78617460,66.17027144283233,58.29555603543374,NaN,NaN,154.45613313666493,129.20287026292655,0.3756691670404787,1.0919643739090503,0.7162952068685716,2048436196,1965140224.8,72.39196544552775,67.69411832669043,NaN,NaN,17.301354043454108,8.906153392620954
2007-10-08T09:30:00-04:00,83.91,84.17999,83.25,83.5,34535328,75356060.8,62.68322213456076,58.66371949664183,NaN,NaN,138.85787470314926,134.1669631813325,0.3570265789525998,1.1625784305593214,0.8055518516067216,2013900868,1983248100,73.65716890711933,68.43105964998398,NaN,NaN,18.58600644764069,10.288989543338058
2007-10-09T09:30:00-04:00,83.92999,84.33,83.3,84.17999,57968992,74009982.4,64.83712544387343,58.95914157831061,NaN,NaN,136.18037990254265,132.08826013879894,0.36267715343350404,1.2588982933986017,0.8962211399650977,2071869860,2002218864.8,74.95224622574483,68.92846917873399,NaN,NaN,20.30972515970418,11.720523202818931
2007-10-10T09:30:00-04:00,84.03999,84.23,83.44,84.11,50131280,73376881.6,64.42493850144109,59.4725270261877,NaN,NaN,121.48568579965608,132.2699172793873,0.3345694130196494,1.3144329062396594,0.97986349322001,2021738580,2022456164,76.2912864871731,69.40336406205344,NaN,NaN,21.601941719747572,13.132154419523022
2007-10-11T09:30:00-04:00,84.59,84.89,82.66,83.16,93749504,74444988,58.947146246806234,59.556214165122675,NaN,NaN,95.17177630954994,129.23036997031258,0.2298533353304255,1.2671801623830419,1.0373268270526164,1927989076,2016786916,75.08038468562772,69.68099751360971,NaN,NaN,21.16995666808469,14.28041188360326
2007-10-12T09:30:00-04:00,83.28,84.08,83.21001,83.82001,60997232,74403309.6,61.40254381625583,60.00958199689194,NaN,NaN,90.74929585604346,116.48900251418829,0.1848332204920271,1.2683683526676504,1.0835351321756233,1988986308,2004896938.4,72.48199438784171,69.6926188207899,NaN,NaN,21.49680683912787,15.311325448678204
2007-10-15T09:30:00-04:00,83.8,83.87,82.03,83.05,80766128,75770495.2,57.11086014656766,60.28698416239392,NaN,NaN,51.86852900280606,99.09113337411965,0.08790759956764549,1.1934196316351802,1.1055120320675347,1908220180,1983760800.8,67.97821676140842,69.5971771283403,NaN,NaN,20.530068138175537,16.056860118606394
2007-10-16T09:30:00-04:00,82.37,84.17999,81.88,81.94,59333904,71803474.4,51.52058222994762,59.99499655992322,NaN,NaN,31.080604733809455,78.07117834037302,-0.05836811250651208,1.0325518914343945,1.0909200039409066,1848886276,1939164084,59.56775263411308,69.21278196007435,NaN,NaN,17.98226750307186,16.331918316387174
2007-10-17T09:30:00-04:00,82.8,82.92,81.06,82.24001,90241504,70578636.8,52.86356026657502,59.679442168851416,NaN,NaN,-4.77543712523193,52.818953755395434,-0.137790914212506,0.918681361175274,1.05647227538778,1939127780,1922641924,56.765647593035794,68.5784439324225,NaN,NaN,16.26236501543912,16.321982130537453
2007-10-18T09:30:00-04:00,81.67999,82.39,81.39,82.12,68562128,67584036.8,52.24013812952306,59.639112836004,NaN,NaN,-14.664314652520133,30.85173556298141,-0.19763877414142472,0.8094238077109992,1.007062581852424,1870565652,1911157239.2,54.83472095447707,68.03087035088905,NaN,NaN,14.670393104903102,16.086040841161118
2007-10-19T09:30:00-04:00,81.91,82.12,79,79.09,128576000,71139144.8,39.55628544945803,58.18734498931222,NaN,NaN,-118.14229496228033,-10.926582600683343,-0.42733842087101304,0.47288955576365765,0.9002279766346707,1741989652,1861757908,47.370643552993855,66.84499945481937,NaN,NaN,8.743457496479966,15.037100363349525
2007-10-22T09:30:00-04:00,78.53999,80.94,78.35001,80.75999,138148064,73693664,47.16979801929952,57.16009542912052,NaN,NaN,-116.34383833711905,-44.56905606866837,-0.45054026947988435,0.33705263978481526,0.7875929092646996,1880137716,1856141415.2,46.59407462757201,65.37362523794287,NaN,NaN,6.230581866324359,13.77902629234593
2007-10-23T09:30:00-04:00,81.41,81.53999,80.19,81.3,84840944,75188668.8,49.38975705331706,56.37889580559972,NaN,NaN,-69.07107773438973,-64.59939256230821,-0.4141828308621346,0.2698643706870314,0.684047201549166,1964978660,1879359892,50.22669804516632,64.08302923166644,NaN,NaN,4.970156921382708,12.520616382208328
2007-10-24T09:30:00-04:00,80.87,81.17,79.11,80.855,126758752,78255388,47.614170670841354,55.42359996794994,NaN,NaN,-105.50618984046065,-84.74554310535395,-0.4043177324609727,0.17865003597295015,0.5829677684339228,1838219908,1859178317.6,47.220175063636496,62.529498240817006,NaN,NaN,3.392385148092144,11.216583348763159
2007-10-25T09:30:00-04:00,81.08,81.5,79.59,80.66,116679440,80926924.8,46.81985296207596,54.04142721932448,NaN,NaN,-91.47375185797749,-100.10743054644541,-0.39469872657336263,0.08959436021721956,0.4842930867905822,1721540468,1829373280.8,43.115466808675976,60.43831976675616,NaN,NaN,1.886495419850615,9.883713644632795
2007-10-26T09:30:00-04:00,81.37,82.00999,80.47,82.00999,79289872,80370559.2,52.702548654721994,53.32852197076458,NaN,NaN,-44.440581845537686,-85.36708792309689,-0.2862409602300739,0.12649188650298981,0.4127328467330637,1800830340,1841141418.4,45.14309698603913,58.40160034382186,NaN,NaN,2.397577786205541,8.814265664857473
2007-10-29T09:30:00-04:00,82.22,82.44,81.39,82.03999,56213376,78239752.8,52.827428338111666,52.47068646321016,NaN,NaN,-18.54612149206036,-65.80754455408514,-0.20510478600156107,0.15635186423111236,0.3614566502326734,1857043716,1836522618.4,44.47306169248642,56.2245157343034,NaN,NaN,2.8417580733435246,7.961050294641194
2007-10-30T09:30:00-04:00,81.50999,81.96001,80.96001,81.27,59966624,78555356.8,49.23431849331246,51.38564217691526,NaN,NaN,-48.43822021012822,-61.680973049232854,-0.1959325663093679,0.11654094234596357,0.31247350865533147,1797077092,1802942304.8,39.84288675102153,53.621058610292586,NaN,NaN,2.1646977551570483,7.132999931857745
2007-10-31T09:30:00-04:00,81.63,82.8,80.77,82.32001,107681568,81116237.6,53.84459163061502,51.02117399004446,NaN,NaN,-13.030333948461896,-43.18580187083309,-0.11575206395984988,0.1677834287055191,0.283535492665369,1904758660,1816250055.2,42.402128931641585,51.286897485007856,NaN,NaN,2.9688520226758235,6.53812165911747
2007-11-01T09:30:00-04:00,81.37,81.39999,79,79.14,171154560,87884804,41.54053645675254,49.602459178651365,NaN,NaN,-123.70766945456823,-49.63258539015125,-0.2649543120589246,-0.047657397408286784,0.21729691465063783,1733604100,1818662781.6,42.87661822876309,49.17222775935939,NaN,NaN,-0.5815801922292307,5.52102139463937
2007-11-02T09:30:00-04:00,80.10001,80.13,78.35001,79.53,130181248,89788822.4,43.25318587563493,48.612625302156175,NaN,NaN,-134.92284455078587,-67.72903793120088,-0.32167421338883084,-0.18479585208540072,0.13687836130343012,1863785348,1831253783.2,45.40426060408525,47.55980231955059,NaN,NaN,-2.7795883331681357,4.335220004952584
2007-11-05T09:30:00-05:00,78.44,79.23,78.05,78.48,98508064,92987459.2,39.86681470021328,47.78021333574657,NaN,NaN,-153.01949330272495,-94.6237122933338,-0.4086188957888105,-0.373895258432583,0.034723637356227494,1765277284,1812900496.8,42.45528154497854,46.33748295604098,NaN,NaN,-5.729744898653258,2.8973678758660353
2007-11-06T09:30:00-05:00,78.99001,80,78.03,79.96001,94964560,94837237.6,46.25417250775543,47.30811421011661,NaN,NaN,-103.79843721953836,-105.69575569521582,-0.34755944873759687,-0.3997256735657686,-0.05216622482817174,1860241844,1825533447.2,45.09851083453813,45.50411604471973,NaN,NaN,-6.089380000560588,1.613546750662232
2007-11-07T09:30:00-05:00,78.89999,79.12,77.17,77.48,112474256,97954386.4,38.81420273134329,46.34911882453234,NaN,NaN,-155.81359243796996,-134.25240739311744,-0.4488617845567078,-0.6132434555240565,-0.16438167096734868,1747767588,1794135232.8,40.160891992207176,44.45598540455759,NaN,NaN,-9.095289596423129,0.08371298679289496
2007-11-08T09:30:00-05:00,78.13,78.16,75.82001,77.71001,120879936,99310908,39.781649503572,46.36521625696905,NaN,NaN,-166.97887642538922,-142.90664878728163,-0.47264871246914825,-0.755192561553784,-0.28254384908463576,1868647524,1821143917.6,45.67111667659304,44.33459062767181,NaN,NaN,-11.067487283951714,-1.5093156233134775
2007-11-09T09:30:00-05:00,76.74001,77.75,76.13,76.85001,104491808,101485636.8,37.40048135328166,45.66740792368206,NaN,NaN,-162.8124443216309,-148.48456874145063,-0.5150881640766529,-0.9264040541804519,-0.411315890103799,1764155716,1801217991.2,42.55753387927741,44.046266288507915,NaN,NaN,-13.454569497060872,-3.215780462420248
2007-11-12T09:30:00-05:00,76.89,78.11,76.03,76.11,106798320,102787246.4,35.435023119960405,44.67064121415659,NaN,NaN,-150.30622038592102,-147.94191415808987,-0.5581624383966256,-1.109018938099581,-0.5508564997029554,1657357396,1779634013.6,39.422377258079386,43.27452908943028,NaN,NaN,-16.031861575226763,-5.046649192821178
2007-11-13T09:30:00-05:00,77.17999,78.74001,77.13,78.465,105193312,105080216.8,45.28876443252641,44.504540768562656,NaN,NaN,-79.25028860152143,-143.03228443448648,-0.40058810986342097,-1.0515916370322316,-0.6510035271688106,1762550708,1760095786.4,36.78091917406722,42.52886795446104,NaN,NaN,-14.984984332218898,-6.466411355592281
2007-11-14T09:30:00-05:00,79.17,79.23,77.60001,78.16,76346368,104385460,44.344832268671894,44.32775357617665,NaN,NaN,-61.43629006046204,-124.15682395898489,-0.2943533953741625,-1.0189452713865137,-0.7245918760123512,1686204340,1747783136.8,35.181133547841966,41.96212986440147,NaN,NaN,-14.46604265497082,-7.609215826932072
2007-11-15T09:30:00-05:00,77.62,77.89,76.24001,76.87,114145056,106664606.4,40.499979856226375,43.45614151914125,NaN,NaN,-110.06886918734445,-112.77482251137592,-0.2880558635628657,-1.0846617054659333,-0.7966058419030676,1572059284,1688465488.8,28.70380691621895,40.78789485941432,NaN,NaN,-15.263377925318272,-8.702667555272958
2007-11-16T09:30:00-05:00,77.32001,77.36,75.53999,76.17,123470560,106409334.4,38.54690373814579,42.43610404771511,NaN,NaN,-120.80533191881726,-104.3734000308132,-0.30641818953969713,-1.179628578827689,-0.8732103892879919,1448588724,1625352090.4,23.70327074479762,39.304338363150826,NaN,NaN,-16.527291512190292,-9.82047097768972
2007-11-19T09:30:00-05:00,75.89,76.03999,74.32001,74.64,116188064,105311334.4,34.61740669065796,41.392038918954086,NaN,NaN,-150.99092323089184,-104.5103405998074,-0.39154452509996995,-1.3626410456629543,-0.9710965205629843,1332400660,1560360743.2,19.865380000742874,37.87737359527379,NaN,NaN,-18.88393386417826,-11.115251390045225
2007-11-20T09:30:00-05:00,74.7,75.56,73.35001,75.00999,129813680,107559971.2,36.30828991671912,40.13944593939009,NaN,NaN,-145.66718306631387,-117.7937194927659,-0.3919094530077101,-1.460983336822622,-1.0690738838149119,1462214340,1500293469.6,17.10825143213104,36.07066805959446,NaN,NaN,-20.259358783338026,-12.42155244622991
2007-11-21T09:30:00-05:00,74.56,74.7,73,73.5,94960880,105970077.6,32.602573936029685,39.50102004505275,NaN,NaN,-156.26096349588903,-136.75865417985128,-0.45821113328164276,-1.6418378004169654,-1.1836266671353226,1367253460,1436503293.6,14.764649503781314,34.062670293524334,NaN,NaN,-22.62635628612984,-13.879381566215613
2007-11-23T09:30:00-05:00,74.36,76,74.11,75.06,50849312,102678571.2,39.475373300633215,39.23117628969548,NaN,NaN,-100.31725429366092,-134.80833120111458,-0.3654011032903375,-1.6403780462482445,-1.274976942957907,1418102772,1405711991.2,13.783159361964877,31.804020204801446,NaN,NaN,-22.449768344175883,-15.103722534495652
2007-11-26T09:30:00-05:00,75.35001,75.62,72.99001,73.02,96761744,103552164.8,34.51825343597261,38.84913619939258,NaN,NaN,-125.61896460877892,-135.7710577391069,-0.4066389576604359,-1.7832756400334517,-1.3766366823730158,1321341028,1380262452,13.01317380648537,29.701012509194793,NaN,NaN,-23.95538497644952,-16.368245740489062
2007-11-27T09:30:00-05:00,73.55,74.39999,73.16,73.95,80871376,104785064.8,38.32083983856386,38.28246958016461,NaN,NaN,-117.19352008966783,-129.0115771108621,-0.3392683985632192,-1.80072218057704,-1.4614537820138207,1402212404,1394224800.8,15.792551404208623,27.607729692742687,NaN,NaN,-23.92945785475226,-17.44841889966952
2007-11-28T09:30:00-05:00,74.91,76.89,74.86,76.75,112699184,107421692.8,48.09402175648484,38.94531379624615,NaN,NaN,-31.419744333392522,-106.16208936427786,-0.08724357338545508,-1.5705082487456394,-1.4832646753601844,1514911588,1404764250.4,17.924380418860423,26.019407437503634,NaN,NaN,-20.451085197324602,-17.87737122790596
2007-11-29T09:30:00-05:00,76.58,76.96001,75.91,76.21001,57398560,104907542.4,46.56173839107492,39.42960585963921,NaN,NaN,-15.49911993618106,-78.00972065233626,0.054355897413843834,-1.4153198035928796,-1.4696757010067234,1457513028,1422816164,21.58609863207326,24.299049005752217,NaN,NaN,-18.236340392149454,-17.928652537083604
2007-11-30T09:30:00-05:00,77.42999,77.95,76.14999,76.58,84981376,100598883.2,47.789170656913235,40.17165509561289,NaN,NaN,15.203074618667824,-54.905654869870524,0.1772689267775278,-1.2480895425348137,-1.4253584693123416,1542494404,1447694490.4,26.455794193856192,23.14892474250785,NaN,NaN,-16.092478738172815,-17.666341994382062
2007-12-03T09:30:00-05:00,76.55,76.75,75.7,75.75,61642000,97171920.8,45.27674510481619,40.874635237388304,NaN,NaN,-17.519139969322726,-33.28568994197927,0.20504176241599792,-1.169056266292344,-1.374098028708342,1480852404,1479596765.6,32.26488050939972,22.637674974745018,NaN,NaN,-15.085569650769418,-17.297660231008827
2007-12-04T09:30:00-05:00,75.02,75.56,74.56,75,57670864,95130060.8,43.073119122111336,40.71637485807294,NaN,NaN,-62.702304098732824,-22.38744674379226,0.17636475131592677,-1.1536420895634336,-1.3300068408793604,1423181540,1483790592.8,33.01394178879984,22.368605161511635,NaN,NaN,-14.910427276736607,-16.956626951827083
2007-12-05T09:30:00-05:00,76.19,76.62,75.52,76.44,70192320,93891448.8,48.27814279554707,40.99732560999259,NaN,NaN,7.03011457800927,-14.697474961511906,0.2531680790212907,-1.013546742102747,-1.2667148211240378,1493373860,1479483047.2,32.61498608432362,22.185308914117464,NaN,NaN,-13.154013961680649,-16.413396524663305
2007-12-06T09:30:00-05:00,76.21001,78.44,76.17,78.25,93207632,92928117.6,53.97458621650169,41.959797492869406,NaN,NaN,92.71989923517287,6.946328872758885,0.4150937965961796,-0.7478475753788132,-1.1629413719749928,1586581492,1505296740,37.49006116992381,22.81289850366781,NaN,NaN,-9.788054289940447,-15.46691906256004
2007-12-07T09:30:00-05:00,78.71001,78.8,77.88,78.36,59125344,89840388,54.303973560214835,43.08530248016006,NaN,NaN,127.57162605785324,29.420039160595962,0.512448054144407,-0.522381304294484,-1.034829358438891,1645706836,1525939226.4,41.1562504102369,24.059539908342042,NaN,NaN,-7.015564113031718,-14.25958264119885
2007-12-10T09:30:00-05:00,78.5,79.25,78.2,79.11,49940880,87112841.6,56.58535908275841,44.65444193673866,NaN,NaN,140.8275308212704,61.08937331871458,0.6039020325243483,-0.2799518177834557,-0.883853850307804,1695647716,1568898288.8,47.99237955318873,26.068611304945318,NaN,NaN,-4.009674387137756,-12.795310033475838
2007-12-11T09:30:00-05:00,79.28,79.58,76.25,76.33,120369184,87791384.8,47.18232883494079,45.43115900232592,NaN,NaN,59.432012697895175,85.51623667804019,0.4602108933964836,-0.3085902335621995,-0.7688011269586831,1575278532,1599317687.2,52.22483706216328,28.576938849947624,NaN,NaN,-4.230978267093186,-11.571834066849744
2007-12-12T09:30:00-05:00,78.71001,78.81,76.09,76.91,112514816,88157460,49.08336902208722,46.60835865133003,NaN,NaN,57.439722984934704,95.59815835942527,0.3900463137943274,-0.28124323471577384,-0.6712895485101013,1687793348,1638201584.8,57.03783459790052,31.596452070956136,NaN,NaN,-3.8185199887572083,-10.464217769979381
2007-12-13T09:30:00-05:00,76.27,76.89,75.64,76.49001,89834432,88831863.2,47.74332114391154,47.19892635442134,NaN,NaN,13.729729160531955,79.80012434449708,0.3049388803725137,-0.29011594804445906,-0.5950548284169728,1597958916,1640477069.6,57.30887863440249,34.705432018987395,NaN,NaN,-3.8844783262400964,-9.52425499230234
2007-12-14T09:30:00-05:00,75.75999,76.87,74.95,75,75866944,86917957.6,43.23366977812243,47.821456093146324,NaN,NaN,-24.73694071232977,49.33841099046049,0.14594583393172456,-0.412622536002317,-0.5585683699340416,1522091972,1615754096.8,53.36924202920098,37.588008320609944,NaN,NaN,-5.329595614380142,-8.925017938313456
2007-12-17T09:30:00-05:00,74.82001,75.2142,73.75,73.85001,71638256,84326342.4,40.08651428926278,47.94757569676767,NaN,NaN,-89.85824439040195,3.201255948126021,-0.029655963155262755,-0.59563832387812,-0.5659823607228572,1450453716,1566715296.8,46.53572111312141,39.78394901410371,NaN,NaN,-7.531555121068406,-8.725951821564163
2007-12-18T09:30:00-05:00,74.67,75.41,73.35001,75.17,114502816,84242080,45.03260957933628,47.728903398399915,NaN,NaN,-67.63546111014722,-22.212238813482454,-0.048766521795618134,-0.62694051296738,-0.5781739911717618,1564956532,1564650896.8,46.26714653112978,41.808432307837236,NaN,NaN,-7.892709004714568,-8.606917133442792
2007-12-19T09:30:00-05:00,75.09,75.73,74.72,75.63,85850000,82043896,46.684433658722995,47.73766734608906,NaN,NaN,-32.317381206404185,-40.16365965175024,-0.02356100079302137,-0.6076252421630386,-0.5840642413700172,1650806532,1557253533.6,45.259164549737505,43.4993655876704,NaN,NaN,-7.695270797158087,-8.476681942544976
2007-12-20T09:30:00-05:00,76.21001,77.00999,74.82001,76.84,121971184,83394411.2,50.86701188974475,47.95751314843418,NaN,NaN,9.362985292882785,-41.037008425280064,0.07601661347349753,-0.48904347452814534,-0.5650600880016429,1772777716,1592217293.6,50.72359542629831,45.23277996141626,NaN,NaN,-6.262775678633167,-8.160409619129004
2007-12-21T09:30:00-05:00,77.88,78.60001,77.64,78.60001,83426880,85023289.6,56.24403342968882,48.740890885925076,NaN,NaN,121.22401353671697,-11.844817575470723,0.2519162879245631,-0.2501647280959389,-0.502081016020502,1856204596,1659039818.4,59.122253412879274,47.151163740236235,NaN,NaN,-3.3069038496711105,-7.46705165206359
2007-12-24T09:30:00-05:00,78.71001,79.33,78.59,79.17,29867024,81678553.6,57.85273248594976,49.79657755477068,NaN,NaN,143.9663126058176,34.920093823773186,0.38991373502623594,-0.014688847237707137,-0.4046025822639431,1886071620,1746163399.2,67.01583199753017,49.57987018371697,NaN,NaN,-0.3956025728906254,-6.456844640753167
2007-12-26T09:30:00-05:00,78.84,79.84,78.71001,79.53999,65572368,80913603.2,58.90880497687116,50.5559105677224,NaN,NaN,142.50934247605008,76.94905454101266,0.48326852106934737,0.19948306907274116,-0.2837854519966062,1951643988,1823500890.4,72.15580365009129,52.40421429555751,NaN,NaN,2.301840339986101,-5.205603929218986
2007-12-27T09:30:00-05:00,78.86,79.08,76.91,77.39,71490064,78853147.2,50.92378321528842,50.33799606763574,NaN,NaN,51.014361647258966,93.61540311174528,0.38182763670523545,0.19349909388493813,-0.18832854282029732,1880153924,1869370368.8,74.67637749965155,55.060379747680926,NaN,NaN,2.286570783774354,-4.135293255934223
2007-12-28T09:30:00-05:00,77.92,78.00999,76.56,76.56,48207328,78393585.6,48.207134144345105,49.90250753793076,NaN,NaN,8.867423292997499,93.51629071176822,0.24697871437344637,0.12039485014651063,-0.12658386422693574,1831946596,1881204144.8,75.2976571234592,57.499051655768234,NaN,NaN,1.4387777225271274,-3.338997401868316
2007-12-31T09:30:00-05:00,76.45,76.8046,75.58,75.92,73935440,77841288.8,46.16217016323451,49.15799404367905,NaN,NaN,-39.25231612658507,61.42102477910781,0.10982172607732985,0.010693293369726575,-0.09912843270760327,1758011156,1861565456.8,72.13479757819276,59.223510086125664,NaN,NaN,0.12161580650188868,-2.844624086386858
2008-01-02T09:30:00-05:00,76.14999,76.5,74.59,75.16,94265680,79472472.8,43.786776336446145,48.91545457950087,NaN,NaN,-71.98963059199481,18.229836139545327,-0.02950034286940177,-0.1360038612943555,-0.10650351842495372,1663745476,1817100228,65.43304600433083,60.166953581994775,NaN,NaN,-1.6927737221541859,-2.6800740343536193
2008-01-03T09:30:00-05:00,75.27,75.62,74.03,74.33,78036752,80490767.2,41.28802684993457,48.358644424347105,NaN,NaN,-108.52708280952287,-31.977448917569262,-0.16727594856891195,-0.31559845413609366,-0.1483225055671817,1585708724,1743913175.2,56.1811170648804,60.10575947249333,NaN,NaN,-3.9729826132729364,-2.8647752599135217
2008-01-04T09:30:00-05:00,73.24001,73.33,71.61,72.09,123498496,83156076,35.414308468580174,47.47800066182344,NaN,NaN,-188.95217673141838,-79.97075659330474,-0.3864614864105175,-0.6313993635803286,-0.24493787716981108,1462210228,1660324436,47.85796910774605,59.430694506303595,NaN,NaN,-7.938952703348841,-3.5896577518328527
2008-01-07T09:30:00-05:00,72.28,72.85001,71.07001,72.25,139678816,85479635.2,36.11343403459197,46.969412394428396,NaN,NaN,-172.11090719487487,-116.1664226908792,-0.4911399074027085,-0.8588627614231967,-0.3677228540204882,1601889044,1614312925.6,43.99432347216713,58.76105746651546,NaN,NaN,-10.906997156096466,-4.63499195244194
2008-01-08T09:30:00-05:00,72.32001,73.27,70.02,70.02,157222688,90384502.4,31.065968809032825,46.32508771726911,NaN,NaN,-178.24794764807265,-143.96554899517673,-0.6699648794517291,-1.2051789533351496,-0.5352140738834205,1444666356,1551643965.6,39.336246891301954,58.24680930781407,NaN,NaN,-15.240655884733876,-6.150086799912216
2008-01-09T09:30:00-05:00,69.92999,71,68.62,70.73,140246368,94899776.8,34.21841062402656,45.552644934746986,NaN,NaN,-182.75038303849527,-166.11769948447682,-0.6967382556125383,-1.4061368933990934,-0.7093986377865551,1584912724,1535877415.2,38.23929216322757,57.67339113867819,NaN,NaN,-17.823738852027425,-7.817751378785817
2008-01-10T09:30:00-05:00,70.11,72.32001,69.86,71.7,153879120,96575273.6,38.365428013801875,44.958430245824054,NaN,NaN,-123.12515067679186,-169.03731305793062,-0.608624532567496,-1.4701793034959252,-0.8615547709284291,1738791844,1566494039.2,41.642568787134444,57.41506286992084,NaN,NaN,-18.722867340725447,-9.375625087634337
2008-01-11T09:30:00-05:00,71.28,71.5,69.91,70.22,120319936,96965529.6,34.764291828666714,43.808235955747044,NaN,NaN,-126.32302512918315,-156.51148273748356,-0.6080869663677329,-1.6216634788880953,-1.0135765125203624,1618471908,1597746375.2,44.975678067853366,57.00449734431762,NaN,NaN,-20.629066929694563,-10.983259636500083
2008-01-14T09:30:00-05:00,71.00999,71.19,70.25999,70.8,71081312,96027873.6,37.250077350568084,42.45152480723842,NaN,NaN,-105.52916630290963,-143.19513455909052,-0.529618278090854,-1.6755993601339298,-1.1459810820430758,1689553220,1615279210.4,46.81107069707918,56.1251271503319,NaN,NaN,-21.4371446154932,-12.476671776356243
2008-01-15T09:30:00-05:00,69.88,70.16,69.07001,69.53999,95296064,96999329.6,34.20113331995344,40.76212486681012,NaN,NaN,-117.91624434127347,-131.12879389773067,-0.5226353629902203,-1.7992752857808512,-1.2766399227906309,1594257156,1645197370.4,49.883103617360405,54.90136083746263,NaN,NaN,-23.065957220441184,-13.989426839796948
2008-01-16T09:30:00-05:00,69.24001,70.71001,68.72,69.57001,135719632,100203398.4,34.33902909267002,39.00714087508147,NaN,NaN,-100.65644526915938,-114.71000634386351,-0.4773065089899702,-1.8732730590280937,-1.3959665500381235,1729976788,1674210183.2,52.734072273350016,53.514094310552544,NaN,NaN,-24.331901714927305,-15.466923250529856
2008-01-17T09:30:00-05:00,69.98,70.10001,67.67999,67.88,123290320,100642773.6,30.46789464920971,37.546005977504414,NaN,NaN,-109.84300177846744,-112.05357656419861,-0.5189997950139182,-2.0447162938055214,-1.5257164987916032,1606686468,1647789108,49.94751790948782,51.74774719696942,NaN,NaN,-26.640801474785725,-17.063191568280693
2008-01-18T09:30:00-05:00,68.12,68.81,66.28999,67.22,131884128,102944480,29.088735362981055,36.18040606454984,NaN,NaN,-117.6418247489012,-110.31733648814225,-0.5461355041332407,-2.208385878958154,-1.6622503748249133,1474802340,1619055194.4,47.03652961110031,49.72909523180093,NaN,NaN,-28.977197276695055,-18.765192383768458
2008-01-22T09:30:00-05:00,64.47,68.13,64.19,66.74001,150963872,104394114.4,28.092780523357533,34.8897353759872,NaN,NaN,-125.33444479945189,-114.27839218745069,-0.5499917364146039,-2.349740045343168,-1.7997483089285642,1323838468,1545912244,40.55685503289836,47.47352790713705,NaN,NaN,-31.20977741587633,-20.542990245498153
2008-01-23T09:30:00-05:00,65.3,69.98,65.09,69.02,183099440,109377742.4,38.80996997692056,34.534249207449655,NaN,NaN,-87.86606039624078,-108.26835539844414,-0.36166567534137894,-2.251830403105288,-1.8901647277639089,1506937908,1528448394.4,39.16940580911561,45.597553607478815,NaN,NaN,-29.920602017264887,-21.88264907003626
2008-01-24T09:30:00-05:00,69.48,70.23,68.28,68.97,113683248,113568553.6,38.67384197307098,34.34752171624511,NaN,NaN,-60.54733018689945,-100.24653238199217,-0.2106260485857272,-2.153447288496068,-1.9428212399103406,1393254660,1461103968.8,34.296883463220624,44.03439406450311,NaN,NaN,-28.932515203562325,-22.889772803397126
2008-01-25T09:30:00-05:00,69.96001,70.22,68.08,68.47,95435936,115061732,37.26616328576126,34.47979706032948,NaN,NaN,-62.17529597000966,-90.71299122030061,-0.11911247266567981,-2.0917118307424403,-1.9725993580767605,1297818724,1399330420,30.54359002347489,42.797652701340894,NaN,NaN,-28.506983216806603,-23.692231433884192
2008-01-28T09:30:00-05:00,68.32001,69.97,67.71001,69.92,81258944,115550176,43.66958161995626,35.0195218878555,NaN,NaN,-50.47681906295733,-77.27999008311183,0.0550099607967216,-1.9038369070808585,-1.9588468678775801,1379077668,1380185485.6,29.467288269621704,41.760007329730506,NaN,NaN,-26.203842989331267,-24.051033084662347
2008-01-29T09:30:00-05:00,70.39,70.39,69.12,70.10001,75340624,116906840.8,44.42794920729557,35.97394905915998,NaN,NaN,-23.8389877508652,-56.98089867339449,0.19060906638155561,-1.7205855349006356,-1.9111946012821912,1454418292,1406301450.4,32.93882679031512,41.30304875108858,NaN,NaN,-24.104574710134607,-24.05868188830124
2008-01-30T09:30:00-05:00,69.72,71.39999,69.10001,69.22,126086560,119514396.8,41.48739865857282,36.493162490199,NaN,NaN,-14.101866751995885,-42.22805994454552,0.22687173057341914,-1.6276049380654172,-1.8544766686388363,1328331732,1370580215.2,30.712200089712965,40.76539931726611,NaN,NaN,-23.12120398198294,-23.92475647311291
2008-01-31T09:30:00-05:00,68.11,71.56,68,70.94,117643568,120683291.2,48.64229742805641,37.22722459121718,NaN,NaN,9.137924209685817,-28.29100906522847,0.3643807665258447,-1.3990007104815305,-1.7633814770073752,1445975300,1381124343.2,32.169776789393055,40.08877131742744,NaN,NaN,-20.039774535321765,-23.36975905342846
2008-02-01T09:30:00-05:00,71.33,72.88,71,72.63,100613008,121812104,54.526113662825985,38.63878329365713,NaN,NaN,129.96612348799013,10.137274826371506,0.5553955885539981,-1.0691369913148776,-1.6245325798688757,1546588308,1430878260,38.720525877043364,39.64197473236959,NaN,NaN,-15.4258550232737,-22.23491562054921
2008-02-04T09:30:00-05:00,72.53999,72.60001,71.67999,71.78999,54586912,118366524.8,51.37552148398969,39.64774358890153,NaN,NaN,124.11806476813898,45.056251592590776,0.6072083015807315,-0.8655222028929614,-1.472730504473693,1492001396,1453463005.6,41.48314677787013,39.26140873814037,NaN,NaN,-12.566584961990618,-20.85372552646941
2008-02-05T09:30:00-05:00,70.69,71.57001,69.8,69.95,125997120,117682440,45.212897424208585,40.4342981677769,NaN,NaN,41.02737655863166,58.02952445449015,0.5038553834357498,-0.8429112751790058,-1.3467666586147555,1366004276,1435780202.4,39.96401324049382,38.552902282649896,NaN,NaN,-12.042713680454922,-19.595009548467342
2008-02-06T09:30:00-05:00,70.42,70.88,68.84,68.96001,97259056,114684258.4,42.27464293416224,41.00112772788349,NaN,NaN,-8.19297515017951,59.211302774853415,0.3617622103886,-0.8945638956290054,-1.2563261060176054,1268745220,1423862900,38.92931769359592,37.56684838409603,NaN,NaN,-12.553770610212766,-18.58911827157383
2008-02-07T09:30:00-05:00,68.64,70.52,68.47,70.11,125992256,113971552.8,46.614711611291625,42.15447179660362,NaN,NaN,2.1582199380831275,57.81536192053288,0.3385801499832912,-0.8331009185384914,-1.1716810685217827,1394737476,1413615335.2,38.0178148372795,36.714726736081154,NaN,NaN,-11.597402086495364,-17.59030167370548
2008-02-08T09:30:00-05:00,69.95,70.64,69,69.67,86493312,110602262.4,45.21400791139488,43.306276978633186,NaN,NaN,12.563135248530248,34.334764272640896,0.2889033732608177,-0.8105518519457604,-1.0994552252065781,1308244164,1365946506.4,34.02665606288858,35.78545005406603,NaN,NaN,-11.253069263177855,-16.68498275791582
2008-02-11T09:30:00-05:00,69.66,70.2,68.73,69.58,80655680,108619049.6,44.91670056727617,44.5079855531988,NaN,NaN,-2.5873230015832323,8.993686718696457,0.24690207347083115,-0.7908276333680391,-1.0377297068388702,1227588484,1313063924,30.23456750571023,35.04814380212402,NaN,NaN,-11.062083921918028,-15.88171149563042
2008-02-12T09:30:00-05:00,70.10001,71.05,69.72,70.41,76564496,108893208.8,48.29344725234746,45.185376787157864,NaN,NaN,64.58371045246426,13.704953497462977,0.2700629024059449,-0.7001510788314391,-0.970213981237384,1304152980,1300693664.8,29.40893029883088,34.35096697996083,NaN,NaN,-9.921521055225272,-15.030255718429684
2008-02-13T09:30:00-05:00,71.02,71.95,70.7,71.85001,86241376,108440474.4,53.60719865314272,46.2520451214487,NaN,NaN,127.80118308623666,40.90378514474621,0.3711658474242242,-0.5062566719571038,-0.877422519381328,1390394356,1325023492,33.268688207008864,34.277524461659986,NaN,NaN,-7.305226508683847,-13.92668011703742
2008-02-14T09:30:00-05:00,72.10001,72.17999,70.02,70.17999,78328128,105570899.2,47.50936315175338,46.98370225473385,NaN,NaN,72.29805930600685,54.93175301833095,0.31650060632290544,-0.4817967614776961,-0.7982973678006016,1312066228,1308489242.4,31.988611937729985,34.380740312678206,NaN,NaN,-6.8911556806048155,-12.921605197547049
2008-02-15T09:30:00-05:00,69.8,70.13,69.14999,69.87,64549120,102633839.2,46.453086067477045,47.18252400098534,NaN,NaN,-0.9829849702312082,52.22252897457865,0.25314109458024725,-0.48187099957529256,-0.7350120941555398,1247517108,1296343831.2,31.04371113016451,34.49334194557412,NaN,NaN,-6.873577740127599,-12.057601275058556
2008-02-19T09:30:00-05:00,70.88,71.00999,69.62,70.73,50724544,98575860,49.78841038746956,47.56541408528348,NaN,NaN,42.76519098860963,61.29303177261725,0.26174266146810243,-0.40783376732041177,-0.6695764287885142,1298241652,1310474464.8,33.50473399290627,34.53376388861635,NaN,NaN,-5.865612649697043,-11.173031471435483
2008-02-20T09:30:00-05:00,69.53999,70.91,69.17,70.77,71204064,94587869.6,49.944581586055136,48.16949858010365,NaN,NaN,18.188953527885104,52.01408038770141,0.26207008117305364,-0.34198882732219715,-0.6040589084952508,1369445716,1323533012,35.785561126526844,34.89614681981734,NaN,NaN,-5.005012416551347,-10.29188589216632
2008-02-21T09:30:00-05:00,71.25999,71.75,69.24001,69.39,85702064,89718000.8,44.77093332298508,47.892972572598545,NaN,NaN,-5.696251898242454,25.31459339080559,0.16597586849125323,-0.3965890728811843,-0.5625649413724375,1283743652,1302202871.2,33.74922710550051,35.008964699539305,NaN,NaN,-5.758814662293103,-9.644304287898718
2008-02-22T09:30:00-05:00,69.5,69.52,68.03999,69.37,84228000,88245238.4,44.698666546977094,47.19101206432363,NaN,NaN,-119.72909263835712,-13.090836998067209,0.10089759225808848,-0.4364429510498269,-0.5373405433079154,1199515652,1279692756,31.69920637118338,34.50744187769216,NaN,NaN,-6.391576688865025,-9.179628916608191
2008-02-25T09:30:00-05:00,69.38,71,69.03,70.77,76367376,87291810.4,50.697837334436116,47.14260605364124,NaN,NaN,2.7803384574593863,-12.338172312529093,0.14906213148811598,-0.35101287894777045,-0.5000750104358864,1275883028,1285365940,32.80698350303409,33.88771592948958,NaN,NaN,-5.213740674927509,-8.613073453510951
2008-02-26T09:30:00-05:00,70.37,72.2,70.31,71.42999,92917376,87874732,53.271386786755855,47.718212436680325,NaN,NaN,102.07653532297232,-0.47590344565655374,0.21811475668647,-0.2274315645777989,-0.4455463212642689,1368800404,1299477690.4,35.60479762716241,33.5763433856802,NaN,NaN,-3.4661585171363427,-7.877799891171722
2008-02-27T09:30:00-05:00,70.84,72.24001,70.71001,71.39999,85187184,88367060,53.13561147358613,48.49399590378203,NaN,NaN,101.34932305292591,16.156170459351607,0.25210909927521513,-0.13040994717025,-0.38251904644546514,1283613220,1282311191.2,33.763082945020145,33.20732661792478,NaN,NaN,-2.0752261283621545,-7.048860782198926
2008-02-28T09:30:00-05:00,70.77,71.14,69.98,70.32001,68720688,85498766.4,48.3573646779961,48.618471122832354,NaN,NaN,2.6128734448059228,17.81799552796128,0.19476567161562924,-0.1390619569259286,-0.33382762854155784,1214892532,1268540967.2,32.318925024577496,32.80026305987464,NaN,NaN,-2.1926249760305554,-6.355112809889159
2008-02-29T09:30:00-05:00,69.60001,69.7,68.10001,68.86,98594368,84546306.4,42.759295778223766,48.44313454189155,NaN,NaN,-140.92446466313675,13.578921123005358,0.05848299916120969,-0.2607238795900457,-0.3192068787512554,1116298164,1251897469.6,30.61446231851299,32.55653493527638,NaN,NaN,-3.9899997632235444,-6.017239517508357
2008-03-03T09:30:00-05:00,68.39,68.72,67.21001,68.2,84862192,83758765.6,40.47807035167806,48.12608952649169,NaN,NaN,-193.5676824441231,-25.69068305731114,-0.06921162509103507,-0.40572141011504925,-0.3365097850240142,1031435972,1203008058.4,26.23719653681745,32.271008437498324,NaN,NaN,-6.189556667532678,-6.0418562532261175
2008-03-04T09:30:00-05:00,67.57001,68.42999,66.78,67.8,90523440,85555592,39.11602031650305,47.47055903107423,NaN,NaN,-194.51411593550225,-85.00881330900606,-0.16807912401337077,-0.5466086900407277,-0.3785295660273569,940912532,1117430484,20.666868149519942,31.64657542683326,NaN,NaN,-8.418448229715583,-6.381369392724612
2008-03-05T09:30:00-05:00,68.21001,68.7,67.42999,68.45,92841744,83897823.2,42.50185053719591,46.67731987993517,NaN,NaN,-129.94284103882967,-131.26724612735717,-0.1763039082577592,-0.5989094513495559,-0.42260554309179665,1033754276,1067458695.2,18.232633801699222,30.572571540739713,NaN,NaN,-9.358352648720833,-6.806652715009787
2008-03-06T09:30:00-05:00,67.91,68.17709,65.92999,66.17,104781248,84273932.8,35.123404243019664,45.79260852931133,NaN,NaN,-197.40454366305164,-171.2707295489287,-0.31386836091852044,-0.8149409942399473,-0.5010726333214268,928973028,1010274794.4,15.921592129754288,29.42492726874145,NaN,NaN,-12.630338250971363,-7.638607791575726
2008-03-07T09:30:00-05:00,65.36,66.84,65.2,65.96001,119085248,83928582.4,34.528855165123076,44.94087775057176,NaN,NaN,-192.85054552172684,-181.65594572064668,-0.39247048433117104,-0.9916607387353906,-0.5991902544042196,809887780,948992717.6,13.889720548650956,28.19964222720477,NaN,NaN,-15.43298903335915,-8.752090826116214
2008-03-10T09:30:00-04:00,66.02,66.06,64.10001,64.5,82746560,83741244.8,30.644764998093464,43.57347450847346,NaN,NaN,-197.27909373238506,-182.39822797829908,-0.5088745453710437,-1.2352834361180243,-0.7264088907469806,727141220,888133767.2,12.221647105902207,26.679421735275906,NaN,NaN,-19.151968038434163,-10.237787570733063
2008-03-11T09:30:00-04:00,66.47,67.3,64.22369,67.3,117630128,85589967.2,43.71996564936034,43.12885908442384,NaN,NaN,-115.66414549479782,-166.6282338901582,-0.36984632127861283,-1.1887167923452466,-0.8188704710666338,844771348,868905530.4,11.741849733379382,24.962013778622516,NaN,NaN,-18.042781093539652,-11.35278664541972
2008-03-12T09:30:00-04:00,67.2,68.03999,66.5,66.52,92578816,86390683.2,41.37963599645731,42.88662356110042,NaN,NaN,-76.506620595405,-155.94098980147328,-0.30563046053994003,-1.2009085467415588,-0.8952780862016188,752192532,812593181.6,10.448195325831861,23.29765436578904,NaN,NaN,-17.94896419454197,-12.295097723865755
2008-03-13T09:30:00-04:00,65.88,67.98,65.2,67.88,123542496,88255739.2,46.73364605659818,43.03197924035908,NaN,NaN,-68.2530293003618,-130.1106869289353,-0.15440544711461457,-1.088284895094887,-0.9338794479802723,875735028,801945581.6,10.218939515351451,21.763349590372474,NaN,NaN,-16.043948695320058,-12.830647862644941
2008-03-14T09:30:00-04:00,68.83,68.83,65.35001,66.14,176997056,93189185.6,41.50994993369608,42.37570156887765,NaN,NaN,-70.29644617998945,-105.5998670605878,-0.15405508411171398,-1.1264483031199148,-0.9723932190082009,698737972,779715620,9.738495693031055,20.11560046108654,NaN,NaN,-16.230892186840617,-13.316397051815752
2008-03-17T09:30:00-04:00,64.23,65.94,64.23,65.06,127006064,96312032.8,38.62414909522578,41.32947030519693,NaN,NaN,-122.30305069081597,-90.60465845227398,-0.20581761485495598,-1.2296652375768957,-1.0238476227219397,571731908,748633757.6,9.094658328223858,18.22201908259093,NaN,NaN,-17.36286968958826,-13.894464571497538
2008-03-18T09:30:00-04:00,66.61,68.17999,65.31,68.05,161001120,101825861.6,49.161651682456345,41.04561603440194,NaN,NaN,-37.9242745833377,-75.05668426998196,-0.02732302869391523,-1.058001408589334,-1.0306783798954187,732733028,726226093.6,8.650634285774473,16.42827274978767,NaN,NaN,-14.50568345724999,-13.98178155517646
2008-03-19T09:30:00-04:00,68.59,68.92999,66.25,66.35001,132797376,104905527.2,44.48520851829416,40.76903345156609,NaN,NaN,-33.56710323309128,-66.46878079751923,-0.01310665405271827,-1.0470616974613165,-1.0339550434085982,599935652,695774717.6,8.073747881969666,14.696474382458536,NaN,NaN,-13.881845505245712,-13.967504976614924
2008-03-20T09:30:00-04:00,66.45,68.10001,66.38989,67.48,103327936,105786820.8,48.02438140867417,41.145110996598255,NaN,NaN,-23.04900249419168,-57.427975436285216,0.07803065932205433,-0.9364167192560302,-1.0144473785780845,703263588,661280429.6,7.466346935608669,13.043037569393944,NaN,NaN,-12.140586663537348,-13.70651664617527
2008-03-24T09:30:00-04:00,68.17,70.35001,67.95,69.99001,90766688,106113755.2,54.9019697054606,42.17538952186844,NaN,NaN,68.92652237170498,-29.58338172594633,0.3004947630894901,-0.638828924716222,-0.9393236878057121,794030276,680338890.4,11.431018820912882,11.985453446829329,NaN,NaN,-8.146070681167588,-12.912167222602744
2008-03-25T09:30:00-04:00,69.94,70.42999,69.28,70.22,71302064,105860489.6,55.48324014767547,43.344476652666465,NaN,NaN,94.66652592514355,13.81053359724557,0.4474195807218857,-0.38004921190335494,-0.8274687926252406,865332340,739058976.8,22.455142829249894,12.113187352524326,NaN,NaN,-4.912306439416831,-11.7693299678619
2008-03-26T09:30:00-04:00,69.92999,70.27,69.34,69.64,63057552,104367498.4,53.606760107444664,44.137684479112814,NaN,NaN,93.94110024562156,40.183608563037424,0.48658436627813517,-0.2192383347775717,-0.7058227010557069,802274788,752967328.8,24.84138693769451,12.585241147952564,NaN,NaN,-2.935193868402149,-10.507310525081936
2008-03-27T09:30:00-04:00,70.08,70.25999,68.97,69.09,63938496,103305064,51.817083830862494,45.33009016395873,NaN,NaN,91.87530310213837,65.27208983008336,0.45695967433009455,-0.13462310814308864,-0.5915827824731832,738336292,780647456.8,29.49167012062439,13.554532433014716,NaN,NaN,-1.8834800482866385,-9.275334742682608
2008-03-28T09:30:00-04:00,69.10001,69.41,67.97,68.19,48866720,102312365.6,48.937929058276914,46.35930972775543,NaN,NaN,53.93408412659032,80.66870715423975,0.3623943599929712,-0.1385898324819692,-0.5009841924749404,689469572,777888653.6,29.297106035419944,14.655059967783927,NaN,NaN,-1.8761235687317543,-8.218304574975344
2008-03-31T09:30:00-04:00,68.21001,69.22,67.81,68.28999,64269600,100596127.2,49.27514770167753,47.69005134944001,NaN,NaN,51.557305584828136,77.19486379686438,0.2950738472803853,-0.13214188337445876,-0.4272157306548441,753739172,769830432.8,28.701483959142394,15.832191171586796,NaN,NaN,-1.7738483467403703,-7.297667970941776
2008-04-01T09:30:00-04:00,69.46001,70.82001,69.14,70.78999,65933680,99649701.6,56.93328311344432,48.63385973973173,NaN,NaN,135.52304490730492,85.36616759329667,0.40084939927858765,0.07384601844339045,-0.3270033808351972,819672852,760698535.2,28.006598877984246,16.99395896763,NaN,NaN,0.7068569222372889,-6.154164414773339
2008-04-02T09:30:00-04:00,70.8,71.5192,70.37,70.96001,58947856,98070922.4,57.40427449089235,49.77847677504851,NaN,NaN,143.26699720535765,95.23134698524389,0.45996578478158456,0.2479538501417835,-0.21201193463980106,878620708,775967719.2,31.014117594520343,18.46295341539346,NaN,NaN,2.8365358789119606,-4.8697786585325815
2008-04-03T09:30:00-04:00,70.42999,71.47,70.35001,71.14999,57232128,96290441.6,57.95756297147185,50.58018512611092,NaN,NaN,125.4473772421781,101.94576181325183,0.4869635755551574,0.3966925348041457,-0.09027104075101171,935852836,815471028,38.20632199907153,20.46205216423061,NaN,NaN,4.735833077015747,-3.4975484105971058
2008-04-04T09:30:00-04:00,71.17999,71.89,70.64,71.16,61536096,94128184,57.988527494169766,51.75722638043046,NaN,NaN,118.52394003571231,114.86373299507622,0.4798196311402697,0.5095034981743254,0.029683867034055705,997388932,877054900,47.41111382994607,23.15295345972454,NaN,NaN,6.305367795881923,-2.09713180967153
2008-04-07T09:30:00-04:00,71.66,71.86,70.78,70.96001,40309312,90189387.2,57.08394255169478,53.075783055892536,NaN,NaN,106.2413448937456,125.80054085685973,0.4371554905170085,0.5761282301803163,0.13897273966330784,957079620,917722989.6,52.4485038331762,26.249656710078277,NaN,NaN,7.396108843224981,-0.7409545735434571
2008-04-08T09:30:00-04:00,70.48,71.28,70.37,71.02,49572896,88530704,57.29912128695227,53.6570308847851,NaN,NaN,85.8610693592093,115.8681457472406,0.3900594542504745,0.6265470574764009,0.23648760322592646,1006652516,955118922.4,56.56828254454977,29.67234587141937,NaN,NaN,8.371383835094836,0.5608080562620132
2008-04-09T09:30:00-04:00,71.09,71.35001,69.45,69.81,71774624,86237928.8,51.67153587746081,54.17033998186844,NaN,NaN,52.727080836833,97.76016247353566,0.2607176244294791,0.5623846337627754,0.30166700933329627,934877892,966370359.2,57.75421879973304,33.2209509369739,NaN,NaN,7.780915213898025,1.5922519359243006
2008-04-10T09:30:00-04:00,69.69,70.89,69.42999,70.47,56066672,84412321.6,54.30763088250178,54.619143515713276,NaN,NaN,50.43154221041239,82.75699546718252,0.20535084015600996,0.5583555595283087,0.35300471937229877,990944564,977388704.8,58.93671861711332,36.89740605708137,NaN,NaN,7.959867836527821,2.501911350296232
2008-04-11T09:30:00-04:00,69.71001,69.78,68.42,68.74001,79545312,82212462.4,47.06147113280599,54.0591079033808,NaN,NaN,-10.477738407408589,56.95665977855833,0.04626098516733507,0.4108309508314676,0.3645699656641325,911399252,960190768.8,56.288335767113345,40.10150012466712,NaN,NaN,6.0268412080062586,3.005472758540521
2008-04-14T09:30:00-04:00,68.64,69.27,68.23,68.53,57846368,76254928,46.25463859448281,53.399922078152755,NaN,NaN,-31.828885667929576,29.342613666223304,-0.07260459350706117,0.27381422378030607,0.34641881728736723,853552884,939485421.6,53.18941211152874,42.29680507340132,NaN,NaN,4.198934404084018,3.175967279332449
2008-04-15T09:30:00-04:00,68.87,69.08,68.27,69.00999,45945264,72201888,48.43077160299528,53.03020861354922,NaN,NaN,-42.69337366892783,3.6317250605958833,-0.11582757642203967,0.20163434675981762,0.3174619231818573,899498148,918054548,50.11406499858169,44.10199636346469,NaN,NaN,3.2283673597878244,3.1834530051117884
2008-04-16T09:30:00-04:00,69.67999,71.28,69.67999,71.2,72389376,67771300.8,56.98799267375897,53.39955924518468,NaN,NaN,69.53245459927537,6.992799813084352,0.000020050389044456995,0.31748698616816284,0.3174669357791184,971887524,925456474.4,51.16432237501854,45.65004295306427,NaN,NaN,4.89963751344755,3.4286222205883257
2008-04-17T09:30:00-04:00,70.84,71.1431,70.14999,70.92,48822416,63572552.8,55.715043082321515,53.88363881833072,NaN,NaN,65.24693602350854,9.95587857570358,0.05186681613487659,0.3823004559477141,0.3304336398128375,923065108,911880583.2,49.12164943788195,47.06608176752585,NaN,NaN,5.892957955712617,3.7806701827489384
2008-04-18T09:30:00-04:00,72.00999,72.27,71.47,71.67,70737312,61943021.6,58.39577391461631,54.535112119254926,NaN,NaN,135.69393484235067,39.19021322565543,0.12649516770125124,0.48855259943940155,0.3620574317381503,993802420,928361216.8,51.64547297806654,48.70493812602042,NaN,NaN,7.527221820977635,4.315891845353038
2008-04-21T09:30:00-04:00,71.35001,71.83,71.23,71.67999,40023184,59405846.4,58.4318688601321,54.64215395830406,NaN,NaN,107.0600427326578,66.9679989057729,0.16397641692443649,0.5670279528936959,0.4030515359692594,1033825604,964415760.8,56.705256337674584,50.75484223028402,NaN,NaN,8.868365607395509,4.966245239930534
2008-04-22T09:30:00-04:00,71.17999,71.60451,69.50999,70.5,81351056,59908296,52.6243189216186,54.30072856049878,NaN,NaN,25.838790662101818,80.67443177197883,0.09989427402583312,0.5279193785015508,0.4280251044757177,952474548,975011040.8,58.093028507212914,52.6890501526192,NaN,NaN,8.39841128267535,5.456554674608364
2008-04-23T09:30:00-04:00,70.53,71.02,69.89999,70.55,48056896,59158263.2,52.83821840700865,53.93506109160855,NaN,NaN,19.8149690443465,70.73093466099306,0.05378086543867444,0.49525118627406073,0.4414703208353863,1000531444,980739824.8,58.860872118048555,54.16437516111756,NaN,NaN,8.071488262711489,5.830116615765953
2008-04-24T09:30:00-04:00,70.5,71.94,69.64,71.23,83228624,60122769.6,55.76344279025116,53.776126469900085,NaN,NaN,50.064058668815285,67.69435919005441,0.06142980321669089,0.5182575748562499,0.456827771639559,1083760068,1012878816.8,62.961024103839286,55.275083037824224,NaN,NaN,8.593547423982965,6.224892445511241
2008-04-25T09:30:00-04:00,71.81,72.27,70.81,71.89999,56252272,60492047.2,58.49501882981746,53.87691763262313,NaN,NaN,103.83818469909168,61.32320916140262,0.10159614242674664,0.5838229496729923,0.48222680724624567,1140012340,1042120800.8,66.25633498813988,56.2613566917502,NaN,NaN,9.810381375914885,6.737105149854618
2008-04-28T09:30:00-04:00,71.92999,72.7,71.59,72.38,35470608,59052097.6,60.38251270009415,54.097159876418985,NaN,NaN,148.1499592101582,69.54119245690269,0.14768253508307505,0.6668299761000895,0.5191474410170145,1175482948,1070452269.6,69.12265280003977,57.158097424285195,NaN,NaN,11.377119279585596,7.399964311244758
2008-04-29T09:30:00-04:00,72.21001,72.38,71.28999,71.74001,40941376,57802482.4,56.68139060862883,54.45500664293099,NaN,NaN,99.00177740955998,84.17378980639434,0.12325119584549837,0.6732114358238874,0.549960239978389,1134541572,1106865674.4,72.37107828781795,58.202158816291266,NaN,NaN,11.711030268033738,8.015830876500326
2008-04-30T09:30:00-04:00,71.97,72.66,71.10001,71.39999,62316384,57970908.8,54.760914619367924,54.487384052707135,NaN,NaN,83.75519708886856,96.96183541529874,0.07476390979491088,0.6434151272220276,0.5686512174271168,1072225188,1121204423.2,73.55106149229071,59.246040450232506,NaN,NaN,11.467463242173936,8.508921214453698
2008-05-01T09:30:00-04:00,71.46001,72.86,71.23,72.75,55323424,57875473.6,60.48547748905834,55.44624164958231,NaN,NaN,118.40937726649766,110.63089913483523,0.12142397028743557,0.7204311802864112,0.5990072099989756,1127548612,1129962132,74.27375186859553,60.53071302890981,NaN,NaN,12.914875681268198,9.138343281141484
2008-05-02T09:30:00-04:00,73.41,73.5,72.24001,72.52,58836752,57740506.4,59.11305615561047,56.364700046805716,NaN,NaN,138.88792598402614,117.64084739182212,0.12416525001128575,0.7542137725130829,0.6300485225017971,1068711860,1115702036,70.87773016095133,61.79416431815427,NaN,NaN,13.72559709386278,9.793665254387383
2008-05-05T09:30:00-04:00,72.31,72.7,71.88,72.27,39901328,57720107.2,57.58361720887604,57.01847473294006,NaN,NaN,93.3106513139746,106.6729858125854,0.09767603538744951,0.7521435667361089,0.6544675313486594,1028810532,1086367552.8,64.35869940726198,62.811638204488574,NaN,NaN,13.984477135562082,10.392352665983768
2008-05-06T09:30:00-04:00,71.86,73.07001,71.67,72.86,60503808,58266652.8,60.20071917044161,57.24795519698882,NaN,NaN,97.48202755536691,106.3690358417468,0.10763853576155369,0.7890157010506016,0.6813771652890479,1089314340,1077322106.4,62.45126030036595,63.61784805629911,NaN,NaN,14.935150498527259,11.041323784918553
2008-05-07T09:30:00-04:00,72.89999,73.22,71.34,71.56,57434016,57549622.4,52.51250036447884,57.019202145714345,NaN,NaN,59.17088249737688,101.45217292344844,0.019065299566012883,0.705208789746564,0.6861434901805511,1031880324,1069253133.6,60.722379174693344,64.44647160892849,NaN,NaN,13.51944438404285,11.395341013364881
2008-05-08T09:30:00-04:00,71.72,71.97,71.19,71.71001,60443616,57768469.6,53.25436835006071,56.65195889110323,NaN,NaN,28.217682823685227,83.41383403488597,-0.03413227491720039,0.6434781465340507,0.677610421451251,1092323940,1062208199.2,59.1818986739305,64.98478773006163,NaN,NaN,12.567627779324955,11.562810551359178
2008-05-09T09:30:00-04:00,71.19,72.12,71.03999,71.5,51713760,56376892,52.02891566175595,56.194605091219216,NaN,NaN,17.009147085725257,59.038078255225784,-0.08526620618921665,0.5710276637147302,0.6562938699039469,1040610180,1056587863.2,57.91948375595007,65.07151825993846,NaN,NaN,11.430294770158497,11.543879725473365
2008-05-12T09:30:00-04:00,71.95,73.27,71.81,73.07001,49247568,55946952,59.52705118643809,56.68765739584918,NaN,NaN,111.73886033103747,62.72372005863836,-0.018635103823555044,0.6329999901245031,0.6516350939480582,1089857748,1068797306.4,59.91963639295414,65.20199025177712,NaN,NaN,12.622509814885378,11.69796973824651
2008-05-13T09:30:00-04:00,73.3,73.64,72.72,73.49001,52328624,56266120,61.27103018427159,57.29000109422511,NaN,NaN,166.5869663318828,76.54470781394153,0.04496744925384122,0.7078444055153597,0.6628769562615184,1142186372,1079371712.8,61.62108784769691,65.39914851818057,NaN,NaN,14.136489879162536,12.04632975837737
2008-05-14T09:30:00-04:00,73.64999,74.35001,72.60001,73.39999,60659440,55679623.2,60.66762670472272,57.64029994525879,NaN,NaN,159.93117078938647,96.69676547234346,0.07068684056642538,0.7512355069695502,0.6805486664031248,1081526932,1089301034.4,63.200788111331526,65.41627451871572,NaN,NaN,15.201586811179519,12.497080765920535
2008-05-15T09:30:00-04:00,73.47,74.28999,73.10001,73.55,46599632,55568484,61.35068893299358,57.84427638119995,NaN,NaN,157.93954135158364,122.64113717792313,0.08647059124977097,0.7886369054653386,0.7021663142155676,1128126564,1096461559.2,64.34068351846321,65.27944227088167,NaN,NaN,16.277165879280762,13.037092924971995
2008-05-16T09:30:00-04:00,74.46001,74.52,73.09,73.9501,64250128,55244124.8,63.18699235259909,58.04459635637887,NaN,NaN,150.76208279246086,149.39172431927028,0.11096254015532714,0.8408694894097266,0.7299069492543995,1192376692,1126814861.6,68.75846855215464,65.25342911031845,NaN,NaN,17.708267580248435,13.704403590011486
2008-05-19T09:30:00-04:00,74.03,74.74001,73.47,73.97,102765744,58381252.8,63.28044021263993,58.51595704237967,NaN,NaN,146.47692435435968,156.3393371239347,0.11511232871017663,0.8737973601421203,0.7586850314319437,1295142436,1167871799.2,73.53459109397765,65.3365371679013,NaN,NaN,18.92602594831337,14.45034964119747
2008-05-20T09:30:00-04:00,73.44,73.73,72.8,73.7,82109936,58419196.8,61.01727510047209,58.9628399338871,NaN,NaN,83.22116798727455,139.66617745501304,0.08753140145439131,0.8680992832499328,0.7805678817955415,1213032500,1182041024.8,74.9574627267041,65.43699439893082,NaN,NaN,19.395548375490694,15.156806603239358
2008-05-21T09:30:00-04:00,73.62,74.23,72.25,72.64999,100028064,61017755.2,53.06853652851449,58.4330584367054,NaN,NaN,45.48352363427488,116.77664802399075,-0.008469803687438882,0.7699806271862428,0.7784504308736817,1113004436,1188336525.6,75.58552591265426,65.53069254493502,NaN,NaN,17.59419956908636,15.50500559836036
2008-05-22T09:30:00-04:00,72.78999,73.56,72.69,73.17,60035264,59858087.2,56.11741786917139,58.219084273388326,NaN,NaN,47.53484914334738,94.69570958234348,-0.04210865873629266,0.7258146074533158,0.7679232661896085,1173039700,1197319152.8,76.49148378556545,65.93167494669316,NaN,NaN,16.88236199167029,15.701770797404635
2008-05-23T09:30:00-04:00,72.85001,73.19,71.73,72.21001,64498496,60270398.4,49.69853161631837,57.65586387391992,NaN,NaN,-32.301172786188616,58.08305846661359,-0.12925076483830633,0.6063598101417256,0.7356105749800319,1108541204,1180552055.2,71.18179843038524,66.41903916263054,NaN,NaN,14.302555227134789,15.501882858794657
2008-05-27T09:30:00-04:00,72.38,73.42,72.35001,73.32001,62335216,61613628.8,55.969777554382176,57.3536537584871,NaN,NaN,31.397459418404704,35.06716547942259,-0.11296302440911388,0.5944067944686395,0.7073698188777534,1170876420,1155698852,64.08119196236169,66.5354628527731,NaN,NaN,13.948677910035498,15.279996437543348
2008-05-28T09:30:00-04:00,73.64,73.75999,72.92,73.66,54388224,62285971.2,57.708976308163294,57.72483061160742,NaN,NaN,67.76953896060664,31.976839674089,-0.08158406394432116,0.6053897389473519,0.6869738028916731,1225264644,1158145280.8,64.45704230065553,66.80222450462753,NaN,NaN,14.190800961864289,15.12439708387491
2008-05-29T09:30:00-04:00,73.50999,75.02,73.47,74.41,69852432,62662773.6,61.33702729745939,58.30216339356446,NaN,NaN,143.55205664368225,51.590546275970475,-0.016039329159208582,0.6669246414426624,0.682963970601871,1295117076,1194567808.8,69.56340121612786,67.54376040049878,NaN,NaN,15.529047594227539,15.182204299639572
2008-05-30T09:30:00-04:00,74.49001,74.81,74.14999,74.67,41633984,61978301.6,62.536874543292775,59.05273188510281,NaN,NaN,150.6314355618061,72.20986355966222,0.03624978936879075,0.7282762073128595,0.6920264179440687,1336751060,1227310080.8,73.27978931171054,68.64092508305309,NaN,NaN,16.98656071305659,15.43996950155629
2008-06-02T09:30:00-04:00,74.57001,74.63,73.22,73.99001,69923504,62532639.2,57.510107523217634,58.90866448058706,NaN,NaN,81.32298390131497,94.93469489716293,0.017418876019367424,0.713800012968278,0.6963811369489106,1266827556,1258967351.2,76.29374725742491,69.8105044305153,NaN,NaN,16.720249193028916,15.622866600338094
2008-06-03T09:30:00-04:00,74.25,74.64999,73.06,73.84,87677872,64921466.4,56.43244246757068,58.56305107225129,NaN,NaN,65.69044899262359,101.79329281200671,-0.011219163564290868,0.682357182493547,0.6935763460578379,1179149684,1260622004,76.44331213971216,70.86923473708782,NaN,NaN,16.188257086773575,15.703636669828876
2008-06-04T09:30:00-04:00,73.58,74.95,73.34,74.3,85092880,66150920,58.9713624876868,58.44188934246301,NaN,NaN,91.92327495566823,106.62404001101902,-0.005547882670304594,0.6866414927199571,0.6921893753902617,1264242564,1268417588,77.17398549800507,71.86732026470736,NaN,NaN,16.466573191894398,15.812627601552522
2008-06-05T09:30:00-04:00,74.42999,76.23,74.25,76.2,106082064,68583322.4,67.41738440565301,58.875224733367254,NaN,NaN,203.92116773858376,118.69786222999933,0.11324059834554012,0.8337401233221868,0.7204995249766467,1370324628,1283459098.4,78.55608885030388,72.88270635983883,NaN,NaN,19.5613275434644,16.34815616468279
2008-06-06T09:30:00-04:00,75.75,75.82001,73.89999,73.92,123993008,71760792,53.25100556423301,58.165511391341106,NaN,NaN,96.93525403129341,107.95862592389679,0.029685727502259285,0.7576066843544709,0.7279209568522116,1246331620,1265375210.4,72.84528892258716,73.17462210058402,NaN,NaN,17.13721867685934,16.46087938070801
2008-06-09T09:30:00-04:00,74.12,74.39,72.78,73.67999,98999008,74125054.4,52.012009967654244,57.36062351669927,NaN,NaN,-10.112263923976453,89.67157635883851,-0.046194215613100775,0.6701781873358357,0.7163724029489364,1147332612,1241476221.6,66.01509911303725,72.63751553051685,NaN,NaN,14.864279458994057,16.23279367760602
2008-06-10T09:30:00-04:00,73.00999,73.63499,72.25,73.14,98700320,76597692,49.236334258392276,56.51912774226499,NaN,NaN,-87.00592824429086,59.13230091145563,-0.1323246475433978,0.5509665935196892,0.683291241063087,1048632292,1215372743.2,59.45754590801776,71.53037861489639,NaN,NaN,12.105704708883712,15.643209539217118
2008-06-11T09:30:00-04:00,73.05,73.22,71.77,71.87,97453568,78853939.2,43.37368282157907,55.82663819176961,NaN,NaN,-156.7014530782129,9.40735530467939,-0.2666507258376204,0.3499778337660615,0.6166285596036819,951178724,1152759975.2,47.31640525756464,69.51115571096143,NaN,NaN,7.691633948357116,14.50727016909426
2008-06-12T09:30:00-04:00,72.28,73.10001,71.63,72.02,98507568,80746345.6,44.21851539997465,54.97671658682699,NaN,NaN,-139.92534151949954,-59.36194654693727,-0.3329144730172394,0.20048546833213265,0.5333999413493721,1049686292,1088632308,38.61849247732096,66.80594204608681,NaN,NaN,4.536719930130697,13.082905849242323
2008-06-13T09:30:00-04:00,72.66,73.35001,72.31,73.32001,84103312,82621529.6,51.03662252505797,55.072294508879814,NaN,NaN,-57.291763972838915,-90.20735014776373,-0.2788946835252653,0.18478158694279045,0.46367627046805576,1133789604,1066123904.8,36.10944949673242,64.30077426511161,NaN,NaN,4.074453866595961,11.795984137435699
2008-06-16T09:30:00-04:00,73.05,74.09,72.95,73.78,67166624,82767354.4,53.21564053823203,54.875570436297664,NaN,NaN,4.640206056845034,-87.25685615159944,-0.20528776671728743,0.20706656207144647,0.4123543287887339,1200956228,1076848628,38.17071115498981,62.45002563601362,NaN,NaN,4.410949947733996,10.740979253192599
2008-06-17T09:30:00-04:00,74.17999,74.25999,73.55,73.72,52324176,80245276,52.88503525135149,54.531003217953966,NaN,NaN,30.053021194655976,-63.84506626381007,-0.15597926884483704,0.21738024273268763,0.37335951157752467,1148632052,1096848580,41.93301052433315,60.841166223419165,NaN,NaN,4.576611201084067,9.860355245748522
2008-06-18T09:30:00-04:00,73.28999,73.49001,72.49001,73.13,88092128,80544385.6,49.62053019670491,53.694110567900076,NaN,NaN,-49.201275517738345,-42.34503075171516,-0.15795323567778513,0.17591796698029327,0.3338712026580784,1060539924,1118720820,45.816107962699164,59.1449309910314,NaN,NaN,3.734870916668803,8.98528605587999
2008-06-19T09:30:00-04:00,73.11,73.8,72.72,73.74001,105985440,80842254.4,52.86048731383394,53.00294005151016,NaN,NaN,-13.302376302002834,-17.020437708215816,-0.11502473714582873,0.19009028122579252,0.30511501837162125,1166525364,1142088634.4,49.68722883302451,57.45974809969669,NaN,NaN,3.9942123572039736,8.272275527497703
2008-06-20T09:30:00-04:00,73.45,73.45,71.85001,72.57001,121590816,83920032,46.662039148891466,52.22807802477257,NaN,NaN,-88.71077135604963,-23.304239184857963,-0.15953654118650168,0.10569434188849414,0.2652308830749958,1044934548,1124317623.2,46.940636292816514,55.36309731651037,NaN,NaN,2.2798551934377205,7.4162154797748485
2008-06-23T09:30:00-04:00,72.92,72.99001,71.86,71.89,73029248,84346569.6,43.471455648114244,51.302293251954254,NaN,NaN,-123.97688600316337,-49.02765759685965,-0.2248872174171344,-0.015878138696422184,0.20900907872071223,971905300,1078507437.6,40.69564308760007,52.809692384216646,NaN,NaN,-0.1603861944101699,6.333843812034131
2008-06-24T09:30:00-04:00,71.45,71.89,70.61,70.7,112302432,86844930.4,38.50911792637265,49.84070435471752,NaN,NaN,-199.97076757277028,-95.03241535034489,-0.3319073114974007,-0.20587506065103867,0.12603225084636205,859602868,1020701600.8,34.46472381030229,49.75903083509502,NaN,NaN,-3.915365503805445,4.869671052628478
2008-06-25T09:30:00-04:00,70.96001,72.10001,70.86,71.5,116515120,89951275.2,43.20303061222663,48.11110765518708,NaN,NaN,-137.52082755800885,-112.69632575839898,-0.33168118434302674,-0.28856922958242137,0.043111954760605364,976117988,1003817213.6,32.881111069108826,46.496532422152505,NaN,NaN,-5.546740682295876,3.3816122333535708
2008-06-26T09:30:00-04:00,70.81,70.95,69.61,69.66,114824752,92199891.2,36.33327418017424,46.902698270611445,NaN,NaN,-201.86163998610763,-150.40817849521994,-0.4319697213497541,-0.4968501969265873,-0.06488047557683317,861293236,942770788,27.891120086767998,43.285520362451145,NaN,NaN,-9.410007164573901,1.5542380336496462
2008-06-27T09:30:00-04:00,69.71001,70.25,69,69.7,118012368,96018810.4,36.56940504795249,45.799655062061326,NaN,NaN,-190.7129259297484,-170.8086094099597,-0.4690398573805129,-0.6511802973024743,-0.18214043992196138,979305604,929644999.2,26.94429457826479,40.494748609967395,NaN,NaN,-12.301537586772938,-0.42515848355358
2008-06-30T09:30:00-04:00,69.86,70.21001,68.92,69.05,115086192,98276944.8,34.34053208645388,44.735669192637154,NaN,NaN,-170.80710643149234,-180.17465349562548,-0.5075077979594803,-0.8165251873713117,-0.30901738941183143,864219412,908107821.6,25.419474430162722,38.063457790120594,NaN,NaN,-15.402641919261306,-2.564798974368969
2008-07-01T09:30:00-04:00,68.24001,69.25999,67.62,69.10001,150737248,101429913.6,34.670449525277704,44.11400967147277,NaN,NaN,-173.4552451262789,-174.87154900632723,-0.4990055865600568,-0.9327743726119024,-0.43376878605184566,1014956660,939178580,31.446833591450684,36.929916956826744,NaN,NaN,-17.77091846883616,-4.7371017592928535
2008-07-02T09:30:00-04:00,68.92,69.175,66.85001,66.91,148304064,104590472.8,28.028671542843796,42.957592253106284,NaN,NaN,-179.31438160514358,-183.23025981575415,-0.6033246024690448,-1.1879245391381517,-0.5845999366691068,866652596,917285501.6,29.629772179440835,36.287865506978164,NaN,NaN,-22.266705561939983,-7.241330873956729
2008-07-03T09:30:00-04:00,67.12,67.17999,65.77,66.32001,73587312,102965735.2,26.55289695492334,41.20875471238238,NaN,NaN,-187.82356236370805,-180.42264429127425,-0.669404565481023,-1.4213556435203856,-0.7519510780393626,793065284,903639911.2,28.523490953571667,35.74601132532382,NaN,NaN,-26.392183936944097,-9.977167025812067
2008-07-07T09:30:00-04:00,66.74001,67.03999,64.94,65.69,125543936,103043281.6,25.03694208047324,39.19599053682818,NaN,NaN,-171.52907726604212,-176.585874558533,-0.7090812845923032,-1.6383026837797416,-0.9292213991874384,667521348,841283060,24.095991118670298,34.74067417987243,NaN,NaN,-30.268212598344153,-12.875887821888078
2008-07-08T09:30:00-04:00,65.78999,68.14,65.25,68.07001,131838752,104685268.8,39.166621869172296,38.21610386667252,NaN,NaN,-112.60172080485762,-164.94479743320602,-0.5364204586395447,-1.5997469724868694,-1.0633265138473247,799360100,828311197.6,23.286228235758486,33.40876115925995,NaN,NaN,-28.883749463771263,-15.162725199299961
2008-07-09T09:30:00-04:00,68.10001,68.55,66,66.25,131079120,106304208.8,33.90385865620803,37.093484470922746,NaN,NaN,-104.4373065976295,-151.14120972747617,-0.5065345925629494,-1.6964947545510114,-1.189960161988062,668280980,758976061.6,19.511836724955117,31.529884642278237,NaN,NaN,-29.60677120076271,-17.226160342366068
2008-07-10T09:30:00-04:00,66.07001,67.45,65.96001,66.89999,131228560,107992958.4,37.151799756394304,35.97143535967705,NaN,NaN,-96.93286010652125,-134.66490542775168,-0.4089198473824065,-1.70110997121607,-1.2921901238336635,799509540,745547450.4,18.873766063547222,29.328923015887,NaN,NaN,-29.0340736775326,-18.913005104532715
2008-07-11T09:30:00-04:00,66.25,67.78,65.67,67.27,131385440,109636852,38.98971944645184,35.42341252378851,NaN,NaN,-83.9782751566347,-113.89584798633703,-0.2909067376165235,-1.655823545854318,-1.3649168082377945,930894980,773113389.6,24.343230393055293,27.714822594475486,NaN,NaN,-27.97724238654086,-20.207896144819593
2008-07-14T09:30:00-04:00,67.78,67.89999,65.86,66.16,113937056,111128539.2,35.62405200393779,34.86288369206162,NaN,NaN,-83.07581659947881,-96.20519585302436,-0.26008251565926876,-1.6900199528118804,-1.4299374371526117,816957924,803000704.8,29.864278614725364,26.941153703555862,NaN,NaN,-28.189243810090204,-21.34808866842968
2008-07-15T09:30:00-04:00,65.55,67.28,64.52,65.88,143442320,114942324,34.80781259449779,34.59850473978484,NaN,NaN,-94.43689600243954,-92.57223089254076,-0.23196101446947504,-1.7198887052394554,-1.4879276907699803,673515604,777831805.6,28.010505040612713,26.480138077149466,NaN,NaN,-28.61100190167354,-22.38564770175023
2008-07-16T09:30:00-04:00,66.31,68.49001,65.78999,68.3,112225008,117937365.6,46.26707672479281,34.81736517639671,NaN,NaN,-43.30451751570977,-80.3456730761568,-0.034171323476731574,-1.5306418451158947,-1.4964705216391632,785740612,801323732,32.238429460056196,26.43423224793142,NaN,NaN,-25.047267947486734,-22.765879165426874
2008-07-17T09:30:00-04:00,68.72,69.53999,68.08,68.39999,115520256,119308772,46.68408429110436,35.55670875574887,NaN,NaN,-2.690213775391163,-61.49714380993076,0.11161490455638923,-1.3569518909436766,-1.4685667955000659,901260868,821673997.6,35.75818133554952,26.996165194272955,NaN,NaN,-22.157076184441177,-22.678907311000344
2008-07-18T09:30:00-04:00,69.75999,69.85001,68.53,68.88,99585744,118988787.2,48.74070632405431,36.426087418327576,NaN,NaN,20.83046540750736,-40.53539569710235,0.2411616101662155,-1.1671147827922965,-1.408276392958512,1000846612,835664324,38.13721454783356,27.795659477813583,NaN,NaN,-19.164831761279416,-22.176896518183067
2008-07-21T09:30:00-04:00,69.37,69.75,68.98,69.72,70224320,116420462.4,52.214525428837554,37.70280122849783,NaN,NaN,45.913725728472215,-14.737487231512148,0.3761627100652727,-0.9380730053769213,-1.314235715442194,1071070932,886486925.6,45.96551402407877,29.263233734521872,NaN,NaN,-15.56183372200881,-21.23188754730103
2008-07-22T09:30:00-04:00,69.19,71.59,69.02,71.47,136370128,119587506.4,58.52124776894126,39.406429674473806,NaN,NaN,104.57235749031138,25.06436346703803,0.5647222610681406,-0.6083328891070181,-1.1730551501751587,1207441060,993272016.8,57.99349910923185,31.1594241286491,NaN,NaN,-10.266668726126678,-19.665427715704695
2008-07-23T09:30:00-04:00,71.38,72.49001,71.17999,71.92999,118339056,119889337.6,60.01507084386207,41.6911724816894,NaN,NaN,150.19963418748776,63.76519380767754,0.693354067613836,-0.3063625656578637,-0.9997166332716997,1325780116,1101279917.6,66.19103486874951,33.770942892171114,NaN,NaN,-5.516558807130421,-17.644160728765513
2008-07-24T09:30:00-04:00,71.87,71.92999,69.86,70.11,112120128,119669588,52.03073596370422,43.51101812517374,NaN,NaN,102.24353336112577,84.75194323498093,0.6305979417517935,-0.21146920608195785,-0.8420671478337514,1213659988,1163759741.6,69.85575022775691,36.72324712604149,NaN,NaN,-3.891369897350294,-15.679476324277624
2008-07-25T09:30:00-04:00,70.69,71.41,70.21001,70.67999,112551632,119555932,54.09071076526626,45.58628731694468,NaN,NaN,104.19280768074387,101.42441168962823,0.6022590273791073,-0.08924336360986729,-0.6915023909889746,1326211620,1228832743.2,73.1233525161654,40.225201511576856,NaN,NaN,-1.92298977967203,-13.71426396076254
2008-07-28T09:30:00-04:00,70.64,70.84,69.22,69.48,82120816,117761354.4,49.29153889298065,46.309495675788135,NaN,NaN,63.956465483204134,105.0329596405746,0.48264906836315213,-0.08819105553503448,-0.5708401238981866,1244090804,1263436717.6,74.69427011678518,43.89720450307876,NaN,NaN,-1.7846660732476527,-12.010035691117556
2008-07-29T09:30:00-04:00,69.67999,71.39999,69.61,71.17999,122966128,118155351.2,55.33719001927313,47.84044791600707,NaN,NaN,94.67362150563298,103.0532124436389,0.4960722323377412,0.04925016652398995,-0.4468220658137513,1367056932,1295359892,76.0830967280151,47.93800878901162,NaN,NaN,0.34211215382084165,-10.245443141840642
2008-07-30T09:30:00-04:00,71.59,72.07001,70.64,71.61,153225568,118279767.2,56.74208890114082,49.23975428348897,NaN,NaN,108.73053676233951,94.75939295860925,0.509996510428905,0.19067357222238002,-0.319322938206525,1520282500,1334260368.8,77.68990520518199,52.13916158484267,NaN,NaN,2.485081419351144,-8.426796775956102
2008-07-31T09:30:00-04:00,70.82001,72.00999,70.74001,71.32001,95287872,115628957.6,55.47477635734815,50.41725834855299,NaN,NaN,94.21292339810799,93.15327096600569,0.47639384031616566,0.27616936218868204,-0.20022447812748362,1424994628,1376527296.8,79.31592460324818,56.06578259985645,NaN,NaN,3.8285806942732274,-6.676028565923341
2008-08-01T09:30:00-04:00,71.44,71.75999,70.32001,71.41,107406752,117319929.6,55.804652479138284,51.858729811067306,NaN,NaN,79.51315219971715,88.21733986980037,0.43792734528307364,0.34718470347635844,-0.09074264180671521,1532401380,1417765248.8,80.78720655835266,59.70313459582983,NaN,NaN,5.009147672837006,-5.0067176746718625
2008-08-04T09:30:00-04:00,71.42999,71.49001,69.81,70.75,104200064,116252736,52.71967591246378,53.13814861949345,NaN,NaN,56.595565410571794,86.7451598552739,0.34956804156025945,0.3462174101436091,-0.003350631416650346,1428201316,1454587351.2,82.0172278096812,63.560757650763286,NaN,NaN,5.140450391663199,-3.5571222366239965
2008-08-05T09:30:00-04:00,70.99001,71.97,70.75,71.96001,93552368,114338416.8,57.3723493069236,53.93138237535994,NaN,NaN,83.27148003174948,84.4647315604972,0.3531117658816574,0.43803907593542135,0.084927310053764,1521753684,1485526701.6,83.00193879510502,67.18672260326677,NaN,NaN,6.624490076512966,-2.102606191890145
2008-08-06T09:30:00-04:00,71.7,72.66,71.2,72.32001,79588816,111763901.6,58.675306035986736,54.787898214280105,NaN,NaN,95.61265969427868,81.84115614688503,0.35902229427569554,0.5337051778983835,0.1746828836226879,1601342500,1501738701.6,83.5114397055965,70.5976696296987,NaN,NaN,8.229809246347761,-0.6265468435704442
2008-08-07T09:30:00-04:00,71.72,72.34,70.97,71.24001,89733504,109689148.8,53.40178915476992,55.12083270218836,NaN,NaN,69.05197239142609,76.80896594554865,0.2733907296159421,0.5164212956426155,0.24303056602667344,1511608996,1519061575.2,84.06119492340805,73.87795394223974,NaN,NaN,8.093913065850385,0.6192331434896743
2008-08-08T09:30:00-04:00,71.24001,73.37,70.98,73.12,112771376,108758445.6,60.120833625615276,55.6855690019582,NaN,NaN,106.58916537114256,82.22416857983373,0.32314783656362506,0.6469653617312048,0.3238175251675797,1624380372,1537457373.6,84.64662349189895,76.64089033279834,NaN,NaN,10.089514471557466,1.9721304760707874
2008-08-11T09:30:00-04:00,73.27,75.60001,73.13,74.87,174577680,111790476.8,65.15721214500692,56.15956645739142,NaN,NaN,200.29883453140795,110.96482240400096,0.4461234127892147,0.8814717911540981,0.43534837836488344,1798958052,1611608720.8,86.75796284351702,78.69549488524727,NaN,NaN,13.522782784333987,3.62222366296553
2008-08-12T09:30:00-04:00,74.64,74.89,74.06,74.31,128838688,111060295.2,62.43972238188886,56.33275585296477,NaN,NaN,186.32784846175443,131.57609609000195,0.4601087152494374,1.0104842724266803,0.5503755571772428,1670119364,1641281856.8,87.49881960509765,80.21747950927214,NaN,NaN,15.422428287147808,5.307967180705855
2008-08-13T09:30:00-04:00,74.25,74.95,73.53,74.58,151013248,112999707.2,63.23586378482235,57.13312212590177,NaN,NaN,166.84114062500458,145.82179227614714,0.4569678730776253,1.1215853985242745,0.6646175254466492,1821132612,1685239879.2,88.52319650151222,81.55086852882609,NaN,NaN,17.189589794137472,7.005341839767515
2008-08-14T09:30:00-04:00,74.17,75.64,74.06,75.3,118194752,113133432,65.34534842979659,57.93702481622537,NaN,NaN,170.9082151141339,166.1930408206887,0.4709337698757582,1.253284737791347,0.7823509679155888,1939327364,1770783552.8,90.20523921709871,82.77100329317848,NaN,NaN,19.309959770374338,8.763144401282775
2008-08-15T09:30:00-04:00,75.74001,76.27,74.48,75.10001,98174752,113062882.4,64.24270201896023,59.00496503950962,NaN,NaN,154.62486546331405,175.80018083912302,0.4351047580026616,1.3262319154189157,0.8911271574162541,1841152612,1814138000.8,90.93070982186777,83.93074898639864,NaN,NaN,20.725099150986214,10.471995079811837
2008-08-18T09:30:00-04:00,75.27,75.42,73.56,74.13,97843680,114443850.4,59.03899143353809,59.269379426242836,NaN,NaN,96.14007042867422,154.96842801857625,0.3198109088201556,1.2908907934414486,0.971079884621293,1743308932,1803008176.8,89.10608874858305,84.8609627021535,NaN,NaN,20.436694704587293,11.895523597636902
2008-08-19T09:30:00-04:00,73.63,73.83,72.44,72.89999,105132368,112881962.4,53.15892004117207,59.01343879338792,NaN,NaN,31.851645218131498,124.07318736985167,0.14343242684512636,1.150370418177701,1.0069379913325747,1638176564,1796619616.8,88.01435935871683,85.59842371312028,NaN,NaN,18.390251458485068,12.823341863472354
2008-08-20T09:30:00-04:00,73.17,73.82001,72.28,73,101310880,112030553.6,53.56388645120317,58.876946657234704,NaN,NaN,27.8482438933484,96.27460802352041,0.022565189635102012,1.035144478376452,1.01257928874135,1739487444,1780290583.2,85.14292831259014,86.01463826378756,NaN,NaN,16.84799692490254,13.39829258653381
2008-08-21T09:30:00-04:00,72.53999,73,72.05,72.16,83526320,110600863.2,49.67894059349671,58.4393958082603,NaN,NaN,-4.754029451298538,61.142159110433944,-0.11721328728644986,0.8660626796332878,0.9832759669197376,1655961124,1723617335.2,75.88900260759767,85.66476655301935,NaN,NaN,14.370071682243319,13.537118171635168
2008-08-22T09:30:00-04:00,72.75,73.81,72.62,73.67999,77915440,108869053.6,55.91046796854346,58.667309526551705,NaN,NaN,35.79089341771598,37.37536470131431,-0.11064134292978711,0.8449742882575038,0.9556156311872909,1733876564,1702162125.6,72.6689309332508,84.99703106184575,NaN,NaN,14.020549482889566,13.606179787528653
2008-08-25T09:30:00-04:00,73.22,73.67999,70.69,72.06,88256000,109175812.8,48.95259161555731,58.06589826288268,NaN,NaN,-31.796301520704933,11.788090311438475,-0.2128183160107754,0.6895927361738217,0.902411052184597,1645620564,1682624452,69.765880728908,84.05159834283167,NaN,NaN,11.452566431373773,13.298520736649385
2008-08-26T09:30:00-04:00,72.17999,72.58,71.46001,72.17,53866256,105720819.2,49.41294150301635,57.40430079624195,NaN,NaN,-41.126282004867704,-2.8074951331613582,-0.2669117417378687,0.5687713750122612,0.8356831167501299,1699486820,1694886503.2,70.56077097188594,83.12655057613806,NaN,NaN,9.555846684039405,12.763853014847959
2008-08-27T09:30:00-04:00,72.2,73.50999,72.11,73.03,62031632,101161122.4,52.98288062241728,57.374378758216764,NaN,NaN,-0.2432150945953365,-8.425786930750105,-0.23956007104153287,0.5362330279482137,0.7757930989897466,1761518452,1699292704.8,70.85727184151374,82.18341321314561,NaN,NaN,9.018691052407405,12.228829877356452
2008-08-28T09:30:00-04:00,73.37,74.64999,73.03,74.50999,75513680,100172412.8,58.42090807967236,57.25295550493512,NaN,NaN,61.631489193832344,4.85131679827607,-0.12248169228485772,0.6226909836336745,0.7451726759185322,1837032132,1735506906.4,73.24257251497298,81.36883814336518,NaN,NaN,10.265438656174453,11.948345417187594
2008-08-29T09:30:00-04:00,74.17,74.52,73.53,73.87,83920752,98998112.8,55.43505162330179,56.55851546767047,NaN,NaN,49.55644768754491,7.6044276522418555,-0.09031480367638678,0.6322791713230487,0.7225939749994355,1753111380,1739353869.6,73.49079064575442,80.42118298638215,NaN,NaN,10.37072834014018,11.722971549037965
2008-09-02T09:30:00-04:00,75.00999,75.5,73,73.85001,112604256,99418322.4,55.33991157394081,56.0513861242456,NaN,NaN,51.42565288124491,24.248818532631823,-0.07328223626468122,0.6309911796685839,0.7042734159332651,1640507124,1738331181.6,73.29612917735454,79.4067050986862,NaN,NaN,10.427124268537225,11.53785050896643
2008-09-03T09:30:00-04:00,73.64999,74.7,73.39,74.14999,96284128,99554910.4,56.545172659958276,55.57347961532674,NaN,NaN,43.06063768115995,41.08620246983735,-0.04604168057562086,0.646721315213739,0.6927629957893598,1736791252,1745792068,73.84051673078633,78.35794225792006,NaN,NaN,10.813957600585931,11.434437236340646
2008-09-04T09:30:00-04:00,73.52,73.67999,71.48,71.82001,126697872,101910363.2,46.13150418438473,54.2010621692259,NaN,NaN,-80.9641127047419,24.942022947808045,-0.18156391536861727,0.4658081015785882,0.6473720169472055,1610093380,1715507053.6,67.79857445762963,76.75746620367227,NaN,NaN,7.866570256019551,10.924741953437632
2008-09-05T09:30:00-04:00,71.53999,72.11,70.14,71.64,122295744,103538475.2,45.43530930593646,52.85767697543848,NaN,NaN,-151.09243918208796,-17.602762727376017,-0.2743785309410016,0.3043988532709534,0.578777384211955,1487797636,1645660154.4,56.34718690201977,74.28721456654027,NaN,NaN,5.2960682130233625,10.120645704807021
2008-09-08T09:30:00-04:00,74.02,74.35001,71.64,72.48,148104064,105305109.6,49.28179746302937,52.160734548973565,NaN,NaN,-46.6049006497096,-36.83503239482692,-0.2698393232090621,0.2414782302006273,0.5113175534096894,1635901700,1622218218.4,53.10523959523166,71.71572534130088,NaN,NaN,4.258584556931619,9.283208397967678
2008-09-09T09:30:00-04:00,73.24001,73.85001,70.56,70.81,132381056,103195278.4,42.819122247713665,51.42217756372654,NaN,NaN,-110.8262233054021,-69.28540763215632,-0.3640858956387943,0.05621018386119658,0.42029607949999087,1503520644,1594820922.4,49.51926805304384,68.96607596232424,NaN,NaN,1.2480186664175699,8.135324150603378
2008-09-10T09:30:00-04:00,71.57001,72.17999,70.42999,71.47,126868944,103096791.2,45.84186797304716,50.87060481528683,NaN,NaN,-122.7556025094519,-102.44865567027868,-0.3657839381151119,-0.036933843143899026,0.32885009497121287,1630389588,1573540589.6,46.87176672418482,66.23242156315243,NaN,NaN,-0.28944193552080955,6.931786138299922
2008-09-11T09:30:00-04:00,70.52,72,69.89999,71.92,144285936,102760425.6,47.86548980997584,50.74107261646391,NaN,NaN,-117.17727474478451,-109.6912880782872,-0.32195335460337204,-0.07359159828300221,0.24836175632036983,1774675524,1606457018.4,51.216415349127416,64.47009390183312,NaN,NaN,-0.9368961013093804,5.807688675498594
2008-09-12T09:30:00-04:00,71.32001,72.39,71.03999,72.25,117709248,102736150.4,49.35982153795488,50.27316929999329,NaN,NaN,-69.46520919433306,-93.36584208073623,-0.2588083048111847,-0.07514862469361105,0.18365968011757366,1892384772,1687374445.6,59.89817008999342,63.55789669874331,NaN,NaN,-1.0320660010842548,4.830580864558187
2008-09-15T09:30:00-04:00,70.14999,71.49001,68.78999,69.00999,168642064,106259516,37.87972314656598,49.482250123636774,NaN,NaN,-194.09698106604282,-122.86425816400288,-0.4141073111176427,-0.33397445877947973,0.08013285233816299,1723742708,1704942647.2,61.50017018423105,62.96748880269496,NaN,NaN,-5.0878532521703566,3.413661705025538
2008-09-16T09:30:00-04:00,67.8,71,67.73,71,252238192,113979241.6,46.16207925937442,49.25004567766235,NaN,NaN,-164.38072053139248,-133.57515760920097,-0.3634702968451019,-0.37420501871821443,-0.010734721873112502,1975980900,1799434698.4,68.73474450118101,62.83705834050175,NaN,NaN,-5.611449744875195,2.124360069325433
2008-09-17T09:30:00-04:00,69.95,70.07001,67.45,67.8,266078432,122026544.8,37.50309370583283,48.14434661219203,NaN,NaN,-213.26596502286554,-151.6772301118837,-0.5167969415405489,-0.6567308987987985,-0.1399339572582497,1709902468,1815337274.4,69.76448645806737,62.75900224168415,NaN,NaN,-9.450332685408753,0.47083253293483507
2008-09-18T09:30:00-04:00,69.39999,72.14999,67.16,71.8,355117568,134716879.2,50.1026170885737,47.5501829699707,NaN,NaN,-90.72117915905939,-146.38601099473868,-0.32926135591496924,-0.5515106521519613,-0.22224929623699202,2065020036,1873406176.8,73.231469926535,62.758209199652875,NaN,NaN,-7.473228190960962,-0.6640332847645645
2008-09-19T09:30:00-04:00,78.92,86.05,73.95,75,138362320,137458679.2,57.4866785690552,47.69672775181022,NaN,NaN,264.6989220310469,-79.55318474966268,0.011785468969421287,-0.20751746002521543,-0.21930292899463671,2203382356,1935605693.6,76.35853477559766,62.96304806607025,NaN,NaN,-2.7183783348545503,-0.9575111490631338
2008-09-22T09:30:00-04:00,75.2,75.36,70.22,71.95,98347008,138480257.6,49.90604908793304,47.30859471709539,NaN,NaN,10.957269615796383,-38.54233461329483,0.03228466617258624,-0.17894709627890393,-0.21123176245149017,2105035348,2011864221.6,79.51773048568602,63.40744815952251,NaN,NaN,-2.2015384765651875,-1.1352293387062844
2008-09-23T09:30:00-04:00,72,72.62,70.81,70.99001,92900368,138712476,47.77078317241768,46.68185261084249,NaN,NaN,-33.86296323350582,-12.4387831537175,-0.01589780913520822,-0.23110402387050044,-0.21520621473529222,2012134980,2019095037.6,79.79345650287767,63.832658143243314,NaN,NaN,-2.6600984409958732,-1.3530677818905112
2008-09-24T09:30:00-04:00,70.83,71.03,68.89999,69.94,91767504,140607538.4,45.478761012306194,46.63522809855117,NaN,NaN,-90.83442794763587,12.047524261328437,-0.11031145298841008,-0.3530955309708048,-0.24278407798239474,1920367476,2061188039.2,81.36603460740704,64.80176243965599,NaN,NaN,-3.8503605808683194,-1.7098238960301981
2008-09-25T09:30:00-04:00,69.92,71.25999,69.89,70.3,115331872,143272550.4,46.42781208286009,46.70612115404571,NaN,NaN,-62.985054170296614,17.59474925908098,-0.138517612142753,-0.415931093160836,-0.277413481018083,2035699348,2055323901.6,80.42695852439158,66.52174612696827,NaN,NaN,-4.430639483229916,-2.0985118370587292
2008-09-26T09:30:00-04:00,69.00999,70.69,68.78999,70.63,94650064,144229369.6,47.33283572571638,46.566909601380495,NaN,NaN,-75.73368147404875,-50.49177144193814,-0.12534640932586022,-0.4340964926754083,-0.30875008334954807,2130349412,2040717312.8,78.0117912623068,68.30078553175935,NaN,NaN,-4.59529990518513,-2.455195846791072
2008-09-29T09:30:00-04:00,69.23,70.33189,65.05,65.05,150003120,147533488,36.197485388720516,46.09393554002385,NaN,NaN,-190.35217931378705,-90.75366122785483,-0.4638078371947155,-0.8885098798429425,-0.424702042648227,1980346292,2015779501.6,73.92991364762474,70.04440307422941,NaN,NaN,-8.891230299593506,-3.3746293400485623
2008-09-30T09:30:00-04:00,65.87,68.39,65.05,68,108273248,147316937.6,43.73383714135789,45.9433619091889,NaN,NaN,-155.13187102732059,-115.00744278661777,-0.45950129414711194,-0.9990786603321169,-0.539577366185005,2088619540,2031076413.6,74.80090683955689,72.03934165389884,NaN,NaN,-9.60784805797117,-4.265089156894649
2008-10-01T09:30:00-04:00,67.19,67.35001,66.28999,67.02,69571568,145981309.6,41.960651011283694,45.521587709282315,NaN,NaN,-145.91591663769552,-126.02374052462969,-0.49033630595744915,-1.1524977486318164,-0.6621614426743673,2019047972,2050812512.8,75.91878118414334,73.80379635639997,NaN,NaN,-10.782337072691135,-5.196124573437004
2008-10-02T09:30:00-04:00,66.63,67.032,63.42,63.58,116143376,145453584.8,36.38410278504485,44.59475065550303,NaN,NaN,-193.2113490946815,-152.06899950950668,-0.6974548186415009,-1.5339799659762434,-0.8365251473347425,1902904596,2024253562.4,71.33280643021992,74.62055609498759,NaN,NaN,-13.8140652325393,-6.42725895330876
2008-10-03T09:30:00-04:00,64.36,65.64,61.73,62.7,118870624,145282328.8,35.09903129633555,44.39612980905799,NaN,NaN,-193.8925168105578,-175.7007665768085,-0.8392440598267266,-1.8855802221181506,-1.046336162291424,1784033972,1954990474.4,60.986369012976496,74.58385601132656,NaN,NaN,-16.597714268393517,-7.880181141178011
2008-10-06T09:30:00-04:00,60.56,60.72,56.38,59.72,172302128,146492232,31.0939626342292,43.319835764404765,NaN,NaN,-240.59194788787673,-185.74872029162643,-1.0647576399993917,-2.3772832122906635,-1.3125255722912719,1611731844,1881267584.8,52.29227652195581,73.40939401281047,NaN,NaN,-20.357559294761234,-9.662663734547042
2008-10-07T09:30:00-04:00,60.2,60.42999,55.63,55.8,152291632,147487760.8,26.767121137566477,42.55298058095717,NaN,NaN,-215.56967429827694,-197.8362809458177,-1.3884880252719478,-3.0481356038812066,-1.6596475786092588,1459440212,1755431719.2,41.43451074300319,71.3858243188773,NaN,NaN,-25.169017012852578,-11.877857060019261
2008-10-08T09:30:00-04:00,53.81,56.95,53.50999,54.46001,173755680,149832097.6,25.462752248002772,40.792990235202105,NaN,NaN,-203.7313238745345,-209.3993623931855,-1.588993463572252,-3.6458894080745736,-2.0568959445023216,1285684532,1608759031.2,32.86797296272151,68.50271739289062,NaN,NaN,-29.38311725307673,-14.378608516170328
2008-10-09T09:30:00-04:00,55.64999,55.92999,49.45,49.99001,154555312,150345566.4,21.669302398289062,38.23460622300452,NaN,NaN,-201.5583921421454,-211.06877100267826,-1.8978813543811732,-4.429247637478788,-2.531366283097615,1131129220,1454403956,26.628520238144006,64.95057349735822,NaN,NaN,-34.43792951467234,-17.244225801670616
2008-10-10T09:30:00-04:00,47.66,54.67,46.50999,52.45,205091936,154714700.8,28.024434604000078,36.67163375986645,NaN,NaN,-167.3611759850723,-205.76250283758117,-1.8119274254678857,-4.796275564932472,-2.9843481394645863,1336221156,1364841392.8,23.804760871631203,60.97107566778288,NaN,NaN,-36.227737133200684,-19.956155991889197
2008-10-13T09:30:00-04:00,54.53999,57.38,52.45,56.98,128728880,152719041.6,37.99992695893526,35.97371545890343,NaN,NaN,-100.75320171918041,-177.7947536038419,-1.3467671888986046,-4.667807125587842,-3.3210399366892376,1464950036,1335485031.2,22.945855529457134,56.91053274110999,NaN,NaN,-34.0528352710302,-21.96996731748077
2008-10-14T09:30:00-04:00,58.75,58.85001,53.86,55.38,131477184,146680991.2,36.096980397356276,35.303588272121296,NaN,NaN,-84.54498306393523,-151.58981535697356,-1.0564449777351181,-4.641596158858135,-3.5851511811230172,1333472852,1310291559.2,22.205380894974795,52.684771761650545,NaN,NaN,-33.02551745774279,-23.549331623232487
2008-10-15T09:30:00-04:00,54.45,54.85001,50.05,50.41,109148320,138834485.6,30.917672671297453,34.19572117129539,NaN,NaN,-110.94264014363768,-133.03207861079417,-1.1035846990288913,-4.964632054909131,-3.86104735588024,1224324532,1298019559.2,21.835735112725843,48.49968437510298,NaN,NaN,-34.02882091520455,-25.046401522085638
2008-10-16T09:30:00-04:00,51.02,53.88,48.28999,53.71001,207606880,131458951.2,37.345935725021285,33.48237117124574,NaN,NaN,-96.1709710923562,-111.95459440083634,-0.8294798690678693,-4.897897192215076,-4.068417323147207,1431931412,1358179997.6,28.15015814234495,44.938139152248574,NaN,NaN,-32.50362659146781,-26.111719389140234
2008-10-17T09:30:00-04:00,51.55,55.45,50.72,52.2,131846128,131133141.6,35.70856028615704,33.44744794963406,NaN,NaN,-80.33561201366975,-94.54948160655584,-0.6734678929529263,-4.910252189338365,-4.236784296385439,1300085284,1350952823.2,27.858997189939473,41.647359405271054,NaN,NaN,-31.875223805913812,-26.93507716296503
2008-10-20T09:30:00-04:00,53.25,54.71001,52.46001,54.69,82673744,130349478.4,40.352646885770575,33.205934359949254,NaN,NaN,-63.13359225216291,-87.02555971315235,-0.3428463723715751,-4.665342261849908,-4.322495889478333,1382759028,1334514621.6,27.170626460675265,38.24519652106522,NaN,NaN,-29.790749589255057,-27.343030366720747
2008-10-21T09:30:00-04:00,53.95,54.59,52.82001,53.17999,83005504,129854735.2,38.53476751566211,32.961228395976285,NaN,NaN,-62.07853163910937,-82.53226942818718,-0.17460457571668808,-4.540751609124193,-4.366147033407505,1299753524,1327770756,26.87721273104296,34.74222734584377,NaN,NaN,-28.70620857080135,-27.53777011016083
2008-10-22T09:30:00-04:00,51.75999,52.46001,49.31,50.49001,91862880,129859504,35.46928152006615,32.89588401990638,NaN,NaN,-85.57842329917196,-77.45942605929403,-0.19186372681592978,-4.605976691927417,-4.414112965111487,1207890644,1324483978.4,26.725732314917934,31.55600776617934,NaN,NaN,-28.78566812483976,-27.716041255114963
2008-10-23T09:30:00-04:00,50.67999,50.94,46.67999,48.99001,133202560,130753038.4,33.852098827699535,32.806817415003806,NaN,NaN,-101.9098303022365,-78.6071979012701,-0.24810748516368797,-4.7242473215660965,-4.4761398364024085,1074688084,1253035312.8,23.61052856192356,28.88630487681841,NaN,NaN,-29.356179537237704,-27.95034672398964
2008-10-24T09:30:00-04:00,44.95,48.2,44.89,47.17,105749440,131308007.2,31.948711226962132,32.8678708859133,NaN,NaN,-123.41826728898964,-87.22372895633409,-0.34569445277909505,-4.908257902376278,-4.5625634495971825,968938644,1186805984.8,21.14959541089324,26.66182765459966,NaN,NaN,-30.415734344017707,-28.30254495542222
2008-10-27T09:30:00-04:00,46.12,47.67,44.7,44.86,99422496,128778976,29.668572964636624,33.075117444989736,NaN,NaN,-130.49547546790473,-100.69610559948244,-0.49456098242451585,-5.1807646776278276,-4.686203695203312,869516148,1084157408.8,18.015404857372957,24.989034377054647,NaN,NaN,-32.01465233374478,-28.8328460094683
2008-10-28T09:30:00-04:00,45.73,48.7,44.08,48.45,114982432,129114435.2,37.17305825127388,33.911567873794816,NaN,NaN,-107.47336737852818,-109.7750727473662,-0.2901132975832912,-5.048845317182426,-4.758732019599135,984498580,1021106420,16.407064784997615,23.813255221502935,NaN,NaN,-31.035018701137716,-29.147442108278216
2008-10-29T09:30:00-04:00,48.50999,50.73,47.82001,48.7,94993504,130385532,37.67181206024167,35.054604278220005,NaN,NaN,-72.98917811941553,-107.25722371141492,-0.08742236367070433,-4.868009974187515,-4.780587610516811,1079492084,995426708,15.788811782445308,23.038990331810172,NaN,NaN,-30.10703914608578,-29.284527399393582
2008-10-30T09:30:00-04:00,50.41,51.48,49.52,51.42999,77436688,128450197.6,42.99373547047482,36.12384005439677,NaN,NaN,-36.518900491314625,-94.17903774923055,0.2620085004488484,-4.45307698495575,-4.7150854854045985,1156928772,1011874845.6,17.922211592860606,22.618808240469413,NaN,NaN,-27.684749425353505,-29.05598768881643
2008-10-31T09:30:00-04:00,51.3,54.09,50.48,53.75,113062688,128159800.8,47.125573363740294,36.775671940454274,NaN,NaN,16.92378510646902,-66.1106272701388,0.6583342305096425,-3.8921676972675456,-4.550501927777188,1269991460,1072085408.8,25.375134995593086,22.79232820233627,NaN,NaN,-24.35737715871203,-28.38475761308723
2008-11-03T09:30:00-05:00,53.48,54.60001,53.38,53.82001,54872720,122288330.4,47.2498242529807,37.57230364442745,NaN,NaN,57.13781779592168,-28.58396861737353,0.9181864839024723,-3.402768822899098,-4.3209553068015705,1324864180,1163155015.2,34.990452094868246,23.70554757375723,NaN,NaN,-21.64919213054309,-27.422533972723784
2008-11-04T09:30:00-05:00,54.92999,55.21001,53.39,54.44,79680880,118657792.8,48.40610017244645,38.82147703736666,NaN,NaN,76.40368828111613,8.191442514555328,1.1118836275616832,-2.931100772349467,-4.04298439991115,1404545060,1247164311.2,42.3675523607594,25.172105948616764,NaN,NaN,-19.074873126978055,-26.230010994760107
2008-11-05T09:30:00-05:00,53.92999,54.44,51.31,51.59,73883680,113664192.8,43.66759161762632,39.27302388683845,NaN,NaN,26.597719985130684,28.108822135464568,1.029981242768538,-2.7555078464504774,-3.7854890892190154,1330661380,1297398170.4,46.292192540034456,26.467965548451726,NaN,NaN,-18.11867279089458,-25.07124839420789
2008-11-06T09:30:00-05:00,51.05,51.7,49.53999,49.59,85233744,110198114.4,40.65961371704244,39.62667056047312,NaN,NaN,-35.359780737419214,28.34064608624366,0.8315293497886751,-2.7460774019831717,-3.577606751771847,1245427636,1315097943.2,47.64503275452695,27.881253803065114,NaN,NaN,-18.163160273405474,-24.084378662664687
2008-11-07T09:30:00-05:00,50.07001,51.07001,49.31,50.62,62313040,103059169.6,42.843223547641735,39.804568893463916,NaN,NaN,-31.748697649060738,18.606149535137707,0.7619019569510392,-2.625229305583048,-3.387131262534087,1307740676,1322647786.4,48.24389316777735,29.386487139286693,NaN,NaN,-17.58351792341849,-23.1556842713438
2008-11-10T09:30:00-05:00,51.74001,51.83859,48.92999,49.45,50460160,99145733.6,40.997708561978406,39.980493253915085,NaN,NaN,-33.28576886491879,0.521432202969612,0.6345338589679357,-2.5939639388241673,-3.228497797792103,1257280516,1309131053.6,47.20288359366075,30.838320772330825,NaN,NaN,-17.60668277572171,-22.362969771969215
2008-11-11T09:30:00-05:00,48.89999,49.89999,48.00999,48.38,73188432,96231296,39.329182647417554,40.256200477297334,NaN,NaN,-66.97195209934853,-28.15369587312332,0.4825873871492501,-2.6252635638555404,-3.1078509510047905,1184092084,1265040458.4,43.87699164248209,32.06341072429969,NaN,NaN,-18.087445999592187,-21.75218066162964
2008-11-12T09:30:00-05:00,47.61,48.38,45.32001,45.56,75376752,94542717.6,35.25665120881743,40.356525647377175,NaN,NaN,-124.95414978254044,-58.46406982665754,0.2104201259514058,-2.8448257935655334,-3.0552459195169392,1108715332,1220651248.8,40.76297045068948,33.288585144925825,NaN,NaN,-19.702797723087823,-21.45941167040938
2008-11-13T09:30:00-05:00,45.7,49.45,43.24001,49.31,142363440,91280545.6,43.61767313795058,41.1900229267335,NaN,NaN,-87.45564080906479,-68.88324184098666,0.2959707218528971,-2.685282517200818,-2.981253239053715,1251078772,1221781476,40.87802576272265,34.697758741485075,NaN,NaN,-18.61762193198114,-21.053441707776773
2008-11-14T09:30:00-05:00,48.23,49.31,45.5,45.64,98701632,89623320.8,38.39218874167586,41.81313833937916,NaN,NaN,-91.68163298282433,-80.86982890773938,0.12704559416402583,-2.822446246348683,-2.949491840512709,1152377140,1190708768.8,38.65513259730246,36.172025008622896,NaN,NaN,-19.334904748011425,-20.807936427810294
2008-11-17T09:30:00-05:00,45.35001,46.58,44.89,45.25,84047120,89691989.6,37.87293899180077,41.86312982084536,NaN,NaN,-114.2014806332561,-97.05297126140684,0.016507721985882018,-2.9288571880303564,-2.9453649100162385,1068330020,1152918669.6,36.08509126310659,37.57759832848783,NaN,NaN,-20.064571964389874,-20.70174150446452
2008-11-18T09:30:00-05:00,45.33,45.99001,43.10001,45.03,98258624,90454645.6,37.56429951374244,41.855450353238275,NaN,NaN,-126.17278859984931,-108.893138561507,-0.04082819326106879,-2.9964001515925744,-2.9555719583315057,970071396,1110114532,33.37809941696332,38.833976016667684,NaN,NaN,-20.74371570843656,-20.707737819317668
2008-11-19T09:30:00-05:00,44.78,45.14999,41.24001,41.36,96010192,90662011.2,32.76709267768132,41.12497586803874,NaN,NaN,-160.12309384357948,-115.9269273737148,-0.28189039363618207,-3.3079349503767332,-3.026044556740551,874061204,1063183706.4,30.66216612858986,39.74397276921977,NaN,NaN,-22.838287853516427,-21.01210210991749
2008-11-20T09:30:00-05:00,41,41.92999,38.44,38.53,140071056,91005436,29.625277516098777,39.874954736064346,NaN,NaN,-191.37798219432133,-136.7113956507661,-0.5712224684454386,-3.740072642297349,-3.1688501738519106,733990148,959765981.6,25.699609393750578,39.76714951194531,NaN,NaN,-25.65101104428474,-21.674803386255668
2008-11-21T09:30:00-05:00,39.28999,40.85001,37.12,40.64,160640192,93749973.6,34.65598688282439,38.975394923910315,NaN,NaN,-165.66692484733946,-151.50845402366912,-0.5590807091357965,-3.8677010602716564,-3.30862035113586,894630340,908216621.6,23.645323452813855,38.956783180369996,NaN,NaN,-26.45802178010696,-22.358120299662996
2008-11-24T09:30:00-05:00,41.2,44.03999,40.73,43.5,97053568,93631527.2,40.830190721475766,38.43425853455527,NaN,NaN,-94.8284861181765,-147.6338551206532,-0.30947997631569546,-3.695470321530479,-3.3859903452147835,991683908,892887399.2,23.055144456051607,37.57732547289087,NaN,NaN,-25.18741738652889,-22.762305597786696
2008-11-25T09:30:00-05:00,44.22,44.42,42.66,44.22,80074064,91886108.8,42.308078012355296,38.33715041989306,NaN,NaN,-69.30756294454794,-136.26080998959293,-0.059993475206524316,-3.460982189222939,-3.400988714016415,1071757972,913224714.4,25.704611527472935,36.106783971993615,NaN,NaN,-23.71121284032461,-22.897863775292112
2008-11-26T09:30:00-05:00,43.27,47.03,43.2,46.87,88145120,91543689.6,47.50511921172853,38.82611509808492,NaN,NaN,-31.245335300692723,-110.48525828101558,0.2996477614677482,-3.0264290121817297,-3.326076773649478,1159903092,970393092,32.71795417088448,35.04056407316201,NaN,NaN,-20.815922272899474,-22.600443560664594
2008-11-28T09:30:00-05:00,46.28999,48.25999,46.16,47.34,24158976,88879804,48.39306386317345,39.22253226348004,NaN,NaN,0.038451305533410696,-72.20197158104465,0.5696733994535368,-2.613985024332557,-3.1836584237860936,1184062068,1060407476,42.001625397206034,34.59468780383549,NaN,NaN,-18.209690345142413,-21.973193101304282
2008-12-01T09:30:00-05:00,46.12,46.32001,41.5,42.02,89163936,87684866.4,40.12060094665258,39.159881719528194,NaN,NaN,-68.94735589828394,-52.858057791233534,0.3985718517699026,-2.6854436090737153,-3.084015460843618,1094898132,1100461034.4,45.59865549301899,34.48010008236108,NaN,NaN,-18.438165827353853,-21.46818920502565
2008-12-02T09:30:00-05:00,42.71001,44.33,41.96001,44.23,84878320,89185146.4,44.374534419745366,39.52026398898018,NaN,NaN,-58.154263145817666,-45.52321319676176,0.43958833869791736,-2.534530037471221,-2.9741183761691383,1179776452,1138079543.2,48.8098026391527,34.83244372498041,NaN,NaN,-17.25482518751917,-20.86628005966758
2008-12-03T09:30:00-05:00,43.14999,45.89,43.02,45.57001,102869744,90344589.6,46.84054116830572,40.347684700372206,NaN,NaN,-22.92557608123535,-36.24681582409924,0.5548835082018009,-2.2805139909168872,-2.835397499118688,1282646196,1180257188,52.21547803443905,35.65047998096252,NaN,NaN,-15.51652966518357,-20.102030003312723
2008-12-04T09:30:00-05:00,44.82001,46.45,43.25999,44.06,101436816,91722246.4,44.449202729894076,40.40707967122531,NaN,NaN,-21.51652201068512,-34.301053166097724,0.5275448436351922,-2.175966444574698,-2.70351128820989,1181209380,1184518445.6,52.558886870372746,36.48482720293753,NaN,NaN,-14.80625015926769,-19.345490025592003
2008-12-05T09:30:00-05:00,43.37,46.27,42.34,46.10001,113953872,93158252.8,48.29007780025986,41.11407174683846,NaN,NaN,-6.438939304335051,-35.596531288071425,0.6375907946173309,-1.9065227949382262,-2.544113589555557,1295163252,1206738682.4,54.39920217649519,37.60940360145129,NaN,NaN,-13.028726625010314,-18.443095254080333
2008-12-08T09:30:00-05:00,47.23,48.57001,46.97,48.14,99340432,95009622.4,51.87355075691682,42.114115444346744,NaN,NaN,92.58500047261272,-3.290060013892088,0.8265234957047651,-1.510959219924601,-2.337482715629366,1394503684,1266659792.8,59.016255174604474,39.24734388084401,NaN,NaN,-10.422450727719907,-17.2972888931717
2008-12-09T09:30:00-05:00,47.69,49.41,46.28,46.649,81957936,96584511.2,49.190401086566176,42.94455127097701,NaN,NaN,88.45813756431359,26.032420128134163,0.8277733720816363,-1.3027660005273205,-2.1305393726089568,1312545748,1293213652,60.90530215275517,41.21357264768627,NaN,NaN,-9.046032442805819,-16.11853797169086
2008-12-10T09:30:00-05:00,47.19,48.44,46.75999,47.75,74641504,96657164.8,51.197795546980416,44.26103004735551,NaN,NaN,100.11545645145802,50.64062663467284,0.8748504910245394,-1.0369762588282825,-1.9118267498528219,1387187252,1314121863.2,62.375825790221434,43.47883405208854,NaN,NaN,-7.311853497140539,-14.860440189612243
2008-12-11T09:30:00-05:00,47.25,47.91,44.78999,45.33,73184944,96547574.4,46.81930286775503,45.489174715330954,NaN,NaN,43.47262423721981,63.63845588425382,0.7214874218852692,-1.0099674724962355,-1.7314548943815047,1314002308,1340680448.8,64.21703532879457,46.23007876173454,NaN,NaN,-7.106434898906507,-13.752725148082853
2008-12-12T09:30:00-05:00,44.16,47,44.02,46.89,97295632,94294184,49.79969648647403,46.57086825844879,NaN,NaN,45.98075086608864,74.12239391833857,0.7028817577504907,-0.8528526971933914,-1.555734454943882,1411297940,1363907386.4,65.79361219112758,49.24067081447124,NaN,NaN,-6.052924417986899,-12.652753615212003
2008-12-15T09:30:00-05:00,47.25999,47.46001,44.62,45.38,78611504,93289677.6,47.05100776213002,47.01521233278124,NaN,NaN,43.280174786197776,64.26142878105557,0.5721925264216006,-0.8404937969168813,-1.4126863233384819,1332686436,1351543936.8,64.17283816183794,52.17764893631311,NaN,NaN,-5.96782331882046,-11.697763572870354
2008-12-16T09:30:00-05:00,46.25999,48.48,46.10001,48.33,109322368,94553440,52.560012921763686,47.747493397738985,NaN,NaN,102.61570988541884,67.09294324527663,0.6614250701713713,-0.5859049856242677,-1.247330055795639,1442008804,1377436548,66.05861035942164,55.06007742430945,NaN,NaN,-4.219442174616785,-10.629431944548415
2008-12-17T09:30:00-05:00,47.94,49.50999,47.57001,48.77,81545632,93717790.4,53.339802447685315,48.16425648602161,NaN,NaN,119.75421987281882,71.0206959295488,0.7221327468447121,-0.34466412223974885,-1.066796869084461,1523554436,1404709984.8,67.97096892392504,57.57814990666949,NaN,NaN,-2.5705187805766267,-9.478158635409589
2008-12-18T09:30:00-05:00,48.8,49.66,47.32001,48.46001,87889936,93311777.6,52.6827785018671,48.47066467449973,NaN,NaN,104.21356162882061,83.16888340786895,0.7122706964380523,-0.17645849853689555,-0.8887291949749478,1435664500,1429042423.2,69.6157879898854,59.55059009186088,NaN,NaN,-1.396248712555408,-8.323600075001849
2008-12-19T09:30:00-05:00,49,50.00999,48.21001,48.7,88222064,90719328,53.16377490062527,49.40231995692635,NaN,NaN,115.53172444538508,97.07907812372824,0.6921689229907415,-0.023518041236521015,-0.7156869642272625,1523886564,1451560148,71.09513103226543,61.37176691609277,NaN,NaN,-0.2901553496761513,-7.175965114241035
2008-12-22T09:30:00-05:00,48.92,48.94,46.12,47.75999,75339008,86454268.8,50.97788436641947,49.87398781026021,NaN,NaN,60.043748701103276,100.43179290670933,0.5898204214069518,0.021588562531427158,-0.5682318588755246,1448547556,1474732372,72.57491006845027,63.06927458961402,NaN,NaN,0.08502718539914421,-6.138680500006724
2008-12-23T09:30:00-05:00,47.73,48,46.34,46.71001,64585120,84830846.4,48.575391299758785,49.997905676792584,NaN,NaN,29.552316201316604,85.81911416988888,0.4329241930482029,-0.02707661756527102,-0.4600008106134739,1383962436,1463123098.4,70.62416200263168,64.38418058734206,NaN,NaN,-0.22829340623139713,-5.294339486610249
2008-12-24T09:30:00-05:00,46.73,47.11,46.16,46.88,19514432,81802864.8,48.99449779713813,50.32256961016715,NaN,NaN,10.681220013997718,64.00451419812467,0.3269321793813971,-0.05133558638672753,-0.37826776576812465,1403476868,1439107584.8,66.63407324592046,65.38955104273833,NaN,NaN,-0.3859156603853506,-4.593136082863835
2008-12-26T09:30:00-05:00,47.35001,47.67,46.73,47.55,25105168,78650867.2,50.6999398184007,50.49470261146293,NaN,NaN,36.063034176334504,50.37440870762744,0.2895665433219812,-0.016309586615648186,-0.30587612993762936,1428582036,1437691092,66.39579904255297,66.24645081888532,NaN,NaN,-0.09238492499230457,-3.950171631739331
2008-12-29T09:30:00-05:00,47.36,47.58,45.9101,46.82001,41446592,79515248,48.78594208570774,50.274159134947986,NaN,NaN,10.788451609720937,29.42575414049461,0.2071692877254117,-0.046914520280864735,-0.25408380800627645,1387135444,1410340868,61.80059775722941,66.44533243192996,NaN,NaN,-0.3222532706183572,-3.4318975801506206
2008-12-30T09:30:00-05:00,47.08,48.2,46.77,48.12,38842192,76999160.8,52.243535534184794,50.492240166920745,NaN,NaN,52.0575876980594,27.82852193988583,0.22994288618759656,0.03334479972821924,-0.19659808645937732,1425977636,1405826884,61.04961378216329,66.4556404054591,NaN,NaN,0.36373001916693043,-2.889665065962399
2008-12-31T09:30:00-05:00,48.22,50.32001,48.14,49.24001,75370496,76523769.6,55.058658333240025,50.768016080225,NaN,NaN,132.95351456342507,48.508761612307524,0.3054317193286203,0.18519156270139803,-0.12024015662722225,1501348132,1429304023.2,63.53173474321753,66.53820533067311,NaN,NaN,1.7113166723679292,-2.232381960486638
2009-01-02T09:30:00-05:00,49.74001,50.72,49.22,50.22,51589456,73959755.2,57.423590240664325,51.525465178289956,NaN,NaN,169.25012239094715,80.2225420876974,0.40037230097131277,0.3802252195869187,-0.02014708138439407,1552937588,1459196167.2,66.46223562942984,66.69857678071847,NaN,NaN,3.5216360885511513,-1.410379382052668
2009-01-05T09:30:00-05:00,50.49001,50.8,49.39,50.39999,59250512,71850440,57.862177601212366,52.101356686485545,NaN,NaN,165.90326769520658,106.19058879147182,0.45056125904524724,0.543054492422165,0.09249323337691774,1612188100,1495917380,69.68500271597068,66.9765332467787,NaN,NaN,5.166628338127623,-0.4708068505983408
2009-01-06T09:30:00-05:00,50.82001,51.91,50.38251,51.25,77986944,70052093.6,59.95987500578867,53.02341863246117,NaN,NaN,192.13023405743948,142.45894528101553,0.5118019691963149,0.7322456948723115,0.22044372567599652,1690175044,1556525300,74.10748493004365,67.6861508730791,NaN,NaN,7.161177137035089,0.6194765762064348
2009-01-07T09:30:00-05:00,50.27,51.34979,49.03,49.74001,77662064,68968175.2,54.74603014786856,53.179562720040096,NaN,NaN,106.77786488972298,153.40300071934826,0.42498317739534924,0.7516726974201831,0.3266895200248338,1612512980,1593832368.8,76.39065820628701,68.42415429071234,NaN,NaN,7.5732275789843815,1.6128695766032841
2009-01-08T09:30:00-05:00,49.38,50.14999,49.17,49.98,59215888,67831072.8,55.40968411124309,53.32741141029421,NaN,NaN,81.64241683582688,143.14078117382863,0.36062575538860675,0.7774717142605923,0.4168459588719855,1671728868,1627908516,78.27503505593279,69.16015901442718,NaN,NaN,8.094151882387232,2.5387670488581335
2009-01-09T09:30:00-05:00,50.11,50.19,47.92,48.13,82730064,68235500.8,49.39600684399613,53.092642006160574,NaN,NaN,27.6516449222334,114.82108568008587,0.17952018898112898,0.6412461950983968,0.4617260061172678,1588998804,1635120759.2,78.66320124367212,69.80640281826909,NaN,NaN,6.8988168484306005,3.1616313059399146
2009-01-12T09:30:00-05:00,47.95,48.11,46.5,46.7,53722304,67262368.8,45.303104353030726,52.53116553847525,NaN,NaN,-59.48894396605964,69.74264334783263,-0.03887274351594716,0.41313507672233385,0.452007820238281,1535276500,1619738439.2,75.56221760124893,70.12548043033934,NaN,NaN,4.65590246733853,3.3750986147111455
2009-01-13T09:30:00-05:00,46.63,47.61,46.41,47.32001,62646704,65529922.4,47.34044694672602,52.271348579925714,NaN,NaN,-64.83384620312388,18.34982729571994,-0.13827270845447553,0.2791669346701866,0.41743964312466214,1597923204,1601288071.2,71.90095890858771,70.07734106177773,NaN,NaN,3.3187169424050285,3.3670440900959857
2009-01-14T09:30:00-05:00,46.32001,46.67,45.12,45.24001,74647936,65331744,41.72542475543961,51.78206525533149,NaN,NaN,-141.82914831978206,-31.371575346181068,-0.3298726552035215,0.0050988241202603035,0.3349714793237818,1523275268,1583440528.8,68.44608345322574,69.92176402253445,NaN,NaN,0.40927746762303024,2.944506001171278
2009-01-15T09:30:00-05:00,45.31,46.52,43.81,45.97,100641008,64897676,44.225720331326904,51.44143829348783,NaN,NaN,-136.8011804422193,-75.0602948017903,-0.38913893486984386,-0.151452189263523,0.23768674560632083,1623916276,1573878010.4,66.59958982650117,69.91930092114735,NaN,NaN,-1.313533037038377,2.33621470999847
2009-01-16T09:30:00-05:00,46.98,47.03,44.97,46.48,80512624,64846025.6,45.96987952017757,51.10357684361475,NaN,NaN,-90.06129925337142,-98.60288363691129,-0.3755065209408564,-0.23169640556974969,0.14381011537110672,1704428900,1596964029.6,68.78872308696151,70.09022406717654,NaN,NaN,-2.2634014503731335,1.6791266870882406
2009-01-20T09:30:00-05:00,45.88,46.25,43.31,43.33,85180368,64710547.2,38.05432666372415,50.33703288490164,NaN,NaN,-154.51879399390938,-117.60885364248122,-0.5496140460676344,-0.5432074422134363,0.006406603854198112,1619248532,1613758436,70.31307721523113,70.69825831417667,NaN,NaN,-5.696506626769613,0.6254647851085473
2009-01-21T09:30:00-05:00,44,45.69,43.03999,45.49001,66088496,63603868.8,45.04251540157011,49.82267430400059,NaN,NaN,-122.743339401571,-129.19075228217065,-0.4921412090664399,-0.6087699074788517,-0.11662869841241186,1685337028,1631241200.8,71.85413550811937,71.47000986603067,NaN,NaN,-6.412231235662603,-0.3799203607159025
2009-01-22T09:30:00-05:00,44.52,45.33,43.37,44.17,69790816,63326459.2,41.929511976753034,48.8848781356801,NaN,NaN,-124.29964540217152,-125.68485169864854,-0.5134961656989055,-0.7584989055360438,-0.24500273983713824,1615546212,1649695389.6,73.42246773258094,72.17649079384235,NaN,NaN,-8.019046636137944,-1.4712241143476226
2009-01-23T09:30:00-05:00,43.03999,45.00999,42.86,44.39,76443936,63919400,42.641034117141466,47.82898126971418,NaN,NaN,-118.39895222996194,-122.00440605619706,-0.48368919203167765,-0.8496142298767353,-0.36592503784505764,1691990148,1663310164,74.5492108150693,72.75413187853088,NaN,NaN,-9.079182130199044,-2.558075259469254
2009-01-26T09:30:00-05:00,44.36,45.87,44.17999,44.89,62971936,66092275.2,44.31109994411527,46.8610471513501,NaN,NaN,-79.29653098436201,-119.8514524023952,-0.40440607105937965,-0.8714326266692822,-0.4670265556099026,1754962084,1673416800.8,75.38350154210086,73.16116750896876,NaN,NaN,-9.45772057340792,-3.5437388757462065
2009-01-27T09:30:00-05:00,45.07001,45.82001,44.72,45.38,54940496,67584041.6,45.971326442215,45.861865111094836,NaN,NaN,-61.95456868569767,-101.33860734075284,-0.2979848650783219,-0.839507636957805,-0.5415227718794831,1809902580,1711547610.4,78.27680457940474,73.45897605535167,NaN,NaN,-9.296170336780317,-4.36551479875108
2009-01-28T09:30:00-05:00,46.25,47.49001,45.489,47.25,71043744,69063899.2,51.868674169992545,45.656339684103685,NaN,NaN,-13.456497342701068,-79.48123892897887,-0.09138526478406173,-0.6557543528595602,-0.5643690880754985,1880946324,1750669469.6,80.7736549676711,73.77204725259341,NaN,NaN,-7.373620247155145,-4.795244148523089
2009-01-29T09:30:00-05:00,46.59,47.2332,45.25,45.39999,66446432,70444111.2,46.46515191224104,45.01744452703211,NaN,NaN,-36.59633147369636,-61.940576143283806,-0.07002014222392439,-0.6518942658554039,-0.5818741236314795,1814499892,1790460205.6,82.92353380054945,74.10408287720887,NaN,NaN,-7.346748993508285,-5.159744840663832
2009-01-30T09:30:00-05:00,45.75999,46.00999,44.11,44.48,58187696,69584971.2,44.00979378387877,44.63271502273801,NaN,NaN,-67.35010007433678,-51.730805712158784,-0.10636510297671276,-0.7148305023523704,-0.6084653993756577,1756312196,1803324615.2,83.56344628886467,74.45410038043691,NaN,NaN,-8.073990356593711,-5.576065628653814
2009-02-02T09:30:00-05:00,43.66,45.14,43.64,44.84,62908752,70150936,45.22945337918745,44.627454238892064,NaN,NaN,-73.24272490484547,-50.52004449625548,-0.09504796392497705,-0.7272753542818791,-0.632227390356902,1819220948,1816176388,84.20042631570108,75.07111528861208,NaN,NaN,-8.311316277815715,-5.966815721391229
2009-02-03T09:30:00-05:00,45.28,45.58,44.45,45.16,57460864,70061453.6,46.34822849234858,44.55658149215082,NaN,NaN,-49.97442554939845,-48.124015868995635,-0.05678648023055133,-0.7032104906450911,-0.6464240104145398,1876681812,1829532234.4,84.85719790520123,75.99656093122734,NaN,NaN,-8.191702560973894,-6.284656698474467
2009-02-04T09:30:00-05:00,45.21001,46.12,44.53,44.83,65084176,69416315.2,45.320128168176055,44.813346021632,NaN,NaN,-41.21528513548336,-53.67577342755209,-0.04499458711846549,-0.7026672443126216,-0.6576726571941561,1811597636,1815662496.8,81.08751771443372,76.89952052131362,NaN,NaN,-8.372240763870872,-6.582882993531096
2009-02-05T09:30:00-05:00,44.44,46.00999,44.2,45.35001,71625120,69114468,47.30377476853138,45.033207052860895,NaN,NaN,-33.985944785787865,-53.15369608997039,0.003936733082845034,-0.6527517408405998,-0.6566884739234449,1883222756,1829407069.6,81.94356078375763,77.99551844683194,NaN,NaN,-7.990874917809634,-6.784024696999459
2009-02-06T09:30:00-05:00,45.42,47.17,45.21001,46.96001,53778032,68842575.2,52.990021859453684,45.53464579138061,NaN,NaN,61.77690040976641,-27.328295993149755,0.14313290878688423,-0.47777233793983953,-0.6209052467267238,1937000788,1865544788,83.99482529801487,79.08166860476432,NaN,NaN,-6.016350555397554,-6.674356962484901
2009-02-09T09:30:00-05:00,46.78999,47.14,46.22,46.75,55266272,67469385.6,52.19878699737846,46.54496438664164,NaN,NaN,101.3221585652759,7.584680700874523,0.21513343848129318,-0.35198844862510725,-0.5671218871064004,1881734516,1878047501.6,84.64476671448665,80.10536071185399,NaN,NaN,-4.590477800616327,-6.376659939360819
2009-02-10T09:30:00-05:00,46.39,47.10001,44.45,44.59,83914816,68979011.2,44.79082366661391,46.52698640557333,NaN,NaN,-2.5488097472306763,17.06980386130808,0.11630851341990744,-0.4217362453315161,-0.5380447587514235,1797819700,1862275079.2,80.21918041480116,80.70286391947411,NaN,NaN,-5.454617499692435,-6.244939590836765
2009-02-11T09:30:00-05:00,44.88,45.19,44.09,44.75999,58424512,68767901.6,45.44698625783015,46.77823456850741,NaN,NaN,-64.58496113769239,12.395868660866276,0.0640234965184091,-0.45801538810341214,-0.5220388846218212,1856244212,1871204394.4,80.83025125478915,81.23199131391756,NaN,NaN,-5.9743547785230025,-6.206284617649085
2009-02-12T09:30:00-05:00,44.10001,45.21001,43.47,45.14,79212816,68996145.6,46.96446796239523,47.087051271739824,NaN,NaN,-66.31520607340565,5.930016403342722,0.05690672266234165,-0.4509054812938942,-0.5078122039562358,1935457028,1881651248.8,81.54843020205817,81.73193555584534,NaN,NaN,-5.9906888730403995,-6.17548522556213
2009-02-13T09:30:00-05:00,45.08,45.7,44.58,44.67,58902512,66909220.8,45.286584478032196,47.15672873844817,NaN,NaN,-24.123329759871137,-11.250029630584788,0.02409824718467457,-0.47768939497539264,-0.5017876421600672,1876554516,1869561994.4,77.91084781889353,81.91246028990194,NaN,NaN,-6.462679707642168,-6.216513008716421
2009-02-17T09:30:00-05:00,43,43.62,42.83,42.89999,81543568,66960768,39.55521176359305,46.698434832832326,NaN,NaN,-200.88334390274554,-71.69113012418907,-0.10611194055998141,-0.634427567860044,-0.5283156273000625,1795010948,1852217280.8,72.887398966923,81.52750274615326,NaN,NaN,-8.583534963460913,-6.5546590022513485
2009-02-18T09:30:00-05:00,43.25,43.34,42.13,42.28999,78279440,66615721.6,37.78062584652443,45.69214566687031,NaN,NaN,-219.92010845378752,-115.16538986550044,-0.2162748225832254,-0.7986591555290943,-0.5823843329458689,1716731508,1835999642.4,68.44371858159738,80.64679300429086,NaN,NaN,-10.891891944268048,-7.174263708253734
2009-02-19T09:30:00-05:00,42.78,43,41.63,41.7,64546224,66538608,36.09396631658655,44.951346695752136,NaN,NaN,-209.1300924999215,-144.07441613794626,-0.306327595928396,-0.9652938278563639,-0.6589662319279679,1652185284,1795187856.8,58.738681046135525,78.91930352183272,NaN,NaN,-13.335651800692643,-8.054462007173578
2009-02-20T09:30:00-05:00,40.89999,41.64,40.19,41.14,83390816,67218608,34.51874585402469,44.27341470076255,NaN,NaN,-229.8569587876009,-176.7827666807853,-0.3764429532750867,-1.1295199235218263,-0.7530769702467396,1568794468,1721855344.8,46.091811279266906,76.2427581640043,NaN,NaN,-15.863591228733153,-9.170051895967802
2009-02-23T09:30:00-05:00,41.38,41.45,39.47,39.56,78809936,67336908,30.47729831776344,43.21968933923227,NaN,NaN,-214.38290127408493,-214.8346809836281,-0.4946223890905219,-1.371354956609892,-0.87673256751937,1489984532,1644541348,37.037644981980364,72.87398806873854,NaN,NaN,-19.380079217782846,-10.628627227655665
2009-02-24T09:30:00-05:00,40.03999,41.37,39.60001,41.02,81467184,68261670.4,37.7321159110589,42.60425272628301,NaN,NaN,-150.44792461969215,-204.7475971270174,-0.4415992543442817,-1.4287316354497221,-0.9871323811054404,1571451716,1599829501.6,33.0003341056299,69.16992636876917,NaN,NaN,-20.25921663376406,-12.004425714242577
2009-02-25T09:30:00-05:00,40.84,41.2532,39.49001,40.17,104510880,70740189.6,35.41504959142058,41.89674711365762,NaN,NaN,-136.1522127005962,-187.99401797637913,-0.430461534846716,-1.5252092996638353,-1.0947477648171193,1466940836,1549871367.2,29.173764708456133,65.46180115405647,NaN,NaN,-21.706885023053186,-13.39049132978695
2009-02-26T09:30:00-05:00,40.59,40.75,39.21001,39.42,68405008,70608252.8,33.462454814117095,40.90808140262802,NaN,NaN,-131.7167074127042,-172.51134095893568,-0.43879776453885766,-1.6432449704906915,-1.2044472059518339,1398535828,1499141476,25.89071335609154,61.458026337794614,NaN,NaN,-23.512462735636962,-14.83648724490838
2009-02-27T09:30:00-05:00,38.72,39.88,38.64,39.14999,87467056,71659284,32.76212975924676,39.46323196689895,NaN,NaN,-130.27520852035184,-152.59499090548587,-0.42727094005370203,-1.7385358810189615,-1.3112649409652595,1311068772,1447596336.8,23.052112091822437,57.104975394495156,NaN,NaN,-25.196133882345656,-16.316436764542278
2009-03-02T09:30:00-05:00,38.25999,38.42,36.82001,36.94,83629248,72931361.6,27.659626203921803,37.71043476736634,NaN,NaN,-158.66585217004265,-141.4515810846774,-0.5267297477607937,-1.9696771256662515,-1.4429473779054578,1227439524,1395087335.2,20.577110450056523,52.52871423275014,NaN,NaN,-28.38766952870645,-18.040898587994302
2009-03-03T09:30:00-05:00,37.42999,37.47,36.02,36.24001,67796944,73175771.2,26.264338193268983,36.38711437641312,NaN,NaN,-154.55615362379814,-142.27322688549862,-0.5929732085227986,-2.184163888558956,-1.5911906800361575,1159642580,1312725508,17.418153067294284,48.04292656507108,NaN,NaN,-31.460377037179697,-19.95796693787793
2009-03-04T09:30:00-05:00,36.78999,37.64999,36.22,36.99001,80122880,74308872,30.32015951991538,35.30662675227635,NaN,NaN,-126.7334715987811,-140.38947866513558,-0.5410388613852084,-2.267489256767668,-1.7264503953824595,1239765460,1267290432.8,15.962339128439467,43.40950427033182,NaN,NaN,-32.79015076083779,-21.791136055443626
2009-03-05T09:30:00-05:00,36.25,36.689,34.92,35.02,97997872,75954556.8,26.237724748646414,33.82614509415144,NaN,NaN,-140.36920402820763,-142.11997798823626,-0.5901069847898195,-2.464084126369734,-1.8739771415799145,1141767588,1215936784.8,14.488371098357419,38.61950004863892,NaN,NaN,-35.30529242891763,-23.72172982308277
2009-03-06T09:30:00-05:00,35.39999,35.88,34.32001,35.2,76042496,76175425.6,27.20220810305881,32.53440392451048,NaN,NaN,-133.61310882251595,-142.78755804866907,-0.5613556793078427,-2.575671740714718,-2.014316061406875,1217810084,1197285047.2,13.98332091207621,34.053248126723396,NaN,NaN,-37.00909474084552,-25.61992481133459
2009-03-09T09:30:00-04:00,34.73,35.64,34.25999,34.39,75741056,77273576.8,25.581223317851652,31.53626189267181,NaN,NaN,-129.38244793081927,-136.9308772008244,-0.5472358983910324,-2.698360934395666,-2.1511250360046335,1142069028,1180210948,13.518747224498355,29.812630145121634,NaN,NaN,-38.93327714184265,-27.52183228712146
2009-03-10T09:30:00-04:00,35.25,36.81,35.10001,36.63,76186192,78319572.8,36.7976756045352,31.466051161101152,NaN,NaN,-89.26986753476406,-123.87361998301758,-0.3471359199086712,-2.5850449358904726,-2.2379090159818014,1218255220,1191933476,15.592204093134583,26.037521967374296,NaN,NaN,-37.00919912490151,-28.87717040680432
2009-03-11T09:30:00-04:00,37.08,37.8,36.36,36.67999,82276000,78237632,37.0257914777246,31.532610101182446,NaN,NaN,-64.00465035292349,-111.32785573384606,-0.17992685710644718,-2.46281758736486,-2.282890730258413,1300531220,1204086628,17.792774946624547,23.112814388837798,NaN,NaN,-35.42605677010985,-29.812725601562253
2009-03-12T09:30:00-04:00,36.53,39.19,36.07001,38.96001,86839504,79658381.6,46.50877883227567,32.38904102820037,NaN,NaN,-31.26449423638327,-89.5069137754812,0.10062683612453416,-2.1571071851027455,-2.2577340212272796,1387370724,1253207255.2,26.170782007461426,21.689883726565977,NaN,NaN,-30.81897498023043,-29.956475512800562
2009-03-13T09:30:00-04:00,39.33,39.66,38.75999,39.37,72449872,79320234.4,48.02443592330654,33.64240800002487,NaN,NaN,6.321282857658281,-61.520035439446346,0.3179453648825197,-1.8603023151241302,-2.17824768000665,1459820596,1301609357.6,33.37598979058447,21.428336927180556,NaN,NaN,-26.65069248860552,-29.484220795058413
2009-03-16T09:30:00-04:00,39.81,40.2,38.56,38.66,78042256,80277221.6,45.61404861361726,34.205403193064754,NaN,NaN,12.429549799225137,-33.15763589343748,0.4120373141387583,-1.6632010373332022,-2.0752383514719606,1381778340,1349551220,39.65766805689973,21.90386078084268,NaN,NaN,-23.929723747210105,-28.69072121679437
2009-03-17T09:30:00-04:00,38.73,40.45,38.42999,40.45,64728272,79436456.8,52.13646732007082,35.39979017368263,NaN,NaN,40.65291984239707,-7.173078418005249,0.5825658183579272,-1.3470310785245516,-1.9295968968824788,1446506612,1395201498.4,44.97750600833931,23.032699445120052,NaN,NaN,-19.400635199642608,-27.363566071486975
2009-03-18T09:30:00-04:00,40.25999,42.17999,39.91,41.85001,111491744,81097072,56.52780013078693,37.04731483915906,NaN,NaN,97.81350175703041,25.19055200398553,0.7658478523763159,-0.9722870814120839,-1.7381349337883998,1557998356,1446694925.6,50.30011704777564,24.77622828024035,NaN,NaN,-14.0988668537294,-25.46860904037875
2009-03-19T09:30:00-04:00,42.45,42.5,41.14999,41.41,64513520,81095436.8,54.8252940753541,38.62325514745243,NaN,NaN,112.72898608494259,53.98924806825071,0.8283443047650492,-0.7027045528320883,-1.5310488575971375,1493484836,1467917748,52.346176442392796,26.86866144813823,NaN,NaN,-10.358455756906796,-23.310015714168472
2009-03-20T09:30:00-04:00,41.8,41.92,39.95,39.98,68437056,80347748.8,49.597216114236126,40.190225855332024,NaN,NaN,76.28810151460729,67.98261179964051,0.7467917140589428,-0.597559215023459,-1.3443509290824018,1425047780,1460963184.8,51.59656694796123,29.084336912274285,NaN,NaN,-8.779527935855723,-21.23423174583808
2009-03-23T09:30:00-04:00,41.34,43.52,40.92999,43.38,94777248,81146114.4,59.48876188010185,42.563398975820085,NaN,NaN,134.98278413924714,92.49325866764491,0.8857643222613256,-0.2371455262557447,-1.1229098485170703,1519825028,1488572522.4,54.389046960296895,31.725115047488753,NaN,NaN,-3.768074863506367,-18.73906647693355
2009-03-24T09:30:00-04:00,42.7,43.11,41.50999,41.56,70570320,80601271.2,53.4426675070328,44.21500668918562,NaN,NaN,110.6216816161222,106.48701102238992,0.8205256379028316,-0.09725280113853074,-0.9177784390413624,1449254708,1489122141.6,54.44538955415261,34.47390436361112,NaN,NaN,-1.7793121778095242,-16.316244434201547
2009-03-25T09:30:00-04:00,41.95,43.28,40.81,42.73,95016368,80126545.6,56.50319645605475,46.37682609685765,NaN,NaN,109.61752909226676,108.84781648943722,0.8196558621440081,0.10679138863864779,-0.7128644735053603,1544271076,1486376685.6,54.0859799580648,37.30230499644737,NaN,NaN,0.8727432694475649,-13.860674762251675
2009-03-26T09:30:00-04:00,43.32001,44.47,42.87,44.38,111107440,82261667.2,60.451588040416354,48.751781806668895,NaN,NaN,141.9219627161786,114.68641181568441,0.887941183468295,0.3970620058300085,-0.4908791776382865,1655378516,1518755421.6,57.63769585500731,40.42047463522816,NaN,NaN,4.431947319460043,-11.247443036292857
2009-03-27T09:30:00-04:00,43.62,44,42.83,42.89,78135808,81795104.8,55.54795505755909,50.89226264521943,NaN,NaN,108.37253523164041,121.10329855909103,0.793580688550829,0.5010966830502497,-0.29248400550057924,1577242708,1549194407.2,60.71437057527945,43.79159058885538,NaN,NaN,5.6742019543114095,-8.830065180492248
2009-03-30T09:30:00-04:00,41.64999,41.81,40.78011,41.66,59094352,80568360,51.81165910655138,51.96469003822058,NaN,NaN,54.12737117229748,104.93221596570109,0.6170073417315249,0.4787751716638269,-0.138232170067698,1518148356,1548859072.8,60.662100627051636,47.01086891270659,NaN,NaN,5.428811562147043,-6.793082788686635
2009-03-31T09:30:00-04:00,42.17,43.31,41.61,42.05,66096752,80483350.4,52.893584785272424,53.09810384590257,NaN,NaN,71.13104134354109,97.03408791118486,0.5001391695267067,0.4869417918406853,-0.013197377686021333,1584245108,1575857152.8,63.39451285097782,50.26813590587468,NaN,NaN,5.575118212460025,-5.026196931379969
2009-04-01T09:30:00-04:00,41.34,43,41.11,42.78,66465312,79800472,54.93323086693085,53.699850419806516,NaN,NaN,64.36088003737632,87.98275810020678,0.4473775541541857,0.5460245650067108,0.09864701085252511,1650710420,1597145021.6,65.433322501731,53.07260308403679,NaN,NaN,6.318028198459283,-3.405593341402933
2009-04-02T09:30:00-04:00,44.12,45.57001,43.82001,44.92,92901808,79545668.8,60.3527793300565,54.58044637743151,NaN,NaN,122.50070052255293,84.09850566148164,0.526525779757832,0.756804235549815,0.23027845579198308,1743612228,1614791764,67.07063253384793,55.47936327998418,NaN,NaN,8.710802708474105,-1.6746796199919276
2009-04-03T09:30:00-04:00,44.86,45.64,44.36,45.63,50769584,78282023.2,61.98612491133206,55.74988039869685,NaN,NaN,128.54860661252818,88.1337199376592,0.5917441393781239,0.9699586300146379,0.378214490636514,1794381812,1658219584.8,70.74333899536371,57.69976834701732,NaN,NaN,11.16718483622879,0.15987244518246047
2009-04-06T09:30:00-04:00,44.99001,45.11,44.03,44.85001,63428704,77666405.6,59.10536157044019,56.247658559437525,NaN,NaN,110.28789606554167,99.36582491630803,0.5483762891840246,1.0636848521165447,0.5153085629325201,1730953108,1700780535.2,73.82457228335747,59.76027308094719,NaN,NaN,12.32758311038085,1.8981168259250876
2009-04-07T09:30:00-04:00,44.08,44.46001,43.12,43.25999,48411904,76277691.2,53.63335860106663,56.040912735886074,NaN,NaN,70.17543527504445,99.1747037026087,0.38627803800148197,0.9981561104343726,0.6118780724328906,1682541204,1720439754.4,75.12760995680958,61.53366543159247,NaN,NaN,11.636311562302492,3.289287502550431
2009-04-08T09:30:00-04:00,43.50999,44.23,43.19,44.06,60266384,75177210.4,55.848213301622124,56.11397839490521,NaN,NaN,73.66859070827363,101.03624583678817,0.3099050551206489,0.9992593913337018,0.6893543362130529,1742807588,1738859188,76.31718331311023,63.245880208072286,NaN,NaN,11.727686465338454,4.494773068663005
2009-04-09T09:30:00-04:00,45.28,46.71001,45.10001,46.64,66702064,74170338.4,62.1307530494688,57.009231033136125,NaN,NaN,157.47039994744165,108.0301857217659,0.40415507471072154,1.1945481796014548,0.7903931048907332,1809509652,1752038672.8,77.15895913060126,65.07176536397515,NaN,NaN,13.83614958736791,5.829255428477992
2009-04-13T09:30:00-04:00,46.25999,47,45.67,46.66,58559856,73475837.6,62.17568476590832,57.20115409640801,NaN,NaN,148.81768826436212,112.0840020521327,0.4361131744243658,1.3355345729211905,0.8994213984968247,1868069508,1766776212,78.09649507992664,66.76515451537726,NaN,NaN,15.50717886271023,7.211815919082597
2009-04-14T09:30:00-04:00,45.96001,46.52499,45.23,45.31,56583488,72402899.2,57.23888030139225,57.472312153147975,NaN,NaN,106.79565241702235,111.38555332242883,0.3389284195879061,1.3230819229817072,0.9841535033938011,1811486020,1782882794.4,79.10588536515534,68.52661850187746,NaN,NaN,15.434498237712901,8.38648482174407
2009-04-15T09:30:00-04:00,45.00999,46.1499,44.89,46,48441680,71588569.6,59.029473378253975,57.652760504733635,NaN,NaN,96.98613365128408,116.74769299767677,0.2953095586326393,1.3532904516846003,1.057980893051961,1859927700,1818360093.6,81.16483947486769,70.46082275307768,NaN,NaN,15.903336681235352,9.460320801671395
2009-04-16T09:30:00-04:00,46.53,47.69,45.75999,47.33,66307568,69329360.8,62.30595551603923,57.78521532442098,NaN,NaN,135.20736322147783,129.0554475003176,0.32772156961051513,1.467632855065105,1.1399112854545899,1926235268,1855045629.6,83.02736010729379,72.27437019966956,NaN,NaN,17.29080632029006,10.57896159004549
2009-04-17T09:30:00-04:00,47.42999,48.27,46.92,47.75,51982176,68702793.6,63.3039718551376,58.33921652424802,NaN,NaN,144.0170107168735,126.36476965420397,0.3472681491570806,1.5739964719009407,1.2267283227438601,1978217444,1888787188,84.54146210750879,73.97630530911452,NaN,NaN,18.721220623412343,11.742141451955039
2009-04-20T09:30:00-04:00,46.77,47,45.2,45.3,53376064,67949744,54.27628467844995,58.515261207955064,NaN,NaN,63.79048645583344,109.35932929249823,0.17377807201455608,1.4439509127620553,1.2701728407474993,1924841380,1900141562.4,85.02556636105734,75.7165528615435,NaN,NaN,17.208499298130878,12.523049715694444
2009-04-21T09:30:00-04:00,45.06,47.058,44.95,46.87,60409248,66231344,58.373026797373136,58.906649923105114,NaN,NaN,75.75693609000507,103.15158602709478,0.14454192789257236,1.4508502506132146,1.3063083227206422,1985250628,1934894484,86.42666831572356,77.36170682331105,NaN,NaN,17.200890719292065,13.19131271620839
2009-04-22T09:30:00-04:00,46.19,48.16,46.03,46.86,72788816,66342268.8,58.33717362988346,59.149788691887444,NaN,NaN,98.36887585666325,103.42813446817061,0.10609261218669164,1.4389240879540068,1.3328314757673152,1912461812,1945401306.4,86.8279393480724,78.88989374090686,NaN,NaN,17.184184493834735,13.761722970155011
2009-04-23T09:30:00-04:00,47.10001,47.21001,45.92999,46.75,70031744,65093037.6,57.91577843100314,58.975717199097915,NaN,NaN,74.6254280586526,91.31174743560555,0.05726066277932684,1.4044073042414738,1.347146641462147,1842430068,1928640266.4,82.63122147345841,80.00136437945048,NaN,NaN,17.051384986613144,14.231674686791887
2009-04-24T09:30:00-04:00,47.12,48.28,46.67,47.62,60773616,62576346.4,60.35496095476637,58.85920548791466,NaN,NaN,104.17940932365592,83.34422715696203,0.06689173310001517,1.430761307837166,1.3638695747371508,1903203684,1913637514.4,78.95271114843435,80.5877481046698,NaN,NaN,17.621088874024572,14.715876713539414
2009-04-27T09:30:00-04:00,46.84,47.78999,46.61,47.11,49385456,61138828.8,58.22453408895866,58.7962892392374,NaN,NaN,82.10674259698621,87.0074783851926,0.024440579089617165,1.3944202985991723,1.369979719509555,1853818228,1899432884,75.52456196539742,80.70917593910123,NaN,NaN,17.513131314035984,15.115484513610353
2009-04-28T09:30:00-04:00,46.53999,47.99001,46.38,47.17999,51197744,60743998.4,58.44133730574222,59.139716289571375,NaN,NaN,80.10783685204669,87.87765853760092,-0.011471442676665555,1.3556404161637232,1.3671118588403888,1905015972,1883385952.8,71.73515340007474,80.46685761362018,NaN,NaN,17.48056422234024,15.453353043428908
2009-04-29T09:30:00-04:00,47.81,49.57001,47.63,48.97,79881872,61433254.4,63.63875176349425,59.69618332256225,NaN,NaN,152.03616161765487,98.61111568979925,0.06839150834435359,1.4526012442708307,1.3842097359264771,1984897844,1897873159.2,73.04983904519213,80.23347588019746,NaN,NaN,18.923310094027,15.94906119351435
2009-04-30T09:30:00-04:00,49.75,50.24001,48.45,48.52,67811568,61500567.2,61.554606037223834,59.655029964544745,NaN,NaN,163.20107850934934,116.3262457799386,0.07352533830482333,1.4761164088075063,1.402591070502683,1917086276,1912804400.8,74.37287351460387,80.03446976476906,NaN,NaN,19.559324912905275,16.46481315342734
2009-05-01T09:30:00-04:00,48.64999,49.3,48.41,48.82001,64534608,60082207.2,62.43781839725536,59.67375379535525,NaN,NaN,133.526760421991,122.19571599960561,0.07924758599965354,1.50165055300225,1.4224029670025964,1981620884,1928487840.8,75.72111775004225,79.86479995549162,NaN,NaN,20.332884820262592,17.01739482011809
2009-05-04T09:30:00-04:00,49.28,50.7,49.07001,50.60001,47532912,59920373.6,67.24574185150965,60.388529620363634,NaN,NaN,176.91342534504258,141.15705254921687,0.1793075558459809,1.6465374118100726,1.4672298559640917,2029153796,1963554954.4,78.45097346056508,79.81802053373517,NaN,NaN,22.448873241958573,17.793320308952442
2009-05-05T09:30:00-04:00,50.38,50.612,49.63,50.35001,58364144,59667145.6,65.96857242861088,60.88417955253198,NaN,NaN,159.7835614119936,157.09219746120624,0.20329273761105382,1.721345777977909,1.5180530403668553,1970789652,1976709690.4,79.38726979363925,79.69105127079027,NaN,NaN,23.84358432343416,18.657643739592686
2009-05-06T09:30:00-04:00,50.92999,51.22,49.5,50.49001,87550064,61624053.6,66.35395358313552,61.17332227161029,NaN,NaN,148.95928899771948,156.4768229372192,0.202763916776578,1.7715079363375779,1.5687440195609998,2058339716,1991398064.8,80.41075068947833,79.50415059808917,NaN,NaN,25.108202061841023,19.57915207134245
2009-05-07T09:30:00-04:00,51.25,51.39999,48.89,49.3,67579504,61989709.6,60.12165188086345,60.94601370201928,NaN,NaN,108.04308499551445,145.4452242344522,0.10155764465444772,1.6956910753790595,1.5941334307246118,1990760212,2006132852,81.40804665048788,79.28033520830196,NaN,NaN,24.501036340132902,20.28227839545537
2009-05-08T09:30:00-04:00,50.14999,51.16,49.64,51.00999,63466128,61827912.8,65.18233302321497,61.72501715521678,NaN,NaN,123.05861580987616,143.35159531202925,0.12739385118769553,1.7533757447092313,1.6259818935215358,2054226340,2020653943.2,82.3611012929306,79.09001627486433,NaN,NaN,25.44712951784751,21.02011427008282
2009-05-11T09:30:00-04:00,50.05,50.66,49.78999,50.25999,40056640,60902752,61.49618825072707,61.94810011617063,NaN,NaN,93.73427339812714,126.71576492264614,0.07422227431074857,1.7187597364099716,1.644537462099223,2014169700,2017657124,81.43332996401335,78.73334924974218,NaN,NaN,25.150281213661724,21.610138119165523
2009-05-12T09:30:00-04:00,50.53999,50.82001,48.71001,49.55,49453968,60546276,58.14403907927222,61.934304791126976,NaN,NaN,62.98684693518136,107.3564220272837,-0.023298331498262215,1.6154145477263953,1.6387128792246575,1964715732,2016442340,81.03484328974525,78.31955667414738,NaN,NaN,23.907047013861405,21.938267961264934
2009-05-13T09:30:00-04:00,48.7,48.81,47.21001,47.28,68822128,61565298.4,48.95570536398627,61.29429957205434,NaN,NaN,-29.80234096633592,71.6040960344726,-0.24300695027869912,1.3349541913762835,1.5779611416549826,1895893604,1983953117.6,71.0245856658844,77.49051125932066,NaN,NaN,19.76711240501822,21.62810288180112
2009-05-14T09:30:00-04:00,47.39,48.75,47.06,47.94,72813632,61890601.6,51.362323283447104,60.65196830981724,NaN,NaN,-25.9002253714348,44.815433961082746,-0.3402435425860073,1.1526567134224734,1.4929002560084808,1968707236,1979542522.4,69.76464123828497,76.83422055145284,NaN,NaN,17.11799438047872,20.983801667326492
2009-05-15T09:30:00-04:00,47.88,48.42,47.28,47.75999,53885792,61985782.4,50.6607565461275,60.111698485329306,NaN,NaN,-31.348060730153097,13.934098653076893,-0.408451730458522,0.9823355929353283,1.3907873233938504,1914821444,1951661543.2,62.24738586627662,75.88585083008708,NaN,NaN,14.775213717809452,20.0968605316812
2009-05-18T09:30:00-04:00,48.3,49.57001,48.11,49.36,55515760,62092767.2,56.365836475564365,59.96344842603089,NaN,NaN,22.486035059069906,-0.3155490147345546,-0.34036222882426626,0.9653345373635176,1.3056967661877839,1970337204,1942895044,60.05617357485871,75.0516379854288,NaN,NaN,14.445667804501753,19.289547284941282
2009-05-19T09:30:00-04:00,49.37,49.96001,48.8,49.38,55706224,61857616,56.4336493903134,59.448798256517975,NaN,NaN,37.37342804776027,-5.4382327922187725,-0.29047013276129774,0.9426091002361616,1.2330792329974594,2026043428,1955160583.2,62.06810427006312,74.26722835863386,NaN,NaN,14.202244032680293,18.562789677475426
2009-05-20T09:30:00-04:00,49.83,50.69,48.85001,48.92,48021520,60619251.2,54.34179126573881,58.9335972014119,NaN,NaN,38.86947271457176,8.296129943962763,-0.28456968253033055,0.8773671298345462,1.1619368123648768,1978021908,1971586244,64.63692756015867,73.57180364760208,NaN,NaN,13.400261293381183,17.82528562260482
2009-05-21T09:30:00-04:00,48.27,48.7,47.45,48.28999,49312880,59583308,51.52480492365321,58.15409623901174,NaN,NaN,-56.76790225732225,2.122594566785273,-0.31675270415482704,0.765995932171343,1.08274863632617,1928709028,1963586602.4,62.41983087302051,72.6217117278148,NaN,NaN,11.912935754349759,16.980664212854098
2009-05-22T09:30:00-04:00,48.53999,48.66,47.35001,47.78999,38440144,58466634.4,49.33882177198623,56.87503051904578,NaN,NaN,-74.8966792330632,-6.587129133796748,-0.3620997430071988,0.6301239575671715,0.9922237005743704,1890268884,1958676090.4,61.03585072520066,71.37777438957448,NaN,NaN,10.033547500637216,15.988218968251687
2009-05-26T09:30:00-04:00,47.37,50.16,47.32001,50.07001,73480624,59671392.8,58.07392425066256,56.311127077763764,NaN,NaN,8.274383930239528,-9.429459359562824,-0.23508088579360398,0.6983725933323655,0.9334534791259694,1963749508,1957358551.2,60.64730669205991,70.03920559660453,NaN,NaN,10.956271403415894,15.269369316132288
2009-05-27T09:30:00-04:00,49.75999,50.37,49.00999,49.10001,48210576,59522034.4,53.822137984105275,55.41599739211874,NaN,NaN,26.417528120946923,-11.620639344925493,-0.21355784946200929,0.6665061672984578,0.8800640167604671,1915538932,1935257652,54.39235207783255,68.18074855291555,NaN,NaN,10.410231134108313,14.575206718700292
2009-05-28T09:30:00-04:00,49.56,49.75,48.10001,49.16,58834176,58469649.6,54.04621810019113,54.98203783635643,NaN,NaN,-18.536394872025156,-23.101812862244877,-0.19306752590241227,0.6387296093824517,0.831797135284864,1974373108,1934527892,54.19359828451405,66.23685938391742,NaN,NaN,10.039779741632907,13.927288579119237
2009-05-29T09:30:00-04:00,49.39,50.27,49.08,50.17,51672752,57662708.8,57.76239184909011,54.45204203820465,NaN,NaN,51.98778046094645,-1.3506763185911352,-0.11323116457248683,0.6902581795692555,0.8034893441417423,2026045860,1953995258.4,58.545336957711356,64.5357333599732,NaN,NaN,10.83169209549468,13.485060510030014
2009-06-01T09:30:00-04:00,51.36,54.55,51.10001,52.13,70177312,57944844,63.868688022644754,54.62150630762734,NaN,NaN,240.63243468398014,61.75514646481753,0.06050184687898308,0.8791166527404712,0.8186148058614882,2096223172,1995186116,65.92240629454044,63.42781024072513,NaN,NaN,13.534761334190772,13.492160627767264
2009-06-02T09:30:00-04:00,51.96001,53,51.6799,52.78,56797840,58408090.4,65.64263395446274,55.15712022728381,NaN,NaN,196.7537164396118,99.45101296669198,0.20024105245730495,1.0689161214331193,0.8686750689758144,2153021012,2033040416.8,71.02541968724526,62.71285141197513,NaN,NaN,16.315928085585057,13.895555978884092
2009-06-03T09:30:00-04:00,52.31,52.50999,51.74001,52.42999,44070992,57693432.8,63.825436092019714,56.21924385071476,NaN,NaN,155.09720185520447,125.18694771354349,0.24707354716184438,1.17751700292812,0.9304434557662755,2108950020,2071722634.4,75.12469445676088,63.005716325609164,NaN,NaN,18.034597022484647,14.486847556541314
2009-06-04T09:30:00-04:00,52.75,53.25999,52.09,53.17999,42972912,55464575.2,65.99759384654003,57.26462031950712,NaN,NaN,163.80933248826202,161.65609318560092,0.3028558164175972,1.3090132262882719,1.0061574098706747,2151922932,2107232599.2,78.17699928632953,63.60659904332663,NaN,NaN,20.14405842639575,15.29502053794909
2009-06-05T09:30:00-04:00,53.69,53.78999,52.67999,53.2,50622336,54616716.8,66.05615634350752,58.3642917336057,NaN,NaN,149.69985221368654,181.19850753614895,0.31404690616858444,1.3987160425814054,1.084669136412821,2202545268,2142532480.8,80.71084606282389,64.92541762879429,NaN,NaN,21.86768241899294,16.23397223524107
2009-06-08T09:30:00-04:00,52.8,53.28,52.03999,52.57001,46326672,53759744,62.411585462852436,58.79613094698341,NaN,NaN,108.22070333860984,154.71616126707488,0.2545051951577417,1.402800630359998,1.1482954352022563,2156218596,2154531565.6,81.49727786335325,66.45692507797247,NaN,NaN,22.326196141467474,17.104289936130556
2009-06-09T09:30:00-04:00,52.84,53.27,52.56,52.81,35033680,53508596,63.24356127688935,59.28255322459598,NaN,NaN,102.13210858768967,135.79183969669046,0.20869083217787177,1.409158975424596,1.2004681432467241,2191252276,2162177818.4,82.00087640073262,67.88069451587744,NaN,NaN,22.937409955424386,17.937592796029673
2009-06-10T09:30:00-04:00,53.38,53.41,51.61,52.60001,65032560,54287525.6,61.95145465246389,59.82610060936206,NaN,NaN,78.45870339718508,120.46414000508658,0.14468984862791645,1.3813304540316196,1.2366406054037031,2126219716,2165631757.6,82.23607700559789,69.1377766191231,NaN,NaN,23.109967583421952,18.676503479942856
2009-06-11T09:30:00-04:00,52.64999,53.46001,52.58,52.62,62963776,53994608,62.030980861016815,60.576541747745175,NaN,NaN,80.54319868968685,103.81091324537155,0.08699188984433914,1.345380467709127,1.2583885778647879,2189183492,2173083869.6,82.75953918992514,70.59061292747343,NaN,NaN,23.27495841646093,19.33342561373115
2009-06-12T09:30:00-04:00,52.28,52.82001,51.89,52.78,44094880,52558670.4,62.702933656498196,61.53112116806745,NaN,NaN,60.12584742455029,85.8961122875443,0.04500600621274575,1.31464608563072,1.2696400794179743,2233278372,2179230490.4,83.1992990284648,72.17371637770658,NaN,NaN,23.583989134055976,19.940648973777556
2009-06-15T09:30:00-04:00,52.03,52.09,50.8,51.36,45943200,52161540.8,53.63138481638078,61.21379692276161,NaN,NaN,16.54546677021294,67.56106497386493,-0.0858653703325607,1.1623083665022733,1.248173736834834,2187335172,2185453805.6,83.65392092591696,73.81704596583924,NaN,NaN,21.370398781839697,20.144898946357863
2009-06-16T09:30:00-04:00,51.75,51.84,50.32001,50.5,53057504,52038628,49.00707274054728,60.8698636910789,NaN,NaN,-7.832423444028066,45.568158567521365,-0.22965436173916887,0.961105784660873,1.190760146400042,2134277668,2174058884,79.41644153818376,75.6044809272929,NaN,NaN,18.066571668918545,19.847995049580817
2009-06-17T09:30:00-04:00,50.5,51.37,50,50.77,71989248,52852779.2,50.45154187048346,60.613101103242634,NaN,NaN,-18.44164670466863,26.188088547150635,-0.3013648184968165,0.8140541232790213,1.1154189417758378,2206266916,2190068324,80.88171821951141,77.51077520836414,NaN,NaN,15.685739726168451,19.253387146236193
2009-06-18T09:30:00-04:00,50.77,51.32001,50.3,51,34318560,52167631.2,51.70651836855733,60.180538711776016,NaN,NaN,-15.320422503342032,7.01536430854487,-0.3260045006621297,0.7079133159481756,1.0339178166103054,2240585476,2200348720.8,81.77872625598391,79.1703030153836,NaN,NaN,14.010352180189841,18.504382151086713
2009-06-19T09:30:00-04:00,51.72,51.92,51.11,51.31,38711920,51637583.2,53.419026149811785,59.43413429228794,NaN,NaN,3.398131943472006,-4.330178787670781,-0.31400103706479854,0.6414165202793072,0.9554175573441057,2279297396,2209552525.6,82.5673208883001,80.35922548636643,NaN,NaN,13.026809252507318,17.72187173700394
2009-06-22T09:30:00-04:00,50.99001,51.03,49.39999,49.49001,54878592,52459505.6,43.63585744271073,57.86222168430566,NaN,NaN,-83.88724345834852,-24.416720833383046,-0.4148749148713421,0.43682391375492813,0.8516988286262702,2224418804,2216969252,83.19836003341267,81.2287212253784,NaN,NaN,9.072190884660287,16.48620304381199
2009-06-23T09:30:00-04:00,49.74001,49.94,49.02,49.09,40812624,50826105.6,41.822913441382475,56.29061292354585,NaN,NaN,-119.84709662504406,-46.819655469586245,-0.489644757992171,0.23964288113605647,0.7292876391282275,2183606180,2226834954.4,84.02666125545926,81.86457599671398,NaN,NaN,5.235348862522984,14.878938160770703
2009-06-24T09:30:00-04:00,49.57001,50.25,49.33,49.62,39962464,50413700,45.078809432946386,54.79641403686059,NaN,NaN,-100.06140586334163,-63.14360730132084,-0.4836664741880018,0.12470454639322526,0.608371020581227,2223568644,2230295300,84.31866987690799,82.30326675318386,NaN,NaN,2.9324931902769644,13.172303164985884
2009-06-25T09:30:00-04:00,49.14999,51.08,49.09,51.05299,42340128,49588997.6,52.77449231692438,53.84772374924751,NaN,NaN,-70.06153271151051,-74.09182934295454,-0.36866113431302927,0.14754460268994052,0.5162057370029698,2265908772,2235359959.2,84.75786863865292,82.59233979431451,NaN,NaN,3.2606534854586187,11.756353210767703
2009-06-26T09:30:00-04:00,50.78999,51.565,50.57001,51.23,60386704,50024695.2,53.63866879991164,53.22108684475173,NaN,NaN,-32.86702642182459,-81.34486101601387,-0.27066197395564,0.1778782695584198,0.4485402435140598,2326295476,2244759575.2,85.56587228586582,82.88295368163685,NaN,NaN,3.787408054604734,10.617932474172992
2009-06-29T09:30:00-04:00,51.33,51.58,50.39999,51.23,49197760,48975717.6,53.63866879991164,52.53502309639618,NaN,NaN,-32.13845305474201,-70.99510293529256,-0.199138706661722,0.19961686018690727,0.3987555668486293,2326295476,2265134909.6,87.15539810238572,83.25113380318349,NaN,NaN,4.212491954764527,9.702869542828926
2009-06-30T09:30:00-04:00,51.24001,51.61011,50.77,51.08,44576640,48364657.6,52.69106753981332,51.873566874064,NaN,NaN,-23.20035564355885,-51.66575473899552,-0.15707815625339766,0.20240787153188222,0.3594860277852799,2281718836,2284757440.8,88.47203128994407,83.69655910920822,NaN,NaN,4.308456590338976,8.932239121044647
2009-07-01T09:30:00-04:00,51.35001,52.25,51.31,51.87,46383040,48480260,56.99970171946696,51.514189792524725,NaN,NaN,23.594525639114703,-26.934568438504254,-0.07534253267510815,0.26530786194139466,0.3406503946165028,2328101876,2305664087.2,89.68519447527511,84.1912487724475,NaN,NaN,5.626923989925969,8.46005124517055
2009-07-02T09:30:00-04:00,50.88,50.88,49.69,49.91,51691760,48916202.4,45.84408784824697,50.30998652050677,NaN,NaN,-84.65125761165666,-29.852513418533484,-0.14835091294384,0.1552117534367028,0.3035626663805428,2276410116,2307764356,89.80130887016142,84.66282090399726,NaN,NaN,3.3119541722424906,7.724608806180828
2009-07-06T09:30:00-04:00,49.47,49.74001,48.64999,49.47,47241696,48747170.4,43.772954598408035,49.605812933508716,NaN,NaN,-137.66489629339156,-50.81208739284688,-0.2171816462582965,0.032085608557672174,0.24926725481596868,2229168420,2288338944.8,80.74744741224663,84.4552156530208,NaN,NaN,0.767242142336834,6.730699282774543
2009-07-07T09:30:00-04:00,49.37,49.5,48.35001,48.39999,40477760,48454724.8,39.14183754344343,48.90115327657272,NaN,NaN,-156.8119156371698,-75.74677990933245,-0.3194964560971469,-0.15010331530546495,0.16939314079168194,2188690660,2260817981.6,69.9823536930233,83.78135223550935,NaN,NaN,-2.9516826579710043,5.347501862668036
2009-07-08T09:30:00-04:00,48.62,48.78,47.27,48.07001,65598752,49982978.4,37.81319623716893,47.998414302764544,NaN,NaN,-178.69525040624038,-106.84575886186875,-0.3894797422022621,-0.31745653696114573,0.0720232052411164,2123091908,2229092596,60.04454692483122,82.29298285731791,NaN,NaN,-6.376906526798513,3.672586378458529
2009-07-09T09:30:00-04:00,48.28999,48.42,47.78999,47.87,41678608,48815280.8,36.99352253444335,46.94748602889926,NaN,NaN,-154.4002754965793,-142.44471908900755,-0.4263475312147251,-0.46091120877728997,-0.034563677562564885,2081413300,2179754880.8,48.5080784820951,79.91650801632584,NaN,NaN,-9.403502641213526,1.804573661362521
2009-07-10T09:30:00-04:00,47.59,48.27,47.33,48.10001,39886224,47661403.2,38.64076393465748,45.891895870673956,NaN,NaN,-143.1182507071419,-154.13811770810457,-0.4121118937223924,-0.5497035447155554,-0.137591650993163,2121299524,2148732762.4,42.923714599524715,77.08482185284188,NaN,NaN,-11.433856588545408,-0.08663066005289743
2009-07-13T09:30:00-04:00,48.28999,49.28999,47.42,49.25999,44827008,47698009.6,46.269943131434424,46.08004484843993,NaN,NaN,-86.66101870786714,-143.9373421909997,-0.306304074987397,-0.5204717447274092,-0.21416766974001225,2166126532,2136124384.8,40.86460536484836,74.06098223365872,NaN,NaN,-10.947646764163016,-1.6382043892114857
2009-07-14T09:30:00-04:00,49.25,49.72,48.95,49.55,32731088,47037404,48.01039316802587,46.522007686057314,NaN,NaN,-34.42769207733663,-119.46049747903308,-0.20346853184028246,-0.4685033345403653,-0.26503480270008284,2198857620,2138157776.8,41.353227114455045,71.01287979501556,NaN,NaN,-10.027968854548364,-2.836742169973897
2009-07-15T09:30:00-04:00,50.46001,51.62,50.25999,51.46001,57652112,47267134.4,57.72336308056359,47.425190089458546,NaN,NaN,74.61959283840113,-68.79752883010478,-0.004038401222433319,-0.2700828042281245,-0.26604440300569115,2256509732,2164841341.6,47.48537961931145,68.38193049090152,NaN,NaN,-5.884664287635557,-3.272159615354134
2009-07-16T09:30:00-04:00,51.28,52.37,51.14,52.10001,38355184,45585431.2,60.39348537398763,47.96940387924878,NaN,NaN,113.38230647156288,-15.241012436476353,0.16444102159249296,-0.06049312601507495,-0.2249341476075679,2294864916,2207531664.8,55.50181665840703,66.29221249231254,NaN,NaN,-1.5946494022249107,-3.0325152991928164
2009-07-17T09:30:00-04:00,52.25,52.27,51.73,51.89999,35685136,45653760,59.13640294111471,48.362099175049,NaN,NaN,110.42647783799227,35.46793327255049,0.2507062623170652,0.08844868028876363,-0.1622575820283016,2259179780,2235107716,59.77351484236653,64.4499012463483,NaN,NaN,1.4459220338180743,-2.3927385373341177
2009-07-20T09:30:00-04:00,52.25,52.74001,52.03,52.53999,42599488,45848138.4,61.87115846479147,48.95013415111185,NaN,NaN,129.24362984704976,78.64886298353386,0.3339557836710911,0.25518714756056227,-0.07876863611052881,2301779268,2262238263.2,63.48727369915571,62.75932093183186,NaN,NaN,4.866961895730002,-1.3556384754678148
2009-07-21T09:30:00-04:00,53.03999,53.07001,51.78999,52.45,40432640,45125840.8,61.25044647415105,49.561518360707396,NaN,NaN,112.58690343748093,108.05178208649735,0.36360362388160533,0.37573589374147787,0.012132269859872535,2261346628,2274736064.8,65.08630576811794,61.088911965987144,NaN,NaN,7.44789596592994,-0.0979906981252785
2009-07-22T09:30:00-04:00,52.22,53.21001,52.14,52.86,47557920,45463105.6,63.06836617609688,49.994994393323815,NaN,NaN,113.6944147146878,115.8667464617547,0.38918024753784547,0.49860757928217936,0.1094273317443339,2308904548,2285215028,66.4144191370518,59.42671372754262,NaN,NaN,10.160168466215062,1.3674606110661984
2009-07-23T09:30:00-04:00,52.88,54.82001,52.77,54.53,64531408,46691552.8,69.37143369856378,51.675519096917874,NaN,NaN,152.6252171720086,123.71532860184388,0.4903875785580578,0.7224118049419062,0.23202422638384834,2373435956,2300929236,68.35825097555025,57.895066735070394,NaN,NaN,14.771094515539474,3.2822654545623804
2009-07-24T09:30:00-04:00,54.17,54.87,53.96001,54.81,31295984,46139345.6,70.28707441711448,53.56938479825404,NaN,NaN,151.3710572553155,131.90424448530854,0.543869071021164,0.9118605651603033,0.36799149413913934,2404731940,2330039668,71.63355470711691,57.2440743989897,NaN,NaN,18.789324154458843,5.497559554547589
2009-07-27T09:30:00-04:00,54.8,55.22,54.42,55.09,32687104,44754365.6,71.21383369536784,55.86024166624865,NaN,NaN,145.03390915021592,135.06230034594176,0.5633937566446668,1.072233689944973,0.5088399333003061,2437419044,2357167623.2,74.30303112969321,57.55269421589469,NaN,NaN,22.37027559529415,7.907947560368527
2009-07-28T09:30:00-04:00,54.75999,55.32001,54.34,55.12,56194720,45104213.6,71.3170606437588,58.25337483814792,NaN,NaN,126.5057127453448,137.84606220751454,0.543372953021721,1.1880561245774572,0.6446831715557363,2493613764,2403621050.4,78.10308303788145,58.84258965254113,NaN,NaN,25.310582030929556,10.394038199020102
2009-07-29T09:30:00-04:00,54.82001,55.13,54.54201,54.84,47422704,45246516.8,68.83595056578008,60.527833983243404,NaN,NaN,108.33806120710918,136.77479150599882,0.47859339381481414,1.242924913824254,0.7643315200094398,2446191060,2431078352.8,79.98693204413274,61.09107919268668,NaN,NaN,27.12252177689505,12.783821567287951
2009-07-30T09:30:00-04:00,55.61,56.44,55.38,55.8,67829680,46318848.8,72.38343241801348,62.938024589197404,NaN,NaN,123.84879162306036,131.01950639620915,0.46719885724574683,1.3483300915666234,0.8811312343208766,2514020740,2459195309.6,81.72116254460857,63.86232547447838,NaN,NaN,29.807841399140717,15.215824400409774
2009-07-31T09:30:00-04:00,55.58,56.28,55.53999,55.57001,40482432,45758382.4,70.31825768522525,64.6557613430396,NaN,NaN,109.53646132079915,122.65258720930589,0.41285511659519813,1.3972001300648742,0.9843450134696761,2473538308,2472956583.2,82.51956240011222,66.8376795484258,NaN,NaN,31.464029429769784,17.536996547461204
2009-08-03T09:30:00-04:00,56.24001,56.58,55.62,56.53999,32398656,45016230.4,73.7233308778793,66.49239975088628,NaN,NaN,110.297163856976,115.70523815065792,0.41007873730295774,1.4969434350983732,1.0868646977954155,2505936964,2486660167.2,83.3017364618066,69.83400164466521,NaN,NaN,33.975956445484975,19.885419390036027
2009-08-04T09:30:00-04:00,56.21001,57.32001,56.16,57.11,41229520,45053818.4,75.50191181548644,67.76229608909505,NaN,NaN,115.32992496437427,113.47008059446382,0.41330952008469035,1.6035015979012783,1.190192077816588,2547166484,2497370711.2,83.90781401472198,72.43560410148022,NaN,NaN,36.655549423873026,22.281152252012742
2009-08-05T09:30:00-04:00,57.17,57.17,56,56.53999,54110464,44479404,70.37224221720301,68.475064435039,NaN,NaN,97.43135830232376,111.28874001350675,0.34644068359867397,1.6232429323149304,1.2768022487162565,2493056020,2506743703.2,84.44006451764173,74.50262180571129,NaN,NaN,37.40974561695899,24.442379875576492
2009-08-06T09:30:00-04:00,56.78,56.96001,55.61,55.75,52409152,45015931.2,63.89321250573156,68.81483654679735,NaN,NaN,77.8923258548077,102.09744685985622,0.22431192063277328,1.5571921495072232,1.33288022887445,2440646868,2492068928.8,79.9798135607904,75.94592885702728,NaN,NaN,36.07061752420954,26.10355668252407
2009-08-07T09:30:00-04:00,56.62,57.84,56.28999,57.09,49364928,45489866.4,69.09143959813623,69.33057091346483,NaN,NaN,101.32704091238146,100.45556277817269,0.20936923138907093,1.5945917681107886,1.3852225367217177,2490011796,2495363626.4,80.23227568024804,77.14200042710529,NaN,NaN,36.53510898340371,27.59377843979259
2009-08-10T09:30:00-04:00,56.92999,57.55,56.71001,57.19,44780592,45487545.6,69.44497179534115,69.9158941506927,NaN,NaN,99.68706755194084,98.33354351716567,0.18278091911362448,1.6136986856137483,1.4309177665001238,2534792388,2501134711.2,80.69158092259865,78.25666293813963,NaN,NaN,37.01031304547194,28.938997669175354
2009-08-11T09:30:00-04:00,56.97,57.03999,55.98,56.27,36079552,45654968.8,62.37623424412822,69.86645615555207,NaN,NaN,70.35615783329166,89.33879009094913,0.08477654741820895,1.536888450772885,1.452111903354676,2498712836,2491443981.6,77.43784941337482,79.04405081501986,NaN,NaN,35.170258709891556,29.829177817849096
2009-08-12T09:30:00-04:00,56.3,57.84,56.25999,57.12,53626160,45453671.2,65.83628105005485,69.61394525208716,NaN,NaN,90.9479703485207,88.04211250018852,0.059911566403332506,1.5270013613588418,1.4670897949555093,2552338996,2503300576.8,78.5761058208495,79.77389758968408,NaN,NaN,34.69390812513362,30.524139290318313
2009-08-13T09:30:00-04:00,57.59,57.78,56.73,57.59,43545264,45713175.2,67.61003666753491,69.42272826997433,NaN,NaN,95.85274308271437,91.63419594576986,0.057805139084385226,1.5393462188109908,1.4815410797266055,2595884260,2534348055.2,81.24444242600941,80.46038956960498,NaN,NaN,34.854251936353116,31.142726811180427
2009-08-14T09:30:00-04:00,57.5,57.55,55.82001,56.41,60233232,46940580,59.287417715682906,68.57084141428254,NaN,NaN,55.45704801292276,82.46019736587813,-0.035357140187541214,1.437344654492179,1.4727017946797203,2535651028,2543475901.6,81.9559868308994,81.00702926254827,NaN,NaN,32.250265132276695,31.300946571337036
2009-08-17T09:30:00-04:00,55.25999,55.37,54.67999,54.82001,48853248,47253268,50.302124808845974,67.06977456893163,NaN,NaN,-38.431758669062276,54.836432121677504,-0.20679176070990346,1.2142120937923409,1.4210038545022443,2486797780,2533876980,78.57983517693737,81.04108298676657,NaN,NaN,26.751550475742942,30.651032843395022
2009-08-18T09:30:00-04:00,55.2,55.89,54.91499,55.55,39360560,47199664,53.766564989223504,65.99338988489187,NaN,NaN,-22.130948277615854,36.339010899495996,-0.26977205829469897,1.0837887816338707,1.3535608399285697,2526158340,2539366080.8,79.10980031122052,80.97843072012998,NaN,NaN,23.4740829678781,29.625754289749747
2009-08-19T09:30:00-04:00,54.92999,56.27,54.82001,56.23,37740064,46708771.2,56.78840994812684,64.87945970847139,NaN,NaN,-12.70886665668451,15.607643498454948,-0.26404913602633573,1.02349941989565,1.2875485559219857,2563898404,2541677962.4,79.34163029334508,80.80846413075402,NaN,NaN,21.81403794076416,28.509794811323236
2009-08-20T09:30:00-04:00,56.11,56.97,55.86,56.84,40017120,45483056.8,59.35484571402734,64.09635885338584,NaN,NaN,45.04034498355754,5.445163878623582,-0.21942978667313384,1.0132613225805684,1.2326911092537023,2603915524,2543284215.2,79.5117539791743,80.59362067211558,NaN,NaN,21.29603081705726,27.479257097856667
2009-08-21T09:30:00-04:00,57.44,58.39,57.37,58.14999,38321680,45834341.6,64.26352534375957,63.420658458091616,NaN,NaN,157.00204058173492,25.754162392386014,-0.10759807902960161,1.0981935104667002,1.2057915894963018,2642237204,2564601450.4,81.66925280727865,80.47701469679217,NaN,NaN,22.508742924869576,26.7691836445728
2009-08-24T09:30:00-04:00,58.39999,58.77,57.84,58.13,33994064,45899689.6,64.13623692723021,62.60882453750189,NaN,NaN,163.25709149505002,66.09193242520847,-0.04413234897452423,1.1506261532781465,1.1947585022526708,2608243140,2588890522.4,83.76681246912331,80.46694315782084,NaN,NaN,23.40839689093813,26.289071251196418
2009-08-25T09:30:00-04:00,58.39999,59.07001,58.2,58.38,30206816,44600294.4,65.06811325379206,62.22995818297253,NaN,NaN,170.65641201052296,104.64940448283623,0.003022262495674166,1.1985363303722636,1.1955140678765894,2638449956,2611348845.6,85.4272644722661,80.537457440294,NaN,NaN,24.419049877355064,26.021925340647652
2009-08-26T09:30:00-04:00,58.3,58.77,58.03,58.50999,34166576,43937488,65.56907632678505,62.34966274161921,NaN,NaN,141.22947186547003,135.43707218726712,0.029815812000854702,1.232783832877658,1.2029680208768032,2672616532,2633092471.2,86.83167002692872,81.02687575930388,NaN,NaN,25.386852015335286,25.931200579888742
2009-08-27T09:30:00-04:00,58.44,58.60001,57.23,58.42,45253808,42808694.4,64.87543818439013,62.048519783494484,NaN,NaN,99.46939356365506,146.32288190328663,0.028336314233098125,1.2383884136681758,1.2100520994350776,2627362724,2637781911.2,87.11996833362215,81.51885380597345,NaN,NaN,25.995259578827568,25.940351865451433
2009-08-28T09:30:00-04:00,59.02,59.17999,57.66,58.05,39329824,42751064,61.972581189624954,61.5147775973719,NaN,NaN,104.35486083968114,135.7934459548759,-0.008720792345209505,1.1991511090035658,1.2078719013487753,2588032900,2626941050.4,82.6169077040386,81.65637714750487,NaN,NaN,25.729380629192413,25.91021311741443
2009-08-31T09:30:00-04:00,57.46001,57.62,56.92999,57.2,35360496,42899156,55.79597268280524,61.04475891442026,NaN,NaN,17.38159691871942,106.61834703960976,-0.09674726229504893,1.086937823479964,1.183685085775013,2552672404,2615826903.2,78.15671675200375,81.7077248145498,NaN,NaN,23.72922378453976,25.59864321271805
2009-09-01T09:30:00-04:00,56.86,58.13,55.7,55.92,77083008,44691830.4,48.032417213285385,59.773054354651,NaN,NaN,-35.931606845751986,65.3007432683548,-0.23932693761475043,0.8845264137565749,1.1238533513713254,2475589396,2583254791.2,66.77846794436766,80.8650363948011,NaN,NaN,19.481208738688764,24.724724002142437
2009-09-02T09:30:00-04:00,55.64999,56.06,55.47,55.64,43441312,44158372.8,46.507951152616386,58.26576253215683,NaN,NaN,-96.82411566612117,17.690025762036555,-0.34426210468771634,0.6935257205116798,1.0377878251993962,2432148084,2535161101.6,54.22566136987718,78.93512346222022,NaN,NaN,15.533480422463697,23.411689205045473
2009-09-03T09:30:00-04:00,55.92,56.31,55.21001,56.25999,43091408,43692485.6,50.271519787738626,57.62176982301795,NaN,NaN,-79.60246528857805,-18.124346008410065,-0.3618816461989365,0.5854357674507256,0.947317413649662,2475239492,2504736455.2,48.06967438647545,76.51467257333279,NaN,NaN,13.2550985133774,21.96074767766432
2009-09-04T09:30:00-04:00,56.19,57.11,55.87,57.05,37231664,43085822.4,54.649973294977734,57.93233042917022,NaN,NaN,-20.886910482364176,-43.17270027281912,-0.3121747190367884,0.5570990148536765,0.8692737338904649,2512471156,2489624106.4,45.31765567062694,74.13880260859635,NaN,NaN,12.598308266563704,20.623256333221374
2009-09-08T09:30:00-04:00,57.66,57.72479,57,57.67999,41068592,42900222.4,57.83800381938105,58.22314748846719,NaN,NaN,36.7164578327682,-39.305728090009374,-0.23237517813222897,0.5788047612251788,0.8111799393574077,2553539748,2489797575.2,45.356327451460395,71.72784026147062,NaN,NaN,13.011132730971342,19.53581010432851
2009-09-09T09:30:00-04:00,57.67999,59.03,57.52,58.67,37222736,42957381.6,62.32069127010364,58.61831044003696,NaN,NaN,94.99858064990626,-13.119690590877727,-0.11439212835817814,0.6681897789096851,0.7825819072678633,2590762484,2512832192.8,50.37503171448566,69.6587975058378,NaN,NaN,14.793369825799266,18.85831863596719
2009-09-10T09:30:00-04:00,58.67,59.56,58.2,59.39999,39173872,42234767.2,65.2541641105048,59.03969032549964,NaN,NaN,122.29500659575207,30.70413386149692,0.005005592464685349,0.78883889784872,0.7838333053840346,2629936356,2552389847.2,57.58034778617566,68.09226849205217,NaN,NaN,17.238337914127634,18.62689281856154
2009-09-11T09:30:00-04:00,59.59,59.99001,59.10001,59.42,31719440,41643476,65.33383502564575,59.116141017062944,NaN,NaN,131.89389299970028,73.0034055191526,0.07371030215827645,0.8759711830818802,0.8022608809236037,2661655796,2589673108,63.02892285057424,66.76081635228758,NaN,NaN,19.20576665084475,18.709589080316285
2009-09-14T09:30:00-04:00,58.98,60.11,58.86501,60.05,37902304,40526929.6,67.83455332738433,59.38030647421681,NaN,NaN,125.10544930748317,102.20187747712205,0.1458001362150363,0.9845110511923991,0.8387109149773628,2699558100,2627090496.8,67.5357005969353,65.60145121855984,NaN,NaN,21.650820488733963,19.129764995804525
2009-09-15T09:30:00-04:00,60.00999,60.72,59.77,60.53999,48814224,40524978.4,69.6672958368845,59.70881951586627,NaN,NaN,148.4204676832577,124.54267944721997,0.2069652133039307,1.0974174316072762,0.8904522183033455,2748372324,2666057012,71.44017321452193,64.60237327157812,NaN,NaN,24.270837097667265,19.864203867499203
2009-09-16T09:30:00-04:00,60.81,61.8,60.62,61.78999,39403952,40527148,73.77283904863083,60.294802567426686,NaN,NaN,188.66920847671685,143.2768050125821,0.30610683705377206,1.2730857646205607,0.9669789275667886,2787776276,2705459770.4,74.747522617247,63.73921988517228,NaN,NaN,27.968283164042163,21.021929481291053
2009-09-17T09:30:00-04:00,61.74001,62.34,61.35001,61.66,50597776,41170033.6,72.67128214959176,60.85164856494108,NaN,NaN,186.19225912903352,156.05625551923836,0.3350888394895579,1.385839976928736,1.050751137439178,2737178500,2726908199.2,76.35282660998158,62.97013833348366,NaN,NaN,30.609345327147548,22.39156031641341
2009-09-18T09:30:00-04:00,62.09,62.09,61.25999,61.91,36823568,41010356,73.4910991259686,61.674399846108486,NaN,NaN,156.4881048015144,160.97509787960118,0.3420632048726362,1.4783301435299734,1.1362669386573372,2774002068,2749377453.6,77.93527540982377,62.63573602675403,NaN,NaN,33.03402043431279,23.911911761827607
2009-09-21T09:30:00-04:00,61.32001,61.96001,61.09,61.74001,37511872,40969865.6,71.91143891964647,62.82550457731144,NaN,NaN,125.3170688839288,161.0174217948903,0.3072955900889258,1.5203864262684945,1.2130908361795687,2736490196,2756763872.8,78.44590984662902,62.65639267637012,NaN,NaN,34.606569833359316,25.43972005776071
2009-09-22T09:30:00-04:00,62.03,62.24001,61.59,62.02,36273792,41083852,72.94303994621647,64.6048347725208,NaN,NaN,120.44818484501074,155.42296522724092,0.2762037701862814,1.5583455489124205,1.282141778726139,2772763988,2761642205.6,78.79494814623706,63.51471269078937,NaN,NaN,36.22685823840299,26.980739797852465
2009-09-23T09:30:00-04:00,62.13,62.61,61.315,61.42999,55048048,42325913.6,67.331260976447,66.09221404565156,NaN,NaN,99.84154220771745,137.65743197344105,0.19289486009530754,1.5232603538452736,1.330365493749966,2717715940,2747630138.4,75.03631155470578,65.0011877039914,NaN,NaN,36.08362253266439,28.281151617111313
2009-09-24T09:30:00-04:00,61.53,61.75999,59.75999,60.2,60639536,43649561.6,57.4145909039853,66.60243341109775,NaN,NaN,49.92375011574586,110.4037301707835,0.039942805321038444,1.380294000401264,1.3403511950802256,2657076404,2731609719.2,70.87363181449717,66.63004180599295,NaN,NaN,32.89878235112012,28.940813150541143
2009-09-25T09:30:00-04:00,59.91,60.34,59.50999,59.83,51804400,43977091.2,54.79993819419645,66.61314518961338,NaN,NaN,22.439152090073158,83.59393962849525,-0.09385070890261438,1.2230378089519576,1.316888517854572,2605272004,2697863706.4,62.95151921024932,67.88960348739455,NaN,NaN,29.455539450362604,29.014345479087066
2009-09-28T09:30:00-04:00,60.22,61.58,60.03999,61.25999,47928560,44407028,62.00216159818212,66.9105850309563,NaN,NaN,56.46932309975405,69.82439047166032,-0.09353728252805782,1.1999669146944996,1.2935041972225574,2653200564,2681205780,59.42068648408454,68.89420056115341,NaN,NaN,28.586221500106078,28.95318491066121
2009-09-29T09:30:00-04:00,61.3,61.78,60.92,60.99001,37454816,44511744,60.05648460721611,66.74885598360719,NaN,NaN,61.288183958581314,57.99239029437443,-0.1174595777707712,1.1466797250090934,1.2641393027798646,2615745748,2649802132,53.34609085423611,69.10641907113559,NaN,NaN,27.27657300331336,28.71366892389723
2009-09-30T09:30:00-04:00,61.12,61.24001,59.56,60.24001,79347248,44624956,54.90220414346406,66.00943027167571,NaN,NaN,22.68847821658292,42.56177749614751,-0.18568434840128512,1.0320338672782583,1.2177182156795434,2536398500,2613538644,47.32906607200176,68.37418466298031,NaN,NaN,24.52050590911108,28.114645636070637
2009-10-01T09:30:00-04:00,60.13,60.17999,58.34,58.44,62845024,45595141.6,44.93466433501928,64.55234665091668,NaN,NaN,-46.28646029261292,23.3197354144757,-0.3446865701058557,0.7868600030472237,1.1315465731530794,2473553476,2576834058.4,42.14722998463326,66.88263517255595,NaN,NaN,18.447764029836446,26.733662549465752
2009-10-02T09:30:00-04:00,57.78,58.52,57.53,58,66449376,46763040,42.8850751715669,62.770241068358295,NaN,NaN,-105.69969660317375,-2.3080343241736783,-0.46467290890684465,0.5507054370195235,1.015378345926368,2407104100,2537200477.6,37.38723248338129,64.72917316444496,NaN,NaN,12.931858221225331,24.761976216859978
2009-10-05T09:30:00-04:00,58.31,59.28999,58.08,59.03999,48920464,47347480,48.82651224951264,61.2816136692603,NaN,NaN,-77.69929043122973,-29.141757030370428,-0.45840637819259444,0.442370373185625,0.9007767513782194,2456024564,2497765277.6,33.35120067103696,62.008532268481744,NaN,NaN,10.26307406208556,22.690704480463634
2009-10-06T09:30:00-04:00,59.52,60.44501,59.36,60.14,52213360,47904718.4,54.247839827188,59.88697086772867,NaN,NaN,-20.54948399586118,-45.50929062125893,-0.3684603596413998,0.44020130182646966,0.8086616614678694,2508237924,2476263712.8,31.363175006895773,58.90965029631379,NaN,NaN,9.882292755224253,20.86093137685801
2009-10-07T09:30:00-04:00,59.98,60.41,59.85001,60.16,35533968,47820280,54.342548629230016,58.577775616274266,NaN,NaN,-17.403938334142932,-53.52777393140409,-0.2988646975845113,0.4350807894872304,0.7339454870717417,2543771892,2477738391.2,31.664040061625528,55.71759411428837,NaN,NaN,9.619707345807312,19.255042229565053
2009-10-08T09:30:00-04:00,60.73,61.31,60.37,60.71001,48972928,48310232.8,56.97994253843046,57.39840728859297,NaN,NaN,23.561721761168847,-39.55813752064774,-0.21116739123282735,0.46998624803070754,0.6811536392635349,2592744820,2501576660,36.50898565369816,52.758573417422255,NaN,NaN,10.2326540239582,17.966129628764072
2009-10-09T09:30:00-04:00,60.85001,61.50999,60.67,61.42,34601776,48454349.6,60.17777144395077,56.56028818318614,NaN,NaN,48.078733084766625,-8.802451583059664,-0.10603071957923493,0.5486152397894912,0.6546459593687262,2627346596,2545625159.2,44.359081861700766,50.32379998992739,NaN,NaN,11.75955738298941,17.079476450796264
2009-10-12T09:30:00-04:00,61.78999,62.03,61.14,61.42999,26896080,47904038.4,60.22257565515918,55.651683590967764,NaN,NaN,66.63234149965176,20.063874803116633,-0.03990552888388732,0.604764048263867,0.6446695771477543,2654242676,2585268781.6,50.3133615127187,48.28940094467607,NaN,NaN,12.987454740376958,16.494901920736364
2009-10-13T09:30:00-04:00,61.32001,61.49001,60.60001,61.17,35459424,47236298.4,58.38161207369131,55.01242295505664,NaN,NaN,30.02187183315098,30.17814596891907,-0.018836910543235996,0.6211234389687093,0.6399603495119452,2618783252,2607377847.2,53.31393294766139,46.73780247274433,NaN,NaN,13.48751860805502,16.06527573321046
2009-10-14T09:30:00-04:00,62.07001,62.46001,61.55,62.34,38636352,47197918.4,63.75176482639385,55.46507823522868,NaN,NaN,102.14969251297872,54.088872138343376,0.06418822356075093,0.7201956289628839,0.656007405402133,2657419604,2630107389.6,56.239762439099096,45.69252608878732,NaN,NaN,15.58803358017272,15.997098282776497
2009-10-15T09:30:00-04:00,61.99001,62.45,61.83,62.3,28632800,46099669.6,63.45032954671505,56.08296333183715,NaN,NaN,104.3899103307869,70.25450985226698,0.10432851556095879,0.7864180498533315,0.6820895342923727,2628786804,2637315786.4,57.15677762539638,45.278615975583534,NaN,NaN,17.194311371882193,16.16812872407731
2009-10-16T09:30:00-04:00,61.89,62.02,61.14,61.67999,49032352,46710108.8,58.808736077238265,55.8548615089126,NaN,NaN,63.41281086497098,73.32132540830786,0.07823252993130203,0.7798801967065003,0.7016476667751983,2579754452,2627797357.6,55.50282446941379,44.998768688821336,NaN,NaN,17.24676127937391,16.32221908911968
2009-10-19T09:30:00-04:00,61.88,62.52,61.38,62.19,38233392,46746184.8,61.315616285359766,55.94479948592285,NaN,NaN,90.39284775957196,78.0734266602919,0.08392585208815984,0.8065549818853981,0.7226291297972383,2617987844,2620546391.2,54.21577149824174,45.060888734821745,NaN,NaN,18.02048230862291,16.564828120477284
2009-10-20T09:30:00-04:00,62.24001,62.32001,60.99001,61.33,43954496,47130220,55.213529037360416,55.96703697834402,NaN,NaN,58.386681141605706,83.74638852198284,0.021623521548942648,0.7496585317334166,0.7280350101844739,2574033348,2611596410.4,52.59458396444837,45.43699715571079,NaN,NaN,16.875256675591185,16.609175056922126
2009-10-21T09:30:00-04:00,61.24001,62.39999,60.41,60.5,64596304,47607632.8,50.03781820099777,56.331547968771055,NaN,NaN,29.580789825990653,69.23260798458523,-0.07816593015395767,0.6303275974920268,0.7084935276459845,2509437044,2581999898.4,47.53279455392807,45.821680339231854,NaN,NaN,14.277558957271582,16.276087042686335
2009-10-22T09:30:00-04:00,60.48,61.61,59.77,61.34,58429648,47497138.4,54.66913395644998,57.17326645340557,NaN,NaN,13.661980852601056,51.08702208894806,-0.08946680066185309,0.5966600268186681,0.6861268274805212,2567866692,2569815876,45.58767915392548,46.407426529985,NaN,NaN,13.478388316271664,15.876415796055667
2009-10-23T09:30:00-04:00,61.47,61.67999,59.97,60.058,68829312,48348384,47.44123020289175,57.07431773578979,NaN,NaN,-14.868019297812893,35.430856056391285,-0.17992950216469694,0.46121494977465005,0.641144451939347,2499037380,2553672461.6,43.07265009654641,47.10181577466425,NaN,NaN,10.370569048090568,15.089866260632082
2009-10-26T09:30:00-04:00,60.24001,61.17,59.22,59.52,69905376,49447224.8,44.766370631731576,56.397069936114335,NaN,NaN,-55.60911116890443,6.230464270696002,-0.2673766638085737,0.3069236221786298,0.5743002859872035,2429132004,2515901293.6,37.81587517127173,47.562722929262534,NaN,NaN,6.962610302544876,13.928829695191052
2009-10-27T09:30:00-04:00,59.57001,59.89,58.69,58.78999,71959632,51172465.6,41.3588048975975,55.46965966956916,NaN,NaN,-103.94703067673349,-26.236278092971833,-0.35999384290467784,0.1243079823563562,0.48430182526103405,2357172372,2472529098.4,32.85701792135609,47.647935633529,NaN,NaN,3.002734234638914,12.367958915112176
2009-10-28T09:30:00-04:00,58.59,58.8,56.59,56.83,84950944,51452650.4,33.89813406808962,53.82095906454481,NaN,NaN,-181.1745643108582,-68.38734892034161,-0.5286702945643121,-0.1765360429443561,0.35213425161995604,2272221428,2425085975.2,28.460608035984905,47.07305151797806,NaN,NaN,-3.3121375525400634,10.127945134018999
2009-10-29T09:30:00-04:00,57.33,58.24001,57.12,57.91,73616688,51991233.6,40.289785898443405,52.40038866843714,NaN,NaN,-147.05567945002676,-100.53088098086717,-0.5409669200638046,-0.3240743984597998,0.21689252160400488,2345838116,2380680260,25.078263982149153,45.69585024086722,NaN,NaN,-6.2631895534693,7.786354464377814
2009-10-30T09:30:00-04:00,57.67,57.74001,55.98,56.33,116218560,54479692.8,34.96341664105816,50.59616302457278,NaN,NaN,-190.43287600250503,-135.64385232180558,-0.6231251033967019,-0.5620138576418725,0.0611112457548294,2229619556,2326796695.2,21.70711565037014,43.652546964985184,NaN,NaN,-10.721655950507754,5.142352976537019
2009-11-02T09:30:00-05:00,56.63,57.14,55.33,56.22,98003120,56933825.6,34.620264295157085,48.89892389753463,NaN,NaN,-185.00893936931362,-161.52381796188743,-0.6495320960381655,-0.7508038742928775,-0.10127177825471201,2131616436,2267293581.6,18.715238164274624,41.1812116233147,NaN,NaN,-14.212585455298793,2.377361771989046
2009-11-03T09:30:00-05:00,55.88,57.09,55.69,57.07001,83108256,58478570.4,39.55695033999691,47.17072286279198,NaN,NaN,-138.53524847367115,-168.44146152127496,-0.576865013769231,-0.8223530454662509,-0.2454880316970198,2214724692,2238804045.6,17.473441459962586,38.41218869623352,NaN,NaN,-15.445324396308191,-0.16873625205341636
2009-11-04T09:30:00-05:00,57.46001,57.67999,56.25,56.25,92806000,61342172,36.67957547562069,45.25852614342811,NaN,NaN,-113.05249428191968,-154.81704751548725,-0.5511715321340505,-0.934452446864583,-0.38328091473053244,2121918692,2208743498.4,16.248370756531983,35.49015963417178,NaN,NaN,-17.40482810006204,-2.6310350874832196
2009-11-05T09:30:00-05:00,56.99001,58.1646,56.77,58.03999,67431376,62265094.4,45.92608091876625,44.338336489251525,NaN,NaN,-70.18981554245818,-139.44387473397356,-0.3884467541336348,-0.8688393573975759,-0.4803926032639411,2189350068,2177445888.8,15.064166083755097,32.60168403519616,NaN,NaN,-15.904419886992974,-4.527232915984613
2009-11-06T09:30:00-05:00,57.42999,58.58,57.27,58.08,56217616,63345886.4,46.115489818456695,43.252613170187026,NaN,NaN,-52.976533155949355,-111.95260616466241,-0.2591580026618566,-0.8043401065912619,-0.5451821039294052,2245567684,2180635514.4,15.738167905867385,29.853283778597994,NaN,NaN,-14.692580973110955,-5.97942549557409
2009-11-09T09:30:00-05:00,58.59,59.27,58.55,59.22,49200176,64461091.2,51.34499980135912,42.976289653329786,NaN,NaN,-14.16257779715875,-77.78333385023144,-0.08681436931329989,-0.6537000655710301,-0.5668856962577302,2294767860,2213265799.2,22.51251608391111,27.704564644273905,NaN,NaN,-11.933513197905247,-6.8300094530499695
2009-11-10T09:30:00-05:00,59.10001,59.50999,58.37,58.85001,55872784,65481759.2,49.66047374337159,42.94933647778505,NaN,NaN,-14.497153428014325,-52.97571484110008,0.007314525159837992,-0.5577425398079328,-0.5650570649677708,2238895076,2218099876,23.49383554340595,25.987496143522325,NaN,NaN,-10.237953360991654,-7.316858582755924
2009-11-11T09:30:00-05:00,59.3,59.84,58.8,59.25999,50323568,66066120,51.55703830940307,42.72704393156742,NaN,NaN,5.310575556590946,-29.303100873397966,0.09724473635370401,-0.4435011445256407,-0.5407458808793447,2289218644,2251559866.4,30.09310434187408,24.880740799804364,NaN,NaN,-8.270369563128401,-7.453074437094849
2009-11-12T09:30:00-05:00,59.28,59.73,58,58.17,68552320,68062096,46.537058576428905,42.66246024396293,NaN,NaN,-15.496056541843968,-18.36434907327513,0.08388278231540403,-0.4358924029850897,-0.5197751853004937,2220666324,2257823117.6,31.28789371630978,24.038972486930316,NaN,NaN,-8.100677911276852,-7.54558921912085
2009-11-13T09:30:00-05:00,58.35001,58.96001,57.63,58.73,69265872,69073772,49.269992465466096,42.98414751780111,NaN,NaN,-18.347622627166174,-11.438566967518454,0.11158707721549882,-0.3802913387811202,-0.491878415996619,2289932196,2266696020,33.034021847126354,23.697411535205653,NaN,NaN,-7.125849996481845,-7.485626473029564
2009-11-16T09:30:00-05:00,59.12,60.67999,59.12,60.28,66106320,70467418.4,55.977743452856984,44.02835741460536,NaN,NaN,65.64069143276508,4.522086878466311,0.22650375410565488,-0.20874872336455041,-0.4352524774702053,2356038516,2278950151.2,35.47288049984148,23.884258862240323,NaN,NaN,-4.076515221157251,-6.998610579904947
2009-11-17T09:30:00-05:00,60.08,60.48,59.74001,60.28,43029248,70421156,55.977743452856984,45.605472370660166,NaN,NaN,80.43410812961466,23.508339189992107,0.2906257135591982,-0.07197033552120757,-0.36259604908040577,2356038516,2302378839.2,39.97401350999463,24.70664496752673,NaN,NaN,-1.6780552840878311,-6.238531251931073
2009-11-18T09:30:00-05:00,60.35001,60.38,59.60001,60.16,54311072,69906894.4,55.32096235382544,46.67912783175888,NaN,NaN,80.07373073531807,38.460970225737526,0.31122863466274875,0.026439744248030195,-0.28478889041471855,2301727444,2304880599.2,40.45168727283115,25.804746631146877,NaN,NaN,0.08489878655296237,-5.3351841035762115
2009-11-19T09:30:00-05:00,59.56,59.66,58.19,58.66,72359440,70603384,47.77520982161022,47.59425591608403,NaN,NaN,20.044832652092808,45.56914806452488,0.2146968973815901,-0.016417768687730927,-0.23111466606932102,2229368004,2306620935.2,40.80458777267139,27.168851782739825,NaN,NaN,-0.6010634105657003,-4.6588811474318526
2009-11-20T09:30:00-05:00,58.22,58.8,58.09,58.59,39795344,69151685.6,47.44994283250394,48.51066152589452,NaN,NaN,6.080788223238491,50.454830234605815,0.14057770028115663,-0.05539254071787525,-0.19597024099903187,2189572660,2286549028,38.00698258447601,28.546833527039926,NaN,NaN,-1.247230741210677,-4.1715025179716845
2009-11-23T09:30:00-05:00,59.41,60.32001,59.28999,59.61,57936336,68553233.6,52.5223427042536,49.43676098048428,NaN,NaN,89.52155787372818,55.23100352279844,0.1536325484974729,-0.003929555377190752,-0.15756210387466366,2247508996,2264843124,35.19668019354309,29.8127791508671,NaN,NaN,-0.3020971359469507,-3.6187303205395795
2009-11-24T09:30:00-05:00,59.62,59.63,58.62,59.34,45240800,67217292,51.11582897978078,50.46792194506715,NaN,NaN,53.11415911107944,49.767013719091395,0.1379670967813323,0.014896767102001718,-0.12307032967933057,2202268196,2234089060,31.62827260966877,30.9113435689483,NaN,NaN,0.0714934046392735,-3.0915555026568864
2009-11-25T09:30:00-05:00,59.69,59.82001,59.25999,59.33,47642736,65351881.6,51.06128930034924,50.83472254375164,NaN,NaN,65.69583613650589,46.891434799328955,0.12139966400824372,0.02867925033097407,-0.09272041367726964,2154625460,2204668663.2,28.637156075410303,31.880842854066533,NaN,NaN,0.3615645468297268,-2.5982526384445133
2009-11-27T09:30:00-05:00,57.14999,58.67,57.03999,57.58,51862016,64264148,42.512632153866974,50.577375567709524,NaN,NaN,-49.4681405619106,32.98884015652827,-0.0061840502483452575,-0.10045047648770122,-0.09426642623935597,2102763444,2179347751.2,26.3292806863668,32.63735090981648,NaN,NaN,-1.9729392109881587,-2.508922148807891
2009-11-30T09:30:00-05:00,57.64999,58.25,56.86,58.09,77941872,62350313.6,45.38245512771075,50.15147951959178,NaN,NaN,-58.451746293547934,20.082333253170987,-0.05242045494325824,-0.15979199491842877,-0.10737153997517053,2180705316,2177574282.4,26.17019965523535,32.898614022053934,NaN,NaN,-3.0661423163658106,-2.588525029887594
2009-12-01T09:30:00-05:00,58.64,59.23,58.46001,58.99001,63144832,60607399.2,50.11519669204274,50.18395973021115,NaN,NaN,17.39401037155132,5.6568237527356136,-0.020237149342129918,-0.13266797665283292,-0.112430827310703,2243850148,2176842512.8,26.100125560811477,33.08477759472576,NaN,NaN,-2.571601589571481,-2.586107395556721
2009-12-02T09:30:00-05:00,59.07001,60.21001,59.06,59.69,71220560,60013014.4,53.49078018520889,50.32208414991156,NaN,NaN,75.38677482365782,10.111346895251291,0.046692324810396466,-0.05406542129770742,-0.10075774610810388,2315070708,2199403015.2,32.13356019302303,33.2305244412364,NaN,NaN,-1.121325432889141,-2.3768528294613525
2009-12-03T09:30:00-05:00,59.98,60.37,58.92999,58.96001,53867328,58066080.8,49.712808911016786,50.54892345952498,NaN,NaN,47.41165906095521,6.4545114801411545,0.040527066475899376,-0.05009891301322966,-0.09062597948912904,2261203380,2220718599.2,37.33893311824855,33.66274154137488,NaN,NaN,-1.0352497483869654,-2.185195246450726
2009-12-04T09:30:00-05:00,60.2,60.87,59.28,60.42,100436000,59716312,56.35261773272367,51.0548252643291,NaN,NaN,116.62669772571023,39.673479137665325,0.1285376769534508,0.07004611670268446,-0.058491560250766336,2361639380,2272493786.4,47.81004559012431,34.718171808731874,NaN,NaN,1.18897880405585,-1.7031703820926436
2009-12-07T09:30:00-05:00,60.41,60.84,60.11,60.50999,55544384,59682650.4,56.73184159953291,51.108689417663086,NaN,NaN,134.10985210620962,78.18579881761683,0.18323907308427573,0.17055728110457835,-0.01268179197969739,2417183764,2319789476,55.178348358671165,36.12570522721971,NaN,NaN,3.067024858287206,-1.0217139191812366
2009-12-08T09:30:00-05:00,60.14,60.47,59.38,60.03999,59582880,60201785.6,54.088631163674094,50.97375282557859,NaN,NaN,71.15106758654807,88.93721026061618,0.17804046892007563,0.20986879417039717,0.03182832525032152,2357600884,2342539623.2,58.23299652955218,37.42991830004525,NaN,NaN,3.851262056307937,-0.32557449411135453
2009-12-09T09:30:00-05:00,59.94,60.10001,59.3,59.85001,55537696,60185031.2,53.01344032250942,50.80892982334173,NaN,NaN,45.10132749598437,82.8801207950815,0.15303465642704328,0.22312164578412563,0.07008698935708234,2302063188,2339938119.2,57.74833585301081,38.66539319862951,NaN,NaN,4.188985554510883,0.3193626556918223
2009-12-10T09:30:00-05:00,60.12,60.44,59.36,59.61,54321216,60384913.6,51.61745049884127,51.08337558600109,NaN,NaN,46.61813194238717,82.72141537136788,0.11338332083539983,0.21181614040133212,0.09843281956593229,2247741972,2337245837.6,57.217599364470914,39.83775116947233,NaN,NaN,4.084327283332436,0.857214745354767
2009-12-11T09:30:00-05:00,60.03,60.27,59.48,60.17,50545504,59484572.8,54.62009047753693,51.59552898921773,NaN,NaN,58.92971878038288,71.18201958230242,0.11742738933641306,0.24521705623644863,0.12778966690003557,2298287476,2324575456.8,54.67105752685197,41.028042236784906,NaN,NaN,4.82935384578537,1.4246631882734246
2009-12-14T09:30:00-05:00,60.64999,61.3775,59.97,61.08,48249632,58433760.8,59.065779555959274,52.06291733576814,NaN,NaN,135.05680223735231,71.37140960853094,0.17071543541148912,0.341183961164397,0.17046852575290786,2346537108,2310446125.6,51.89721466772252,42.220937556369144,NaN,NaN,6.788859556093471,2.1909769551048597
2009-12-15T09:30:00-05:00,60.96001,61.52,60.78,60.91,55380144,57897452,57.924144487688515,52.54922558633298,NaN,NaN,147.2667904382119,86.59455417886372,0.18276303325347498,0.3989223173197516,0.2161592840662766,2291156964,2297157341.6,49.36060760772806,43.48753291337338,NaN,NaN,8.093587943492208,3.034207096303052
2009-12-16T09:30:00-05:00,61.3,61.62,60.89999,61.3,56553424,58573660.8,59.84178050781482,53.17640352972337,NaN,NaN,151.9034260033657,107.95497388033998,0.20365169993256904,0.4707239089819879,0.26707220904941886,2347710388,2306286781.6,51.12792089207091,45.09401611456342,NaN,NaN,9.743169927126022,3.9926303578491904
2009-12-17T09:30:00-05:00,60.92999,61.17,60.17999,60.62,60924272,58904320.8,55.124348170057715,54.07724038802272,NaN,NaN,89.06643971737822,116.44463543533818,0.16023769515103192,0.46736932798820874,0.3071316328371768,2286786116,2314095610.4,52.65011633801639,46.97407580396696,NaN,NaN,9.866169656461292,4.831707400508062
2009-12-18T09:30:00-05:00,61.03999,61.19,60.32001,61.17999,63876080,58480152.8,58.056723572836425,54.982545276960266,NaN,NaN,100.81634701699923,124.82196108266146,0.15756390635389694,0.504086515779548,0.34652260942565105,2350662196,2324570554.4,54.688871050532185,49.011123760773884,NaN,NaN,10.807000705966917,5.685320729859327
2009-12-21T09:30:00-05:00,61.63,62.11,61.62,61.991,47660448,58873408,61.936025261221964,55.82689017475878,NaN,NaN,166.59698846745346,131.1299983286817,0.1962258500506412,0.5918049219889525,0.3955790719383113,2398322644,2334927661.6,56.675212686053996,51.19505855543406,NaN,NaN,12.78297725388933,6.699271661863612
2009-12-22T09:30:00-05:00,62.05,62.64999,61.92,62.57001,38751968,57914189.6,64.46308476240614,56.61062621598715,NaN,NaN,169.83681575728693,135.6440033924967,0.2435165706835417,0.6999747852927385,0.4564582146091968,2437074612,2364111191.2,61.76184163803388,53.31136437293484,NaN,NaN,15.227144480718119,7.917539207414256
2009-12-23T09:30:00-05:00,62.7,63.16,62.2825,63.12,49507904,58127544.8,66.72303293839798,57.82564221794296,NaN,NaN,171.93931550983962,139.65118129379147,0.29132957168614193,0.8206201792168741,0.5292906075307322,2486582516,2391885616.8,65.86894206586663,55.349222154907565,NaN,NaN,17.987908694815495,9.356163419900147
2009-12-24T09:30:00-05:00,63.28999,63.3929,63.13,63.36,16522449,56571530.45,67.68867171580507,58.63536035959162,NaN,NaN,169.34454732303078,155.706802814922,0.3165166547557936,0.9249364259754742,0.6084197712196806,2503104965,2435149386.6,71.0797427664635,57.01134338178893,NaN,NaN,20.559934674517226,10.95670217055973
2009-12-28T09:30:00-05:00,63.59,63.61,62.97,63.25999,35791120,55767985.65,66.8185403701253,59.35583884320537,NaN,NaN,150.89480384697214,165.72249418091658,0.3037818529321832,0.9881470873849096,0.6843652344527265,2467313845,2458479716.4,73.43503680954282,58.315392556851194,NaN,NaN,22.451410904052896,12.59880341820161
2009-12-29T09:30:00-05:00,63.42,63.53,63.17999,63.23,24085984,53075191.25,66.54230177061942,60.24538674370147,NaN,NaN,135.37239521319506,159.4775755300649,0.2717220602102606,1.0240178097155521,0.7522957495052915,2443227861,2467460759.8,74.30264183751646,59.463224364562926,NaN,NaN,23.95338510904923,14.220886516894128
2009-12-30T09:30:00-05:00,63.03999,63.49001,62.64999,63.19,45268928,52181396.05,66.14949216212987,61.18367616081721,NaN,NaN,107.86916279546466,147.08404493770044,0.22797224053758947,1.0372610501772783,0.8092888096396889,2397958933,2459637624,72.09387453036024,60.48790569865931,NaN,NaN,25.121427679349722,15.778106682959212
2009-12-31T09:30:00-05:00,63.23,63.57001,62.25999,62.44,34408000,50340768.05,59.10435111740047,61.71845477642858,NaN,NaN,77.49509745143162,128.19520132601886,0.13335864012526621,0.9759871097962716,0.8426284696710054,2363550933,2435031307.4,65.49866524112394,61.07941040413453,NaN,NaN,24.29995582189069,16.995513702806566
2010-01-04T09:30:00-05:00,63.28999,64.03999,63.27,63.98,42866128,49790708.05,66.89975363226861,62.595573573195125,NaN,NaN,116.9107859454593,117.70844905050456,0.1576629074416077,1.039707103973015,0.8820441965314073,2406417061,2415693726.6,60.79196425524905,61.51661802759146,NaN,NaN,25.86901451894118,18.26315667654008
2010-01-05T09:30:00-05:00,63.88,64.17999,63.49001,63.75999,55523664,47545091.25,64.99368307329956,63.01899525300515,NaN,NaN,106.12525241661751,108.75453876443362,0.1425494484210016,1.0602310070576593,0.9176815586366577,2350893397,2392409637,55.61016977946891,61.78182910700192,NaN,NaN,26.584675311374014,19.45194505294493
2010-01-06T09:30:00-05:00,63.75999,64.10001,63.53999,63.7,59713824,47753563.25,64.45443526733732,63.48544459440864,NaN,NaN,94.40259332804781,100.56057838740415,0.11340919821269124,1.0594430564025217,0.9460338581898304,2291179573,2361999979.4,49.65696120841067,61.80299722133639,NaN,NaN,27.01482590027753,20.532356602563873
2010-01-07T09:30:00-05:00,63.74001,64.218,63.14,64.17,56123824,47580610.45,66.7799605310399,63.98102888178185,NaN,NaN,89.17979638696485,96.82270510570417,0.11056904824360869,1.0842451684943413,0.9736761202507326,2347303397,2351868872.2,47.820258523091326,61.56673562355213,NaN,NaN,28.04716461851698,21.605900604842887
2010-01-08T09:30:00-05:00,63.94,64.52,63.8,64.52,48811776,47244314.45,68.43604298706083,64.9318642258535,NaN,NaN,104.56008651638501,102.23570291869486,0.11645204805647946,1.1192411803213318,1.0027891322648523,2396115173,2358381720.2,49.1230605191288,61.31480306506016,NaN,NaN,29.396789629463576,22.71888475121727
2010-01-11T09:30:00-05:00,64.78,64.88,64.00999,64.25999,51638880,47110197.65,65.81128728178646,65.48576163363565,NaN,NaN,104.05012718688826,99.66357116698065,0.08829932170703425,1.1131632843986452,1.024863962691611,2344476293,2345993566.6,46.73293938270461,60.7465222316439,NaN,NaN,29.809560942866938,23.731838492881508
2010-01-12T09:30:00-05:00,63.86,64.16,63.25999,63.56,45855856,46875715.25,59.22561596157798,65.29216096937536,NaN,NaN,58.51265513325919,90.14105171030899,0.012009726274272214,1.0398761205344513,1.0278663942601791,2298620437,2335538974.6,44.7539168594202,59.89500110117006,NaN,NaN,28.257085860873747,24.378302402594684
2010-01-13T09:30:00-05:00,63.78,64.50999,63.23,64.38,39504160,46438441.65,63.796095573520724,65.24451888445498,NaN,NaN,78.38645112269515,86.93782326923845,0.0065229387520848725,1.036020067700285,1.0294971289482002,2338124597,2344927979.4,46.92758694702413,58.83541148038365,NaN,NaN,28.23774398315538,24.92965119981764
2010-01-14T09:30:00-05:00,64.14,64.82001,64.02,64.62,41868880,45762878.45,65.03156673944369,65.12369987024395,NaN,NaN,104.80555708534698,90.06297540891488,0.00867249390719893,1.0403377463321988,1.0316652524249998,2379993477,2351465995.4,48.4486366070091,57.59110394760811,NaN,NaN,28.584289945208706,25.451742449159223
2010-01-15T09:30:00-05:00,64.64999,64.80009,63.27,63.67999,68728688,46371641.65,56.84872999495382,64.34941831875457,NaN,NaN,58.13462610471287,80.77788332658045,-0.05982957037065795,0.9568782894616774,1.0167078598323354,2311264789,2334495918.6,44.85520091222608,55.717922386591155,NaN,NaN,26.325045997957446,25.57650009898754
2010-01-19T09:30:00-05:00,63.92,64.87,63.92,64.85001,46843616,45667608.85,63.076444299515714,64.08212574228246,NaN,NaN,108.6474556104765,81.6973490112981,-0.03423016067770135,0.9739201589852087,1.00815031966291,2358108405,2337222341,45.55389830748177,53.726412493586786,NaN,NaN,26.349014419597484,25.686859287646104
2010-01-20T09:30:00-05:00,64.39,64.39999,63.19,63.91,62485008,45598055.25,56.07441789033926,63.33441975083388,NaN,NaN,32.313466573139166,76.4575112992741,-0.08557090123040889,0.9011866931248989,0.9867575943553077,2295623397,2336622933,45.41765244417194,51.66319896549076,NaN,NaN,23.962670488447763,25.440546602046343
2010-01-21T09:30:00-05:00,63.96001,64.48,62.64,62.8575,98330368,48131551.25,49.45471418247275,62.1419356094298,NaN,NaN,-43.10350798423683,52.159519477887706,-0.18942868653209977,0.749971736190183,0.9394004227222827,2197293029,2308456619.4,39.44721343906965,49.33129460182714,NaN,NaN,19.58486396702972,24.604020511329683
2010-01-22T09:30:00-05:00,62.75999,63.06,61.17999,61.73,83765440,50382224.85,43.52670702882567,61.029246745960165,NaN,NaN,-217.20725910058243,-12.243043759298184,-0.3251133198280881,0.5330087729371726,0.8581220927652607,2113527589,2255163441.8,31.113224877449213,46.87519171870752,NaN,NaN,13.732359420658646,23.05092606980525
2010-01-25T09:30:00-05:00,62.08,62.14999,61.33,61.8,62301264,51021892.85,43.97570419710656,59.39181464344859,NaN,NaN,-212.6433282441721,-66.39863462907518,-0.39647094073158984,0.36253341685077345,0.7590043575823633,2175828853,2228076254.6,27.888193596109033,44.52492238591181,NaN,NaN,9.42038444315512,21.10370583742666
2010-01-26T09:30:00-05:00,61.57001,62.02991,61.14,61.19,58219888,53106764.8,40.92234772941556,57.672433547456876,NaN,NaN,-199.03193762247335,-127.93451327566513,-0.4662613260124264,0.1761777000668303,0.6424390260792567,2117608965,2179976366.6,23.274629849846235,42.21524096236733,NaN,NaN,4.852147640351605,18.782054666415938
2010-01-27T09:30:00-05:00,60.92,61.935,60.71001,61.84,72570688,54945743.2,45.28210484100886,56.3029813741477,NaN,NaN,-160.58307666964157,-166.5138219242213,-0.44993791076059697,0.08001663762851052,0.5299545483891075,2190179653,2158887617.8,21.58835946092664,40.21034083754705,NaN,NaN,2.4572845609735112,16.449944651352734
2010-01-28T09:30:00-05:00,61.96001,61.99001,60.22,60.78,93822880,58432588,40.0867299732645,54.39632204859232,NaN,NaN,-162.8984201338602,-190.47280435414595,-0.4885984396536124,-0.08079350117790796,0.4078049384757044,2096356773,2138700366.6,20.088010073500428,38.22946594829055,NaN,NaN,-1.3583579079170016,13.905901428599915
2010-01-29T09:30:00-05:00,61.03,61.69,59.97,60.11,79332496,60135766.4,37.182800897286675,52.16394761360845,NaN,NaN,-155.58981992178192,-178.14931651838586,-0.5336926871463714,-0.2593109204572599,0.2743817666891115,2017024277,2119399704.2,18.74656130410176,36.05971600436005,NaN,NaN,-5.46914691516028,11.138037379491315
2010-02-01T09:30:00-05:00,60.39,60.94,60.16,60.82001,60731776,61451955.2,41.97948685839472,50.46167615479475,NaN,NaN,-129.70339942763084,-161.5613307550776,-0.4911701420133747,-0.3395809108276069,0.15158923118576784,2077756053,2099785144.2,17.46978237108344,33.96949050352997,NaN,NaN,-7.31281430089918,8.502201425149817
2010-02-02T09:30:00-05:00,60.92999,61.56,60.62,61.49001,71049568,62861127.2,46.15761743025054,49.52824768827137,NaN,NaN,-85.63842963746787,-138.8826291580765,-0.39739405938514166,-0.34515334304565926,0.05224071633948241,2148805621,2106024475.4,19.351415681842283,32.155026133702975,NaN,NaN,-7.480948833657587,6.218894245320188
2010-02-03T09:30:00-05:00,61.2,61.63,60.59,61.08,50250064,62597447.2,44.06633952636967,48.11897939918915,NaN,NaN,-81.38755523127652,-123.04352487040349,-0.3444271232637385,-0.3782931877401907,-0.033866064476452226,2098555557,2087699656.2,18.049805685155633,30.092327472140934,NaN,NaN,-8.271993934195129,4.148767362532286
2010-02-04T09:30:00-05:00,60.66,60.67999,58.99001,59.03999,99167312,64570121.6,35.45822737375653,46.00659801592578,NaN,NaN,-135.00538230243583,-117.4649173041186,-0.42305295682189986,-0.5626822605038271,-0.13962930368192722,1999388245,2068305950.6,16.764615186471545,27.829183084959677,NaN,NaN,-12.044740509816815,1.8354090950538433
2010-02-05T09:30:00-05:00,59.17,59.33,58,59.27,106758000,67101830.4,36.953636702630874,44.58551992361701,NaN,NaN,-146.10815523443847,-115.56858436664993,-0.43420529643868355,-0.6823859242302817,-0.2481806277915981,2106146245,2086130344.2,22.24442117251212,26.214127389265823,NaN,NaN,-14.476449461696436,-0.4948564130533395
2010-02-08T09:30:00-05:00,59.08,59.60001,58.62,58.67999,61585344,67740508.8,34.73068569030974,42.56082288010229,NaN,NaN,-129.32069748341934,-115.49204397780764,-0.45382405214320426,-0.8154606929706034,-0.36163664082739916,2044560901,2079491313.8,21.67210905012483,24.50828529945461,NaN,NaN,-17.186804378966567,-2.8794204081838006
2010-02-09T09:30:00-05:00,59.38,59.9286,58.75,59.49001,91995184,69758324,40.06156848560786,41.41704792262147,NaN,NaN,-103.62789524949703,-119.08993710021346,-0.3873399451486476,-0.8458115722632087,-0.4584716271145611,2136556085,2077041406.6,21.452765543524805,22.796507663694104,NaN,NaN,-17.736515671191476,-5.001862588613468
2010-02-10T09:30:00-05:00,59.31,59.78,58.69,59.63,55715440,70251303.2,40.959057864861514,40.81021532850639,NaN,NaN,-96.49695912383211,-122.11181787872458,-0.3122503618543373,-0.8487845794324826,-0.5365342175781453,2192271525,2095784600.2,27.498502173441096,21.94302828757778,NaN,NaN,-17.897725550787573,-6.844128726066912
2010-02-11T09:30:00-05:00,59.46001,60.62,59,60.578,51979184,70875054.4,46.77156680346634,41.041991026694994,NaN,NaN,-60.814646880776465,-107.2736707943927,-0.18342636048932803,-0.7658171681898054,-0.5823908077004774,2244250709,2144757093,40.40531854979843,22.606749264174148,NaN,NaN,-16.204699821990044,-8.181353168341644
2010-02-12T09:30:00-05:00,60,61.0974,59.81,61.02,65913120,72077266.4,49.27882068787483,41.420785061749875,NaN,NaN,-28.222071424077274,-83.69645403232047,-0.059549506022244736,-0.6568276902282832,-0.5972781842060385,2310163829,2185560609.8,48.613570252835935,24.087133311083214,NaN,NaN,-14.032861881192721,-9.017282984463227
2010-02-16T09:30:00-05:00,61.66,62.11,61.08,62.05,50057520,71143708,54.64073950679692,42.40067018870569,NaN,NaN,38.10901086646877,-50.21051236234282,0.09239325489806327,-0.48178661558345937,-0.5741798704815226,2360221349,2248692699.4,58.20538429964433,26.582187200354504,NaN,NaN,-10.418854661410892,-9.217507509741464
2010-02-17T09:30:00-05:00,62.36,62.61,61.99001,62.47,50465968,71324825.6,56.65301100644433,43.21287777195108,NaN,NaN,87.09403456358403,-12.066126399726604,0.21482273380941608,-0.3056514532197525,-0.5204741870291686,2410687317,2303518945.8,64.41716220501843,29.641387396361065,NaN,NaN,-6.822940096538566,-8.875426450712478
2010-02-18T09:30:00-05:00,62.47,63,62.25,62.98,43072752,70354212.8,59.02981880855672,44.565955545900515,NaN,NaN,120.3381632848928,31.300898082018374,0.31758986901425273,-0.12348685076135268,-0.4410767197756054,2453760069,2355816654.6,69.13026881327428,33.14440587777348,NaN,NaN,-3.0846952055811245,-8.048179129979427
2010-02-19T09:30:00-05:00,62.74001,63.38,62.61,63.06,56849040,68280146.4,59.405832160078454,46.153314921814214,NaN,NaN,141.28014510481776,71.71985647913722,0.3744803580697609,0.027023727811595677,-0.3474566302581652,2510609109,2409088334.6,73.04659403093166,37.02297964397561,NaN,NaN,0.0522612858809136,-6.890973356285093
2010-02-22T09:30:00-05:00,63.42,63.45,63.02,63.25,45347072,66359228,60.336876975163136,47.46455707301196,NaN,NaN,143.90931856208286,106.14613447636926,0.40580038718814554,0.1597938537270167,-0.24600653346112883,2555956181,2458246805,76.06431088364747,41.208303109158756,NaN,NaN,2.9261719218721884,-5.488524030834053
2010-02-23T09:30:00-05:00,63.16,63.25,62.33,62.50999,58965936,66192461.6,55.04184489090893,48.09914474877327,NaN,NaN,102.43131787502912,119.01059587808132,0.359175533025349,0.2029628828205574,-0.15621265020479158,2496990245,2485600584.2,77.56922843551027,45.366718305849325,NaN,NaN,3.9785810655380103,-4.136080445638044
2010-02-24T09:30:00-05:00,62.74001,63.35001,62.55,63.03999,50475968,65805265.6,57.8920298222153,49.08669405561939,NaN,NaN,107.52077453636007,123.09594387263652,0.34637092549593707,0.27675100666512975,-0.06961991883080731,2547466213,2512956363.4,78.99179364310783,49.71971744570306,NaN,NaN,5.7053374373506065,-2.730163605211094
2010-02-25T09:30:00-05:00,62.17999,63.12,61.98,63.06,51955952,64774528.8,58.00028950682368,50.696841350838476,NaN,NaN,84.55922923708908,115.94015706307577,0.3220996122613521,0.33300459649588277,0.010904984234530707,2599422165,2542088782.6,80.41620971205457,54.26625991181613,NaN,NaN,7.149989960209174,-1.3187130958653412
2010-02-26T09:30:00-05:00,63.16,63.21001,62.46001,62.8,60097936,63088281.6,55.98613008393772,52.056305163788956,NaN,NaN,80.17783123957278,103.7196942900268,0.2733098181680003,0.3525422569445311,0.0792324387765308,2539324229,2547831806.6,80.69410841301658,58.44123757185217,NaN,NaN,7.844680966271808,-0.009656801274320115
2010-03-01T09:30:00-05:00,63.25999,64.32001,63.25999,64.25999,70971120,62670212.8,63.62498234212865,54.12018349606173,NaN,NaN,119.16153896434456,98.77013837047913,0.3208527721312052,0.48029840394053736,0.15944563180933213,2610295349,2558699640.2,81.23671574414398,62.69585233571068,NaN,NaN,10.828527643929304,1.5386552623261973
2010-03-02T09:30:00-05:00,64.5,65.14999,64.39999,64.75,55627296,62414988.8,65.77211261257654,55.956650933702356,NaN,NaN,137.38295925504946,105.76046664648318,0.36364980017365955,0.6140078820264065,0.250358081852747,2665922645,2592486120.2,82.85045392461839,67.08140150578879,NaN,NaN,13.998235771784866,3.318595335106007
2010-03-03T09:30:00-05:00,65.07001,65.49001,64.78,65.12,56212208,61673120.8,67.33978629754563,57.84098867889408,NaN,NaN,133.9007772302558,111.03646718526234,0.3927410935759824,0.741284448822725,0.3485433552467426,2722134853,2627419848.2,84.34926100265093,71.14216999358949,NaN,NaN,17.118614194444113,5.290026600725737
2010-03-04T09:30:00-05:00,65.14,65.37,64.87,65.28999,47181200,61519677.6,68.06350396069706,59.361841332981996,NaN,NaN,120.82126461472194,118.2888742607889,0.39805757702306216,0.8461153265255703,0.44805774950250815,2769316053,2661398625.8,85.66186374977535,74.3747803650164,NaN,NaN,19.90443925038338,7.377799836391114
2010-03-05T09:30:00-05:00,65.71001,66.72,65.5,66.62,52294368,59176030.4,73.08819334652645,61.062510808599974,NaN,NaN,150.91799452647652,132.43690691816965,0.4613162839823888,1.0247031044804942,0.5633868204981054,2821610421,2717855864.2,87.53281857983978,77.15472667408812,NaN,NaN,24.101135508331907,9.766847789525514
2010-03-08T09:30:00-05:00,66.64,66.92999,66.515,66.74001,46056000,56140930.4,73.49344284855877,62.40913247586867,NaN,NaN,159.23917324510975,140.45243377432269,0.4793051218176665,1.1625182227701885,0.683213100952522,2867666421,2769330078.6,88.94873428913579,79.35068024476608,NaN,NaN,27.607897193720817,12.315569132981985
2010-03-09T09:30:00-05:00,66.55,67.49001,66.53,66.98,70685744,56595950.4,74.32603622824041,63.67149142028268,NaN,NaN,150.08880051747198,142.9936020268072,0.4745410880833839,1.2763894610567519,0.801848372973368,2938352165,2823815982.6,90.21547566362325,81.19341692038071,NaN,NaN,30.76384355367684,14.951036907366964
2010-03-10T09:30:00-05:00,67.03999,67.89999,67.00999,67.55,73655184,55678950.4,76.23535057649849,64.90045797513567,NaN,NaN,144.75934900172658,145.16531638110135,0.4757446258731529,1.3965291553148091,0.9207845294416562,3012007349,2881790481.8,91.35142281945568,82.78064220653653,NaN,NaN,34.067297615841795,17.68193129429194
2010-03-11T09:30:00-05:00,67.14,67.86,66.89999,67.75,60019392,55894148,76.88491150802787,66.14896364284634,NaN,NaN,128.29323070714494,146.65970959958594,0.45592857659528785,1.490695250185766,1.0347666735904781,3072026741,2942332619.4,92.35021079900005,84.15947197568427,NaN,NaN,37.00285809733144,20.44206369472615
2010-03-12T09:30:00-05:00,68.10001,68.13,67.25999,67.72,61862848,56388331.2,76.54693056982777,67.30682461389381,NaN,NaN,119.685384148883,140.41318752406724,0.40825943127912634,1.545090962689386,1.1368315314102597,3010163893,2980043313.8,92.90021417047787,85.36203649617214,NaN,NaN,39.334954542288756,23.14104810152081
2010-03-15T09:30:00-04:00,67.6803,67.81,67,67.49001,49874272,55586388.8,73.86610433226822,68.6514145739909,NaN,NaN,99.60462915879033,128.48627870680338,0.33193799992413275,1.5517540313154257,1.219816031391293,2960289621,2998567953.8,93.1603612638182,86.47568884105128,NaN,NaN,40.62219100454956,25.638354230524918
2010-03-16T09:30:00-04:00,67.83,68.10001,67.34,68.07001,52878112,55727418.4,76.13591386764497,69.95454914866446,NaN,NaN,103.03272476011402,119.07506355533175,0.2925938819835181,1.5855583838706906,1.2929645018871725,3013167733,3013531067.4,93.37163099853534,87.50282008072467,NaN,NaN,42.39805689214576,28.032597467899322
2010-03-17T09:30:00-04:00,68.22,68.88,68.2,68.47,53591392,55883689.6,77.58198057634485,71.35324136791597,NaN,NaN,113.87802494660217,112.89879874430687,0.26633421309042893,1.6258822682502085,1.3595480551597796,3066759125,3024481422.6,93.52915829395411,88.43945926514608,NaN,NaN,44.34214366965757,30.362532639579072
2010-03-18T09:30:00-04:00,68.44,68.78,68.14,68.25999,71535120,57306808,75.01188586075602,72.71222392340299,NaN,NaN,98.10823978334321,106.86180055954654,0.21011639413359084,1.6221935478267682,1.4120771536931773,2995224005,3009120875.4,90.28769672452437,89.12471557311093,NaN,NaN,45.29194136559166,32.49530531472373
2010-03-19T09:30:00-04:00,68.5,68.50999,67.16,67.4075,80546432,58491677.6,65.52298437191381,72.84779549695907,NaN,NaN,67.2126591857493,96.3672555669198,0.09658794765386891,1.5328120882605134,1.4362241406066445,2914677573,2990023611.4,86.28389342815659,89.4852282648261,NaN,NaN,43.379447944976235,34.05018283333123
2010-03-22T09:30:00-04:00,66.92999,68.50999,66.78,68.36,56682992,59058473.6,70.07751735971058,73.15532440746863,NaN,NaN,68.31331497804132,90.10899273077,0.06805976043931095,1.521298841155783,1.4532390807164721,2971360565,2992237800.2,86.35942093468563,89.7358687655452,NaN,NaN,43.02214119697527,35.33189117099466
2010-03-23T09:30:00-04:00,68.42,69.25,68.11,69.23,61187664,59169560,73.51859282336552,73.59666773074149,NaN,NaN,99.28205190430107,89.35885815960742,0.08888350449179794,1.5643434613312195,1.4754599568394215,3032548229,2996113899.4,86.49956891693438,89.88946218799401,NaN,NaN,43.80664038287419,36.542569629834595
2010-03-24T09:30:00-04:00,68.67999,68.97369,68.25,68.27,59666528,59629088,64.67963972970135,73.35496314281322,NaN,NaN,80.85849656404258,82.7549524830955,0.022559559611483815,1.5036594063537763,1.4810998467422924,2972881701,2977338414.6,82.09934579805189,89.63499662001378,NaN,NaN,41.49699287709354,37.250344379443014
2010-03-25T09:30:00-04:00,68.87,69.36,67.78999,67.838,66976944,60380137.6,61.11861999752306,72.49999361788441,NaN,NaN,70.89262461814717,77.3118294500563,-0.061265748878812865,1.4045176606437764,1.4657834095225892,2905904757,2959474565,78.03208034270574,88.95637246021849,NaN,NaN,38.443760248416204,37.4208323607249
2010-03-26T09:30:00-04:00,68.12,68.57001,67.56,67.81,58124304,60281456,60.88464280887987,71.59936504362163,NaN,NaN,49.52375918192039,73.77404944929052,-0.125744338619463,1.3086029862482604,1.4343473248677234,2847780453,2946095141,75.0338360324427,87.96245115616898,NaN,NaN,35.96998723206799,37.21356877091677
2010-03-29T09:30:00-04:00,68.11,68.39999,67.81,68.17999,38649168,58665358.4,62.9054581424117,70.78360946606243,NaN,NaN,55.81967614861108,71.27532168340447,-0.14903131683005943,1.2480581788301492,1.3970894956602087,2886429621,2929108952.2,71.28878074758403,86.6105443764519,NaN,NaN,34.49827539846742,36.82566971770972
2010-03-30T09:30:00-04:00,68.28999,68.735,67.87,68.39,35775552,57672771.2,64.04104678633496,69.91258776676504,NaN,NaN,68.83856022975445,65.18662334849515,-0.15514932641061518,1.2031528376469396,1.3583021640575548,2922205173,2907040341,66.63538754579481,84.84511328547612,NaN,NaN,33.60844230247183,36.36606580124717
2010-03-31T09:30:00-04:00,68.13,68.81,67.78999,67.80251,59821520,57853236.8,58.63348005144863,68.6089140912951,NaN,NaN,46.77124761065616,58.36917355781786,-0.2007264130965094,1.107394147686918,1.3081205607834274,2862383653,2884940731.4,62.25307211644444,82.69531766529356,NaN,NaN,31.215542587939332,35.63027677077462
2010-04-01T09:30:00-04:00,68.33,68.69,67.39,68.42999,58846992,58436526.4,62.295500296104976,67.59095478602919,NaN,NaN,43.917576126423555,52.97416385947313,-0.1906524155592748,1.0698050413343339,1.2604574568936087,2921230645,2888005909,62.620261980191586,80.53246393741597,NaN,NaN,30.228773162684558,34.85863339819033
2010-04-05T09:30:00-04:00,68.61,69.75999,68.44,69.71001,52028480,58423232,68.43436232318518,67.20297321395182,NaN,NaN,185.01984965792872,80.0733819546748,-0.10414737840137933,1.1302732338918844,1.2344206122932637,2973259125,2913101643.4,65.5730769321277,78.5619436280095,NaN,NaN,31.343418716733996,34.356459872268
2010-04-06T09:30:00-04:00,69.47,70.28999,69.33,70.12,50203504,58630607.2,70.11285815363172,66.77275494866517,NaN,NaN,238.10127081395976,116.52970088774455,-0.02955749242420369,1.1974737467630092,1.227031239187213,3023462629,2940508245,68.49962500579274,76.78537177138503,NaN,NaN,32.79505436679134,34.13340194291419
2010-04-07T09:30:00-04:00,70.03999,70.31,69.45,69.89799,71419936,58667316.8,68.00410952175113,66.08862130190847,NaN,NaN,198.06856763820332,142.37570236943432,-0.006611313477810965,1.2187670973399491,1.22537841081776,2952042693,2946475749,69.11526044531956,75.041521925054,NaN,NaN,33.31597637361031,34.01662686158507
2010-04-08T09:30:00-04:00,69.7,70.2,69.16,69.83,54606496,57714882.4,67.33617670159032,65.54035636196805,NaN,NaN,150.7755387195254,163.17656059120816,-0.007393021108639708,1.2161371344319605,1.2235301555406002,2897436197,2953486257.8,69.86048248008547,73.58243519330836,NaN,NaN,33.54024826886215,33.94857277691037
2010-04-09T09:30:00-04:00,69.94,70.25999,69.5,70.25,53074816,57367653.6,69.33956386449401,65.81296918286664,NaN,NaN,150.9037436192036,184.57379408976416,0.008153302002154472,1.2337217830432934,1.225568481041139,2950511013,2959342331.4,70.50079750167012,72.45507119855934,NaN,NaN,34.31638949530919,34.001118022395914
2010-04-12T09:30:00-04:00,70.28,70.67999,70.12,70.53999,49306160,56739819.2,70.6768575507702,65.85577919651375,NaN,NaN,159.08203458635947,179.38623107545033,0.024803237011279178,1.256572527305238,1.2317692902939588,2999817173,2964653941,71.10052187455918,71.36514983712173,NaN,NaN,35.35541941733327,34.19458965024411
2010-04-13T09:30:00-04:00,70.39,70.74001,69.94,70.7,42150976,56353654.4,71.41764773634799,65.70571169029822,NaN,NaN,136.1524486307421,158.9964666388068,0.03292052593453354,1.2729199477121256,1.239999421777592,3041968149,2968355045,71.53477787292704,70.29623619112121,NaN,NaN,36.42988414226523,34.51391743481856
2010-04-14T09:30:00-04:00,71.11,72.21001,70.99001,72.21001,62044208,56811959.2,77.25684131340404,66.60408323199127,NaN,NaN,198.0281336374492,158.98837983865596,0.12134300951353616,1.3916781836695122,1.270335174155976,3104012357,2998748977.8,74.87382466647962,69.78012753886604,NaN,NaN,39.38069838258232,35.209171855927664
2010-04-15T09:30:00-04:00,72.17999,72.58,72.09,72.42999,55145584,56889668.8,77.96314674001505,67.80726371359783,NaN,NaN,191.48622479850368,167.13051705445162,0.17286071451362517,1.4864110672980075,1.3135503527843824,3159157941,3051093326.6,79.36347129419823,69.87522689254408,NaN,NaN,41.98663735079264,36.17738121233695
2010-04-16T09:30:00-04:00,72.24001,72.47,70.94,71.4575,93255008,57975663.2,67.92088115672337,68.30985216701524,NaN,NaN,126.46302447799687,162.24237322621025,0.12205194193260804,1.4661152802001425,1.3440633382675344,3065902933,3074171710.6,80.97737115983136,70.29976511592898,NaN,NaN,41.04825649027955,36.87322053775732
2010-04-19T09:30:00-04:00,71.06,71.77,69.78,71.11,85286192,58212651.2,64.7132114426935,68.43897740274964,NaN,NaN,76.58730423331693,145.74342715560175,0.04937761605841384,1.4057853583405517,1.356407742282138,2980616741,3070331624.2,79.85824261727771,70.91186953519282,NaN,NaN,39.26438170111669,37.214814989665804
2010-04-20T09:30:00-04:00,71.49001,72.13,71.17999,72.08,50736576,57915330.4,69.09999750863528,68.8003310257711,NaN,NaN,116.03803486083804,141.72054440162094,0.05077532374188465,1.4198768969594937,1.369101573217609,3031353317,3068208657.8,79.20651814494882,71.8098074351324,NaN,NaN,39.126328100819606,37.4878882912592
2010-04-21T09:30:00-04:00,72.2,72.72,71.92,72.58,60389216,57875408,71.09477142887891,69.69042326701612,NaN,NaN,132.03306578205792,128.5215308305427,0.06841664767128752,1.4546223828067184,1.3862057351354309,3091742533,3065754693,78.40994561685389,72.96386982801877,NaN,NaN,39.65800673210181,37.79790521137958
2010-04-22T09:30:00-04:00,71.8401,73.49001,71.46001,73.35001,79289504,58856556.8,73.89020789016848,70.51861666659208,NaN,NaN,131.0618558407857,116.4366570389991,0.11238984024929777,1.5266930354470531,1.4143031951977554,3171032037,3068129512.2,78.63388826183066,74.10770027670729,NaN,NaN,41.03099160860917,38.259774696698095
2010-04-23T09:30:00-04:00,73.49001,74.21001,72.64,74.13,66273440,58821381.6,76.38190597052704,71.08629835568793,NaN,NaN,152.27197227292874,121.59844659798549,0.1709429316508404,1.6279818597613058,1.4570389281104654,3237305477,3102410021,81.60067511698608,75.25252871848288,NaN,NaN,43.024799808083955,38.94049256975322
2010-04-26T09:30:00-04:00,74.17,74.66,73.83,73.85001,62716192,59050976,73.66429546701228,71.33997244950083,NaN,NaN,150.31821962821604,136.34462967696533,0.16752991055685573,1.666451316306535,1.4989214057496794,3174589285,3141204529.8,84.26367867861784,76.37853255225612,NaN,NaN,43.75701829056085,39.62856767272574
2010-04-27T09:30:00-04:00,73.55,74.24001,72.02,72.16,101050128,62171024,59.82766838523692,70.75594093974982,NaN,NaN,83.56280835758466,129.84958437631462,0.03509062994909651,1.54278469318605,1.5076940632369535,3073539157,3149641697.8,84.7796270849887,77.49741588366103,NaN,NaN,39.53249764182881,39.614843382597606
2010-04-28T09:30:00-04:00,72.57001,72.78,71.92,72.28,79765872,64370540,60.396499605784896,70.26024971862086,NaN,NaN,55.518987294784374,114.54676867885992,-0.055846493490013804,1.4378859463744362,1.49373243986445,3153305029,3161954197,85.52546079600758,78.6163429062269,NaN,NaN,36.46636748130912,39.165061110984965
2010-04-29T09:30:00-04:00,72.82001,73.84,72.38,73.81,68869568,64822942.4,66.84303069126187,70.08192592053284,NaN,NaN,94.91298336796959,107.31699418429666,-0.025893603130911824,1.4613654359508104,1.4872590390817222,3222174597,3172182709,86.13336980120877,79.73295521333681,NaN,NaN,35.975571098655394,38.70941968065217
2010-04-30T09:30:00-04:00,73.8,73.92999,71.57001,71.64999,88767312,66318958.4,53.582412131707116,68.86089410488549,NaN,NaN,42.80367936495503,85.42333560270193,-0.15716817506381742,1.2907988202519505,1.447966995315768,3133407285,3151403070.6,78.8850286189235,80.28899140936282,NaN,NaN,30.346081117525024,37.51465702877686
2010-05-03T09:30:00-04:00,72.10001,73.31,72.06,73.25999,53776832,66406376,59.95873420764214,68.04240028140649,NaN,NaN,64.75638151232494,68.31096797952371,-0.14166391805263268,1.270887097749977,1.4125510158026098,3187184117,3153922037,79.11447523284835,80.83039836364291,NaN,NaN,28.24549918281315,36.190491622210615
2010-05-04T09:30:00-04:00,72.19,72.2,70.53,70.96001,105733248,69182863.2,49.49807897563833,66.05963154299465,NaN,NaN,-38.75446801353146,43.84751270530048,-0.2841772018587365,1.0573295134791891,1.3415067153379256,3081450869,3155504379.4,79.26688698126175,81.1441885289845,NaN,NaN,22.101351726309527,34.1777573513676
2010-05-05T09:30:00-04:00,70.38,70.95,69.39,69.92,110340320,71128882.4,45.622112904354836,63.749557697590355,NaN,NaN,-112.41015715759644,10.261683814824329,-0.4372059979049461,0.7949992179567431,1.2322052158616892,2971110549,3119065483.4,67.11977645229177,80.26963889741975,NaN,NaN,15.906751397429538,31.567613643662167
2010-05-06T09:30:00-04:00,69.42,70.19,63.36,67.3,195388128,78167964,37.628289365265886,61.58580114105768,NaN,NaN,-263.7555936152846,-61.47203158182651,-0.6886384806954704,0.37140711499235124,1.0600455956878216,2775722421,3029775048.2,47.792668477971745,77.89930299157264,NaN,NaN,7.335649716419823,28.105904511198975
2010-05-07T09:30:00-04:00,66.71001,67.62,64.64,65.36,189573056,84992876,33.015327225476724,59.32166655411362,NaN,NaN,-256.71467691711206,-121.37570283823993,-0.9436024239300055,-0.11945743422468524,0.8241449897053202,2586149365,2920323464.2,34.62941330933995,74.66867232671994,NaN,NaN,-1.3092787316822208,23.903735476501662
2010-05-10T09:30:00-04:00,68.55,69.06,67.7,69.03,107708192,87912977.6,46.4017624779331,57.7003640519206,NaN,NaN,-118.72519823708642,-158.0720187881222,-0.8272464321304052,-0.20991305045768627,0.6173333816727189,2693857557,2821658152.2,27.323619977826027,70.96275102906831,NaN,NaN,-2.7192725279661567,20.100448618720545
2010-05-11T09:30:00-04:00,68.21001,70.52,67.98,69.49001,100027680,90806812.8,47.80964255972651,56.03714056126686,NaN,NaN,-81.69743640642012,-166.66061246669992,-0.687222472797757,-0.24169470932447723,0.44552776347327966,2793885237,2764145025.8,24.128158462725253,67.08548051805913,NaN,NaN,-3.151095353507375,16.77879947983084
2010-05-12T09:30:00-04:00,69.85001,71.7,69.78999,71.62,84620256,91935615.2,53.853926825863574,54.605977628102224,NaN,NaN,-11.502199172287002,-146.47902086963805,-0.43156363601841585,-0.09392678154974021,0.33763685446867564,2878505493,2745624014.6,23.187708718824823,63.12503912213013,NaN,NaN,-1.0953102451449896,14.225355233405722
2010-05-13T09:30:00-04:00,71.46001,72.10001,70.59,70.92999,78558688,93106270.4,51.76254775355149,52.8474520411754,NaN,NaN,-2.4006454892966924,-94.20803124444045,-0.2958113480984981,-0.03212733065444695,0.2636840174440511,2799946805,2750468891.4,24.021970158949827,59.0122744822704,NaN,NaN,-0.32015896143313366,12.147424634143029
2010-05-14T09:30:00-04:00,70.47,70.5,68.62,69.56,86140320,92750536,47.793967547107016,50.99957147546788,NaN,NaN,-62.91074922292117,-55.44724570560227,-0.28505104242449447,-0.09262978558656698,0.1924212568379275,2713806485,2776000315.4,28.433203313093557,55.02438338473296,NaN,NaN,-1.1160533463156457,10.252642065506075
2010-05-17T09:30:00-04:00,70,70.57001,67.75,69.69,78576256,92415039.2,48.19981374128232,50.16901042947113,NaN,NaN,-65.0729359683516,-44.71679325185529,-0.2568218161936977,-0.12860601340419464,0.12821580278950306,2792382741,2795705352.2,31.72780377094692,51.23496743372997,NaN,NaN,-1.5867563127613207,8.561299440039305
2010-05-18T09:30:00-04:00,70.60001,70.8,68.13,68.35001,87163936,94236407.2,44.370848605608344,49.02432107231566,NaN,NaN,-65.92650915073487,-41.562607800718254,-0.3123492104392467,-0.2622207102595553,0.05012850017969139,2705218805,2777972065.8,30.372703931834067,47.29548480057472,NaN,NaN,-3.230082138099441,6.876816357448055
2010-05-19T09:30:00-04:00,68.03999,68.8,66.58,67.53999,107301184,96582005.6,42.18904996966973,47.26332244934479,NaN,NaN,-102.7164713687851,-59.80546224001787,-0.38292943967718074,-0.42853329941678453,-0.04560385973960379,2597917621,2721854491.4,26.513539076366143,43.03692546308595,NaN,NaN,-5.257467098196698,5.143347292355948
2010-05-20T09:30:00-04:00,65.77,66.12,64.08,64.12,166841376,100959599.2,34.4800419985922,45.898867439836586,NaN,NaN,-168.79781316247528,-93.08489577465359,-0.6249339764040058,-0.8267713302446111,-0.20183735384060528,2431076245,2648080379.4,22.47125377961845,39.007370117421296,NaN,NaN,-9.843083419938372,3.002428619171045
2010-05-21T09:30:00-04:00,63.07001,65.64,62.75999,65.07001,139644432,104628148.8,37.87588043534448,44.32152074181532,NaN,NaN,-156.23212763760134,-111.74917145758964,-0.6813901284888493,-1.053575014451667,-0.3721848859628176,2570720677,2619463217.8,21.12576828382099,34.8653196210622,NaN,NaN,-12.343610800513874,0.8101372735017711
2010-05-24T09:30:00-04:00,64.8,65.41,64.14,64.2,76022624,105293470.4,36.0339790193935,43.35979931636926,NaN,NaN,-138.35128924398379,-126.40484211271605,-0.7331850215355467,-1.2886661628822509,-0.5554811413467042,2494698053,2559926280.2,18.626932704066803,30.533894315548277,NaN,NaN,-14.952971659077932,-1.441735431152472
2010-05-25T09:30:00-04:00,62.8,64.24001,61.71001,64.19,110830688,105782498.4,36.01230123173317,42.67338419689628,NaN,NaN,-147.6121392436724,-142.74196813130357,-0.7227882478082274,-1.4589664511069884,-0.736178203298761,2383867365,2495655992.2,16.37518457633736,26.909280610122956,NaN,NaN,-17.002787429858476,-3.664742859539044
2010-05-26T09:30:00-04:00,64.44,65.95,63.98,64.345,104172816,107002845.6,36.64847562974123,42.60339750150166,NaN,NaN,-97.50634020812824,-141.6999418991722,-0.6617786631066811,-1.5634015321821124,-0.9016228690754313,2488040181,2473680504.2,15.6773321545746,24.61532801559458,NaN,NaN,-18.477380845239598,-5.780834000353408
2010-05-27T09:30:00-04:00,65.96001,67.14,64.3479,67.11,86856128,107902173.6,46.808014932422815,43.58858948056924,NaN,NaN,-52.79441126323541,-118.49926151932422,-0.4041717422618323,-1.4068375469027217,-1.0026658046408894,2574896309,2502444517,20.45572594535804,23.60292177531016,NaN,NaN,-16.655999082199685,-7.334429012045733
2010-05-28T09:30:00-04:00,66.91,67.17,65.73,66.25,92380752,108082845.6,44.42184412504946,43.44716674107756,NaN,NaN,-41.865532563610934,-95.62594250452615,-0.26726344249448886,-1.3367451077590005,-1.0694816652645116,2482515557,2484803493,19.71773075451715,23.05964397364524,NaN,NaN,-15.879637404265894,-8.555173068077185
2010-06-01T09:30:00-04:00,65.60001,66.47,64.19,64.24001,88425376,109815272.8,39.37023807776411,42.844352135223104,NaN,NaN,-74.68275737382605,-82.89223613049461,-0.2859641871681049,-1.4269368992246427,-1.1409727120565378,2394090181,2464681918.6,18.880998622385505,22.6848468421924,NaN,NaN,-16.801133369648788,-9.733167396873128
2010-06-02T09:30:00-04:00,64.63,66.10001,64.02,66.07001,61553760,107606298.4,45.452304697760425,42.24423626893002,NaN,NaN,-56.01647246535708,-64.57310277483155,-0.15550638120150784,-1.3353556885584226,-1.1798493073569147,2455643941,2479037233.8,21.442260300378223,22.560171955160502,NaN,NaN,-15.605081717625433,-10.572012299837743
2010-06-03T09:30:00-04:00,66.2,67.09,65.87,66.92,74870368,105832800.8,48.05861571457117,41.97966969471714,NaN,NaN,-12.922082046798018,-47.65625114256552,-0.000585217354491796,-1.1805808290500295,-1.1799956116955377,2530514309,2487532059.4,22.991772154498392,22.486586383413968,NaN,NaN,-13.803311003544597,-11.033626400367293
2010-06-04T09:30:00-04:00,65.11,65.7,63.37,63.55499,105564944,101341641.6,39.925492649865085,41.41763577348557,NaN,NaN,-85.27341672638622,-54.15205223519566,-0.10744223728870073,-1.3142984083064135,-1.2068561710177128,2424949365,2457542670.6,21.38789260662513,21.983349904380507,NaN,NaN,-14.935681718945915,-11.591062874449953
2010-06-07T09:30:00-04:00,63.84,64.11,61.86,61.92,88434128,96284695.2,36.67760855334624,40.594621117204426,NaN,NaN,-122.95064017090625,-70.36907375665473,-0.2621244124230482,-1.534511686546523,-1.2723872741234747,2336515237,2428342606.6,19.930056493690188,21.14065367029074,NaN,NaN,-16.97336233611759,-12.35996279754533
2010-06-08T09:30:00-04:00,62.11,62.60001,60.7,61.89,129072000,97352885.6,36.618745262890705,40.040899449867446,NaN,NaN,-134.88788422894615,-82.41009912767875,-0.335649626279962,-1.6919493069734273,-1.3562996806934653,2207443237,2391013217.8,18.220250582422977,20.272621288189953,NaN,NaN,-18.5631904218281,-13.246138172442869
2010-06-09T09:30:00-04:00,62.37,63.42,61.59,61.92999,108645568,97783780,36.76443192112369,39.65342673211416,NaN,NaN,-107.5846813532176,-92.72374090525085,-0.34922130419094133,-1.792826310932142,-1.4436050067412007,2316088805,2363102190.6,17.042936511113368,19.59614967638618,NaN,NaN,-19.780824983366006,-14.179664859717603
2010-06-10T09:30:00-04:00,63.03,64.08,62.8,64.07001,75497248,97327629.6,44.161262189699364,40.34494246005039,NaN,NaN,-63.752207005041676,-102.88976589689958,-0.18968886294231346,-1.6807160854190926,-1.491027222476779,2391586053,2335316539.4,15.938799329013449,19.12954578705725,NaN,NaN,-18.576184095279427,-14.807739036226435
2010-06-11T09:30:00-04:00,63.28999,65.03,63.17999,64.94,65298880,96664639.2,46.88152544578743,40.98820281793917,NaN,NaN,-34.534300525899674,-92.74194265680227,-0.010639075863214442,-1.5043260673057972,-1.4936869914425828,2456884933,2341703653,17.26568357029656,18.853825450376938,NaN,NaN,-16.748417255416342,-15.084978781824994
2010-06-14T09:30:00-04:00,65.8,66.5,65.16,65.35001,70547120,95884979.2,48.16320183140628,41.854575875940085,NaN,NaN,24.119768418532605,-63.32786093891449,0.1419271193672751,-1.316278092233489,-1.458205211600764,2527432053,2379887016.2,24.89778948543517,19.30174379190325,NaN,NaN,-14.877087847140563,-15.055280076870075
2010-06-15T09:30:00-04:00,65.92,67.17,65.35561,66.99001,72341936,95573263.2,53.04366523535957,43.07110187619911,NaN,NaN,74.4146988020163,-21.46734433272201,0.3480677479469656,-1.023120526667057,-1.3711882746140227,2599773989,2458353166.6,37.63057192528493,20.81998574539951,NaN,NaN,-11.757824159178853,-14.584214945771329
2010-06-16T09:30:00-04:00,66.39999,67.38,66.25,66.67999,62370336,94333583.2,52.0460992664523,44.17093213596418,NaN,NaN,102.39452593819179,20.52849712555987,0.4517425234571495,-0.806510120292586,-1.2582526437497354,2537403653,2502616136.2,43.454445639276635,22.804065280021085,NaN,NaN,-9.48893160334833,-13.856317325425186
2010-06-17T09:30:00-04:00,67.08,67.2,65.97,66.75999,67329376,92334992.8,52.29541699528248,44.56288942616845,NaN,NaN,102.8057198959683,53.84008250576187,0.509619436963209,-0.6212283475457241,-1.130847784508933,2604733029,2545245531.4,48.44725820448281,24.803460441387138,NaN,NaN,-7.559046761108901,-12.956707244808573
2010-06-18T09:30:00-04:00,66.97,67.53329,66.45,66.8,52765424,86631195.2,52.42862740140089,45.13480251733641,NaN,NaN,103.58531349292096,81.46400530952599,0.5320435402157297,-0.4657933592392709,-0.9978368994550006,2657498453,2585368235.4,52.6821069261479,27.158058739360765,NaN,NaN,-5.920339496430828,-11.951511852183181
2010-06-21T09:30:00-04:00,67.87,67.995,65.72,66.1077,58651376,82581542.4,49.83548026291757,45.88231981627594,NaN,NaN,78.19697425846394,92.27944647751227,0.48312405205004294,-0.39393183439244694,-0.8770558864424899,2598847077,2599651240.2,54.12674727451484,29.67561221451286,NaN,NaN,-5.1621408233014465,-10.981601705200076
2010-06-22T09:30:00-04:00,66.36,67.10001,64.67,64.75,70837184,82322270.4,45.122005010781,45.8587269814917,NaN,NaN,21.844725647749847,81.76545184665898,0.34848681239889057,-0.44144737094387665,-0.7899341833427672,2528009893,2585298421,52.39560980515798,31.886565750568558,NaN,NaN,-5.762214421436469,-10.235974950376704
2010-06-23T09:30:00-04:00,64.58,65.25999,63.81,64.57001,70319440,80296708,44.52083797897213,45.60602857180605,NaN,NaN,-29.680859972753066,55.350374664469996,0.2415456822430555,-0.4880020805389478,-0.7295477627820033,2457690453,2569355781,50.46490106675315,33.8489321014439,NaN,NaN,-6.424824751458454,-9.691524921959811
2010-06-24T09:30:00-04:00,64.03,64.53,63.39,63.53999,72527568,78714445.6,41.142670276525514,45.692969830853215,NaN,NaN,-62.30797513917842,22.32763565744066,0.10277250746625999,-0.6010821284491783,-0.7038546359154383,2385162885,2525441752.2,45.492260107686256,35.570672637233976,NaN,NaN,-7.937664976026097,-9.440973501112138
2010-06-25T09:30:00-04:00,63.78,64.91499,63.2,64.63,87177632,78730520.8,45.827226486808705,46.34651396895769,NaN,NaN,-36.591228641958566,-5.707672769535241,0.08638346543395203,-0.5958753041229983,-0.6822587695569503,2472340517,2488410165,41.75573790476069,37.12964988088187,NaN,NaN,-7.985314543016255,-9.233022221384156
2010-06-28T09:30:00-04:00,64.59,65.24001,63.91,64.25999,64649344,77343950.4,44.531530296284004,46.91171289991434,NaN,NaN,-21.390471132533225,-25.62516184773468,0.05418961657779675,-0.6145217488347043,-0.6687113654125011,2407691173,2450178984.2,38.261723795260146,38.56118368179881,NaN,NaN,-8.378272605929254,-9.110915133462028
2010-06-29T09:30:00-04:00,63.22,63.22,61.38,61.83,110281936,78436778.4,37.11067205794826,46.936444338258966,NaN,NaN,-123.68709352447286,-54.731525682179225,-0.1178093444594347,-0.8159730459867944,-0.6981637015273597,2297409237,2404058853,34.510155060242084,39.80884214959372,NaN,NaN,-11.01667382605127,-9.38316637526049
2010-06-30T09:30:00-04:00,61.63,62.62,60.94,61.11501,93806368,80049408.8,35.249365187286585,46.29988026665804,NaN,NaN,-134.00005566888817,-75.59536482140625,-0.25870316681056527,-1.0215426600405664,-0.7628394932300011,2203602869,2353241336.2,30.91346028058065,40.87846078899138,NaN,NaN,-13.78895738383982,-10.012565090771822
2010-07-01T09:30:00-04:00,61.2,61.39999,59.12,60.67999,114232624,82017521.6,34.127807817759304,45.38890043608461,NaN,NaN,-163.16140569285423,-95.76605093214141,-0.35425833566982534,-1.2056624128172828,-0.8514040771474575,2089370245,2294082808.2,27.341056287985268,41.59813026882629,NaN,NaN,-16.417104489476472,-10.927499290586772
2010-07-02T09:30:00-04:00,60.75,60.89,59.42,59.82001,72092320,80343890.4,31.962709645248694,44.23172242278765,NaN,NaN,-147.86531606121892,-118.02086841599348,-0.4426994830368922,-1.4047784309435727,-0.9620789479066805,2017277925,2203070289.8,22.947495027771055,41.45882352185028,NaN,NaN,-19.31231542551274,-12.125330167004767
2010-07-06T09:30:00-04:00,60.86,61.5,58.66,59.03999,89452496,80394808.8,30.097604976321904,42.592718118570666,NaN,NaN,-141.45128503634407,-142.03303119675564,-0.5159336063975066,-1.6069959559035638,-1.0910623495060572,1927825429,2107097141,19.40610976173913,40.15707622445415,NaN,NaN,-22.335731823467846,-13.58395897507092
2010-07-07T09:30:00-04:00,59.22,61.14999,58.9865,61.10001,79640192,77923218.4,40.04747643109947,41.735673630331185,NaN,NaN,-111.9083333878287,-139.6772791694268,-0.3933765729593317,-1.5827830657052218,-1.18940649274589,2007465621,2049108417.8,17.635198758247824,38.31284430438067,NaN,NaN,-22.025714945473595,-14.789924113699874
2010-07-08T09:30:00-04:00,61.77,62.11,61.03999,61.98,58770016,75429440.8,43.73197242920506,41.12399901846851,NaN,NaN,-67.07173607103057,-126.2916152498553,-0.2289362508065198,-1.4755768062540398,-1.24664055544752,2066235637,2021634971.4,16.850634030847473,36.05594257769243,NaN,NaN,-20.62111973619131,-15.622952059770078
2010-07-09T09:30:00-04:00,61.98,62.94,61.77,62.94,38203360,73564746.4,47.52105358740679,40.773458031754636,NaN,NaN,-36.993880674615006,-101.05811024620745,-0.041236684806830404,-1.298186411456058,-1.2569497266492276,2104438997,2024648721.8,17.285354066831744,33.52760308774127,NaN,NaN,-18.25863299695591,-15.999477907939482
2010-07-12T09:30:00-04:00,62.75999,63.17999,61.62,62.23,43039648,72451784.8,45.102029992690895,40.43535444102417,NaN,NaN,-39.39745562407652,-79.36453815877897,0.04472029139161782,-1.2010493624097052,-1.245769653801323,2061399349,2033473006.6,18.62684818094813,30.99189600962936,NaN,NaN,-17.01154025183061,-16.14405824278107
2010-07-13T09:30:00-04:00,63.08,64.44,62.84,64.2,83581184,73103488,52.349900366204245,40.951632680697244,NaN,NaN,9.175932020795369,-49.23909474735109,0.23333038909594106,-0.9541066674313967,-1.1874370565273378,2144980533,2076904027.4,25.068209634785703,29.039938854602774,NaN,NaN,-13.547706688760536,-15.773150877920994
2010-07-14T09:30:00-04:00,64.02,64.39,63.47,63.97,52527472,72112764.8,51.49509684139216,41.44979402801296,NaN,NaN,17.952152005969467,-23.266997668591443,0.33546355410013673,-0.768107613902167,-1.1035711680023037,2092453061,2093901515.4,27.48745042892375,27.398692380472102,NaN,NaN,-11.035149714013214,-15.09629356879131
2010-07-15T09:30:00-04:00,64.10001,64.10001,62.61,63.38,71047808,72546638.4,49.27248428495656,42.030495028615185,NaN,NaN,4.506330922732785,-8.951384269838766,0.3543017154764523,-0.6606940236567382,-1.0149957391331905,2021405253,2084935438.6,26.992391669243503,26.077273206297615,NaN,NaN,-9.598867623924527,-14.310947005238912
2010-07-16T09:30:00-04:00,62.91,63.03999,60.89,61.07001,98127504,74086544.8,41.68614309531857,41.73470335779445,NaN,NaN,-50.8887777132246,-11.7303636775607,0.2093713858560815,-0.7532815068130887,-0.9626528926691702,1923277749,2048703189,25.03052379164417,24.882615055360727,NaN,NaN,-10.713599112009344,-13.797040163348974
2010-07-19T09:30:00-04:00,61.27,61.48,60.14999,61.33,63879584,74642252.8,42.754461677408635,41.607769885017646,NaN,NaN,-70.75507282299306,-18.001887117344,0.13292454608487758,-0.7964972100630732,-0.9294217561479508,1987157333,2033854785.8,24.25256741359813,23.881961028099152,NaN,NaN,-11.27865745915217,-13.437271205606574
2010-07-20T09:30:00-04:00,60.45,62.47,60.21001,62.3595,71434432,75281405.6,46.90263040390816,42.30719548115764,NaN,NaN,-35.92728982466596,-27.02253148643627,0.15221466922461513,-0.7391534196171818,-0.891368088841797,2058591765,2016577032.2,23.34340450140148,23.084335988181966,NaN,NaN,-10.490312449026327,-13.016277097523682
2010-07-21T09:30:00-04:00,62.85001,62.97,61.10001,61.24001,68462192,75162656,43.23388493218813,42.877518320079176,NaN,NaN,-25.63095853100543,-35.739153593831254,0.09300919646479644,-0.7751065932608014,-0.8681157897255979,1990129573,1996112334.6,22.278120796537806,22.467526025036047,NaN,NaN,-10.947300425086492,-12.720709001461227
2010-07-22T09:30:00-04:00,62.17999,63.66,62.17,63.42,81000688,75696718.4,51.233370981230166,44.0993442603271,NaN,NaN,49.92970647997241,-26.654478482383333,0.19806097226254282,-0.6205395743974194,-0.8186005466599622,2071130261,2006057336.2,24.091039548958094,22.235381972248398,NaN,NaN,-8.727825786971168,-12.150297113676933
2010-07-23T09:30:00-04:00,63.11,65.11,62.94,64.98,73919744,75766327.2,56.01059671680052,45.817050479723655,NaN,NaN,115.91594397357845,6.706465854977279,0.36054128717760003,-0.36792393768796217,-0.7284652248655622,2145050005,2050411787.4,31.738668997244616,22.863322970067937,NaN,NaN,-5.2417829377887175,-11.163366517121474
2010-07-26T09:30:00-04:00,65.25999,66.52,64.92,66.46001,66150128,74714952,60.012796757157446,47.95384989264047,NaN,NaN,185.30168439320636,57.917817298217166,0.5445726897896092,-0.047749362628550784,-0.5923220524181599,2211200133,2095220347.4,38.48157998208278,24.225856557235343,NaN,NaN,-0.964021408397408,-9.70631721587518
2010-07-27T09:30:00-04:00,67.06,67.27,65.98,66.22,84132000,75689084.8,59.07415980981867,49.312898705406134,NaN,NaN,189.8316288029302,103.0696010237364,0.6214558169983022,0.18449771882971788,-0.43695809816858433,2127068133,2108915621,40.41878868560721,25.853255837761015,NaN,NaN,2.1059126527946415,-8.018855806065204
2010-07-28T09:30:00-04:00,66.13,66.42999,64.78,65.14999,59706256,73160300.8,54.94797519695467,50.1140417602454,NaN,NaN,120.7464099280316,132.3450747155438,0.5727650559364316,0.2789982217519551,-0.29376683418447647,2067361877,2124362081.8,42.613726495088066,27.693476728063917,NaN,NaN,3.397457219882615,-6.387953945215516
2010-07-29T09:30:00-04:00,65.71001,65.99001,63.95,64.98,63319632,71635964,54.299095895487234,50.598187639394,NaN,NaN,88.68842725404508,140.09681887035833,0.5040511909978155,0.33629715456279285,-0.1677540364350226,2004042245,2110944478.6,41.194085922330885,29.401243289170996,NaN,NaN,4.241318738527037,-4.86948641896658
2010-07-30T09:30:00-04:00,64.10001,65.61,63.82001,65.02,67453376,69297001.6,54.43544762039078,51.26486032708685,NaN,NaN,74.28627604326398,131.77088528429545,0.43864156340732885,0.38054791782413844,-0.058093645583190384,2071495621,2096233601.8,39.635048361174704,30.901829016330034,NaN,NaN,4.964140356471886,-3.464682593903942
2010-08-02T09:30:00-04:00,66.17,66.53999,65.5901,66.151,49896512,68187211.2,58.23021678322339,51.6848829283025,NaN,NaN,113.33066413666265,117.3766812329867,0.44735716690950544,0.5011028130536914,0.05374564614418599,2121392133,2078272001.8,37.7561612559697,31.808111274986036,NaN,NaN,6.69025139336143,-2.0139777385803175
2010-08-03T09:30:00-04:00,65.92999,66.53,65.09,65.62,51145680,66271870.4,55.87728076758116,51.997896065887424,NaN,NaN,90.82066337166812,97.5744881467343,0.39499156813937497,0.5474851063184047,0.15249353817902975,2070246453,2066907665.8,36.57478877898765,32.45720687141917,NaN,NaN,7.4841302048616525,-0.6571051752314647
2010-08-04T09:30:00-04:00,65.98,66.48,65.715,66.31,40818048,64330763.2,58.238709659599586,52.63834073550479,NaN,NaN,99.71663299715394,93.36853276055876,0.3841076481810662,0.6326280984053625,0.2485204502242963,2111064501,2075648190.6,38.177026791228506,33.256109380132386,NaN,NaN,8.828587798628499,0.6979938210342442
2010-08-05T09:30:00-04:00,65.66,66.21001,65.46001,65.53,37994592,63291992,54.67631496918479,53.56621015506666,NaN,NaN,73.4180144779311,90.31445020533596,0.3051067690982292,0.6299039115970828,0.3247971424988536,2073069909,2089453723.4,40.724112279745235,34.37707998642532,NaN,NaN,8.984686095923832,1.8818070031613283
2010-08-06T09:30:00-04:00,64.45,65.41,63.86,65.14,62489072,64506277.6,52.932861540748476,54.293238716733796,NaN,NaN,28.861795411184833,81.22955407892013,0.21174634515057156,0.589480073937068,0.37773372878649647,2010580837,2077270766.6,39.1896737414216,35.44401615269842,NaN,NaN,8.632473014542848,2.8461878619301166
2010-08-09T09:30:00-04:00,65.62,66.11,64.85001,65.86,35103312,64109460.8,55.738853038954616,54.92439747637997,NaN,NaN,59.77353414125556,70.5181280798387,0.1846347384514947,0.6085271518508648,0.4238924133993701,2045684149,2062129169.8,37.30816839731024,36.441499288120475,NaN,NaN,9.099722738329277,3.7395499871299966
2010-08-10T09:30:00-04:00,65.21001,65.41,64.13,64.62,59849760,62922889.6,50.189351089986594,55.42121648765129,NaN,NaN,16.49675691474876,55.65334678845484,0.07496440117462422,0.5175979148676504,0.44263351369302617,1985834389,2045246757,35.274667987432,37.369824087470064,NaN,NaN,7.907385578982076,4.334955071680294
2010-08-11T09:30:00-04:00,63.33,63.33,61.91,62.08,87392560,64666144,41.15127504066658,54.70106677761104,NaN,NaN,-82.03502066538614,19.30301605594682,-0.16383687069528713,0.23783742532391727,0.4016742960192044,1898441829,2002722222.6,30.73099840852666,37.84410686315353,NaN,NaN,3.8059795217593395,4.2593871359773
2010-08-12T09:30:00-04:00,60.85001,62.14999,60.75999,61.77,63307280,64279117.6,40.19979237352983,53.571723610234564,NaN,NaN,-108.52257452004713,-17.085101743648824,-0.3283697457318985,-0.008787886145668722,0.31958185958622976,1835134549,1955135150.6,26.601609223781807,37.477174022191896,NaN,NaN,0.22173821427544493,3.6825801471627493
2010-08-13T09:30:00-04:00,61.5,61.67999,60.97,61.07001,68244128,62784948.8,38.059862108321845,52.003656849603445,NaN,NaN,-118.7491705866462,-46.607294943215024,-0.4618673729035895,-0.2577523565432571,0.20411501636033236,1766890421,1906397067.4,23.167924476916966,36.38334148610863,NaN,NaN,-3.431926922146163,2.6662219944043333
2010-08-16T09:30:00-04:00,60.64,61.92,60.38,61.56,51373856,62159662.4,40.44954862454931,50.67332747922706,NaN,NaN,-118.87440997415646,-82.33688376629742,-0.4919201089967479,-0.4107851198856025,0.08113498911114538,1818264277,1860913093,20.507559971184506,34.96111086364986,NaN,NaN,-5.763346145269418,1.4619979744509404
2010-08-17T09:30:00-04:00,62.22,63.155,61.86,62.62,54593152,61317598.4,45.360636743683806,49.98851758970771,NaN,NaN,-71.74433575965405,-99.98510230117797,-0.41806228535033646,-0.4414428675767752,-0.02338058222643874,1872857429,1838317701,19.32063937111107,33.29731892622293,NaN,NaN,-6.320201332772206,0.35025521627620515
2010-08-18T09:30:00-04:00,62.55,63.42999,61.94,62.81,61766512,60982814.4,46.216829381673065,49.411212838720985,NaN,NaN,-68.79940395704554,-97.33797895950985,-0.337515604108795,-0.4452750873624325,-0.10775948325363749,1934623941,1845554123.4,20.899613432365328,31.84771374836825,NaN,NaN,-6.529320941857865,-0.6325413777429476
2010-08-19T09:30:00-04:00,62.59,62.8521,60.94,61.09,89239008,61394730.4,40.0921331597845,48.38669037724911,NaN,NaN,-107.2754907636306,-97.08856220822655,-0.3781213381966838,-0.5804111559994922,-0.20228981780280844,1845384933,1847604200.2,21.369114537725252,30.543004189550427,NaN,NaN,-8.601480407702434,-1.7709612391657312
2010-08-20T09:30:00-04:00,60.87,61.19,60.14,61.14999,64087216,60903104,40.38885326861484,47.11230726906279,NaN,NaN,-118.54785723674043,-97.0482995382454,-0.37807782098741893,-0.6748870940370821,-0.2968092730496632,1909472149,1876120545.8,27.789577175564858,29.831105326664368,NaN,NaN,-10.181909902742579,-2.972525333962424
2010-08-23T09:30:00-04:00,61.60001,61.92,60.28,60.32001,55423680,60366781.6,37.61313070522819,45.80772512175186,NaN,NaN,-103.48379604504831,-93.97017675242378,-0.40849251225247174,-0.8074249133652529,-0.39893240111278117,1854048469,1883277384.2,29.348787849219278,29.314962403109487,NaN,NaN,-12.359793367820904,-4.313563624513636
2010-08-24T09:30:00-04:00,59.36,60.32001,58.8,59.63,78904496,60105406.4,35.43294151858581,44.178741683108015,NaN,NaN,-130.36673274788868,-105.6946561500707,-0.4465398346721481,-0.9571071944529663,-0.5105673597808182,1775143973,1863734693,27.596495035181007,28.55921013482038,NaN,NaN,-14.856955507525987,-5.819762464943971
2010-08-25T09:30:00-04:00,59.14,60.67999,58.89,60.52991,64032128,60321700,40.293691623531934,43.15141144413281,NaN,NaN,-103.75576261504172,-112.68592788166993,-0.38489390425351944,-0.9916847400977176,-0.6067908358441981,1839176101,1844645125,25.96565202072405,27.50503440203315,NaN,NaN,-15.596600291620321,-7.216453583040592
2010-08-26T09:30:00-04:00,60.75,61.28,59.86,60.08,74582368,60884836.8,38.72410623413846,42.13650035080353,NaN,NaN,-83.75255308933305,-107.98134034681043,-0.3492588637832479,-1.043364415573258,-0.6941055517900101,1764593733,1828486885,24.63840007324599,26.465657711449175,NaN,NaN,-16.6675038184752,-8.566603616674108
2010-08-27T09:30:00-04:00,60.77,61.8,59.56,61.64999,72004624,61112399.2,46.54870448484344,41.480061168367016,NaN,NaN,-59.3190837651532,-96.13558565249298,-0.20209366217983382,-0.9467226295148023,-0.7446289673349685,1836598357,1813912126.6,23.47289852896658,25.47742414942463,NaN,NaN,-15.239245093710299,-9.519838113393563
2010-08-30T09:30:00-04:00,61.35001,61.66,60.27,60.3,42410496,60738098.4,41.62648999638446,40.86842823310972,NaN,NaN,-63.710558320242974,-88.18093810753192,-0.178623848982306,-0.9679087785628511,-0.7892849295805451,1794187861,1801940005,22.530102059130925,24.567098011688834,NaN,NaN,-15.535105077869368,-10.379161965461535
2010-08-31T09:30:00-04:00,60.14999,60.91,59.67999,60.17999,60627024,61212165.6,41.20931345157941,40.8725738338892,NaN,NaN,-76.13277608786598,-77.33414677552737,-0.1550126652233652,-0.9830507611097516,-0.8280380958863864,1733560837,1793623377.8,21.872871385814847,23.934374652923708,NaN,NaN,-15.895946243881646,-11.167274005235836
2010-09-01T09:30:00-04:00,61.23,62.55,61.02,62.50999,62585184,62300522.4,51.39430003188112,41.672181523771435,NaN,NaN,1.1971366146582911,-56.34356692958737,0.024156609346188573,-0.7978423342036507,-0.8219989435498393,1796146021,1785017361.8,21.184208765256358,23.547417477314745,NaN,NaN,-12.851503873642828,-11.40787827215112
2010-09-02T09:30:00-04:00,62.49001,63.38,62.2742,63.2,45824176,62692001.6,53.93918243480215,42.8064186899486,NaN,NaN,56.20723891908335,-28.3516085279041,0.18671894385527943,-0.5886002637307399,-0.7753192075860194,1841970197,1800492654.6,25.713517407164503,23.729245543761,NaN,NaN,-9.542877581032927,-11.141449601991377
2010-09-03T09:30:00-04:00,64.16,64.53,63.61,64.33,51987568,62166926.4,57.832879862751156,44.04808520696302,NaN,NaN,123.73623604666565,8.259455434459671,0.35800414752860965,-0.3278140231752573,-0.685818170703867,1893957765,1811964536.2,28.972095567026173,24.33385522917826,NaN,NaN,-5.4711602237404815,-10.331408262241249
2010-09-07T09:30:00-04:00,64.13,64.14,62.91,63.11,48882208,62855871.2,52.657341221438806,44.56927838394552,NaN,NaN,99.24533039059405,40.85063317662707,0.3749901493515655,-0.21708048401441005,-0.5920706333659755,1845075557,1822142075.4,31.829095400858762,25.22731637416024,NaN,NaN,-3.6954096365142255,-9.38340845856596
2010-09-08T09:30:00-04:00,63.25999,63.995,63.23,63.48,58868800,62806823.2,54.00180198256407,45.12534785543774,NaN,NaN,120.93011060543333,80.26321051528694,0.394989373510405,-0.0983339164779693,-0.49332328998837427,1903944357,1856218779.4,40.46404868662335,26.624776035178666,NaN,NaN,-1.8500684831766046,-8.307217033510337
2010-09-09T09:30:00-04:00,64.45,64.48,63.03999,63.52,52495520,61061971.2,54.1533833182593,46.12972286675737,NaN,NaN,115.88098655571996,103.19998050349928,0.3938687449358095,-0.0009873588186124493,-0.3948561037544219,1956439877,1888277550.6,47.23543057391786,28.472370037763852,NaN,NaN,-0.33090591822989895,-7.167744017041703
2010-09-10T09:30:00-04:00,63.75999,64.11,63.35001,63.72,46974640,60245339.2,54.952717158053474,47.16999885886013,NaN,NaN,102.83295032922639,112.52512278552788,0.38888246669872695,0.09124697961898676,-0.2976354870797402,2003414517,1920566414.6,53.02985719778459,30.27524718220812,NaN,NaN,1.1469390055480977,-5.979932156671731
2010-09-13T09:30:00-04:00,64.44501,65.48,64.32001,65.27,60551472,59860706.4,60.675077114432696,48.81728074523188,NaN,NaN,147.3117895885346,117.24023349390166,0.46700216743730216,0.2861172222168875,-0.18088494522041465,2063965989,1954568059.4,58.23158804232026,32.33830433885819,NaN,NaN,4.226132820107384,-4.521922874274715
2010-09-14T09:30:00-04:00,65.13,65.62,64.75999,64.99001,55811168,60082572,59.211853391986715,50.5157744504748,NaN,NaN,131.41460481566995,123.67408837891685,0.4752658429539579,0.41319735847203276,-0.06206848448192516,2008154821,1987183912.2,62.51949121048329,34.8328040656655,NaN,NaN,6.338065524711796,-2.9704959601337846
2010-09-15T09:30:00-04:00,64.81,65.57001,64.33,65.3575,63011472,60503488,60.55636637799715,51.963108361508034,NaN,NaN,114.16833100004636,122.32173245783945,0.47954935364812623,0.5373682075782327,0.05781885393010641,2071166293,2020628299.4,66.33580776765933,37.71638661901802,NaN,NaN,8.489420648718731,-1.3333650160119965
2010-09-16T09:30:00-04:00,65.2,65.41,64.39,64.94,52663728,60048348.8,58.20881334124688,53.35487315487292,NaN,NaN,95.91729954112094,118.32899505491964,0.42992440753136085,0.5952243633443075,0.16529995581294663,2018502565,2033040837,67.65225932985004,40.78880513734688,NaN,NaN,9.666825834288083,0.23809081974515744
2010-09-17T09:30:00-04:00,65.39999,65.52,64.28,65.21001,61780944,58675445.6,59.30751029298465,54.26621642688301,NaN,NaN,89.21496789887148,115.60539856884866,0.3920075041043912,0.6553093359434357,0.26330183183904443,2080283509,2048414635.4,69.25588840597199,44.059018699990126,NaN,NaN,10.958017409985445,1.7695089040651986
2010-09-20T09:30:00-04:00,65.42,67.2,64.97,67.02251,70673680,59004768.8,65.80617022787614,55.99333644341813,NaN,NaN,127.78343511926167,111.69972767499408,0.4609612856105511,0.8395034388522333,0.3785421532416822,2150957189,2065812875.4,71.0075633018362,47.5216945030405,NaN,NaN,14.14307697879943,3.5371614861700884
2010-09-21T09:30:00-04:00,67.02,67.42999,66.53,66.63,64980192,59482594.4,63.44323266106681,57.58147352981008,NaN,NaN,131.64494442237407,111.74579559633489,0.4515156599289125,0.9429367281528229,0.4914210682239104,2085976997,2081377310.6,72.5161881496266,51.139074271884205,NaN,NaN,16.102101874766955,5.332152970255355
2010-09-22T09:30:00-04:00,66.45,66.89999,65.33,65.84,65235056,58799122.4,58.862006407121534,58.114881128041546,NaN,NaN,96.2901458080068,108.17015855792697,0.36702998126518516,0.9502085448053919,0.5831785635402067,2020741941,2071292440.2,69.9754275912803,54.624161330885904,NaN,NaN,16.44476171880691,6.91966850576272
2010-09-23T09:30:00-04:00,65.14999,66.16,64.66,64.88,62725616,58733796.8,53.77988397611539,58.10350266670678,NaN,NaN,60.47255588168036,101.08120982603886,0.22825399162237114,0.8684960530681707,0.6402420614457995,1958016325,2059195192.2,66.94537413235926,57.56929395411411,NaN,NaN,15.206494823071306,8.103500836806804
2010-09-24T09:30:00-04:00,65.78999,67.06,65.69,66.99001,71675504,58588453.6,61.62285616955988,58.374215260050256,NaN,NaN,107.60913123506451,104.76004249327745,0.2581253826084128,0.9628987897063155,0.7047734070979027,2029691829,2049076856.2,64.43224285443712,60.1021616175006,NaN,NaN,16.623923397577368,9.320704059774027
2010-09-27T09:30:00-04:00,67.00999,67.16,66.50999,66.82001,48359056,57406175.2,60.728741913899256,58.950743880940294,NaN,NaN,109.5954268226119,101.12244083394751,0.24604254521303848,1.0123265886142008,0.7662840434011623,1981332773,2015151973,56.741171383888464,61.881595616288436,NaN,NaN,17.46360919923838,10.483976222554649
2010-09-28T09:30:00-04:00,66.97,67.63,65.74899,67.48,66177504,58594525.6,62.97480362052162,59.59167256936583,NaN,NaN,109.68286596292502,96.7300251420577,0.26070425462105085,1.0921643616774759,0.831460107056425,2047510277,2007458629,55.13391951278941,62.92944353244315,NaN,NaN,18.852878235091676,11.679533652917081
2010-09-29T09:30:00-04:00,67.38,67.95,67.12,67.67,53587296,58242539.2,63.61988114659445,60.26785098567548,NaN,NaN,138.91080015499358,105.25415601145508,0.2607724752539673,1.1574257011238842,0.8966532258699169,2101097573,2023529755.4,57.82168118334947,63.6856042902597,NaN,NaN,20.169809845835253,12.892430251905392
2010-09-30T09:30:00-04:00,68.17,68.55,66.95,67.5,81820688,59204314.4,62.56947547242027,60.8119051509874,NaN,NaN,127.33560045396442,118.62676492591189,0.22812149141289684,1.181805090136038,0.9536835987231411,2019276885,2035781867.4,59.79892235441895,64.16910894430501,NaN,NaN,20.958865153656276,14.04477809501266
2010-10-01T09:30:00-04:00,68.14,68.25999,67.25,67.86,61763408,60001276,63.92771426709574,61.044236376177615,NaN,NaN,118.18415460318138,120.74176959953527,0.2099777894102126,1.2161558354859068,1.0061780460756942,2081040293,2046051560.2,61.4309968274616,64.39763814324367,NaN,NaN,22.001490243289414,15.181451259052196
2010-10-04T09:30:00-04:00,67.67999,68.10001,66.48,66.94,56297328,60216764,58.1231530782463,60.96647206805331,NaN,NaN,76.62806424015827,114.14829708304453,0.11971290190826567,1.1558191734610261,1.0361062715527605,2024742965,2054733598.6,62.80575697648911,64.41808569795838,NaN,NaN,21.269712529616232,16.051202869132773
2010-10-05T09:30:00-04:00,67.67999,69.00999,67.25,68.84,77657248,61655516,65.15906609579507,61.295236333610305,NaN,NaN,127.80787743529902,117.77329937751934,0.16866864916037838,1.2469420830032334,1.078273433842855,2102400213,2065711585.8,64.52749125289179,64.28892023261784,NaN,NaN,22.78591089093487,17.013304015104502
2010-10-06T09:30:00-04:00,68.78,69.06,68.22,68.61,43163392,60870245.6,63.76247089884978,61.69192615915336,NaN,NaN,130.20988513394158,116.03311637330894,0.16600279805672735,1.2857769314137641,1.1197741333570368,2059236821,2057339435.4,62.16413453513569,63.89691131870967,NaN,NaN,23.585897350835214,17.952245920208888
2010-10-07T09:30:00-04:00,69.02,69.08,67.92,68.41,39956800,60243309.6,62.50783702968929,61.92052092606083,NaN,NaN,113.72183905357589,113.31036409323124,0.13265745345902658,1.28559595018082,1.1529384967217935,2019280021,2057340062.6,62.164246334825265,63.3903654564849,NaN,NaN,23.876150100988244,18.79851794603451
2010-10-08T09:30:00-04:00,68.50999,69.66,68.145,69.28,59953152,60892235.2,65.6721031800238,61.91094470835709,NaN,NaN,135.83165357776923,116.83986388814878,0.14981336187882577,1.3402051990703256,1.1903918371914999,2079233173,2056978638.6,62.05046328367437,62.75057259804477,NaN,NaN,25.060932716370743,19.693148627511118
2010-10-11T09:30:00-04:00,69.34,69.86,69.14,69.34,37345840,59731953.6,65.8859400548388,62.08542380791223,NaN,NaN,143.89390438378,130.29303191687313,0.14568937360182743,1.3725035541937842,1.2268141805919568,2116579013,2075345848.2,65.50582518219818,62.24983238608564,NaN,NaN,26.08646805115144,20.60647997374545
2010-10-12T09:30:00-04:00,69.16,69.82001,68.41,69.52,51109456,59496868,66.55894964132244,62.635205467498004,NaN,NaN,118.24764039641886,128.38098450909712,0.1357698087211714,1.396526441493421,1.2607566327722497,2167688469,2088403499.4,67.75370674686172,62.09113804005574,NaN,NaN,27.127460078957622,21.53804856020433
2010-10-13T09:30:00-04:00,69.99001,71.1436,69.77,70.58,58582176,59275403.2,70.27763359207519,63.81361615435228,NaN,NaN,164.97385741659218,135.33377896562723,0.17858778598874192,1.483991365258177,1.3054035792694352,2226270645,2121810264.2,72.6621719109272,62.49948073852489,NaN,NaN,29.145717030298663,22.624858341646377
2010-10-14T09:30:00-04:00,70.63,70.95,69.89,70.53,70382064,60161320,69.88287739130956,64.40361767019154,NaN,NaN,146.05285230937338,141.79998161678674,0.1809713993306581,1.5316178284327577,1.3506464291020996,2155888581,2149131976.2,75.89400648239499,63.31817814052188,NaN,NaN,30.69644878044977,23.77794269004686
2010-10-15T09:30:00-04:00,71.14,71.25,69.89,70.28999,74957248,60820135.2,67.91092911465216,64.91663104167388,NaN,NaN,130.2292123822502,140.67949337768295,0.14534811902983558,1.5323315778893942,1.3869834588595586,2080931333,2149471608.2,75.93209628801513,64.68895849081663,NaN,NaN,31.483938121207366,24.878799180212646
2010-10-18T09:30:00-04:00,70.56,71.03,70.25999,70.88,39853984,59279150.4,70.14145898102471,65.42853499599553,NaN,NaN,126.13223010953759,137.12715852283446,0.1404089448854411,1.56249463996636,1.4220856950809189,2120785317,2150312869,76.03311505086592,66.18175817210782,NaN,NaN,32.78702359844616,26.008545525674577
2010-10-19T09:30:00-04:00,70.03999,70.75999,68.95,69.5,64630320,59261656.8,59.690410487129,65.14785852031943,NaN,NaN,69.82608767819644,127.44284797918996,0.02891943741558789,1.4582349918504036,1.4293155544348157,2056154997,2128006174.6,67.89555224492523,66.90132039079181,NaN,NaN,30.876449647420518,26.703960400209713
2010-10-20T09:30:00-04:00,69.84,70.63,69.42751,70.21001,54127936,58706300.8,62.76447260866638,65.16178688719415,NaN,NaN,79.9332080129455,110.43471809846062,-0.010195648242546707,1.4165709941316322,1.426766642374179,2110282933,2104808632.2,60.62847678204761,66.96057427847957,NaN,NaN,30.1487900841006,27.19607892647984
2010-10-21T09:30:00-04:00,70.56,71.09,68.96001,69.87,62494864,58694763.2,60.389400022383285,64.90905015542899,NaN,NaN,66.97498902004716,94.61914544059539,-0.0688839564269439,1.340661696840499,1.4095456532674429,2047788069,2083188529.8,54.74708882168629,66.48315227806704,NaN,NaN,28.839736532849937,27.43088715596128
2010-10-22T09:30:00-04:00,70.03999,70.39,69.75999,70.32001,26271008,56424538.4,62.416500946501834,65.21571786030438,NaN,NaN,70.80128158054576,82.7335592802545,-0.08618961196189012,1.3018086383150802,1.3879982502769703,2074059077,2081814078.6,54.385890539014376,65.88173324681885,NaN,NaN,28.31502019633555,27.55719187601475
2010-10-25T09:30:00-04:00,70.84,71.56,70.3564,70.74001,36098464,55811508.8,64.2551113315597,65.151149662859,NaN,NaN,105.55990708833217,78.6190946760134,-0.07836895600313909,1.2900370552730465,1.3684060112761856,2110157541,2079688523.4,53.794801774451244,65.11511256978739,NaN,NaN,28.39569417868403,27.67697791925322
2010-10-26T09:30:00-04:00,70.36,71.17,69.99001,70.69,37893168,54397292,63.85454305952797,65.15772624576458,NaN,NaN,82.73139395699535,81.20015593177318,-0.0850259079538489,1.2621236263338744,1.3471495342877233,2072264373,2082910398.6,54.60025601669623,64.574835532756,NaN,NaN,28.3516395129491,27.773358146924057
2010-10-27T09:30:00-04:00,70.21001,70.62,69.53999,70.50999,53522912,54394072.8,62.34788380120509,65.14630101515857,NaN,NaN,51.829446308602044,75.57940359090449,-0.10851068069608805,1.2115111834176133,1.3200218641137014,2018741461,2064602104.2,49.33708613026775,63.65860980385903,NaN,NaN,27.90958638105993,27.792819323229182
2010-10-28T09:30:00-04:00,71.06,71.12,69.75,70.08,48482304,52727153.6,58.78008883558577,64.65401427627015,NaN,NaN,53.32205494728287,72.84881677635164,-0.157017516717874,1.1237499682163588,1.2807674849342328,1970259157,2049096321.8,45.349958950692255,62.46571663721745,NaN,NaN,26.554524708320386,27.615920092527926
2010-10-29T09:30:00-04:00,69.88,70.67,69.83,70.3,40455024,51661734.4,60.040035815641865,64.23644968775608,NaN,NaN,45.01263668214736,67.69108779667197,-0.17682617076053653,1.059734771483562,1.2365609422440986,2010714181,2036427342.6,42.339291415736156,60.81096422532731,NaN,NaN,25.726260711128784,27.345968752328048
2010-11-01T09:30:00-04:00,70.66,71.17,69.31,69.82001,47357440,51214740,56.016953693001824,63.48344997716175,NaN,NaN,22.801240854708784,51.139354549947285,-0.22187766182199908,0.9592138649665998,1.1810915267885989,1963356741,2007067182.6,36.32133328782248,58.56579469253878,NaN,NaN,23.898861381636674,26.85352484222928
2010-11-02T09:30:00-04:00,70.67,71.31,70.272,71.27,55102800,50087017.6,63.88881146772475,63.027105539708145,NaN,NaN,112.05610855120077,57.004297468788366,-0.15671668159897645,0.9851956747898782,1.1419123563888547,2018459541,1996306216.2,34.39185995485977,55.83220098139112,NaN,NaN,24.50307134476512,26.51774577116297
2010-11-03T09:30:00-04:00,71.36,71.62,70.5,71.55,58044400,50831068,65.18461984254894,62.69151571479667,NaN,NaN,142.12021636800227,75.06245148066841,-0.10020134527407887,1.016660674796256,1.116862020070335,2076503941,2007858712.2,38.188138380449224,53.13892468839499,NaN,NaN,25.388659228827887,26.35644769368653
2010-11-04T09:30:00-04:00,72.86,73.38,72.62,73.36,60910496,51878752.8,72.14338997912924,62.99383434797361,NaN,NaN,328.9972626052364,130.19749301225912,0.045801846407682145,1.1741143280799378,1.1283124816722556,2137414437,2041289768.2,47.63155151474209,51.11745720458977,NaN,NaN,28.61172508609988,26.678630178317007
2010-11-05T09:30:00-04:00,73.45,74,73.30099,73.77,45659056,51164048,73.43849217483384,63.22933671895998,NaN,NaN,295.91130484874446,180.37722664557856,0.15079144257501698,1.3168017848910267,1.1660103423160098,2183073493,2075761630.6,55.22728820842615,49.631326715844075,NaN,NaN,31.634715668825137,27.386642391246742
2010-11-08T09:30:00-05:00,73.53,73.91,73.12,73.71249,31656624,50879587.2,72.92633371583483,64.17475980672468,NaN,NaN,215.5170879044671,218.92039605553023,0.19439170331012612,1.4089999714536674,1.2146082681435413,2151416869,2113373656.2,61.746794215980124,49.19212971377657,NaN,NaN,33.86575294589749,28.312229613339706
2010-11-09T09:30:00-05:00,73.91,74.05,72.33,72.73,48438560,50746042.4,64.63341927076956,64.3082559968749,NaN,NaN,140.70856481335304,224.6508873079607,0.13775559950031058,1.3868027675189296,1.249047168018619,2102978309,2130277409.8,64.26524361803348,49.45189877348985,NaN,NaN,33.19558144172534,29.009851303109084
2010-11-10T09:30:00-05:00,72.83,73.55,72.11,73.53999,53667552,50500311.2,67.8766634957247,64.84306053068501,NaN,NaN,118.05786042334388,219.83841611902898,0.13534015560679902,1.4182223625271178,1.2828822069203187,2156645861,2146305793.8,66.51631811950855,50.292558009048584,NaN,NaN,33.663492235238735,29.674657150556175
2010-11-11T09:30:00-05:00,72.73,73.53999,72.46001,73.25,42991120,49130764,65.55870840994484,65.06750392093093,NaN,NaN,101.11701162532084,174.26236592304588,0.09652917104302872,1.4035436707241047,1.307014499681076,2113654741,2141553854.6,65.20488840686706,51.06534357103806,NaN,NaN,33.32130998882288,30.195607556022846
2010-11-12T09:30:00-05:00,72.53,73.10001,71.89999,72.03,48799120,47822857.6,56.774557638082015,64.53317865711111,NaN,NaN,52.88261902436919,125.65662875817081,-0.022630372404832233,1.2787265341750356,1.3013569065798678,2064855621,2117910280.2,58.97459206600169,51.43532859186309,NaN,NaN,30.11505513067057,30.184100066686806
2010-11-15T09:30:00-05:00,72.38,72.85001,71.97,72.03999,38922512,47776284,56.82557128045539,64.0311092443202,NaN,NaN,44.55254896416908,91.46372097011121,-0.10735762826619633,1.1671598712471223,1.2745174995133186,2103778133,2108382533,56.626526361276795,51.58006218790456,NaN,NaN,27.617944372223718,29.81750639604922
2010-11-16T09:30:00-05:00,71.5,71.67999,70.14999,70.64,70140064,48051771.2,48.234475248843566,63.02300863343724,NaN,NaN,-36.29888247194892,56.06223151305081,-0.2557987904537835,0.9547690114460892,1.2105678018998727,2033638069,2094514485,53.30006248130434,51.86313192726432,NaN,NaN,22.47528825853017,28.76861809068936
2010-11-17T09:30:00-05:00,70.8,71.02,70.39999,70.83,39512496,47320999.2,49.35357023456981,62.34968587622182,NaN,NaN,-43.002242030872125,23.85021102220761,-0.3343405992942299,0.7926420527820852,1.126982652076315,2073150565,2077815425.8,49.527223874925916,52.16150799328101,NaN,NaN,18.733168718348608,27.334982466069253
2010-11-18T09:30:00-05:00,71.67,72.58,71.66,72.21001,52641648,46828338.4,56.67907227113409,62.10961705161412,NaN,NaN,29.53959169826798,9.534727036797037,-0.2882478682530123,0.7666728167600496,1.054920685013062,2125792213,2080242920.2,50.08039885862105,52.71444423920137,NaN,NaN,17.79242152747366,25.97175947484131
2010-11-19T09:30:00-05:00,72,72.61,71.53,72.45,32830304,47156303.2,57.82161922389145,62.23852173239195,NaN,NaN,27.450553190137303,4.448313869950659,-0.2385493172191584,0.7567340384891139,0.9952833557082723,2158622517,2098996299.4,54.251829721237655,53.9951939844453,NaN,NaN,17.40762535970389,24.748311744107394
2010-11-22T09:30:00-05:00,72.17,72.99001,71.74001,72.802,42172256,47459992.8,59.50846265728755,61.92563967450358,NaN,NaN,41.74808185551761,3.887420448220366,-0.1815040695666923,0.7684032687499069,0.9499073383165992,2200794773,2118399627.4,58.148604127805484,55.69210428251286,NaN,NaN,17.611793968650126,23.728809204756356
2010-11-23T09:30:00-05:00,71.92,72.24001,71.5,72.1075,52202240,48175446.4,54.847694318456305,61.18728785135411,NaN,NaN,4.209588629901605,11.98911466859047,-0.1892159616437482,0.713387386261914,0.9026033479056622,2148592533,2141390520.2,62.25154289277655,57.410918890536244,NaN,NaN,16.34955283164961,22.674629722883964
2010-11-24T09:30:00-05:00,72.75999,73.75,72.75,73.73,42139696,47606285.6,62.280343777135855,60.48278455121173,NaN,NaN,91.49615325837455,38.8887937264398,-0.08881531570643353,0.7915842032726204,0.8803995189790539,2190732229,2164906853,65.93068783756716,58.71800005645231,NaN,NaN,17.693294573093123,21.963010415770988
2010-11-26T09:30:00-05:00,73.28,73.73,73.13,73.39,19005232,46132432,60.04958493296649,59.52643403393548,NaN,NaN,86.72556877708648,50.325989142203504,-0.050954730366055245,0.8167061060214849,0.8676608363875401,2171726997,2174093809.8,67.27266490835532,59.57838410644725,NaN,NaN,18.049460436790422,21.40393184734519
2010-11-29T09:30:00-05:00,72.95,73.50999,72.03,73.33,47898496,46504605.6,59.643588326982986,58.577666506160355,NaN,NaN,48.627997896724814,54.561478083521,-0.0362926758441835,0.8222949915823108,0.8585876674264943,2123828501,2167135006.6,65.17839358466372,59.82349834706751,NaN,NaN,18.209081916835366,20.947524714415216
2010-11-30T09:30:00-05:00,72.48,73.25,72.17999,72.75,68634944,47568480.8,55.72167507668974,57.941113349440364,NaN,NaN,23.387814974533615,50.88942470732421,-0.07004208697072989,0.7710350587130819,0.8410771456838118,2055193557,2138014763.4,57.159282828406155,59.31592971923699,NaN,NaN,17.164403241061038,20.407078789650335
2010-12-01T09:30:00-05:00,74.12,74.57001,72.8091,74.38,59975808,47812131.2,63.07098041675471,57.597850272371076,NaN,NaN,119.82988125414323,74.01348323217253,0.008831010141045814,0.8521159083601191,0.8432848982190733,2115169365,2131330129.8,55.472091278848765,58.52705637347558,NaN,NaN,18.622185309853574,20.152094006822225
2010-12-02T09:30:00-05:00,74.47,75.28999,74.36,75.13,42531472,47036484.8,65.87741769639979,57.620615221403575,NaN,NaN,190.85541559990972,93.88533570047957,0.09797938365583847,0.9657591277888713,0.8677797441330328,2157700837,2124723851.4,53.7824966255804,57.711171246240816,NaN,NaN,20.761480138231004,20.23914916845205
2010-12-03T09:30:00-05:00,74.83,75.89999,74.75999,75.67,36550608,45818490.4,67.77622609663487,58.40644868272879,NaN,NaN,198.80694532095032,116.30161100925234,0.17526977206826921,1.0868669592183693,0.9115971871501001,2194251445,2129228741,54.79365537275169,57.412532911008675,NaN,NaN,23.12680274962918,20.651671108620214
2010-12-06T09:30:00-05:00,75.64,76.35001,75.5,76.14,36177424,45344408.8,69.3736608317664,59.302740793536714,NaN,NaN,206.24589428781096,147.82519028746955,0.23620940353778808,1.2068589415723352,0.9706495380345471,2230428869,2150548814.6,59.32878062007987,57.60555107235175,NaN,NaN,25.57331748029933,21.354763447431516
2010-12-07T09:30:00-05:00,77.06,77.24001,76.41,76.58,66777376,47100446.4,70.83147028552368,60.91681186758529,NaN,NaN,205.30606954081884,184.2088412007266,0.2812532422172378,1.3222160908060943,1.0409628485888565,2297206245,2198951352.2,67.33957879356493,58.60837366608461,NaN,NaN,28.04623390433892,22.31068779841829
2010-12-08T09:30:00-05:00,76.75,77.00999,76.37,76.53,40388736,46697955.2,70.42125536894314,62.42164652004052,NaN,NaN,160.7769202789283,192.39824900568362,0.2820609451722178,1.3935390300541286,1.1114780848819108,2256817509,2227280981,70.94655789442234,60.13832609604864,NaN,NaN,29.921245235332112,23.397910289405978
2010-12-09T09:30:00-05:00,77.08,77.08,76.48,76.78999,49390976,46484126.4,71.35038291643245,63.469597280418974,NaN,NaN,138.23019683597536,181.87320525289675,0.2742399177856203,1.4542779821139362,1.180038064328316,2306208485,2256982510.6,74.16768450576177,61.85884649941584,NaN,NaN,31.75442287319733,24.59169780137617
2010-12-10T09:30:00-05:00,77.05,77.94,76.77,77.745,43312672,46500204,74.51691284237552,64.66211825316785,NaN,NaN,139.4054747511569,169.99291113893807,0.3051500650273389,1.5614756456124894,1.2563255805851505,2349521157,2288036453,77.03455267631475,63.486183853349914,NaN,NaN,34.35176105915469,25.98599255248739
2010-12-13T09:30:00-05:00,78.06,78.19,77.32001,77.35001,43029328,46211714.4,71.02058702136026,65.48441285060161,NaN,NaN,123.50845714893664,153.44542371116322,0.2718664563059785,1.5961586509676238,1.3242921946616453,2306491829,2303249045,78.30477489553836,64.9259103367594,NaN,NaN,35.52807401694419,27.34914704740979
2010-12-14T09:30:00-05:00,77.71001,77.72,77.17999,77.31,60000672,47265622.4,70.65893469523644,66.61378716322876,NaN,NaN,101.630782395316,132.71036628206267,0.2221265824095493,1.601950422673582,1.3798238402640326,2246491157,2293106027.4,75.3136990904689,65.85892149373743,NaN,NaN,36.39069812312148,28.64079720108289
2010-12-15T09:30:00-05:00,77.25,78.06,76.92,77.07001,52002400,46358739.2,68.40870098459968,67.0515269637619,NaN,NaN,90.13640124689744,118.58226247565649,0.15141115886996626,1.5690877888514905,1.4176766299815242,2194488757,2280640277,71.6893521703866,66.27025466036739,NaN,NaN,36.51349115724465,29.765467766248857
2010-12-16T09:30:00-05:00,77.17999,77.97,76.86,77.78,57936080,47279918.4,71.31876266308387,67.85646823019884,NaN,NaN,88.53099146444382,108.64242140135016,0.13153609414671674,1.5820967476649201,1.4505606535182034,2252424837,2269883547.4,68.62063391835709,66.3665381610818,NaN,NaN,37.43688536848796,30.861384566568727
2010-12-17T09:30:00-05:00,77.86,78.17,77.28999,78.02,40363152,46665993.6,72.24933844060237,68.75687895260023,NaN,NaN,89.91675611309952,98.74467767373869,0.11427520393967194,1.5934046584427932,1.4791294545031213,2292787989,2258536913.8,65.43857891114128,66.38512282725877,NaN,NaN,38.47308685487827,31.948770607755804
2010-12-20T09:30:00-05:00,78.31,78.81,77.92999,78.33,42700048,47159480.8,73.44770864103909,70.0230242071966,NaN,NaN,100.11927874460181,94.06684199287172,0.1037644522232899,1.6088350197822336,1.5050705675589438,2335488037,2264336155.4,66.29875575447056,67.03794232197765,NaN,NaN,39.689132431871045,33.05453658262941
2010-12-21T09:30:00-05:00,78.64999,79.28,78.59,79.201,30166736,46559204.8,76.51621420428111,70.98339804916279,NaN,NaN,114.965398468286,96.73376520746572,0.13360075673980565,1.6720715134837008,1.538470756743895,2365654773,2288168878.6,69.6426127526271,68.05012242724754,NaN,NaN,41.69218836531137,34.28848683729826
2010-12-22T09:30:00-05:00,79.03,79.17999,78.72,78.82001,29813248,45439755.2,72.565848580351,71.46114311230215,NaN,NaN,105.28128308985129,99.7627415760565,0.1069581659934864,1.672168464235753,1.5652102982422667,2335841525,2316439432.2,73.0575600945493,69.42691267503103,NaN,NaN,42.26491694026039,35.427976852007134
2010-12-23T09:30:00-05:00,78.96001,79.12,78.61,78.72,25241264,44594833.6,71.52199881921972,71.7286983067725,NaN,NaN,96.36714679755671,101.32997264267907,0.06400005438993928,1.6452103662296906,1.5812103118397514,2310600261,2328074517,74.33707597983003,70.82287128982234,NaN,NaN,42.450529930629514,36.43119872038176
2010-12-27T09:30:00-05:00,78.47,79.10001,78.31,78.96001,15776859,44433414.95,72.54278049789295,71.95506399721012,NaN,NaN,91.64457537632823,101.67553649532482,0.03462103857387122,1.6244866100570903,1.589865571483219,2326377120,2334792343.2,75.07314763639388,71.94746893384477,NaN,NaN,42.883711134978,37.35298620818122
2010-12-28T09:30:00-05:00,79.11,79.16,78.52,78.74001,25829520,43329966.15,70.06367888695648,71.90022175445532,NaN,NaN,88.05212432825694,99.26210561205585,-0.014142438400611024,1.5721875234824552,1.5863299618830662,2300547600,2327804255.8,72.73604446902112,72.33293076780593,NaN,NaN,42.58943475370093,38.10105028611261
2010-12-29T09:30:00-05:00,78.85001,79.02,78.75,78.91,18139296,40805183.75,70.89144223823814,71.93380653083354,NaN,NaN,91.84450988467253,94.63792789533315,-0.04757897385884435,1.5268562445595109,1.5744352184183552,2318686896,2318410680.4,69.5994639930084,72.2367097748478,NaN,NaN,42.55267771160401,38.73699706118281
2010-12-30T09:30:00-05:00,78.84,79.22,78.75999,78.75999,37998048,39706295.75,69.07626868084118,71.77136979971986,NaN,NaN,88.24298742827409,91.23026876301772,-0.0899692911829082,1.46197360443972,1.5519428956226282,2280688848,2307380145,66.00028915576152,71.65332439270492,NaN,NaN,42.05117482916672,39.21045102803765
2010-12-31T09:30:00-05:00,78.67,78.88,78.17,78.24001,33323504,39245897.35,63.04984729611858,70.95229368927293,NaN,NaN,48.176473531469746,81.59213410980033,-0.15915505790519346,1.3529990732411363,1.5121541311463298,2247365344,2294733161.6,62.03899715454909,70.58221328400738,NaN,NaN,39.966832600956295,39.3185055384546
2011-01-03T09:30:00-05:00,78.94,80.02,78.73,79.60001,48877936,39862263.75,70.33868093667955,70.90358611179576,NaN,NaN,114.59692751353666,86.18260453724199,-0.12117018278586178,1.3606914026640027,1.4818615854498645,2296243280,2288706393.6,60.18519700144675,69.28795772014368,NaN,NaN,40.118347819114554,39.43276872140602
2011-01-04T09:30:00-05:00,79.84,79.89999,77.57001,78.422,77510560,41928920.55,59.40727154740295,70.0998958869505,NaN,NaN,44.22379884383407,77.41693944035742,-0.17969775311044134,1.2572393940618127,1.436937147172254,2218732720,2272343417.6,55.349343641569334,67.86193233093658,NaN,NaN,36.57429024457797,39.02441465328773
2011-01-05T09:30:00-05:00,78.39999,79.36,78.10989,79.34,47154160,40947759.75,64.0907322082968,69.79146954578599,NaN,NaN,65.4771747204051,72.14347240750394,-0.16147731346691985,1.2350905053386043,1.3965678188055242,2265886880,2261783414.4,52.421937722899806,66.48568844183038,NaN,NaN,35.137067826543095,38.46907939232421
2011-01-06T09:30:00-05:00,79.39999,79.53,78.64999,78.97,39396640,40898154.95,61.034155501067,69.05685474849908,NaN,NaN,72.32258098422508,68.95939111869413,-0.17793696512166135,1.1741466124034474,1.3520835775251088,2226490240,2250943692.8,49.52629438473886,65.12180704657193,NaN,NaN,32.96854569218237,37.68328886373252
2011-01-07T09:30:00-05:00,79.24001,79.44,77.44,78.52,59496800,41403446.15,57.44581276495205,67.99946005738119,NaN,NaN,3.905221581277969,60.10514072865577,-0.2199704427680571,1.0771205240650374,1.2970909668330945,2166993440,2234869312,45.511579453977404,63.69844994248881,NaN,NaN,30.022772946016392,36.588929446915934
2011-01-10T09:30:00-05:00,78.24001,79.28999,77.62,78.97,55023920,41989008.55,59.97969296107131,67.03745893738349,NaN,NaN,18.19795947492942,40.825347120934325,-0.21789238017300816,1.0247254916168345,1.2426178717898426,2222017360,2220024128,42.1160859970354,61.971116388386285,NaN,NaN,28.391777978504667,35.41790780857147
2011-01-11T09:30:00-05:00,79.36,79.67999,78.87,79.28999,42133328,41944208.55,61.72498352039122,65.98094245996279,NaN,NaN,101.04999559065891,52.19058647029929,-0.19607530787567073,0.9975237369452543,1.193599044820925,2264150688,2229107721.6,44.828479749959854,60.1986783167672,NaN,NaN,27.592606781712682,34.30000766187736
2011-01-12T09:30:00-05:00,79.94,80.13,79.50999,79.97,38446160,40866482.95,65.19835091500255,65.4546926267236,NaN,NaN,179.18128629935492,74.93140878608925,-0.13960736306969213,1.0190898409838098,1.158697204053502,2302596848,2236449715.2,46.99064247385048,58.33675562957443,NaN,NaN,27.99695866167965,33.39957209042054
2011-01-13T09:30:00-05:00,79.99001,80.3,79.57001,79.94,29703856,39751555.75,64.91845654597253,64.98301103577738,NaN,NaN,185.50882902347482,97.5686583939392,-0.1093740517169115,1.0219796394073626,1.131353691124274,2272892992,2245730265.6,49.67535952423228,56.57520445417458,NaN,NaN,28.236841876033647,32.66203920265099
2011-01-14T09:30:00-05:00,79.86,80.67999,79.69,80.53999,38038928,38756698.15,67.88764114583805,64.65050108205917,NaN,NaN,214.6884385474781,139.72530178717923,-0.0567152048861197,1.0604596850166246,1.1171748899027443,2310931920,2274517961.6,56.957532608287195,55.281231952166955,NaN,NaN,29.343722112580224,32.18799390406945
2011-01-18T09:30:00-05:00,80.28999,80.63,79.87,80.60001,37824064,38629743.75,68.17779307651975,64.51579495274227,NaN,NaN,182.6312846617794,172.61196682454923,-0.027091289145416253,1.083310778470974,1.1104020676163902,2348755984,2299865686.4,62.15093770094468,54.52515289730435,NaN,NaN,30.326142996362986,31.922015202968527
2011-01-19T09:30:00-05:00,80.57001,80.7,78.36,78.53,70707376,40030110.15,51.046788926201295,63.098319716168206,NaN,NaN,9.25973844980758,154.25391539637897,-0.1493299484990862,0.9237396319925324,1.0730695804916186,2278048608,2302645270.4,62.682667664198725,54.0310960166751,NaN,NaN,25.419179456112257,30.993038667703345
2011-01-20T09:30:00-05:00,78.1402,78.53999,77.34,77.71001,79653008,42504423.75,46.10474807895071,61.45749681603318,NaN,NaN,-166.22199429692796,85.17325927712238,-0.2802314660574887,0.7227802479197578,1.0030117139772465,2198395600,2281805020.8,56.29669962130942,53.337982478499946,NaN,NaN,19.60076323814474,29.365570749194973
2011-01-21T09:30:00-05:00,78.21001,78.24001,77.12,77.19,56677824,43847652.55,43.24540854232092,60.042894047904774,NaN,NaN,-184.16110785683193,11.23927190106104,-0.38991789446809155,0.5156143458921321,0.9055322403602236,2141717776,2255569977.6,49.46483315274009,52.43982790694216,NaN,NaN,13.931749287135432,27.160739111757895
2011-01-24T09:30:00-05:00,77.2,78.07001,77.09,77.75999,48148032,44992990.95,47.116890868108115,58.384194757292526,NaN,NaN,-148.68440934894758,-61.4352976782241,-0.41010721686487295,0.3928982192791324,0.8030054361440053,2189865808,2231356755.2,44.140675575421135,51.293790662226044,NaN,NaN,10.56664691057169,24.790154511588437
2011-01-25T09:30:00-05:00,77.31,77.89999,76.95,77.88,47021632,46555229.6,47.92238475817463,57.56384570091908,NaN,NaN,-135.8878759033677,-125.13912979125352,-0.40092508447922925,0.30184908054496873,0.702774165024198,2236887440,2208983046.4,39.870230218753946,50.18813970345352,NaN,NaN,8.163262635147113,22.414884243525393
2011-01-26T09:30:00-05:00,78,79.38,77.75,79.12,65896128,48558560,55.469660375915964,56.94805485574902,NaN,NaN,-13.911157725530446,-129.77330902632113,-0.3014259011425249,0.32599178859604194,0.6274176897385668,2302783568,2213930038.4,41.22423559717697,49.388303837330454,NaN,NaN,8.519224431522934,20.4297899846679
2011-01-27T09:30:00-05:00,79.12,79.67,78.73,79.35001,48174768,50060333.6,56.72254351907953,56.640082571321344,NaN,NaN,34.95634451483696,-89.53764126396815,-0.214301843285161,0.35954038563211554,0.5738422289172765,2350958336,2244442585.6,48.87164909384296,49.34154345940932,NaN,NaN,9.203079434957283,18.825974191852097
2011-01-28T09:30:00-05:00,79.31,79.45,77.33,77.41,91028128,52711837.6,45.17701062888765,55.763739561602456,NaN,NaN,-75.48232956102584,-67.80188560480693,-0.2774986309987564,0.22696894016883107,0.5044675711675874,2259930208,2268085072,53.87906596436112,49.93922106729387,NaN,NaN,5.738992676443224,16.956405403936543
2011-01-31T09:30:00-05:00,77.87,78.5,77.25,77.95,53271408,53709232.8,48.329649103335846,54.93159357176421,NaN,NaN,-85.23439898659636,-55.111883532336684,-0.27269981252111924,0.16359280551618838,0.4362926180373076,2313201616,2292752233.6,58.45122095023453,51.106016421093805,NaN,NaN,4.077381618794903,15.116544863202023
2011-02-01T09:30:00-05:00,78.58,80.00999,78.37,79.75,57789264,54154799.2,57.17090202932202,54.60630203668784,NaN,NaN,50.15224753385942,-17.903858844891268,-0.14450243292638532,0.255664576879326,0.4001670098057113,2370990880,2319572921.6,62.77258762250424,52.38773841198984,NaN,NaN,5.894524247318956,13.7991133466473
2011-02-02T09:30:00-05:00,79.59,80.13,79.42,79.45,39938576,52276200,55.467396229665944,53.91123384487809,NaN,NaN,69.45624046049026,-1.2303792076871276,-0.07936928806795845,0.30095539972076324,0.3803246877887217,2331052304,2325226668.8,63.63128852910287,53.576355987365005,NaN,NaN,6.695449335243192,12.784304202160998
2011-02-03T09:30:00-05:00,79.39,79.85001,78.5,79.728,41162000,51976592,56.75336124899579,53.32801275223689,NaN,NaN,39.39308196675519,-0.3430317173034808,-0.020110462517010208,0.35518660964245896,0.37529707215946917,2372214304,2329477862.4,64.29813997204855,54.62084030506617,NaN,NaN,7.747749529151024,12.064796391731
2011-02-04T09:30:00-05:00,79.60001,79.97,79.24001,79.87,39537232,51983621.6,57.42958003693564,52.58100838731529,NaN,NaN,63.08217908909358,27.3698700127204,0.023726641473319987,0.40495537400111914,0.38122873252779915,2411751536,2359842128,68.71108276030259,55.46037960163869,NaN,NaN,8.791248234742312,11.597146655018332
2011-02-07T09:30:00-05:00,79.98,81.25,79.91,80.66,40835664,51050564.8,61.076069731666564,52.07374243411149,NaN,NaN,124.1634162264675,69.24943305533318,0.09689946406783984,0.5023530626125989,0.4054535985447591,2452587200,2387719244.8,72.11848621922402,56.17234735294436,NaN,NaN,10.833573262024462,11.488064741733494
2011-02-08T09:30:00-05:00,80.66,81.27,80.34,81.23,37563840,50177560.8,63.50509347167045,52.963621330216434,NaN,NaN,135.5422144989059,86.32742644834248,0.1703627669641442,0.6184070572499394,0.4480442902857952,2490151040,2411551276.8,74.65917610233055,57.02781224138234,NaN,NaN,13.300998945161457,11.747055342223202
2011-02-09T09:30:00-05:00,81.00999,81.3,80.42,80.87,43298832,50235836,60.91936584378173,54.02180831341865,NaN,NaN,115.42299155432127,95.52077666710868,0.1804183509987053,0.6735672290341768,0.49314887803547147,2446852208,2434711257.6,76.86544417162338,58.49700828069048,NaN,NaN,14.564794475274812,12.149589504087718
2011-02-10T09:30:00-05:00,80.33,81.28999,80.24001,81.19,48006352,50713845.6,62.38546087569619,55.38895490865974,NaN,NaN,109.5273697557373,109.5476342249051,0.19318887641043014,0.7346349735485092,0.541446097138079,2494858560,2459240108.8,78.95524597568942,60.603466339472575,NaN,NaN,16.045203532740597,12.706105793895272
2011-02-11T09:30:00-05:00,80.89,82.10001,80.78999,82.07001,38588128,51158059.2,66.14664463519625,56.748223034880304,NaN,NaN,142.84006024055165,125.49921045519673,0.2422898358229293,0.8443083919167407,0.6020185560938114,2533446688,2483579139.2,80.80783330350205,63.2225490343355,NaN,NaN,18.49839956125254,13.533576332089167
2011-02-14T09:30:00-05:00,82.11,82.61,82.05,82.49001,36734080,51092816.8,67.80146655502558,58.16815744894109,NaN,NaN,164.4234572652983,133.55121866296287,0.28167906292294353,0.9541173847474909,0.6724383218245473,2570180768,2507097852.8,82.41843223861167,66.2617063214682,NaN,NaN,21.047467066692835,14.606989294175404
2011-02-15T09:30:00-05:00,82.27,82.4886,81.83,82.01801,42913728,51347300,64.01438618440932,58.778495006690605,NaN,NaN,133.26821616135322,133.09641899545232,0.2553489562972656,0.9916245171961293,0.7362755608988637,2527267040,2514521052.8,82.90603755005016,69.23897788953056,NaN,NaN,22.097248438057328,15.677026314729964
2011-02-16T09:30:00-05:00,82.21001,82.82001,82.1783,82.67999,38285664,49726214.4,66.81405807134146,59.499317474709315,NaN,NaN,133.03826056585115,136.6194727977583,0.260993474677898,1.0625174042462362,0.8015239295683382,2565552704,2538261152,84.3964619888076,71.77646452488518,NaN,NaN,23.84128534816437,16.843349033792023
2011-02-17T09:30:00-05:00,82.60001,83.50999,82.45,83.25999,34898752,47488501.6,69.08358411354541,61.206929866470595,NaN,NaN,135.4558908275777,141.8051770121264,0.2805565445783217,1.1522196102912403,0.8716630657129186,2600451456,2559379731.2,85.59932690989855,74.04219744956643,NaN,NaN,26.013110980020883,18.15331502611043
2011-02-18T09:30:00-05:00,83.45,83.77,83.03999,83.35001,39514240,46630322.4,69.43298957188847,62.71431132851007,NaN,NaN,132.33901673911802,139.70496831183965,0.2759091404403342,1.2165494912633363,0.9406403508230021,2639965696,2580683532.8,86.71214872507423,76.06083514776927,NaN,NaN,27.88292669257532,19.54325954989113
2011-02-22T09:30:00-05:00,82.73,83.02,81.09,81.21001,68370256,47641433.6,53.85181098673566,62.47723339689676,NaN,NaN,57.50501431395263,118.32127972157052,0.11338718540588444,1.0823743325803576,0.9689871471744732,2571595440,2580966467.2,86.7268187614801,77.7718516576961,NaN,NaN,24.556365968528667,20.25941760969649
2011-02-23T09:30:00-05:00,81.37,81.44,79.28999,79.81,91261680,49853436,46.50007150647986,61.83671020238347,NaN,NaN,-22.14002667846742,87.23963115360637,-0.09260180943742813,0.8532348853776881,0.9458366948151162,2480333760,2571579811.2,83.43573918808775,79.18645527619503,NaN,NaN,19.051384975003067,20.086841519026002
2011-02-24T09:30:00-05:00,79.96001,80.72,79.36,80.31799,85137440,50815501.6,49.20951954012624,61.29786436603564,NaN,NaN,-29.450427838452647,54.741893472745616,-0.19306165842686107,0.7045096217815399,0.8975712802084009,2565471200,2571563510.4,83.42981827120667,80.55300372613489,NaN,NaN,15.572897665846455,19.44199239714321
2011-02-25T09:30:00-05:00,80.7,82.21001,80.64,82.17999,58567280,51335127.2,57.67146235383508,61.3151416743856,NaN,NaN,46.430021012019594,36.936719509633996,-0.13526183039064488,0.7284939922200948,0.8637558226107397,2624038480,2576280915.2,83.7883624219228,81.62995227339347,NaN,NaN,15.51178468270726,18.880534152223788
2011-02-28T09:30:00-05:00,82.64999,82.84,81.59,82.26801,49879328,49277687.2,58.02745370968747,61.09738338710138,NaN,NaN,69.2544191867786,24.31979999916612,-0.09420083547666835,0.7460047782649042,0.8402056137415725,2673917808,2583071337.6,84.31449149654509,82.50109550748785,NaN,NaN,15.58459439298667,18.409685615189915
2011-03-01T09:30:00-05:00,82.58,82.64,80.35001,80.62,70867936,50157513.6,49.61401188897979,60.10516327405205,NaN,NaN,0.9199191802515311,13.002780972425905,-0.17635857824058,0.6197573909408476,0.7961159691814276,2603049872,2589362224,84.80644554442416,83.22590046763739,NaN,NaN,12.680509588617356,17.59123189710812
2011-03-02T09:30:00-05:00,80.53,81.37,80.24001,80.96001,61076144,50321857.6,51.186532590485456,59.40996089881661,NaN,NaN,-28.593114413876304,11.712163425344157,-0.20416784510613195,0.5409061627987626,0.7450740079048945,2664126016,2626120675.2,87.3107731566237,83.9719953951374,NaN,NaN,10.935230170010971,16.640374507522814
2011-03-03T09:30:00-05:00,81.77,83.02,81.02631,82.8,78944000,52272128.8,58.698605038617,59.146614053310955,NaN,NaN,64.40354060987308,30.48295711500931,-0.10026417327070847,0.6197437913165089,0.7200079645872174,2743070016,2661640438.4,89.16863161097619,84.70152294051503,NaN,NaN,12.048785386638393,15.984433204539325
2011-03-04T09:30:00-05:00,82.78999,82.84,81.64999,82.44,60947072,53261382.4,56.85503039262298,58.482927321698575,NaN,NaN,60.36954791896435,33.27086249639826,-0.05942188522143921,0.6457306080604184,0.7051524932818576,2682122944,2673257331.2,89.69979476769913,85.33666304510054,NaN,NaN,12.301160537252214,15.458251394926881
2011-03-07T09:30:00-05:00,82.75999,82.82001,80.41,81.09,90799056,55824473.6,50.4553783087653,57.24392101839427,NaN,NaN,-16.740762709894497,16.07182611706364,-0.12329032373878557,0.5510395886083757,0.6743299123471612,2591323888,2656738547.2,83.43421079897973,85.4092186565554,NaN,NaN,10.327675474213729,14.725311977682145
2011-03-08T09:30:00-05:00,81.16,82.81,80.55,82.41,67766880,57171034.4,55.70542162322211,56.65042354973804,NaN,NaN,21.49442170165328,20.18672662134399,-0.07876716201950529,0.5758709598227796,0.6546381218422849,2659090768,2667946726.4,84.23867109087728,85.50440676661448,NaN,NaN,10.486734537769022,14.119800914837413
2011-03-09T09:30:00-05:00,82.25,82.58,81.75,82.08,51237200,57854702.4,54.16026730123109,55.74658135187302,NaN,NaN,37.07428013879836,33.32020553187891,-0.07375984187847484,0.5624383194941913,0.6361981613726662,2607853568,2656692236.8,80.03574369393728,85.19292688840946,NaN,NaN,10.10627787697302,13.546440480856786
2011-03-10T09:30:00-05:00,81.005,81.03,79.69991,79.97,107666752,61073098.4,45.474712644762455,54.060233389817085,NaN,NaN,-137.48680306710602,-7.0578632035169075,-0.20721010568131926,0.3771855292710171,0.5843956349523364,2500186816,2608115596.8,64.96861943087325,83.71930492562193,NaN,NaN,6.707845467151946,12.569498336041809
2011-03-11T09:30:00-05:00,79.34,80.7,79.28,80.17999,83241248,62834843.2,46.39604106052199,52.41473706757663,NaN,NaN,-140.9983877051775,-47.33145032834528,-0.27191860176091587,0.2444973827511916,0.5164159845121075,2583428064,2588376620.8,60.023786692311525,81.81299335185317,NaN,NaN,4.385839849503244,11.400404266536299
2011-03-14T09:30:00-04:00,79.34,80.33,78.91,79.75,60182144,63914544,44.72935588497184,51.76313313173636,NaN,NaN,-143.90289875479246,-72.76387753732487,-0.33037123428384785,0.10345194165729765,0.4338231759411455,2523245920,2574761027.2,56.811734027544375,79.67620158514346,NaN,NaN,1.9926534743513553,10.056439867652735
2011-03-15T09:30:00-04:00,77.96001,79.67,77.5699,79.03999,84974432,66326561.6,42.04361859348366,51.44481506652234,NaN,NaN,-173.999558588076,-111.86267359527073,-0.39895586849248943,-0.06487165967446629,0.33408420881802314,2438271488,2530597171.2,47.8645158779155,77.13539992013116,NaN,NaN,-0.8356651343121437,8.500424867372038
2011-03-16T09:30:00-04:00,78.67999,79.64,77.75999,78.25,126083056,70485028,39.22173255492383,50.73140171043646,NaN,NaN,-156.77638135683034,-150.63280589439645,-0.47449056083965785,-0.2590289922315492,0.21546156860810867,2312188432,2471464144,39.006527910525016,73.96230775151105,NaN,NaN,-4.090656286679117,6.701698988221873
2011-03-17T09:30:00-04:00,79.33,79.44,78.42,78.42,64028640,71772176.8,40.152618657035745,49.48005573209365,NaN,NaN,-125.21613070936988,-148.17867142284922,-0.4880759825390123,-0.39463340956565673,0.09344257297335556,2376217072,2446670195.2,35.99834511836512,70.5487350869712,NaN,NaN,-6.449428175798835,4.822966536218915
2011-03-18T09:30:00-04:00,79.33,79.59,79.07001,79.46001,70057184,73530098.4,45.63811597991974,48.59510303711024,NaN,NaN,-82.44369264018592,-136.46773240985092,-0.40548620170896765,-0.413415179162854,-0.007928977453886349,2446274256,2419239433.6,32.96899489667692,66.88119961555205,NaN,NaN,-6.8712797002474835,3.1523599310094292
2011-03-21T09:30:00-04:00,80.48,81.32001,80.36,81.3,50644288,74086600.8,53.72022532434071,48.888403996778884,NaN,NaN,16.406647296767904,-104.40582319953884,-0.21496812016507652,-0.276639127660232,-0.06167100749515549,2496918544,2413973958.4,32.40527029793816,63.13825852651733,NaN,NaN,-4.626939677214182,2.0410314155489138
2011-03-22T09:30:00-04:00,81.42,81.60001,80.67,80.87,52388352,73287505.6,51.78267762932137,48.93098578526717,NaN,NaN,22.60635200734605,-65.08464108045443,-0.1111654461631429,-0.20062781519908413,-0.08946236903594122,2444530192,2415225699.2,32.699874321518564,59.23748003829554,NaN,NaN,-3.4106520379435903,1.2622194936214133
2011-03-23T09:30:00-04:00,80.69,81.36,79.85001,81.12,58047008,71626772,52.84749609174693,48.5130494319193,NaN,NaN,3.677794850205034,-32.993805839047354,-0.023506437414585926,-0.11884541580417363,-0.0953389783895877,2502577200,2453303452.8,41.108415782785876,55.80460747913908,NaN,NaN,-2.1064952998837745,0.7809745231206722
2011-03-24T09:30:00-04:00,81.49001,81.78999,80.74001,81.50999,52881568,70013978.4,54.53426222221284,48.347280276890004,NaN,NaN,37.428099854130515,-0.4649597263472828,0.05842621530324246,-0.022306209260534615,-0.08073242456377708,2555458768,2489151792,47.72969947946379,52.80674352997942,NaN,NaN,-0.5301681496831037,0.5936684270058471
2011-03-25T09:30:00-04:00,81.98,83.06,81.5507,82.22,78215248,70996376.8,57.514087117778615,48.85147376324811,NaN,NaN,94.7259604489981,34.968970891489526,0.15276441756805054,0.11022309739628611,-0.04254132017176444,2633674016,2526631744,53.603135711520075,50.67595245230374,NaN,NaN,1.6982666669903228,0.7514681755750579
2011-03-28T09:30:00-04:00,82.49001,82.75999,81.97,82.03999,42807184,70642769.6,56.502985633668466,48.90844262113713,NaN,NaN,93.25389434776515,50.338420301688984,0.19278563534455756,0.19844072400893253,0.00565508866437496,2590866832,2545421401.6,56.256836608883496,48.67724998930419,NaN,NaN,3.2589134283417818,1.1096746402560185
2011-03-29T09:30:00-04:00,82.09,82.89,81.58,82.81,40970352,69147890.4,59.76168794094842,49.308544095402645,NaN,NaN,95.59669078692995,64.93648805760577,0.25685270069146315,0.3267209645287039,0.06986826383724075,2631837184,2582882800,61.0411465918334,47.32049305343962,NaN,NaN,5.559929694131861,1.7454253622382816
2011-03-30T09:30:00-04:00,83.17,83.99001,83.03999,83.88,42161472,68202156.8,63.81815576465127,50.61879003253756,NaN,NaN,146.44301144437733,93.48953137644023,0.3511919777265538,0.508858235995433,0.1576662582688792,2673998656,2617167091.2,64.83212352869627,47.310743346141294,NaN,NaN,8.82405825237624,2.75665863225799
2011-03-31T09:30:00-04:00,83.8,84.28999,83.7,84.17,41635488,66336731.2,64.85235315771233,51.93709803947969,NaN,NaN,153.79380584895188,116.76267257540448,0.40898165445331347,0.668893326335521,0.25991167188220754,2715634144,2649202166.4,67.96856131171467,47.87822724752722,NaN,NaN,11.830966797510678,4.052988370151231
2011-04-01T09:30:00-04:00,84.77,85.02,84.25,84.53999,49185712,65748663.2,66.18053089547689,53.46932482594434,NaN,NaN,161.95951842874214,130.2093841713533,0.44500594245308767,0.8161690999485671,0.37116315749547946,2764819856,2675431334.4,70.30381786874857,48.84194752189895,NaN,NaN,14.746369665329134,5.58061426946236
2011-04-04T09:30:00-04:00,84.75999,84.97,84.53999,84.73,42241008,63320760.8,66.87286382822244,55.2428423427114,NaN,NaN,143.5381713704379,140.26623957588785,0.45299949206799506,0.9374125225804733,0.4844130305124782,2807060864,2718670140.8,73.70690959304339,50.68783278726522,NaN,NaN,17.37763231063291,7.265902561058153
2011-04-05T09:30:00-04:00,84.67999,85.745,84.521,85.19,45473552,62206094.4,68.55134450139097,57.33781462460191,NaN,NaN,138.236822030021,148.79426582450606,0.45920253640869624,1.0584162010233484,0.5992136646146522,2852534416,2762809587.2,76.64876160979435,53.37656376578446,NaN,NaN,20.118279662482944,9.101956432690265
2011-04-06T09:30:00-04:00,85.63,85.88,84.91,85.38,59046480,62596558.4,69.24450784154124,59.41580670920945,NaN,NaN,127.96845356537015,145.09935424870463,0.4456807681986332,1.1563146248629437,0.7106338566643104,2911580896,2810326035.2,79.32992352209175,56.4716765089078,NaN,NaN,22.624143772823043,11.033697481280662
2011-04-07T09:30:00-04:00,85.46001,85.77499,84.61749,84.87,69454128,60685927.2,65.09692350751598,60.80572153260918,NaN,NaN,103.86579293735578,135.11375166638544,0.37481654175306167,1.1791545338556375,0.8043379921025758,2842126768,2835624560,80.60666105058168,59.87436694847242,NaN,NaN,23.726150035991505,12.846904989096496
2011-04-08T09:30:00-04:00,85.25,85.35989,83.60001,83.98,63655008,59706615.2,58.51051958232786,61.14788540817968,NaN,NaN,71.12955301705273,116.94775858404753,0.24662099827439665,1.1126142399455716,0.865993241671175,2778471760,2838354940.8,80.74489608175742,63.327197361602366,NaN,NaN,22.876783427262055,14.27974476597729
2011-04-11T09:30:00-04:00,84.02,84.28,82.89999,83.23,41790720,58787044,53.58982742955477,61.27696753676779,NaN,NaN,38.514406951409775,95.94300570024191,0.09758389198692763,0.9879731066548345,0.8903892146679069,2736681040,2824278976,77.67117104900504,66.53943284213712,NaN,NaN,20.696538668494167,15.196429609193986
2011-04-12T09:30:00-04:00,82.78999,83.05,82.05,82.14,58127872,57444716,47.35647697155489,60.8847518853255,NaN,NaN,-4.544590304387685,67.38672323336017,-0.07862394984423526,0.7921092773626128,0.8707332272068481,2678553168,2789482726.4,70.5241248644744,68.64055491940059,NaN,NaN,16.813173151789602,15.42739297242193
2011-04-13T09:30:00-04:00,82.64999,82.81,81.67,82.25,80460064,55163566.4,48.01364948067336,60.418993832358396,NaN,NaN,-19.80596615546475,37.83183928919317,-0.18586437962425717,0.6384027526765266,0.8242671323007837,2759013232,2758969193.6,64.88566810166051,69.86598124955749,NaN,NaN,13.844811925873076,15.201309965772094
2011-04-14T09:30:00-04:00,81.59,82.71001,81.45,82.63,58541888,54889228.8,50.320844175453374,59.90519076504945,NaN,NaN,-29.150393932782727,11.228601915165457,-0.22660125936749387,0.5410155580914164,0.7676168174589103,2817555120,2754054864,63.9982120368889,70.60848670136954,NaN,NaN,11.979004530548192,14.740980617882965
2011-04-15T09:30:00-04:00,82.66,83.50999,82.25999,83.50999,53705232,54071631.2,55.271452139878335,59.81722408692159,NaN,NaN,0.7235708173625897,-2.8525945247725595,-0.19109484394590104,0.5287482625265341,0.7198431064724351,2871260352,2772612582.4,65.895175155025,71.29693945466538,NaN,NaN,11.768120986013814,14.3162863847588
2011-04-18T09:30:00-04:00,82.25,82.25999,81.42999,82.13,58617104,54470272,47.30956261244685,58.92778656345719,NaN,NaN,-64.26673002603087,-23.408821920260685,-0.25345301323181657,0.4030268399326644,0.656479853164481,2812643248,2787805024,67.40914841477041,71.7517967277323,NaN,NaN,9.031788809626043,13.561358159739836
2011-04-19T09:30:00-04:00,82.41,82.69501,81.67,82.14861,31998512,53450780,47.419563092415856,57.75645851544038,NaN,NaN,-57.139813066557245,-33.9278664726946,-0.28404883468357167,0.30141880981001634,0.585467644493588,2844641760,2821022742.4,70.49339138880606,72.15617300345443,NaN,NaN,6.895266744307205,12.609059386106603
2011-04-20T09:30:00-04:00,83.5,83.89999,83.25,83.83,47098816,52903370.4,56.29688451352652,57.14535361228424,NaN,NaN,20.465321363601625,-25.87360896888133,-0.18637060853993526,0.352504383818669,0.5388749923586043,2891740576,2847568211.2,72.7155419975226,72.49524305244071,NaN,NaN,7.806573894503323,11.922990030163277
2011-04-21T09:30:00-04:00,84.34,84.48,83.73,84.45,30383920,51778488,59.04285190339802,56.63551939856433,NaN,NaN,49.18405839135005,-10.206718504054772,-0.08072380234852139,0.43797023942295255,0.5186940417714739,2922124496,2868482086.4,74.35423872220791,72.7845588276878,NaN,NaN,9.449957172724831,11.569699621957785
2011-04-25T09:30:00-04:00,84.37,84.53,83.77,84.34,23442960,49039873.6,58.34244043571206,56.02620344195644,NaN,NaN,43.78033421519101,-1.5953658244890874,-0.02202353342643637,0.4911646249884285,0.5131881584148649,2898681536,2873966323.2,74.78196009504772,72.86134814925956,NaN,NaN,10.543443917723472,11.423091664210025
2011-04-26T09:30:00-04:00,84.53,85.67,84.35001,85.17999,53163408,49557684.8,62.04514741276575,55.56147507848321,NaN,NaN,92.75227694195961,29.808435569109008,0.06485072888404908,0.5942515695199262,0.5294008406358771,2951844944,2901806662.4,76.8891526928108,72.87851894090359,NaN,NaN,12.64323594687728,11.597397990305348
2011-04-27T09:30:00-04:00,85.23,85.77,84.89,85.69,44683152,49743324.8,64.12986754279686,55.19614362857289,NaN,NaN,107.7326492850465,62.78292803942976,0.14362345141056143,0.708930154899079,0.5653067034885175,2996528096,2932183929.6,78.95544393715147,72.85177039912213,NaN,NaN,15.038343488953432,12.08896163296936
2011-04-28T09:30:00-04:00,85.60001,86.5,85.52,86.08,43474912,49808996.8,65.6821512720204,55.23794561175178,NaN,NaN,129.4464902033141,84.57916180737226,0.20520278474024223,0.8218101844138204,0.6166073996735781,3040003008,2961836416,80.7634502584029,72.86296962825223,NaN,NaN,17.496196623934182,12.861423774535764
2011-04-29T09:30:00-04:00,86.19,86.67999,85.92999,86.39,41034688,49778956.8,66.90801641256061,55.83776681391125,NaN,NaN,129.96346920699568,100.73504397050138,0.24720443264437064,0.9256129404790414,0.6784085078346708,3081037696,2993619056,82.49899822609555,72.98826263856209,NaN,NaN,19.901102153117023,13.867092114333087
2011-05-02T09:30:00-04:00,86.78,86.81,85.28,85.38,48978656,49768604,59.45616942615613,56.25679124223992,NaN,NaN,92.89174713387881,110.55732655423894,0.18993062567338126,0.9158217899263974,0.7258911642530161,3032059040,3020294556.8,83.81857173979706,73.42736268790438,NaN,NaN,19.79889754448624,14.714492890069252
2011-05-03T09:30:00-04:00,85.28999,85.49001,83.72,84.3,56077488,50460428,52.69747729133504,56.638291265081364,NaN,NaN,20.27225984796848,96.06132313544072,0.06853514769156654,0.8115600988674743,0.7430249511759077,2975981552,3025121878.4,84.05290322518798,74.39370399938392,NaN,NaN,17.56006337508178,15.121002959356757
2011-05-04T09:30:00-04:00,84.42,84.46001,82.73,83.21001,64787536,51426127.2,46.902577978696016,56.55892901494013,NaN,NaN,-33.39873837787037,67.83504560285735,-0.08748054381067882,0.6336742714125592,0.721154815223238,2911194016,3008055062.4,79.66063825318948,75.44905901020742,NaN,NaN,13.703386319559192,14.918486296528533
2011-05-05T09:30:00-04:00,82.64,84.08,82.41,82.83,91882320,53067919.2,45.04289235254362,56.18193245616086,NaN,NaN,-48.0658745112459,32.33257265994534,-0.21150826327818306,0.45676948612550916,0.6682777494036922,2819311696,2963916800,69.5397964301255,75.84488646686717,NaN,NaN,9.987980674024556,14.214128350456535
2011-05-06T09:30:00-04:00,83.755,84.34,82.84,83.27,76495184,53419972,47.63200588094627,55.63625772337999,NaN,NaN,-22.650581856802884,1.8097624471856257,-0.25617161096086494,0.348063235702611,0.6042348466634759,2895806880,2926870636.8,62.37659436985688,75.5935592679266,NaN,NaN,7.709524501547276,13.284899229183784
2011-05-09T09:30:00-04:00,83.17,84.33,83.03999,84.24001,45818992,52528171.2,52.90012077206723,56.035583306210015,NaN,NaN,1.7530651871539205,-16.417973942159357,-0.2143417145444365,0.33630770348293026,0.5506494180273668,2941625872,2908784003.2,59.171886891241556,75.00518344481739,NaN,NaN,7.378896924389215,12.441184614213132
2011-05-10T09:30:00-04:00,84.67,85.53999,84.56,85.53,44421296,52659700,58.83142199705138,56.85071608511255,NaN,NaN,74.31011653515253,-5.610402604722542,-0.09958341647735935,0.4261701474306676,0.525753563908027,2986047168,2910797126.4,59.42178156888774,74.2143541719661,NaN,NaN,9.050954779570034,11.956866066406976
2011-05-11T09:30:00-04:00,85.24001,85.35899,83.55,83.95,81332880,53819950.4,50.45117367772918,56.43316531112703,NaN,NaN,16.14360725569065,4.298066521989666,-0.12805991495760133,0.3656786702110253,0.4937385851686266,2904714288,2909501180.8,59.170705370225186,73.24686584144486,NaN,NaN,7.610607882963334,11.33597204020074
2011-05-12T09:30:00-04:00,83.47,84.94,82.98,84.69,80117248,53802809.6,53.772469447558784,56.05670942142422,NaN,NaN,5.550305009401034,15.021302426119053,-0.09647156938202506,0.3731491234410953,0.46962069282312036,2984831536,2942605148.8,63.42232092015497,72.46601456986964,NaN,NaN,7.5763433250760945,10.798882223754362
2011-05-13T09:30:00-04:00,84.75999,84.99001,83.27,83.50999,74677376,54609584,48.221675245645,55.33379762213372,NaN,NaN,-20.45377988475619,15.46066282052839,-0.1512023309597394,0.2806177791234461,0.4318201100831855,2910154160,2945474604.8,63.77444952248732,71.67976381468675,NaN,NaN,5.63440468875164,10.061099718753972
2011-05-16T09:30:00-04:00,82.96001,83.89,82.22,82.28999,68783568,55363500.8,43.25064342163662,53.99133305133879,NaN,NaN,-99.80660103507526,-4.8512704239174465,-0.2593746073406736,0.10760185090734353,0.3669764582480171,2841370592,2925423548.8,59.466414040264105,70.435282482362,NaN,NaN,2.271412461169638,8.948287253384782
2011-05-17T09:30:00-04:00,81.63,82.32001,81.39999,82.03,76489376,56257114.4,42.25105030766761,52.428560391686695,NaN,NaN,-163.00488515347536,-52.31427076164302,-0.3335156577541387,-0.049918113944656284,0.28359754380948243,2764881216,2881190358.4,51.24282636415367,68.45580979857642,NaN,NaN,-0.679837097513936,7.572840917542108
2011-05-18T09:30:00-04:00,82.13,83.325,82,83.28999,54523312,57383354.4,48.4670479657225,51.19891015552256,NaN,NaN,-100.81624615559974,-75.7062414439011,-0.28467827635378545,-0.07225030163274937,0.21242797472103608,2819404528,2864128406.4,48.45907870857252,66.14835468787426,NaN,NaN,-1.1337794886829342,6.329038002367103
2011-05-19T09:30:00-04:00,83.86,83.97,82.73,83.47,52926976,57674762.4,49.3065710407049,49.94166405753286,NaN,NaN,-60.27292678842861,-88.87088780346703,-0.22959349380712255,-0.0745638925378671,0.15502960126925544,2872331504,2841628400,44.98824023220545,63.469014831167826,NaN,NaN,-1.2261195083524772,5.24972978655002
2011-05-20T09:30:00-04:00,83.25,83.45,82.28889,82.85899,56026224,58956877.6,46.53537527813842,49.018750189817304,NaN,NaN,-87.49285921678405,-102.27870366987261,-0.2234383549972846,-0.1242683424773503,0.09917001251993429,2816305280,2822858624,42.26844238520219,60.50114844869676,NaN,NaN,-2.1568106824197244,4.1916525766972
2011-05-23T09:30:00-04:00,81.42,81.95,81.23,81.37,50708240,60320141.6,40.553721577051576,48.15133906736848,NaN,NaN,-152.880529148825,-112.89348929262255,-0.30379540277491507,-0.28057424094870953,0.023221161826205525,2765597040,2807703913.6,40.1574947205754,57.36576212693872,NaN,NaN,-4.932131656075085,2.888254829158302
2011-05-24T09:30:00-04:00,81.59,81.96001,80.83,80.98,60226208,60673281.6,39.13479911366421,47.596497719866214,NaN,NaN,-148.58508424343626,-110.00952911061472,-0.3633367783243829,-0.4309498110792731,-0.06761303275489021,2705370832,2795801836.8,38.52999844400294,54.4278592834254,NaN,NaN,-7.615738579843414,1.387684342158057
2011-05-25T09:30:00-04:00,80.77,82.28999,80.75999,82,60013728,61439810.4,44.59486879051279,47.564496036864014,NaN,NaN,-112.28249907488896,-112.30277969447256,-0.31589901249788127,-0.4624867983772418,-0.14658778587936055,2765384560,2784997843.2,37.06166538556471,52.107992780242476,NaN,NaN,-8.19046404597836,0.019377429567140503
2011-05-26T09:30:00-04:00,81.7,83.12,81.64999,83.08,51833312,61857730.4,49.736383958779385,47.71480875670924,NaN,NaN,-53.115219696330975,-110.87123827605305,-0.19934650188078068,-0.3957709132303364,-0.19642441134955574,2817217872,2773975116.8,35.57221550874932,50.19339429016337,NaN,NaN,-7.025074269522354,-0.98697281315993
2011-05-27T09:30:00-04:00,83.46001,83.92999,83.25999,83.64999,46620736,62137032.8,52.25464322630732,47.66870321772638,NaN,NaN,21.116509056112648,-89.14936462147371,-0.07767737912667907,-0.2935211352579046,-0.2158437561312255,2863838608,2783481782.4,37.89058305076023,48.67330115870042,NaN,NaN,-5.275106063363915,-1.599563277474785
2011-05-31T09:30:00-04:00,84.61,84.86,83.77,84.84,77456128,63560906.4,57.088446853982134,47.54420499322144,NaN,NaN,95.29456203745103,-39.51434638421849,0.08056591090594684,-0.11513636749879197,-0.1957022784047388,2941294736,2818621321.6,45.67241767106643,47.691203737427465,NaN,NaN,-2.197703215429027,-1.6850118400396767
2011-06-01T09:30:00-04:00,84.71001,84.8185,82.03,82.11,80933808,64803722.4,45.666243918053226,47.20242429610172,NaN,NaN,-15.66342095283138,-12.930013726097519,0.003088299331603178,-0.19184190424023484,-0.19493020357183802,2860360928,2849619340.8,51.45107244251409,47.139801385448095,NaN,NaN,-3.3869534325936685,-1.9281463532616756
2011-06-02T09:30:00-04:00,82.32001,82.66,81.60001,82.08,64676928,64798192,45.558370827732944,46.61570296611416,NaN,NaN,-78.38504791656709,-6.150523494433155,-0.04577244882404291,-0.25214576460189164,-0.20637331577784873,2795684000,2855679228.8,52.51443968100696,46.36066701122324,NaN,NaN,-4.322724950456118,-2.270229010003739
2011-06-03T09:30:00-04:00,80.81,81.73,80.69,80.88,76496432,64028897.6,41.350668237031485,46.1249167512132,NaN,NaN,-135.72234353581675,-22.67194826233031,-0.1486976822297071,-0.39224541856498263,-0.24354773633527552,2719187568,2836073168,48.79092462356678,45.29041523272891,NaN,NaN,-6.512637423799441,-2.876287354831696
2011-06-06T09:30:00-04:00,80.75,81.07001,79.49001,79.55,63792160,63393746.4,37.244863296376785,45.69593245655177,NaN,NaN,-177.87214055447623,-62.46967818444809,-0.2880713609759918,-0.6036369375552653,-0.3155655765792735,2655395408,2794384528,41.97564306621669,44.04107444886838,NaN,NaN,-9.751869988805083,-3.8585134453993226
2011-06-07T09:30:00-04:00,80.03999,80.42999,79.5291,79.74001,58330224,64019308,38.189120280624735,45.40579459747728,NaN,NaN,-157.27849276533215,-112.98428914500474,-0.3453239605120878,-0.7472205272193833,-0.40189656670729546,2713725632,2748870707.2,36.05439544879815,42.95618652634299,NaN,NaN,-11.992884000620586,-5.020566381859503
2011-06-08T09:30:00-04:00,79.47,79.72,78.71001,78.85001,67750256,65185756,35.49506136346493,44.47922412588746,NaN,NaN,-174.43642319233476,-144.73888959290542,-0.4162400346176566,-0.9221966099793661,-0.5059565753617096,2645975376,2705993596.8,31.540501451456706,41.74771672226329,NaN,NaN,-14.723091912713068,-6.406641457695726
2011-06-09T09:30:00-04:00,79.08,79.71001,78.73,79.27,58471808,64042702.4,37.7275884967847,43.65215394417887,NaN,NaN,-145.99960371232325,-158.26180075205664,-0.4074533754299169,-1.0152732946491057,-0.6078199192191888,2704447184,2687746233.6,29.828948376304737,40.66491016112752,NaN,NaN,-16.276329316674047,-7.8165968661212
2011-06-10T09:30:00-04:00,78.78,78.91,77.64999,78,71824880,63628084,33.90611173750102,42.7500636912762,NaN,NaN,-170.99549490631674,-165.31643102615664,-0.4560937433196217,-1.1779370983687159,-0.7218433550490941,2632622304,2670433180.8,28.26190359156753,39.664443104439336,NaN,NaN,-18.826582220839466,-9.389451916795238
2011-06-13T09:30:00-04:00,78.23,78.64,77.35001,77.78,60288816,62908656,33.27729536496379,42.23031896184136,NaN,NaN,-156.96106549617772,-161.13421601449693,-0.47013037386804635,-1.309506322384152,-0.8393759485161058,2572333488,2653820796.8,26.806680761341468,38.710813535922625,NaN,NaN,-21.07287566391324,-11.05851245209781
2011-06-14T09:30:00-04:00,78.44,79.67999,78.39,79.45,66668816,62802918.4,42.06130906180247,42.43935538670838,NaN,NaN,-89.78253599013001,-147.63502465945652,-0.34005532203393707,-1.2644451010585271,-0.9243897790245901,2639002304,2638876131.2,25.53297690110051,37.78245485428674,NaN,NaN,-20.33463725214471,-12.383673137818796
2011-06-15T09:30:00-04:00,78.60001,79.21001,77.72,78.03,89261936,63441546.4,37.53622629386361,41.93516663694772,NaN,NaN,-109.12048863855108,-134.57183774869978,-0.32289413507722053,-1.3280074478711157,-1.0051133127938952,2549740368,2619629129.6,23.95437769664244,36.84622001936372,NaN,NaN,-21.15253647314613,-13.636367900008416
2011-06-16T09:30:00-04:00,78.09,78.88,77.23,78.21001,81850192,64807890.4,38.44036025550405,41.12830780099949,NaN,NaN,-103.03253119781445,-125.97842324579801,-0.2745599475648648,-1.3483132472499761,-1.0737532996851114,2631590560,2605057804.8,22.80485290415031,35.93426554760664,NaN,NaN,-21.52430256000334,-14.76321570857912
2011-06-17T09:30:00-04:00,78.99001,79.12711,77.83,78.23,77866624,66054872.8,38.54673789555733,40.14917170594591,NaN,NaN,-83.07798083704836,-108.39492043194431,-0.21880721010929638,-1.3472623123217318,-1.1284551022124354,2709457184,2620424780.8,26.794645804629056,35.141698601454415,NaN,NaN,-21.791527543197372,-15.767260256381727
2011-06-20T09:30:00-04:00,77.96001,79.23,77.92999,78.95,53351216,65921122.4,42.40709642723307,39.10050381832098,NaN,NaN,-65.2233166402497,-90.04737066075873,-0.11615561115398187,-1.2736496161549127,-1.1574940050009308,2762808400,2658519763.2,35.67093854687131,34.42730723544049,NaN,NaN,-20.904030994074564,-16.501084647480702
2011-06-21T09:30:00-04:00,79.58,80.77,79.42,80.66,75979744,67184697.6,50.3795452139971,39.437168196602684,NaN,NaN,-3.047285534725147,-72.70032056967776,0.0739543484796541,-1.0650510694013633,-1.1390054178810174,2838788144,2698476931.2,43.42022307847066,33.85367513800882,NaN,NaN,-17.59858847741278,-16.65787090889957
2011-06-22T09:30:00-04:00,80.22,81.11,80.00999,80.03999,55852304,66966002.4,47.79608173704632,39.597004690125075,NaN,NaN,2.8063920011915604,-50.314944441729224,0.16005128421923698,-0.9389413126069712,-1.0989925968262082,2782935840,2745116025.6,50.86103741768152,33.735574976342704,NaN,NaN,-15.626708147550541,-16.510561942992567
2011-06-23T09:30:00-04:00,79.13,80.50999,78.3,80.35001,92521056,68591368.8,49.19888582237475,40.15759166050674,NaN,NaN,-21.017943779253365,-33.912026958017016,0.23542908063781254,-0.8047062460289425,-1.040135326666755,2875456896,2793889292.8,57.20001578279592,34.336224344859076,NaN,NaN,-13.595753043488592,-16.094160671634857
2011-06-24T09:30:00-04:00,80.63,80.75999,79.47,79.94,73867744,69693090.4,47.385344788368776,40.88191176707759,NaN,NaN,-1.6083709050546358,-17.618104971618273,0.2536496765742283,-0.7230732309489696,-0.9767229075231979,2801589152,2812315686.4,59.334358198674856,35.57613256860609,NaN,NaN,-12.409891281445908,-15.567836473036435
2011-06-27T09:30:00-04:00,79.91,80.72,79.455,80.56,51197344,69921920.8,50.3648450287955,41.75160639194693,NaN,NaN,17.331682819836846,-1.1071050796009665,0.30024480580818913,-0.6014169002629615,-0.9016617060711506,2852786496,2830311305.6,61.360913551054004,37.38374100448151,NaN,NaN,-10.53977316989755,-14.849541715445165
2011-06-28T09:30:00-04:00,80.83,81.85001,80.67,81.81,54021696,68750199.2,55.79944325406672,43.20191938413278,NaN,NaN,102.82466393762864,20.067284814869794,0.4017027586971593,-0.3995332576997015,-0.8012360163968608,2906808192,2843915315.2,62.86741929401512,39.621377993235676,NaN,NaN,-7.2243966846919525,-13.76023528248042
2011-06-29T09:30:00-04:00,82.10001,82.39999,81.44,82.2,68230192,68115018.4,57.36783561962298,44.60479417862122,NaN,NaN,147.46383993039385,48.99877440071025,0.4764303203154361,-0.2056981160025657,-0.6821284363180018,2975038384,2882335824,66.80393034159002,42.2624481336132,NaN,NaN,-4.008157247621943,-12.367081277500636
2011-06-30T09:30:00-04:00,82.41,83.05,82.28,82.8,59919648,67877154.4,59.734987608182266,46.44971388366987,NaN,NaN,185.04793947691294,90.21195105194352,0.5428022766072722,-0.00362559055891154,-0.5464278671661837,3034958032,2914236051.2,69.67819490455298,45.22075465596931,NaN,NaN,-0.5748329534694062,-10.682474374067603
2011-07-01T09:30:00-04:00,82.88,84.23,82.62,84.09,63908352,67247750.4,64.32183615883511,48.66718108323216,NaN,NaN,210.52139624144627,132.63790448124368,0.6432548055803835,0.25764063980929564,-0.38561416577108787,3098866384,2973691497.6,74.16758755010895,48.603676569452695,NaN,NaN,3.917908330752863,-8.596705416236109
2011-07-05T09:30:00-04:00,83.92999,84.14,83.53,84.03999,48268896,66471587.2,64.017371959705,50.23547129022519,NaN,NaN,181.7416452376074,165.51989696479782,0.6728200741897126,0.4554109269660529,-0.2174091472236597,3050597488,3013253696,76.64545156796675,52.254567617086,NaN,NaN,7.455923455451817,-6.303472720280691
2011-07-06T09:30:00-04:00,83.91,84.50999,83.61,84.38,57096000,66409876,65.22266759744551,52.21307424048104,NaN,NaN,159.02248166419795,176.75946051011167,0.6797613932782474,0.6322925943741495,-0.04746879890409786,3107693488,3053430755.2,78.8628389468202,56.176600563527266,NaN,NaN,10.771263662459562,-3.864224665603512
2011-07-07T09:30:00-04:00,85.215,85.97,84.94,85.64999,68558752,66450300.8,69.35213653765868,54.42105826063494,NaN,NaN,170.997913198047,181.4662751636423,0.7299584209695631,0.864979227307856,0.13502080633829291,3176252240,3093673526.4,80.82649748154111,60.321003747626605,NaN,NaN,15.028961154711324,-1.1651981198442503
2011-07-08T09:30:00-04:00,84.62,85.21001,84.32001,85.13,61989920,66626206.4,65.90170086720875,56.374984187181475,NaN,NaN,125.85219500025171,169.62712626831006,0.688739812895389,0.9959455724575292,0.3072057595621402,3114262320,3109534384,81.5538557552645,64.23237588695771,NaN,NaN,17.612650301997988,1.5173516547046404
2011-07-11T09:30:00-04:00,84.06,84.53,83.09,83.32001,59769744,66023449.6,55.54291962311201,57.313257272601405,NaN,NaN,77.12123661541125,142.94709434310306,0.50848983920823,0.9428180585724277,0.4343282193641977,3054492576,3100659622.4,79.73126035184909,67.37954173017042,NaN,NaN,16.69921704035355,3.6861895669401985
2011-07-12T09:30:00-04:00,82.88,83.76801,82.78,82.85001,65322064,66275112,53.20427138109118,57.515023427393835,NaN,NaN,54.693767781220444,117.53751885182567,0.33490278064820633,0.8529566951744556,0.5180539145262493,2989170512,3088374227.2,77.16052101668552,69.78956301147147,NaN,NaN,15.220382968631615,5.333931481467544
2011-07-13T09:30:00-04:00,83.38,84.47,83.22,83.59,79327120,66908027.2,56.32249125365171,58.124052678579936,NaN,NaN,67.35049366394281,99.20312125177465,0.2510470525182422,0.831862730174052,0.5808156776558098,3068497632,3080535056,75.48799453718617,71.54863137715037,NaN,NaN,14.923514187354947,6.703871868022887
2011-07-14T09:30:00-04:00,83.75,84.17,82.05,82.25999,91726560,67031258.4,49.888050672230136,58.173278739283894,NaN,NaN,32.34754042669834,71.4730466975049,0.09515428863382758,0.6997585384480942,0.6046042498142666,2976771072,3040638822.4,67.47215748049427,72.28235578412882,NaN,NaN,12.583282381550815,7.543787655669734
2011-07-15T09:30:00-04:00,82.61,82.91,82.17999,82.81,75497312,66713614.4,52.314204499066655,58.52534014719089,NaN,NaN,19.94984424557443,50.29257654656946,0.022043871070188903,0.6321590886520028,0.6101152175818139,3052268384,3028240035.2,65.15656997277668,72.69822805370752,NaN,NaN,11.411679485668978,8.096343631383911
2011-07-18T09:30:00-04:00,82.44,82.63,81,81.48,56866000,65663583.2,46.45695749296927,58.2462053232033,NaN,NaN,-23.779403056813393,30.112448612124513,-0.11537569527725355,0.46589559848524686,0.5812712937625004,2995402384,3016421996.8,62.93934533523957,72.81097318114935,NaN,NaN,8.477159872867125,8.150745951595798
2011-07-19T09:30:00-04:00,82.23,83.41,82.17999,83.32001,56068400,65799442.4,54.111677667733574,58.12565063846522,NaN,NaN,23.187309346494946,23.81115692517941,-0.08333363243787262,0.4771042532151597,0.5604378856530323,3051470784,3028882051.2,64.31801345215572,72.91458704958796,NaN,NaN,8.471076175988273,8.196507412223294
2011-07-20T09:30:00-04:00,83.35001,83.42,82.64999,83.17999,40277328,64014321.6,53.48504474236908,57.84830843294708,NaN,NaN,24.00761404646012,15.142581001682874,-0.07292695600643972,0.4692791906449827,0.5422061466514224,3011193456,3017421216,62.03217940185837,72.57374769674999,NaN,NaN,8.265339687251245,8.206340594370145
2011-07-21T09:30:00-04:00,83.44,84.3,83.24001,83.94,63407232,64392068,56.43409941671058,57.61253070498481,NaN,NaN,58.14116309106736,20.301305534556683,-0.01902242855303382,0.5184281109601301,0.5374505395131639,3074600688,3036987139.2,64.36085057116306,72.19393738722214,NaN,NaN,9.022961801775152,8.323000766856575
2011-07-22T09:30:00-04:00,83.85001,84.25999,83.39999,84.05,34540176,61493024,56.860408228592405,57.079571567110335,NaN,NaN,57.472713457968396,27.805879377035478,0.017881181129822288,0.5598020159254418,0.5419208347956195,3109140864,3048361635.2,65.67872026726351,71.58758972416175,NaN,NaN,9.755420609820709,8.52763217299431
2011-07-25T09:30:00-04:00,83.02,83.759,82.75,83.06,49769408,60288107.2,51.93476473937916,56.216528194229916,NaN,NaN,2.196044762612034,33.00096894092057,-0.028045788311499842,0.5068635994062447,0.5349093877177445,3059371456,3061155449.6,67.1501226685265,70.9093519456303,NaN,NaN,8.896735843803887,8.580361268824248
2011-07-26T09:30:00-04:00,82.88,83.09,82.21001,82.42999,52213296,60338904.8,49.02430637324558,55.05950239250135,NaN,NaN,-60.12996004117013,16.33751506338755,-0.1004441496016949,0.4093542007156259,0.5097983503173208,3007158160,3052292924.8,65.06906249583791,69.92408219913156,NaN,NaN,7.2974848699850545,8.39709321184722
2011-07-27T09:30:00-04:00,81.89,81.91,79.85001,79.97,97533248,62514482.4,39.674802286986484,52.939692803167624,NaN,NaN,-217.19214832910146,-31.902437411724765,-0.3021951406335538,0.13205442452537852,0.4342495651589323,2909624912,3031979216,60.44508944429702,68.46826733932842,NaN,NaN,2.591369937599462,7.56770417266897
2011-07-28T09:30:00-04:00,79.96001,80.97,79.69,79.84,67439376,62474941.6,39.248813328345264,51.03591512182023,NaN,NaN,-219.49663352456278,-87.42999673485079,-0.4250624513112341,-0.09707849898011034,0.32798395233112376,2842185536,2985496185.6,51.43746631476273,66.31709666500686,NaN,NaN,-1.2214918704290252,6.312104737940685
2011-07-29T09:30:00-04:00,78.72,80.17999,78.14,79.74001,93519504,64154934.4,38.90282408244509,49.847336868915455,NaN,NaN,-219.76536599819482,-142.87761262608345,-0.48916212052040453,-0.28346869831938193,0.2056934222010226,2748666032,2913401219.2,41.18584874681459,63.56385297893297,NaN,NaN,-4.370707701425679,4.785988675174062
2011-08-01T09:30:00-04:00,80.69,80.99001,78.47,79.22,93483184,65633676,37.07250096443091,48.69506755343972,NaN,NaN,-166.95461746091615,-176.7077450707891,-0.5387569557326173,-0.467752772464749,0.07100418326786828,2655182848,2832563497.6,33.196684592295654,60.423578948619415,NaN,NaN,-7.557184385638879,3.0226782379150707
2011-08-02T09:30:00-04:00,78.92,79.6801,76.61,76.75,95669568,68003709.6,29.88110461778929,46.806397079449546,NaN,NaN,-202.77910224099466,-205.237573510754,-0.6998764689738277,-0.8038414029494163,-0.10396493397558865,2559513280,2743034521.6,26.959374074884863,56.957248915597894,NaN,NaN,-13.04117327686876,0.7278423072316662
2011-08-03T09:30:00-04:00,76.69,77.35001,74.88,77.25999,114910320,70894425.6,32.780490818247074,45.58442851845076,NaN,NaN,-195.86581847748036,-200.97230754042977,-0.7306801786468335,-1.0173151572841306,-0.28663497863729703,2674423600,2695994259.2,24.368629701145622,53.87842550278727,NaN,NaN,-16.541019687137908,-1.7391379776782725
2011-08-04T09:30:00-04:00,76.07001,76.21249,72.59,72.60001,130904816,74011728.8,23.299950712277052,43.51198181939435,NaN,NaN,-224.9242739610649,-202.05783562773019,-1.0064597253970289,-1.5447096353835832,-0.5382499099865543,2543518784,2636260908.8,21.5381791831025,50.76282616066769,NaN,NaN,-23.92065041128077,-4.907925468192915
2011-08-05T09:30:00-04:00,73.52,73.85001,69.66,71.33,188574320,80340948.8,21.476906793126844,41.72769248369132,NaN,NaN,-224.51790365033267,-203.00834315815774,-1.202694670199827,-2.041618247736338,-0.838923577536511,2354944464,2557516595.2,18.489349882134874,47.58782648544593,NaN,NaN,-30.347161855019365,-8.542102094882408
2011-08-08T09:30:00-04:00,69.00999,71.4099,65.08,65.12,170163440,85860633.6,15.210130291225482,38.94901052822645,NaN,NaN,-248.68704638734485,-219.3548289434435,-1.651303076116694,-2.9030524226823786,-1.2517493465656846,2184781024,2463436230.4,15.640668319711153,44.11087326169989,NaN,NaN,-39.41058297799989,-12.951885078184905
2011-08-09T09:30:00-04:00,66.92,69.62,63.75999,69.46001,207866880,92987874.4,30.4780028688061,37.30565039440052,NaN,NaN,-189.05154451563422,-216.6093173983714,-1.5575368390573006,-3.1986703953873104,-1.6411335563300098,2392647904,2430063155.2,14.77126390927782,40.73509358365842,NaN,NaN,-39.46877338485852,-16.740011979138277
2011-08-10T09:30:00-04:00,67.35001,69.5752,65.87,66.06,182376320,98140334.4,26.458487283307477,35.16453524201459,NaN,NaN,-158.58302934980247,-209.15275957283583,-1.6191361171998278,-3.6650537028297947,-2.045917585629967,2210271584,2337232752,12.662763367629793,37.04237306912034,NaN,NaN,-41.32333805082174,-20.251915703664487
2011-08-11T09:30:00-04:00,66.50999,70.44,66.07001,69.36,121880000,99648006.4,35.36798707843141,33.62936230271737,NaN,NaN,-117.79323758539734,-187.7265522977023,-1.3436170299088288,-3.725438873016003,-2.3818218431071743,2332151584,2294959312,11.83432253328904,33.196344659550725,NaN,NaN,-38.76953813064695,-22.897290336090553
2011-08-12T09:30:00-04:00,69.99001,70.60001,68.8,69.78999,86476496,100196965.6,36.448367177351145,32.5231910482868,NaN,NaN,-90.1268007643219,-160.84833172050017,-1.0513368063980475,-3.6959928511047337,-2.6446560447066862,2418628080,2307696035.2,13.666994226038128,29.37612119937298,NaN,NaN,-36.55426536902445,-24.848286769366823
2011-08-15T09:30:00-04:00,70.58,71.83,70.38,71.75999,57622384,100234784.8,41.29042925209031,31.970771253918567,NaN,NaN,-62.87249230896131,-123.68542090482345,-0.6631967900072877,-3.4736520322157958,-2.810455242208508,2476250464,2365989923.2,21.690255328526348,26.27763497313644,NaN,NaN,-32.996105303994376,-26.012260845742187
2011-08-16T09:30:00-04:00,70.59,71.41,69.66,70.44,79484256,101405577.6,39.138645943787346,31.93247437226148,NaN,NaN,-64.799959307981,-98.8351038632928,-0.44376856973045475,-3.3651659543715766,-2.921397384641122,2396766208,2366813584,21.800837782418625,23.517331283002274,NaN,NaN,-31.0217018365949,-26.72789527300686
2011-08-17T09:30:00-04:00,70.97,71.52,69.75999,70.46001,66792944,102731358.4,39.19038071726165,31.928300614326947,NaN,NaN,-57.33472361530344,-78.58544271639299,-0.255061316810818,-3.2402240306546446,-2.9851627138438266,2463559152,2417471097.6,28.48923411563841,21.878171840207674,NaN,NaN,-29.51486389372055,-27.126033647394532
2011-08-18T09:30:00-04:00,68.06,70.39751,65.82001,66.45,110700752,105096034.4,33.11529251820107,31.514905502595223,NaN,NaN,-86.27841097157071,-72.28247739362767,-0.3521068422924549,-3.4252962667093954,-3.0731894244169404,2352858400,2421612460.8,29.023696824816895,21.009446702922123,NaN,NaN,-30.293360206167435,-27.578508870076377
2011-08-19T09:30:00-04:00,65.00999,67.41,64.89999,65.28,99198000,108328925.6,31.577235956684163,31.12238657347046,NaN,NaN,-99.87039748931447,-74.2311967386262,-0.44112406038261565,-3.6245944998952098,-3.183470439512594,2253660400,2388618924.8,27.27474856806971,20.58645127262027,NaN,NaN,-31.424513045372272,-28.12793803797579
2011-08-22T09:30:00-04:00,67.12,67.19,64.57001,65.05,72216128,109451261.6,31.269771388879278,31.22157705711974,NaN,NaN,-96.72128163639272,-81.00095460411248,-0.4594488463152482,-3.757781497406654,-3.298332651091406,2181444272,2329657686.4,24.440390055878837,20.406523842691268,NaN,NaN,-32.40259544519446,-28.738603381864174
2011-08-23T09:30:00-04:00,65.46001,68.3,64.86,68.19,93279376,111504565.6,39.87673583465899,31.728451701149165,NaN,NaN,-72.10246039349754,-82.46145482121578,-0.21639166582945757,-3.568822233378228,-3.3524305675487702,2274723648,2305249174.4,23.358225596803962,20.334352120952577,NaN,NaN,-30.443317319784814,-28.982133944424266
2011-08-24T09:30:00-04:00,68.12,69.63,67.52,69.2,67697936,110012800,42.3763853945901,33.09105417845724,NaN,NaN,-42.805574310684094,-79.55562496029191,0.04231478480954065,-3.2995370865368443,-3.341851871346385,2342421584,2281021660.8,22.30263958905661,20.388956435663584,NaN,NaN,-28.068823395539432,-28.85166100886929
2011-08-25T09:30:00-04:00,69.98,70.28999,67.255,67.5,80732880,110677475.2,39.406646386482954,34.37174986369696,NaN,NaN,-45.620740535751764,-71.42409087312812,0.12422576226935522,-3.1865696685096907,-3.310795430779046,2261688704,2262787721.6,21.514608128666282,20.605046310415826,NaN,NaN,-27.00228713985779,-28.587464741867645
2011-08-26T09:30:00-04:00,67.25999,69.32001,66.06,69.11,84472816,110225140.8,43.448669903548385,36.38878840743432,NaN,NaN,-44.182716008102396,-60.28655457688571,0.3019841850439837,-2.933315199474066,-3.2352993845180498,2346161520,2281287945.6,24.432075140466225,21.233003940469764,NaN,NaN,-24.8491407070687,-28.053418451182083
2011-08-29T09:30:00-04:00,70.07001,72.45,70.035,72.38,53078448,108204904,50.649346619984144,37.82959867537561,NaN,NaN,48.49168531587569,-31.243961186432028,0.6357485783091357,-2.4406136616316303,-3.076362239940766,2399239968,2324847084.8,30.941207308939155,22.387999897588436,NaN,NaN,-20.57761275337409,-26.985446208638084
2011-08-30T09:30:00-04:00,71.89999,73.265,71.12,72.8,67801568,106811504,51.503483075411324,39.61852694624016,NaN,NaN,85.55828782518823,0.2881884573051224,0.8664686690363528,-1.993276403645325,-2.8597450726816778,2467041536,2363310662.4,36.16960035593544,24.06705968246741,NaN,NaN,-16.925149536852444,-25.548260969811565
2011-08-31T09:30:00-04:00,73.2,73.89,71.89999,72.64999,70313808,104581678.4,51.16288282510402,40.74673378528821,NaN,NaN,113.61982446862807,31.57326821316756,0.982156294911853,-1.6320497040418616,-2.6142059989537145,2396727728,2374171891.2,37.60609943706675,25.907900889880104,NaN,NaN,-14.094779498304092,-23.912049331024782
2011-09-01T09:30:00-04:00,72.7,73.63,70.69,71.09,86788752,102375875.2,47.634949580016965,41.54577538547863,NaN,NaN,88.76793708716876,58.45100373775167,0.9274591013588234,-1.454882122255185,-2.3823412236140085,2309938976,2383821945.6,38.921332818458794,27.71178221791015,NaN,NaN,-12.68251822668459,-22.307830601833327
2011-09-02T09:30:00-04:00,69.36,70.03999,68.10001,68.46001,78923184,96893318.4,42.33488998110212,41.62037972326518,NaN,NaN,-8.004068986730477,65.68673314202606,0.698436553976753,-1.5092955311430671,-2.20773208511982,2231015792,2360792800,36.92115453816702,28.799703590027345,NaN,NaN,-13.038269277212608,-20.98360755545894
2011-09-06T09:30:00-04:00,65.92999,68.31,65.92999,68.27,71503872,91960340,41.97154676004702,41.82272978156944,NaN,NaN,-59.16881138226837,44.15463380239724,0.5262779376096813,-1.5498846631077186,-2.0761626007174,2159511920,2312847190.4,33.10654125441316,29.607253838026956,NaN,NaN,-13.430439796904123,-19.90458358995111
2011-09-07T09:30:00-04:00,69.39999,70.95,69.07001,70.85001,68959184,85014955.2,48.44212708445172,42.483568807797305,NaN,NaN,39.232612584675444,34.889498754294685,0.5743620819672888,-1.358209998258289,-1.9325720802255777,2228471104,2265133104,29.806162657434598,29.701320162440968,NaN,NaN,-11.832040639750403,-18.751363168493864
2011-09-08T09:30:00-04:00,70.34,71.3,69.17999,69.55,71124000,79452339.2,45.678232252685426,43.38092164597476,NaN,NaN,24.444802600274237,17.054494380623925,0.5090465723011861,-1.2962638648490952,-1.8053104371502813,2157347104,2217256979.2,26.907604324155116,29.550170698107987,NaN,NaN,-11.31146000964637,-17.68851986008708
2011-09-09T09:30:00-04:00,68.7,69.13,66.75,67.5,99456944,78331186.4,41.64330803879673,44.09992679469708,NaN,NaN,-57.8868041641548,-12.276453869640791,0.32705547356043674,-1.3964910951997354,-1.723546568760172,2057890160,2166847216,24.23519573031291,29.33305978112536,NaN,NaN,-12.091722780621193,-16.888977420163382
2011-09-12T09:30:00-04:00,66.38,68.25,66.37,68.08,100109872,79012855.2,43.17277931587957,44.95014164662568,NaN,NaN,-60.377180134957996,-22.75107609928629,0.2485696803511943,-1.4128344683211793,-1.6614041486723736,2158000032,2152244064,23.50684785928884,29.266378195654646,NaN,NaN,-12.284088303675917,-16.23113611780803
2011-09-13T09:30:00-04:00,68.53999,69.46001,67.82899,69.17999,84144000,80338936,46.06017069095642,45.391815564932635,NaN,NaN,-10.734549589034737,-13.064223740639568,0.27169136881631073,-1.3217899376519853,-1.593481306468296,2242144032,2168770486.4,26.20961737713101,29.470049037106577,NaN,NaN,-11.613034168641006,-15.571407267927027
2011-09-14T09:30:00-04:00,69.84,71.39999,68.44,70.42,77019120,80215679.2,49.194068230109565,45.87879291032688,NaN,NaN,39.58336051326855,-12.994074154920947,0.36560309091546883,-1.13647744282396,-1.5020805337394287,2319163152,2186908896,29.167781975858333,29.960416350449556,NaN,NaN,-10.135349456552971,-14.794827580587876
2011-09-15T09:30:00-04:00,71.07001,71.44,69.99001,71.41,74213008,80586682.4,51.61127655366432,46.7505522079827,NaN,NaN,71.72783809154707,-3.537467056666381,0.48217328948223726,-0.8993639218866321,-1.3815372113688693,2393376160,2234114707.2,36.32245555255601,31.01811973787025,NaN,NaN,-8.19153933363764,-13.851500688166414
2011-09-16T09:30:00-04:00,71.64999,72.03,70.88,71.52,75773248,78840307.2,51.885194551386974,47.353161111399736,NaN,NaN,81.75904161658383,24.391702099481346,0.5495760650793873,-0.6945671300196352,-1.2441431950990225,2469149408,2316366556.8,46.46862817595458,32.59215924040513,NaN,NaN,-6.517716923342346,-12.803817293191548
2011-09-19T09:30:00-04:00,70.10001,71.00999,69.45,70.24001,69216192,77341216.8,48.448393746713805,47.19595019188042,NaN,NaN,29.03973740071921,42.27508560661679,0.49266977806577894,-0.6283059725167988,-1.1209757505825777,2399933216,2364753193.6,51.37684276568421,34.0518474873155,NaN,NaN,-5.992404845833693,-11.830758372140426
2011-09-20T09:30:00-04:00,70.49001,71.28999,69.11,69.14999,63453184,76903069.6,45.67385283343339,46.77954803173915,NaN,NaN,5.744417992088258,45.57087912284139,0.3718326479873246,-0.6561849405984219,-1.0280175885857465,2336480032,2383620393.6,53.17951902658496,35.266841678076176,NaN,NaN,-6.304586678944838,-11.041305273112485
2011-09-21T09:30:00-04:00,69.03999,69.63,66.53999,66.59,81435632,76310882.4,39.895266497189795,45.974718294030986,NaN,NaN,-100.77925602180862,17.498355815825953,0.12260185295384007,-0.8747652723934465,-0.9973671253472866,2255044400,2370796643.2,51.7744981766345,36.278870159473875,NaN,NaN,-8.310963669381035,-10.651256472579421
2011-09-22T09:30:00-04:00,64.3,65.92,63.49001,64.73,159808192,80916395.2,36.30159011320497,45.16519261783014,NaN,NaN,-194.77114623338713,-35.801441049160886,-0.149646221691758,-1.1844249024619842,-1.0347786807702262,2095236208,2311168652.8,45.72509192183893,36.76485295257246,NaN,NaN,-11.164916299637323,-10.724636447873406
2011-09-23T09:30:00-04:00,64.25,65.53,64.10001,65.14,84093744,81084438.4,37.635151652426906,44.82949702292476,NaN,NaN,-161.05453878706803,-84.36415712989125,-0.27684221646224283,-1.3808314513480298,-1.103989234885787,2179329952,2253204761.6,40.74166934186092,37.03774686712202,NaN,NaN,-13.11611819819339,-11.066276697919118
2011-09-26T09:30:00-04:00,65.84,66.48,64.28,66.37,75558688,80638732,41.586144816670746,44.80196831268359,NaN,NaN,-119.39763511109629,-114.05163163225436,-0.253493089724248,-1.420855597041097,-1.167362507316849,2254888640,2224195846.4,38.481289702309745,37.4216574705432,NaN,NaN,-13.650935383358023,-11.435513652981818
2011-09-27T09:30:00-04:00,67.85001,69.39,67.27,67.8,93999504,82684784.8,45.87901457541303,44.61888884775226,NaN,NaN,-32.19275032041894,-121.6390652947558,-0.12366790238322922,-1.3219473852958856,-1.1982794829126564,2348888144,2226677468.8,38.794131324058675,38.06365523244493,NaN,NaN,-12.855373013303858,-11.638350704456395
2011-09-28T09:30:00-04:00,67.78999,68.12,65.10001,65.2,85412560,83565334.4,40.10762044724308,44.220988004506374,NaN,NaN,-93.1144816800224,-120.10611042639854,-0.19081455490688515,-1.436797676546263,-1.2459831216393777,2263475584,2228363705.6,39.02104716468686,38.92890114962576,NaN,NaN,-13.92872704076506,-11.96554732392906
2011-09-29T09:30:00-04:00,66.73,67.02,64.37,66.33,73927120,83746000,43.43790916324259,44.34917379910966,NaN,NaN,-92.05850721820083,-99.56358262336128,-0.1394246111908548,-1.4202638856279464,-1.2808392744370916,2337402704,2276797004.8,45.294581339483244,40.43314297885222,NaN,NaN,-13.806354620123203,-12.228519794813938
2011-09-30T09:30:00-04:00,65.14999,66.17999,64.24001,64.3,72139312,83013528,39.21892161694691,44.066755392043035,NaN,NaN,-117.3649473161024,-90.82566432916816,-0.21777821192692426,-1.5530620393457468,-1.3352838274188226,2265263392,2293983692.8,47.36399837800584,42.13722515876058,NaN,NaN,-15.024606970452695,-12.627960819905189
2011-10-03T09:30:00-04:00,63.81,64.96001,60.85001,60.99001,119484944,85041616,33.50466277566183,43.16993339809342,NaN,NaN,-180.60297372639062,-103.06673205222701,-0.4545347384646541,-1.9034522504996403,-1.4489175120349862,2145778448,2272161654.4,45.034559091622654,43.481863852652836,NaN,NaN,-18.048230419281484,-13.402285048387517
2011-10-04T09:30:00-04:00,60.32001,64.88,60.09,64.78999,165084368,89720640.8,43.65457393089168,42.77425523386358,NaN,NaN,-127.13999458988715,-122.05618090612067,-0.3233863299519346,-1.8531504244749044,-1.5297640945229698,2310862816,2264556588.8,44.21835650427593,44.55690489039695,NaN,NaN,-17.113867013516845,-13.932511043405993
2011-10-05T09:30:00-04:00,64.78,66.13,63.92,65.67999,100370944,91291228.8,45.74346819037302,42.35512606505706,NaN,NaN,-60.459439408613015,-115.52517245183881,-0.1534883144351662,-1.7216244875669275,-1.5681361731317613,2411233760,2294108224,48.15075671102503,45.40178354457331,NaN,NaN,-15.674902556189691,-14.181424116660807
2011-10-06T09:30:00-04:00,65.50999,67.31,65.14999,67.14,85789680,92024512.8,49.07856849697962,42.15465277545654,NaN,NaN,-17.779577178325276,-100.66938644386369,0.06851740679936635,-1.4824894146325533,-1.5510068214319197,2497023440,2326032371.2,52.08080920335421,45.802653617958995,NaN,NaN,-13.398370836438927,-14.069559362343396
2011-10-07T09:30:00-04:00,67.38,67.61501,65.2,65.5,93662256,91734778.4,45.681750269143315,41.957035384201504,NaN,NaN,-28.368159718471905,-82.87002892433759,0.11355376068845024,-1.4090646205713568,-1.522618381259807,2403361184,2353651929.6,55.24171447193162,46.07871588269096,NaN,NaN,-12.617187875985566,-13.862077721435135
2011-10-10T09:30:00-04:00,66.97,68.38,65.5428,68.37,76366624,90547616,51.94936488743165,42.405286245201374,NaN,NaN,12.940054920613044,-44.16142319493686,0.33286711532936386,-1.1065344870981022,-1.439401602427466,2479727808,2420441801.6,61.80326929262545,46.69469804455099,NaN,NaN,-9.832641815375338,-13.28644402056945
2011-10-11T09:30:00-04:00,67.72,69.12,67.53999,68.84,63181440,89499488,52.90767764579757,43.334744184387645,NaN,NaN,47.04666053141467,-9.324092170676497,0.4959960846362377,-0.819406496632169,-1.3154025812684067,2542909248,2466851088,65.57927228569386,47.68075333805523,NaN,NaN,-7.332722784193732,-12.435912415372918
2011-10-12T09:30:00-04:00,69.37,70.53,68.8213,69.82001,88580000,90077532,54.926271536337126,44.66507857175422,NaN,NaN,86.76847062686807,20.121489836419727,0.6467754508763095,-0.5069332676730198,-1.1537087185493293,2631489248,2510902185.6,68.73831201580938,49.32455477333883,NaN,NaN,-4.659656421695947,-11.325018701990494
2011-10-13T09:30:00-04:00,69.42,70.12,68.58,69.75999,54163216,89075042.4,54.771424445924225,45.889098057004034,NaN,NaN,84.80916476227569,40.639238224539916,0.7140638046542257,-0.2611289627315472,-0.9751927673857729,2577326032,2526962704,69.82564012260148,51.40198125767745,NaN,NaN,-2.561295941094933,-10.073058307576844
2011-10-14T09:30:00-04:00,70.58,71.34,69.80521,71.14,69768496,88774804.8,57.72264498280243,47.041705211727724,NaN,NaN,130.4356991668421,72.40001000160274,0.8157660971930755,0.044514854105571544,-0.7712512430875039,2647094528,2575709372.8,72.90593583919699,53.8608845531694,NaN,NaN,0.10410721031510874,-8.619177519306565
2011-10-17T09:30:00-04:00,70.50999,70.62,68.63,68.98,57529888,88190489.6,52.00294921016056,47.47912911420969,NaN,NaN,88.51042153459868,87.51408332439985,0.7059325135693588,0.1111643988741946,-0.5947681146951642,2589564640,2597676739.2,74.18486497605467,56.38879409974054,NaN,NaN,0.7543724506295065,-7.28009895217284
2011-10-18T09:30:00-04:00,69.21001,71.28999,67.85001,70.81,98951120,89965386.4,55.982500414320796,48.6130491118581,NaN,NaN,107.5465744842786,99.61406611497264,0.722293514481402,0.3080987784065883,-0.4141947360748137,2688515760,2626798041.6,75.81469171333448,59.01691156750108,NaN,NaN,2.524712380511527,-5.879411618932216
2011-10-19T09:30:00-04:00,70.61,71.14999,69.07001,69.42999,71075440,89447376.8,52.450772329374956,49.25682505229612,NaN,NaN,94.10853897574937,101.0820797847489,0.6103915734262344,0.3487947307079793,-0.2615968427182551,2617440320,2623988256,75.32057704406141,61.16162554639952,NaN,NaN,2.9530902108716166,-4.617625643245955
2011-10-20T09:30:00-04:00,69.56,69.73,67.745,69.62,91000064,86006970.4,52.89144252730321,50.23343368875015,NaN,NaN,60.06678307220374,96.13360344673451,0.5227667925530625,0.391861647973073,-0.1309051445799895,2708440384,2650211126.4,76.83778854354613,63.266896272509534,NaN,NaN,3.426184699140443,-3.4685098800478977
2011-10-21T09:30:00-04:00,70.57001,71.16,70.02,71.13,60414448,84823005.6,56.35328239306421,51.86547794713603,NaN,NaN,104.56217230159078,90.95889807368424,0.5379990879592742,0.5415937153691033,0.0035946274098290487,2768854832,2674563187.2,78.17937447428221,65.63438308555665,NaN,NaN,4.840020951119209,-2.281576904166882
2011-10-24T09:30:00-04:00,71.45,73.58,71.1604,73.42,81405872,85115364.8,61.03038120278843,53.106607037985796,NaN,NaN,145.41571902844328,102.33995757245316,0.6654532730396309,0.8354112187093676,0.16995794566973677,2850260704,2726702400,80.75022885336682,68.24380253906314,NaN,NaN,7.518267572063911,-0.8815991218481976
2011-10-25T09:30:00-04:00,72.89,72.94,71.16,71.36,66772368,83754008,55.29063181471751,53.78854729686755,NaN,NaN,105.5851670362282,101.94767608284307,0.5774410652550384,0.8917592772385348,0.3143182119834964,2783488336,2745696915.2,81.60070079505383,70.63308425935091,NaN,NaN,8.071836413085405,0.3974630974280313
2011-10-26T09:30:00-04:00,72.60001,73.03999,70.53999,72.59,76643312,83315545.6,57.84020737956722,54.414378645623806,NaN,NaN,101.79143165164042,103.48425461802128,0.5676364510338041,1.0238637757757516,0.4562273247419475,2860131648,2794235180.8,83.5952500196943,72.88411574623235,NaN,NaN,9.311259650351083,1.6708626049884672
2011-10-27T09:30:00-04:00,75.28999,76.97,72.6516,76.42,129534256,86095902.4,64.60807540714563,55.76625901262397,NaN,NaN,169.81128767132284,125.43315553784512,0.7719969830370343,1.4212235535382405,0.6492265705012061,2989665904,2850480284.8,85.55002085624645,75.0489947736834,NaN,NaN,12.703548615214814,3.246960606449374
2011-10-28T09:30:00-04:00,76.3,76.92,75.75999,76.03,82397504,86608812,63.49040935706932,56.590619331883794,NaN,NaN,175.37827744792077,139.59637656711112,0.8288090842541974,1.685237925818953,0.8564288415647555,2907268400,2878162998.4,86.40844886164842,76.8065076000422,NaN,NaN,15.031900826382408,4.9305234950112355
2011-10-31T09:30:00-04:00,74.85001,75.44,73.92999,74.00999,66969184,83983024,57.903124073235055,56.94743693384362,NaN,NaN,121.98079160382163,134.9093910821868,0.6842500495661463,1.7117414035224385,1.0274913539562922,2840299216,2876170700.8,86.01241889040992,78.26601807180762,NaN,NaN,15.249553745040167,6.404670673586796
2011-11-01T09:30:00-04:00,71.17999,72.97,70.96001,71.39,110064880,81232049.6,51.5647686212657,56.70732958276709,NaN,NaN,41.44738051882168,122.08183377870549,0.3812046453608793,1.5039971606573914,1.1227925152965121,2730234336,2865519900.8,83.80118487965555,79.34193756208235,NaN,NaN,13.354681400693266,7.397529348887721
2011-11-02T09:30:00-04:00,72.62,73.3,71.83,73.14999,63839920,79405498.4,55.11889893463542,56.7321491891036,NaN,NaN,63.207216700084274,114.36499078839424,0.2733604446521878,1.4644930711117468,1.191132626459559,2794074256,2852308422.4,81.0188246586345,80.14145074322757,NaN,NaN,12.919786089432037,8.186423168965481
2011-11-03T09:30:00-04:00,74.27,75.2,72.28999,74.97,74629808,78847504.8,58.50944370741275,56.78834909800434,NaN,NaN,95.18147252971067,99.43902776007181,0.296725240258505,1.5620391767826902,1.2653139365241852,2868704064,2828116054.4,76.04010633432581,80.3653200643082,NaN,NaN,13.644776467548315,8.966187925905887
2011-11-04T09:30:00-04:00,74.17999,74.82001,73.55,74.60001,65262480,77427516,57.55750532397625,57.18510310613403,NaN,NaN,91.52656823405546,82.66868591729876,0.2606674910156428,1.5911483002937388,1.330480809278096,2803441584,2807350691.2,71.95290719185698,80.20589450829407,NaN,NaN,13.93154298908893,9.675524363503465
2011-11-07T09:30:00-05:00,74.5,74.87,72.89999,74.45,67142688,76966319.2,57.15150586420723,57.268603495411625,NaN,NaN,76.09963956090331,73.4924555087151,0.20269954441220417,1.5838552397933512,1.381155695381147,2736298896,2786550627.2,68.00957840921141,79.64838641514244,NaN,NaN,14.045237176015569,10.299769051005194
2011-11-08T09:30:00-05:00,75.14,75.64,73.46001,75.53999,72280880,77421291.2,59.392871744113855,57.76446773932155,NaN,NaN,93.12445999256204,83.82787140346318,0.21270939599294758,1.6470424403723314,1.4343330443793838,2808579776,2802219715.2,69.37135588405376,79.22344204657045,NaN,NaN,14.780980337118327,10.9399420918785
2011-11-09T09:30:00-05:00,73.32001,73.92,71.82001,71.94,78806320,76932607.2,50.07599691382893,57.56336448121624,NaN,NaN,8.592780028497163,72.90498406914575,-0.034986693125345525,1.390599677972702,1.4255863710980474,2729773456,2789359555.2,66.85591924219145,78.51045138218798,NaN,NaN,12.540242712326666,11.168556466228237
2011-11-10T09:30:00-05:00,73.12,73.23,71.63,72.47,72175056,77833199.2,51.287530183019534,57.20152503764162,NaN,NaN,-1.152888106604168,53.63811194188279,-0.16757717984909126,1.2161148962866832,1.3836920761357745,2801948512,2776008444.8,64.25114683678493,77.51557797950962,NaN,NaN,11.085149678935474,11.1566412109007
2011-11-11T09:30:00-05:00,73.34,74.53,72.5295,74.38,62457648,77467656.8,55.48047058344024,56.805102850545325,NaN,NaN,47.957548415690994,44.9243079782099,-0.13262077418992346,1.21791610839837,1.3505368825882935,2864406160,2788201360,65.57042516156174,76.43130628723782,NaN,NaN,11.096161247330564,11.148001216104966
2011-11-14T09:30:00-05:00,74.10001,74.27,72.77,73.31,61117264,77647025.6,52.741627442701216,56.62303110968702,NaN,NaN,27.158211216076804,35.136022309244595,-0.18435606346106925,1.120091803261957,1.3044478667230262,2803288896,2801599360,67.01107864037868,75.38919041904673,NaN,NaN,10.28301781911278,11.024432159391797
2011-11-15T09:30:00-05:00,72.92,74.64,72.42999,74.24001,65795248,75989232,54.82888645434026,56.40793675788509,NaN,NaN,35.03025808929395,23.517181928590976,-0.1596598276932033,1.104873082106522,1.2645329097997253,2869084144,2813700233.6,68.30120446182181,74.29675859348443,NaN,NaN,10.212975199189426,10.908509736505744
2011-11-16T09:30:00-05:00,73.47,74.88,72.91,73.03799,56938688,75282394.4,51.65343450431033,55.48260526482543,NaN,NaN,21.040484678565623,26.006722858604668,-0.22404968698915506,0.9844708010632814,1.2085204880524365,2812145456,2830174633.6,70.02018315109589,73.18748447168795,NaN,NaN,9.224414030723036,10.667924635679643
2011-11-17T09:30:00-05:00,72.95,73.44,71.27,72,78929120,74678847.2,49.013587425898315,54.44854655545607,NaN,NaN,-67.4833496812276,12.740630543679979,-0.32992289600987923,0.7961168680400874,1.1260397640499666,2733216336,2816428198.4,66.76666965859613,71.78450024289849,NaN,NaN,7.619569872555526,10.23244538380477
2011-11-18T09:30:00-05:00,72.25,72.47,71.45,71.98,53462880,74331268.8,48.961664727883225,53.809870887930934,NaN,NaN,-92.73424574066591,-15.397728287591402,-0.39052931180172257,0.6378781242978135,1.028407436099536,2679753456,2779497657.6,58.85460093920654,69.84465610352683,NaN,NaN,6.294270943274562,9.669849035157597
2011-11-21T09:30:00-05:00,70.53999,70.85001,69.61,70.25999,58236864,73172818.4,44.58709266752965,53.31146546266408,NaN,NaN,-172.34951323008264,-55.29927317682329,-0.5271868614671756,0.36942385926556653,0.8966107207327422,2621516592,2743143196.8,52.28600536447526,67.59357185244251,NaN,NaN,3.8628144061503553,8.840272659585134
2011-11-22T09:30:00-05:00,70.13,70.63,69.3,69.67,55412320,72604816,43.16252017016058,52.457438408058735,NaN,NaN,-172.24234602834883,-96.75379400035185,-0.6310311719564796,0.10782175578714259,0.7388529277436222,2566104272,2682547222.4,43.559409951813045,64.91789937338385,NaN,NaN,1.4152315788096432,7.779552505188635
2011-11-23T09:30:00-05:00,68.89999,69.09,67.37,67.48,69734192,72259360,38.274139842171394,51.012059560541495,NaN,NaN,-220.81038983761155,-145.12396890358727,-0.8095357420773555,-0.2730667498530721,0.5364689922242833,2496370080,2619392147.2,36.686844244596145,62.1069520812603,NaN,NaN,-2.2567473425980173,6.345795384076256
2011-11-25T09:30:00-05:00,67.05,68.03999,66.62,66.62,28167824,67191038.4,36.5247582079352,49.50972048082428,NaN,NaN,-214.07760328275097,-174.44281962389195,-0.9387558234092331,-0.6369757870372581,0.30178003637197504,2468202256,2566389331.2,32.108279885689186,59.260907273676885,NaN,NaN,-5.86814964747378,4.600946093854822
2011-11-28T09:30:00-05:00,69.09,69.92,68.91,69.78999,59167088,66029517.6,46.27280139113911,48.732670161319405,NaN,NaN,-104.41525134053316,-176.77902074386537,-0.7709872503570255,-0.6619540265743069,0.10903322378271862,2527369344,2535912508.8,29.804917280402393,56.53200290733339,NaN,NaN,-6.187742198504829,3.059704909232015
2011-11-29T09:30:00-05:00,69.84,70.17999,69.12,69.66,58160112,65589064,45.96109893841865,47.77325781805546,NaN,NaN,-87.44727713295924,-159.7985735244407,-0.6347064265337976,-0.6843498093845284,-0.04964338285073078,2469209232,2505451036.8,27.668451181073593,53.553223999977675,NaN,NaN,-6.535135655126914,1.6890134000378823
2011-11-30T09:30:00-05:00,72.56,73.78999,69.64861,73.73,93812000,64776420,55.96335183547103,48.193783169601325,NaN,NaN,12.984703392226008,-122.75316364032574,-0.2558254056948964,-0.36942513996935133,-0.1135997342744549,2563021232,2504834428.8,27.625283593119676,50.75103573932969,NaN,NaN,-3.52406510572312,0.944287899214882
2011-12-01T09:30:00-05:00,73.47,74.145,73.0605,73.2,57399712,64454409.6,54.547453894856915,48.426634863303995,NaN,NaN,51.05640156292698,-68.37980536021807,-0.037727026210498865,-0.16075851703757849,-0.12303149082707962,2505621520,2506684716.8,27.988353733907346,48.16083623198129,NaN,NaN,-1.5722670657594922,0.5847800470756856
2011-12-02T09:30:00-05:00,74.09,74.63,73.31,73.5,47677952,63106816.8,55.23780445369207,48.40930156832197,NaN,NaN,64.74217614048035,-12.615849475571803,0.12121747960000426,0.02849035867292571,-0.09272712092707855,2553299472,2523704160,31.397415238588906,45.71990695176895,NaN,NaN,0.20404234194709614,0.53038894634303
2011-12-05T09:30:00-05:00,74.94,75.39,74.13,74.75999,58434496,62765417.6,58.11519299867151,48.793127679462714,NaN,NaN,98.03389385910512,27.873979564355853,0.29574138968729247,0.27694961618203706,-0.01879177350525542,2611733968,2540577084.8,34.69798116213492,43.41182856046582,NaN,NaN,2.5830032032133183,0.8236195544673569
2011-12-06T09:30:00-05:00,74.81,75.28999,74.09,74.83,43602096,61588388,58.275685226635694,49.03932759176953,NaN,NaN,94.75955729232052,64.3153464494118,0.3942655387590085,0.4740401499435052,0.0797746111844967,2655336064,2577802451.2,41.39685985654413,41.490089660088834,NaN,NaN,4.5571380633140155,1.356979341445451
2011-12-07T09:30:00-05:00,74.28,75.06,73.13,74.67999,55914128,60770050.4,57.76493730217961,49.47586350590304,NaN,NaN,80.59140989857669,77.83668775068195,0.42504993798071994,0.6110870336603966,0.1860370956796767,2599421936,2585082592,42.63622341533973,39.53409253610625,NaN,NaN,6.053942693155957,2.0279741059755234
2011-12-08T09:30:00-05:00,73.89999,74.17999,72.22,72.36,71486624,60404065.6,50.406932362295684,49.57538814421714,NaN,NaN,29.67827704863515,73.56106284782358,0.2723107763390116,0.5264255661034412,0.2541147897644296,2527935312,2589545350.4,43.426069497310756,37.866906810300144,NaN,NaN,5.311114495668893,2.496994161646005
2011-12-09T09:30:00-05:00,72.5,74.97,72.38,74.53999,72184816,60404553.6,56.06951829868561,50.08309197070303,NaN,NaN,62.95311025343802,73.20324967041509,0.29910700091718334,0.6279985409109088,0.32889153999372545,2600120128,2598909481.6,45.133186424506135,36.88680577353583,NaN,NaN,6.36857812216142,3.0500775845767785
2011-12-12T09:30:00-05:00,73.49001,74.59621,72.5,73.47,47638576,59663600,52.87812879604868,50.67530883702582,NaN,NaN,48.16627041278404,63.229724981150866,0.22893996861615262,0.6150665007639162,0.3861265321477636,2552481552,2587058998.4,43.35042381795537,36.24854994878441,NaN,NaN,6.295412827230469,3.513696904955877
2011-12-13T09:30:00-05:00,74.23,74.47,71.55,71.94,79040256,60559749.6,48.616883830137716,51.064906241309906,NaN,NaN,19.061913568225734,48.090196236331906,0.07179795314141835,0.47587397357453654,0.4040760204331182,2473441296,2550680044.8,38.34332545198486,35.87597248451097,NaN,NaN,4.9281079716305145,3.7157556287665394
2011-12-14T09:30:00-05:00,71.25,71.8947,70.58,71.03999,77704880,61155231.2,46.2555113545208,51.63500420647772,NaN,NaN,-29.72644691285356,26.026624874045854,-0.09157980471508864,0.2896012645392574,0.381181069254346,2395736416,2509942940.8,33.65548084098947,35.65944652711049,NaN,NaN,3.074761077894253,3.624184978641927
2011-12-15T09:30:00-05:00,72.06,72.11,71.03999,71.7,50096000,60813096.8,48.2409282853285,52.47187349772009,NaN,NaN,-10.27983940360061,18.035001583598703,-0.15053591224581736,0.1930111789470743,0.3435470911928917,2445832416,2493522361.6,31.959331374740117,35.64880734775698,NaN,NaN,2.109029004134858,3.4077341251409172
2011-12-16T09:30:00-05:00,72.28,73.28,71.73,72.25999,66230368,60178159.2,49.9309849777185,52.733172325332895,NaN,NaN,19.186007571222397,9.2815810471556,-0.1469919166995305,0.15980719531847853,0.306799112018009,2512062784,2475910892.8,30.201303345564156,35.67712063812568,NaN,NaN,1.7806534633517155,3.175294030599603
2011-12-19T09:30:00-05:00,72.92999,73.2,70.83,71.00999,52897504,60149890.4,46.29700821282745,52.757165844933525,NaN,NaN,-7.675575706802533,-1.8867881767617092,-0.21963415849727153,0.032256413896419645,0.25189057239369117,2459165280,2457247638.4,28.417331928081197,35.73061212005479,NaN,NaN,0.4466647357917009,2.7854898456270454
2011-12-20T09:30:00-05:00,72.55,73.97,72.50999,73.86,74174320,60946763.2,54.43893088703307,52.64827863433082,NaN,NaN,52.34973118182706,4.7707753459585565,-0.07406678103519662,0.1593070960996954,0.23337387713489202,2533339600,2469227299.2,31.225552057742377,35.987774153242135,NaN,NaN,1.754109648281634,2.6381498174348437
2011-12-21T09:30:00-05:00,73.53,74.39,72.73,74.161,59204288,61136361.6,55.211259522461155,52.69569332201684,NaN,NaN,59.55196822418793,22.62645837336686,0.038136225819143804,0.28104415940882177,0.24290793358967797,2592543888,2508588793.6,39.60873822231782,36.817801616700024,NaN,NaN,3.0399646714010418,2.6955519394300147
2011-12-22T09:30:00-05:00,74.16,74.67,73.98,74.27,41507200,59725012,55.50540365374365,52.71480755059195,NaN,NaN,78.0490568011636,40.29223761431969,0.11120531290005098,0.38191457471474166,0.2707092618146907,2634051088,2546232528,46.34471124931756,37.88546561746635,NaN,NaN,4.1688808283333625,2.9060274949876357
2011-12-23T09:30:00-05:00,74.55,74.67999,74.0799,74.55,24337376,59533489.6,56.299357715726366,52.58510503038159,NaN,NaN,81.78629569577126,52.81229523922946,0.16657497604144017,0.4789279818664909,0.3123530058250507,2658388464,2575497664,50.92727910086902,39.044701184518786,NaN,NaN,5.3281980121255925,3.2520518545787724
2011-12-27T09:30:00-05:00,74.25999,75.16,74.08,74.77,26926592,57921464.8,56.94936319344034,52.49036774229621,NaN,NaN,90.34200133782718,72.41581064815541,0.2037396960223602,0.5670276258530009,0.36328792983064073,2685315056,2620727619.2,57.03490512623101,40.161704418067856,NaN,NaN,6.475444544003228,3.7125365244965516
2011-12-28T09:30:00-05:00,74.88,74.89999,73.27,73.41,37827472,56904832.8,51.81823651888261,52.065603400632135,NaN,NaN,34.84810835399608,68.91548608258921,0.12624940147402974,0.5210996816731779,0.39485028019914814,2647487584,2643557216,59.757447129803325,41.384648969100965,NaN,NaN,6.104714095866734,4.0542761775494345
2011-12-29T09:30:00-05:00,73.73,74.44,73.60001,74.14999,27096240,53569044.8,54.23444404413971,52.338997092192415,NaN,NaN,46.19850785103477,66.24479400795857,0.11468644225923519,0.5382083330231922,0.42352189076395697,2674583824,2659965203.2,61.63889286572651,42.685564923987805,NaN,NaN,6.446168077552204,4.395975020406973
2011-12-30T09:30:00-05:00,74.12,74.52,73.69,73.75,31988176,52298468,52.69615331889477,52.098042450778784,NaN,NaN,37.341540079867976,58.103290663699454,0.07203935503624226,0.5135710845592598,0.44153172952301756,2642595648,2661674115.2,61.83900569394009,43.878837728947374,NaN,NaN,6.3226309886959795,4.671211587305402
2012-01-03T09:30:00-05:00,75.67999,75.87,74.77,74.97501,60508752,52940008,56.74281303555281,52.37409132502908,NaN,NaN,118.79427395178827,65.50488631490285,0.11568448080205646,0.5861373305255881,0.4704528497235317,2703104400,2670617302.4,62.92888096474413,45.277298953718,NaN,NaN,7.334939859387362,5.051744197602825
2012-01-04T09:30:00-05:00,74.58,74.86,74.07001,74.56,34653152,51750940.8,55.0254295583693,52.83184459133133,NaN,NaN,68.96723779100388,61.22993360553819,0.10620203095192882,0.6032053884134427,0.4970033574615139,2668451248,2667244540.8,62.207314113442614,46.98186957239356,NaN,NaN,7.72681710845618,5.433897470581876
2012-01-05T09:30:00-05:00,74.03,75.34,73.37,74.98,57274912,52434581.6,56.46159459375611,53.560850536991,NaN,NaN,75.09171050739285,69.27865403621755,0.11696366320145024,0.6432079364633267,0.5262442732618765,2725726160,2682892256,64.25512710311574,49.167558591116865,NaN,NaN,8.445959574259556,5.864192056821544
2012-01-06T09:30:00-05:00,75.02,75.38,74.27,74.795,45500672,51913908.8,55.61909755212838,54.0878626274767,NaN,NaN,89.72710786212554,77.98437403843569,0.10097348091525538,0.6524611244059457,0.5514876434906903,2680225488,2684020588.8,64.40490360128746,51.48509946444168,NaN,NaN,8.836343544434573,6.2887851264805485
2012-01-09T09:30:00-05:00,75.14,75.30099,74.41,75.17,52045200,50941837.6,57.01911928749758,54.59415793531806,NaN,NaN,92.30567874565243,88.97720177159258,0.10456176407487694,0.6821898485842866,0.5776280845094096,2732270688,2701955596.8,66.78714194063994,54.09837364980423,NaN,NaN,9.53389447265282,6.75237217593373
2012-01-10T09:30:00-05:00,76.16,76.42999,75.96001,76.27,42977520,49481472.8,60.914096371451464,55.638235660934065,NaN,NaN,160.69795408870806,97.35793779897655,0.16626283520226104,0.785456628512236,0.6191937933099749,2775248208,2716384358.4,68.6074060477906,56.969093229783475,NaN,NaN,11.21921874703663,7.390493114662716
2012-01-11T09:30:00-05:00,75.95,76.67,75.87,76.57001,33452288,48772158.4,61.927468784063706,56.17313122500769,NaN,NaN,149.3194930051154,113.42838884179885,0.2097209643809267,0.8813449987861333,0.6716240344052066,2808700496,2744434208,71.83863692627318,59.87002786324996,NaN,NaN,12.926918517737661,8.181411029387709
2012-01-12T09:30:00-05:00,76.78999,76.92,75.94,76.8,36132208,46626756,62.72531791080774,56.70984968131815,NaN,NaN,144.69553487072736,127.34915371446576,0.2345201147074183,0.9647741777894794,0.7302540630820611,2844832704,2768255516.8,74.26157605282921,62.34523056542935,NaN,NaN,14.594604804195788,9.097581568646007
2012-01-13T09:30:00-05:00,76.17999,76.48,75.60001,76.39,42602832,44871653.6,60.299370469462545,57.05227588244093,NaN,NaN,115.33724403347446,132.47118094873554,0.20494698068847284,0.9864377889426521,0.7814908082541793,2802229872,2792656393.6,76.49266424752389,64.49865577958694,NaN,NaN,15.429883465218849,10.00219612529927
2012-01-17T09:30:00-05:00,77.10001,77.27,76.13,76.36,34521392,44092923.2,60.116159351515165,57.32490457071156,NaN,NaN,132.0984582698724,140.42973685357953,0.1666282213857675,0.9897760849863886,0.8231478636006211,2767708480,2799743952,77.11324028200978,66.36908157823986,NaN,NaN,16.093870431421117,10.872435311888104
2012-01-18T09:30:00-05:00,76.32001,77.73,76.14999,77.72,49330704,43247940,65.26809043841563,57.919099373924084,NaN,NaN,150.76169117261344,138.44248427036058,0.2131633795521024,1.089602088040749,0.8764387084886467,2817039184,2808102147.2,77.8556688907695,67.8562789899926,NaN,NaN,18.120609211321565,11.907888726092883
2012-01-19T09:30:00-05:00,78.13,78.36,77.66,78.2,35832496,42394689.6,66.8935376188623,58.995906595351194,NaN,NaN,177.00524058136605,143.97963378561073,0.25379849278763444,1.1936868244731897,0.9398883316855553,2852871680,2816936384,78.64421507933749,69.20533384353075,NaN,NaN,20.320834226512286,13.109738083295655
2012-01-20T09:30:00-05:00,78.10001,78.50999,77.89999,78.25,42225392,40797243.2,67.06643816039866,59.91247760365541,NaN,NaN,155.54622642728876,146.14977209692302,0.26058535883643974,1.265620030231105,1.0050346713946652,2895097072,2826989257.6,79.53718300478134,70.48378313917753,NaN,NaN,22.21263731523467,14.410152259286942
2012-01-23T09:30:00-05:00,78.25999,78.84,77.55,78.14999,37482336,39711145.6,66.32035281199649,60.88563471030553,NaN,NaN,132.54568748742068,149.59146078771226,0.23563380607199869,1.2995769289846635,1.0639431229126648,2857614736,2838066230.4,80.50450303859704,71.81703294951016,NaN,NaN,23.637170832829394,15.728297769793006
2012-01-24T09:30:00-05:00,77.67999,78.75,77.27,78.60001,49860320,40128801.6,68.04309787282145,61.69279791296758,NaN,NaN,118.08387547927627,146.78854422959301,0.22666180141894499,1.347270374686346,1.120608573267401,2907475056,2866019545.6,82.72395615486707,73.23096689166182,NaN,NaN,25.341988451553952,17.101682152901713
2012-01-25T09:30:00-05:00,78.60001,79.57001,78.19,79.27,68272880,42325576.8,70.4652837703861,62.79564464239735,NaN,NaN,139.92417996134643,144.62104198733962,0.2416971586718457,1.422730021607208,1.1810328629353624,2975747936,2897761296,84.83516667168205,74.84724207439321,NaN,NaN,27.523119452020932,18.590458909918745
2012-01-26T09:30:00-05:00,79.86,79.91,78.75,79.17999,52758608,43617177.6,69.70094029957598,63.741312192813055,NaN,NaN,135.34779402181394,136.2895526754292,0.22193938577919847,1.4584570951593605,1.236517709380162,2922989328,2911784825.6,85.66844793279927,76.37676499079917,NaN,NaN,29.1797138331792,20.103209613241667
2012-01-27T09:30:00-05:00,78.8,79.78,78.77,79.72,52205344,44336071.2,71.68530275322327,64.88889827860555,NaN,NaN,126.66141585273598,130.51259056051865,0.22111024787397238,1.5129055192226275,1.2917952713486551,2975194672,2927804345.6,86.57588494001122,77.96040651499372,NaN,NaN,31.18249621948939,21.685964842705626
2012-01-30T09:30:00-05:00,79.08,79.42999,78.52,79.10001,46332320,45297875.2,66.31531548359173,65.55291229261228,NaN,NaN,96.23629246624165,123.25071155628284,0.15765623143993746,1.488865560648577,1.3312093292086395,2928862352,2942053868.8,87.34354818604271,79.42872124680821,NaN,NaN,31.52960947703004,23.092199790466257
2012-01-31T09:30:00-05:00,79.66,79.82001,78.58,79.02,52026656,46299799.2,65.63202837369319,65.88990743562954,NaN,NaN,91.92700558871451,118.01933757817048,0.0923774504500392,1.4466811422711885,1.3543036918211493,2876835696,2935925996.8,85.0900465427747,80.60605271073564,NaN,NaN,31.64299378859816,24.313741790199387
2012-02-01T09:30:00-05:00,79.75999,80.89999,79.47,80.72,67292192,46638971.2,72.1889025404785,66.62286698965917,NaN,NaN,129.99610536153057,116.03372265820732,0.14276249683213837,1.5327568128613223,1.3899943160291839,2944127888,2929601987.2,82.7181519208804,81.38316092463616,NaN,NaN,33.70197137114357,25.654917444619986
2012-02-02T09:30:00-05:00,81.03999,81.53,80.74001,81.17999,46407024,47226664.8,73.65360144825777,67.4034586709056,NaN,NaN,148.1054196227597,118.58524777839648,0.18354219612289535,1.619422061182803,1.4358798650599076,2990534912,2943111104,83.75958838772972,82.06159037712905,NaN,NaN,35.87642809040171,27.115133251160234
2012-02-03T09:30:00-05:00,82.47,83.2229,82.242,82.95,72740944,47999966.4,78.37346270263464,68.69446525898931,NaN,NaN,198.54669995490673,132.96230459883063,0.2993477968839062,1.8100646111647904,1.5107168142808842,3063275856,2960727340.8,85.02674336107222,82.6711674566682,NaN,NaN,39.50322851662583,28.884861146226747
2012-02-06T09:30:00-05:00,82.57001,82.92999,82.37,82.67999,34520176,47450941.6,76.1328395699146,69.83851384601785,NaN,NaN,168.5359556161605,147.4222372288144,0.325235873519397,1.9172616561801306,1.5920257826607336,3028755680,2980706006.4,86.32947761408624,83.3294701232451,NaN,NaN,41.69562639535403,30.714970467530645
2012-02-07T09:30:00-05:00,82.605,82.99001,82.08,82.63,41623664,46929864.8,75.70132918064328,70.58374518474838,NaN,NaN,146.91534358512854,158.4199048280972,0.30670817631864256,1.9754110030590368,1.6687028267403943,2987132016,3002765270.4,87.61115736828326,84.0262907287818,NaN,NaN,43.31792956045856,32.515393195091775
2012-02-08T09:30:00-05:00,82.8,83.21001,81.92999,82.81,46707152,47116346.4,76.2238867473148,71.25019869392356,NaN,NaN,132.51939802379232,158.92456336054957,0.27529115958361006,2.012816776219907,1.737525616636297,3033839168,3020707526.4,88.55135512763087,84.73394358937419,NaN,NaN,44.80479838219943,34.271022507535726
2012-02-09T09:30:00-05:00,83.02,83.03,81.84,82.39999,48716704,47879567.2,72.40424793683869,71.63147082081214,NaN,NaN,107.48533541068895,150.8005465181354,0.1991617949360891,1.9864778603064082,1.787316065370319,2985122464,3019625036.8,88.11686602832339,85.34677809105575,NaN,NaN,44.9813650229341,35.80107143830692
2012-02-10T09:30:00-05:00,81.5,81.67,81.08,81.27,42506848,48198299.2,63.02987010320575,71.3964363416128,NaN,NaN,59.318988311755554,122.95500418950516,0.0525970523193795,1.8530623807695434,1.800465328450164,2942615616,2995492988.8,78.8307431639442,85.22722381429485,NaN,NaN,42.2580254215639,36.72349343591506
2012-02-13T09:30:00-05:00,82.11,82.429,81.61,82.32001,38574000,47996857.6,67.27042155445272,71.34124517601502,NaN,NaN,78.21043365331246,104.88989979693557,0.008570573147319793,1.8111785448843136,1.8026079717369938,2981189616,2985979776,75.45491277209116,84.70800642981087,NaN,NaN,41.161373273458565,37.35747626984985
2012-02-14T09:30:00-05:00,81.91,82.12,81.36,81.95,49376896,48739632.8,64.46436896556575,70.91260840424215,NaN,NaN,59.683395841122305,87.4435102481343,-0.05952086124960143,1.728206895174992,1.7877277564245935,2931812720,2974915916.8,71.61389425690258,83.76362982875517,NaN,NaN,39.38662569608525,37.647354759312044
2012-02-15T09:30:00-05:00,82.42,82.42999,81,81.27,59836592,49264927.2,59.548266622110276,70.18741742728032,NaN,NaN,44.18892568655284,69.77741578068643,-0.15877345538319143,1.5892609371956041,1.7480343925787956,2871976128,2942543308.8,61.71463348358819,82.05264308238296,NaN,NaN,36.32973418625458,37.459123248875265
2012-02-16T09:30:00-05:00,81.32001,82.89999,81.28,82.8,61459520,50546278.4,65.85734191215808,69.77113451006137,NaN,NaN,69.0702411066316,62.09439691987495,-0.13095536189769685,1.5843401902066745,1.7152955521043713,2933435648,2932205945.6,58.914095551853144,80.07680098322882,NaN,NaN,35.62011664472241,37.196408019710574
2012-02-17T09:30:00-05:00,83.28999,83.31,82.63,82.78999,33298976,50099957.6,65.78505109724725,69.73325848246533,NaN,NaN,87.46463487395627,67.7235262323151,-0.12293146030512436,1.561631226722966,1.6845626870280903,2900136672,2923710156.8,56.63926259592492,77.88363772679182,NaN,NaN,35.044944919786914,36.88905614829291
2012-02-21T09:30:00-05:00,82.92,83.03999,81.83,82.23,39889936,50220337.6,61.704431108552185,69.45271582066955,NaN,NaN,59.03327908310558,63.88809531827371,-0.1625530539760911,1.4813713695579764,1.6439244235340675,2860246736,2899521580.8,50.64348940758004,75.4231693599922,NaN,NaN,33.29475584461545,36.37558467633899
2012-02-22T09:30:00-05:00,81.97,82.36,81.5,81.58,42626848,49858664,57.264253824453824,68.38666948381064,NaN,NaN,26.512166565224344,57.25384946309413,-0.23533462824892193,1.349756138222915,1.585090766471837,2817619888,2876683014.4,45.72200521099842,72.78058745214348,NaN,NaN,30.425126910057603,35.52551928115594
2012-02-23T09:30:00-05:00,81.71001,82.85001,81.25999,82.8,53186480,49104344,62.69088235256038,67.60361811983225,NaN,NaN,49.48721492959582,58.31350731170272,-0.20520949899806795,1.3285788927242521,1.53378839172232,2870806368,2876449062.4,45.67304142260609,70.06011981177751,NaN,NaN,29.61689710229273,34.681430398461195
2012-02-24T09:30:00-05:00,82.83,83.03,82.47,82.64,37608592,48346843.2,61.586375828106554,66.40454048593739,NaN,NaN,71.37181809964008,58.77382271030442,-0.19976431277801376,1.2840830007498027,1.4838473135278165,2833197776,2856401488,41.5653230642277,66.9557326477172,NaN,NaN,28.631304217996274,33.81712665839478
2012-02-27T09:30:00-05:00,81.84,82.95,81.25,82.5,51811952,48327173.6,60.58062502199453,65.29366801822881,NaN,NaN,33.64429319798425,48.00975437511001,-0.20834182582576544,1.2234200312456096,1.431761857071375,2781385824,2832651318.4,37.28687488251365,63.452689595462004,NaN,NaN,27.53549303902318,32.91975042705598
2012-02-28T09:30:00-05:00,82.55,83.06,81.84151,82.28,47687248,48394920,58.95140685639992,64.09724499506856,NaN,NaN,40.928215807939395,44.38874172007677,-0.22988940764326715,1.1444000975172912,1.3742895051605584,2733698576,2807341686.4,33.34754149938041,59.57671703339752,NaN,NaN,26.160105768642744,31.95408690442552
2012-02-29T09:30:00-05:00,82.55,82.96001,80.97,81.05,64219920,49004583.2,50.7360039626209,62.27668193901901,NaN,NaN,-59.14802136601248,27.256704133829412,-0.3223686934430563,0.9713286383567379,1.2936973317997942,2669478656,2777713440,29.428023639359353,55.35362192709241,NaN,NaN,22.35434475001604,30.582695168081308
2012-03-01T09:30:00-05:00,81.38,82.37,81.36,81.47,69526432,49116295.2,53.13753752677663,60.90048833830029,NaN,NaN,-70.0462327642298,3.350014595064289,-0.34842479138710836,0.8581663425659087,1.206591133953017,2739005088,2751353184,26.449416162869014,50.948804079559956,NaN,NaN,19.89568598294565,29.055979570204787
2012-03-02T09:30:00-05:00,81.42,81.64,79.84,80.25,70789872,50335437.6,46.10654231700069,59.69167921071421,NaN,NaN,-229.35828519905562,-56.79600606467485,-0.4353490563865805,0.6624048134697915,1.097753869856372,2668215216,2718356672,23.27383495766503,46.98045349339714,NaN,NaN,15.414003312880013,27.10712581915839
2012-03-05T09:30:00-05:00,79.99001,80.3999,79.42,80.34,44334736,48915127.2,46.66717361519421,58.22001864362432,NaN,NaN,-235.807868765478,-110.6864384573673,-0.47127420751453086,0.5086611104632084,0.9799353179777393,2712549952,2704589497.6,22.08254437591809,43.16814146509906,NaN,NaN,12.009456955330187,24.95031598146865
2012-03-06T09:30:00-05:00,79.42,79.62,78.41,78.74001,80771248,51227680.8,38.9165735286365,56.395176112415086,NaN,NaN,-278.6215922921617,-174.5964000773875,-0.5801279307265345,0.25477540456957115,0.8349033352961056,2631778704,2684205523.2,20.416240283284168,39.511166181269175,NaN,NaN,6.257122751351949,22.279859805737694
2012-03-07T09:30:00-05:00,78.91,79.56,78.78,79.48,57457904,52019392.8,43.58342335132494,55.254830164501854,NaN,NaN,-193.4378159510153,-201.4543589943881,-0.5783312921345565,0.11198922012791002,0.6903205122624665,2689236608,2688157113.6,21.650507172134354,36.64944287330818,NaN,NaN,3.0005870852343217,19.525677988522926
2012-03-08T09:30:00-05:00,80,80.69,79.35001,80.5101,43803088,51874189.6,49.38106847324021,54.07795349029343,NaN,NaN,-101.71034087650195,-207.78718061684248,-0.48744305673207544,0.08101669134737222,0.5684597480794477,2733039696,2686964035.2,21.541877138104383,33.97999870089755,NaN,NaN,2.1671220549775367,17.04588428373073
2012-03-09T09:30:00-05:00,80.52,82.14999,80.46001,81.60001,61462816,52511495.2,54.68702195179866,53.28523712276138,NaN,NaN,-6.312604810053315,-163.17804453904205,-0.34055053012649494,0.14277158542132895,0.4833221155478239,2794502512,2712221494.4,29.59543895789028,32.048297012466506,NaN,NaN,3.2795501733855925,15.079265125109995
2012-03-12T09:30:00-04:00,81.74001,81.92999,81.05,81.44,34086064,52090456,53.79548880752644,52.72031267268812,NaN,NaN,-1.4423685860620883,-116.30494450315886,-0.2452467385658017,0.17676369234057177,0.42201043090637347,2760416448,2721794793.6,32.42671222962993,30.74709864261293,NaN,NaN,3.8674427104071727,13.477576208723878
2012-03-13T09:30:00-04:00,82.06,83.09,81.4046,83.06,60998080,53211660,60.768777342828216,52.97063578114343,NaN,NaN,77.1592923684072,-45.148767571045084,-0.073118702229446,0.330612053119566,0.403730755349012,2821414528,2759721958.4,42.32270380639195,30.504291399426755,NaN,NaN,6.804250933671983,12.524244026573607
2012-03-14T09:30:00-04:00,82.96001,83.23,82.00999,82.38,46708544,53078242.4,56.88771744476864,52.556124002015444,NaN,NaN,73.86183418941451,8.311162457040876,-0.00847592816133641,0.39313584514734146,0.40161177330867787,2774705984,2776815833.6,46.15043391794066,30.538390863379224,NaN,NaN,7.904037605170054,11.86421453780167
2012-03-15T09:30:00-04:00,82.25,83.12,82.03,83.07001,58742400,53023532.8,59.7002850886539,52.42140323491168,NaN,NaN,80.68671634677696,44.79057390169665,0.07285864078043758,0.4926850742842248,0.41982643350378723,2833448384,2796897571.2,50.32152889939533,31.16383413731977,NaN,NaN,9.735527797957714,11.560116432109677
2012-03-16T09:30:00-04:00,83.22,83.27071,82.64999,83,42046096,52052861.6,59.27773042146978,52.3283393348742,NaN,NaN,92.77194525761732,64.60748391523079,0.11172285043746716,0.5594799965506212,0.44775714611315404,2791402288,2796277526.4,50.192254942078726,32.08564699871728,NaN,NaN,11.04811518611641,11.486973396967782
2012-03-19T09:30:00-04:00,82.89,84.39,82.75,83.7,66828496,53729337.6,62.161515420225,52.557632803718846,NaN,NaN,131.24213772939163,91.14438517832151,0.1708157359330078,0.6612768160294138,0.490461080096406,2858230784,2815840393.6,54.19081735595525,33.57445241704405,NaN,NaN,13.053472313394302,11.710758956457285
2012-03-20T09:30:00-04:00,83.12,83.3,82.58,82.951,43830064,53926344,57.471723380554735,53.03875561928555,NaN,NaN,82.03743413137282,92.12001353091463,0.1466286983590548,0.6737469530452245,0.5271182546861697,2814400720,2814437632,53.8569417167362,35.319375136856685,NaN,NaN,13.326553596533836,11.941586762182506
2012-03-21T09:30:00-04:00,83.2,83.42999,82.64,82.92999,40504704,53820236.8,57.341038164151115,53.339005664812305,NaN,NaN,77.94169813103949,92.93598631923963,0.11763576750130578,0.674162964062802,0.5565271965614962,2773896016,2814275638.4,53.81570664543749,37.27411017132586,NaN,NaN,13.50747886195148,12.165285633578074
2012-03-22T09:30:00-04:00,82.09,82.46001,81.62,82.13,60103808,54166103.2,52.4504133672518,53.792139311258815,NaN,NaN,20.29772019134531,80.8581870881533,0.037169653712914474,0.6029892637026393,0.5658196099897248,2713792208,2790344403.2,47.9722828006822,39.03828501725565,NaN,NaN,12.220147630311185,12.173123061682805
2012-03-23T09:30:00-04:00,82,82.78999,81.25,82.67999,46465184,54608932.8,55.27468901381949,54.40696183973205,NaN,NaN,33.27567327881447,68.95893269239275,0.01472716535469587,0.5842285666830946,0.5695014013283988,2760257392,2784115424,46.55530208730267,40.78633913949741,NaN,NaN,11.954511393559814,12.141892823379521
2012-03-26T09:30:00-04:00,83.74001,84.46001,83.62,84.39999,56454000,54841035.2,62.730175970032604,56.10793344268892,NaN,NaN,139.91082805211354,70.69267075693713,0.10446297229035229,0.7000801166913391,0.5956171444009868,2816711392,2775811545.6,44.661411933360974,42.5181371145029,NaN,NaN,14.128727140191142,12.425726297209753
2012-03-27T09:30:00-04:00,84.42,84.66,83.75,83.81,41730624,54543204,59.091459239156464,57.215650291819735,NaN,NaN,121.44734684497011,78.5746532996566,0.11214960469382285,0.7358041502682653,0.6236545455744424,2774980768,2767927555.2,42.87792793749968,44.03438145488614,NaN,NaN,14.767554448277597,12.760273175933731
2012-03-28T09:30:00-04:00,83.8,84.02,82.60989,83.32001,48841264,53774271.2,56.177002879874145,57.70107417800788,NaN,NaN,71.8602248280713,77.35835863906296,0.07413261283216754,0.7163203116146519,0.6421876987824844,2726139504,2758376252.8,40.754611521805494,45.4067196251505,NaN,NaN,14.390781642671104,12.993202956896214
2012-03-29T09:30:00-04:00,82.73,83.22,82.015,83.08,45625056,52579202.4,54.752499144513244,57.70575112034463,NaN,NaN,39.179442513927334,81.13470310357937,0.025246564621973056,0.6737459045599508,0.6484993399379777,2680514448,2751720700.8,39.29439355800693,46.0995020965874,NaN,NaN,13.660061140388976,13.088468411680894
2012-03-30T09:30:00-04:00,83.59,83.60001,82.53,82.81,45904624,51334940,53.12062262175774,57.65754639278972,NaN,NaN,46.35193392621395,83.74995523305925,-0.029860743876855778,0.611173410091908,0.6410341539687637,2634609824,2726591187.2,34.29762070541838,46.23313841628658,NaN,NaN,12.583982621904191,13.016399013141365
2012-04-02T09:30:00-04:00,82.53999,83.86,82.38,83.83,52757312,51756068.8,58.19031214835142,57.47337030746995,NaN,NaN,63.94874628970974,68.55753888057849,-0.00358575662645777,0.6365519581856915,0.6401377148121493,2687367136,2700722336,30.059968745842625,45.35722876910448,NaN,NaN,13.141968655541234,13.034337533484203
2012-04-03T09:30:00-04:00,83.66,84,82.92999,83.27,52014400,50318226.4,54.693231476323355,57.31662130972386,NaN,NaN,64.93809221058639,57.25568795370175,-0.028503037453760594,0.6045089179949485,0.6330119554487091,2635352736,2672796729.6,26.284497829309544,43.93823333420226,NaN,NaN,12.57127969781202,12.968186414102464
2012-04-04T09:30:00-04:00,82.37,82.42999,81.45,81.94,65172336,50703948,47.406378005686534,56.4384850895119,NaN,NaN,-69.83534963185943,28.916573061715603,-0.13327507206997846,0.4664181153612361,0.5996931874312146,2570180400,2641604908.8,22.834651223705265,41.974884928795824,NaN,NaN,9.733580406876124,12.506099841641557
2012-04-05T09:30:00-04:00,81.60001,82,81.42,81.58,31978688,50112728,45.63410142300619,55.46394016105022,NaN,NaN,-116.71094089256634,-2.261503619583132,-0.2203993013841119,0.3241940607010747,0.5445933620851866,2538201712,2613142361.6,20.225937186605194,39.83443366054771,NaN,NaN,6.871439956732679,11.701148429511717
2012-04-09T09:30:00-04:00,80.09,80.57001,79.85001,80.24001,50063152,49542744.8,39.68674525904357,53.85859943525154,NaN,NaN,-238.53954153837824,-59.23979871250158,-0.35393336993772023,0.1021766496630363,0.45611001960075653,2488138560,2583848108.8,17.95265140713373,37.24599323563189,NaN,NaN,2.3678428413118713,10.367819059768882
2012-04-10T09:30:00-04:00,79.9202,80.16,78.14,78.35001,101231184,52900000.8,33.12858202792536,52.11980362434944,NaN,NaN,-289.7018541122993,-129.96991879290337,-0.5438498176233674,-0.22370225242845265,0.3201475651949147,2386907376,2523756156.8,14.38176431543772,34.426337706967715,NaN,NaN,-4.042810584461732,8.309157682021652
2012-04-11T09:30:00-04:00,79.00999,79.57001,78.8499,79.46001,54348816,52567537.6,39.45635857682076,50.8423265109687,NaN,NaN,-196.88277356454878,-182.3340919479304,-0.5664573790341815,-0.38792415859781215,0.17853322043636935,2441256192,2484936848,12.633569725755592,31.48475649841901,NaN,NaN,-7.124853347980562,6.104298963449908
2012-04-12T09:30:00-04:00,79.53999,80.91,79.44,80.60001,60728672,53268544,45.192467724400714,50.323901822193626,NaN,NaN,-112.37861096176456,-190.84274421391143,-0.4798082452494142,-0.4212270861253984,0.058581159124015805,2501984864,2471297740.8,12.078052726039175,28.920882921658794,NaN,NaN,-7.656896069927412,4.13841395868172
2012-04-13T09:30:00-04:00,80.38,80.41,79.42999,79.54201,53965760,53029712,41.2832632515289,49.32451426774429,NaN,NaN,-120.65716926156675,-191.63198988771154,-0.4683990673689538,-0.5269176750871765,-0.05851860771822266,2448019104,2453261219.2,11.366280298332313,26.407381365303767,NaN,NaN,-9.447360101512608,2.1975890929396726
2012-04-16T09:30:00-04:00,79.89,80.2,78.88,79.67,44729248,53163869.6,41.937586676189774,47.839329318184085,NaN,NaN,-112.95665775028311,-166.5154131300925,-0.4279922368333623,-0.5935089037599255,-0.16551666692656322,2492748352,2454183177.6,11.652882713179494,24.04962927814794,NaN,NaN,-10.618250323338172,0.36675489061426636
2012-04-17T09:30:00-04:00,80.33,81.55,80.27,80.82001,46737776,52159333.6,47.5890727466289,47.01773028300355,NaN,NaN,-45.541594353550934,-117.68336117834284,-0.3053300225606455,-0.5471791951273701,-0.2418491725667246,2539486128,2484698928,20.78338297250248,22.47144749493386,NaN,NaN,-9.754421212799475,-1.079127409873411
2012-04-18T09:30:00-04:00,80.41,80.668,79.83,80.21001,49010144,52418337.6,45.08245539471848,46.225262605492425,NaN,NaN,-67.68850017148196,-91.84450649972946,-0.24916570088734535,-0.5533062986759063,-0.30414059778856095,2490475984,2494542886.4,23.528935303004303,21.241042050733775,NaN,NaN,-9.844665357815707,-2.33134711672231
2012-04-19T09:30:00-04:00,80.32001,80.99001,79.25,79.75,74262128,54106208.8,43.233104414622176,45.40244869621449,NaN,NaN,-70.243715011414,-83.41752730965933,-0.2274852861369817,-0.5884972054597881,-0.3610119193228064,2416213856,2477388684.8,22.09201032268966,20.012300391068255,NaN,NaN,-10.486884328947003,-3.4964238613258374
2012-04-20T09:30:00-04:00,80.28,80.97,80.06,80.21001,46639152,53432976,45.63479731903733,44.86774688887732,NaN,NaN,-46.78352739075034,-68.64279893549606,-0.1693232272998439,-0.5726659534476113,-0.4033427261477674,2462853008,2480355465.6,22.968206715653835,19.203056534656497,NaN,NaN,-10.29325528583292,-4.467399779112563
2012-04-23T09:30:00-04:00,78.98,79.16,78.31,79.10001,62477440,54233588.8,41.114586911009646,43.6480522290672,NaN,NaN,-102.71803036658143,-66.59507345875573,-0.19115258043329014,-0.6422834516893801,-0.4511308712560899,2400375568,2461880908.8,21.357408052606303,18.581445056568185,NaN,NaN,-11.514506799553356,-5.474129353461247
2012-04-24T09:30:00-04:00,79.13,79.92999,78.86,79.7,44817152,53651746.4,44.32477320674627,42.907448066954544,NaN,NaN,-70.49223230430788,-71.58520104890712,-0.15241142778762123,-0.6416451559906164,-0.4892337282029952,2445192720,2443022227.2,19.82868090115889,18.120315275986,NaN,NaN,-11.55556879758172,-6.342906416907029
2012-04-25T09:30:00-04:00,80.75,81.37,80.52499,80.94,50263360,54078383.2,50.34914292100509,43.11764556090587,NaN,NaN,1.4145942844632597,-57.764582157718074,-0.03654541131016492,-0.5349154923407013,-0.4983700810305364,2495456080,2444018246.4,20.153750996033608,17.92882240258088,NaN,NaN,-9.68485979870291,-6.820328328592155
2012-04-26T09:30:00-04:00,80.95,81.87,80.82001,81.74001,43151120,53793876,53.82093100759871,43.702419102662475,NaN,NaN,36.219748302786805,-36.471889494877914,0.09359124809852226,-0.38138102090738357,-0.47497226900590583,2538607200,2468496915.2,27.892056442301453,18.47640234941633,NaN,NaN,-7.015429443647052,-6.8481999164571405
2012-04-27T09:30:00-04:00,81.98,82.53,81.03,82.38,46796384,53852442.4,56.44472466617374,44.89941763174321,NaN,NaN,68.91276733520687,-13.332630549686467,0.2154250753512792,-0.20569092481680684,-0.42111600016808604,2585403584,2493007030.4,34.714647523461906,19.673687786296913,NaN,NaN,-3.9758545476118687,-6.4378648637649585
2012-04-30T09:30:00-04:00,82.35001,82.36,81.42999,81.47,38095552,53461988.8,51.92689601097816,46.24215434481841,NaN,NaN,63.054391175294676,19.821853758688754,0.22626037965235535,-0.13829052560264188,-0.3645509052549972,2547308032,2522393523.2,41.822062031811264,21.633709051752167,NaN,NaN,-2.7720588069483325,-5.914178284219727
2012-05-01T09:30:00-04:00,81.56,82.97,81.28999,81.55,60494336,53848840,52.28844177315611,47.15873171598522,NaN,NaN,84.72307505768957,50.86491523108824,0.22961974961660558,-0.07752621823424022,-0.3071459678508458,2607802368,2554915452.8,48.50373007404214,24.195863362344063,NaN,NaN,-1.70059315404123,-5.312237551337084
2012-05-02T09:30:00-04:00,80.91,81.815,80.57001,81.77,52098768,53853058.4,53.32796740671743,47.739838836150696,NaN,NaN,61.72772668841932,62.92754171187945,0.23652836812462033,-0.011485507695070396,-0.24801387581969073,2659901136,2587804464,54.22876799968013,27.206628739032706,NaN,NaN,-0.5205798950138422,-4.627715029005192
2012-05-03T09:30:00-04:00,81.66,81.75999,80.17,80.62,61494416,53669162.4,47.50181729281485,48.18402126767113,NaN,NaN,27.95685253977962,61.274962559278016,0.1573301302354337,-0.05135121302539858,-0.2086813432608323,2598406720,2599764368,56.13839554235951,30.40463697074893,NaN,NaN,-1.176444842531394,-4.134676430937507
2012-05-04T09:30:00-04:00,80.07001,80.5518,78.94,79.09,75098432,55825149.6,41.07261273972343,48.12223741506639,NaN,NaN,-71.11208056729714,33.26999297877721,0.003704185980379804,-0.20405111078535754,-0.20775529676573734,2523308288,2587345308.8,53.6359880042061,33.40343020582226,NaN,NaN,-3.81191569054425,-4.08856775373847
2012-05-07T09:30:00-04:00,78.75999,79.60001,78.62,79.3,47361984,55690091.2,42.22838971622419,47.739331484323195,NaN,NaN,-90.664659098537,2.526182924010874,-0.07748398441419982,-0.3046102772834871,-0.2271262928692873,2570670272,2592017756.8,54.458506690823306,35.80879618570232,NaN,NaN,-5.587853982026517,-4.302751500636763
2012-05-08T09:30:00-04:00,78.69,79.3,77.97,79.25,62951040,53776084,42.0170806550017,47.520376145772,NaN,NaN,-116.1615713779305,-37.650746363113136,-0.12542953437546123,-0.38391321083861385,-0.2584836764631526,2507719232,2572001129.6,50.33851560851925,37.72376620752482,NaN,NaN,-7.08473724510274,-4.700178035560474
2012-05-09T09:30:00-04:00,78.25,79.25999,77.97,78.8,64441120,54280699.2,40.07351920745996,47.29469148811755,NaN,NaN,-122.33945706193744,-74.46418311318449,-0.17526705515692065,-0.47756749540930343,-0.3023004402523828,2443278112,2528676524.8,42.792368535607,39.2023632227332,NaN,NaN,-8.908322480957583,-5.30134152776006
2012-05-10T09:30:00-04:00,79.32001,79.55,78.63,79.10001,45701760,53529353.6,41.99975792599784,47.03504581718615,NaN,NaN,-81.50307931097268,-96.35616948333495,-0.1754145062914617,-0.5215685731167099,-0.3461540668252482,2488979872,2506791155.2,39.565745895309696,40.38790173556576,NaN,NaN,-9.920282433917974,-5.9611902286397624
2012-05-11T09:30:00-04:00,78.45,79.56,78.42,78.89999,44863600,53074245.6,41.05231861571425,47.030598081807916,NaN,NaN,-84.33381318100383,-99.0005160060763,-0.17592039609202292,-0.5660545619402768,-0.3901341658482539,2444116272,2490952752,37.36968928519996,41.53163610932245,NaN,NaN,-11.027779618689763,-6.684988712932619
2012-05-14T09:30:00-04:00,78.09,78.46001,77.61,77.85001,51221680,53398867.2,36.40921651779961,46.46520117545458,NaN,NaN,-134.77258948998386,-107.82210208436568,-0.2304659320957726,-0.6782165809679697,-0.44775064887219707,2392894592,2455397616,32.94853280051291,42.46876838784773,NaN,NaN,-13.367498088497642,-7.639632909441908
2012-05-15T09:30:00-04:00,77.83,78.49001,77.47,77.71001,54317968,53777876.8,35.827358498298196,45.427930859546954,NaN,NaN,-123.51668890826656,-109.29312559043288,-0.25742502808970247,-0.7695319339843252,-0.5121069058946227,2338576624,2421569094.4,29.386268051740103,43.12823389182677,NaN,NaN,-15.473002124755528,-8.758685654486712
2012-05-16T09:30:00-04:00,77.98,78.39,77.10001,77.155,52662400,53960489.6,33.53905330370988,43.979225309269175,NaN,NaN,-125.26327965012425,-109.87789010807023,-0.2915784825140604,-0.8765800090371982,-0.5850015265231379,2285914224,2390096316.8,26.51413643573217,43.02981103421468,NaN,NaN,-17.951803592364392,-10.071988217040666
2012-05-17T09:30:00-04:00,77.22,77.35001,75.36,75.39999,71669504,53830858.4,27.547438900057443,41.9151334688323,NaN,NaN,-176.46833439179957,-128.8709411242356,-0.4043674711471953,-1.090460865457132,-0.6860933943099367,2214244720,2335149286.4,22.398214430232343,42.150065813269705,NaN,NaN,-22.233216029355294,-11.809306475942755
2012-05-18T09:30:00-04:00,75.39,75.91,74.49001,74.69341,77644432,55381122.4,25.567093921041348,40.032290462408234,NaN,NaN,-192.81440301012773,-150.56705909006038,-0.4927011155015738,-1.301969788686904,-0.8092686731853301,2136600288,2273646089.6,18.8676399536142,40.510464236255636,NaN,NaN,-26.479093106157624,-13.904990280259165
2012-05-21T09:30:00-04:00,74.92999,76.45,74.41,76.45,61393104,55326905.6,37.58067398578803,38.98173562045337,NaN,NaN,-140.16260448545245,-151.64506208915412,-0.40275930774813484,-1.3127178078704986,-0.9099585001223638,2197993392,2234665849.6,17.03489153316079,38.26269005476411,NaN,NaN,-26.313106802210257,-15.677578354823606
2012-05-22T09:30:00-04:00,76.42,77.03,75.47,75.99001,59686592,56070377.6,35.944596918717195,37.74006629988192,NaN,NaN,-109.26582735180021,-148.79488977786085,-0.3463317858999465,-1.342873232497297,-0.9965414465973504,2138306800,2194611884.8,15.381520829030222,35.487886685431974,NaN,NaN,-26.707773528545996,-17.253320522498232
2012-05-23T09:30:00-04:00,75.25,76.64,74.69,76.48,66981744,56906296.8,38.99146264452586,37.132183825004134,NaN,NaN,-105.03360978332458,-144.7489558045009,-0.2524535286456038,-1.3121083574043553,-1.0596548287587515,2205288544,2178486748.8,14.760406235315429,32.53231602064311,NaN,NaN,-26.063135099902983,-18.51186546212748
2012-05-24T09:30:00-04:00,76.42999,76.7401,75.55,76.64,54579280,57477704.8,39.9951565868827,37.0552226712298,NaN,NaN,-81.67503622645343,-125.79029617143166,-0.16050692757704677,-1.26028848823006,-1.0997815606530132,2259867824,2187611369.6,16.80756908953485,29.90171466959516,NaN,NaN,-25.242131430399727,-19.473332029023517
2012-05-25T09:30:00-04:00,76.7,76.89011,76.2699,76.59,33848528,56830312,39.774937528601505,36.87997608639961,NaN,NaN,-64.41408789019404,-100.11023314744494,-0.08762692559247443,-1.2093152176436064,-1.121688292051132,2226019296,2205495171.2,20.821307360447037,27.499057574568287,NaN,NaN,-24.638502453664625,-20.21121351825796
2012-05-29T09:30:00-04:00,77.33,77.91,76.75999,77.7,51168240,57483946.4,46.78068441724127,37.22023349798815,NaN,NaN,-25.130123411787437,-77.10373693271195,0.043710220852187565,-1.0670505159858976,-1.1107607368380852,2277187536,2221334000,24.304543762894454,25.63948815702366,NaN,NaN,-21.978270829603154,-20.46365027702156
2012-05-30T09:30:00-04:00,76.89999,77.03999,76.11,76.21001,47893312,56853895.2,40.046476084988385,37.21830184638304,NaN,NaN,-60.963575249250674,-67.44328651220204,0.03877735051607689,-1.062289048692989,-1.101066399209066,2229294224,2239531484.8,28.2120455597467,24.598036515890783,NaN,NaN,-21.691766376424663,-20.639095434079145
2012-05-31T09:30:00-04:00,76.27,76.59,75.07001,76.11,59565872,57227250.4,39.63406216104723,37.04932357745799,NaN,NaN,-78.73141670378293,-62.182847896293694,0.03730855779251008,-1.0544307019684283,-1.0917392597609383,2169728352,2232419446.4,27.612121117925,23.744206174649012,NaN,NaN,-21.58870294612602,-20.77475365008584
2012-06-01T09:30:00-04:00,74.39999,75.00999,73.71001,73.82001,76129744,57959016.8,31.607434726753326,36.37468901396078,NaN,NaN,-149.3440101970501,-75.71664269041301,-0.10175646280956996,-1.2189348382729008,-1.1171783754633309,2093598608,2199165603.2,24.941473867775358,22.85647650197583,NaN,NaN,-24.251604004909613,-21.27144655791781
2012-06-04T09:30:00-04:00,74.09,74.35001,72.94,73.64999,50132240,56710707.2,31.10378469539488,35.995729598074725,NaN,NaN,-157.78749997663425,-94.39132510770106,-0.18425065886450076,-1.3474916990439567,-1.163241040179456,2043466368,2162655017.6,22.3818593833888,22.101714115038394,NaN,NaN,-26.48837332616739,-22.016721810524892
2012-06-05T09:30:00-04:00,73.25999,74.67,73.21001,74.60001,48275504,56756383.2,37.13197371312783,36.088916399133986,NaN,NaN,-123.1030140281527,-113.98590323097412,-0.15506459527590666,-1.3570717842743392,-1.2020071889984325,2091741872,2125565884.8,20.122679467822962,21.440029216187174,NaN,NaN,-26.423807154961125,-22.64630543115864
2012-06-06T09:30:00-04:00,75.19,76.50999,75.03,76.44,48640720,56040867.2,46.83457497701514,37.03859651865578,NaN,NaN,-26.954262858137454,-107.18404075275149,-0.00026026038314386213,-1.2023325144773622,-1.2020722540942184,2140382592,2107783558.4,19.12589119843439,20.912297413523046,NaN,NaN,-22.974144803692614,-22.693139627234924
2012-06-07T09:30:00-04:00,77.66,77.72,75.94,75.94,57907024,55714162.4,44.81071948327973,38.27168798888595,NaN,NaN,9.119584587856048,-89.61384049442367,0.07583197232499939,-1.1072822886879692,-1.1831142610129686,2082475568,2090333001.6,18.174446195485714,20.61059968246971,NaN,NaN,-20.90578976250733,-22.437803932273837
2012-06-08T09:30:00-04:00,75.89999,77.06,75.3501,76.97,50423280,55950238.4,49.63866189572484,39.99108570136334,NaN,NaN,14.45661033517736,-56.853716387978196,0.1960682929525157,-0.9380288948223239,-1.1340971877748396,2132898848,2098193049.6,20.102398751246383,20.69879673944344,NaN,NaN,-17.554848424084497,-21.74023885967536
2012-06-11T09:30:00-04:00,77.78999,77.86,75.09,75.27,52802912,56347204,42.95895458566525,40.37524860135458,NaN,NaN,-2.632221600727351,-25.82266071279681,0.16300118454398516,-0.9303457070948582,-1.0933468916388434,2080095936,2105518963.2,21.948310669153344,21.04975524915719,NaN,NaN,-16.946510019456294,-21.05542045392978
2012-06-12T09:30:00-04:00,75.44,76.25999,74.78,76.22,56599344,56616087.2,47.23227179337561,41.1815110924016,NaN,NaN,-21.318906710286207,-5.465839249223511,0.2043251857056918,-0.8379404095067287,-1.0422655952124205,2136695280,2114509644.8,24.260974222694003,21.684001920133174,NaN,NaN,-14.98477622535726,-20.188185564133708
2012-06-13T09:30:00-04:00,76.09,76.53999,74.995,75.34,62717104,57036044,43.94784919907493,41.53553870344082,NaN,NaN,-24.4415825388937,-4.963303185374762,0.17285779750988595,-0.826193348325063,-0.9990511458349489,2073978176,2101228761.6,23.168894162503165,22.284608200646584,NaN,NaN,-14.486303235941747,-19.37363094582057
2012-06-14T09:30:00-04:00,75.38,76.47,75.16,76.2,53623904,57084119.2,47.770269537718164,42.090903914214785,NaN,NaN,14.655424547825612,-3.856135193380843,0.20806450631162776,-0.7389705129454143,-0.947035019257042,2127602080,2110254064,25.61923430177579,22.914012858663792,NaN,NaN,-12.814480084245899,-18.436609394167043
2012-06-15T09:30:00-04:00,76.35001,77.32001,76.10001,77.22,57934976,56397392.8,51.955117646335694,42.960916779767224,NaN,NaN,102.48403839702577,13.74935041898884,0.29295225868163344,-0.5808446959050002,-0.8737969545866336,2185537056,2120781705.6,28.484364138555165,23.461374057100084,NaN,NaN,-10.04038727360177,-17.237149091229146
2012-06-18T09:30:00-04:00,76.60001,77.60001,76.35001,77.31,45657456,54798044,52.31814726393248,43.35644984024517,NaN,NaN,115.4935422096598,37.37450318106627,0.34451104562276336,-0.4431581475581794,-0.7876691931809428,2231194512,2151001420.8,36.094084256875256,24.30348409238443,NaN,NaN,-7.748369310563589,-15.881609122562638
2012-06-19T09:30:00-04:00,77.64999,79.08,77.53999,78.64999,66903248,55073551.2,57.4707470309807,44.60104062210176,NaN,NaN,206.77572336547584,82.99342919621867,0.4514633171491683,-0.22334004674448238,-0.6748033638936507,2298097760,2183281916.8,43.063451239994166,25.36429878383068,NaN,NaN,-4.096506760298288,-14.198023070810589
2012-06-20T09:30:00-04:00,78.67,79.08,77.98,78.53,54650480,54821745.6,56.87803188227916,45.832752745046896,NaN,NaN,177.8932972779276,123.46040515958293,0.49332704781789305,-0.058144554121284386,-0.5514716019391774,2243447280,2217175737.6,49.313835440752825,26.91442123546124,NaN,NaN,-1.3634404562536584,-12.364511268731027
2012-06-21T09:30:00-04:00,78.37,78.53,76.49001,76.62,62486848,54597000.8,48.332962430406944,47.027433295307866,NaN,NaN,70.08826746982716,134.54697374398324,0.37684132757138433,-0.08041994247494699,-0.4572612700463313,2180960432,2227847408,51.13282160682441,28.785231788250453,NaN,NaN,-1.6160950311721551,-10.829023234794045
2012-06-22T09:30:00-04:00,77.07001,77.74001,76.64999,77.49001,41003072,53918190.4,51.87928829163903,48.511397837896745,NaN,NaN,68.987222165137,127.84761049760547,0.3437664591457522,-0.027553196114141087,-0.3713196552598933,2221963504,2235132697.6,52.38898605426428,30.928597979027273,NaN,NaN,-0.6946024726636523,-9.38124884020399
2012-06-25T09:30:00-04:00,76.39999,77.59979,76,76.28,48628400,54657184,47.04302721749847,49.219330231066074,NaN,NaN,21.986447248323987,109.14619150533834,0.23118020557001068,-0.08234439829737994,-0.3135246038673906,2173335104,2223560816,50.18239203050002,33.07572030493277,NaN,NaN,-1.4821576624830013,-8.252807243386705
2012-06-26T09:30:00-04:00,76.09,76.58,75.42,76.2,42502912,54223917.6,46.73284020165771,49.21206346139768,NaN,NaN,-12.982820916441266,65.1944826489549,0.14624740546522452,-0.13071534703585996,-0.2769627525010845,2130832192,2190107702.4,44.364859715687956,34.87850377045089,NaN,NaN,-2.198324539161845,-7.387881142783154
2012-06-27T09:30:00-04:00,76.42999,77.46001,76.36,77.44,38516720,53755088,52.014328391489265,49.72660695484122,NaN,NaN,57.66842560086108,41.149508313541595,0.16700556080536993,-0.06820580149437205,-0.235211362299742,2169348912,2175288028.8,42.03979618643096,36.58317162694698,NaN,NaN,-1.1816582880258797,-6.501277877817829
2012-06-28T09:30:00-04:00,76.78,77.37,76.12,77.31,58192672,53686428,51.43850217122371,49.85516697451971,NaN,NaN,42.71901222703451,35.67565726498306,0.16510974375515147,-0.028824182605802662,-0.19393392636095413,2111156240,2161327190.4,39.917450830898616,37.99853248977928,NaN,NaN,-0.535963922870244,-5.649090169968174
2012-06-29T09:30:00-04:00,78.94,79.73,78.56,79.56,71664192,53463150.4,59.744907497334566,51.05416361106752,NaN,NaN,188.65808971624014,59.60983077520369,0.30062395893523797,0.18184602230809332,-0.11877793662714464,2182820432,2153498576,38.736494456259095,39.19768847457255,NaN,NaN,2.7824546522641063,-4.444583766792134
2012-07-02T09:30:00-04:00,79.92,80.50999,79.28,80.48,53374592,53625268,62.56455029017596,52.14932636083898,NaN,NaN,216.48230651251328,98.50900262804154,0.4295975654663417,0.4182190202057825,-0.011378545260559203,2236195024,2166070560,41.71847995091906,40.444653169445765,NaN,NaN,6.452381936681285,-2.8878743805816462
2012-07-03T09:30:00-04:00,80.56,81.60001,80.42999,81.53,32322688,52827627.2,65.53195052613052,53.69104788420009,NaN,NaN,232.3775774814025,147.5810823076103,0.5550277921817185,0.6824061949665889,0.12737840278487045,2268517712,2193607664,47.720956157502435,42.19837188337429,NaN,NaN,10.497705036128838,-0.9756487496230057
2012-07-05T09:30:00-04:00,81.62,81.84,81.03,81.44,42819888,52536585.6,65.0559385137592,54.92573852534587,NaN,NaN,189.01182769304302,173.8497627260467,0.597644679966129,0.8744342527425317,0.2767895727764027,2225697824,2204877446.4,49.99097725804808,43.93921066596516,NaN,NaN,13.554152620340446,1.100037160371773
2012-07-06T09:30:00-04:00,80.77,80.83,80.14999,80.53,38531584,51567813.6,60.28750537326516,55.5209090772694,NaN,NaN,120.4406984257092,189.39409996578163,0.5324290861436498,0.942325930455965,0.4098968443123152,2187166240,2220079446.4,52.958238055830954,45.68734451719915,NaN,NaN,14.718028151675904,3.0454644448437915
2012-07-09T09:30:00-04:00,80.42,80.52499,79.86,80.22,34636288,50778464,58.708814681870244,55.977385321407816,NaN,NaN,93.30828278801259,170.32413858013612,0.44012197580807333,0.9600493140724069,0.5199273382643336,2152529952,2214021350.4,51.64319326391738,46.7979951605593,NaN,NaN,15.20957602538872,4.7831946706359245
2012-07-10T09:30:00-04:00,80.81,80.96001,78.98,79.33,49992704,50637953.6,54.31162193174467,55.75173352860524,NaN,NaN,66.9045650230334,140.40859028224014,0.2976559470013892,0.89199727201607,0.5943413250146808,2102537248,2187289795.2,46.19250560175985,47.02149904354257,NaN,NaN,14.330220255987388,6.147055468543276
2012-07-11T09:30:00-04:00,79.39,79.64999,78.55,79.06,40178192,49816896,53.014370260336236,55.47575769846646,NaN,NaN,34.610905585524385,100.85525590306453,0.17010811793488834,0.8069764724332913,0.636868354498403,2062359056,2146058064,39.30208373826579,46.30637392193635,NaN,NaN,13.231612274519138,7.159135012254113
2012-07-12T09:30:00-04:00,78.44,79.10001,77.59,78.78999,55510528,49456567.2,51.684848403840824,55.71517812514031,NaN,NaN,4.004799051545816,63.85385017476508,0.0582086464276933,0.7096291625330196,0.6514205161053263,2006848528,2102288204.8,33.5762949214065,45.05233630154935,NaN,NaN,11.94249739057696,7.842472494871663
2012-07-13T09:30:00-04:00,79.07001,80.09,79.02,79.771,42114880,48881116,56.00214284433939,56.00966773604748,NaN,NaN,49.86844815870571,49.739400121364376,0.041687721990677384,0.703530168593673,0.6618424466029956,2048963408,2074647638.4,30.54951692245855,43.49237422070609,NaN,NaN,12.012576521628837,8.43820164155126
2012-07-16T09:30:00-04:00,79.62,79.88,79.11099,79.45,31924144,47580574.4,54.292579949910106,56.52749293121974,NaN,NaN,37.674214146044775,38.6125863929708,0.002628026008057449,0.6651274791130675,0.66249945310501,2017039264,2047549500.8,27.894632436574312,41.900391392568544,NaN,NaN,11.59433178623356,8.889077376505874
2012-07-17T09:30:00-04:00,79.98,80.14999,78.64999,79.731,43662416,47480822.4,55.57116989985841,57.15880219537694,NaN,NaN,34.549060400796414,32.14148546852341,-0.010098717708919569,0.6498760559688606,0.6599747736777801,2060701680,2039182387.2,27.111183554918625,40.66798595251358,NaN,NaN,11.585891235355298,9.274336499198649
2012-07-18T09:30:00-04:00,79.60001,80.70821,79.55,80.22,46045264,46437923.2,57.78429443523612,57.570942627073144,NaN,NaN,62.259506673752036,37.67120568616895,0.007643770930230831,0.6695294873405686,0.6618857164103378,2106746944,2048059964.8,29.3775811730152,39.763542022983884,NaN,NaN,12.175723371073147,9.688820338037862
2012-07-19T09:30:00-04:00,80.55,80.74001,79.81,79.95,49405456,46175672,56.121978616279115,57.90547665886282,NaN,NaN,57.724219104483176,48.415089696756425,-0.004901334987197581,0.6557590476763409,0.6606603826635384,2057341488,2058158556.8,31.968974044499888,39.195793681098266,NaN,NaN,12.236045985148603,10.05270971619654
2012-07-20T09:30:00-04:00,79.33,79.46001,78.80991,78.92999,42315296,45167094.4,50.2417546228015,57.2266800249676,NaN,NaN,-1.9792562679418746,38.04554881142691,-0.08362519812848335,0.5561288850029342,0.6397540831314176,2015026192,2051371113.6,31.141860204723542,38.65331980598858,NaN,NaN,10.638377680847576,10.136376568289545
2012-07-23T09:30:00-04:00,77.50999,78.03,77.17999,77.67,47372848,45485583.2,44.09559972065924,55.907469270002125,NaN,NaN,-83.14713293344731,13.881279395528491,-0.21482615343201938,0.3712213913413933,0.5860475447734127,1967653344,2041493929.6,29.928383433447138,37.81117005474058,NaN,NaN,7.326610642895581,9.734981436090408
2012-07-24T09:30:00-04:00,77.95,77.98,76.22,76.64999,55612800,45834803.2,39.84602277794067,54.07276014513142,NaN,NaN,-123.74426982296936,-17.77738664922466,-0.35623636735482894,0.1407520855798765,0.49698845293470545,1912040544,2011761702.4,26.57187255349899,36.3005212258832,NaN,NaN,3.100231116886356,8.7871599619184
2012-07-25T09:30:00-04:00,77,77.375,76.47501,76.82001,37217584,45570536.8,40.86895362071365,52.345118367056735,NaN,NaN,-135.14130733716175,-57.25754945140742,-0.41987572049750144,-0.027856197687171402,0.39201952281033003,1949258128,1980263939.2,23.55765981904456,34.41242712309724,NaN,NaN,-0.0381911376064874,7.526395519129131
2012-07-26T09:30:00-04:00,77.98,78.17999,77,77.48,44745200,45881960.8,44.79353966845539,51.238406530998894,NaN,NaN,-99.79663985801719,-88.76172124390749,-0.3992080022844792,-0.10699048004526901,0.2922175222392102,1994003328,1967596307.2,22.454458593013555,32.233585732895996,NaN,NaN,-1.5925301440790205,6.223691852956538
2012-07-27T09:30:00-04:00,77.83,79.72,77.39,79.32001,67301680,46337411.2,53.96668111446265,50.89968270475549,NaN,NaN,-32.635942626057144,-94.89305851553056,-0.2505656855387977,-0.02098958468428691,0.2295761008545108,2061305008,1976852070.4,25.21037123611248,30.34552701662421,NaN,NaN,-0.08718597311868409,5.322137877802935
2012-07-30T09:30:00-04:00,79.52,79.91,78.74001,79.05,34785104,44493456.8,52.58584730315945,50.77641308842798,NaN,NaN,-3.9072154361440634,-79.04507501606989,-0.1635889027033802,0.02508997247528555,0.18867887517866574,2026519904,1988625382.4,28.682347562814428,29.094801442413825,NaN,NaN,0.6983177728385113,4.661592148522303
2012-07-31T09:30:00-04:00,78.73,79.47,78.35001,78.35001,48938816,44271668,49.07981969755006,50.49537376251469,NaN,NaN,-33.96987012403349,-61.090195076282725,-0.1468898154299828,0.005066605891187237,0.15195642132117004,1977581088,2001733491.2,32.442742476195875,28.604848495123115,NaN,NaN,0.288304727557733,4.036836802670221
2012-08-01T09:30:00-04:00,78.91,79,77.03999,77.06,63601072,45835587.2,43.344397995595365,49.89962730478287,NaN,NaN,-93.24242098487042,-52.710417805824456,-0.21243372638203645,-0.1135857366563755,0.09884798972566093,1913980016,1994677868.8,31.48055699021687,28.455152928609575,NaN,NaN,-1.9139523558191767,3.186724065743164
2012-08-02T09:30:00-04:00,76.27,77.30499,76.25,76.78,43378032,45863494.4,42.19189757475171,48.91318121409803,NaN,NaN,-138.3575294332163,-60.42259572086429,-0.2611493771260415,-0.22758873168189098,0.03356064544415055,1870601984,1969997600,28.316920984179077,28.29568179016104,NaN,NaN,-4.045164143494316,2.1535971787092385
2012-08-03T09:30:00-04:00,77.94,79.02,77.64999,78.61,52414144,46557622.4,51.30507030759645,48.69978766821849,NaN,NaN,-20.504433821584424,-57.99629395996974,-0.16151316256758394,-0.16833080776532938,-0.006817645197745442,1923016128,1942339824,25.254059515116992,28.107069438628372,NaN,NaN,-2.9790082416184123,1.4203678329481457
2012-08-06T09:30:00-04:00,78.7,79.6315,78.59,79.22,34665376,46559076.8,53.91315275597223,48.581357872226626,NaN,NaN,36.726277046239424,-49.86959546349304,-0.051605396588272144,-0.07132439093308562,-0.01971899434481348,1957681504,1928572144,23.86997839973563,27.87555478468673,NaN,NaN,-1.262972894214168,1.0370334433535295
2012-08-07T09:30:00-04:00,79.85001,80.57001,79.64,79.94,50064080,46562645.6,56.85078747517429,48.51467880365078,NaN,NaN,102.23174175807355,-22.629273087071635,0.06611639427946991,0.06292649850452392,-0.0031898957749460013,2007745584,1934605043.2,25.789296165401353,27.619248712714317,NaN,NaN,1.1026946719382087,1.0464136188656266
2012-08-08T09:30:00-04:00,79.60001,80.19,79.53999,79.82001,28012896,45954380.8,56.207782277725975,48.520807636611266,NaN,NaN,81.75526174347324,12.370263458597098,0.12880780169439943,0.1578198563430533,0.029012054648653855,1979732688,1947755577.6,29.935863482718844,27.47402652972995,NaN,NaN,2.798256591170438,1.2966769006234566
2012-08-09T09:30:00-04:00,79.75999,80.39,79.69,80.2,24049456,44381327.2,57.834265061643336,49.06312981081425,NaN,NaN,89.53441374105346,57.94865209345105,0.18533482022782516,0.2606805799334353,0.07534575970561014,2003782144,1974391609.6,37.54757446393879,27.931577548245325,NaN,NaN,4.685823218423159,1.7808406603091282
2012-08-10T09:30:00-04:00,79.77,80.05,79.5,79.92,26076192,43579392.8,56.17852035632005,49.92619557050431,NaN,NaN,69.71548327994758,75.99263551375745,0.19249344402868673,0.31596256474146855,0.12346912071278182,1977705952,1985329574.4,40.41048667486362,28.6802992083465,NaN,NaN,5.789128670355303,2.3534532331728673
2012-08-13T09:30:00-04:00,79.8,80.00999,78.89,79.78999,31546544,43560512.8,55.38563804821034,51.03616808980929,NaN,NaN,51.51026407258276,78.94943291902612,0.17746692744687084,0.3453027800213704,0.16783585257449954,1946159408,1983025155.2,39.99451021902525,29.63905904159838,NaN,NaN,6.489373340915186,2.9442989628503415
2012-08-14T09:30:00-04:00,80.3,80.42,79.27,79.60001,26060288,42680406.4,54.18223487072177,51.98711675052415,NaN,NaN,63.54242122532891,71.21156881247718,0.14509128117546097,0.34919995404382576,0.2041086728683648,1920099120,1965495862.4,36.884207105275095,30.590955276329137,NaN,NaN,6.762111026607634,3.4897006862442406
2012-08-15T09:30:00-04:00,79.38,80.3,79.31,80.3,27061376,41731212,57.818878532584925,52.917498097961975,NaN,NaN,78.75314176542149,70.61114481686683,0.16000383528794976,0.40411346697830197,0.2441096316903522,1947160496,1958981424,35.77086397903757,31.542127089616567,NaN,NaN,7.999535340034552,4.133962779642856
2012-08-16T09:30:00-04:00,80.17999,81.3,79.83,81.14,46045696,41563224,61.74306104946301,53.47295380760486,NaN,NaN,126.71114235461278,78.04649053957868,0.21234440655301595,0.5095401398816222,0.2971957333286062,1993206192,1956866233.6,35.39725667887092,32.269761764099314,NaN,NaN,10.228929621380768,5.004672328462558
2012-08-17T09:30:00-04:00,81.22,81.86,80.99001,81.71001,33453968,41120157.6,64.17842369996582,54.300994978805306,NaN,NaN,152.36832616601973,94.57705911679314,0.26768624772421457,0.6318035429838744,0.36411729525965986,2026660160,1966657075.2,38.59430930762031,32.97775903158544,NaN,NaN,12.859191786510696,6.126746536755149
2012-08-20T09:30:00-04:00,81.59,81.66,80.98,81.53,32658000,40384415.2,62.81842250477761,55.28232375075014,NaN,NaN,131.38991918052199,110.55299013838098,0.2735334806436077,0.7060341460641695,0.43250066542056176,1994002160,1976225625.6,41.634267248364836,33.634296515311796,NaN,NaN,14.679752895277224,7.348604587972588
2012-08-21T09:30:00-04:00,81.92999,82.71001,81.19,81.48,43746544,39791102.4,62.422736125698776,56.64506218861466,NaN,NaN,142.14024153512452,126.2725542003401,0.25572542670936443,0.7521574488072673,0.4964320220979029,1950255616,1982256924.8,43.53189733744732,34.49510654011397,NaN,NaN,16.090987629090066,8.597516450989371
2012-08-22T09:30:00-04:00,81.27,81.5,80.78999,81.09,37611984,39810822.4,59.285879786280674,57.86606091800959,NaN,NaN,96.7296619001542,129.86785822728663,0.20174336919455105,0.7486112335910917,0.5468678643965407,1912643632,1975353552,41.85451871031536,35.46207780626657,NaN,NaN,16.49180568456119,9.725272055785345
2012-08-23T09:30:00-04:00,81.06,81.06,80.2,80.52,32208656,39183995.2,54.94039217737948,58.12572676585124,NaN,NaN,57.79777662036674,116.08518508043741,0.11597098226432512,0.6918315922269471,0.575860609962622,1880434976,1952799308.8,36.85760109207527,36.29090220462073,NaN,NaN,15.663056671375733,10.573527000869685
2012-08-24T09:30:00-04:00,80.34,81.07001,80.11,80.74001,25679232,37102872.8,56.27266302492585,58.294263213633634,NaN,NaN,55.84680523791154,96.78088089481578,0.06492163425808373,0.6570126527852267,0.592091018527143,1906114208,1928690118.4,32.40412444211407,36.90048406479061,NaN,NaN,15.308558526767573,11.249960075997954
2012-08-27T09:30:00-04:00,81.23,81.41,80.58,80.98,23633312,36545283.2,57.74045772168494,58.357811088384395,NaN,NaN,72.97156326681707,85.0972097120748,0.0394392129161697,0.6413900346723551,0.6019508217561854,1929747520,1915839190.4,30.30235513816912,37.22284541998831,NaN,NaN,15.387558821592446,11.841045611082881
2012-08-28T09:30:00-04:00,80.97,81.50999,80.75,81.35001,28512800,35523982.4,59.97139684333755,58.62664070021379,NaN,NaN,80.16251873569274,72.70166515218844,0.03952515923383959,0.6513572707984849,0.6118321115646453,1958260320,1917440131.2,30.903619574737505,37.291970855132504,NaN,NaN,16.045639837358728,12.441701929122289
2012-08-29T09:30:00-04:00,81.52,81.96001,81.145,81.60001,30861008,33886979.2,61.452122597303706,58.885059095618104,NaN,NaN,96.85485802940696,72.72670437803899,0.04788351394318502,0.6716865039936266,0.6238029900504416,1989121328,1932735670.4,36.5366799270772,37.21976410249953,NaN,NaN,17.00327288601643,13.09335492296431
2012-08-30T09:30:00-04:00,81.17999,81.25,80.64,80.78999,24562832,32946219.2,54.42692692183297,58.75994527886903,NaN,NaN,39.0202323860077,68.97119553116717,-0.006768441010267523,0.6153424387876072,0.6221108797978747,1964558496,1949560374.4,42.12577643254437,37.34228479947673,NaN,NaN,15.920460993928668,13.497227218816361
2012-08-31T09:30:00-04:00,81.48,81.53,80.34,81.12,34089904,32030007.2,56.6035908186658,58.846941905330134,NaN,NaN,42.49934705282143,66.30170389414914,-0.025279613632848474,0.5905113627568142,0.6157909763896626,1998648400,1968067212.8,47.59312277295912,37.88504283904343,NaN,NaN,15.59155290200967,13.79641660212969
2012-09-04T09:30:00-04:00,81.17999,82.39999,80.55009,82.11,69563632,33774920,62.40468093316616,59.43425948121902,NaN,NaN,106.77776102282685,73.0629434453511,0.02200857949943491,0.6433017007639563,0.6212931212645214,2068212032,1995760115.2,54.51716712060586,39.14453998299563,NaN,NaN,17.019789082204458,14.256898384997514
2012-09-05T09:30:00-04:00,82.2,82.50999,81.85001,82.13,35158256,33029628.8,62.51370135587994,59.76960396859723,NaN,NaN,141.78227182566516,85.38689406334558,0.046106319209587965,0.6789260202765064,0.6328197010669184,2103370288,2024782108.8,60.41917578249759,40.905133683242774,NaN,NaN,18.20843660988105,14.821403845695162
2012-09-06T09:30:00-04:00,82.58,83.94009,82.52,83.638,46336752,33945821.6,69.65819599308753,60.3349707502847,NaN,NaN,230.28574023248416,112.07307050396102,0.14926108678612549,0.8193960595495753,0.6701349727634498,2149707040,2056899251.2,65.72046603944787,43.07107720899827,NaN,NaN,21.67724847757517,15.80081022167802
2012-09-07T09:30:00-04:00,83.86,84.39999,83.7,84.25999,32012864,34343992,72.02637459667868,60.895538671478484,NaN,NaN,242.31365179775295,152.73175438631006,0.23967643994034193,0.9697305226888773,0.7300540827485353,2181719904,2100331532.8,71.31551873162579,45.4083064535701,NaN,NaN,25.367508182041192,17.16748135887276
2012-09-10T09:30:00-04:00,84.17999,84.45,83.78999,83.88,30674560,34573910.4,68.50841827124185,61.30196694051164,NaN,NaN,195.02111080485162,183.2361071367161,0.25287695884128625,1.046150281300143,0.7932733224588568,2151045344,2130810921.6,74.46528662683943,47.753379266318284,NaN,NaN,27.29293333764597,18.613974498697505
2012-09-11T09:30:00-04:00,83.89,84.56,83.83,84.06,33164080,34654787.2,69.27399720514998,61.79134273190101,NaN,NaN,169.88182818399113,195.85692056894896,0.25214961833888927,1.1084603453824684,0.8563107270435791,2184209424,2154010400,76.57386097135998,50.11351952588347,NaN,NaN,29.085796338537595,20.10994904724609
2012-09-12T09:30:00-04:00,84.485,84.64999,83.89999,84.49001,29752704,34839408,71.08260893032659,62.63396624219,NaN,NaN,150.473779768017,197.59522215741933,0.25811104792720596,1.1789495369525866,0.9208384890253807,2213962128,2176128768,78.40480319171027,52.724254131697386,NaN,NaN,31.1443892615965,21.686297649296147
2012-09-13T09:30:00-04:00,84.64,86.14999,84.19,85.60001,69441376,36958408,75.14902502131845,64.07744001675708,NaN,NaN,168.6907015186394,185.27621441465038,0.3107594469662027,1.309287797733134,0.9985283507669314,2283403504,2202868060.8,80.39927365478975,55.834373600462705,NaN,NaN,34.325580757671794,23.49190952192124
2012-09-14T09:30:00-04:00,85.86,86.96001,85.83,86.39999,46045552,36958400.8,77.59442363298633,65.60042291733282,NaN,NaN,179.0150036441493,172.61648478392965,0.3694173821284388,1.4603000784274798,1.090882696299041,2329449056,2232413891.2,82.34011196253643,59.40122985192145,NaN,NaN,37.85616338833421,25.543945788551664
2012-09-17T09:30:00-04:00,85.98,86.22,85.57001,86,30184992,36794952,73.68989292820524,66.73966828922713,NaN,NaN,132.47676649109735,160.10761592117882,0.35134577322922333,1.5300649128355701,1.1787191396063468,2299264064,2262057635.2,84.04691499748616,63.240126984729805,NaN,NaN,39.50298792991944,27.53809466588992
2012-09-18T09:30:00-04:00,85.74001,85.89999,85.36,85.72,32993616,36811732.8,70.99668441177374,67.52718882982971,NaN,NaN,105.98340686655935,147.32793165769246,0.2929856096053274,1.544951151613006,1.2519655420076785,2266270448,2278469840,84.91612921420368,67.09816338754882,NaN,NaN,40.01844853281386,29.32100236116477
2012-09-19T09:30:00-04:00,85.94,86.03,85.41,85.57001,29344496,36091630.4,69.53070575186452,68.10423048372691,NaN,NaN,94.34291000077417,136.10175770424388,0.22006185761552177,1.5270428640270808,1.306981006411559,2236925952,2283062604.8,85.15980573700841,70.5712438025439,NaN,NaN,40.006100350016,30.84744493100066
2012-09-20T09:30:00-04:00,85.14,85.39999,84.61,85.19,34941456,35958104,65.82235826471192,68.91818986536113,NaN,NaN,66.11300365033075,115.58621813058217,0.12665180964287592,1.465295768465154,1.338643958822278,2201984496,2266778803.2,80.21206576824757,73.29169304080843,NaN,NaN,38.90970718019274,31.99919668088524
2012-09-21T09:30:00-04:00,86.03999,86.08,85.47,85.5,38829392,36289140.8,67.35207400074792,69.68593866408128,NaN,NaN,81.34836987136582,96.05289137602549,0.0690442184188298,1.4249492318458152,1.3559050134269854,2240813888,2249051769.6,75.09690605451442,75.25624898949094,NaN,NaN,38.41332223502457,32.91550033147657
2012-09-24T09:30:00-04:00,84.89,85.42999,84.60001,84.89,54640736,37737216,61.51736512674879,69.6225589636229,NaN,NaN,50.0394690699914,79.5654318918043,-0.021972817852299764,1.3284389911116108,1.3504118089639106,2186173152,2226433587.2,69.04671824223976,76.29407406960765,NaN,NaN,36.24948584010053,33.39178397556571
2012-09-25T09:30:00-04:00,85.42999,85.50999,83.58,83.67,74752128,40293156.8,51.843928329393286,68.86043231887385,NaN,NaN,16.590636205226655,61.686877759537744,-0.16803767802281167,1.1403647114353959,1.3084023894582075,2111421024,2195463702.4,61.71502490385162,76.38663472113294,NaN,NaN,31.09100428814961,33.0631011630777
2012-09-26T09:30:00-04:00,83.85001,83.92999,82.84,83.14,42171552,40976094.4,48.29127777232318,67.33422387453354,NaN,NaN,-32.46562404974555,36.3251709494338,-0.29653130653607507,0.9377382562881138,1.2342695628241889,2069249472,2161928406.4,54.91515364386615,75.61482669287709,NaN,NaN,25.632117615604944,32.00153208486731
2012-09-27T09:30:00-04:00,83.49001,84.35001,83.07001,84.03999,33252800,41095684,54.049534260458984,66.05016385051785,NaN,NaN,-14.529226308990042,20.196724957569643,-0.31534130321326215,0.8400929338076111,1.1554342370208732,2102502272,2142031961.6,51.3034323925062,74.18539195436855,NaN,NaN,22.75174025346577,30.680133251809945
2012-09-28T09:30:00-04:00,83.78,84,83.25999,83.44,43945968,42064840.8,50.04818429406916,64.73157570929122,NaN,NaN,-39.77174550529839,-4.027298117763199,-0.3594241660290005,0.7061540294846225,1.065578195513623,2058556304,2105580444.8,45.410840445179716,72.11007436996428,NaN,NaN,19.040986653824348,29.017398023526287
2012-10-01T09:30:00-04:00,83.96001,84.53999,83.31,83.72,43711376,42545914.4,51.840025550311395,63.486292019659906,NaN,NaN,-34.99487245429839,-21.034166422621155,-0.36005856885000154,0.6155049844511211,0.9755635533011227,2102267680,2088799350.4,42.96427523848979,69.70938967475927,NaN,NaN,16.599993741233572,27.2434831260559
2012-10-02T09:30:00-04:00,84.14999,84.24001,83.37,83.88,25798096,40357637.6,52.880181590768785,62.186118638262926,NaN,NaN,-48.405936807729994,-34.033481025212495,-0.34026453558603387,0.5502328838185804,0.8904974194046142,2128065776,2092128300.8,43.61327694514592,67.22428065714755,NaN,NaN,14.933416177415149,25.484902133392936
2012-10-03T09:30:00-04:00,83.94,84.22,83.17,83.64,38570944,40528272,51.097444220837694,60.46814858108572,NaN,NaN,-70.37175601117228,-41.61470741749783,-0.33345552410237667,0.47367801427664347,0.8071335383790201,2089494832,2096177372.8,44.441377737643904,64.65585952020855,NaN,NaN,13.031100572721463,23.705787624725584
2012-10-04T09:30:00-04:00,83.96001,84.25999,83.2,84.21001,43327424,40377805.6,54.97949086293347,58.85279624036766,NaN,NaN,-56.747989791734405,-50.0584601140467,-0.28268925388279076,0.4537719710255317,0.7364612249083224,2132822256,2102241369.6,45.72689860664896,62.04062999478801,NaN,NaN,12.517251568219162,22.107425330938952
2012-10-05T09:30:00-04:00,84.58,85.25,83.84,84.11,40983952,40826360,54.167016357643725,57.458305056756124,NaN,NaN,-16.019134168925667,-45.30793784677216,-0.2491474823726868,0.4250268719424639,0.6741743543151507,2091838304,2108897769.6,47.17186606245372,59.406697927999986,NaN,NaN,11.866432473355754,20.64442635128421
2012-10-08T09:30:00-04:00,83.62,83.89999,83.39,83.58,21069056,40346084.8,49.95397067197182,55.955254075341706,NaN,NaN,-77.6749804767526,-53.843959451263004,-0.25503310780267896,0.35538296956180204,0.610416077364481,2070769248,2102598083.2,45.92565113024266,56.621663779145635,NaN,NaN,10.084882977463717,19.135920155024138
2012-10-09T09:30:00-04:00,83.62,83.7,82.44,82.60001,45221120,40948936.8,43.25473350795249,54.07839891506227,NaN,NaN,-123.32473407943819,-68.82771890560464,-0.313458566089279,0.21859286975288228,0.5320514358421613,2025548128,2082094553.6,42.033416869781114,53.54120743148654,NaN,NaN,6.379605873279931,17.313589543346396
2012-10-10T09:30:00-04:00,82.67,82.83,82.17999,82.47,32469776,41084790.4,42.44155402360201,52.408341469268706,NaN,NaN,-136.8642282755297,-82.12621335847612,-0.3467940413078038,0.09855888420740655,0.44535292551521033,1993078352,2062811257.6,38.710568528800096,50.57681477152601,NaN,NaN,3.1294451790203666,15.287283205585535
2012-10-11T09:30:00-04:00,83.10001,83.44,82.60001,82.77,38978432,39561643.2,45.01053815656858,50.81251748039875,NaN,NaN,-96.46170926591918,-90.06895725331307,-0.33442345313020594,0.027323609102452906,0.36174706223265884,2032056784,2042658163.2,35.54775787359628,47.751875615746144,NaN,NaN,1.1333284926603613,13.265289675167653
2012-10-12T09:30:00-04:00,82.74001,83.02,81.91,82.10001,31847008,38851716,40.64723743673544,49.32179407396923,NaN,NaN,-131.4588665297867,-113.1569037254853,-0.35519395359311223,-0.08224537975873147,0.27294857383438076,2000209776,2024332457.6,32.914268890612206,45.17098637634417,NaN,NaN,-1.939801411696637,11.093133805615611
2012-10-15T09:30:00-04:00,82.34,82.64,81.75999,82.64,34421024,39063517.6,45.253604583126354,48.8510566635216,NaN,NaN,-126.0077193779975,-122.82345150573425,-0.3176201666757126,-0.12407663451025996,0.19354353216545261,2034630800,2017104768,31.910180323877924,43.04206890634605,NaN,NaN,-3.1972663793125946,9.051648064911582
2012-10-16T09:30:00-04:00,83.08,83.36,82.88,83.25,29239488,38875811.2,49.97662082514036,48.971438310151385,NaN,NaN,-55.464608092887296,-109.25142630842409,-0.24025519549129762,-0.1067754621986694,0.13347973329262822,2063870288,2024769200,34.20243463947915,41.56258897746126,NaN,NaN,-2.82748674897916,7.354628805784333
2012-10-17T09:30:00-04:00,83.42,84.14999,83.25,84,35466448,39181908.8,55.10497741490635,49.04682710689763,NaN,NaN,10.398519266359594,-79.79887680004623,-0.13252341739706452,-0.03217453845370244,0.10034887894336209,2099336736,2046020876.8,40.212622279531935,40.770388255105956,NaN,NaN,-0.8670712091433487,6.180100232223236
2012-10-18T09:30:00-04:00,83.94,84.14999,83.45,83.53999,31432864,39006479.2,51.61011028294928,49.158393248960486,NaN,NaN,9.373304138293095,-58.63187411920377,-0.08832375458162937,-0.010055814283674636,0.07826794029795474,2067903872,2053190294.4,42.13299090313237,40.536256144959715,NaN,NaN,-0.31189130189570186,5.252672870206244
2012-10-19T09:30:00-04:00,82.85001,82.88,81.47,81.85001,53568064,39743412.8,41.25765513481774,48.4025096478538,NaN,NaN,-152.99283904343662,-62.938668621933765,-0.16455431442565732,-0.12742495273411691,0.0371293616915404,2014335808,2056015500.8,42.911165871881245,40.53246261877339,NaN,NaN,-3.4237763967173978,4.013180117788581
2012-10-22T09:30:00-04:00,81.64,81.97,81.35001,81.83,30691184,38545935.2,41.15239742448481,47.56481077883352,NaN,NaN,-165.89127197964345,-70.91537914226295,-0.20532343618539203,-0.21952493354019964,-0.014201497354807614,1983644624,2045818265.6,40.779565658374004,40.33005466971825,NaN,NaN,-5.834352392561618,2.606389759167124
2012-10-23T09:30:00-04:00,81.14999,81.53,80.42999,81.4203,40737840,36845220.8,38.960704348690285,46.69790078796585,NaN,NaN,-188.2668474462639,-97.47582701293827,-0.24612996259506612,-0.32186395059864026,-0.07573398800357414,1942906784,2021625564.8,36.18681937108542,39.74044335782121,NaN,NaN,-8.507157845955964,1.0187401012923971
2012-10-24T09:30:00-04:00,81.7,81.85001,80.91,81.2,24474640,35960375.2,37.795094400237296,45.47044389777326,NaN,NaN,-142.36986143814937,-128.02950315384007,-0.2721727424719031,-0.415949916093453,-0.1437771736215499,1918432144,1985444646.4,30.630752753743337,38.66214722547081,NaN,NaN,-11.030274618986386,-0.7025477158902862
2012-10-25T09:30:00-04:00,81.88,82.14,80.87,81.53,27796208,35687545.6,40.659042362188444,44.5055886123836,NaN,NaN,-111.31752462950507,-152.1676689073997,-0.25185748935460395,-0.45859903531480484,-0.2067415459602009,1946228352,1961109542.4,27.56515115829623,37.261667589459556,NaN,NaN,-12.278909058319098,-2.3563136219515446
2012-10-26T09:30:00-04:00,81.44,81.89999,80.46001,81.14,41405760,35560535.2,38.40842171306374,43.68090654389016,NaN,NaN,-119.80517301111766,-145.53013570093592,-0.2489255621836589,-0.5178984986897746,-0.26897293650611565,1904822592,1939206899.2,25.1275830156103,35.776091295557244,NaN,NaN,-13.996815236447313,-4.0192424240223685
2012-10-31T09:30:00-04:00,81.16,81.64999,80.88,81.63,24879760,34618954.4,42.69998981966318,43.64128199472664,NaN,NaN,-92.7568246922238,-130.90324624345197,-0.2003159675437597,-0.5193678959358152,-0.31905192839205554,1929702352,1928418444.8,24.001718553076714,34.488112844364075,NaN,NaN,-14.196446349312907,-5.473128699063874
2012-11-01T09:30:00-04:00,81.82001,82.71001,81.52,82.49001,77113248,37184712,49.368211769606084,44.136043262298365,NaN,NaN,-26.683888031553955,-98.58665436051,-0.10155495673338999,-0.445995624308793,-0.34444066757540304,2006815600,1941200208,28.1114311613496,33.731031603831894,NaN,NaN,-12.286935288625681,-6.446529640429847
2012-11-02T09:30:00-04:00,82.89,82.95,81.17,81.1913,39323376,37222333.6,41.51186020318513,43.88613769419955,NaN,NaN,-57.165186415121816,-81.54571935590448,-0.11407022819089041,-0.4870284528140161,-0.37295822462312567,1967492224,1951012224,31.187711069478695,33.41959968925207,NaN,NaN,-13.162278221663609,-7.405922294891813
2012-11-05T09:30:00-05:00,81.17999,81.84,80.92,81.72659,26862688,36399096.8,45.37073343765968,44.223530265694144,NaN,NaN,-73.17510378690574,-73.9172351873846,-0.07837366181807426,-0.47092530189571846,-0.3925516400776442,1994354912,1960637536,34.16397121756894,33.50886414117755,NaN,NaN,-12.597385205035728,-8.1475598534838
2012-11-06T09:30:00-05:00,82.03,82.57001,81.97,82.34,27347312,35717264.8,49.48383541766592,44.52568961101839,NaN,NaN,2.1090657031783544,-49.53438744452539,-0.00916605718070762,-0.40400921155352876,-0.39484315437282114,2021702224,1984013462.4,40.85456709527425,34.147748910562996,NaN,NaN,-10.77015672677288,-8.522216549667954
2012-11-07T09:30:00-05:00,81.37,81.37,79.91,80.34,65102240,37918924,39.1372275022472,43.751447230811735,NaN,NaN,-148.7257144379327,-60.728165393667176,-0.08934318947033326,-0.5065221412107377,-0.4171789517404044,1956599984,1989392988.8,42.30761378597079,34.72669027816954,NaN,NaN,-12.85706430330702,-9.141480514473535
2012-11-08T09:30:00-05:00,80.16499,80.5,79.14999,79.21001,42653632,37790549.6,34.720055266759644,42.295381363086975,NaN,NaN,-197.58973005841236,-94.90933379903886,-0.20322312614239813,-0.6712078594184021,-0.467984733276004,1913946352,1970819139.2,38.766368276694074,34.623386420823984,NaN,NaN,-16.219316210856057,-10.152599899671038
2012-11-09T09:30:00-05:00,78.87,79.97,78.7,79.38,33030128,37818567.2,35.892246031850945,41.17267677372281,NaN,NaN,-186.44707398638374,-120.76571131329123,-0.2488326799895566,-0.7790255832629498,-0.5301929032733932,1946976480,1966715990.4,38.00948396283449,34.328850210802706,NaN,NaN,-18.358043289141886,-11.324806098166874
2012-11-12T09:30:00-05:00,79.56,79.66,79.03,79.14999,20155008,36877396,34.97705904730658,40.72406276747201,NaN,NaN,-166.7229702665461,-139.4752846092193,-0.2742206778359746,-0.8729687505683614,-0.5987480727323868,1926821472,1953209302.4,35.54901313166961,33.80298215793045,NaN,NaN,-20.33227501453142,-12.611587371933238
2012-11-13T09:30:00-05:00,78.78999,79.56,78.58,78.7,34408192,37005455.2,33.19382897611817,40.15559359258868,NaN,NaN,-162.3746155292241,-172.3720208556998,-0.29901692063165586,-0.9725192235219566,-0.6735023028903008,1892413280,1927351513.6,31.363251205064373,33.13038826840833,NaN,NaN,-22.510556131496877,-14.025725766156615
2012-11-14T09:30:00-05:00,78.88,79.10001,77.06,77.24001,54655184,38017163.2,28.17483011713506,39.38517400462045,NaN,NaN,-191.44446801131443,-180.91577157037614,-0.38591672321336834,-1.1558982069070112,-0.7699814836936428,1837758096,1903583136,28.089242432910552,32.55198991568155,NaN,NaN,-26.178513794877333,-15.761838341688145
2012-11-15T09:30:00-05:00,77.09,77.49001,76.28999,76.8401,55971008,39353739.2,26.97182587582705,38.612083395734,NaN,NaN,-193.2154631450655,-180.04091818770678,-0.4386549913416602,-1.3183002228707181,-0.8796452315290579,1781787088,1877151283.2,24.967822608421912,32.14749490530146,NaN,NaN,-29.505496476573473,-17.72521807524319
2012-11-16T09:30:00-05:00,76.78,77.67999,76.13,77.48,62750400,40717936.8,31.976752809323983,37.991919856243676,NaN,NaN,-153.9814282346914,-173.54778903736832,-0.3998588158620089,-1.379468751356569,-0.9796099354945602,1844537488,1856663484.8,22.848387688902193,31.810583228916165,NaN,NaN,-30.65845828625133,-19.572823819672927
2012-11-19T09:30:00-05:00,78.32001,79.17999,78.22,79.1194,45625376,41427562.4,42.793782801653236,38.30515993400007,NaN,NaN,-66.90492182205206,-153.5841793484695,-0.241027269961823,-1.280894022946839,-1.039866752985016,1890162864,1849331763.2,22.124601600685963,31.59608455642157,NaN,NaN,-27.94084245698118,-20.768255053574105
2012-11-20T09:30:00-05:00,78.98,79.35001,78.64,79.26109,36934752,40595896.8,43.628139951832175,38.37145637201214,NaN,NaN,-49.5128760727151,-131.0118314571677,-0.11031709481967811,-1.1777631215096136,-1.0674460266899355,1927097616,1856268630.4,24.55961125791923,31.63593403533889,NaN,NaN,-25.561077641580727,-21.45294399471791
2012-11-21T09:30:00-05:00,79.41,79.73,79.13,79.67999,19257504,40024212.8,46.129716880266805,38.14013530848791,NaN,NaN,-25.75270885280504,-97.87347962546582,0.013857436124373734,-1.0501242315344683,-1.063981667658842,1946355120,1877988035.2,31.75479324451716,31.89617418413658,NaN,NaN,-22.832657946301428,-21.65004598780127
2012-11-23T09:30:00-05:00,79.89999,80.56,79.86,80.47,20093264,38991984,50.58351248454959,38.788110471442515,NaN,NaN,13.29312929105726,-56.57176113824126,0.15107790712012692,-0.8751342837586833,-1.0262121908788102,1966448384,1914920294.4,41.901904061011564,32.66147368353178,NaN,NaN,-19.0934987858881,-21.28482495895653
2012-11-26T09:30:00-05:00,80.35001,80.78999,80.07001,80.73,31180688,39327286.4,51.99032188351644,39.26093821757514,NaN,NaN,27.243633666728744,-20.32674875795724,0.2551136596525122,-0.7073201163131699,-0.9624337759656821,1997629072,1945538611.2,48.71051763436798,33.70051271330314,NaN,NaN,-15.630784931494546,-20.47710495503339
2012-11-27T09:30:00-05:00,80.67999,81.23,80.57001,80.63,39946224,39934787.2,51.38441464992386,39.39669387702214,NaN,NaN,44.061799834829344,1.8665955734190476,0.3093403328793133,-0.5757583598665406,-0.8850986927458538,1957682848,1959042608,51.41488519354138,34.45482114889365,NaN,NaN,-12.993289208266152,-19.407988419780928
2012-11-28T09:30:00-05:00,80.315,81.31,79.63,81.31,51324736,40430736,55.20724481042646,40.5445522561778,NaN,NaN,42.744462166935485,20.318063221349156,0.3785777169297583,-0.411876546583656,-0.7904542635134143,2009007584,1975424601.6,54.54599747916268,35.32899141269307,NaN,NaN,-9.567613089766239,-18.002220515493114
2012-11-29T09:30:00-05:00,81.94901,82.41,81.62,82.24001,53045936,41839044.8,59.85654532109493,42.34001583148746,NaN,NaN,107.47596840681881,46.963798673273914,0.4686861845731557,-0.20459653279696965,-0.6732827173701253,2062053520,1998564281.6,58.60414258182311,36.74597529163086,NaN,NaN,-5.104117817537377,-16.159634415785153
2012-11-30T09:30:00-05:00,82.39999,82.41,81.73,82.08,35722912,39769528,58.72710669401237,43.97107730735614,NaN,NaN,107.73499164013342,65.85217114308915,0.4965218477668464,-0.05263040766156735,-0.5491522554284137,2026330608,2010540726.4,60.56649098542607,38.35719007895883,NaN,NaN,-1.7877564038520877,-14.106508985509
2012-12-03T09:30:00-05:00,82.71001,82.75999,81.75,81.99001,24959744,39051346.4,58.063537386989175,45.620111474476325,NaN,NaN,109.81218803450184,82.36588201664377,0.4872037711887088,0.05985245855747223,-0.42735131263123655,2001370864,2011289084.8,60.691882423843836,40.15310931411414,NaN,NaN,0.7565418266571746,-11.983216012342403
2012-12-04T09:30:00-05:00,82.065,82.32001,81.46001,82.0885,37225792,39569501.6,58.61469575570482,47.43588767301822,NaN,NaN,96.45735016300446,92.8449920822788,0.4660048366113801,0.15515473313298855,-0.31085010347839154,2038596656,2027471846.4,63.401996290346666,42.44159110592001,NaN,NaN,3.028566210581816,-9.8386756947818
2012-12-05T09:30:00-05:00,82.48,82.50999,81.39999,81.9933,40377248,40220998.4,57.823617649660456,49.553658211055755,NaN,NaN,99.01768394628455,104.09963643814861,0.4250475310001811,0.22045931027183485,-0.20458822072834626,1998219408,2025314211.2,62.78049775099319,44.919537914354486,NaN,NaN,4.74307212830586,-7.755568862912135
2012-12-06T09:30:00-05:00,81.98,82.31,81.61,82.12061,31829408,38557356.8,58.62775855343373,51.81479625945623,NaN,NaN,92.53618259266791,101.11167927531842,0.3870844099217317,0.27926729167381836,-0.10781711824791333,2030048816,2018913270.4,60.874071518007746,47.48426997932491,NaN,NaN,6.4140624928487044,-5.731335812089158
2012-12-07T09:30:00-05:00,82.5,82.55,81.83,82.17999,24123968,37630873.6,59.020218038622545,53.74647234726327,NaN,NaN,90.04690001953676,97.57406095119909,0.3477706976669465,0.3268962538357698,-0.02087444383117669,2054172784,2024481705.6,61.956380161688344,50.277698013095346,NaN,NaN,7.938980070696373,-3.778433543119797
2012-12-10T09:30:00-05:00,82.37,82.66,82.21001,82.53999,29177312,37438232.8,61.41025531960608,55.076220384259905,NaN,NaN,92.90285278773986,94.1921939018467,0.32806357711747397,0.3892050275656658,0.06114145044819182,2083350096,2040877552,65.02426253940956,53.34195950871846,NaN,NaN,9.90576728655201,-1.823547710309539
2012-12-11T09:30:00-05:00,83.11,83.56,82.92,83.41,40267104,38443837.6,66.49583291267544,56.70962702432014,NaN,NaN,115.9404943364013,98.08882273652605,0.35347849170072854,0.5029895650741025,0.14951107337337396,2123617200,2057881660.8,67.91411463894775,56.4387097502205,NaN,NaN,13.17311110444042,0.31883212036902653
2012-12-12T09:30:00-05:00,83.67,83.8,82.77,82.94,40574752,38752165.6,61.760632026087926,57.82612096330736,NaN,NaN,101.11746548056499,98.50877904338213,0.3195207752512385,0.5489120424374221,0.22939126718618358,2083042448,2074846268.8,70.53024786384138,59.20838508017222,NaN,NaN,14.738372130894135,2.378766407586899
2012-12-13T09:30:00-05:00,82.98,83.21001,82.11,82.41,33439280,37691370.4,56.844796028222675,58.27335550214116,NaN,NaN,70.14274969274595,94.03009246339775,0.24557225120991322,0.5363565811985751,0.2907843299886619,2049603168,2078757139.2,71.11494808773719,61.2950310820812,NaN,NaN,14.716218957521637,4.141259629006147
2012-12-14T09:30:00-05:00,82.22,82.81,82.12,82.36,28513024,36318471.2,56.38880389062825,58.587532788363426,NaN,NaN,58.76316778678654,87.7733460168477,0.18050753734291247,0.5164187516673024,0.33591121432439,2021090144,2072140611.2,68.63389070152951,62.71812915830702,NaN,NaN,14.572645848176247,5.631457660316162
2012-12-17T09:30:00-05:00,82.67999,83.5275,82.52,83.52,35849360,34973419.2,63.670027649906764,59.46507657407649,NaN,NaN,96.60712734922548,88.51420092914483,0.20122978342926146,0.5874484436109668,0.38621866018170536,2056939504,2066858492.8,66.63521480656573,63.80529555923733,NaN,NaN,16.629035296070537,7.2025401797096436
2012-12-18T09:30:00-05:00,83.71001,84.77,83.49001,84.6615,53506608,35367480.8,69.13165788808581,60.459677508195014,NaN,NaN,162.92352779268427,97.91080762040141,0.2729960695013964,0.7274637470584508,0.4544676775570545,2110446112,2064224275.2,65.60909981278832,64.5955171544963,NaN,NaN,20.30409288534713,9.074190566229284
2012-12-19T09:30:00-05:00,84.08,84.52,83.75999,84.12,49010880,35971287.2,64.20098547098867,60.76999466175886,NaN,NaN,151.51376305446993,107.99006713518243,0.26496632217621874,0.7856755802773279,0.5207092581011091,2061435232,2059902832,63.87145547400397,64.97175378965208,NaN,NaN,21.751818133359794,10.885280218676499
2012-12-20T09:30:00-05:00,84.14,84.61,83.85001,84.53999,50304528,37523638.4,66.21375599767967,61.30475532630652,NaN,NaN,150.01493246374983,123.96450368938319,0.2680990333855997,0.8558330498331088,0.5877340164475091,2111739760,2072330150.4,66.61015573932137,65.40344412921603,NaN,NaN,23.58048662020803,12.698881133181004
2012-12-21T09:30:00-05:00,83.27,84.19,83.08,84.19,54924592,39265204.8,63.033263643108675,61.6597357731722,NaN,NaN,99.90474019488116,132.1928181710021,0.22831455873926265,0.8731272148715874,0.6448126561323247,2056815168,2079475155.2,68.1070743277235,65.93310069377887,NaN,NaN,24.095729536351765,14.32700233363397
2012-12-24T09:30:00-05:00,83.89,83.97,83.50999,83.78,10105117,38211426.25,59.43180871707473,61.71810098469863,NaN,NaN,83.56228966714073,129.5838506345852,0.15936591827595992,0.8440200539772746,0.6846541357013147,2046710051,2077429264.6,67.17836926997535,66.2028416208952,NaN,NaN,23.417744765266978,15.625679823867257
2012-12-26T09:30:00-05:00,83.97,84.00999,83.08,83.1808,24673136,37447771.85,54.528343222973454,61.48272423993526,NaN,NaN,50.39592078567586,107.0783292331835,0.06331461618920609,0.7637974059378223,0.7004827897486162,2022036915,2059747425.2,59.61259574264078,65.97656290601289,NaN,NaN,21.30380711437591,16.43684086536849
2012-12-27T09:30:00-05:00,83.25999,83.435,82.05,83.12,35568384,36659954.25,54.04112334134401,61.15510743907172,NaN,NaN,-3.963391378599558,75.98289834656958,-0.010473817782755912,0.6873905175201713,0.6978643353029272,1986468531,2044754085,54.05350948288083,65.48937990350382,NaN,NaN,19.458185506845357,16.868461528436615
2012-12-28T09:30:00-05:00,82.69,83.37,82.52,82.53,34262144,35720764.65,49.42592255804393,60.46980061903039,NaN,NaN,-13.565410101303295,43.26682983355898,-0.10018864142834016,0.5726285335175021,0.6728171749458423,1952206387,2012847410.4,44.53561898231327,64.24503981926274,NaN,NaN,16.450599589864005,16.808766965783384
2012-12-31T09:30:00-05:00,82.66,84.42999,82.35001,84.31779,67461056,37307671.85,60.44840486888106,60.401097015407174,NaN,NaN,65.36851500699866,36.359584795982485,-0.04320946524479241,0.6188053433898517,0.6620148086346441,2019667443,2005417865.4,42.65229693913265,62.647042276385825,NaN,NaN,17.271499676241113,16.874871638705915
2013-01-02T09:30:00-05:00,86.34,86.91,86.03999,86.8,116410560,41880212.65,70.16955877473723,60.66350600555444,NaN,NaN,274.18060454663737,74.4832477718818,0.14714247074738906,0.8459428970688805,0.6988004263214914,2136078003,2023291455.8,48.31490711403518,61.2470988817492,NaN,NaN,21.97040124437516,17.602804439515808
2013-01-03T09:30:00-05:00,86.85001,87.28,86.37,86.60001,45872896,42312567.85,68.704373180282,61.1594875165683,NaN,NaN,229.6143097840732,110.32692557156129,0.23960420035506824,0.9983056767653267,0.7587014764102584,2090205107,2036925094.2,52.192657860641425,59.93727102437778,NaN,NaN,24.883403685622195,18.642890046102433
2013-01-04T09:30:00-05:00,87.00999,87.44,86.66,87.24001,29853408,41786375.85,70.80527004890078,62.156664232331025,NaN,NaN,207.384430049091,152.59648985709939,0.31892334138825107,1.1573556531455722,0.8384323117573211,2120058515,2063643091,58.7277217468337,59.05246914288467,NaN,NaN,27.938926558127232,19.970895262105977
2013-01-07T09:30:00-05:00,86.8,87.07001,86.62,86.91,23694000,41379605.45,68.26064794602972,63.00465309343112,NaN,NaN,157.70842855440733,186.8512575882415,0.3232162591891965,1.2424526357438168,0.9192363765546203,2096364515,2092474716.6,64.3853435967953,58.749001492546526,NaN,NaN,29.469642008182994,21.327859082974122
2013-01-08T09:30:00-05:00,86.88,87.00999,86.39,86.84869,23769744,41361894.25,67.77333776401309,63.297746673010145,NaN,NaN,128.05875183465392,199.38930495377258,0.2966702829560075,1.2900742302496297,0.9934039472936222,2072594771,2103060182.2,66.2164207820013,58.71908763364906,NaN,NaN,30.509112112844615,22.639466658669907
2013-01-09T09:30:00-05:00,87.02,87.35001,86.96001,87.27,27426512,41274354.25,69.39047474208871,63.316233591153214,NaN,NaN,125.66237565635069,169.68565917571522,0.28231017865677455,1.3462916706145904,1.0639814919578159,2100021283,2095848838.2,63.80954075575344,58.59054770100371,NaN,NaN,31.86311600708177,23.957130851300175
2013-01-10T09:30:00-05:00,87.61,87.69,86.95,87.47,39754016,41248699.85,70.15607201122673,63.74159691545593,NaN,NaN,112.84842506768553,146.3324822324377,0.2615737940203666,1.390948734483274,1.1293749404629074,2139775299,2105762876.6,65.65769110286035,58.718135960207746,NaN,NaN,33.19313371720951,25.276559832144365
2013-01-11T09:30:00-05:00,87.39999,87.53999,87,87.34,27322368,40586080.65,68.94889998340818,63.936964343007965,NaN,NaN,95.21996879923759,123.899589982467,0.21627190729823442,1.3997148245857005,1.183442917287466,2112452931,2104241759.8,65.1083067895018,58.61086103522063,NaN,NaN,33.94526652052775,26.51494650191342
2013-01-14T09:30:00-05:00,87.16,87.52,87.05,87.39,24354832,40131858.25,69.16863937858173,64.37520546697033,NaN,NaN,85.35500518959732,109.42890530950501,0.16894189160457151,1.3946202817931805,1.225678390188609,2136807763,2112330409.4,66.70375969169967,58.51062427550465,NaN,NaN,34.62546897351366,27.673592569284885
2013-01-15T09:30:00-05:00,86.83,87.88499,86.77,87.77,34705472,40441480.65,70.85662614636952,65.19126385477709,NaN,NaN,82.31667942103185,100.28049082678058,0.14349657791017,1.4050491125763216,1.2615525346661516,2171513235,2132114102.2,70.28294167498578,58.73237944729111,NaN,NaN,35.6720572548167,28.816230381503715
2013-01-16T09:30:00-05:00,87.57001,87.75,87.3,87.50999,20884016,39693213.45,68.10891274245952,66.16130453474038,NaN,NaN,76.61959597417524,90.47193489034551,0.09193105609465402,1.376466354784469,1.284535298689815,2150629219,2142235689.4,71.94456122488339,59.61323412459415,NaN,NaN,35.83370850927001,29.8187272568989
2013-01-17T09:30:00-05:00,87.91,88.50999,87.83,88.32001,34222112,38728988.65,71.78032643060601,67.42839046968767,NaN,NaN,94.7339954815041,86.84904897310922,0.09477432906512817,1.4030032100212253,1.3082288809560971,2184851331,2151250895.8,73.3726820035838,60.993175018930074,NaN,NaN,37.018430417119255,30.847256279787523
2013-01-18T09:30:00-05:00,88.34,88.62,88.11,88.57001,23257136,37441301.45,72.82033529686929,69.09941995103235,NaN,NaN,95.36681854025636,86.87841892131298,0.09561575350856799,1.4277485728418071,1.3321328193332391,2208108467,2170382003,76.14747933402481,63.251165044052335,NaN,NaN,38.30894221920694,31.913211413990297
2013-01-22T09:30:00-05:00,88.64,89.25999,88.381,89.21001,31590224,36505586.25,75.32718557743566,70.16219000164338,NaN,NaN,108.1348585562049,91.4343895946345,0.11982931046336498,1.4819194574124452,1.3620901469490803,2239698691,2190960188.6,78.7166633727706,65.82719121788361,NaN,NaN,40.18132213805525,33.09437008885672
2013-01-23T09:30:00-05:00,89.24001,89.285,88.91,89,32818864,35400299.85,72.94951652912142,70.36075841267083,NaN,NaN,109.29296997399845,96.82964770522781,0.10290398495707676,1.4907201281454263,1.3878161431883496,2206879827,2198033507,79.53272285637328,68.05703519947919,NaN,NaN,41.08083716058637,34.23529395624667
2013-01-24T09:30:00-05:00,89.14999,89.85001,88.92999,89.28999,39817904,36885939.2,74.16229459985557,70.75060994264037,NaN,NaN,120.63344645199653,105.63241780079208,0.09275515135936674,1.5037600823875579,1.4110049310281911,2246697731,2217247209.4,81.5968942662413,70.15733779987919,NaN,NaN,42.18451289495438,35.37089666177634
2013-01-25T09:30:00-05:00,89.73,89.94,89.28999,89.94,34620720,37383318.4,76.6855078844801,71.17062693089603,NaN,NaN,134.61059835565533,113.60773837562233,0.11014993781009008,1.5486923532908037,1.4385424154807136,2281318451,2236540633.4,83.4065851235224,71.92011375535694,NaN,NaN,43.90121609409772,36.58951372353654
2013-01-28T09:30:00-05:00,90.00999,90.23,89.38,90,42633552,37736576.8,76.9096617389612,71.78841363039113,NaN,NaN,137.92522692220783,122.11942005201263,0.10599255443091615,1.5710331085193587,1.4650405540884426,2323952003,2259709340.6,85.2787157394807,73.41249747983447,NaN,NaN,45.3752132554371,37.844613656665196
2013-01-29T09:30:00-05:00,89.96001,90.1601,89.6499,90.05,37056208,37876280,77.10718709277197,72.45511715387393,NaN,NaN,127.71069447687368,126.03458723614638,0.08766487033397263,1.5746216420059085,1.4869567716719359,2361008211,2283971244.6,86.9403643774487,74.89277916522357,NaN,NaN,46.6557966723583,39.10335408747849
2013-01-30T09:30:00-05:00,89.97,90.02,88.69,88.97,39299264,36468190.4,64.31012342005093,72.09223491658551,NaN,NaN,75.80402273885909,119.3367977891185,-0.010897482329341956,1.4733349187602585,1.4842324010896004,2321708947,2306937068.6,88.28798306419876,76.64123933011253,NaN,NaN,44.075731923961754,39.81369377840468
2013-01-31T09:30:00-05:00,88.87,89.67999,88.75999,89.58,36925056,32493915.2,67.58265383901772,71.9084193328563,NaN,NaN,74.87512799857426,110.18513409843403,-0.04670588003463161,1.4258500510463108,1.4725559310809424,2358634003,2329324323,89.4327127924587,78.33945516508383,NaN,NaN,42.798979145022976,40.24016311649301
2013-02-01T09:30:00-05:00,89.96001,90.7,89.85001,90.37,33927472,31896644,71.25829505216089,72.0733761234815,NaN,NaN,122.5254791236633,107.76811025203563,-0.02971054750467661,1.4354177467000966,1.4651282942047732,2392561475,2351572927.8,90.43343581261131,80.1483929524488,NaN,NaN,42.82321040711983,40.60916987229684
2013-02-04T09:30:00-05:00,89.82001,90.17999,89.14999,89.28,27015168,31754732,60.98392676389954,71.48875379386133,NaN,NaN,66.9089177441038,93.56484841641482,-0.1004192748858137,1.3396042005975062,1.4400234754833199,2365546307,2359891788.6,90.78483383150467,81.86846967672058,NaN,NaN,39.35228735686316,40.42961522723488
2013-02-05T09:30:00-05:00,89.71001,90.38,89.58501,90.08,26551568,31897610.4,64.97546465937224,71.06867083050439,NaN,NaN,89.14551161349856,85.8518118437398,-0.10154827912370301,1.3130881265786911,1.4146364057023941,2392097875,2366109721.4,91.04947575380626,83.35179353949347,NaN,NaN,37.775602285569185,40.05047052128264
2013-02-06T09:30:00-05:00,89.64999,90.52,89.57001,90.46001,24300160,31924131.2,66.7172918943677,70.96926934135497,NaN,NaN,93.71269534737623,89.4335463654432,-0.08557820816845241,1.3076636454918287,1.393241853660281,2416398035,2385047539,91.81998549553337,84.77146670168277,NaN,NaN,37.08237819818831,39.62645733226916
2013-02-07T09:30:00-05:00,90.39,90.55,89.55,90.16,30212224,32063416.8,64.01077244936172,70.41430119983752,NaN,NaN,82.22788186591053,90.90409713891046,-0.10293018335722426,1.2645791244637508,1.367509307820975,2386185811,2390557900.6,92.03484701143101,86.10447848795755,NaN,NaN,35.659267874926584,39.05971598122022
2013-02-08T09:30:00-05:00,90.28,90.86,90.24001,90.8,25189536,31335192.8,67.07891677536492,70.00419987687292,NaN,NaN,115.19770296817155,89.43854190781211,-0.08003431142782991,1.2674664185361877,1.3475007299640176,2411375347,2394320675,92.18578640639096,87.25007185026944,NaN,NaN,35.42837017786717,38.540952295026926
2013-02-11T09:30:00-05:00,90.71001,90.75,90.25999,90.7,15725414,30755345.1,66.13026196727427,69.3472767618614,NaN,NaN,105.36049798534363,97.12885795606007,-0.08015476493537177,1.247307273794803,1.3274620387301748,2395649933,2400341400.2,92.43288161247699,88.22980172453416,NaN,NaN,34.95638560312528,38.028871339040975
2013-02-12T09:30:00-05:00,90.74001,91.24001,90.67999,91.10001,19792688,30527237.9,68.07520050503692,68.99911133156964,NaN,NaN,133.1585992803834,105.93147548943708,-0.06260293194615052,1.2492083737974866,1.3118113057436371,2415442621,2405010349.4,92.62757204304314,89.1651480950106,NaN,NaN,35.14018058687233,37.61620123158831
2013-02-13T09:30:00-05:00,91.19009,91.55,90.98,91.48,22591248,29921526.7,69.84659930247878,68.69084738175702,NaN,NaN,151.4415507713539,117.4772465742326,-0.03602949312262771,1.2667744393403524,1.30280393246298,2438033869,2409337516.2,92.81215100232106,89.96623786187342,NaN,NaN,35.82127619521568,37.359783369249364
2013-02-14T09:30:00-05:00,91.17999,91.875,91.16,91.71001,22359280,29995289.9,70.89917351139677,68.27753778367965,NaN,NaN,163.6012278972961,133.7519157805097,-0.014683764829886758,1.2844492264256218,1.2991329912555085,2460393149,2424178983.8,93.42058930662382,90.68152387495209,NaN,NaN,36.69334554399801,37.264577965642026
2013-02-15T09:30:00-05:00,91.67,92.03,91.47,91.74001,29339088,29751138.7,71.04116318445318,67.8583593155005,NaN,NaN,161.11240089438238,142.93485536575184,-0.010464346239419609,1.286052558456234,1.2965169046956535,2489732237,2439850361.8,93.99829575334093,91.30435101879925,NaN,NaN,37.4473315949461,37.29068562697118
2013-02-19T09:30:00-05:00,91.88,92.56,91.87,92.55,21170544,29646809.1,74.6391409983537,67.68207030875634,NaN,NaN,183.40292897228332,158.5433415631398,0.03260043428958603,1.337267447557636,1.30466701326805,2510902781,2462900931.4,94.73111682076032,91.86083333617866,NaN,NaN,39.202641863534915,37.563822232194575
2013-02-20T09:30:00-05:00,92.63,92.67999,90.74001,90.8299,41753760,30154985.9,58.12372466295694,67.24018468324962,NaN,NaN,91.06311788492465,150.12424528404804,-0.06378352786712616,1.2249376034341424,1.2887211313012685,2469149021,2473642211.4,95.03532655254307,92.34278644248897,NaN,NaN,35.28957604443964,37.238929919658155
2013-02-21T09:30:00-05:00,90.77,90.8199,89.37,89.95,45093360,30768710.7,51.80850761866517,66.11345995322444,NaN,NaN,-33.41356182378911,113.15322276501942,-0.1887536771032694,1.0527790349221817,1.2415327120254511,2424055661,2470846569.8,93.52184291601556,92.63486716560017,NaN,NaN,29.766364373722894,36.17142055595312
2013-02-22T09:30:00-05:00,90.41,91.03,90.37,91.03,24765504,30016090.7,57.86051183352613,65.15647543760767,NaN,NaN,30.628982941507598,86.55877377386173,-0.19958350574067207,0.992053329849611,1.191636835590283,2448821165,2468532173,92.21258899467055,92.76194953574725,NaN,NaN,27.21557258308073,34.89201370268564
2013-02-25T09:30:00-05:00,91.5,91.53,88.97,89.02,53492720,30959690.7,46.22548673881572,64.10230115010168,NaN,NaN,-62.03366318172441,41.92956095864038,-0.3350463651950655,0.7728288790964513,1.1078752442915167,2395328445,2449651414.6,82.11330349098259,92.14255451142425,NaN,NaN,20.299280994381625,32.80733760149935
2013-02-26T09:30:00-05:00,89.41,89.78,88.78999,89.37,47522800,31204153.1,48.17956857506353,62.902594286936775,NaN,NaN,-105.73717361201464,-15.898459558219221,-0.3901522818392522,0.6201848919924515,1.0103371738317037,2442851245,2436041107.4,75.6788982255809,91.044656116551,NaN,NaN,15.831049568331885,30.38215359676114
2013-02-27T09:30:00-05:00,89.36,90.85001,89.31,90.31,41199328,31411309.1,53.108008119005966,61.93050258869664,NaN,NaN,-29.536656645655967,-40.01841446433534,-0.3534616226715708,0.5685101454922403,0.9219717681638111,2484050573,2439021417.8,76.12016822629363,89.92324059731959,NaN,NaN,13.997343903276697,28.041466497691932
2013-02-28T09:30:00-05:00,90.3,91.05,90.17999,90.48,31218128,31007252.3,53.960797825032344,61.2126472583874,NaN,NaN,2.9183183611668815,-32.75203842734414,-0.309492023765799,0.5351067384565624,0.8445987622223614,2515268701,2457264025.8,78.67110463870621,88.96868757069639,NaN,NaN,12.886793172106954,25.876513165465507
2013-03-01T09:30:00-05:00,89.88,91.06,89.21001,90.89,49278800,31624939.5,56.03736781817198,60.423965190016474,NaN,NaN,-22.565872020084278,-43.39100941966252,-0.24724345123745495,0.5355444481755427,0.7827878994129976,2564547501,2480409293,81.38771864330442,88.19739701619021,NaN,NaN,12.673025614277659,23.990300658152957
2013-03-04T09:30:00-05:00,90.67,91.17,90.2,91.13,27577536,31307442.7,57.25282121312073,59.789862279005504,NaN,NaN,23.283353086666928,-26.327606165984246,-0.18708663020929872,0.5489296116513742,0.7360162418606729,2592125037,2519768611.4,84.90799372980389,87.6599050245707,NaN,NaN,12.880166171841031,22.403138588679823
2013-03-05T09:30:00-05:00,91.61,92.35001,91.60001,92.19,35615216,31737445.1,62.22087031665871,59.371695836978496,NaN,NaN,135.62000195507105,21.943828947432923,-0.07863750585576512,0.6377193595409665,0.7163568653967316,2627740253,2556746413,87.33213826356007,87.28165975460763,NaN,NaN,14.674491583059869,21.299046159305544
2013-03-06T09:30:00-05:00,92.47,92.60001,92.12,92.42999,28483552,31834044.3,63.2619092424322,58.901360832689456,NaN,NaN,146.07886122768844,57.06693252210181,0.002243324617894671,0.7191610211691,0.7169176965512053,2656223805,2591181059.4,89.08961934676377,87.01576463635354,NaN,NaN,16.441215887182445,20.6050704061451
2013-03-07T09:30:00-05:00,92.48,92.94,92.32001,92.87,27908704,32014471.5,65.15764004708156,58.49125129952408,NaN,NaN,149.99689163916034,86.4826471777005,0.07436467191781826,0.8098735364484781,0.7355088645306599,2684132509,2624953821,90.48404497291884,86.80601146966032,NaN,NaN,18.492658847726663,20.303297326371037
2013-03-08T09:30:00-05:00,93.60001,93.75,92.92,93.73,38066080,32407164.3,68.57120664241722,58.31482583223579,NaN,NaN,179.2316043193545,126.84214244558825,0.16384831316054105,0.9403192559813363,0.7764709428207952,2722198589,2656484038.6,91.56760167509749,86.6323904640715,NaN,NaN,21.355021133674086,20.45354358455719
2013-03-11T09:30:00-04:00,93.42,93.75,93.33,93.7,26723520,32483863.5,68.3197549265717,57.86344111282279,NaN,NaN,159.80781143921573,154.147034116098,0.20235225929792355,1.0294112669431996,0.8270590076452761,2695475069,2677154045,92.19503629253408,86.45124185491248,NaN,NaN,23.569831074433637,20.898727511682395
2013-03-12T09:30:00-04:00,93.48,93.75,93.17999,93.50999,21488992,32772042.4,66.65262309462241,58.472648143656045,NaN,NaN,131.71281372170543,153.3655964694249,0.19621201358474893,1.0723240246262122,0.8761120110414633,2673986077,2686403209.8,92.46520520951368,86.26766175898182,NaN,NaN,24.93907812681163,21.47592045670086
2013-03-13T09:30:00-04:00,93.53999,94.02,93.25,93.86,28662864,33215551.2,68.1923507010191,59.64292264953847,NaN,NaN,126.62286636068413,149.47439749602404,0.1964271430941782,1.121645939909186,0.9252187968150078,2702648941,2695688237,92.73700286892644,86.2116017556183,NaN,NaN,26.539881656020185,22.19934348517505
2013-03-14T09:30:00-04:00,94.03,94.81,93.8735,94.8,24749968,33323487.2,71.93956630478044,60.6485693974852,NaN,NaN,146.5889050307146,148.7928001743349,0.23781850750822997,1.2224919312002953,0.9846734236920653,2727398909,2704341517,92.99076519819704,86.26718577015592,NaN,NaN,29.1150430165454,23.1873005610851
2013-03-15T09:30:00-04:00,94.64999,94.96001,94.39,94.75,35361632,33973604.8,71.45734012099601,62.45084463906951,NaN,NaN,134.26044412960675,139.7985681363853,0.23912701086186994,1.2835821872694027,1.0444551764075327,2692037277,2698309254.6,90.61397625148132,86.87437668162012,NaN,NaN,31.077548171010395,24.31447879107443
2013-03-18T09:30:00-04:00,93.74001,94.61,93.67,94.23,36701248,34341712.8,66.46724661248342,63.75710735602807,NaN,NaN,96.52055412616188,127.14111667377456,0.18470443870641473,1.2753357247905512,1.0906312860841365,2655336029,2690281446.6,87.41196313137665,87.71245274631983,NaN,NaN,31.376872341912854,25.32339215547992
2013-03-19T09:30:00-04:00,94.41,94.71001,93.00999,93.83,51516384,35859004.8,62.83239423504259,64.4517063643164,NaN,NaN,74.98307885240243,115.79516969991398,0.10544077015409492,1.2224322487767552,1.1169914786226602,2603819645,2676248160.2,81.9597168695769,88.1295633636972,NaN,NaN,30.603759609300933,26.077730363168634
2013-03-20T09:30:00-04:00,94.36,94.74001,94.25999,94.7,27961584,35169396,67.05269092753468,65.3868415859237,NaN,NaN,94.46545208847944,109.36368684547304,0.09557042831950602,1.2364545140220429,1.1408840857025369,2631781229,2662074617.8,76.75255438644888,87.99252405996454,NaN,NaN,31.15438260504334,26.802966397722162
2013-03-21T09:30:00-04:00,94.03999,94.47,93.5401,93.87,37125776,34771016.8,60.047545140344404,65.67328282322174,NaN,NaN,63.91664882400658,92.82923560413145,0.021004046100314255,1.1671391433279297,1.1461350972276154,2594655453,2635525926.6,68.03343772347114,87.03864685140502,NaN,NaN,29.475480346687082,27.18475410471715
2013-03-22T09:30:00-04:00,94.25,94.37,93.94,94.16,33429904,35204236.8,61.55868208680056,65.98084431419888,NaN,NaN,66.44014183942097,79.2651751460943,-0.018775756884294115,1.1226654011222479,1.141441158006542,2628085357,2622735542.6,64.24677904265603,85.56284580232303,NaN,NaN,28.541154937129747,27.378525652204665
2013-03-25T09:30:00-04:00,94.12,94.72,93.28,93.95,36682272,34363714.4,59.79495699865318,65.8075647914842,NaN,NaN,54.26093109108721,70.81325053907935,-0.06653272108818453,1.0582752566463114,1.124807977734496,2591403085,2609948953.8,60.61460363898871,83.6544504719965,NaN,NaN,27.257090642245657,27.361177793639094
2013-03-26T09:30:00-04:00,94.34,94.49001,93.75,94.25,26350592,33305104,61.49232316446835,65.68116578591534,NaN,NaN,58.847492059337526,67.58613318046636,-0.08408746634625386,1.0196986448016787,1.1037861111479326,2617753677,2612735760.2,61.13038128723801,81.65736203917322,NaN,NaN,26.652898517474018,27.259995039901227
2013-03-27T09:30:00-04:00,93.64999,94.38,93.24001,94.314,28469104,32668592.8,61.86223113983248,65.44577943539755,NaN,NaN,45.01881992565696,57.696806747901874,-0.09666111344504857,0.982959719341622,1.0796208327866705,2646222781,2615624070.6,61.6903416983573,79.60066894813312,NaN,NaN,26.254005012570484,27.11628217885398
2013-03-28T09:30:00-04:00,94.27,94.66,94.14,94.42999,24162832,32315828,62.56410624771047,65.01670083577564,NaN,NaN,71.74548698898737,59.26257438089804,-0.10191538278768109,0.9522266043020693,1.0541419870897504,2670385613,2630770102.6,64.57255774310985,77.6724515244197,NaN,NaN,26.10281624768012,26.97150133154343
2013-04-01T09:30:00-04:00,94.27,94.47,92.705,93.16,59669264,32835351.2,51.408273110166604,63.80873784888956,NaN,NaN,-15.503584980928276,42.873829016828175,-0.19052429039671814,0.8159866240938527,1.0065109144905708,2610716349,2627296301,63.39451576533651,75.61527148676274,NaN,NaN,22.603379593304577,26.347483940366452
2013-04-02T09:30:00-04:00,93.78,93.92,92.5,92.58,47917200,33852334.4,47.263374895292316,62.4237915489374,NaN,NaN,-85.1479804344056,14.99204671172962,-0.2822654518128346,0.6536790997245276,0.9359445515373622,2562799149,2621575513.8,61.407640278476904,73.3968739916887,NaN,NaN,18.31056137937413,25.199352145938978
2013-04-03T09:30:00-04:00,92.94,92.98,90.92,91.13,65445072,35343827.2,38.83364430267795,60.326741091913036,NaN,NaN,-231.81758644520576,-43.14096898917903,-0.4260386534171414,0.40339623476593545,0.8294348881830769,2497354077,2597495593.8,53.76871056074994,70.61342454110466,NaN,NaN,11.400313951874182,23.228060975358293
2013-04-04T09:30:00-04:00,91.25999,91.94,90.96001,91.91,37707872,35805043.2,44.5617349223265,58.37118170745204,NaN,NaN,-218.16912173411157,-95.77855732113274,-0.4516032823979377,0.2649307851856548,0.7165340675835925,2535061949,2575263427.4,47.85028654696177,67.389104637445,NaN,NaN,7.535646040086896,20.986287413176665
2013-04-05T09:30:00-04:00,90.52,91.75,90.42,91.73,46419696,36730592.8,43.54821972459203,56.3776731077089,NaN,NaN,-213.8071860284732,-152.88909192462486,-0.461972590078606,0.13906832998533503,0.601040920063941,2488642253,2538914755.4,40.08211913442595,63.77968627194103,NaN,NaN,4.164592600013459,18.58318815415335
2013-04-08T09:30:00-04:00,91.99001,92.52,91.33,92.49001,28889904,36271784,48.839209316393436,55.11852758655961,NaN,NaN,-116.9487046706923,-173.17811586257764,-0.40123201736210223,0.09950089836131326,0.5007329157234155,2517532157,2520277917,36.78473154593025,60.16345544440914,NaN,NaN,3.0027320209344244,16.357408706550647
2013-04-09T09:30:00-04:00,92.64,92.83,92.03999,92.22,36828512,36777033.6,47.148487127978825,53.99824850748363,NaN,NaN,-83.82460249689166,-172.91344027507486,-0.3639242515878074,0.04582760123865626,0.40975185282646365,2480703645,2503858816.2,34.121498147230355,56.7464398213844,NaN,NaN,1.5389375638051275,14.240484257587001
2013-04-10T09:30:00-04:00,92.50999,94.10001,92.45,93.89,50119552,38208561.6,57.05160359182097,53.28388512636121,NaN,NaN,1.8249119010406267,-126.18494060582559,-0.21862308699943755,0.13647299407716673,0.3550960810766043,2530823197,2510552640.2,36.1510719639059,53.8463339340599,NaN,NaN,3.6197121143371853,12.723231094265598
2013-04-11T09:30:00-04:00,93.83,94.575,93.75,94.02,32618912,38406364,57.71581147847708,53.11733272194213,NaN,NaN,48.19044030996903,-72.91302819700947,-0.11103159540176194,0.21630658682440185,0.3273381822261638,2563442109,2516228672.2,37.898183651575565,51.69381578606736,NaN,NaN,5.452686093240105,11.684581808404813
2013-04-12T09:30:00-04:00,93.7,93.94,92.91499,93.64,41932704,39265500.8,55.036443490161005,52.65145853646787,NaN,NaN,5.619646789133414,-29.027661633488144,-0.06500986513464657,0.24607585080785555,0.3110857159425021,2521509405,2522802102.6,39.947596113332814,49.95815986254427,NaN,NaN,6.111239280231176,10.888390018665723
2013-04-15T09:30:00-04:00,93.06,93.14999,89.78999,90.11,100203936,42507616,37.58235040590905,51.06484377984329,NaN,NaN,-154.1846749095539,-36.4748556812605,-0.2608688740057958,-0.015000376564742623,0.24586849744105316,2421305469,2503556765,36.18276915390756,48.21302882789562,NaN,NaN,-0.19291047447872173,9.30534709107366
2013-04-16T09:30:00-04:00,90.81,91.8,90.49001,91.67,58063248,43575716,45.76773755134058,49.94165909319131,NaN,NaN,-114.02960477918553,-42.515856137719275,-0.27264030950937135,-0.094931889445661,0.17770842006371032,2479368717,2503289779.4,36.13189559692552,46.42742270715901,NaN,NaN,-1.952393071506266,7.697098496419385
2013-04-17T09:30:00-04:00,90.92,91.02,89.23,90.076,77711440,44885468.8,39.996113801730075,48.379793569041134,NaN,NaN,-158.41421015822007,-74.5636805495714,-0.36907165156071736,-0.2836311443871864,0.08544050717353097,2401657277,2477456595.4,31.514700099014192,44.27201973577736,NaN,NaN,-5.696338897959101,5.783750297222459
2013-04-18T09:30:00-04:00,90.14999,90.37,89.13,89.58,58516576,46413218.4,38.37445733844934,46.651961504093904,NaN,NaN,-154.658247816725,-115.1334181749102,-0.44259810878445555,-0.46780712880703845,-0.025209020022582906,2343140701,2433396313.8,25.523858243233505,41.482826914357624,NaN,NaN,-9.08739217779444,3.6593013722200447
2013-04-19T09:30:00-04:00,89.96001,90.69,89.21001,90.61,44933600,46803609.6,43.49772697032472,46.0869224941052,NaN,NaN,-114.63759879890615,-139.18486729251813,-0.3995193239511679,-0.5246081749615428,-0.12508885101037487,2388074301,2406709293,22.708113730771785,38.57665534046014,NaN,NaN,-9.897871878803588,1.722562336359526
2013-04-22T09:30:00-04:00,90.7,91.07001,89.2,90.87,49192656,47591747.2,44.74645373396503,45.90714241115326,NaN,NaN,-94.17663416375218,-127.18325914335779,-0.33384190928661617,-0.542391237618645,-0.2085493283320289,2437266957,2409901590.6,23.791143337847288,35.889762701843736,NaN,NaN,-10.087781311600354,0.03537038665097181
2013-04-23T09:30:00-04:00,91.60001,92.34,90.8582,92.31,55313120,48523289.6,51.181605852169675,46.789139664688385,NaN,NaN,-18.096854199664758,-107.99670902745363,-0.18137729331014957,-0.43527094496971586,-0.2538936516595663,2492580077,2412543862.6,24.73125605251107,33.815658808398105,NaN,NaN,-7.990096493964079,-1.111124882008321
2013-04-24T09:30:00-04:00,92.28999,92.86,91.92999,92.78999,41022832,49256901.6,53.14067198800804,47.40192088366564,NaN,NaN,23.781262084681984,-71.55761457887323,-0.04336078790547665,-0.3080946365414121,-0.26473384863593546,2533602909,2438932989,33.54811618734672,32.794075211282745,NaN,NaN,-5.6789576154420365,-1.7636724153559946
2013-04-25T09:30:00-04:00,93.03,93.89999,92.89,93.39999,36544336,49660663.2,55.580299716499084,48.261355168801856,NaN,NaN,75.94970921237115,-25.43602317305398,0.08676063090397937,-0.15628306000596126,-0.24304369090994063,2570147245,2484334297.8,45.39848839621923,33.173815872839405,NaN,NaN,-3.0108692319538655,-1.9418433891556903
2013-04-26T09:30:00-04:00,93.09,93.36,92.5,92.89999,32406320,50072837.6,53.13822256267487,48.568427543536245,NaN,NaN,56.50220788724157,8.791938164175571,0.13407703073407734,-0.07544740249234394,-0.20952443322642128,2537740925,2514267622.6,51.535032865656994,34.22740882424846,NaN,NaN,-1.5945075034668017,-1.8922239769144205
2013-04-29T09:30:00-04:00,93.31,93.78,93.07001,93.57001,20792864,48129017.6,55.93243847442779,49.19585263971117,NaN,NaN,90.21368132841775,45.67000126260956,0.2013747993478669,0.04219406595841235,-0.15918073338945454,2558533789,2538520989,55.86336148810769,35.78039906288255,NaN,NaN,0.4523736921996589,-1.5572814527552663
2013-04-30T09:30:00-04:00,93.58,94.14,93.17,94.10001,30495696,47257942.4,58.0626137999862,49.26806765458012,NaN,NaN,104.11513353255447,70.11239880905342,0.2682739193874052,0.17616166584480197,-0.09211225354260323,2589029485,2557810870.6,58.999690776795156,37.412443263803205,NaN,NaN,2.7985527390510367,-0.9350194253543659
2013-05-01T09:30:00-04:00,93.81,93.89999,91.75999,91.8199,120179248,49994651.2,47.43851643704603,48.53397515162076,NaN,NaN,24.355960029954367,70.22733839810789,0.15147010600650868,0.09722537896553263,-0.05424472704097606,2468850237,2544860336.2,56.116611084875,38.71375950903888,NaN,NaN,1.4658101617819632,-0.5920437700491761
2013-05-02T09:30:00-04:00,92.34,93.47,92.17,93.28,38835776,50051046.4,53.327833134207424,48.41193155476692,NaN,NaN,48.187709243368374,64.67493840430731,0.16399413515811895,0.15074794190667262,-0.013246193251446325,2507686013,2532368089.8,53.40560028435089,39.675045521254454,NaN,NaN,2.350097238273445,-0.17173791171737307
2013-05-03T09:30:00-04:00,94.53,95.47,94.35001,94.75999,51982320,50329177.6,58.41415342426108,49.899917484649215,NaN,NaN,140.9713877002109,81.56877436690118,0.25781737773603397,0.30902552891859614,0.05120815118256217,2559668333,2536753571.4,54.241346621651914,40.96494391180762,NaN,NaN,4.8734755443071665,0.549006867714704
2013-05-06T09:30:00-04:00,94.83,95.5,94.74001,95.37,26895248,50229444.8,60.33299031432042,50.940292682004916,NaN,NaN,139.96034668547554,91.51810743831274,0.34157131372752636,0.4781722933419701,0.13660097961444376,2586563581,2542359529.8,55.343997097363065,42.3372368761246,NaN,NaN,7.519517800465993,1.5447941438220307
2013-05-07T09:30:00-04:00,95.50999,96.17,95.13,96.14999,29923008,49884169.6,62.70275913517321,52.562195920108,NaN,NaN,146.9862707356913,100.09233487894011,0.4246927000830159,0.6674668547182137,0.24277415463519775,2616486589,2547850950.6,56.45103380290104,44.11840356925937,NaN,NaN,10.453712825252325,2.8174968125977866
2013-05-08T09:30:00-04:00,95.92999,96.47,95.67999,96.42999,37669520,49261668,63.54471759641326,54.36007165281971,NaN,NaN,145.7780790918612,124.3767586913215,0.4701841018546603,0.8305042819535231,0.3603201800988628,2654156109,2584912125,63.099656898893265,46.80238918752078,NaN,NaN,13.055279856758533,4.280037247477893
2013-05-09T09:30:00-04:00,96.3,96.50999,95.75,96.10001,32334064,49247425.6,61.77485335874565,55.66558068056406,NaN,NaN,130.7631361982355,140.8918440822949,0.4497058805991549,0.9224525308478064,0.47274665024865153,2621822045,2607739331.4,66.49285745263295,49.929870881939436,NaN,NaN,14.653380665207266,5.76194345001066
2013-05-10T09:30:00-04:00,96.21001,96.935,96.07001,96.83,39288864,49115233.6,64.15345533436465,57.051795080592676,NaN,NaN,131.58630943600014,139.01482842945276,0.45557251831986656,1.0422122981484847,0.5866397798286181,2661110909,2628027846.6,69.20344503538655,53.17360671747796,NaN,NaN,16.717345327008353,7.3270008610103305
2013-05-13T09:30:00-04:00,96.74001,97.12,96.42999,96.75999,22528144,45231444,63.743781441568025,57.949093336978265,NaN,NaN,121.13083347065208,135.2489257864881,0.4255515914424317,1.1185792691316578,0.6930276776892261,2638582765,2638431683.4,70.52041353701566,56.444260823514,NaN,NaN,18.280758956476255,8.891823446076891
2013-05-14T09:30:00-04:00,96.94,98.03,96.92999,98,33543888,44005476,67.68048622340253,58.9876514966493,NaN,NaN,132.24709910444466,132.30109146023875,0.4572432787239593,1.2645817760941753,0.807338497370216,2672126653,2649559696.2,71.90436503870009,59.183992884324944,NaN,NaN,20.85099463362274,10.600276472869155
2013-05-15T09:30:00-04:00,97.8,98.67,97.69,98.2,34001840,41819996,68.2787465084523,59.894683410360244,NaN,NaN,131.64217675927668,129.47391099372186,0.4585407479029596,1.3805144322489156,0.921973684345956,2706128493,2659954173,73.17134037568027,61.16776802571503,NaN,NaN,23.135324920820917,12.390997679719407
2013-05-16T09:30:00-04:00,98.03,98.56,97.7,97.95,42053296,40996832,66.6187151062275,60.85757573489972,NaN,NaN,115.53576739677167,126.42843723342908,0.4109566386951551,1.4356694827149,1.0247128440197448,2664075197,2668404803.4,74.19035969597766,62.78600565645222,NaN,NaN,24.594054396649238,14.134291496423668
2013-05-17T09:30:00-04:00,98.39999,99.0715,97.9565,99.05,35679328,40534118.4,70.06710843493131,61.867195017792824,NaN,NaN,124.41775661831676,124.99472666989239,0.42044613362800254,1.5502705110547481,1.1298243774267456,2699754525,2676133526.6,75.12107815552379,64.16155684698194,NaN,NaN,26.90249363186603,15.958320372915434
2013-05-20T09:30:00-04:00,98.75999,99.60001,98.75,99.21001,25028336,39325902.4,70.54379149181129,62.75870771006605,NaN,NaN,128.8400816331742,126.53657630239681,0.4042645553337121,1.6351550715938856,1.2308905162601735,2724782861,2693373545.8,77.10444154167722,65.4547533301878,NaN,NaN,28.945355343439488,17.8136110829903
2013-05-21T09:30:00-04:00,99.2,99.55,98.88,99.23,23605056,37740499.2,70.60676802332192,64.41358282337147,NaN,NaN,118.66842822575856,123.82084212665961,0.362983960761313,1.6846204672118148,1.3216365064505018,2748387917,2708625798.6,78.72069375930357,67.06933066407555,NaN,NaN,30.654494858458335,19.648023050914304
2013-05-22T09:30:00-04:00,99.41,100.38,97.11,97.78,68656560,39122185.6,60.502295718136075,64.92604443650923,NaN,NaN,84.5082200733523,114.39405078947475,0.21349714450894974,1.588507937086689,1.3750107925777393,2679731357,2703346371.4,76.70230960491256,68.73338132982995,NaN,NaN,29.35907808258055,21.035316626866624
2013-05-23T09:30:00-04:00,96.64999,97.935,96.50999,97.89999,44527088,39521323.2,60.99968582802844,65.11072532249261,NaN,NaN,45.5002360719793,100.38694452451628,0.1037316015723837,1.504675294543219,1.4009436929708352,2724258445,2715383021,78.08211265689809,70.4362931894904,NaN,NaN,28.42631239267869,22.091173164839777
2013-05-24T09:30:00-04:00,97.3,97.95,96.71001,97.88,33336320,39567823.2,60.862178700289164,65.14852449291895,NaN,NaN,42.302639100620056,83.96392102097693,0.015447052476991185,1.4202525085670743,1.4048054560900831,2690922125,2713616541,77.35801467471302,72.00872301644397,NaN,NaN,27.616821676304333,22.88055152362043
2013-05-28T09:30:00-04:00,99.2,100.095,98.4807,99.14999,46125936,40834476.8,66.09184484162648,65.3906020433799,NaN,NaN,102.09232318461528,78.61436933126514,0.02754269912641516,1.439233829998102,1.4116911308716869,2737048061,2716069581,77.66772756959978,73.52420114263676,NaN,NaN,28.337243516406996,23.660078951161367
2013-05-29T09:30:00-04:00,98.55,99.1848,97.37,98.23,40491632,41334273.6,59.852654645104856,65.12688326114359,NaN,NaN,56.61203020229106,66.20308972657163,-0.037901548793364714,1.3643141948799808,1.4022157436733456,2696556429,2705703283.4,73.11615122776189,74.2396650232702,NaN,NaN,27.125557505035186,24.155147316000484
2013-05-30T09:30:00-04:00,98.5,99.125,98.31,98.89,30625328,36856577.6,62.58169509025334,65.18451481339413,NaN,NaN,74.54096028333258,64.20963776856766,-0.04759794886261415,1.342718307595078,1.390316256457692,2727181757,2715193363.4,74.58456888454911,74.81764441126424,NaN,NaN,26.888730948245687,24.545659263464085
2013-05-31T09:30:00-04:00,98.38,99.02,97.77,97.8,38959408,36862759.2,55.831730799941056,64.59010591807815,NaN,NaN,40.27712032803316,63.16501461977843,-0.1334168029276479,1.2235452527981323,1.3569620557257802,2688222349,2707986144.2,71.39516515614962,74.97419584846159,NaN,NaN,24.585767214183583,24.551388970709727
2013-06-03T09:30:00-04:00,98.14,98.84,97.03,98.73,87088432,38618064.8,59.814329151767396,64.30943075452096,NaN,NaN,34.48960609559274,61.60240801877296,-0.13323320548822126,1.1904205488655037,1.323653754353725,2775310781,2724863875.4,74.17970092259087,75.23557351885982,NaN,NaN,23.83892045698147,24.449607754462832
2013-06-04T09:30:00-04:00,98.67999,99.2,96.92,97.67999,68207184,40683661.6,53.90448289713089,63.32543051693013,NaN,NaN,8.460443890644854,42.876032159978884,-0.2052105091813221,1.0671406178770724,1.2723511270583945,2707103597,2718874982.6,71.51926055752065,75.20806605591845,NaN,NaN,21.288769645074684,23.99805945312167
2013-06-05T09:30:00-04:00,97.56,97.71001,96.14999,96.42999,58973536,42136188,47.8440933952222,61.8658124374137,NaN,NaN,-93.51594377935251,12.850437363650173,-0.33093887684551215,0.8586775310015042,1.1896164078470164,2648130061,2709189709,67.31462900807517,74.78972952966093,NaN,NaN,17.053733046715926,23.006012823635135
2013-06-06T09:30:00-04:00,96.36,97.45,95.73,97.45,46336160,42569520,52.533736556640875,60.85974254101466,NaN,NaN,-91.59118778251317,-20.37599224951898,-0.3381454696012758,0.7669345708454216,1.1050800404466974,2694466221,2702646601.8,64.55353139937006,74.10138465133181,NaN,NaN,15.040992751864513,21.86815281338219
2013-06-07T09:30:00-04:00,97.89999,98.45,97.27,98.2,44757664,43190700,55.688686277280546,59.83271238689674,NaN,NaN,-2.742553822492248,-28.979927079624066,-0.287147833974589,0.7461452479784612,1.0332930819530501,2739223885,2712846909,66.83722122103372,73.50968058458253,NaN,NaN,14.415471034973812,20.803483987895277
2013-06-10T09:30:00-04:00,98.64,98.8,97.81,98.8,32136464,42833080,58.08869725342759,58.94306279844076,NaN,NaN,43.105589795924594,-27.2567303395577,-0.21126047750521126,0.7692174850715361,0.9804779625767474,2771360349,2712056822.6,66.47994770095193,72.75078816738787,NaN,NaN,14.669950349463257,19.9272648966907
2013-06-11T09:30:00-04:00,97.675,98.47,96.86,97.73,43466432,43879994.4,52.61563225314473,57.657981671999536,NaN,NaN,-56.53797391182784,-40.25641390005224,-0.22984486004334426,0.693171887522567,0.9230167475659112,2727893917,2716214886.6,67.46560610770129,71.94685333513056,NaN,NaN,13.116575633796245,18.95430928770578
2013-06-12T09:30:00-04:00,98.33,98.48,96.625,96.75999,58453424,45125471.2,48.18348393557274,56.77806654467357,NaN,NaN,-100.30512355645801,-41.61424985547334,-0.299763083193785,0.5483128935736801,0.848075976767465,2669440493,2720476973,68.48844524537708,71.36014873802087,NaN,NaN,10.362624522098688,17.72692574976191
2013-06-13T09:30:00-04:00,96.73,98.7,96.37,98.47501,47769216,45813840,55.34560080091731,56.37420332845135,NaN,NaN,-30.195150441416587,-29.33504238725402,-0.2261555717635504,0.565381512063027,0.7915370838265774,2717209709,2725025670.6,69.58737033834795,70.75338142955302,NaN,NaN,10.3775239372554,16.677011205118124
2013-06-14T09:30:00-04:00,98.2803,98.64,97.42,97.711,37845920,45603471.2,51.90379141885437,55.73431852263458,NaN,NaN,-20.15230455615648,-32.81699253398686,-0.2241379866727995,0.5113646004855781,0.7355025871583776,2679363789,2713053651.4,63.32762740594469,69.75121091035528,NaN,NaN,9.241586480409206,15.61480767301685
2013-06-17T09:30:00-04:00,98.59,98.855,97.75999,98.35001,33311392,45485074.4,54.45495406387074,54.903112038509164,NaN,NaN,29.471644486728454,-35.54378159582609,-0.17704903112909154,0.5141912982470132,0.6912403293761047,2712675181,2701316617.8,57.83485792554712,68.33457736435152,NaN,NaN,9.147204561668278,14.690864371395625
2013-06-18T09:30:00-04:00,98.52,99.8,98.3297,99.50999,40521488,46259732,58.73400232199384,54.8232083011441,NaN,NaN,136.64462026551539,3.092737239642551,-0.07052807574906761,0.6030802346897701,0.6736083104388377,2753196669,2706377168.2,59.46726386841733,67.35965683868405,NaN,NaN,10.47543725311217,14.088660497355132
2013-06-19T09:30:00-04:00,99.50999,99.7,98.16,98.28999,43193440,47239151.2,53.08499857617538,54.144872835852816,NaN,NaN,83.66127977147332,39.88601790522882,-0.08406431454113827,0.5685279172624149,0.6525922318035532,2710003229,2714489715.4,62.006636898752376,66.46123312541286,NaN,NaN,9.732395413194263,13.466336913903579
2013-06-20T09:30:00-04:00,96.71001,98.205,95.28999,95.69,76263744,47619510.4,43.48595779117487,53.26303190665522,NaN,NaN,-177.58159320008457,10.408729353495222,-0.26001662305529905,0.32757145298442936,0.5875880760397284,2633739485,2697795670.6,54.447265611223784,65.25066887220387,NaN,NaN,5.5622595411327875,12.337183003507752
2013-06-21T09:30:00-04:00,95.64,96.17999,94.63,95.97501,66116880,48699000,44.667127623137866,52.18108894032455,NaN,NaN,-218.46753747464282,-29.254317230202048,-0.34383787619553263,0.15779073079531258,0.5016286069908452,2699856365,2701894185.8,55.86970569649915,63.94281207034017,NaN,NaN,2.768628297706937,10.97024661696478
2013-06-24T09:30:00-04:00,94.91,95.515,93.83,94.71001,58775408,49970954.4,40.61012395482108,51.23149187301671,NaN,NaN,-231.42624012972536,-81.43389415349282,-0.46365346112780503,-0.0779382194189111,0.38571524170889393,2641080957,2687575341,49.9958944226223,62.40542877499029,NaN,NaN,-0.9408399729937079,9.268662818399282
2013-06-25T09:30:00-04:00,95.59,95.84,94.8701,95.62,32420576,49285686.4,44.51429856842355,50.99364938538823,NaN,NaN,-144.014342750353,-137.56568675666648,-0.4598891243010711,-0.18914616366744497,0.27074296063362613,2673501533,2671636313.8,44.400050621316865,60.76867317593612,NaN,NaN,-2.6740560072444084,7.562560129021612
2013-06-26T09:30:00-04:00,96.52,96.63,95.64999,96.07001,33752624,48948736,46.39112343426383,50.55489130521844,NaN,NaN,-85.21164029459806,-171.34027076988076,-0.40717128807602865,-0.2382211494614097,0.16895013861461894,2707254157,2671086499.4,44.21620567565708,59.31600705281377,NaN,NaN,-3.465518695217009,5.9871202969875235
2013-06-27T09:30:00-04:00,96.64999,97.74001,96.605,97.56,40852240,49460081.6,52.16104873763179,50.30291719524352,NaN,NaN,-3.157405581308295,-136.4554332461255,-0.25923678315709814,-0.15509584033175372,0.1041409428253444,2748106397,2693959881.8,52.94531722029812,58.32372819561838,NaN,NaN,-2.265026946412995,4.808242119358878
2013-06-28T09:30:00-04:00,97.39999,97.96001,96.85001,97,46141552,49819188.8,49.9835883044538,49.723980841745394,NaN,NaN,-2.2343072774621224,-93.20878720668937,-0.1896120057348343,-0.13287406434319848,0.05673794139163582,2701964845,2694381577.8,53.09105476022896,57.367378699852445,NaN,NaN,-1.9722058089274055,3.8396067010322663
2013-07-01T09:30:00-04:00,97.64999,99.10001,97.64,98.58,37811456,47355340,55.613580746295085,49.93812001982756,NaN,NaN,79.95707834254257,-30.93212351223578,-0.035718129592479664,0.012090279401036241,0.047808408993515905,2739776301,2714120646.6,59.42581588076964,56.79310796935733,NaN,NaN,0.12289579766744546,3.3086480005515777
2013-07-02T09:30:00-04:00,98.16,98.85001,97.45,98.08,36849696,45787465.6,53.558990308399345,50.32208476074374,NaN,NaN,56.4584576992064,9.162436577676111,0.03026728188056209,0.08564251134421852,0.05537522946365643,2702926605,2720005661,61.11196554380678,56.26621656210231,NaN,NaN,1.1779827277861694,3.0042672472993766
2013-07-03T09:30:00-04:00,97.73,98.64,97.59,98.28,19162096,43796893.6,54.286491375142646,50.24643408747413,NaN,NaN,54.14239340620989,37.03324331783769,0.0822976858782399,0.1582473368114563,0.0759496509332164,2722088701,2722972569.8,61.970017914427984,55.72211996039374,NaN,NaN,2.244105352783541,2.8956726909399713
2013-07-05T09:30:00-04:00,99.38,99.75,98.31,99.67,29429040,42951537.6,59.083791132322474,50.759291209864706,NaN,NaN,115.50172330858709,60.76506909581676,0.1986092886598455,0.3242112617580233,0.12560197309817778,2751517741,2723654838.6,62.17669544816745,55.63991053483823,NaN,NaN,4.669272195297823,3.1490440487053784
2013-07-08T09:30:00-04:00,100.13,100.44,99.89,100.07001,30905232,42258916,60.37260027318094,51.18198022481543,NaN,NaN,154.31627843478543,92.07518623826628,0.28548233534558554,0.4824548922801597,0.19697255693457416,2782422973,2739746464.2,66.7644401256872,56.27773783484823,NaN,NaN,7.043699754335056,3.7054234352239037
2013-07-09T09:30:00-04:00,100.7,101.2,100.3,101,36011056,42452645.6,63.26936838307517,51.505934943464105,NaN,NaN,174.0643971741553,110.8966500045888,0.3825212502125918,0.6751241197003139,0.29260286948772213,2818434029,2755478009.8,70.52805153900795,57.06779409703328,NaN,NaN,9.957029272984222,4.5985099834753775
2013-07-10T09:30:00-04:00,101.03999,101.38,100.74001,101.28,36061040,42082376,64.11979626696521,52.29413477852052,NaN,NaN,162.23290706840422,132.0515398784284,0.4384923074332968,0.8407182537793432,0.40222594634604636,2854495069,2785791702.6,76.13592826853152,58.07702919487464,NaN,NaN,12.599619184726182,5.741525583654064
2013-07-11T09:30:00-04:00,102.42,102.59,101.94,102.47,34437552,40881582.4,67.55770452907717,54.013545259799265,NaN,NaN,186.42321544986842,158.5077042871601,0.5228633931981819,1.0558051878437738,0.5329417946455919,2888932621,2819160486.6,80.52813999360012,59.93994879361581,NaN,NaN,15.970044649204517,7.202742593018415
2013-07-12T09:30:00-04:00,102.48,103.11,102.47,102.67999,28586656,39922454.4,68.13786822396919,55.69002673128721,NaN,NaN,169.1041944622366,169.22819851789,0.5568785347667268,1.2290399631040003,0.6721614283372735,2917519277,2852360793.8,83.7356118615555,61.930370662548405,NaN,NaN,18.903022750036303,8.874211186878114
2013-07-15T09:30:00-04:00,102.95,103.67999,102.84,103.58,30789888,39569652.8,70.56728849679448,57.829824198571025,NaN,NaN,159.34056247476397,170.2330553258857,0.6003146417031776,1.4225547304662456,0.822240088763068,2948309165,2885538032.2,86.18467191705965,64.5152833407225,NaN,NaN,22.173804294171124,10.774153059348544
2013-07-16T09:30:00-04:00,103.62,103.67,102.82001,103.06,38632640,39835715.2,67.37103136709894,59.462447969904986,NaN,NaN,129.7644959438113,161.3730750798169,0.5553886754201008,1.516475933038194,0.9610872576180932,2909676525,2903786531.4,87.31600232809474,67.58070846263522,NaN,NaN,24.037227426029936,12.668877968874456
2013-07-17T09:30:00-04:00,103.64,103.95,103.24001,103.46001,28484928,39233887.2,68.55107030353201,61.04530131770986,NaN,NaN,121.12866449908859,153.15222656595378,0.5148812126440674,1.6046887734231774,1.08980756077911,2938161453,2920519808.2,88.26496913210781,70.72704870952454,NaN,NaN,25.93991774406859,14.564740793902189
2013-07-18T09:30:00-04:00,103.73,104.59,103.66,104.14999,32035104,38675970.4,70.53082467571613,62.35742817043017,NaN,NaN,117.80838755865358,139.42926098771082,0.4965983399435776,1.710555485708582,1.2139571457650045,2970196557,2936772595.4,89.11667202306242,73.310716909722,NaN,NaN,28.14996751168256,16.505487467870815
2013-07-19T09:30:00-04:00,104.06,104.31,103.74001,104.31,22807696,36003168,70.98696028717367,63.857669026338726,NaN,NaN,104.52827780839038,126.5140776569416,0.4582505327768698,1.7867703117360918,1.328519778959222,2993004253,2951869590.6,89.85334403725051,75.93659471522355,NaN,NaN,30.11613529718986,18.449865729202106
2013-07-22T09:30:00-04:00,104.48,104.75999,104.13,104.53,25857888,33990218.4,71.63699782188948,65.00219881745262,NaN,NaN,102.70745789016001,115.18745674002079,0.41212064482119537,1.8436705849857162,1.4315499401645209,3018862141,2965980185.8,90.50056102952942,78.15621936870639,NaN,NaN,31.954316750573746,20.379073017969482
2013-07-23T09:30:00-04:00,104.91,104.95,104.25,104.46001,26311040,32367000,71.09129073040825,66.25450599045325,NaN,NaN,96.59546262575165,108.55365007640887,0.34408551370015195,1.861656832289711,1.517571318589559,2992551101,2982555101,91.20983597667606,80.30606725676849,NaN,NaN,33.36617467712854,22.234373254992203
2013-07-24T09:30:00-04:00,104.91,104.98,103.44,103.5899,31809648,32336453.6,64.51191066103351,66.98489308230259,NaN,NaN,76.22512231438192,99.57294163946754,0.2140410848733847,1.7851226746812898,1.5710815898079051,2960741453,2987071101,91.39828292899068,82.40808618638009,NaN,NaN,32.898599724682356,23.757834179233654
2013-07-25T09:30:00-04:00,103.47,104.64999,103.33,104.53999,46098464,32953745.6,67.99497876111242,67.62140648435901,NaN,NaN,74.21994569922005,90.85525326758084,0.16762064216413686,1.780607392513076,1.6129867503489392,3006839917,2994399773,91.70892413475188,84.5175310925647,NaN,NaN,33.43431632113107,25.140188770933285
2013-07-26T09:30:00-04:00,103.9599,104.17,103.36,104.12,23037968,32063032,64.959809088278,67.94906425686595,NaN,NaN,60.839217971988155,82.1174413003004,0.08823018400752192,1.7232744803583415,1.6350442963508196,2983801949,2992559312.2,90.82186960548948,86.23591891255057,NaN,NaN,33.04843574876223,26.269938339194564
2013-07-29T09:30:00-04:00,103.84,104.27,103,103.39,30373168,31274612.8,59.95060958705689,67.71201005715037,NaN,NaN,46.2887418391085,70.83369809009011,-0.027648670489673677,1.6004834582387275,1.6281321287284012,2953428781,2979472640.2,84.55883194252345,87.23811751280168,NaN,NaN,31.28016685772789,26.98568527041361
2013-07-30T09:30:00-04:00,103.69,103.87,103.11,103.48,26311376,30699608.8,60.356491783115615,67.44320259401825,NaN,NaN,39.66745191113373,59.44809594716651,-0.10792968263868241,1.4932200254300483,1.6011497080687307,2979740157,2976910451.4,83.34697591646182,87.75319234479672,NaN,NaN,29.92222608168008,27.405191100594536
2013-07-31T09:30:00-04:00,103.89,104.67999,103.61,103.655,38336656,30773956.8,61.18031926107049,66.98767507487491,NaN,NaN,55.82501901793974,55.36807528787807,-0.1560196985305642,1.4061250849055256,1.5621447834360898,3018076813,2988377523.4,84.42295358969999,88.0313933159467,NaN,NaN,28.986930663473505,27.631153895291533
2013-08-01T09:30:00-04:00,104.67999,105.35001,103.74831,105.07001,34487040,31540204,67.12856614228919,66.91558206904065,NaN,NaN,90.81425923507149,58.68693799504835,-0.10192192175064219,1.434742381247787,1.5366643029984293,3052563853,2997522310.6,85.24188367570295,88.13898415981438,NaN,NaN,29.81256442471023,27.942783970922775
2013-08-02T09:30:00-04:00,104.72,105.28,104.56,105.16,22982912,31217897.6,67.46994860090095,66.69434350504827,NaN,NaN,110.49557285483095,68.61820897161691,-0.0709380913170301,1.4479916888521416,1.5189297801691717,3075546765,3015871273.8,86.74739982246278,88.17917901020031,NaN,NaN,30.586006447903607,28.320387181920037
2013-08-05T09:30:00-04:00,105.05,105.63,104.89999,105.52,14993254,30422298.7,68.8630771009489,66.80091820032327,NaN,NaN,135.40952210775544,86.44236502534629,-0.038672768584579575,1.470588819438447,1.5092615880230267,3090540019,3043293521.4,88.61640360217976,88.27206481549209,NaN,NaN,31.63220821733079,28.793504472693
2013-08-06T09:30:00-04:00,105.22,105.3201,104.14999,104.46001,24689632,29856227.5,60.62973688301724,66.2351086702865,NaN,NaN,76.25749646035537,93.76037393519061,-0.09782793422155334,1.386976670246085,1.4848046044676384,3065850387,3060515567.4,89.60766585059012,88.36797172395511,NaN,NaN,30.167339563517793,28.989766628525114
2013-08-07T09:30:00-04:00,104.12,104.34,103.47,103.72,23365168,29221433.9,55.629238876926046,65.17070968465863,NaN,NaN,-13.233168836433514,79.94873636431598,-0.19053933360832875,1.2466304374572275,1.4371697710655562,3042485219,3065397248.6,89.87675620204215,88.42226345102509,NaN,NaN,27.38179292421941,28.760056099338584
2013-08-08T09:30:00-04:00,104.3,104.60001,103.58501,104.14999,27641840,28881648.3,57.80682448492713,64.2292714130696,NaN,NaN,9.282575417515021,63.64239960080467,-0.22432210111291018,1.1567671446744185,1.3810892457873287,3070127059,3068909889.8,90.0758813140404,88.4381589707958,NaN,NaN,25.671558331462958,28.31884213249921
2013-08-09T09:30:00-04:00,103.92999,104.57001,103.52,104.03999,27698128,28837221.9,57.035665566111575,63.18631910908546,NaN,NaN,-10.409523620258906,39.461380305786705,-0.25334822013583613,1.0644039706175334,1.3177521907533696,3042428931,3062286323,86.61610669135916,88.16069794664078,NaN,NaN,24.04794059177235,27.708713340966803
2013-08-12T09:30:00-04:00,103.33,104.63,103.33,104.59,18964912,28245973.1,59.91510598445194,62.38802019866001,NaN,NaN,5.756266214550674,13.53072912714575,-0.23517363878243214,1.0237851422753295,1.2589587810577616,3061393843,3056457087.8,83.57372708770092,87.61526159742827,NaN,NaN,23.44903604823714,27.100188013433993
2013-08-13T09:30:00-04:00,104.67999,104.67999,103.78,104.45,22813104,27454996.3,58.83423892560871,61.98247221755823,NaN,NaN,18.05757605485533,1.8907450460457391,-0.2318661323665916,0.9691261155995221,1.2009922479661137,3038580739,3051003158.2,80.71704044408648,86.85231570564939,NaN,NaN,22.65201010501224,26.4647340265166
2013-08-14T09:30:00-04:00,104.48,104.64,104.00999,104.03999,23632368,27212368.3,55.66697214451311,61.10190031637257,NaN,NaN,-1.9086651905645298,4.155645775219533,-0.2547533430402731,0.8825505691657725,1.1373039122060455,3014948371,3045495788.6,77.82418460735337,85.86054859654949,NaN,NaN,21.085717579296666,25.69630310548518
2013-08-15T09:30:00-04:00,102.84,102.96001,101.89,102.11,50048336,28113029.9,43.732480814658935,59.58566258254264,NaN,NaN,-294.30124028919494,-56.561117366122474,-0.389280047756309,0.6507038525106594,1.0399839002669684,2964900035,3024450383.8,67.82129684947155,84.21765054254821,NaN,NaN,15.636655180303302,24.25921054474491
2013-08-16T09:30:00-04:00,101.81,102.38,101.55,101.67999,36064144,28775852.3,41.592876569777474,58.274395938451256,NaN,NaN,-269.95863908343813,-108.4709404587583,-0.4901156450203136,0.42733934399157647,0.91745498901189,2928835891,3001731775.8,59.0046018290272,82.39234839158418,NaN,NaN,10.480927750867721,22.290884431333883
2013-08-19T09:30:00-04:00,101.64,101.88,100.59,100.64799,25185776,28742246.7,36.9238901366731,56.60063867799108,NaN,NaN,-266.20083612327574,-162.8623609263236,-0.6018488629534912,0.16514391032002607,0.7669927732735172,2903650115,2970183030.2,49.400511510432885,79.96760093401069,NaN,NaN,4.431604561728736,19.739558735676006
2013-08-20T09:30:00-04:00,100.77,102.33,100.71001,102.10001,32450368,29049213.1,46.092986036052594,55.52297201906123,NaN,NaN,-160.35762795180406,-198.54540172765547,-0.554659169909123,0.07366881088711352,0.6283279807962365,2936100483,2949686979,44.349985434924854,77.10524606581247,NaN,NaN,2.200930960307285,17.234040482051903
2013-08-21T09:30:00-04:00,101.69,102.5,101.00999,101.48,41452896,29531375.5,43.204929478341285,53.81414082877923,NaN,NaN,-134.97045794207804,-225.15776027795818,-0.5413013703149948,-0.04829873209750701,0.4930026382174878,2894647587,2925626822.2,39.27397019329637,73.82182367421198,NaN,NaN,-0.57649578437412,14.689678158276756
2013-08-22T09:30:00-04:00,101.82001,102.99001,101.78999,102.91,24010384,28426971.5,50.85357918661669,52.6272572991875,NaN,NaN,-63.99549377904625,-179.09661097592843,-0.41778839971040993,-0.029232861420524614,0.3885555382898853,2918657971,2916378409.4,37.49739353099444,70.30396608196425,NaN,NaN,-0.29312408048808863,12.549277838453207
2013-08-23T09:30:00-04:00,103.19,103.25,102.45,103.17,20801744,28315160.3,52.116233386783996,51.431054176747146,NaN,NaN,-34.04678307238706,-131.9142397737182,-0.3054214983851974,0.006778665308388554,0.31220016369358594,2939459715,2918503174.2,38.189179887796996,66.70202153093692,NaN,NaN,0.3492788905700065,10.806420845898465
2013-08-26T09:30:00-04:00,103.36,103.82001,102.77,103.17999,23376080,27965305.9,52.167084002235924,50.82657897097705,NaN,NaN,-13.387293427934216,-81.35153123464991,-0.2211901327498228,0.03571249775630747,0.25690263050613027,2962835795,2930340310.2,42.038083696080136,63.3041942341862,NaN,NaN,0.8668943866043546,9.386488494570735
2013-08-27T09:30:00-04:00,101.94,102.39011,100.55499,100.75999,47269216,29013197.9,40.85000018891488,49.770919064690545,NaN,NaN,-122.20624879203805,-73.72125540269673,-0.31358127102686034,-0.13507395827744517,0.17850731274941517,2915566579,2926233529.4,41.08228440254193,59.81887481993619,NaN,NaN,-2.620856160218903,7.671153543886501
2013-08-28T09:30:00-04:00,100.62,101.36501,100.50011,100.96001,28933744,28543052.3,41.9705449341647,48.639756239636085,NaN,NaN,-120.48434898586002,-70.82403361145313,-0.34391440616889046,-0.25138569496169794,0.09252871120719254,2944500323,2936204076.6,44.38820818779909,56.555469596633245,NaN,NaN,-4.9437376421638435,5.869026231593595
2013-08-29T09:30:00-04:00,100.89,102.36,100.81,101.97,27632336,28200317.1,47.39017504278741,47.950792630827216,NaN,NaN,-71.3842466316268,-72.30178418196924,-0.2812864304811442,-0.25907932689423774,0.022207103586906488,2972132659,2946899014.2,47.77339527158973,53.78099020950686,NaN,NaN,-5.0898491381513535,4.303472607344316
2013-08-30T09:30:00-04:00,101.99001,102.05231,100.24001,100.38,43338528,29218097.9,40.91220706104489,46.59344270772671,NaN,NaN,-104.26923410808268,-86.34627438910836,-0.3289594725304926,-0.38899223707620934,-0.06003276454571668,2928794131,2944765897.4,47.15682664336737,51.17978303491161,NaN,NaN,-7.473086705530043,2.621106991219408
2013-09-03T09:30:00-04:00,101.86,102.37,100.13,101.06,37997072,30368288.8,44.41189124301007,45.56327501611253,NaN,NaN,-81.4859038172509,-99.9659964669717,-0.29765209392579123,-0.43209788195295573,-0.1344457880271645,2966791203,2945556979,47.42781006017683,48.80198086463234,NaN,NaN,-8.19651027951637,1.0757330954000115
2013-09-04T09:30:00-04:00,101.16,102.00999,100.745,101.95,22581888,30262901.6,48.69497681864634,45.06527534997919,NaN,NaN,-54.577351370858906,-86.44021698273588,-0.2044023835470059,-0.3899487674609219,-0.18554638391391598,2989373091,2960318281.4,52.33918783299932,46.98162395217848,NaN,NaN,-7.350031933062451,-0.12794762295176887
2013-09-05T09:30:00-04:00,102.03,102.53,101.85001,102.11,22770800,30233183.2,49.44905913366062,45.47360237276502,NaN,NaN,-14.92566276184174,-65.32847973793221,-0.12333774374892545,-0.3397185636000728,-0.21638081985114735,3012143891,2973846995,56.362838549564536,46.16316264504227,NaN,NaN,-6.446342511289635,-1.0305754641428926
2013-09-06T09:30:00-04:00,102.7,102.89,100.74001,102.39,36794320,30690807.2,50.81158399976556,46.132081474907025,NaN,NaN,-20.016644384343074,-55.05495928847547,-0.04622078117319475,-0.2741567963176408,-0.22793601514444603,3048938211,2989208105.4,60.44602967807724,46.266121777117284,NaN,NaN,-5.300055441280073,-1.6405011751624898
2013-09-09T09:30:00-04:00,102.74001,104.03,102.73,103.94,27361616,30673981.6,57.62119427985155,47.610460342276916,NaN,NaN,93.74488001609609,-15.452136463639704,0.10553303474905157,-0.09601972170813156,-0.20155275645718312,3076299827,3018709244.6,66.85962426928288,47.513201259892284,NaN,NaN,-2.0518679332689786,-1.6992678548919882
2013-09-10T09:30:00-04:00,104.58,104.98,104.2,104.96001,25126304,30982051.2,61.40753231522124,48.70435650507468,NaN,NaN,168.82597316970924,34.61023893375233,0.2620493438207693,0.12600892331877844,-0.1360404205019908,3101426131,3045636230.2,71.41553425798493,49.44645474725372,NaN,NaN,1.9492212483771043,-1.1780551258535463
2013-09-11T09:30:00-04:00,104.78999,105.22,104.535,105.00999,26416016,31162196.8,61.588627540996946,50.01747779526437,NaN,NaN,174.32905150004393,80.3915195079329,0.35084353588653616,0.3025139993561794,-0.04832953653035675,3127842147,3073330041.4,75.19278179208186,52.012084147166966,NaN,NaN,5.1574635422257025,-0.2729810304136536
2013-09-12T09:30:00-04:00,104.91,105.0201,104.21001,104.24001,32711104,31616133.6,57.14012812345215,50.46651700503833,NaN,NaN,142.04827085760343,111.78630623182194,0.3394085037243001,0.3759310931250184,0.036522589400718286,3095131043,3089927471.8,77.14227275123376,54.84386123432693,NaN,NaN,6.549003725842965,0.701588220480149
2013-09-13T09:30:00-04:00,104.59,104.83,104.10001,104.81,29478624,30587648,59.47370640045719,50.99205079172928,NaN,NaN,124.09252873726612,140.60814085614376,0.35049135321062286,0.47463678091399686,0.124145427703374,3124609667,3105061763,78.77983503697233,57.74319374498231,NaN,NaN,8.419652337461734,1.8041688086203753
2013-09-16T09:30:00-04:00,106.05,106.08,104.85001,105.03999,34929392,30530910.4,60.41036095074312,51.580856288051216,NaN,NaN,140.43479843904407,149.94612454073336,0.35261014699769466,0.5649081114504924,0.2122979644527977,3159539059,3121709609.4,80.43986979165099,60.48617846609451,NaN,NaN,10.227434899711913,3.0074925359191664
2013-09-17T09:30:00-04:00,105.06,106.08,105.03999,106.08,28908240,30717033.6,64.41549233816824,53.2641057272836,NaN,NaN,138.76480937119027,143.93389178102956,0.39988928785851696,0.7121595742759439,0.31227028641742693,3188447299,3139113843,82.02316931083091,63.410527388115156,NaN,NaN,13.039616930099292,4.440653163659184
2013-09-18T09:30:00-04:00,106.05,107.61,105.25999,107.09,46244560,31406743.2,67.82025161161351,55.11051334710137,NaN,NaN,154.74375076585756,140.0168316341923,0.47016901200737743,0.8999815514266487,0.4298125394192713,3234691859,3160483785.4,83.76127577959434,66.22288935895767,NaN,NaN,16.553734033379882,6.1710932879049984
2013-09-19T09:30:00-04:00,107.36,107.42999,106.62,106.98,34778016,31072999.2,67.06759963266015,56.51604367494944,NaN,NaN,145.7870131695935,140.76458009659032,0.47863348313465137,1.0281043933375855,0.5494709102029341,3199913843,3181440345.4,85.26577470181815,68.90091646111685,NaN,NaN,19.172034510545252,8.028370605425035
2013-09-20T09:30:00-04:00,107.24001,107.28,106.55,106.59,49522480,32348604,64.3412538512141,58.189547017104374,NaN,NaN,119.56213549192428,139.85850144752195,0.4289497812704728,1.0856581367910252,0.6567083555205524,3150391363,3186596684.6,85.61882811844879,71.64820228076552,NaN,NaN,20.598422591300967,9.824092317693026
2013-09-23T09:30:00-04:00,106.72,106.87,105.8,106.60001,47765120,33696772.8,64.38127602598291,59.61593164445958,NaN,NaN,93.1695226464554,130.4054462890042,0.3699744732272714,1.1191764470546417,0.7492019738273703,3198156483,3194320169.4,86.1540007750442,74.41435876039888,NaN,NaN,21.77824926616402,11.531829024617453
2013-09-24T09:30:00-04:00,106.46001,107.42,105.78999,106.67,45268000,34791368.8,64.67977625001896,60.75770303241477,NaN,NaN,89.62057809693525,120.57660003415319,0.311251486352249,1.1382663317676815,0.8270148454154326,3243424483,3205315606.2,86.9013279615717,76.88308305529692,NaN,NaN,22.843783691636126,13.147822548477263
2013-09-25T09:30:00-04:00,106.77,107.48,106.33,106.47,37106592,34283237.6,63.053646491662114,61.72945927227202,NaN,NaN,86.96594679560376,107.02103924010244,0.2378254693530617,1.1242966821067597,0.886471212753698,3206317891,3199640812.6,84.37029210236327,78.88361545192541,NaN,NaN,23.34104507077186,14.603997194519348
2013-09-26T09:30:00-04:00,106.75,107.47,106.36,107.06,29497328,34311416.8,65.78635164296841,62.79908553250077,NaN,NaN,88.80550747234822,95.62473810065339,0.20890689312305388,1.1476048291575154,0.9386979360344615,3235815219,3206821087.8,84.96690942945176,80.63510686273787,NaN,NaN,24.50505452548316,16.018433956085605
2013-09-27T09:30:00-04:00,106.39,107.05,106.21001,106.58,30864544,34473027.2,61.78265061252959,63.09633241340634,NaN,NaN,70.64143531511871,85.84059806529228,0.14063963671457913,1.1144974819276854,0.9738578452131063,3204950675,3217732950.2,85.85083995851659,81.99162226911172,NaN,NaN,24.461276257404286,17.224554284845418
2013-09-30T09:30:00-04:00,105.42999,106.84,105.24001,106.61,45771696,34594685.6,61.93856124717121,63.13426305140276,NaN,NaN,50.680115811123144,77.34271669822586,0.08351453463453506,1.078251013506275,0.99473647887174,3250722371,3228246127.8,86.66442227123689,83.08082855577256,NaN,NaN,24.464264164533684,18.258798553372312
2013-10-01T09:30:00-04:00,106.56,107.9294,106.45,107.85001,39344352,34662049.6,67.78808304397855,63.577081301615735,NaN,NaN,94.92189109934286,78.40297929870738,0.11339737615227552,1.1364831990620843,1.0230858229098088,3290066723,3237574575.8,87.35898710534173,83.94984322100541,NaN,NaN,26.125074198386145,19.382552216945715
2013-10-02T09:30:00-04:00,107.09,107.75,106.85001,107.41,30622896,35064100,64.0277570767931,64.06905479828295,NaN,NaN,87.08747159748857,78.42728425908433,0.08877519603656547,1.1340548179555157,1.0452796219189502,3259443827,3248199763,88.11808744661253,84.73382998496105,NaN,NaN,26.47991057279943,20.396460553496247
2013-10-03T09:30:00-04:00,107.21001,107.36,105.60001,106.31,57799184,36815519.2,55.70810194078284,63.800083051163355,NaN,NaN,35.02527801410582,67.67123836743585,-0.011040296905502567,1.031479250787072,1.0425195476925746,3201644643,3241365647.8,84.59913324929407,85.14949414298403,NaN,NaN,24.260045528542605,20.948401264217157
2013-10-04T09:30:00-04:00,106.33501,107.32001,106.14999,107.02,25911392,36271372.8,59.37718387294487,63.72628468846347,NaN,NaN,55.21777853089174,64.58650701059047,-0.03721787393345455,0.9959972052757564,1.033215079209211,3227556035,3245886719.8,85.02517686797819,85.47701607700739,NaN,NaN,23.46715827059275,21.308223693699386
2013-10-07T09:30:00-04:00,105.99001,106.66,105.72,105.77,32924160,36549500,51.317228147899705,62.79069438915858,NaN,NaN,-12.791009139651816,51.892282020435474,-0.14086615404525915,0.857132386652637,0.9979985406978962,3194631875,3234668620.6,79.17260980896549,85.27340468401701,NaN,NaN,20.097575389837353,21.13527393600481
2013-10-08T09:30:00-04:00,105.84,106.03,103.92,104.05499,61365024,38361436,42.74424389002358,60.999550980473586,NaN,NaN,-134.03205478525203,6.101492843516459,-0.31699294527145694,0.601757359108575,0.9187503043800319,3133266851,3203308646.2,65.58237134427829,83.97491151006587,NaN,NaN,13.966564502258086,20.111172588326706
2013-10-09T09:30:00-04:00,104.3,104.36,103,103.64,52608912,39671080.8,40.96106177356974,59.134798276252845,NaN,NaN,-195.54990565692617,-50.42598260736649,-0.4456282753306755,0.3617149602166876,0.8073432355473631,3080657939,3167551468.6,54.16550041115212,81.75346334644686,NaN,NaN,8.528511265960004,18.456506685131462
2013-10-10T09:30:00-04:00,105.00999,106.31,104.92,106.14,53157808,40693416,53.53636131461028,58.363020237924,NaN,NaN,-35.740663906008706,-64.5791709913894,-0.3507100721987504,0.3689556452989251,0.7196657174976755,3133815747,3153985689.4,50.568764783608195,79.24988739395825,NaN,NaN,8.207427223560556,16.99235247633562
2013-10-11T09:30:00-04:00,105.84,107.73,105.83,107.67999,43197120,41379340.8,59.288849686297326,57.999275499375024,NaN,NaN,74.76399261300708,-60.66992817496632,-0.18111487071303078,0.49327212910638707,0.6743869998194179,3177012867,3143877055.8,48.01045029200765,76.52534807374136,NaN,NaN,10.169427779612072,16.017648948232253
2013-10-14T09:30:00-04:00,107.06,108.345,106.92999,108.22,38774800,41571611.2,61.107211085108894,57.74409227331002,NaN,NaN,140.5116314441634,-30.009400058203276,-0.03700762413594649,0.6281274696494847,0.6651350937854312,3215787667,3148108214.2,49.169618514262496,73.83022597036212,NaN,NaN,12.329212829477882,15.490729502695915
2013-10-15T09:30:00-04:00,107.99001,108.22501,106.92,107.16,42263504,42239374.4,55.835340451516025,57.22849898472816,NaN,NaN,93.33664232924131,15.464339364695391,-0.0184546263269858,0.6420668108766989,0.6605214372036847,3173524163,3156159676.6,51.39062886143278,71.47453573886709,NaN,NaN,12.198862006605916,15.020462717540202
2013-10-16T09:30:00-04:00,107.91,108.60001,107.64,108.49001,34333600,41643826.4,60.4463172006203,56.84706795313186,NaN,NaN,155.17313719881358,85.60894793584335,0.0729977384688476,0.7517686102897443,0.6787708718208967,3207857763,3181599641.4,57.682422011550344,69.52564378044555,NaN,NaN,13.7489804735941,14.838822396976473
2013-10-17T09:30:00-04:00,108,109.46001,107.97,109.44,38967152,41853283.2,63.38671163627822,56.96164374054248,NaN,NaN,190.4642355595761,130.84992782896032,0.18092956490026335,0.9049328279462259,0.7240032630459625,3246824915,3204201475,62.34560022560958,67.8466980852379,NaN,NaN,16.031224034844413,15.009165488100464
2013-10-18T09:30:00-04:00,110.22,110.77,109.83,110.69,39499024,41352110.4,66.87600176122784,57.3143180629751,NaN,NaN,243.63921198705737,164.62497170377037,0.31226599617947026,1.1143357582703004,0.8020697620908301,3286323939,3226063689.4,66.2228147023418,66.38658325888825,NaN,NaN,19.146689625669467,15.600240364896036
2013-10-21T09:30:00-04:00,110.85001,111.08,110.27,110.47,29204992,40424104,65.68943756439691,57.16441481443355,NaN,NaN,203.97152727865068,177.31695087066782,0.35686342442172125,1.2481490426179818,0.8912856181962605,3257118947,3234329945.4,67.58203313583388,64.97394368963771,NaN,NaN,21.1705216092441,16.39599482837433
2013-10-22T09:30:00-04:00,110.95,111.49001,110.37,110.75999,38112656,40066336.8,66.53236651130648,57.34331548832737,NaN,NaN,178.16262908362185,194.2821482215439,0.37648966153200525,1.3618976951112671,0.9854080335792619,3295231603,3258671433.4,71.25075807901666,63.769134449095134,NaN,NaN,23.048171455902544,17.346305775164076
2013-10-23T09:30:00-04:00,110.24001,110.545,109.77,110.39,32278784,39824946.4,64.35981750106606,57.961295171204746,NaN,NaN,124.00916658217075,188.04935409821536,0.33645912217194773,1.4059819362941965,1.0695228141222488,3262952819,3269690444.6,72.75394566809958,62.92304962186696,NaN,NaN,23.933661982629744,18.287356661944887
2013-10-24T09:30:00-04:00,110.47,111.25999,110.33,110.981,24716832,39585921.6,66.2553189336312,58.45259053268234,NaN,NaN,127.60348767105044,175.4772045205102,0.3216966164387052,1.4716435846706304,1.1499469682319252,3287669651,3277859391.8,73.84573163416653,62.12451781945184,NaN,NaN,25.23942249270658,19.280508923482273
2013-10-25T09:30:00-04:00,111.24001,111.45,110.57001,111.08,21330016,39109195.2,66.57600124217467,59.54250289655912,NaN,NaN,115.81259078665042,149.91188028042885,0.2914139973443337,1.5142144649123424,1.2228004675680086,3308999667,3282394537.4,74.45766524887162,61.78773606515943,NaN,NaN,26.39446850390098,20.296788863542087
2013-10-28T09:30:00-04:00,111.13,111.285,110.46,111.03,22512163,37946218.55,66.23365317815716,61.22031784571152,NaN,NaN,98.16675226198957,128.75092527709663,0.24281811344655901,1.5263231093762073,1.2835049959296483,3286487504,3288268248.8,75.26486689588329,62.47934289027406,NaN,NaN,27.255671469977905,21.290914950175775
2013-10-29T09:30:00-04:00,111.33,111.62,110.53,111.35,30034654,37480733.65,67.38942803684174,63.1080582930881,NaN,NaN,93.94945070723988,111.90828960182023,0.2083504105066698,1.5439430090629855,1.3355925985563157,3316522158,3292526359.8,75.86044639413734,64.02898188905873,NaN,NaN,28.299312398481668,22.292114585648047
2013-10-30T09:30:00-04:00,111.4,111.48,109.52,109.83,46076553,38253416.5,57.34819172948545,63.38033189415061,NaN,NaN,58.301743182878305,98.76680492196174,0.06664545747111239,1.4188994203952063,1.352253962924094,3270445605,3294024917,76.07874475888508,65.85112331586421,NaN,NaN,26.368244273404347,22.87441882675609
2013-10-31T09:30:00-04:00,109.77,110.18,108.89,109.19,47370004,37731957.5,53.71872998350984,62.98246620109436,NaN,NaN,26.74266940008722,78.59464126776909,-0.07883767291819943,1.2537068717763447,1.332544544694544,3223075601,3281106107,70.18615046920982,67.43510189995008,NaN,NaN,23.64557129454197,22.984583465011216
2013-11-01T09:30:00-04:00,109.41,109.63,107.92,108.715,117037638,42288269.8,51.13221260986922,62.269966310005806,NaN,NaN,1.4062387270329741,55.71337085584562,-0.20835282404917876,1.0721035146330706,1.2804563386822494,3106037963,3240513766.2,55.61107636354002,67.89520603204134,NaN,NaN,20.5891359253109,22.642376673625456
2013-11-04T09:30:00-05:00,109.24,110.15,108.8279,109.97,31969881,42240555.85,57.02046211902959,62.35461785768535,NaN,NaN,28.4275245474633,41.76552531294034,-0.21019072026027175,1.0177179383569097,1.2279086586171815,3138007844,3210817834.2,47.79205188832884,67.63816481967677,NaN,NaN,19.594279307101438,22.206934192693453
2013-11-05T09:30:00-05:00,109.55,109.93,108.86,109.59,26645778,40504593.55,54.86479430053641,61.955937650536505,NaN,NaN,14.163327932921822,25.80830075807673,-0.2357694542238733,0.9331968408373399,1.1689662950612132,3111362066,3169785815.8,39.523062024273976,66.34106767772847,NaN,NaN,18.131285568089634,21.624698674892908
2013-11-06T09:30:00-05:00,110.35,110.37,108.905,109.12,31773363,39462816.1,52.23448184667751,61.15934980842217,NaN,NaN,2.2729371263959584,14.602539546780253,-0.28009382931923255,0.8188490084121725,1.098942837731405,3079588703,3131614435.4,33.68426329917156,64.29382932584004,NaN,NaN,16.129286491820515,20.839639791596852
2013-11-07T09:30:00-05:00,109.62,109.81,107.14,107.28,60459737,39827912.55,43.451819251511566,59.48619391487101,NaN,NaN,-91.40017244663355,-9.0260288225639,-0.42063586106352613,0.5731480114019973,0.9937838724655235,3019128966,3090825108.4,28.78980144873576,61.62004266486819,NaN,NaN,11.395788467165504,19.490518173820945
2013-11-08T09:30:00-05:00,107.44,109.46,107.39,109.23,48148087,40075460.9,52.55619004769348,58.548104806535044,NaN,NaN,-62.63171778824607,-21.833620125619706,-0.3712901503286694,0.5296711845546866,0.9009613348833561,3067277053,3083072926.4,27.958322778826584,58.789777639367664,NaN,NaN,10.256056575772062,18.171309374099675
2013-11-11T09:30:00-05:00,109.04,109.595,108.64,109.38,19898100,39131625.9,53.1806406621108,57.59441010302107,NaN,NaN,-34.971546608725724,-34.51343435685751,-0.3195388145563305,0.501537816687943,0.8210766312442734,3087175153,3072906388.2,26.86261547085499,55.61919602449897,NaN,NaN,9.57632357573235,16.9434542600472
2013-11-12T09:30:00-05:00,109.07,109.51,108.67,109.47,28077647,38422333.05,53.57546330539844,56.82409908904481,NaN,NaN,-44.44394407354157,-46.23488875815019,-0.2720933363860517,0.48095996076170877,0.7530532971477605,3115252800,3073684535,27.098117854377307,52.35806546637595,NaN,NaN,9.158999106643643,15.831389238132406
2013-11-13T09:30:00-05:00,108.66,110.55,108.62,110.52,36465895,38528947.8,58.0229992173105,56.23607625216476,NaN,NaN,3.182833713022126,-46.05290944082496,-0.16794874369062596,0.543117367534478,0.711066111225104,3151718695,3088110533.4,31.501686660254805,49.33349082538226,NaN,NaN,10.185783555248037,15.024874140577497
2013-11-14T09:30:00-05:00,110.47,110.6,109.74,110.405,33236252,38242402.8,57.37468517946518,55.578839390542655,NaN,NaN,29.14753171282685,-21.94336860893288,-0.10769046528327775,0.5764530296210069,0.6841434949042846,3118482443,3107981228.8,37.13455868095875,46.66755464195991,NaN,NaN,10.820516113255033,14.424251565245717
2013-11-15T09:30:00-05:00,110.6,110.99,110.16,110.83,27519423,37643422.75,59.18950249304199,55.07568577017729,NaN,NaN,64.16739229817875,3.4164534083520848,-0.043391130163235814,0.6299045822002398,0.6732957123634756,3146001866,3123726191.4,41.256688651726826,44.23839905309159,NaN,NaN,11.880896699165062,14.060915155805624
2013-11-18T09:30:00-05:00,111.32,111.42,109.75,110.05,35517144,37959030.35,54.59529225391637,54.16181892853975,NaN,NaN,43.1755256202645,19.04586785415013,-0.05673100411807419,0.6023819572158828,0.659112961333957,3110484722,3128388105.2,42.45975263669935,41.852635213274596,NaN,NaN,11.461502734363025,13.689570524170968
2013-11-19T09:30:00-05:00,110.11,110.69,108.99,109.37,36081328,37857463.95,50.88701541296581,53.700306334502635,NaN,NaN,-17.34231941627582,24.466192785603283,-0.11152326414816982,0.5197088811487447,0.6312321452969145,3074403394,3120218224,40.87969077794046,39.33841707177855,NaN,NaN,10.008779447893357,13.16374322755988
2013-11-20T09:30:00-05:00,109.93,110.2,108.85,109.33,43376916,38412370.55,50.66899607564366,53.48246819822648,NaN,NaN,-34.918563207934525,16.845913401411952,-0.14832728697221698,0.44582303658164335,0.5941503235538603,3031026478,3096079780.6,36.55173487159537,36.93595881480609,NaN,NaN,8.765199878116782,12.535379891925151
2013-11-21T09:30:00-05:00,109.81,111.36,109.68,111.3,45586321,39455845,59.80319540017178,54.10182411181953,NaN,NaN,91.34072221248458,29.284551501343493,-0.043315731349365394,0.5400056593671536,0.583321390716519,3076612799,3087705851.8,35.16100990069344,35.47523978174562,NaN,NaN,10.445724643289168,12.236857713548583
2013-11-22T09:30:00-05:00,111.29,111.97,111.1,111.85,28787982,39828743.3,61.92299339356955,54.45200491714381,NaN,NaN,162.81629516877138,49.01433207546202,0.05455584484312892,0.6515161967704302,0.5969603519273012,3105400781,3079585634.8,33.81733057426871,34.4770454021699,NaN,NaN,12.499095965003617,12.274320320899301
2013-11-25T09:30:00-05:00,112.13,112.275,111.6297,111.99,22968585,39851564.4,62.46559676872052,54.994919379156954,NaN,NaN,173.87099852790286,75.1534266569897,0.11653204453278332,0.7426254075932803,0.626093363060497,3128369366,3083162563.6,34.99575932047556,34.153666637612865,NaN,NaN,14.31810404303645,12.56628942406175
2013-11-26T09:30:00-05:00,111.99,113.02,111.9,112.82,30761596,39887911.5,65.59575613218209,55.94929611383585,NaN,NaN,198.52484900343313,118.32686034093149,0.19652941077360508,0.8717551265275034,0.6752257157538983,3159130962,3100108077.2,40.40913150622703,34.63401436668826,NaN,NaN,16.846745816331882,13.177783194386055
2013-11-27T09:30:00-05:00,112.84,113.57,112.64,113.45,29099601,39039063.9,67.7913717104751,57.68783557519039,NaN,NaN,196.42737425499553,164.5960478335175,0.27041703790846283,1.0132470131394768,0.742829975231014,3188230563,3131548894.2,48.910378806922054,36.07119846370157,NaN,NaN,19.661091400169628,14.103970080926565
2013-11-29T09:30:00-05:00,113.94,114.16,113.45,113.51,15675502,37454338.8,68.00082081538197,58.79102348716814,NaN,NaN,183.29004512746891,182.98591241651437,0.2996094839238741,1.1173418301358566,0.8177323462119825,3203906065,3157007547.4,54.56287252327941,37.9715234454482,NaN,NaN,22.006388350585894,15.232886976592184
2013-12-02T09:30:00-05:00,113.7,113.76,112.055,112.37,43160293,33760471.55,60.015246463792955,59.27920961585972,NaN,NaN,112.5161935638502,172.92589209553012,0.22199347284499749,1.0952241872682293,0.8732307144232319,3160745772,3168076545.6,56.80077391912646,40.10996333461045,NaN,NaN,21.751302421108075,16.164089182951596
2013-12-03T09:30:00-05:00,112.13,112.6,111.27,111.83,36931077,34008531.35,56.623213180108976,59.496906035481906,NaN,NaN,62.51938749494145,150.65556988893783,0.11928537989954102,1.022337439297658,0.9030520593981171,3123814695,3167165611.4,56.55391086559578,42.213948549697484,NaN,NaN,20.52542639158187,16.787137355613062
2013-12-04T09:30:00-05:00,111.31,112.42,110.37,111.53,40609914,34706738.15,54.7711221508654,59.26462910216439,NaN,NaN,34.860350161424705,117.92267012053617,0.021278547910290713,0.9296502442859804,0.9083716963756897,3083204781,3151980375.2,52.46077838803277,43.71102653025305,NaN,NaN,18.969106265043465,17.098847199817406
2013-12-05T09:30:00-05:00,111.49,112.02,111.15,111.61,37927916,35014465.8,55.1920198970035,59.10872443913142,NaN,NaN,37.636877195137444,86.16457070856455,-0.044441730572857385,0.852819533159618,0.8972612637324754,3121132697,3138560802,49.080124941328926,44.564281263136635,NaN,NaN,17.803033235114878,17.199445204859902
2013-12-06T09:30:00-05:00,112.62,113.1,112.19,112.48,36471868,33815072.35,59.59557711951275,59.13772976959361,NaN,NaN,80.13508592857254,65.53357886878527,-0.035963011107595255,0.8523074998479814,0.8882705109555766,3157604565,3129300502,46.8371352221112,44.96288458959266,NaN,NaN,18.011237895446776,17.315415589229456
2013-12-09T09:30:00-05:00,112.63,112.89,111.89,112.45,31236464,32969491.2,59.378873126229166,59.47941411761595,NaN,NaN,64.37681921071903,55.90570399815904,-0.03877619614555505,0.8398002657736328,0.8785764619191878,3126368101,3122424967.8,45.185967161316356,45.15761419849388,NaN,NaN,18.12286338858929,17.43076527485229
2013-12-10T09:30:00-05:00,112.23,112.58,111.24,111.43,34946434,33721907.9,52.401950064035596,59.58762373554951,NaN,NaN,21.994525060744042,47.80073151131955,-0.11161056474217601,0.7390632559914678,0.8506738207336438,3091421667,3115946362.2,43.625338619507794,45.35373190146297,NaN,NaN,16.196641109469518,17.25446182265475
2013-12-11T09:30:00-05:00,111.55,111.55,109.32,109.6,47181580,34677104.55,42.70661661898206,59.01888234578797,NaN,NaN,-83.63937626245286,24.100786226544038,-0.2759526813414571,0.5057329690568224,0.7816856503982795,3044240087,3108153423.4,41.75710677717068,45.725544180432635,NaN,NaN,11.152382980612169,16.382736273791526
2013-12-12T09:30:00-05:00,109.7,110.2455,109.36,109.84,37706170,34739118.3,44.16563812509314,57.901913968996645,NaN,NaN,-105.1232031900258,-4.451229850488611,-0.3563034801916891,0.33630630015866814,0.6926097803503573,3081946257,3100316135.4,39.906212169209084,46.06448719961232,NaN,NaN,7.564789178870727,15.123029545945698
2013-12-13T09:30:00-05:00,110.05,110.5301,109.42,110.2,32980646,34726338,46.37174638558718,56.791110611283614,NaN,NaN,-88.23295046463465,-38.12483712913005,-0.37132781924765756,0.22845000629078527,0.5997778255384428,3114926903,3091780603,37.934104514121074,46.35854248103034,NaN,NaN,5.272825443489695,13.715857531309126
2013-12-16T09:30:00-05:00,110.62,111.57,110.1542,111.51,33991164,35049925.05,53.56211526784636,56.15514764693546,NaN,NaN,-24.25382877840064,-55.850966726953985,-0.28314608636982563,0.24584521757616074,0.5289913039459864,3148918067,3096290596.2,39.63168023472203,46.68967968919081,NaN,NaN,5.50961798065069,12.543537595500778
2013-12-17T09:30:00-05:00,111.45,111.54,110.615,111.35,32399830,34894059.35,52.633883764025704,55.22929962063858,NaN,NaN,-21.725249092602912,-64.59492155762338,-0.2280660377951792,0.2439087567020124,0.4719747944971916,3116518237,3101309910.2,41.54783204790635,46.7710154421679,NaN,NaN,5.4174168081734155,11.525520340168297
2013-12-18T09:30:00-05:00,111.53,112.9,110.36,112.88,52979025,35738944.2,59.8069617462324,54.65898462319267,NaN,NaN,33.189377974789764,-41.229170710174856,-0.0882492103323263,0.36166328158178374,0.44991249191411004,3169497262,3126361345.2,50.066735771865076,46.85361236823526,NaN,NaN,7.7031434296993755,10.979466495815593
2013-12-19T09:30:00-05:00,112.72,112.85,111.885,112.04,32872335,35213715.15,54.89200802744424,53.72264085262568,NaN,NaN,43.02183423761102,-11.600163224647488,-0.05369716606503894,0.38279103433281136,0.4364882003978503,3136624927,3137297079.2,53.26852396179924,46.761158899558104,NaN,NaN,8.01132014560022,10.555445588641968
2013-12-20T09:30:00-05:00,112.1,114.22,112.09,113.93,48774690,35373133.6,62.38270828182487,53.89174526819939,NaN,NaN,125.21368956685315,31.089164781650073,0.08741028508347581,0.545751056752195,0.4583407716687192,3185399617,3151391622,57.08772014303097,46.78165505840843,NaN,NaN,10.963990196597878,10.613809104064241
2013-12-23T09:30:00-05:00,114.18,114.82,113.95,114.78,37049099,35786189.45,65.18299284310397,54.503158101270465,NaN,NaN,179.46958195966778,71.83384692926376,0.22133791909429634,0.7350131705365897,0.5136752514422933,3222448716,3166097751.8,60.696997699856354,47.07758983228418,NaN,NaN,14.334046836951197,11.145271637333806
2013-12-24T09:30:00-05:00,114.91,115.44,114.87,115.22,17371248,35506322.6,66.57027830844784,55.34595496966921,NaN,NaN,184.96993039652443,113.17288282708924,0.3170749588846892,0.9100189500481548,0.5929439911634656,3239819964,3190758097.2,65.87950020050428,48.036069961746385,NaN,NaN,17.464911985842953,12.048077401406541
2013-12-26T09:30:00-05:00,115.63,115.97,115.1,115.23,19670070,34951746.3,66.60284816436501,56.161014131623595,NaN,NaN,168.71726922833625,140.2784610777985,0.3556919068581581,1.0375588747361633,0.6818669678780052,3259490034,3208756651.6,69.08373256158816,49.46489907747919,NaN,NaN,19.916564189594276,13.172146942576218
2013-12-27T09:30:00-05:00,115.47,115.74,114.78,115.16,20070432,34500287.85,66.1172460650185,56.62684762773115,NaN,NaN,139.40324460924032,159.5547431521244,0.3505666167463598,1.120075238810955,0.7695086220645951,3239419602,3229315586.6,72.28532522805705,51.28262693504674,NaN,NaN,21.745958315510133,14.396977138709634
2013-12-30T09:30:00-05:00,115.11,115.37,114.85,115.09,28917378,35162381.65,65.60214731898061,57.07136721292768,NaN,NaN,122.16391493062146,158.94478822487804,0.3174942031756106,1.1663763760341084,0.8488821728584978,3210502224,3234336108,73.0200967266225,53.27077904685433,NaN,NaN,23.101417355295453,15.640468598221894
2013-12-31T09:30:00-05:00,115.36,115.71,115.17,115.36,38358640,34922299,66.68041293059974,58.091257417682264,NaN,NaN,116.86901311792639,146.42467445652977,0.28961315680197486,1.2108986188609663,0.9212854620589914,3248860864,3239618537.6,73.80695775707969,55.42660898525232,NaN,NaN,24.543445411310028,16.912322428663057
2014-01-02T09:30:00-05:00,115.09,115.12,113.64,114.11,44250045,35288247.4,57.66765608194964,59.15990309360853,NaN,NaN,61.98300755011172,121.82728988724723,0.16878459336624996,1.1322662037668039,0.9634816104005539,3204610819,3232576708.6,70.84090946842426,57.50402346319901,NaN,NaN,23.243705221993906,17.81680568485318
2014-01-03T09:30:00-05:00,114.5,114.895,114.11,114.69,26471622,34581332.8,60.34590004619111,60.31563608797267,NaN,NaN,65.13424674567217,101.1106853907144,0.11243399044008906,1.1040240984506653,0.9915901080105762,3231082441,3226895190,68.45077186867181,59.542920584589204,NaN,NaN,22.911800871330783,18.544662140064265
2014-01-06T09:30:00-05:00,115.22,115.265,113.71,113.76,36201506,34495012.3,54.40248332297936,60.88926015492926,NaN,NaN,47.35437981134803,82.70091243113595,0.002829983564055838,0.995127587465646,0.9922976039015902,3194880935,3217987456.6,64.76148010103711,61.45916169794035,NaN,NaN,20.809375055876313,18.868192556608843
2014-01-07T09:30:00-05:00,114.19,115.16,114.11,114.71,28546997,34098768.75,58.859861684385514,61.26767061325348,NaN,NaN,57.895727403630914,69.84727492573782,-0.014435844193178116,0.9742527986601175,0.9886886428532956,3223427932,3220572598.2,65.34523352236121,63.295844075628864,NaN,NaN,20.351425590322894,19.080082989996566
2014-01-08T09:30:00-05:00,114.78,115.08,114.07,114.86,30764666,34075178.85,59.532523491969634,61.76043059382091,NaN,NaN,53.44111216539805,57.16169473523216,-0.023942015790241467,0.9587611231154938,0.9827031389057352,3254192598,3221638945,65.59839018571387,65.01374108547226,NaN,NaN,20.180275587477016,19.2372533610652
2014-01-09T09:30:00-05:00,115.25,115.39,114.16,114.89,29873359,33821525.1,59.6745355038592,61.750971576508526,NaN,NaN,54.39154702002542,55.64340262921489,-0.0356898069734608,0.9380908801889092,0.97378068716237,3284065957,3237529972.6,69.20831410812687,66.38099668091954,NaN,NaN,20.080999822495198,19.357788569840913
2014-01-10T09:30:00-05:00,114.92,115.53,114.3999,115.52,29175394,32921215.8,62.639601946598866,62.30437114216244,NaN,NaN,63.282491602757304,55.273051600631916,-0.009854820679773502,0.961462161312653,0.9713169819924266,3313241351,3253961754.6,72.42993504436092,67.74966890110251,NaN,NaN,20.83754647834745,19.569182556770418
2014-01-13T09:30:00-05:00,115.3,115.49,113.2606,113.94,45378016,33304808.1,52.26109705997542,61.58139891203033,NaN,NaN,17.867469893670272,49.375669617096364,-0.10283256614204372,0.8427762743148719,0.9456088404569156,3267863335,3268558234.6,74.93834687904173,69.02471366796043,NaN,NaN,18.280077180239918,19.38502464583749
2014-01-14T09:30:00-05:00,114.44,115.51,114.18,115.34,39126063,33612078.95,58.77837891988204,61.12392648894305,NaN,NaN,55.48637399711692,48.8937989357936,-0.07499476863249799,0.8518653796662932,0.9268601482987912,3306989398,3285270527.8,77.46628501592343,70.22251990482235,NaN,NaN,18.16194178873633,19.210298523394467
2014-01-15T09:30:00-05:00,115.64,116.29,115.56,116.2,31644489,33494745.2,62.1928476197175,60.81125286831946,NaN,NaN,122.7612472421886,62.7578259511517,-0.007182042933406518,0.917882594632033,0.9250646375654396,3338633887,3302158785.6,79.69517884906622,71.20935409400535,NaN,NaN,19.201475745916586,19.20903812661191
2014-01-16T09:30:00-05:00,116.05,116.38,115.83,116.34,23095126,33029510,62.734006808628294,60.534907057195404,NaN,NaN,140.6753231940232,80.01458118595126,0.03619898955538603,0.9703133745096721,0.9341143849542861,3361729013,3317691396.8,81.50697315642748,72.09672842220816,NaN,NaN,20.190117967414928,19.34919238958377
2014-01-17T09:30:00-05:00,116.31,116.43,115.69,115.93,28737861,31817451.8,60.02432163842202,60.099698169581366,NaN,NaN,122.13711251060302,91.78550536752041,0.02681038473448205,0.9676273658723886,0.9408169811379066,3332991152,3321641357,81.94810206879718,72.78692676797532,NaN,NaN,20.18104579488176,19.468028590340626
2014-01-21T09:30:00-05:00,116.73,116.87,115.78,116.62,29829225,31665296.3,62.926532312457695,59.908582811972586,NaN,NaN,158.6268174321758,119.93737487522151,0.05497728365369903,1.0095385857050303,0.9545613020513313,3362820377,3340632765.4,83.93260656865151,73.56639175669167,NaN,NaN,21.058453527740163,19.695232152826275
2014-01-22T09:30:00-05:00,116.69,117.37,116.5,117.21,24019722,30427547.9,65.24969346579407,59.806388564486475,NaN,NaN,199.62431881477713,148.76496383875354,0.09869961862930288,1.0779358253379598,0.979236206708657,3386840099,3356602905.6,85.38737447826746,74.39356437963366,NaN,NaN,22.505629132710162,20.09671743566683
2014-01-23T09:30:00-05:00,116.72,116.78,115.66,116.42,36059538,30378069.85,59.84234344682635,59.96172337626337,NaN,NaN,102.7053345648181,144.75378130327945,0.06158647005489015,1.0562192942772697,0.9946328242223795,3350780561,3359032240.4,85.6009470800197,75.4478527804619,NaN,NaN,22.09493431344289,20.38217698963484
2014-01-24T09:30:00-05:00,115.69,115.74,113.2201,113.45,57138648,32366439.85,44.808229639558476,58.85188977578962,NaN,NaN,-108.02368058886705,95.01398054670139,-0.16351013613567678,0.7902451540527835,0.9537552901884603,3293641913,3345414820.4,78.66081303131264,76.17714143493625,NaN,NaN,16.145179377402243,19.776891616458755
2014-01-27T09:30:00-05:00,113.78,113.84,111.15,111.79,60388333,34402353,38.92242958218641,57.74617165144726,NaN,NaN,-236.02426206145415,23.381705632289965,-0.410657383388189,0.44043356095322395,0.851090944341413,3233253580,3325467306,69.74099369114006,76.53282097708644,NaN,NaN,8.915864358741567,18.22531629392773
2014-01-28T09:30:00-05:00,111.93,112.985,111.79,112.97,43845082,35591085.5,44.502967735860025,56.72067922655259,NaN,NaN,-174.01386041543202,-43.1464299372316,-0.4764915416876233,0.2554765172318838,0.7319680589195071,3277098662,3308322963,63.116436670721775,76.37362120196936,NaN,NaN,5.178204151202251,16.361443130681234
2014-01-29T09:30:00-05:00,111.88,112.58,111.02,111.34,61930645,37241748.85,39.17789324249918,55.26677706587613,NaN,NaN,-198.50442708581767,-122.77217911735056,-0.6034726478054732,-0.022372750837334365,0.5810998969681388,3215168017,3273988546.6,52.38476826722892,75.42979106493472,NaN,NaN,0.08680618699966051,14.036494995869582
2014-01-30T09:30:00-05:00,112.33,113.65,112.04,113.001,40867981,37367215.9,46.23753406789492,54.30699124902154,NaN,NaN,-106.12124363099852,-164.5374947565139,-0.5507235489353988,-0.1073045392011096,0.4434190097342891,3256035998,3255039634,47.57682297974459,73.88468455576455,NaN,NaN,-1.4277275535480847,11.827320345952772
2014-01-31T09:30:00-05:00,111.25,113,111.17,112.16,49294763,37619451.8,43.48536378546798,52.938831380369336,NaN,NaN,-132.4408070316522,-169.4209200450709,-0.5465048189619699,-0.2397120139681732,0.30679280499379663,3206741235,3237659498.4,43.62211216798429,71.82698292173765,NaN,NaN,-3.596714248086505,9.62388683251859
2014-02-03T09:30:00-05:00,111.87,112.2,108.15,108.65,91709562,40881348.8,34.30710143421538,51.656403121386475,NaN,NaN,-206.82327700074532,-163.58072303292914,-0.7420088865201527,-0.6207183031563943,0.12129058336375842,3115031673,3214015117,38.886485414057674,69.25184995995308,NaN,NaN,-9.241240918678546,6.928868582347571
2014-02-04T09:30:00-05:00,109.19,109.95,108.4,109.47,53173783,41729962.65,37.61960894781749,50.145062409096155,NaN,NaN,-177.66148302572867,-164.31024755498848,-0.7744250153452066,-0.8467406858177497,-0.07231567047254323,3168205456,3192236475.8,35.10606236401132,66.22611977053079,NaN,NaN,-12.24794471101017,4.189323826153608
2014-02-05T09:30:00-05:00,108.81,109.15,107.27,108.65,60669948,43336110.2,35.68197381279768,48.25142856574473,NaN,NaN,-169.93701626891,-158.59676539160694,-0.805817374073551,-1.079587388064482,-0.273770013990931,3107535508,3170709974,31.813867448786553,62.806026099082246,NaN,NaN,-15.26509561596071,1.4101210487087052
2014-02-06T09:30:00-05:00,108.88,109.97,108.85,109.51,57619699,44678861.85,39.21789628044577,46.57170638516027,NaN,NaN,-116.63471325142125,-160.6994593156915,-0.7258721182117674,-1.1811101617556403,-0.4552380435438729,3165155207,3152533815.8,29.314133445022932,59.07796611969621,NaN,NaN,-16.443156641531946,-1.1403471927542448
2014-02-07T09:30:00-05:00,109.97,110.835,109.5,110.75,52626463,45816517.05,43.99844784474626,45.42700111418343,NaN,NaN,-80.53467140412539,-150.31823219018614,-0.5544283432715127,-1.1482734726332637,-0.593845129361751,3217781670,3154741902.8,30.033362303716075,55.36977042219041,NaN,NaN,-15.78655240191907,-3.232662222634934
2014-02-10T09:30:00-05:00,110.79,111.09,109.96,111.04,38261778,46270836.25,45.08623640076696,44.15269426334839,NaN,NaN,-64.71459383238131,-121.89649555651332,-0.39398556145665853,-1.0863270811825743,-0.6923415197259157,3256043448,3182944257.8,38.62333325095164,52.13339375664042,NaN,NaN,-14.923440093232179,-4.902773347005969
2014-02-11T09:30:00-05:00,111.12,112.34,110.87,112.03,44404445,46222157.7,48.74632274791371,42.97388206921408,NaN,NaN,-32.44302359729457,-92.8528036708265,-0.20327832728802286,-0.9464394288359443,-0.7431611015479215,3300447893,3209392745.2,45.39413544710252,49.27673382584293,NaN,NaN,-13.044195494701356,-6.065833653819595
2014-02-12T09:30:00-05:00,112.2,113.01,111.972,112.47,42324292,46382069.15,50.33084753064812,42.294489503772766,NaN,NaN,-8.69837424424527,-60.60507526589354,-0.03823551172063544,-0.7909554911987158,-0.7527199794780803,3342772185,3256440080.6,54.92063755464186,47.0852831454588,NaN,NaN,-11.034819944044532,-6.775688838137444
2014-02-13T09:30:00-05:00,111.38,114.07,111.36,113.9,42102313,46904960.35,55.18048428332036,43.03536483547005,NaN,NaN,15.069089879227295,-34.264314639763825,0.1653361600024883,-0.5460497794749699,-0.7113859394774582,3384874498,3300383938.8,61.650441143058934,45.87025658201211,NaN,NaN,-7.765304008905294,-6.917062433961422
2014-02-14T09:30:00-05:00,113.64,114.21,113.14,114.06,33396501,47420029.1,55.701653321436154,44.23388081684504,NaN,NaN,43.69668540656814,-9.418043277625113,0.3009601413169255,-0.3351857628313013,-0.6361459041482268,3418270999,3340481804.6,66.55661180250902,45.64280073282415,NaN,NaN,-4.982801172044573,-6.6407393965447294
2014-02-18T09:30:00-05:00,114.41,115.45,114.14,115.25,33666606,47666466.35,59.47594934152817,45.303379502964184,NaN,NaN,86.84315955307173,20.8935073994655,0.4519324381323637,-0.0712303564827721,-0.5231627946151358,3451937605,3379660636,70.52449143233699,46.17194750151096,NaN,NaN,-1.4188680171497972,-5.894757770916882
2014-02-19T09:30:00-05:00,114.9,115.64,113.98,114.07,44064964,48378253.3,54.51584388616202,46.39894740608296,NaN,NaN,80.62436498622746,43.5069851161699,0.45233263579769145,0.042253000131978524,-0.4100796356657129,3407872641,3401145585.6,72.454529846128,47.605501900003745,NaN,NaN,0.16944080785081583,-5.028443688235782
2014-02-20T09:30:00-05:00,114.2,115.54,113.91,115.3,35941069,48974320.65,58.409449696955804,47.26836995101588,NaN,NaN,103.51064283025988,65.94878853107093,0.5111057919852239,0.2288026043158169,-0.282303187669407,3443813710,3421353890.6,74.16787555838478,49.504862798478044,NaN,NaN,2.7422428699195573,-3.9183456084993056
2014-02-21T09:30:00-05:00,115.62,116.11,115.4,115.66,34815637,48912125.6,59.50216180025101,48.41242695207181,NaN,NaN,138.1777288582265,90.57051632687077,0.5466987207295866,0.4010702132425763,-0.1456285074870103,3478629347,3440104860.4,75.67950634479962,51.794676668250574,NaN,NaN,5.166402641616659,-2.6205244299113106
2014-02-24T09:30:00-05:00,115.84,117.305,115.76,116.51,43116053,48210995.85,62.03821752126097,50.393220958289355,NaN,NaN,154.46675558189514,112.72453036193617,0.5959215101492357,0.5992733801995342,0.0033518700502986054,3521745400,3460799740.6,77.26104554778118,54.53571667780225,NaN,NaN,7.985184064866489,-1.1054232163716249
2014-02-25T09:30:00-05:00,116.66,117.24,116.18,116.63,28488442,46616001.3,62.39623586097352,52.162980023514784,NaN,NaN,137.00546593935243,122.75699163919231,0.6031617719766218,0.7573040850210759,0.15414231304445408,3550233842,3480458988,78.6794333060509,57.648100316519354,NaN,NaN,10.387246140712383,0.5363866917832334
2014-02-26T09:30:00-05:00,116.71,118.11,116.43,117.35,40808471,46464170.75,64.55614537867457,54.22542084964885,NaN,NaN,133.8152826167467,133.39517516529617,0.6206245229621392,0.929922966747128,0.3092984437849889,3591042313,3517092922.4,81.05137273387979,61.1650649797403,NaN,NaN,13.069193900116547,2.326787721545135
2014-02-27T09:30:00-05:00,116.96,118.055,116.76,117.99,29911862,44863231.6,66.40342002230123,56.16724397406709,NaN,NaN,124.41131512235785,137.57530962371575,0.6370591639142678,1.1056223986778235,0.4685632347635558,3620954175,3552521015.4,83.0188951536741,65.0011193875011,NaN,NaN,15.892191022049836,4.264702478760093
2014-02-28T09:30:00-05:00,117.96,118.71,116.8,117.52,47375710,45188618.05,63.77471638731174,57.57983458425034,NaN,NaN,109.9276232088346,131.9252884938374,0.5796982808436226,1.193186085818084,0.6134878049744614,3573578465,3571510839,83.97914754104,68.85438976159567,NaN,NaN,17.573811282319145,6.166003736411386
2014-03-03T09:30:00-05:00,116.52,117.26,115.58,116.89,50899497,45268854.75,60.32730976400949,58.66848268162481,NaN,NaN,74.1341240183499,115.85876218112833,0.46755866939352586,1.1979361417163688,0.7303774723228429,3522678968,3571697552.6,83.98873458710904,72.0947755713212,NaN,NaN,18.08031423292238,7.868048093055814
2014-03-04T09:30:00-05:00,118.2,120.58,118.18,119.83,112815303,46324141.8,68.80258867227838,60.10107310479371,NaN,NaN,133.35627438885064,115.12892387102798,0.5537267550137699,1.4225359160900553,0.8688091610762854,3635494271,3588749638.4,84.87870277579879,74.91510180908521,NaN,NaN,21.305559717078758,9.787692610773377
2014-03-05T09:30:00-05:00,119.86,119.96,119.47,119.76,34692352,45400070.25,68.42776235223747,61.39370987776437,NaN,NaN,128.22100284325185,114.01006791632899,0.5663199664917102,1.576709119190923,1.0103891526992128,3600801919,3590701559.6,84.98160901063532,77.0623140559419,NaN,NaN,23.744122895401254,11.781468365720215
2014-03-06T09:30:00-05:00,120.12,120.25,119.42,119.74,35093117,44121228.7,68.31325143433205,62.331764674265216,NaN,NaN,121.19285833936652,113.36637655973072,0.5340378407169557,1.6779364535954073,1.1438986128784516,3565708802,3579652485,81.5965013598476,78.48703264285537,NaN,NaN,25.676855913055174,13.76652372962521
2014-03-07T09:30:00-05:00,120.41,120.47,119.025,119.7,36955761,43088031.8,68.06790957639043,63.21506869247623,NaN,NaN,110.60439358181671,113.50173063432715,0.47282747176867046,1.7349329525892898,1.2621054808206194,3528753041,3570687400.2,78.85193907006283,79.3652703048235,NaN,NaN,27.199348434805863,15.68549868750816
2014-03-10T09:30:00-04:00,119.36,119.58,118.49,119.3,32095387,42061478,65.53328683416734,63.64773565623618,NaN,NaN,87.12789795315858,116.10048542128888,0.3726421606923307,1.7279081816860327,1.355266020993702,3496657654,3565483137.4,77.2280142388212,79.8440933624295,NaN,NaN,27.825614005262167,17.41980087575873
2014-03-11T09:30:00-04:00,119.41,119.805,117.51,118.06,50376565,42667217.35,58.28739365358893,63.917132068195244,NaN,NaN,62.9653703334215,102.02230461020307,0.19882382604643656,1.6037958035517477,1.404971977505311,3446281089,3527640501,66.50292017011586,79.41897838557149,NaN,NaN,26.336701655166983,18.693643844245624
2014-03-12T09:30:00-04:00,117.34,118.44,116.92,118.42,37236926,42308841.4,59.681201972506045,64.00797151644883,NaN,NaN,39.63612043300416,84.30532812815352,0.08962068544993906,1.5169978343177348,1.4273771488677958,3483518015,3504183720.2,60.86087995718157,78.46847869977127,NaN,NaN,25.46086231663849,19.660389340301748
2014-03-13T09:30:00-04:00,118.85,118.96,116.38,117.05,53542790,42869766.3,52.49271469704027,63.50729672336235,NaN,NaN,16.133489141682592,63.293454288616736,-0.08396711631610687,1.3224182534726623,1.4063853697887692,3429975225,3477037004.8,55.04098407381491,76.99429853755807,NaN,NaN,22.51936221723703,20.06881403700679
2014-03-14T09:30:00-04:00,116.63,117.87,116.62,117.54,46894073,43109354.3,54.599038769653774,62.97592681253327,NaN,NaN,3.333872296514729,41.83935003155635,-0.16991798421252358,1.1939878895231146,1.3639058737356382,3476869298,3466660256.2,52.956378225368056,75.25825087167142,NaN,NaN,20.64572903492025,20.15123046528014
2014-03-17T09:30:00-04:00,118.22,119.1,117.878,118.06,41563375,43517698,56.788591201648856,62.575380765438645,NaN,NaN,43.65761961167257,33.14529436325911,-0.19413222587535772,1.121240591391441,1.3153728172667987,3518432673,3471015260,53.748111967355776,73.47744220462177,NaN,NaN,19.675757691118793,20.08330578325709
2014-03-18T09:30:00-04:00,118.22,119.88,118.1,119.78,41606597,43914697.55,63.12361721626535,62.47305732526656,NaN,NaN,82.24915130648424,37.002050557871655,-0.10135813249920078,1.1886751516427978,1.2900332841419986,3560039270,3493766896.2,57.748728852360955,71.81296764165613,NaN,NaN,20.73274493883494,20.176082805482498
2014-03-19T09:30:00-04:00,119.68,119.74,118.1,119,47422981,44082598.4,58.90606173480561,61.937531733302585,NaN,NaN,58.63483544615112,40.80179356050104,-0.09943453229553856,1.1657401187725753,1.2651746510681139,3512616289,3499586551,58.73201525300936,70.07819050589437,NaN,NaN,20.318398309398273,20.19641359175618
2014-03-20T09:30:00-04:00,118.73,119.54,118.16,119.16,33212932,43946191.55,59.5037758633853,61.632464553022125,NaN,NaN,51.834499351030466,47.941995602370625,-0.09433986404589434,1.147249821010746,1.2415896850566404,3545829221,3522757350.2,62.476343209990645,68.54227591081941,NaN,NaN,20.158481416058383,20.19099470951364
2014-03-21T09:30:00-04:00,119.72,120.26,118.56,118.61,47872766,44599048,56.46351360919931,61.35647911339282,NaN,NaN,57.82804836376165,58.840830815820006,-0.13262022438439258,1.0758144045761497,1.2084346289605423,3497956455,3526974781.6,63.132037576434804,67.0525118386284,NaN,NaN,19.136433335842092,20.04034308470342
2014-03-24T09:30:00-04:00,119.07,119.23,116.19,117.26,66747026,45780596.65,49.74502018682049,59.995224221574404,NaN,NaN,-58.419571282927734,38.42539263689995,-0.24683235532021075,0.8998941848102788,1.1467265401304896,3431209429,3509530132.8,58.57281026453622,65.17351951639536,NaN,NaN,16.14274173905566,19.483542892468027
2014-03-25T09:30:00-04:00,117.665,118.31,116.14,116.93,47699697,46741159.4,48.23416238245984,58.55282422373315,NaN,NaN,-94.08326606217649,3.1589091631678,-0.33699326243247674,0.7254849620898938,1.0624782245223705,3383509732,3474224225.2,50.60712824562109,62.71819946175149,NaN,NaN,13.23187222837653,18.5904470833121
2014-03-26T09:30:00-04:00,117.63,117.68,114.65,114.69,69060817,48153776.7,39.47083466774034,56.49265159754803,NaN,NaN,-179.72808514499923,-44.513674955062264,-0.5284766067470439,0.4018824660885656,0.9303590728356095,3314448915,3434590750.4,43.461632108477495,59.994280229510764,NaN,NaN,7.533250310464585,17.010847544333885
2014-03-27T09:30:00-04:00,114.71,115.38,113.69,114.4,65234852,49919926.2,38.49570744703371,54.38035144545112,NaN,NaN,-212.70846920712958,-97.42226866669428,-0.6477800689069644,0.12063398670190395,0.7684140556088683,3249214063,3375267718.8,35.403826754640605,56.89084363555203,NaN,NaN,2.683578497673615,14.964094823382418
2014-03-28T09:30:00-04:00,114.48,116,113.98,114.29,50557963,50079038.85,38.111101634947005,52.421623931221085,NaN,NaN,-165.46657270187293,-142.0811928798212,-0.7026248933663479,-0.10986706109906663,0.5927578322672813,3198656100,3315407647.8,29.467103963057014,53.479350044426006,NaN,NaN,-1.3177930130883657,12.638110846743734
2014-03-31T09:30:00-04:00,115.04,116.68,114.6299,116.34,44599234,49764025.7,48.448092579236224,51.71881671162446,NaN,NaN,-103.14823160349283,-151.0269249439342,-0.5747456580568835,-0.12567424030382313,0.44907141775306036,3243255334,3277816828.8,26.465794712898997,50.619555368910525,NaN,NaN,-1.6996979626589335,10.589852445400496
2014-04-01T09:30:00-04:00,116.63,118.06,116.59,117.87,47906600,46518590.55,54.549652055634326,51.35227743184792,NaN,NaN,-18.24579870656573,-135.85943147281208,-0.3709173864343255,-0.014575315289846458,0.356342071144479,3291161934,3259347269.2,25.11241043309289,48.06609326004705,NaN,NaN,0.04447457717953307,9.083369892797501
2014-04-02T09:30:00-04:00,118.29,118.482,117.71,118.4,33856476,46476796.75,56.47158438392299,51.636482409482404,NaN,NaN,22.4658551883757,-95.42064340613707,-0.1931430131018691,0.11491330476714268,0.3080563178690118,3325018410,3261461168.2,25.581471774922278,45.961842381554725,NaN,NaN,2.072828160121772,8.081863930986682
2014-04-03T09:30:00-04:00,118.4,118.44,116.68,117.2,38473979,46645839.85,51.19317572129345,51.39320647745666,NaN,NaN,-13.204768348034253,-55.519903234317994,-0.15098229128695528,0.11932845376031764,0.2703107450472729,3286544431,3268927241.8,27.31315451361708,44.13018354500108,NaN,NaN,2.0736883683407594,7.223553136322979
2014-04-04T09:30:00-04:00,117.96,118.12,114.02,114.49,86345902,49115346.9,41.711206903637446,50.31625045617013,NaN,NaN,-111.9215981722187,-44.81090832838716,-0.29205226685730057,-0.09475458852435281,0.19729767833294776,3200198529,3269235727.6,27.388337785906828,42.24734253204044,NaN,NaN,-1.3524553269494821,5.998409070141198
2014-04-07T09:30:00-04:00,113.95,114.24,112.08,112.82,68537730,50937464.05,37.14534556744171,48.4606596241113,NaN,NaN,-202.0229029901553,-64.58584260571965,-0.47353655599111155,-0.3946230166559417,0.07891353933516987,3131660799,3246916820.6,25.345696694223548,39.93284023503063,NaN,NaN,-5.857045371479879,4.304772721338187
2014-04-08T09:30:00-04:00,112.81,114.2,112.2,113.61,60088199,51423045.75,40.46532398024362,47.14346407021401,NaN,NaN,-152.6540692162051,-91.46749670764753,-0.5127673089970198,-0.5620455969111049,-0.04927828791408509,3191748998,3227034233.4,23.65329775524667,37.427217556619006,NaN,NaN,-8.238195001898191,2.512920189447276
2014-04-09T09:30:00-04:00,114,115.25,113.5,115.25,42744858,51698442.35,46.75305496820235,46.23269829198666,NaN,NaN,-83.65353447428951,-112.69137464018056,-0.4053660459042302,-0.5559858452943729,-0.15061979939014267,3234493856,3208929322.6,22.199670000362886,34.55031232735988,NaN,NaN,-8.010510583244129,1.0095729362056467
2014-04-10T09:30:00-04:00,115.1,115.11,111.4,111.959,74865768,52764591.25,38.065065965690835,44.91852346030748,NaN,NaN,-134.04292085067814,-136.85900514070934,-0.5254498166076471,-0.8074320701497015,-0.2819822535420544,3159628088,3183546054,20.31468682348411,31.491930130720544,NaN,NaN,-11.123355167968935,-0.7237025072478649
2014-04-11T09:30:00-04:00,111.04,112.2375,109.86,110.41,71007952,53970285.2,34.78826366250021,43.85018370857032,NaN,NaN,-171.9260179718531,-148.85988910063622,-0.6694538328977726,-1.1187995446642702,-0.4493457117664976,3088620136,3161230375.4,18.803085328965537,28.651235492465496,NaN,NaN,-14.811207917653613,-2.7362032801629717
2014-04-14T09:30:00-04:00,111.55,111.97,109.65,110.72,62662262,55025229.55,35.97611109472952,42.97460861658958,NaN,NaN,-151.86305469853428,-138.82791944231204,-0.7007388094814131,-1.325269223618264,-0.6245304141368508,3151282398,3165154695.2,19.93139528089948,26.460111709271093,NaN,NaN,-17.18464651881479,-4.800266599970374
2014-04-15T09:30:00-04:00,111.08,111.72,108.66,111.15,76969749,56793387.15,37.67204613833261,42.84612372163188,NaN,NaN,-140.587995885035,-136.414704776078,-0.6504784203894063,-1.4376284396236088,-0.7871500192342025,3228252147,3172455325,22.100129081447392,24.934290064483225,NaN,NaN,-18.491133046507212,-6.756104663761351
2014-04-16T09:30:00-04:00,111.93,112.44,111.23,112.36,49360448,56890260.5,42.303508773369636,43.11810953065587,NaN,NaN,-87.51065066264027,-137.18612801374815,-0.500481358859612,-1.4127517178087174,-0.9122703589491055,3277612595,3181079072.8,24.694840852538007,24.169362500047328,NaN,NaN,-18.078125306224848,-8.373536184113279
2014-04-17T09:30:00-04:00,111.99,113.41,111.72,112.92,50276042,57743416,44.36403551914003,43.564747665241086,NaN,NaN,-61.622834148182086,-122.70211067324894,-0.33617516031771044,-1.3324893093462435,-0.9963141490285331,3327888637,3214731182.6,33.94144726576444,24.488958450240716,NaN,NaN,-17.100769292734114,-9.620283771059112
2014-04-21T09:30:00-04:00,113.13,113.53,112.28,113.45,31970685,56948311.95,46.31805818219974,43.41260235116705,NaN,NaN,-42.70516648025803,-96.85794037492994,-0.17266179306427776,-1.2121413903588802,-1.0394795972946025,3359859322,3268979019.8,45.54850762018539,25.852009372189745,NaN,NaN,-15.71004347779153,-10.490249443449457
2014-04-22T09:30:00-04:00,113.63,115.02,113.47,114.62,40541907,55638056,50.45490391355595,43.120120341018605,NaN,NaN,4.612905557209953,-65.56274832378108,0.02301983798837548,-1.0107047998091332,-1.0337246377975087,3400401229,3318802786,53.6106471540091,27.88759770939805,NaN,NaN,-13.254909285294497,-10.88520084942732
2014-04-23T09:30:00-04:00,114.48,114.77,113.77,113.9,33863201,54946231.2,48.00333644054284,42.51524548792002,NaN,NaN,2.1614785779548282,-37.0128534311831,0.10793810765660816,-0.8988020032267485,-1.0067401108833567,3366538028,3346459962.2,57.38273713003143,30.159116663334423,NaN,NaN,-11.92288208042045,-11.033441025283482
2014-04-24T09:30:00-04:00,114.62,114.67,112.68,113.61,44323900,53709385.35,47.01249546885266,42.216625469888534,NaN,NaN,-13.045987195745482,-22.119920737804165,0.1461760748958001,-0.8240200172636065,-0.9701960921594066,3322214128,3355380268.8,58.55334081798483,32.39055854221783,NaN,NaN,-11.1087642634995,-11.04420148788577
2014-04-25T09:30:00-04:00,113.17,113.21,111.21,111.61,58391755,53367230.5,40.763369371390446,42.148922789013746,NaN,NaN,-69.71651676084801,-23.73865726033734,0.04368986552100984,-0.9155837602581443,-0.9592736257791541,3263822373,3342567016,56.166802921770405,34.446163194779515,NaN,NaN,-12.260499275091542,-11.217958314629453
2014-04-28T09:30:00-04:00,112.01,112.54,109.32,110.96,66050449,54141854.8,38.95121561401461,42.27791350662609,NaN,NaN,-99.2212618822014,-35.04187634072602,-0.05557276691644708,-1.028739584424713,-0.9731668175082658,3197771924,3310149536.4,50.55287246601305,36.24667574990734,NaN,NaN,-13.758693858935548,-11.580920535244609
2014-04-29T09:30:00-04:00,111.42,111.98,110.9,111.24,34487600,53636273.1,40.1847917155154,42.25787548771694,NaN,NaN,-77.09470599238267,-51.38339865064454,-0.08813432363710283,-1.0833347220546443,-0.9952003984175415,3232259524,3276521195.4,45.47511440341646,37.80537693906233,NaN,NaN,-14.635658187379837,-12.017311628406784
2014-04-30T09:30:00-04:00,110.88,112.06,109.95,111.98,43933159,53437601.05,43.43771799422391,42.02106570386133,NaN,NaN,-74.26293615968015,-66.66828159817155,-0.04762500639689882,-1.054731656413665,-1.0071066500167662,3276192683,3258452126.4,42.97719049284483,39.28948554566818,NaN,NaN,-14.45982339306989,-12.366241880501514
2014-05-01T09:30:00-04:00,111.75,112.77,110.54,111.94,78690921,55679323.3,43.30063932951663,42.39503522984889,NaN,NaN,-50.99824910514121,-74.25873398005069,-0.013109077078945486,-1.023492996365448,-1.0103839192865025,3197501762,3233509653.2,39.73273178184068,40.67648875697937,NaN,NaN,-14.352404639862282,-12.649979417553052
2014-05-02T09:30:00-04:00,112.09,113.12,111.68,112.03,43451603,55928204.5,43.730908243670065,43.0337955570753,NaN,NaN,-15.969168973576211,-63.509264422596324,0.02416710528549859,-0.9801750376796292,-1.0043421429651278,3240953365,3228935851.6,39.149087327316366,42.129774614004425,NaN,NaN,-14.15015359310495,-12.864290014060465
2014-05-05T09:30:00-04:00,111.12,112.18,110.53,111.89,28108490,53016333.9,43.181956294165545,43.54849878560645,NaN,NaN,-51.92150160175402,-54.049312366506854,0.04648613730946549,-0.946234471328296,-0.9927206086377615,3212844875,3231950441.8,39.77699816849987,43.54731767740445,NaN,NaN,-14.116633573895479,-13.043196236894039
2014-05-06T09:30:00-04:00,111.41,111.71,109.99,110.07,45355109,51857202.85,36.72742955157046,43.4810261722663,NaN,NaN,-100.39334494224482,-58.70904015647928,-0.04905930979475048,-1.0540447458811997,-1.0049854360864492,3167489766,3218996490.2,37.96414281280858,44.68046151535882,NaN,NaN,-15.889941093824422,-13.449874073598378
2014-05-07T09:30:00-04:00,110.2,110.45,108.43,110.139,64244972,52065041.5,37.111223060958885,43.110148621379814,NaN,NaN,-140.48868968884508,-71.95419086231227,-0.09280789574126591,-1.1209953057630315,-1.0281874100217656,3231734738,3210104901.2,36.72683860931446,45.53988992655714,NaN,NaN,-17.255177827009703,-13.993488895514282
2014-05-08T09:30:00-04:00,110.03,111.24,108.69,109.03,58522868,52853942,33.585111262027525,42.3402254601575,NaN,NaN,-132.02563060471996,-88.15966716222803,-0.17676351942937396,-1.2491418093084832,-1.0723782898791092,3173211870,3205246922.8,36.035806825609946,45.68948703797468,NaN,NaN,-19.480150182290064,-14.777297650767965
2014-05-09T09:30:00-04:00,108.69,110.06,108.28,110.03,48409859,51531146.55,39.195342880629674,41.83146008147393,NaN,NaN,-128.532265204447,-110.67228640840219,-0.14652471010250734,-1.2555341775072435,-1.1090094674047362,3221621729,3201380595.6,35.46389559496899,44.96915760760208,NaN,NaN,-19.841674824060597,-15.500780104095483
2014-05-12T09:30:00-04:00,110.68,113.035,110.51,112.53,76294561,51795477,50.46164969138788,41.831941922747625,NaN,NaN,19.991180066939805,-96.28975007466343,0.04976424435189175,-1.0468041619648716,-1.0965684063167633,3297916290,3218394878.6,39.97831871950659,43.995419862280464,NaN,NaN,-16.524361924405362,-15.647006078425466
2014-05-13T09:30:00-04:00,112.38,112.85,111.34,111.43,58122812,51568504.5,46.38882719503269,41.716619833782616,NaN,NaN,7.882161374896293,-74.6346488112352,0.10998340897897418,-0.9590891450930457,-1.0690725540720198,3239793478,3232855621,43.590061103028845,43.01022871749457,NaN,NaN,-15.043285889132896,-15.560760337097957
2014-05-14T09:30:00-04:00,111.1,111.12,109.42,109.62,65720721,51006053.1,40.58434886544433,41.257466504967745,NaN,NaN,-102.05049598268727,-66.94701007000363,0.03619866158802365,-1.0238242270869904,-1.060022888675014,3174072757,3221323224.8,41.448028226584576,41.78842067525169,NaN,NaN,-15.702828678833777,-15.581055814488789
2014-05-15T09:30:00-04:00,109.07,109.21,107.44,108.88,75870525,52331556.95,38.46522701531383,41.0933134795337,NaN,NaN,-163.65937054089463,-73.27375805723855,-0.04950682717400845,-1.1219064226425246,-1.0723995954685162,3098202232,3206321297.2,38.77845780291633,40.54639602390497,NaN,NaN,-16.93086570372591,-15.77388579866552
2014-05-16T09:30:00-04:00,108.93,109.62,108.03,109.57,44668826,52051196.15,41.530899888826724,41.27757664202028,NaN,NaN,-117.35635915303963,-71.03857684695708,-0.04681908700917603,-1.1309234542299862,-1.0841043672208102,3142871058,3190571163,36.146236104583366,39.517350569517134,NaN,NaN,-16.95785865749132,-15.943024778497778
2014-05-19T09:30:00-04:00,109.27,111.04,108.95,110.75,35339501,52219636.95,46.44478061764619,41.72471870645819,NaN,NaN,-50.87192581387607,-85.21119802312026,0.042508286245350746,-1.0309690094141217,-1.0734772956594725,3178210559,3166630016.8,32.531464143168236,38.59280412235655,NaN,NaN,-15.40430136012993,-15.866064290159514
2014-05-20T09:30:00-04:00,110.48,110.51,108.42,109.06,89570244,54671053.8,41.11523309980813,41.55882692828563,NaN,NaN,-89.71855568889511,-104.73134143587853,-0.0017965656201908153,-1.075723002684711,-1.0739264370645203,3088640315,3136399384.2,28.637121455180292,37.56851347680909,NaN,NaN,-15.809649112796844,-15.858004979107704
2014-05-21T09:30:00-04:00,109.65,110.13,108.55,109.62,55278486,55741818.05,43.43163060671664,41.568183448085634,NaN,NaN,-76.55196670380472,-99.63163558010204,0.01605686456669453,-1.0538553563561521,-1.0699122209228467,3143918801,3130368593,27.919089863856144,36.72468191123876,NaN,NaN,-15.39887570704887,-15.7924150830993
2014-05-22T09:30:00-04:00,109.96,111.05,109.62,110.76,41295052,55590375.65,47.922798347852094,41.86760416981292,NaN,NaN,-6.987056433067515,-68.29717275853662,0.10891164359815231,-0.9337726664251562,-1.0426843100233085,3185213853,3147770917.2,33.129438756448806,36.294707013319645,NaN,NaN,-13.61724047028335,-15.481675852697022
2014-05-23T09:30:00-04:00,110.69,112.02,110.51,111.97,42649313,54803253.55,52.25564069999843,42.51572448451527,NaN,NaN,65.34153761060546,-31.757593405807597,0.24812721891663947,-0.7325252863775091,-0.9806525052941486,3227863166,3164769338.8,37.85485200868145,36.157410859046905,NaN,NaN,-10.712943720926395,-14.800428405301219
2014-05-27T09:30:00-04:00,112.69,113.84,112.65,113.58,46373919,53819427.05,57.34141290873808,43.988151867170096,NaN,NaN,163.42072485587147,11.100936728141914,0.4340644660931188,-0.4380719226777501,-0.8721363887708689,3274237085,3183974644,42.7751018396212,36.50105078953352,NaN,NaN,-6.522376378092663,-13.617849544271426
2014-05-28T09:30:00-04:00,113.33,113.46,112.525,112.99,37055940,53947844.05,55.028121520054235,45.26793032853404,NaN,NaN,125.98581284433776,54.24181043478849,0.4981506331779426,-0.24944809729844053,-0.7475987304763831,3237181145,3213682810,49.44315705034717,37.409359249607284,NaN,NaN,-3.863311594167852,-12.224344122828057
2014-05-29T09:30:00-04:00,113.33,113.59,112.7,113.37,25557332,53029052.7,56.252269026843955,46.88701302602094,NaN,NaN,122.74168079700532,94.10053993495049,0.5432711489776919,-0.06850979425426829,-0.6117809432319602,3262738477,3237446745.2,54.05504927385085,38.69644799591021,NaN,NaN,-1.3372712271360383,-10.669047994872056
2014-05-30T09:30:00-04:00,113.33,113.43,112.34,112.86,38856791,51037346.2,54.12292777186095,47.95326908968031,NaN,NaN,97.34469162837394,114.96688954723876,0.516103124342644,0.03334796219634484,-0.4827551621462992,3223881686,3245180311.8,55.478413317335544,40.126056404650676,NaN,NaN,0.13168638822028772,-9.126085940144579
2014-06-02T09:30:00-04:00,113.07,113.1,111.36,112.25,40374390,50883485.55,51.60666849309371,48.03505614694502,NaN,NaN,65.91329873071777,115.08124177126123,0.4374921659701571,0.06411004531639719,-0.3733821206537599,3183507296,3236309137.8,53.43348698170526,41.087139851950575,NaN,NaN,0.6403355990322988,-7.7308828631193105
2014-06-03T09:30:00-04:00,111.64,112.36,111.11,111.98,31147213,51035421.7,50.48779969110939,48.327839896664784,NaN,NaN,43.90742737195169,91.1785822744773,0.3514595622388027,0.06594233214474343,-0.28551723009405927,3152360083,3211933737.4,48.17860244096423,41.41489280466025,NaN,NaN,0.748629313763645,-6.51952398070746
2014-06-04T09:30:00-04:00,111.48,112.565,111.16,112.42,28835813,50209456.9,52.30265151960336,49.164861514819,NaN,NaN,50.20527208457233,76.0224741225242,0.309794680102642,0.1017261200342432,-0.20806856006839877,3181195896,3200736687.6,45.943436980283835,41.73599342992448,NaN,NaN,1.337251097344135,-5.397127540985803
2014-06-05T09:30:00-04:00,112.72,114.88,112.09,114.78,67185749,50356495.75,60.63683357112013,50.748547697376594,NaN,NaN,123.75199405253537,76.2245367736302,0.41994659807521734,0.3168646875256229,-0.10308191054959442,3248381645,3197865321.2,45.3622448751384,42.20626393508319,NaN,NaN,4.475144629486945,-3.9868029452039817
2014-06-06T09:30:00-04:00,115.27,116.24,115.11,115.88,45854004,49723052.55,63.810872332615226,52.339974300504345,NaN,NaN,182.07293452805848,93.17018535356712,0.5381125999645093,0.5695588394060422,0.03144623944153291,3294235649,3211936113.8,48.78154579562094,43.1087860558716,NaN,NaN,8.150690307777113,-2.252875337635254
2014-06-09T09:30:00-04:00,115.88,117.48,115.66,116.9,44032217,49504170.45,66.50773532777754,53.773042494085146,NaN,NaN,195.58605498368496,119.10473660416055,0.6487753367453729,0.8424154103732491,0.19364007362787616,3338267866,3242888227.8,55.394417921847094,44.741854182920086,NaN,NaN,12.11314958167349,-0.20058606344829055
2014-06-10T09:30:00-04:00,116.63,116.83,115.96,116.67,39801683,47679526.55,65.32557506005747,55.50235263410296,NaN,NaN,156.89740865408027,141.70273286058628,0.6676832787968461,1.0282441721239337,0.3605608933270877,3298466183,3272109447.8,60.57025225813589,47.02279209741692,NaN,NaN,14.96617463608384,1.9660940364848707
2014-06-11T09:30:00-04:00,116.03,116.33,115.4,116.1,30149927,46280882.3,62.36694690288345,56.8548752266863,NaN,NaN,118.33749824207561,155.32917809208692,0.6048701165826533,1.1166485390554044,0.5117784224727511,3268316256,3289533519.8,63.30451230573691,49.55032227183697,NaN,NaN,16.502049778576662,4.042659142497984
2014-06-12T09:30:00-04:00,115.78,115.9199,114.91,115.39,39482798,44968986.15,58.79491687013981,57.63145512113543,NaN,NaN,90.3288229337683,148.6445438683335,0.4838154248899006,1.1165477035851268,0.6327322786952262,3228833458,3285623882.4,62.2612224881913,51.63116396696143,NaN,NaN,16.77445680426383,5.861487379893105
2014-06-13T09:30:00-04:00,115.67,115.91,114.66,115.59,33779504,42864435.1,59.49861567795366,58.14881047670366,NaN,NaN,82.41338189782621,128.71263334228706,0.3895733186727879,1.119698927036211,0.7301256083634231,3262612962,3279299345,60.5235354623162,53.25035564222106,NaN,NaN,17.194161983586685,7.480440894706473
2014-06-16T09:30:00-04:00,115.49,116.15,115.1,116.15,30052776,42133632.6,61.48215457465867,58.44457773855512,NaN,NaN,87.28241004959331,107.05190435546872,0.3391635910998273,1.1540800972382073,0.81491650613838,3292665738,3270178919.4,58.00920780473195,54.3385060683004,NaN,NaN,18.100254172528704,8.997557077252505
2014-06-17T09:30:00-04:00,116.04,117.45,115.78,116.97,62581411,43495728.1,64.2435922375626,59.10282564694857,NaN,NaN,105.60878593432079,96.79417981151683,0.33468928066698234,1.233278106972108,0.8985888263051256,3355247149,3281535112.6,60.22490863379042,55.10863118140349,NaN,NaN,19.66878904218164,10.522018786528095
2014-06-18T09:30:00-04:00,116.9,117.81,116.5,117.76,37448855,40889658.65,66.71911034487812,59.85045716966529,NaN,NaN,114.00003260027029,95.92668668315576,0.3565635960411244,1.3442933213565311,0.9877297253154067,3392696004,3306411062.2,64.62791480016864,55.86383586185475,NaN,NaN,21.739423810291196,12.124505218494253
2014-06-19T09:30:00-04:00,118.17,118.23,117.1,117.86,30915956,39671532.15,67.03027136792227,60.77241028366967,NaN,NaN,114.85821445015387,100.83256498643287,0.3489591632609155,1.423928679391551,1.0749695161306356,3423611960,3345366762.6,70.19257446162365,56.91484737216105,NaN,NaN,23.535724784970117,13.754679442276519
2014-06-20T09:30:00-04:00,117.87,118.3,117.56,118.25,30104388,39111998.95,68.27601117432162,61.96307761804309,NaN,NaN,115.42093078176117,107.43407476321988,0.3409884331547466,1.5012050575740687,1.1602166244193222,3453716348,3383587439.8,74.44104895648692,58.415387513216885,NaN,NaN,25.410187545916855,15.419752028510853
2014-06-23T09:30:00-04:00,118.5,118.55,117.69,118.02,21388730,38048969.8,66.67597695896626,63.11937599431858,NaN,NaN,109.20246017856519,111.81808478901425,0.29286182064321165,1.5262939002233367,1.233432079580125,3432327618,3411519815.8,77.01898393452944,60.47541476275726,NaN,NaN,26.58260350617484,17.014445096748567
2014-06-24T09:30:00-04:00,117.74,118.91,116.6528,116.76,41792423,37819895,58.5772378233025,63.56756073029709,NaN,NaN,79.53545659237878,106.60341892062586,0.15568947048074144,1.4280439176810518,1.2723544472003103,3390535195,3418577425,77.63285050560077,62.7389443002799,NaN,NaN,25.378993898114732,18.209380639800877
2014-06-25T09:30:00-04:00,116.06,117.79,116.05,117.75,34620791,37698137.55,62.43778246539518,63.69619993703102,NaN,NaN,65.68177980690348,96.9397683619525,0.11313067411712452,1.413767789846716,1.3006371157295915,3425155986,3425069421.4,78.20945522500985,65.085173610985,NaN,NaN,25.417805388555827,19.239155603908728
2014-06-26T09:30:00-04:00,117.79,117.82,116.59,117.55,28018883,37821215.1,61.19693421207569,63.5094900712782,NaN,NaN,65.77534909551223,87.12319529102416,0.05590395510262858,1.3705170596078773,1.3146131045052487,3397137103,3419774450,76.47775499468314,67.06347426806087,NaN,NaN,25.09863561733009,20.076224177254637
2014-06-27T09:30:00-04:00,117.06,118.51,117.03,118.34,38525081,37804629.6,64.2215775467127,63.346193086916436,NaN,NaN,86.31679596077228,81.30236832682638,0.055535656266471056,1.3840326748383376,1.3284970185718665,3435662184,3416163617.2,75.25406374526688,68.48202039830514,NaN,NaN,25.676772368548928,20.87630249029668
2014-06-30T09:30:00-04:00,118.16,118.88,117.83,118.81,34227986,37497309.4,65.92342085250019,63.388896357805194,NaN,NaN,104.71959755009317,80.40579580113199,0.07027619108501981,1.4163422574281412,1.3460660663431214,3469890170,3423676127.6,76.1105211911556,69.59203960780654,NaN,NaN,26.649469584937478,21.70104064667394
2014-07-01T09:30:00-04:00,119.26,120.97,119.2,120.02,65733194,39226608.45,69.8937558990234,63.92652557181519,NaN,NaN,175.34356940817,99.56741836429023,0.14077882450900914,1.5220395969793827,1.3812607724703736,3535623364,3452693761.4,79.11698931157635,70.72150225108079,NaN,NaN,28.718088040806773,22.703475988692915
2014-07-02T09:30:00-04:00,119.56,119.96,118.89,119.1,30796790,39324657.3,63.80647862349706,64.28449426848356,NaN,NaN,132.19139984630138,112.86934237216983,0.10628370915404406,1.5141154089129287,1.4078316997588847,3504826574,3468627879,80.56349085376853,72.0288071343363,NaN,NaN,28.65157086300107,23.553203827879795
2014-07-03T09:30:00-04:00,119.58,119.91,119.25,119.82,15933937,36762066.7,66.28151778606403,64.76898727620573,NaN,NaN,143.96918022227268,128.50810859752193,0.11220505654505564,1.548088020440204,1.4358829638951485,3520760511,3493352560.6,82.5798381979926,73.60425732974177,NaN,NaN,29.344553018265845,24.380539426506374
2014-07-07T09:30:00-04:00,119.44,119.47,117.7,117.77,32278983,36083315.65,54.79259843773848,64.29116183785429,NaN,NaN,53.814359083634585,122.00762122209437,-0.03388241382210322,1.3935299466175195,1.4274123604396227,3488481528,3503916429.4,83.37348153430415,75.41599116756835,NaN,NaN,26.099675108269217,24.62613023818678
2014-07-08T09:30:00-04:00,117.51,117.7,115.7,116.34,52539880,36508698.8,48.479896556164825,63.165183574897306,NaN,NaN,-56.388625050127665,89.78597670205019,-0.22794374322340127,1.142482681410371,1.3704264246337723,3435941648,3497126725,80.82471575661476,76.88740596205581,NaN,NaN,21.114332537135745,24.124444852322345
2014-07-09T09:30:00-04:00,116.67,117.09,116.02,116.49,27892006,35913214.95,49.14179944821258,61.909661367992626,NaN,NaN,-59.62594727083224,42.792073366249745,-0.3405497037698484,0.9447392949214617,1.28528899869131,3463833654,3482768783,75.56402147923487,77.66855643913198,NaN,NaN,17.454264295177165,23.17156191558732
2014-07-10T09:30:00-04:00,114.13,116.05,113.97,115.25,50834501,36947443.65,44.09806518667656,60.271646640760785,NaN,NaN,-143.4530526559423,-12.336817134198991,-0.48412839769196947,0.6801285015763483,1.1642568992683178,3412999153,3464403298.8,69.34648683932853,77.60812160896805,NaN,NaN,12.630283075361938,21.665664938412263
2014-07-11T09:30:00-04:00,115.18,115.38,114.51,115.1,33927024,36669654.95,43.51622116778227,58.50309021172226,NaN,NaN,-145.18455118431135,-70.16756341551579,-0.5689288883557717,0.45309578882360313,1.0220246771793748,3379072129,3436065622.4,61.00547900125305,76.64843804073705,NaN,NaN,8.636283347366689,19.80432471112004
2014-07-14T09:30:00-04:00,116.42,116.46,115.4,115.69,28823439,36421851.7,46.50599012765422,57.06237686662855,NaN,NaN,-97.18200026268651,-100.36683528478002,-0.563921182849402,0.3171231986176224,0.8810443814670244,3407895568,3419948430.4,56.819461812713115,75.20561503203588,NaN,NaN,6.210629900104018,17.862368309546323
2014-07-15T09:30:00-04:00,115.56,116,113.87,114.55,49539593,37396192.55,41.89194409305629,55.87057017161096,NaN,NaN,-151.41176424421317,-119.37146312359712,-0.6120052200142624,0.1160378564491964,0.7280430764634588,3358355975,3404431295.8,53.04558077760393,73.44938148003611,NaN,NaN,2.6428364312298878,15.688149469786833
2014-07-16T09:30:00-04:00,115.05,115.09,113.82,114.24,63437530,37438998.5,40.70915677130383,54.318525479175854,NaN,NaN,-151.6232947485323,-137.7709326191371,-0.636481943583176,-0.06755935301551119,0.5689225905676648,3294918445,3370648254,45.89803295384663,71.1414227463816,NaN,NaN,-0.6196218811847606,13.358467848219462
2014-07-17T09:30:00-04:00,113.52,114.266,112.2,112.48,62221525,38677632,34.71616658616543,52.42704207732512,NaN,NaN,-179.05064768386575,-144.8904516247218,-0.7359638914835942,-0.3510322737868279,0.38493161769676626,3232696920,3334587807.4,39.742323057905935,68.51746332232608,NaN,NaN,-5.559564449637349,10.655891805668489
2014-07-18T09:30:00-04:00,112.69,114.45,112.46,114.23,46165076,39440088,43.606014165761586,50.954501835828616,NaN,NaN,-125.33231202637957,-140.92000379313544,-0.6515652422283791,-0.4295249350887076,0.22204030713967146,3278861996,3314545780.8,36.78908614950021,65.76996492262846,NaN,NaN,-6.898528047076556,8.148117540990626
2014-07-21T09:30:00-04:00,113.51,113.99,113.01,113.77,32722484,39570992.8,41.98751203802365,49.24479406336601,NaN,NaN,-114.30188422967659,-144.34398058653346,-0.5958901017431854,-0.5228223200393103,0.0730677817038751,3246139512,3282194569.6,32.58049866499404,62.660677599331216,NaN,NaN,-8.488841871657167,5.7714090534695135
2014-07-22T09:30:00-04:00,114.47,115.25,114.19,114.73,31330742,40068093.4,46.45424523647785,47.570543301755606,NaN,NaN,-64.2617088382885,-126.91396950534855,-0.46915764625212414,-0.5133792761112801,-0.04422162985915594,3277470254,3266017425.4,30.689861121318785,59.20159701431282,NaN,NaN,-8.365401372748178,3.751864706866986
2014-07-23T09:30:00-04:00,115.01,115.44,114.51,114.865,26418396,39299392.05,47.071416942401015,46.3751817531059,NaN,NaN,-50.87007120014658,-106.76332479567141,-0.35611163452956257,-0.48936117302110915,-0.13324953849154658,3303888650,3267811466.4,31.16691013937597,55.67326982042763,NaN,NaN,-8.077909838418885,2.0618969146832904
2014-07-24T09:30:00-04:00,115.22,115.65,114.34,114.64,31905127,39163608.85,46.11735023291481,44.934884070738086,NaN,NaN,-48.41664541166308,-80.63652434123087,-0.27973278787006356,-0.482915523329126,-0.20318273545906246,3271983523,3275668787,33.33120117686833,52.155510033204465,NaN,NaN,-8.120106433129507,0.6073250078528909
2014-07-25T09:30:00-04:00,113.77,114.01,113.21,113.6,46518509,40088590.15,41.890891985384194,44.01333360985564,NaN,NaN,-86.0267275793661,-72.77540745182817,-0.28171394366674185,-0.5553251650424897,-0.2736112213757479,3225465014,3264989390.6,31.864691185128933,48.476310722549094,NaN,NaN,-9.416593690414263,-0.8246633776138454
2014-07-28T09:30:00-04:00,113.86,113.88,112.23,113.03,37374846,40031078.4,39.74118508571365,43.389139933394844,NaN,NaN,-97.96704531329658,-69.50843966855216,-0.3020693904000701,-0.6511979593758355,-0.3491285689757654,3188090168,3253379521.8,30.30371860545185,44.867668068894595,NaN,NaN,-11.141566275713371,-2.2985066487709203
2014-07-29T09:30:00-04:00,113.39,114.11,113.03,113.34,30574485,39848403.35,41.49947673964389,42.84325973992566,NaN,NaN,-76.99285729826452,-72.05466936054736,-0.27602639916715865,-0.6941615679347137,-0.4181351687675551,3218664653,3241618401.6,28.766355469204726,41.52497763960673,NaN,NaN,-12.069207205270672,-3.6943210139851703
2014-07-30T09:30:00-04:00,114.18,114.31,113.31,113.79,30225035,38072995.4,44.05155423611843,42.8399375291715,NaN,NaN,-62.90727542903001,-74.46211020632406,-0.21270338960599194,-0.684014405775045,-0.4713110161690531,3248889688,3230618609.2,27.367918826204942,38.52650849581219,NaN,NaN,-12.133787413780214,-4.899959071098747
2014-07-31T09:30:00-04:00,112.63,112.99,111.05,111.1899,61511779,39608744.85,34.64659550817362,42.20639283919946,NaN,NaN,-154.935392349873,-95.76585959396604,-0.32349894594800666,-0.8756846986040614,-0.5521857526560547,3187377909,3213697486.4,25.328107212464232,35.97812479661299,NaN,NaN,-15.271779995586272,-6.381647774596965
2014-08-01T09:30:00-04:00,111.16,111.7,109.86,110.68,67805374,42202316.7,33.15179791923465,41.25252196716949,NaN,NaN,-189.80335273027228,-116.52118462414728,-0.4034915595699571,-1.0565502021185011,-0.6530586425485441,3119572535,3192518990.6,23.015899444754254,33.56358462747307,NaN,NaN,-18.290176542696233,-8.082866170039718
2014-08-04T09:30:00-04:00,111.16,111.795,109.89,111.66,34649452,42320840.15,38.631918522869526,41.01966299787044,NaN,NaN,-155.90278659594114,-128.1083328806762,-0.36398256425538855,-1.1080368478677798,-0.7440542836123912,3154221987,3185745354.4,22.314253651953592,31.368489832783755,NaN,NaN,-19.10198256023668,-9.65702565435357
2014-08-05T09:30:00-04:00,111.11,112.23,110.56,111.38,44374974,41912594.85,37.681435288090874,40.80339717764094,NaN,NaN,-129.2077714976171,-138.5513157205467,-0.33122406893041423,-1.158084369775409,-0.8268603008449948,3109847013,3163981826.4,20.185073437109438,29.53184986730253,NaN,NaN,-20.04419410640977,-11.14090686179017
2014-08-06T09:30:00-04:00,110.67,112.47,110.63,111.731,33659052,42200947.15,39.68479422075605,41.15829915154027,NaN,NaN,-105.72564439634071,-147.11498951400887,-0.2633900381540146,-1.156097848537513,-0.8927078103834984,3143506065,3142905101.8,18.35816098470957,28.00440971921708,NaN,NaN,-20.229207442331447,-12.439235516153209
2014-08-07T09:30:00-04:00,112.09,112.52,110.77,111.19,40852248,41701834.5,37.67448229224166,40.73461830343171,NaN,NaN,-97.71409638803571,-135.6707303216414,-0.23345235021649857,-1.1845232481541217,-0.9510708979376231,3102653817,3125960283.4,17.02411606005063,26.592626141399254,NaN,NaN,-20.965761449676453,-13.657310649513672
2014-08-08T09:30:00-04:00,111.33,112.4,110.9923,112.27,32667219,41638844.25,43.7954738613115,40.86375843366655,NaN,NaN,-68.40164290256627,-111.39038835610017,-0.12485622069046043,-1.1071411738006987,-0.9822849531102382,3135321036,3129109983.6,18.213818076849577,25.566434670817504,NaN,NaN,-19.770755728675795,-14.530659946536833
2014-08-11T09:30:00-04:00,112.89,114.22,112.62,113.34,31002727,41747808.65,49.12629331510417,41.054619010711285,NaN,NaN,18.762723281169176,-76.45728638067813,0.02699510354425494,-0.9485410736799196,-0.9755361772241745,3166323763,3131530338.8,19.17286109335052,24.743791811676914,NaN,NaN,-17.069738796750155,-14.893385496567307
2014-08-12T09:30:00-04:00,112.94,113.47,112.04,112.56,31190063,40830332.15,45.721880067590405,40.95822351965338,NaN,NaN,-16.421999135697078,-53.90013190829412,0.07987344312698752,-0.8756943733154401,-0.9555678164424276,3135133700,3136587676.2,21.250795501928636,24.035497909002107,NaN,NaN,-15.817216847518454,-15.025361403846041
2014-08-13T09:30:00-04:00,112.92,113.65,112.7,113.44,23126108,38814761.05,49.937071281144995,41.23106073738411,NaN,NaN,22.587962536491684,-28.237410521727657,0.1737007376206654,-0.7384418944165958,-0.9121426320372612,3158259808,3139538424.8,22.502657350419298,23.262030492827172,NaN,NaN,-13.4350412758995,-14.798172814139393
2014-08-14T09:30:00-04:00,113.52,113.73,113.23,113.61,20882065,36747788.05,50.733045737735274,41.862643148266336,NaN,NaN,36.53560884368133,-1.3874694753842447,0.2425690214921945,-0.6089313551720181,-0.8515003766642126,3179141873,3154836036,28.820131888284152,23.044561971623978,NaN,NaN,-11.271494670234384,-14.294361650724392
2014-08-15T09:30:00-04:00,114.45,114.45,112.26,113.39,53716386,37125353.55,49.63324503760623,42.5692188591158,NaN,NaN,28.284984306753145,17.94985596647964,0.26674153904662623,-0.5180734528559299,-0.7848149919025561,3125425487,3152856926.2,28.49647947282402,22.915473462150565,NaN,NaN,-9.793629614366312,-13.651399931244667
2014-08-18T09:30:00-04:00,114.5,115.135,114.09,115.04,33289919,37153725.3,57.13807232317657,43.68626140079671,NaN,NaN,106.90902705022039,35.579116720289875,0.38036352627627157,-0.30936058405721667,-0.6897241103334882,3158715406,3151335254.8,28.233942731568277,22.877443980890813,NaN,NaN,-6.079490616532987,-12.56969860057157
2014-08-19T09:30:00-04:00,115.13,115.73,115.06,115.44,22692899,36721833.15,58.74299871968558,44.73565029248009,NaN,NaN,140.6738519326091,66.9982869339511,0.4634554506640499,-0.11040479700342587,-0.5738602476674758,3181408305,3160590175.8,32.31814866297913,23.231031826374686,NaN,NaN,-2.5328037221646964,-11.135856475084875
2014-08-20T09:30:00-04:00,114.85,115.22,114.41,114.95,26266947,36714260.7,55.977838394463696,46.259310498643664,NaN,NaN,108.99713103635372,84.28012063392353,0.46520187763164256,0.007642099372077382,-0.4575597782595652,3155141358,3159966485.8,32.18521782414527,23.720825441494764,NaN,NaN,-0.36520084387549684,-9.597191384912106
2014-08-21T09:30:00-04:00,114.88,115.4,113.84,115.2,33023174,36770163.05,57.08771440109644,47.96901881877665,NaN,NaN,106.68093175004242,98.30918521519574,0.46203575419824583,0.11998491448824211,-0.3420508397100037,3188164532,3161771017.6,33.043348524575975,24.437071804339173,NaN,NaN,1.7478441207361788,-7.976472026962352
2014-08-22T09:30:00-04:00,115.04,115.63,114.61,115.21,30102031,35949339.15,57.1342685094498,49.29061524638952,NaN,NaN,115.35018970092196,115.7222262940295,0.43958720050730343,0.20743316092412556,-0.23215403958317787,3218266563,3180339232.8,41.277584096527136,25.791595407522998,NaN,NaN,3.49570854109202,-6.33758908866887
2014-08-25T09:30:00-04:00,115.96,116.41,115.32,115.75,27808593,35471026.5,59.67814109592296,50.861808518377536,NaN,NaN,133.25205302552376,120.99083148909017,0.4390510370466805,0.31665975672517277,-0.12239128032150776,3246075156,3197811182.8,47.784629350729375,27.76299225849585,NaN,NaN,5.720138570498615,-4.615056565930658
2014-08-26T09:30:00-04:00,115.88,116.92,115.8,116.8,34836651,35684134.8,64.1350665295175,52.608256540431924,NaN,NaN,145.66275514227596,121.98861213102354,0.4838235642661509,0.4823881750111809,-0.0014353892549700265,3280911807,3217711883.2,54.03263214990183,30.311168770295296,NaN,NaN,9.040145059504825,-2.664313476582732
2014-08-27T09:30:00-04:00,116.89,116.9448,116.29,116.51,19074974,35126631.75,62.093632855638276,54.352481580674535,NaN,NaN,129.18795959645823,126.02677784304447,0.4680292498826856,0.583601173098387,0.11557192321570138,3261836833,3239050978.2,59.61315732368536,33.35324314626921,NaN,NaN,11.25596395861128,-0.6757024144121586
2014-08-28T09:30:00-04:00,116.03,116.23,115.51,115.91,22817891,33191937.35,57.98150026915429,55.36576918123473,NaN,NaN,88.39114943238148,122.36882137951227,0.3942505674995082,0.6083851325900866,0.21413456509057843,3239018942,3249221860.2,61.98223509790355,36.47955864777306,NaN,NaN,12.020953853631381,1.1381056238797755
2014-08-29T09:30:00-04:00,116.16,116.81,115.65,116.56,26234587,31113398,60.995102767412476,56.21354128497104,NaN,NaN,96.604051868574,118.61959381304268,0.36686951002206736,0.6727214526181626,0.30585194259609527,3265253529,3258619253.4,64.07887027876582,39.68713073244559,NaN,NaN,13.549274404697984,2.9111297354252335
2014-09-02T09:30:00-04:00,116.98,117.5,116.5,117.2,38818975,31321874.15,63.75176520368547,57.501390223263556,NaN,NaN,115.69171643492284,115.1075264949225,0.36853059878062366,0.7665151910718748,0.39798459229125116,3304072504,3270218723,66.53232078568112,42.92152539557076,NaN,NaN,15.67418682695189,4.734423605643327
2014-09-03T09:30:00-04:00,117.76,117.8,116.27,116.46,33267077,30766479.3,58.595173734861085,58.1198261128147,NaN,NaN,99.49461032587888,105.87389753164307,0.29939933329340007,0.7722337589080013,0.4728344256146012,3270805427,3268197447,65.69034226795347,46.006360032537486,NaN,NaN,16.00558792167907,6.344589936505576
2014-09-04T09:30:00-04:00,116.78,117.49,115.7202,116.01,26525384,30409795.9,55.647485591441566,58.470857530936584,NaN,NaN,76.08451731939125,95.25320907622968,0.20734549767586752,0.7320162977094355,0.524670800033568,3244280043,3264686089,64.1710488712666,48.53142553132194,NaN,NaN,15.420979351764208,7.641216995828238
2014-09-05T09:30:00-04:00,115.78,116.42,115.17,116.38,26940137,29714190.35,57.538892201815976,59.035546614094415,NaN,NaN,50.5117416040698,87.67732751056732,0.15760775535905558,0.7216804942323876,0.564072738873332,3271220180,3271126336.6,65.7363086046199,51.191413326450224,NaN,NaN,15.464815118660677,8.758873870518586
2014-09-08T09:30:00-04:00,116.26,116.8,115.83,116.56,20347446,29098201.7,58.46682652140397,59.13045762825352,NaN,NaN,66.482531375674,81.65302341198733,0.1245156790835521,0.7197173377277721,0.59520165864422,3291567626,3276389156,67.00484540825451,53.96076351764209,NaN,NaN,15.756855450851667,9.758585524851883
2014-09-09T09:30:00-04:00,116.36,116.39,115,115.18,36390492,29367589.95,49.52996196612782,58.472383574427965,NaN,NaN,10.423639667197115,60.59940805844218,0.003752173147922644,0.5998918750791233,0.5961397019312007,3255177134,3266610082,62.38316138084041,56.10826442606076,NaN,NaN,13.295753719074844,10.263895266883734
2014-09-10T09:30:00-04:00,115.16,115.93,114.71,115.86,23060927,28961133.15,53.31659072372007,58.282294455089136,NaN,NaN,-0.025077741010753635,40.69547044506426,-0.034175628384668144,0.5534201664503655,0.5875957948350337,3278238061,3268096608.8,62.803171398385985,58.29526110993509,NaN,NaN,12.337327287768547,10.56009984129585
2014-09-11T09:30:00-04:00,115.17,116.73,115.14,116.61,27078656,29158760.55,57.13642499688613,58.28577378335983,NaN,NaN,43.41928637189553,34.162424255565135,-0.013650247525318071,0.570532985428386,0.5841832329537041,3305316717,3280303943.6,66.14604225069115,60.65973923322902,NaN,NaN,12.689492462758892,10.864298787219141
2014-09-12T09:30:00-04:00,116.55,116.56,114.97,115.37,32893604,29759337.5,49.870793902787774,57.76695416859826,NaN,NaN,-11.598214138640024,21.740433107023165,-0.08452955807211882,0.47852128536355565,0.5630508434356745,3272423113,3280544530.2,66.21049341943609,62.44066132772252,NaN,NaN,10.627264594093297,10.830436759629736
2014-09-15T09:30:00-04:00,115.36,115.4,113.705,114.11,41648041,29155920.25,43.77882196300112,56.6312885162467,NaN,NaN,-150.92896322397254,-21.741865812906134,-0.21006764112272458,0.3004662920322687,0.5105339331549933,3230775072,3268386019.4,59.99429411081409,63.31278023915714,NaN,NaN,6.750578276086718,10.247599833409305
2014-09-16T09:30:00-04:00,113.775,114.76,113.4,114.43,51367474,30059798,45.596441720068945,55.30710102985751,NaN,NaN,-162.3373283267588,-56.29405941169732,-0.26197317462862585,0.183067464869211,0.44504063949783684,3282142546,3273779101.8,61.71144491699664,63.8612668653782,NaN,NaN,4.249370885679861,9.39070998373367
2014-09-17T09:30:00-04:00,114.49,115.47,114.19,114.73,45548233,31202564.7,47.31608011716606,54.25156154853807,NaN,NaN,-92.63514724818644,-74.81607331313246,-0.2656855421628878,0.11293371179422707,0.3786192539571149,3327690779,3283669645.4,64.70360382881194,64.22487018717295,NaN,NaN,2.755673879946147,8.442847683192594
2014-09-18T09:30:00-04:00,115.24,115.53,114.91,115.43,24722412,31125337.95,51.1927236594259,53.76664893355747,NaN,NaN,-48.16775141187854,-93.13348086988728,-0.21286414186204428,0.11253907662955953,0.3254032184916038,3352413191,3293088940.2,67.32266263804615,64.60632929718314,NaN,NaN,2.683202674708465,7.6200412534091475
2014-09-19T09:30:00-04:00,115.89,115.91,113.61,113.97,52460118,32097185.15,43.931736654243515,52.547837068331106,NaN,NaN,-123.65538340079358,-115.54491472231798,-0.2647384496190986,-0.0055198435322694195,0.2592186060868292,3299953073,3298594932.2,68.78092859068411,64.9421906051773,NaN,NaN,0.21903716820595118,6.562754955522976
2014-09-22T09:30:00-04:00,113.44,113.53,112.05,112.37,45800592,32882113.2,37.632321340514665,50.68216250667605,NaN,NaN,-243.65537671844095,-134.09019742121168,-0.3878457424197761,-0.22558857193789095,0.16225717048188515,3254152481,3303270414,70.005020755558,65.19024060302566,NaN,NaN,-4.169577252129096,5.029564640144109
2014-09-23T09:30:00-04:00,111.9,112.62,111.19,111.32,51616824,34072524.75,34.16961287612318,48.937479588194776,NaN,NaN,-238.0471002284178,-149.23215180154347,-0.5131633085199654,-0.47919696516807164,0.033966343351893774,3202535657,3287349036.2,61.20435684342227,64.86981307270199,NaN,NaN,-9.012415238713812,3.0235675145929775
2014-09-24T09:30:00-04:00,111.15,112.11,110.6,112.02,34323127,34046848.55,38.24897725523241,47.694728992751266,NaN,NaN,-193.71116618182705,-169.4473555882716,-0.5204463625484563,-0.6165916098336766,-0.09614524728522028,3236858784,3269182637.2,53.01486766856185,64.0729429867945,NaN,NaN,-11.53692767598095,0.9434967730824164
2014-09-25T09:30:00-04:00,111.73,111.83,109.75,110.13,49733609,35579780.3,32.409353054657714,45.89976191081139,NaN,NaN,-196.79966426548523,-199.1737381589929,-0.617467428144074,-0.8679795324653128,-0.2505121043212388,3187125175,3236125034,42.00137273282369,62.37759042452335,NaN,NaN,-15.86659388086722,-1.4579447489103887
2014-09-26T09:30:00-04:00,110.55,111.22,110.2,111.12,26473277,35762549.6,37.76892891510326,44.421340653218486,NaN,NaN,-152.38362934347487,-204.91938734752915,-0.5804463313331265,-0.976070018487647,-0.39562368715452045,3213598452,3218854109.8,37.60583864761547,60.27766137019199,NaN,NaN,-17.473592379551256,-3.7458944104305125
2014-09-29T09:30:00-04:00,109.82,111.35,109.72,111.03,30619676,35981804.05,37.47798315748732,43.56048502402988,NaN,NaN,-133.87916605946208,-182.9641452157334,-0.5289510333450081,-1.0568124788357807,-0.5278614454907725,3182978776,3204619368.8,34.40955105681326,58.279546347047194,NaN,NaN,-18.799811334369657,-5.896453970993248
2014-09-30T09:30:00-04:00,110.92,111.03,109.31,109.35,55596881,36820699.35,32.4525084918437,42.07019343603871,NaN,NaN,-136.7348417384849,-162.70169351774683,-0.5713475541526793,-1.2420458881816216,-0.6706983340289423,3127381895,3189588616.4,31.37693822918922,56.03481540639028,NaN,NaN,-21.680639956467026,-8.151337683203787
2014-10-01T09:30:00-04:00,109.29,109.39,107.43,107.8,88630419,39588866.45,28.637131240708896,40.034529596311764,NaN,NaN,-160.21459057525445,-156.0023783964323,-0.6607726393731459,-1.4966641332453747,-0.8358914938722288,3038751476,3149967154.8,25.097707173863682,53.10279147233117,NaN,NaN,-25.469435755832336,-10.625351693579294
2014-10-02T09:30:00-04:00,107.79,109.28,106.94,108.83,71834884,41854341.45,34.175325014293904,38.91342467570506,NaN,NaN,-134.32882862376545,-143.50821126808836,-0.6088308997823985,-1.596930118600227,-0.9880992188178285,3110586360,3134659391.8,23.168578440771455,50.02836897385513,NaN,NaN,-26.63963608062251,-12.913106606014038
2014-10-03T09:30:00-04:00,109.75,110.32,109.08,109.65,44036688,42709169,38.28181088388589,38.520781027196826,NaN,NaN,-87.01354076635606,-130.43419355266457,-0.48302010557676556,-1.5918743507887854,-1.1088542452120198,3154623048,3122864311,21.77943333965962,47.29873606162981,NaN,NaN,-26.200942800761663,-14.811368919549412
2014-10-06T09:30:00-04:00,109.95,110.07,108.51,108.71,35573619,43470477.65,35.54433274419557,37.80277324320587,NaN,NaN,-93.51938630289769,-122.36223760135172,-0.4287230165382161,-1.6447580158847899,-1.2160349993465738,3119049429,3110078441.6,20.354720327173794,44.34468430521389,NaN,NaN,-26.738631340589563,-16.515263551126576
2014-10-07T09:30:00-04:00,108.02,108.5,106.85,106.92,40275436,43664724.85,30.998543145303216,36.637234888072804,NaN,NaN,-125.67189499519858,-120.14964825269445,-0.47536354334535114,-1.8102394285282628,-1.3348758851829117,3078773993,3100356861.2,19.31987279333947,41.10298923125157,NaN,NaN,-28.762424220897557,-18.264857932522432
2014-10-08T09:30:00-04:00,106.68,109.04,105.76,108.97,51597394,45091548.2,40.39954341205825,35.86629344183226,NaN,NaN,-103.44958132139789,-108.79664640192314,-0.33668156006168504,-1.7557278352600179,-1.4190462751983328,3130371387,3118680843.4,26.86716730340045,38.213310993062585,NaN,NaN,-27.13084463919318,-19.531427462046825
2014-10-09T09:30:00-04:00,108.89,108.9,106.01,106.03,60786087,46776919.75,33.37637445154007,35.11233899878202,NaN,NaN,-119.00812147016926,-105.73250497120391,-0.4067957335426573,-1.9275409421266545,-1.5207452085839972,3069585300,3110480631.4,25.70816141199859,35.13668476601362,NaN,NaN,-28.374304969300297,-20.79469567736875
2014-10-10T09:30:00-04:00,105.77,106.89,104.59,104.74,66579488,48461213.95,30.842779246048224,34.627371706320126,NaN,NaN,-149.9707212700293,-118.32394107193856,-0.49787747713570996,-2.1430920550036348,-1.6452145778679248,3003005812,3080157184.2,21.93919234281549,31.703411307960586,NaN,NaN,-30.285729804441942,-22.150557695522064
2014-10-13T09:30:00-04:00,104.84,106.11,103.86,104.32,72054307,49981527.25,30.043151561871014,34.33262446958783,NaN,NaN,-148.39001651845925,-129.29806711505086,-0.5406705009590671,-2.3210527040667586,-1.7803822031076915,2930951505,3042537599.4,18.345774520866186,28.64208399920658,NaN,NaN,-32.017088206098904,-23.560062054175898
2014-10-14T09:30:00-04:00,105.23,106.99,104.86,105.54,70043423,50915324.7,35.29114468263241,34.12135071440211,NaN,NaN,-109.37223093177593,-126.03813430236634,-0.4450605436187405,-2.336707882631117,-1.8916473390123767,3000994928,3026981786.4,17.0986433488293,26.07663940493997,NaN,NaN,-31.643832472793882,-24.71488639969275
2014-10-15T09:30:00-04:00,104.19,107,103.54,106.6,117505455,54513185.8,39.535339927435075,34.63034977674336,NaN,NaN,-101.6378187232517,-125.67578178273712,-0.27691075415351873,-2.2377857817042752,-1.9608750275507565,3118500383,3024607585.6,16.909704391148864,24.28437738053463,NaN,NaN,-29.92411833462182,-25.459062390396905
2014-10-16T09:30:00-04:00,105.15,108.57,104.95,107.8,100537136,58303922,44.01231056603886,35.07630560895304,NaN,NaN,-56.268972730293655,-113.12795203476199,-0.06254348450412373,-2.039054383180911,-1.9765108986767874,3219037519,3054498029.4,27.736034193559846,23.579391348102085,NaN,NaN,-27.022474273202807,-25.682406945083464
2014-10-17T09:30:00-04:00,109.16,109.22,107.04,107.48,72674963,59314664.25,43.09593737005882,35.47758805270816,NaN,NaN,-24.400553557890284,-88.01391849233418,0.0726942200927696,-1.8856431235608255,-1.9583373436535951,3146362556,3083169378.2,36.30862367155291,23.715039392012063,NaN,NaN,-25.001628070659308,-25.585152820165728
2014-10-20T09:30:00-04:00,107.01,108.74,107,108.74,34916678,58770468.55,47.712330092429646,36.56757530989286,NaN,NaN,-9.09174335982358,-60.154263860607045,0.2519118863642791,-1.6434474856982462,-1.8953593720625252,3181279234,3133234924,47.92553263389361,24.89708184949095,NaN,NaN,-21.828969990964346,-25.04855527313696
2014-10-21T09:30:00-04:00,109.33,110.59,109.01,110.53,44752291,58427241.9,53.485507816388036,38.3424593510128,NaN,NaN,72.34490448845912,-23.810836776560045,0.4825496580486939,-1.292172299501658,-1.774721957550352,3226031525,3178242243.4,55.740777783356215,27.08587260731184,NaN,NaN,-17.18228404015189,-23.924802239853378
2014-10-22T09:30:00-04:00,110.8,111.06,108.86,108.95,48801898,59151180.45,48.405132566593615,39.35887417617706,NaN,NaN,63.150525261316346,9.146832020353566,0.5171607871844093,-1.1282709735698404,-1.6454317607542497,3177229627,3189988092.2,57.5320635289637,29.540407256468427,NaN,NaN,-14.877019419268795,-22.632261836912722
2014-10-23T09:30:00-04:00,110.04,111.58,109.77,110.88,60795105,59704255.25,54.1359547192965,40.491313021563535,NaN,NaN,112.0966220041409,42.81995096724047,0.6499131278114194,-0.8330403509899753,-1.4829534788013947,3238024732,3193785534.8,58.12217854880907,32.136317628550536,NaN,NaN,-10.965979945867947,-20.96565013819204
2014-10-24T09:30:00-04:00,110.92,111.32,110.44,111.07,41927606,60476971.7,54.66975581865885,41.85741466973949,NaN,NaN,120.33657072482565,71.76737582378367,0.7246953629065072,-0.5770842751682608,-1.301779638074768,3279952338,3220503491.2,62.11133870411473,35.11893322690345,NaN,NaN,-7.738475316376162,-19.076053735075487
2014-10-27T09:30:00-04:00,110.42,111.09,109.51,111.01,31133656,60502670.7,54.45421924497709,43.532820105430474,NaN,NaN,103.32023932726153,94.24977236120068,0.7416167073090079,-0.374758753938508,-1.1163754612475159,3248818682,3234011380.8,63.97950698247156,38.308907097555746,NaN,NaN,-5.234035357049095,-17.098622538214574
2014-10-28T09:30:00-04:00,111.51,114.21,111.3,114.17,84918882,61968770.75,62.77758380541151,45.13125156209856,NaN,NaN,191.78443714288176,118.13767889208525,0.9251875045456369,0.04010891943453032,-0.8850785851111066,3333737564,3255552588.6,66.7915536361651,41.160648978467506,NaN,NaN,-0.09463085429021688,-14.669480869082523
2014-10-29T09:30:00-04:00,114.36,114.89,112.98,113.9,67138686,60894184.1,61.73939932952274,47.15718191052589,NaN,NaN,176.8680010432609,140.88117404847418,0.9825845893911522,0.34315215162783375,-0.6394324377633185,3266598878,3273426438.8,68.95710193625087,44.249859015914105,NaN,NaN,3.646290385142187,-12.052942118478994
2014-10-30T09:30:00-04:00,113.49,115.38,113.14,114.87,59046218,60254750.8,64.04020428155125,49.528426555918955,NaN,NaN,162.3130559045935,150.9244608285647,1.034783979767383,0.6540475369459102,-0.38073644282147273,3325645096,3290950511.6,70.95680419773267,47.751117005551045,NaN,NaN,7.485512617951358,-9.261734298988943
2014-10-31T09:30:00-04:00,116.91,116.96,115.875,116.56,53134839,60709658.35,67.68619661707069,52.21721548843322,NaN,NaN,182.3078793903386,163.31872256166727,1.1245794135909706,1.0249878241672405,-0.09959158942373003,3378779935,3310716031,73.06440123336273,51.659590342157934,NaN,NaN,11.98437244278336,-6.226576193021471
2014-11-03T09:30:00-05:00,116.75,117.37,115.9,116.36,39740088,60917981.8,66.82271984692036,54.46947085731093,NaN,NaN,153.82401288890725,173.41947727399642,1.1100535654920283,1.2879753674413053,0.17792180194927704,3339039847,3328760264,74.85812559794658,55.785267645666316,NaN,NaN,15.328919700597831,-3.1472196367901426
2014-11-04T09:30:00-05:00,115.9,116.5,115.28,115.82,37347630,60771591.5,64.43267974094451,56.24785227256161,NaN,NaN,120.94406894590122,159.2514036346003,1.0066745855687864,1.43626503391026,0.42959044834147364,3301692217,3322351194.6,72.99867233919953,59.7916224990985,NaN,NaN,17.41621941717898,-0.209585486223125
2014-11-05T09:30:00-05:00,116.67,116.735,115.55,116.03,31073522,59745397.9,64.95759019551357,57.743943674666944,NaN,NaN,110.7083312699077,146.01946967992967,0.898592313795926,1.552830840586381,0.6542385267904551,3332765739,3335584566.8,74.41200011522258,63.12562006493157,NaN,NaN,19.281500718087674,2.574855400106989
2014-11-06T09:30:00-05:00,115.98,116.53,115.56,116.53,31720902,58292138.65,66.23530039161884,59.396755319064084,NaN,NaN,99.6601232450231,133.48888314801556,0.8096870099509111,1.666347289229094,0.8566602792781829,3364486641,3343352875.8,75.23158992956127,65.90583194050359,NaN,NaN,21.21417713073178,5.237615647339101
2014-11-07T09:30:00-05:00,116.39,116.71,115.7,116.71,28657679,56396048.2,66.70594412930883,60.75344203598403,NaN,NaN,91.18483858072824,115.26427498609351,0.7151949281198808,1.7506539394280338,1.035459011308153,3393144320,3346225752.8,75.54357116742989,67.87854897861332,NaN,NaN,22.958597114144215,7.76918442831126
2014-11-10T09:30:00-05:00,116.68,117.31,116.46,117.29,29371810,54261923.35,68.24205296084472,61.80748097487379,NaN,NaN,93.49422205196497,103.19831681870505,0.6460515847682664,1.843023492268486,1.1969719075002196,3422516130,3362921009.4,77.3305983330606,69.42067901787792,NaN,NaN,24.879096855565695,10.21345763220475
2014-11-11T09:30:00-05:00,117.12,117.435,116.87,117.37,23536783,51936591.35,68.45821934896863,63.239844316472,NaN,NaN,89.56191052404544,96.92188513433389,0.5630396337680001,1.90077144971022,1.3377318159422198,3446052913,3391793148.6,80.0460250359248,71.028819125518,NaN,NaN,26.552478376432347,12.547603452808692
2014-11-12T09:30:00-05:00,116.69,118.08,116.66,117.9,34594660,47791051.6,69.91904354285305,64.36720780386891,NaN,NaN,90.07087872108431,92.79439462456921,0.5031213993167061,1.9666335650881024,1.4635121657713963,3480647573,3421369515.4,82.37506099404159,72.76116787160603,NaN,NaN,28.395082988277405,14.811529100732795
2014-11-13T09:30:00-05:00,117.94,118.25,116.62,116.9,25135235,44020956.55,63.905141367570906,65.02687820021977,NaN,NaN,78.48237186783396,88.5588443491314,0.36203113077772997,1.9160510792435588,1.5540199484658288,3455512338,3439574654.8,83.64079604307335,74.29898625296023,NaN,NaN,28.469191988631636,16.762623799004057
2014-11-14T09:30:00-05:00,116.94,117.21,116.37,116.69,23321447,41553280.75,62.685775974671216,65.61484653805505,NaN,NaN,62.293308799756225,82.780538392937,0.22705080109117826,1.8378334498298017,1.6107826487386234,3432190891,3447383969,84.16609529403186,75.74088541807167,NaN,NaN,28.213704958430263,18.398492536064943
2014-11-17T09:30:00-05:00,116.59,116.93,115.68,115.72,29847311,41299812.4,57.25172435386676,65.22014229151615,NaN,NaN,41.12021088970891,72.3057361604858,0.053957035429980316,1.6782289430260988,1.6242719075961185,3402343580,3443349459,82.68884487221365,76.87640622064657,NaN,NaN,26.50357522101115,19.55636149105726
2014-11-18T09:30:00-05:00,116.16,117.12,115.7499,116.39,33717213,40748058.5,59.84126386335387,65.0845611867898,NaN,NaN,45.42247958452041,63.47784997258079,-0.029413642637491133,1.5875048542992545,1.6169184969367456,3436060793,3441351035,81.92183992567263,77.8024589341767,NaN,NaN,25.69439033960214,20.4332227551351
2014-11-19T09:30:00-05:00,116.25,116.25,114.37,115.15,38258716,40220899.4,53.39462890661587,64.32416294572299,NaN,NaN,0.2737538396074762,45.518424996285425,-0.17400189716886239,1.3994161254756676,1.57341802264453,3397802077,3424781935.8,75.65584990455346,78.13810505609247,NaN,NaN,23.088822336260243,20.81259412386726
2014-11-20T09:30:00-05:00,114.62,116.46,114.62,116.44,26554960,38508892.15,58.41382338532748,63.66185057202704,NaN,NaN,15.252263770701868,32.872403376859005,-0.18752531244367532,1.3390113820899359,1.5265366945336112,3424357037,3418550875.6,73.38268302361399,78.16083946968185,NaN,NaN,22.23208901938286,21.015379108940916
2014-11-21T09:30:00-05:00,118.08,118.12,116.16,116.58,43240434,38574533.55,58.930760509898256,63.09813919081118,NaN,NaN,65.91360848864718,33.59646331463718,-0.19115381111603824,1.2875944306385634,1.4787482417546016,3467597471,3425632191.6,74.32675746515741,78.12288460305406,NaN,NaN,21.67955596931828,21.110261517566254
2014-11-24T09:30:00-05:00,116.74,118.05,116.584,117.97,24573155,38246508.5,63.748919558124875,63.04929917775264,NaN,NaN,108.9349409180409,47.15940932030357,-0.10818239788811757,1.3435202443944547,1.4517026422825723,3492170626,3443597600.8,76.59485212114075,78.37975458747842,NaN,NaN,22.62324008044318,21.32640131226296
2014-11-25T09:30:00-05:00,118.22,118.78,117.53,118.06,26745910,35337859.9,64.04306325731915,62.98397582502446,NaN,NaN,154.25272077622446,68.92545755864438,-0.0579977295804861,1.3792054803069647,1.4372032098874508,3518916536,3460168749.4,78.48310531313092,78.67054781590045,NaN,NaN,23.47301292421173,21.633060113969925
2014-11-26T09:30:00-05:00,118.07,118.5,117.84,118.45,14640724,32712961.8,65.35492154990493,62.9210916220449,NaN,NaN,153.95457152031653,99.66162109478618,-0.011716433340251964,1.4225576682121357,1.4342741015523877,3533557260,3487319786,81.16441208585235,79.09432082706408,NaN,NaN,24.557986804456288,22.050906784039405
2014-11-28T09:30:00-05:00,118.48,118.52,116.57,116.69,21110656,30816183.7,55.512003199316084,62.1215244127597,NaN,NaN,52.660412816795244,107.14325090400487,-0.10748911020251439,1.2999127137992446,1.407401824001759,3512446604,3504937699.4,82.67323137018482,79.60358227011803,NaN,NaN,22.54741201237442,22.121836102372978
2014-12-01T09:30:00-05:00,116.32,116.47,114.81,114.87,36244144,29971648.95,47.5387312802826,60.642715721290976,NaN,NaN,-127.11017305119739,68.53849459603596,-0.2908619737887814,1.0438243567657821,1.3346863305545635,3476202460,3506658697.2,82.81802242147269,79.99554113357603,NaN,NaN,18.074253868130537,21.54361006890977
2014-12-02T09:30:00-05:00,114.99,116.64,114.98,116.25,31812079,29575248.5,53.04575468634113,59.54182538824615,NaN,NaN,-66.219490678589,33.50760827670998,-0.31464877130740865,0.9413753664203028,1.2560241377277115,3508014539,3509827479.8,83.0980861344928,80.21354549775945,NaN,NaN,16.079741357605094,20.763057395866245
2014-12-03T09:30:00-05:00,116.28,117.71,116.02,117.37,29147963,29165265.15,56.99172469188779,58.61844547032006,NaN,NaN,29.06450911257596,8.46996594398028,-0.25303861547485385,0.9397258683841443,1.1927644838589981,3537162502,3513476673,83.43298755408952,80.28911168062002,NaN,NaN,15.734881181906946,20.044746508157772
2014-12-04T09:30:00-05:00,117.19,117.3,116.219,116.81,28631920,29043185.05,54.524409821331574,57.948393217017255,NaN,NaN,1.1687134349420525,-22.087205673094616,-0.2477699588949267,0.8830520352403397,1.1308219941352664,3508530582,3508471337.4,81.06046036455552,80.10480198929731,NaN,NaN,14.659717221509192,19.275456610065117
2014-12-05T09:30:00-05:00,117.25,117.98,116.96,117.69,30261397,28970209.8,57.628710541980986,57.58717425753938,NaN,NaN,71.76164407754723,-18.26695942094423,-0.18562910046182912,0.8987856185579801,1.0844147190198092,3538791979,3513740412.4,81.65195269341021,79.9252203749672,NaN,NaN,14.75297722750539,18.629388126842297
2014-12-08T09:30:00-05:00,117.27,118.37,115.85,116.22,32295024,29152077.05,51.325808119717806,57.16389452652874,NaN,NaN,-4.217699143003558,6.311535360694544,-0.24064779788941837,0.7836049716580362,1.0242527695474546,3506496955,3519799311.4,82.33513110278955,79.89995510572261,NaN,NaN,12.75993299969311,17.790894537249557
2014-12-09T09:30:00-05:00,114.96,118.27,114.74,118.17,52645939,30315783.5,57.90318700204866,57.02546046500694,NaN,NaN,21.32929920288612,23.821293336989562,-0.14741076887362026,0.8399893084554293,0.9874000773290496,3559142894,3530024982.4,83.45482287886156,80.00945388809325,NaN,NaN,13.27383285534301,17.145600011262907
2014-12-10T09:30:00-05:00,117.74,118.16,115.56,115.66,45413576,31409623.15,48.768081376514566,56.694992784285425,NaN,NaN,-37.22231335597415,10.563928843279538,-0.25042836350810993,0.6743646229439122,0.9247929864520221,3513729318,3525338345.6,80.92310802148612,80.38568661073131,NaN,NaN,10.373549452598967,16.17816421716806
2014-12-11T09:30:00-05:00,116.21,117.68,115.87,116.12,36021754,31480977.85,50.31513032107251,56.11651470826722,NaN,NaN,-22.818136861850196,5.766558783921089,-0.28094496318813333,0.5736117824668554,0.8545567456549887,3549751072,3533582443.6,81.95984851403156,80.99834128861826,NaN,NaN,8.673878105725615,15.106123344104853
2014-12-12T09:30:00-05:00,114.78,115.99,114.6,114.71,44815983,32465015.25,45.75432484893986,55.17534073248447,NaN,NaN,-151.67153953107345,-38.92007793780304,-0.3831183141654376,0.3756588529481917,0.7587771671136293,3504935089,3526811065.6,78.20068188573995,81.27505017580275,NaN,NaN,5.6932213631189645,13.76142306110687
2014-12-15T09:30:00-05:00,115.26,115.74,113.16,113.55,66361180,34617001.9,42.35298134330894,53.64705943142619,NaN,NaN,-196.08398920504717,-77.29333595021177,-0.5080210126529845,0.12375090129739874,0.6317719139503832,3438573909,3513226456.4,71.15016265862289,80.8861437856229,NaN,NaN,2.0991606646296006,12.09538557589583
2014-12-16T09:30:00-05:00,113.32,115.34,113.03,113.39,62849705,36267121.6,41.890409045305006,52.0647269877109,NaN,NaN,-178.55324321219032,-117.26984443322706,-0.5756468735050893,-0.08778667793097839,0.48786019557411087,3375724204,3476542718.4,56.370256154996724,79.30665456004189,NaN,NaN,-0.852454551774322,10.245694129085809
2014-12-17T09:30:00-05:00,113.64,116.99,113.49,116.89,70379359,38100228.9,53.7819905282579,51.23808905759325,NaN,NaN,-41.093555531168604,-118.04409286826595,-0.36894299755295756,0.026681448632913884,0.39562444618587145,3446103563,3463017567.4,52.07509847242,77.2288464447967,NaN,NaN,0.5881186376151342,8.86604048744714
2014-12-18T09:30:00-05:00,118.46,118.74,117.47,118.63,54315620,38903074.1,58.345695609048434,51.44049565828841,NaN,NaN,119.36102689328939,-89.60826011723802,-0.11260850855966947,0.2548638104862846,0.36747231904595407,3500419183,3453151189.6,49.13398746363167,74.8331861657572,NaN,NaN,3.4154590058818406,8.08738599008067
2014-12-19T09:30:00-05:00,118.65,119.48,118.14,118.9,49041799,40027416.05,59.02186839283062,52.260719737756126,NaN,NaN,140.49744286746463,-31.174463637530415,0.06784070145478532,0.4522731958644357,0.3844324944096504,3549460982,3462056368.2,51.78107565682481,72.61626139685379,NaN,NaN,5.812288897958803,7.762372119777545
2014-12-22T09:30:00-05:00,119.2,119.71,118.8035,119.71,27043410,39217564.85,61.06387197338385,52.83344240111632,NaN,NaN,154.19578939393278,38.88149208226558,0.2255739587604929,0.6663999428602665,0.4408259840997736,3576504392,3489642464.8,58.91398968953487,70.88882593649964,NaN,NaN,8.417709160279147,7.85599169699206
2014-12-23T09:30:00-05:00,120.44,120.44,119.45,119.86,34532959,39715555.05,61.44700832066657,53.1516769460291,NaN,NaN,160.34262411394013,106.66066554749166,0.3181668721990838,0.8385345743486283,0.5203677021495445,3611037351,3536705094.2,67.69413119447643,69.764621910813,NaN,NaN,10.601143477954164,8.248156237129503
2014-12-24T09:30:00-05:00,119.63,120.07,119.2601,119.76,19175429,39337031,61.01594865724168,53.615358291451244,NaN,NaN,135.6992815943059,142.01923297258656,0.34839762394025053,0.9558647320748577,0.6074671081346071,3591861922,3565856766,71.72486561272672,69.0977937142538,NaN,NaN,12.242181233131559,8.818731236558369
2014-12-26T09:30:00-05:00,120.14,120.83,120.07,120.54,18261936,39518091.6,63.18533443166147,54.012259997856994,NaN,NaN,154.9094467924815,149.12891695242496,0.39332171042606745,1.0991192461671915,0.705797535741124,3610123858,3587797701,74.32170609294273,68.57420467136326,NaN,NaN,14.268849568580807,9.597319569704432
2014-12-29T09:30:00-05:00,120.63,121.38,120.61,121.05,27692468,39847182.2,64.57349093913379,54.9585230563867,NaN,NaN,147.8218386493018,150.59379610879242,0.4269730706558923,1.2395138740609895,0.8125408034050972,3637816326,3605468769.8,76.21628483516011,68.13714422367545,NaN,NaN,16.370803407953748,10.564960118025763
2014-12-30T09:30:00-05:00,120.79,121.24,120.27,120.34,23995988,39234774.4,61.11837798582379,55.188179555227784,NaN,NaN,114.81685580902409,142.71800939181068,0.37296413669463546,1.2787459742733915,0.9057818375787561,3613820338,3612931959,76.98849899327757,67.67526394613373,NaN,NaN,17.220999796651807,11.515822929258055
2014-12-31T09:30:00-05:00,120.8,121.41,119.54,119.62,35688662,39428603.55,57.74414717457139,55.82932711223184,NaN,NaN,87.23255753710774,128.0959960764442,0.2653544288117031,1.237474873593385,0.9721204447816818,3578131676,3606350824,74.68569731934821,67.22973461026673,NaN,NaN,17.01486311970538,12.30140009932196
2015-01-02T09:30:00-05:00,120.07,120.56,117.89,118.93,46133132,40277862,54.63138150900493,56.13763076851273,NaN,NaN,44.2014143283107,109.79642262324515,0.13109960645362984,1.1359949528487192,1.0048953463950894,3531998544,3594378148.4,70.55131264957211,66.41483919137676,NaN,NaN,15.96867143068654,12.825296003802613
2015-01-05T09:30:00-05:00,118.23,118.71,116.79,117.34,51141891,41403360.55,48.18543160230939,56.31128125089627,NaN,NaN,-11.501932224455075,76.51414681985783,-0.07055269777994333,0.9167044741701602,0.9872571719501035,3480856653,3568524707.4,62.50494879507219,65.29371539918621,NaN,NaN,13.101475196604717,12.864750174202914
2015-01-06T09:30:00-05:00,117.62,117.77,114.36,115.31,67446040,43262592.7,41.459500615982336,56.24746119894438,NaN,NaN,-70.64785410515803,32.82020826896586,-0.33179645915451916,0.5725115980069546,0.9043080571614738,3413410613,3523643564.8,51.51994537137105,63.891557021525365,NaN,NaN,8.327716825120374,12.216602552905409
2015-01-07T09:30:00-05:00,116.06,116.76,115.48,116.73,32252095,43260446.25,47.02941375697925,56.61453296406396,NaN,NaN,-51.37861758905781,-0.4188864106505122,-0.3957689903137305,0.4095968192693107,0.8053658095830412,3445662708,3490012038.8,45.12069728254733,63.08801710206469,NaN,NaN,6.0085443228349,11.329737091466765
2015-01-08T09:30:00-05:00,117.66,118.8457,117.45,118.71,28361730,42046235.8,53.651425019501865,56.60520685629567,NaN,NaN,15.749515556042107,-14.715494806863626,-0.29610226103715465,0.4352379832865978,0.7313402443237524,3474024438,3469190591.2,41.66985894596615,62.34478570731799,NaN,NaN,6.195503483178491,10.596275147425583
2015-01-09T09:30:00-05:00,118.81,118.84,117.31,117.57,26975175,41124315.75,49.79186438505604,55.994218911724786,NaN,NaN,-1.7074879893394392,-23.89727527039365,-0.2975305423417174,0.3594270663966057,0.6569576087383231,3447049263,3452200735,39.045726304339475,61.62419562451141,NaN,NaN,5.072192644681242,9.807120504176392
2015-01-12T09:30:00-05:00,117.7,118.01,116.23,117.18,27316763,40689066.2,48.5062845383485,55.24310577926178,NaN,NaN,-31.066065716089312,-27.810101968720495,-0.3137069647231435,0.2648239028343937,0.5785308675575372,3419732500,3439975904.4,37.22902612578481,60.5847635151514,NaN,NaN,3.7730677115932596,8.945112962378802
2015-01-13T09:30:00-05:00,118.09,119.39,115.82,117.27,49991380,40947836.05,48.83459120497447,54.3695857243754,NaN,NaN,-24.217061359012085,-18.523943419491303,-0.30693176115958465,0.1948661661080564,0.501797927267641,3469723880,3451238557.8,39.998848329171246,59.233681989411146,NaN,NaN,2.8337041382612984,8.072054558933445
2015-01-14T09:30:00-05:00,115.98,117.1,115.55,116.8,34224203,39340987.2,47.14417538543349,53.34795480043017,NaN,NaN,-74.7116586512236,-23.19055163192446,-0.3211644226351914,0.10034239897365183,0.42150682160884323,3435499677,3449205951.6,39.65873077538769,57.231153388047666,NaN,NaN,1.5643621743499068,7.142384218278654
2015-01-15T09:30:00-05:00,117.23,117.38,114.48,114.83,46199361,38508470,40.77335334080974,51.90205513497075,NaN,NaN,-124.95958324825045,-51.332371392782974,-0.4428128043368809,-0.1320091838122579,0.310803620524623,3389300316,3432261127.2,36.84592627293345,54.73980057806243,NaN,NaN,-1.5708738957646289,5.897633059129613
2015-01-16T09:30:00-05:00,114.41,116.94,114.2,116.7,41895670,37084285.55,47.962013867209905,50.814675094652785,NaN,NaN,-108.40440333887656,-72.6717544626904,-0.37934118029202135,-0.16337285484040365,0.21596832545161768,3431195986,3429090471.8,36.32673927381475,52.025874376696144,NaN,NaN,-2.0322066304413626,4.764798817762331
2015-01-20T09:30:00-05:00,116.85,117.08,115.16,116.21,36444437,36190726.4,46.373680874930784,49.51468866149543,NaN,NaN,-87.75620493759816,-84.00978230699216,-0.3529123017569801,-0.22517205174460742,0.12774025001237266,3394751549,3424094281.6,35.47839354089662,49.116024998534456,NaN,NaN,-2.896316993482083,3.6703537018702717
2015-01-21T09:30:00-05:00,115.8,116.82,115.29,115.84,27333530,35105312.95,45.15759217989083,48.37463253250022,NaN,NaN,-85.2317425450698,-96.21271854420372,-0.34262406577408333,-0.3005398322052315,0.042084233568851825,3367418019,3403633109.4,32.16546182395072,45.91437948643969,NaN,NaN,-3.9616945656426776,2.5800610922255647
2015-01-22T09:30:00-05:00,116.56,118.24,115.1,118.2,37876960,35646990.45,53.52854533494815,48.073518115384275,NaN,NaN,-32.4579858844258,-87.76198399084416,-0.1679886664035461,-0.1679015994355808,0.00008706696796529495,3405294979,3397592169.8,31.23801165016978,42.81097336721266,NaN,NaN,-2.238967158169094,1.8916284850263279
2015-01-23T09:30:00-05:00,118.24,118.77,117.55,118.12,28173394,35329012.2,53.23193021922201,47.973557308971216,NaN,NaN,12.933846558992325,-60.1832980293956,-0.054830544725349165,-0.06845111393872116,-0.013620569213371996,3377121585,3395156423.6,30.851740134367446,39.9752896161266,NaN,NaN,-0.9663975553460954,1.4833390506874102
2015-01-26T09:30:00-05:00,117.88,119.27,117.07,119.26,23006787,35520580.1,56.8972538455963,48.595830326348846,NaN,NaN,34.505415730438145,-31.601334215532653,0.09184539434482918,0.10118617371766447,0.009340779372835301,3400128372,3388942900.8,29.838128860197514,37.64194533506413,NaN,NaN,1.2522511243835632,1.4503264897868606
2015-01-27T09:30:00-05:00,117.86,119.25,117.62,118.69,26919080,35953437.3,54.593385819052415,49.53396498371099,NaN,NaN,41.679227432351304,-5.714247741542756,0.1425031175513931,0.18746967631207667,0.044966558760683575,3373209292,3384634449.4,29.12362402970352,36.042208096373585,NaN,NaN,2.4116581907256047,1.587659589920967
2015-01-28T09:30:00-05:00,119.18,119.45,116.32,116.69,38086115,36473119.65,47.34877785423543,49.55677670494357,NaN,NaN,-2.4274948163687435,10.846601804197457,0.03873886898861158,0.09339014499644804,0.054651276007836466,3335123177,3378175481,28.03961650148996,34.82213089772663,NaN,NaN,1.1792667636914622,1.5293177576024661
2015-01-29T09:30:00-05:00,117.02,118.32,116.09,118.3,39299943,37238317.4,52.78094039908996,49.49459923205701,NaN,NaN,13.255592030928435,19.9893173872683,0.07391888620677092,0.14704988376630013,0.0731309975595292,3374423120,3372001109.2,27.004848641255734,33.77463016167589,NaN,NaN,1.8727717555947982,1.5783826144585136
2015-01-30T09:30:00-05:00,117.48,117.96,115.6,115.7,49739789,37940873.75,44.75120570481843,49.13455218346861,NaN,NaN,-57.66675378283227,5.869197318903375,-0.0744985579824047,-0.019992199918476672,0.05450635806392803,3324683331,3361513458.4,25.297145031407197,32.792588642180725,NaN,NaN,-0.2855665427578868,1.3121041634275992
2015-02-02T09:30:00-05:00,116.12,116.84,114.38,116.76,44819096,37875171.95,48.21046625589668,49.11342230615062,NaN,NaN,-80.42346963282519,-17.116579753749292,-0.0964685995794037,-0.0660793914103266,0.0303892081690771,3369502427,3355388269.4,24.329470384079997,31.871191803487527,NaN,NaN,-0.8636506070058497,1.0012820533656779
2015-02-03T09:30:00-05:00,117.33,119,117.27,118.85,43920001,37514077.45,54.287856941298976,49.50294128731666,NaN,NaN,97.37472582610312,-5.977480074998931,0.027919912143607194,0.0652890983485861,0.0373691862049789,3413422428,3363430896.6,28.212492420073374,31.029309238551967,NaN,NaN,0.7500458798822783,0.965391171439478
2015-02-04T09:30:00-05:00,118.42,119.24,118.1,118.41,28597060,35571628.45,52.88094966938266,49.912710879027316,NaN,NaN,103.32828602180533,15.173676092635883,0.07600015373838401,0.13236937837795892,0.05636922463957491,3384825368,3373371334.8,32.80225336562363,30.53956085214025,NaN,NaN,1.5557065827216334,1.0497219444797858
2015-02-05T09:30:00-05:00,118.77,120.25,118.6,119.94,32337113,35575879.35,57.04923218088889,51.07527365331868,NaN,NaN,156.69492961358372,43.861543609166944,0.19927898223758664,0.3054679524365582,0.10618897019897158,3417162481,3381919207,36.55848128253068,30.519029067111482,NaN,NaN,3.60817297072869,1.4152149482296292
2015-02-06T09:30:00-05:00,120.1,120.82,119.35,119.81,31694901,35742537.9,56.59114754809755,51.69164034481066,NaN,NaN,165.7233884077246,88.53957204727831,0.25683682922337975,0.42723500672819625,0.1703981775048165,3385467580,3394076056.8,41.56162598399949,30.892949546410396,NaN,NaN,5.082718398292727,1.9391440125243573
2015-02-09T09:30:00-05:00,119.4,120.22,118.72,118.86,32367852,36012171.75,53.227598770837524,52.181205908803996,NaN,NaN,106.82864880577428,125.9899957349982,0.21726889335770222,0.4419842942019443,0.22471540084424207,3353099728,3390795517,40.630453558884945,31.26095383340956,NaN,NaN,5.30149224219824,2.4194794739063403
2015-02-10T09:30:00-05:00,119.53,119.84,118.1,119.62,28960804,36094373.8,55.50597576587207,52.92037616494552,NaN,NaN,89.92631583992193,124.50031373776196,0.22753162039208868,0.509129926334353,0.28159830594226426,3382060532,3384523137.8,38.838717098701835,31.73761492446321,NaN,NaN,6.163671534610654,2.9543640540069567
2015-02-11T09:30:00-05:00,119.37,119.82,118.62,119.45,23794191,34784514.35,54.86220801781888,53.01563778515058,NaN,NaN,85.38295577129227,120.91124768765935,0.20862023450415845,0.5423735990724623,0.33375336456830385,3358266341,3379211332.4,37.337105409854686,32.173264478726416,NaN,NaN,6.683770672072999,3.4871364280163912
2015-02-12T09:30:00-05:00,120.16,120.92,119.84,120.81,27854552,34466031.8,58.96275971114277,53.424982748859215,NaN,NaN,134.26700649622688,116.42566306418799,0.26957998385789095,0.6707283443906675,0.4011483605327766,3386120893,3373003014.8,35.60444505408027,32.51274340156304,NaN,NaN,8.344576596476227,4.181056452082082
2015-02-13T09:30:00-05:00,120.91,121.69,120.65,121.53,20446915,33178409.5,60.983579893784416,53.71686318087264,NaN,NaN,159.07685967441978,115.09635731752704,0.33594807047079167,0.8210834486212661,0.48513537815047447,3406567808,3377223060.4,37.72011772803653,33.07574260640869,NaN,NaN,10.336276323970118,5.060373576637516
2015-02-17T09:30:00-05:00,121.66,122.06,121.26,121.91,16868460,31927049,62.04587288187562,54.24918368536002,NaN,NaN,165.1786281258247,126.76635318153713,0.3797631740266181,0.9598393456837471,0.580076171657129,3423436268,3391290368.4,44.29063187917341,34.15910030994225,NaN,NaN,12.296960398400488,6.094171694032226
2015-02-18T09:30:00-05:00,121.56,122.05,121.13,122.04,20450185,31127336.4,62.42280718999094,55.32590006648541,NaN,NaN,144.5169246746373,137.68447494848016,0.39032567155051967,1.0679832610952786,0.677657589544759,3443886453,3403655552.6,49.349036446134534,35.681201734559714,NaN,NaN,14.026505580219267,7.227362249201803
2015-02-19T09:30:00-05:00,121.76,122.38,121.54,122.05,16620467,30591683.25,62.4536969953751,56.01681125193435,NaN,NaN,139.86740154963354,148.58136410414843,0.3709446254313823,1.1413383713339869,0.7703937459026046,3460506920,3424103668.4,56.399451301146506,37.7808162102662,NaN,NaN,15.47730256891047,8.405925152017327
2015-02-20T09:30:00-05:00,121.85,122.54,120.9,122.38,30331597,30214415.1,63.519436347036844,57.35739915494995,NaN,NaN,122.28989415281927,146.18594163546692,0.3533877273087721,1.2121284050385697,0.8587406777297976,3490838517,3445047193.2,62.20267357018365,40.41692539160737,NaN,NaN,17.001994148178888,9.633935008611836
2015-02-23T09:30:00-05:00,122.1,122.53,121.27,122.5,25778239,30094657.35,63.9204844884523,58.479543314418216,NaN,NaN,112.59735371607691,136.89004044379834,0.32368737990652874,1.2633499026129584,0.9396625227064297,3516616756,3467056982.8,67.15091940462891,43.4756003216466,NaN,NaN,18.405153847721078,10.886966271341727
2015-02-24T09:30:00-05:00,122.47,123.05,122.1866,122.66,20023603,29945498.15,64.48116708423811,59.20763689605672,NaN,NaN,117.67922152881226,127.39015912439586,0.2897476525805116,1.3018470884320692,1.0120994358515576,3536640359,3489697801,71.31154182022746,46.55410385022903,NaN,NaN,19.75471849035381,12.15378801691488
2015-02-25T09:30:00-05:00,122.57,123.04,122.23,122.8,17059628,29452525.55,64.99378556996975,60.07283946038438,NaN,NaN,105.89096035367163,119.6649662602027,0.2529931938513492,1.3283409281657441,1.075347734314395,3553699987,3511660507.8,74.66391953655892,49.5442228624387,NaN,NaN,21.049315772149342,13.424577696234088
2015-02-26T09:30:00-05:00,122.69,123.3,122.33,123.25,24379043,28767171.95,66.65941342063147,60.759280977508844,NaN,NaN,104.37382335753477,112.56625062178296,0.23560809858900877,1.369857857550656,1.1342497589616471,3578079030,3535174929.8,77.67223952234755,52.48091987956848,NaN,NaN,22.61329256897668,14.73725124948303
2015-02-27T09:30:00-05:00,123.03,123.36,122.55,122.58,23821659,27993257.75,61.93431219815154,61.14093559536984,NaN,NaN,90.86605119232586,106.28148202968427,0.1592619185307944,1.3333271571251402,1.1740652385943458,3554257371,3547858700.6,79.11289957853924,55.163153707749885,NaN,NaN,22.861765733781766,15.897896175811422
2015-03-02T09:30:00-05:00,122.55,123.775,122.53,123.47,29683461,26990441.35,65.4389009359537,62.01317146430671,NaN,NaN,100.07477540246494,103.77696636696189,0.14915483113115258,1.3605087775082865,1.211353946377134,3583940832,3561323515.8,80.54780002626208,58.014392741133975,NaN,NaN,24.00362483147889,17.055857412335346
2015-03-03T09:30:00-05:00,123.19,123.19,122.26,122.74,23068431,25902908.1,60.517362213040876,62.37112763910448,NaN,NaN,74.46191547624439,95.13350515644831,0.07737038455239542,1.3080669270676282,1.2306965425152327,3560872401,3566169924.2,81.05234895568415,61.02965215948985,NaN,NaN,23.69588977003172,18.00443346343483
2015-03-04T09:30:00-05:00,122.21,122.605,121.61,122.36,22822508,24848033.45,58.069113549356,62.60019231992856,NaN,NaN,44.74856869174388,82.90502682406274,-0.007149336983616195,1.2217598712857125,1.2289092082693287,3538049893,3563039905.4,79.61604361154829,64.04957631675367,NaN,NaN,22.769908240778292,18.685215574483895
2015-03-05T09:30:00-05:00,122.53,122.92,121.91,122.72,19725646,24404462.75,59.731178691665484,62.6550793899659,NaN,NaN,57.49333151124432,73.52892845480466,-0.047979252664197336,1.1689351424390821,1.2169143951032795,3557775539,3558979207.2,77.69251434819901,67.0558669806193,NaN,NaN,22.405770605463612,19.216723436052426
2015-03-06T09:30:00-05:00,121.98,122.685,120.88,121.17,37319894,24653601.8,50.45747181510257,61.90321452720291,NaN,NaN,-2.9031184725888517,54.77509452182172,-0.18106725626828846,0.9905803247679188,1.1716475810362073,3520455645,3552218862,74.46688660785324,69.6806361863205,NaN,NaN,19.303366464946244,19.229101011608687
2015-03-09T09:30:00-04:00,121.37,121.92,121.12,121.7,17556337,23946673.6,53.13672508455289,61.26684682739415,NaN,NaN,-8.860669846159963,32.98800547209673,-0.23185071933632706,0.8818341818657984,1.1136849012021255,3538011982,3543033092,70.20192183948757,71.53144261205722,NaN,NaN,17.437848592690333,18.973207808906064
2015-03-10T09:30:00-04:00,120.61,120.7,119.83,120.3,32440299,23950295.95,46.0520290241126,60.0975055298314,NaN,NaN,-114.96555509343787,-4.897488641839699,-0.35102479433069655,0.6749039082887549,1.0259287026194515,3505571683,3531972948.4,65.34881502436471,72.67428393907366,NaN,NaN,13.4958879370823,18.19073354150267
2015-03-11T09:30:00-04:00,120.47,121.139,119.88,121.04,20914510,23547981.25,49.857600791333425,59.19778437239986,NaN,NaN,-98.3778004853269,-33.52276247725386,-0.3694476209160473,0.5641191764743922,0.9335667973904396,3526486193,3529660208.4,64.34708553411045,73.24197209857108,NaN,NaN,11.338772512861137,17.21188196598245
2015-03-12T09:30:00-04:00,121.82,123.15,121.74,123.05,41063341,24411438.75,58.434443110209344,58.834570569769326,NaN,NaN,65.76953556806306,-31.867521665890116,-0.24186528295472187,0.6312351936970373,0.8731004766517592,3567549534,3531615007.4,64.83771074906838,73.43018903992,NaN,NaN,12.270417901244791,16.505958528162783
2015-03-13T09:30:00-04:00,122.94,123.19,121.21,122.61,26371036,24337262.95,56.16946551988402,58.28092635772874,NaN,NaN,28.113266796548718,-25.664244612062596,-0.1852598298704622,0.6415256893136814,0.8267855191841436,3541178498,3535759578,65.90888027821225,73.34147195946166,NaN,NaN,12.27158162038911,15.901047541337972
2015-03-16T09:30:00-04:00,123.11,123.58,122.88,123.33,19906326,24310233.5,58.971932864733354,57.887409627764114,NaN,NaN,119.35358546249472,-0.021393550331652023,-0.10165792990817535,0.6997131067989244,0.8013710367070997,3561084824,3540374146.4,67.11025316847075,73.04137991290762,NaN,NaN,13.17803812667824,15.512046196386581
2015-03-17T09:30:00-04:00,122.97,123.78,122.77,123.66,23142597,24623940.35,60.22714376328609,57.546935213001,NaN,NaN,119.72563526733776,46.91684452182348,-0.030174919695779012,0.7636523870873759,0.7938273067831549,3584227421,3556105294,70.87792354853738,72.77095162804893,NaN,NaN,14.300398192332814,15.3389536243789
2015-03-18T09:30:00-04:00,123.4,125.12,122.85,124.65,40292648,25616063.5,63.804754675715046,57.34303101693554,NaN,NaN,177.03458051183898,101.99932072125665,0.07215338055329057,0.8840190324747681,0.8118656519214775,3624520069,3575712069.2,74.75897812971724,72.56286152857533,NaN,NaN,16.398184681534822,15.490272346829746
2015-03-19T09:30:00-04:00,124.36,124.96,124.31,124.89,34008230,26485451.65,64.63525085433665,57.53595520666305,NaN,NaN,193.87510442790492,127.62043449322502,0.14042299242356804,0.9873943924509376,0.8469714000273696,3658528299,3593907822.2,77.72571923600796,72.46377721839453,NaN,NaN,18.34933986877662,15.89871056425073
2015-03-20T09:30:00-04:00,125.36,126.16,125.31,125.99,34165600,26677151.8,68.23298188064204,57.735532416997934,NaN,NaN,237.45650969732145,169.48908307337956,0.2383296108588423,1.1448834136009225,0.9065538027420802,3692693899,3624210902.4,81.60369243734955,72.53919810490076,NaN,NaN,21.188846916037583,16.65444432879171
2015-03-23T09:30:00-04:00,125.95,126.32,125.79,125.88,17132355,26244857.6,67.49353839043928,58.23383071538353,NaN,NaN,199.40537454410605,185.49944088970182,0.27191712951178126,1.2464502146318068,0.9745330851200256,3675561544,3647106246.4,83.8863470381607,72.74162653936338,NaN,NaN,23.260578732716258,17.598177815066645
2015-03-24T09:30:00-04:00,125.77,126.31,125.66,125.85,30115619,26749458.4,67.27939436350826,58.89170791639441,NaN,NaN,159.388934426974,193.43210072162907,0.2679156282247308,1.309427620400939,1.0415119921762082,3645445925,3659349947.2,84.96102419701424,73.12341086689666,NaN,NaN,24.889346220736506,18.63977330159091
2015-03-25T09:30:00-04:00,125.53,125.6,122.38,122.47,42513976,28022175.8,48.57832523960803,58.095075526961736,NaN,NaN,20.115716757807444,162.04832797082275,0.026164015069596314,1.0742170110132037,1.0480529959436073,3602931949,3655032323.2,82.86228859010046,73.4926804556039,NaN,NaN,20.097620453512317,18.848037180436826
2015-03-26T09:30:00-04:00,122.09,122.91,121.54,122.32,26899195,28148183.4,47.94144941422765,57.915359641184956,NaN,NaN,-44.89164086688273,114.29497891186524,-0.14586032213389943,0.8657275932762332,1.0115879154101326,3576032754,3638533214.2,75.21603362474629,73.54619095681055,NaN,NaN,16.178638036135652,18.466694445536657
2015-03-27T09:30:00-04:00,122.38,123.23,121.86,123.1,23066819,28110441.4,51.502052867683005,57.798597339979956,NaN,NaN,-18.93246904060525,63.0171831642799,-0.20548028107070915,0.7547375640717462,0.9602178451424553,3599099573,3619814349,67.59505906424631,73.35998647286475,NaN,NaN,14.05744685933929,17.83680193322275
2015-03-30T09:30:00-04:00,123.72,124.99,123.7,124.77,20486967,27650616.7,58.10844790970129,58.659770117522,NaN,NaN,68.73341608511156,36.882791472481,-0.13425592465718217,0.7923979393209777,0.9266538639781599,3619586540,3608619348.2,63.454206237160825,73.22465727377876,NaN,NaN,14.41300568700371,17.347688183762887
2015-03-31T09:30:00-04:00,124.28,124.71,123.9,124.37,24507777,27722584,56.13597671002859,59.10822554028594,NaN,NaN,54.846599868379926,15.974324560762195,-0.1165511524066345,0.7809649234698668,0.8975160758765013,3595078763,3598545915.8,59.89847722127526,72.90689953714767,NaN,NaN,14.05805071006144,16.87773997323411
2015-04-01T09:30:00-04:00,124.23,124.42,122.9,124.42,31955181,28179217.65,56.33550045079982,58.95830106461384,NaN,NaN,30.52289890171729,18.055760989544172,-0.10433593970978328,0.7670961512392722,0.8714320909490555,3627033944,3603366314.8,61.024003557737835,72.63449188062405,NaN,NaN,13.838140047116369,16.44351141236015
2015-04-02T09:30:00-04:00,124.36,125.26,124.29,124.65,23586392,28372254.95,57.29773195618453,59.03889152434959,NaN,NaN,65.21102647444731,40.076294457810164,-0.08447683602622547,0.7658360459162736,0.8503128819424991,3650620336,3618283831.2,64.35792945284699,72.52370967881227,NaN,NaN,13.93760987399411,16.085525478307858
2015-04-06T09:30:00-04:00,123.91,125.48,123.88,125.2,22045576,27608539.05,59.59096955016467,59.08310843045182,NaN,NaN,64.32070480119532,56.72692922617027,-0.04025354437081807,0.7999959514789765,0.8402494958497946,3672665912,3632997099,67.32652693809251,72.53915780521382,NaN,NaN,14.684460256924456,15.885373303824515
2015-04-07T09:30:00-04:00,124.97,125.5,124.37,124.4,20214722,27741458.3,54.96702788745273,58.70738586789229,NaN,NaN,53.724121593264805,53.72507032780093,-0.06913960991527512,0.7538249834557007,0.8229645933709758,3652451190,3639570029,68.58532345623604,72.37540065576373,NaN,NaN,13.984299173035852,15.61379128514042
2015-04-08T09:30:00-04:00,124.38,125.66,124.38,125.47,19314420,27085164.35,59.494205411545416,58.39948949188017,NaN,NaN,70.7082625737795,56.89740286888084,-0.022838334405656413,0.7944166753639053,0.8172550097695617,3671765610,3654907398.4,71.35823818701516,72.13249065985643,NaN,NaN,14.734973374800933,15.488245869377637
2015-04-09T09:30:00-04:00,125.36,125.73,123.77,125.02,22325251,27155701.4,56.903321519153145,57.847208825081346,NaN,NaN,45.226423902882104,59.8381078691138,-0.02878907533467534,0.7812686656012175,0.8100577409358929,3649440359,3659388681.4,72.132240317434,71.73295645138687,NaN,NaN,14.594081661147348,15.360508125344738
2015-04-10T09:30:00-04:00,125.44,125.79,125.22,125.62,14966323,25850850.5,59.43961096379021,57.219110902449074,NaN,NaN,87.93000644932401,64.38190386408914,-0.0001042570703505552,0.8099274195979547,0.8100316766683052,3664406682,3662145950.6,72.62246841322307,71.09144044966355,NaN,NaN,15.221929453034313,15.340711172157535
2015-04-13T09:30:00-04:00,125.69,126.39,125.58,125.7,22819196,25673258.5,59.77949126464884,56.668107536321195,NaN,NaN,106.70810670809487,72.85938424546904,0.015600805559026765,0.8295326836170887,0.8139318780580619,3687225878,3665057943.8,73.15947912773933,70.32523559891916,NaN,NaN,15.830508500242127,15.410682219026762
2015-04-14T09:30:00-04:00,125.74,126.08,124.78,125.67,22600832,25807983.8,59.57787533412424,56.117999034222336,NaN,NaN,71.4054141675998,76.39564276033606,0.015291623070113891,0.8330464068957042,0.8177547838255903,3664625046,3667492715,73.62531025450312,69.51554174588266,NaN,NaN,16.279387174885432,15.534782927006573
2015-04-15T09:30:00-04:00,126.16,127.13,125.92,126.55,37282314,26514969.65,63.469851469556545,57.18167947921866,NaN,NaN,141.38186720591793,90.53036368676374,0.06300045121742082,0.8965053478473664,0.8335048966299455,3701907360,3673521065,74.79186023209246,68.93908257745352,NaN,NaN,17.777083653374692,15.855111602202019
2015-04-16T09:30:00-04:00,126.47,126.75,126.16,126.48,24439877,25722331.1,62.95063175315842,58.25376393199944,NaN,NaN,118.80812298347165,105.24670350288166,0.07753469116269218,0.9304232605833107,0.8528885694206185,3677467483,3679126489.8,75.86098947626405,68.98515085256193,NaN,NaN,18.881992693780703,16.28752318671326
2015-04-17T09:30:00-04:00,125.12,125.545,123.82,124.43,48283498,26436094.5,50.04014166563688,58.14934170328185,NaN,NaN,-22.174649729194584,83.22577226717793,-0.056021858556907,0.7828612462244848,0.8388831047813918,3629183985,3672081950.4,71.74288820431914,69.28142436256712,NaN,NaN,15.963389078684676,16.241218314137747
2015-04-20T09:30:00-04:00,125.05,125.95,124.83,125.65,24602271,25957928.05,55.84407334996616,57.987600663300775,NaN,NaN,46.377761288464406,71.15970318325184,-0.06658614538359031,0.7556504230519039,0.8222365684354942,3653786256,3665394026,67.9704502764202,69.60401322251421,NaN,NaN,15.26954577676517,16.10240795165595
2015-04-21T09:30:00-04:00,126.05,126.25,125.42,125.52,13844627,25793541.65,55.1093988395478,57.91427367255214,NaN,NaN,68.0906961013851,70.49675957000889,-0.0855095500724884,0.7153496308448837,0.8008591809173721,3639941629,3660457342.6,65.24330783678535,69.9857868379078,NaN,NaN,14.492785105152764,15.872461830726925
2015-04-22T09:30:00-04:00,125.52,125.88,124.47,125.71,21991306,25387326,56.020081845135856,57.89174377214757,NaN,NaN,42.31611512202291,50.68360915322988,-0.08806374576810283,0.6907794987072435,0.7788432444753464,3661932935,3652462457.6,60.97642000335248,69.98238801259455,NaN,NaN,14.126052771337893,15.622974822242778
2015-04-23T09:30:00-04:00,125.48,126.535,125.26,126.28,18025829,24162918.65,58.725296380960096,57.99371265963155,NaN,NaN,87.6954732510146,44.46107920673848,-0.055772715891253766,0.7091273496112791,0.7649000655025329,3679958764,3652960713.8,61.14695968080741,69.75303302887744,NaN,NaN,14.603785269881447,15.477376314762587
2015-04-24T09:30:00-04:00,126.33,126.46,125.69,125.86,14992501,23567583.95,55.992326013722845,57.736666692742844,NaN,NaN,80.61366149790307,65.01874145215803,-0.06638649271262886,0.6819169496117468,0.7483034423243756,3664966263,3660117169.4,63.607020766389994,69.48735401661297,NaN,NaN,14.220370764765342,15.29780409333441
2015-04-27T09:30:00-04:00,126.21,126.91,124.04,124.47,32924563,24060471.15,48.026342355649085,57.240903440471165,NaN,NaN,-14.498529272247069,52.84348334001571,-0.16508760510643394,0.5419439359413332,0.7070315410477671,3632041700,3655768258.2,61.0762070295319,68.95098855756268,NaN,NaN,11.380317120068721,14.738163097153597
2015-04-28T09:30:00-04:00,124.54,125.37,123.25,125.16,35654899,24818867.75,51.69982962019326,56.68416231251744,NaN,NaN,-78.06185961890588,23.612972195957525,-0.18070906870766368,0.4811452051631875,0.6618542738708512,3667696599,3661319252.2,63.094662669292674,68.36073316343963,NaN,NaN,10.114893441556019,14.0776960034968
2015-04-29T09:30:00-04:00,124.47,124.9,123.63,123.8,26437936,24915375.7,44.95531361106978,55.83073317622576,NaN,NaN,-129.93043805228365,-10.836338438903786,-0.27385325333568167,0.3195377072012491,0.5933909605369307,3641258663,3657184397.8,60.57483721959981,67.5352043707372,NaN,NaN,6.768271450210056,13.033492495884408
2015-04-30T09:30:00-04:00,123.06,123.44,120.66,121.18,72393767,26937305,35.37976460273197,54.11217272186446,NaN,NaN,-323.1385616248401,-93.00314541407474,-0.49049049501803205,-0.0197221582356093,0.47076833678242275,3568864896,3634965624.2,49.20335455524891,65.86241052373904,NaN,NaN,0.012742204750870454,11.17338531143676
2015-05-01T09:30:00-04:00,121.52,122.16,120.905,121.97,47996208,28157795.8,39.560151718251596,52.667934182836085,NaN,NaN,-251.1399133414173,-159.3538603819388,-0.5544381495464981,-0.22227935015069988,0.33215879939579823,3616861104,3625344592.4,45.24276174071754,63.86835928180893,NaN,NaN,-3.8135404428572244,9.032395917966191
2015-05-04T09:30:00-04:00,122.13,123.345,121.795,122.41,37675148,28939274.4,41.81776040656122,51.39935454515301,NaN,NaN,-154.41256385177238,-187.33666729784386,-0.5404031928589568,-0.3433451916778978,0.19705800118105904,3654536252,3629843502.8,47.375907249581665,61.99340192431454,NaN,NaN,-6.0356384102435285,6.879819585364803
2015-05-05T09:30:00-04:00,122.35,122.62,120.28,120.85,56891572,30773116.9,36.59811894945966,49.47994507943181,NaN,NaN,-185.11408255685802,-208.7471118854343,-0.6046296213031696,-0.5587290254479029,0.04590059585526665,3597644680,3615833119,41.901513542082405,59.64409144645668,NaN,NaN,-9.774559520324935,4.50062257026627
2015-05-06T09:30:00-04:00,121.11,121.49,120.24,121.27,34348279,31524809.85,38.81249817968908,47.75579268132686,NaN,NaN,-158.8776563758852,-214.53655555015462,-0.5868048666948608,-0.6876054875133093,-0.10080062081844854,3631992959,3613979978.2,41.222995955815705,57.16994905213893,NaN,NaN,-11.975274246891944,2.146923024957953
2015-05-07T09:30:00-04:00,121.14,122.23,120.57,121.73,29826089,31899851.75,41.23338109525115,47.12673835487074,NaN,NaN,-114.00919380151142,-172.71068198548886,-0.5145962696930597,-0.7440459579347731,-0.22944968824171347,3661819048,3632570808.6,49.9747605661769,55.61508279227163,NaN,NaN,-12.970481338983141,-0.012706169890774444
2015-05-08T09:30:00-04:00,122.93,123.25,122.4,122.64,26357112,32469391.2,45.801783029509146,46.409431903409526,NaN,NaN,-56.2407127380405,-133.7308418648135,-0.3821954101343079,-0.7071939509095984,-0.32499854077529045,3688176160,3646833819.8,55.45482842551301,54.72110980292113,NaN,NaN,-12.345096672639414,-1.7744762417120086
2015-05-11T09:30:00-04:00,122.6,123.66,122.44,122.71,28406742,32748768.5,46.1485774593711,45.769373233396905,NaN,NaN,-43.65352247350044,-111.5790335891591,-0.27174361531984326,-0.6646780599250945,-0.3929344446052513,3716582902,3659243149.8,59.60136279430741,54.318113728458414,NaN,NaN,-11.744035648683845,-3.1986990141365563
2015-05-12T09:30:00-04:00,122.35,122.92,120.87,122.49,34961556,33366804.7,45.170327854764196,44.99439080551321,NaN,NaN,-68.3992604276099,-88.23606916330948,-0.198726898499883,-0.6413430677301051,-0.44261616923022207,3681621346,3676038483,64.42773807986613,54.56463644820939,NaN,NaN,-11.529795776319027,-4.3888556944483375
2015-05-13T09:30:00-04:00,122.76,123.21,122,122.485,27214715,32863424.75,45.146904378621095,44.024505662489,NaN,NaN,-44.41784693131913,-65.34410727439626,-0.13882768375822102,-0.6161507739279983,-0.4773230901697773,3654406631,3680521217.4,65.6087161393668,54.88333333810648,NaN,NaN,-11.361070046287617,-5.384886316139663
2015-05-14T09:30:00-04:00,123.08,123.86,122.45,123.79,23293248,32806093.3,52.12493219969927,43.74826324720159,NaN,NaN,-6.825443454363155,-43.907357204966615,-0.0063727250321209405,-0.4852889964599285,-0.47891627142780757,3677699879,3683697383.6,66.45840314749053,55.0870035081851,NaN,NaN,-9.151545609964447,-5.922980500971775
2015-05-15T09:30:00-04:00,123.56,123.72,122.94,123.65,22055622,31494699.5,51.36993939028259,43.987091606818275,NaN,NaN,-1.3031161473159416,-32.91983788682169,0.07241326109010615,-0.3883996950651749,-0.46081295615528106,3655644257,3677191003,63.023353446691885,55.2260853951251,NaN,NaN,-7.543595944614492,-6.154496992920735
2015-05-18T09:30:00-04:00,123.4,125.16,123.17,125.05,30846033,31806887.6,57.931916655187116,44.4322406807464,NaN,NaN,49.3572152222359,-14.317690347674446,0.211544641154297,-0.19638215471240983,-0.4079267958667068,3686490290,3671172480.6,59.93721920378583,55.000553719017475,NaN,NaN,-4.056784457624409,-5.854823773592688
2015-05-19T09:30:00-04:00,124.8,125.05,124.31,124.88,23256804,32277496.45,56.92740071189147,45.287389759376524,NaN,NaN,67.80389028654714,12.922939795156964,0.28052996298807165,-0.05726434213161724,-0.3377943051196889,3663233486,3667494908.6,58.06613968003628,54.82136103762008,NaN,NaN,-1.496328351749968,-5.232181570472299
2015-05-20T09:30:00-04:00,125.17,125.4625,124.34,125.11,20838541,32219858.2,57.98877337330037,46.90231895727426,NaN,NaN,80.88584616979624,37.98367841538003,0.32682045091066997,0.07073125851864859,-0.2560891923920214,3684072027,3673427987.8,60.22351498742378,55.60851535420399,NaN,NaN,0.9366611458536277,-4.350918325282882
2015-05-21T09:30:00-04:00,124.98,125.47,124.48,124.97,16229256,32130029.55,57.06697371755632,48.15280624293889,NaN,NaN,87.04693421435191,56.75815394912304,0.3321022072122984,0.15903856662335158,-0.1730636405889468,3667842771,3671456566.2,59.134864395839394,56.60080840099841,NaN,NaN,2.7227972844353117,-3.3403875238945684
2015-05-22T09:30:00-04:00,124.76,125.24,124,124.43,22601420,32510475.5,53.53222671094116,48.98955383610888,NaN,NaN,73.3248675795865,71.68375069450353,0.28511961297735733,0.1833358756327499,-0.10178373734460745,3645241351,3669375985,57.94438035250164,57.35569933692126,NaN,NaN,3.3323034829337903,-2.3871459514905173
2015-05-26T09:30:00-04:00,123.94,124.04,122.52,123.24,44037812,33066137.95,46.671596174607,49.7090879236194,NaN,NaN,8.268560873704496,63.46601982479725,0.16571031482644943,0.10535415618845434,-0.060356158637995094,3601203539,3652318634.8,49.19952786461084,57.876986074244726,NaN,NaN,1.8904007435263732,-1.7760678522023903
2015-05-27T09:30:00-04:00,123.36,124.87,122.79,124.75,32086276,32887706.8,54.619189569810295,50.83813730862806,NaN,NaN,62.672892702113224,62.439820307910466,0.1790949995034746,0.16351259074134816,-0.015582408762126437,3633289815,3646329900.6,46.54364040034057,58.25703210599651,NaN,NaN,3.0685137233211117,-1.0839847699847471
2015-05-28T09:30:00-04:00,124.45,124.71,123.77,124.64,18631916,32497405.8,53.98797859192603,51.74917998696198,NaN,NaN,75.34481249451716,61.33161357285466,0.17121792356649468,0.1984399956959919,0.027222072129497232,3614657899,3632447075,41.016114749351814,57.61712883336613,NaN,NaN,3.821494069702875,-0.38320207860080113
2015-05-29T09:30:00-04:00,124.61,124.73,123.32,123.89,33468891,30551162,49.76511040911561,52.03227479979101,NaN,NaN,46.57954485247516,53.238135700479305,0.1091937721973351,0.1637142873761661,0.05452051517883101,3581189008,3615116322.4,35.36910288111754,56.1824341516236,NaN,NaN,3.1910688406314884,0.1274080527180974
2015-06-01T09:30:00-04:00,124.69,124.9,123.03,124.28,35649419,29933822.55,51.87318329231353,52.441175216429755,NaN,NaN,46.9830621623817,47.96977461703834,0.08898595351295618,0.16575295707002624,0.07676700355707006,3616838427,3609435737.6,33.72987540084419,54.33447076637623,NaN,NaN,3.2883185237996373,0.5789666914440317
2015-06-02T09:30:00-04:00,123.8,125.31,123.48,124.52,29477552,29523942.75,53.17540671213213,53.01296656338461,NaN,NaN,64.47323882636958,59.21071020757135,0.08627166272496782,0.18460658196327984,0.09833491923831202,3646315979,3618458225.6,38.59752188526807,52.48945532390494,NaN,NaN,3.7413498442720607,1.0307357132766073
2015-06-03T09:30:00-04:00,124.76,125.93,124.42,125.76,30774798,28218104.05,59.302582534810846,54.02408643168388,NaN,NaN,115.58095078040361,69.79232182322944,0.15828529717209644,0.29619154070343257,0.13790624353133613,3677090777,3627218418,42.9770089824262,50.8729048126949,NaN,NaN,6.033541106792415,1.7454221980645799
2015-06-04T09:30:00-04:00,125.08,125.62,124.08,124.5,25820603,27791720.25,51.87454375569311,54.00620154282628,NaN,NaN,68.19190766107603,68.36174085654122,0.11345694996725544,0.2797274309904054,0.16627048102314998,3651270174,3634540873,46.41725916755794,49.441394528413994,NaN,NaN,5.6938281087266,2.3094801853020113
2015-06-05T09:30:00-04:00,124.23,125.52,123.32,125.4,36626467,28131739.15,56.103978808219864,54.34434721553608,NaN,NaN,65.70639594502212,72.1871110750506,0.13533185081131277,0.33543529453729093,0.20010344372597816,3687896641,3655882399.6,54.9483437715294,48.864608123045244,NaN,NaN,6.776600746201796,2.947640265430552
2015-06-08T09:30:00-04:00,125.28,125.62,124.57,124.82,18798651,27753816.1,52.87876177307629,53.9834075810996,NaN,NaN,82.91128457700984,79.37275555797623,0.10310974571399423,0.32899062586847094,0.22588088015447672,3669097990,3666334312.2,58.43835647760882,48.75754649974689,NaN,NaN,6.643022654897725,3.4755520353544336
2015-06-09T09:30:00-04:00,124.71,124.86,123.5,124.44,23928304,27529894.2,50.81756515025398,53.54699075526835,NaN,NaN,9.124056426527337,68.30291907800778,0.05119834611558699,0.28987881279896044,0.23868046668337345,3645169686,3666105053.6,58.33161461070553,48.776508994794696,NaN,NaN,5.898575531480632,3.8216982490867477
2015-06-10T09:30:00-04:00,124.93,126.48,124.85,125.99,42563464,27909989.6,58.00775028022368,53.548346248620014,NaN,NaN,162.1348723249377,77.6137033869146,0.11271875929631092,0.37957891580376213,0.2668601565074512,3687733150,3668233528.2,59.07894246421689,48.69475381456563,NaN,NaN,7.588232729608531,4.359774603447002
2015-06-11T09:30:00-04:00,126.17,126.54,125.91,126.31,17489367,27423722.2,59.32968658507684,53.70996859630005,NaN,NaN,200.8430752640502,104.14393690750944,0.16335839812219077,0.4710581541601897,0.30769975603799893,3705222517,3679023996.8,62.728482167520234,48.95144079825712,NaN,NaN,9.360417710291632,5.074152190139092
2015-06-12T09:30:00-04:00,125.92,126.15,125.43,125.93,23578621,27437990.85,57.03358875082355,53.960065884863084,NaN,NaN,136.2170836676422,118.24607445203344,0.15947887332710514,0.5070483476968803,0.3475694743697752,3681643896,3677773447.8,62.037934496080105,49.24383752279844,NaN,NaN,10.113514632633876,5.794061110495489
2015-06-15T09:30:00-04:00,125.11,125.8,123.94,125.53,30618318,27866125.65,54.6366154248324,54.52899583130776,NaN,NaN,42.86832281055295,110.23748209874206,0.11999132619854602,0.4975586321179577,0.3775673059194117,3651025578,3674158965.4,59.98259201120404,50.01405639041223,NaN,NaN,10.025817560071133,6.398597746149153
2015-06-16T09:30:00-04:00,125.38,126.65,125.32,126.42,32800865,27963867.25,58.786939995550675,54.82669229028921,NaN,NaN,146.75860635307376,137.76439208405137,0.14230666480459736,0.5554506369251584,0.41314397212056103,3683826443,3681890316.8,62.82005129142779,51.176657168347035,NaN,NaN,11.20955003809253,7.085876644998207
2015-06-17T09:30:00-04:00,126.74,126.96,125.97,126.23,32467043,28424379.2,57.575880504576936,55.0829709983357,NaN,NaN,148.1458136358667,134.96658034623715,0.13294162534630566,0.5793210038034431,0.44637937845713743,3651359400,3674615566.8,58.60898365784516,52.43329066181084,NaN,NaN,11.823013903417985,7.7626105390581746
2015-06-18T09:30:00-04:00,126.82,128.24,126.74,127.92,39642055,29364554.9,64.56785525545521,56.14030991593139,NaN,NaN,213.4297520660901,137.48391570664512,0.22388507663332613,0.7262357242487951,0.502350647615469,3691001455,3671771354.4,57.00019531953945,53.97836869312669,NaN,NaN,14.645794257084344,8.7459224987762
2015-06-19T09:30:00-04:00,127.82,128.16,127.6,127.86,23310943,29718639.25,64.16353590027099,57.018192245071205,NaN,NaN,184.21052631576933,147.08260423627053,0.2607413495698464,0.828277334577777,0.5675359850079306,3667690512,3668980677.6,55.393528053430906,55.52577245402574,NaN,NaN,16.761247283951594,9.890968896658398
2015-06-22T09:30:00-04:00,128.42,128.84,128.15,128.74,25229954,29850065.95,67.3889741852432,58.03344706457914,NaN,NaN,187.7891297072603,176.066765615612,0.3211590819399974,0.9689848374329273,0.6478257554929299,3692920466,3677359655.2,59.11944017096229,56.99162376014676,NaN,NaN,19.594287064202206,11.277157206307514
2015-06-23T09:30:00-04:00,128.68,129.09,128.395,129.01,23378512,28817100.95,68.33079128637027,58.67831911826196,NaN,NaN,172.21915329408344,181.15887500381396,0.35351672181509586,1.0897216577617996,0.7362049359467038,3716298978,3683854162.2,61.78396746483793,58.33497793746188,NaN,NaN,22.19537430286704,12.836902505816017
2015-06-24T09:30:00-04:00,128.76,129.1,127.73,127.92,26436839,28534629.1,60.70828964782454,59.30930096769992,NaN,NaN,122.5463573589746,176.03898374843553,0.2789928394677974,1.0849459852814505,0.8059531458136531,3689862139,3691554710,64.72019451867283,59.64233046254152,NaN,NaN,22.156738445786925,14.168307640097575
2015-06-25T09:30:00-04:00,128.35,128.42,127.245,127.85,24100905,28808078.55,60.24350950427315,59.604981731703724,NaN,NaN,89.52552974427245,151.258139284072,0.20584249066660631,1.063256259146911,0.8574137684803047,3665761234,3686506665.8,61.390303431312134,60.10247043824029,NaN,NaN,21.989262668570692,15.285586929879448
2015-06-26T09:30:00-04:00,128.1,128.34,126.82,127.5,38219897,29045628.85,57.85833484590347,59.96066552261995,NaN,NaN,67.1958210372671,127.85519822837155,0.11904960569889467,1.006225775603923,0.8871761699050283,3627541337,3678476830.8,56.417806035574245,59.95814540666639,NaN,NaN,21.162683053654263,16.125172090418708
2015-06-29T09:30:00-04:00,126.63,127.07,124.11,124.28,49224899,29724402.85,41.556906901106856,59.299189933395155,NaN,NaN,-59.742792389191685,78.34881380908116,-0.15517236347903585,0.6932107155562335,0.8483830790352693,3578316438,3655556025.2,45.17072580720972,59.0180819207024,NaN,NaN,14.394364520662196,15.877913866167777
2015-06-30T09:30:00-04:00,125.18,125.32,124.29,124.86,39631251,30232087.8,44.58549347981577,58.34045730479458,NaN,NaN,-79.12242320759255,28.080498508745983,-0.2896352910688934,0.48633896519915254,0.775974256268046,3617947689,3635885767.4,38.14315718881808,57.52266868674535,NaN,NaN,10.073840529582572,15.04876053236989
2015-07-01T09:30:00-04:00,125.77,126.16,124.06,125.23,28627704,30124733.1,46.490498478726124,57.423372440055246,NaN,NaN,-60.67751108286072,-8.564275179621069,-0.34219276210638117,0.34823330363506955,0.6904260657414507,3646575393,3627228418.2,35.52361865062433,55.57946414982422,NaN,NaN,7.272295067271769,13.93783689449873
2015-07-02T09:30:00-04:00,124.805,124.96,123.37,123.78,31486357,30408020.8,40.6000284689878,56.24954670563841,NaN,NaN,-115.26964214746698,-49.52330955796894,-0.45602655189516295,0.12039287587249703,0.57641942776766,3615089036,3617093978.6,32.69311365734302,53.48340551848586,NaN,NaN,2.808366025549884,12.347912484648894
2015-07-06T09:30:00-04:00,122.94,124.51,122.82,123.74,27852246,29969309.75,40.44777854190057,55.236058356857555,NaN,NaN,-125.9143482338315,-88.14534341218865,-0.5112775130561878,-0.06267746355257486,0.448600049503613,3587236790,3609033069.2,30.60430692058584,51.38495658344169,NaN,NaN,-0.6968380958591132,10.484376687433464
2015-07-07T09:30:00-04:00,123.88,123.99,121.53,123.88,39347102,30996732.3,41.277793367676466,53.98540502629511,NaN,NaN,-140.06892230577353,-104.21056939550502,-0.5142610611291292,-0.19422627690779848,0.3200347842213307,3626583892,3618686560,35.88719919990997,49.46118143404756,NaN,NaN,-3.259324466809187,8.520990808255943
2015-07-08T09:30:00-04:00,122.8,123.35,121.28,121.99,40724492,31836541.7,34.32290220440673,52.324478004854384,NaN,NaN,-166.67396860168796,-121.72087847432411,-0.6127057573136849,-0.4458474124207754,0.16685834489290946,3585859400,3612268902.2,34.032352340499315,47.705707768522856,NaN,NaN,-7.955446667709943,6.1672140259751025
2015-07-09T09:30:00-04:00,123.35,123.53,122.2701,122.43,29770370,31196887,36.98481978036327,50.354261185204955,NaN,NaN,-124.16129511037308,-134.41763527982658,-0.6157313810449929,-0.6028058814133317,0.012925499631661203,3615629770,3606079777.6,32.29859058620575,45.94130743042759,NaN,NaN,-10.907204298257055,3.7280114082276516
2015-07-10T09:30:00-04:00,123.84,124.34,123.36,124.13,28735789,31759208.1,46.078210915947516,49.062452257753286,NaN,NaN,-68.71475104759864,-125.1066570598529,-0.47697793776431874,-0.5832969225737372,-0.1063189848094185,3644365559,3611935082.2,35.63918634413382,44.53028302262066,NaN,NaN,-10.483626813586218,1.697777376539956
2015-07-13T09:30:00-04:00,124.77,125.64,124.75,125.53,21349926,31647773.35,52.196177643358595,47.97725250476152,NaN,NaN,-15.547957796651795,-103.03337897241697,-0.2746919767158611,-0.4496839557042449,-0.17499197898838378,3665715485,3627630821.2,43.66390660901405,43.42631633962436,NaN,NaN,-7.995069275036359,0.31308499774333964
2015-07-14T09:30:00-04:00,125.46,126.5,125.4,126.23,21009543,31167334.6,54.9485445722743,47.02137773946896,NaN,NaN,10.618008033208845,-72.8959929046205,-0.08723551479280636,-0.28403637247939173,-0.19680085768658537,3686725028,3639659048.4,48.92000800614499,42.50746209257486,NaN,NaN,-5.061697537777246,-0.4547410787596011
2015-07-15T09:30:00-04:00,126.31,126.48,125.27,125.56,22238319,30639207.3,51.8701608903518,46.390082828220905,NaN,NaN,0.8805973842978653,-39.38507970742333,-0.006132045163585814,-0.20446591414106763,-0.19833386897748181,3664486709,3655384510.2,54.85081016792633,41.80250606752154,NaN,NaN,-3.6715980808758784,-0.9142920790619264
2015-07-16T09:30:00-04:00,126.11,126.74,125.97,126.31,33568440,30694277.15,54.915035617452354,46.00947755059085,NaN,NaN,22.986022000591,-9.955616285230544,0.09469491019301299,-0.07996523123621557,-0.17466014142922856,3698055149,3671869586,60.08309844141101,41.7091342825286,NaN,NaN,-1.5423888554397358,-1.004020189973042
2015-07-17T09:30:00-04:00,126.31,126.38,125.36,125.76,24739898,29949169.3,52.30191922285056,45.61259072037278,NaN,NaN,7.27303718688093,5.241941361665363,0.11941985686958104,-0.02538532034225227,-0.1448051772118333,3673315251,3677659524.4,61.759333179565616,42.09067193567084,NaN,NaN,-0.6056802315292825,-0.9471144816239336
2015-07-20T09:30:00-04:00,125.78,125.86,124.76,125.08,23271055,29947174.9,49.18563760909601,46.15750005665772,NaN,NaN,-12.588820155689687,5.833768889857785,0.08658093797932678,-0.036579004737674836,-0.12315994271700162,3650044196,3674525266.6,60.28355088772655,43.17015944142204,NaN,NaN,-0.7771909209074797,-0.9228396872358687
2015-07-21T09:30:00-04:00,125.07,125.8,124.11,124.49,28118741,30091614.25,46.59172328189507,46.30080218537767,NaN,NaN,-25.819658788320332,-1.4537644744480451,0.024929828013562652,-0.09199765770004831,-0.11692748571361096,3621925455,3661565352,54.485853267793146,44.33749487563455,NaN,NaN,-1.703755400743797,-1.0343990748798584
2015-07-22T09:30:00-04:00,124.08,125.09,123.88,124.95,20654239,29955400.6,48.85636457187467,46.46979262060256,NaN,NaN,-26.68295638796508,-6.966475228900634,0.015403374812337361,-0.09767326719818925,-0.11307664201052661,3642579694,3657183949,52.64258032326191,45.56027785225151,NaN,NaN,-1.8078067748099547,-1.1448858891555864
2015-07-23T09:30:00-04:00,124.99,125.39,123.3,123.57,39712139,30619165.6,42.96982128868407,46.639063536295154,NaN,NaN,-50.00896693387962,-21.56547301579476,-0.07841256976425892,-0.21109235421585026,-0.13267978445159134,3602867555,3638146430.2,45.44804247594171,46.47134419643714,NaN,NaN,-3.7290290699282025,-1.5140492006945316
2015-07-24T09:30:00-04:00,123.48,123.71,121.49,121.58,39533027,31390771.7,36.1969891111294,46.33543571981149,NaN,NaN,-144.09863758997517,-51.839807971165975,-0.2588916045589641,-0.45629429015029643,-0.19740268559133237,3563334528,3616150285.6,38.84269079829932,47.059800187702386,NaN,NaN,-7.773063858726805,-2.4081941518419994
2015-07-27T09:30:00-04:00,121.13,121.32,120.27,120.57,35627207,31261137.2,33.32593066102302,45.76744552647911,NaN,NaN,-201.31598510954595,-89.58524096193723,-0.4210969992514457,-0.7237739346556396,-0.3026769354041938,3527707321,3591682910.6,33.082864746500476,46.85949058388742,NaN,NaN,-12.088195119795616,-3.7910514329782306
2015-07-28T09:30:00-04:00,120.92,121.81,119.339,121.6,53474775,31473631,38.66854006259072,46.077848230635105,NaN,NaN,-161.1377831227912,-116.64886582883142,-0.43219795609710393,-0.8429243805255737,-0.4107264244284698,3581182096,3583534238.8,31.41222470225999,46.672338609727476,NaN,NaN,-13.905596768397347,-5.235986480895247
2015-07-29T09:30:00-04:00,121.36,122.33,120.97,121.94,32411277,31112632.3,40.367206065563735,46.31944725100657,NaN,NaN,-103.79321650416541,-132.07091785207146,-0.39105676964606306,-0.8995473864860486,-0.5084906168399855,3613593373,3577736974.6,30.242150515936146,46.52545003327964,NaN,NaN,-14.816824188000908,-6.604677581910341
2015-07-30T09:30:00-04:00,121.63,122.44,121.01,122.29,29383880,31150441.1,42.14364217827498,46.0384066268871,NaN,NaN,-84.78976687654924,-139.0270778406054,-0.317798434732657,-0.9057386602558068,-0.5879402255231498,3642977253,3585758914.2,33.910639588674385,46.40198240788968,NaN,NaN,-15.018002029449192,-7.806581074415891
2015-07-31T09:30:00-04:00,122.45,123.67,122.22,122.96,31812747,31166760.6,45.49115941585616,45.559476753494074,NaN,NaN,-34.27080751101991,-117.06151182481435,-0.20710403700700675,-0.8468202717819082,-0.6397162347749015,3674790000,3608050008.6,42.89710593911696,46.34721093146846,NaN,NaN,-14.181239515493116,-8.717246565998352
2015-08-03T09:30:00-04:00,123.03,123.16,121.455,122.35,34033236,31475810.1,43.0489973126272,44.70950909209072,NaN,NaN,-56.778605964885195,-88.1540359958822,-0.15996280130373763,-0.8396697364045735,-0.6797069351008359,3640756764,3630659897.2,50.28168167555638,46.44447333642641,NaN,NaN,-14.19372878993322,-9.499601169417618
2015-08-04T09:30:00-04:00,122.39,122.96,121.61,122.06,21728894,30594899.7,41.89743417174651,43.997171469333196,NaN,NaN,-57.869179044412526,-67.50031518020646,-0.13434043779651816,-0.8476324823464836,-0.7132920445499654,3619027870,3638229052,52.49644434865607,46.27630434933568,NaN,NaN,-14.531874295239767,-10.218497330249354
2015-08-05T09:30:00-04:00,122.59,123.53,121.91,122.34,25673532,29842351.7,43.46978716774159,43.17965372292527,NaN,NaN,-43.228810352306674,-55.3874339498347,-0.08686659571787425,-0.8218752891973082,-0.735008693479434,3644701402,3644450657.8,54.29855112806409,45.86312239838232,NaN,NaN,-14.377300333131316,-10.812612044946777
2015-08-06T09:30:00-04:00,122.47,122.66,119.78,120.69,42225320,30465099.2,37.09856876785296,42.09370011899688,NaN,NaN,-99.64321202543009,-58.35812297961087,-0.1511554320778561,-0.9239529835767541,-0.7727975514988981,3602476082,3636350423.6,51.556247904688504,45.13433059303396,NaN,NaN,-16.152867106800876,-11.575505625211647
2015-08-07T09:30:00-04:00,120.14,120.44,119.07,119.88,42261408,31141380.15,34.430687878053874,41.03977513820816,NaN,NaN,-129.87879557279084,-77.47972059196506,-0.22817347163389656,-1.0580143910412687,-0.8298409194073721,3560214674,3613435358.4,44.681412132086436,44.01989211048824,NaN,NaN,-18.480247869229636,-12.561897374357075
2015-08-10T09:30:00-04:00,120.33,121.52,120.31,121.26,28798903,31513829,42.073688690962726,40.717058381712995,NaN,NaN,-77.78508247669775,-81.68101589432759,-0.1688517789904852,-1.0409056431454786,-0.8720538641549934,3589013577,3603086721,41.96018274646812,43.125201358965036,NaN,NaN,-18.123678580703455,-13.356437546692272
2015-08-11T09:30:00-04:00,120.48,121.09,119.65,120.22,33383754,32132539.55,38.43741635059582,39.97284779447879,NaN,NaN,-98.03300319705961,-89.713780724857,-0.18123862377602695,-1.098602143875027,-0.9173635200990001,3555629823,3590407111.6,38.83903663978446,42.13923395300235,NaN,NaN,-18.978020303060678,-14.159520797602044
2015-08-12T09:30:00-04:00,119.57,120.34,117.965,119.99,46500071,33345627.15,37.66218643724204,39.59373101937579,NaN,NaN,-125.09145151850659,-106.08630895809699,-0.18581626454818134,-1.1496338507842268,-0.9638175862360454,3509129752,3563292781.6,33.15894750283748,41.261441454923485,NaN,NaN,-19.898653347669235,-14.97939687618307
2015-08-13T09:30:00-04:00,120.1,120.59,119.39,119.59,35698295,33452119.9,36.29131758510064,39.60046876751659,NaN,NaN,-102.96076025396707,-106.74981860380437,-0.1956847700360198,-1.2084235487810702,-1.0127387787450504,3473431457,3537483856.6,28.83602182450241,40.546679385366566,NaN,NaN,-21.064042154657898,-15.84863191596519
2015-08-14T09:30:00-04:00,119.49,120.49,119.02,120.36,21091502,33269700.1,40.76135265494697,40.13157033851115,NaN,NaN,-91.50417991984115,-99.07489547321444,-0.13323949182142414,-1.1792881435218305,-1.0460486517004064,3494522959,3524345513.6,26.912544146844553,40.10594219967685,NaN,NaN,-20.739150379333022,-16.547277410732022
2015-08-17T09:30:00-04:00,120.03,121.68,119.6,121.63,22328153,33222555,47.32593125191812,40.749955423463106,NaN,NaN,-37.056030140905094,-90.9290850060559,0.003469692059391516,-1.041711536626167,-1.0451812286855584,3516851112,3509913020.6,24.9441756558316,39.643938696360536,NaN,NaN,-18.41079459563315,-16.813494151432185
2015-08-18T09:30:00-04:00,121.46,121.46,120.52,120.66,26360378,33134636.85,43.372544378627516,40.96462244582481,NaN,NaN,-35.26815718535316,-78.37611580371461,0.03660005687899681,-0.9994311575868124,-1.0360312144658093,3490490734,3496885202.8,23.288382871812132,39.147241007494536,NaN,NaN,-17.64111365387214,-16.931725508923606
2015-08-19T09:30:00-04:00,119.9,120.5,118.74,119.41,45178918,34360870.8,38.8667503020007,40.730558740376644,NaN,NaN,-109.0041388630885,-75.158653272631,-0.014879888704967037,-1.054631075347018,-1.039751186642051,3445311816,3484121615.6,21.76410744686555,38.2796315687939,NaN,NaN,-18.41324660844455,-17.14337138028374
2015-08-20T09:30:00-04:00,118.34,118.61,116.39,116.39,51879763,34969252,30.596632689381735,39.66666397419989,NaN,NaN,-243.25291539360288,-103.21708430055814,-0.2296166245426996,-1.3267719673204255,-1.0971553427777259,3393432053,3468121734.8,19.99716940265091,36.643921816189184,NaN,NaN,-22.174297322499278,-17.86207508631453
2015-08-21T09:30:00-04:00,115.13,116.66,114.37,115.03,79168349,36951018.1,27.734615404474198,38.572779552188976,NaN,NaN,-268.1574221196494,-138.54773274051982,-0.4289620345023304,-1.6333578859056388,-1.2043958514033084,3314263704,3432069883.8,16.706011368105777,34.245659651371284,NaN,NaN,-26.27304488186161,-19.06364219996411
2015-08-24T09:30:00-04:00,109.51,114.9188,108.26,110.54,83809198,39360117.65,20.812785249201,37.066733200578575,NaN,NaN,-323.6579356069516,-195.8681138337291,-0.8069820402908905,-2.2131234017669215,-1.406141361476031,3230454506,3374790562.6,13.035260539359868,31.427003664992988,NaN,NaN,-33.05637814227316,-21.06260447743683
2015-08-25T09:30:00-04:00,114.05,114.1,109.56,109.69,59240249,39648391.35,19.805081901218415,35.376397110112634,NaN,NaN,-238.79196205609378,-236.5728748078772,-1.043039816289195,-2.7099411318375246,-1.6669013155483297,3171214257,3310935267.2,10.314382354370053,28.285277324014846,NaN,NaN,-38.453846783708876,-23.547067664047123
2015-08-26T09:30:00-04:00,111.83,112.69,109.42,112.48,51605349,40608094.95,31.524537398247077,34.97825201228364,NaN,NaN,-173.5223502128152,-249.47651707782256,-0.9430702832127056,-2.8457391695642116,-1.902668886351506,3222819606,3266436825.2,8.917485428444735,25.239651432854576,NaN,NaN,-38.24993519781513,-25.647477311728267
2015-08-27T09:30:00-04:00,113.3,115.12,112.36,114.49,49533703,41615586.1,38.4976810881334,35.268751527289325,NaN,NaN,-98.53027244101378,-220.53198848730477,-0.685354240693437,-2.759361687218302,-2.074007446524865,3272353309,3242221076.4,8.261746760015939,22.638246763420966,NaN,NaN,-35.34625292360768,-27.033016684853898
2015-08-28T09:30:00-04:00,114.36,115.7,114.21,115.62,41601408,42105019.15,42.069333862248726,35.26844046809547,NaN,NaN,-63.77262177600112,-179.65502841857509,-0.39687312612966963,-2.570098854186952,-2.1732257280572824,3313954717,3242159279,8.260077478859102,20.23109638716318,NaN,NaN,-31.79186678194286,-27.712852413009465
2015-08-31T09:30:00-04:00,115.1,115.98,114.76,115.2,29250929,41865903.8,41.113639133967844,35.45959923833633,NaN,NaN,-53.48527343674731,-125.62049598453423,-0.20224454192854768,-2.426031405467967,-2.223786863539419,3284703788,3253009135.4,11.635842609843507,18.28801109931025,NaN,NaN,-29.419358568679282,-27.956639006676582
2015-09-01T09:30:00-04:00,113.11,114.12,111.6,111.9,45129150,43035916.6,34.4848880854493,35.23264935606542,NaN,NaN,-97.30236203271326,-97.32257597985813,-0.2599775730993179,-2.5487588299135666,-2.2887812568142487,3239574638,3266681211.6,15.838486153892191,17.0508352886713,NaN,NaN,-29.7440841357393,-28.2119883108284
2015-09-02T09:30:00-04:00,113.41,113.97,112.075,113.91,26865761,43095528.05,40.75094086041734,35.551193875730895,NaN,NaN,-73.43390216904092,-77.3048863711033,-0.13339517848603277,-2.45552522992179,-2.322130051435757,3266440399,3275405370.2,18.502072295393887,16.312696036592126,NaN,NaN,-27.72392356166297,-28.14226477523334
2015-09-03T09:30:00-04:00,114.08,115.13,113.55,113.73,33334527,42650988.4,40.37849443212283,35.52384685981489,NaN,NaN,-51.019964434669824,-67.8028247698345,-0.037379753233443225,-2.368854742977561,-2.331474989744118,3233105872,3267555882.8,17.95157130550801,15.672626547925228,NaN,NaN,-26.31961720241927,-27.881886550545616
2015-09-04T09:30:00-04:00,112.53,113.7,112.28,112.87,31154598,42095647.9,38.56494451445378,34.89806209285315,NaN,NaN,-68.46069826025739,-68.74044006668575,-0.008867214822480207,-2.342559008272218,-2.333691793449738,3201951274,3245155194.2,16.447582639941444,15.065727046790217,NaN,NaN,-25.77317031862268,-27.580641374556624
2015-09-08T09:30:00-04:00,114.56,115.57,114.11,115.45,29916293,42151517.4,46.34989581416167,35.11073005253416,NaN,NaN,-20.919086460661614,-62.2272026714686,0.19539412119514177,-2.0894491419558108,-2.2848432631509525,3231867567,3234587950,15.776111842749486,14.52913625900003,NaN,NaN,-22.67199084213407,-26.879405584210545
2015-09-09T09:30:00-04:00,116.17,116.415,114.01,114.12,40963018,42530480.6,43.30354631209632,35.42764405325528,NaN,NaN,-20.85157312622842,-46.937044890171634,0.249131273719279,-1.9734291710018539,-2.222560444721133,3190904549,3224853932.2,15.16206910428086,14.05756209167255,NaN,NaN,-21.13627397094242,-26.058958210886527
2015-09-10T09:30:00-04:00,113.75,115.28,113.725,114.64,29877872,41699370.65,44.83029656581341,36.444334330143256,NaN,NaN,-24.150039171436223,-37.08027229065069,0.32320065133175735,-1.818559630556436,-2.1417602818881933,3220782421,3215722336.6,14.58842028063225,13.671222868671217,NaN,NaN,-19.43387360173353,-25.1125175524361
2015-09-11T09:30:00-04:00,114.16,115.2,113.66,115.18,27949443,41311928.05,46.44317641789163,37.78066011681593,NaN,NaN,-15.69877157595984,-30.016033718908695,0.4066707481758707,-1.6334218466683552,-2.040092594844226,3248731864,3218847535,15.763063047235676,13.603869417180492,NaN,NaN,-17.565075262850865,-24.03431151106678
2015-09-14T09:30:00-04:00,115.52,115.54,114.43,114.65,22365778,41375641.85,45.051067403187446,39.51196598495782,NaN,NaN,-2.9063432328498537,-16.90516271342718,0.42244560812678245,-1.5120355846857478,-1.9344811928125303,3226366086,3223730497.4,17.66828975729281,13.934800075604272,NaN,NaN,-16.427074719648285,-22.947563398006995
2015-09-15T09:30:00-04:00,114.86,116.19,114.73,115.94,26745295,41596498.95,49.053843350373434,41.601163231326034,NaN,NaN,36.678054830477436,-5.385734455199372,0.5101487699976275,-1.296795230315496,-1.8069440003131234,3253111381,3227979260.2,19.37699389578114,14.582129471419348,NaN,NaN,-14.270246093039873,-21.70794664015455
2015-09-16T09:30:00-04:00,115.95,117.02,115.79,116.94,27127827,41634871.4,51.97442636369386,43.0618695860008,NaN,NaN,93.64171563775642,17.512923297597595,0.6186677986148197,-1.0336092520445987,-1.6522770506594184,3280239208,3245846192,26.30356637612431,15.823992396253603,NaN,NaN,-11.582696347967445,-20.26148231269925
2015-09-17T09:30:00-04:00,116.92,118.89,116.68,117.34,50405392,41896195.1,53.13181948513368,44.10716518578654,NaN,NaN,152.50837906643096,52.84460694517103,0.6948443950916816,-0.7837215567948164,-1.478565951886498,3330644600,3267818627.8,33.83224413952013,17.650456494789616,NaN,NaN,-9.027879731958436,-18.65668194402199
2015-09-18T09:30:00-04:00,115.76,116.84,115.4,115.72,42736050,41439009.45,48.07826629446038,44.53637464523023,NaN,NaN,80.47088109733696,72.07853747983037,0.6162607067761796,-0.7082400684162735,-1.3245007751924531,3287908550,3275653965,36.33011772251676,19.65545936933659,NaN,NaN,-8.216184039662384,-17.16518224339919
2015-09-21T09:30:00-04:00,116.54,117.3,115.08,115.51,33021745,39131679.25,47.44825066776735,44.98884689764448,NaN,NaN,76.50958595363741,87.96172331712783,0.5333740801280942,-0.6577831750323355,-1.1911572551604297,3254886805,3281358108.8,38.16035949491761,21.55006771827046,NaN,NaN,-7.724622111667976,-15.816530796009017
2015-09-22T09:30:00-04:00,114.45,114.73,113.05,113.76,35786940,36730566.35,42.45549956863539,45.558176289300626,NaN,NaN,-34.179225669452194,73.79026721714192,0.352640639329169,-0.7503564559989684,-1.1029970953281374,3219099865,3274555805.6,36.80175468973091,23.047444042258938,NaN,NaN,-8.74031692224192,-14.805643099756574
2015-09-23T09:30:00-04:00,114.02,114.42,113.07,113.42,25506813,35043894.55,41.5409202520862,45.614603388705554,NaN,NaN,-59.03900674307195,43.254122740976236,0.20923222327684443,-0.8414568162320819,-1.0506890395089263,3193593052,3257226574.4,33.52696837285504,24.12065090493473,NaN,NaN,-9.839787043217626,-14.096235091679581
2015-09-24T09:30:00-04:00,112.79,113.42,111.87,113.23,39810257,34454139.95,41.00926661421879,45.659658544569545,NaN,NaN,-119.0740545636919,-11.062363985048336,0.10583188278289013,-0.9183991860303138,-1.024231068813204,3153782795,3221854213.4,28.04180209875028,24.841381675880605,NaN,NaN,-10.898282883358888,-13.639384776205196
2015-09-25T09:30:00-04:00,113.82,113.91,110.93,111.42,43750267,34164968.15,36.249706381919815,45.49428439224569,NaN,NaN,-146.8007326061354,-56.51668672574281,-0.07069758197971265,-1.1126030462878447,-1.041905464308132,3110032528,3186279009,23.820764285566952,25.368037507711,NaN,NaN,-13.248442646031982,-13.583535900466165
2015-09-28T09:30:00-04:00,111.05,111.15,107.88,108.3,56765262,34923160.85,29.824115146020745,44.313871487378485,NaN,NaN,-245.43740192616838,-120.90608430170396,-0.36724900435452623,-1.5009667197512897,-1.1337177153967635,3053267266,3145955101.2,20.123239375834473,25.678546617217073,NaN,NaN,-17.585386751966997,-14.155228879251998
2015-09-29T09:30:00-04:00,108.25,109.11,106.99,107.53,49980722,35959650.5,28.482265233659717,43.25520855320444,NaN,NaN,-237.13426574573592,-161.4970923169607,-0.5726736042208072,-1.8495597206727723,-1.2768861164519651,3003286544,3102792437,17.069055254694476,25.814759913675186,NaN,NaN,-21.55845253287448,-15.212832258340924
2015-09-30T09:30:00-04:00,108.48,109.43,107.91,109.2,50834522,36244919.1,35.28313240427863,42.57326825595196,NaN,NaN,-170.08588757277005,-183.70646848290033,-0.5531926414865413,-1.9683769183101418,-1.4151842768236005,3054121066,3074898039.8,15.438295138412073,25.87546526065946,NaN,NaN,-22.83820584190956,-16.302171341707872
2015-10-01T09:30:00-04:00,109.37,109.68,107.43,109.01,44985931,37150927.6,34.87677453974432,41.74709669322715,NaN,NaN,-144.8459252307304,-188.86084261630802,-0.5112064702878869,-2.054192364683459,-1.542985894395572,3009135135,3045968507.8,13.949768199419466,25.74594420010116,NaN,NaN,-23.982305197990346,-17.399333321176798
2015-10-02T09:30:00-04:00,107.98,110.63,107.12,110.63,58019232,38385162.85,41.10502246948644,41.46523634081994,NaN,NaN,-104.68877799528299,-180.43845169413754,-0.3406403404330025,-1.9687863199368252,-1.6281459795038227,3067154367,3037392875.6,13.533217523349748,25.450581897676653,NaN,NaN,-23.066197674289786,-18.20888537162151
2015-10-05T09:30:00-04:00,111.66,113.45,111.54,113.27,45220492,39088457.55,49.569444980083034,41.50206502865633,NaN,NaN,-13.553555750663325,-134.06168245903652,-0.032553736539970624,-1.668838150178786,-1.6362844136388153,3112374859,3049214394.2,17.2035416587309,25.295335309315924,NaN,NaN,-19.43693652878253,-18.38432125121594
2015-10-06T09:30:00-04:00,113.21,113.674,111.78,112.49,34140043,39299645.05,47.40179469495146,41.175448480889024,NaN,NaN,-13.421904656622369,-89.31921024121382,0.12739541369491847,-1.4770401465201672,-1.6044355602150857,3078234816,3064204048.6,21.739813110281887,24.96935293318432,NaN,NaN,-17.18055534867044,-18.21235469370944
2015-10-07T09:30:00-04:00,113.1,114.5,112.63,114.48,36371014,39070044.85,53.043542207858586,41.16914296108365,NaN,NaN,22.56501503074456,-50.789029720510904,0.3625946479752018,-1.1511922502460834,-1.5137868982212852,3114605830,3076301001.4,25.29690371326801,24.3596857598806,NaN,NaN,-13.372559974218687,-17.5209554480679
2015-10-08T09:30:00-04:00,114.38,115.75,113.95,115.51,43072218,39729762.15,55.69257919270845,41.71302245381566,NaN,NaN,55.481684118201116,-10.723507850724605,0.5705382607764149,-0.8006140722507666,-1.3711523330271815,3157678048,3106009584,33.31337784975538,24.144204340397643,NaN,NaN,-9.394454534403396,-16.360026746115828
2015-10-09T09:30:00-04:00,115.72,116.14,115.395,115.74,26497160,39657148,56.285630418801134,42.34426386460378,NaN,NaN,71.91423275340385,24.59709429901277,0.6981433271116531,-0.49847317413761516,-1.1966165012492682,3184175208,3129413752.2,38.87803090150986,24.195466583725658,NaN,NaN,-6.03839579285474,-14.885508038507101
2015-10-12T09:30:00-04:00,115.79,115.9899,115.07,115.57,22984026,39688060.4,55.69227290060132,43.28974767402992,NaN,NaN,64.23560204572213,40.15492585828987,0.7415862051142097,-0.26963374485650604,-1.0112199499707157,3161191182,3139177016.8,41.08654608398051,24.501523111886343,NaN,NaN,-3.483493051861133,-13.256648754700535
2015-10-13T09:30:00-04:00,115.11,116.3,113.93,113.99,37445271,40223059.2,50.376795212001575,43.92088159973816,NaN,NaN,44.208274720779414,51.68096173377023,0.6383273755596915,-0.21331073052110128,-0.8516381060807928,3123745911,3148279235.8,43.14897163949535,25.18880905950351,NaN,NaN,-2.787274373487823,-11.76102384309872
2015-10-14T09:30:00-04:00,114.04,114.75,112.71,112.87,39987423,40866039,46.9555815343249,44.34561837974574,NaN,NaN,13.343316070098377,49.83662194164099,0.4764330044120195,-0.25609685056576836,-0.7325298549777879,3083758488,3142109767.4,42.073841322894815,26.19109757551383,NaN,NaN,-3.2090538290489254,-10.539313841091607
2015-10-15T09:30:00-04:00,113.19,115.57,112.66,115.57,42503375,40470938.15,54.90613790323435,45.678220631268196,NaN,NaN,55.298277814728564,49.79994068094648,0.5289713708002213,-0.07131564147751135,-0.6002870122777326,3126261863,3135826530.4,40.95462510663212,27.414944777018487,NaN,NaN,-1.0550016810804754,-9.18441210394716
2015-10-16T09:30:00-04:00,115.8,115.8,114.43,115.42,33685613,40018416.3,54.418144739309206,47.43493703078881,NaN,NaN,76.99243434897406,50.815581000060526,0.5300719002075427,0.06230286298169574,-0.46776903722584695,3092576250,3117506738.8,37.79753432349644,28.677394416137197,NaN,NaN,0.5076750848809174,-7.799828219828863
2015-10-19T09:30:00-04:00,114.9,116.21,114.65,115.64,24949454,39614801.75,55.04916988127363,49.332573077046945,NaN,NaN,87.53604259150805,55.47566910921771,0.5212788928711098,0.1838295788630404,-0.33744931400806943,3117525704,3108773643.2,36.35865524991469,30.055222987224358,NaN,NaN,1.9606363624581291,-6.4054761366450075
2015-10-20T09:30:00-04:00,115.58,116.3,115.03,115.48,20531392,38852024.35,54.45869170030422,50.70225588390591,NaN,NaN,85.04757250396308,63.64352866585443,0.4813069400562432,0.26418436106223453,-0.21712257899400864,3096994312,3103423323.4,35.46783172736001,31.485904172149212,NaN,NaN,2.9952448193751895,-5.062516000070693
2015-10-21T09:30:00-04:00,115.92,115.98,113.65,113.72,34060342,39279700.8,48.318977142459936,51.66241321267132,NaN,NaN,47.15346351005932,70.40555815384663,0.32068276608608853,0.18373087861360204,-0.1369518874724865,3062933970,3099258419.8,34.75399563605053,32.971920417622854,NaN,NaN,2.147930938520931,-4.032452151700461
2015-10-22T09:30:00-04:00,114.41,115.42,113.73,114.72,36882595,39133317.7,51.65410578377099,52.41591916369164,NaN,NaN,48.292268558147825,69.00435630253048,0.26826215318152014,0.19837580400441368,-0.06988634917710645,3099816565,3093969360.2,33.82302809443803,34.42119260127202,NaN,NaN,2.3853156120156003,-3.11562818545531
2015-10-23T09:30:00-04:00,115.65,116.05,114.73,115.85,40172530,38954430.85,55.17433811478418,52.816268673313154,NaN,NaN,69.52393643430972,67.51065671959759,0.294094283836281,0.2977315056182448,0.0036372217819637953,3139989095,3103451929.2,37.077410750035995,35.840754679222385,NaN,NaN,3.6230114869513845,-2.1529653751114965
2015-10-26T09:30:00-04:00,115.6,115.87,114.93,115.06,19783305,37105333,52.30683747175908,53.16662887165655,NaN,NaN,58.5539052182108,61.714229244938146,0.24441934028003018,0.3091613971320015,0.06474205685197135,3120205790,3103987946.4,37.26521591453272,36.94971202238316,NaN,NaN,3.8355721059425125,-1.2974600206752096
2015-10-27T09:30:00-04:00,114.59,114.87,113.1,113.8,38189196,36515756.7,48.02018425400547,52.807817589238475,NaN,NaN,5.708933892545638,45.846501522654656,0.11947068493686686,0.21408041302305492,0.09460972808618806,3082016594,3100992402.8,36.60762753181274,37.75762086656493,NaN,NaN,2.7443512657931377,-0.7200584083225886
2015-10-28T09:30:00-04:00,114.14,117.14,113.92,117.12,65529933,37250527.25,57.82734059793145,52.960300546754404,NaN,NaN,90.29937995409264,54.47568481146131,0.2459045427482315,0.40199040652147744,0.15608586377324593,3147546527,3117914914.2,42.753368874895465,38.43190593978922,NaN,NaN,4.95563487804647,0.09075491830156268
2015-10-29T09:30:00-04:00,116.74,117.1127,115.56,115.87,27251998,36363830.6,53.717888616402625,52.776890418011654,NaN,NaN,100.60516532723574,64.9382641652789,0.23106502812674698,0.44491714893167966,0.21385212080493268,3120294529,3122010507,44.16423682480031,38.809492077167114,NaN,NaN,5.425906333416151,0.8529194061750753
2015-10-30T09:30:00-04:00,115.56,116.03,115.08,115.34,28018673,34863802.65,52.02958108000166,52.515269573683106,NaN,NaN,53.806690111262384,61.79481490066943,0.1738780864719478,0.43119972889486746,0.25732164242291966,3092275856,3112467859.2,41.59215564837995,38.845607046052784,NaN,NaN,5.269911628863484,1.4839182951305623
2015-11-02T09:30:00-05:00,115.45,118.0711,115.42,117.74,33836894,34294622.75,58.40481011114695,53.08869920933635,NaN,NaN,171.5635797903704,84.39674981510134,0.27973588359190255,0.6069914969127979,0.3272556133208953,3126112750,3113649251.2,42.042179775541676,38.766550484341806,NaN,NaN,7.240940129899694,2.306349985811867
2015-11-03T09:30:00-05:00,117.59,119.0299,117.39,118.35,28626346,34018937.9,59.86480369923204,54.01078650682972,NaN,NaN,248.8062301032318,133.01620905723857,0.36736653073057124,0.7864637767341094,0.41909724600353815,3154739096,3128193751.6,47.4140308952776,39.147992596654866,NaN,NaN,9.286036007106215,3.3034479888539163
2015-11-04T09:30:00-05:00,118.65,119,117.69,118.29,25695977,33485186.05,59.64304852129811,54.34913726526283,NaN,NaN,217.963593853181,158.54905183705628,0.395383872661779,0.9133270868307619,0.5179432141689829,3129043119,3124493070,46.239689342483594,39.52549718492997,NaN,NaN,10.843136925024348,4.380546408306835
2015-11-05T09:30:00-05:00,118.24,118.6,117.09,118.38,27141341,32688642.2,59.88310062051178,54.739491256777306,NaN,NaN,157.52290523701294,169.9325998190117,0.39323952417902097,1.0094926193927591,0.6162530952137382,3156184460,3131671056.2,48.884217207513224,40.31740310521688,NaN,NaN,12.175450892424012,5.494104191752146
2015-11-06T09:30:00-05:00,118.01,119.36,117.29,119.22,35141285,33120848.45,62.14627116570643,55.246427062808216,NaN,NaN,158.4703755325138,190.86533690326198,0.41926979820811816,1.1403403429738859,0.7210705447657677,3191325745,3151481034,55.40419922139416,41.6777991031797,NaN,NaN,13.96056439123951,6.703598505964626
2015-11-09T09:30:00-05:00,119.07,119.29,117.27,117.82,32983110,33620802.65,56.432143936257425,55.38738793680488,NaN,NaN,111.06188710357443,178.76499836590278,0.3176876621856749,1.1181801224978614,0.8004924603121865,3158342635,3157927011,57.312225456618215,43.238112940983854,NaN,NaN,13.881653460710261,7.729034928071146
2015-11-10T09:30:00-05:00,117.32,118.17,116.96,118.17,21892226,32843150.4,57.48460429735314,56.042075590725815,NaN,NaN,81.80708932439845,145.3651702101361,0.2524024804701287,1.1159955608998473,0.8635930804297186,3180234861,3163026164,58.81343035246614,44.956643992156394,NaN,NaN,14.110562053434863,8.640681660265962
2015-11-11T09:30:00-05:00,118.31,118.34,117.08,117.14,22037623,31945660.4,53.39663774374586,56.166542159295446,NaN,NaN,60.93088476519791,113.95862839253948,0.12464623125233998,1.0194008694951435,0.8947546382428035,3158197238,3168856987.8,60.523039085373405,46.86378763436607,NaN,NaN,13.139248827358246,9.283334112707717
2015-11-12T09:30:00-05:00,116.33,116.49,114.73,114.9,39916109,31816297.1,45.77302421868175,55.49501973814528,NaN,NaN,-50.24776102787448,72.404495139562,-0.11307194631271089,0.7534147053519149,0.8664866516646258,3118281129,3161276321.6,57.19881511050778,48.30103080297119,NaN,NaN,9.865182515847756,9.366455313156294
2015-11-13T09:30:00-05:00,114.44,115.34,113.66,114.07,43882996,32326166.25,43.30580449218499,54.85208881103284,NaN,NaN,-97.83036178098375,21.144347676862488,-0.3170099307499835,0.47022423822714643,0.7872341689771299,3074398133,3137890799.2,48.37227586708658,49.09439222815361,NaN,NaN,6.368974207383012,8.938243726617253
2015-11-16T09:30:00-05:00,113.96,115.09,113.36,115.05,28979093,32527648.2,46.94227063507246,54.77509498110906,NaN,NaN,-85.54678158500224,-18.17738606085284,-0.3728518771634477,0.32116932252282027,0.694021199686268,3103377226,3126897717.4,44.867259616518496,49.68436594848974,NaN,NaN,4.495339288659427,8.303543092623277
2015-11-17T09:30:00-05:00,115.15,116.15,114.45,114.61,34441040,33223130.6,45.53021459500263,53.89672883804271,NaN,NaN,-55.59914629340374,-45.658633184413276,-0.42271404670804547,0.16562864130121113,0.5883426880092566,3068936186,3104637982.4,38.745211186483026,49.398068970745996,NaN,NaN,2.5344307685513283,7.479384189184428
2015-11-18T09:30:00-05:00,114.93,116.65,114.52,116.55,35554327,33297829.85,52.337835152973064,53.798153590654884,NaN,NaN,-19.772243972755316,-61.79925893200393,-0.31336485993316,0.19663661309280656,0.5100014730259665,3104490513,3093896637.4,36.179801361083754,48.8277521519091,NaN,NaN,2.8583632576939073,6.8192383418286395
2015-11-19T09:30:00-05:00,116.44,116.65,115.74,116.06,25512498,32729325,50.61709257061321,53.69726155426999,NaN,NaN,-11.955649028207926,-54.140836532070615,-0.2643200456893856,0.1796014159142345,0.4439214616036201,3078978015,3086036014.6,34.38549351016967,48.31299057060836,NaN,NaN,2.609742405253153,6.217881779460713
2015-11-20T09:30:00-05:00,116.48,117.36,116.38,116.81,31697746,32305585.8,53.15576224066313,53.322329563521144,NaN,NaN,21.560597749973553,-30.262644625879147,-0.17590751207918442,0.22403707150463958,0.399944583583824,3110675761,3093291540.2,37.46817387597241,47.98627586349628,NaN,NaN,3.1494777923633013,5.779538352732511
2015-11-23T09:30:00-05:00,116.71,117.89,116.68,117.39,22716394,32452240.25,55.07898892114129,52.98048565080039,NaN,NaN,41.537065090765296,-4.845875290725644,-0.0779028598027306,0.30256600883041074,0.38046886863314133,3133392155,3099294526,39.980656078400386,47.45532051943361,NaN,NaN,4.159519379950214,5.548107070906469
2015-11-24T09:30:00-05:00,116.88,118.42,116.56,118.25,24994483,31792504.6,57.842757264888384,52.85189341819969,NaN,NaN,58.20611279572556,17.915176527100215,0.03902288305072521,0.4292474724465478,0.3902245893958226,3158386638,3117184616.4,46.83628225627066,47.49793429898983,NaN,NaN,5.829842700128355,5.588355017938167
2015-11-25T09:30:00-05:00,118.3,119.32,118.11,119.17,20772630,29554639.45,60.633099047937066,52.90546473444435,NaN,NaN,110.46346844485656,43.96231901062259,0.16541867704947188,0.5969979357076625,0.4315792586581906,3179159268,3132118367.4,51.78692689083277,47.705270704941235,NaN,NaN,8.08641835594152,5.945221209081503
2015-11-27T09:30:00-05:00,119.27,119.9,118.88,119.62,14129309,28898505,61.959399559237504,52.89211676255372,NaN,NaN,128.04322434015813,71.96209368429582,0.26075291464008965,0.7575204019583026,0.49676748731821296,3193288577,3154980479.8,58.203696120026656,47.905234769129265,NaN,NaN,10.356327213903324,6.575379209770334
2015-11-30T09:30:00-05:00,120.02,120.07,119.05,119.1,30165410,29005841.85,59.466203479582234,53.10883530136264,NaN,NaN,114.74595046172173,90.59916422664546,0.26912334962910023,0.8331716743545883,0.564048324725488,3163123167,3165469961,60.78269798276638,48.153125663854134,NaN,NaN,11.591176397125375,7.291921665106768
2015-12-01T09:30:00-05:00,119.61,119.91,118.9,119.89,27899883,28708991.3,61.96991864755344,53.429214897805515,NaN,NaN,110.05241664412404,104.30223453731722,0.30553551893190367,0.9459677233903676,0.6404322044584639,3191023050,3176996140,63.4514027146553,48.4844094040105,NaN,NaN,13.368459831340097,8.159998545997244
2015-12-02T09:30:00-05:00,119.73,120.04,118.45,118.6,22238250,28389586.5,55.89818582487061,53.607896903600135,NaN,NaN,79.50518547416321,108.56204907300473,0.22417779996895826,0.9206544544196618,0.6964766544507035,3168784800,3179075772.4,63.92835470254468,48.72764623380846,NaN,NaN,13.190848306625803,8.87869136894418
2015-12-03T09:30:00-05:00,118.93,119.45,116.14,116.6,39485407,29079058,48.03941839783973,53.76978220211142,NaN,NaN,2.1806697413165623,86.90548933229674,0.02744761482502045,0.7307861729819791,0.7033385581569587,3129299393,3169103797.4,59.89232449587652,48.92003976133479,NaN,NaN,10.547477145170813,9.117089336976557
2015-12-04T09:30:00-05:00,116.6,117.93,116.34,117.78,32669866,29355484.25,52.3003864580078,54.41225234252734,NaN,NaN,1.5605213676200467,61.60894873778913,-0.028405263324692398,0.6678319790010931,0.6962372423257855,3161969259,3162839933.8,57.43922454841713,49.5676789528584,NaN,NaN,9.633523867832015,9.190865698527336
2015-12-07T09:30:00-05:00,117.64,117.67,115.5139,116.01,29621390,29079489.5,46.182671111404325,54.3579952336939,NaN,NaN,-41.35729025824746,30.388300593795282,-0.18122844145348682,0.46970169050892707,0.6509301319624139,3132347869,3156684874.2,55.05306104086777,50.29523619745478,NaN,NaN,6.813112789441495,8.851186711515073
2015-12-08T09:30:00-05:00,114.96,116.005,114.46,115.37,30945962,28977632.1,44.170751841567665,54.26089075130569,NaN,NaN,-86.92263680356307,-9.006710095742136,-0.31429246506565023,0.25806455063035116,0.5723570156960014,3101401907,3138760645.6,48.70736634029816,51.00681870844158,NaN,NaN,3.8811800243303476,8.141185756202969
2015-12-09T09:30:00-05:00,115.03,116.17,113.6,114.08,41980377,29982039.65,40.35465360796335,53.40494921237642,NaN,NaN,-104.75974968696573,-45.85969712796792,-0.4687615428083648,-0.013594912814454574,0.4551666299939102,3059421530,3116887991.6,42.29994610315059,51.443971904303496,NaN,NaN,0.15222671004124244,6.99990589246558
2015-12-10T09:30:00-05:00,113.89,115.08,113.65,114.46,31278835,30444100.25,41.945753037216946,52.78556781713383,NaN,NaN,-101.47350614766472,-66.59053230576419,-0.5209054685397168,-0.19596520568073572,0.32494026285898103,3090700365,3109168186,40.285627081810695,51.86541001656356,NaN,NaN,-2.3728372831138778,5.660942581668515
2015-12-11T09:30:00-05:00,113.27,113.34,111.53,111.91,52609323,31078760.95,35.166377972104996,51.500611797951116,NaN,NaN,-169.74009152135022,-100.85065488355824,-0.69197900666199,-0.5400334954685064,0.15194551119348354,3038091042,3084392542.6,34.59224366506423,51.65998643007013,NaN,NaN,-6.9773036106493365,3.855478839908822
2015-12-14T09:30:00-05:00,111.87,112.38,110.28,111.11,53400352,31554628.75,33.34552962696621,49.948221848367176,NaN,NaN,-186.01717984664984,-129.78263280123872,-0.8153692924173654,-0.8672661043282233,-0.05189681191085782,2984690690,3054861106.8,29.28043800560694,50.895685139156306,NaN,NaN,-11.311344122666776,1.6887898452551653
2015-12-15T09:30:00-05:00,111.73,112.96,111.6,112.71,48273941,32519371.15,40.03315608753865,48.67610747855648,NaN,NaN,-132.5953665984718,-138.91717876022045,-0.747383531983138,-0.9861262268897804,-0.23874269490664235,3032964631,3041173651.6,27.19598962723927,49.4928070942255,NaN,NaN,-12.821174564474076,-0.3840622132775833
2015-12-16T09:30:00-05:00,113.49,114.645,112.83,114.43,44560568,33025347.55,46.2737046659268,47.65043645127003,NaN,NaN,-76.05192231376819,-133.17561328558094,-0.5536493413628636,-0.9308043716102219,-0.3771550302473583,3077525199,3044794385.4,28.643121104253837,47.83967810946986,NaN,NaN,-12.006431250866905,-2.044400647218915
2015-12-17T09:30:00-05:00,114.91,114.94,112.9701,113.21,41318043,33313533.35,42.86615515580137,46.28663327959602,NaN,NaN,-76.47378682529488,-128.175669421107,-0.477616390039981,-0.9741755177973346,-0.49655912775735356,3036207156,3033895743.6,26.9092577338226,45.60436108188386,NaN,NaN,-12.457964180384039,-3.5320525805282186
2015-12-18T09:30:00-05:00,112.66,112.89,111.44,111.48,49876639,34531740.4,38.53293324809023,44.79139969163231,NaN,NaN,-112.6866103406314,-116.76497318496322,-0.5108004923858722,-1.1350597432396938,-0.6242592508538216,2986330517,3023543638.6,25.34017747834595,43.07275247442526,NaN,NaN,-14.295312124148325,-5.0696610867596625
2015-12-21T09:30:00-05:00,112.17,112.63,111.5,112.32,26479327,34270819.45,41.61886825169711,43.33775323478543,NaN,NaN,-94.34382785001634,-98.43030278563651,-0.44552454894844973,-1.1811649370393837,-0.735640388090934,3012809844,3029167469.4,27.80309725921559,40.52644494189384,NaN,NaN,-14.772714376772866,-6.455811556761549
2015-12-22T09:30:00-05:00,112.64,113.52,111.79,113.35,28108666,34540433.05,45.24865962015777,42.57707279159166,NaN,NaN,-67.98593495914336,-85.50841645777083,-0.3088168324277103,-1.121661428625572,-0.8128445961978616,3040918510,3030758245.2,28.52138893183526,37.997375958271746,NaN,NaN,-14.000931185131332,-7.533685789385803
2015-12-23T09:30:00-05:00,113.92,114.96,113.725,114.78,29609692,34771193.5,49.90541507939937,42.71035826884592,NaN,NaN,-23.0153736714307,-74.90110672930334,-0.10827258724519973,-0.9481853302543612,-0.8399127430091615,3070528202,3029358845.8,28.25507364290752,35.737572325916815,NaN,NaN,-11.838864556532897,-8.148711327549673
2015-12-24T09:30:00-05:00,114.44,115.16,114.15,114.5,13370511,34401087.55,49.02614340004399,42.47648376470564,NaN,NaN,-15.34031446697373,-62.67441225763912,0.012888866666750487,-0.8238016596757234,-0.8366905263424739,3057157691,3033548952.8,30.352089121847982,33.80277693830474,NaN,NaN,-10.377921507667429,-8.467169924709353
2015-12-28T09:30:00-05:00,113.98,114.07,112.955,113.97,22125532,34800898.7,47.32640740077174,42.55817921394618,NaN,NaN,-38.09044954451407,-47.75518009841564,0.06195944899796568,-0.7592412150950167,-0.8212006640929824,3035032159,3043289281.2,35.100873627589465,32.37762069449915,NaN,NaN,-9.671175691999569,-8.639170748607954
2015-12-29T09:30:00-05:00,114.48,115.29,114.065,115.2,22841477,34434702.05,51.52661730293973,43.08359817547275,NaN,NaN,9.099869983807583,-27.06644053165086,0.17545037884526515,-0.601887690536401,-0.7773380693816662,3057873636,3052302039.6,39.22977069711046,31.70064957712859,NaN,NaN,-7.79658356643545,-8.51880115115474
2015-12-30T09:30:00-05:00,115.05,115.35,114,114.04,21273192,34103367.5,47.66626666646062,43.60585625107971,NaN,NaN,4.771091982645762,-12.515035143293032,0.17044524898108981,-0.5642815081553039,-0.7347267571363937,3036600444,3051438426.4,38.97390307548351,31.463075075152375,NaN,NaN,-7.342718691023949,-8.350789371136056
2015-12-31T09:30:00-05:00,113.56,113.97,112.51,112.62,39517671,34967338.55,43.381611810389515,43.7084175920206,NaN,NaN,-51.37017251421954,-18.1859949118508,0.07445038992544317,-0.6416637697295897,-0.7161141596550329,2997082773,3036749340.6,34.81459500076073,31.072287069363092,NaN,NaN,-8.263297052677459,-8.338290468499114
2016-01-04T09:30:00-05:00,110.61,110.83,109.08,110.01,66665883,36326362.35,36.82878175353424,43.82716071926554,NaN,NaN,-182.18971390803333,-51.555874800062725,-0.14965556692918836,-0.9031836183165183,-0.7535280513873299,2930416890,3011401180.4,29.052647884773805,30.67660165648521,NaN,NaN,-11.278683736891074,-8.758346649697966
2016-01-05T09:30:00-05:00,110.41,110.575,109.55,110.25,28253333,36105535.7,37.75978189024583,44.14246445235695,NaN,NaN,-153.74658374746153,-74.68710164065222,-0.2600896361943834,-1.0786400966303091,-0.8185504604359257,2958670223,2996128793.2,26.23530793862453,30.459092365986468,NaN,NaN,-13.368566802166123,-9.416949528621988
2016-01-06T09:30:00-05:00,108.7,109.6,108,108.57,35569158,36402924.1,33.98415013921726,43.710392598905415,NaN,NaN,-190.8834587990729,-114.68376739722831,-0.41542434975271214,-1.3378308976268158,-0.9224065478741037,2923101065,2969174279,22.152288897403437,30.098828028141053,NaN,NaN,-16.388997469318245,-10.41295637729288
2016-01-07T09:30:00-05:00,106.72,107.5,105.49,105.67,52481988,37479725.4,28.65731713466542,42.45207920381531,NaN,NaN,-241.261966978865,-163.89037918953048,-0.667669728653516,-1.7569937086909988,-1.0893239800374828,2870619077,2935978005.6,18.36210550221486,29.364469770852555,NaN,NaN,-20.964265378626486,-11.920286234626253
2016-01-08T09:30:00-05:00,105.87,106.49,103.66,103.85,60299290,38395671.05,25.912233445715543,41.241084795952034,NaN,NaN,-232.17724526131147,-200.05179373894885,-0.8969888842513298,-2.210560085351645,-1.3135712011003151,2810319787,2898625408.4,15.208880143202279,28.528728514379672,NaN,NaN,-25.732613272803373,-13.893475811508699
2016-01-11T09:30:00-05:00,104.21,104.78,102.31,103.4,47144827,39188970.65,25.267749025486722,40.293571637194646,NaN,NaN,-206.5599997886408,-204.92585091507036,-1.010442419629602,-2.5766242256373175,-1.5661818060077155,2763174960,2865177022.4,13.048064683263078,27.650720457588033,NaN,NaN,-29.680477276652862,-16.14876173510072
2016-01-12T09:30:00-05:00,104.22,104.99,101.94,103.71,53702941,39243651.55,26.62171881301606,39.222346677288854,NaN,NaN,-164.12235922022876,-207.00100600962378,-0.994521779979485,-2.809334030982072,-1.8148122510025868,2816877901,2836818558,11.549804306795622,26.48977096098661,NaN,NaN,-32.4078054169377,-18.47148226107743
2016-01-13T09:30:00-05:00,103.91,104.42,99.65,100.38,70591573,40103212.6,22.008899351116284,37.56236380092874,NaN,NaN,-167.6840552001759,-202.3611252898444,-1.1283760800425786,-3.22528235105581,-2.0969062710132316,2746286328,2801455610.6,10.006739348387057,25.16729599074031,NaN,NaN,-36.50811890042794,-21.048144638127503
2016-01-14T09:30:00-05:00,100.86,102.71,99.19,101.77,69373353,41158183.2,27.64470410943808,35.97231301736009,NaN,NaN,-144.30732175327353,-182.97019624472608,-1.0452983765492894,-3.403529241699843,-2.3582308651505537,2815659681,2790463731.4,9.578378516129249,23.833246338827575,NaN,NaN,-37.99454086245131,-23.469058384459476
2016-01-15T09:30:00-05:00,99.08,100.29,97.51,100.12,85759237,43218116.65,25.30692193524156,34.27808291273134,NaN,NaN,-146.47618589216867,-165.82998437089753,-1.0222302179580813,-3.6360186375981556,-2.6137884196400742,2729900444,2774379862.8,8.973089989024658,22.30617497219734,NaN,NaN,-40.00722972337283,-25.831654290018527
2016-01-19T09:30:00-05:00,101.07,101.1985,97.74,98.77,51391062,43721767.6,23.552012805638313,32.57991187022181,NaN,NaN,-126.47385873109572,-149.8127561593885,-1.0165089819371693,-3.884424647061536,-2.8679156651243667,2678509382,2757446747.2,8.37317249664666,20.39705346284428,NaN,NaN,-42.23733829244176,-28.175323433221845
2016-01-20T09:30:00-05:00,97.43,100.325,95.06,99.18,94385846,45947227.95,25.24742856671554,30.70282696049151,NaN,NaN,-121.1527424118941,-141.21883279772157,-0.9073244596561305,-4.00207123969453,-3.0947467800383994,2772895228,2748650212.6,8.071280655291204,18.171447031285762,NaN,NaN,-43.48451193554139,-30.362350362124637
2016-01-21T09:30:00-05:00,99.33,100.91,98.38,98.95,65798203,47913171.75,24.913636548071892,29.077639094892316,NaN,NaN,-94.11056059869631,-126.50413387742564,-0.777790115907913,-4.066984424923291,-3.289194309015378,2707097025,2740812352,7.801380339443867,15.944838264425789,NaN,NaN,-44.58576339399786,-32.3942665095351
2016-01-22T09:30:00-05:00,100.65,101.61,100.13,101.37,46056677,48810572.3,34.696528911871624,28.457276030712475,NaN,NaN,-67.72073659125991,-111.18681684502295,-0.47140175252852234,-3.8784464996760306,-3.4070447471475083,2753153702,2728311156.2,7.377624037959876,13.985054624225727,NaN,NaN,-42.508911891182684,-33.83921584977047
2016-01-25T09:30:00-05:00,100.74,101.08,98.85,99.115,35019608,49081068.1,30.684687375732267,28.01841214658376,NaN,NaN,-77.49690974280895,-97.39096161515099,-0.36749925856595445,-3.8664188203549514,-3.498919561788997,2718134094,2725957886.2,7.2972695768952605,12.431099030805829,NaN,NaN,-41.97141190769907,-35.00095814376027
2016-01-26T09:30:00-05:00,99.52,101.4,99.18,101.1,33349614,50080023.25,37.531912389425166,28.002135753668,NaN,NaN,-61.255608197122314,-84.34731150835631,-0.1245332254403122,-3.654586093589387,-3.530052868149075,2751483708,2740552751.4,13.583673556515706,11.5274108606552,NaN,NaN,-39.239157962168534,-35.60641526067574
2016-01-27T09:30:00-05:00,100.59,101.59,99.06,99.71,47973897,51372441.5,34.92983103370855,28.069684388988808,NaN,NaN,-62.57583630441573,-72.63193028686064,-0.022242319987829884,-3.5578557681338623,-3.5356134481460324,2703509811,2726675668,12.701702201099536,10.852368953776349,NaN,NaN,-37.818752939603556,-35.92246350052257
2016-01-28T09:30:00-05:00,100.55,100.95,99.215,99.69,41951147,52327925,34.8923466621207,28.515043640949898,NaN,NaN,-61.093906817877944,-66.02859953069695,0.07399477665430432,-3.443119977328152,-3.5171147539824563,2661558664,2717567995.8,12.144379846782542,10.408245692674038,NaN,NaN,-36.71591197532306,-36.03581328263692
2016-01-29T09:30:00-05:00,100.04,102.98,99.96,102.96,42245331,53376531.95,45.23955430093379,29.89556655917977,NaN,NaN,-21.540001295099188,-56.79245247146481,0.3711840204821457,-3.0531347283797743,-3.42431874886192,2703803995,2707698054.4,11.552786669194177,10.147096158816314,NaN,NaN,-32.264163805149884,-35.49700621442449
2016-02-01T09:30:00-05:00,102.14,103.09,101.25,102.49,33615712,53081434,44.15340357373128,31.244541884054378,NaN,NaN,-6.546701923331509,-42.60241090756932,0.5392229596890266,-2.750290049250637,-3.2895130089396636,2670188283,2698108892.2,10.992518691148604,10.00027144509385,NaN,NaN,-29.059422900202353,-34.5773514552499
2016-02-02T09:30:00-05:00,101.33,101.47,99.77,100.28,39692710,51732775.35,39.36725661022385,32.1549374409978,NaN,NaN,-43.076464433808226,-38.96658215490652,0.5052323779107946,-2.6579725365511706,-3.163204914461965,2630495573,2673911265.2,9.712498530412617,9.86903531820935,NaN,NaN,-27.79995543376491,-33.609152023609184
2016-02-03T09:30:00-05:00,101.06,101.07,98.14,100.41,55262501,53083233.75,39.7807730509927,33.424356990988976,NaN,NaN,-57.02909191566967,-37.857233277157306,0.4945772553509933,-2.5449833452732236,-3.039560600624217,2685758074,2670360917.8,9.53702354769537,9.835484189588515,NaN,NaN,-26.67886984983834,-32.619111713070495
2016-02-04T09:30:00-05:00,100,101.97,99.97,100.8,51188412,53864196.45,41.07903214237501,34.383951850484465,NaN,NaN,-11.681077425940405,-27.9746673987698,0.5145722566626345,-2.3963452797959235,-2.910917536458558,2736946486,2685438482.2,16.441340663395692,10.32569577153612,NaN,NaN,-25.384931309935755,-31.58565736976553
2016-02-05T09:30:00-05:00,100.35,100.44,97.96,98.04,53366634,53908428.75,35.28196741623661,35.09645509912697,NaN,NaN,-100.29358716116604,-43.72538457198317,0.35053153553053784,-2.472753117045386,-2.8232846525759236,2683579852,2681393653.6,16.086634554949555,10.833806097673612,NaN,NaN,-26.00023905850505,-30.78774046815689
2016-02-08T09:30:00-05:00,97.01,97.01,94.94,96.43,61107710,53948849.75,32.4088520048948,35.72908647050243,NaN,NaN,-215.94832047895179,-85.60570828310722,0.15233145571692308,-2.6328703329297696,-2.7852017886466927,2622472142,2671850425.4,15.250647428335313,11.325054307079947,NaN,NaN,-27.43101995566771,-30.30820896637272
2016-02-09T09:30:00-05:00,95.13,97.13,95.02,95.78,55857232,54384470,31.300633078916263,36.161458221373906,NaN,NaN,-198.6978092241373,-116.72997724117303,0.004028690416297387,-2.7801659256263207,-2.784194616042618,2566614910,2659074292.8,14.187646741069088,11.761937598921223,NaN,NaN,-28.936586556507898,-30.112262907820604
2016-02-10T09:30:00-05:00,96.45,97.92,95.675,95.83,42756146,53837130.25,31.49468926281625,36.63153341528422,NaN,NaN,-154.63983921026104,-136.2521267000913,-0.06056194633145617,-2.859897048956938,-2.799335102625482,2609371056,2643796889.2,13.01906305379633,12.13462922137497,NaN,NaN,-30.093403250414358,-30.109568671048283
2016-02-11T09:30:00-05:00,94.08,95.4,93.64,94.7892,57923232,53203713.2,29.619137225387945,36.268862580535384,NaN,NaN,-198.82153038856293,-173.68021729261582,-0.13877176953261205,-2.972799814541247,-2.834028045008635,2551447824,2606697156.8,10.711709493421196,12.37277818247935,NaN,NaN,-31.62669572045728,-30.32630110667814
2016-02-12T09:30:00-05:00,95.66,96.79,95.19,96.59,40097274,51739909.25,36.64872753473445,36.69486544903554,NaN,NaN,-112.27516601087567,-176.07653306255776,-0.039757384349776714,-2.883724775445856,-2.843967391096079,2591545098,2588290206,9.785102538007422,12.550480536844503,NaN,NaN,-30.912950578855035,-30.410108174131985
2016-02-16T09:30:00-05:00,97.79,99.0999,97.22,98.88,38882093,49396052.05,44.27141522041467,37.17625850839193,NaN,NaN,-23.66746259380478,-137.62036148552835,0.1964574198204958,-2.5983956163204596,-2.7948530361409554,2630427191,2589881215.8,10.505724861120399,12.33062705860198,NaN,NaN,-27.88696396429814,-30.04965900129858
2016-02-17T09:30:00-05:00,99.57,101.09,99.53,100.43,40940444,48873521.15,48.765071190249074,38.164489948144826,NaN,NaN,47.905503054330346,-88.29969902983481,0.4586111808131297,-2.2215890601245434,-2.680200240937673,2671367635,2610831760.8,19.611756304248672,12.824202351684063,NaN,NaN,-23.889339218345793,-29.16961331801961
2016-02-18T09:30:00-05:00,100.51,100.635,99.54,99.95,35043592,45906408.45,47.48804352530898,39.06418258122971,NaN,NaN,33.319293905028914,-50.707872406776815,0.5926853188827015,-1.9393435923342963,-2.532028911216998,2636324043,2616222358.2,21.81609095305366,13.515038859274856,NaN,NaN,-21.02614334558001,-28.006260464813952
2016-02-19T09:30:00-05:00,99.56,100.56,99.11,100.45,32424829,44237739.75,48.98665379822453,39.3318325453219,NaN,NaN,31.67064761573084,-4.6094368059180635,0.700643703565766,-1.6562242817597905,-2.3568679853255565,2668748872,2639682567.8,30.719851475467735,14.884114916865824,NaN,NaN,-18.22737784308768,-26.60927723313877
2016-02-22T09:30:00-05:00,101.34,102.01,101.24,101.57,28867445,43378278.15,52.27239143065178,39.911760249387655,NaN,NaN,88.36269245040603,35.51813488633827,0.8245439258954144,-1.3261880779562887,-2.150732003851703,2697616317,2660896811.6,37.63608734207317,16.787226963360435,NaN,NaN,-14.860659696001505,-24.930903299262017
2016-02-23T09:30:00-05:00,101.24,101.49,100.55,100.64,29857092,43120152.35,49.42563111655947,40.630215571268764,NaN,NaN,58.286649347790856,51.908957274657396,0.8192356156058753,-1.1266874843443588,-1.9459230999502342,2667759225,2668363218.4,39.90978906231173,18.944176287067513,NaN,NaN,-12.810813684509952,-23.19946192572601
2016-02-24T09:30:00-05:00,99.62,101.819,98.97,101.61,36909566,43298149.95,52.34102159726498,41.52737618171678,NaN,NaN,54.211741606494236,53.17020498509017,0.8526065282240998,-0.8801649396701094,-1.7327714678942092,2704668791,2675023449.6,41.94315664250168,21.25890007955368,NaN,NaN,-10.215205244055028,-21.344568114058728
2016-02-25T09:30:00-05:00,101.79,102.6,101.39,102.54,22612577,42030083.95,55.018326108749065,42.52304003645779,NaN,NaN,96.41165673559647,65.78867755120368,0.9039755007424666,-0.6028020919661259,-1.5067775927085925,2727281368,2693214914.6,47.198724340476154,23.455856056488,NaN,NaN,-7.223479277864808,-19.327269708888167
2016-02-26T09:30:00-05:00,103.06,103.47,102.7,103.19,27474747,41306263.95,56.843137553123775,44.06312361766402,NaN,NaN,116.90888821007239,82.83632567007199,0.9440031732126879,-0.32677362619273254,-1.2707767994054204,2754756115,2710416363.2,51.65526083664866,25.996472219466508,NaN,NaN,-4.176738556514417,-17.162908115691916
2016-02-29T09:30:00-05:00,103.13,104.03,102.72,102.73,32014358,40794715.3,55.13836887980664,45.686660537300575,NaN,NaN,113.92107668738316,87.94800251746742,0.9018348407751735,-0.14348324843645344,-1.045318089211627,2722741757,2715441451.2,52.90576216683833,28.686123272216722,NaN,NaN,-2.076590763369816,-15.007719922503044
2016-03-01T09:30:00-05:00,103.62,104.94,103.07,104.94,36422727,40935066.05,61.16446233071495,47.819791198143335,NaN,NaN,142.91496913240516,104.87366647439028,0.9786958768975698,0.17805175691033526,-0.8006441199872345,2759164484,2733722503,57.23911283264697,31.761227993043715,NaN,NaN,1.6659951213051947,-12.625760630530438
2016-03-02T09:30:00-05:00,104.79,106.09,104.59,106.0208,24937069,40197284,63.730373577644855,50.122340077773956,NaN,NaN,159.96611264452426,126.02454068199627,1.0518394808746918,0.5141552311061304,-0.5376842497685614,2784101553,2749609055.4,60.62943430791852,35.16196879690958,NaN,NaN,5.6323838896359755,-10.017454270506665
2016-03-03T09:30:00-05:00,106.05,107.15,105.92,107.13,28216300,38844973.95,66.19865936264225,52.73516308757782,NaN,NaN,163.51442524367644,139.4450943836123,1.118233828527492,0.8601080358908035,-0.25812579263668844,2812317853,2766616352.4,63.926814247050466,38.963047707883106,NaN,NaN,9.767701327210963,-7.191003470832719
2016-03-04T09:30:00-05:00,107.07,108.32,106.67,107.72,38180879,38194597.3,67.46690836761589,54.936461718497924,NaN,NaN,156.63402554979143,147.3901218515561,1.1412345595108135,1.1684174067518285,0.02718284724101494,2850498732,2785764875.8,67.25235370206624,43.06785136245873,NaN,NaN,13.586301642038443,-4.222817026136839
2016-03-07T09:30:00-05:00,107.21,108.99,107.21,108.8892,38739949,37463263.05,69.87883374054942,56.76556304136469,NaN,NaN,148.5430176331609,154.31451004071164,1.1701933623887555,1.4899245502269594,0.3197311878382038,2889238681,2819064260.6,72.0737784181183,47.46556947367287,NaN,NaN,17.60746202246949,-1.1042057334787927
2016-03-08T09:30:00-05:00,108.29,108.29,106.14,106.26,46193930,36717574.05,59.24251139040073,57.51395162708981,NaN,NaN,105.94635594610921,146.92078740345247,0.9562963793805443,1.5151016620638842,0.5588052826833398,2843044751,2835840314,74.13949428565682,51.36040790091631,NaN,NaN,17.931998889833636,1.6152520698515542
2016-03-09T09:30:00-05:00,106.62,107.005,106.07,106.8,25627172,35206071.05,60.56999005243986,58.44837637902773,NaN,NaN,90.61015637117896,133.0495961487834,0.8014662752580403,1.5606381267558902,0.7591718514978499,2868671923,2852754388,76.06208908057968,55.23512205288245,NaN,NaN,18.597860442604244,4.041338980244795
2016-03-10T09:30:00-05:00,107.1,107.49,104.81,105.93,48532279,35494877.7,57.33022189931608,59.044345529105705,NaN,NaN,71.59046103454959,114.66480330695802,0.599964986664057,1.5091280848279212,0.9091630981638642,2820139644,2854318746.2,76.23804568214575,58.48642163907375,NaN,NaN,18.167552454730913,6.059369476599954
2016-03-11T09:30:00-05:00,106.79,108.33,106.66,108.2008,33625007,34279966.45,62.907104273898305,59.803967875051875,NaN,NaN,98.10297930674221,102.95859405834817,0.5788452112810958,1.6327196122652339,1.053874400984138,2853764651,2854971930,76.31632594580864,61.24929582505485,NaN,NaN,19.543573031954168,7.985684270221984
2016-03-14T09:30:00-04:00,107.87,108.34,107.4,107.92,24422690,33496237.25,61.83093688211924,60.69006114402043,NaN,NaN,92.554329544528,91.7608564406216,0.5077357510105149,1.6885440897472819,1.180808338736767,2829341961,2842992586,71.65409832273562,63.516746486513696,NaN,NaN,20.316537776388174,9.747234771102868
2016-03-15T09:30:00-04:00,107.21,107.28,106.03,106.24,34258389,33265052.05,55.69229738354441,60.92943798589754,NaN,NaN,54.69872516706394,81.51133028481254,0.31857049242909197,1.579021454273132,1.26045096184404,2795083572,2833400350.2,68.06824857224262,65.38282448149519,NaN,NaN,19.062231801355814,11.077948632567574
2016-03-16T09:30:00-04:00,105.73,107.33,105.73,106.99,37952235,33115641.6,57.71081384152835,61.121758538238915,NaN,NaN,53.19341565606766,74.02798214179026,0.21967733850740645,1.535047634978298,1.3153702964708915,2833035807,2826273127,65.44747705968936,66.68630681858185,NaN,NaN,18.631740624239253,12.157061774234958
2016-03-17T09:30:00-04:00,106.73,109.1,106.33,108.63,41724464,33449685.2,61.80805994303243,61.476395851803815,NaN,NaN,82.12022988771226,76.1339359124228,0.23884616517403612,1.6139280029384366,1.3750818377644005,2874760271,2837197252.4,67.51217364287574,67.81894344759806,NaN,NaN,19.52266381779483,13.209290637600652
2016-03-18T09:30:00-04:00,108.77,109.95,108.7,109.61,36512573,33654072.4,64.0495361466748,62.11290779943726,NaN,NaN,115.99349331985631,79.71203871504562,0.2883450556202187,1.7355131572896738,1.447168101669455,2911272844,2848698891,69.57367532771498,69.00950867337498,NaN,NaN,20.953532237473404,14.315610866153902
2016-03-21T09:30:00-04:00,109.44,109.94,109.08,109.35,29903737,33705887,62.99323373465429,62.24353432829007,NaN,NaN,111.4544440018235,83.49206160650472,0.27446832898035,1.7902535128948927,1.5157851839145426,2881369107,2859104320.2,71.34519300801972,70.01708582875874,NaN,NaN,21.80269272682017,15.385193989106225
2016-03-22T09:30:00-04:00,108.78,109.69,108.47,109.22,23602060,33393135.4,62.4387596691705,62.15127619197047,NaN,NaN,98.91230276283522,92.33477712565897,0.22926716173665418,1.8023691360853604,1.5731019743487062,2857767047,2871641015.2,73.35786397643548,70.92625937650995,NaN,NaN,22.341942786394654,16.379015245861716
2016-03-23T09:30:00-04:00,108.54,108.59,106.8,106.88,39243307,33509822.45,53.337935482979226,61.23265305770883,NaN,NaN,33.35306254701523,88.36670650384848,0.025242378581432856,1.6046549475754972,1.5794125689940643,2818523740,2868738601.8,72.09532929167305,71.50972473684013,NaN,NaN,20.061304068269305,16.905056506205657
2016-03-24T09:30:00-04:00,106.24,107.22,105.74,107.2,30924321,33925409.65,54.31852087467961,60.2934825224991,NaN,NaN,-7.6131786061370885,70.42002480507861,-0.09793720056622313,1.4569910682862854,1.5549282688525086,2849448061,2863676159.8,69.83760225052374,71.69438534744424,NaN,NaN,18.480144680417922,17.130069102521695
2016-03-28T09:30:00-04:00,107.43,107.78,106.55,107.33,21096397,33606492.15,54.734685411744834,59.211757641870186,NaN,NaN,8.39991352087706,48.90130884528276,-0.17588943242490274,1.3350664783213801,1.5109559107462829,2870544458,2855530482.6,66.24295859491355,71.27789821721532,NaN,NaN,17.297674905663037,17.154012788684742
2016-03-29T09:30:00-04:00,107.04,110.34,106.77,110.31,46761082,34343828.35,63.04559755516989,59.48340665363941,NaN,NaN,113.26816822306351,49.26405368953077,-0.039126424922557135,1.4620478795930865,1.5011743045156436,2917305540,2862717769.2,67.81699774668226,70.82629132157429,NaN,NaN,18.742332621045996,17.380915621879208
2016-03-30T09:30:00-04:00,110.89,111.12,110.05,110.32,35683503,34306867.15,63.07010114340182,59.66198601727956,NaN,NaN,178.81828401648198,65.24524994026015,0.0355973075408087,1.5456709389416545,1.5100736314008458,2952989043,2881762168.4,71.59631106988589,70.50730717795331,NaN,NaN,19.897694015831245,17.740455392443785
2016-03-31T09:30:00-04:00,110.48,111.17,110.34,110.63,28555881,34487807.75,63.86989687146461,60.12910565814731,NaN,NaN,164.89131813926207,91.55290105870952,0.08658304846020193,1.6183024419760983,1.5317193935158964,2981544924,2914366405.2,76.65149408877188,70.53683920699802,NaN,NaN,21.07869069456069,18.217346149889057
2016-04-01T09:30:00-04:00,109.61,111.22,109.48,111.12,29981404,34576062.95,65.15449360052361,60.28963346719197,NaN,NaN,134.5746958743243,119.99047595480178,0.13130735857800158,1.6958535917383983,1.5645462331603968,3011526328,2946782058.6,80.3886054365178,70.82771631347725,NaN,NaN,22.434077968669243,18.819736409714796
2016-04-04T09:30:00-04:00,110.91,111.32,110.1,110.19,21529429,33743490.45,60.74035004598405,60.211734407468036,NaN,NaN,112.85551364592587,140.88159597981155,0.07884224428161346,1.6630990385124136,1.5842567942308001,2989996899,2970672546.8,82.59916381824169,71.6095067060134,NaN,NaN,22.374218044118155,19.327519500343847
2016-04-05T09:30:00-04:00,109.37,109.855,108.84,108.94,32515822,33432284.1,55.31580791071712,60.184842302266084,NaN,NaN,42.878871734918,126.80373668218246,-0.05239036022415178,1.5187688439506104,1.5711592041747622,2957481077,2978707654.2,83.28171705096538,72.69618302592218,NaN,NaN,20.738448027944834,19.52908071857256
2016-04-06T09:30:00-04:00,108.93,110.27,108.585,110.17,28157751,32530475.15,59.17902368609752,60.28971443402103,NaN,NaN,58.742114868791546,102.78850285264437,-0.06772625713726943,1.4865013827531754,1.5542276398904449,2985638828,2985237611.2,83.83660132085632,74.00969190171982,NaN,NaN,20.4396404204724,19.659160675986822
2016-04-07T09:30:00-04:00,109.37,109.88,108.13,108.68,33298409,32914037,53.18088557991192,59.67348769379813,NaN,NaN,16.44628751443745,73.09949672767945,-0.18304609371051805,1.3254200227522972,1.5084661164628153,2952340419,2979396710.2,81.2392490845334,74.99019729040965,NaN,NaN,18.325023973238807,19.46856971845139
2016-04-08T09:30:00-04:00,109.61,110.07,108.63,109.11,26151735,31795009.8,54.61066600179147,58.99928268344932,NaN,NaN,30.341535534755156,52.2528646597656,-0.23204155665787485,1.2184141706404716,1.4504557272983465,2978492154,2972789875.4,78.28482354664496,75.61242216319036,NaN,NaN,17.00824473242695,19.1170947204479
2016-04-11T09:30:00-04:00,109.74,110.55,108.75,108.77,25842078,31405863.35,53.22655893448751,58.301663054865976,NaN,NaN,31.83811595702929,36.04938512198628,-0.28550849549909474,1.093570107924478,1.3790786034235727,2952650076,2965320510.8,74.96554465854994,75.87101870965681,NaN,NaN,15.520365903590402,18.603276318039686
2016-04-12T09:30:00-04:00,108.79,110.18,108.43,109.94,25058742,31437665.95,57.24257451308983,57.930506972288775,NaN,NaN,37.96675598811896,35.06696197262649,-0.24195983954137468,1.0766288039968543,1.318588643538229,2977708818,2969366059,75.56973360209103,76.02900939720362,NaN,NaN,15.381016354159986,18.142953466056873
2016-04-13T09:30:00-04:00,110.58,112.43,110.51,112.31,40534712,31751482.1,63.9877531159117,58.69120823178396,NaN,NaN,171.40207960791238,57.59895492045065,-0.0627539087751714,1.2401462575692648,1.3029001663444362,3018243530,2975886999.4,76.55206225769867,76.34734746620545,NaN,NaN,17.41450506383671,18.03888940859685
2016-04-14T09:30:00-04:00,112.26,112.7,111.88,112.17,25538576,31130799.15,63.35197374958197,59.33645486570556,NaN,NaN,186.58963120376686,91.62762365831654,0.032045795377899866,1.342957410566811,1.310911615188911,2992704954,2983959906.4,77.74511167152771,76.91216956770573,NaN,NaN,18.8413226761606,18.15352273253453
2016-04-15T09:30:00-04:00,111.9,112.63,111.86,112.45,21176072,30103379.55,64.11982795038048,60.00682218989382,NaN,NaN,159.6356903367643,117.48645461871835,0.09570213472295785,1.4305392835926085,1.3348371488696507,3013881026,2991037680.8,78.76523501976511,77.80661788376656,NaN,NaN,20.233565395742875,18.450671684421437
2016-04-18T09:30:00-04:00,111.98,113.39,111.87,113.3,19428332,29249167.5,66.41997086610891,60.2478488549609,NaN,NaN,156.33608815425143,142.38604905816277,0.17265938971049932,1.550661386007775,1.3780019962972756,3033309358,3007169537.2,80.91277997229808,78.74203089988198,NaN,NaN,22.10260524367991,18.97237647860122
2016-04-19T09:30:00-04:00,113.51,114.125,112.89,113.39,23228123,28915386.8,66.66365460997197,60.5045312454302,NaN,NaN,155.6021561899876,165.91312909853653,0.20502422429293254,1.6342822766634413,1.4292580523705087,3056537481,3022935269.8,82.74899561325896,79.53865122440864,NaN,NaN,23.703506204348038,19.648252153707908
2016-04-20T09:30:00-04:00,113.39,114.21,112.97,113.56,21422528,28806410.2,67.14859739443727,60.738724139928244,NaN,NaN,138.15623433420416,159.26396004379487,0.21238089698114626,1.6947341735969417,1.4823532766157954,3077960009,3034878565.6,84.00438019701853,80.06385737499768,NaN,NaN,25.174015333970374,20.437646893745402
2016-04-21T09:30:00-04:00,113.47,113.92,112.66,112.99,20535667,27871028.2,63.79750188541029,60.641796160277295,NaN,NaN,111.31925969070276,144.20988574118206,0.15596815909448303,1.6773134754838992,1.5213453163894162,3057424342,3047822443.2,85.25661163696603,80.41157210360112,NaN,NaN,25.558648064861682,21.169218489619155
2016-04-22T09:30:00-04:00,112.98,114.19,112.975,114.11,29094547,27779539.5,67.25543750139724,61.107159549949664,NaN,NaN,119.1940600368318,136.12155968119558,0.17003960788408534,1.7338948262445228,1.5638552183604375,3086518889,3062350015.8,86.5310815686138,80.69242337148485,NaN,NaN,26.870508885328736,21.983688546149097
2016-04-25T09:30:00-04:00,113.8,113.91,112.81,113.3,16369582,27543198.75,62.59856427461368,61.62735643308513,NaN,NaN,90.8144210165749,123.01722625366025,0.10399588494930745,1.693850074547072,1.5898541895977645,3070149307,3069718005.6,87.1383351989008,80.96789609633736,NaN,NaN,26.6980561239478,22.65716962869177
2016-04-26T09:30:00-04:00,113.67,114.53,113.17,114.41,30564079,26733348.6,66.06611802296388,62.1192917428613,NaN,NaN,107.281118688424,113.35301875334756,0.11349253242670554,1.7317198551311463,1.6182273227044408,3100713386,3078553186.6,87.84596943992125,81.25427953341344,NaN,NaN,27.55346286514132,23.356640091041704
2016-04-27T09:30:00-04:00,114.48,115.05,113.9,114.81,24360273,26167187.1,67.24464344447873,63.12384587604464,NaN,NaN,115.16260918650462,108.75429372380763,0.12426937691593687,1.7735640438493618,1.649294666933425,3125073659,3087975916.6,88.56835078373247,81.77778679764195,NaN,NaN,28.60601548780734,24.106550862008223
2016-04-28T09:30:00-04:00,114.27,115,113.19,113.5,26126474,26045716.75,59.906663357950656,63.50213140148458,NaN,NaN,80.05204148011182,102.50085008168944,0.025872243919323745,1.6816349718325796,1.6557627279132558,3098947185,3096280485.2,89.17879613352167,82.55592769670457,NaN,NaN,27.353272452415712,24.570368232066436
2016-04-29T09:30:00-04:00,113.01,113.46,111.72,112.48,33284537,26210873.4,54.88459248690631,63.620562369514495,NaN,NaN,25.538477624415453,83.76973359920618,-0.11734672837893623,1.5090793174395856,1.6264260458185218,3065662648,3092109237,86.67518812642068,83.39233080155248,NaN,NaN,24.727619470540006,24.592832694705518
2016-05-02T09:30:00-04:00,112.83,113.51,112.175,113.48,21880990,26228451.45,58.55306009700399,63.71416848265121,NaN,NaN,41.45121284734491,73.89709196536015,-0.15197224817968835,1.4364607355939114,1.5884329837735998,3087543638,3095588103.2,87.00291132536407,84.20898635321484,NaN,NaN,23.58517091235667,24.448881011512825
2016-05-03T09:30:00-04:00,112.55,112.56,110.93,111.62,37929639,26499142.3,50.35193239590011,62.740181288364674,NaN,NaN,-20.098066633120407,48.42125490105126,-0.2988905118199563,1.2148198439986544,1.5137103558186107,3049613999,3085368225.8,80.72189272827885,84.5068313868277,NaN,NaN,19.845102387985502,23.791198351008923
2016-05-04T09:30:00-04:00,110.99,111.99,110.37,110.7,30767164,26629612.95,46.85610689828539,61.56190508470063,NaN,NaN,-57.02945353212147,13.982842357326046,-0.44782015775155704,0.9539351586291644,1.4017553163807215,3018846835,3064122861,69.49069352966231,83.91723009098018,NaN,NaN,15.595529638008653,22.620388534866027
2016-05-05T09:30:00-04:00,111.15,111.33,110.1,110.26,26249158,26277150.4,45.23843404014018,60.213234091112035,NaN,NaN,-89.25456597580074,-19.878479133856448,-0.5585502096454031,0.7035675543239677,1.2621177639693708,2992597677,3042852959.4,60.42615452702541,82.6072957700702,NaN,NaN,11.64862057326162,21.052993111779685
2016-05-06T09:30:00-04:00,109.8,110.93,109.54,110.91,25497420,26244434.65,48.089610819542,58.9039226592144,NaN,NaN,-102.87084034542646,-45.56034272782483,-0.5686985412803776,0.5512445873688989,1.1199431286492765,3018095097,3033339449.2,56.853923738024505,80.88880603905065,NaN,NaN,9.230842513932501,19.364114454944374
2016-05-09T09:30:00-04:00,110.92,111.8899,110.625,111.23,23426969,26123679.2,49.48404543662754,57.67680771826122,NaN,NaN,-71.38568504031198,-68.1277223053562,-0.5350358569835473,0.45114830741984235,0.9861841644033896,3041522066,3024135134.8,53.55515998811583,78.80353206582615,NaN,NaN,7.65794866424941,17.691805056273665
2016-05-10T09:30:00-04:00,111.66,112.4,111.07,112.35,18635261,25802505.15,54.12854682481683,56.74680410614548,NaN,NaN,-42.633534869163064,-72.63481595256474,-0.4234043441980414,0.4569287341558379,0.8803330783538793,3060157327,3026243800.4,54.21063530248269,76.67540743050215,NaN,NaN,7.681673444329393,16.26178625456734
2016-05-11T09:30:00-04:00,112.1,112.27,110.87,110.96,23604637,24956001.4,48.2049726042256,55.6330520146323,NaN,NaN,-78.14524113385167,-76.85797347291079,-0.42797270062163273,0.3453672025768384,0.7733399031984711,3036552690,3029784971.4,55.350259539990816,74.53923942357537,NaN,NaN,5.849186335833463,14.774271980462501
2016-05-12T09:30:00-04:00,111.19,111.49,109.498,110.3708,34802970,25419221.1,45.911409398451696,54.10847857870761,NaN,NaN,-120.49692268107651,-83.10644481396594,-0.45305278156746065,0.20702392623914534,0.660076707806606,3001749720,3031615380,55.96039505565411,72.35561895836395,NaN,NaN,3.6301757583028533,13.182258234439693
2016-05-13T09:30:00-04:00,110.06,110.94,109.36,109.64,24510250,25585930,43.167936671235935,52.72057660703778,NaN,NaN,-127.15917895832204,-87.96411253654506,-0.49767845704387503,0.03797863650176225,0.5356570935456373,2977239470,3023444254.6,52.51075232485416,69.88222018164633,NaN,NaN,0.9271139111497769,11.431523331112562
2016-05-16T09:30:00-04:00,109.92,111.52,109.87,111.03,27337046,25981365.7,49.36558289386836,51.52768124067381,NaN,NaN,-74.25078402959899,-88.53713233440246,-0.4157367695639662,0.01598613159067952,0.43172290115464573,3004576516,3016055144.6,49.536914771672606,67.14585913391427,NaN,NaN,0.494119094183114,9.869037011551212
2016-05-17T09:30:00-04:00,110.88,111.42,108.77,109.27,46676264,27153772.75,42.975111163952974,49.79414322063625,NaN,NaN,-111.95578536008864,-102.40158243258756,-0.4588387224931374,-0.141825501961776,0.3170132205313614,2957900252,2995603729.6,42.38253706609514,63.84687243979732,NaN,NaN,-1.9997523034049935,8.173495680843182
2016-05-18T09:30:00-04:00,108.81,110.661,108.79,109.84,35967936,27881043.15,45.43854804305648,48.76070641242952,NaN,NaN,-104.65313249756224,-107.70316070532968,-0.42831518818044,-0.21838076469418866,0.20993442348625135,2993868188,2987066829.2,39.79865414061197,60.31971944030378,NaN,NaN,-3.2282051503113003,6.5446812763925415
2016-05-19T09:30:00-04:00,109.04,109.77,107.99,108.955,36849284,28696724,42.377531049794804,47.86734488120727,NaN,NaN,-132.2267087648241,-110.0491179220792,-0.44512320283526374,-0.34646958005782835,0.0986536227774354,2957018904,2978120666,37.236661357215894,56.7883960996463,NaN,NaN,-5.220878154686679,4.863887071952653
2016-05-20T09:30:00-04:00,109.29,110.79,109.23,110.79,37404518,29112222.55,49.911997282622515,47.25012610875145,NaN,NaN,-61.51556184753489,-96.92039449992177,-0.3161180401138394,-0.2964939273648639,0.019624112748975533,2994423422,2981557456.4,38.864837915110805,53.3499622846282,NaN,NaN,-4.473646141403567,3.529953755758907
2016-05-23T09:30:00-04:00,110.77,111.39,110.5,110.66,23721741,29479830.5,49.41899772617692,47.18348791805694,NaN,NaN,-28.020500282812836,-87.67433775056455,-0.22716387892863046,-0.26433073591181255,-0.03716685698318208,2970701681,2974782489.4,36.836179788408195,50.21526850320886,NaN,NaN,-4.039723993250402,2.4485712201861487
2016-05-24T09:30:00-04:00,111.31,113.22,111.27,112.94,41124267,30007839.9,57.37171615952236,47.93460286528815,NaN,NaN,70.3067801253421,-51.22182465347839,-0.013657711477397187,-0.05423899632992857,-0.04058128485253138,3011825948,2985567628.6,42.02420382655247,48.25337638155816,NaN,NaN,-0.9428801223872402,1.9640781712470932
2016-05-25T09:30:00-04:00,113.3,113.9,113.08,113.6,26486474,30114149.95,59.363482680224884,48.94353491100849,NaN,NaN,143.3091486330313,-1.6293684273596796,0.16336940773053005,0.1636304748106312,0.00026106708010113777,3038312422,2994456475.4,45.963555106121106,47.22033356577929,NaN,NaN,2.206223685454754,1.9986703875624732
2016-05-26T09:30:00-04:00,113.77,114.015,113.25,113.47,15157174,29565684.95,58.78089556156097,49.70719810686698,NaN,NaN,149.992740167694,54.81452135914394,0.2574638057614397,0.3220908242819007,0.06462701852046106,3023155248,3007683744.2,51.269781638499275,46.82146627295606,NaN,NaN,4.521486585246499,2.359072701517334
2016-05-27T09:30:00-04:00,113.56,114.6,113.51,114.6,21265095,28964712.85,62.2489822541754,50.6189793081204,NaN,NaN,170.55922180269664,101.22947808919025,0.3744684413213295,0.5327125701721229,0.15824412885079342,3044420343,3017683128.4,54.877094683723165,46.91589017978515,NaN,NaN,7.596017261529086,3.10720763866187
2016-05-31T09:30:00-04:00,114.82,115.54,114.5,115,32764366,29508881.65,63.42219105396379,51.282811038773765,NaN,NaN,190.002169835679,144.83401211288862,0.4522588096704478,0.7235676409388532,0.2713088312684054,3077184709,3038979734,61.426428706335024,47.43130399434603,NaN,NaN,10.46747403593427,4.158674266843641
2016-06-01T09:30:00-04:00,114.61,115.95,114.42,115.78,26806050,28952702.2,65.6631136370356,52.529821112545896,NaN,NaN,168.077185594826,164.3880932067854,0.5246124583280286,0.9270744041784411,0.4024619458504125,3103990759,3057412696.2,66.02319152316849,48.193656278858725,NaN,NaN,13.580469609363718,5.504645030060795
2016-06-02T09:30:00-04:00,115.49,116.67,115.37,116.67,23303289,28579508.45,68.06707742511138,54.112368828735875,NaN,NaN,166.01141472438786,168.9285464250567,0.5955898236975765,1.1469492254723832,0.5513594017748067,3127294048,3075209021.4,69.7689161640929,49.17997921517578,NaN,NaN,16.974842200418852,7.143244625826231
2016-06-03T09:30:00-04:00,116.47,116.47,115,115.97,28733150,28703708.05,64.25661593595308,55.61870306192996,NaN,NaN,127.29568616353035,164.38913562422397,0.5591562554342973,1.2503047210676783,0.6911484656333811,3098560898,3090290151.4,72.53243055679985,50.610099088886194,NaN,NaN,18.728927736105458,8.798342213008977
2016-06-06T09:30:00-04:00,116.08,117.58,116.01,117.22,26946041,28776139.1,67.73060142844004,56.93049010011365,NaN,NaN,140.85123938246858,158.44753914017835,0.5804795169501246,1.4167478618210367,0.8362683448709122,3125506939,3106507470.6,75.16183496201796,52.44045053105372,NaN,NaN,21.331733339097287,10.588826659593021
2016-06-07T09:30:00-04:00,117.29,117.98,116.96,117.56,21038458,28656713.55,68.6238764831802,58.76254476577274,NaN,NaN,134.7285466900326,147.39281451104907,0.5774887355199699,1.5581292642708746,0.9806405287509047,3146545397,3120379608.2,77.17464888727862,54.92560137542397,NaN,NaN,23.732388196215133,12.466478307681895
2016-06-08T09:30:00-04:00,117.66,118.64,117.6499,118.43,27999930,29124947,70.84766127298867,60.57748142505361,NaN,NaN,133.45699193685834,140.46877577945557,0.5919223128982984,1.7205434198737777,1.1286211069754792,3174545327,3134490521.8,79.03571028402844,57.728248242810864,NaN,NaN,26.46043761499059,14.465615351583136
2016-06-09T09:30:00-04:00,117.94,117.94,117.29,117.67,23440747,29116752.5,66.41907303147772,62.29473442374525,NaN,NaN,105.17834202267342,128.30216123911265,0.5111486061278874,1.7675568646353383,1.256408258507451,3151104580,3139252628.2,79.6390607971432,60.756991059948525,NaN,NaN,27.487596135682757,16.325898320740226
2016-06-10T09:30:00-04:00,116.58,116.88,115.69,116.07,32686798,29010943.9,58.174577354194305,62.88491871457181,NaN,NaN,63.978189258398544,115.6386618580863,0.32016326063081624,1.6566123342959713,1.336449073665155,3118417782,3143224005,80.15207723179621,63.70607958256891,NaN,NaN,25.83852049318481,17.684844345375165
2016-06-13T09:30:00-04:00,115.65,116.18,114.59,114.81,36400315,29605447.15,52.63379357026978,63.114546989149865,NaN,NaN,33.58129329846807,94.1846726412862,0.09107945139807816,1.4502983879127527,1.3592189365146745,3082017467,3134526110.6,75.65599214484595,66.47892332231446,NaN,NaN,22.638534689586947,18.392514394548275
2016-06-14T09:30:00-04:00,114.39,115.11,113.67,114.48,34267576,29951973.65,51.25684439561934,62.67777043458536,NaN,NaN,9.019730846492036,69.04290947257809,-0.09073194613403812,1.2458040038471268,1.3365359499811649,3047749891,3114767009.4,66.52639770496296,68.22908002791522,NaN,NaN,19.628239261987222,18.569046518468124
2016-06-15T09:30:00-04:00,114.89,115.56,114.46,114.56,24197681,28828044.5,51.587496664896406,62.122342862061906,NaN,NaN,15.948777611833885,45.541266607573185,-0.20701101931961974,1.0777721758316403,1.28478319515126,3071947572,3094247458.4,58.61581759575367,69.13281306288897,NaN,NaN,17.290612970731104,18.386413154505693
2016-06-16T09:30:00-04:00,113.72,114.59,112.89,114.55,36306581,28844976.75,51.54043138871389,61.60516684971568,NaN,NaN,-19.664263443098772,20.572745514418752,-0.28139192977498384,0.9330432829325304,1.2144352127075142,3035640991,3071154740.6,51.23249699814285,69.13014987429207,NaN,NaN,15.365312197009736,17.954827303434843
2016-06-17T09:30:00-04:00,114.41,114.92,113.68,114.06,30096390,28507332.05,49.173071641946116,60.671173234556456,NaN,NaN,-25.622015732539918,2.652704516231058,-0.35560384280341895,0.7699304092032406,1.1255342520066596,3005544601,3048580104.4,45.23412386628668,68.44136624447519,NaN,NaN,13.057494966761798,17.255208398195837
2016-06-20T09:30:00-04:00,115.8,116.45,115.3,115.3,28219801,28048096.2,54.82763791795903,60.05727658198469,NaN,NaN,28.077694395757824,1.5519847356890089,-0.3146044689147973,0.7322786658631628,1.0468831347779601,3033764402,3038929491.4,42.92060718568735,67.11952185014322,NaN,NaN,12.556502574645737,16.58396470911725
2016-06-21T09:30:00-04:00,115.34,115.41,114.33,115.08,34706778,28597348.05,53.68645351104612,59.20180085869972,NaN,NaN,-20.510386158278898,-4.354038665265177,-0.29599888927879436,0.6768845231794671,0.9728834124582615,2999057624,3029191038,40.660648367977124,65.3079116247724,NaN,NaN,11.822894725835171,15.903811854362667
2016-06-22T09:30:00-04:00,115.3,115.88,114.49,114.63,27226146,27902442,51.33288687928719,58.006501533998,NaN,NaN,-26.658177987015087,-12.87542978503497,-0.3064080626041934,0.5898733342030198,0.8962813968072132,2971831478,3009167819.2,36.41500397424393,62.92548932549748,NaN,NaN,10.54655285013268,15.13848913947267
2016-06-23T09:30:00-04:00,115.82,116.91,115.73,116.82,30240296,28090133.1,60.42558155886528,57.73285622134887,NaN,NaN,57.43988763951049,2.54540043148688,-0.16528045647728662,0.6896808262106049,0.8549612826878915,3002071774,3002453975.8,35.09188760232189,60.25116482874905,NaN,NaN,12.133759443752803,14.709242040084117
2016-06-24T09:30:00-04:00,111.94,114.035,111.5,112.55,74945393,31079544.05,43.39962717636091,55.9949294890575,NaN,NaN,-173.40300792261618,-27.010798006528375,-0.34845607572941284,0.4193911880261254,0.7678472637555382,2927126381,2986770331.8,32.152896717592114,57.17909781129005,NaN,NaN,7.230308273997006,13.6408229306431
2016-06-27T09:30:00-04:00,111.07,111.07,108.19,108.69,59524205,32992499.55,34.057470801291274,53.52590051177972,NaN,NaN,-301.00606950897384,-92.8275507874747,-0.6983368611597912,-0.1050738126942008,0.5932630484655904,2867602176,2953537886.6,26.99398080625224,53.59476437693103,NaN,NaN,-1.1232180472884585,11.53167421951002
2016-06-28T09:30:00-04:00,109.65,110.88,109.57,110.37,42040579,33456310.2,40.100958811613445,51.329707478824346,NaN,NaN,-202.43521677251388,-129.2125169103217,-0.7792223776966376,-0.38076492365520664,0.39845745404143096,2909642755,2935654912.8,24.697545263319142,49.713466875451786,NaN,NaN,-5.013261972572963,9.168111906355309
2016-06-29T09:30:00-04:00,111.7,113.05,111.53,112.88,34031605,33817587.95,47.798533191314746,49.99966891881271,NaN,NaN,-95.0534982590514,-142.89158096472897,-0.6325220521736215,-0.3921951111755959,0.24032694099802557,2943674360,2930023489.2,24.004993781733816,45.739604945779696,NaN,NaN,-4.971496899121859,7.1481677912871415
2016-06-30T09:30:00-04:00,113.12,115.02,112.57,114.98,42973797,34801113.35,53.21561288254261,49.64545717083759,NaN,NaN,-24.37997402984227,-159.25555329859952,-0.3755891998549329,-0.22915955882064054,0.14642964103429235,2986648157,2926938765.8,23.61437117601656,41.70119737036686,NaN,NaN,-2.761920128271409,5.73244094563592
2016-07-01T09:30:00-04:00,115.05,115.95,114.8,115.39,24401900,34584550.85,54.21459749780511,49.75837173709011,NaN,NaN,23.853437526499082,-119.80426420877646,-0.17002938807106932,-0.06610709405454429,0.10392229401652502,3011050057,2943723501,30.263976982775716,38.45891057307613,NaN,NaN,-0.7679823079050564,4.803809052272924
2016-07-05T09:30:00-04:00,115.02,115.26,113.065,113.69,29347243,34704610.95,49.49535745120148,49.63255124106026,NaN,NaN,-26.1521260221611,-64.83347551141392,-0.14171272712489816,-0.07321861488959769,0.06849411223530047,2981702814,2966543628.6,38.14765164008359,36.431857282727606,NaN,NaN,-0.8527449427005528,3.995729910133856
2016-07-06T09:30:00-04:00,112.54,114.01,112.31,113.89,24678267,34886601.4,50.04627858911562,49.522464235647355,NaN,NaN,-44.829189621257996,-33.31227008116274,-0.10439649228700391,-0.06200150312345443,0.04239498916354949,3006381081,2985891293.8,43.93474510676663,35.38320924779996,NaN,NaN,-0.733465126515026,3.320130619184016
2016-07-07T09:30:00-04:00,114.22,114.99,113.41,114.13,20780605,34525635.15,50.740682966272196,49.46533934833009,NaN,NaN,-2.597616111810874,-14.821093651714625,-0.0606050303009812,-0.03336129871267701,0.027243731588304187,3027161686,3002588759,48.420049211908804,35.18232012021182,NaN,NaN,-0.4223895582683672,2.785484879547961
2016-07-08T09:30:00-04:00,115.25,117.09,115.15,116.79,37964832,35251839.4,57.750701731925915,50.07802721190008,NaN,NaN,112.02962086830604,12.460825327915028,0.13952623537816952,0.20165152581101609,0.062125290432846564,3065126518,3018284431.2,52.28436703800331,35.68590891819157,NaN,NaN,2.195619635949821,2.7012184161767983
2016-07-11T09:30:00-04:00,117.56,118.43,117.47,118.14,26987339,34966866.45,60.79969884469197,50.504602992381,NaN,NaN,181.94360401789632,44.07885862619449,0.34323790144389865,0.4911726672377199,0.14793476579382125,3092113857,3034497191.2,55.955072449352706,36.616942151310525,NaN,NaN,5.365427765952643,3.0818197518590615
2016-07-12T09:30:00-04:00,119,120.42,118.83,119.72,44153034,35354502.4,64.06803337647519,51.24614441134022,NaN,NaN,214.95378825611348,92.3000414818494,0.5524105450260999,0.8384479470764461,0.2860374020503462,3136266891,3065410006.6,61.96343848976327,38.1385700171524,NaN,NaN,9.101477024669547,3.941770790831988
2016-07-13T09:30:00-04:00,120.33,120.39,118.95,119.25,28050156,35043631.4,62.401337160486975,52.036748002854495,NaN,NaN,172.30354737313704,135.72658888072843,0.6219555817014403,1.0634818791771465,0.44152629747570626,3108216735,3085777137.4,65.32014753950457,40.20322312895673,NaN,NaN,11.564878140962588,5.03078612656493
2016-07-14T09:30:00-04:00,120.3,120.36,119.3,119.37,19345447,34801019.7,62.66836719579343,52.19694697692079,NaN,NaN,149.27331502731423,166.10077510855345,0.6365739327366083,1.2372437133964667,0.6006697806598583,3127562182,3105857236.6,68.29121639280345,42.57460375684827,NaN,NaN,13.61290244206945,6.256802743065576
2016-07-15T09:30:00-04:00,119.89,120.04,119.28,119.7,23857289,34178555.1,63.43739531055439,53.62821612936318,NaN,NaN,127.29871596217633,169.15459412732747,0.6279498118456431,1.3856070454669123,0.7576572336212691,3151419471,3123115827.2,70.62090584073846,45.322318694215866,NaN,NaN,15.518822517498215,7.579948425127381
2016-07-18T09:30:00-04:00,119.53,120.35,119.33,119.9,17422363,33544853.75,63.922463556345804,55.76142989758136,NaN,NaN,114.90156708130961,155.74618674001016,0.5954823295619952,1.5020101455737631,0.9065278160117679,3168841834,3138461422.6,72.5519534947928,48.5764596005402,NaN,NaN,17.231423481150518,8.958730575987829
2016-07-19T09:30:00-04:00,119.76,119.97,118.93,119.3,19734076,33120567.5,61.29523201392423,57.27530655488927,NaN,NaN,90.35769319037796,130.82696772686305,0.4973609336144642,1.528228983029848,1.030868049415384,3149107758,3141029596,72.87330238166975,52.017585108993806,NaN,NaN,17.998701898016677,10.250155050563379
2016-07-20T09:30:00-04:00,119.55,120.44,118.94,120.08,22390481,32504752.65,63.401144802904874,58.38977881286,NaN,NaN,89.2390884511321,114.21407594246205,0.45016741211848466,1.5935773145634897,1.143409902445005,3171498239,3153685896.8,74.46020368348567,55.621528673404654,NaN,NaN,19.23423999298638,11.533595756623807
2016-07-21T09:30:00-04:00,120.01,120.595,119.25,119.51,19018735,32094382.1,60.7978171195876,58.93136482979178,NaN,NaN,79.60705643833077,100.28082422466534,0.35018858932669095,1.5811456391033687,1.2309570497766777,3152479504,3158669361.2,75.07841632604311,59.297531898406554,NaN,NaN,19.603122090440223,12.686385232883294
2016-07-22T09:30:00-04:00,119.58,120.65,119.35,120.4,17796052,31472169.9,63.32971320718752,59.5824445233191,NaN,NaN,78.85619968217327,90.59232096866474,0.3147416559446692,1.6243841197075142,1.309642463762845,3170275556,3162440578.2,75.56052742328501,62.53299978701436,NaN,NaN,20.611567170250495,13.81855408107861
2016-07-25T09:30:00-04:00,120.15,120.46,119.76,120.22,13694585,28409629.5,62.45120937137783,60.50786251761741,NaN,NaN,72.0669865462357,82.02540486164995,0.25259798729090077,1.6253899478764708,1.37279196058557,3156580971,3159988405.6,74.5506305938445,65.13321256942585,NaN,NaN,21.22954923894204,14.8772676750591
2016-07-26T09:30:00-04:00,120.2,120.97,119.92,120.8,19551145,26410976.5,64.17567419011316,61.5171050605458,NaN,NaN,76.13616320770804,79.18109886511597,0.22490469856196826,1.6539228337880303,1.429018135226062,3176132116,3165393277.2,75.33318428869975,67.37595822527821,NaN,NaN,22.219069113101995,15.926096451922371
2016-07-27T09:30:00-04:00,121,121.4675,120.35,121.14,21064730,25362184.05,65.18506552859444,62.54884667214024,NaN,NaN,83.16627432059832,77.96653603900921,0.20442712589352574,1.6845520425929692,1.4801249166994435,3197196846,3170532998.6,76.08623455531338,69.35211432123569,NaN,NaN,23.32970067928702,16.98375419868875
2016-07-28T09:30:00-04:00,120.88,121.235,120.53,120.83,16540120,24487609.8,63.43019510232311,62.95452477002576,NaN,NaN,76.74876536450134,77.39487782424332,0.14759828020424526,1.66462276695475,1.5170244867505047,3180656726,3176168443,76.91828975032777,71.11168022925887,NaN,NaN,23.84249889609632,17.963574869746974
2016-07-29T09:30:00-04:00,120.71,121.76,120.05,121.07,30267873,23852313.6,64.23300665566522,63.19976104223814,NaN,NaN,76.53893150359683,76.93142418852804,0.10572753158600912,1.649183901233016,1.543456369647007,3210924599,3184298251.6,78.10200012859755,72.69360363491921,NaN,NaN,24.48459897160702,18.895149741441266
2016-08-01T09:30:00-04:00,121.2,121.7,120.44,121.17,34771679,24370802.55,64.58189760329273,63.23646562986796,NaN,NaN,78.86159721676847,78.29034632263459,0.06625171489066317,1.626271013260336,1.5600192983696728,3245696278,3202121313,80.46700954256974,74.01528728154825,NaN,NaN,25.120561662455966,19.78449430158622
2016-08-02T09:30:00-04:00,121.16,121.21,119.1,119.48,28690965,24337988.65,54.84509342017414,62.69673393413133,NaN,NaN,32.67347449678277,69.59780858044954,-0.08403823662428511,1.4549715025893164,1.5390097392136015,3217005313,3210295952.4,81.45623941108394,75.16786527237535,NaN,NaN,23.09198119842488,20.25699242970603
2016-08-03T09:30:00-04:00,119.37,120.5,119.1,120.45,17830311,23995590.85,58.69441443442971,62.41288016546249,NaN,NaN,31.691287143532904,59.30281114503646,-0.12595936752138992,1.381560529811864,1.507519897333254,3234835624,3217823708,82.3430400643797,76.17156696320221,NaN,NaN,22.342619695699696,20.55493918199084
2016-08-04T09:30:00-04:00,120.45,121.19,120.26,120.56,17526744,23832897.8,59.12000854849766,62.10449539674415,NaN,NaN,79.6104507832921,59.875148228794615,-0.15235555016081492,1.3170754596322354,1.4694310097930503,3252362368,3232164836.4,83.92064849661969,77.12154858147946,NaN,NaN,21.832978758594248,20.737516264362753
2016-08-05T09:30:00-04:00,121.34,122.58,120.97,122.3,28643444,23366828.4,65.22392571244654,62.19745697932278,NaN,NaN,196.5836292500793,83.88408777809111,-0.06326722334899437,1.3903469806068074,1.4536142039558018,3281005812,3246181079,85.30278605453063,78.03232233574646,NaN,NaN,23.14747296106562,21.08179579246316
2016-08-08T09:30:00-04:00,122.35,122.85,122.03,122.24,14625743,22748748.6,64.86426745309294,62.45238808212054,NaN,NaN,202.91803855525546,108.69537604578849,-0.021193196694963667,1.4271227080870972,1.4483159047820608,3266380069,3250317837.2,85.69364928811474,78.94806140049252,NaN,NaN,24.11775191738033,21.51550381030847
2016-08-09T09:30:00-04:00,122.27,122.63,122.14,122.37,12487734,21165483.6,65.31059809226218,62.58877760278892,NaN,NaN,169.46567453749626,136.05381605393123,0.001381247144834008,1.4500424637131033,1.4486612165682693,3278867803,3262690335.2,86.82242400467261,79.83107713772016,NaN,NaN,25.046929620121748,22.019993211710368
2016-08-10T09:30:00-04:00,122.38,122.599,121.15,121.4892,19138052,20719878.4,59.770549502651406,62.515401344436334,NaN,NaN,100.14938164428104,149.74543495408085,-0.05395970213073786,1.381211588904847,1.435171291035585,3259729751,3267669160.6,87.25810305910986,80.70105476151063,NaN,NaN,24.32856565340204,22.34978927480918
2016-08-11T09:30:00-04:00,122.03,122.4,121.565,122.07,21144639,20809838,62.05617467454914,62.42443430639073,NaN,NaN,109.01457341828332,155.62625948107907,-0.061836563819438695,1.3578755862612866,1.4197121500807253,3280874390,3273371565,87.75735770223966,81.57225692429311,NaN,NaN,24.34240761329997,22.63444903745072
2016-08-12T09:30:00-04:00,121.83,122.46,121.63,122.19,12251154,20229531.25,62.529855278772295,62.430051871204626,NaN,NaN,103.54217469494702,137.0179685700526,-0.0688171782852336,1.3336906772241832,1.4025078555094168,3293125544,3275795511.4,87.97307858076786,82.53100320907336,NaN,NaN,24.481274984945845,22.89828131566431
2016-08-15T09:30:00-04:00,122.46,123.685,122.43,123.4,22047954,20460810.8,67.00295287870179,62.63200034896096,NaN,NaN,164.3586658331038,129.3060940256223,-0.0051520051788576104,1.3960678490358447,1.4012198542147023,3315173498,3285554197.2,88.82667476794826,83.4948239575911,NaN,NaN,25.89480841720002,23.326356615883697
2016-08-16T09:30:00-04:00,123.08,123.12,122.26,122.4,20244282,20486321.1,60.56772971735966,62.30219064815848,NaN,NaN,105.80809128320047,116.57457737476314,-0.04157014920959945,1.349257167702703,1.3908273169123024,3294929216,3288766479.8,89.10089280055652,84.4244424036799,NaN,NaN,25.232638156675762,23.598682550282565
2016-08-17T09:30:00-04:00,122.44,122.5,121.33,122.04,20632642,20398429.15,58.39342309710053,61.94242121921401,NaN,NaN,51.709217238441816,106.88654449359528,-0.09787142657548453,1.2684880336929467,1.3663594602684312,3274296574,3291679844.4,89.356035281152,85.31285279873877,NaN,NaN,24.04558328267664,23.662525512053147
2016-08-18T09:30:00-04:00,122.08,122.97,122.04,122.94,16244574,20259721.1,62.06031344756661,61.78722884720697,NaN,NaN,93.81611740669909,103.84685329127845,-0.08305033553379304,1.26254654085119,1.345596876384983,3290541148,3293613196,89.53117731161699,86.12922259752588,NaN,NaN,24.08627568162032,23.723061250562743
2016-08-19T09:30:00-04:00,122.77,123.07,122.28,122.94,17379463,20238891.65,62.06031344756661,61.60711569322653,NaN,NaN,93.48188401410721,101.83479515511047,-0.08167467684842955,1.2435035303244462,1.3251782071728757,3290541148,3293096316.8,89.10902270607016,86.74650925206163,NaN,NaN,24.119253533530784,23.779660148129608
2016-08-22T09:30:00-04:00,122.68,123.34,122.33,123.22,16929728,20400648.8,63.229595368205906,62.20600868951452,NaN,NaN,101.21356919375728,89.20577582724118,-0.07074337000559039,1.2367489946658878,1.3074923646714782,3307470876,3291555792.4,87.78052858513688,87.19824419306542,NaN,NaN,24.46819459233994,23.878022211588227
2016-08-23T09:30:00-04:00,123.61,124.46,123.61,124.08,21539440,20500063.55,66.63125227319935,62.772925677998046,NaN,NaN,169.31197076830645,101.90655172426236,-0.01722032172473531,1.285966962515559,1.3031872842402943,3329010316,3298372012.4,88.59101313014446,87.64452798347718,NaN,NaN,25.752391250059652,24.145789217084147
2016-08-24T09:30:00-04:00,123.94,124.25,122.77,123.07,21533373,20523495.7,59.65177243017544,62.8109088124036,NaN,NaN,106.85371230834592,112.93545073824319,-0.05910714442571785,1.229303353708147,1.2884104981338649,3307476943,3305008086.2,89.33282540084055,88.03111204806439,NaN,NaN,24.824784542641613,24.242788549306642
2016-08-25T09:30:00-04:00,122.62,123.69,122.61,123.31,17023195,20547649.45,60.70508197632606,62.488134259823575,NaN,NaN,86.35880295756719,111.44398784841681,-0.07869245249070866,1.190044932520479,1.2687373850111876,3324500138,3311799884.2,90.04616388655305,88.36992475035171,NaN,NaN,24.358964662913603,24.25938513696478
2016-08-26T09:30:00-04:00,123.45,124.41,122.3,123.06,26734376,20370974.6,58.97791461948604,62.06768048599451,NaN,NaN,82.56166221126136,109.25994348784764,-0.11436420827562488,1.1257821246666566,1.2401463329422815,3297765762,3313244807,90.19636663505266,88.69154741799012,NaN,NaN,23.48301819293831,24.148475573532426
2016-08-29T09:30:00-04:00,123.27,124.17,123.24,123.7,14013850,19333083.15,61.96162060712781,61.82846780848491,NaN,NaN,108.48283601835824,110.71379685276784,-0.10119028550020093,1.1136584760670303,1.2148487615672312,3311779612,3314106554.2,90.29047007914707,88.93926499473831,NaN,NaN,23.560153095506685,24.064429505243034
2016-08-30T09:30:00-04:00,123.83,124.17,123.38,123.93,14031348,18600102.3,63.003066160388315,62.059361855466115,NaN,NaN,112.57605472664109,99.36661364443475,-0.0840260455378532,1.1098162046449147,1.193842250182768,3325810960,3313466683,89.602709993192,89.10673691860133,NaN,NaN,23.9135369310169,24.04287342321073
2016-08-31T09:30:00-04:00,123.78,123.89,122.55,123.23,29236343,19170403.9,57.814950934672076,61.756417302617756,NaN,NaN,53.5205342587848,88.69997803452254,-0.12441944488535839,1.03831794407607,1.1627373889614283,3296574617,3311286217.8,87.16611131023669,89.06450503345825,NaN,NaN,22.749385958168503,23.85808949963327
2016-09-01T09:30:00-04:00,123.34,123.63,122.02,123.32,22964707,19442302.05,58.290518114525426,61.45360750517155,NaN,NaN,20.951996629217856,75.61861676885266,-0.148071837236452,0.9776475924158632,1.1257194296523152,3319539324,3310294055,86.01985945367792,88.92498938152326,NaN,NaN,21.913025377927887,23.5802231965325
2016-09-02T09:30:00-04:00,124.01,124.53,123.63,124.51,23083322,19164295.95,64.05981353566466,61.24338326638317,NaN,NaN,149.59432351054673,89.02514902870975,-0.08945447737028855,1.0139013329394544,1.103355810309743,3342622646,3319265431.8,87.60685190599534,88.83785917709805,NaN,NaN,22.83528974769211,23.473804132412443
2016-09-06T09:30:00-04:00,124.92,124.97,123.97,124.6292,13710992,19118558.4,64.58819793712428,61.53055956779493,NaN,NaN,160.08640083170474,99.34586199137905,-0.050476919076339444,1.0402596614643187,1.0907365805406581,3356333638,3328176237,88.94874373659245,88.82699138681491,NaN,NaN,23.743418908649634,23.512320529017757
2016-09-07T09:30:00-04:00,124.55,125.44,124.48,125.41,17830458,19385694.6,67.91564536761595,62.210718301403176,NaN,NaN,190.86127486179544,115.0029060184099,0.016484337555976003,1.1113420024856282,1.0948576649296522,3374164096,3337846864.2,90.19016694820277,88.8865722201757,NaN,NaN,25.533758399432045,23.80109736764837
2016-09-08T09:30:00-04:00,125.31,125.41,124.77,125.16,16265541,19242069.05,65.78422160879344,62.4767117414908,NaN,NaN,164.3095684478075,137.16071285621445,0.03165419544858117,1.1344254092403787,1.1027712137917975,3357898555,3350111651.8,91.49504598645775,89.0268485540929,NaN,NaN,26.421178056496363,24.17539460891237
2016-09-09T09:30:00-04:00,124.18,124.21,121.21,121.25,54239022,20896788.2,43.03579950074422,61.11781788814635,NaN,NaN,-105.61083637338638,111.8481462556936,-0.22007781692752837,0.8276739426323871,1.0477517595599155,3303659533,3346935693.6,88.22248786427193,88.96352463682159,NaN,NaN,18.63239911087569,23.383538109192845
2016-09-12T09:30:00-04:00,120.69,122.97,120.58,122.94,33408148,21954637.9,50.933634529329325,60.239534971083735,NaN,NaN,-112.00372142279481,59.528537269025286,-0.268022023542551,0.7127242301317267,0.9807462536742777,3337067681,3345824700.6,87.04954322831821,88.91131139704883,NaN,NaN,15.287703661937066,22.226990331013447
2016-09-13T09:30:00-04:00,122.06,122.16,119.8805,120.58,47536241,23229052.25,42.14599314561221,58.490587890541796,NaN,NaN,-196.5617072579222,-11.801084348900094,-0.4435733290521695,0.4262795923590659,0.8698529214112354,3289531440,3332464261,74.26270713269734,87.88786096865975,NaN,NaN,8.79598815202666,20.308275734015336
2016-09-14T09:30:00-04:00,120.77,121.47,120.29,120.6,30545517,23744114,42.2369468672216,57.24667177890224,NaN,NaN,-175.62501785538356,-85.09834289233589,-0.5370065692404056,0.19859470986072836,0.7356012791011339,3320076957,3321646833.2,65.83100892812752,86.2091597920374,NaN,NaN,4.196653729107273,18.0066154475999
2016-09-15T09:30:00-04:00,120.68,122.185,120.51,122.04,30052131,24215088.45,48.5131956261553,56.375822753890034,NaN,NaN,-112.72938942121625,-140.50613446614062,-0.48222684291707885,0.13281772545478532,0.6150445683718642,3350129088,3320092939.8,64.6947039564781,84.39834122560346,NaN,NaN,2.773263325945543,15.830422287363563
2016-09-16T09:30:00-04:00,121.47,121.97,121.095,121.86,31940489,24999884.2,47.813839594528964,55.57838882353597,NaN,NaN,-98.5066380558071,-139.0852948026248,-0.4397072671848432,0.0654104843908101,0.5051177515756533,3318188599,3322998753,65.88073278233196,82.6615102361234,NaN,NaN,1.459472585433545,13.777429472802131
2016-09-19T09:30:00-04:00,122.32,123.55,121.99,122.67,22807008,25271261.45,51.221556999712575,54.81124142300631,NaN,NaN,-23.33475271388409,-121.35150106084264,-0.3429193937596322,0.07646850937611305,0.41938790313574525,3340995607,3323784338.2,66.21120757733007,80.94156291456504,NaN,NaN,1.5399769482624754,12.029221969296467
2016-09-20T09:30:00-04:00,123.2,123.23,122.15,122.15,16877927,25268671.4,49.00903602710674,53.811667842057616,NaN,NaN,-36.36407310048919,-89.31197422935604,-0.3012868931650722,0.042779286679405004,0.3440661798444772,3324117680,3330701586.2,69.0535369497787,79.47376484003553,NaN,NaN,0.8942204977037427,10.43850747335465
2016-09-21T09:30:00-04:00,122.58,123.97,122.1,123.92,30784744,25730936.6,55.97925767099611,53.680546894652196,NaN,NaN,21.446871660269743,-49.89759632622538,-0.1495780122832019,0.1570936644904748,0.3066716767736767,3354902424,3337666679.6,71.64043644805703,78.36478806416554,NaN,NaN,2.7029832473238526,9.333432583921677
2016-09-22T09:30:00-04:00,124.73,125.8,124.66,125.7,36287691,26468652.5,61.65580667076668,53.92092464866943,NaN,NaN,142.844560534918,1.2171936650014743,0.06415087619072757,0.38686027201208617,0.3227093958213586,3391190115,3345878885,74.36172661960728,77.53206429030335,NaN,NaN,6.280910164056299,8.897357952512337
2016-09-23T09:30:00-04:00,125.56,125.882,124.81,124.81,26117971,26923391.3,57.65266375664537,53.46327109302519,NaN,NaN,113.36086353653965,43.590693983470814,0.1350093071757022,0.49147102979098634,0.35646172261528414,3365072144,3355255594,77.06755913272211,76.77925766364096,NaN,NaN,7.792374590530489,8.73950318651493
2016-09-26T09:30:00-04:00,123.8,124.17,123.1,123.23,20028044,26588074.7,51.286446135999945,52.51314596437346,NaN,NaN,15.51570182343458,51.36078489093457,0.06826288567227318,0.4417903297056256,0.3735274440333524,3345044100,3356065292.6,77.2904428974399,75.94652188941579,NaN,NaN,6.85680376195468,8.470546125863466
2016-09-27T09:30:00-04:00,123.17,123.88,122.81,123.73,16939478,26734356.1,53.05315941614732,51.45153982498284,NaN,NaN,14.783771249599015,61.5903537609522,0.051352522002665824,0.4377180965366847,0.3863655745340189,3361983578,3363638472.2,79.31539576727737,75.16975251934969,NaN,NaN,6.705220529999114,8.2183567550257
2016-09-28T09:30:00-04:00,123.95,124.76,123.07,124.68,19426446,27004111,56.296348488441375,50.77383460210056,NaN,NaN,53.50497846316758,68.00197512153177,0.09516580903778565,0.5053228358312509,0.4101570267934653,3381410024,3368939992.2,80.61827880020427,74.39284057747444,NaN,NaN,7.640272587455274,8.13577330251564
2016-09-29T09:30:00-04:00,124.62,124.64,122.7,122.86,26657696,26875178.65,49.27352155917667,51.219386177702866,NaN,NaN,8.828970051433435,41.19885702483485,-0.0022490918861607923,0.40734566193576427,0.40959475382192506,3354752328,3361652434.8,73.74220397748824,73.35853458556132,NaN,NaN,6.077746099525226,7.841769416374152
2016-09-30T09:30:00-04:00,123.42,124.78,122.86,124.21,31764459,27315166.25,53.87035642092436,51.42915202710252,NaN,NaN,37.020643232754125,25.930812964077745,0.019230685536077652,0.43363311074202215,0.4144024252059445,3386516787,3365941363.4,75.08884678619864,72.50419912540993,NaN,NaN,6.3356595959402355,7.626610870597879
2016-10-03T09:30:00-04:00,123.83,124.095,123.13,123.82,18674272,27094713.75,52.39323920431957,52.16109817415303,NaN,NaN,23.863126053899357,27.60029781017071,0.003018772881857257,0.41817589130826605,0.4151571184264088,3367842515,3370501046.4,76.4704348260166,72.661893960647,NaN,NaN,6.06528454025032,7.403564251976799
2016-10-04T09:30:00-04:00,124.02,124.31,122.65,123.21,26057254,27712026.85,50.08020975762446,52.72133123775324,NaN,NaN,10.794195973000715,26.80238275485105,-0.05001447208657189,0.35263902831819394,0.40265350040476583,3341785261,3366461383,72.62734855337696,73.14734679102196,NaN,NaN,5.125223761419655,7.078087039040064
2016-10-05T09:30:00-04:00,123.69,124.68,123.65,123.95,24317330,28036370.45,52.802363984555384,53.027700406210386,NaN,NaN,57.954281286306774,27.692243319478887,-0.03707868521465679,0.35630514388644485,0.39338382910110165,3366102591,3363399896.4,69.76580063045719,73.50956798202047,NaN,NaN,5.174532517840099,6.80615067886864
2016-10-06T09:30:00-04:00,123.75,124.015,122.82,123.82,18937089,28169947.85,52.263185973868325,53.34551086187748,NaN,NaN,31.017764395503264,32.13000218829285,-0.03890976023845172,0.34474662880303697,0.3836563890414887,3347165502,3361882531.2,68.32883205279049,73.68443221562464,NaN,NaN,5.058396626053834,6.556471528466525
2016-10-07T09:30:00-04:00,124.04,124.32,122.23,122.83,28732709,26894632.2,48.22464605505742,53.13144579440211,NaN,NaN,0.0782176797793134,24.74151707769789,-0.10469493790734363,0.25278771665730915,0.3574826545646528,3318432793,3348265732.4,56.985543760493925,73.02545622870777,NaN,NaN,3.7728357529214294,6.158809274817226
2016-10-10T09:30:00-04:00,123.57,124.74,123.56,124.3,21481669,26298308.25,53.918682120959076,53.48213480110585,NaN,NaN,69.43756553553537,33.85640497402509,-0.04988666646651474,0.29512432148150936,0.3450109879480241,3339914462,3342680121.8,53.09200570781532,71.88534685428182,NaN,NaN,4.369356549833991,5.903173171248192
2016-10-11T09:30:00-04:00,124.05,124.11,121.34,122.03,31931287,25518060.55,45.58215452671405,52.73948457651427,NaN,NaN,-65.58120136095755,18.581325507233434,-0.16093025843650394,0.14384816490239416,0.3047784233388981,3307983175,3335919704.6,48.75044537807306,70.2503474921401,NaN,NaN,2.1587742287860423,5.368259036610742
2016-10-12T09:30:00-04:00,122.09,122.61,121.5328,121.93,20210417,25001305.55,45.250240473267155,51.56765841955002,NaN,NaN,-119.3079680470117,-16.87112435943026,-0.23125437362981188,0.015710456301633258,0.24696482993144514,3287772758,3320253738,40.48795556271528,67.83079241664781,NaN,NaN,0.32345460421111544,4.647572689125081
2016-10-13T09:30:00-04:00,120.99,121.41,120.11,120.92,26302531,24813825.55,41.929346976164005,50.444564363801355,NaN,NaN,-210.41359302575725,-65.15739584368237,-0.3299168019019494,-0.1654311724459916,0.1644856294559578,3261470227,3303114683,33.74880565482181,64.73659573965493,NaN,NaN,-2.2636218687490492,3.660259180857348
2016-10-14T09:30:00-04:00,121.36,121.84,120.4,120.43,24554561,24444529.15,40.38099235956434,49.66560337977024,NaN,NaN,-189.32477896226095,-103.0379951720904,-0.40723195597354706,-0.34455431551097604,0.06267764046257102,3236915666,3286811257.6,28.83250613354606,61.275314542233936,NaN,NaN,-4.856191119902997,2.44362342360587
2016-10-17T09:30:00-04:00,120.58,120.85,120.16,120.29,17119460,24160151.75,39.92732329074981,48.72804365652756,NaN,NaN,-183.72609985447073,-153.67072825009163,-0.44384971766960757,-0.4921345066244385,-0.048284788954830904,3219796206,3262787606.4,23.418853435473196,57.28270437567649,NaN,NaN,-7.094502429739332,1.0810340159851268
2016-10-18T09:30:00-04:00,121.52,121.58,120.66,120.98,19158923,24274201.55,43.30789757924552,47.80029716301357,NaN,NaN,-124.21619852317896,-165.39772768253593,-0.39905929443132215,-0.5471089069939836,-0.14804961256266147,3238955129,3248981997.2,20.980860014751656,53.02288874814416,NaN,NaN,-8.055224082499896,-0.22414571236987624
2016-10-19T09:30:00-04:00,121.17,121.95,120.5001,121.49,18477446,23658836.65,45.738484670503304,47.547794528108334,NaN,NaN,-94.0274991347702,-160.34163390008763,-0.31616942864737674,-0.5432613983718824,-0.22709196972450565,3257432575,3242913960.6,19.995539929391967,49.183841316137276,NaN,NaN,-8.188591857971877,-1.3619237331701621
2016-10-20T09:30:00-04:00,121.14,122,120.41,121.13,20485609,22868732.55,44.29484496588702,46.86382942417709,NaN,NaN,-88.69018973457936,-135.99695324185205,-0.26854554755706705,-0.5627739041708395,-0.29422835661377245,3236946966,3238009308.4,19.2102469666942,45.19251275760125,NaN,NaN,-8.694945734378756,-2.4094983047713896
2016-10-21T09:30:00-04:00,120.26,121.37,120.1,121.07,21093688,22617518.4,44.0453221461412,46.26754963430721,NaN,NaN,-95.08558538238991,-117.14911452587782,-0.22576485622920417,-0.5764344269002777,-0.3506695706710735,3215853278,3233796830.8,18.53688378089346,41.054401968663875,NaN,NaN,-9.181881462840105,-3.37698161306692
2016-10-24T09:30:00-04:00,122.04,122.61,121.4499,121.84,15421590,22387195.7,48.08696265001644,46.12517484090664,NaN,NaN,-29.825535964940862,-86.36900174797186,-0.13477919220385914,-0.5191435609258974,-0.3843643687220383,3231274868,3236092563.2,20.17899272664154,37.30809083818277,NaN,NaN,-8.525904834013684,-4.112542073202172
2016-10-25T09:30:00-04:00,121.81,121.9895,120.6,120.93,16459836,22363213.6,44.03850842545468,45.49918515811373,NaN,NaN,-66.57044746949508,-74.83985153723509,-0.12525569020375055,-0.5409339814767264,-0.4156782912729759,3214815032,3231264543.8,19.297974094286957,33.70324608559919,NaN,NaN,-9.054436936162574,-4.818527053625086
2016-10-26T09:30:00-04:00,120.11,121,119.46,119.73,24975308,22640656.7,39.33554505422643,44.575782235282176,NaN,NaN,-115.48197189597482,-79.130746089476,-0.18551197034094524,-0.6475682541991574,-0.4620562838582122,3189839724,3217745973.6,17.052901765012393,30.04067963647218,NaN,NaN,-10.899975175683657,-5.68730535677631
2016-10-27T09:30:00-04:00,120.12,120.14,118.09,118.36,29525724,22784058.1,34.77023177090287,43.61475264355685,NaN,NaN,-159.67550773439118,-93.32780968943837,-0.2967723158325767,-0.8330216786489331,-0.5362493628163564,3160314000,3202419380.4,14.931933294628308,27.036850317481775,NaN,NaN,-13.961381889728838,-6.8693162900552425
2016-10-28T09:30:00-04:00,118.31,119.03,117.75,118.03,35473669,22969518.6,33.75400920723135,42.17441886400487,NaN,NaN,-168.314816562304,-107.97365592542118,-0.3671217957067199,-0.9951516074497562,-0.6280298117430363,3124840331,3184216791,12.882603768837384,24.164750178983354,NaN,NaN,-16.77623646334743,-8.284590600525554
2016-10-31T09:30:00-04:00,118.18,118.64,117.7999,118.5,20311801,23051395.05,36.59627459109535,41.53257029717496,NaN,NaN,-151.34377760073937,-132.27730425258088,-0.35625042571734633,-1.0733428438897192,-0.7170924181723729,3145152132,3166992243.8,11.30191260560052,21.4898549809496,NaN,NaN,-18.319017672959827,-9.718080182301879
2016-11-01T09:30:00-04:00,118.66,118.7,116.28,117.05,34147171,23455890.9,32.03041622199001,40.588297136369455,NaN,NaN,-177.61824756748135,-154.48686427217814,-0.4167592434694579,-1.2380414725091953,-0.8212822290397374,3111004961,3146230229.6,9.74911478471681,19.294223496806847,NaN,NaN,-21.121211474294686,-11.347098938300851
2016-11-02T09:30:00-04:00,116.87,117,115.39,115.56,29859889,23733018.85,28.14458953207594,39.60367160464888,NaN,NaN,-201.3640507525026,-171.6632800434837,-0.5204386357563415,-1.4718305237351643,-0.9513918879788228,3081145072,3124491299.2,8.44135362682465,17.48654835194991,NaN,NaN,-24.86375188455124,-13.278049359193764
2016-11-03T09:30:00-04:00,115.91,116.24,114.88,115,22717468,23922037.8,26.82729129206605,38.635550099827576,NaN,NaN,-184.03535340013298,-176.53524917663205,-0.585204850467647,-1.6828979510633815,-1.0976931005957344,3058427604,3104114020,7.434619676982493,15.958127890766795,NaN,NaN,-28.342611893362847,-15.430129721217918
2016-11-04T09:30:00-04:00,115.3,116.9,115.0458,115.74,35237242,24247264.45,31.396725355807675,38.02622167590313,NaN,NaN,-138.23313200465077,-170.5189122651014,-0.5378891241598804,-1.770054505795585,-1.2321653816357045,3093664846,3097878923,7.153492738861345,14.79631641243738,NaN,NaN,-29.842729884062997,-17.489072601624358
2016-11-07T09:30:00-05:00,118,118.82,117.7082,118.57,32370934,24791727.7,45.43122378425867,38.17788783340408,NaN,NaN,-45.28868963316237,-149.307894671586,-0.28819810167132554,-1.5924130087248614,-1.3042149070535358,3126035780,3094055652.6,6.9792209313003895,13.796199335048005,NaN,NaN,-26.31853547544557,-18.750424440741675
2016-11-08T09:30:00-05:00,118.3,119.46,117.71,118.88,26196823,24505004.5,46.71710197162824,38.2477890691987,NaN,NaN,-28.30983408907237,-119.44621197590422,-0.0849150312416771,-1.4103586961056322,-1.3254436648639552,3152232603,3102301181,11.960650353804809,13.222278651077492,NaN,NaN,-23.147406125434024,-19.378564681412012
2016-11-09T09:30:00-05:00,118.08,122.83,118.05,122.54,77416809,27365324.1,59.00092930038267,39.298223664519824,NaN,NaN,66.30882226808673,-65.91163737178636,0.2926067117695319,-0.9596852751520402,-1.252291986921572,3229649412,3132002049,27.10374276962405,13.786099779858201,NaN,NaN,-15.364739422274349,-18.805161072963774
2016-11-10T09:30:00-05:00,124.26,125.4,122.62,124.5,83440705,30222232.8,63.812277477533634,40.71014904533357,NaN,NaN,161.50135875638387,3.195705059517013,0.650390627222676,-0.43930370289322695,-1.089694330115903,3313090117,3182934551.6,44.67705408715498,15.65325480173402,NaN,NaN,-7.145767865218746,-17.13953347185734
2016-11-11T09:30:00-05:00,125.03,127.72,124.55,127.36,95612752,33775142.35,69.44665762340735,42.23584154343292,NaN,NaN,206.99302270767262,72.2409360019817,1.0330011563257122,0.2015571152912372,-0.831444041034475,3408702869,3245942156.2,58.12570022280472,18.36373390860282,NaN,NaN,2.053084005422539,-14.397730975103073
2016-11-14T09:30:00-05:00,128.95,130.26,128.39,129.15,83119421,37075140.4,72.34850877666906,44.25798442566252,NaN,NaN,232.2666880599481,127.7520115406038,1.3404761308487438,0.8441511225264549,-0.496325008322289,3491822290,3319099458.2,67.88692919397724,21.834373558580698,NaN,NaN,10.409435423469711,-10.853850061021248
2016-11-15T09:30:00-05:00,128.85,129.89,128.3,129.55,38704481,38052418.3,72.9663998694596,46.66018834103631,NaN,NaN,190.89068765625007,171.59211588966826,1.4929774801766156,1.3698968418984805,-0.12308063827813509,3530526771,3394758291.8,74.50581296094381,25.938152929718658,NaN,NaN,16.862552660153447,-6.894363957996292
2016-11-16T09:30:00-05:00,129.25,130,129.03,129.54,42325510,39244821.5,72.92252864165141,49.38535240323264,NaN,NaN,163.90878972800513,191.11210938165198,1.5107819510010436,1.7653968004731695,0.25461484947212587,3488201261,3446468661.6,77.86399911371076,30.433300488224546,NaN,NaN,21.73346450552413,-2.804674177493375
2016-11-17T09:30:00-05:00,129.95,130.83,129.75,130.3,42576893,40349385.7,74.19251994265895,52.27381745576319,NaN,NaN,145.2726436545808,187.86636636129137,1.4889239115840671,2.11576973895221,0.6268458273681428,3530778154,3490006269,80.22575549384996,35.24352561143973,NaN,NaN,26.09238201985759,1.3234767078424774
2016-11-18T09:30:00-05:00,130.69,131.09,130.2979,130.99,41380592,41363730.9,75.3241013441195,55.04009079526491,NaN,NaN,128.19673813260542,172.10710944627792,1.4354912184431559,2.4212098504220876,0.9857186319789317,3572158746,3522697444.4,81.79628673613924,40.278838049335356,NaN,NaN,30.01169845191965,5.421794099853502
2016-11-21T09:30:00-05:00,131.31,132,130.61,131.6,32293090,42207305.9,76.31292110001718,58.20312685798114,NaN,NaN,116.01360096918557,148.85649202812542,1.3566919861563023,2.6815836146743095,1.3248916285180072,3604451836,3545223353.6,82.80943566828998,45.497432398162005,NaN,NaN,33.540546052936364,9.438758664579625
2016-11-22T09:30:00-05:00,132.12,132.9,131.67,132.8,39681546,43368391.4,78.16647063112526,61.776118365056085,NaN,NaN,111.78768944426939,133.03589238572926,1.3006845307157244,2.9507472919126627,1.6500627611969383,3644133382,3567944675.8,83.78948103109379,50.87944149846694,NaN,NaN,37.1359587086111,13.395501528012693
2016-11-23T09:30:00-05:00,132.48,133.65,132.1,133.63,37939230,44016587.5,79.36899687653255,65.52909733537511,NaN,NaN,105.38757598242819,121.33164963661389,1.2353214640549681,3.1942145912656486,1.9588931272106804,3682072612,3606718946,85.32683720284045,56.44317132174251,NaN,NaN,40.517200766156385,17.270029990604648
2016-11-25T09:30:00-05:00,133.73,134.1,133.54,134.07,13373383,43208970.45,79.99793050744356,69.0006119890634,NaN,NaN,101.86828670835709,112.65077824736913,1.1398164851060915,3.383663733593295,2.2438472484872034,3695445995,3639652514.2,86.49809492039573,62.110642906137834,NaN,NaN,43.49491789898567,21.016442548944795
2016-11-28T09:30:00-05:00,133.97,134,132.15,132.33,32505736,43060573.8,70.8054556515071,70.81305712243828,NaN,NaN,81.8894120852898,103.389313037906,0.8887052888386817,3.3547288595355553,2.4660235706968736,3662940259,3657808816.8,87.10902002495973,67.83419998425636,NaN,NaN,43.37848021443665,24.211019358300774
2016-11-29T09:30:00-05:00,132.51,133.09,132.1,132.26,27993682,43444667.85,70.45470605442884,72.50860027120976,NaN,NaN,72.00444256701839,94.58748135747257,0.6577767534549386,3.288244512515547,2.6304677590606085,3634946577,3663907765,87.31662604113475,73.2167696762085,NaN,NaN,43.183329022358066,26.92134931030896
2016-11-30T09:30:00-05:00,132.92,133.09,131.5,131.61,32491183,43361868.45,67.12931536258097,73.08919927565249,NaN,NaN,62.74554753534597,84.77905297568788,0.41309052303616856,3.146830912855819,2.7337403898196504,3602455394,3655572167.4,85.29480341213024,77.37327400781608,NaN,NaN,42.06810767099582,29.085171933264224
2016-12-01T09:30:00-05:00,132.25,132.55,130.29,130.97,39815930,43859670.5,63.92977813662908,73.0975921798736,NaN,NaN,49.15904644314979,73.5333470678322,0.17230475220021102,2.9491213300699144,2.7768165778697034,3562639464,3631685537.8,79.60632028519673,79.86822159339049,NaN,NaN,40.209836514201704,30.674409730541008
2016-12-02T09:30:00-05:00,130.94,131.47,130.52,130.9,24054051,43926499.65,63.572875664840446,72.67803632569026,NaN,NaN,41.056818146935896,61.371053355547964,-0.017430547154703824,2.755028393926324,2.7724589410810276,3538585413,3600313421.4,72.74437942360022,80.91241296487588,NaN,NaN,38.57683014878228,31.803326933146902
2016-12-05T09:30:00-05:00,131.95,133.33,131.89,133.15,27547125,43541993.8,69.47229965630781,72.47259281709303,NaN,NaN,68.16211006002503,58.625592950495005,-0.01712545428260981,2.7510521232277654,2.768177577510375,3566132538,3580951877.2,68.80266171350189,80.97782243055622,NaN,NaN,38.73226117674628,32.793174682232525
2016-12-06T09:30:00-05:00,133.52,134.91,132.74,134.59,27820030,43314448.6,72.53769418768599,72.44197098268062,NaN,NaN,92.77390001078227,62.77948443924778,0.05062400595278138,2.8314575849513517,2.7808335789985703,3593952568,3572753075.4,67.1435133726793,80.45194388853733,NaN,NaN,39.80339037495189,33.79463406690672
2016-12-07T09:30:00-05:00,134.59,136.18,134.18,135.9,31825849,43595899.9,74.99733699324749,72.5901715792232,NaN,NaN,128.05624094314308,75.8416231208072,0.14868307173473827,2.966687418666993,2.8180043469322547,3625778417,3577417680,67.62190156111393,79.72036549192326,NaN,NaN,41.49207436451876,34.89426839513701
2016-12-08T09:30:00-05:00,136.25,138.21,135.8,138.04,49048887,42177503.8,78.40065672220904,72.89075277776249,NaN,NaN,181.31204868838472,102.27222356985419,0.3132289749880903,3.2095405656673677,2.8963115906792773,3674827304,3599855248,69.89269114372846,78.98228946691458,NaN,NaN,44.12596439210667,36.213082108989816
2016-12-09T09:30:00-05:00,138.4,138.82,137.75,138.31,34313467,39721141.9,78.79287954531058,73.13852264927614,NaN,NaN,196.26902940337357,133.31466582114172,0.3907688282239272,3.3847726259591866,2.9940037977352594,3709140771,3633966319.6,72.99364811759828,78.35352956559022,NaN,NaN,46.33235031020028,37.658691852019885
2016-12-12T09:30:00-05:00,137.95,138.57,136.51,136.85,34592908,36670149.7,71.2576327634779,72.77743062523761,NaN,NaN,149.163194089731,149.51488262708293,0.2984150080524506,3.367022557800823,3.0686075497483722,3674547863,3655649384.6,74.77237841530675,77.77945404751999,NaN,NaN,45.828771634935535,38.82584610672212
2016-12-13T09:30:00-05:00,137.53,138.05,136.2417,136.86,32624555,34145406.4,71.27789365825939,72.28538941289005,NaN,NaN,121.60501126588123,155.28110487810272,0.1975482822829968,3.315542902602118,3.1179946203191213,3707172418,3678293354.6,76.51219399036918,77.25964783032539,NaN,NaN,45.43655751515352,39.77023345078375
2016-12-14T09:30:00-05:00,136.42,137.35,134.81,135.15,45923656,34506365.15,63.088244054810076,71.12247849705274,NaN,NaN,71.64295502469008,143.9984476944121,-0.013583201615333884,3.1010156182999538,3.1145988199152876,3661248762,3685387423.6,77.04627555944435,76.66817914151137,NaN,NaN,42.51967919205054,40.16301141382186
2016-12-15T09:30:00-05:00,135.37,137.14,134.96,136.16,41352520,34457715.65,65.60216447525573,70.0942094947536,NaN,NaN,72.38189835677797,122.21241762809078,-0.10914363401315175,2.978169277398848,3.087312911412,3702601282,3690942219.2,77.47811980941243,76.02389520501256,NaN,NaN,40.82886213334596,40.258132945182446
2016-12-16T09:30:00-05:00,136.35,137.525,135.63,135.91,39348181,34296280.05,64.43241053252422,69.63899198625482,NaN,NaN,72.19541518363046,97.39769478414215,-0.2074184305322211,2.8280398732467233,3.0354583037789444,3663253101,3681764685.2,74.96857007106387,75.15672020830571,NaN,NaN,39.11287361329938,40.09452446919915
2016-12-19T09:30:00-05:00,136.045,137.19,135.91,136.8,33393867,33896943.8,66.70827957910949,69.37139009516059,NaN,NaN,72.05113030382289,81.97528202696051,-0.2290179253598401,2.749185897079144,2.978203822438984,3696646968,3686184506.2,75.38212261924888,74.304255678171,NaN,NaN,38.31054251203696,39.83966990389027
2016-12-20T09:30:00-05:00,137.28,138.21,136.99,137.96,31753610,33869969.8,69.4519329226264,69.53729134944955,NaN,NaN,95.89278268302243,76.83283631038873,-0.18367379791616179,2.748611575043782,2.9322853729599436,3728400578,3690430138.2,75.79579658152873,73.6257551902709,NaN,NaN,38.43098210858637,39.63842879027543
2016-12-21T09:30:00-05:00,137.85,138.15,137.01,137.06,23215910,33046688,64.97762338869558,69.61213743888287,NaN,NaN,78.14859696689793,78.1339646988303,-0.22979347676003226,2.6450435270099035,2.874837003769936,3705184668,3699217319.4,76.66961540809481,73.41599055619221,NaN,NaN,37.19261731079991,39.28902715035035
2016-12-22T09:30:00-05:00,136.56,136.75,134.81,135.32,34737851,32886619.05,57.292811437490485,69.16356142264358,NaN,NaN,18.381858183603402,67.33395666419538,-0.38390631945329323,2.394954104453319,2.7788604239066124,3670446817,3692786426.4,74.54844491733643,73.54485237717337,NaN,NaN,33.66402159714561,38.48545492846396
2016-12-23T09:30:00-05:00,135.46,136.12,135.27,136.04,17081375,33072018.65,59.43093290782736,68.44632094060927,NaN,NaN,21.829669878129664,57.26080760309522,-0.43976188204896216,2.2291580713454096,2.6689199533943717,3687528192,3697641444.6,75.10834474193277,73.99525830777557,NaN,NaN,31.39139844104184,37.47201828740366
2016-12-27T09:30:00-05:00,136.23,137.3,136.21,136.65,13571701,32125316.9,61.20312252298813,67.63670867884514,NaN,NaN,48.97690848381632,52.64596323909391,-0.4371212808871343,2.1225183522854536,2.559639633172588,3701099893,3698532029.6,75.21604970972984,74.57186804613632,NaN,NaN,30.032938029036565,36.409292536208355
2016-12-28T09:30:00-05:00,136.89,136.98,134.83,135.25,22712422,31861253.9,55.239033446701605,66.2254012826633,NaN,NaN,6.702755480166521,34.80795779852273,-0.5252320586712762,1.9030995598334925,2.4283316185047688,3678387471,3688529408.2,71.47528009408043,74.84710936991965,NaN,NaN,27.00084051114855,35.06522796119981
2016-12-29T09:30:00-05:00,135.29,136.26,134.685,135.37,21312932,31302341.35,55.63807563370521,64.59950263348445,NaN,NaN,-11.738943539578537,16.830449697227436,-0.5674051709566905,1.7190751548089054,2.286480325765596,3699700403,3687432555.2,71.05794742856762,74.93034196169388,NaN,NaN,24.674197083867746,33.5807949787238
2016-12-30T09:30:00-05:00,135.6,135.63,134.4,134.85,28399349,30731512.3,53.41581007225959,62.78685481398081,NaN,NaN,-49.95937110204286,3.162203840098188,-0.6181247339186151,1.5138244083673271,2.1319491422859422,3671301054,3687603402.6,71.08626625949283,74.79410040040064,NaN,NaN,22.080073845705236,31.937834816864008
2017-01-03T09:30:00-05:00,136.49,136.8295,134.5,135.52,29792446,31018432.05,55.86201320669482,61.68716770278201,NaN,NaN,-33.031519866798675,-7.810034108887477,-0.5941903920463534,1.3892111522280004,1.9834015442743538,3701093500,3690316464.2,71.56212612787489,74.56479666558405,NaN,NaN,20.551891055991632,30.311271422453668
2017-01-04T09:30:00-05:00,136.05,137.96,136.01,137.78,34499365,31366044.05,62.93272246975517,61.09108404646029,NaN,NaN,69.7821108883741,-3.6489936279759205,-0.4218947410951355,1.4560331179054344,1.87792785900057,3735592865,3697215058.6,72.78847334777842,74.29881661968473,NaN,NaN,21.321027371751843,29.02695084378198
2017-01-05T09:30:00-05:00,137.49,137.76,135.51,136.19,30286876,31489386.35,56.12110792190504,60.5934314655385,NaN,NaN,3.2056011724505935,-4.348424489519103,-0.41037754081989286,1.364955932975704,1.7753334737955968,3705305989,3702598762.2,73.74020152982087,74.06266847471161,NaN,NaN,19.8014168386631,27.70901741447928
2017-01-06T09:30:00-05:00,136.41,136.71,135.68,135.69,23435995,31069893.65,54.13673554806765,59.774472256453635,NaN,NaN,-40.70642516353378,-10.141920814310122,-0.4297403223141818,1.2381580709028697,1.6678983932170515,3681869994,3699032680.4,71.94523280213978,73.66746225990643,NaN,NaN,17.953906990940435,26.31543021111659
2017-01-09T09:30:00-05:00,135.54,135.72,134.5,134.8,24077865,29821342.55,50.70027074383691,58.79360512869026,NaN,NaN,-118.84924773744372,-23.919896141390296,-0.4913524729023895,1.0537078020890647,1.5450602749914542,3657792129,3696330895.4,70.54416917662626,73.35143362458946,NaN,NaN,15.341764819744874,24.747763726634915
2017-01-10T09:30:00-05:00,135,136.38,134.76,136.09,21684855,29189911.95,55.14471853856825,57.96763648293732,NaN,NaN,-48.11087320213298,-26.935766808457153,-0.4359734999906417,1.000093400003152,1.4360668999937938,3679476984,3692007592.2,68.25366338827529,72.84225796523421,NaN,NaN,14.476713057308203,23.280470773873954
2017-01-11T09:30:00-05:00,136.23,136.79,135.42,136.33,27428753,28831704.2,55.94054542325075,57.002537375839054,NaN,NaN,0.14135421641602,-40.86391814284877,-0.3761846898469714,0.9658360376850794,1.3420207275320508,3706905737,3686270166.6,65.22686940916762,72.08733459577984,NaN,NaN,14.016369480982089,21.95702773203226
2017-01-12T09:30:00-05:00,136.16,136.22,133.59,135.28,41844214,29292687.15,51.625072137620684,56.04878371504799,NaN,NaN,-113.7632245597533,-64.25768328928955,-0.39823349270540587,0.8442288616502935,1.2424623543556994,3665061523,3678221273.4,61.13121146257777,70.97744859967148,NaN,NaN,12.325080068179297,20.581035208624694
2017-01-13T09:30:00-05:00,135.65,136.97,135.65,136.26,27784455,28385727.1,55.10612255001483,55.89259165165687,NaN,NaN,20.675450164464934,-51.9813082236898,-0.33996317902167816,0.8175083805786016,1.1574715596002798,3692845978,3680416470.2,61.83506715299517,70.06935018793281,NaN,NaN,11.929865012325841,19.34515375201057
2017-01-17T09:30:00-05:00,135.6,135.69,134.13,134.41,28197779,27727990.05,48.07337636664019,55.08133761300065,NaN,NaN,-128.40015437903463,-53.89148955200799,-0.4142341690111364,0.6396788483363594,1.0539130173474958,3664648199,3681787684.2,62.294376422353984,69.15406673653433,NaN,NaN,9.336901613250767,17.915403446473455
2017-01-18T09:30:00-05:00,134.76,134.935,133.95,134.85,21289660,26825064,49.71703490746492,54.260902783320425,NaN,NaN,-127.0475565384185,-69.67882621926509,-0.42059949876438496,0.5281636438920145,0.9487631426563995,3685937859,3683079859.2,62.749338787096406,68.26358738491766,NaN,NaN,7.737467354309419,16.461412576164307
2017-01-19T09:30:00-05:00,135.14,135.44,133.17,133.75,34105880,26860664.65,45.81282399216728,53.58760210799654,NaN,NaN,-151.18067459507952,-99.94323198156421,-0.48138976607193296,0.34702593506648327,0.8284157011384162,3651831979,3672065107.6,56.49193925974806,67.19334875389391,NaN,NaN,5.165655290273211,14.84773296389415
2017-01-20T09:30:00-05:00,134.21,134.88,133.82,134.44,29286081,26737288.2,48.54254011403447,53.08077814230577,NaN,NaN,-120.55242394522165,-101.30107185865788,-0.4577750007032064,0.25619695025940814,0.7139719509626146,3681118060,3675276415,57.812800757903375,66.24726684884648,NaN,NaN,3.849060695471631,13.276494068405219
2017-01-23T09:30:00-05:00,134.03,134.68,133.12,133.88,20537008,26603343.1,46.495368367732,52.58646087769665,NaN,NaN,-147.5751806611742,-134.9511980237857,-0.4612234390194987,0.13744265218824125,0.59866609120774,3660581052,3668823429.8,54.24877400714193,65.04458883082141,NaN,NaN,2.149298547398168,11.686894708261354
2017-01-24T09:30:00-05:00,134.34,136.28,134.22,135.93,34313842,26582142.65,54.122813232633966,52.46223230812088,NaN,NaN,0.4390954633207298,-109.18334805531462,-0.31383847219185,0.2063680009679274,0.5202064731597774,3694894894,3674872768.8,56.9293626957524,63.999391442812666,NaN,NaN,3.0225109861538386,10.449125605103138
2017-01-25T09:30:00-05:00,137.06,137.55,136.95,137.21,29127322,27184440,58.13583001327864,52.11959713265827,NaN,NaN,144.60800535159,-54.85223567731292,-0.1280645124303102,0.3601258326218897,0.4881903450521999,3724022216,3682489640.2,60.099372151798484,63.093027071671244,NaN,NaN,5.0663450072429885,9.680156948265974
2017-01-26T09:30:00-05:00,137.34,137.5,136.42,136.66,22255562,27618633.05,55.87419319614122,52.10196036653229,NaN,NaN,110.84967043661308,-2.4461666709744008,-0.044462093421518245,0.43261272827530206,0.4770748216968203,3701766654,3692476575.2,63.85566765303546,62.38698893761515,NaN,NaN,6.035016882582115,9.15942265316828
2017-01-27T09:30:00-05:00,136.77,137.04,135.65,136.19,19467824,27456403.15,53.942964741048044,52.08811959460231,NaN,NaN,58.083313807169105,33.28098087950375,-0.024074642505663824,0.44698151856474055,0.4710561610704044,3682298830,3692712729.2,63.94211030710106,61.81533733082666,NaN,NaN,6.2551469520059495,8.744526124430804
2017-01-30T09:30:00-05:00,135.23,135.24,133.24,134.29,40464369,28413975,46.8875809925022,51.81578461236412,NaN,NaN,-96.14596496563833,43.56682401861093,-0.13558224105790684,0.30157835974802083,0.43716060080592767,3641834461,3688963411,61.43015907864733,61.16433660954245,NaN,NaN,4.2188094822732705,8.097995175551157
2017-01-31T09:30:00-05:00,133.87,135.56,133.48,135.23,32944993,28641257.2,50.34764860101527,51.47313675968177,NaN,NaN,-56.71071704754561,32.13686151643766,-0.14236250421631913,0.25920747053552873,0.40156997475184786,3674779454,3684940323,58.762581727065836,60.48640220517035,NaN,NaN,3.605701598592147,7.456238950271298
2017-02-01T09:30:00-05:00,136.22,136.87,134.7,135.15,30010459,28652157.85,50.04881521151708,51.052298887415084,NaN,NaN,4.8269152308177805,4.180643492283214,-0.1479158140068395,0.21667520724329847,0.364591021250138,3644768995,3669089678.8,49.620082504459184,59.37163171197688,NaN,NaN,3.0282601801142475,6.823670554534576
2017-02-02T09:30:00-05:00,135.3,135.67,134.49,134.81,19935725,27923975.85,48.72515423816522,50.845161894596835,NaN,NaN,-32.99827393645885,-24.588945382331183,-0.16866444205297987,0.15376046868391313,0.322424910736893,3624833270,3653703002,42.67853686450256,58.05358352640008,NaN,NaN,2.1727571283778744,6.159254350797905
2017-02-03T09:30:00-05:00,135.99,136.98,135.51,136.87,24534082,27636336.15,56.27126038628975,50.92838602575932,NaN,NaN,86.17356801300927,-18.97089454116315,-0.04430271028869098,0.26704652287602926,0.31134923316472024,3649367352,3647116706.4,40.09301347050606,56.500579691936586,NaN,NaN,3.7254690247750917,5.811570732794646
2017-02-06T09:30:00-05:00,136.4,136.7784,135.43,135.84,23691510,27649111.9,52.13945619148814,51.21882029896275,NaN,NaN,50.66451654061502,10.391201760087519,-0.032603470085474096,0.27059489555787763,0.30319836564335173,3625675842,3643884982.6,38.849356854640476,54.82593543709991,NaN,NaN,3.7657951190999754,5.519317073695407
2017-02-07T09:30:00-05:00,135.82,136.465,134.77,135.24,30342153,27962326.3,49.843516515141665,51.22785469951109,NaN,NaN,6.100806344290641,22.95350643845477,-0.06461628511618583,0.22242800924811945,0.2870442943643053,3595333689,3627995829.6,33.36881214141037,52.72732639097948,NaN,NaN,3.1058126566007873,5.174530728396176
2017-02-08T09:30:00-05:00,134.6,135.22,133.89,135,32956872,28525927.15,48.91564795069645,51.44948498226317,NaN,NaN,-53.82544051225517,11.223035289840182,-0.09922717230301575,0.16301032898553558,0.26223750128855133,3562376817,3611517394,28.826908855749878,50.7512527906939,NaN,NaN,2.298504957025188,4.763669903914606
2017-02-09T09:30:00-05:00,135.25,137.25,135.25,136.9,28267608,28567869.9,55.91274487405574,51.97592817940755,NaN,NaN,86.65959150234191,35.15460837760033,0.003143838480879124,0.2661672993896502,0.2630234609087711,3590644425,3604679625,27.17405406954282,48.562770884382424,NaN,NaN,3.735455023393,4.616782063840091
2017-02-10T09:30:00-05:00,137.79,138.37,137.2,137.94,27287550,27840036.7,59.20645847308187,52.883863186932544,NaN,NaN,165.27609854879614,50.975114484757704,0.13111563526009468,0.42691800498388943,0.29580236972379476,3617931975,3598392549.6,25.714139166358024,46.52458268146928,NaN,NaN,5.988008284691632,4.81267152396174
2017-02-13T09:30:00-05:00,138.77,139.205,138.09,138.3,23245053,27613066.6,60.31177903528657,53.325932172836296,NaN,NaN,181.7754456109293,77.19730029882056,0.22473016523023837,0.5767150762615927,0.3519849110313543,3641177028,3601492786.8,27.774736711574334,44.442109396885144,NaN,NaN,8.156571598428895,5.290371534599905
2017-02-14T09:30:00-05:00,137.94,138.945,137.61,138.76,27144980,27560426.65,61.73837269644126,53.58325665020505,NaN,NaN,148.388224338353,105.65478389763302,0.29777235850061523,0.7242003591571233,0.4264280006565081,3668322008,3616090450.6,36.680975781252236,42.76936679898898,NaN,NaN,10.378915712331173,6.017306417132943
2017-02-15T09:30:00-05:00,138.19,139.77,138.07,139.59,20253540,27508620.65,64.23633360231653,54.1805523935033,NaN,NaN,160.7350999901222,148.5668919981085,0.3770250693865529,0.8977093373896992,0.5206842680031463,3688575548,3641330196.8,48.50480685027682,41.67287674164908,NaN,NaN,13.025485564006534,7.018474866686313
2017-02-16T09:30:00-05:00,139.46,139.84,138.21,139.2,24613563,27034004.8,62.18205900081331,54.76905912634366,NaN,NaN,138.73385049547807,158.98174379673574,0.3772989880776818,0.9923080031002485,0.6150090150225667,3663961985,3655993708.8,53.891727214119705,40.95499223500756,NaN,NaN,14.657129815602774,8.109711287960094
2017-02-17T09:30:00-05:00,138.45,139.16,138.25,139.11,26703217,26904861.6,61.69175273105731,55.82649996481189,NaN,NaN,111.94734988824639,148.31599406462578,0.34634152905587023,1.0479359263424044,0.7015943972865342,3637258768,3659859067.4,55.221507254918535,40.51151710474121,NaN,NaN,15.87244947315892,9.21867388584564
2017-02-21T09:30:00-05:00,139.38,140.32,139.38,140.2,21353474,26945684.9,65.2640694634789,56.89195859784501,NaN,NaN,144.14247238726674,140.78939941989327,0.37194714959507014,1.1665283342803718,0.7945811846853017,3658612242,3663346110.2,56.44196133295293,40.34575850516172,NaN,NaN,17.97728158955971,10.469903557804791
2017-02-22T09:30:00-05:00,140,140.02,139.25,139.58,14890829,25974534.25,61.737468143070586,57.72686237867026,NaN,NaN,111.7574440583529,133.46324336389324,0.3216871757349147,1.196690154353945,0.8750029786190303,3643721413,3658425991.2,54.19739027364056,40.67270906010325,NaN,NaN,18.79825088963731,11.659667462352294
2017-02-23T09:30:00-05:00,139.96,140.01,137.69,138.75,24596201,25747978.2,57.275540740136236,58.33760427166819,NaN,NaN,69.88135645978114,115.29249465782502,0.21237592840060926,1.140472889119792,0.9280969607191827,3619125212,3644535924,48.35145223368293,41.07791730075899,NaN,NaN,18.241178176888802,12.599883278714652
2017-02-24T09:30:00-05:00,137.46,138.65,137.3,138.65,24512342,25860817.2,56.74343748299105,58.37133120714685,NaN,NaN,40.880757431202305,95.72187604496989,0.11788560996636033,1.075453973177133,0.9575683632107728,3594612870,3630666101,43.32599445711212,41.308844514087994,NaN,NaN,17.63491429606944,13.31917342405105
2017-02-27T09:30:00-05:00,138.34,140,138.21,140,28269036,26300877.8,61.89069816643276,59.067848491071466,NaN,NaN,80.13463759640769,89.35933358660216,0.12990502865244125,1.1199496490263243,0.9900446203738831,3622881906,3627790728.6,42.343432311065655,41.55842133240407,NaN,NaN,18.56650991059297,14.068792922128466
2017-02-28T09:30:00-05:00,139.38,139.48,137.76,137.84,40184131,26286865.9,51.36006689699862,59.176173518346964,NaN,NaN,34.78305930489738,67.48745097012828,-0.01624347049703656,0.9697402822525873,0.9859837527496239,3582697775,3612607835.2,37.50656763220723,41.853975296032424,NaN,NaN,16.046853400383963,14.35137299045068
2017-03-01T09:30:00-05:00,139.65,140.86,139.52,140.36,35719834,26425607.95,59.926788374069794,59.96268354858792,NaN,NaN,108.57897791750088,66.85175774195788,0.0448364783219245,1.0420293506520295,0.997192872330105,3618417609,3607547074.4,36.02923310489925,42.36842702811452,NaN,NaN,16.742253780593856,14.692927389042561
2017-03-02T09:30:00-05:00,140.33,140.36,138.64,138.75,25937002,26221935.1,53.449737960902056,59.78675448336266,NaN,NaN,59.90770271955579,64.85702699391281,-0.031067851172100758,0.9583580583649791,0.9894259095370799,3592480607,3602218153.4,34.48874933679156,42.89090526148943,NaN,NaN,15.003217954704379,14.737254612708535
2017-03-03T09:30:00-05:00,138.8,139.42,137.88,138.65,30989760,26774636.85,53.06609063474077,59.348156780624,NaN,NaN,26.160046170726368,61.91288474181763,-0.09241675982633857,0.8739049597541566,0.9663217195804952,3561490847,3595593748.8,32.621516376870105,43.38428934795457,NaN,NaN,13.548955893736428,14.567497652855376
2017-03-06T09:30:00-05:00,137.78,137.97,136.99,137.7,23892086,26742537.05,49.43583850556488,58.571303885643886,NaN,NaN,-39.79755471144182,37.92644628024773,-0.19546097927302797,0.7219954954892103,0.9174564747622382,3537598761,3578537119.8,28.36346088093572,43.42634107433753,NaN,NaN,11.160094349010276,14.080725752306076
2017-03-07T09:30:00-05:00,137.4,137.74,136.61,136.8,29711279,27043525.5,46.210578804885735,57.46217575053278,NaN,NaN,-76.96410960972976,15.577012497322306,-0.315600885195788,0.5229553682675032,0.8385562534632912,3507887482,3563575061.2,25.24994911498665,42.60983916960428,NaN,NaN,8.140517345590814,13.232124551346754
2017-03-08T09:30:00-05:00,137.28,137.62,135.78,135.9,34115126,27232174.15,43.17696964502022,55.95793546786876,NaN,NaN,-125.61762643746685,-31.26230837367124,-0.4394387855561571,0.28925777151809484,0.728696557074252,3473772356,3534646010.6,20.552311810542548,40.61323238105182,NaN,NaN,4.657597476755424,12.007192112119421
2017-03-09T09:30:00-05:00,135.83,136.49,134.89,135.36,35223796,27345520.35,41.420000043648116,54.47493125664267,NaN,NaN,-195.8859280037587,-82.42103451833415,-0.5351268009626502,0.05978805587093916,0.5949148568335894,3438548560,3503859601.2,16.940296891371403,37.97384450085552,NaN,NaN,1.2629206708642227,10.472296191940107
2017-03-10T09:30:00-05:00,136.29,136.31,134.84,135.96,39516613,27907970.6,44.13991816631701,53.22122878773265,NaN,NaN,-175.63997753198194,-122.78103925887581,-0.5341830909728567,-0.07281400688248141,0.4613690840903752,3478065173,3487174466.4,15.364294602511691,35.126900739969315,NaN,NaN,-0.7462797685180749,8.869642483303224
2017-03-13T09:30:00-04:00,135.65,136.79,135.65,136.28,21295021,27608344.15,45.59089818433359,51.8160022677937,NaN,NaN,-121.83866352297663,-139.18926102118277,-0.489373392959837,-0.1503476571094211,0.3390257358504159,3499360194,3479526753,14.689711199246759,32.1445971589903,NaN,NaN,-1.9810669330866786,7.3195411381046664
2017-03-14T09:30:00-04:00,135.75,135.83,134.5601,135.63,30037834,27947983.2,43.13966464412774,50.48758773215492,NaN,NaN,-143.86160588533554,-152.56876027630392,-0.48020609484417726,-0.2612318827048057,0.21897421213937157,3469322360,3471813728.6,14.021086406683295,29.274861168493352,NaN,NaN,-3.7378545665830356,5.739913180292138
2017-03-15T09:30:00-04:00,136.29,138.02,135.97,137.73,31230409,28152254.65,52.100146221512354,50.11791669511036,NaN,NaN,-40.356805816652084,-135.51659615214098,-0.31726626506716643,-0.17760861919458648,0.13965764587257995,3500552769,3477169811.2,16.85138012643729,27.02485601797581,NaN,NaN,-2.5597049968109493,4.554253440705983
2017-03-16T09:30:00-04:00,138.22,138.51,137.555,137.91,25306607,28404908,52.786933180578096,49.835309244938,NaN,NaN,0.7049777260586826,-96.1984150061775,-0.18829316717147287,-0.09570881309176116,0.09258435407971172,3525859376,3494631974.4,25.465881315836285,25.74913365074182,NaN,NaN,-1.4070852050510148,3.702633634169269
2017-03-17T09:30:00-04:00,138.14,138.73,137.31,138.46,33324628,28840461.25,54.914108950206106,49.33698144377895,NaN,NaN,12.676482148798124,-58.5351230700215,-0.06332904785535329,0.0134230442605201,0.07675209211587339,3559184004,3510855740.6,32.46644516045116,25.043634568555067,NaN,NaN,0.18725414547510172,3.2004365643558166
2017-03-20T09:30:00-04:00,138.28,138.52,137.37,137.7512,19091187,28459859.75,51.682418907121715,49.36000658735917,NaN,NaN,-0.2254884703398999,-34.21248805949415,-0.027617839777535624,0.04222979239395386,0.06984763217148948,3540092817,3519002265.2,35.7307199619939,24.91678830639697,NaN,NaN,0.6113329186923822,2.830564614975326
2017-03-21T09:30:00-04:00,138.51,138.6,133.92,133.97,61868962,30485634.15,38.62393180398881,47.83837397521053,NaN,NaN,-117.19279255523081,-28.878725393473196,-0.2457311115551092,-0.23731625727239702,0.00841485428271218,3478223855,3520782564.2,36.45359519402872,24.947099884191932,NaN,NaN,-3.5462195029477437,1.9195954552720305
2017-03-22T09:30:00-04:00,133.71,134.31,132.78,134,46332586,32057722,38.756149264308746,46.78883192545386,NaN,NaN,-181.09003967058297,-57.02537216425937,-0.3677208405356225,-0.4512361963868159,-0.08351535585119343,3524556441,3525583298.6,38.46357451849726,25.231015968599475,NaN,NaN,-6.678998372793646,0.6912249084055053
2017-03-23T09:30:00-04:00,134,135.6957,133.64,134.78,37764648,32716144.35,42.24011668873318,46.01554807216761,NaN,NaN,-115.3065787114233,-80.22768345175577,-0.37436593390064893,-0.5514727732270046,-0.17710683932635568,3562321089,3532875641.2,41.49095948061444,25.86454761886693,NaN,NaN,-8.151564050907439,-0.5720306572106295
2017-03-24T09:30:00-04:00,134.95,135.47,133.86,134.49,33514377,33166246.1,41.299432681011325,45.43437622755664,NaN,NaN,-105.36021246383113,-103.8350223742816,-0.37579854207925834,-0.6468550169254286,-0.27105647484617024,3528806712,3526800182.8,39.736970700470046,26.676941177405094,NaN,NaN,-9.62239413080908,-1.8649397248675512
2017-03-27T09:30:00-04:00,132.76,135.07,132.4,134.74,35596748,33532631.7,42.48848282610716,45.168512229072455,NaN,NaN,-115.4788327886489,-126.8856912379434,-0.33857090648246446,-0.6942701079492508,-0.35569920146678635,3564403460,3531662311.4,41.855403854544164,27.863045087373486,NaN,NaN,-10.47924200460682,-3.0955543362588758
2017-03-28T09:30:00-04:00,134.28,135.9,134.14,135.79,26891866,32868018.45,47.31545789069299,45.464118532334794,NaN,NaN,-56.99071934004975,-114.8452765949072,-0.22723751059852865,-0.6397460897149472,-0.41250857911641853,3591295326,3554276605.6,50.560595156046574,30.00649389776663,NaN,NaN,-9.796192206527916,-4.052788317725882
2017-03-29T09:30:00-04:00,135.7,136.49,135.3,136.23,22095540,32186803.75,49.23813289074214,46.02255659284151,NaN,NaN,-17.32143948189188,-82.09155655716899,-0.11370319509241056,-0.5546375729819317,-0.44093437788952117,3613390866,3572043490.6,56.11909359098778,32.80497937631066,NaN,NaN,-8.667718799221563,-4.7120641007966935
2017-03-30T09:30:00-04:00,136.32,137.38,136.26,137.26,25792935,32179600.4,53.51481044515532,46.69219175561568,NaN,NaN,41.30927455967635,-50.768385902949056,0.03317053200245412,-0.3994712128864535,-0.4326417448889076,3639183801,3587416033,60.280213672900025,36.01325930990983,NaN,NaN,-6.40797727471407,-4.9543374113563186
2017-03-31T09:30:00-04:00,137.42,138.17,136.94,137.48,29434275,32101826.15,54.39853685996467,47.321308803875034,NaN,NaN,79.94635979110151,-13.707071451962523,0.1414734828733084,-0.2557998912972721,-0.3972733741705805,3668618076,3615378305.8,66.50260288797767,39.714180144819174,NaN,NaN,-4.293475969155681,-4.859928633899084
2017-04-03T09:30:00-04:00,137.97,138.1,135.6,136.03,38834899,32848966.8,47.9308581252244,47.663536909667656,NaN,NaN,27.712085754324704,14.931112256632199,0.11302565354015959,-0.255991307245381,-0.3690169607855406,3629783177,3628454249.2,68.95205198761258,43.63782054345698,NaN,NaN,-4.294042649142982,-4.779087778933927
2017-04-04T09:30:00-04:00,135.93,136.55,135.35,135.87,25642559,32645530.8,47.26309862504539,47.31803350992002,NaN,NaN,-9.516837481709382,24.425888628300264,0.08242354469708485,-0.2659875299141845,-0.34841107461126936,3604140618,3631023307.6,69.42510301263248,47.3930864638995,NaN,NaN,-4.485231796393328,-4.737108352856699
2017-04-05T09:30:00-04:00,136.83,137.43,134.08,134.33,44968767,33188212.85,41.299179852771175,46.497479700790954,NaN,NaN,-46.678582256805356,18.554460073317568,-0.036180847693646934,-0.393637134228328,-0.3574562865346811,3559171851,3620179504.6,64.92832343619136,50.211832329639144,NaN,NaN,-6.474814586141921,-4.985352100468873
2017-04-06T09:30:00-04:00,134.54,135.63,133.83,135.58,41012050,33477625.55,47.13076390475232,45.94152648325854,NaN,NaN,-60.40985745710304,-1.7893663300383096,-0.025592182769097083,-0.38944651499605243,-0.36385433222695535,3600183901,3612379524.6,61.826233327821456,52.30896005587988,NaN,NaN,-6.391292301775431,-5.186200700655524
2017-04-07T09:30:00-04:00,135.21,136.03,134.75,135.52,24300166,32716803.2,46.88996847932896,45.599208595559055,NaN,NaN,-33.09852448290514,-24.398343184839643,-0.018125697556918285,-0.3865114541731032,-0.3683857566161849,3575883735,3593832656.4,55.086714776337566,53.69153111404728,NaN,NaN,-6.3953346327002905,-5.358934119519062
2017-04-10T09:30:00-04:00,135.47,136.85,135.16,135.82,22779946,32791049.45,48.311932908537706,46.291208674455405,NaN,NaN,-0.8638752697123867,-30.11353538964706,0.01000813151117097,-0.3558755922272212,-0.3658837237383922,3598663681,3587608757.2,52.99886474920711,54.87333608227431,NaN,NaN,-5.992688530233406,-5.449470463906826
2017-04-11T09:30:00-04:00,135.27,136.92,135.08,136.9,32589223,32918618.9,53.17263574707562,47.32095770893875,NaN,NaN,18.520109434285015,-24.506146006448176,0.09937599672807673,-0.24166372782829626,-0.341039724556373,3631252904,3593031214.4,54.61286451130524,56.02685679604631,NaN,NaN,-4.199415191303343,-5.270891139249185
2017-04-12T09:30:00-04:00,136.64,136.7,134.92,135.04,25700826,32642139.75,45.275866894421945,47.537797009345084,NaN,NaN,-24.3154897274669,-20.033527500580487,0.0345889287124283,-0.2978035636658376,-0.3323924923782659,3605552078,3602307259.8,57.31333105181665,57.157026193989324,NaN,NaN,-5.048141115362226,-5.239069707265334
2017-04-13T09:30:00-04:00,134.88,135.37,133.66,133.72,30206992,32887159,40.660753940396255,47.49217709930115,NaN,NaN,-102.08654013252428,-28.368864035664735,-0.08904051651874939,-0.4436931380267026,-0.35465262150795324,3575345086,3597339496.8,55.4118527057968,58.27666062294123,NaN,NaN,-7.287894151297392,-5.531758913555628
2017-04-17T09:30:00-04:00,134.07,135.32,133.68,135.29,18278795,32134867.35,47.513624769313125,47.85111580953015,NaN,NaN,-61.90671054308792,-34.1305012477013,-0.058434374234104136,-0.4276955893005834,-0.36926121506647924,3593623881,3600887526,56.521341374090525,59.32422758862312,NaN,NaN,-6.924356218961904,-5.730701385756525
2017-04-18T09:30:00-04:00,134.72,135.46,134.155,135.32,24553317,32407973.85,47.63806262374926,47.874159004748456,NaN,NaN,-38.89420276730665,-41.73656674722015,-0.03090679680748909,-0.40789471107584063,-0.37698791426835154,3618177198,3604790229.4,57.76621841722165,59.838914964421335,NaN,NaN,-6.602777979981771,-5.855283756360132
2017-04-19T09:30:00-04:00,135.69,136.9628,135.54,135.79,34627635,31045907.5,49.65201552416068,47.903722049992645,NaN,NaN,55.04615685803026,-34.431357262471096,0.02139836963345665,-0.3502399522265307,-0.37163832185998735,3652804833,3609100615.2,59.157137214569225,60.055918080391436,NaN,NaN,-5.727491134785119,-5.837027667563701
2017-04-20T09:30:00-04:00,136.34,137.67,136.15,137.52,31934431,30325999.75,56.312738260734825,48.10357403681975,NaN,NaN,126.3417018246054,-4.2999189520566405,0.16685321078930204,-0.16307180837335977,-0.3299250191626618,3684739264,3624938052.4,63.86595450688072,60.31204242567577,NaN,NaN,-2.7903366428743164,-5.4017860926080745
2017-04-21T09:30:00-04:00,137.24,137.5475,136.71,137.21,29385980,29907066.35,54.91089939223503,48.14017136055334,NaN,NaN,115.0332992306797,39.12404892058415,0.23249915391491233,-0.03930107676902139,-0.2718002306839337,3655353284,3640939692,67.8936024802322,60.41139953940824,NaN,NaN,-0.8539273576312626,-4.752091987611387
2017-04-24T09:30:00-04:00,139.08,139.34,138.49,138.92,33836931,29923194.05,60.719686930118094,49.05365913233146,NaN,NaN,218.0732695735988,95.1200449439215,0.37306292540717767,0.1945284260750384,-0.17853449933213927,3689190215,3660052958.8,71.91976074574848,60.62337873641794,NaN,NaN,2.7668672469317483,-3.677954954105225
2017-04-25T09:30:00-04:00,140.24,140.88,140.09,140.27,31569478,29721830.55,64.59736578860716,50.291821072585876,NaN,NaN,256.05199060361366,154.10928361810556,0.5293905103036722,0.48320363854745096,-0.046186871756221215,3720759693,3680569457.8,75.47494610837958,61.055510386114165,NaN,NaN,7.148460535419275,-2.1313241698874394
2017-04-26T09:30:00-04:00,140.17,141.8166,140.13,140.99,41669249,30460699.7,66.49697526569554,52.09166360208047,NaN,NaN,223.63453938217083,187.82696012293368,0.6459918814639662,0.7613029800737365,0.11531109860977035,3762428942,3702494279.6,78.59394728224694,62.03162637511814,NaN,NaN,11.343408933213048,-0.20636229801594141
2017-04-27T09:30:00-04:00,141.34,141.8,140.48,140.95,23004326,30506139,66.28418544350646,53.45976514056291,NaN,NaN,181.66638046949768,198.89189585191212,0.6816074242582053,0.9673203789325271,0.28571295467432173,3739424616,3713431350,79.96290473251025,63.32710290402448,NaN,NaN,14.59850274308685,1.9086184221416003
2017-04-28T09:30:00-04:00,141.03,141.17,139.04,139.06,31113926,30772188.55,57.00245379521834,54.1820855202693,NaN,NaN,107.9293283299262,197.47110167176143,0.5449793939260661,0.9669371970819043,0.4219578031558382,3708310690,3724022831.2,81.21572338154323,65.19346066153916,NaN,NaN,14.587818843555194,3.719932768057828
2017-05-01T09:30:00-04:00,139.64,140.29,138.7799,139.86,20925239,30346736.75,59.58235433134175,54.987115621898155,NaN,NaN,92.71106960230748,172.39866167750316,0.47798209338074815,1.0194354198817734,0.5414533265010253,3729235929,3732031974,82.12583215102136,67.27395833309734,NaN,NaN,15.388441307516912,5.386862559409126
2017-05-02T09:30:00-04:00,139.98,140.34,138.69,139.15,17993929,29304688.25,56.350793244047495,55.214126871681856,NaN,NaN,73.93469542391608,135.97520264156364,0.36068600425546915,0.9923108318203617,0.6316248275648926,3711242000,3730128435.4,81.11985910158495,69.16731508954588,NaN,NaN,15.049309063744579,6.767212060028476
2017-05-03T09:30:00-04:00,138.49,139.1142,137.69,138.29,27050258,29375073.2,52.627460017538915,55.73924066619021,NaN,NaN,34.82848606120347,98.21399197737018,0.20761773777661507,0.8911469997856614,0.6835292620090463,3684191742,3714480995.4,73.18408164108195,70.30094013163627,NaN,NaN,13.611708558768681,7.74499727413422
2017-05-04T09:30:00-04:00,138.53,138.73,137.11,138.1,25799132,28416591.45,51.812924897344836,56.53582430597225,NaN,NaN,17.981797321381833,65.47707534774702,0.08243688695363238,0.7865753707010867,0.7041384837474544,3658392610,3698274594.2,65.9841272683808,71.05610260039226,NaN,NaN,12.207232520634673,8.382459452205714
2017-05-05T09:30:00-04:00,138.69,138.99,137.53,138.99,23806535,27556315.7,55.30271746695619,57.092188070089605,NaN,NaN,31.075584173374505,50.10632651643668,0.05003270162886975,0.7666793607835416,0.7166466591546719,3682199145,3693052285.2,63.80574757070293,71.57641732872172,NaN,NaN,12.016693519477435,8.901635747530245
2017-05-08T09:30:00-04:00,138.66,138.98,137.76,138.41,16680015,27175308.15,52.62782023969649,57.44859932837155,NaN,NaN,22.59908107195796,36.083928810366785,-0.016448186663759246,0.6960864258249728,0.7125346124887321,3665519130,3680308925.4,58.71211199099655,71.64398115541992,NaN,NaN,11.07527175742332,9.212155177514969
2017-05-09T09:30:00-04:00,138.59,138.83,137.78,138.35,23988364,27235729.05,52.345754697978556,57.64100926935855,NaN,NaN,16.618495690151644,24.6206888636139,-0.06757998025271417,0.6280596371728393,0.6956396174255535,3641530766,3666366678.6,53.66447134566257,71.25164787906945,NaN,NaN,10.226869684311795,9.357114392771658
2017-05-10T09:30:00-04:00,138.04,139.48,137.86,139.21,19791524,26595844.1,55.986981185620074,57.61774090685035,NaN,NaN,33.74826996162339,24.40464564369787,-0.04754456637434523,0.636208909457622,0.6837534758319672,3661322290,3661792788.2,52.08252967323147,70.40997467666594,NaN,NaN,10.501061751881824,9.52053544407311
2017-05-11T09:30:00-04:00,138.67,138.83,136.98,138.24,28617310,26741668.3,51.232034354439584,57.354964832722096,NaN,NaN,-5.894638396987474,19.629358500024004,-0.10063117619806994,0.5579645055843798,0.6585956817824498,3632704980,3656655262.2,50.28931496122494,69.15252556816542,NaN,NaN,9.364843591774262,9.49829375088756
2017-05-12T09:30:00-04:00,137.71,137.8875,137.16,137.51,24111218,26436879.6,47.93270009083282,56.441608629916004,NaN,NaN,-41.04290706090486,5.205660253168133,-0.18122076793846886,0.43206972185936365,0.6132904897978325,3608593762,3641934185.6,45.45945366901153,67.26250363411278,NaN,NaN,7.423725571974531,9.2019268681857
2017-05-15T09:30:00-04:00,137.98,139.25,137.975,138.58,31132243,27079552,52.73721580838201,55.59445505989992,NaN,NaN,5.916129371227595,1.8690699130220594,-0.159539222696798,0.41386646142683503,0.573405684123633,3639726005,3636775560.6,43.86944268202404,65.00496767508739,NaN,NaN,7.139164140614511,8.907246478532672
2017-05-16T09:30:00-04:00,138.97,139.04,137.62,138.63,18520895,26777930.9,52.955671190275076,54.62721905451274,NaN,NaN,-17.023391792617762,-4.859307583531821,-0.13962308747857544,0.39887682477541375,0.5384999122539892,3658246900,3640118787.4,45.207015498973554,62.620186833425,NaN,NaN,6.9700650453912365,8.630506273798181
2017-05-17T09:30:00-04:00,136.33,137.04,134.75,134.89,50791166,27586107.45,38.58810565170166,52.6489276408124,NaN,NaN,-209.3123247031487,-53.47142651648623,-0.3634082303891259,0.0842396242675818,0.4476478546567077,3607455734,3629345476.2,41.75410509967698,59.89098685965119,NaN,NaN,1.7391438181395769,7.646025922989809
2017-05-18T09:30:00-04:00,134.57,135.9,134.23,135.38,44805143,28229643.05,40.85232023889809,51.49534667250381,NaN,NaN,-211.380096304196,-94.56851809792795,-0.4574324273579575,-0.12414267954073921,0.3332897478172183,3652260877,3633256655.6,43.44302427217146,57.192936923267496,NaN,NaN,-1.6293221967413327,6.320976191599646
2017-05-19T09:30:00-04:00,135.64,136.76,135.4176,136.03,44450513,28982869.7,43.81177925371747,50.36887702410207,NaN,NaN,-145.045811915784,-115.36909906890378,-0.453942666283251,-0.23413858503684537,0.21980408124640557,3696711390,3650880181.2,50.419332398107926,54.92818694091653,NaN,NaN,-3.40884706081914,4.931001441254105
2017-05-22T09:30:00-04:00,136.26,137.2,136.16,136.95,20062657,28294156,47.79339395863578,49.75763421800123,NaN,NaN,-91.93886305100864,-134.94009755335102,-0.37125058811783207,-0.24425915390088448,0.12699143421694756,3716774047,3666289789.6,55.57888902925531,53.10383193575013,NaN,NaN,-3.6191630830953914,3.7095493663470345
2017-05-23T09:30:00-04:00,137.29,137.69,136.35,137.4,16681423,27549753.25,49.67198865369444,49.54652912058377,NaN,NaN,-62.167592165683395,-143.96893762796415,-0.27239903419114203,-0.21350735852198,0.058891675669162036,3733455470,3681331503.6,59.959092938896326,52.15918988559402,NaN,NaN,-3.208924461343758,2.721195962391207
2017-05-24T09:30:00-04:00,137.51,138.03,136.83,137.49,21500658,26541323.7,50.05904938678771,49.421252298401114,NaN,NaN,-37.15337064331084,-109.53714681599658,-0.1909545021944407,-0.17980145207388887,0.011153050120551851,3754956128,3710831582.4,66.8608124048536,52.221810252484936,NaN,NaN,-2.765719979779035,1.9373508277954583
2017-05-25T09:30:00-04:00,138.14,138.61,137.2,137.58,22804164,26531315.6,50.469280564939794,49.07600680539995,NaN,NaN,-6.21483470011528,-68.50409449518042,-0.12425458732472837,-0.1441651840353586,-0.01991059671063024,3777760292,3735931465.4,71.38086153771167,52.76288982155699,NaN,NaN,-2.2881862734316285,1.3337026704773032
2017-05-26T09:30:00-04:00,137.38,137.79,136.78,137.54,20047267,25977982.65,50.27163048428227,48.90770753715607,NaN,NaN,-29.14059343328478,-45.32305079868059,-0.07830592753103954,-0.11779300612442967,-0.039487078593390124,3757713025,3748131792.4,73.28804072763064,53.80402758845943,NaN,NaN,-1.9447883850695042,0.8653468053991878
2017-05-30T09:30:00-04:00,137.12,137.44,136.22,136.46,25544111,26208926.25,45.132307968840145,48.39246134221762,NaN,NaN,-69.04869762389234,-40.74501771325733,-0.11396435239519653,-0.1819425190873858,-0.06797816669218926,3732168914,3751210765.8,73.76322767139501,55.23965304029746,NaN,NaN,-3.0612153018909933,0.3044093615005905
2017-05-31T09:30:00-04:00,136.84,136.92,134.64,136.32,34345409,27026500.25,44.49726201415158,47.57176711568415,NaN,NaN,-112.31499102782011,-50.77449748568469,-0.13865489157645622,-0.24129678116275954,-0.10264188958630333,3697823505,3744084372.8,70.63135008708257,56.564568784143965,NaN,NaN,-4.164063843495462,-0.33394395349884565
2017-06-01T09:30:00-04:00,136.72,139,136.27,138.95,44618558,27904915.25,56.79585484575685,47.96918286506396,NaN,NaN,48.90170336915891,-33.56348268319074,0.02191429768793811,-0.07524901747638069,-0.0971633151643188,3742442063,3741581559.8,69.51503465935139,57.93783447686729,NaN,NaN,-1.36928478859727,-0.4818497870843348
2017-06-02T09:30:00-04:00,139.45,141.02,139.05,139.85,46680183,28948967.8,60.057576329572925,48.83524545354539,NaN,NaN,169.19805108307028,1.5190944734463947,0.17972888791368508,0.12749779472778755,-0.05223109318589752,3789122246,3743853950.6,69.97896669120581,59.689228264166886,NaN,NaN,2.0341395551465897,-0.12242273819420268
2017-06-05T09:30:00-04:00,139.96,140.11,138.95,138.98,20808877,28799084.9,55.68141665073482,49.045545513713456,NaN,NaN,117.65495928963391,30.878205018030133,0.21417714378333302,0.21549033654326877,0.001313192759935744,3768313369,3745974019.4,70.43108865418893,61.58648869075008,NaN,NaN,3.51696350061484,0.3974895816356605
2017-06-06T09:30:00-04:00,138.11,139.66,137.81,138.85,25460884,29238128.35,55.03608689718485,49.19414663563558,NaN,NaN,76.77855454309417,60.04365545142743,0.21623285497671668,0.2716042614808316,0.05537140650411492,3742852485,3748110733.6,70.90664818694091,63.42217673989061,NaN,NaN,4.510121635211303,0.9850084464321808
2017-06-07T09:30:00-04:00,138.86,139.53,138.49,138.98,20542219,29065821.1,55.59037203179714,50.40859423421382,NaN,NaN,86.46066402921385,99.79878646283423,0.21397753711390233,0.32284332789649284,0.10886579078259051,3763394704,3761224973.4,73.70221627176282,65.70418468075388,NaN,NaN,5.478567663240472,1.6269454774047938
2017-06-08T09:30:00-04:00,138.98,141.46,138.74,140.88,33956430,29774066.4,62.80687414700111,51.97677665622119,NaN,NaN,156.31114492687055,121.28067477437655,0.32160794411327964,0.5108757209241901,0.18926777681091045,3797351134,3772206787.6,75.79931833890898,68.0153485426637,NaN,NaN,8.673104392968463,2.6335396081996034
2017-06-09T09:30:00-04:00,141.46,142.9,140.7,141.61,56979378,31192169.8,65.15005418068816,53.5009391510048,NaN,NaN,193.08696326480043,126.0584572107226,0.4170707546044222,0.7106062200664383,0.29353546546201603,3854330512,3785248440.8,78.03904434615879,69.98818511038162,NaN,NaN,12.082071664392913,3.983329901941505
2017-06-12T09:30:00-04:00,141.66,142.15,140.8901,141.38,34665481,31719882.95,63.7865337789784,54.643306281029275,NaN,NaN,151.4573946680418,132.81894428640416,0.4376872871794816,0.840644574436368,0.4029572872568864,3819665031,3795518773.2,79.63727592069107,71.70664131691275,NaN,NaN,14.44163314983499,5.477373223069145
2017-06-13T09:30:00-04:00,141.8,142.31,141.47,142.1,22046771,31265609.35,66.1732278853988,55.82196622615102,NaN,NaN,147.4400894822396,146.95125127423324,0.4699400728295893,0.990382378293873,0.5204423054642837,3841711802,3815290636.6,82.30684700290674,73.30290946434206,NaN,NaN,17.17126132361973,7.147928666004943
2017-06-14T09:30:00-04:00,142.03,142.04,140.45,141.26,33021942,31990661.7,61.11276685852113,56.61151747413198,NaN,NaN,103.93667623464667,150.44645371531982,0.40716884811584075,1.0294033656090846,0.6222345174932439,3808689860,3824349667.8,83.38184407114724,74.4829831547916,NaN,NaN,18.007420088740446,8.699284583538587
2017-06-15T09:30:00-04:00,139.69,140.98,139.69,140.54,27376771,30819941.95,57.08323810238085,57.08394301252063,NaN,NaN,65.75936497580139,132.336097725106,0.2948590854425416,0.9908083742964209,0.6959492888538793,3781313089,3821142058.8,81.49380492946835,75.2053362542028,NaN,NaN,17.50690998702439,9.957516784036558
2017-06-16T09:30:00-04:00,140.03,140.215,139.28,140.19,35608427,30360106.15,55.17859680728558,57.43444060702085,NaN,NaN,40.8338048857802,101.88546604930195,0.1803274823525064,0.9213586417945123,0.7410311594420059,3745704662,3799416888.8,69.94213373681718,74.96634289771613,NaN,NaN,16.533894336541874,10.896999291537318
2017-06-19T09:30:00-04:00,140.56,141.58,140.51,141.23,25163275,29395744.25,59.502561401549364,58.460887280785805,NaN,NaN,81.29723786333693,87.85343468836098,0.1587027585197318,0.9394096075916707,0.7807068490719389,3770867937,3789657470,65.45365104441413,74.37280171007464,NaN,NaN,16.96371955740651,11.763673615232916
2017-06-20T09:30:00-04:00,140.88,140.97,139.7,139.8,20111946,29398208.7,52.06500942911625,59.00144066756899,NaN,NaN,37.229183507243555,65.81125349336176,0.03845252513793407,0.8287725054943564,0.7903199803564224,3750755991,3771466307.8,57.984156780003566,73.469430759569,NaN,NaN,14.982838356750221,12.223554292592532
2017-06-21T09:30:00-04:00,140.05,140.8,139.22,139.45,23351393,29731707.2,50.40435560654971,58.54490500762562,NaN,NaN,18.174953049119697,48.65890885625636,-0.06847511515742921,0.7047260864096359,0.7732012015670651,3727404598,3755209255.4,52.24595237822993,72.23592488234603,NaN,NaN,12.861602467409266,12.314704031852065
2017-06-22T09:30:00-04:00,139.37,140.39,139.01,139.98,17917206,29552534.6,52.856507776548675,58.03054296812389,NaN,NaN,12.249301473115455,37.956896155719164,-0.10513147581581528,0.641786856797296,0.7469183326131112,3745321804,3748010998.4,49.891636954145774,70.80111561541317,NaN,NaN,11.816742922493367,12.243566730515107
2017-06-23T09:30:00-04:00,140.14,141.08,139.55,140.91,20772474,29450950.1,56.884843086016204,58.116501999215416,NaN,NaN,44.046106964511104,38.59935657146535,-0.07005489135485021,0.6593497184195485,0.7294046097743987,3766094278,3752088921.6,51.232363124645424,69.42977807758864,NaN,NaN,12.132317487220954,12.227673981473085
2017-06-26T09:30:00-04:00,141.09,141.53,140.201,141.08,22988281,29598000.8,57.598090060583445,58.29950222517245,NaN,NaN,62.74865899756416,34.8896407983108,-0.04019801434328085,0.6791570918452976,0.7193551061885785,3789082559,3755731846,52.45618908397194,68.11188814166228,NaN,NaN,12.59641501679326,12.28035127223311
2017-06-27T09:30:00-04:00,141.1,141.62,139.75,139.84,24610096,29551300.05,50.97413632656374,57.96977110337008,NaN,NaN,24.284229934251016,32.30065008371229,-0.10506918224453332,0.5880186283829119,0.6930878106274452,3764472463,3758475140.4,53.40447457222211,66.66204944883795,NaN,NaN,10.98971608220705,12.0959748165151
2017-06-28T09:30:00-04:00,140.67,142.26,140.4,141.98,25085426,29088300.9,59.6076093663681,57.74125219046772,NaN,NaN,100.42676358251396,48.75101219039114,-0.00997022207070497,0.680625033039064,0.6905952551097689,3789557889,3770905798.6,57.53740450448077,65.35762703209306,NaN,NaN,12.390128138759493,12.137996719692872
2017-06-29T09:30:00-04:00,142.24,142.35,139.65,141.14,38794877,28797116.85,55.47780260502167,57.05037707792011,NaN,NaN,52.241909192704654,56.749533734308976,-0.009744243415456544,0.6784149508404482,0.6881591942559048,3750763012,3771994040.2,57.889547954331995,63.91837728981973,NaN,NaN,12.167801191091948,12.142254501321311
2017-06-30T09:30:00-04:00,141.25,141.67,140.77,140.92,22798521,27603033.75,54.41446669215188,56.38094371457536,NaN,NaN,53.04472133653949,58.54925660871466,-0.029405497086726795,0.6514023228974963,0.6808078199842231,3727964491,3764368082.8,54.47994747898281,62.12142525826914,NaN,NaN,11.657757959259301,12.073040709598168
2017-07-03T09:30:00-04:00,141.34,142.495,141.3,142.1,12968191,27210999.45,58.95828296491261,55.8655905059692,NaN,NaN,115.55998411045582,69.11152163129299,0.028910743126278726,0.7169462488920715,0.6880355057657928,3740932682,3754738107.4,50.439843425282646,59.84521071701027,NaN,NaN,12.672442529008086,12.15866954094244
2017-07-05T09:30:00-04:00,141.7,141.85,140.7,141.59,21865451,27031227.8,56.34422056594329,55.52498005649936,NaN,NaN,57.5546428413331,75.7656042127094,0.025126986872410995,0.7194442393563065,0.6943172524838955,3719067231,3745657061,46.90726825250552,57.23988387282157,NaN,NaN,12.689670748203616,12.234526856265466
2017-07-06T09:30:00-04:00,139.93,140.47,138.83,139.14,30992598,27553746.75,45.831486901254,54.72128354213316,NaN,NaN,-136.56510871413303,28.367229753380002,-0.1412450306268942,0.5177609642002778,0.659005994827172,3688074633,3725360409.8,40.140602207464575,54.286083678392735,NaN,NaN,9.053840285703076,11.78014306047084
2017-07-07T09:30:00-04:00,139.43,140.68,139.18,140.49,20511003,26881475.4,51.23108848997647,54.43931866232537,NaN,NaN,-68.90469218957773,4.137909476923525,-0.15797367583989208,0.4615389000273069,0.619512575867199,3708585636,3716924934.6,37.70606897479411,51.98350762396252,NaN,NaN,7.896181127818407,11.225291355806206
2017-07-10T09:30:00-04:00,139.92,140.89,139.37,139.88,17206023,24892807.65,48.86103465540605,53.67920960902941,NaN,NaN,-68.33919987025966,-20.138874764436302,-0.2047543782734531,0.36356960302538255,0.5683239812988357,3691379613,3709607959,35.68436954304347,49.857130373864614,NaN,NaN,6.1824440808658565,10.5048846022433
2017-07-11T09:30:00-04:00,139.78,140.38,138.98,140.29,16192892,23969178.2,50.51798948756232,53.568708184632705,NaN,NaN,-77.2715650121139,-58.705184588950246,-0.20235811250510394,0.3153763406674557,0.5177344531725596,3707572505,3702935923.6,33.899486086517726,48.13679675290133,NaN,NaN,5.3421032347788815,9.76734440689124
2017-07-12T09:30:00-04:00,141.05,142.22,141.01,141.37,19358610,23834770.15,54.68324913658092,53.87434343677779,NaN,NaN,96.56781501638652,-50.902550153939565,-0.12604524216613539,0.3601779004648904,0.4862231426310258,3726931115,3704508700.4,34.728287115381974,46.8855349484122,NaN,NaN,5.964441216157984,9.224072522500775
2017-07-13T09:30:00-04:00,141.2,141.56,140.38,141.49,16559268,23011636.45,55.135149963748006,54.03710359300631,NaN,NaN,56.42077851388456,-12.305372708336046,-0.06838099751083165,0.40074689574248623,0.4691278932533179,3743490383,3715591850.4,40.39950236996823,46.207525335256655,NaN,NaN,6.595865175267497,8.848614330038878
2017-07-14T09:30:00-04:00,141.1,142.3,141.1,141.73,15465287,22416062.25,56.078507111748465,53.97950816627291,NaN,NaN,102.66211490700535,22.00798871098057,-0.01761423135709711,0.4471101040569465,0.4647243354140436,3758955670,3725665857.2,45.07120217368664,45.767442410188174,NaN,NaN,7.386279672003271,8.639709378890934
2017-07-17T09:30:00-04:00,141.6,142.46,141.26,142.06,15374599,21404370.85,57.404736403766826,53.965697190785995,NaN,NaN,111.96943917495557,58.06971652002362,0.031951787268169995,0.5046640694992561,0.47271228223108613,3774330269,3742255988.4,51.775117014301,45.718794405211675,NaN,NaN,8.421118695744932,8.608482138441506
2017-07-18T09:30:00-04:00,141.54,141.87,141.04,141.69,16653259,20978870.05,55.38539725449596,54.28078725706687,NaN,NaN,69.46531489547131,87.41709250154067,0.033421678745878536,0.5144893806634343,0.48106770191755577,3757677010,3752276889.4,55.32212781161701,45.855769636597024,NaN,NaN,8.742473158915699,8.627623712794962
2017-07-19T09:30:00-04:00,141.88,143.14,141.88,143.1,16985452,20822545.35,61.01367939300447,54.381220830398036,NaN,NaN,160.37934604641984,100.17939870754734,0.11818806219328959,0.6288027796591678,0.5106147174658782,3774662462,3761823158.8,58.45687209232938,45.92144589287193,NaN,NaN,10.701996435754202,8.92396267321771
2017-07-20T09:30:00-04:00,143.12,143.52,142.8,143.2,17047795,20507365.45,61.385738664883064,54.80321626324527,NaN,NaN,180.6014828222312,125.01553956921666,0.1668489650940892,0.7191759238334896,0.5523269587394004,3791710257,3771467133.6,61.40311756654387,46.17241515088706,NaN,NaN,12.408295474211343,9.421724501931086
2017-07-21T09:30:00-04:00,143.01,143.33,142.25,142.55,21949464,20708978.35,57.54175921468306,55.02659430056893,NaN,NaN,126.17101224793556,129.7173190374027,0.14208523692450348,0.7299335048950297,0.5878482679705263,3769760793,3773628158.2,62.052559830194994,46.7133160331165,NaN,NaN,12.805778900689383,9.905160844610842
2017-07-24T09:30:00-04:00,142.31,142.82,141.97,142.75,16694031,20505056.2,58.40485215792057,54.987063528640924,NaN,NaN,98.48692178896552,127.02081556020468,0.1265197012714585,0.7459978945598493,0.6194781932883908,3786454824,3776053069.2,62.80878215925984,47.59681165697202,NaN,NaN,13.37375645311574,10.400674502968684
2017-07-25T09:30:00-04:00,143.62,144.25,143.21,144.05,21066388,20408961.55,63.586376133255406,55.5043603548775,NaN,NaN,178.30303605612926,148.78835979233628,0.18744645179685604,0.8537862580344608,0.6663398062376048,3807521212,3786021909.6,65.8240195959205,48.94800818150166,NaN,NaN,15.41527274550692,11.117045680474146
2017-07-26T09:30:00-04:00,144.15,144.15,143.0483,143.25,13574876,19857200.55,58.7372883015161,56.42620331203908,NaN,NaN,132.76026553567505,143.26454369018728,0.1586788820605738,0.864688408813322,0.7060095267527482,3793946336,3789878684.4,66.94072536144091,50.86230269249997,NaN,NaN,15.75357828619991,11.779407481292111
2017-07-27T09:30:00-04:00,143.48,143.68,141.55,142.34,24355819,19820720.2,53.71895375396509,56.60390797375255,NaN,NaN,57.56918766246512,118.65808465823409,0.06781908930413727,0.7907833883829198,0.7229642990787826,3769590517,3785454736.4,64.34359634930036,52.764983219250425,NaN,NaN,14.531327504420071,12.172538913167534
2017-07-28T09:30:00-04:00,142.02,142.36,141.47,141.96,19933344,18877643.55,51.73136494573209,56.808931565918705,NaN,NaN,13.763158252054007,96.17651385905778,-0.023527097039630185,0.6935554277792448,0.717082524818875,3749657173,3781434012.4,61.989625635610224,54.643930083005195,NaN,NaN,12.929955513555836,12.280741284651578
2017-07-31T09:30:00-04:00,142.22,142.38,140.97,141.51,16417720,18558603.5,49.4003624787836,56.72910106529165,NaN,NaN,-10.24113666149846,74.43090216896496,-0.11480324088441662,0.5735784737133542,0.6883817145977709,3733239453,3770790938.2,56.135270610500235,56.23220040614681,NaN,NaN,10.902229002654915,12.083810958652055
2017-08-01T09:30:00-04:00,142.17,142.2,140.965,141.78,19835907,18901989.3,50.83191736029285,56.454005938413935,NaN,NaN,-7.074581312540339,37.355378695231046,-0.15504025940377064,0.4945813903430576,0.6496216497468282,3753075360,3759901767.8,50.8445278279554,57.3833604570449,NaN,NaN,9.606144293497454,11.729858577915683
2017-08-02T09:30:00-04:00,141.59,141.82,139.725,140.23,19934286,18805431.05,43.26454128898785,55.6061053187882,NaN,NaN,-78.50843108957017,-4.898360629817968,-0.27697243199757626,0.30340610974985793,0.5803785417474342,3733141074,3747740715.4,45.66783602513504,57.75967000384253,NaN,NaN,6.061896577974036,10.920149720781163
2017-08-03T09:30:00-04:00,140.44,140.54,139.16,139.53,19624901,18237046.2,40.34352679253463,54.48217815313007,NaN,NaN,-141.0676961471113,-44.62573739173324,-0.3888413680530321,0.09432683168114409,0.4831681997341762,3713516173,3736525846.6,41.47417285591175,57.50273933828718,NaN,NaN,2.1547526090585722,9.667950133392221
2017-08-04T09:30:00-04:00,139.91,140.32,139.49,140.21,16473509,18035171.5,44.27916172167291,53.544637104409084,NaN,NaN,-121.22597380947828,-71.62356380403969,-0.3995838837202053,-0.016311654916080442,0.38327222880412487,3729989682,3732592348.4,40.083830444802466,56.66764744046585,NaN,NaN,0.03422654154062253,8.29170390598485
2017-08-07T09:30:00-04:00,140.44,140.85,139.71,140.44,9176166,17633678.65,45.58673378647725,52.84473257097917,NaN,NaN,-100.41849492966786,-89.65903545767358,-0.3741863940293179,-0.08446076373252254,0.2897256302967954,3739165848,3733777627.4,40.72861618131714,55.62525375258729,NaN,NaN,-1.3204130227359205,6.918544344739026
2017-08-08T09:30:00-04:00,140.41,141.79,139.69,140,27248712,18186469.65,43.48444927701507,51.59264470555134,NaN,NaN,-93.8748678617962,-107.01909276752474,-0.36937341578092914,-0.17199113942936606,0.19738227635156308,3711917136,3725545982.6,37.6947076990784,54.14224201021222,NaN,NaN,-3.0710364675395487,5.4914613715563725
2017-08-09T09:30:00-04:00,139.12,139.39,138.28,138.79,26534308,18545254.55,38.25920781802292,49.94074964506134,NaN,NaN,-181.10212430933575,-127.53783141147787,-0.42601243919775833,-0.33513327264563486,0.09087916655212347,3685382828,3715994333.4,34.48470253587952,52.21949807945048,NaN,NaN,-6.250945524022327,3.813974672187987
2017-08-10T09:30:00-04:00,138.28,138.28,136.26,136.27,40983533,19766467.8,30.13702704035616,47.98326877546656,NaN,NaN,-230.23245076288137,-145.37078233463188,-0.600829446614963,-0.6601576417165802,-0.05932819510161727,3644399295,3702170957.8,30.444077110324955,49.96174931374548,NaN,NaN,-12.1971476558108,1.5266714824738745
2017-08-11T09:30:00-04:00,136.21,136.74,135.77,136.47,32779614,20632184.15,31.38208152203775,46.05307087290351,NaN,NaN,-202.05177064315134,-161.53594170136648,-0.6656004710871429,-0.8913287839605459,-0.22572831287340303,3677178909,3691608803.2,27.766925322523107,47.45875953969285,NaN,NaN,-16.405964160909548,-1.0351336094380428
2017-08-14T09:30:00-04:00,137.26,138.59,137.23,138.54,21710931,20949000.75,42.75351362125747,44.56500926490366,NaN,NaN,-109.7820321997606,-163.40864915538504,-0.5371453318127328,-0.8971599776393191,-0.36001464582658627,3698889840,3683553601.6,25.896582510810163,44.60679974789927,NaN,NaN,-16.188405444935665,-3.1998867287948456
2017-08-15T09:30:00-04:00,138.8,138.82,137.34,137.4,16645977,20948636.65,38.927445345346925,43.150020482320144,NaN,NaN,-105.27927327643796,-165.68953023831338,-0.49794404516779467,-0.9824447022863296,-0.48450065711853496,3682243863,3677618947,24.582785609144523,41.58123262273523,NaN,NaN,-17.34570216099347,-5.22071750482322
2017-08-16T09:30:00-04:00,137.67,138.39,137.21,137.44,21858645,21192296.3,39.13327155955345,42.10818603986217,NaN,NaN,-100.29804542652158,-149.52871446175055,-0.44030058193206645,-1.034876384533618,-0.5945758026015515,3704102508,3681362883,27.095581873067914,38.92066016014719,NaN,NaN,-18.16409190498881,-7.069770990561161
2017-08-17T09:30:00-04:00,136.98,137.69,134.9199,134.93,32722877,21976050.4,31.87404713323147,40.68980619611212,NaN,NaN,-143.30087383778863,-132.142399076732,-0.5358511939327875,-1.2643897950175358,-0.7285386010847483,3671379631,3686758950.2,30.680473212690387,36.68429212993864,NaN,NaN,-21.509538829678508,-9.132594967577925
2017-08-18T09:30:00-04:00,134.47,135.46,134.12,134.92,42401868,22998670.6,31.84869895662463,39.436115944529334,NaN,NaN,-151.5937893890604,-122.05080282591382,-0.5616464906516756,-1.4305967143993428,-0.8689502237476672,3628977763,3677118721,28.028792497311855,34.67668655042519,NaN,NaN,-24.05265129909521,-11.264031586366109
2017-08-21T09:30:00-04:00,134.69,135.02,134.14,134.83,21504100,23239174.05,31.605089729317484,38.062771113745384,NaN,NaN,-135.08860076636438,-127.1121165392346,-0.5461935822020281,-1.5516922015002024,-1.0054986192981743,3607473663,3658835485.6,23.82334437670376,32.746602018192924,NaN,NaN,-26.126884221828885,-13.387296248575076
2017-08-22T09:30:00-04:00,135.26,136.445,135.14,136.29,25170593,23444384.3,39.66722972615345,37.80582028782864,NaN,NaN,-88.59249107007817,-123.77476009796263,-0.40553490028410577,-1.5124172446533066,-1.1068823443692009,3632644256,3648915564.2,21.903112850405975,31.049121791426565,NaN,NaN,-25.364766905422837,-15.098363485267614
2017-08-23T09:30:00-04:00,135.53,136.57,135.207,136.07,18381856,23684733.3,38.92269667543512,37.704332422321535,NaN,NaN,-80.9891593003381,-119.91298287272593,-0.30006260487342296,-1.4819606004609795,-1.1818979955875566,3614262400,3630947542.6,18.927237050710758,29.43862637676935,NaN,NaN,-24.979291215636408,-16.509924589606012
2017-08-24T09:30:00-04:00,136.64,136.93,136.02,136.49,15726649,23253274.8,41.192036543013394,37.483823480988704,NaN,NaN,-58.7411346411113,-103.00103503339047,-0.18064627864577432,-1.4077058438947745,-1.2270595652490002,3629989049,3622669426.2,17.73192628962377,27.842061794256583,NaN,NaN,-23.985363359949336,-17.577844413940774
2017-08-25T09:30:00-04:00,136.88,137.31,136.42,136.88,17162964,23114755.8,43.29878205120425,37.32039835704064,NaN,NaN,-40.94579538454169,-80.87143623248673,-0.060252905694318404,-1.302375697366898,-1.2421227916725797,3647152013,3626304276.2,20.11745767196261,26.369836186445546,NaN,NaN,-22.545185311250876,-18.287464542127932
2017-08-28T09:30:00-04:00,137.37,137.61,136.77,137.46,16333269,23110533.25,46.37549716840416,37.52690177785414,NaN,NaN,-20.97811216870531,-58.04933851295491,0.06670432634970891,-1.1587423837354436,-1.2254467100851525,3663485282,3637506600,27.130491849957963,25.6152493400798,NaN,NaN,-20.42673536281006,-18.593074659368234
2017-08-29T09:30:00-04:00,136.49,137.81,136.23,137.49,20277565,23132616.15,46.53709124082913,38.11817916519744,NaN,NaN,-18.413548586367114,-44.0135500162127,0.15586860246685408,-1.030610957001585,-1.186479559468439,3683762847,3647730318.2,32.91866122091152,25.503389246153514,NaN,NaN,-18.644965790651284,-18.600487678122956
2017-08-30T09:30:00-04:00,137.36,138.51,137.25,138.37,15915526,22931678.15,51.18406148269852,39.621538768221896,NaN,NaN,27.549638096321093,-22.305790536880863,0.2705606054602647,-0.8482788026431081,-1.1188394081033728,3699678373,3664813512.8,41.307855834729764,26.279373440753854,NaN,NaN,-15.733615259141684,-18.190934475411346
2017-08-31T09:30:00-04:00,138.91,139.94,138.67,139.73,29260570,23413461.6,57.35345012394055,41.476636525500666,NaN,NaN,96.9192770477702,8.826291800895435,0.4252563650728376,-0.5872689517623257,-1.0125253168351633,3728938943,3684603491.6,49.22911473563458,27.812386970261816,NaN,NaN,-11.188039839487063,-17.19052095599359
2017-09-01T09:30:00-04:00,139.98,140.63,139.7256,140.52,17412507,23460411.5,60.47803203571684,42.74267355510491,NaN,NaN,135.816633966847,44.178777671173165,0.5595709833386285,-0.31306158766187764,-0.8726325710005062,3746351450,3704443379,55.68613851496031,29.940212399129685,NaN,NaN,-6.332709584177882,-15.639405045734204
2017-09-05T09:30:00-04:00,140.63,140.89,138.58,139.17,21908373,24097021.85,53.292404700984854,43.768742080507614,NaN,NaN,105.12561103833751,69.39952231258174,0.5362249267923043,-0.20235141251012578,-0.73857633930243,3724443077,3716634938,59.12620866150834,32.407599760012815,NaN,NaN,-4.257831139681896,-14.01346591629816
2017-09-06T09:30:00-04:00,139.74,140,139.08,139.46,18399672,23654569.85,54.54187929350465,44.869356918646986,NaN,NaN,110.3361676034738,95.14946555054992,0.518722856115963,-0.0901727691574763,-0.6088956252734393,3742842749,3728450918.4,62.18980681691574,34.9143301131448,NaN,NaN,-2.1972833223344224,-12.325439831446197
2017-09-07T09:30:00-04:00,139.59,139.685,138.59,139.11,18159823,23235845.6,52.70922201218318,46.35758369571497,NaN,NaN,88.44459743306075,107.32845741789785,0.46377559087249454,-0.029176136682821152,-0.4929517275553157,3724682926,3733451829,63.43883131814608,37.25421283496307,NaN,NaN,-1.0303984462816895,-10.711862490708409
2017-09-08T09:30:00-04:00,138.93,139.77,138.615,139.22,21870454,22280191.65,53.24099435971289,47.885604795935556,NaN,NaN,82.17358225314017,104.37931845897185,0.4165379165208325,0.027720668095724932,-0.38881724842510756,3746553380,3736974716.4,64.33268580347257,39.8473480711174,NaN,NaN,0.07516041648087073,-9.170859218252797
2017-09-11T09:30:00-04:00,140.39,140.92,140.23,140.68,22617670,21772094.45,59.71582764603382,49.89351464712958,NaN,NaN,132.57908624216415,103.73180891403527,0.4618132133117527,0.1884492682145833,-0.2733639450971694,3769171050,3741538636.4,65.50913921008443,42.82490484493031,NaN,NaN,3.062480926282889,-7.423239197604842
2017-09-12T09:30:00-04:00,141.04,141.69,140.82,141.54,22679587,21820527.25,62.968669288314004,51.557903187283905,NaN,NaN,142.92795216031422,111.2922771384306,0.5233572782501335,0.3808326527154975,-0.142524625534636,3791850637,3755020148.4,68.78450503028955,46.173575714921995,NaN,NaN,6.6347303388717,-5.414957835251051
2017-09-13T09:30:00-04:00,141.41,142.22,141.32,141.96,25052476,22240852.2,64.47725675408971,53.3832289071878,NaN,NaN,137.63169808387337,116.75138323451054,0.5625994411229176,0.560724675869011,-0.0018747652539065907,3816903113,3769832221.2,71.93763561866233,49.96003275548996,NaN,NaN,10.047922374509014,-3.20597494814247
2017-09-14T09:30:00-04:00,141.78,142.16,141.42,141.83,18353801,22065610,63.6134259101461,54.984756719125855,NaN,NaN,118.17724750441877,122.69791324878216,0.5494240717900689,0.6849053244836796,0.13548125269361067,3798549312,3784605498.4,74.68431009327202,54.02806017003627,NaN,NaN,12.592314661736928,-0.9490764324454135
2017-09-15T09:30:00-04:00,141.64,142.47,141.55,142.41,23184039,21588668.1,65.81401796145957,56.592987855572666,NaN,NaN,116.73290605271268,129.60977800869665,0.5481433761126239,0.8206604728343905,0.2725170967217666,3821733351,3799641492.6,77.13706880767299,58.10088953687272,NaN,NaN,15.415060156049215,1.3886573659109618
2017-09-18T09:30:00-04:00,142.62,143.8075,142.6,143.38,24427354,20689942.4,69.1719566182878,58.22130638770721,NaN,NaN,142.58963461977265,131.61188768421835,0.5780247268846584,0.9950480053275896,0.4170232784429312,3846160705,3815039423.6,79.34417169121835,61.830438096962745,NaN,NaN,18.924643809675267,3.8937982864487193
2017-09-19T09:30:00-04:00,143.57,143.6886,143.09,143.38,16346316,20432053.2,69.1719566182878,59.83808248609711,NaN,NaN,136.8864747217645,130.4035921965084,0.5626508456998935,1.120336835567798,0.5576859898679045,3846160705,3825901437.2,80.75550576603592,65.24735556447163,NaN,NaN,21.770219421441062,6.447572734304767
2017-09-20T09:30:00-04:00,143.53,144.02,143.26,143.84,20244658,20185756.45,70.7520252844161,61.23579418621979,NaN,NaN,130.29640166707853,128.93653291314945,0.547791516386202,1.242425385350657,0.694633868964455,3866405363,3835801887.2,81.96507525270914,68.15144266575588,NaN,NaN,24.659294243359007,9.04924723559823
2017-09-21T09:30:00-04:00,144.02,144.26,143.48,143.69,17395878,20136457.55,69.50107618292259,62.10348176186137,NaN,NaN,120.33253551581039,129.36759051542776,0.49385634621182006,1.31195430172923,0.81809795551741,3849009485,3845893921.8,83.12912215869471,70.57287176740303,NaN,NaN,26.74366024519395,11.577020522683332
2017-09-22T09:30:00-04:00,143.67,144.67,143.56,144.3,25203026,20610276.4,71.6929644552992,62.904548363260105,NaN,NaN,119.38411416388635,129.89783213766248,0.46563239274655,1.4001384464505975,0.9345060537040475,3874212511,3856389753.8,84.26649890339726,72.61432608086281,NaN,NaN,29.18878620661086,14.092987048958694
2017-09-25T09:30:00-04:00,144.27,144.94,143.69,144.5,30012818,21252769.1,72.39349986692635,64.2689123036845,NaN,NaN,113.51647935504234,124.08320108471642,0.4277767655079463,1.4692270105889804,1.0414502450810341,3904225329,3868002678.6,85.436389238378,74.49362469349636,NaN,NaN,31.445220353951775,16.57187752110056
2017-09-26T09:30:00-04:00,144.29,145.15,144.18,144.61,28238135,21848012.4,72.79231774923329,65.57251505052226,NaN,NaN,112.4009137946025,119.18608889928404,0.37915006675551965,1.5153878285254336,1.136237761769914,3932463464,3885263230.4,86.98538059922214,76.26473710651825,NaN,NaN,33.45603304636595,18.983899738995618
2017-09-27T09:30:00-04:00,145.63,147.86,145.16,147.44,66351679,24151718.1,80.56954354854886,67.56253801740552,NaN,NaN,168.5816905635373,126.84314667857579,0.4990412468367298,1.7600393203158262,1.2609980734790964,3998815143,3911745186.4,88.93065900668165,78.08558194141365,NaN,NaN,38.23946034819477,21.734694111738353
2017-09-28T09:30:00-04:00,147.25,148.06,146.78,147.83,29291396,24820511.6,81.3602863593747,69.57105887452423,NaN,NaN,167.7683597387833,136.33031152317037,0.5614187592040742,1.9627715224841893,1.401352763280115,4028106539,3947564597.2,90.90980022376333,79.98394725714869,NaN,NaN,42.34920210144135,24.679623824553065
2017-09-29T09:30:00-04:00,147.92,148.43,147.74,148.18,21738748,24444420.5,82.06567022404695,71.16747620152516,NaN,NaN,160.60665388947342,144.57481946828779,0.580645593132761,2.1271597546960663,1.5465141615633053,4049845287,3982691152.4,92.35361920381995,81.9014101138441,NaN,NaN,45.91640126696324,27.713449173468803
2017-10-02T09:30:00-04:00,148.31,150,148.08,150,29772446,25062417.45,85.20173552289786,72.7555523611383,NaN,NaN,171.8662837103865,156.24478033935662,0.6643070724309295,2.3768980021019672,1.7125909296710378,4079617733,4017769633.2,93.46918809046385,83.6646017609994,NaN,NaN,50.298389780131615,30.93986926013492
2017-10-03T09:30:00-04:00,150.11,150.33,149.33,150.33,28372757,25385636.65,85.69033897059633,74.27077251946021,NaN,NaN,165.51815937782084,166.86822945600028,0.6873668568694595,2.5717995007578622,1.8844326438884027,4107990490,4052875038.4,94.35655400279563,85.26595307415178,NaN,NaN,53.933328859548624,34.2246492029083
2017-10-04T09:30:00-04:00,150.09,150.61,149.39,149.85,22024675,25566886.8,81.47638788417399,75.54669837474789,NaN,NaN,141.87317001955142,161.5265253472031,0.6179748852159945,2.6569012504083958,2.0389263651924012,4085965815,4070305172.8,94.73879085904427,86.69841598599267,NaN,NaN,55.57512826412797,37.2747176402254
2017-10-05T09:30:00-04:00,150.29,150.63,149.87,150.26,22538502,25785820.75,82.278058968614,76.72270130383036,NaN,NaN,127.9174324940701,153.55633989826046,0.5496628167819564,2.7260048861698465,2.17634206938789,4108504317,4086384728.4,95.07049399410545,87.9793749278807,NaN,NaN,57.164666301531305,40.11613887755481
2017-10-06T09:30:00-04:00,149.71,150.34,149.57,150.05,19350771,25659836.6,80.35970391598845,77.52182611080899,NaN,NaN,105.75975145588471,142.58695941154275,0.4447888979605259,2.7323281918385476,2.2875392938780217,4089153546,4094246380.2,95.22887717235717,89.11399674796203,NaN,NaN,57.89544301255242,42.65603946826875
2017-10-09T09:30:00-04:00,150.19,150.68,149.18,149.43,13981340,25228020.1,74.81366442028607,77.92480523952315,NaN,NaN,89.32345346988916,126.07839336344327,0.295317377722351,2.65668601603096,2.361368638308609,4075172206,4093357274.8,94.85768202659804,90.12129505228789,NaN,NaN,56.87288121939247,44.68701686128642
2017-10-10T09:30:00-04:00,149.93,150.29,149.41,149.86,21951851,25191633.3,76.04830982636258,78.3031112782336,NaN,NaN,82.33695409642255,109.44215230716361,0.1920639479642965,2.60144857326398,2.4093846252996833,4097124057,4091183988.2,93.89425004319725,90.97337896589418,NaN,NaN,56.357557190265375,46.35423690828342
2017-10-11T09:30:00-04:00,149.94,150.19,149.46,149.75,15137112,24695865.1,75.03498203178593,78.69839026743814,NaN,NaN,74.12670646620865,95.89285959649507,0.0882925462826023,2.519750308152936,2.431457761870334,4081986945,4090388214.2,93.51970065979124,91.71556314454394,NaN,NaN,55.64789452303964,47.68190228182002
2017-10-12T09:30:00-04:00,149.46,150.01,149.02,149.64,17185574,24637453.75,73.97347929527511,78.86128418457928,NaN,NaN,62.700879084376744,82.84954891455638,-0.01056487838849307,2.4182516638847176,2.4288165422732106,4064801371,4081647625,89.30578973205951,92.07551248944837,NaN,NaN,54.76711121215574,48.694074986153694
2017-10-13T09:30:00-04:00,149.92,149.99,149.23,149.37,15464432,24251473.4,71.30695829132281,78.78367407203616,NaN,NaN,56.971610078901456,73.09192063915974,-0.11134679462941222,2.2896330489864454,2.4009798436158576,4049336939,4073684303.6,85.52474137910329,92.08182335664306,NaN,NaN,53.294518761651766,49.35128123979628
2017-10-16T09:30:00-04:00,149.61,150.35,149.03,149.24,20653103,24062760.85,69.99861213213933,78.58412367081517,NaN,NaN,52.61749541997613,65.75072902917712,-0.19886353551657976,2.152400424220133,2.3512639597367126,4028683836,4064386629.6,81.2019542368928,91.66872147361951,NaN,NaN,51.7002158803365,49.68684333130202
2017-10-17T09:30:00-04:00,149.27,149.77,148.5,148.81,18046820,24147786.05,65.70429328076416,77.52232008025912,NaN,NaN,33.1105354611035,55.90544530211332,-0.2921701982312017,1.9860512119477107,2.2782214101789124,4010637016,4047089221.4,73.73509867671392,90.58332430719325,NaN,NaN,49.1417419364276,49.60897170346282
2017-10-18T09:30:00-04:00,149.5,149.91,149.08,149.52,20541658,24162636.05,69.07757756859974,76.6449837380609,NaN,NaN,44.12592104510696,49.90528821789299,-0.31079653060252,1.8897257469257625,2.2005222775282824,4031178674,4036927567.2,69.68135823841985,89.06700702252586,NaN,NaN,47.7119980668503,49.33797546966103
2017-10-19T09:30:00-04:00,148.77,149.33,148.17,149.29,17164885,24151086.4,66.78590700701986,75.55357207970182,NaN,NaN,16.863780434575794,40.7378684879328,-0.34091849141932773,1.774374163254123,2.1152926546734507,4014013789,4026770050.8,65.78790018553374,87.16945566407684,NaN,NaN,45.86752343640866,48.84219660776784
2017-10-20T09:30:00-04:00,150.31,150.4134,149.86,149.98,25224483,24152159.25,70.00122910985462,74.46782162162731,NaN,NaN,65.9970715647873,42.54296078510996,-0.31717737356329767,1.7188209377193289,2.0359983112826265,4039238272,4024750317.4,65.01005950130488,85.1366607648512,NaN,NaN,45.094019862554376,48.30674278702306
2017-10-23T09:30:00-04:00,150.15,150.15,148.7,148.86,14676363,23385336.5,59.86994362726268,72.62350766853206,NaN,NaN,11.479151065793966,34.31529191427352,-0.37570753024196013,1.5663638984801764,1.9420714287221366,4024561909,4023925932,64.67393910182079,83.01647398621013,NaN,NaN,41.23831630945078,47.29696757594131
2017-10-24T09:30:00-04:00,149.39,149.78,149.0401,149.17,17527726,22849816.05,61.52958448984091,71.19873599750827,NaN,NaN,2.1937108820359867,28.131926998460017,-0.3906199076914443,1.4537965441078313,1.8444164517992756,4042089635,4030216455.8,66.11366592850379,80.97182220545724,NaN,NaN,38.53117546810854,46.044711560536626
2017-10-25T09:30:00-04:00,148.94,149,147.22,148.45,27235302,20893997.2,55.76146786234385,69.30469377563182,NaN,NaN,-146.61042552698945,-10.01534231595928,-0.44225366661771615,1.2915993685271303,1.7338530351448465,4014854333,4026951587.6,64.64115834082443,78.7982982302229,NaN,NaN,34.37624959837757,44.377788423085335
2017-10-26T09:30:00-04:00,148.94,149.34,148.51,148.76,15205927,20189723.75,57.604299854971785,67.67930777127349,NaN,NaN,-85.8190502461598,-30.551908452106403,-0.44745676978147886,1.174532072917998,1.6219888426994769,4030060260,4030160881.8,65.45562296964457,76.67163721574342,NaN,NaN,31.47623227416619,42.534708973239745
2017-10-27T09:30:00-04:00,148.88,149.91,148.3,149.79,32744061,20739989.4,63.10384045666403,66.84289177387191,NaN,NaN,-30.813927176938336,-49.91410820045153,-0.3763167197207484,1.1515929430485414,1.5279096627692899,4062804321,4034874091.6,66.66985942707338,74.65822131577737,NaN,NaN,30.595320464678093,40.829082043445226
2017-10-30T09:30:00-04:00,149.27,149.45,147.385,148.21,30524847,20777609.45,51.96753227505011,65.12283623449245,NaN,NaN,-169.80213579880274,-86.17036557337087,-0.4267619398479272,0.9944572379593808,1.421219177807308,4032279474,4036417604.6,67.07798194284496,72.74277359432362,NaN,NaN,25.88314385654695,38.69394801674547
2017-10-31T09:30:00-04:00,148.79,149.83,148.635,149.26,22449361,20481439.65,57.35374217352183,63.859890530330745,NaN,NaN,-27.849538549197778,-92.17901545961763,-0.38195689740851346,0.9437730560466662,1.3257299534551796,4054728835,4038945444.6,67.77394239615433,70.90379086120672,NaN,NaN,23.826193820165727,36.5699831315198
2017-11-01T09:30:00-04:00,150.5,150.53,147.44,148.27,31585535,20959482.65,51.49088506116693,62.25399094218015,NaN,NaN,-94.93540633628753,-81.84401162147724,-0.4091170672149693,0.8143336194364679,1.2234506866514372,4023143300,4040603238,68.24800386141902,69.39966329901812,NaN,NaN,20.02707352371084,34.206710330404235
2017-11-02T09:30:00-04:00,148.24,149.23,147.72,148.71,28176568,21241385.95,53.75358908478158,61.00017885599864,NaN,NaN,-112.09754318049058,-87.0997102083434,-0.3877681370666817,0.738740515318085,1.1265086523847667,4051319868,4044855159.6,69.48777323602648,68.25416557451264,NaN,NaN,17.802781503628427,31.86329192657912
2017-11-03T09:30:00-04:00,148.48,148.96,148.06,148.61,22312722,21389483.5,53.146833476536465,59.796480380598446,NaN,NaN,-100.42340085343496,-101.02160494364271,-0.3707115254797222,0.663119245535114,1.0338307710148362,4029007146,4038095724.6,65.13379658393079,67.1064400278725,NaN,NaN,15.876780599180185,29.579504594093557
2017-11-06T09:30:00-05:00,148.75,149.38,148.39,148.78,15576775,21469255.25,54.09546067065003,58.967278051304575,NaN,NaN,-47.25346572101305,-76.51187092808479,-0.33916369599051155,0.6098761510266968,0.9490398470172083,4044583921,4040556614,65.96980100209102,66.55177590825657,NaN,NaN,14.61613574090587,27.4418804722096
2017-11-07T09:30:00-05:00,148.8,148.85,146.54,147,29549299,21849127.65,44.040796833850656,57.178936570251075,NaN,NaN,-218.33804919541788,-114.60957305732879,-0.4238582629893848,0.4192170182804773,0.8430752812698621,4015034622,4032617771.4,60.89698097349238,65.92432038933318,NaN,NaN,10.023239065344265,24.953503128371697
2017-11-08T09:30:00-05:00,146.66,147.45,145.835,147.2,30682450,22626394.55,45.27167083318788,55.642205414977354,NaN,NaN,-247.01242226399623,-145.02497624287054,-0.4496464498862798,0.28101721891201237,0.7306636687982921,4045717072,4037132525.8,62.6556758823355,65.70059008196188,NaN,NaN,6.798050277686272,22.359867006845207
2017-11-09T09:30:00-05:00,146.27,147.39,145.28,146.68,40223140,23778272.85,42.6452132127166,53.68820427946749,NaN,NaN,-226.640293989962,-167.93352640476482,-0.48208528230668934,0.1280570659149305,0.6101423482216198,4005493932,4027967338.6,57.046475816576105,65.13176267590981,NaN,NaN,3.301657096239087,19.637265591044333
2017-11-10T09:30:00-05:00,146.71,147.1,146.345,146.57,17823700,23896236.25,42.088942856348325,52.418132795830765,NaN,NaN,-167.54280936650633,-181.35740810737911,-0.4897281012592697,-0.002017778352467303,0.4877103229068024,3987670232,4019699955.8,52.48227683758802,64.26092965703604,NaN,NaN,0.3286620556333712,16.878893657414196
2017-11-13T09:30:00-05:00,145.93,146.825,145.5,146.61,14679965,23597579.35,42.38326049784669,51.050538224974034,NaN,NaN,-162.22084416794758,-204.35088379676603,-0.47073977117296045,-0.10071439105939817,0.3700253801135623,4002350197,4011253211,48.235957397929205,62.98395047628071,NaN,NaN,-2.003043937300612,14.181474001026366
2017-11-14T09:30:00-05:00,146.06,146.49,145.59,146.21,19682236,23679350.15,40.18392329169111,49.937856469927404,NaN,NaN,-146.77397361342454,-190.03806868036733,-0.46306181336037916,-0.20880188658691168,0.2542599267734675,3982667961,4004779878.8,45.216557121711546,61.59647896062978,NaN,NaN,-4.619162774489263,11.495668747381277
2017-11-15T09:30:00-05:00,145.35,146.21,144.5,145.63,23925205,23848527.5,37.17185780038311,48.47839632317107,NaN,NaN,-155.54926639765077,-171.74543750709827,-0.47330723695319776,-0.33737411941802975,0.135933117535168,3958742756,3987385015.6,38.28195291818666,59.65550252838279,NaN,NaN,-7.77012089148502,8.743413084686091
2017-11-16T09:30:00-05:00,146.21,148.4,146.19,147.77,25888988,24284732.65,51.590212719747825,47.65599434196277,NaN,NaN,-32.463124931242945,-132.91000369535442,-0.31958679822556146,-0.2635503802467838,0.05603641797877765,3984631744,3983212578,36.82314348280212,57.523594246649125,NaN,NaN,-6.078429341027032,6.626007023869931
2017-11-17T09:30:00-05:00,147.25,149.03,147.171,148.45,25816709,24314343.95,55.11507249427396,47.8808186433359,NaN,NaN,19.32460892011953,-95.53652003802925,-0.16359939916600588,-0.1484628309787297,0.015136568187276177,4010448453,3987768222.2,39.532529655130084,55.55606194038378,NaN,NaN,-3.4967892122692525,5.179893275850048
2017-11-20T09:30:00-05:00,148.76,149.58,148.33,149.53,22793043,24720177.95,60.08595948917155,48.075977023025175,NaN,NaN,78.54241279104008,-47.38386864623173,0.011531711146128547,0.029551207119936862,0.018019495973808315,4033241496,3993946482,43.09664555286954,53.79339788014915,NaN,NaN,0.42957715985601114,4.5012766878509005
2017-11-21T09:30:00-05:00,150.2,151.29,150.06,151.09,29392343,25313408.8,65.95160177522607,49.10888535974368,NaN,NaN,169.8106421622398,15.933054508901142,0.22008726213319546,0.29312857364030265,0.07304131150710719,4062633839,4009939657.6,51.12727829919162,52.57048891141863,NaN,NaN,6.012359202085865,4.717145618455896
2017-11-22T09:30:00-05:00,151.28,151.77,150.86,150.89,14136608,24658474.1,64.6400612322947,49.886490513137474,NaN,NaN,165.03817869471487,80.05054352737427,0.3258390666832987,0.48034014486123056,0.15450107817793185,4048497231,4027890552.6,58.249418373966954,51.76774927841437,NaN,NaN,9.869206449712278,5.453154308635379
2017-11-24T09:30:00-05:00,151.21,151.37,150.77,150.95,6814364,24238895.95,64.86579288829199,50.72355904254859,NaN,NaN,141.27787525302568,114.79874356422802,0.37746172971428504,0.6263282403207882,0.2488665106065031,4055311595,4042026522.8,62.84165770930703,51.60402507308411,NaN,NaN,12.95088775231623,6.524259086304072
2017-11-27T09:30:00-05:00,151.3,151.62,150.44,150.49,18416900,23522537.9,61.61806038687803,51.26088759370772,NaN,NaN,122.02546210050356,135.33891420030483,0.3584056533784755,0.6968735773295975,0.338467923951122,4036894695,4047315771.2,64.41867733508903,51.493230525441106,NaN,NaN,14.520122271013378,7.666525255548258
2017-11-28T09:30:00-05:00,151.02,152.97,150.66,152.86,35898267,23791208.9,69.9625951194181,53.1124446141054,NaN,NaN,156.60594549175443,150.9516207404477,0.47583557311443725,0.9332623903441686,0.45742681722973133,4072792962,4055226064.4,66.6951947002041,51.907388648777655,NaN,NaN,19.00634944666755,9.286500139993871
2017-11-29T09:30:00-05:00,153.34,154.21,152.95,153.37,38234167,24580449.2,71.40337142272435,54.97899465621515,NaN,NaN,179.15114281692172,152.81972087138408,0.5528710203550868,1.14851559267359,0.5956445723185031,4111027129,4064904722.4,69.28466746245954,52.380888047357935,NaN,NaN,23.05324326855056,11.253177729787684
2017-11-30T09:30:00-05:00,154.1,154.55,153.281,153.65,32230663,24612705.6,72.19200694211341,57.08947992260063,NaN,NaN,156.01922193561606,151.0159295195643,0.5846115017994995,1.3264089495678775,0.741797447768378,4143257792,4083856834.6,73.61129649116336,53.56408952411417,NaN,NaN,26.51165205849726,13.432959776746195
2017-12-01T09:30:00-05:00,153.67,153.71,148.75,153.02,62734781,26340616.25,67.67006195693918,58.91670271549999,NaN,NaN,81.09965842710643,138.98028615438048,0.5268915657647419,1.4004119049743053,0.8735203392095634,4080523011,4088899117.8,74.63502132461397,55.1464284160446,NaN,NaN,27.963294456462627,15.508721873848542
2017-12-04T09:30:00-05:00,154.9,155.41,152.3,152.45,36366775,27043318.9,63.77760891821712,60.44487045981216,NaN,NaN,110.50049234438089,136.67529220315595,0.4187535149864283,1.3969622329425988,0.9782087179561705,4044156236,4090351426,74.93661425827027,57.053618191783244,NaN,NaN,27.962597176488902,17.287846917082877
2017-12-05T09:30:00-05:00,152.95,152.96,150.92,150.93,29667221,27747841.2,54.7358648899052,61.4842948596846,NaN,NaN,55.6208345808772,116.47827002098047,0.22310193736693185,1.2570861396648354,1.0339842022979036,4014489015,4078690636.6,67.95053678054893,58.6774738817002,NaN,NaN,24.96214465261391,18.384175165015883
2017-12-06T09:30:00-05:00,150.82,151.19,149.95,150.22,21273789,27334065.7,51.092203173434534,62.478605243473986,NaN,NaN,21.644360738735358,84.97691360534321,0.03403876878802348,1.0765326632829328,1.0424938944949094,3993215226,4055128256,56.490398293723025,59.97807712280994,NaN,NaN,21.294284442679963,18.799905061825037
2017-12-07T09:30:00-05:00,150.32,151.89,150.02,151.27,29675223,27283704.35,55.78030895409883,62.77789783164191,NaN,NaN,34.06131688306638,60.58533259483327,-0.028742401854252808,1.0065658921770932,1.035308294031346,4022890449,4031054787.4,47.64841622310491,60.75131088997443,NaN,NaN,19.706660060109453,18.929441490151383
2017-12-08T09:30:00-05:00,151.89,152.28,151.28,151.41,20832438,26314169.25,56.38068255616188,62.86829855034819,NaN,NaN,46.968266019763384,53.759054113364655,-0.06708993429892329,0.9514458761576918,1.0185358104566151,4043722887,4023694762.6,45.3132106440637,61.16421667489825,NaN,NaN,18.638685864465955,18.88790497219632
2017-12-11T09:30:00-05:00,151.68,152.13,151.02,151.35,26654053,26755686.9,56.02958228307871,62.57855732134156,NaN,NaN,38.2495618969147,39.3088680238714,-0.1007233158949159,0.8926316655879702,0.9933549814828861,4017068834,4018277282.2,43.61867062596094,61.201504180119066,NaN,NaN,17.680091914288106,18.715360249638003
2017-12-12T09:30:00-05:00,151.7,151.93,150.82,150.88,25854822,27314429.75,53.23308889912208,61.67009211590557,NaN,NaN,23.208239555697904,32.82634901883554,-0.15557451498151953,0.7988868377559868,0.9544613527375063,3991214012,4013622281.6,42.159748593757485,60.56096634401663,NaN,NaN,16.05975016649825,18.33598738061804
2017-12-13T09:30:00-05:00,150.81,152.71,150.81,151.78,30082614,27834448.65,57.59742307580132,61.1670465332989,NaN,NaN,41.18557238771329,36.73459134863113,-0.1330644553010496,0.7881307836111944,0.921195238912244,4021296626,4019238561.6,44.56870199672625,59.583772317070874,NaN,NaN,15.919855837307034,17.99082573157361
2017-12-14T09:30:00-05:00,151.85,152.2,149.64,150.1,32882639,28282320.35,48.49904546153437,59.997993145673355,NaN,NaN,-31.94197375953523,23.533933220110807,-0.2275921637263283,0.6367050342543337,0.864297197980662,3988413987,4012343269.2,42.24255566344469,58.11240788522356,NaN,NaN,12.840498224442731,17.255064659126344
2017-12-15T09:30:00-05:00,151.05,153.2525,150.58,152.24,42851606,29130451.25,57.67145469116298,59.716092738836565,NaN,NaN,45.07210787158523,23.154701590475174,-0.14621937476487135,0.6815229795245727,0.8277423542894441,4031265593,4009851810.4,41.40171997765661,56.468339502549824,NaN,NaN,13.26016254516436,16.684364357131773
2017-12-18T09:30:00-05:00,153.67,154.72,153.46,154.3,22714348,28975333.2,64.26860329957722,59.30937903741937,NaN,NaN,180.10496850093415,51.525782911279066,0.036366592566932754,0.8732005949981101,0.8368340024311773,4053979941,4017234031.8,44.901333438740814,54.91163512673102,NaN,NaN,16.107874969567206,16.602008730336834
2017-12-19T09:30:00-05:00,154.75,154.77,152.82,153.08,24313555,29051358.8,58.45772077180394,58.38468970521077,NaN,NaN,118.59400769776818,70.60293653969312,0.06341473701704481,0.9161024237024833,0.8526876866854385,4029666386,4024924506.6,48.361220699758526,53.41710321510951,NaN,NaN,16.251734682879963,16.55196958070014
2017-12-20T09:30:00-05:00,153.75,153.935,152.84,153.38,19042817,28533882.5,59.42913313991981,57.47305586219694,NaN,NaN,92.35843398561737,80.83750885927392,0.08841519291593458,0.9632066778303567,0.8747914849144222,4048709203,4030407022,50.73620171609767,51.78316787403339,NaN,NaN,16.69509127776927,16.5724155374243
2017-12-21T09:30:00-05:00,153.24,154.0199,153.08,153.47,16772605,28665682.35,59.73333711516619,56.90614694492744,NaN,NaN,88.81322719028154,104.98854904923728,0.09721840658083025,0.99631449314046,0.8990960865596297,4065481808,4045820586.2,56.75765487933903,50.50621312794233,NaN,NaN,17.13516821896701,16.652808777644687
2017-12-22T09:30:00-05:00,153.38,153.39,152.8,153.19,13599369,29004932.6,58.26950216941017,56.51271074858409,NaN,NaN,55.542033501437054,107.08253417520766,0.07157390757284443,0.9885634710256852,0.9169895634528408,4051882439,4049943955.4,58.228566663878325,49.31278115691434,NaN,NaN,17.045102520505527,16.70885074091052
2017-12-26T09:30:00-05:00,153,153.43,152.9,153.28,11949550,28681565.1,58.620520276548355,56.79018613334432,NaN,NaN,53.51456895912904,81.76445426684663,0.04913198083740167,0.9784045394995928,0.9292725586621912,4063831989,4051914365,58.94720290828851,48.66968588032431,NaN,NaN,17.073325447463116,16.76091855613232
2017-12-27T09:30:00-05:00,153.21,153.95,152.81,153.13,15949851,27684144.3,57.748651283114626,57.265646712607186,NaN,NaN,54.05029672828834,68.85571207295067,0.014445586202271099,0.94732954141503,0.9328839552127589,4047882138,4055557515.4,60.30692378763136,48.9422948441749,NaN,NaN,16.85600160004265,16.77450184811951
2017-12-28T09:30:00-05:00,153.24,153.75,153.015,153.73,10167342,26280803.05,60.29265140427245,57.58795688761959,NaN,NaN,66.79047182122967,63.74211964007312,0.02173323787599213,0.960050502557749,0.9383172646817569,4058049480,4057425570.8,61.019855273922516,49.89739763351902,NaN,NaN,17.372383401031232,16.85991349853547
2017-12-29T09:30:00-05:00,154.15,154.15,152.39,152.46,21006483,25719594.05,53.01616070014502,57.34763389790409,NaN,NaN,39.61543785305757,53.902561772628324,-0.06444118792369402,0.8577657797771394,0.9222069677008334,4037042997,4051737808.6,57.626040175028,50.776885457159324,NaN,NaN,15.701301402293854,16.694397484786666
2018-01-02T09:30:00-05:00,153.2,153.97,152.46,153.9,20489647,23607337.35,59.05074133234341,57.56343097285157,NaN,NaN,62.34267481940371,55.26269003622167,-0.03158568397717765,0.8827248627293613,0.914310546706539,4057532644,4052867849.6,58.12436878800821,51.81300675444841,NaN,NaN,16.07018876781852,16.605224810934075
2018-01-03T09:30:00-05:00,153.87,154.46,153.5199,154.06,21836626,22880829.9,59.67055761830032,58.02325016707859,NaN,NaN,94.4500340310986,63.449783050615565,-0.007461485390428568,0.9049836899685033,0.9124451753589319,4079369270,4055975305.8,59.53367710454156,53.05400164807585,NaN,NaN,16.551405031406894,16.59753627100162
2018-01-04T09:30:00-05:00,154.97,155.15,154.02,154.47,14072053,22101071.5,61.287579237561935,58.28683275006149,NaN,NaN,115.67298313618461,75.77432033219483,0.02589689198598033,0.9448162903414072,0.9189193983554269,4093441323,4065087142.8,63.42109280684925,54.40060099165606,NaN,NaN,17.42378048818899,16.715571159171244
2018-01-05T09:30:00-05:00,154.88,154.98,153.94,154.79,19983854,22036574.75,62.549696637561524,59.29045069120629,NaN,NaN,112.34065813245503,84.88435759443989,0.057491758468973364,0.9907840964416437,0.9332923379726703,4113425177,4076162282.2,67.50697072598378,56.20520206755172,NaN,NaN,18.511556937548008,16.97214055608221
2018-01-08T09:30:00-05:00,154.73,155.27,153.5,155.03,18457323,21475679.75,63.51056201699873,59.70752978590885,NaN,NaN,110.30379965460452,99.02202995474929,0.08108858692741294,1.0346530716319364,0.9535644847045235,4131882500,4095130182.8,73.05763671654216,58.46633897747211,NaN,NaN,19.68880795669472,17.360235899026854
2018-01-09T09:30:00-05:00,155.24,155.5,154.73,154.82,16571253,21262620.5,62.01132278700558,59.5462954635823,NaN,NaN,131.93559213203423,112.94061341727539,0.06953264935004189,1.0404802963920758,0.970947647042034,4115311247,4106685903.4,75.77293839126571,60.67145361693817,NaN,NaN,20.283283154023472,17.777814078312087
2018-01-10T09:30:00-05:00,154.47,155.17,153.92,154.84,18516753,20855755.5,62.103076641902774,59.80667802573221,NaN,NaN,99.15480602542564,113.8815678161408,0.05106900409191795,1.0347839021569314,0.9837148980650134,4133828000,4117577649.4,78.02131594667961,62.79003184886111,NaN,NaN,20.80420848953587,18.21015613705834
2018-01-11T09:30:00-05:00,155.07,157.66,154.98,157.5,26522383,20889133.55,71.84362177281214,60.69342721379595,NaN,NaN,223.68174562148425,135.48332031320072,0.1976058721663123,1.2307222382729037,1.0331163661065914,4160350383,4130959461.4,80.4249752977967,64.91065853326818,NaN,NaN,24.468804909303692,19.104248818807676
2018-01-12T09:30:00-05:00,157.68,158.8599,157.47,158.16,24089801,20589492.9,73.65310956385707,61.687696674416735,NaN,NaN,259.2501863959797,164.86522596590567,0.3117944492517086,1.4228594276712272,1.1110649784195186,4184440184,4145162462.8,82.60002749680207,66.7565422916584,NaN,NaN,28.10352041959046,20.38985904749093
2018-01-16T09:30:00-05:00,158.86,159.41,155.8,156.14,27704736,20330597.75,60.77882060603487,61.86693370560421,NaN,NaN,169.91394176887516,176.78725438875978,0.2279798086864857,1.3960397392776258,1.16805993059114,4156735448,4150133052.4,83.29940517238155,68.5473164708372,NaN,NaN,27.025690726379064,21.337835001617805
2018-01-17T09:30:00-05:00,156.8,157.935,156.28,157.62,18571607,19116597.8,65.53256820994602,62.360651415132615,NaN,NaN,155.03131105376568,181.40639817310608,0.2472965004754779,1.4771805561854876,1.2298840557100097,4175307055,4162132214,84.87941397177202,70.39961726108602,NaN,NaN,27.788374688779165,22.259340671212286
2018-01-18T09:30:00-05:00,157.22,157.5,156.39,156.54,17903632,18876062,59.833467085976146,62.50956682962272,NaN,NaN,109.08166964694873,183.3917708974107,0.1663044423744675,1.4377646086780942,1.2714601663036267,4157403423,4166847298.6,85.46147843019034,72.19637116412595,NaN,NaN,26.402648513674105,22.851241791563975
2018-01-19T09:30:00-05:00,156.73,158.69,156.55,158.6,31040932,19212430.85,65.92127167279055,62.911611134516875,NaN,NaN,137.64366296536318,166.18415436618648,0.22669496358791963,1.5548288707885263,1.3281339072006066,4188444355,4172466093,86.14589312650344,73.99108815359601,NaN,NaN,27.443934603069458,23.507340764636186
2018-01-22T09:30:00-05:00,158.4,159.45,158.31,159.45,12702360,18895408,68.07162377804504,63.987001354366875,NaN,NaN,153.9894180396678,145.1320006949241,0.2947995186702561,1.6966333055384268,1.4018337868681707,4201146715,4175807399.2,86.55134177514117,76.05718112503266,NaN,NaN,29.030143393799534,24.296312568802378
2018-01-23T09:30:00-05:00,159.24,160.3,158.67,159.96,16904622,18902008.85,69.32241078060613,64.72069202924278,NaN,NaN,146.97669475774524,140.54455129269815,0.3417990139882219,1.8290825543534481,1.4872835403652263,4218051337,4188070577,87.94568960691967,78.18727546924062,NaN,NaN,30.69569737860049,25.210510398773536
2018-01-24T09:30:00-05:00,160.36,160.625,158.4,158.97,20340878,19239084.3,64.07500244627965,65.0352952312413,NaN,NaN,118.37737814536183,133.21376471101735,0.2766009506930571,1.8330347287315476,1.5564337780384905,4197710459,4192551257.8,88.41818173709883,80.25045437156614,NaN,NaN,30.31387858176171,25.939562996343277
2018-01-25T09:30:00-05:00,159.64,159.915,158.21,159.03,20290883,19656150.95,64.25161775122277,65.24701226793137,NaN,NaN,97.58838861908747,130.9151085054451,0.21087553899104017,1.8200282017772906,1.6091526627862505,4218001342,4204670841.6,89.60505117744133,82.12073711232271,NaN,NaN,30.07085130279255,26.529747040121745
2018-01-26T09:30:00-05:00,159.53,159.685,158.77,159.6,16120307,19664673.75,65.96354084516071,65.49085828275987,NaN,NaN,97.81787787827878,122.94995148802823,0.18033141074944892,1.8345669262230615,1.6542355154736126,4234121649,4213806300.4,90.40336308353073,83.75619370929037,NaN,NaN,30.387624643687527,27.080872412059712
2018-01-29T09:30:00-05:00,159.06,159.86,158.62,158.7,18293263,20070969.8,60.99663347464494,65.31129195830604,NaN,NaN,81.6993207276598,108.49193202562665,0.07921642550599262,1.7532560473561034,1.6740396218501108,4215828386,4216742634.6,90.65186794721096,85.01292451148097,NaN,NaN,29.139739348981568,27.374996260191406
2018-01-30T09:30:00-05:00,157.66,158.22,156.73,157.18,24533792,20247335.25,53.649267699273246,64.71400230918229,NaN,NaN,18.50463523458678,82.79752012099496,-0.10057789293502806,1.5483172556813258,1.648895148616354,4191294594,4211391286,86.26751450185446,85.76253709080876,NaN,NaN,25.6713795265295,27.131622441096848
2018-01-31T09:30:00-05:00,157.74,158.42,155.9199,156.36,26181042,20531905,50.1403883461848,63.85952457377387,NaN,NaN,-6.790144192282914,57.76401565346602,-0.27536017584836214,1.304694928805901,1.5800551046542632,4165113552,4204871904.6,81.12014496721832,85.98388202084723,NaN,NaN,21.6647360137941,26.350638665767885
2018-02-01T09:30:00-05:00,155.73,157.21,155.53,156.85,21412980,20510722.7,52.15418451277624,62.45313619805702,NaN,NaN,-30.34212149244842,32.1779136311588,-0.35360989476637283,1.1380427361962973,1.49165263096267,4186526532,4198576942.6,76.38105326789409,85.69503044728276,NaN,NaN,18.994896008191855,25.299818286114167
2018-02-02T09:30:00-05:00,156.13,156.15,153.51,153.83,33314082,21472824.15,41.12851053697364,60.129950553279635,NaN,NaN,-124.0600253953624,-12.197667023569437,-0.5904469446733354,0.7535939501210009,1.3440408947943363,4153212450,4182395102.8,65.7477804174914,84.49129851304629,NaN,NaN,12.52309155742852,23.474571610587645
2018-02-05T09:30:00-05:00,152.67,153.79,147.86,147.92,52622248,23104743.85,28.452115360587797,57.820900178604845,NaN,NaN,-278.67765500899696,-84.27306217090079,-1.0973553721972082,-0.027653320452174057,1.0697020517450342,4100590202,4159347466,54.17882637762261,82.41125717056352,NaN,NaN,0.3678856107486177,20.173616467753497
2018-02-06T09:30:00-05:00,145.53,150.37,144.24,149.69,69232423,25643498.85,34.921470431749356,55.63439319444793,NaN,NaN,-269.3648356045342,-141.84695633872497,-1.2543455766770264,-0.4982299191012487,0.7561156575757776,4169822625,4155053072.2,52.33111909328066,80.08637896495698,NaN,NaN,-6.071857305952774,16.424263071509746
2018-02-07T09:30:00-05:00,149.61,150.79,148.61,149.84,37100959,26669984.15,35.45411247394141,53.89301072215974,NaN,NaN,-176.66758616145262,-175.82244473255892,-1.2843098401497866,-0.8492716426114555,0.43503819753833095,4206923584,4163415078.6,55.512631403009394,77.94717560587263,NaN,NaN,-10.483893569553763,12.58024069421496
2018-02-08T09:30:00-05:00,149.99,150,145.44,145.44,44704507,27979371.85,28.170612781662214,51.19653508707915,NaN,NaN,-195.66821074991327,-208.8876625840519,-1.520529096951428,-1.465623173650954,0.05490592330047395,4162219077,4158553587.6,53.285964979100385,75.60003788105813,NaN,NaN,-17.39413775331278,8.298186630282425
2018-02-09T09:30:00-05:00,146.76,147.94,142.5,146.77,53315264,29319015.9,32.67303455896253,48.668064428573246,NaN,NaN,-171.52284357110406,-218.3802262192002,-1.504501176914431,-1.8257205478425647,-0.3212193709281338,4215534341,4171017965.8,57.94375258142902,73.55663865293583,NaN,NaN,-20.857577005799094,4.1330775394136365
2018-02-12T09:30:00-05:00,146.92,148.92,145.48,148.16,36213869,29925219.3,37.10987981651987,46.36716935970994,NaN,NaN,-117.49086146207397,-186.14286750981563,-1.3239517009875499,-1.976158997162571,-0.6522072961750213,4251748210,4201249567.4,66.63367493718096,72.03435189081164,NaN,NaN,-21.896096620844823,0.41462408794814243
2018-02-13T09:30:00-05:00,147.38,148.79,146.9,148.48,25021222,29791043.6,38.12087541377671,44.51330314310259,NaN,NaN,-94.35140314528884,-151.14018101796654,-1.1150153495634867,-2.0459764831293796,-0.9309611335658929,4276769432,4222638928.8,71.17223147048738,70.8024983003394,NaN,NaN,-22.335294164663598,-2.8353642338535345
2018-02-14T09:30:00-05:00,147.63,151.52,147.18,151.15,36286949,30676810.7,45.93104999673126,43.20469116063891,NaN,NaN,-58.919101114394785,-127.59048400855497,-0.7467265878179841,-1.864369368338373,-1.117642780520389,4313056381,4243865488.2,74.8310505251739,69.74721253946315,NaN,NaN,-19.94626699461397,-5.2797789139621685
2018-02-15T09:30:00-05:00,152.22,152.87,150.56,152.8,23773557,30970306.95,50.12084731478128,42.07307019418324,NaN,NaN,-25.231881472764783,-93.50321815312527,-0.36125720406434625,-1.5692142856008218,-1.2079570815364755,4336829938,4278787660.4,79.45177910731614,68.9649565411621,NaN,NaN,-16.54629852230574,-6.889281715154107
2018-02-16T09:30:00-05:00,152.61,154.29,152.54,153.34,27973884,30816954.55,51.44688740416613,41.39094547486332,NaN,NaN,-3.284164924233542,-59.85548242375116,-0.05524050992903695,-1.2770077189477718,-1.2217672090187348,4364803822,4308641556.6,82.42264674817292,68.3771550269451,NaN,NaN,-13.44980236263465,-7.82649895050847
2018-02-20T09:30:00-05:00,152.55,153.77,151.67,152.08,24046205,31384146.8,48.22527166630292,41.00351718679401,NaN,NaN,-12.21775834312066,-38.800861799960515,0.07018898625708392,-1.13403097619738,-1.2042199624544638,4340757617,4326443438,83.915969034212,68.20918749354207,NaN,NaN,-11.919048705443178,-8.411148915499142
2018-02-21T09:30:00-05:00,152.42,154.81,152.01,152.24,26735476,31875689.5,48.66487740987924,40.898123548486474,NaN,NaN,1.1809659099393344,-19.694387988914865,0.16631581159515818,-0.9963251979605161,-1.1626410095556743,4367493093,4344588170.2,85.2879341488858,68.50688672080405,NaN,NaN,-10.57282316859054,-8.719959523083627
2018-02-22T09:30:00-05:00,152.805,154.025,151.91,152,16340031,31675647.15,48.00643031584537,40.601855391562836,NaN,NaN,0.5313454388837628,-7.804298678259168,0.2131310306025882,-0.8962272213024391,-1.1093582519050273,4351153062,4352207506.4,85.8343653169919,69.1821232957396,NaN,NaN,-9.665790515315948,-8.855078236259674
2018-02-23T09:30:00-05:00,152.98,154.02,152.15,153.98,18065157,31564360.85,53.585910263768135,41.491669657762436,NaN,NaN,21.218639310861075,1.4858054784659938,0.3677740038921615,-0.6496407470398253,-1.0174147509319869,4369218219,4358685162.6,86.30023075904046,70.6501554629931,NaN,NaN,-7.179895302926743,-8.615766388640683
2018-02-26T09:30:00-05:00,154.53,155.26,153.47,154.99,15267664,31521728.7,56.169712511849596,43.471498025709714,NaN,NaN,53.5817345502954,12.858985373371784,0.5191533191487988,-0.3684731019959884,-0.8876264211447872,4384485883,4362621574.8,86.58887118077837,72.9651586632185,NaN,NaN,-4.312029385041388,-8.000946816697926
2018-02-27T09:30:00-05:00,155.18,155.88,152.75,152.76,18125486,31513339.85,49.60383387259423,44.520238271484345,NaN,NaN,45.62323683273308,24.42718440854253,0.4525989967322286,-0.3218776752295014,-0.77447667196173,4366360397,4367742130.8,86.97335469324253,75.43960406321578,NaN,NaN,-3.7678702106206043,-7.396221587258308
2018-02-28T09:30:00-05:00,153.14,153.6,150.31,150.35,29951777,31784239.1,43.66355775320383,45.10662722000309,NaN,NaN,-2.854123196567874,23.620166587241087,0.2404182357030502,-0.4739538773329173,-0.7143721130359675,4336408620,4361525236.2,83.83097979593286,77.46234323413888,NaN,NaN,-5.2068477882678055,-7.0834539016882365
2018-03-01T09:30:00-05:00,150.05,151.57,148.38,149.95,38943221,32422348.05,42.74851774925125,46.14790614625945,NaN,NaN,-32.812091992207044,16.951479101022926,0.07581005279238595,-0.619609547045485,-0.6954195998378709,4297465399,4350787703.6,78.55206040640569,79.26706433608926,NaN,NaN,-6.637683841446923,-7.019772464510906
2018-03-02T09:30:00-05:00,148.71,152.75,148.4,152.35,31921692,32947783.65,49.57646537451855,47.35529406165631,NaN,NaN,7.397502132459248,14.187251665342563,0.12816514540707669,-0.5352131680790251,-0.6633783134861018,4329387091,4342821478,74.78924901814162,80.47031408156873,NaN,NaN,-5.721091476832059,-6.834246609128213
2018-03-05T09:30:00-05:00,151.82,154.2601,151.47,153.71,19603692,32262264.15,52.99734789213096,48.490113209914234,NaN,NaN,70.3205107441288,17.535006904109242,0.24710159071446114,-0.35450132509302534,-0.6016029158074865,4348990783,4335722458,71.50221031479012,80.81806660854082,NaN,NaN,-3.8691352515432187,-6.410659272330356
2018-03-06T09:30:00-05:00,154.43,155.39,152.8,155.37,17303960,30496349.75,56.845765181878484,49.82760533620722,NaN,NaN,101.19317241375069,28.648994020312763,0.42011719763488314,-0.07645641876388254,-0.4965736163987657,4366294743,4335709327.2,71.49595103214597,80.84118943437356,NaN,NaN,-1.0697497309299258,-5.647672194987438
2018-03-07T09:30:00-05:00,154.46,156.93,154.22,156.74,22684579,28168957.55,59.77310706004774,50.81632369787269,NaN,NaN,131.3336591242649,55.48655048447931,0.5984941567758847,0.25154407957109015,-0.34695007720479454,4388979322,4346223467.6,73.49661311367785,80.74587247640956,NaN,NaN,2.198494637856505,-4.526791218866874
2018-03-08T09:30:00-05:00,156.9,157.47,155.5,156.42,23391297,27483474.45,58.77028945513357,51.43414099361213,NaN,NaN,130.65424028569547,88.17981694005982,0.6616647515718905,0.4801308622600686,-0.1815338893118219,4365588025,4359847992.8,75.86100102270065,80.48938832750845,NaN,NaN,4.524227667210542,-3.233788520855815
2018-03-09T09:30:00-05:00,157.31,159,156.87,158.92,24927153,26494606.75,63.87013651824787,52.32151593033227,NaN,NaN,169.60368525297275,120.62105356416252,0.827772466306919,0.8531816935718268,0.025409227264907852,4390515178,4372073610.2,77.7768329709564,80.1575444862787,NaN,NaN,8.224485553836235,-1.5968922244712367
2018-03-12T09:30:00-04:00,159.25,159.65,158.49,159.2,15310119,24594349.5,64.40124637983394,53.476942695584476,NaN,NaN,182.64254314160976,143.0854600436587,0.906129658142863,1.1580712999434866,0.2519416418006236,4405825297,4383440513,79.41285904934486,79.83589377307392,NaN,NaN,11.35148136129894,0.2528754306387886
2018-03-13T09:30:00-04:00,160,160.3,158.14,158.46,17757217,23671516.9,61.81499774545114,54.416237005268194,NaN,NaN,157.00888139034103,154.24860183897678,0.8582196388844893,1.3247161904062352,0.46649655152174596,4388068080,4387795180.4,80.01971210156968,79.45959219826561,NaN,NaN,13.207560196864957,2.1035446829568127
2018-03-14T09:30:00-04:00,159.22,159.3899,157.41,157.71,18097545,23325333.05,59.21930355854182,55.21715652260365,NaN,NaN,117.07688173832224,151.39724636178826,0.7310850674964946,1.3803528858923642,0.6492678183958696,4369970535,4383993423,77.86183730118192,78.89012591142205,NaN,NaN,14.027694657584409,3.806994679332184
2018-03-15T09:30:00-04:00,158.1,158.14,156.37,156.92,14172090,22219590.1,56.5267509247771,55.42721656981858,NaN,NaN,77.68904850579138,140.80420800580742,0.5567396886755324,1.345192429240285,0.7884527405647527,4355798445,4382035507,76.7144741181852,78.2054290085038,NaN,NaN,13.962486822481582,5.257779271210669
2018-03-16T09:30:00-04:00,156.98,158.27,156.75,157.8,36000320,22830928.25,58.77528185138855,55.61332866549993,NaN,NaN,80.37911541305928,122.95929403782472,0.46724953943890835,1.3725146648633881,0.9052651254244798,4391798765,4382292224.4,76.76282512505838,77.50356857595239,NaN,NaN,14.533866933660988,6.582934651560715
2018-03-19T09:30:00-04:00,157.17,157.2099,154.45,156.28,25663049,22715386.5,53.616785387273424,55.89996805940559,NaN,NaN,30.699677283479506,92.57072086619868,0.2814088763076128,1.2570262208089957,0.9756173445013829,4366135716,4374354308.2,71.79838758992665,76.41964235428695,NaN,NaN,13.546285958344962,7.577699123958464
2018-03-20T09:30:00-04:00,156.67,157.02,155.77,156.24,11418519,22084002.2,53.48375483535302,56.60141070813053,NaN,NaN,36.24810451822148,68.41856549177476,0.13872840703309408,1.1490278532927505,1.0102994462596564,4354717197,4367684131.6,67.82877106086585,75.27662744463932,NaN,NaN,12.702200896933324,8.309770805812015
2018-03-21T09:30:00-04:00,156.32,158.26,156.2,157.15,22213473,21857902.05,56.1493416015808,57.55861241186836,NaN,NaN,55.39051583546751,56.08129231120381,0.09089004760908947,1.1239120057710181,1.0330219581619287,4376930670,4369076158.6,68.22362208239132,74.53888185006687,NaN,NaN,12.696595670164088,8.936460072148025
2018-03-22T09:30:00-04:00,155.655,156.62,153.31,153.35,29774835,22529642.25,44.644449866278535,57.20632558985121,NaN,NaN,-28.87805678233278,34.76787125357897,-0.1957837022923773,0.7882923302964571,0.9840760325888344,4347155835,4367347636.6,67.12197552757556,73.99121945788356,NaN,NaN,9.005781560819214,8.946363141958194
2018-03-23T09:30:00-04:00,153.56,154.13,150,150.05,35744100,23413589.4,37.46517390274528,56.096884590609385,NaN,NaN,-112.10121560048378,-3.7281949491296444,-0.5847718736895812,0.25311119047685793,0.8378830641664391,4311411735,4351270230.6,57.77681333279186,73.01083395916942,NaN,NaN,3.1420605157651265,8.117177052502042
2018-03-26T09:30:00-04:00,152.09,153.38,150.43,153.33,28442432,24072327.8,46.648579142326234,55.36851415921279,NaN,NaN,-76.49984370045321,-25.168099145916194,-0.596244298295953,0.09257769129649773,0.6888219895924508,4339854167,4346013920.8,55.07695075129072,71.8380482248226,NaN,NaN,1.3412578672215978,7.149188597461978
2018-03-27T09:30:00-04:00,153.66,153.7,149.71,150.36,32820649,24807085.95,40.805193687667845,54.0136632040428,NaN,NaN,-98.16537395882297,-52.05079484132508,-0.7679972005507887,-0.2711745110960351,0.4968226894547536,4307033518,4336477185,50.46891807131423,70.19321286465377,NaN,NaN,-2.341010227376978,5.793445908199271
2018-03-28T09:30:00-04:00,150.74,151.35,149.39,150.31,26510850,24635039.6,40.71273353289361,52.723837781025665,NaN,NaN,-117.58513645984758,-86.6459253003881,-0.8431092307849504,-0.5570638490264344,0.286045381758516,4280522668,4317195584.6,42.691808390266345,67.8239848194799,NaN,NaN,-5.128428287595063,4.233178165942937
2018-03-29T09:30:00-04:00,151.08,153.1,150.75,151.83,24209149,23898336,44.80704682797012,51.36218851743439,NaN,NaN,-84.32063654832528,-97.7344412535866,-0.751595789265562,-0.6534493548234366,0.09814643444212548,4304731817,4308710781,39.78636828559057,65.11038019909662,NaN,NaN,-6.050040961887442,2.764146861967169
2018-04-02T09:30:00-04:00,151.52,152.07,147.18,148.13,35040722,24054287.5,37.93879785782081,49.472013623004884,NaN,NaN,-148.0842528994008,-104.93104871337,-0.8918571822384115,-1.0166750433558889,-0.12481786111747739,4269691095,4300366653,37.111515344580766,62.08885564875634,NaN,NaN,-9.301772789981246,1.0404440545459668
2018-04-03T09:30:00-04:00,149.02,150.6,148.3,150.25,29857789,24566992.35,43.301572452929115,48.14962610211045,NaN,NaN,-120.23718947666329,-113.67851786861202,-0.796586290914377,-1.1205507247604487,-0.32396443384607165,4299548884,4292305596.4,34.68541790466658,58.85069177754899,NaN,NaN,-10.077863734205454,-0.547885629561379
2018-04-04T09:30:00-04:00,148.5,152.58,148.27,152.16,29619678,25182778.25,47.687458736736275,47.32592290055292,NaN,NaN,-80.24756704379904,-110.09495648560724,-0.5702687124744219,-1.036800324439099,-0.4665316119646772,4329168562,4296732605.2,37.11671413512554,55.94032583711638,NaN,NaN,-9.192394694881322,-1.7828154960356566
2018-04-05T09:30:00-04:00,153.04,153.6099,152.32,153.42,17301630,24913630.8,50.412543684246614,46.88919381194359,NaN,NaN,-30.350349535322447,-92.64799910070221,-0.3138592745125882,-0.8588557051054124,-0.5449964305928242,4346470192,4309922110,43.82585601054725,53.591138829427955,NaN,NaN,-7.572152604883526,-2.609863654442495
2018-04-06T09:30:00-04:00,152.37,153.4,149.15,150.36,25762675,25032199.7,44.36780249838644,45.86008814387202,NaN,NaN,-69.9062175847383,-89.76511530798477,-0.32700720733157074,-0.9537554397572876,-0.6267482324257169,4320707517,4313117250,45.34707331717665,51.3471565574364,NaN,NaN,-8.24111614481317,-3.4143282959240198
2018-04-09T09:30:00-04:00,151.4,152.6,150.42,150.54,18997049,24735694.5,44.787189260410045,45.22940270623892,NaN,NaN,-59.2791754547663,-72.00409981905787,-0.30090469525611785,-1.0028791014958642,-0.7019744062397464,4339704566,4327119944.2,51.54061529883732,49.90017282235859,NaN,NaN,-8.62472414382732,-4.158670559910205
2018-04-10T09:30:00-04:00,152.14,153.95,151.67,153.38,24728903,25206633.7,51.05642639098451,45.056022103069736,NaN,NaN,-13.692399179978748,-50.69514175972096,-0.08112829312142034,-0.8033847726415217,-0.7222564795201014,4364433469,4340096861.2,56.464560398946205,49.08844348936434,NaN,NaN,-6.890331279286461,-4.548907805535385
2018-04-11T09:30:00-04:00,152.78,154.31,152.63,153.71,14884595,25063002.6,51.74210950963522,44.74121981078791,NaN,NaN,7.170340392313577,-33.211560272498446,0.08852068066073837,-0.6116056286941784,-0.7001263093549168,4379318064,4350126761.6,59.85946979374722,48.491004040175476,NaN,NaN,-5.30801848358565,-4.657352188113994
2018-04-12T09:30:00-04:00,154.43,155.41,153.93,154.76,14413182,24878784.45,53.95262081750026,45.4060891644466,NaN,NaN,47.927759653488735,-17.55593843473621,0.2636044353554574,-0.37062076516059506,-0.6342252005160525,4393731246,4359578972.4,62.8032897636736,48.18252648561105,NaN,NaN,-3.3272584168487893,-4.467338792218965
2018-04-13T09:30:00-04:00,155.29,155.3292,153.511,153.95,19813591,25160859.5,51.97475308499895,46.442487677464726,NaN,NaN,42.04225734614883,4.833756551441217,0.31361476317299264,-0.24220674654981167,-0.5558215097228043,4373917655,4370221000,65.84075985051433,48.75852266544836,NaN,NaN,-2.26399194192931,-4.1525749564633
2018-04-16T09:30:00-04:00,154.84,155.82,154.11,155.37,18846929,24303189.95,55.08345480108968,47.04497879594783,NaN,NaN,78.18087137649358,32.3257659176932,0.4242084649068488,-0.025560928589243304,-0.44976939349609213,4392764584,4380833003.6,68.59477939286921,49.72408185413254,NaN,NaN,-0.43851071649764034,-3.62199435075392
2018-04-17T09:30:00-04:00,156.21,157.49,155.96,157.06,18624191,23951247.05,58.52445422364886,48.31064026280361,NaN,NaN,133.99535841014074,61.86331743571709,0.5832410594548674,0.2792819308224921,-0.3039591286323753,4411388775,4390224064.8,70.83563228574785,51.17884715516351,NaN,NaN,2.1672251459050123,-2.7949629940883582
2018-04-18T09:30:00-04:00,157.52,158.38,157.16,157.48,16974157,24229028.95,59.35775768363513,49.64242770214229,NaN,NaN,154.90210086321844,91.40966952989807,0.6819197048059014,0.5484405023750014,-0.13347920243089995,4428362932,4400033038.4,73.00248257771437,53.3438953114098,NaN,NaN,4.547590720643569,-1.7460267491266543
2018-04-19T09:30:00-04:00,157.14,157.54,155.88,156.39,16184535,23927582.05,56.20185490495932,50.45634256478438,NaN,NaN,122.55360124998116,106.33483784919653,0.6396778610924528,0.6661181239346661,0.026440262842213264,4412178397,4403722468.6,73.7912395989164,55.77281469093307,NaN,NaN,5.694545178035913,-0.6830879023891447
2018-04-20T09:30:00-04:00,156.05,156.72,155.15,155.55,21480629,23512871.75,53.82675543378054,51.59119667735293,NaN,NaN,90.5681405885613,116.04001449767904,0.525820632881165,0.6837160539436695,0.15789542106250454,4390697768,4407078491.2,74.52046398746702,58.44488245113923,NaN,NaN,6.00633042550894,0.27254328731058175
2018-04-23T09:30:00-04:00,155.78,156.29,154.57,155.32,13268151,22389074.3,53.16425808520017,52.29567422251515,NaN,NaN,69.21952043417126,114.24774430921457,0.4107751764740678,0.6713643916550893,0.2605892151810215,4377429617,4404011497.8,72.53423022941533,61.148369045764134,NaN,NaN,6.08767465697611,1.1032763401199428
2018-04-24T09:30:00-04:00,155.9,156.63,153.19,154.43,24859690,22209937.2,50.57049672750869,52.501605507570325,NaN,NaN,44.44256922837295,96.33718647286102,0.2579599367439694,0.5830391361109832,0.32507919936701385,4352569927,4392247728.2,65.34047811536281,63.16435218720965,NaN,NaN,5.460909485624929,1.7257953609063694
2018-04-25T09:30:00-04:00,154.36,154.8,152.96,154.2,21981372,21667973.35,49.89305357781538,52.464499071396666,NaN,NaN,17.242025786514343,68.8051714575202,0.1310138711750684,0.48884653833584935,0.35783266716078094,4330588555,4372692852.8,55.488784439148326,63.997418503538306,NaN,NaN,4.7555906155802665,2.1586232544312116
2018-04-26T09:30:00-04:00,154.42,155.41,153.94,154.91,14862876,21085574.65,52.02937317991397,53.01175412007721,NaN,NaN,37.023262377291616,51.69910368298228,0.08662682220158124,0.46611619491275746,0.3794893727111762,4345451431,4359347459.6,49.95332127912935,64.32643621510636,NaN,NaN,4.691132999803945,2.5204103609130306
2018-04-27T09:30:00-04:00,154.88,155.37,153.78,154.69,17734290,20761831.7,51.29952811787023,53.47692118132436,NaN,NaN,28.59072788063311,39.30362114139665,0.036765140448426936,0.4254457982717099,0.388680657823283,4327717141,4346751334.2,45.3543760712097,63.88456198456152,NaN,NaN,4.451741506819327,2.796314810328216
2018-04-30T09:30:00-04:00,155.02,155.65,153.29,153.32,15624584,19791024.8,46.88858203410709,53.17921801297597,NaN,NaN,1.305555218091632,25.72082809818072,-0.08738821190191581,0.2794453929458882,0.36683360484780403,4312092557,4333683922.2,41.1244633862221,62.788840769366935,NaN,NaN,3.0692028089840053,2.8352988101361856
2018-05-01T09:30:00-04:00,153.01,154.29,151.71,154.07,24977510,19547010.85,49.45103569526493,53.01556988337809,NaN,NaN,-42.30446937268647,8.371420377968846,-0.11610519752470516,0.22170210794192258,0.33780730546662774,4337070067,4330583950.2,40.167404099610046,61.38226464835714,NaN,NaN,2.5319526449944023,2.7919636436873594
2018-05-02T09:30:00-04:00,153.78,155.78,153.68,154.65,16786819,18905367.9,51.403679056651605,52.833502614746045,NaN,NaN,15.23880272583272,7.970775765832516,-0.09408350117156628,0.22020292900216987,0.31428643017373614,4353856886,4335237616.4,42.33689947733876,59.92037962790466,NaN,NaN,2.5759675420076262,2.7611070577331116
2018-05-03T09:30:00-04:00,154.11,154.5,152.16,153.81,20985937,19089583.25,48.48266829503284,52.58406798689133,NaN,NaN,-52.4908123005258,-9.932039169730965,-0.13182084293028878,0.14951037651087518,0.28133121944116396,4332870949,4332721520,41.4615467006916,58.17900726006018,NaN,NaN,1.841651820655484,2.629756309579165
2018-05-04T09:30:00-04:00,153.26,156.5,152.8,155.73,17927916,18697845.3,54.80447247794536,52.564140678095306,NaN,NaN,23.846926692620247,-10.88079940733354,-0.028598539737157813,0.2455830447697167,0.2741815845068745,4350798865,4337337864.8,43.75913241416548,56.40503247586706,NaN,NaN,2.9481814206807733,2.675245611165109
2018-05-07T09:30:00-04:00,156.19,157.86,156.1,157.05,16303479,18563166.8,58.56868219486145,52.56729981889621,NaN,NaN,138.58395013112232,16.574879575272604,0.1193380379358494,0.42335413192668625,0.30401609399083684,4367102344,4348339822.2,48.90614847547973,54.83864077513363,NaN,NaN,5.023255691159986,3.0106756225929487
2018-05-08T09:30:00-04:00,156.92,157.83,156.75,157.83,17281248,18190784.05,60.65405491468865,52.65989247825717,NaN,NaN,144.2946239437419,53.89469823855827,0.25281204274858904,0.6200311474265732,0.36721910467798413,4384383592,4357802527.2,52.89883476670613,53.40266593149017,NaN,NaN,7.393365462245047,3.636774171114677
2018-05-09T09:30:00-04:00,158.01,159.1,157.38,158.68,15758472,18234477.9,62.84857434919567,53.134658152845475,NaN,NaN,166.17543617623443,84.08202492863862,0.37411528587470133,0.8348632120213608,0.4607479261466595,4400142064,4367059562.8,56.4815423132201,52.16625898251187,NaN,NaN,10.059678168084435,4.5543318849675
2018-05-10T09:30:00-04:00,158.9,160.17,158.75,159.53,15828661,18305251.85,64.95364642973485,53.929436081127925,NaN,NaN,181.0783800280255,130.79586339434886,0.4805785305014125,1.0614710892734252,0.5808925587720126,4415970725,4383679518,62.061181406219795,51.276310226708496,NaN,NaN,12.957110174542422,5.754728783478202
2018-05-11T09:30:00-04:00,159.55,160.13,159.04,159.84,14413632,18035253.9,65.71660810264555,54.82603251094546,NaN,NaN,158.1385244982586,157.65418295547653,0.5366024982181624,1.2516456815447157,0.7150431833265533,4430384357,4399596616.4,66.49214314773337,50.844732578016924,NaN,NaN,15.588468857485275,7.159548794050641
2018-05-14T09:30:00-04:00,160.02,160.69,159.05,159.23,15028536,17844334.25,62.81859128509906,55.7008964079162,NaN,NaN,133.68780858336262,156.6749546459246,0.4981399590267901,1.3377181321100409,0.8395781730832508,4415355821,4409247311.8,68.86637576670608,51.09658241025573,NaN,NaN,17.05355427156496,8.572978147981258
2018-05-15T09:30:00-04:00,158.71,159.5899,158.17,159.26,17544917,17790370.55,62.90523050665492,56.63033761711902,NaN,NaN,98.20222202485323,147.45647426214686,0.4421793207872977,1.3923023240673729,0.9501230032800752,4432900738,4418950741,71.0848452223382,52.21058675191215,NaN,NaN,18.295049779890352,9.961845523968272
2018-05-16T09:30:00-04:00,159.49,161.32,159.47,160.92,21004449,17991885.15,67.4280017382687,57.7302396570015,NaN,NaN,137.00443901306602,141.62227482951317,0.4811997380930799,1.551622675896425,1.0704229378033452,4453905187,4429703365.6,73.35094733211952,53.881845755697164,NaN,NaN,20.72925444279759,11.500046798086746
2018-05-17T09:30:00-04:00,161,162,160.75,161.66,18639701,18114643.45,69.22911195408831,59.01092421673137,NaN,NaN,140.0918808359156,133.4249749910912,0.5178979239204051,1.7177953427038517,1.1998974187834466,4472544888,4441018198.2,75.52465486803992,56.036865669756466,NaN,NaN,23.337894216800347,13.191167857902975
2018-05-18T09:30:00-04:00,161.95,162.3178,161.55,161.87,17579847,17919604.35,69.74047605505508,60.64320236108479,NaN,NaN,131.3626620942114,128.06980251028176,0.5162130445522313,1.8451637244737356,1.3289506799215043,4490124735,4452966273.8,77.60223827571744,58.642421019006136,NaN,NaN,25.656302828530446,14.97190142513547
2018-05-21T09:30:00-04:00,162.37,163.24,162.36,162.94,15667339,18039563.75,72.26920186776005,62.27307137340586,NaN,NaN,134.87936701517222,128.3081141966437,0.544265364619162,2.0092823856954567,1.4650170210762947,4505792074,4471053524.4,80.32496709500235,61.51081837581987,NaN,NaN,28.43722497480118,16.895519075087716
2018-05-22T09:30:00-04:00,163.26,163.33,161.63,161.76,13212023,17457180.4,65.74420863435685,63.29739491467052,NaN,NaN,106.96415957704723,130.0605017070825,0.4446556017652805,2.0208365232828953,1.5761809215176148,4492580051,4482989387,81.8895379536357,64.3360068384125,NaN,NaN,29.01914153699715,18.62746514107478
2018-05-23T09:30:00-04:00,161.33,162.28,161.13,161.97,14235681,17069895.85,66.32689115745029,64.57198226198605,NaN,NaN,87.88189768801342,120.23599344207199,0.3579445195738602,2.02361157098494,1.6656670514110798,4506815732,4493571496,83.16753703154988,67.31500614775953,NaN,NaN,29.66224353262662,20.203862054153614
2018-05-24T09:30:00-04:00,161.92,162.35,160.62,162.03,12785045,16966004.3,66.50221087829487,65.40753500486817,NaN,NaN,78.1628726164367,107.85019179817621,0.2734751412069478,2.0075109779197646,1.7340358367128168,4519600777,4502982673.8,84.23315661886174,70.2060078766664,NaN,NaN,30.24262998920063,21.63797175916033
2018-05-25T09:30:00-04:00,161.75,162.16,161.47,161.74,11150236,16636801.6,64.74751407084617,65.84888013886707,NaN,NaN,75.03256661133143,96.58417270160021,0.17187935625989037,1.9488850320376798,1.7770056757777895,4508450541,4506647835,84.64096142846832,72.75849451616558,NaN,NaN,30.276352682678286,22.87202617680575
2018-05-29T09:30:00-04:00,160.88,162.23,160.11,161.52,20986902,16904917.5,63.3812453164688,66.04367945327995,NaN,NaN,57.926529993807804,81.19360529732732,0.0689503790347521,1.8631936495712296,1.7942432705364775,4487463639,4502982148,82.34691652817499,74.86192892769907,NaN,NaN,29.951748657182176,23.88341510257381
2018-05-30T09:30:00-04:00,162.36,164.39,162.36,164.08,25169013,16914492.65,71.03937805828835,66.62873686107228,NaN,NaN,116.34086150406387,83.06894568273066,0.14783744333821502,1.9790400747092463,1.8312026313710312,4512632652,4506992668.2,82.89320250532876,76.74847608427827,NaN,NaN,31.904217569208736,25.029244026378798
2018-05-31T09:30:00-04:00,164.08,164.38,162.34,162.77,28573727,17503838.05,63.69824948818031,66.53906565096123,NaN,NaN,95.67752127115614,84.62807039935919,0.08923657943210794,1.9427483556611662,1.8535117762290583,4484058925,4502441306.8,79.87240551931814,78.02070637807101,NaN,NaN,31.31927449764667,25.927819807988495
2018-06-01T09:30:00-04:00,163.83,164.38,163.28,163.84,21108153,17509948.85,66.7230986591446,66.6109578335683,NaN,NaN,113.17624209659743,91.63074429539134,0.09921555149812544,1.977531215601715,1.8783156641035896,4505167078,4499554567,77.93253638424115,78.83787732353584,NaN,NaN,31.763620688419664,26.76150564805009
2018-06-04T09:30:00-04:00,164.32,164.71,163.32,164.71,14836035,17355354.8,68.98594404526668,67.05148303072313,NaN,NaN,123.72731623115025,101.3696942193551,0.13866625685943101,2.0516484851778785,1.9129822283184474,4520003113,4501865081.4,78.38503364617847,79.51778145778387,NaN,NaN,32.842509824139974,27.630220530348645
2018-06-05T09:30:00-04:00,164.55,165.77,164.34,165.73,13283590,17204360.35,71.43818637686653,67.66097987859538,NaN,NaN,156.60307680000543,121.10500358059463,0.20377780364764875,2.1677044828780083,1.9639266792303596,4533286703,4511029694.2,80.1258104419138,80.16356468775355,NaN,NaN,34.52991090724944,28.615890584191614
2018-06-06T09:30:00-04:00,165.71,166.93,165.58,166.93,16661337,17173364.8,74.03890617315484,68.13318733823012,NaN,NaN,186.02782466619996,135.04239621302185,0.2925825424874078,2.3296548573396194,2.0370723148522116,4549948040,4518492771.8,81.4368864388016,80.74113176680227,NaN,NaN,36.80779500496141,29.786162644301587
2018-06-07T09:30:00-04:00,167.11,167.23,165.23,166.02,17571873,17264034.85,68.91428389912349,68.11069962001834,NaN,NaN,149.69437001903438,145.84576596259748,0.2562602984858233,2.357397687959491,2.1011373894736676,4532376167,4528156220.2,83.00064513091239,81.27513107129316,NaN,NaN,37.0826551024408,30.828518709750046
2018-06-08T09:30:00-04:00,166.06,166.61,165.76,166.52,17569845,17351094.05,70.13733262137539,68.13904651761264,NaN,NaN,134.53207367738585,150.11693227875517,0.23281379472856223,2.3921546328843704,2.159340838155808,4549946012,4537112007,84.31904659663594,81.75490309421592,NaN,NaN,37.680341457663516,31.80735053088054
2018-06-11T09:30:00-04:00,166.64,167.1125,166.29,166.77,15922997,17426562.3,70.75686149359201,68.03102220517208,NaN,NaN,132.15008168343556,151.80148536921223,0.20218161429635728,2.4120678560262547,2.2098862417298974,4565869009,4546285186.2,85.55482043445544,82.12846404703399,NaN,NaN,38.348221590937406,32.741760682317235
2018-06-12T09:30:00-04:00,166.92,167.94,166.73,167.53,16166725,17483471.75,72.61670709810306,68.52191495258252,NaN,NaN,136.91400124460975,147.8636702581331,0.2007375762004302,2.460808211980435,2.260070635780005,4582035734,4556034992.4,86.75002534510162,82.475641717853,NaN,NaN,39.46353931331704,33.70201477246007
2018-06-13T09:30:00-04:00,167.77,167.87,166.62,166.87,19853695,17598910.65,68.53997759642827,68.67999255536667,NaN,NaN,114.33541516014883,133.52518835692288,0.12658519495344533,2.4183021294718117,2.2917169345183663,4562182039,4558481792.2,87.0398377684912,82.75223462763451,NaN,NaN,39.21656477250236,34.48980762960897
2018-06-14T09:30:00-04:00,167.49,167.8399,166.61,167.76,19248134,17511094.9,70.91150098059437,68.99494184838805,NaN,NaN,109.53266748033359,125.49284784918272,0.10937668882257556,2.4284377955465857,2.31906110672401,4581430173,4568292593.4,88.15826565585729,83.03259955884847,NaN,NaN,39.69637475519615,35.23360293326428
2018-06-15T09:30:00-04:00,167.24,167.87,166.53,167.81,24922582,17825238.95,71.04356307661851,69.44465963451465,NaN,NaN,97.20878007398295,118.02818912850213,0.07490546955006927,2.4126929436615967,2.3377874741115274,4606352755,4579573942,89.30156279939311,83.36549965677168,NaN,NaN,40.12382651595945,35.932206302220735
2018-06-18T09:30:00-04:00,166.97,168.61,166.73,168.6,18616479,17877070.55,73.12004068044351,70.14028787479856,NaN,NaN,103.54261296833566,112.30669538548216,0.07847570089814582,2.4358821002342097,2.357406399336064,4624969234,4591393987,90.35255372690482,83.9373308852524,NaN,NaN,41.08470950654459,36.66827818855271
2018-06-19T09:30:00-04:00,167.55,168.77,166.54,168.61,24605878,18323997.5,73.14629156798819,70.29078169691998,NaN,NaN,93.28304066005893,103.58050326857202,0.05574577930888713,2.427088623472173,2.371342844163286,4649575112,4604901862.6,91.39313546251226,84.54446895362264,NaN,NaN,41.88124731603958,37.41298806390798
2018-06-20T09:30:00-04:00,169.45,170.2,168.9515,169.97,19216897,18624241.2,76.50663863527583,71.20566663599823,NaN,NaN,133.84671469815092,107.48276317617243,0.10374976167287953,2.5010300462543853,2.3972802845815058,4668792009,4626223856.6,92.72671749234878,85.4626340945534,NaN,NaN,43.59061017906177,38.29550550892995
2018-06-21T09:30:00-04:00,169.98,170.08,167.77,168.38,26946202,19259767.25,66.09350278795496,71.16069550234182,NaN,NaN,96.97101496586035,104.97043267327777,0.0050733616575877605,2.4036219866534907,2.398548624995903,4641845807,4638306983.4,93.3550673883321,86.56424345198846,NaN,NaN,41.905671039807046,38.81124344191239
2018-06-22T09:30:00-04:00,169.01,169.2,167.31,167.82,34140419,20327535.95,62.84894161119248,70.72233818562223,NaN,NaN,72.63826542300443,100.05632974308205,-0.11464604990322247,2.255241062616875,2.3698871125200975,4607705388,4638577510,93.36887992067342,87.63451818588096,NaN,NaN,39.50719605796223,38.91066524420523
2018-06-25T09:30:00-04:00,167.24,167.37,164.14,165.08,37005119,21620280.1,49.93285813787877,69.18624331140883,NaN,NaN,-27.69619663933958,73.80856782154702,-0.38014012963321386,1.8947119504785803,2.274852080111794,4570700269,4627723717,85.67422488351866,88.03083350313844,NaN,NaN,32.64962535928313,38.01623097493064
2018-06-26T09:30:00-04:00,165.23,166.66,164.85,166.04,20481682,21595019.1,53.53579567277781,67.72173541852474,NaN,NaN,-28.43043773759315,49.46587214201659,-0.486093536504173,1.667235159481578,2.153328695985751,4591181951,4616045084.8,78.20592430345744,87.800050493471,NaN,NaN,28.283344193906927,36.62581857764154
2018-06-27T09:30:00-04:00,166.21,166.51,163.31,163.38,27511763,21712156.6,44.07206415021648,65.94729115074567,NaN,NaN,-101.99498458249322,2.2975322858877663,-0.7164077252992924,1.2578190393616353,1.9742267646609277,4563670188,4595020720.6,66.89983915728718,86.64999292392635,NaN,NaN,20.809494083473425,34.366343649903236
2018-06-28T09:30:00-04:00,163.23,164.22,162.26,163.88,26759106,21621425.55,46.00425808048382,64.22350011211057,NaN,NaN,-150.4932972808148,-47.19533016344727,-0.8092987367988154,0.9626033436624084,1.7719020804612238,4590429294,4584737418,62.165934639968874,85.0676277841644,NaN,NaN,15.730010984266855,31.70401041195518
2018-06-29T09:30:00-04:00,164.31,165.05,163.61,163.77,24146597,21773347.75,45.6307611816853,62.42877866126009,NaN,NaN,-118.58713787570994,-85.44041082319013,-0.8482702821842221,0.7115642277309462,1.5598345099151683,4566282697,4576452879.8,58.57016984334181,83.14015274194199,NaN,NaN,11.691990130227394,28.845150371708357
2018-07-02T09:30:00-04:00,162.76,164.96,162.48,164.9,24283647,22245728.35,50.11159682194166,60.821270784391416,NaN,NaN,-119.1567823658374,-103.73252796848969,-0.7703359153019433,0.596914615787739,1.3672505310896823,4590566344,4580426094.8,59.77195324081614,81.21314759163589,NaN,NaN,9.73714513719652,26.115435338206666
2018-07-03T09:30:00-04:00,164.75,165.701,164.7,164.96,13561340,22259615.85,50.34559958931663,59.52167235531202,NaN,NaN,-68.36267836602416,-111.7189760941759,-0.6897417846576115,0.505073300267668,1.1948150849252794,4604127684,4583015241.4,60.574534718639505,79.32276880236077,NaN,NaN,8.265736337025151,23.565478338037877
2018-07-05T09:30:00-04:00,165.86,166.87,164.83,166.84,18640546,22358576.3,57.13073757224744,58.53733211185865,NaN,NaN,-15.159032403572244,-94.3517856583917,-0.4939852339234321,0.5773335425209893,1.0713187764444214,4622768230,4594834849.8,64.09607931354307,77.60404120648124,NaN,NaN,9.134575954789094,21.503920854716622
2018-07-06T09:30:00-04:00,166.97,168.44,166.52,168.25,19606588,22460312.05,61.39187551484054,57.847925857445944,NaN,NaN,55.43399827520303,-53.166326547188135,-0.2651774009288772,0.7398470252833249,1.0050244262122021,4642374818,4605223954.6,66.89511342910274,76.00358053717478,NaN,NaN,11.292668932446407,20.045170580106593
2018-07-09T09:30:00-04:00,169.01,169.33,168.385,169.31,16565172,22410078.4,64.26739121143328,57.21559375251666,NaN,NaN,103.40690332613794,-8.767518306818559,-0.04937993861544787,0.9432995029428923,0.9926794415583402,4658939990,4623755413.2,71.20701783494947,74.63604225917797,NaN,NaN,14.037787981043442,19.186973065954714
2018-07-10T09:30:00-04:00,169.58,169.87,167.57,168.54,18790701,22553463.6,60.72902414983859,56.32864607979169,NaN,NaN,79.28876880761841,30.921591927872605,0.030276637927281635,1.0305252389674422,1.0002486010401606,4640149289,4633672002.2,73.21735059440833,73.33777191145626,NaN,NaN,15.171091063739922,18.613275637066888
2018-07-11T09:30:00-04:00,167.62,168.61,167.045,167.11,23912637,22940759.2,54.70521832905879,54.771401772204754,NaN,NaN,33.00043851863856,51.194215304805155,-0.021761649314286813,0.973046539397302,0.9948081887115888,4616236652,4636093795.8,73.70028903311417,71.9787413072252,NaN,NaN,14.196355751382791,17.98228708196916
2018-07-12T09:30:00-04:00,168.07,168.25,166.64,167.92,19617573,22928953.1,57.289517586819976,54.1425456864094,NaN,NaN,32.214465551796394,60.66891489587887,-0.010614626663699278,0.9815399053819647,0.992154532045664,4635854225,4638710994.8,74.24086144106624,70.6134408824205,NaN,NaN,14.216357824354459,17.444297188024205
2018-07-13T09:30:00-04:00,167.85,168.73,167.42,167.42,15409852,22737039,55.196021858744196,53.59590856123453,NaN,NaN,41.41781759362754,57.86567875956378,-0.04402556794233603,0.9371225721177439,0.9811481400600799,4620444373,4634324905.8,71.58532492913275,69.05747266873902,NaN,NaN,13.592336466202465,16.894017084906814
2018-07-16T09:30:00-04:00,167.76,168.03,165.96,166.77,15946913,22288255.55,52.50966210063821,53.77996598714592,NaN,NaN,3.6155073254671706,37.90739955942963,-0.11308542742768402,0.8397913557754748,0.9528767832031588,4604497460,4623436399.8,65.33725741798813,67.60483213548684,NaN,NaN,12.26600854463062,16.2328730077245
2018-07-17T09:30:00-04:00,166.75,168,166.59,167.51,15134723,22114167.75,55.18386201293919,53.897685011443166,NaN,NaN,24.02500035531937,26.85464586896982,-0.11190480898995347,0.812995771965717,0.9249005809556705,4619632183,4619332978.6,63.10200109917545,66.52598047803812,NaN,NaN,11.94071817786694,15.619708032030562
2018-07-18T09:30:00-04:00,167.36,168.06,166.57,167.98,13780017,21572874.7,56.845975729952684,54.81010726713861,NaN,NaN,32.56830954536848,26.7682200743158,-0.08373642527868008,0.8202300493573205,0.9039664746360005,4633412200,4622768088.2,64.20596845295367,66.3335611420143,NaN,NaN,12.15225047667646,15.124356952694262
2018-07-19T09:30:00-04:00,167.77,169.25,167.26,169.17,18401301,21532094.9,60.809163301322535,55.86760049719852,NaN,NaN,81.58946852303353,36.64322066856322,0.006010303846033849,0.9114793544435429,0.905469050597509,4651813501,4625959943.4,65.24646273479667,66.55359886307343,NaN,NaN,13.524091206977069,14.895747560448948
2018-07-20T09:30:00-04:00,168.8,169.31,168.35,168.48,17570893,21063329.45,57.51107970430923,56.716194677385936,NaN,NaN,88.54094858577825,46.067846866993364,0.009657568389520588,0.9175410110844098,0.9078834426948892,4634242608,4628719590.4,66.1623136360173,67.09589484826454,NaN,NaN,13.716606105557755,14.727298781178778
2018-07-23T09:30:00-04:00,168.3,169.15,167.81,168.69,12335035,19973060.25,58.25319395830138,57.297737329983065,NaN,NaN,79.3664399870465,61.21803339930923,0.016562046807103714,0.9285860012037688,0.9120239543966651,4646577643,4637135627,68.8576667901514,67.74487438750278,NaN,NaN,14.085336321678732,14.635589858393057
2018-07-24T09:30:00-04:00,169.45,169.755,166.22,166.89,25831306,19414369.6,50.16528497139992,57.28485771441758,NaN,NaN,35.07672702975155,63.42837873419567,-0.10316511291783192,0.7830675632493751,0.886232676167207,4620746337,4637358457.8,68.92823891139167,68.34156754412793,NaN,NaN,11.964331590436215,14.253981534399223
2018-07-25T09:30:00-04:00,166.94,167.5,166.14,167.5,18418151,19311193.05,52.5686725162125,56.9589959247008,NaN,NaN,6.5385230090470445,58.222421426931376,-0.141950530654398,0.7087945128492095,0.8507450435036075,4639164488,4638508915.4,69.31486411045242,68.7143378867643,NaN,NaN,10.910522834659634,13.776344577293568
2018-07-26T09:30:00-04:00,167.66,169.365,167.51,168.4,20944208,18982815.3,55.94456551941988,56.569902353599325,NaN,NaN,68.51063256983828,55.60665423629233,-0.10913938044703841,0.7143208179448095,0.8234601983918479,4660108696,4640167954.4,69.89657981624795,68.92872834298896,NaN,NaN,11.021696909181271,13.382823481848954
2018-07-27T09:30:00-04:00,168.5,168.72,164.79,165.26,28782611,19083990.55,44.14048171291135,55.13226596084776,NaN,NaN,-60.37627703760649,25.82320911161538,-0.29074751431885937,0.46002580549327377,0.7507733198121331,4631326085,4639584649.8,69.39843467040285,68.79954383123562,NaN,NaN,7.058144603042685,12.479297927733773
2018-07-30T09:30:00-04:00,165.25,166.02,164.07,164.2,20093717,18881346.55,40.995813786019106,53.722750934860656,NaN,NaN,-158.82857865237602,-21.815794616269123,-0.4638258898508356,0.1709909574985886,0.6348168473494242,4611232368,4632515594.8,63.49269397356413,68.10492550117533,NaN,NaN,2.7557999837817158,11.09022679288348
2018-07-31T09:30:00-04:00,164.53,166.62,164.39,165.87,23601020,18847215.2,47.35877138208953,53.19800472436285,NaN,NaN,-120.34559323419477,-52.900258669058395,-0.44720554841295335,0.07580991183323249,0.5230154602461858,4634833388,4635333005,64.7791585506144,67.46770189528249,NaN,NaN,1.2999450588139287,9.69161511658783
2018-08-01T09:30:00-04:00,165.7,166.24,164.495,165.76,17942577,19066277.05,46.99924728520159,52.46298541710439,NaN,NaN,-133.88835407233563,-80.98563408533492,-0.4251331617054239,-0.008400991885594067,0.41673216981982986,4616890811,4630878269.6,61.11222805980729,66.5299423680497,NaN,NaN,0.05935097908060529,8.315577382658226
2018-08-02T09:30:00-04:00,164.96,167.21,164.94,166.97,18292169,19048858.2,51.37233660001447,52.189865041480836,NaN,NaN,-73.089281201492,-109.30561683960097,-0.31559232892021144,0.02224175866956557,0.337834087589777,4635182980,4625893126.4,57.20943568788934,65.50309313653231,NaN,NaN,0.41969885172717936,7.187594735382363
2018-08-03T09:30:00-04:00,167.15,167.6799,165.61,166.39,21735100,19155283.8,49.273646471779045,51.9587210679909,NaN,NaN,-53.42112126192709,-107.9145856844651,-0.2704845996193575,-0.0002716619344198534,0.27021293768493765,4613447880,4622317485.4,54.5199824892663,64.73043064162361,NaN,NaN,0.06450913353488157,6.17001107797558
2018-08-06T09:30:00-04:00,166.27,167.51,165.9,167.32,16288797,19141465.05,52.61627300361217,51.77532185303897,NaN,NaN,-22.99257382594533,-80.74738471917897,-0.17114575153221315,0.05628074826967122,0.22742649980188437,4629736677,4626018347.2,56.78446942369078,64.27917837908899,NaN,NaN,0.8003609467025651,5.4029182020794355
2018-08-07T09:30:00-04:00,167.89,168.4933,167.6,167.72,15045699,18954214.95,54.01969345308266,51.57344454754825,NaN,NaN,57.518921301607676,-45.17448181201847,-0.07645668142395554,0.13185564802193994,0.20831232944589548,4644782376,4628008144.8,57.99544748909169,63.83556973881314,NaN,NaN,1.8219449115418271,4.891350589145492
2018-08-08T09:30:00-04:00,167.72,167.985,166.49,167.57,14792590,18498212.6,53.38119067579546,51.04287507429631,NaN,NaN,13.522531055170251,-15.692304786517298,-0.024571214450196333,0.17759831138315008,0.2021695258333464,4629989786,4630627939.8,59.60059335140075,63.43229335428485,NaN,NaN,2.4763000887248023,4.546343374799679
2018-08-09T09:30:00-04:00,167.65,168.71,167.55,168,10537762,18044222.05,55.02241770986786,50.865113503264794,NaN,NaN,67.13336787767686,12.352225029316473,0.03483610918924129,0.24571466231989803,0.21087855313065673,4640527548,4631696853.4,60.267740118499816,63.01125238874789,NaN,NaN,3.4868619825224574,4.394988890188647
2018-08-10T09:30:00-04:00,167.05,168.665,166.96,167.53,20521940,18299826.45,52.833008637463905,50.47795740891926,NaN,NaN,40.11696142207451,31.059841566116795,0.03832846081767105,0.25878912915274555,0.2204606683350745,4620005608,4633008399,61.1162177110325,62.458291740239396,NaN,NaN,3.7537170922500804,4.30337863334028
2018-08-13T09:30:00-04:00,167.74,168.05,165.88,166.55,20518282,18528394.9,48.49952070376569,50.35897424694538,NaN,NaN,-27.198542097040317,30.218647911897797,-0.02604305046285943,0.1879068552565002,0.21394990571935962,4599487326,4626958528.8,55.25465608033078,61.48160725230648,NaN,NaN,2.7762789910777705,4.085221541588493
2018-08-14T09:30:00-04:00,166.91,168.6,166.89,168.2,17683090,18655813.25,55.16714602010666,50.54457949722354,NaN,NaN,50.3566599744178,28.786195646459817,0.03832395793743956,0.2618548531411591,0.22353089520371952,4617170416,4621436136.8,50.494043159833105,60.137262898690814,NaN,NaN,3.882519154061159,4.0562640576560165
2018-08-15T09:30:00-04:00,167.7,167.82,165.15,166.09,27477238,19340674.3,46.81940445186795,49.89278227811269,NaN,NaN,-57.23770630544597,14.63414817433657,-0.06003421255439617,0.14848812951072432,0.2085223420651205,4589693178,4613376815.2,44.472088827100066,58.3212278280374,NaN,NaN,2.1901261438033846,3.7896729271056406
2018-08-16T09:30:00-04:00,166.86,168.17,166.69,167.63,15484737,19194846.1,52.4721518558946,50.48790157404006,NaN,NaN,30.04995727338043,7.217466053477284,-0.02215797179032744,0.1808248773272112,0.20298284911753864,4605177915,4606306888.6,39.9688957988185,56.219117908638516,NaN,NaN,2.619211276635995,3.622464119895691
2018-08-17T09:30:00-04:00,167.47,168.47,166.93,168.35,15106680,19071635.45,54.88654996632774,51.480097015490685,NaN,NaN,68.00851665593503,12.795777100249389,0.046841841690758806,0.26153515123098714,0.21469330954022833,4620284595,4606362686,40.02051597721697,54.5425337660423,NaN,NaN,3.7501623011981122,3.6407067172246084
2018-08-20T09:30:00-04:00,168.81,169.18,167.83,168.82,12547301,19082248.75,56.44207829800149,52.12890465234154,NaN,NaN,122.41538092108718,42.71856170387489,0.11567104536083711,0.3592821162412747,0.2436110708804376,4632831896,4613031600,45.99750963814148,53.20098741515137,NaN,NaN,5.150388633950062,3.8563755624711016
2018-08-21T09:30:00-04:00,169.14,171.36,169.12,170.76,20661194,18823743.15,62.23097978244836,53.21688554500202,NaN,NaN,217.99171751262517,76.24557321151636,0.2743335016171354,0.5865279479018568,0.3121944462847214,4653493090,4620296134.8,51.649698109447804,52.52509241869712,NaN,NaN,8.312431553851283,4.492954989811127
2018-08-22T09:30:00-04:00,170.59,171.49,170.42,171.18,14329156,18619293.4,63.366106463136084,54.073583392367844,NaN,NaN,210.16423486289995,129.72596144518553,0.3833562415559183,0.7913897482296193,0.408033506673701,4667822246,4635921948.4,61.08471315320195,52.80189795193373,NaN,NaN,11.206805750382584,5.452076527035621
2018-08-23T09:30:00-04:00,171.09,171.52,170.175,170.66,12945761,18219371.05,60.924696438320765,54.905801247120834,NaN,NaN,171.22310434272535,157.96059085905455,0.3946882664008078,0.9013938396747108,0.506705573273903,4654876485,4645861662.4,65.67341592071791,53.598571768466,NaN,NaN,12.844897228379445,6.5081937700847385
2018-08-24T09:30:00-04:00,171.15,171.78,171.02,171.59,11894458,17374963.4,63.624064819167934,55.692072091089095,NaN,NaN,173.95902172771181,179.15069187340987,0.4358316382800711,1.0514951211239918,0.6156634828439207,4666770943,4655158932,69.3177869992796,54.49380873815091,NaN,NaN,15.060419669341945,7.729940327121482
2018-08-27T09:30:00-04:00,172.11,172.94,171.62,171.84,15880417,17164298.4,64.33727263341768,56.42904203254158,NaN,NaN,170.922152551112,188.85204619941484,0.4491140215393047,1.1770560097680516,0.7279419882287469,4682651360,4665122824.8,72.66696456185875,55.54177424334857,NaN,NaN,17.077395200344732,9.065291023296233
2018-08-28T09:30:00-04:00,172.16,172.48,171.1,172,13170323,16642763.55,64.81277383133653,57.245583686508795,NaN,NaN,132.76132127806014,171.80596695250182,0.4374701809648651,1.2747797144348283,0.8373095334699632,4695821683,4673588543.4,75.14903559001796,56.652377260392655,NaN,NaN,18.87158633970024,10.46619035421109
2018-08-29T09:30:00-04:00,172.02,172.77,171.455,172.5,13157918,16403530.6,66.323876126718,58.0528307162838,NaN,NaN,125.17478213119418,154.80807640616067,0.4315143782206061,1.3767025062457208,0.9451881280251146,4708979601,4681820014.4,77.3068742423313,57.86945826923776,NaN,NaN,20.823147533376222,11.945755665520394
2018-08-30T09:30:00-04:00,172.17,173.23,171.82,172.36,14199577,16198901,65.47599753231927,58.95590135163062,NaN,NaN,114.6822904532931,143.49991362827421,0.3876091270164077,1.4296995367956242,1.0420904097792165,4694780024,4689800722.2,79.19325160992516,59.160674976301515,NaN,NaN,22.23251591308632,13.415292843744098
2018-08-31T09:30:00-04:00,171.96,173.39,171.95,173.02,12240491,15724170.55,67.5801415843207,60.31880284309883,NaN,NaN,109.91246539309877,130.69060236135164,0.3723901739870059,1.507578127262974,1.135187953275968,4707020515,4697850636.6,80.9164233602804,60.99365835344077,NaN,NaN,24.038923164778023,14.932954318177515
2018-09-04T09:30:00-04:00,172.79,173.12,171.12,172.25,17923503,15805905.85,62.773290198870484,60.86209885586767,NaN,NaN,80.55435190217219,112.61704223156366,0.28384102778099307,1.4899892380022095,1.2061482102212164,4689097012,4699139767,81.1851528432329,63.18588047368361,NaN,NaN,24.32421517028458,16.27456301133567
2018-09-05T09:30:00-04:00,172.18,172.23,170.36,171.79,15166068,15811924.3,60.02643395495178,61.80545810608795,NaN,NaN,52.45548465016086,96.55587490598381,0.17310837436445947,1.4225336781767908,1.2494253038123313,4673930944,4694761619.2,77.20866343835849,65.52420723163064,NaN,NaN,23.82058776530407,17.35256654761687
2018-09-06T09:30:00-04:00,172.17,172.48,170.42,170.63,16647720,15904680.8,53.650816963116306,61.8896484708895,NaN,NaN,38.80824664529999,79.28256780880496,0.009209403389694781,1.2609370580494499,1.251727654659755,4657283224,4684422343.8,68.65626792182968,67.57330524041716,NaN,NaN,21.526694789827854,17.94887058221844
2018-09-07T09:30:00-04:00,170.21,171.445,169.6585,170.54,17247965,16240190.95,53.178875613675984,61.767671731414374,NaN,NaN,13.815644401905587,59.10923859852746,-0.1111574203474408,1.112780879225454,1.223938299572895,4640035259,4673473390.8,60.95600726787474,69.06869747546415,NaN,NaN,19.50248156982155,18.170815009018884
2018-09-10T09:30:00-04:00,171.25,171.68,170.39,170.75,11067142,15767451.05,54.19143350022835,61.606911388716284,NaN,NaN,24.160946087761246,41.958934737459955,-0.17853066036571041,1.0007749741157568,1.1793056344814672,4651102401,4662289768,54.261595848373794,69.65898934762359,NaN,NaN,18.057680545547708,18.154652942808717
2018-09-11T09:30:00-04:00,170.6,171.6,170,171.03,14078385,15445456.2,55.57107807314002,61.13120412376569,NaN,NaN,15.890385345579118,29.02614142614134,-0.20428258823929002,0.9239523991823546,1.1282349874216446,4665180786,4657506522.8,51.648940510663756,69.65893523342474,NaN,NaN,17.176119912620905,18.014862509924743
2018-09-12T09:30:00-04:00,170.79,171.09,169.33,170.62,21572349,15639919.15,53.05149517158939,60.3944461743695,NaN,NaN,-15.871835798669629,15.36067733637525,-0.2461657120807066,0.8205278473207613,1.066693559401468,4643608437,4651442021.4,48.46286693400875,68.75737478919665,NaN,NaN,15.74278220538949,17.69027960927685
2018-09-13T09:30:00-04:00,171.28,171.54,170.26,170.66,14570480,14994581.25,53.27408150492856,59.84797367912721,NaN,NaN,-3.7629781268325506,6.846432381948736,-0.26668496431120436,0.7333373540124626,1.000022318323667,4658178917,4651621160,48.563801983845984,67.53525950799151,NaN,NaN,14.58794638619206,17.247089148836167
2018-09-14T09:30:00-04:00,170.77,171.93,170.4,171.38,15734941,15007091.45,57.206931209009504,59.38960699268732,NaN,NaN,13.789869603820845,6.841277422331805,-0.22873426222011628,0.7141044905485217,0.9428387527686379,4673913858,4658396879.8,52.36401419297266,66.32427573611245,NaN,NaN,14.563943559172346,16.86378263602705
2018-09-17T09:30:00-04:00,171.42,171.54,169.35,169.56,20023209,15252917.9,46.542797909919756,58.11857308386603,NaN,NaN,-94.48558343794382,-16.888028482809208,-0.31770069847073135,0.5457128796802238,0.8634135781509551,4653890649,4658954529.4,52.673920318326914,64.89620114728875,NaN,NaN,11.318897489137415,16.071656186471387
2018-09-18T09:30:00-04:00,169.8,170.71,169.63,170.27,13018237,15276464.7,50.42527475097731,57.0908945781261,NaN,NaN,-107.28333741296932,-41.52277303451889,-0.3193697770273054,0.4642013568668233,0.7835711338941287,4666908886,4659300149.4,52.8785346008269,63.305451076632245,NaN,NaN,9.706623561135135,15.162365811423351
2018-09-19T09:30:00-04:00,170.28,171.07,169.07,169.65,17593518,15123080.9,47.201418116697106,55.725004720267464,NaN,NaN,-128.776696850965,-64.10374524497797,-0.3503846517099424,0.3455903192567007,0.6959749709666431,4649315368,4660441535.6,53.592119390886936,61.61154001581478,NaN,NaN,7.3593502530632335,14.047649303086192
2018-09-20T09:30:00-04:00,170.37,171.3,169.81,171.22,16918661,15252556.15,55.04013673611361,54.97958609196706,NaN,NaN,-42.993562766980105,-71.94986217300747,-0.25760777064386775,0.37396525766180844,0.6315730283056762,4666234029,4662052558,54.63633122893718,59.85747427431564,NaN,NaN,7.758639789936428,13.149219372636226
2018-09-21T09:30:00-04:00,171.75,171.82,170.22,170.4,32565335,16233534.85,50.798147381402686,53.780872220330046,NaN,NaN,-39.636424360109274,-82.6351209657935,-0.24404120903758064,0.32652151700870036,0.570562726046281,4633668694,4654003525.2,48.7360343206573,57.558875057199714,NaN,NaN,6.716638897776721,12.230279304799154
2018-09-24T09:30:00-04:00,170.26,170.5,168.76,169.77,15786693,16428146.6,47.753040903284734,52.70799727064536,NaN,NaN,-131.7919319680274,-90.09639067181021,-0.2681517472816647,0.23537304194420017,0.5035247892258649,4617882001,4646801795.6,44.14269069314041,54.91298490362168,NaN,NaN,4.882537766012287,11.180601942115317
2018-09-25T09:30:00-04:00,170.05,170.52,169.85,170.03,13758483,16322049.9,49.1088980849479,51.928173279930796,NaN,NaN,-83.63553591627574,-85.36683037247151,-0.2572047546584266,0.18201884590283157,0.4392236005612582,4631640484,4639748115.2,40.151151450097295,52.266019761603026,NaN,NaN,3.813827330432872,10.128205569017824
2018-09-26T09:30:00-04:00,169.93,170.03,167.78,168.03,17787202,16552893.85,40.41957408247298,50.98308450274199,NaN,NaN,-199.40666683617,-99.4928243695125,-0.36849993887201044,-0.02140132302875486,0.3470986158432556,4613853282,4632655698,36.570397631295535,49.97417188370772,NaN,NaN,-0.1282329351399036,8.663000068423862
2018-09-27T09:30:00-04:00,168.37,168.7,167.76,168.04,14471938,16618594.85,40.47628550152079,50.07575663758804,NaN,NaN,-202.77794973224846,-131.44970176256618,-0.4214664836652824,-0.1797344887383474,0.24173199492693498,4628325220,4625073936.2,33.16536139329902,47.98912574980947,NaN,NaN,-3.169043383075358,6.972708146781117
2018-09-28T09:30:00-04:00,167.45,169,167.45,168.55,22740288,17045630.4,43.433488686609266,49.30733200804382,NaN,NaN,-165.34745850940678,-156.59190859242568,-0.40222773420330055,-0.2610526728271907,0.14117506137610986,4651065508,4628553299,36.10551288142366,46.69226268074159,NaN,NaN,-4.783993750509,5.2931793043111
2018-10-01T09:30:00-04:00,169.29,169.32,165.77,166.33,27897458,17828478.75,35.22888634637994,47.85431831327524,NaN,NaN,-218.5549083001551,-173.9445038588512,-0.5120460960421211,-0.4988825586765415,0.013163537365579597,4623168050,4629610508.8,37.01222726077478,45.64678316289238,NaN,NaN,-9.129943061171272,3.232733252099333
2018-10-02T09:30:00-04:00,166.18,166.53,164.18,164.53,28440336,18354320.4,30.240835991931746,46.22498551472826,NaN,NaN,-265.24108099843073,-210.26561287528222,-0.6690276195661635,-0.8231209870921248,-0.15409336752596128,4594727714,4622227954.8,33.44323556029613,44.57395235048433,NaN,NaN,-14.712364155475107,0.6691479081601273
2018-10-03T09:30:00-04:00,165.18,166.73,164.51,165.97,26027249,18897379.45,37.825228222979106,45.12149599458901,NaN,NaN,-179.08531863205218,-206.20134323445865,-0.639046788224833,-0.9529018528070026,-0.31385506458216955,4620754963,4623608291,34.71089891446876,43.58445927410025,NaN,NaN,-16.586395517711946,-1.7959297241073116
2018-10-04T09:30:00-04:00,165.44,165.65,163.13,163.64,29463003,19538143.6,31.800568606341912,43.306755808684194,NaN,NaN,-196.9397499750686,-205.03370328302267,-0.7325892953328218,-1.2295916837481968,-0.49700238841537503,4591291960,4616201639,31.26936151287771,42.077698368379174,NaN,NaN,-20.50293843388271,-4.468359539789512
2018-10-05T09:30:00-04:00,163.75,164.16,160.66,162.16,31240134,20237752.05,28.676194998276813,42.030569886423976,NaN,NaN,-208.18932566728472,-213.60207671459824,-0.8427354517051808,-1.550421703046851,-0.7076862513416702,4560051826,4597998902.6,24.769509571079325,40.08452617214721,NaN,NaN,-24.81543232136504,-7.37508422287173
2018-10-08T09:30:00-04:00,161.77,162.4,160.55,161.82,21330667,20750928.3,27.99570557763542,40.428457802613835,NaN,NaN,-186.89156559436353,-207.26940817343993,-0.8828415089309827,-1.8112381375053985,-0.9283966285744158,4538721159,4581109524.4,20.509576241933956,37.77245771794056,NaN,NaN,-28.31230765116332,-10.3661161411991
2018-10-09T09:30:00-04:00,161.62,162.74,160.98,161.19,20620373,21078027.7,26.72996540187293,38.9662111801264,NaN,NaN,-151.83859885208747,-184.5889117441713,-0.8934403112498011,-2.045197017636667,-1.1517567063868661,4518100786,4565784138.8,17.5586465388445,35.19863822850897,NaN,NaN,-31.50508738745264,-13.385969176378177
2018-10-10T09:30:00-04:00,160.82,160.9865,156.36,156.56,46926177,22345719.1,19.68577854341025,36.440899880647585,NaN,NaN,-191.78873506503746,-187.12959503076837,-1.1382232551891291,-2.5745357753732776,-1.4363125201841485,4471174609,4535868068,13.481053825764533,32.258975556853784,NaN,NaN,-37.45597846534023,-16.824541931944186
2018-10-11T09:30:00-04:00,155.81,157.315,153.51,153.57,68877446,25061067.4,16.636664842730553,34.00079398502815,NaN,NaN,-203.38173717869788,-188.41799247149422,-1.409701146091081,-3.198438952798,-1.7887378067069188,4402297163,4498069108.6,10.24404286458099,29.50954759570547,NaN,NaN,-43.62186846012929,-20.65273143597063
2018-10-12T09:30:00-04:00,155.557,155.76,151.885,153.6,53492577,26948949.2,16.7759499300396,31.788144629796356,NaN,NaN,-182.53458748330382,-183.28704483469807,-1.4877372541505909,-3.6484093743951576,-2.1606721202445667,4455789740,4477216691.4,8.965137196284303,26.996865203072893,NaN,NaN,-47.98258984147757,-24.55699692247162
2018-10-15T09:30:00-04:00,153.36,155.29,152.54,154.17,32747562,27585166.85,19.527119570879734,29.67516045022006,NaN,NaN,-150.0628835916563,-175.9213084341566,-1.4025846259794799,-3.9139029027189167,-2.511318276739437,4488537302,4467179920,8.420240786226543,24.73037158422498,NaN,NaN,-50.38109598599904,-28.246153931546964
2018-10-16T09:30:00-04:00,155.28,158.86,154.04,158.64,35569062,28712708.1,37.09031029677749,29.437355894098953,NaN,NaN,-93.11909717940559,-164.17740809962024,-0.9675266379417797,-3.7207265741666617,-2.753199936224882,4524106364,4468381035.6,9.132016808699646,22.77048723975385,NaN,NaN,-45.74398470132819,-30.74584404151571
2018-10-17T09:30:00-04:00,158.1807,158.2199,155.885,157.96,24140149,29040039.65,35.80991738023317,29.104043885435555,NaN,NaN,-80.53597409031885,-141.92685590467653,-0.662416987507759,-3.581221170609581,-2.918804183101822,4499966215,4474139356.8,12.637630243388813,21.304220729045976,NaN,NaN,-42.71515085343854,-32.45574501464754
2018-10-18T09:30:00-04:00,157.41,157.63,154.3735,155,31042710,29746242.1,30.822080636092352,28.203229024684344,NaN,NaN,-92.38935543615409,-119.72837955616777,-0.5987452808081839,-3.6672357841120515,-3.0684905033038676,4468923505,4487464625.2,20.300211082765728,20.17527060057041,NaN,NaN,-41.99005526330678,-33.81778933588458
2018-10-19T09:30:00-04:00,155.47,156.36,152.74,153.36,34214194,29828685.05,28.457055844061358,27.719526845947307,NaN,NaN,-101.64990315893245,-103.55144269129349,-0.6041359980408139,-3.823660500854885,-3.219524502814071,4434709311,4483248539.4,19.71112306237565,18.9394774435419,NaN,NaN,-42.26874021002776,-35.025068032190745
2018-10-22T09:30:00-04:00,153.92,154.45,152.52,153.03,28218316,30450266.2,27.991623448920564,27.558868807160795,NaN,NaN,-100.3656679261857,-93.61199955819936,-0.5675530265827518,-3.928965786042511,-3.361412759459759,4406490995,4466839278,17.573627023992245,17.805933976663056,NaN,NaN,-42.63657103773441,-36.11242560441127
2018-10-23T09:30:00-04:00,150.93,152.89,148.92,151.66,37228114,31623747.75,26.084247652856348,26.720227337866312,NaN,NaN,-115.40212158557976,-98.06860443943421,-0.5716563022517742,-4.075983137274477,-3.504326835022703,4369262881,4435870581.4,14.399885432950114,16.355147299411723,NaN,NaN,-43.56381373655568,-37.17690962328904
2018-10-24T09:30:00-04:00,151.43,151.98,145.82,145.95,40412447,32755010,19.974919617995397,25.87553812441299,NaN,NaN,-141.62799926617615,-110.2870094746057,-0.8767115695272247,-4.600216296931734,-3.723504727404509,4328850434,4401647425.2,11.852464867538473,14.968226110458914,NaN,NaN,-46.781109341633076,-38.54893815448105
2018-10-25T09:30:00-04:00,146.73,149.82,146.41,149.11,32311281,33646977.15,29.77723582869305,25.954183898014154,NaN,NaN,-125.25985481658516,-116.86110935069192,-0.7863453324719507,-4.706436392994448,-3.920091060522497,4361161715,4380095067.2,10.582767328293514,13.95488737883136,NaN,NaN,-45.62915089170107,-39.560397116941054
2018-10-26T09:30:00-04:00,147.54,149.42,144.7,147.48,36986059,34359265.7,27.880166684797402,25.94593111995429,NaN,NaN,-131.40130105636902,-122.81138893017915,-0.7567680741719052,-4.866051153237379,-4.109283079065474,4324175656,4357988336.2,9.462983706296868,13.16584505485728,NaN,NaN,-45.430949535907914,-40.399047462507745
2018-10-29T09:30:00-04:00,149.13,150.63,145.07,146.67,33031269,34615956.25,26.960953745727224,25.96243028737246,NaN,NaN,-117.77359755994537,-126.29297485693107,-0.7127873469816475,-5.0002672627925335,-4.287479915810886,4291144387,4334919014.6,8.45729965686057,12.515748849001284,NaN,NaN,-45.593866928597976,-41.141164529092066
2018-10-30T09:30:00-04:00,146.85,149.89,146.56,149.73,29017208,34644799.85,35.59933216291951,27.09911268876598,NaN,NaN,-93.07463249125404,-121.82747703806595,-0.4134854014064029,-4.80433666756889,-4.390851266162487,4320161595,4325098757.4,8.06440292989329,12.128845213581911,NaN,NaN,-42.67812782073552,-41.36073071361256
2018-10-31T09:30:00-04:00,151.26,151.86,150.03,150.03,36785372,35182706,36.393591840008064,28.51032176000009,NaN,NaN,-60.23216579283925,-105.54831034339854,-0.1450373003689247,-4.5721478916236435,-4.427110591254719,4356946967,4330718064,10.623086581832737,12.155919764814175,NaN,NaN,-40.17922269611914,-41.19194385397064
2018-11-01T09:30:00-04:00,150.89,153.7725,150.81,153.49,28496352,35134373.45,44.842764116751205,30.51509420190806,NaN,NaN,-21.386715639962254,-84.77368250807396,0.29199410261410463,-4.062117962987088,-4.354112065601193,4385443319,4335574384.8,12.879722345773231,12.435532989777672,NaN,NaN,-35.082714678172735,-40.319196828856654
2018-11-02T09:30:00-04:00,154.0593,154.89,152.4365,154,26671569,34905945.2,45.98178653264764,32.40471327060577,NaN,NaN,6.006041669974927,-57.29221396280518,0.6228527230645167,-3.5755461617705464,-4.198398884835063,4412114888,4353162231.2,20.68979651385024,13.311929827465077,NaN,NaN,-30.731615164772975,-38.94954230541613
2018-11-05T09:30:00-05:00,154.04,154.66,152.35,153.88,16940941,34686458.9,45.74243028648913,33.02272184129946,NaN,NaN,12.20828182819644,-31.295838085176825,0.8281954091789698,-3.1631546233613506,-3.9913500325403204,4395173947,4373968143.2,28.81918100162443,14.718155841245418,NaN,NaN,-27.36982774465546,-37.295297368164604
2018-11-06T09:30:00-05:00,153.65,155.11,153.52,154.64,15572913,34434085.9,47.602737010126745,33.86506610057757,NaN,NaN,41.49367876799254,-4.382175833327513,0.9983746556758737,-2.743381712945478,-3.7417563686213517,4410746860,4392085196.2,35.06111154596182,16.31983307714349,NaN,NaN,-24.046065758393823,-35.40254999534021
2018-11-07T09:30:00-05:00,155.36,157.41,154.8,157.41,22127752,33194164.65,53.817852495719336,35.50762123340807,NaN,NaN,96.42525124480865,26.949307574202066,1.263591068623088,-2.162267532842492,-3.42585860146558,4432874612,4407270725.2,39.82436495981836,17.71441549693296,NaN,NaN,-19.14025533750966,-33.07936504422156
2018-11-08T09:30:00-05:00,156.61,157.9,156.34,156.99,14987739,30499679.3,52.79528971063599,37.24606650959197,NaN,NaN,103.56838640917739,51.94032798403,1.3680135264875064,-1.7158416933561966,-3.083855219843703,4417886873,4413759436,41.789153986914265,19.291417705828582,NaN,NaN,-15.458177299587462,-30.562052509273833
2018-11-09T09:30:00-05:00,156,156.03,152.9501,154.08,20654377,28857769.3,46.23976287869485,38.549505040290136,NaN,NaN,37.242344852441676,58.18758862052334,1.2041554881578955,-1.5786608596463338,-2.7828163478042294,4397232496,4410782957.6,41.12581013468942,20.973716499449804,NaN,NaN,-14.154704426135673,-28.218145640254097
2018-11-12T09:30:00-05:00,154.02,154.17,150.84,151.03,21886776,28314730,40.55573462221934,39.58318268095893,NaN,NaN,-16.070498212291003,52.53183261242585,0.8690551545349656,-1.6964974046355223,-2.565552559170488,4375345720,4406817312.2,40.21000085917373,22.817296172751494,NaN,NaN,-14.847502050716452,-26.308053698891577
2018-11-13T09:30:00-05:00,151.6,153.09,150.29,150.55,18468484,27459701.1,39.728051729314345,40.99412068891028,NaN,NaN,-27.075903445698206,38.817916169687706,0.6062206244747275,-1.8077767785770789,-2.4139974030518063,4356877236,4396043387.4,37.75044126636709,24.667151629810682,NaN,NaN,-15.656108950546471,-24.786347306270848
2018-11-14T09:30:00-05:00,151.82,152.5,148.48,149.45,24549050,27480146.15,37.823012372276914,41.56881901345198,NaN,NaN,-49.75231935902776,9.58240204892042,0.36151046944960186,-1.962109316239804,-2.323619785689406,4332328186,4375934102.2,33.61718791999256,26.312467386360613,NaN,NaN,-16.905091598909785,-23.660453633790695
2018-11-15T09:30:00-05:00,148.49,151.8,148.13,151.58,24481980,27152109.65,43.47520888107194,42.682750598900164,NaN,NaN,-34.953173331427685,-18.121909899200592,0.34629553090487963,-1.8907503720583065,-2.237045902963186,4356810166,4363718760.8,31.370295580849543,27.877275377400085,NaN,NaN,-16.26594448333874,-22.60409518372613
2018-11-16T09:30:00-05:00,150.61,152.29,150.06,151.94,29323504,26907575.15,44.395249605739394,43.928057446043894,NaN,NaN,-6.01428572700309,-26.773236015089548,0.3619747976883425,-1.7845774058527581,-2.1465522035411007,4386133670,4361498995.6,30.965270541420338,29.484987583440073,NaN,NaN,-15.47991175464228,-21.586354693857007
2018-11-19T09:30:00-05:00,151.68,152.03,148.37,148.86,21540887,26573703.7,38.60561147401833,44.14279168255094,NaN,NaN,-49.820356028857034,-33.523207578402754,0.17583824346107413,-1.926754399214758,-2.102592642675832,4364592783,4359348408.2,30.553683605880337,31.091364774582,NaN,NaN,-16.568312553360897,-20.869491530928993
2018-11-20T09:30:00-05:00,147.25,148.43,145.59,145.99,25906981,26007647.05,34.13805951043466,43.98168223043856,NaN,NaN,-122.25528943331976,-52.55908477592707,-0.11403403332842421,-2.2451351843363625,-2.1311011510079383,4338685802,4355710121.4,29.831274798380747,32.463378218621145,NaN,NaN,-18.979323071548187,-20.599467465303164
2018-11-21T09:30:00-05:00,146.78,149.37,146.53,148.03,17902261,24882137.75,39.49756800106668,43.59988250788967,NaN,NaN,-87.44705748548904,-60.09803240121933,-0.14012563161112546,-2.306258190521845,-2.1661325589107197,4356588063,4360562096.8,32.13572337968449,33.83880686390052,NaN,NaN,-19.282832437173393,-20.41137674699891
2018-11-23T09:30:00-05:00,146.82,149.3,146.81,147.89,11134825,23823314.95,39.26144447148261,43.11985807494931,NaN,NaN,-85.4549799106339,-70.19839371706057,-0.13831997865396328,-2.339032532228174,-2.2007125535742107,4345453238,4358290711.2,31.612319710900678,34.618987092261264,NaN,NaN,-19.594124271628484,-20.294626393374564
2018-11-26T09:30:00-05:00,149.32,150.4001,148.74,149.81,15346405,22741332.25,44.189157058760664,43.00890998725442,NaN,NaN,-47.1088180992161,-78.41730019150317,0.012656122284071536,-2.1848924007191215,-2.197548523003193,4360799643,4353223905.8,30.42199773487583,34.73347400177922,NaN,NaN,-18.355902776402885,-20.017665876664324
2018-11-27T09:30:00-05:00,149.18,149.73,148.29,148.57,14471032,21813320.4,41.82888359731795,42.59649188633951,NaN,NaN,-72.9584289093288,-83.04491476759752,0.04752228989076546,-2.1381456606397364,-2.185667950530502,4346328611,4349571071.4,29.557901473590775,34.34038756803844,NaN,NaN,-18.029706982633854,-19.733671748945685
2018-11-28T09:30:00-05:00,149.2,152.37,147.7,152.24,26125946,21668757.3,50.291527828405236,42.344611552959925,NaN,NaN,-22.02574481218472,-62.99900584337051,0.32102167502232604,-1.7843908567525943,-2.1054125317749204,4372454557,4356324822.4,33.328533471584564,33.87639960459317,NaN,NaN,-14.991638184846042,-19.056238382645738
2018-11-29T09:30:00-05:00,151.61,152.74,150.44,151.83,15134471,20586212.25,49.42643943222694,42.103979390216416,NaN,NaN,3.2512844754321164,-44.85933745118628,0.46864670639046446,-1.51960414878684,-1.9882508551773044,4357320086,4356471227,33.411743155088814,33.278013116605635,NaN,NaN,-12.835636174892848,-18.167580924395324
2018-11-30T09:30:00-05:00,151.46,152.86,151.08,152.62,20304680,20176628.65,51.169392536581014,42.45609579435115,NaN,NaN,19.836078207066784,-23.80112582764614,0.6051504392678839,-1.2318128060924494,-1.8369632453603333,4377624766,4362905532.6,37.12571467143107,32.992292012087184,NaN,NaN,-10.54261295022754,-17.0782997852285
2018-12-03T09:30:00-05:00,154.39,154.48,152.02,154.08,23353435,20010721.95,54.30378144822076,43.438099139065535,NaN,NaN,61.51180213904517,-2.07700177999388,0.7689063809648897,-0.8758302691542212,-1.644736650119111,4400978201,4370941244.2,41.51311022314429,33.08537125237079,NaN,NaN,-7.655404258158464,-15.732171852789921
2018-12-04T09:30:00-05:00,153.75,154.13,147.14,147.52,41077908,21217570.3,41.43440445469903,43.559981476593016,NaN,NaN,-53.990467523599975,1.71659049715188,0.4275889651357576,-1.1102504436994138,-1.5378394088351715,4359900293,4373655580.6,42.96098095595937,33.45755265877023,NaN,NaN,-9.254561157022446,-14.80679889625171
2018-12-06T09:30:00-05:00,145.45,147.2,143.43,147.2,37581207,22317985,40.92490241695675,43.78154505121301,NaN,NaN,-150.04966073700186,-23.888192687811554,0.18484143712255685,-1.3067876124319753,-1.4916290495545321,4322319086,4363628486.4,39.109323361380106,33.84984804744077,NaN,NaN,-10.654995453601813,-14.213684118730296
2018-12-07T09:30:00-05:00,147.14,148.26,143.27,144.02,28525063,22637850.55,36.16560946961956,43.25943080753784,NaN,NaN,-159.39526242452453,-56.417502067802886,-0.1663389778272748,-1.6995527718386256,-1.5332137940113508,4293794023,4350923273.8,34.84626530857746,34.098131599421336,NaN,NaN,-13.479740542949562,-14.108835036475906
2018-12-10T09:30:00-05:00,144.27,144.72,141.45,143.6,30776558,23427291.5,35.57712835585177,42.62956500397444,NaN,NaN,-196.74306663412062,-99.73333103604037,-0.3905576956509278,-2.0214109135750107,-1.6308532179240829,4263017465,4328001813.6,28.756251871501007,33.94034455156996,NaN,NaN,-15.885651344822127,-14.362665937668224
2018-12-11T09:30:00-05:00,145.68,146.19,142.39,143.45,29229335,23856039.4,35.35585722030498,42.397439700137774,NaN,NaN,-147.68861163603157,-141.5734137910557,-0.5053244364596832,-2.262508763498687,-1.7571843270390037,4233788130,4294563799.4,22.561623691709528,33.369483129129186,NaN,NaN,-17.867296894509476,-14.86332750293126
2018-12-12T09:30:00-05:00,144.88,146.76,144.76,144.82,27894826,24156441.9,39.08243670405786,42.750609499682284,NaN,NaN,-93.5044444729958,-149.4762091809349,-0.4473179507062204,-2.316331765421779,-1.8690138147155588,4261682956,4274920332,19.855617868075853,32.656936205535985,NaN,NaN,-18.454336844131785,-15.376328837388478
2018-12-13T09:30:00-05:00,145.24,145.69,142.54,142.77,23205437,24393289.55,35.76042011117042,42.483670364689694,NaN,NaN,-123.78974470971858,-144.22422597547822,-0.5012982317152244,-2.4956366043595892,-1.9943383726443649,4238477519,4258152018.6,17.883770157385612,31.638939546800348,NaN,NaN,-19.96450619375722,-16.031782745441156
2018-12-14T09:30:00-05:00,141.73,143.23,140.095,140.61,24037238,24367698.95,32.61471290279172,42.008903824068916,NaN,NaN,-156.9927235897711,-143.74371820852755,-0.6285172960057022,-2.7799849926514923,-2.15146769664579,4214440281,4242281270.2,16.23990511579713,30.540909932864377,NaN,NaN,-22.24167893773068,-16.918910772911087
2018-12-17T09:30:00-05:00,139.67,140.8801,136.16,137.02,36468455,24967022.7,28.178089106504643,40.86525611319349,NaN,NaN,-190.66323468673878,-142.52775181905116,-0.8847987184220569,-3.2574660946733616,-2.3726673762513046,4177971826,4225272142.4,14.682257425767887,29.4166427679281,NaN,NaN,-25.745365904213497,-18.179832934525717
2018-12-18T09:30:00-05:00,138.26,139.18,136.29,136.85,42277225,25614708.75,27.98396145773556,39.87633310322332,NaN,NaN,-172.68213257831812,-147.52645600750847,-0.9882661853981825,-3.6080001079990325,-2.61973392260085,4135694601,4205653436.6,13.119228427116568,28.242451836037084,NaN,NaN,-28.569689775683738,-19.66409819754829
2018-12-19T09:30:00-05:00,136.8,138.68,133.25,134,47676620,26921495.4,24.88831108559029,38.061817621593676,NaN,NaN,-178.34545581930658,-164.49465827677062,-1.1593077705010337,-4.068868635727142,-2.9095608652261085,4088017981,4170920441.6,10.905703361157208,26.6408211138637,NaN,NaN,-32.044899629656456,-21.432784116420887
2018-12-20T09:30:00-05:00,133.63,134.41,130.23,131.79,57908060,28521549.35,22.783579296177876,36.15875618330446,NaN,NaN,-187.3913991863652,-177.21498917209996,-1.3202516194374452,-4.559875389522915,-3.23962377008547,4030109921,4129246922,8.953697200060091,24.893817831361652,NaN,NaN,-35.676449109012715,-23.46759340107686
2018-12-21T09:30:00-05:00,132.38,132.95,127.98,128.37,59404809,30596676.75,19.969211988843497,33.93017185846607,NaN,NaN,-180.38668041711526,-181.8937805375688,-1.540639713181283,-5.165423411562074,-3.624783698380791,3970705112,4080499888.2,7.306301926881332,22.76385977817953,NaN,NaN,-39.80814947656113,-25.80195855471747
2018-12-24T09:30:00-05:00,127.73,128.47,125.84,125.88,28575715,31468721.25,18.205900956577096,31.35175182334866,NaN,NaN,-177.79011818587614,-179.31915723739627,-1.723871342999784,-5.779622877130521,-4.055751534130737,3942129397,4033331402.4,6.13085078489911,20.23655553259059,NaN,NaN,-43.86371491927783,-28.382209463940377
2018-12-26T09:30:00-05:00,126.28,132.1,125.81,131.93,40182691,32710535.55,33.557530277797355,30.789117953569967,NaN,NaN,-121.86670357208331,-169.15607143614932,-1.3252768157623436,-5.712347553833666,-4.387070738071323,3982312088,4002654899.8,5.509987248729857,17.561484553502765,NaN,NaN,-41.94922553817161,-30.320354617401982
2018-12-27T09:30:00-05:00,130.27,132.48,127.8701,132.48,39527882,33963378.05,34.756374045274455,30.348508784164093,NaN,NaN,-98.37489604081274,-153.16195948045055,-0.9308764859501197,-5.550666345508972,-4.6197898595588525,4021839970,3989419297.6,5.262370850040426,15.143845088407076,NaN,NaN,-40.08193327176529,-31.714865853739596
2018-12-28T09:30:00-05:00,132.48,135.01,131.54,132.86,35994373,34456799.4,35.62068253955384,30.30958543201654,NaN,NaN,-69.05340698565912,-129.49436104030934,-0.5685074618738648,-5.330424186901183,-4.761916725027318,4057834343,3994964182,7.145011890465355,13.165184129970498,NaN,NaN,-38.34897057944587,-32.662595100269066
2018-12-31T09:30:00-05:00,133.72,134.05,131.8,133.9,29173374,35158744.55,38.039912436417445,30.485498580628366,NaN,NaN,-61.02716434551973,-105.62245782599021,-0.20179562108943472,-5.014161251389112,-4.812365630299677,4087007717,4018224703,14.794368924406228,12.167906776606587,NaN,NaN,-36.189985748145475,-33.16650804996569
2019-01-02T09:30:00-05:00,132.17,135.17,131.54,134.66,27295132,35508267.15,39.8196279155549,30.80433934457479,NaN,NaN,-50.04574739811724,-80.07358366843845,0.13100555958745552,-4.648608680815357,-4.779614240402813,4114302849,4052659393.4,24.685777040005405,12.319632015770578,NaN,NaN,-33.89331212757661,-33.27033720391011
2019-01-03T09:30:00-05:00,133.91,134.64,131.65,132.25,29294638,35805327.3,36.2626122734796,30.602923313819193,NaN,NaN,-54.34254971170048,-66.56875289636187,0.222505625176602,-4.50148220893206,-4.723987834108662,4085008211,4073198618,29.912202725753332,13.037959505604684,NaN,NaN,-32.950712440558895,-33.22467652343136
2019-01-04T09:30:00-05:00,133.92,137.6,133.71,137.19,35355270,35519195.4,46.760807140165035,31.388665244461663,NaN,NaN,-9.592099416282966,-48.81219357145592,0.6265189357051382,-3.9408391644772394,-4.5673581001823775,4120363481,4092903320.2,34.6010800563533,14.23205306981666,NaN,NaN,-28.59030370755945,-32.56262326402109
2019-01-07T09:30:00-05:00,137.26,140.37,136.74,139.59,30477884,35164029.25,50.9847726863417,32.700812371858085,NaN,NaN,32.34312770590404,-28.532886633143278,1.0417056189526557,-3.265226076491558,-4.306931695444214,4150841365,4111504724.6,38.76575733012191,15.841042513697001,NaN,NaN,-23.555113653802874,-31.27583617684706
2019-01-08T09:30:00-05:00,140.8,141.79,139.39,141.73,27320946,35103823.4,54.454694869913226,34.57771278353013,NaN,NaN,67.14027562030516,-2.899398639978301,1.4231639333433868,-2.5279767787649803,-3.951140712108367,4178162311,4129735643.4,42.6223272678514,17.836761788131536,NaN,NaN,-18.244850100480082,-29.414266737366063
2019-01-09T09:30:00-05:00,142.22,143.39,141.62,142.9,25764592,34853225.1,56.27713833580433,36.598653989106474,NaN,NaN,92.51355786228454,25.612462412102058,1.6983384720077406,-1.8282176220986912,-3.526556094106432,4203926903,4147660454.2,46.20942921920291,20.200347558994846,NaN,NaN,-13.365252989038451,-27.121550487604978
2019-01-10T09:30:00-05:00,142.06,143.72,141.35,143.64,22896774,34536597.05,57.43717427187036,38.92357278812648,NaN,NaN,98.54883869826715,56.190740094095574,1.8611588427267347,-1.2001075406980135,-3.061266383424748,4226823677,4176023547.4,51.388194608744755,23.091954076679674,NaN,NaN,-9.054114816560295,-24.54048824888431
2019-01-11T09:30:00-05:00,143.01,143.99,142.6775,143.68,22428368,34263274.15,57.502809355132186,41.403517792337496,NaN,NaN,110.84808300276111,80.2787765779044,1.896108162609821,-0.691131180162472,-2.587239342772293,4249252045,4201801260.2,55.57447334072679,26.422009515298722,NaN,NaN,-5.558413853432372,-21.82876333524832
2019-01-14T09:30:00-05:00,142.82,143.44,142.09,142.25,29184961,34562250.35,54.280199349815945,43.854302603835535,NaN,NaN,99.86222748708586,93.78259653414077,1.7509447041457977,-0.3985584625900458,-2.1495031667358435,4220067084,4215646404,57.682352364972445,30.02029883230523,NaN,NaN,-3.4609051206770527,-19.204783590309567
2019-01-15T09:30:00-05:00,142.65,143.6481,142.0901,143.45,25678933,34644335.1,56.48412191423413,46.58846124366818,NaN,NaN,103.56985363581504,101.06851213724273,1.6643494526221185,-0.06906635095819524,-1.7334158035803138,4245746017,4229163145.2,59.693074156229834,33.84617193025742,NaN,NaN,-1.0521070028446093,-16.611544077814575
2019-01-16T09:30:00-05:00,143.68,145.2501,143.6717,144.52,20827343,33862279.5,58.409319229533224,48.36358902593502,NaN,NaN,111.15219422718933,104.79623941022369,1.6069133993685338,0.2752259456303534,-1.3316874537381804,4266573360,4241692436.6,61.518329296850915,37.8467677908375,NaN,NaN,1.5381681039465003,-14.018728051848708
2019-01-17T09:30:00-05:00,143.99,146.33,143.97,145.83,19273422,32712089.35,60.7016336890633,50.21682185763422,NaN,NaN,108.22703291550229,106.73187825367071,1.5824184181372036,0.6463355689333241,-0.9360828492038795,4285846782,4253497057.6,63.20876438638334,41.985795900576285,NaN,NaN,4.41385563699482,-11.385501810585346
2019-01-18T09:30:00-05:00,146.6,147.92,146,147.33,28306742,31743595.45,63.20255742153605,52.186955777775815,NaN,NaN,113.23868135351177,107.20999792382085,1.5883730345270195,1.0493834439548948,-0.5389895905721247,4314153524,4266477353.4,65.02797342288869,46.12029315289222,NaN,NaN,7.618747890285063,-8.670608996175288
2019-01-22T09:30:00-05:00,146.46,146.76,144.05,145,27741105,30235247.7,57.121553204896614,53.54993011838146,NaN,NaN,83.2301674769983,103.88358592180334,1.3650588421062104,1.1673339620606384,-0.19772488004557204,4286412419,4279746420.4,66.83339934433815,49.837366754315944,NaN,NaN,8.722608355988378,-6.185863660151907
2019-01-23T09:30:00-05:00,145.32,146.18,143.46,144.6,20621253,28296069.9,56.12322797184035,54.714472979544716,NaN,NaN,71.32366770258953,97.43434873515825,1.129806746917645,1.214533553601484,0.0847268066838392,4265791166,4283755450.2,67.38130903641817,52.88704761120256,NaN,NaN,9.355514102884149,-3.965666836861042
2019-01-24T09:30:00-05:00,144.43,145.76,144.33,145.47,16976334,27716100.85,57.84877265445341,56.256341578185705,NaN,NaN,71.73739758477971,89.55138940667632,0.9778778840511055,1.307074161747721,0.3291962776966156,4282767500,4286994278.2,67.84348806901826,55.596425135721496,NaN,NaN,10.36487678251417,-1.9184463198074404
2019-01-25T09:30:00-05:00,146.62,147.64,146.43,147.34,22266882,26820310.4,61.365761078150754,57.29955257375611,NaN,NaN,93.65832310250691,86.63764744407726,0.9477276533223132,1.5138558443495072,0.5661281910271939,4305034382,4290831798.2,68.41454356848799,58.01167252944539,NaN,NaN,12.24876737305721,0.10544135060179549
2019-01-28T09:30:00-05:00,145.96,146.91,145.37,146.55,22784746,25983153.6,59.12148531927328,57.880746333251224,NaN,NaN,77.92330431233995,79.57457203584289,0.8235713861065016,1.595592423660321,0.7720210375538193,4282249636,4284451020.6,66.30605988305743,59.978836997512225,NaN,NaN,13.220231858069798,1.978982851668653
2019-01-29T09:30:00-05:00,146.71,146.82,145.88,146.2,12084754,24787672.65,58.10755449004957,58.14166487754668,NaN,NaN,75.69215349305045,78.06696923905332,0.6732051194056174,1.6135274368108412,0.9403223174052238,4270164882,4281201513.2,65.20395143267436,61.591810152142436,NaN,NaN,13.761054941246325,3.662136007322606
2019-01-30T09:30:00-05:00,146.98,148.34,145.68,147.8,25516861,24604847,61.369176157814955,58.505381864833154,NaN,NaN,93.15193206477942,82.4326221114913,0.6372034547704248,1.7368266358682547,1.0996231810978299,4295681743,4287179628.6,66.31328269025809,63.02779968578924,NaN,NaN,15.132998671562673,5.300830673642615
2019-01-31T09:30:00-05:00,147.61,149.3,147.53,149.06,27252906,24602735.7,63.76193079213997,58.95715018770955,NaN,NaN,118.27822980278988,91.74078855509333,0.6516202525851409,1.914148496829256,1.262528244244115,4322934649,4295213058.4,67.79895385809553,64.19999677502857,NaN,NaN,16.990566835315256,6.970792982452992
2019-02-01T09:30:00-05:00,149.35,149.68,148.58,149.18,17057872,23990897.4,63.99068779955328,59.420570076596775,NaN,NaN,130.4988641957727,99.1088967737465,0.6226453024144414,2.0408348722621668,1.4181895698477254,4339992521,4302204686.2,69.0771725979785,65.1644752934037,NaN,NaN,18.59521165851751,8.63142422189078
2019-02-04T09:30:00-05:00,149.41,150.97,148.875,150.96,21301684,23288218.1,67.28924047863023,60.349787300083506,NaN,NaN,156.95350411240997,114.91493673376048,0.6725103473560701,2.258827504042813,1.586317156686743,4361294205,4318013600,71.80270335175808,66.17307179245981,NaN,NaN,20.95572796573021,10.39203904243927
2019-02-05T09:30:00-05:00,151.01,151.6,150.24,151.12,18295914,22679119.6,67.57674840882169,61.14211776398262,NaN,NaN,161.25900405154408,132.0283068454592,0.6642593632945506,2.416641360804931,1.7523819975103805,4379590119,4339898647.4,75.07756199184094,67.27196378071775,NaN,NaN,22.999909533089312,12.19316339824642
2019-02-06T09:30:00-05:00,151.04,151.37,150.1,150.93,13720569,21999100.75,66.82560920726793,61.74328133382081,NaN,NaN,139.36834166116492,141.27158876473632,0.596164744576074,2.497587928230473,1.901423183654399,4365869550,4353936208.8,76.92849172781231,68.37268966864356,NaN,NaN,24.533166443510368,13.956020976141268
2019-02-07T09:30:00-05:00,149.92,150.7028,148.39,149.69,22850753,21853408.8,61.98331984428036,61.83483034490775,NaN,NaN,92.21792874437295,136.05952855305296,0.4257636003995704,2.433627684153862,2.0078640837542916,4343018797,4357953038.4,77.44469939512989,69.38954216926831,NaN,NaN,24.621153964245906,15.479611403013358
2019-02-08T09:30:00-05:00,149.06,149.9,148.5,149.85,13462999,21381720.05,62.36229775277689,61.774811797139236,NaN,NaN,78.38321215045139,125.63639814398866,0.28854574560128343,2.3685462657558958,2.0800005201546123,4356481796,4361250893.4,77.88224402455216,70.30770435510142,NaN,NaN,24.79124321840086,16.809844519497286
2019-02-11T09:30:00-05:00,150.29,151.15,149.63,151.1,16374788,21079041.05,65.27475610745817,62.35718343303649,NaN,NaN,104.26849763500638,115.09939684850795,0.2482233198486261,2.3902796699653948,2.1420563501167686,4372856584,4363563369.2,78.20156639778807,71.1197162874907,NaN,NaN,25.705019247837935,18.080583766403095
2019-02-12T09:30:00-05:00,151.92,153.19,151.8815,152.99,20779904,20658788.2,69.16054967559303,63.28842069759025,NaN,NaN,145.95855737304797,112.03930751280873,0.31102439371994084,2.5308368422666945,2.2198124485467536,4393636488,4366372643,78.60566617392283,71.92145608302675,NaN,NaN,27.631526636137266,19.44500417636512
2019-02-13T09:30:00-05:00,153.42,153.76,152.7,153.42,15534481,20151565.6,69.98352247446584,64.15518854187685,NaN,NaN,145.78025655325987,113.32169049122771,0.34128646657431494,2.6464205317646474,2.3051340651903325,4409170969,4375032926.8,79.84602348168411,72.77878004107431,NaN,NaN,29.479906991938304,20.878561721447003
2019-02-14T09:30:00-05:00,152.58,154.37,152.4,153.77,18250979,20022747.4,70.66961222163171,64.81974933783978,NaN,NaN,136.94254174774846,122.26661309190281,0.3436840621138897,2.7347391428326944,2.3910550807188047,4427421948,4391913557,82.0326440479789,73.75150150389508,NaN,NaN,31.227276843544033,22.356949596032294
2019-02-15T09:30:00-05:00,154.78,156.24,154.27,156.22,27240206,20421086.6,74.98063408774769,65.95254567844509,NaN,NaN,171.27642859170206,140.845256380153,0.4617248256965545,2.968211112839498,2.5064862871429434,4454662154,4411549628.6,84.18246424898169,75.02838753003253,NaN,NaN,34.14580707454274,24.041072092962356
2019-02-19T09:30:00-05:00,155.55,157.1,155.55,156.65,15856928,19798595.9,75.65691191089905,67.20607120850578,NaN,NaN,165.67999996902205,153.1275568469561,0.51609654956125,3.1516069740945056,2.6355104245332557,4470519082,4431082128.2,85.97954640714403,76.51235859963751,NaN,NaN,36.76688645689146,25.859045573523655
2019-02-20T09:30:00-05:00,156.66,157.58,156.53,157.39,18317389,19327410.1,76.81821012905155,68.30957363502266,NaN,NaN,159.91511968652162,155.91886930965083,0.5463186845464256,3.318408780216288,2.772090095669862,4488836471,4450122124.8,87.47354754373225,78.02380608917136,NaN,NaN,39.33354095782279,27.78397348556639
2019-02-21T09:30:00-05:00,157.13,157.37,156.06,156.79,17497048,19171199.85,73.74627261473594,69.02274090806523,NaN,NaN,132.7057884238713,153.3039756837731,0.47305919051490664,3.3634140838134954,2.8903548932985887,4471339423,4462555815.6,88.3468226863856,79.4915110054778,NaN,NaN,40.66162437187545,29.623637897896256
2019-02-22T09:30:00-05:00,157.27,158.27,157.1,158.15,20411817,19342974,76.08113408878413,69.88634421443886,NaN,NaN,135.05681351659257,152.92683003754195,0.4627842234181605,3.468835172571289,3.0060509491531286,4491751240,4475421674,89.18685935383064,80.92791720232438,NaN,NaN,42.50628882800982,31.464016602198193
2019-02-25T09:30:00-05:00,159.08,159.5,158.09,158.19,17957117,19127485.75,76.14832257270692,70.5191357925872,NaN,NaN,130.7541489091703,144.82237410103556,0.40723127324874264,3.515090040714057,3.107858767465314,4509708357,4486430914.6,89.86042062388502,82.21775415033346,NaN,NaN,44.04018484892994,33.26061206601701
2019-02-26T09:30:00-05:00,158.01,158.19,156.89,157.1,21497347,19063115.8,70.34917135371808,70.71716600293693,NaN,NaN,96.26862627697838,130.94009936262685,0.25316901535433267,3.42432003665823,3.1711510213038974,4488211010,4489969300.2,90.07442054092331,83.28895833241076,NaN,NaN,43.76608947514318,34.76139455303503
2019-02-27T09:30:00-05:00,156.49,157.44,156.12,157.32,18194872,19368621.7,70.83199844839368,71.00333666301735,NaN,NaN,79.33828095021718,114.82473161536595,0.12846334615928878,3.3317302040030086,3.20326685784372,4506405882,4493483182.4,90.29351055077657,84.24360253405108,NaN,NaN,43.66401513891876,36.03319749387556
2019-02-28T09:30:00-05:00,157.09,157.48,156.37,156.78,18155251,19000541.2,67.90893991760535,71.42659523968342,NaN,NaN,70.02743638312744,102.2890612072172,-0.020099123177877765,3.1781429538713724,3.19824207704925,4488250631,4496865424,90.51063365030693,85.17688355227801,NaN,NaN,42.78248653355418,36.99738164240108
2019-03-01T09:30:00-05:00,157.95,158.34,156.7501,158.24,19247143,18600253.05,71.35130296143636,72.06866704030196,NaN,NaN,80.6728325871725,91.41226502133318,-0.04814554492790446,3.1380601458893693,3.186205690817274,4507497774,4500014730.8,90.7188152252019,86.09378149518156,NaN,NaN,42.9278759862874,37.84459512009913
2019-03-04T09:30:00-05:00,158.54,158.775,155.59,156.81,23301820,18912450.45,64.09876314910699,71.98466754327687,NaN,NaN,58.997275598413005,77.06089035918173,-0.18350791805880728,2.9568207932437645,3.1403287113025717,4484195954,4494912250.2,87.37425043184506,86.74897321189992,NaN,NaN,40.89421920410991,38.28025570352924
2019-03-05T09:30:00-05:00,156.94,156.95,155.96,156.08,16798163,18687274.4,60.70646020587917,71.38080400972589,NaN,NaN,37.70882023146052,65.34892915007815,-0.33394731484709084,2.722894567743708,3.056841882590799,4467397791,4490749606.4,84.63296430992536,87.17949450732866,NaN,NaN,38.16020584363885,38.2631057235449
2019-03-06T09:30:00-05:00,156.02,156.08,152.88,153.02,29604624,19252709.9,49.00002792903632,69.88198297076664,NaN,NaN,-24.537734356126958,44.57372608880932,-0.6338844394183836,2.2644863333178193,2.898370772736203,4437793167,4477027063.4,76.15099809301705,86.91556412242389,NaN,NaN,31.56595748932492,37.30637026151348
2019-03-07T09:30:00-05:00,153.02,153.14,151.37,151.68,26822483,19907805.6,44.915395934851325,68.04239609313947,NaN,NaN,-78.90001173641865,14.7882364649001,-0.900589511193723,1.7726338837440494,2.6732233949377724,4410970684,4461571074,67.89716773379931,85.90588724283963,NaN,NaN,24.66002630271945,35.499749695971474
2019-03-08T09:30:00-05:00,150.84,151.76,150.61,151.64,20565517,19793543.8,44.79535497318248,65.8863047278134,NaN,NaN,-105.22761156621846,-22.39185236577809,-1.0474686668872044,1.3638875613287667,2.411356228215971,4390405167,4438152552.6,57.693542717362355,84.0138214191525,NaN,NaN,19.21691209274493,33.17363003836768
2019-03-11T09:30:00-04:00,152.11,154.31,151.9,154.29,20854536,20163120.65,53.636029812203546,64.31338457790658,NaN,NaN,-55.98770653036444,-45.388848791533576,-0.9374867031041099,1.2394978493358337,2.1769845524399436,4411259703,4423565302.4,52.410105958165474,81.61600424422548,NaN,NaN,17.16098253063843,30.886108965834932
2019-03-12T09:30:00-04:00,154.4,154.98,153.8,154.37,18966779,20292720.2,53.876169509927486,62.674667390826286,NaN,NaN,-38.25943072384287,-60.58249898259426,-0.8341492763189393,1.1342979570412695,1.9684472333602088,4430226482,4416131040.6,49.90194237423415,78.9323181606899,NaN,NaN,15.632120871777957,28.70696780954108
2019-03-13T09:30:00-04:00,154.92,155.73,154.75,154.98,24109137,20459181.85,55.757842581473604,61.389779531307546,NaN,NaN,-16.90524976362399,-59.05600206409366,-0.7046690785119722,1.0876108852202435,1.7922799637322158,4454335619,4419439531,51.02522737559508,76.26648992420486,NaN,NaN,14.946773573811642,26.741225775865445
2019-03-14T09:30:00-04:00,154.9,155.02,154.2,154.35,14217484,20393332,53.33765985093978,59.765245657175804,NaN,NaN,-44.8568715535054,-52.247374027511015,-0.6431184839871458,0.9883818587482835,1.6315003427354293,4440118135,4425269021.2,53.023854742947606,73.68341816628465,NaN,NaN,13.656386300305206,24.871962993642555
2019-03-15T09:30:00-04:00,154.53,155.87,154.33,154.76,22025850,20582075.55,54.71525656572155,58.23431237096256,NaN,NaN,-30.972063164639746,-37.39626434719527,-0.5595352651721277,0.9320812612702696,1.4916165264423973,4462143985,4439616784.8,57.60917419684866,71.37975770721062,NaN,NaN,12.983526234582943,23.173614885205467
2019-03-18T09:30:00-04:00,155.06,156.45,154.48,155.75,24510167,20445573.6,57.94390356411238,57.34822181456216,NaN,NaN,-7.180542180590653,-27.634831477240517,-0.42823445567395124,0.9563234568499581,1.3845579125239094,4486654152,4454695674.6,61.8263853324962,69.36204090660867,NaN,NaN,13.343054638796414,21.76924913571846
2019-03-19T09:30:00-04:00,156.48,156.53,154.57,154.96,18633096,20584382,54.59866382415453,56.18869791283079,NaN,NaN,-13.63729035779291,-22.710403404030526,-0.3865275988251764,0.9013984139924389,1.2879260128176153,4468021056,4462254589.4,63.77206701217998,67.46765208242321,NaN,NaN,12.683475254170773,20.471281438354506
2019-03-20T09:30:00-04:00,154.54,155.42,152.41,153.26,29463214,21141673.25,48.155856770321684,54.777763402310526,NaN,NaN,-75.06092579551184,-34.34153861040811,-0.46035593761691396,0.7124810907964729,1.1728370284133869,4438557842,4459099034,62.34349964804968,65.45571393940483,NaN,NaN,10.118270615850417,18.992279892282493
2019-03-21T09:30:00-04:00,152.73,156.06,152.73,155.27,31844984,21859070.05,54.92807625967415,53.604675780756075,NaN,NaN,-30.314122177653392,-31.43298873523771,-0.36491651816665205,0.7166913807050719,1.081607898871724,4470402826,4465155972.2,64.01003184905727,63.54794369825164,NaN,NaN,10.006729560353843,17.708629844864113
2019-03-22T09:30:00-04:00,154.2,154.545,149.57,149.62,40663039,22871631.15,39.36286298486408,51.83782576902445,NaN,NaN,-156.3928822240463,-56.51715254711901,-0.656398025468832,0.261110367035684,0.917508392504516,4429739787,4458675132.6,60.904160049705915,61.657222956670275,NaN,NaN,3.719595384692305,15.710196350553854
2019-03-25T09:30:00-04:00,149.48,151.32,148.405,150.28,26454650,23296507.8,41.45007794575956,50.46236989330162,NaN,NaN,-181.4946543853623,-91.37997498807334,-0.7709286089271474,-0.046152368654418297,0.7247762402727291,4456194437,4452583189.6,58.05270090186946,59.758632713237716,NaN,NaN,-0.21213236132016397,13.435577963143281
2019-03-26T09:30:00-04:00,151.47,152.82,150.79,151.86,21308588,23287069.85,46.222379800758596,50.26396645556749,NaN,NaN,-98.16887571432895,-108.28629205938054,-0.7080765460366685,-0.16031944227310646,0.547757103763562,4477503025,4454479583.4,58.70091431269441,58.51219815750039,NaN,NaN,-1.6408352140755218,11.281804652112024
2019-03-27T09:30:00-04:00,151.71,152.21,149.48,151.27,23477054,23551178.95,44.755391818650764,50.25253759012459,NaN,NaN,-114.368873439204,-116.14788158811898,-0.6742097666892761,-0.2950051045980331,0.379204662091243,4454025971,4457573209.2,59.79246864093576,57.933291079438696,NaN,NaN,-3.245031017300646,9.2065424136245
2019-03-28T09:30:00-04:00,151.79,152.93,150.93,152.62,19473276,23617080.2,48.76247910627129,50.53590359963094,NaN,NaN,-63.05971495251168,-122.69700014309065,-0.5349428258208286,-0.28947387018479276,0.24546895563603582,4473499247,4458192493.4,60.02026758381249,58.09948571275656,NaN,NaN,-3.216375589277766,7.43183984178132
2019-03-29T09:30:00-04:00,153.68,153.97,152.1,153.09,28298935,24069669.8,50.11898887726107,50.284686389992196,NaN,NaN,-22.304271180392735,-95.87927793435992,-0.39185401007119436,-0.2443485569529571,0.14750545311823723,4501798182,4472604172.4,64.9911290875011,58.99813022199485,NaN,NaN,-2.760589920986835,5.975778447100155
2019-04-01T09:30:00-04:00,154.29,154.92,153.72,154.76,20075224,23908340,54.70742918794672,50.34406208127928,NaN,NaN,44.359303716170004,-50.708486314053474,-0.17639635821862665,-0.07298999465504608,0.10340636356358057,4521873406,4485739966.2,68.79903517885565,60.34792256518209,NaN,NaN,-0.8845845291164509,4.9957265933549255
2019-04-02T09:30:00-04:00,154.87,154.88,153.5072,154.36,18253472,23981105.45,53.43942748031622,50.17846100262518,NaN,NaN,41.63204935131874,-22.748301300923934,-0.058574489171952765,0.030188252098639623,0.08876274127059239,4503619934,4490963348,70.18765816471671,61.71666762154791,NaN,NaN,0.23626946778604105,4.315804146845085
2019-04-03T09:30:00-04:00,155.74,156.15,154.73,155.16,19554701,23478609.3,55.653284992452924,50.34386279844755,NaN,NaN,86.62339140504791,17.450151667926445,0.06858944535501343,0.17449954796435918,0.10591010260934575,4523174635,4504793080.8,73.54483008836347,63.18245157479191,NaN,NaN,1.8382925316295335,3.9618739161000067
2019-04-04T09:30:00-04:00,155.28,156.01,154.84,155.92,15909543,22932962.3,57.71046616119196,50.55780634098115,NaN,NaN,89.80772293569949,48.02363924556869,0.19223362618991818,0.3462021353467435,0.1539685091568253,4539084178,4517910067,76.27386698076972,64.51564391650057,NaN,NaN,3.7908042182149706,3.937435387830716
2019-04-05T09:30:00-04:00,156.3,157.47,156.19,157.38,21378988,22973635.85,61.41359910965275,50.805641737091186,NaN,NaN,142.2277698266139,80.93004744697001,0.35142428668133385,0.5932488675084926,0.24182458082715877,4560463166,4529643063.8,78.41844189382024,65.70079081373798,NaN,NaN,6.619634916027628,4.320606749001703
2019-04-08T09:30:00-04:00,156.85,157.5,156.07,157.12,14202430,22641030.55,60.39928290383054,51.219971671353754,NaN,NaN,122.49527997700149,96.55724269913631,0.4139824056970705,0.7593025879484969,0.3453201822514264,4546260736,4534520529.8,79.25778471406521,66.80691350672979,NaN,NaN,8.641024137153979,4.937809233023456
2019-04-09T09:30:00-04:00,156.46,156.7,154.91,155.2,18534152,22619399.2,53.387036153816965,51.593627341603415,NaN,NaN,62.313576189722866,100.69354806681713,0.3058128482481728,0.7275862425616424,0.4217733943134696,4527726584,4539341859.8,80.08239908836045,68.07397775246626,NaN,NaN,8.356586941844071,5.4262060485692585
2019-04-10T09:30:00-04:00,155.48,157.36,155.33,157.31,18938830,22360883.85,59.01801969136172,51.885766158152535,NaN,NaN,100.44659853742421,103.4581894932924,0.3527930935235697,0.8627647612179317,0.509971667694362,4546665414,4544040015.6,80.88007625252584,69.2789809241426,NaN,NaN,9.890259986004546,6.063928039631442
2019-04-11T09:30:00-04:00,157.52,157.68,156.81,157.11,12218698,22260944.55,58.29911433331701,53.238355540184884,NaN,NaN,109.87181999481456,107.4710089051154,0.3463325570652701,0.9428873640259496,0.5965548069606795,4534446716,4543112523.2,80.19723904372141,70.6570579951437,NaN,NaN,10.90124480423835,6.754973291718143
2019-04-12T09:30:00-04:00,158.13,158.16,157.11,157.68,14120287,21865666.4,59.80198376873791,54.549205956111905,NaN,NaN,114.96664002485218,102.01878294476307,0.3550652851191013,1.0403864133595562,0.6853211282404549,4548567003,4540733290.6,78.36941882045073,72.10825213218523,NaN,NaN,12.180525530553492,7.530052182980335
2019-04-15T09:30:00-04:00,157.95,158.1,156.5,157.17,10964045,21188360.3,57.79498934864165,55.37582092381784,NaN,NaN,93.86459687709127,96.29264632478103,0.3031307304618095,1.0642345413177168,0.7611038108559073,4537602958,4539001735,76.99406159314063,73.41490550935997,NaN,NaN,12.681714762860018,8.266003980106005
2019-04-16T09:30:00-04:00,157.71,157.8999,156.98,157.54,16782942,21095852.6,58.87336477992373,56.38424756390877,NaN,NaN,93.08286583785271,102.44650425440697,0.27136224140241993,1.1003066126089323,0.8289443712065123,4554385900,4544333598.2,78.25929252466547,74.7339643581978,NaN,NaN,13.399103775501175,8.999303950876744
2019-04-17T09:30:00-04:00,158.09,158.11,155.2,156.1,17108477,20478115.75,53.17845157431335,56.699674168768915,NaN,NaN,54.69028917091826,93.2952423811058,0.13777034732054738,1.0011573053571965,0.8633869580366491,4537277423,4542456000,76.66043605471177,75.92254782040489,NaN,NaN,12.410073392382612,9.486556728234724
2019-04-18T09:30:00-04:00,156.11,156.28,154.66,155.64,23276340,20049683.55,51.46580769158567,56.79587551264924,NaN,NaN,22.324890214966818,75.78585642513625,0.009587927507385685,0.8753718674208812,0.8657839399134956,4514001083,4538366873.4,73.15509160962864,76.50568800055684,NaN,NaN,11.097790344720853,9.716732959161314
2019-04-22T09:30:00-04:00,155.31,155.81,154.52,155.23,15596772,18796370.2,49.92254862487843,56.454098329572936,NaN,NaN,5.6154779817895,53.915624016523715,-0.10531537401044244,0.7341397224004425,0.8394550964108849,4498404311,4528334335,65.26949390950735,76.25357790988912,NaN,NaN,9.564867634320882,9.695037912755538
2019-04-23T09:30:00-04:00,155.37,158.05,155.36,157.57,23396092,18643442.3,57.71574184393992,56.75954935554605,NaN,NaN,68.16548754333323,48.7758021497721,-0.03013354996669282,0.8017881589525189,0.8319217089192117,4521800403,4525173824,62.96681724895753,75.73780355876347,NaN,NaN,10.447506275673971,9.802533393172457
2019-04-24T09:30:00-04:00,157.62,158.69,157.37,158.06,18053139,18480669.85,59.14937117625838,57.00926979724644,NaN,NaN,106.18183160831619,51.395595303864795,0.04225479516286368,0.8847402028727913,0.8424854077099276,4539853542,4522267352.4,60.84106341529344,74.83039165354418,NaN,NaN,11.599714665009731,10.059273574863496
2019-04-25T09:30:00-04:00,157.33,157.4725,155.47,156.75,19365357,18275085,53.888980172892325,56.736306512367904,NaN,NaN,31.543928255939342,46.76632312086901,-0.00587057693731885,0.8351471865382791,0.841017763475598,4520488185,4518909504.8,58.388565669119515,73.55287013128346,NaN,NaN,11.03524975426868,10.19869874334995
2019-04-26T09:30:00-04:00,156.96,158.49,156.395,158.27,16999448,18151393.6,58.50072605432148,56.528244151272816,NaN,NaN,89.39260531263467,60.17986614040258,0.053608568106807475,0.9080284736091073,0.8544199055022998,4537487633,4523606814.8,60.7708502540278,72.29232787129827,NaN,NaN,11.963281120420337,10.450781940074291
2019-04-29T09:30:00-04:00,158.62,159.61,158.49,159.03,13698861,17421389.9,60.62140787673935,56.544110220766306,NaN,NaN,167.32844675452708,92.52245989495009,0.12879053551117536,1.015408074891269,0.8866175393800937,4551186494,4534163251.4,65.54490322288278,71.3128363362138,NaN,NaN,13.38232595645453,10.869573942414325
2019-04-30T09:30:00-04:00,159.15,159.19,156.96,158.29,24127485,17624002.95,57.53825868470189,56.840626115829515,NaN,NaN,100.53680562932165,98.99672351214777,0.11385352938448534,1.0289344511107004,0.915080921726215,4527059009,4535214972.6,65.98898797402802,70.3061641137615,NaN,NaN,13.653234675866036,11.267239761478855
2019-05-01T09:30:00-04:00,158.67,158.7329,156.71,156.79,17734287,17598043.7,51.7885421907057,56.32423486578266,NaN,NaN,42.55216936764054,86.27079106401263,-0.005546200638480103,0.908148170928115,0.913694371566595,4509324722,4529109208.6,61.068022556262584,68.89101742117126,NaN,NaN,12.118218423066079,11.388808141705601
2019-05-02T09:30:00-04:00,156.64,158.15,155.6764,157.52,22715745,17756095.9,54.18785371454538,56.03057339301325,NaN,NaN,12.490868538208693,82.4601791204665,-0.04183597984737397,0.8613993967573776,0.9032353766047516,4532040467,4531419665,62.2162459671737,67.60666077284642,NaN,NaN,11.560345256746086,11.413313443854241
2019-05-03T09:30:00-04:00,158.31,160.64,158.19,160.53,20178822,17969559.85,62.47938342856753,56.22181622585823,NaN,NaN,220.8298897998432,108.7476360179082,0.121467944363715,1.0550703070593954,0.9336023626956804,4552219289,4534365996.2,63.6870341314284,66.55791900934483,NaN,NaN,13.821884921265676,11.757395083484447
2019-05-06T09:30:00-04:00,158.18,161.11,158.01,160.71,21262070,17963713.95,62.911680084403066,56.587294135555474,NaN,NaN,189.01530500204137,113.08500766741106,0.22043183493216234,1.2091421563608833,0.988710321428721,4573481359,4538824969.2,65.85339364290462,65.76215701289941,NaN,NaN,15.730136898525132,12.324929628490258
2019-05-07T09:30:00-04:00,159.31,159.87,156.25,157.53,25434464,18525315.65,51.60055979727241,56.067808065366094,NaN,NaN,35.966742829497036,100.17099510744615,0.058951029045378966,1.0623991077354447,1.0034480786900657,4548046895,4543022546.4,67.80082469393194,65.01512359641843,NaN,NaN,13.573286653116574,12.503266346294017
2019-05-08T09:30:00-04:00,157.26,158.09,156.65,156.76,16113734,18404294.75,49.28967355060231,55.790038206529594,NaN,NaN,-23.10159733692269,87.0402417665335,-0.10364016776754492,0.8738978689806345,0.9775380367481794,4531933161,4547544234.2,69.79895185067976,64.52501758184472,NaN,NaN,11.084582098428834,12.300597168027563
2019-05-09T09:30:00-04:00,155.52,156.65,153.74,156.19,25259925,18720349.5,47.5905925604421,55.51323712573363,NaN,NaN,-138.45462133929843,56.8511437910321,-0.24540428722485275,0.6707826777171135,0.9161869649419663,4506673236,4542470788,64.93025585708652,63.937529313805996,NaN,NaN,8.54800600066888,11.76451271554775
2019-05-10T09:30:00-04:00,155.59,156.83,153.67,156.62,26544657,19436647.45,49.01833681703664,55.44865056803065,NaN,NaN,-110.55719057435164,-9.426272283806862,-0.30230589885870407,0.5383045913685862,0.8406104902272903,4533217893,4538670508.8,61.47138849632963,63.666236070007585,NaN,NaN,6.930348604272468,11.073917842508425
2019-05-13T09:30:00-04:00,153.69,154.02,151.16,151.63,26936494,20077457.8,36.568469351203795,53.93813110426378,NaN,NaN,-260.8144100322898,-99.39221529067311,-0.6482371797395321,0.030314015552875162,0.6785511952924073,4506281399,4525230516.8,51.10319613939826,62.81883456218192,NaN,NaN,0.7208554022867721,9.594908922476762
2019-05-14T09:30:00-04:00,151.96,154.17,151.7,153.54,15519159,20305213.5,42.58002235517878,52.75460618847239,NaN,NaN,-171.49801229073694,-140.8851663147199,-0.7153730245016906,-0.21566508533470596,0.49970793916698464,4521800558,4519981249.4,47.71790691932299,61.88146624104117,NaN,NaN,-2.156902632634103,7.916078700318067
2019-05-15T09:30:00-04:00,152.4,154.41,152.0699,154.04,18410553,20386594.05,44.07424282758874,52.05355352095069,NaN,NaN,-131.10709827090363,-162.4862665015161,-0.6925983453056145,-0.3660399924650335,0.326558352840581,4540211111,4521636839.4,48.86837893283127,61.201452902734864,NaN,NaN,-3.8647468618493255,6.23310362000844
2019-05-16T09:30:00-04:00,154.51,156.175,154.44,155,13772117,20219776.05,46.9297840266077,51.227057661828276,NaN,NaN,-55.391764436988105,-145.87369512105403,-0.5837286807823395,-0.40310249813734345,0.1806261826449961,4553983228,4531098837.8,54.96745862875294,60.78692492950095,NaN,NaN,-4.303312101745465,4.727901374043597
2019-05-17T09:30:00-04:00,153.82,155.27,152.66,152.84,21534435,20132680.8,41.76283971709179,49.88001707899632,NaN,NaN,-108.58509927141534,-145.47927686046677,-0.6243841504773371,-0.5998540054516752,0.024530145025661837,4532448793,4530945017.8,54.85291022524265,60.02321114395522,NaN,NaN,-6.411791492388071,3.1365166788390733
2019-05-20T09:30:00-04:00,151.93,152.82,151.41,151.78,18689812,20287332.8,39.466427551320855,48.58917199804053,NaN,NaN,-146.2544934145731,-122.56729353692344,-0.6850053226374461,-0.8317265082711458,-0.1467211856336997,4513758981,4532440534.2,55.81696559463818,59.296638116855945,NaN,NaN,-8.871790023862381,1.4210442927388658
2019-05-21T09:30:00-04:00,152.63,154.04,152.58,153.82,11659095,19700482.95,45.65932427680212,48.151370718475995,NaN,NaN,-85.00822407451764,-105.2693358936796,-0.5555667247590308,-0.8411795915824882,-0.28561286682345743,4525418076,4533164037.8,56.30310075981921,58.956286559967126,NaN,NaN,-8.913207021749962,-0.05527732361668103
2019-05-22T09:30:00-04:00,153.22,153.59,152,152.53,13922642,19493958.1,42.68545628164248,47.32977090184007,NaN,NaN,-97.41302567525685,-98.5305213745502,-0.5250343018454817,-0.9419057441303096,-0.41687144228482786,4511495434,4527420902.4,51.46264103573447,58.188171922007186,NaN,NaN,-9.913514795718632,-1.4635969624883882
2019-05-23T09:30:00-04:00,151.06,151.06,148.58,149.39,26379401,19844660.3,36.46046152497705,45.47127648015503,NaN,NaN,-160.44000362330425,-119.54016921181343,-0.6749609320157006,-1.2605726073044536,-0.585611675288753,4485116033,4513647463.4,42.11205641222938,56.64710208492154,NaN,NaN,-12.953316475644804,-3.104985464367876
2019-05-24T09:30:00-04:00,150.38,151.09,149.79,150.79,16093125,19799344.15,40.61854288691311,43.878909537477185,NaN,NaN,-119.75266183918406,-121.7736817253672,-0.6388658326636744,-1.384193966118346,-0.7453281334546716,4501209158,4507399536.4,38.67886036106975,54.70606399336191,NaN,NaN,-14.009001714018135,-4.662702071460769
2019-05-28T09:30:00-04:00,151.01,151.65,149.58,149.59,14042225,19816512.35,38.30467477947082,42.929203464777075,NaN,NaN,-113.39563311116137,-115.20190966468485,-0.6525379033032368,-1.5610005125837176,-0.9084626092804808,4487166933,4502081126.8,35.98921484620128,52.43380614709544,NaN,NaN,-15.622202731280375,-6.22834502286357
2019-05-29T09:30:00-04:00,148.84,148.93,147.36,148.34,22622297,19741252.95,36.003884317903626,41.98021851958431,NaN,NaN,-147.01200921798417,-127.60266669337815,-0.6983899767226684,-1.7814500801838165,-1.083060103461148,4464544636,4489906438.8,30.72251174239628,49.64263185364661,NaN,NaN,-17.68516212219369,-7.86503317991073
2019-05-30T09:30:00-04:00,148.75,149.58,147.04,147.93,17739134,19741495.3,35.2558609915679,41.09916626466473,NaN,NaN,-133.8203982856062,-134.884141215448,-0.7068096013651277,-1.9665721051675575,-1.2597625038024298,4446805502,4476968452.4,26.315261692745025,46.88441798476508,NaN,NaN,-19.56465529075003,-9.536407767173486
2019-05-31T09:30:00-04:00,146.19,146.84,145.32,145.86,25411311,19876273.6,31.677472576119854,39.86053310459924,NaN,NaN,-164.12108865066813,-135.6203582209208,-0.7956522815476244,-2.2543278557369604,-1.458675574189336,4421394191,4464224084,22.839611954462995,44.125005374631755,NaN,NaN,-22.327290729485856,-11.363676761789538
2019-06-03T09:30:00-04:00,146.13,147.205,145.33,146.37,26554491,20195057.05,33.46916574277405,39.639154275425696,NaN,NaN,-141.01629635248645,-139.87308512358126,-0.7637822696452699,-2.4134034112459233,-1.6496211416006534,4447948682,4453571988.8,20.41281912440742,41.93283558784669,NaN,NaN,-24.029423068322398,-13.173069091294233
2019-06-04T09:30:00-04:00,147.92,150.29,146.4238,150.16,21217585,20192832.8,45.00999882797875,39.81272402348283,NaN,NaN,-72.87827886639224,-131.76961427462746,-0.4468598080124546,-2.2081959016162216,-1.761336093603767,4469166267,4449971855.6,19.652779596739904,39.92818363623361,NaN,NaN,-21.78580705611655,-14.403460229125992
2019-06-05T09:30:00-04:00,150.76,150.885,148.61,150.19,18184095,19830314.35,45.09119263955969,39.885363295766474,NaN,NaN,-43.34448635624335,-111.03610970227928,-0.20682152446209412,-2.0198629991813846,-1.8130414747192904,4487350362,4454533000.8,23.537175951749745,38.118811994727785,NaN,NaN,-20.012148544445882,-15.204701417028833
2019-06-06T09:30:00-04:00,150.12,150.52,148.31,149.8,20772463,20063250.8,44.1779775758716,39.688805692142466,NaN,NaN,-45.59067965800193,-93.39016597675842,-0.053887988421406297,-1.8804014602460484,-1.826513471824642,4466577899,4458487480.2,26.83957102166049,36.109677165649764,NaN,NaN,-18.83930050963647,-15.723929858829925
2019-06-07T09:30:00-04:00,150.35,151.51,150.02,150.86,17107474,19655628.25,47.30191359894942,40.084453826560875,NaN,NaN,-6.006652608524954,-61.76727876832981,0.129091384871312,-1.6651492407355022,-1.7942406256068142,4483685373,4470945716.6,36.189771569237486,34.77659583307797,NaN,NaN,-16.925114933226823,-15.89552772660091
2019-06-10T09:30:00-04:00,151.45,153.14,151.45,151.75,18912302,19274010.5,49.840091867451505,40.825429849141635,NaN,NaN,41.782187279694426,-25.20758204189363,0.31016759753428813,-1.406531128688954,-1.716698726223242,4502597675,4481875515.2,43.06467725642277,33.865718094634005,NaN,NaN,-14.569314165493802,-15.706068646442752
2019-06-11T09:30:00-04:00,152.87,153.23,150.58,151.3,15373037,18695837.65,48.56638284329517,41.03307688960542,NaN,NaN,29.891344321119696,-4.6536574043912555,0.39433602749196517,-1.2237786918582856,-1.6181147193502508,4487224638,4485487189.4,45.167000722348924,33.070282377671845,NaN,NaN,-12.95860814489192,-15.313574289078348
2019-06-12T09:30:00-04:00,151.18,151.78,150.62,151.47,11957587,18517759.05,49.09564087426467,41.49094721764987,NaN,NaN,20.28069397527791,8.071378661913002,0.452020468479877,-1.0530891337504045,-1.5051096022302815,4499182225,4487853562,46.55935166740994,32.720047422791524,NaN,NaN,-11.477459808468412,-14.7655579347055
2019-06-13T09:30:00-04:00,152.31,153.18,151.87,153.07,14839357,18339199.25,53.90342332170266,42.736873060273126,NaN,NaN,71.83171421084032,31.55585743568148,0.5803103577233322,-0.7797216550761163,-1.3600320127994485,4514021582,4497342298.6,51.840174125282566,33.414912973723894,NaN,NaN,-8.787776002542627,-13.911589087253661
2019-06-14T09:30:00-04:00,152.88,152.94,151.72,151.73,16154767,18458331.75,49.67213912685452,43.383558505983224,NaN,NaN,61.82915714807489,45.12301938700145,0.5571826297814577,-0.6635537255726263,-1.220736355354084,4497866815,4500178587,53.3248851210974,34.46105759944015,NaN,NaN,-7.616743137941001,-13.012325380208996
2019-06-17T09:30:00-04:00,151.87,152.895,151.67,152.24,12509313,18007075.65,51.240916942652625,44.30757580335335,NaN,NaN,72.06073716230333,51.17872936352323,0.5571544126929606,-0.5242933394878833,-1.0814477521808439,4510376128,4501734277.6,54.15964678195374,35.75894559485105,NaN,NaN,-6.194873086934635,-12.038403624026945
2019-06-18T09:30:00-04:00,153.27,155.15,152.258,154.01,22100754,18177622.75,56.32878684514371,45.759354555299076,NaN,NaN,123.20813875114213,69.84208824952772,0.650746389484875,-0.2680147653247502,-0.9187611548096252,4532476882,4510784726.4,58.77848374824236,37.762943595268624,NaN,NaN,-3.4250450957779335,-10.807923834277085
2019-06-19T09:30:00-04:00,154.19,154.7025,153.4,154.56,15625008,18375918.4,57.80226504371555,47.369811987595334,NaN,NaN,134.80137906394296,92.74622526726073,0.7187707114879875,-0.020297765449640792,-0.7390684769376283,4548101890,4520568659.4,63.10626533840717,40.39087242710163,NaN,NaN,-0.6847896193569016,-9.361761803574202
2019-06-20T09:30:00-04:00,156.05,156.22,154.44,155.29,17595703,18559571.45,59.74371843570252,49.37454383470838,NaN,NaN,158.93934792763397,110.16775201061947,0.7770527310763298,0.23224743690778382,-0.544805294168546,4565697593,4530903861.6,67.04253921330289,43.54822437416162,NaN,NaN,2.2004344421678987,-7.710019482753903
2019-06-21T09:30:00-04:00,155.13,155.17,153.61,153.95,19857126,18233457.7,54.76300325201486,50.89553222822558,NaN,NaN,107.68162858760311,119.3382462985251,0.6922996000192528,0.32056920585552007,-0.37173039416373277,4545840467,4540498592,70.21917810645203,47.10582144430766,NaN,NaN,3.3217374625122225,-6.134054204858742
2019-06-24T09:30:00-04:00,154.36,154.41,152,152.08,24002606,18628931.75,48.66562353090914,51.15664827843489,NaN,NaN,56.320255829987275,116.1901500320619,0.4869364541173117,0.23694017348290686,-0.24999628063440482,4521837861,4542790938.6,70.9398606257501,50.769184374951244,NaN,NaN,2.485951377722558,-4.902624835918557
2019-06-25T09:30:00-04:00,152.31,152.5,151,151.15,17462151,18799928.05,45.92689435150983,51.2163412578599,NaN,NaN,14.213921678771838,94.39130661758783,0.27562154028209906,0.09453064471821904,-0.18109089556388003,4504375710,4537170704.2,66.67938833391906,53.850770973677626,NaN,NaN,0.956544472764603,-4.0656006489638195
2019-06-26T09:30:00-04:00,151.7,152.22,150.76,150.8,15726887,18455157.55,44.90273076794791,51.26810934300821,NaN,NaN,0.13414634039819595,67.45786007287887,0.10803969834724675,-0.046041272629821606,-0.15408097097706835,4488648823,4525280090.8,58.65345533482907,56.123191281761095,NaN,NaN,-0.5990952913083984,-3.570385597870188
2019-06-27T09:30:00-04:00,151.24,153.77,151.24,153.63,22278430,18682122.35,53.86185320423154,51.736676457671216,NaN,NaN,51.79987837634679,46.02996616262143,0.17934774231270462,0.0701037069138124,-0.1092440353988922,4510927253,4514326022.8,52.396512838370164,57.280815658127715,NaN,NaN,0.7542391514339805,-2.9525820622553067
2019-06-28T09:30:00-04:00,153.95,156.02,153.94,155.5,35089883,19166050.95,58.64687169562665,52.36573215968373,NaN,NaN,131.59324313925376,50.81228907295157,0.3349755261506552,0.3094753722894268,-0.025500153861228392,4546017136,4514361356.6,52.41414664284213,57.94863490001482,NaN,NaN,3.482829281519921,-2.0332375845731314
2019-07-01T09:30:00-04:00,157.54,158.03,155.22,156.1,23151311,18995891.95,60.077527723795136,53.18795679400516,NaN,NaN,171.7387144138363,73.89598078972138,0.4534831137732437,0.5413537383553262,0.08787062458208253,4569168447,4523827473.8,57.008802705601546,58.79447789881857,NaN,NaN,6.136554415066937,-0.8661244417674074
2019-07-02T09:30:00-04:00,156.02,156.1175,154.26,155.15,19024616,18886243.5,56.73092788773773,53.73333443782467,NaN,NaN,105.83168053697469,92.21953256136196,0.44256115931420803,0.6410720737248425,0.19851091441063454,4550143831,4532981098,60.936616471600296,59.821425384832175,NaN,NaN,7.3249388271952265,0.3040274537986829
2019-07-03T09:30:00-04:00,155.6,156.34,155.17,156.26,9115116,18432794.55,59.56513624240403,54.137742503589045,NaN,NaN,120.89744566858526,116.37219242699936,0.4815435233071401,0.8004403185445597,0.31889679523741954,4559258947,4547103122.8,66.08480292240537,60.83889887034094,NaN,NaN,9.194872783356418,1.5741482151640735
2019-07-05T09:30:00-04:00,155.49,156.74,154.86,156.68,14156687,18102005.75,60.61632669340507,54.919470186914076,NaN,NaN,113.66709397072717,128.74563554587544,0.5046297042325832,0.9496839255281486,0.4450542212955654,4573415634,4559600799,69.86931888060501,62.02064413887721,NaN,NaN,11.035994322670806,2.925840516236464
2019-07-08T09:30:00-04:00,156.21,156.48,154.89,155.19,9735719,17733418,55.13971899138244,55.19795604753764,NaN,NaN,80.77094450325869,118.58117581867643,0.3935003587556014,0.9369296697400671,0.5434293109844657,4563679915,4563133354.8,70.85915342400803,63.21346604188108,NaN,NaN,11.000345986904623,4.079341297760486
2019-07-09T09:30:00-04:00,154.54,155.43,154.48,155.4,12381583,17406882.05,55.746576323194475,55.156369581684125,NaN,NaN,57.1876359591378,95.67096012773672,0.311666067014311,0.9330118947523545,0.6213458277380435,4576061498,4564511965,71.25601384767589,64.10471819184062,NaN,NaN,11.144478050944887,5.0886465482154
2019-07-10T09:30:00-04:00,156.2,156.56,154.85,155.67,17325420,17504501.2,56.56023311205445,55.0676530151369,NaN,NaN,75.58493420880495,89.62161086210277,0.2556019460316603,0.9408482602776189,0.6852463142459586,4593386918,4573160582.4,73.67786077562133,64.85983215164163,NaN,NaN,11.488087394484257,6.002852383396665
2019-07-11T09:30:00-04:00,155.89,155.94,154.215,154.91,14260840,17619663.85,53.57426536253808,54.62697779562516,NaN,NaN,40.955015155797916,73.6331247595453,0.1523142804226948,0.8756391647743271,0.7233248843516323,4579126078,4577134008.6,74.7312447188238,65.40902540203598,NaN,NaN,10.957028988466815,6.710591898406687
2019-07-12T09:30:00-04:00,155.14,156.67,154.88,156.11,16678026,17711597.3,57.39855348616277,54.815231383778574,NaN,NaN,75.66404652568373,66.0325152705366,0.14957778804754962,0.9102971194110694,0.7607193313635198,4595804104,4581611702.6,75.90162555961919,65.81491450583363,NaN,NaN,11.563269538754016,7.4038315613134476
2019-07-15T09:30:00-04:00,156.56,156.59,154.85,155.29,12194256,17513571.75,54.1179734689106,55.204684950778685,NaN,NaN,55.58061819066032,60.994450008016926,0.08075567556044083,0.8616639258140708,0.78090825025363,4583609848,4585597689.2,76.9261662696038,66.2425077661089,NaN,NaN,11.152968900498156,7.939422609768406
2019-07-16T09:30:00-04:00,155.13,156.2,154.67,155.24,15152686,17645740.4,53.91562256576089,55.775308394653756,NaN,NaN,40.51657048258673,57.660236912706715,0.02307568815791794,0.8097528604510273,0.7866771722931094,4568457162,4584076822,75.60537471152661,66.88007822165228,NaN,NaN,10.759819880401158,8.342336505573085
2019-07-17T09:30:00-04:00,155.24,155.34,153.73,154.13,14155079,17248456.65,49.49145561896999,56.103074455441046,NaN,NaN,-16.574437548584516,39.22836256122883,-0.09229626865689988,0.6713068364719845,0.7636031051288844,4554302083,4576259855,69.04368312065222,67.62223734921109,NaN,NaN,9.170491612004046,8.460644377920365
2019-07-18T09:30:00-04:00,154.08,155.01,153.73,154.71,15746865,17254549.5,51.7207484006781,55.95013839804437,NaN,NaN,-12.658055626679328,28.505748404733378,-0.1297182318830703,0.6014553152750466,0.7311735471581169,4570048948,4574444429,67.57683236057645,68.70654588651153,NaN,NaN,8.417910832227285,8.454539585678496
2019-07-19T09:30:00-04:00,154.94,155.43,153.82,153.82,17182646,17233896.65,48.20482455186625,55.204277887775774,NaN,NaN,-17.39681120548915,9.8935768584988,-0.2098372398432351,0.46887699735407296,0.6787142371973081,4552866302,4565856868.6,60.977396747271406,69.31820660825649,NaN,NaN,6.769520303369686,8.213822545348666
2019-07-22T09:30:00-04:00,154.24,154.7,153.4,153.68,14481912,16965135.95,47.6560232024277,54.317027564820954,NaN,NaN,-41.37973137973326,-9.498493055579916,-0.2641764480972112,0.34849367707579404,0.6126701251730052,4538384390,4556811777,54.896325529400634,69.167315381385,NaN,NaN,5.247158085612304,7.7900133368149005
2019-07-23T09:30:00-04:00,154.28,154.72,153.54,154.7,15493249,16539668.1,51.9483228619211,53.975412920119766,NaN,NaN,-24.629223250542896,-22.52765180220584,-0.2248782246540325,0.33157234435546457,0.5564505690094971,4553877639,4553895872.4,53.05928953566658,68.60464917167545,NaN,NaN,5.067351111342703,7.401061590318872
2019-07-24T09:30:00-04:00,154.29,157.45,154.12,157.26,23823122,16857716.65,60.66624858953406,54.05406380205763,NaN,NaN,98.99060215802086,0.5853561391152468,-0.030158205650296477,0.5187528119466265,0.548911017596923,4577700761,4558575608,55.625769697473864,67.85757536989462,NaN,NaN,7.62478638521271,7.433022275303706
2019-07-25T09:30:00-04:00,157.18,157.24,155.09,155.36,17902531,16966498.85,52.98308353070755,53.50883214757924,NaN,NaN,69.35455115453347,16.987877495357804,-0.03278840534125149,0.5079255109203586,0.5407139162616101,4559798230,4556525464.4,54.22698346889449,66.74026569762957,NaN,NaN,7.372871660720332,7.424429330363224
2019-07-26T09:30:00-04:00,155.58,157.415,155.5,157.2,14260262,16565590.45,58.4686108924277,53.746610140511045,NaN,NaN,140.3175393647817,48.530747609411975,0.07977677469927946,0.6404348846357095,0.5606581099364301,4574058492,4560763902.4,56.65377691057631,65.72559594667017,NaN,NaN,9.017706667512945,7.652040378527469
2019-07-29T09:30:00-04:00,157.19,157.36,155.6,156.15,13192152,15470703.9,54.55687194889855,53.66163125663276,NaN,NaN,93.93069284318115,75.59283245399486,0.07402845846753203,0.6531936830208451,0.5791652245533131,4560866340,4565260292.4,59.129360168886244,64.85940639818519,NaN,NaN,9.060106468641553,7.853192677115196
2019-07-30T09:30:00-04:00,155.06,157.84,154.71,157.84,20743141,15350295.4,59.279095986660984,53.85583574767609,NaN,NaN,131.6534282844823,106.84936276099988,0.1691165441502629,0.7905609047411417,0.6214443605908788,4581609481,4570806660.8,62.01145556460984,64.0260917402558,NaN,NaN,10.696259565702789,8.259345089770566
2019-07-31T09:30:00-04:00,157.78,159.23,155.55,156.56,40445872,16421358.2,54.647244891914944,53.93247714263157,NaN,NaN,142.10367691379923,115.47197771215556,0.13249834609883315,0.7870672932144203,0.6545689471155871,4541163609,4563499230.4,56.371246392854026,62.71466328840081,NaN,NaN,10.492173841493987,8.578320625731054
2019-08-01T09:30:00-04:00,156.88,158.17,153.59,154.29,38070177,17869111.25,47.551218268678376,53.22909605566839,NaN,NaN,-14.915812591514412,98.61790496294599,-0.048232690283812496,0.5942780842608215,0.642510774544634,4503093432,4552158270.8,48.93263773348637,60.7883070151056,NaN,NaN,7.826818427043514,8.470963168775691
2019-08-02T09:30:00-04:00,153.35,153.75,151.28,152.58,30148305,18668692.15,43.019458864879816,52.43634501252335,NaN,NaN,-218.64135317786835,26.82612645441598,-0.27396881843622056,0.3000497514993583,0.5740185699355789,4472945127,4531935597.8,39.03990519226118,58.08214550958114,NaN,NaN,4.022274978156604,7.835436284401537
2019-08-05T09:30:00-04:00,149.78,149.915,146.2072,148,39221517,20142982.05,33.74365813877205,50.995490410595565,NaN,NaN,-364.30170028377245,-64.82035217097473,-0.6986120701686932,-0.29924651777528766,0.39936555239340554,4433723610,4506507051.8,30.649109399028433,54.87098370154555,NaN,NaN,-3.1764630655836923,6.262307805832219
2019-08-06T09:30:00-04:00,148.9,149.7,147.38,149.36,24283346,20738070.2,38.01745600539325,50.175919009625794,NaN,NaN,-238.63888327523344,-138.87881448291787,-0.8449967512447417,-0.6568803866625217,0.18811636458222006,4458006956,4481786546.8,25.019338579825174,51.72638766291505,NaN,NaN,-7.1183099740722025,4.350790980131587
2019-08-07T09:30:00-04:00,147.92,149.71,146.69,149.32,23952105,21069404.45,37.93994043715603,49.19157558365993,NaN,NaN,-194.83832822017231,-206.2672155097122,-0.8967194349498688,-0.932782929105116,-0.03606349415524718,4434054851,4460364795.2,21.358173651053917,48.42505489794916,NaN,NaN,-10.082450057466556,2.2888994033318526
2019-08-08T09:30:00-04:00,150.15,152.63,149.99,152.54,19415553,21327140.1,47.26196769777696,49.1242286655107,NaN,NaN,-75.85241820140592,-218.45453663169047,-0.6763090350374878,-0.881449787952107,-0.20514075291461917,4453470404,4450440189.6,19.904903021654803,45.491305346119404,NaN,NaN,-9.318296032422461,0.6307286267955221
2019-08-09T09:30:00-04:00,152.09,152.15,150.03,150.62,19313212,21458899.4,43.10430836203594,48.79910617691129,NaN,NaN,-86.66897421317111,-192.06006083875104,-0.6233665147105942,-0.9843488963028619,-0.3609823815922677,4434157192,4442682602.6,18.826572904738995,42.914894444357856,NaN,NaN,-10.173924635282665,-0.9127932677870758
2019-08-12T09:30:00-04:00,149.81,150.12,148.33,148.67,15767098,21637541.5,39.3209365626728,47.89715001267927,NaN,NaN,-119.33971523248896,-143.06766382849435,-0.6786587028482225,-1.2093057601525459,-0.5306470573043234,4418390094,4439615899.4,18.402158409011918,40.439385078168236,NaN,NaN,-12.204515837870389,-2.5258964920846916
2019-08-13T09:30:00-04:00,148.34,151.79,147.67,150.27,21952977,21977556.05,43.6883718662197,46.68444453244253,NaN,NaN,-84.2317651478008,-112.18624020300781,-0.5707922945134426,-1.2441374254461266,-0.673345130932684,4440343071,4436083122.4,17.90150447742535,37.74479470530763,NaN,NaN,-12.33662566800015,-3.9274292315011854
2019-08-14T09:30:00-04:00,147.95,147.98,145.72,146.07,28235762,22681590.2,36.30198605780128,45.49293757009208,NaN,NaN,-140.73909692252872,-101.3663939434791,-0.7351572732266083,-1.5922917224659443,-0.857134449239336,4412107309,4431693614,17.27270305346616,35.105203247062754,NaN,NaN,-15.183388792557228,-5.535423454509191
2019-08-15T09:30:00-04:00,146.62,146.67,144.791,145.49,24281975,23108345.7,35.41160657272076,43.84600869011302,NaN,NaN,-138.36456730239001,-113.86882376367592,-0.8288398124060021,-1.8931842147468387,-1.0643444023408366,4387825334,4418564600,15.517066855179678,32.16686681453442,NaN,NaN,-17.657811603558606,-7.267193190087679
2019-08-16T09:30:00-04:00,146.14,148.91,146.11,148.63,23945306,23446478.7,43.49213880483156,43.055670608393946,NaN,NaN,-82.94961445474445,-113.12495181199056,-0.6340181713339346,-1.8568671165082549,-1.2228489451743203,4411770640,4414087289.6,14.958677420299608,29.011818046778227,NaN,NaN,-16.899108635993805,-8.643181110931412
2019-08-19T09:30:00-04:00,150.32,150.89,149.95,150.13,17031814,23573973.8,46.90918737630708,42.17210570765438,NaN,NaN,-31.84824255793172,-95.62665727707912,-0.37179648468731985,-1.6875945510334702,-1.3157980663461504,4428802454,4416169761.6,16.46440287678726,25.758457140505193,NaN,NaN,-15.116054982216076,-9.567877378257792
2019-08-20T09:30:00-04:00,149.92,150.01,148.99,149.15,13326668,23465644.75,44.99482415812819,41.48264708381247,NaN,NaN,-45.999370683836865,-87.98017838428633,-0.23849625621779502,-1.6139183866183942,-1.3754221304005991,4415475786,4411196304.6,15.747293203468416,22.856746198406224,NaN,NaN,-14.32313716074847,-10.24720020432789
2019-08-21T09:30:00-04:00,150.62,150.65,149.79,150.38,13794625,22964219.9,47.870335473680605,41.505441169884065,NaN,NaN,-23.872798525786465,-64.60691870493788,-0.05140870010671539,-1.4396830055339933,-1.388274305427278,4429270411,4414628925,18.38932866147718,20.67508126469128,NaN,NaN,-12.756401644547502,-10.60565755293069
2019-08-22T09:30:00-04:00,150.67,151.08,149.14,150.03,12982210,22718203.85,47.11555021940469,41.798019123778694,NaN,NaN,-23.58797272954923,-41.65159979036973,0.05886953409206286,-1.3146873878121994,-1.3735569219042623,4416288201,4420321498.4,22.717490945484215,19.50919453277864,NaN,NaN,-11.730932869654163,-10.766411169605473
2019-08-23T09:30:00-04:00,149.22,150.11,144.93,145.43,36977684,23854074.95,38.5192879517789,42.139135538993465,NaN,NaN,-95.10205769460457,-44.082088438341756,-0.15613504070414996,-1.5687257227844498,-1.4125906820802998,4379310517,4413829473.8,21.328278726577395,18.843420913317853,NaN,NaN,-13.639812997980957,-11.176897145087684
2019-08-26T09:30:00-04:00,146.8,147.05,145.71,147.03,19188188,24153876.75,42.45225692455334,42.45590703321919,NaN,NaN,-97.62159543490743,-57.2367590137369,-0.16772430430402752,-1.6222460624603343,-1.4545217581563068,4398498705,4407768724,20.09294926013081,18.491535961911108,NaN,NaN,-13.906769992571627,-11.566878980442533
2019-08-27T09:30:00-04:00,147.96,148.02,144.68,144.85,24565206,24344980,38.809418096805295,42.51801258033699,NaN,NaN,-112.48260133608287,-70.5334051441861,-0.2920577549213337,-1.819593951807974,-1.5275361968866403,4373933499,4399460266.6,18.5101841860085,18.288108142979294,NaN,NaN,-15.32916306674682,-12.104348135628861
2019-08-28T09:30:00-04:00,144.56,147.385,144.25,146.54,20134648,23329418.8,42.90004467517369,42.20644665015105,NaN,NaN,-102.16367383831229,-86.19158020669127,-0.23289929513564656,-1.8186603158061985,-1.585761020670552,4394068147,4392419813.8,17.26881706896164,18.099816289215493,NaN,NaN,-15.176644431477108,-12.543247606464325
2019-08-29T09:30:00-04:00,148.15,149.29,147.96,149.11,18795178,22365668.85,48.53450714866315,42.59431799205299,NaN,NaN,3.8411427341200723,-80.70575711395739,-0.005142476191219547,-1.5921891159095765,-1.587046639718357,4412863325,4391734838.6,17.148321781794834,17.979941209005197,NaN,NaN,-13.187066099605445,-12.635221676913057
2019-08-30T09:30:00-04:00,149.89,149.97,148.04,148.84,18729081,21794707.65,47.998635307776325,43.21415361670324,NaN,NaN,19.874719607143216,-57.71040165360786,0.13511869468284599,-1.4181482713647995,-1.5532669660476455,4394134244,4394699584,19.758113461134585,18.076795141299673,NaN,NaN,-11.78555421501007,-12.513840610926916
2019-09-03T09:30:00-04:00,147.45,148.315,146,146.66,20704417,20868852.65,43.79422960794161,43.22171488396909,NaN,NaN,-64.26386648423026,-51.03885586347243,0.09098686534233691,-1.4395333843697244,-1.5305202497120614,4373429827,4389685808.4,18.686134703234643,18.132840157428905,NaN,NaN,-11.892160991257086,-12.425029236688369
2019-09-04T09:30:00-04:00,148.01,148.36,147.175,147.84,13121041,20310737.4,46.52471005873531,43.95190945546438,NaN,NaN,-26.689549994759783,-33.88024559520781,0.14781451212828034,-1.3457521095517109,-1.4935666216799912,4386550868,4392209282.2,21.009066931094154,18.39972329154519,NaN,NaN,-11.145905401800118,-12.24229726027576
2019-09-05T09:30:00-04:00,149.85,151.91,149.37,150.59,25681627,20397213.5,52.33613690049436,45.16080447887678,NaN,NaN,85.87312665020765,3.7271145024961783,0.36479943651323965,-1.0375673260384417,-1.4023667625516814,4412232495,4395842151.8,24.359212422671206,19.031305117794584,NaN,NaN,-8.648391970305896,-11.728882218851494
2019-09-06T09:30:00-04:00,150.7,151.23,149.83,149.9,14645857,20158728.7,50.84312608923343,45.68587499919119,NaN,NaN,79.43255808047823,18.845397571767812,0.45042891620842207,-0.8393306172911537,-1.2897595334995757,4397586638,4392786814.4,23.45811132743097,19.638407539732537,NaN,NaN,-7.0752614838275285,-11.064079256705213
2019-09-09T09:30:00-04:00,150.57,152.24,150.06,151.91,25780078,20482072,54.88099703111528,46.25528997453464,NaN,NaN,122.63931635352814,39.398316921044795,0.6205195828235321,-0.5141100549701605,-1.1346296377936926,4423366716,4398633308.8,28.879680683648118,20.525213097365455,NaN,NaN,-4.48066375753826,-10.123591328252791
2019-09-10T09:30:00-04:00,151.68,153.95,150.89,153.85,29576175,21172525.85,58.430242407956406,47.214962706665226,NaN,NaN,159.5983831368084,84.17076684525253,0.8287509251947986,-0.09869098130019438,-0.927441906494993,4452942891,4414535921.6,41.10037785662735,22.336147715448238,NaN,NaN,-1.162855649300143,-8.843486231259556
2019-09-11T09:30:00-04:00,154.52,157.16,153.555,157,42970546,22223404.3,63.456860542416884,48.328285925860676,NaN,NaN,225.01291093975138,134.51125903215478,1.1253027553910344,0.47918653774380005,-0.6461162176472344,4495913437,4436408435.4,53.049969431375715,24.81190777044099,NaN,NaN,3.407672050100277,-7.093320762493866
2019-09-12T09:30:00-04:00,157.18,157.9,155.57,157.04,38648321,22744032.25,63.517188805026535,49.499831539119384,NaN,NaN,209.64205735364953,159.26504517284314,1.2606286922584116,0.9296696476757802,-0.3309590445826314,4534561758,4460874288,62.27070525209441,27.63713736377029,NaN,NaN,7.024559235899833,-5.076480762723337
2019-09-13T09:30:00-04:00,157.85,158.92,157.13,157.31,31042751,23082071.05,63.949813134712144,51.31629762361461,NaN,NaN,200.20344999242127,183.41922355523175,1.2996121883152145,1.2935561908113868,-0.006055997503827737,4565604509,4494477862.2,70.76371599690744,31.168240025936743,NaN,NaN,10.087487591525475,-2.910199569259221
2019-09-16T09:30:00-04:00,156.97,158.75,156.7,157.9,23242562,23046933.85,64.92851349555744,52.92174452154342,NaN,NaN,164.4898191980785,191.78932412414184,1.2936261030146559,1.6109766312644922,0.3173505282498363,4588847071,4527573933.2,76.39871962900642,35.190080766570716,NaN,NaN,12.920863094635546,-0.6486191887028259
2019-09-17T09:30:00-04:00,157.36,157.575,156.45,157.49,23025019,23346594.1,63.6356308366485,54.695045431532215,NaN,NaN,124.96930743421339,184.8635089836228,1.1930016564277905,1.8086025987845744,0.6156009423567839,4565822052,4550149765.4,79.32590690166067,39.534060960545865,NaN,NaN,14.949028446572173,1.5796161877650312
2019-09-18T09:30:00-04:00,157.48,157.5,155.065,156.52,19845744,23672547.9,60.563045743562846,55.95668836498858,NaN,NaN,94.31640498505465,158.72420779268347,0.9998776343681879,1.8654479853170187,0.8655703509488308,4545976308,4560162339.6,80.48211086394433,44.04929623161606,NaN,NaN,15.881390104485787,3.6227267472965674
2019-09-19T09:30:00-04:00,156.8,157.82,155.525,155.76,21945289,24080081.1,58.19224413848015,56.64652672140408,NaN,NaN,82.98029925761716,133.39185617347698,0.7700233367940299,1.8280995219413683,1.0580761851473384,4524031019,4558056191.8,79.47525410112804,48.50121996871129,NaN,NaN,16.051064704449438,5.398203598318406
2019-09-20T09:30:00-04:00,155.64,156.65,154.45,155.43,23570007,24609470.95,57.14617662526944,57.29992252979645,NaN,NaN,61.0728634172405,105.56573885844082,0.5548831127034453,1.7516800760266449,1.1967969633231996,4500461012,4545027492.4,73.36116900560322,52.33000965045905,NaN,NaN,15.922617378511534,6.901691281203139
2019-09-23T09:30:00-04:00,154.86,155.95,154.56,155.31,15461691,23533671.3,56.74670380222925,58.22509925795985,NaN,NaN,51.11257331663363,82.89028968215186,0.3723804094091365,1.6622724750846203,1.2898920656754838,4484999321,4524257942.4,64.80257328902167,55.624040978015266,NaN,NaN,15.713051940707087,8.160457089703703
2019-09-24T09:30:00-04:00,155.15,155.29,151.84,152.43,28353080,23991915.9,48.06296852831727,58.33497486292998,NaN,NaN,10.830064331521825,60.06244106161355,0.04291588271955016,1.3435369190749213,1.3006210363553712,4456646241,4502422780.2,57.241840696364,58.21209624696311,NaN,NaN,13.066852040665541,8.861370654126823
2019-09-25T09:30:00-04:00,152.28,154.36,151.8,154.1,22137081,23870509.65,52.593150968026116,58.353333010610825,NaN,NaN,9.087802346624464,43.01672053392751,-0.07111783645447467,1.2117237407872778,1.2828415772417525,4478783322,4488984183,53.133010025404566,60.26736750430121,NaN,NaN,12.000497151300442,9.309817296580198
2019-09-26T09:30:00-04:00,153.92,153.92,151.95,152.38,21122200,23919887.25,47.95378999214806,58.14695186081901,NaN,NaN,-12.621818525880931,23.89629697722789,-0.2603256514821155,0.9574345128891082,1.2177601643712237,4457661122,4475710203.6,49.363842045306306,62.117776841292304,NaN,NaN,9.681188006334226,9.362870255116487
2019-09-27T09:30:00-04:00,152.82,153.22,150.5,151.16,20183249,23989290.8,44.92654178121985,57.435919342969335,NaN,NaN,-43.413569173866094,2.999010459006571,-0.4542303803846688,0.6499721888903878,1.1042025692750566,4437477873,4463113575.8,46.027029126441974,63.34258744434901,NaN,NaN,6.795178557586095,8.996057155469288
2019-09-30T09:30:00-04:00,151.37,152.26,150.79,151.34,18105216,23958097.55,45.473469976580844,56.51043559787108,NaN,NaN,-52.4229193450581,-17.708088073331773,-0.5505342253452428,0.4160347875935031,0.9665690129387459,4455583089,4457230329.4,44.51359676714537,63.58638879510029,NaN,NaN,4.585646543998589,8.365998496687759
2019-10-01T09:30:00-04:00,152.11,153.35,148.05,148.37,34572321,24651492.75,38.65265961950893,54.73870696052052,NaN,NaN,-99.19951925432545,-39.71400479050122,-0.7803861825713945,-0.008913715275497225,0.7714724672958972,4421010768,4450103234.8,42.68262615614354,62.84586427544085,NaN,NaN,0.39604910527357196,7.227434297914304
2019-10-02T09:30:00-04:00,147.63,147.63,145.86,147.25,25066269,25248754.15,36.43332424809838,52.80414520645422,NaN,NaN,-174.0004845615708,-76.33166217214027,-0.9620529538699458,-0.431093725041535,0.5309592288284108,4395944499,4433535470.2,38.697786209119876,61.16208434379981,NaN,NaN,-3.8071375180271914,5.651066895636947
2019-10-03T09:30:00-04:00,146.69,147.94,144.93,147.74,26257819,25277563.75,38.107662421958544,50.95827729840039,NaN,NaN,-159.86618438294718,-105.78053534355354,-0.9990557597580187,-0.7178604708691125,0.28119528888890616,4422202318,4426443709.4,37.10109362561859,58.75761131727918,NaN,NaN,-6.774982031947588,3.875917048839156
2019-10-04T09:30:00-04:00,147.99,149.25,147.12,149.14,18821815,25486361.65,42.74771737596685,49.37393471842963,NaN,NaN,-114.72886388498564,-120.04359428577743,-0.8830951222659196,-0.8226736139434934,0.06042150832242624,4441024133,4427152961.4,37.37937475702115,55.97051525499452,NaN,NaN,-7.979839083126286,2.1822376014155216
2019-10-07T09:30:00-04:00,148.78,150.07,148.12,148.88,16064734,25000594.45,42.11622849600454,47.836834551240784,NaN,NaN,-95.74380320246324,-128.70777105725847,-0.7812633796126125,-0.9161577161933394,-0.1348943365807269,4424959399,4421028223.4,35.90219516469807,52.86882155949719,NaN,NaN,-9.147470756107428,0.5637078360551002
2019-10-08T09:30:00-04:00,147.42,147.93,146.11,146.46,18411888,24442380.1,36.68423821449429,46.1312054420216,NaN,NaN,-124.56418758482174,-133.7807047233577,-0.8296910393115823,-1.1720081357202048,-0.3423170964086225,4406547511,4418135572,35.19478251865543,49.634012391976555,NaN,NaN,-11.86321364558772,-1.2115666613224454
2019-10-09T09:30:00-04:00,147.54,147.6874,146.64,147.13,11050857,22846395.65,39.02888677588564,44.76239420183628,NaN,NaN,-103.97021688975971,-119.77465118899549,-0.7706721085478523,-1.3056572320934379,-0.5349851235455856,4417598368,4422466345.8,37.19019794619653,46.613651238052874,NaN,NaN,-13.427913173875103,-2.956759020258539
2019-10-10T09:30:00-04:00,147.34,148.5,147.1,147.72,16519948,21739977,41.097418290703125,43.61605432079583,NaN,NaN,-82.67746181141118,-104.33690667468832,-0.6507505018223665,-1.3484232508235436,-0.6976727490011772,4434118316,4424849545.4,38.31577967029331,44.11040914267359,NaN,NaN,-14.140923000768149,-4.554496731759912
2019-10-11T09:30:00-04:00,149.79,151.96,147.6865,150.22,29572307,21666454.8,48.99388712147766,43.06228170074214,NaN,NaN,-35.54927214007066,-88.50098832570531,-0.37556783655187,-1.1671325446910146,-0.7915647081391446,4463690623,4429382843.4,40.500042030158745,42.37451405275481,NaN,NaN,-12.358216783405702,-5.669313881995024
2019-10-14T09:30:00-04:00,149.91,150.3257,149.1,149.67,10965122,21052582.8,47.485654305891636,43.02104497056888,NaN,NaN,-35.05750357021048,-76.36372839925475,-0.21128395729801086,-1.0556696547616582,-0.8443856974636473,4452725501,4434936063.8,43.15547117891016,41.36834480150811,NaN,NaN,-11.337300023239788,-6.479026187887134
2019-10-15T09:30:00-04:00,150.17,152.13,149.79,151.39,18016649,20802164.3,52.41868038919683,43.00858278636679,NaN,NaN,2.8873436144678473,-50.873422159396846,0.02022633467354118,-0.8191027791217209,-0.8393291137952621,4470742150,4447774991.6,48.84026684926472,41.061720288926686,NaN,NaN,-8.926951902380901,-6.828729861386243
2019-10-16T09:30:00-04:00,151.21,152.27,151.14,151.55,13177575,20468755.85,52.86226895833247,43.35918842680853,NaN,NaN,24.22811048061622,-25.23375668532165,0.182135032223121,-0.6116603235163609,-0.7937953557394819,4483919725,4461039263,53.96269002563452,41.390209430378704,NaN,NaN,-6.846462072300315,-6.8312630343739675
2019-10-17T09:30:00-04:00,152.29,153.51,152.05,153.34,13459924,20044487.6,57.6221935107904,44.26602069320643,NaN,NaN,68.72060067011589,5.045855810983767,0.39553894677118695,-0.2993716722754982,-0.6949106190466852,4497379649,4473691529.6,58.25616689163339,42.26371927074952,NaN,NaN,-3.553041011917711,-6.362945602594502
2019-10-18T09:30:00-04:00,152.93,153.5,151.45,152.61,14490904,19590532.45,55.17521615394391,44.95900256301808,NaN,NaN,64.3170522496753,25.01912068893295,0.46831005378237833,-0.10952305181871225,-0.5778331056010906,4482888745,4477531154,59.490855251681644,43.3335234482164,NaN,NaN,-1.5121175148832964,-5.669970161492902
2019-10-21T09:30:00-04:00,154.17,154.98,153.905,154.04,17467259,19690810.85,58.86070319720939,46.40243424713954,NaN,NaN,123.60246002924143,56.751113408823336,0.5858992403658277,0.15454094485619407,-0.43135829550963367,4500356004,4487057254.6,62.45771384951916,44.74602971202894,NaN,NaN,1.374284849827675,-4.6636480170185335
2019-10-22T09:30:00-04:00,154.2,155.05,153.74,154.21,12669592,18906636.45,59.28923544666897,48.034999332751724,NaN,NaN,119.35307042750998,80.04425877143174,0.6436696721927843,0.3732287947313466,-0.27044087746143763,4513025596,4495513943.8,64.91436243237014,46.61864229940396,NaN,NaN,3.8506428917916646,-3.4473207443313623
2019-10-23T09:30:00-04:00,154.34,154.75,153.55,154.4,8769357,18238250.25,59.793332418787124,49.58397576109662,NaN,NaN,112.92973880546106,97.7845844364007,0.6607277458151757,0.555468804807532,-0.10525894100764369,4521794953,4503088989.4,66.99759373234335,48.754106592741444,NaN,NaN,6.042793019722357,-2.0915902066094025
2019-10-24T09:30:00-04:00,154.95,155.06,153.47,154.18,8687064,17616493.45,58.88413768195631,50.73657721152444,NaN,NaN,107.19689305463847,105.47984291330522,0.6237027152885355,0.6743694531030258,0.050666737814490215,4513107889,4506234637.4,67.8512475728575,50.93066893672975,NaN,NaN,7.647569126364306,-0.7002817304703013
2019-10-25T09:30:00-04:00,153.91,155.53,153.9,155,10531482,17133905.1,61.2492928683412,52.10322466669135,NaN,NaN,111.50418227903714,114.9172689191776,0.6196691818464543,0.825253215122558,0.20558403327610378,4523639371,4514384762.6,70.0153323600393,53.36732159353984,NaN,NaN,9.692804940670403,0.7844449368355135
2019-10-28T09:30:00-04:00,155.66,156.98,155.0061,156.34,15392374,16998263,64.81155551560266,54.11231875962767,NaN,NaN,128.36002482157778,115.86878187764486,0.6682983578871187,1.040956980635002,0.3726586227478834,4539031745,4522119910.8,71.94552782949343,55.99237483002827,NaN,NaN,12.536868884440523,2.463362643636229
2019-10-29T09:30:00-04:00,156.01,157.34,155.86,156.85,11978307,15868562.3,66.08926911271489,56.045203212258336,NaN,NaN,124.06422662181942,116.81101311650676,0.6928944301122737,1.2387766603882255,0.5458822302759518,4551010052,4529716802,73.73386797758938,58.602636975127766,NaN,NaN,15.312294579919314,4.298924348819527
2019-10-30T09:30:00-04:00,156.79,156.81,155.28,156.33,14451505,15337824.1,63.55529015575972,57.649336916905234,NaN,NaN,101.42203938922421,114.50947323325938,0.6338262114187827,1.3381649945494303,0.7043387831306476,4536558547,4532669520.8,74.41648804602805,61.181259001965955,NaN,NaN,17.009290705017513,6.114690971133525
2019-10-31T09:30:00-04:00,156.1,156.1,154.24,155.45,17344204,14892143.35,59.40427993334744,58.39293640346737,NaN,NaN,74.33083652354118,107.93626192703994,0.5009963125336332,1.3305841737976891,0.8295878612640559,4519214343,4533890811.6,74.70925778385086,63.624774412943964,NaN,NaN,17.36390623345752,7.721721722894095
2019-11-01T09:30:00-04:00,156.4,158.185,156.05,158.1,18421556,14872130.4,66.49997728823905,59.75110233077789,NaN,NaN,115.91511934748831,108.81844934073015,0.5530316656350605,1.5208774433078815,0.9678457776728211,4537635899,4536690117.2,75.4040353596128,65.92824328299415,NaN,NaN,19.88147733499851,9.45882966748044
2019-11-04T09:30:00-05:00,159.4,159.7,158.47,158.95,16182047,14877996.05,68.4074455166514,60.89315698273894,NaN,NaN,139.33025240970977,111.01249485835656,0.6020769321480997,1.7204419428579456,1.118365010709846,4553817946,4539647357.4,76.14945943675424,67.87889989638626,NaN,NaN,22.576252885237295,11.332747270017133
2019-11-05T09:30:00-05:00,159.4,160.46,158.97,159.15,13760242,14645413.75,68.85678176387752,62.035622183135004,NaN,NaN,141.8652649370707,114.57270252140681,0.6038232998035755,1.8731441354643152,1.2693208356607397,4567578188,4542960984.6,76.99093265870047,69.52377437017668,NaN,NaN,24.89877962203213,13.27075189173356
2019-11-06T09:30:00-05:00,158.99,158.99,157.81,158.23,16025460,14894143.9,64.32460973893268,62.51436619943089,NaN,NaN,109.27753535289462,116.14380171414089,0.5029800675919058,1.8980459201506221,1.3950658525587163,4551552728,4545959820.8,77.7558111160027,70.91660610048878,NaN,NaN,25.577043694784397,15.028793577883679
2019-11-07T09:30:00-05:00,159.74,160.17,158.17,158.65,13448926,14740592.8,65.44287146233228,63.247770150030064,NaN,NaN,115.97032163330422,124.4716987360935,0.4274913067416375,1.929429985985763,1.5019386792441256,4565001654,4555117283,79.94790996192339,72.37782429407747,NaN,NaN,26.45895530536977,16.661673824667407
2019-11-08T09:30:00-05:00,158.28,159.27,157.95,159.08,11985671,13861261,66.59728225788659,63.80038294007843,NaN,NaN,99.06072694406421,121.10082025540869,0.3715153204034958,1.9663328297484952,1.5948175093449994,4576987325,4562987568.2,81.62399015269662,73.7468440300187,NaN,NaN,27.522173087094824,18.213173719299895
2019-11-11T09:30:00-05:00,158.03,158.9,157.88,158.78,10525673,13839288.55,64.96666956963725,64.20591394886188,NaN,NaN,83.67127024052941,109.96902382157262,0.28327026365214425,1.9489053389101798,1.6656350752580356,4566461652,4565516309.4,82.14052824458169,74.97728444517668,NaN,NaN,27.97632529491747,19.607909658673833
2019-11-12T09:30:00-05:00,158.93,159.88,158.485,158.83,14316891,13654300.65,65.11995637148425,64.58638708834026,NaN,NaN,92.36288159330361,100.06854715281918,0.20111608252017477,1.917030178408254,1.7159140958880792,4580778543,4568156380.4,82.68767330578801,76.09800441470846,NaN,NaN,28.39582626714816,20.863326317027308
2019-11-13T09:30:00-05:00,157.74,158.5,157.19,158.15,14697826,13730313.2,61.19815784411258,64.75167424277998,NaN,NaN,50.20282383095745,88.25360484843175,0.0800409233342878,1.815965250055939,1.735924326721651,4566080717,4571061978.2,83.29427521300477,77.2010778175761,NaN,NaN,27.72639564141925,21.843764791940444
2019-11-14T09:30:00-05:00,157.93,158.91,157.7938,158.1,13134824,13714058.2,60.907695977165204,64.72727446483884,NaN,NaN,55.08397061229164,76.07633464422923,-0.019059492209151818,1.7120999614602113,1.731159453669363,4552945893,4568650826,80.76528655545309,77.96893168867709,NaN,NaN,27.08705724115889,22.59280657040022
2019-11-15T09:30:00-05:00,159.23,159.29,158.35,158.92,13121681,13645597.05,63.93120288646269,64.66439213418599,NaN,NaN,69.77760646539384,70.21971054849516,-0.0436267486611539,1.6766260178429206,1.7202527665040745,4566067574,4566466875.8,78.44210185391552,78.43297269042152,NaN,NaN,27.29205943164535,23.264128407720953
2019-11-18T09:30:00-05:00,158.72,158.74,157.94,158.52,10780160,13311242.1,61.4350745544814,64.33194966574074,NaN,NaN,47.415241430832204,62.96850478655572,-0.09794832443576507,1.5978173609593682,1.6957656853951333,4555287414,4564232028.2,76.03194683467362,78.59712118021325,NaN,NaN,26.813135223242192,23.771129381366844
2019-11-19T09:30:00-05:00,159.11,159.7,158.31,159.11,15212218,13438373.4,63.687189734863885,64.34137106424818,NaN,NaN,69.35216940396663,58.36636234868831,-0.10466897313680401,1.5649294689741282,1.6695984421109322,4570499632,4562176246,73.78607968192304,78.5520920113486,NaN,NaN,26.97926783822214,24.229434875203314
2019-11-20T09:30:00-05:00,158.55,159.595,157.26,158.51,21332219,14066516.5,59.85885064688896,64.37384040092972,NaN,NaN,38.41855173209452,56.00950792891574,-0.15690643360192724,1.4734654001085232,1.6303718337104505,4549167413,4558793585.2,70.11603514113402,78.224004679726,NaN,NaN,26.092633036435565,24.495606041093634
2019-11-21T09:30:00-05:00,158.82,158.89,157.23,157.73,15391852,14401755.9,55.21238376836994,63.56758372093907,NaN,NaN,4.240036232711214,45.840721052999655,-0.2460641338638383,1.3227916663806525,1.5688558002444908,4533775561,4554959518.8,66.10273021204111,77.55962574061371,NaN,NaN,24.00749764591234,24.42587627035345
2019-11-22T09:30:00-05:00,158.31,158.54,157.35,158.22,13482393,14549301.45,57.44703846003022,62.784697502608985,NaN,NaN,-0.4371878112813479,31.79776219766461,-0.2720796682094364,1.2287562149826954,1.5008358831921318,4547257954,4551197594.8,62.332773768516695,76.5727196214539,NaN,NaN,22.80983252407236,24.19501287802758
2019-11-25T09:30:00-05:00,159.03,161.83,158.89,161.58,24776400,15018502.75,68.90429743216356,62.7880914789151,NaN,NaN,196.10223052033285,61.53516001556477,-0.07337831917008697,1.4091129842295231,1.48249130339961,4572034354,4554546982.8,64.28575698284966,75.66520707317885,NaN,NaN,25.429424178834115,24.37135734957137
2019-11-26T09:30:00-05:00,161.75,162.54,161.29,161.69,15516610,15195417.9,69.19670339700775,63.13609816877761,NaN,NaN,242.34873480091133,96.1344730949537,0.04851480245526063,1.5431348064686858,1.4946200040134252,4587550964,4557957249.2,66.20694493960596,74.84028806057907,NaN,NaN,27.563767392573407,24.82741592714309
2019-11-27T09:30:00-05:00,162.38,162.93,162.08,162.83,13222952,15133990.25,72.12245364323218,63.61321118169902,NaN,NaN,249.59038558899695,138.3688398663342,0.18149779498962904,1.7214922477504615,1.5399944527608325,4600773916,4568278549.8,71.24805756532609,74.2188700322507,NaN,NaN,30.348230841592105,25.616103772064378
2019-11-29T09:30:00-05:00,162.41,162.795,161.67,161.77,9988199,14766190,65.85864421919635,63.560451321792584,NaN,NaN,177.21517429957555,172.96386747970706,0.1736479849637511,1.7570544339655214,1.5834064490017703,4590785717,4579680581,75.5816472547264,73.78727411096712,NaN,NaN,30.654543548494257,26.33588088298293
2019-12-02T09:30:00-05:00,162.15,162.21,159.91,160.19,17242018,14707213.1,57.80049174132556,63.04858147691318,NaN,NaN,82.14580444103481,189.48046593017028,0.04435743862233088,1.638853247279684,1.594495808657353,4573543699,4584937730,77.28187037177949,73.44022712005267,NaN,NaN,28.16910223962386,26.597769648217348
2019-12-03T09:30:00-05:00,158.82,160.1183,158.1,159.68,14993054,14647763.45,55.44239066682993,62.357326783723586,NaN,NaN,-4.549713989838172,149.3500770281361,-0.0860883837521984,1.4868853289671051,1.5729737127193035,4558550645,4582240988.2,74.41934616659773,72.84963232439623,NaN,NaN,25.404206723570823,26.42726065898213
2019-12-04T09:30:00-05:00,160.5,161.22,160.3,160.78,10842080,14501855.35,59.299304252669984,62.22169438433483,NaN,NaN,72.54822205047601,115.38997447804903,-0.10747747361562032,1.4386268706997782,1.5461043443153986,4569392725,4578609340.4,70.62548008663131,71.94471838679813,NaN,NaN,24.321261718346186,26.12640366746271
2019-12-05T09:30:00-05:00,161.47,161.65,160.45,160.94,11488959,14275030.3,59.84378531050786,62.14570076528788,NaN,NaN,74.80716236818077,80.43332983388578,-0.11913430597241148,1.3971864618498842,1.5163207678222956,4580881684,4574630894,66.61877602036473,70.93425334857753,NaN,NaN,23.630087601067316,25.769787086549083
2019-12-06T09:30:00-05:00,162.59,163.41,162.5,162.82,16486577,14426912.85,65.65729031725854,62.268992724630436,NaN,NaN,143.32802057711282,73.65589908939326,-0.014042164506988364,1.4987680621885602,1.5128102266955485,4597368261,4575947402.8,67.28027687886754,70.13698013607409,NaN,NaN,24.919361360078845,25.648297697053334
2019-12-09T09:30:00-05:00,162.75,163.155,162.39,162.51,13871128,14521185.7,64.01165770441975,62.453034378197465,NaN,NaN,115.04491033522328,80.23572026823095,0.018988189407253442,1.5365454634546154,1.517557274047362,4583497133,4577938089.6,68.30311884991572,69.58492099430568,NaN,NaN,25.431196302565816,25.617283212126544
2019-12-10T09:30:00-05:00,162.41,162.96,161.94,162.61,13878177,14688810.9,64.32230651119153,62.49839986222087,NaN,NaN,95.6220034682342,100.27006375984543,0.03124206946165531,1.5566098608744312,1.525367791412776,4597375310,4585703022.6,71.98229767243362,69.4560794221993,NaN,NaN,25.933149396803557,25.66240695279469
2019-12-11T09:30:00-05:00,162.88,163.08,161.95,162.56,19631237,14954528.2,64.02472205915826,62.795962105954395,NaN,NaN,87.16876211130777,103.19417177201179,0.020187432998250543,1.550602082660589,1.5304146496623385,4577744073,4587373292.2,72.71592770926227,69.64178603420847,NaN,NaN,26.257845036630243,25.74746953619977
2019-12-12T09:30:00-05:00,162.75,165.1,162.25,163.96,24875102,15463392,68.42904416304061,63.740009277002294,NaN,NaN,125.32160731943763,113.29706076226316,0.08759257354515304,1.63990536659378,1.552312793048627,4602619175,4591720790.4,74.58157980247384,70.24741814781079,NaN,NaN,27.870160648701265,26.050711123699983
2019-12-13T09:30:00-05:00,163.73,164.81,162.55,163.33,23339258,15973613.7,64.59655055202899,64.25068871214506,NaN,NaN,107.37414331563897,106.1062853099684,0.07089179471136164,1.6409275364378288,1.5700357417264672,4579279917,4588103121.6,70.27533729312402,70.81474411385418,NaN,NaN,28.101649657033573,26.34370234274764
2019-12-16T09:30:00-05:00,164.06,164.845,163.735,163.88,20125175,16323788.4,66.36750300513911,64.06948911021475,NaN,NaN,116.98226167037357,106.49375557699845,0.07749380400011074,1.6669029967266056,1.5894091927264948,4599405092,4591284713.4,71.81654601950954,71.35265761647274,NaN,NaN,28.8137456485206,26.696565672143777
2019-12-17T09:30:00-05:00,164.14,164.7,163.695,164.7,12990059,16434283.35,68.86788197405937,64.04600186571842,NaN,NaN,114.0892290379536,110.18720069094233,0.1154096063738943,1.7336712006938626,1.6182615943199683,4612395151,4594288681.6,73.22798201141704,71.85416026445925,NaN,NaN,30.169241687188237,27.192662245721557
2019-12-18T09:30:00-05:00,165.06,165.28,164.32,165.02,15459710,16446657.95,69.81110575241104,63.88090558780264,NaN,NaN,123.18033682164625,117.38951563301002,0.13879280484433676,1.7917526003753892,1.6529597955310524,4627854861,4604310839.2,77.31061448798687,72.28720004464931,NaN,NaN,31.567487588304914,27.81763729466204
2019-12-19T09:30:00-05:00,165.28,165.73,164.88,165.73,11931267,15976610.35,71.84904948724699,64.30879167837769,NaN,NaN,136.59812284592923,119.64481873830835,0.17641401484051555,1.873477314081697,1.6970632992411814,4639786128,4611744229.8,79.77423870718351,72.58667086268196,NaN,NaN,33.368762647490286,28.61065520220893
2019-12-20T09:30:00-05:00,166.15,166.41,165.72,165.97,25456092,16479822.35,72.52424901742337,65.36048862667039,NaN,NaN,152.5629901688708,128.68258810895472,0.19059078341182234,1.9353017785059592,1.7447109950941369,4665242220,4628936690.4,84.07984870062374,73.07224074331369,NaN,NaN,35.059176273496874,29.53187249810721
2019-12-23T09:30:00-05:00,166.24,166.36,165.36,166.3,13378604,16474632.9,73.46661396843945,66.64793314821392,NaN,NaN,137.8515488369559,132.85644554227116,0.1946390554534343,1.9880098144109297,1.7933707589574954,4678620824,4644779836.8,86.85654000225745,73.9606117315751,NaN,NaN,36.75327369308723,30.563501240247213
2019-12-24T09:30:00-05:00,166.45,166.7,166.04,166.68,4334517,15452538.75,74.54911132620211,67.73720508203765,NaN,NaN,136.8330219137183,137.40520411742415,0.19487402639402807,2.0369632919500305,1.8420892655560024,4682955341,4658891874.8,88.74035441341074,75.25453132634506,NaN,NaN,38.50192103955371,31.697561211576712
2019-12-26T09:30:00-05:00,166.83,166.98,166.36,166.68,9388339,15146125.2,74.54911132620211,68.78758551173009,NaN,NaN,126.62764815480509,138.09466638405587,0.16801170693962275,2.0521038992305307,1.884092192290908,4682955341,4669911970.8,89.95153389051484,76.92115688849864,NaN,NaN,39.957931163172375,32.877614061804664
2019-12-27T09:30:00-05:00,167.12,167.12,165.43,165.86,12264813,15098218.25,67.64266701185255,68.9293981327725,NaN,NaN,94.34808279355461,129.64465837358097,0.07286008100517138,1.975167293547372,1.9023072125422007,4670690528,4676092850.8,90.5645819831671,78.58432153880574,NaN,NaN,39.409634939113154,33.81075990142016
2019-12-30T09:30:00-05:00,165.98,166.205,164.57,165.44,14947611,15346188.85,64.35408782385747,68.95385742701806,NaN,NaN,61.007188146193556,111.3334979690455,-0.034744951120765366,1.858876023641244,1.8936209747620094,4655742917,4674192990.2,88.77180636022248,80.04637064668479,NaN,NaN,38.03702627840108,34.41451224098886
2019-12-31T09:30:00-05:00,165.08,166.35,164.71,165.67,17368500,15352512.95,65.34762431904522,69.02709441329333,NaN,NaN,61.31732024714833,96.02665225108399,-0.10295403113880841,1.764928435838499,1.8678824669773073,4673111417,4673091108.8,87.68762075442031,81.16817943825528,NaN,NaN,37.12669101682607,34.80196635182275
2020-01-02T09:30:00-05:00,166.74,166.75,164.2299,165.78,18298020,15517761.25,65.83804228870187,69.15661728683214,NaN,NaN,56.07120381644051,79.87428863162843,-0.1503183255129905,1.6799845600860692,1.8303028855990597,4691409437,4674781928,87.93119966534948,82.2549845779758,NaN,NaN,36.479655115957684,35.0416361752706
2020-01-03T09:30:00-05:00,163.74,165.41,163.7,165.13,19309352,15941124.85,60.39847114430836,68.58300492835129,NaN,NaN,11.308941108690556,56.81054722240553,-0.23029341613064913,1.5424361154357484,1.7727295315663976,4672100085,4672610876.8,85.58979087973167,83.0412853692085,NaN,NaN,34.42896775158826,34.95411211474455
2020-01-06T09:30:00-05:00,163.85,165.54,163.54,165.35,17180137,16225683.75,61.55620313531737,68.36583725572902,NaN,NaN,5.798628318522028,39.10065632739903,-0.2704696428545499,1.43464247799821,1.70511212085276,4689280222,4676328815.6,86.26432083024635,84.18335562186009,NaN,NaN,32.971463473706166,34.67087659459621
2020-01-07T09:30:00-05:00,164.85,165.335,164.21,164.8,11951253,15998917.55,57.06473255135674,67.70135365188742,NaN,NaN,-1.5972496540444079,26.579768767351435,-0.3321177546422174,1.2899649275499883,1.6220826821922056,4677328969,4680646026,87.02387976534675,85.26959374656276,NaN,NaN,30.44746844700621,34.067532573511926
2020-01-08T09:30:00-05:00,164.82,166.025,164.72,165.31,13836961,15997209.2,59.98067322612645,67.06655302703506,NaN,NaN,29.568715612603754,20.23004784044252,-0.3355886449296164,1.202596876030185,1.5381855209598014,4691165930,4684256928.6,87.63954285118713,86.29899094940346,NaN,NaN,29.007854772498447,33.34472145908143
2020-01-09T09:30:00-05:00,166.12,166.45,165.26,165.51,11912371,15898918.9,61.09650227621044,66.44408135016359,NaN,NaN,51.206232261797275,19.25705352951387,-0.32143183143561016,1.1363957316652886,1.4578275631008988,4703078301,4686590701.4,88.03468193158221,87.06499576680314,NaN,NaN,28.08190895706874,32.59289110165104
2020-01-10T09:30:00-05:00,165.55,165.69,164.2,164.89,15364093,15685561.7,55.89370218461271,65.30441368568971,NaN,NaN,-28.035652471209293,11.388134813533899,-0.3485663144407962,1.0221196700499036,1.3706859844906998,4687714208,4689713526,88.56161315444655,87.69266537017906,NaN,NaN,25.79891911766401,31.62232367536718
2020-01-13T09:30:00-05:00,164.94,166.04,164.07,165.96,17284919,15306052.55,61.92052609375101,64.5470049054274,NaN,NaN,6.0745224811684215,11.443313646063174,-0.2915126427194261,1.0062951810914171,1.2978078238108433,4704999127,4692857307,89.08284224661179,88.05002205203536,NaN,NaN,25.473128506056014,30.743867222608444
2020-01-14T09:30:00-05:00,165.14,167.59,164.98,166.57,18347624,15056470.85,64.86782181970666,63.9328054662322,NaN,NaN,110.94094812686126,33.950953202244285,-0.21337402343583634,1.0310902945160478,1.2444643179518842,4723346751,4702060863.4,90.45423729791058,88.30700043029628,NaN,NaN,26.090220642558382,30.079060568315576
2020-01-15T09:30:00-05:00,166.15,167.95,166.14,167.37,15437158,14822070,68.3298293880959,63.48857104208175,NaN,NaN,177.49855509170223,63.53692109806398,-0.11350424435844664,1.1025840125038258,1.2160882568622724,4738783909,4711584459.2,91.6264172011267,88.51314777227601,NaN,NaN,27.7193614696336,29.741960697075292
2020-01-16T09:30:00-05:00,168.59,169.865,168.43,169.53,19976236,15171378.85,75.38327924093343,63.548154464562565,NaN,NaN,308.16301472009485,114.92827758972348,0.08180158775341395,1.31834024155404,1.236538653800626,4758760145,4722720828,92.747860052557,88.71288535527901,NaN,NaN,31.883780785233917,30.047934995383667
2020-01-17T09:30:00-05:00,170.28,170.5586,168.67,169.07,18306378,15313712.25,71.7199181435858,63.8393866882578,NaN,NaN,247.51686729831852,170.03878154362906,0.15929791298927642,1.4356610450372216,1.2763631320479452,4740453767,4733268739.8,93.61948407814089,88.93109264777715,NaN,NaN,33.89991794702315,30.598218274189307
2020-01-21T09:30:00-05:00,168.36,168.9905,167.27,167.67,17935111,15613904.45,61.86594759035515,63.66166238586477,NaN,NaN,118.72914239106757,192.56970552560887,0.09853936008423902,1.399537332153244,1.300997972069005,4722518656,4736772645.6,93.88251484798873,89.29614325404616,NaN,NaN,32.091035136338284,30.811477825924875
2020-01-22T09:30:00-05:00,168.19,168.62,167.18,167.56,14916349,15086917.3,61.1549754163038,63.36218746424039,NaN,NaN,92.0473101869421,188.79097793762506,0.03641058693529575,1.3465112057381248,1.310100618802829,4707602307,4733623756.8,90.28058931185181,89.4813552938627,NaN,NaN,30.470732127441963,30.762799868998744
2020-01-23T09:30:00-05:00,167.1,167.965,165.45,167.45,15954270,15215700.6,60.407364717654076,62.97428192345126,NaN,NaN,37.52621045552656,160.7965090103899,-0.023403107858298133,1.2808467339799563,1.3042498418382544,4691648037,4724196582.4,80.34247225601052,88.93930333605276,NaN,NaN,28.961531054917778,30.505475752701464
2020-01-24T09:30:00-05:00,168.01,168.01,164.23,165.39,20491383,16023543.9,48.45968620885349,62.12151157091877,NaN,NaN,-24.84695110822366,94.19451584472623,-0.2030213276983983,1.0504731822152564,1.2534945099136547,4671156654,4706675884.2,65.83693339356623,87.52838494418381,NaN,NaN,23.299116620994294,29.475995876743298
2020-01-27T09:30:00-05:00,162.85,164.49,162.42,163.51,18539046,16481079.25,40.572825003577165,60.62269884722304,NaN,NaN,-147.8844756655738,15.11424725194775,-0.4363649127892846,0.7080383689270491,1.1444032817163337,4652617608,4689108652.4,55.09593111210183,85.30207139288777,NaN,NaN,15.339917407595937,27.456556095436532
2020-01-28T09:30:00-05:00,164.5,165.4,163.4901,164.87,16690367,16702356.95,47.25981934942471,59.9223479042279,NaN,NaN,-78.22088164518405,-24.27575755530257,-0.4833864650005788,0.5401702004656102,1.023556665466189,4669307975,4678466516.2,49.79589397196044,82.64292955050303,NaN,NaN,11.339466304623388,25.15411469674894
2020-01-29T09:30:00-05:00,165.1,165.56,163.9,163.93,14968785,16703415.65,43.60740731256789,58.752828910402286,NaN,NaN,-80.16817618739141,-58.71885483016928,-0.5568389204420676,0.3275080149136045,0.8843469353556721,4654339190,4667813892.8,45.117304146216796,79.6056267858623,NaN,NaN,6.834198495382012,22.53698381083938
2020-01-30T09:30:00-05:00,162.84,164.135,161.93,163.93,21889663,16929473.8,43.60740731256789,57.50360784157068,NaN,NaN,-125.29966475282316,-91.28402987183922,-0.5817495023626685,0.1571600574023364,0.7389095597650049,4654339190,4660352123.4,42.131262600734324,76.32681111937315,NaN,NaN,3.450292626376074,19.810313641630337
2020-01-31T09:30:00-05:00,163.32,163.9195,160.03,160.53,30439036,17536524.6,32.931224199430645,55.86343084262911,NaN,NaN,-182.81524897552654,-122.87768944529981,-0.7905832566940257,-0.24931951110252726,0.5412637455914985,4623900154,4650900823.4,38.642640650236174,72.76117022621526,NaN,NaN,-4.003250769530433,16.408375868607372
2020-02-03T09:30:00-05:00,161.6,162.93,161.49,162.32,17403639,17441238.95,41.10616109651342,54.37669048568357,NaN,NaN,-134.7019865894357,-120.24119163007217,-0.7707335074507952,-0.42215313872199545,0.3485803687287997,4641303793,4648638060.4,37.834895831898336,69.10060262516431,NaN,NaN,-6.835322890531416,13.087847474444688
2020-02-04T09:30:00-05:00,164.31,165.31,164.16,164.77,15994178,17381941,50.075763602772206,53.32011489875968,NaN,NaN,-33.18244884310735,-111.23350506965684,-0.5647136094716723,-0.35731164311079056,0.20740196636088165,4657297971,4646236059.6,36.951891526499395,65.27900649863494,NaN,NaN,-5.5450902239741975,10.42599923181342
2020-02-05T09:30:00-05:00,166.48,167.53,165.685,167.31,17807017,17674729.2,57.33123624958079,52.534501103151456,NaN,NaN,46.725907762639544,-85.85468827965066,-0.2457750861744143,-0.09981689135713623,0.14595819481727806,4675104988,4650389219.2,39.57766895608401,61.56123876684618,NaN,NaN,-1.4836488713897054,8.72462093135583
2020-02-06T09:30:00-05:00,167.89,168.15,166.76,166.93,14768884,17721325.35,56.01955445164808,51.15137790391679,NaN,NaN,58.348903203422424,-49.12497468840153,-0.05856804774824337,0.07274813513197387,0.13131618288021724,4660336104,4651588602,40.35027512806666,57.818554129382576,NaN,NaN,0.9797389136237683,7.6182092145369635
2020-02-07T09:30:00-05:00,166.29,166.36,164.4,164.88,18029615,18027187.55,49.44702821397733,49.56045719465904,NaN,NaN,-19.987882756976486,-16.559501444691524,-0.07018346442313654,0.04358685235129656,0.1137703167744331,4642306489,4655269869,42.76915895104227,54.186388048875536,NaN,NaN,0.5288998004628852,6.605450726812095
2020-02-10T09:30:00-05:00,164.56,165.89,164.46,165.81,11428805,17830423.15,52.18763468070959,48.86914912968435,NaN,NaN,-14.469967637855325,7.486902345624553,-0.015471444299986134,0.09443101139945043,0.10990245569943656,4653735294,4657756169.2,44.4088174641063,50.652552521455355,NaN,NaN,1.166822403206525,5.8285038234398705
2020-02-11T09:30:00-05:00,166.79,167.96,166.2679,166.96,15005571,17716455.75,55.40697228746211,48.45857747762424,NaN,NaN,45.76684879474854,23.27676187319574,0.0920203823210306,0.22492793360072483,0.13290755127969422,4668740865,4660044748,45.94401427741039,47.48565430470954,NaN,NaN,2.8018844505130063,5.396129627307461
2020-02-12T09:30:00-05:00,168.02,168.29,167.28,168.11,12122957,17405222.4,58.4218916679931,48.31675797407702,NaN,NaN,71.28494396960457,28.188569114588745,0.22674893690172482,0.41634372240685025,0.18959478550512543,4680863822,4661196514.8,46.74115186089007,45.08555999077236,NaN,NaN,5.1525669286720195,5.361334956073827
2020-02-13T09:30:00-05:00,167.22,168.95,167.11,168.55,12649272,17265828.1,59.54877748768468,49.10883592256496,NaN,NaN,78.37098998188002,32.19298647028027,0.3256589034405891,0.5966684148058619,0.27100951136527274,4693513094,4667831912.8,51.205400335667605,44.040450486636736,NaN,NaN,7.36917391012279,5.648169092366536
2020-02-14T09:30:00-05:00,168.7,168.78,167.34,167.9,16006202,17067326.4,57.08727725554809,50.288439654848595,NaN,NaN,76.23378577808545,51.43732017729265,0.3266299529530602,0.6792969525565979,0.35266699960353776,4677506892,4674871993.4,55.47023616802629,44.067186562059916,NaN,NaN,8.412527805305952,6.04307747992931
2020-02-18T09:30:00-05:00,167.5,168.06,166.43,167.54,13422380,16823126.5,55.713669846079426,50.89228611889536,NaN,NaN,59.034551721814516,66.13822404922662,0.2839265494193833,0.7075751863777668,0.42364863695838356,4664084512,4676941837,56.66937668842791,44.55814961323616,NaN,NaN,8.852868484511859,6.444476194869674
2020-02-19T09:30:00-05:00,168.17,169.14,167.5344,168.4,11084637,16480602.8,58.29527147881948,51.94141927362762,NaN,NaN,96.37674860503127,76.26020401128316,0.29329785162737443,0.7902709514926016,0.4969730998652272,4675169149,4678227493.8,57.43609069922422,45.43806293845098,NaN,NaN,9.987139038800635,6.950570886859811
2020-02-20T09:30:00-05:00,167.9,169.105,166.59,168.81,20383833,16753977,59.50717405655145,53.07711689819788,NaN,NaN,87.56269396200781,79.51575400976381,0.30543087754259846,0.8787616967934753,0.5733308192508768,4695552982,4681165325.8,59.21214374347704,46.65812587721832,NaN,NaN,11.273992789998871,7.568202587308249
2020-02-21T09:30:00-05:00,168.15,168.628,166.3295,167.1,18730732,16892800.1,52.636961704781044,54.48466957715148,NaN,NaN,55.48397518585652,74.93835105055912,0.18266927906100283,0.8016674180771304,0.6189981390161275,4676822250,4677827157,56.33564798834128,47.9219121156544,NaN,NaN,10.380563986371074,7.969968501460081
2020-02-24T09:30:00-05:00,161.86,162.91,161.095,162.07,28239504,17280206.15,38.541340789182655,54.30146812662786,NaN,NaN,-123.0318530469785,35.08522328554632,-0.23049727491484162,0.3308765453725755,0.5613738202874171,4648582746,4672042327.8,51.65276350306258,48.9089026635947,NaN,NaN,4.274815084609554,7.442089441910006
2020-02-25T09:30:00-05:00,162.52,162.76,155.96,156.31,45046965,18605602.1,28.973175367233523,52.79414039551795,NaN,NaN,-211.1320532277993,-18.948097704376444,-0.8500867001033745,-0.5012345548418011,0.34885214526157343,4603535781,4659932581.6,43.500889283977486,49.37668821770028,NaN,NaN,-5.525478964717473,5.589579669534652
2020-02-26T09:30:00-05:00,157.05,158.49,154.215,154.5,39589899,19750578.7,26.727719442327768,50.60817490928559,NaN,NaN,-224.7039389073357,-83.16423520684984,-1.312560788776897,-1.291848840709548,0.020711948067349106,4563945882,4637687928.2,33.150997766019216,48.91764027555279,NaN,NaN,-13.80736561587208,2.8185874859051196
2020-02-27T09:30:00-05:00,151.35,155.01,148.815,149.06,50530279,21528653.4,21.36765204097776,48.13303902280914,NaN,NaN,-247.26707278777442,-150.13018855680627,-1.880980900539002,-2.3305141776064033,-0.44953327706740137,4513415603,4601260452.4,23.352505344181864,47.70351386241817,NaN,NaN,-23.255429566879915,-0.906272093064171
2020-02-28T09:30:00-05:00,144.85,149.1325,143.91,146.33,72757680,24072054.25,19.278239708653956,45.978125558143184,NaN,NaN,-241.4759944771789,-209.52218248941335,-2.3087754006276904,-3.3355025278520145,-1.0267271272243241,4440657923,4554027587,16.530094251580024,45.82929495531372,NaN,NaN,-31.28124907358667,-5.245554518853099
2020-03-02T09:30:00-05:00,147.97,151.23,145.39,151.03,33569321,24228568.5,31.66675569613929,44.51234848781673,NaN,NaN,-165.4306877519322,-218.0019494304041,-2.1465753887782473,-3.7099463631971332,-1.563370974418886,4474227244,4519156486.6,13.414243581943566,43.61539682087352,NaN,NaN,-32.540701640392946,-9.144861250501648
2020-03-03T09:30:00-05:00,151.09,154.2,146.31,147.95,42941276,25505450.35,28.572125540017055,42.59557372014208,NaN,NaN,-134.143962692079,-202.60433132326003,-2.114689984565895,-4.206733455126255,-2.09204347056036,4431285968,4484706524,11.173473510667279,41.13178676610617,NaN,NaN,-34.7567896963278,-12.803708171333955
2020-03-04T09:30:00-05:00,150.28,152.45,148.52,152.16,36195813,26515532.1,37.55506481020136,41.10508608744267,NaN,NaN,-100.64702267065086,-177.79294807592305,-1.6961041619205353,-4.212173672961029,-2.516069511040494,4467481781,4465413703.8,10.15082991388013,38.51819234131973,NaN,NaN,-32.84937338167713,-15.66737462995441
2020-03-05T09:30:00-05:00,148.84,152.4823,145.485,147.32,32729431,27261652.8,32.495411829674495,39.17270282615623,NaN,NaN,-108.00767290772463,-149.9410680999131,-1.6307690622149873,-4.554530838809228,-2.9237617765942407,4434752350,4449681053.2,9.395644585551892,35.531781216311465,NaN,NaN,-33.37496560036758,-18.197030482870577
2020-03-06T09:30:00-05:00,142.71,145.98,140.99,144.4,39688307,28507623.95,29.87991749948911,37.22931998643772,NaN,NaN,-128.11801826637696,-127.2694728577527,-1.6640228788386988,-5.003790375142614,-3.3397674963039155,4395064043,4440562277.2,8.978694083521944,32.21095678170401,NaN,NaN,-34.795944746988376,-20.56830394917312
2020-03-09T09:30:00-04:00,134.13,136.17,130.26,130.36,56319957,30422141.05,21.090107739654684,34.756208407407385,NaN,NaN,-183.6715716556778,-130.9176496385018,-2.463186875130468,-6.418751090217,-3.9555642150865324,4338744086,4413465645.6,7.862179683537661,28.72472842421185,NaN,NaN,-40.23187248888082,-23.37738516913136
2020-03-10T09:30:00-04:00,134.71,134.8,128.02,134.43,54432656,32572333.6,27.727327265717676,32.57278382075726,NaN,NaN,-155.77157685548684,-135.24317247118339,-2.539163043772936,-7.129518019802703,-4.590354976029767,4393176742,4405843800.4,7.576772498809447,25.163348552753654,NaN,NaN,-41.2449229440861,-25.929890565553467
2020-03-11T09:30:00-04:00,130.92,132.27,124.17,125.88,51521245,34398117.3,23.294639728271505,29.98617422588012,NaN,NaN,-161.91466720099305,-147.49670137725184,-2.957467947398645,-8.287189910278073,-5.329721962879428,4341655497,4380678543.6,6.710591477952661,21.413237676644773,NaN,NaN,-43.99963408714322,-28.511282497209145
2020-03-12T09:30:00-04:00,116.77,119.9,111.6,111.97,70114293,37297684.1,18.19759170372886,27.526219225804965,NaN,NaN,-205.05884142125205,-166.90693507995735,-3.9037316462143545,-10.20938652064737,-6.305654874433016,4271541204,4348036314.4,5.786521035069086,17.802585751411048,NaN,NaN,-48.696637972184725,-31.39490470791994
2020-03-13T09:30:00-04:00,118.31,119.96,109.55,119.47,57915123,39560976.65,27.419136399065295,26.7317760550823,NaN,NaN,-167.6655468373034,-174.8164407941426,-3.7560714064734047,-11.000744132524773,-7.244672726051368,4329456327,4334914771.2,5.460980769449208,14.50317269901009,NaN,NaN,-47.963196924638254,-33.76180359602256
2020-03-16T09:30:00-04:00,108.62,111.3,101.43,103.62,59095694,41715451.25,21.820779996578125,26.22089067146405,NaN,NaN,-181.42182043261582,-174.36649054953023,-4.412083032269738,-12.759776516388541,-8.347693484118803,4270360633,4321238080.6,5.1366079976403825,11.762866892843151,NaN,NaN,-50.00298422559774,-36.08197225739044
2020-03-17T09:30:00-04:00,104.96,110.5,100.61,108.37,59344831,44011573.8,26.653954763758975,26.215621765852,NaN,NaN,-147.13624524058807,-172.6394242265505,-4.212731495894369,-13.613607853986764,-9.400876358092395,4329705464,4308543825,4.848727389207241,9.741276151642298,NaN,NaN,-49.33629297474653,-37.975446645584164
2020-03-18T09:30:00-04:00,103.05,106.775,96.25,99.97,62296685,46572176.2,23.84636463613812,26.392672665506307,NaN,NaN,-142.91427631665954,-168.83934604968377,-4.317305849532746,-14.797508670008327,-10.480202820475581,4267408779,4293694481.4,4.528970313475412,8.396737935163262,NaN,NaN,-49.998859466649925,-39.69307704859356
2020-03-19T09:30:00-04:00,99.66,106.8,95.69,103.87,62654661,48685717.6,27.65650971448524,26.991120523065685,NaN,NaN,-121.33665765407035,-152.0949092962474,-3.8120958243006164,-15.245322600851352,-11.433226776550736,4330063440,4305398928.6,9.589981396935812,7.901015588402962,NaN,NaN,-49.00601273677062,-41.023496432618856
2020-03-20T09:30:00-04:00,106.12,108.76,100.45,101.4,76203733,51559367.65,26.743884649468427,26.639486876874912,NaN,NaN,-104.52106998277954,-139.46601392534265,-3.3489986892488695,-15.619475138111824,-12.270476448862954,4253859707,4290279604.6,8.93134080340991,7.580808247079129,NaN,NaN,-48.58861883917035,-42.10422820498336
2020-03-23T09:30:00-04:00,101.9,102.18,95.91,99.9,63534702,53324127.55,26.178914317503228,26.468543218123923,NaN,NaN,-105.91509358901183,-124.36466855662184,-2.867037235602364,-15.85427299336591,-12.987235757763546,4190325005,4274272479,8.282749781178495,7.37432798068707,NaN,NaN,-48.457641984682645,-43.0118587449404
2020-03-24T09:30:00-04:00,105.37,109.33,99.9337,109.04,73386687,54741113.65,35.16644903339302,26.297927805494748,NaN,NaN,-74.04866356222004,-109.74715222094824,-1.7129627075050244,-15.128439142144828,-13.415476434639803,4263711692,4261073724.6,7.780992648665986,7.205053890314632,NaN,NaN,-45.23869706927783,-43.32997850556003
2020-03-25T09:30:00-04:00,109.48,114,106.02,109.97,56043666,55563802,36.01999295251419,26.549683599983297,NaN,NaN,-53.89422648158947,-91.94314225393423,-0.7181580505524696,-14.31317399783039,-13.59501594727792,4319755358,4271543040.4,12.318298128650014,7.413814857678785,NaN,NaN,-42.47572860833229,-43.207942805956066
2020-03-26T09:30:00-04:00,111.54,117.6,111.2,116.81,51657562,55620166.15,42.061573838285156,27.419801909897302,NaN,NaN,-30.110158408429363,-73.69784240480602,0.5034692534105538,-12.965679380514729,-13.469148633925283,4371412920,4279812936.4,15.840756199686425,7.903962151690536,NaN,NaN,-38.1542541970848,-42.48598729040303
2020-03-27T09:30:00-04:00,112.25,116.02,110.87,112.56,39931488,53978856.55,39.56180461855501,28.739208829818754,NaN,NaN,-33.55988910744848,-59.505606229739826,1.0943394763099015,-12.101224288537907,-13.195563764847808,4331481432,4295337281.4,22.1623218860194,8.92540088043923,NaN,NaN,-35.39400821399569,-41.47284742234484
2020-03-30T09:30:00-04:00,113.24,115.26,110.8,115.04,41552124,54377996.7,41.737755283801526,29.739953688253316,NaN,NaN,-26.5683813430852,-43.6362637805545,1.685887643606966,-11.0882042103391,-12.774091853946066,4373033556,4331878991.6,34.6125545646545,10.856528170856734,NaN,NaN,-32.486475772705475,-40.18908004382493
2020-03-31T09:30:00-04:00,114.6,116.17,111.955,114.46,52948046,54878335.2,41.362689606410186,31.03052867954894,NaN,NaN,-18.83459937731608,-32.5934509435737,2.0477262706599895,-10.21443401562108,-12.26216028628107,4320085510,4343153755.2,37.91241535952229,13.085229876683139,NaN,NaN,-30.257358469866436,-38.77026267611657
2020-04-01T09:30:00-04:00,108.7,110.38,105.525,106.66,54224225,55779755.8,36.599433909742814,32.344945979978505,NaN,NaN,-50.7331001439618,-31.961225676048166,1.7811885142144632,-10.03567464351299,-11.816863157727454,4265861285,4332374940.6,36.0398685301513,15.24618326918901,NaN,NaN,-29.69722261895032,-37.4741140965214
2020-04-02T09:30:00-04:00,105.72,110.39,104.565,107.67,43774153,56331991.9,37.60146449067141,33.07225512937894,NaN,NaN,-46.23831358664481,-35.18685671169125,1.6929428932035417,-9.700684541223026,-11.393627434426568,4309635438,4320019444.2,33.96875123532446,17.2824525881801,NaN,NaN,-28.953601207269518,-36.256897969485415
2020-04-03T09:30:00-04:00,106.59,108,102.6,104.62,42189243,56457038.7,35.76328308096494,34.06814820683514,NaN,NaN,-59.26305291397198,-40.32748947299596,1.4581150354622814,-9.570983640098717,-11.029098675560999,4267446195,4307212396.8,31.92102529773784,19.195625252472777,NaN,NaN,-28.848830642848316,-35.198602637108685
2020-04-06T09:30:00-04:00,109.09,113.34,109.02,112.63,48708106,56076446.15,43.565936112820296,35.27614687462524,NaN,NaN,10.882670030879158,-32.837279198203085,1.8462223585569042,-8.72132072736487,-10.567543085921773,4316154301,4295836545.8,30.180659510790207,21.005048975442985,NaN,NaN,-26.39999504332682,-33.94165869513985
2020-04-07T09:30:00-04:00,116.88,118.64,112.39,112.92,57546079,56232117.3,43.83194644043301,36.70368843207488,NaN,NaN,61.272011376074786,-16.815957047524908,2.1075478786660735,-7.933108237589181,-10.040656116255255,4373700380,4306559519.8,33.84217571328817,23.0988493611439,NaN,NaN,-24.351331965754543,-32.57161201951338
2020-04-08T09:30:00-04:00,114.88,119.24,113.2856,118.07,52822250,56297167.55,48.47662232167966,38.19083933258876,NaN,NaN,106.09711938382551,14.550086858032557,2.581060223476838,-6.814330836909207,-9.395391060386045,4426522630,4338691788.8,43.41796546478033,25.515133937418508,NaN,NaN,-21.200190228584404,-30.947123192237814
2020-04-09T09:30:00-04:00,121.92,124.61,121.325,123.72,69679032,56275404.5,53.06239831350126,40.070733165733955,NaN,NaN,172.53559002680836,58.30486758072319,3.1887709332763485,-5.409427393790608,-8.598198327066957,4496201662,4376005033.6,52.09008228336347,28.59790118598662,NaN,NaN,-17.066465093345997,-28.96417203525327
2020-04-13T09:30:00-04:00,122.85,123.51,119.115,120.37,40198162,55389556.45,50.20894576097309,41.787163983124664,NaN,NaN,135.2895366194108,97.21538548739974,3.267110550456474,-4.514310138996365,-7.781420689452839,4456003500,4413716494.6,58.93966442722878,32.216252232133066,NaN,NaN,-14.415938536238897,-26.885852963965505
2020-04-14T09:30:00-04:00,123.9,124.88,121.3,122.81,35089744,54189258.95,52.22416263265096,43.00557209735738,NaN,NaN,138.26610877115644,122.6920732354552,3.371601797913679,-3.5669184420607394,-6.938520239974419,4491093244,4448704283.2,64.07183941499025,36.23702700115623,NaN,NaN,-11.615205513859983,-24.704331899664716
2020-04-15T09:30:00-04:00,117.86,119.11,116.66,117.8,34809851,52962509.95,47.93424509828535,43.8565901077696,NaN,NaN,72.6927157319227,124.9762141066248,3.0038806187880107,-3.1836694664894054,-6.187550085277416,4456283393,4465220885.8,66.21842293498,40.087035915894084,NaN,NaN,-10.42483065163213,-22.664403149945777
2020-04-16T09:30:00-04:00,118.09,118.42,114.555,116.91,49501272,52322739.3,47.192613119292936,44.223092913555874,NaN,NaN,53.53872162795998,114.46453455545168,2.6155447141713193,-2.9181191925632675,-5.533663906734587,4406782121,4461272784,65.21538996356156,43.613795470456594,NaN,NaN,-9.656494487347794,-20.80613048386035
2020-04-17T09:30:00-04:00,121.9,122.72,120.06,122.06,46250183,51502515.4,51.836313423054136,45.09984354244866,NaN,NaN,105.25765464905355,101.00894747990068,2.614142442789908,-2.2659858532472015,-4.8801282960371095,4453032304,4452638912.4,62.9691001389826,46.528565345668255,NaN,NaN,-7.63886745194741,-18.925092907872788
2020-04-20T09:30:00-04:00,119.59,122.9,119.04,120.62,36700541,49527355.8,50.499122907547026,45.725655515573344,NaN,NaN,89.18869328653446,91.78877881332542,2.4288196219810025,-1.8441037685608563,-4.272923390541859,4416331763,4444704565,60.893346324525105,48.40576475708758,NaN,NaN,-6.3338598516925595,-17.12634532841847
2020-04-21T09:30:00-04:00,117.42,119.24,116.48,117.74,31608900,47931065.7,47.84100550716086,46.18839236562696,NaN,NaN,43.29954699754482,72.7954664586031,2.040500685306708,-1.722297533908474,-3.762798219215182,4384722863,4423430488.8,55.60092337870153,49.669229615600386,NaN,NaN,-5.9552836980687305,-15.53047938122565
2020-04-22T09:30:00-04:00,120.32,120.99,118.77,119.17,24407189,45482090.8,49.26888950132299,47.09335347931126,NaN,NaN,63.46505793675738,70.94993489957004,1.815707453464845,-1.4931639023841257,-3.3088713558489706,4409130052,4413999820.6,53.385853990051544,50.90822857702183,NaN,NaN,-5.250007465896234,-14.06184053617859
2020-04-23T09:30:00-04:00,120.11,122.9,119.68,120.34,38571211,44608468.05,50.46376113565849,48.012088953953196,NaN,NaN,76.7192191967249,75.58603441332303,1.6844620409000348,-1.203293804723927,-2.887755845623962,4447701263,4422183649,55.05904811382003,52.41467835405722,NaN,NaN,-4.337421723201147,-12.672637848610384
2020-04-24T09:30:00-04:00,121.53,123.32,120.09,122.41,27155771,43383378.5,52.59128403004329,49.214089021744506,NaN,NaN,83.13194234110502,71.16089195173333,1.672327358248121,-0.7973466478138107,-2.4696740060619318,4474857034,4426548595,55.966899803513684,54.132240818755506,NaN,NaN,-2.986722592808183,-11.288935669210069
2020-04-27T09:30:00-04:00,123.95,128.44,123.86,127.26,39021253,43337866.75,57.22661655838253,50.18985191071324,NaN,NaN,135.78217627313543,80.47958854905353,1.909086626750146,-0.08331572262424913,-1.9924023493743952,4513878287,4446057899.8,59.86901479095716,56.25283762448171,NaN,NaN,-0.4769498522777331,-9.744366266791165
2020-04-28T09:30:00-04:00,131.12,131.46,127.28,129.11,47292710,43624896.05,58.87823280102553,51.26458665075556,NaN,NaN,154.61910954373084,102.74350105829072,2.0936323038334486,0.6246380304174153,-1.468994273416033,4561170997,4481347526.6,65.7768774079857,58.53388774553154,NaN,NaN,2.1174691101207848,-8.049818355803744
2020-04-29T09:30:00-04:00,133.49,136.845,131.875,135.46,50390529,43497020.2,64.01452228620549,52.37443664822168,NaN,NaN,192.81730093787544,128.61394965851431,2.518184999681673,1.6787369761860589,-0.8394480234956145,4611561526,4521833821.4,71.04360349017635,60.5071476044884,NaN,NaN,6.020113333869583,-6.039828114421841
2020-04-30T09:30:00-04:00,131.9,132.94,130.14,130.31,43727524,42972185.15,57.71791582854083,52.70697361358166,NaN,NaN,138.33804316253662,140.93771445167667,2.331271104432808,2.074640857045395,-0.2566302473874126,4567834002,4545860369.2,73.63653808791258,62.046180161956194,NaN,NaN,7.573948444257897,-4.095002891753307
2020-05-01T09:30:00-04:00,127.15,127.46,123.29,125.14,43352036,42951079.3,52.17014996307859,52.84705962801776,NaN,NaN,60.039230520759375,136.31917208760754,1.7643103395192095,1.9487576770115993,0.18444733749238984,4524481966,4555785355.6,74.64650716129277,63.16809750010362,NaN,NaN,7.203585015297015,-2.4809189050318325
2020-05-04T09:30:00-04:00,123.6,125.9,122.25,125.68,28498224,42266528.35,52.68174241446484,52.87974389814733,NaN,NaN,41.92774539022773,117.548285911026,1.349242219837956,1.8710001122898348,0.5217578924518789,4552980190,4563605736.2,75.44474575994596,63.980447953314744,NaN,NaN,7.053976760788591,-1.118790952771772
2020-05-05T09:30:00-04:00,128.07,129.92,126.1,126.65,31209384,41391592.25,53.64097096728834,53.28736717450469,NaN,NaN,78.95965053602549,102.41639410948494,1.0755024237389716,1.8661359221255935,0.7906334983866219,4584189574,4568209451.6,75.92527684697065,64.67379466131408,NaN,NaN,7.198948747396698,0.0694575758237237
2020-05-06T09:30:00-04:00,127.49,128.2,125,125.72,29836758,40006126.2,52.54123227410173,53.66941139984817,NaN,NaN,51.07987979461528,74.06890988083289,0.7809895264927977,1.766870406502619,0.9858808800098213,4554352816,4556767709.6,72.14642193893394,65.16886837384067,NaN,NaN,7.017332826226541,1.0620111830241261
2020-05-07T09:30:00-04:00,127.39,128.5,126.55,127.44,27492978,38739662.6,54.40313933680924,53.85275610797354,NaN,NaN,63.4557160714629,59.09244446261816,0.6562320806305209,1.8061709807979724,1.1499389001674516,4581845794,4559570068,72.50733851432386,65.85017111493647,NaN,NaN,7.360350420314028,1.9617739312083977
2020-05-08T09:30:00-04:00,130.16,132.75,129.19,132.36,32162026,36863812.3,59.31955482248041,54.482786959040205,NaN,NaN,114.79533807019575,70.04366597250544,0.8471348930127454,2.2088575164333832,1.3617226234206379,4614007820,4577475238.8,74.75789957203969,66.8404963469018,NaN,NaN,9.066685691182853,2.976761325490463
2020-05-11T09:30:00-04:00,130.41,132.95,129.332,131.7,33983188,36553063.6,58.40972057529699,55.23769517819279,NaN,NaN,101.02221001159509,81.8625588967789,0.8678466431486713,2.446530927356477,1.5786842842078057,4580024632,4582884127.2,75.41268551501638,68.25562221378142,NaN,NaN,10.23405527636781,4.013517604187227
2020-05-12T09:30:00-04:00,132.26,132.29,126.84,126.97,44275308,37012341.8,52.22723235257258,55.449005381853475,NaN,NaN,54.96859406425958,77.06434760242573,0.519084298665772,2.227539657540021,1.7084553588742488,4535749324,4573196077.2,71.81910893976888,69.57228328161838,NaN,NaN,9.504443760167948,4.797935626470187
2020-05-13T09:30:00-04:00,125.65,126.08,120.41,122.72,58719331,38207815.8,47.37501747656202,55.22838083477516,NaN,NaN,-37.00085738550289,59.44820016640209,-0.013525171505411437,1.6915488944924846,1.705074065997896,4477029993,4557731512.6,66.38141208538013,70.38102356530125,NaN,NaN,7.402764687042579,5.170054063694814
2020-05-14T09:30:00-04:00,119.97,123.27,117.18,123.12,55904273,38527965.85,47.86594822757436,54.89085684888452,NaN,NaN,-75.46139327286635,31.664778297536238,-0.3366632264716638,1.2842450329083164,1.6209082593799802,4532934266,4547949207,63.12553312507165,70.8923545168411,NaN,NaN,5.824712761760438,5.263576734847046
2020-05-15T09:30:00-04:00,122.01,125.53,121.46,125.08,40236628,38227288.1,50.31197265800324,54.39695371314314,NaN,NaN,-29.69509108188072,2.7666924671209414,-0.4112463465728351,1.1068503261639364,1.5180966727367715,4573170894,4539781821.8,60.45922205703679,70.93451217870394,NaN,NaN,5.155107573726032,5.248081140401187
2020-05-18T09:30:00-04:00,131.45,133.39,130.83,132.68,47075369,38746029.5,58.45209051038808,54.366514978097605,NaN,NaN,106.28421052940679,3.8190925706832815,0.03473865913064422,1.5615199966500768,1.5267813375194326,4620246263,4547826148,62.15476308254739,70.6757897268869,NaN,NaN,7.034837727903836,5.503332081472994
2020-05-19T09:30:00-04:00,132.22,133.45,130.055,130.06,30269953,38679082.15,55.100820750278125,53.72982201124565,NaN,NaN,79.22517663606652,8.670409085044671,0.1313307094061471,1.6909447242771165,1.5596140148709694,4589976310,4558671545.2,64.37287926819154,70.19930942531656,NaN,NaN,7.580563364087355,5.80007940756076
2020-05-20T09:30:00-04:00,132.73,134.98,132.3826,134,35901345,39253789.95,58.915571794231774,53.81536886593786,NaN,NaN,116.74002491526878,39.418585545199,0.4222110545911879,2.0873778331099544,1.6651667785187665,4625877655,4588441077.6,69.63393408880655,69.91340913966613,NaN,NaN,9.234144177610196,6.290660088996393
2020-05-21T09:30:00-04:00,134.05,135.06,132.5787,134.24,32731490,38961803.9,59.14328642314077,54.313450041656594,NaN,NaN,108.2166824280445,76.15420068538117,0.5825314501609005,2.393331091219892,1.8107996410589915,4658609145,4613576053.4,73.22856930260693,69.81212786404572,NaN,NaN,10.626933836382639,6.910127767194428
2020-05-22T09:30:00-04:00,134.67,135.05,133.02,134.89,24035237,38805777.2,59.793265364864,54.8214159666851,NaN,NaN,104.9934897065538,103.09191684306806,0.6774526737819659,2.657615483286449,1.980162809504483,4682644382,4635470751,75.90434771013221,69.8449565747733,NaN,NaN,11.957486656618393,7.631179037112137
2020-05-26T09:30:00-04:00,140.09,140.375,134.9893,138.78,36971004,38703264.75,63.53234427462302,55.527942631494724,NaN,NaN,152.82139901973747,112.39935454113422,0.9316322151170953,3.144703078400852,2.2130708632837566,4719615386,4655344575.6,78.0490142504537,69.99665210359352,NaN,NaN,14.230582787753306,8.573951001489446
2020-05-27T09:30:00-04:00,141.57,143.5,137.33,143.09,42681965,38472727.5,67.1747341594353,56.573192766161405,NaN,NaN,175.759012929685,131.70612179985793,1.2969873136158334,3.8343050053035483,2.537317691687715,4762297351,4689808783.8,81.17772082896539,70.64174488145292,NaN,NaN,17.348465366924376,9.827453053694436
2020-05-28T09:30:00-04:00,144.74,144.74,137.58,139.7,42164072,38061404.65,61.93486000445486,57.11117281385038,NaN,NaN,151.64062492130532,138.68624180106522,1.2185204716950269,4.060468281306498,2.8419478096114714,4720133279,4708659908.6,82.63560837596884,71.36519272871327,NaN,NaN,18.43914692447698,11.057695035234799
2020-05-29T09:30:00-04:00,138.3,139.28,136.41,138.9,41628788,37956467.85,60.7309338977172,57.21198560493872,NaN,NaN,102.70269910450024,137.58344513635637,1.02849849194424,4.1275709245417715,3.0990724325975316,4678504491,4712638977.8,82.93605013023274,71.94934634001278,NaN,NaN,18.977975368823234,12.189163654318861
2020-06-01T09:30:00-04:00,139.26,141.67,138.61,140.23,25664212,37072076.65,62.0516336422196,57.47212225257605,NaN,NaN,117.19984757040454,140.02471670912652,0.9121046469833964,4.239203241326777,3.3270985943433806,4704168703,4716943842,83.2732405109059,72.51081455400488,NaN,NaN,19.802296288637937,13.276754030650157
2020-06-02T09:30:00-04:00,141.07,141.855,139.56,141.39,24666237,36880477.3,63.21369930577925,58.25686989209081,NaN,NaN,113.54574548935264,132.16958600304957,0.8350331743401416,4.370890062268558,3.535856887928416,4728834940,4718787752.8,83.4243291673704,73.33975885597643,NaN,NaN,20.817160743428726,14.353954989618524
2020-06-03T09:30:00-04:00,143.67,146.07,143.11,144.8,36111708,37125593.5,66.46472587042841,59.620420491652695,NaN,NaN,140.7111440506772,125.16001222724799,0.9283349508907137,4.696275576541808,3.7679406256510943,4764946648,4719317612.2,83.47053366981416,74.56041039772171,NaN,NaN,22.64828807285559,15.538859715795247
2020-06-04T09:30:00-04:00,143.84,145.6,143.182,144.59,28904716,37078991.4,66.07743507317717,60.921240980624326,NaN,NaN,123.29485973184995,119.49085918935691,0.8903965399011318,4.880936300527509,3.990539760626377,4736041932,4722499342.8,83.76321873944312,76.03453079874825,NaN,NaN,24.050623952369826,16.7548260353059
2020-06-05T09:30:00-04:00,150.86,152.315,149.55,150.18,53513382,38380011.6,70.93284289936669,62.394160283578856,NaN,NaN,165.87525847615865,132.1253710636886,1.1403011724199805,5.415916226151353,4.275615053731372,4789555314,4744709507.4,85.67062049220952,77.83534497268916,NaN,NaN,26.81164476681934,18.191514425522104
2020-06-08T09:30:00-04:00,152.35,153.39,151.63,153.09,33834297,38463625.15,73.09200033272474,63.43986812803148,NaN,NaN,158.67120240574533,140.41964203075676,1.3838895183164812,6.005476951626974,4.621587433310493,4823389611,4768553689,87.38408918821088,79.63743969452227,NaN,NaN,29.83963567413341,19.85553174675229
2020-06-09T09:30:00-04:00,150.86,151.77,149.06,150.26,39645961,38746763.8,67.8161438492698,64.34810549224517,NaN,NaN,120.55223206730244,141.82093934634673,1.2412820800646518,6.1731900333913075,4.931907953326656,4783743650,4779535431,88.09043624856575,81.33155090740614,NaN,NaN,30.84289812577544,21.42515551518417
2020-06-10T09:30:00-04:00,150.09,150.26,145.9,146.18,51774514,39121724.1,60.98201295724604,64.49570843246048,NaN,NaN,86.24148991814154,130.9270085198396,0.7814891110070237,5.908769342085435,5.127280231078411,4731969136,4772939928.6,85.01192522374029,82.42997884561568,NaN,NaN,29.58509783383983,22.590861560706408
2020-06-11T09:30:00-04:00,140.15,141.0323,134.77,135.03,72041452,39787830.15,47.03278219961801,63.63067241649456,NaN,NaN,-19.81512970475413,102.30501063251879,-0.3059785515988631,4.744807041579833,5.050785593178696,4659927684,4757717079,78.21755876812352,82.78633523600972,NaN,NaN,23.240880418339575,22.683721397511146
2020-06-12T09:30:00-04:00,140.33,141.02,134.15,138.27,63864888,40185860.9,50.57100448779686,62.97193949670405,NaN,NaN,-22.284965942195363,64.67296574884799,-0.8108201308639371,4.037260429598774,4.848080560462711,4723792572,4744564530.6,72.80353430530033,82.56484856423603,NaN,NaN,19.40855384242671,22.21584031821337
2020-06-15T09:30:00-04:00,133.28,142.06,133.28,140.99,57354791,41041769.05,53.38615400975029,62.247211620641714,NaN,NaN,-22.447316172676437,28.449262033163638,-0.9553555007326215,3.653886184546934,4.609241685279556,4781147363,4736116081,69.47687719672354,81.95255306039816,NaN,NaN,17.290311413028444,21.512193331758382
2020-06-16T09:30:00-04:00,146.69,146.69,141.03,144.38,48957023,41135851.75,56.69639216564119,61.498758621084995,NaN,NaN,42.27675973096364,12.794167565895883,-0.8215458527283994,3.5823093693690566,4.403855222097456,4830104386,4745388228.2,71.04085059112303,81.22849090055229,NaN,NaN,16.654505736175675,20.818237960960854
2020-06-17T09:30:00-04:00,144.59,144.99,141.32,141.77,34811402,41362924.2,53.54372326103805,60.89939171084093,NaN,NaN,16.494311542695943,-1.1552681091932364,-0.9013229765448791,3.277201501416357,4.178524477961236,4795292984,4758052997.8,73.07054050091455,80.54527176661983,NaN,NaN,15.108501546227934,20.002561330284724
2020-06-18T09:30:00-04:00,140.37,143.31,139.81,141.72,26974059,40916559.9,53.48236857296883,60.381637044787475,NaN,NaN,-6.103253122840034,1.5871072071895802,-0.9453625856636023,2.9968212458817334,3.9421838315453357,4768318925,4779731246,76.15169190222073,80.06067475033326,NaN,NaN,13.875032553926184,19.12720007651922
2020-06-19T09:30:00-04:00,144.42,144.51,139.84,140.99,50293840,41794677.4,52.53584283392055,59.70193770133755,NaN,NaN,-10.542601543673182,3.935580086894011,-1.005935322674611,2.6847646782020718,3.690700000876683,4718025085,4778577748.6,75.65566642620787,79.51656231571197,NaN,NaN,12.594183322069389,18.19391196874067
2020-06-22T09:30:00-04:00,140.24,142.56,138.83,142.4,28983237,42042077.4,54.221107118870634,59.059609687986935,NaN,NaN,-27.70024391291876,2.884994538845546,-0.9348328503327545,2.5221589379607394,3.456991788293494,4747008322,4771749940.4,72.63955769960245,78.74622149658568,NaN,NaN,11.994500218903095,17.308281718763876
2020-06-23T09:30:00-04:00,144.32,144.66,142.65,143,20344161,41210735.25,54.954057778828144,58.23741911001549,NaN,NaN,8.663145358425837,-3.837728335662015,-0.8344878513618377,2.413881974091197,3.2483698254530347,4767352483,4759199559.8,67.32641717316466,77.59307031825357,NaN,NaN,11.695251276764488,16.506420227049677
2020-06-24T09:30:00-04:00,141.1,141.6,136.31,138.36,42998651,41226569.55,48.488583799454815,56.981072590463896,NaN,NaN,-78.74541364376931,-22.885673372955065,-1.0535770456717914,1.9313985183632951,2.9849755640350866,4724353832,4745011729.4,61.82137620222515,76.02579585130944,NaN,NaN,9.544537237391971,15.511865514241434
2020-06-25T09:30:00-04:00,137.71,140.58,136.29,140.45,37191198,40977925.85,51.269660872983955,55.576559588579414,NaN,NaN,-69.29816544127124,-35.52465583664131,-1.0295021935713216,1.6980978220709346,2.727600015642256,4761545030,4743656950.4,61.305893108136324,74.2854581810185,NaN,NaN,8.507906034545549,14.511299874284878
2020-06-26T09:30:00-04:00,139.48,139.83,136.49,136.67,39100061,40851489.5,46.3912761060341,53.66936500095865,NaN,NaN,-95.36603417962462,-52.48934236383159,-1.226542114443808,1.1944223725874963,2.4209644870313043,4722444969,4744540927.2,61.53128615723219,72.43882939309144,NaN,NaN,6.136204051524544,13.314857613890545
2020-06-29T09:30:00-04:00,138.71,141.985,137.1,141.14,33935236,41265040.7,52.18526627987841,52.55287374600213,NaN,NaN,-50.14141490344705,-56.977576561937255,-1.0225520689870722,1.1427744007974638,2.165326469784536,4756380205,4746415303.8,62.036255948890705,70.57781651454322,NaN,NaN,5.819662993637079,12.244115525282908
2020-06-30T09:30:00-04:00,140.67,143.62,140.59,143.18,32865850,41675021.35,54.59702534707262,52.09680320241831,NaN,NaN,-7.091115914032568,-60.128428816428936,-0.7306440252077699,1.2520214382748236,1.9826654634825935,4789246055,4750794018.2,63.24989830862179,69.02338602060618,NaN,NaN,6.289901842963448,11.393513570665842
2020-07-01T09:30:00-04:00,143.65,144.51,141.24,141.82,26457470,41192309.45,52.68899398355507,52.50081832984238,NaN,NaN,-4.045471447950105,-45.18844037726509,-0.6142477567971611,1.2148557674861422,1.8291035242833034,4762788585,4758480968.8,65.34442979072605,68.10387680793494,NaN,NaN,6.1189869234624625,10.640009763922503
2020-07-02T09:30:00-04:00,144.56,145.28,141.8909,142.4,24022381,40948192.7,53.436366560025974,52.70548704928733,NaN,NaN,10.514792954430456,-29.225848698124754,-0.48875429099174883,1.2181606605436173,1.706914951535366,4786810966,4763534156,66.68848977233424,67.66708791272308,NaN,NaN,6.189801062115603,10.004265663664375
2020-07-06T09:30:00-04:00,145.32,145.6966,142.93,143.43,19858176,39265432.4,54.80185949541455,52.806608869691914,NaN,NaN,38.04148268846331,-2.5443453245071668,-0.3343055343349979,1.2890330336166187,1.6233385679516166,4806669142,4780378990.6,70.75961725134574,67.75871220233896,NaN,NaN,6.626454648381559,9.521721232909687
2020-07-07T09:30:00-04:00,142.18,143.435,140.48,140.89,22661045,38706769.8,50.84228234614789,52.38845816829954,NaN,NaN,-4.868698961601595,6.510197863861923,-0.39687173126147557,1.1272489038747722,1.5241206351362477,4784008097,4785904569,71.96977674888495,67.82506407075051,NaN,NaN,5.905474301887042,9.00511452847788
2020-07-08T09:30:00-04:00,140.76,142.5,139.1,141.94,27358919,38092417.7,52.37420219758626,52.30492094948156,NaN,NaN,-4.566579839338414,7.015105078800751,-0.3621689093271401,1.0714094984773226,1.4335784078044627,4811367016,4790328761.2,72.93560264420044,67.81542565241378,NaN,NaN,5.7152613021432455,8.535135496144362
2020-07-09T09:30:00-04:00,142.02,142.35,137.24,139.07,34647849,37236084.45,47.97349036099002,51.91142964862593,NaN,NaN,-48.86241069639342,-1.9482827708879114,-0.5176587160160477,0.7865050127844029,1.3041637288004506,4776719167,4793114877.6,73.55360304282534,67.62984787674269,NaN,NaN,4.30582341051628,7.93094805534035
2020-07-10T09:30:00-04:00,139.14,141.5,138.455,141.31,24008201,34834421.9,51.40546261345265,51.830688204306796,NaN,NaN,-27.13928502183096,-9.479098366140192,-0.4569184340474439,0.7330156862411457,1.1899341202885896,4800727368,4795898158,74.18770543940543,67.52499352054251,NaN,NaN,4.054957433170575,7.377235109316096
2020-07-13T09:30:00-04:00,142.8,144.64,139.39,139.52,34235495,33352952.25,48.64400670864674,51.43232388929081,NaN,NaN,-3.784504524954454,-17.844295808823745,-0.5199772031795127,0.5399626163141988,1.0599398194937115,4766491873,4787862704.2,69.04090324682227,67.26794677391536,NaN,NaN,3.058099441733141,6.760215728232817
2020-07-14T09:30:00-04:00,139.43,141.98,138.64,141.83,28113961,31890910.75,52.21175001535742,51.23644476332862,NaN,NaN,-26.928040811766678,-22.256164178856785,-0.3944876193987096,0.5668302952453246,0.9613179146440342,4794605834,4789982251.6,69.63922636063697,67.43314743016337,NaN,NaN,3.2121859001073685,6.253354324214896
2020-07-15T09:30:00-04:00,145.42,147.78,144.79,147.03,40770083,31481563.75,59.09990391697528,51.99439620029437,NaN,NaN,225.22834557693537,23.70282090439797,0.027934213370105265,0.9962356813566657,0.9683014679865605,4835375917,4794784031.8,71.00630919070655,68.08921407219775,NaN,NaN,5.50356784567433,6.146241970137672
2020-07-16T09:30:00-04:00,146.11,146.67,144.88,146.16,30530808,31267534.05,57.603895082597475,52.446841500981044,NaN,NaN,170.4883993861088,67.57298292089841,0.22688648968227443,1.2519095800894036,1.0250230904071291,4804845109,4800409220.2,72.56481819862253,68.89342300723249,NaN,NaN,6.928894939408728,6.258049537176395
2020-07-17T09:30:00-04:00,146.68,147.59,145.51,146.59,20644131,30951037.65,58.167526014874966,53.288002208755394,NaN,NaN,160.03793568099445,105.0084270614635,0.35778881301339616,1.4722591066738744,1.1144702936604782,4825489240,4805361594.6,73.89523197293973,69.77656199406874,NaN,NaN,8.256622373396414,6.543559942350683
2020-07-20T09:30:00-04:00,146.12,146.85,145.15,145.96,19663343,29419512.8,56.97246346510693,53.62994486484314,NaN,NaN,119.5274737351498,129.67082271348437,0.3707144313430004,1.5778633328392289,1.2071489014962284,4805825897,4813228399.4,75.89489792758404,70.76646499254683,NaN,NaN,9.037809100164326,6.899881250609774
2020-07-21T09:30:00-04:00,147.47,149.16,147.2,148.03,24544748,29197588.35,59.88850291480064,54.007907548252284,NaN,NaN,156.35537033528902,166.32750494289547,0.48047971342564066,1.8077485432782794,1.3272688298526387,4830370645,4820381361.6,77.57682427528212,71.78981684730829,NaN,NaN,10.539757359174546,7.419863551833313
2020-07-22T09:30:00-04:00,147.09,148.67,147.03,148.11,24424808,29401620.7,60.00132570483668,54.530216956915254,NaN,NaN,130.65845539418598,147.41352690634562,0.5170958817322595,1.9736386820179632,1.4565428002857037,4854795453,4824265268.8,78.45583711903932,72.7263459421878,NaN,NaN,11.813739200846342,8.047560073120888
2020-07-23T09:30:00-04:00,147.98,150.2,146.7,148.26,21704889,28336932.6,60.227217209212164,55.015277717571415,NaN,NaN,123.55130564156178,138.02610815743623,0.5092327929649283,2.093083791491864,1.5838509985269358,4876500342,4838596315.4,81.35951858115907,73.77427657138958,NaN,NaN,12.943715598940972,8.747010862523757
2020-07-24T09:30:00-04:00,147.29,147.665,145.56,146.08,20015547,27478150.05,55.33605141309324,55.05343428311989,NaN,NaN,68.86488195063954,119.79149741136523,0.3240473624388458,1.988910201575493,1.6648628391366471,4856484795,4844795426.4,82.46072127666478,74.61006971605522,NaN,NaN,12.669347400346224,9.307344653641252
2020-07-27T09:30:00-04:00,146.19,147.69,145.39,147.6,13370650,26191679.5,57.90314118204095,55.557781342826544,NaN,NaN,71.987580347476,110.28351873383049,0.272814236313933,2.0058806345290634,1.7330663982151304,4869855445,4857601336,84.49805442489675,75.50494669291321,NaN,NaN,13.11526945802734,9.851333911410693
2020-07-28T09:30:00-04:00,147.07,148.04,146.06,146.13,13268007,25158318.05,54.63278034032314,55.71910835302204,NaN,NaN,61.3943016600321,91.29130499877911,0.11678893098644405,1.8790525619481855,1.7622636309617414,4856587438,4862844694.6,85.25336748121076,76.38478703841393,NaN,NaN,12.620988507807043,10.246998853753029
2020-07-29T09:30:00-04:00,147,149.4486,146.98,149.35,19864417,24508246.4,59.9666099501387,56.575759752246945,NaN,NaN,97.21544164901053,84.60270224974401,0.2022996799286596,2.015138230872566,1.8128385509439062,4876451855,4867175975,85.8659962796828,77.26424369818947,NaN,NaN,13.696951431815737,10.7398492220477
2020-07-30T09:30:00-04:00,147.14,149.12,146.33,148.76,23618913,24366318.55,58.60696036526889,57.09015244880525,NaN,NaN,77.26750582481714,75.34594228639507,0.19111155255995027,2.051727991643844,1.8606164390838937,4852832942,4862442495,81.86338707695671,77.81250667230027,NaN,NaN,14.215567960375983,11.236380470380313
2020-07-31T09:30:00-04:00,148.14,148.42,144.67,147.36,29936504,24662024.7,55.397246049572885,57.572526687442824,NaN,NaN,42.92469483152804,70.15790486257279,0.06777305343377216,1.9453327558761089,1.8775597024423367,4822896438,4855724823.6,76.41903247155346,78.33951590263823,NaN,NaN,13.7678653885154,11.59802117297104
2020-08-03T09:30:00-04:00,148.29,149.97,147.22,149.76,20777073,24707969.55,59.49283977583255,58.09260452747676,NaN,NaN,89.17615704717083,73.59562020251175,0.12295913594446417,2.031258622372917,1.9082994864284528,4843673511,4850488436.8,72.37827689480241,78.53516236936433,NaN,NaN,14.547190883516908,12.019331131620449
2020-08-04T09:30:00-04:00,149.39,150.93,149.045,150.79,20284998,24589167.2,61.14193972547349,58.23846422808378,NaN,NaN,116.4026326419575,84.59728639889683,0.19943757382023497,2.1575964537037464,1.9581588798835114,4863958509,4851962651,72.8141079653571,78.66429085326794,NaN,NaN,15.67567393740767,12.54166581816148
2020-08-05T09:30:00-04:00,152.29,153.89,151.78,153.79,18526867,24147564.6,65.54213777515719,58.805481563266596,NaN,NaN,185.83352915110356,102.32090389931541,0.41051876059730263,2.4713073306301396,2.060788570032837,4882485376,4853169355.2,73.18704627404426,78.70873571579806,NaN,NaN,18.018386101104404,13.324054430010468
2020-08-06T09:30:00-04:00,153.8,154.44,152.91,153.73,18237747,23327059.5,65.38267164751701,59.32084910845531,NaN,NaN,187.54041428431248,124.37548559121447,0.49868341151428996,2.6841428344256997,2.1854594229114097,4864247629,4855452292.6,73.91607430223345,78.71022445360475,NaN,NaN,19.873183396411743,14.259644282353507
2020-08-07T09:30:00-04:00,153.45,156.25,153.15,156.17,20475155,23150407.2,68.71610602776502,60.15968072007375,NaN,NaN,202.727886080661,156.33612384104106,0.6635921815329744,3.014949649827628,2.3513574682946534,4884722784,4867817561.8,77.48661949589018,78.8239188513409,NaN,NaN,22.51267384491225,15.438648505576184
2020-08-10T09:30:00-04:00,156.65,158.83,156.65,157.79,24000500,22638657.45,70.73127747854761,60.93416461748426,NaN,NaN,223.56523997840267,183.21394042728744,0.8141149432576396,3.3690011473667028,2.554886204109063,4908723284,4880827516.4,80.50962334889165,79.03340449945587,NaN,NaN,25.37610441319401,16.8582850638073
2020-08-11T09:30:00-04:00,159.27,159.82,156.16,156.88,30359375,22750928.15,68.07843289423319,61.511100845298294,NaN,NaN,176.28446259838836,195.1903064185736,0.7844159596973475,3.5354061537307473,2.7509901940334,4878363909,4883708596.4,81.11439727487226,79.22330165344394,NaN,NaN,27.016511281168288,18.309460237716014
2020-08-12T09:30:00-04:00,158.67,158.89,156.49,157.52,23402789,21882563.45,68.96017747728072,62.1348837215889,NaN,NaN,144.51730268892072,186.92706112613706,0.7404438837355136,3.676545048702792,2.9361011649672784,4901766698,4887564860.8,81.92292898955253,79.26354525404348,NaN,NaN,28.637383666352672,19.784877870378395
2020-08-13T09:30:00-04:00,156.99,158.53,156.65,157.19,15799875,21146016.8,67.91842426725293,63.03362463974317,NaN,NaN,119.40518265765847,173.30001480080625,0.6262400435639206,3.718901219422179,3.0926611758582583,4885966823,4891908699.6,82.81540605619874,79.28887988115305,NaN,NaN,29.711548995377807,21.202973745378312
2020-08-14T09:30:00-04:00,156.28,157.7585,155.87,157.09,13360915,20781856,67.58523649240242,63.72520287619756,NaN,NaN,95.3929592572896,151.833029436132,0.48725378315915213,3.7017284048071986,3.2144746216480464,4872605908,4889485324.4,80.4296991504373,78.99828307583451,NaN,NaN,30.52522922213018,22.534724527771434
2020-08-17T09:30:00-04:00,157.5,158.03,156.74,157.9,9744151,20285896.4,68.9154335218885,64.74539238916653,NaN,NaN,93.75221627997894,125.8704246964472,0.39698379544276285,3.7107043659515,3.313720570508737,4882350059,4884210679.4,75.34223116809824,78.29034476775506,NaN,NaN,31.577953231253698,23.826614342554613
2020-08-18T09:30:00-04:00,157.85,157.85,155.71,156.39,14647527,19791035.35,63.66996439751304,65.0099177068361,NaN,NaN,71.21691631503609,104.85691543977676,0.19301853914823663,3.554993744444033,3.3619752052957965,4867702532,4882078404,73.32311685696163,77.39442480898924,NaN,NaN,31.120850811554305,24.868648123840284
2020-08-19T09:30:00-04:00,156.93,158.04,156.19,156.4,14337271,19286658.5,63.689675263791216,65.37296877101628,NaN,NaN,68.02501525158357,89.55845795230931,0.025046407632370205,3.3932832148362593,3.368236807203889,4882039803,4878133025,69.60605680953083,76.51890121845884,NaN,NaN,30.74258094970804,25.707781384678533
2020-08-20T09:30:00-04:00,154.8,156.485,154.54,155.76,15413013,18972064.7,61.39389798313406,65.80130105198494,NaN,NaN,43.360152815549014,74.3494519838874,-0.15309912119091962,3.1768629057152395,3.329962026906159,4866626790,4874265018.4,66.06979215000136,75.7796697669194,NaN,NaN,29.822326084292545,26.295573484623393
2020-08-21T09:30:00-04:00,155.15,155.7178,153.6,154.61,20685122,19005543.45,57.39071963190802,65.65114961313317,NaN,NaN,23.0107257628464,59.87300528499876,-0.36048052004367737,2.8793613768515627,3.23984189689524,4845941668,4868932170.4,61.435595253827884,74.99804964970693,NaN,NaN,27.943113278372984,26.530936312301908
2020-08-24T09:30:00-04:00,155.86,156.27,154.33,156.23,13707136,19022367.75,61.226201530387065,65.65716831348415,NaN,NaN,35.671258011855734,48.25681363137411,-0.39771858343075106,2.742693667606801,3.140412251037552,4859648804,4864391919.4,57.723416263948764,73.92014309960634,NaN,NaN,27.259771540849243,26.635055630665814
2020-08-25T09:30:00-04:00,156.81,156.82,154.79,156.4,16269657,19172450.25,61.61666199672983,65.37677718645362,NaN,NaN,38.627899616256855,41.739010291618264,-0.41799115099017214,2.617923312299837,3.035914463290009,4875918461,4866035105.2,58.69614319086395,72.88507859366489,NaN,NaN,26.786884985987786,26.656745538568952
2020-08-26T09:30:00-04:00,156.5,156.77,155.1822,155.42,13772726,18867865.7,57.99120552978106,64.84881532090105,NaN,NaN,29.400390629468987,34.01408536719534,-0.4990049799570757,2.4121582383436646,2.9111632183007403,4862145735,4862056291.6,55.37378201606222,71.56062914465267,NaN,NaN,25.397950991686958,26.476917746157238
2020-08-27T09:30:00-04:00,156.12,157,154.6301,155.8,17508373,18562338.7,58.9986132559735,64.15470869434452,NaN,NaN,24.04914311376153,30.151883426837855,-0.5259140199572792,2.2537706933541415,2.7796847133114206,4879654108,4864661755.2,57.08673307649502,70.10349440041016,NaN,NaN,24.468986796487123,26.190070467632935
2020-08-28T09:30:00-04:00,156.6,157.2,155.73,157.12,12371402,17684083.6,62.374032717454604,63.55776263998073,NaN,NaN,46.55185925392841,34.860110125054256,-0.4563133416536478,2.209293036244361,2.665606377898009,4892025510,4873878523.6,62.5613463166368,68.82147461239195,NaN,NaN,24.53472944066857,25.953593178066598
2020-08-31T09:30:00-04:00,157.19,157.37,155.3,155.43,17051511,17497805.5,56.01578968475664,62.69614526787526,NaN,NaN,9.712015444756442,29.6682616116344,-0.5209219618703007,2.014453925560133,2.5353758874304337,4874973999,4876943562.6,64.19711504759351,67.61309731044346,NaN,NaN,22.783482933601714,25.500720286000185
2020-09-01T09:30:00-04:00,155.22,157.31,154.45,157.21,15654144,17266262.8,60.574372939265174,62.09715922944558,NaN,NaN,11.641375559841796,24.270956800351385,-0.4436288997307658,1.9808397627669763,2.424468662497742,4890628143,4879885499,65.74421223512897,66.4574746851275,NaN,NaN,22.55218716946755,25.079501269352665
2020-09-02T09:30:00-04:00,157.96,158.98,156.175,158.46,16763449,17178091.9,63.43996514272604,61.77726929197937,NaN,NaN,108.19262084291508,40.02940284304066,-0.31425868404486224,2.0316453074416643,2.3459039914865265,4907391592,4888934670.4,70.03359183682468,65.54448795517222,NaN,NaN,23.210002624006407,24.8124300343032
2020-09-03T09:30:00-04:00,158.12,158.29,152.96,153.78,32117585,17872083.8,49.06189444728131,60.454173431613576,NaN,NaN,-112.99916615041475,12.6197409902054,-0.5367518052284397,1.674964234950977,2.2117160401794167,4875274007,4888058650.2,69.13113959377725,64.73744798683934,NaN,NaN,18.814701777437005,23.955611711893745
2020-09-04T09:30:00-04:00,155.71,155.89,149.29,152.8,30618783,18379265.2,46.676287498388945,58.86566300136361,NaN,NaN,-250.1417558613693,-46.71898203285414,-0.7307738701080941,1.2982487025442992,2.0290225726523934,4844655224,4878584593,60.10982447812087,63.64941893755525,NaN,NaN,14.497188215227247,22.604408355227104
2020-09-08T09:30:00-04:00,151.18,152.48,149,149.86,26447776,18501629,40.33922404926839,57.19918154791757,NaN,NaN,-303.53845806509844,-109.36907673482513,-1.0201969108374889,0.7537764341055322,1.773973344943021,4818207448,4867231282.8,51.44584138275999,62.0867564036837,NaN,NaN,8.472502150844177,20.585564611743827
2020-09-09T09:30:00-04:00,151.43,152.7787,150.57,152.13,19254454,17946382.95,46.39112301516187,55.96357067301547,NaN,NaN,-184.39190227417234,-148.57573230162797,-1.0194281373471124,0.4996881732591305,1.5191163106062429,4837461902,4856598034.6,44.91601695612619,60.323182128440514,NaN,NaN,5.602366075797012,18.44510767803714
2020-09-10T09:30:00-04:00,152.83,153.875,150.055,150.15,23005486,17926517.8,42.35527931955821,54.603669339902915,NaN,NaN,-164.54842671359518,-203.12394181293,-1.1057146453211029,0.13697300395486423,1.242687649275967,4814456416,4838010999.4,36.25372657438347,58.19346315875352,NaN,NaN,1.8299107201617544,16.071508112626372
2020-09-11T09:30:00-04:00,150.92,151.05,147.675,149.15,20850987,18179073.4,40.44169209170532,53.39302451560271,NaN,NaN,-193.78412535362327,-219.2809336535717,-1.1769809779651175,-0.2285385731804297,0.9484424047846878,4793605429,4821677283.8,30.65823548706871,55.995080318270716,NaN,NaN,-1.8063105217344122,13.517534022003403
2020-09-14T09:30:00-04:00,150.59,153.43,150.37,153.08,21991291,18610592.2,50.00197597028095,52.591294118452275,NaN,NaN,-78.8226822766215,-185.01711893662215,-0.917793396433605,-0.19879934075731853,0.7189940556762865,4815596720,4815865583,28.94632173800784,53.939573566417785,NaN,NaN,-1.5961762498269891,11.358432554599062
2020-09-15T09:30:00-04:00,154.38,154.695,152.86,153.37,16175459,18932157.6,50.63172358826793,51.806655660705005,NaN,NaN,-29.125073062759693,-130.1344419361544,-0.6952752042594024,-0.15009994964796647,0.5451752546114359,4831772179,4818578529.2,30.886406982380876,51.95316383724043,NaN,NaN,-1.2235662303711095,9.561004156746181
2020-09-16T09:30:00-04:00,154.11,156.85,153.84,154.82,22210881,19310325.3,53.76730168101136,51.50494824293573,NaN,NaN,24.58086199944449,-88.33988908143104,-0.4317922833991698,0.005434900362473627,0.43722718376164343,4853983060,4821882760.8,33.27603379921872,50.37475325032303,NaN,NaN,0.11697947688761234,8.211857773909243
2020-09-17T09:30:00-04:00,152.62,154.4,151.75,153.69,20002880,19593605.75,51.046298575182014,50.93692576573635,NaN,NaN,-34.032017980395466,-62.23660733479109,-0.32011110500670353,0.037088302503264,0.35719940750996754,4833980180,4825787513.6,36.08828947091045,48.874864421352704,NaN,NaN,0.3516397353989225,7.088969482693483
2020-09-18T09:30:00-04:00,153.98,155.29,151.14,153.29,38352759,20740593.05,50.08015277165108,50.05879148389324,NaN,NaN,-31.404524204234416,-29.760687104913323,-0.2621143372732838,0.029556485918362796,0.2916708231916466,4795627421,4826191912,36.387321150079444,47.00529119517004,NaN,NaN,0.24946354124772427,6.111897205344089
2020-09-21T09:30:00-04:00,149.82,150.255,146.33,147.92,40652521,21738963,39.32053562443439,48.86627333672736,NaN,NaN,-171.05438207139466,-48.20702706386795,-0.5573825820796361,-0.4050574044078985,0.1523251776717376,4754974900,4814067548,31.6118054232427,44.67776907914497,NaN,NaN,-3.5884414691645627,4.726134537557139
2020-09-22T09:30:00-04:00,148.65,149.3,146.56,149.06,19385790,22022895.7,42.16148538304186,47.55106708271141,NaN,NaN,-144.77757427300196,-71.33752730591638,-0.6418686644605,-0.6500106529038874,-0.008141988443387427,4774360690,4802585250.2,27.880011389591786,41.97318330446375,NaN,NaN,-5.692494941986973,3.237758897622266
2020-09-23T09:30:00-04:00,148.41,149.43,143.98,144.07,33403387,22879582.2,34.538779267448604,45.48669666304873,NaN,NaN,-180.02297129851135,-112.25829396550755,-0.9795510015963802,-1.2325807404388627,-0.2530297388424825,4740957303,4779980098.8,22.29895742986801,38.5635665611097,NaN,NaN,-10.395064522637178,1.29021269472806
2020-09-24T09:30:00-04:00,144.04,146.53,142.09,144.07,31723749,23777133.35,34.538779267448604,44.44933129306069,NaN,NaN,-183.33337835821987,-142.11856604107243,-1.1375472425542763,-1.674963792035328,-0.5374165494810517,4740957303,4761375523.4,18.938713699098443,34.97839328291836,NaN,NaN,-13.928628986579358,-0.8839075454587138
2020-09-25T09:30:00-04:00,143.44,146.85,143.35,146.41,20689266,23936178,40.39921529559912,44.00096899286142,NaN,NaN,-132.7858923920655,-162.39483967863868,-1.0227112618973133,-1.8158056268526934,-0.7930943649553801,4761646569,4754579353,17.878838563323086,31.961894289004242,NaN,NaN,-14.922636082281485,-2.8894401935762524
2020-09-28T09:30:00-04:00,148.37,150.44,146.404,150.02,17600904,24197653.1,48.116292728819936,44.55647389854367,NaN,NaN,-53.92490029397051,-138.96894332315384,-0.6595098233465929,-1.6174816441386213,-0.9579718207920284,4779247473,4759433867.6,21.2682206317306,29.806349949644993,NaN,NaN,-13.081159410111159,-4.3454000816526674
2020-09-29T09:30:00-04:00,149.85,150.28,148,149.34,18703037,24280229.4,46.88483456448674,44.591739009209725,NaN,NaN,-42.47570319166469,-118.50856910688637,-0.43195196848256234,-1.4979117813952314,-1.065959812912669,4760544436,4756670616.8,20.743407468747748,28.07973498626082,NaN,NaN,-12.04351218057504,-5.44513038149872
2020-09-30T09:30:00-04:00,149.9,151.97,148.49,149.79,29073746,24951209.5,47.8362809822933,44.98323912797652,NaN,NaN,-17.450747867486253,-85.99412442068135,-0.22824337676895334,-1.3512640338738606,-1.1230206571049073,4789618182,4766402792.6,27.5264911511876,27.456361027461107,NaN,NaN,-10.923662440630338,-6.227777818517523
2020-10-01T09:30:00-04:00,150.81,152.2,149.49,152.18,25871962,25406635.15,52.68406531732923,45.857694358378225,NaN,NaN,21.423257533143335,-45.042797242408724,0.0741646984797324,-1.0303147840052418,-1.1044794824849742,4815490144,4781309360.8,36.491958033731954,27.873055495079914,NaN,NaN,-8.418002600760804,-6.540667073123706
2020-10-02T09:30:00-04:00,149.41,153.58,148.99,152.85,29451992,25273355.5,53.97536395278552,46.14150778569998,NaN,NaN,42.08966477194353,-10.067685809606914,0.31264754875503376,-0.713670046541182,-1.0263175952962158,4844942136,4797968474.2,44.72204602737483,28.999892944320415,NaN,NaN,-5.993605683547985,-6.46251544604146
2020-10-05T09:30:00-04:00,154.49,157.305,154.48,157.07,18553610,24670096.85,61.16441338330553,46.893842771059816,NaN,NaN,153.506394450733,31.41857313933379,0.7244017609157789,-0.12081539415149223,-0.8452171550672711,4863495746,4814818128.8,51.559689820854615,30.4765560042114,NaN,NaN,-1.378192921308277,-5.736183656793862
2020-10-06T09:30:00-04:00,158.5,161.01,156.34,156.62,36347976,25165106.85,60.086600216402424,47.34522123787345,NaN,NaN,166.68279553201646,73.25027288407003,0.9234947215161329,0.30915124682789497,-0.6143434746882379,4827147770,4828138795.6,56.17495374732014,32.1121931433615,NaN,NaN,1.9523074209792521,-4.6378277885405605
2020-10-07T09:30:00-04:00,158.59,160.56,158.4638,160.04,27049660,25554867.15,65.11754942823491,48.35031058452008,NaN,NaN,175.45662878469548,111.83174821450636,1.2237284752915891,0.9153171194262484,-0.30841135586534063,4854197430,4841054645.2,60.140501248899916,33.83020827036075,NaN,NaN,6.564429644013228,-3.0375052981757333
2020-10-08T09:30:00-04:00,161.72,162.28,160.58,161.86,37278551,26268520.4,67.46760036137333,49.5922711266431,NaN,NaN,176.04557889680927,142.75621248723957,1.4667191824824912,1.5249876222377736,0.058268439755282286,4891475981,4856251812.6,64.24060873456057,35.819728812109396,NaN,NaN,11.153548566848233,-1.0102118888865954
2020-10-09T09:30:00-04:00,163.35,163.71,161.805,162.7,25038061,26477874.1,68.52168232635299,51.67806731963729,NaN,NaN,165.3563516322432,167.4095498592995,1.595208822417236,2.0522794677768275,0.4570706453595913,4916514042,4870566193.8,67.61927004322348,38.39169057067945,NaN,NaN,15.194072078314647,1.304685820713582
2020-10-12T09:30:00-04:00,163.4,164.24,162.6,163.79,20336191,26395119.1,69.88522820735102,53.6583346642308,NaN,NaN,149.56798916719146,166.6218688025912,1.6575143847762677,2.5289636263299258,0.8714492415536582,4936850233,4885237091.2,70.67720784744822,41.44863317481206,NaN,NaN,18.95232736316187,3.8257774696347657
2020-10-13T09:30:00-04:00,162.52,163.22,161.48,162.7,20106459,26591669.1,66.77044930807452,55.960596809989795,NaN,NaN,116.01931486075291,156.48917266833845,1.5321705712894902,2.786662455665521,1.2544918843760309,4916743774,4903156292,73.9171927385536,45.13564998257531,NaN,NaN,21.18135813497509,6.305146136111954
2020-10-14T09:30:00-04:00,163.01,163.909,160.935,161.09,19063417,26434295.9,62.35003857968074,57.94711533229209,NaN,NaN,97.61626656806625,140.92110022501262,1.2591051823754633,2.82837336234536,1.5692681799698966,4897680357,4911852877.4,75.34123785184138,49.16440170777123,NaN,NaN,21.790664378257194,8.517363027846988
2020-10-15T09:30:00-04:00,159.29,163.18,158.81,162.75,22865137,26577408.75,64.92816223935523,59.69918297113181,NaN,NaN,81.970955909039,122.10617562745855,1.113579316014488,2.9612423249880067,1.8476630089735187,4920545494,4917666780,76.2738485293538,53.335473848202,NaN,NaN,23.070960419496696,10.596448369511233
2020-10-16T09:30:00-04:00,163.21,163.7,162.31,162.35,17643220,25541931.8,63.79456321395772,60.81905943435594,NaN,NaN,84.73243640654897,105.98139258231973,0.9216189979438418,2.999686756403321,2.078067758459479,4902902274,4914944426.4,74.8463966578466,57.162486421496,NaN,NaN,23.801059765204833,12.482821426038889
2020-10-19T09:30:00-04:00,162.88,164.03,160.03,160.41,18360611,24427336.3,58.46323276966541,61.64608787758299,NaN,NaN,64.70988935685676,89.00977262025279,0.61023758379919,2.8408647382084666,2.2306271544092766,4884541663,4904482712.4,69.4661517215253,60.642682439551535,NaN,NaN,22.893027233546476,13.96999368425426
2020-10-20T09:30:00-04:00,161.56,162.45,160.34,160.76,18927696,24404431.6,59.12688516550733,62.452559604955425,NaN,NaN,56.37071840572622,77.08005332924743,0.38508006371986303,2.7119772340591055,2.3268971703392425,4903469359,4901827829.4,68.12776228050443,63.54277323450274,NaN,NaN,22.32608822215055,15.1637214753823
2020-10-21T09:30:00-04:00,160.87,161.365,159.29,159.38,17504062,23609465.35,55.37040257583586,62.64444083770589,NaN,NaN,38.91205218557074,65.33921045274833,0.11448690550054819,2.470005802214928,2.3555188967143796,4885965297,4899484817.4,66.9026763221901,65.71496739796403,NaN,NaN,20.77265682242444,15.964997953531176
2020-10-22T09:30:00-04:00,160.14,162.19,159.18,162.13,20673932,23056974.5,60.72526083617032,63.12657632937624,NaN,NaN,48.16342415992474,58.577704102925466,0.0929065227685042,2.4716520501750097,2.3787455274065055,4906639229,4896703564.4,65.39930507936711,67.19191447310634,NaN,NaN,20.931184493080718,16.674453173466826
2020-10-23T09:30:00-04:00,163.07,163.33,161.25,163.07,20889837,23067003.05,62.38656022527747,63.21387253237424,NaN,NaN,63.588223699189925,54.34886156145366,0.11281207858702569,2.519760625640288,2.406948547053262,4927529066,4901628922.8,66.82119354404773,68.28202188190585,NaN,NaN,21.546014953500407,17.370390570614482
2020-10-26T09:30:00-04:00,160.92,161.37,157.38,159.55,26509948,23512455.25,53.29531946829614,62.72878105036665,NaN,NaN,8.84452968037772,43.17578962615785,-0.12720716732889148,2.247939587892148,2.3751467552210395,4901019118,4904924413.8,67.77538478426578,69.11062409883053,NaN,NaN,19.241561329419543,17.637700679015204
2020-10-27T09:30:00-04:00,159.45,160.06,157.94,158.18,20523013,23603454.05,50.2274569373382,61.665203015302595,NaN,NaN,-15.208018917486134,28.860042161515384,-0.3800621298341875,1.9000690929283053,2.280131222762493,4880496105,4900329763,64.96992470571982,69.45558291717482,NaN,NaN,16.363596734203924,17.45568582975645
2020-10-28T09:30:00-04:00,154.66,155.44,153.045,153.31,32338738,23766703.65,41.157779546341175,59.78593009994315,NaN,NaN,-136.12849980559042,-6.148068236716834,-0.8502027807602879,1.217377746812133,2.067580527572421,4848157367,4892768177,60.52931189678899,69.19049028590541,NaN,NaN,10.522542097963639,16.46523672521462
2020-10-29T09:30:00-04:00,152.77,155.79,151.67,155.14,27203172,23833264.15,45.16475988001076,58.117578496632994,NaN,NaN,-142.52582445272003,-44.285917959245786,-1.0023722101790469,0.8146152648486122,1.8169874750276591,4875360539,4886512439,57.054956345675414,68.43589645036626,NaN,NaN,7.1049805969577395,15.12805727832078
2020-10-30T09:30:00-04:00,154.32,155.28,151.39,153.09,31732985,23947313.8,41.73607759202595,56.10692488125263,NaN,NaN,-174.49110127130552,-91.90178295334488,-1.1925943917315067,0.32624448536327577,1.5188388770947825,4843627554,4869732136.6,48.94012476759004,66.88324765894782,NaN,NaN,3.132930005819249,13.414467667963418
2020-11-02T09:30:00-05:00,154.77,155.89,153.665,155.82,25252096,24282238.1,47.45664143799676,54.72736717624708,NaN,NaN,-119.96068615214031,-117.66282611984848,-1.0889289431286353,0.15767769818398847,1.2466066413126238,4868879650,4863304243,46.22779263338881,64.90543336572176,NaN,NaN,1.6969214069864638,11.740532487823852
2020-11-03T09:30:00-05:00,158.43,161.2301,158.06,160.24,30257381,23977708.35,55.13685262730424,54.212139608220184,NaN,NaN,-0.5423241768309093,-114.72968717171743,-0.6961609944277707,0.3764053982779103,1.072566392705681,4899137031,4867032428.2,48.02695132786868,62.954412899723714,NaN,NaN,3.1720527240426586,10.516463950140825
2020-11-04T09:30:00-05:00,157.75,162.35,157.71,160.42,45226280,24886539.35,55.422614867430006,53.533171938796954,NaN,NaN,7.3677365449394925,-86.03043990161146,-0.4117789472625415,0.5578427086275042,0.9696216558900457,4944363311,4886273617,56.17656670034035,61.518892769079905,NaN,NaN,4.3922338698640715,9.641573938672718
2020-11-05T09:30:00-05:00,162.01,165.58,161.91,164.91,31910985,24618161.05,61.93576038493372,53.400400308152385,NaN,NaN,107.26528373332009,-36.07221826440343,0.06575379834182993,1.051813903817333,0.9860601054755032,4976274296,4906456368.4,62.77094793588363,60.65636071751111,NaN,NaN,7.756183210333703,9.37223240605286
2020-11-06T09:30:00-05:00,165.62,165.71,163.3,163.62,24930386,24612777.3,59.256940765560564,53.457093736430615,NaN,NaN,104.93227420356625,19.812456830570923,0.2703006410938307,1.3239359068427916,1.053635265748961,4951343910,4927999639.6,68.26100419899909,60.57027875161642,NaN,NaN,9.535822949767246,9.395602483726343
2020-11-09T09:30:00-05:00,176.95,178.1,169.33,169.55,55052701,26348602.8,66.44223684066984,53.979618856085075,NaN,NaN,261.62687896138425,96.12996985327584,0.7531699879853289,1.995097750730622,1.2419277627452932,5006396611,4955503031.8,73.61124178063831,60.96195585876885,NaN,NaN,13.770941706209259,10.020650944081044
2020-11-10T09:30:00-05:00,171.2,173.33,169.75,172.7,35492159,27117887.8,69.51749918709777,54.9901257568895,NaN,NaN,212.22039806703665,138.68251430204936,1.2060439472343873,2.7494826967882773,1.54343874955389,5041888770,4984053379.6,77.79559915418491,61.740021775339905,NaN,NaN,18.328731304654607,11.207519567020125
2020-11-11T09:30:00-05:00,173.34,173.48,170.86,172.63,23972637,27363348.8,69.36537297151426,55.607276623699775,NaN,NaN,181.48496696282393,173.50596038562625,1.408135281727558,3.3036078517133376,1.8954725699857795,5017916133,4998763944,79.59127638303475,62.75373401131616,NaN,NaN,21.730417946915722,12.710790764148067
2020-11-12T09:30:00-05:00,171.4,172.6383,168.34,169.98,34011364,27920660.15,63.683766139170736,55.69993418897787,NaN,NaN,124.09415519210755,176.87173467738373,1.2745879660032116,3.488707527489794,2.2141195614865823,4983904769,5000290038.6,79.77401723808411,63.67893570374732,NaN,NaN,22.70803769907954,14.138968897709706
2020-11-13T09:30:00-05:00,171.35,174.1264,171.31,173.5,25494206,28313209.45,67.49260102199435,56.714025728527744,NaN,NaN,137.30258982783886,183.34579780223825,1.3285195596483286,3.8747690110469932,2.5462494513986647,5009398975,5011901051.6,81.15648515541227,64.63472858740064,NaN,NaN,24.81732835190373,15.664448819737423
2020-11-16T09:30:00-05:00,176.49,177.78,175.4,177.63,31812262,28985792,71.2964172093865,58.21895146224548,NaN,NaN,154.12215251057958,161.84485251207732,1.5330329284799982,4.462540611998662,2.929507683518664,5041211237,5018863976.8,81.95311044796846,65.84781328327554,NaN,NaN,27.93603882137525,17.417533105685685
2020-11-17T09:30:00-05:00,176.04,178.8,174.28,178.46,26154529,29347133.65,72.0053818458545,60.42235162649643,NaN,NaN,132.75239382761316,145.95125166419263,1.6071147252654105,4.938401090100427,3.331286364835017,5067365766,5023959376,82.5349888172974,67.41964734902615,NaN,NaN,30.609630779266023,19.302118487625734
2020-11-18T09:30:00-05:00,178.94,179.715,175.86,175.96,24377836,29690822.35,66.66430963493775,61.958033751848355,NaN,NaN,113.71948292467611,132.39815485656305,1.3793852893122271,5.055517976475301,3.6761326871630735,5042987930,5028973735.4,83.11205880484039,69.28086895325222,NaN,NaN,31.11992509093907,20.990376573813354
2020-11-19T09:30:00-05:00,175.65,177.59,175.07,177.31,20187595,29666505.5,68.04282105878566,63.837086856616914,NaN,NaN,95.37379370206976,126.6540825585555,1.2169784806741424,5.197355788005751,3.980377307331609,5063175525,5044827886.6,84.81989642293583,71.84370978577692,NaN,NaN,31.961829162177054,22.557726943579596
2020-11-20T09:30:00-05:00,176.67,177.94,175.83,177.5,24898766,29866951.95,68.2418702195707,65.32174605530076,NaN,NaN,88.06543523335509,116.80665163965878,1.0272260324455251,5.2644098478885155,4.23718381544299,5088074291,5060562949.8,86.30064143872748,74.70605612901541,NaN,NaN,32.69306842502134,24.005632869499845
2020-11-23T09:30:00-05:00,179.25,181.99,178.73,180.82,24816040,29782256.55,71.57369046854163,66.49580590110342,NaN,NaN,104.32700453693721,106.84762204493029,1.0276890358167288,5.521795110213901,4.494106074397172,5112890331,5074898768.6,87.49724416851457,77.52536276049011,NaN,NaN,34.35140734946623,25.483600652352184
2020-11-24T09:30:00-05:00,183.39,185.44,182.36,184.22,34945395,30503375.65,74.5216618196338,67.86002354054656,NaN,NaN,120.13429186210769,104.32400165182919,1.1501142296758822,5.931748861492025,4.781634631816143,5147835726,5090992760.6,88.69145858769487,79.84785503815829,NaN,NaN,36.72777121376127,27.08991073255348
2020-11-25T09:30:00-05:00,183.5,184.3105,181.89,183.59,21082745,29940576,73.01076095877777,68.65109501010686,NaN,NaN,108.55227053437498,103.29055917376897,1.082758702613674,6.135083010083235,5.052324307469561,5126752981,5107745770.8,89.78521257469419,81.7774453695019,NaN,NaN,38.19366823438053,28.67616180424306
2020-11-27T09:30:00-05:00,183.72,184.49,183.22,184.37,10384405,29099637.65,73.72115362651162,69.68425307160337,NaN,NaN,110.30872504055615,106.27754544146623,0.9874982642499051,6.2866971377819425,5.2991988735320374,5137137386,5122538143,90.6455357685169,83.37634048161031,NaN,NaN,39.60572391748288,30.237527820420176
2020-11-30T09:30:00-05:00,183.82,184.32,180.32,181.02,25481587,28787067.75,65.72020260648483,69.632679197733,NaN,NaN,86.48879454547973,105.96221730389115,0.6139236178182141,6.066603395804805,5.4526797779865905,5111655799,5127254444.6,90.90845268415777,84.61185554614742,NaN,NaN,38.457653929772945,31.411831550327715
2020-12-01T09:30:00-05:00,183.595,184.22,181.0218,182.7,30324341,29040680,67.61821660255163,69.49701615597971,NaN,NaN,87.67227908100219,102.63127221270415,0.40509401077438145,5.959047291454567,5.553953280680186,5141980140,5133072406.4,91.2356961726456,85.57186247603747,NaN,NaN,38.048364440753964,32.35990767753147
2020-12-02T09:30:00-05:00,181.95,183.48,180.76,182.89,20142804,28534951.15,67.83512285140307,69.38771257597178,NaN,NaN,79.90874721597703,94.58616328347803,0.21445898557190368,5.822027012645066,5.607568027073162,5162122944,5135929850,91.3994350007764,86.41530237730474,NaN,NaN,37.776586204384856,33.13371889565338
2020-12-03T09:30:00-05:00,183.34,185.18,182.94,183.92,19603550,27253814.65,69.04561449156265,69.77070174399977,NaN,NaN,97.10877817422798,92.29746481144863,0.098339417008658,5.730492298333985,5.632152881325327,5181726494,5146924552.6,92.01740692813861,87.28983021230862,NaN,NaN,37.87910504969258,33.81163120337327
2020-12-04T09:30:00-05:00,185.02,188.45,183.9203,188.2,24415714,26879051.1,73.50728586109823,70.20032208965003,NaN,NaN,123.46912178560392,94.92954416045818,0.24219514470918124,5.934896812211804,5.6927016675026225,5206142208,5160725517,92.72411228772455,88.11608929318807,NaN,NaN,39.31282748434325,34.59751638636898
2020-12-07T09:30:00-05:00,188.23,188.9528,187.44,188.38,14671510,26366107.3,73.67911204599037,70.37051457797888,NaN,NaN,130.83915330592671,103.79961591254758,0.2792527632147621,6.041767621521075,5.762514858306313,5220813718,5182557100.8,93.677641501578,88.95355579701733,NaN,NaN,40.52186506728286,35.44385191221382
2020-12-08T09:30:00-05:00,187.12,190.98,187.08,190.8,20165590,24621751.75,75.93860618714425,70.6514591737853,NaN,NaN,135.15765336947183,113.2966907702415,0.38974386772044234,6.249694692956865,5.859950825236423,5240979308,5202356934.4,94.39507082695633,89.80070451199296,NaN,NaN,42.24658552675678,36.41567100000567
2020-12-09T09:30:00-05:00,192.02,192.81,187.9,189.41,29507618,24322524.7,72.10958476996315,71.04040739771568,NaN,NaN,129.52169256775855,123.2192798405978,0.29643592807496066,6.230495735330123,5.934059807255163,5211471690,5212226683.6,94.71689489301221,90.6296213754338,NaN,NaN,42.60050593696862,37.299218848143234
2020-12-10T09:30:00-05:00,187.76,191.65,187.305,191.24,21245294,24186157.55,73.97044154462398,71.46380886098984,NaN,NaN,121.1301206208785,128.0235483299279,0.28509929222938446,6.290433922541894,6.005334630312509,5232716984,5222424781.6,95.03417136285985,91.35921244257123,NaN,NaN,43.4432287753506,38.17693455203
2020-12-11T09:30:00-05:00,189.99,191.72,188.3,190.3,30864993,24028839,71.33752289919117,71.68492690953417,NaN,NaN,115.10405653720511,126.35053528024814,0.14831023900986384,6.190722429074839,6.042412190064975,5201851991,5221566738.2,94.51983606418344,91.94629777296095,NaN,NaN,43.401380966171295,38.92328403976447
2020-12-14T09:30:00-05:00,191.96,193.12,189.88,189.93,32237656,24366011.5,70.2771661055272,71.59231802646171,NaN,NaN,118.2185423090923,123.82641308088128,-0.023901211458186467,6.012535675742242,6.036436887200429,5169614335,5211326861.6,88.37293836729881,92.00884735858838,NaN,NaN,43.07598150011798,39.516526534100684
2020-12-15T09:30:00-05:00,191.76,194.9,190.73,194.68,26906346,24120715.7,75.34396633506293,71.65105406327807,NaN,NaN,137.50381174441722,124.29564475587036,0.11751378896581866,6.183329123407702,6.065815334441884,5196520681,5202435136.2,83.30666327538819,91.62421912199504,NaN,NaN,44.29833813726828,40.19964247741034
2020-12-16T09:30:00-05:00,195.13,195.21,192.96,193.98,25484653,24087221.9,73.35929841397726,71.67594959579232,NaN,NaN,128.18710578156947,124.02872739863253,0.10001645935353398,6.190835908633801,6.090819449280267,5171036028,5194348003.8,78.87755683699174,90.84510085501631,NaN,NaN,44.7151588442564,40.844716244102635
2020-12-17T09:30:00-05:00,194.73,196.38,194.055,196.29,23834154,24060037.8,75.6397446159832,71.81299180932601,NaN,NaN,134.073965169403,126.61749630833742,0.1756964091982649,6.310439960778098,6.134743551579833,5194870182,5186778643.4,74.86549698513066,89.71795522763158,NaN,NaN,45.75989985583608,41.54688533149313
2020-12-18T09:30:00-05:00,196.61,197.83,194.8,195.34,37033375,24902326.8,72.8768760212798,72.32418276752564,NaN,NaN,127.59389430894865,129.11546386268614,0.09736477293482615,6.256449517748365,6.159084744813539,5157836807,5177975606.6,70.3818379991898,88.25176846441958,NaN,NaN,45.82038712223296,42.15738558731311
2020-12-21T09:30:00-05:00,191.9,195.78,191.48,195.24,30872963,25201036.65,72.57636082242553,72.67833592608807,NaN,NaN,93.60303264140028,124.19236192914772,-0.01936896775849739,6.1348735351154176,6.154242502873915,5126963844,5169445508.4,66.24193586400466,86.46649987094523,NaN,NaN,45.78616667188705,42.675782885109385
2020-12-22T09:30:00-05:00,195.99,197.72,195.39,197.46,22031442,25061806.75,75.0373259406922,73.19277900389443,NaN,NaN,123.58305273117188,121.40821012649867,-0.005951902103142004,6.146802625244987,6.152754527348129,5148995286,5159940429.4,61.8744904152971,84.35757525769671,NaN,NaN,46.45562970866423,43.215761002760075
2020-12-23T09:30:00-05:00,198.57,199.645,197.9045,199.14,18392049,24234139.45,76.7385376968311,73.74227351855646,NaN,NaN,140.17487416932988,123.80576380405076,0.05388984990642598,6.220116839731162,6.166226989824736,5167387335,5159210690.8,61.539029914560956,82.18054832815544,NaN,NaN,47.525676652611864,43.83146323845319
2020-12-24T09:30:00-05:00,199.93,199.94,198.06,199.01,8904865,23625245.45,76.30518641976286,73.94212355846108,NaN,NaN,126.91360352726174,122.3736914756225,0.024059895024334033,6.196301858605153,6.172241963580819,5158482470,5151933148.4,58.15290276286337,79.71117621923679,NaN,NaN,48.28444857746177,44.4676040011687
2020-12-28T09:30:00-05:00,201.16,201.18,198.13,198.27,27168444,24464447.4,73.75205177269449,73.94733353893993,NaN,NaN,114.93145798444425,119.8412042107216,-0.09939442527756004,6.047998931983869,6.147393357261429,5131314026,5146628592.2,55.745166959574895,77.00171375195086,NaN,NaN,48.23974290663629,45.00648098766407
2020-12-29T09:30:00-05:00,198.64,199,193.44,194.43,33901256,24885430.85,62.1340032649063,72.9612904730658,NaN,NaN,56.710991420696644,112.4627959665809,-0.47266722238451386,5.5565593292807876,6.029226551665301,5097412770,5140718377.4,53.106850581499465,74.05255516298965,NaN,NaN,44.703965351644285,44.96326446823267
2020-12-30T09:30:00-05:00,195.05,197.48,195.025,196.41,20595685,24398998.05,65.17985205957646,72.46630956518104,NaN,NaN,60.98984585877636,99.9441545921018,-0.6104577165069811,5.266154406031575,5.876612122538556,5118008455,5134521011.2,50.412544986425594,70.8879587410906,NaN,NaN,42.55716491094197,44.61953596004829
2020-12-31T09:30:00-05:00,196.62,196.8399,194.62,196.06,24747745,24629245.1,64.196837125413,71.76819496380882,NaN,NaN,48.063089621731415,81.5217976825821,-0.7407330598555371,4.950695797719135,5.691428857574672,5093260710,5119695686.2,44.58522323155289,67.28446244599724,NaN,NaN,40.52231915440016,44.03421927352713
2021-01-04T09:30:00-05:00,197.54,197.89,190.94,193.5,33664242,25332279.7,57.380266893467855,70.77124810625716,NaN,NaN,7.86944681153482,57.712966339436704,-0.9988175600822675,4.442906907471837,5.4417244675541045,5059596468,5099918485.8,38.235655119568776,63.264163807096175,NaN,NaN,36.633754013561344,42.977009950674876
2021-01-05T09:30:00-05:00,193.09,197.615,193.07,196.49,27442945,25483641.25,62.40178890085241,70.2087211630661,NaN,NaN,37.73008663894634,42.272692070337115,-0.9670166063515993,4.2329537096146055,5.199970315966205,5087039413,5091063563.2,35.77877828054386,59.50743808661368,NaN,NaN,34.73962414179115,41.80024054940577
2021-01-06T09:30:00-05:00,199.48,206.78,199.16,204.53,52952237,27397677.6,71.96649433077877,69.9674731627601,NaN,NaN,203.17953645415935,71.56640107702965,-0.43070489590566563,4.6615891960841225,5.092294091989788,5139991650,5099579339.2,39.78594030118429,56.398815017027694,NaN,NaN,36.446773307661964,41.035459514870944
2021-01-07T09:30:00-05:00,205.71,208.52,205.7,208.17,24031395,27590967.85,75.05987306245208,70.08894278050829,NaN,NaN,254.4980722990609,110.26804636508655,0.11389397955987057,5.234661566439627,5.120767586879756,5164023045,5108782257.2,43.86253156817963,53.897741783541115,NaN,NaN,39.014922686399025,40.74681139651781
2021-01-08T09:30:00-05:00,209.32,209.77,204.6581,207.72,29016981,27566436,73.97313341146038,69.96989912304238,NaN,NaN,201.53010893406423,140.96145022755314,0.3738644841197196,5.588098192029406,5.2142337079096865,5135006064,5117131328,47.34536829331725,51.93201830555445,NaN,NaN,40.56639447223277,40.721037550191376
2021-01-11T09:30:00-05:00,205.09,208.12,204.83,207.54,21000529,27554197.75,73.51463674987876,70.01545346079945,NaN,NaN,156.9967670065591,170.78691426655797,0.4581860129802511,5.786966224135,5.328780211154749,5114005535,5128013141.4,51.56332777216026,50.58783900362376,NaN,NaN,41.61393292713848,40.84859403261239
2021-01-12T09:30:00-05:00,208.52,211.39,208.49,211.26,24892230,27255559.6,76.72534297863206,70.31180932909992,NaN,NaN,178.52645898777365,198.94618873632345,0.675838483164843,6.173578315110802,5.497739831945959,5138897765,5138384811.8,55.24338969940393,49.80222856329515,NaN,NaN,43.60757116953257,41.242733623600984
2021-01-13T09:30:00-05:00,211.43,211.73,209.19,209.75,22782228,26782788.2,72.86410168000651,70.15657902476522,NaN,NaN,146.70405488176388,187.65109242184434,0.6303437478034457,6.285669516700267,5.655325768896821,5116115537,5133609589.2,53.237851460460796,49.18532578080684,NaN,NaN,43.97203032770068,41.63263315275808
2021-01-14T09:30:00-05:00,211.24,215,211.13,213.94,33913728,27133157.3,76.41150164728771,70.13321930694069,NaN,NaN,154.25565400481696,167.60260876299554,0.7846223540724919,6.636103711487436,5.8514813574149445,5150029265,5130810833.2,52.04527016064674,48.50720008409867,NaN,NaN,45.496058861907365,42.18455111120798
2021-01-15T09:30:00-05:00,210.81,213.9553,208.26,210.75,41043473,27911098.3,69.01431649818991,69.6124428839712,NaN,NaN,108.39894090235956,148.97637515665463,0.5832648091167547,6.580562368810888,5.997297559694133,5108985792,5125606778.8,49.810908792244554,47.911343371911606,NaN,NaN,44.24555128873611,42.478979707997716
2021-01-19T09:30:00-05:00,213.34,213.61,211.72,213.45,19744124,27706596.8,71.52679244589842,69.45349578920005,NaN,NaN,113.2864224636315,140.23430624806912,0.5441135710283209,6.677439523479535,6.133325952451214,5128729916,5128551655,51.09051154292525,47.57886798500806,NaN,NaN,44.06141214714055,42.70504148501812
2021-01-20T09:30:00-05:00,214.36,215.98,213.07,214.39,25385045,27124180.3,72.36687057127648,70.18441488251221,NaN,NaN,114.4950818234842,127.42803081521122,0.49512324301059785,6.752230006214461,6.257106763203863,5154114961,5131595094.2,52.4400627785611,47.53124028479817,NaN,NaN,44.185091874195095,42.91647725490055
2021-01-21T09:30:00-05:00,214.97,215.155,211.95,212.53,21236918,26642378.05,68.08619679482848,70.39201093503021,NaN,NaN,91.753836999084,116.43798723867526,0.2627161732739989,6.585501979796362,6.322785806522363,5132878043,5134947595.4,53.9474974068717,47.783736886258616,NaN,NaN,42.93540569336476,42.919181317538296
2021-01-22T09:30:00-05:00,210.49,215.33,209.55,215,24800215,26780816.7,70.57535375197548,70.84761926549896,NaN,NaN,84.11198602200126,102.40925364211209,0.20326190686042622,6.576863190097896,6.37360128323747,5157678258,5136477394,54.653795698394994,48.50292063389019,NaN,NaN,42.660934191197356,42.88228887091816
2021-01-25T09:30:00-05:00,214.93,217.91,211.6,214.79,33984986,27560463.55,70.07492370451399,71.75438046628797,NaN,NaN,90.532599230493,98.8359853077388,0.08383318377329374,6.478392762954087,6.394559579180793,5123693272,5139418890,56.04957478729182,49.775343467298974,NaN,NaN,42.29340685596155,42.7981628687815
2021-01-26T09:30:00-05:00,216.3,216.69,212.77,213.3,23969823,28313711.45,66.47337178371234,72.04520781506368,NaN,NaN,79.40856683952958,92.06041418291841,-0.14880339831779565,6.208555331283549,6.357358729601344,5099723449,5133617596.6,52.61014463209716,50.97758392098136,NaN,NaN,40.92599865783879,42.53071083864683
2021-01-27T09:30:00-05:00,209.5,212.985,207.29,209.39,45830266,29246802.55,58.042909447449276,71.050666037683,NaN,NaN,31.137395623720924,75.38887694296577,-0.5943008725790833,5.61448263887749,6.2087835114565735,5053893183,5113573241,42.83056976262863,51.19505745394167,NaN,NaN,37.05727581730562,41.748791549883805
2021-01-28T09:30:00-05:00,210.84,212.37,207.63,208.72,32202541,29161866.8,56.71554995364898,69.74035724419707,NaN,NaN,22.555354976219313,61.54918053839282,-0.9417379538289197,5.031611069170424,5.973349022999344,5021690642,5091335760.8,35.04699024156818,50.565375930612284,NaN,NaN,33.520487516776384,40.57331954515417
2021-01-29T09:30:00-05:00,209.73,210.99,204.84,205.56,40591915,30161678.3,50.81334684033331,68.08608677483085,NaN,NaN,-15.722277384627693,41.58232785706702,-1.3662590261882084,4.265525240264083,5.631784266452291,4981098727,5056019854.6,26.736895760267245,49.093342178251575,NaN,NaN,28.567553603895995,38.858210124974434
2021-02-01T09:30:00-05:00,208.17,211.57,205.76,210.61,26375099,30243046,58.284657512211105,66.99823111499744,NaN,NaN,6.165325199638779,24.708873050896177,-1.2897837540794441,4.019554573852986,5.30933832793243,5007473826,5032775965.4,22.889895853189643,47.0452398983251,NaN,NaN,26.51177959098329,37.09443433440427
2021-02-02T09:30:00-05:00,213.15,214.05,210.89,213.61,22773106,29698489.2,61.97939127186912,65.94494885022866,NaN,NaN,61.75365089833927,21.177889862658116,-1.0311891720577648,4.020351862860224,5.051541034917989,5030246932,5018880662,20.94934281441735,44.59566512082605,NaN,NaN,26.01887748473019,35.51221192730797
2021-02-03T09:30:00-05:00,213.7,214.74,211.59,214.25,23923243,29522504.1,62.73762187058826,65.22162886384163,NaN,NaN,70.804828268472,29.11137639160833,-0.8202610880153545,4.026214674898796,4.84647576291415,5054170175,5018936060.4,20.9781063987634,42.2913976164191,NaN,NaN,25.868546015068045,34.13454536841655
2021-02-04T09:30:00-05:00,215.09,218.83,215.08,218.62,25400832,28144933.85,67.50313675061138,64.58531708550763,NaN,NaN,157.96991763753712,56.19428892387189,-0.41035721317919993,4.3335292464401505,4.74388645961935,5079571007,5030512133.4,26.958832892375952,40.499509240114044,NaN,NaN,27.31677906744346,33.16057875399183
2021-02-05T09:30:00-05:00,220.94,221.84,218.77,221.65,23338798,28110304,70.33593592252066,64.67971847295982,NaN,NaN,209.17550085041015,101.17384457087945,0.018192611651781654,4.766627224184077,4.748434612532296,5102909805,5054874349,37.653321872560845,39.63111017442235,NaN,NaN,29.47950093317863,32.63471049387566
2021-02-08T09:30:00-05:00,223.79,227.33,223.4019,227.31,20831466,27701028.25,74.76174048120185,64.91078618976721,NaN,NaN,282.78298376263854,156.49737628347938,0.6037630579432722,5.503138434961386,4.899375377018114,5123741271,5078127838,45.80925213106211,39.25387735928927,NaN,NaN,32.9716986395432,32.68285165754245
2021-02-09T09:30:00-05:00,227.13,229.62,226.31,228.38,19510942,27626548.9,75.50574877846482,65.13499177599495,NaN,NaN,251.8863402467013,194.5239141531518,0.9627552423065735,6.102819429901331,5.140064187594757,5143252213,5100728894.2,52.33572411680967,39.246424597735604,NaN,NaN,35.949278786698365,33.14948410456472
2021-02-10T09:30:00-05:00,229.92,230.315,224.945,226.88,27955436,27779709.2,72.28853467906275,65.43515876772595,NaN,NaN,184.25806183244825,217.21456086594708,0.9947078881788709,6.383449047818345,5.3887411596394745,5115296777,5112954214.6,55.460473072088426,39.35449428810823,NaN,NaN,37.328658708358184,33.746509047963784
2021-02-11T09:30:00-05:00,228.14,229,223.42,226.62,25847586,27932977.1,71.71811358851325,65.5167844703358,NaN,NaN,136.98861789123623,213.01830091668688,0.8968702392859011,6.509828958746851,5.61295871946095,5089449191,5114929851.4,55.962899400956445,39.44800169543404,NaN,NaN,38.25362147171256,34.39038225135646
2021-02-12T09:30:00-05:00,225.93,227.74,224.64,227.26,17440191,27109300.25,72.29758902381569,65.67554627885735,NaN,NaN,117.03558681637996,194.59031810988085,0.7782031080562986,6.585712604531324,5.807509496475025,5106889382,5115725766.8,56.177370956945836,39.45712999326646,NaN,NaN,39.17848366555026,35.07439673909843
2021-02-16T09:30:00-05:00,229.47,229.63,224.79,225.83,22999508,26207102,68.90062785069024,65.84892171221291,NaN,NaN,103.09282760695393,158.65228687874395,0.518824941539318,6.456040673399173,5.937215731859855,5083889874,5107755487.4,53.37405220055836,39.511694819585124,NaN,NaN,39.00019054726796,35.63522442597979
2021-02-17T09:30:00-05:00,223.61,224.74,220.96,224.06,25163197,26478055.65,64.83966124906962,66.33440398375721,NaN,NaN,58.109439998512336,119.89690682910614,0.16196834353356415,6.13967616127681,5.977707817743246,5058726677,5090850380.2,47.912806125712805,39.87471170266257,NaN,NaN,37.6920668385711,35.92905905634998
2021-02-18T09:30:00-05:00,222.34,222.9,219.385,220.59,24501509,26433878.85,57.66414742524034,66.40216094601374,NaN,NaN,30.32843418748939,89.11098130011437,-0.34613802142101413,5.545035290966979,5.891173312387993,5034225168,5074636058.4,43.33301168265005,40.466570377025555,NaN,NaN,34.36621615495222,35.70579578472173
2021-02-19T09:30:00-05:00,222.46,226.3,222.17,225.19,31238155,26933940.7,63.44017682424409,67.30407737343594,NaN,NaN,61.35047304387505,73.98335233064213,-0.4066115692714689,5.382908850798657,5.789520420070126,5065463323,5069838884.8,42.05228828990504,41.5605269862854,NaN,NaN,33.16366315574317,35.34263398058194
2021-02-22T09:30:00-05:00,223.51,226.385,222.98,223.73,23272101,26857535,60.61353733443085,67.47042593216592,NaN,NaN,53.95988902269234,61.36821277190461,-0.5691557088632688,5.078075783991039,5.647231492854308,5042191222,5056899252.8,38.72740758189518,42.69177782405008,NaN,NaN,31.302433605836498,34.76546249847544
2021-02-23T09:30:00-05:00,220.96,222.975,215.56,221.76,38646584,27090614.9,56.92776724216675,67.10959564433004,NaN,NaN,6.923600490790762,42.13436734867198,-0.8184046730918952,4.624225651489439,5.4426303245813346,5003544638,5040830205.6,35.023972604203294,43.697108523320516,NaN,NaN,28.60911843527316,33.88598477516083
2021-02-24T09:30:00-05:00,222.62,227.45,221.71,227,27584915,27271369.5,63.31730688221143,67.15100171658884,NaN,NaN,59.37454689911628,42.38738872879278,-0.6469418331604437,4.63395303313078,5.280894866291224,5031129553,5035310780.8,33.82738871993736,44.61491440340437,NaN,NaN,28.247118413204564,33.08043243773851
2021-02-25T09:30:00-05:00,226.79,227.585,218.01,218.61,49961436,27477928,50.42020458801697,65.93079227640352,NaN,NaN,9.987315347395576,38.31916496077402,-1.0891335968558025,3.9194778702214705,5.008611467077273,4981168117,5024699370.6,31.592645130986156,44.94590099187652,NaN,NaN,23.146070567488415,31.661237884845637
2021-02-26T09:30:00-05:00,219.515,222.23,214.81,218.31,47734237,28254512.8,50.02780805442709,64.48021171439683,NaN,NaN,-35.36521653153264,18.97602704569248,-1.3740044986377935,3.2911058437800307,4.665110342417824,4933433880,4998293482,26.840755649399355,44.17357483307927,NaN,NaN,19.171067485976646,29.876927827864353
2021-03-01T09:30:00-05:00,223.48,226.71,222.94,226.07,26160993,27532966.7,58.931237562925986,63.349461505948554,NaN,NaN,51.64437192948407,18.512923627050828,-1.0278343240305094,3.380317437379688,4.408151761410197,4959594873,4981774212.2,24.371131939899442,42.642280533710505,NaN,NaN,18.859161438722737,28.302961200844123
2021-03-02T09:30:00-05:00,225.79,225.96,221.55,221.72,26895435,27558983.5,53.20828191652108,61.756785301524005,NaN,NaN,8.427340360306232,18.81367160095392,-1.074775907109542,3.0646818775232703,4.139457784632812,4932699438,4967605172.2,22.46206972510973,40.50844807716051,NaN,NaN,16.515704290259293,26.61906735647486
2021-03-03T09:30:00-05:00,222.42,224.26,219.21,219.32,33407617,28090709.05,50.30561028287582,60.186576416082076,NaN,NaN,-45.755785826828436,-2.2123949442350224,-1.2387574925722005,2.5910109189175614,3.829768411489762,4899291821,4941237625.8,19.414312479104836,37.933722320518825,NaN,NaN,13.660250405958932,24.76780779211544
2021-03-04T09:30:00-05:00,218.51,220.685,209.43,213.19,59126462,29850870,43.74188910413761,58.188274667198094,NaN,NaN,-191.51420014303073,-42.51269804232028,-1.7027178055500563,1.7013711545521915,3.4040889601022477,4840165359,4913037074.2,16.790322318014674,35.1356811003087,NaN,NaN,8.84937039200528,22.493745306385417
2021-03-05T09:30:00-05:00,216.89,218.15,207.21,217.71,53204284,31241042.6,49.02349952538293,56.525839703024324,NaN,NaN,-178.53418863470918,-71.14649246295559,-1.6468384491549992,1.3455408986584985,2.9923793478134977,4893369643,4905024226.8,16.1234950841654,32.27468996653867,NaN,NaN,6.820962364194361,20.254776314643838
2021-03-08T09:30:00-05:00,219.36,222.27,217.67,218.74,40619724,32105088.9,50.171501132875974,55.18804493746617,NaN,NaN,-67.29997334061177,-94.93536151697477,-1.487033115940279,1.1335879528881492,2.620621068828428,4933989367,4899903125.6,15.694489775484683,29.58329265046198,NaN,NaN,5.645418806101736,18.167725241994965
2021-03-09T09:30:00-05:00,222.41,224.99,220.92,223.34,32247276,32675879.4,55.04110260797495,54.488147891673684,NaN,NaN,7.816906373376211,-95.05744831436077,-1.0392479443725287,1.3215611383627675,2.360809082735296,4966236643,4906610566.6,18.744047434684234,27.499809886817083,NaN,NaN,6.30909856396146,16.473635716561606
2021-03-10T09:30:00-05:00,225.6,228.97,225.2,227.22,36812000,33540932.3,58.70676994319212,54.56262092867025,NaN,NaN,95.61668379875307,-66.78295438924448,-0.4780162895103972,1.7632887208472994,2.2413050103576966,5003048643,4927361931,27.483643174122108,26.36771213620794,NaN,NaN,8.097989870483923,15.277114881407652
2021-03-11T09:30:00-05:00,229.55,232.28,228.79,232.22,25256669,33405993.95,62.9042141810937,54.52433788273093,NaN,NaN,168.5351346932085,5.226912578003367,0.19746601181016876,2.4881375251204076,2.290671513310239,5028305312,4964989921.6,40.070705362762915,26.226170498554932,NaN,NaN,11.048569097331699,14.673036912253945
2021-03-12T09:30:00-05:00,231.99,234.15,231.37,233.59,23732175,33300223.4,63.984480919440266,54.76511956737446,NaN,NaN,184.97828893322165,77.92940809158954,0.6770403218689278,3.1369719156463987,2.459931593777471,5052037487,4996723490.4,48.23172896553021,26.90505059738601,NaN,NaN,13.730352996100425,14.538367781374872
2021-03-15T09:30:00-04:00,233.34,234.53,231.91,234.42,21543170,33505372.35,64.65600907223302,55.317136840950624,NaN,NaN,170.8923212104872,125.56786700180933,0.9726785702747733,3.6757798066209375,2.703101236346164,5073580657,5024641748.4,54.14763530109969,28.271026504307184,NaN,NaN,16.07755118515158,14.758251124771544
2021-03-16T09:30:00-04:00,234.02,234.09,229.12,230.5,24675008,33589147.35,59.05549941331133,55.01272202174347,NaN,NaN,119.20698820212253,147.8458833675586,0.8321805788215615,3.743326959873116,2.9111463810515543,5048905649,5041175549.6,57.26247749934246,29.944961417121835,NaN,NaN,16.37620529188653,14.989387434359399
2021-03-17T09:30:00-04:00,228.97,232.82,227.36,232.31,29422584,33802116.7,60.74624049437589,55.75029601505482,NaN,NaN,98.91840922957238,148.50622845372246,0.789464484264895,3.897976986382673,3.108512502117778,5078328233,5056231467.6,59.93175568666088,31.96918359967003,NaN,NaN,17.131720458025068,15.29543500916878
2021-03-18T09:30:00-04:00,230.8,232.93,224.61,225.24,35726301,34363356.3,51.756062720310126,55.87374277690361,NaN,NaN,46.22946770408642,124.04509505589803,0.24177523264176948,3.41073154291999,3.1689563102782206,5042601932,5059090791.6,60.437129921851536,34.3689246191309,NaN,NaN,14.915785734298858,15.241199398473077
2021-03-19T09:30:00-04:00,224.57,228.6,222.95,226.94,40855626,34844229.85,53.536690742799635,55.48841800403745,NaN,NaN,23.424210436912222,91.73427935663616,-0.03458077827158501,3.125730337438739,3.160311115710324,5083457558,5065374805.8,61.583920963384266,37.02698097795123,NaN,NaN,13.675839440668911,15.017576547358196
2021-03-22T09:30:00-04:00,227.68,228.1,224.1,225.23,26128435,34987046.55,51.47848817360738,55.364861308115046,NaN,NaN,17.056193906544515,60.96705389584762,-0.3439227487872776,2.730407679726227,3.0743304285135045,5057329123,5062124499,60.605378776334554,39.75150305303873,NaN,NaN,12.036232578616705,14.591670266109412
2021-03-23T09:30:00-04:00,223.16,223.86,216.03,217.06,43660722,35237753.45,42.97719015776498,54.84140272774998,NaN,NaN,-79.49051714122571,21.227552827177966,-1.0692017012289048,1.7378283019773733,2.807030003206278,5013668401,5055077049.4,58.43720561889738,42.53885256302391,NaN,NaN,7.695368248819455,13.606484263639418
2021-03-24T09:30:00-04:00,219.86,221.33,212.04,212.04,47270223,36222018.85,38.74345095285121,54.484371431229526,NaN,NaN,-116.23402707661792,-21.8029344340601,-1.813699006769661,0.539906244744202,2.353605251513863,4966398178,5032691038.4,52.06541435549071,45.0585019942722,NaN,NaN,2.5911705707403123,12.032868021796688
2021-03-25T09:30:00-04:00,209.34,217.52,208.03,216.66,59244571,36686175.6,44.19228141296917,54.13928442319997,NaN,NaN,-116.97490059012884,-54.44380809290313,-1.911878158619374,-0.036242446760354596,1.8756357118590194,5025642749,5029299201.8,51.15528010251464,47.56077235272572,NaN,NaN,0.14227806591617628,10.334212313813758
2021-03-26T09:30:00-04:00,218.96,220.68,215.96,220.61,34452574,36022092.45,48.41699445147912,54.0139625173859,NaN,NaN,-56.73977837218345,-70.47660585472227,-1.638211177326753,-0.1721282597994218,1.466082917527331,5060095323,5024626754.8,49.86221078794378,50.00132385361565,NaN,NaN,-0.4788118998398671,8.789494569006097
2021-03-29T09:30:00-04:00,219.01,220.93,214.08,214.4,38078842,36617984.9,42.9164472410802,53.147915705464854,NaN,NaN,-79.77727409518992,-89.84329945506916,-1.7904779687481098,-0.7720145434078063,1.0184634253403035,5022016481,5017564226.4,47.891642116741465,52.083294902334025,NaN,NaN,-2.87813247220367,7.12269070597613
2021-03-30T09:30:00-04:00,214.39,218.68,213.1399,218.01,36205448,37083485.55,46.70680425992551,52.290775299517236,NaN,NaN,-70.59592271933492,-88.064380570691,-1.570959400226243,-0.9452358249425004,0.6257235752837427,5058221929,5026474932,50.547152004111005,53.73068839019037,NaN,NaN,-3.569673874220375,5.5952100516623435
2021-03-31T09:30:00-04:00,219.17,222.3999,219.12,220.94,34800086,37153109,49.63017991044478,51.34262999447089,NaN,NaN,-23.72160526248677,-69.56189620786478,-1.1697359740209206,-0.8364463922424079,0.33328958177851253,5093022015,5051799699.4,57.21984232494429,54.9556267446319,NaN,NaN,-3.182084408013948,4.341310843137159
2021-04-01T09:30:00-04:00,222.4,223.9,222.02,223.74,29799201,35686745.95,52.32176507127796,50.5095788624593,NaN,NaN,-2.0908441585236437,-46.58508492154374,-0.6812864896179096,-0.5183185302438744,0.16296795937403513,5122821216,5071235392.8,61.51198751481971,55.90421664100972,NaN,NaN,-2.009466783257231,3.4340568965093894
2021-04-05T09:30:00-04:00,226.4,226.535,223.57,224.97,27826550,34417859.25,53.497331998954984,49.7125305000823,NaN,NaN,13.984478796135408,-32.440233487879965,-0.2624116733568305,-0.165046632322003,0.0973650410348275,5150647766,5089345881.4,65.03254072280046,56.681709885416915,NaN,NaN,-0.7054020885095275,2.8427056129352586
2021-04-06T09:30:00-04:00,225,226.69,223.84,224.31,24907760,33632261.05,52.74581517675568,49.26183876889974,NaN,NaN,9.917914357041344,-14.50119579743371,-0.02912031655941444,0.06096464533555945,0.09008496189497389,5125740006,5110090586.4,68.57806257580691,57.48996596230723,NaN,NaN,0.14041446164061355,2.4566640198931666
2021-04-07T09:30:00-04:00,224.23,224.37,219.94,220.69,26233700,33331582.25,48.704480506624314,48.401713055488926,NaN,NaN,-32.11197816143478,-6.8044068858536875,-0.1132125090321782,-0.05143067439524884,0.06178183463692934,5099506306,5118347461.8,69.88683935423384,58.20104336713387,NaN,NaN,-0.2947436737135257,2.0636057779493533
2021-04-08T09:30:00-04:00,221.84,222.82,219.39,222.56,23989440,32690454.25,50.80151816190521,48.333531301317144,NaN,NaN,-29.632601087468053,-7.9866060508499475,-0.041209301193598794,0.010270208144930848,0.05147950933852964,5123495746,5124442208,70.85192762667614,58.94495748890706,NaN,NaN,-0.060873135900786135,1.7601087902564763
2021-04-09T09:30:00-04:00,222.49,223.09,221.24,222.59,23267373,32590989.45,50.8362426773565,48.1406421537855,NaN,NaN,-15.477525201309893,-10.663942259407197,0.0075263752638800585,0.060887478418379715,0.053361103154499656,5146763119,5129230588.6,71.621445459857,59.6619235243694,NaN,NaN,0.1399921977293825,1.5286635627526057
2021-04-12T09:30:00-04:00,222.72,222.93,220.4,221.72,20533914,32431076.4,49.73983636765324,48.01645273907449,NaN,NaN,-18.043670085005687,-17.069572035635417,-0.01832944244071002,0.03044930010361213,0.04877874254432215,5126229205,5124346876.4,69.6031541338469,60.30462176419171,NaN,NaN,0.02158002465235706,1.3133659144525702
2021-04-13T09:30:00-04:00,221.48,222.57,218.83,221.14,24608360,32584335.9,48.981393893599744,48.44532443449126,NaN,NaN,-24.276339826329284,-23.908422872309544,-0.07103345990576077,-0.040013082337878814,0.031020377567881955,5101620845,5119523044.2,67.57748002285851,60.957498507331785,NaN,NaN,-0.27281687127901305,1.0867683736337725
2021-04-14T09:30:00-04:00,221.87,226,221.8,223.32,27361960,32718683.5,51.94724773351438,49.388452775967195,NaN,NaN,37.78072117055884,-9.92988300591082,0.03849607460057504,0.07914047081860076,0.04064439621802572,5128982805,5125418344,68.77356344467277,62.15093772798765,NaN,NaN,0.23758768240456046,0.9654568463153137
2021-04-15T09:30:00-04:00,225.09,225.12,222.26,224.29,20587325,32276920.55,53.249535643660174,50.03539950673083,NaN,NaN,53.83896407621425,6.764430026825641,0.1666616237482928,0.24897142590339172,0.08230980215509892,5149570130,5130633220.8,69.83369476650002,63.485110203986615,NaN,NaN,1.0113102520625408,0.9720073328506319
2021-04-16T09:30:00-04:00,225.4,225.678,223.01,224.65,23942972,31687754.1,53.75050502841512,50.416364547940546,NaN,NaN,72.85757643781514,24.43145035465065,0.2604805854823065,0.40791053400798205,0.14742994852567554,5173513102,5135983217.4,70.92428542292558,64.98954410648531,NaN,NaN,1.796580995432822,1.0898035703623734
2021-04-19T09:30:00-04:00,223.71,224.6571,219.94,221.73,25285933,30909269.45,49.14991956707918,50.86161257122619,NaN,NaN,24.442952960358898,32.92877496372357,0.11793800136072793,0.29485245022658546,0.17691444886585753,5148227169,5140382810.2,71.82632745388295,66.69916448770971,NaN,NaN,1.3275572123498942,1.1237683763605906
2021-04-20T09:30:00-04:00,220.77,221.6165,215.24,217.19,35570761,31381385.75,42.988999477702905,50.59605508678171,NaN,NaN,-67.68253775207741,24.247535378573946,-0.2689325227650664,-0.15925120459047548,0.10968131817459092,5112656408,5142589922.8,72.290754779034,68.25227897163278,NaN,NaN,-0.8409340644162593,0.8430965991067549
2021-04-21T09:30:00-04:00,217.02,222.62,215.5,222.5,31147779,30755738.6,50.76289385696954,50.6769632258192,NaN,NaN,-15.04590090555486,13.682210963351206,-0.15944573389600417,-0.08962584919541428,0.06981988470058989,5143804187,5145554199.2,72.93602957379264,69.37486377512195,NaN,NaN,-0.5124638649636999,0.6494451042395472
2021-04-22T09:30:00-04:00,223.26,225.33,220.78,221.58,31943659,29989410.4,49.503408661917476,50.475652053722015,NaN,NaN,40.237903774148805,10.961998902938117,-0.14181191217566955,-0.10744500551899705,0.034366906656672504,5111860528,5138012278.8,68.56134006981529,69.87838895762162,NaN,NaN,-0.6081272814957634,0.46979190627735995
2021-04-23T09:30:00-04:00,222.82,226.65,222.02,225.76,28409681,28447665.9,54.97005803868833,50.58084677084583,NaN,NaN,103.55993953614774,17.102471522604635,0.14311915865397343,0.2132658549741393,0.07014669632016587,5140270209,5131363700.2,64.8676147905777,69.86660853389144,NaN,NaN,0.9710572626447332,0.5414012429012705
2021-04-26T09:30:00-04:00,227,228.69,226.75,228.11,19069177,27678496.05,57.739965546237364,50.937571797237375,NaN,NaN,178.13197587432205,47.840276105397265,0.4635378869590109,0.6495690550189295,0.1860311680599186,5159339386,5133586143.6,65.53601620000373,69.64931950704836,NaN,NaN,3.1494910175904134,0.9139854964282907
2021-04-27T09:30:00-04:00,228.71,229.39,227.51,228.45,19648108,26756959.35,58.14115257626425,51.611619802211656,NaN,NaN,175.46948897652496,96.47068145111774,0.6600727113728859,1.011122057276026,0.3510493459031401,5178987494,5146852360.8,69.29168114023199,69.60680820604821,NaN,NaN,5.034668448130561,1.5026544895286151
2021-04-28T09:30:00-04:00,228.08,229.49,227.1,228.84,16222739,25757823.9,58.626342006162666,52.1705357910872,NaN,NaN,158.67083140110728,131.21402791245015,0.7703432685663263,1.3139784316110479,0.5436351630447216,5195210233,5157133570,71.85176562209526,69.67822520572102,NaN,NaN,6.7275220383475345,2.249064139359889
2021-04-29T09:30:00-04:00,230.85,230.95,225.79,227.99,25500342,25292836.7,57.07360336866353,52.61606155475198,NaN,NaN,132.6635960228652,149.69916636219347,0.7398748181936676,1.4684786857868062,0.7286038675931386,5169709891,5168703442.6,74.43472614655688,69.87917382619959,NaN,NaN,7.747168317896932,3.0345075934366097
2021-04-30T09:30:00-04:00,225.72,227.8,224.14,224.89,27005991,25153176.2,51.69598667944292,52.75578657702267,NaN,NaN,50.663009335540906,139.11978032207207,0.47751502299979465,1.3254976463428818,0.8479826233430872,5142703900,5169190180.8,74.54057028688663,70.23184640855956,NaN,NaN,7.165776717691388,3.624688896901578
2021-05-03T09:30:00-04:00,227.21,227.407,224.92,225.99,18693364,24696516.9,53.37475718845492,53.06959824094089,NaN,NaN,61.75905035084768,115.84519521737721,0.35050939405236803,1.2861193659085473,0.9356099718561792,5161397264,5169601756.4,74.63619489091866,70.73604032770672,NaN,NaN,7.131820906989801,4.125707755485609
2021-05-04T09:30:00-04:00,224.6,226.1447,220.955,223.29,26892736,24795765.7,48.88389544666168,52.850787363308555,NaN,NaN,-9.54303173990695,78.84269107409082,0.07169297488161541,1.0252261904581985,0.9535332155765831,5134504528,5160705163.2,68.63515652778585,70.72615411935764,NaN,NaN,5.827839472556804,4.368869429352923
2021-05-05T09:30:00-04:00,224.28,224.28,221.44,222.4,13509943,24159577.85,47.46618028865414,52.437690552236695,NaN,NaN,-32.97433104799746,40.51365858426986,-0.17231292040394142,0.7381420650716564,0.9104549854755978,5120994585,5145862033.6,59.97137749063902,70.02170288536759,NaN,NaN,4.3353913460912015,4.36408684602982
2021-05-06T09:30:00-04:00,222.65,222.81,218.64,222.59,27647251,24342468.4,47.81413628863459,52.01366421368095,NaN,NaN,-71.37504651695812,-0.29406992369478785,-0.3123932485547031,0.5199634247822189,0.832356673336922,5148641836,5141648422.6,57.74307428850998,69.0801878043379,NaN,NaN,3.1831405888962263,4.195380237867878
2021-05-07T09:30:00-04:00,222.66,225.93,222.16,225.39,26172680,24487733.75,52.77798957509596,52.27281207139644,NaN,NaN,15.767380429288382,-7.273195704945293,-0.21271569235649745,0.5664620578913002,0.7791777502477977,5174814516,5148070545.8,60.17207065422623,68.2477408900767,NaN,NaN,3.505484138035401,4.096823652177524
2021-05-10T09:30:00-04:00,225.23,225.67,219.59,219.66,28109133,24866494.7,43.63162126222915,52.31871362743402,NaN,NaN,-67.0893190667796,-33.04286958847075,-0.5118676516095894,0.13934318573581095,0.6512108373454003,5146705383,5145132169.6,58.51474544814249,67.26374022358445,NaN,NaN,0.9746704087020277,3.6508017602524534
2021-05-11T09:30:00-04:00,214.92,220.3888,214.42,218.96,39519517,25612052.55,42.659020022572314,51.73986549640565,NaN,NaN,-161.00040912842803,-63.334345066174954,-0.7231466855855483,-0.252722519636535,0.47042416594901326,5107185866,5139668437.2,55.456102190898726,66.01517398194918,NaN,NaN,-1.3759516956710987,2.932694123691946
2021-05-12T09:30:00-04:00,217.1,218.77,211.54,211.85,42113404,26349624.75,34.29646372118823,50.653655143496415,NaN,NaN,-210.72657728677086,-98.88479431392963,-1.2756961037934738,-1.124195963792829,0.15150014000064482,5065072462,5128484012.6,49.726076030213925,64.6697979791205,NaN,NaN,-6.485851058260669,1.5871876691272868
2021-05-13T09:30:00-04:00,213.31,217.44,211.8,215.75,37739892,27207253.1,41.115301035553905,49.66402964327254,NaN,NaN,-158.2384818813634,-116.2574813868107,-1.3076415856850605,-1.4830518421056809,-0.17541025642062036,5102812354,5119318116.2,45.570449086422215,63.29142900025226,NaN,NaN,-8.485206475319181,0.1482742199206486
2021-05-14T09:30:00-04:00,217.94,221.41,215.678,221.02,25070399,27263624.45,48.84156476501076,49.02842958747063,NaN,NaN,-63.78395764191051,-132.16774900105048,-0.9211973920069673,-1.3269069964293294,-0.40570960442236215,5127882753,5109931763.6,41.72493313756812,61.59063735293542,NaN,NaN,-7.454180672922764,-0.9377907647712673
2021-05-17T09:30:00-04:00,219.78,221.39,217.9,221.32,20048545,27001755.05,49.24979036181294,48.393332286438394,NaN,NaN,-44.269669559223196,-127.6038190995392,-0.6078468924164956,-1.1655182199429817,-0.5576713275264861,5147931298,5110176946.6,41.862940591307265,59.6314415994408,NaN,NaN,-6.529848205809513,-1.7366561134910166
2021-05-18T09:30:00-04:00,221.39,223.24,219.47,219.64,24564503,26451442.15,46.9885450057195,47.562061072121026,NaN,NaN,-37.371854813790925,-102.87810823661178,-0.48171002353201886,-1.1598088569415097,-0.6780988334094908,5123366795,5113413132.4,43.75625090823013,57.624619119879,NaN,NaN,-6.496179387399168,-2.4165880097636094
2021-05-19T09:30:00-04:00,216.03,218.16,214.05,217.95,31202833,26454194.85,44.76208100819387,46.682666617801765,NaN,NaN,-108.73808392600532,-82.48040956445867,-0.4790675965961684,-1.2769333291547014,-0.797865732558533,5092163962,5118831432.4,46.87568874497848,55.656116448337684,NaN,NaN,-7.157358815895471,-3.093840982068161
2021-05-20T09:30:00-04:00,218.27,219.87,216.33,219.4,24932752,26103649.5,47.07903502727182,46.3528843569324,NaN,NaN,-67.08753144912204,-64.2502194780104,-0.3524882574296738,-1.2384760543456252,-0.8859877969159514,5117096714,5121688304.4,48.49765384603696,53.795908131134134,NaN,NaN,-7.003151015124878,-3.652313843933406
2021-05-21T09:30:00-04:00,221.33,222.37,219.3497,219.97,24213723,25893851.6,48.00236145004272,45.96914180418867,NaN,NaN,-27.48248974664453,-56.98992589895721,-0.2102193129753378,-1.1487619381351237,-0.9385426251597859,5141310437,5124373841.2,50.04177095983691,52.03916356462829,NaN,NaN,-6.609801537713686,-4.074812085902018
2021-05-24T09:30:00-04:00,221.18,222.45,220,221.4,18324181,25856601.8,50.34310036327975,46.07337072680425,NaN,NaN,-9.234071795565422,-49.982806346225644,-0.010212077820890841,-0.9513077224358994,-0.9410956446150086,5159634618,5126714505.2,51.40918506932889,50.808737031881364,NaN,NaN,-5.607572643178585,-4.29377787979867
2021-05-25T09:30:00-04:00,222.23,223.71,219.19,219.26,20514901,25899941.45,46.93780673366686,46.03562975859087,NaN,NaN,-14.334438817626298,-45.37532314699271,-0.012306094833282488,-0.9564782631566118,-0.9441721683233293,5139119717,5129865089.6,53.26351001535424,50.32960364078959,NaN,NaN,-5.709731322685429,-4.496056943068207
2021-05-26T09:30:00-04:00,220.13,223.69,220.12,223.35,20388238,26108216.4,53.42244183630611,46.436223011995985,NaN,NaN,33.18634566522935,-16.990437228745783,0.2566486041434549,-0.6233614131440106,-0.8800100172874655,5159507955,5143333888.2,60.2477040864474,50.5085057692137,NaN,NaN,-3.8255093251179186,-4.400264426218166
2021-05-27T09:30:00-04:00,225.04,226.36,224.18,225.65,21225724,25894485.5,56.63209427876302,46.71151620511506,NaN,NaN,118.17466292067385,20.062001645213385,0.5665737651519218,-0.17179281084756326,-0.7383665759994851,5180733679,5156061281.2,65.49502055946166,50.88871647673053,NaN,NaN,-1.2386439505216542,-3.9486043582615213
2021-05-28T09:30:00-04:00,227.08,227.18,225.05,225.5,20668438,25577607.85,56.35932517215394,47.620637912966835,NaN,NaN,130.54015219725963,51.66653003399422,0.7282870163948413,0.17199219449406655,-0.5562948219007747,5160065241,5159812242,66.88248093998224,51.486411869004804,NaN,NaN,0.7702616084351014,-3.2744806487334324
2021-06-01T09:30:00-04:00,227.46,228.5598,225.96,228.06,23081522,25797015.75,59.90843139078669,48.85273872498214,NaN,NaN,166.40422959311965,86.79419031173123,0.9599125936081097,0.6435959201093624,-0.31631667349874726,5183146763,5164514671,68.58778484253862,52.42438920126479,NaN,NaN,3.577220080502911,-2.2956662588425263
2021-06-02T09:30:00-04:00,228.91,228.92,226.825,228.33,18927549,25398756.4,60.27537206962034,50.70837503558443,NaN,NaN,159.3912887629619,121.53933582784887,1.0748853816984936,1.0272900536243696,-0.047595328074123866,5202074312,5177105590,72.6488458565893,54.06172990314875,NaN,NaN,5.980165327598696,-1.1134046036366374
2021-06-03T09:30:00-04:00,226.82,227.62,224.04,226.42,24811508,25963834.65,56.346532517498936,51.79632014143765,NaN,NaN,102.09250572109295,135.32056783902158,0.9691430096371506,1.1638334339723144,0.19469042433516381,5177262804,5180656559.8,73.68223567106702,56.06971465919481,NaN,NaN,6.970488955485488,0.041437333380808905
2021-06-04T09:30:00-04:00,227.56,228.055,226.21,227.4,19395789,25551261.55,57.86412039792421,52.44078840093146,NaN,NaN,110.18489826870517,133.72261490862786,0.9128280165069783,1.3357254449688867,0.42289742846190836,5196658593,5183841542.6,74.60888432561397,58.418568315483796,NaN,NaN,8.228796186357906,1.2110600266632512
2021-06-07T09:30:00-04:00,227.89,230.775,227.2494,230.45,24049857,25445120.4,62.261356961984156,53.370186015229415,NaN,NaN,138.04386261194756,135.22335699156545,1.0204673163262215,1.6984815738696852,0.6780142575434638,5220708450,5195970184.4,77.81265359919206,60.98640495890414,NaN,NaN,10.643201998884818,2.5585088798377607
2021-06-08T09:30:00-04:00,231.21,233.4818,229.98,232.89,27770308,25428179.15,65.37449614922353,54.68346823976542,NaN,NaN,153.19489071362725,132.58148921566698,1.183972734319641,2.157980175443015,0.9740074411233741,5248478758,5209036583.4,80.64588015045737,63.62137847620608,NaN,NaN,13.680261393468307,4.147330667499267
2021-06-09T09:30:00-04:00,233.54,233.64,230.98,231.34,18700649,24387235.75,61.88224952770609,55.906337419730576,NaN,NaN,130.07227766847532,126.71768699676966,1.1165917366999356,2.3697471119982936,1.253155375298358,5229778109,5214577342.8,81.71231129331595,66.10970865823019,NaN,NaN,15.23603152461491,5.731430789944358
2021-06-10T09:30:00-04:00,231.68,232.18,228.71,229.28,29068994,23735015.25,57.48697305426939,56.64976156451611,NaN,NaN,92.07574903793969,124.71433566013897,0.8729358830458902,2.3443252291057206,1.4713893460598304,5200709115,5219266605,82.58680706426247,68.54464817381772,NaN,NaN,15.281041001833549,7.095660820214243
2021-06-11T09:30:00-04:00,230.3,231.8,230.07,231.7,16707152,22683378.25,60.9921129878892,57.57760096007657,NaN,NaN,100.81436667388807,122.84022934117556,0.8154807435606184,2.4907402755106034,1.675259531949985,5217416267,5223418139.8,83.34609052821989,70.92352814298793,NaN,NaN,16.365811531085562,8.419968064624431
2021-06-14T09:30:00-04:00,232.31,233.35,230.14,231.02,19182832,22388999.9,59.50743325206533,58.232196166418404,NaN,NaN,97.47350031611914,114.7261568820099,0.6780510943568785,2.522823399896083,1.8447723055392047,5198233435,5218923136.8,79.31354854770183,72.91669696287173,NaN,NaN,16.829214019906967,9.621288915379079
2021-06-15T09:30:00-04:00,231.12,231.47,228.475,230.36,17039888,22238567.05,58.030916967881794,59.024561183148045,NaN,NaN,69.31493833887308,97.95016640705906,0.4974301988050036,2.466560054045459,1.9691298552404555,5181193547,5205466094.6,68.61090367782245,74.01293936733374,NaN,NaN,16.80064858753902,10.64691172568764
2021-06-16T09:30:00-04:00,229.7,230.68,227.64,229.87,24526975,22236690.65,56.90207803969569,59.2731066262473,NaN,NaN,52.489865895712285,82.43368405250644,0.3089215714084257,2.3552818195009877,2.046360248092562,5156666572,5190843787.2,59.25436790176186,73.94198678271334,NaN,NaN,16.469086179693868,11.478650933402816
2021-06-17T09:30:00-04:00,229.24,230.2,224.52,227.29,48292458,23091171.9,51.24921959283909,58.888615577252736,NaN,NaN,9.79630743997844,65.97779573291419,-0.008732011882336188,2.035445233239642,2.044177245121978,5108374114,5172376787,49.983619905712686,72.83402959315984,NaN,NaN,14.554922894500299,11.918118356416743
2021-06-18T09:30:00-04:00,223.7,225.7375,221.13,222.13,54023731,24545720.85,42.21618545454468,57.878391311709215,NaN,NaN,-86.78414743069148,28.45809291199829,-0.5553088964684598,1.3500411245364035,1.9053500210048633,5054350383,5139763610.2,38.521213541678776,70.80822477899531,NaN,NaN,9.812575450301903,11.617326512686052
2021-06-21T09:30:00-04:00,224.05,227.5,223.28,226.88,26736350,24671852.2,50.81110899610827,57.22858256923219,NaN,NaN,-34.17140462851828,2.1291119230708104,-0.5830192981241447,1.1765758983496823,1.759595196473827,5081086733,5116334269.8,32.71666141262638,68.24600167685873,NaN,NaN,8.434567781360236,11.162646693925222
2021-06-22T09:30:00-04:00,226.27,228.41,224.72,227.91,21188548,24815070.55,52.46231822457774,56.67050729458629,NaN,NaN,-15.821639557066705,-14.898203656117147,-0.5201345058377587,1.1094270641766286,1.6295615700143873,5102275281,5100550616.6,29.492528651004392,65.1634075907455,NaN,NaN,7.872834996988648,10.692673594362855
2021-06-23T09:30:00-04:00,227.99,229.96,227.99,228.66,22387483,24908699.65,53.6815815752291,56.48015365585273,NaN,NaN,25.10240883743694,-20.375695067772217,-0.42044637995064615,1.1040035950760796,1.5244499750267257,5124662764,5094149855,28.275601462276,61.92007657583188,NaN,NaN,7.797678575352643,10.279102877361396
2021-06-24T09:30:00-04:00,230.12,231.91,228.7152,231.89,21732461,24975910.8,58.60567483650202,56.53312183003686,NaN,NaN,75.61205652307059,-7.212545251153784,-0.14369036523221368,1.3448370184864586,1.4885273837186723,5146395225,5101754077.2,31.872143488617738,58.86745223033214,NaN,NaN,9.30265424934402,10.139610216216056
2021-06-25T09:30:00-04:00,232.29,233.41,231.75,232.28,27619031,25295576.15,59.170088802531964,56.312316961504564,NaN,NaN,115.51669613470968,33.247623461926445,0.04862569838723241,1.5493095067027127,1.5006838083154803,5174014256,5125686851.8,41.76896365959247,56.292902948932166,NaN,NaN,10.67732830718179,10.216427086354019
2021-06-28T09:30:00-04:00,232.24,232.59,228.77,230.44,25005986,25512453.55,55.33649171995895,55.59531664512851,NaN,NaN,51.20932447365332,50.323769282360765,0.03551069257338679,1.5450721740322138,1.509561481458827,5149008270,5139271159.2,46.518022438529606,53.85519882665161,NaN,NaN,10.695627064083546,10.284884226029666
2021-06-29T09:30:00-04:00,231.23,231.73,228.77,229.34,18844314,25300593.15,53.12070663890024,54.96949215307096,NaN,NaN,26.600441019333246,58.80818539764075,-0.05853288225013875,1.4363953786461536,1.4949282608962924,5130163956,5144848894.2,48.37959302933216,51.4742903792242,NaN,NaN,10.05964481859942,10.252707167825346
2021-06-30T09:30:00-04:00,228.65,230.32,227.76,229.37,26039028,25656167.1,53.17577471015664,54.661549414205766,NaN,NaN,-2.107928682750088,53.366117893603345,-0.12612362829753865,1.3372737255243692,1.4633973538219078,5156202984,5151156938.2,50.47893666898792,49.180871065276015,NaN,NaN,9.557498709604529,10.1533916737938
2021-07-01T09:30:00-04:00,230.81,231.85,229.71,231.39,18089141,25320048.75,56.85115890107068,54.36576697943302,NaN,NaN,57.13081256409826,49.669869101808885,-0.046306422890100674,1.4055143252092819,1.4518207480993826,5174292125,5156736318.2,52.325745451678664,46.96513213123736,NaN,NaN,10.155486428998907,10.153690924537386
2021-07-02T09:30:00-04:00,232,232.08,228.56,229.19,21029729,25401745.75,52.05846699164046,53.83369796083123,NaN,NaN,13.9961761179391,29.365765098454766,-0.14748591868242578,1.2674633497463503,1.414949268428776,5153262396,5152585946.2,50.807827281406944,44.92900918364488,NaN,NaN,9.288929451309823,10.030153571219163
2021-07-06T09:30:00-04:00,229.36,229.46,223.87,225.86,27771266,25587816.2,45.76894897637862,52.95784310429529,NaN,NaN,-109.84485477207429,-2.8450707506907578,-0.4285844538092689,0.8792187011671899,1.3078031549764588,5125491130,5147882518.2,49.0705620537737,43.53327049621282,NaN,NaN,6.564506925892585,9.535061193315366
2021-07-07T09:30:00-04:00,225.54,226.67,221.8,223.76,28521454,25625373.5,42.29831508759923,51.91471717914555,NaN,NaN,-159.89147685686928,-40.143454325931266,-0.7282445503156656,0.3974974670818767,1.1257420173975423,5096969676,5141243662.2,46.64610592580024,42.63268035507271,NaN,NaN,3.159069239421249,8.62420519990192
2021-07-08T09:30:00-04:00,219.31,224.075,217.85,221.7,42297883,26805235.2,39.16122666807501,51.05128911309097,NaN,NaN,-197.77956809014142,-79.27778220740954,-1.0196174732822445,-0.14877982420526337,0.8708376490769811,5054671793,5120937424,40.117142969992436,41.92793200252127,NaN,NaN,-0.718149301951953,7.28958312820851
2021-07-09T09:30:00-04:00,224.16,226.45,223.34,226.38,23976354,26550603.2,48.50517802079552,51.50050286782317,NaN,NaN,-74.25496361681134,-105.55493744359146,-0.8580669377303869,-0.20174602308600242,0.6563209146443845,5078648147,5101808628.4,35.129014700607,41.68563208530185,NaN,NaN,-1.148596448180023,6.084128903010148
2021-07-12T09:30:00-04:00,225.56,226.8881,224.55,226.57,16831028,26556797,48.84865655082354,51.36032769315998,NaN,NaN,-51.87925981916844,-118.73002463101295,-0.7056871014090704,-0.22578796211695362,0.4798991392921168,5095479175,5090251984.2,32.49985011301537,41.67014556390105,NaN,NaN,-1.3778999607728823,5.018124779612572
2021-07-13T09:30:00-04:00,225.23,225.74,222.22,222.3,25357534,26865532.1,42.05891750977329,50.61722764210251,NaN,NaN,-106.04853399739088,-117.97076047607626,-0.8500616614920331,-0.5826779375729245,0.26738372391910853,5070121641,5079178086.4,30.169738108374432,41.71851766799892,NaN,NaN,-3.831270522102807,3.753925450796089
2021-07-14T09:30:00-04:00,223.71,224.355,218.55,218.87,30594073,27543241.35,37.54453720638453,49.46458161575647,NaN,NaN,-154.05143969379972,-116.80275304346237,-1.1173234750627772,-1.129270619909363,-0.011947144846585767,5039527568,5067689664.8,27.93232077990163,41.69399761925789,NaN,NaN,-7.459751885596462,2.1519715455971538
2021-07-15T09:30:00-04:00,217.83,219.0598,214.94,217.63,45476978,28590741.5,36.03855557028146,47.85264452531215,NaN,NaN,-193.9617178580721,-116.03918299704851,-1.3052910425297468,-1.6435609480087692,-0.33826990547902247,4994050590,5055565424.2,25.761032043048544,41.25748965886009,NaN,NaN,-10.852802442547135,0.29414669014796946
2021-07-16T09:30:00-04:00,219.83,219.88,214.47,214.95,36620206,28007128.9,32.9612256112558,45.98058286879242,NaN,NaN,-174.06825511083244,-136.00184129585273,-1.5226273558136665,-2.2415541002461055,-0.7189267444324391,4957430384,5031321871.6,22.06714868303588,39.85021716053461,NaN,NaN,-14.722931884113786,-1.851150249032281
2021-07-19T09:30:00-04:00,210.63,214.445,209.05,211.73,58570962,28234490.45,29.681766678994848,44.14810250872356,NaN,NaN,-210.91049555607609,-167.80808844323425,-1.7779694640567056,-2.9413885745033213,-1.1634191104466156,4898859422,4991997921,17.64700413519546,37.78800156743932,NaN,NaN,-19.115325300082773,-4.317460970610923
2021-07-20T09:30:00-04:00,212.2,219.27,211.26,218.3,40794553,28937400.6,42.296907792981074,43.374974019729336,NaN,NaN,-118.99901182228643,-170.39818400821338,-1.4149201322088252,-2.932069275707647,-1.517149143498822,4939653975,4965904387.8,15.437353870251059,35.43498448464781,NaN,NaN,-18.553185649536395,-6.351135924743133
2021-07-21T09:30:00-04:00,219.45,222.22,219.36,222.06,28278730,29291909.7,48.04184209033992,43.00826454688528,NaN,NaN,-46.06118176958119,-148.80013242336966,-0.8594094179684286,-2.591410915959358,-1.7320014979909293,4967932705,4951585415.2,14.373735442915063,32.85604153992832,NaN,NaN,-16.000496655432553,-7.729616029127335
2021-07-22T09:30:00-04:00,221.47,221.9255,217.58,218.53,32878958,29816483.45,43.64820748422758,42.06519658853934,NaN,NaN,-64.0923176879826,-122.82625238935175,-0.6756604287459989,-2.576577033923428,-1.900916605177429,4935053747,4939786046.6,13.54552549088703,30.086025828443205,NaN,NaN,-15.48372463572584,-8.837345830069978
2021-07-23T09:30:00-04:00,219.87,219.95,216.91,219.55,23660330,29912876.9,45.207527776873235,41.57584378748454,NaN,NaN,-64.24933491526978,-100.86246835023921,-0.4426465750296753,-2.4542248239645232,-2.011578248934848,4958714077,4940042785.2,13.662096184803517,27.43275932154296,NaN,NaN,-14.55675827138375,-9.65440475025766
2021-07-26T09:30:00-04:00,220.39,222.05,219.15,220.19,22194195,29641635.1,46.21322576224653,41.60757784361795,NaN,NaN,-35.937569352528854,-65.86788310952976,-0.21421126108457855,-2.279342325290571,-2.0651310642059926,4980908272,4956452555.2,20.994636981680728,25.427336102107745,NaN,NaN,-13.507858167315835,-10.204898095551686
2021-07-27T09:30:00-04:00,219.01,219.08,215.3819,217.62,35063568,30144514.2,42.81479529444448,41.644469286964046,NaN,NaN,-73.75211527170067,-56.81850379941261,-0.204987113855708,-2.3213649565256276,-2.1163778426699196,4945844704,4957690701,21.536109976040436,23.63376496283919,NaN,NaN,-13.690410682238966,-10.70282846507844
2021-07-28T09:30:00-04:00,219,222.59,217.4,220.82,33043685,30854482.75,47.94759635315643,42.272067121612714,NaN,NaN,-25.19755290775907,-52.645778027048195,0.035051303186583116,-2.072563713686691,-2.107615016873274,4978888389,4959881837.8,22.54777449125372,22.37881007150071,NaN,NaN,-12.203481617095372,-10.917207486795144
2021-07-29T09:30:00-04:00,222.79,224.435,222.14,222.52,22634837,30684273.2,50.49001560038605,42.41384123444061,NaN,NaN,27.31920864495946,-34.36347276045978,0.3113700377297892,-1.7184024697110374,-2.0297725074408266,5001523226,4973175733.6,28.56562495839249,21.909996518485382,NaN,NaN,-10.186851410986069,-10.812870904536705
2021-07-30T09:30:00-04:00,221.65,224.05,220.275,221.05,28473020,31203467.15,48.29343292629762,42.374182404117334,NaN,NaN,15.487705357180394,-18.416064705969752,0.39293181815452405,-1.5386077347476714,-1.9315395529021955,4973050206,4976042959.4,29.8319385779904,21.71943140884074,NaN,NaN,-9.18288285256059,-10.580015468540118
2021-08-02T09:30:00-04:00,222.47,224.55,219.64,219.95,24192605,31361610.95,46.65765264665229,42.70266348532298,NaN,NaN,18.278024701152145,-7.57294589523355,0.370865074019731,-1.4679582103775317,-1.8388232843972627,4948857601,4969632825.2,28.61082969684847,21.60808080801746,NaN,NaN,-8.831204611317027,-10.330185346079677
2021-08-03T09:30:00-04:00,220.62,221.12,217.1,220.86,27798643,31362979.8,48.220191134464834,43.46521019447157,NaN,NaN,-15.51397719552743,4.0746817200011005,0.4124309812517921,-1.3232845578325225,-1.7357155390843146,4976656244,4975795133.2,31.513122612024134,21.863852367454786,NaN,NaN,-8.093976257568844,-10.010726904863844
2021-08-04T09:30:00-04:00,219.1,221.2,217.89,218.11,25588462,31216330.2,44.02339285141133,44.035555714552274,NaN,NaN,-26.46849667030714,3.820492967491485,0.25718898484463226,-1.4142293080285242,-1.6714182928731565,4951067782,4970231011.8,30.314726368846095,22.189116247868895,NaN,NaN,-8.664056493275735,-9.818345417494115
2021-08-05T09:30:00-04:00,219.09,222.435,218.68,222.03,23915217,30297196.9,50.6207730313852,45.29695195884723,NaN,NaN,28.01839011803379,3.9603292621063537,0.4118072811593838,-1.1566591914239268,-1.5684664725833106,4974982999,4964922966.4,29.17489396026366,22.696812339099456,NaN,NaN,-7.153004450509239,-9.43758242221056
2021-08-06T09:30:00-04:00,223.75,225.21,222.14,223.39,24429215,30319839.95,52.70349599281866,46.941361195548936,NaN,NaN,103.3938438559678,21.541556961863837,0.5882228479063545,-0.8331879127003674,-1.421410760606722,4999412214,4970195368,31.913362603585853,23.715837943984486,NaN,NaN,-5.275708094204122,-8.84302894678107
2021-08-09T09:30:00-04:00,222.92,223.19,221.21,222.16,17225596,30339568.35,50.62383223733573,47.536141513002846,NaN,NaN,74.73419294251339,32.83279061013609,0.6024240978117543,-0.668380638342029,-1.2708047361537833,4982186618,4976861171.4,35.318460391704136,25.135916981231134,NaN,NaN,-4.314916052946473,-8.196155676233271
2021-08-10T09:30:00-04:00,222.64,223.22,221.19,222.6,22681588,30205771.05,51.36318395079524,47.773380217321076,NaN,NaN,82.83033286429664,52.50165262210089,0.619410555746633,-0.4965415414704921,-1.115952097217125,5004868206,4982503563.8,38.13867643567918,26.833412766428573,NaN,NaN,-3.316779079675975,-7.499101876725086
2021-08-11T09:30:00-04:00,223.02,223.73,220.47,223.69,25691282,29960631.5,53.23148057879891,48.45789972407618,NaN,NaN,85.16340838556455,74.82803363327523,0.6773219894532702,-0.2692996104005374,-0.9466215998538076,5030559488,4998401905,45.366892773701515,29.10636757234389,NaN,NaN,-1.9526098200097308,-6.7067458686228925
2021-08-12T09:30:00-04:00,223.76,223.84,221.71,223.16,23305194,28852042.3,52.181855340317,48.95606597860787,NaN,NaN,86.00752621532301,86.42586085273308,0.6529202228693702,-0.1304713212670947,-0.783391544136465,5007254294,5004856164,48.02216690198633,31.56065833785695,NaN,NaN,-1.084049309555295,-5.903503503041807
2021-08-13T09:30:00-04:00,222.98,223.3,220.7,221.13,20813674,28061715.7,48.25693952518713,49.102045533103635,NaN,NaN,45.21574220198228,74.79024052193597,0.48099068495478237,-0.18215318794298696,-0.6631438728977693,4986440620,5002261845.2,47.03266934225407,33.42051779218362,NaN,NaN,-1.3833954984107137,-5.257773788094508
2021-08-16T09:30:00-04:00,219.77,220.26,217.65,219.07,24120034,26339169.3,44.591556787632214,49.228957068331326,NaN,NaN,-70.99622141562693,45.64415765030791,0.22259562355562212,-0.3848993434532417,-0.6074949670088639,4962320586,4998288638.8,45.48684116310548,35.13128430554541,NaN,NaN,-2.6761498054991266,-4.888970362009454
2021-08-17T09:30:00-04:00,216.66,217.44,213.75,216.4,35161520,26057517.65,40.31712995235266,48.683923753988196,NaN,NaN,-197.2334758236525,-10.368604087281913,-0.11588497213327664,-0.7523511821754596,-0.636466210042183,4927159066,4982746810.8,39.954902875052966,36.374650618673925,NaN,NaN,-5.081260906947241,-4.916440439857709
2021-08-18T09:30:00-04:00,216.1,218.04,214.37,214.51,29102340,26098698.15,37.57163544679805,47.761182314446195,NaN,NaN,-170.71001610176066,-61.54328898474696,-0.4367760139913146,-1.1824362275313263,-0.7456602135400117,4898056726,4956246258.4,32.66101974354284,36.66717881761323,NaN,NaN,-7.9672259318589305,-5.352266938715027
2021-08-19T09:30:00-04:00,212.43,214.07,210.6825,211.94,38119879,26360744.2,34.164695151681215,46.75198675911645,NaN,NaN,-229.1911199393863,-124.58301821568882,-0.7722211361223869,-1.7109366336929952,-0.9387154975706083,4859936847,4926782769,26.80260998988507,36.45079820417714,NaN,NaN,-11.535713163551835,-6.235616399405999
2021-08-20T09:30:00-04:00,212.1,216.02,211.42,215.52,31759533,26765704.35,42.04798589558121,46.42272484832565,NaN,NaN,-144.3073340239956,-162.4876334608844,-0.7049652055581566,-1.819922004518304,-1.1149567989601474,4891696380,4907833921,23.840818497781555,36.1100831185295,NaN,NaN,-12.259775020684943,-7.096210488160134
2021-08-23T09:30:00-04:00,217.48,219.94,217.44,219.62,25778831,26944936.15,49.50526359650418,46.514515738471324,NaN,NaN,-19.580050723041065,-152.20439932236724,-0.35403778030722877,-1.5575040243441833,-1.2034662440369546,4917475211,4898864846,22.56951526059798,35.471254021999066,NaN,NaN,-10.430811673550583,-7.572582086073055
2021-08-24T09:30:00-04:00,220.32,221.92,219.69,221.78,18677896,26125652.55,52.94092050168642,47.15148199920526,NaN,NaN,32.09161389807802,-106.33938137802113,0.03329390258102882,-1.1618488658106685,-1.1951427683916973,4936153107,4900663654.2,23.451149706896416,34.980998546145514,NaN,NaN,-7.792127680591143,-7.603945742432782
2021-08-25T09:30:00-04:00,221.77,223.9699,220.85,222.56,21548025,25550869.55,54.15400380967627,47.403855626226054,NaN,NaN,62.7875325778638,-59.639871642096224,0.33499424242939413,-0.7763999653549547,-1.1113942077843488,4957701132,4912592535.4,29.20769790918267,34.98334168535401,NaN,NaN,-5.298316095954649,-7.274570078650192
2021-08-26T09:30:00-04:00,222.14,223.16,219.74,220.2,22380325,25538143.95,49.95783552921992,47.20773702168328,NaN,NaN,29.135270360272585,-7.9745935821644425,0.36605590103582,-0.6538243314895738,-1.0198802325253937,4935320807,4927669327.4,35.780963386685286,35.25959888414683,NaN,NaN,-4.477394275167693,-6.874973535295549
2021-08-27T09:30:00-04:00,220.65,227.025,220.57,226.41,33998457,25814415.8,58.967601491775895,47.80372053985757,NaN,NaN,117.55967486293096,44.39880819522086,0.7719412373846343,-0.054953685794600915,-0.8268949231792352,4969319264,4943193904.2,41.776010587533236,35.72085246956319,NaN,NaN,-0.5944491988468107,-5.977755772945729
2021-08-30T09:30:00-04:00,227.25,227.35,224.98,225.48,20733337,25641452.4,57.30366831886812,48.22804085186278,NaN,NaN,134.82593360150176,75.28000506012941,0.9340640834901334,0.3406851811834315,-0.5933789023067019,4948585927,4949416047.4,44.03118356443654,36.141745835903,NaN,NaN,1.9186095963923344,-4.8497035773260055
2021-08-31T09:30:00-04:00,225.24,226.609,224.33,225.92,20839803,25293510.4,57.90882506224837,48.56213688639489,NaN,NaN,114.15423663072588,91.692529606659,1.020203854129356,0.6818759153549934,-0.33832793877436285,4969425730,4956070572,46.42136706526826,36.217065428157774,NaN,NaN,4.098803705858855,-3.571345394013883
2021-09-01T09:30:00-04:00,226.83,228.24,224.87,227.44,20451506,25036662.6,60.01709978323481,49.121797203746155,NaN,NaN,129.86712885294594,105.10844886167543,1.1208011419605044,1.0626734886762677,-0.05812765328423675,4989877236,4962505792.8,48.70281094349505,36.26568285969411,NaN,NaN,6.554467838025737,-2.1248006465796516
2021-09-02T09:30:00-04:00,228.33,229.84,227.6,229.02,22849904,24983396.95,62.1399322527898,50.113439541432065,NaN,NaN,150.19701862035166,129.32079851369124,1.226461172733416,1.4749488126325332,0.24848763989911726,5012727140,4977987059.4,53.79954670757906,36.74903124293161,NaN,NaN,9.254048384535803,-0.4992507849917298
2021-09-03T09:30:00-04:00,228.25,228.97,227.19,227.96,18252374,24674554.9,59.844323600486604,51.202922885207386,NaN,NaN,123.2346831767824,130.45580017646154,1.1584815737136696,1.6965896070412043,0.5381080333275348,4994474766,4983018159.8,55.352080132057345,37.453691169285314,NaN,NaN,10.8401473451637,1.1206632336019031
2021-09-07T09:30:00-04:00,227.72,229,226.2549,226.39,19153387,24770944.45,56.514179874928615,52.35985502253424,NaN,NaN,96.54181231436823,122.79897591903482,0.9500441992198695,1.7256632823523717,0.7756190831325022,4975321379,4988365250.2,57.00573354537483,38.67160764573688,NaN,NaN,11.23351918646473,2.5653569411537354
2021-09-08T09:30:00-04:00,225.61,225.97,222.63,223.92,25241516,24898940.85,51.64505673446708,53.365099400224885,NaN,NaN,39.06943749984617,107.78201609285888,0.6048960034355179,1.5317390874268995,0.9268430839913816,4950079863,4984496076.8,55.40658074969922,40.29629057474805,NaN,NaN,10.136036649374013,3.646882613756632
2021-09-09T09:30:00-04:00,223.54,226.285,222.962,223.81,27180475,24973400.5,51.43253094419077,54.598516242547,NaN,NaN,39.89106060141955,89.7868024425536,0.34138435840833736,1.3535735320018034,1.012189173593466,4922899388,4971100507.2,50.160215836161385,41.964690992339214,NaN,NaN,9.183185989687463,4.437783096032465
2021-09-10T09:30:00-04:00,225.16,225.29,221.52,221.62,24366127,25026447.15,47.262531705485365,54.97098380039729,NaN,NaN,13.286832869844565,62.40476529245218,0.009335812949100797,1.023858939779842,1.0145231268307413,4898533261,4948261731.4,42.73109406618497,43.313996390082316,NaN,NaN,7.13910512595039,4.823686243163597
2021-09-13T09:30:00-04:00,223.21,223.38,220.25,222.88,34693062,25720416.55,49.785093709197724,54.99097166558969,NaN,NaN,1.8040373065702733,38.11863611840976,-0.12811413851857423,0.8543804536825235,0.9824945922010977,4933226323,4936012042.8,39.363578843086266,44.51357236026005,NaN,NaN,6.106418736137363,5.006933742159849
2021-09-14T09:30:00-04:00,223.75,223.77,219.07,220.04,30312554,26030042.55,44.6060581053552,54.39562435156603,NaN,NaN,-21.6236060179728,14.48555245194155,-0.3977485313082907,0.48530892806573434,0.883057459374025,4902913769,4921530520.8,35.77427488328419,45.39379558714489,NaN,NaN,3.6380292226201636,4.81137595365418
2021-09-15T09:30:00-04:00,220.02,222.74,219.46,222.03,27572014,25650567.25,48.63797115590455,54.00162201915377,NaN,NaN,-20.18511977771141,2.6346409964300315,-0.4269530250623198,0.34936617804612524,0.776319203108445,4930485783,4917611704.8,34.84825140006009,45.79669226506471,NaN,NaN,2.7042138451820117,4.510352795301013
2021-09-16T09:30:00-04:00,222.26,223.34,220.26,222.19,22369030,25313901.75,48.959643832389695,53.930322612237326,NaN,NaN,-17.819234041337136,-8.907417932121305,-0.4197429806597046,0.25164047728381433,0.671383457943519,4952854813,4923602789.8,37.51135205036176,45.92029145532731,NaN,NaN,2.035773621946156,4.156841484821747
2021-09-17T09:30:00-04:00,221.62,223.03,220.64,222.48,39957579,25405786.75,49.57605643439712,53.259497965281696,NaN,NaN,-30.182761950970242,-17.601336896284266,-0.38083399619448444,0.19534096270041346,0.5761749588948979,4992812392,4942458616,45.11527589264811,46.158810405692655,NaN,NaN,1.6478439034245878,3.798413258907867
2021-09-20T09:30:00-04:00,217.45,218.99,214.22,217.19,44958534,26065736.8,40.069661658618294,52.028497489549565,NaN,NaN,-172.93853504513626,-52.54985136662558,-0.6793309698587011,-0.2729887534284785,0.4063422164302226,4947853858,4945384123,46.2089474834132,46.31436497133385,NaN,NaN,-1.7017568242135537,3.0126746756048073
2021-09-21T09:30:00-04:00,218.77,219.29,215.82,217.52,26711163,26112353.4,40.83187167308424,50.80871510460927,NaN,NaN,-147.63939345005122,-77.75300885304125,-0.8134561534863373,-0.610477975427699,0.20297817805863827,4974565021,4959714373.4,51.32546619881632,46.66465776658729,NaN,NaN,-4.177477420559084,1.9855100904385372
2021-09-22T09:30:00-04:00,218.88,222.55,218.87,220.9,32100323,26783474.75,48.111165952090026,49.95829125952749,NaN,NaN,-63.92812111473563,-86.50160912044609,-0.6410273140097689,-0.5983059644535729,0.042721349556196025,5006665344,4974950285.6,56.10592710570772,47.1934517781739,NaN,NaN,-4.147701541034456,1.1093370002281095
2021-09-23T09:30:00-04:00,222.18,225.645,221.56,224.81,31057849,27258965.95,55.00705970115627,49.44880036298225,NaN,NaN,16.525703236691175,-79.63262166484044,-0.2502109637418075,-0.27004235512106334,-0.01983139137925584,5037723193,4991923961.6,60.73282350102987,47.68868583484896,NaN,NaN,-1.8407003717168666,0.6879030899502558
2021-09-24T09:30:00-04:00,223.02,224.355,221.84,223.05,28866026,27583251,51.677846193607664,48.865480548205184,NaN,NaN,-10.069794537810171,-75.61002818220842,-0.10427666390075972,-0.1501772212552055,-0.04590055735444577,5008857167,4995132916.6,61.55784268719507,48.13195458878737,NaN,NaN,-1.0146889672879316,0.44467565320194335
2021-09-27T09:30:00-04:00,223.62,227.675,223.53,226.44,29743232,27370489.75,57.06772316010739,48.90501935428938,NaN,NaN,61.27530539963731,-28.767260093253707,0.20941883001472875,0.21587298016396517,0.006454150149236414,5038600399,5013282224.8,65.91923221183501,48.768633064963105,NaN,NaN,1.4994117502834794,0.5953522384993056
2021-09-28T09:30:00-04:00,225.41,225.6,220.85,221.29,39938155,28330730.65,48.260884164169624,48.66329274212527,NaN,NaN,-20.805500994220278,-3.4004816020875204,0.06633919727587625,0.08937814674408173,0.023038949468205477,4998662244,5018101669.4,66.99021244198218,49.596035328697596,NaN,NaN,0.6214988610375556,0.5990874702904841
2021-09-29T09:30:00-04:00,222.27,222.66,220.17,220.82,23628860,28470183.5,47.53983889967694,48.385243310374285,NaN,NaN,-52.63728658756987,-1.1423146966543627,-0.05702229865210347,-0.048238923846923853,0.00878337480517961,4975033384,5011775277.4,64.14083185355369,50.59465075851133,NaN,NaN,-0.29300652215948797,0.47164547136905954
2021-09-30T09:30:00-04:00,222.12,222.61,218.6,218.75,33153551,29105285.75,44.39391730606327,48.180342281844126,NaN,NaN,-80.31371247978221,-20.51019783994904,-0.2635363317242789,-0.320637039850169,-0.057100708125890104,4941879833,4992606605.4,56.323645365668774,51.565547279903036,NaN,NaN,-2.07221852708233,0.10823632873314676
2021-10-01T09:30:00-04:00,219.95,223.5,217.74,222.28,32647021,29595141.6,50.419389691314564,48.22564913770962,NaN,NaN,-40.197219963101794,-26.53568292500737,-0.15336338729736984,-0.2488049422476024,-0.09544155495023257,4974526854,4985740542.8,53.794609102504694,52.59633515557578,NaN,NaN,-1.5997311387131896,-0.135759023759187
2021-10-04T09:30:00-04:00,222.14,222.32,218.93,220.26,32580237,30311534.75,47.263266950690856,48.415449769519306,NaN,NaN,-56.53713887725608,-50.098171780386046,-0.204311116425454,-0.3508304504820501,-0.1465193340565961,4941946617,4966409786.4,47.348517672365716,53.423066783367325,NaN,NaN,-2.2415702993891307,-0.4365892059920361
2021-10-05T09:30:00-04:00,220.96,223.06,219.88,221.02,20407608,30374245.8,48.567750849067686,48.410434033316676,NaN,NaN,-17.695639536956506,-49.47619948893329,-0.17569662638834072,-0.366140117042022,-0.19044349065368127,4962354225,4959148182.6,45.15937525851566,54.15957563039986,NaN,NaN,-2.350249025468484,-0.7099691802029573
2021-10-06T09:30:00-04:00,218.76,220.2,216.76,219.87,32893268,30756833.4,46.68592095961357,48.24802525668981,NaN,NaN,-108.24125072697876,-60.59699231681507,-0.22020538734618364,-0.4657002248364108,-0.24549483749022719,4929460957,4950033697.2,42.503103194077035,54.51612928352238,NaN,NaN,-3.0056637034255536,-1.037925540663328
2021-10-07T09:30:00-04:00,221.53,224.95,221.37,223.26,24289331,30612276.2,52.52547329756182,48.458697889773006,NaN,NaN,79.21796365134503,-28.690657090589617,-0.017979076245285414,-0.26796868279683395,-0.24998960655154853,4953750288,4952407788.2,43.436382630625374,54.396208336235034,NaN,NaN,-1.7600705367875236,-1.1410891115382131
2021-10-08T09:30:00-04:00,223.39,224.11,221.5,221.58,17989556,30293447.65,49.62459893114414,49.141193409239136,NaN,NaN,45.26488381295899,-11.598236335377461,0.004780382974317876,-0.24401412783365117,-0.24879451080796905,4935760732,4944654563.8,41.09064249532893,54.03061512280045,NaN,NaN,-1.611688175201591,-1.20831754920441
2021-10-11T09:30:00-04:00,221.83,223.55,220.25,220.31,15929780,29355283.55,47.48941690121795,49.61673235410582,NaN,NaN,0.6547722825848876,-0.15985410340926456,-0.059985245469635684,-0.32377606764501365,-0.26379082217537797,4919830952,4940231430.8,39.77109177057841,53.2053026636406,NaN,NaN,-2.1279639476178644,-1.3396956061206178
2021-10-12T09:30:00-04:00,220.85,222.47,220.36,221.52,18800635,28779687.6,49.70960257684054,49.73090639873086,NaN,NaN,3.2727771571789606,4.033829235417831,-0.017810257179248445,-0.2860536436494385,-0.2682433864701901,4938631587,4935486903.2,38.348503445776494,51.93691525935979,NaN,NaN,-1.9092477163933974,-1.4210601933024434
2021-10-13T09:30:00-04:00,221.89,222.7,219.83,222.57,19676172,28384895.5,51.621156484222375,49.489056168949865,NaN,NaN,14.203961279544519,28.522871636722478,0.07901192228711196,-0.16947848361130013,-0.2484904058984121,4958307759,4941256263.6,41.107135515782744,50.53508040327072,NaN,NaN,-1.1779611689308536,-1.386331761249359
2021-10-14T09:30:00-04:00,224.75,226,224.32,225.87,18159962,28174442.1,57.1356659587085,49.87890043788564,NaN,NaN,157.83298720081174,44.245876346615816,0.3484199832882183,0.1870345732118608,-0.1613854100763575,4976467721,4945799750.2,43.26032985673398,49.22811520109492,NaN,NaN,1.1471248586430842,-1.02440938697901
2021-10-15T09:30:00-04:00,227.98,228.4062,225.06,225.16,27555333,27554329.8,55.66549917951218,49.77874158212884,NaN,NaN,159.4363249375638,67.08016457153678,0.4551757640289065,0.40758429495977566,-0.047591469069130865,4948912388,4948430081.4,44.52484758847121,47.69994487085465,NaN,NaN,2.635451859621437,-0.5015720660360891
2021-10-18T09:30:00-04:00,223.88,225.675,223.73,225.03,19082599,26260533.05,55.38449215527469,50.28757072435064,NaN,NaN,97.78177579285625,86.50556527359106,0.4903647395441212,0.5653644553610206,0.07499971581689943,4929829789,4950429848.8,45.51896391484944,46.16628426177374,NaN,NaN,3.7762951853359956,0.1095518270170659
2021-10-19T09:30:00-04:00,225.98,226.88,224.61,225.87,15498358,25699892.8,56.89855369845651,50.95605035283489,NaN,NaN,120.75627453185231,110.00226474852573,0.5396378572510355,0.7495470373806938,0.2099091801296583,4945328147,4951769160.8,46.214138348562194,44.88580615427435,NaN,NaN,5.158520337988758,0.8308330428701647
2021-10-20T09:30:00-04:00,225.97,227.98,225.12,227.37,18130549,25001404.1,59.539077716892045,52.037847525036945,NaN,NaN,136.76778368508337,134.5150292296335,0.6360453784638012,1.0049659032094098,0.36892052474560866,4963458696,4952799348.2,46.776699058401434,44.203881418040964,NaN,NaN,7.093645361545225,1.725520516966602
2021-10-21T09:30:00-04:00,227.19,229.01,226.62,227.95,17851620,24341092.65,60.54558134616257,52.76114692895466,NaN,NaN,149.5579579571904,132.86002338090924,0.6967800622925632,1.2398956026113126,0.5431155403187494,4981310316,4953767867.2,47.334404472486554,43.74243823018253,NaN,NaN,9.002932576560385,2.7651508111942853
2021-10-22T09:30:00-04:00,227.8,228.39,225.69,227.41,16886970,23742139.85,59.072206636370396,53.604642620788916,NaN,NaN,109.34503348394654,122.84176509018577,0.6589080040792188,1.3667505454177729,0.7078425413385541,4964423346,4956870058.8,49.17159701862153,43.872658183486514,NaN,NaN,10.247895404082573,3.834114324464041
2021-10-25T09:30:00-04:00,227.79,229.98,227.28,229.57,16387146,23074335.55,62.95549165521694,54.63233839265672,NaN,NaN,144.0521584862134,132.09584162885722,0.7320223738391147,1.6228705086374475,0.8908481347983328,4980810492,4967066199.4,54.75787510280913,44.55826531522176,NaN,NaN,12.446364768736743,5.064435816502998
2021-10-26T09:30:00-04:00,230.03,230.72,227.8,227.84,25290160,22341935.8,58.193055835415834,55.45427659807116,NaN,NaN,119.8153479905959,131.90765632060592,0.620948971096061,1.667034348668409,1.046085377572348,4955520332,4969104636.4,55.80367455721366,45.50830612687438,NaN,NaN,13.064331911711408,6.207278115818485
2021-10-27T09:30:00-04:00,227.18,227.46,223.5,223.65,27088453,22514915.45,48.60318331529192,55.17411302790902,NaN,NaN,22.842768892473934,109.12265336208404,0.24184617086851157,1.3483930911579876,1.106546920289476,4928431879,4962099273,51.40586753790543,46.07755504882295,NaN,NaN,10.66826297968402,6.844561667799276
2021-10-28T09:30:00-04:00,224.8,228.26,224.77,228.11,22890647,22001770.25,56.769677625777504,55.68447579181141,NaN,NaN,69.32204342230288,93.07547045510654,0.26609250779451843,1.439162555032624,1.1730700472381055,4951322526,4956101715,47.92368116311838,46.56562923937934,NaN,NaN,11.198207114677427,7.466511017353297
2021-10-29T09:30:00-04:00,227.8,228.83,226.96,228.05,20777666,21408302.5,56.639295409320745,56.33803854239017,NaN,NaN,84.71633887147321,88.14973153261187,0.25281691756417257,1.4890911941933211,1.2362742766291486,4930544860,4949326017.8,44.274796709094375,46.887322449273334,NaN,NaN,11.569546696583092,8.052658971528983
2021-11-01T09:30:00-04:00,229.25,234.18,228.89,233.96,35500822,21554331.75,65.13363340083342,57.43975502981824,NaN,NaN,176.5405697991658,94.64741379520237,0.5971344707861912,1.9826923651118875,1.3855578943256963,4966045682,4946373055.8,42.747208652429556,47.201515678319986,NaN,NaN,14.905484088539774,9.03163398824481
2021-11-02T09:30:00-04:00,234.38,234.85,232.65,234.45,24949704,21781436.55,65.73301361359961,58.44774482477375,NaN,NaN,189.6033990591426,108.60502400891168,0.800282055357505,2.3859104635225776,1.5856284081650727,4990995386,4953468066.6,47.439540493132235,47.65383031955923,NaN,NaN,17.68644246667888,10.268035199449677
2021-11-03T09:30:00-04:00,234.15,239.81,233.92,238.64,47648496,22519197.95,70.41630101878765,59.3963616147794,NaN,NaN,232.79130664759424,150.59473155993575,1.138599057867434,3.0088772304993654,1.8702781726319313,5038643882,4975510467.2,58.750536931673956,48.76027368205495,NaN,NaN,21.75649029021676,11.90924306955926
2021-11-04T09:30:00-04:00,239.48,240.935,237.56,238.55,26514023,22630432.55,70.19438408863732,60.43413910828834,NaN,NaN,213.2174995209819,179.37382277967157,1.2681677978531836,3.4554879199484105,2.187320122095227,5012129859,4987671933.8,63.42696690099157,50.110425061520694,NaN,NaN,24.821680490480414,13.75387698683371
2021-11-05T09:30:00-04:00,241.17,243.4,240.2,241.81,42041677,23833038.6,73.4574085173419,61.72506170557886,NaN,NaN,207.76764300806852,203.98408360699062,1.4710037264163267,4.026074780115636,2.555071053699309,5054171536,5012397269,70.6998539164961,51.90906006163829,NaN,NaN,28.553969208614017,15.868175875659468
2021-11-08T09:30:00-05:00,243.74,244.46,241.93,242.56,31324548,24602777,74.158332791396,62.95790306936025,NaN,NaN,178.65151872230683,204.40627339161884,1.5455940635844052,4.487063633179815,2.94146956959541,5085496084,5036287349.4,75.72324129670925,54.016853129363085,NaN,NaN,31.755559923677062,18.13780216823341
2021-11-09T09:30:00-05:00,242,242.53,239.54,241.15,29895916,25157541.05,70.394675082955,63.73330288122189,NaN,NaN,128.21262874615664,192.12811932902164,1.3945235245083856,4.684623975230892,3.2901004507225062,5055600168,5049208305.8,77.92739653649485,56.241902949226905,NaN,NaN,33.258098197743095,20.297844458163365
2021-11-10T09:30:00-05:00,240.08,241.56,236.31,237.35,32471632,25797314.05,61.35687807413448,63.791252647505594,NaN,NaN,83.61570143354187,162.29299828621117,0.9542298695511469,4.48288778766144,3.528657918110293,5023128536,5046105236.6,76.13949759618738,58.29940960091982,NaN,NaN,31.67057332888315,21.922520011123336
2021-11-11T09:30:00-05:00,238.31,240.378,237.66,239.26,17987496,25788690.75,63.86789960331736,64.13380214514466,NaN,NaN,81.50970260952553,135.95143890391992,0.7179616671913474,4.4261100020994775,3.70814833490813,5041116032,5051902471.2,77.19230352683707,60.30088863722093,NaN,NaN,31.142714051189362,23.239690588275625
2021-11-12T09:30:00-05:00,239.92,240.21,238.74,239.5,20526719,25437260.05,64.18284256325606,64.22147006714746,NaN,NaN,76.67565732633447,109.7330417675731,0.5137463570284475,4.350331281193689,3.836584924165242,5061642751,5053396714.2,77.46826497285339,61.9230593422241,NaN,NaN,30.816140238481797,24.322040538305078
2021-11-15T09:30:00-05:00,240.57,240.76,237.55,238.55,27390040,25852632.1,61.88346460675955,64.485070693672,NaN,NaN,63.49941725788252,86.70262147468824,0.2632125309244846,4.1656005878208475,3.902388056896363,5034252711,5043148039.6,71.11281888306915,63.01656965121378,NaN,NaN,29.870684500106304,25.11470396141954
2021-11-16T09:30:00-05:00,237.76,239.37,236.95,238.99,21925179,26173973.15,62.5526194336098,65.48145898783757,NaN,NaN,51.831198629138136,71.42633545128454,0.08488719162547254,4.008497046428204,3.923609854802731,5056177890,5043263584,71.14156378850939,64.42626224054264,NaN,NaN,29.275865041249233,25.709155544252354
2021-11-17T09:30:00-05:00,238.06,238.13,235.13,235.86,26527765,26593833.95,55.13722215467456,65.36485502561592,NaN,NaN,22.514196446349832,59.20603445384613,-0.2668536930100207,3.5900427385402054,3.856896431550226,5029650125,5044567901.8,71.48648953421332,66.10931998133513,NaN,NaN,26.51856556419896,25.824785547101868
2021-11-18T09:30:00-05:00,236.92,237.07,233.05,234.86,30637302,27233118.05,52.976434959952414,65.10322213637534,NaN,NaN,0.4841849682594167,43.00093092559292,-0.5723094059712257,3.141509674086194,3.71381908005742,4999012823,5036147260,66.00176496412104,67.6612462852656,NaN,NaN,23.58087172551485,25.504226429732295
2021-11-19T09:30:00-05:00,233.27,234.42,232.39,232.72,33994017,28088470.4,48.588139675684786,63.921401156007576,NaN,NaN,-30.682601489077886,21.529279162510402,-0.9041897046543683,2.583581949239459,3.4877716538938275,4965018806,5016822471,55.48136521998317,68.57082889723372,NaN,NaN,19.701205722361724,24.675223471536498
2021-11-22T09:30:00-05:00,234.22,235.74,231.62,231.73,31042087,28821217.45,46.66244806596407,62.55921790260504,NaN,NaN,-37.729792471026656,1.283437216728568,-1.1597835634495461,2.038042199581895,3.197825763031441,4933976719,4996767272.6,47.09213752705172,68.54601439965654,NaN,NaN,15.88909872190802,23.420062793018143
2021-11-23T09:30:00-05:00,231.39,233,228.62,231.33,33843831,29248901,45.87139092354406,60.80601003865907,NaN,NaN,-73.22901828791345,-23.72860616668175,-1.3138681042164153,1.5554906327609217,2.869358736977337,4900132888,4965558272.2,37.57141385443572,67.03321989413952,NaN,NaN,12.511959416763057,21.861762310695987
2021-11-24T09:30:00-05:00,229.39,231.99,228.54,231.58,24099292,29099442.95,46.48205791068862,59.112272454519875,NaN,NaN,-89.19961211924837,-46.07136787980139,-1.3517751521065895,1.1796397968441,2.5314149489506894,4924232180,4944474683.2,32.75379392018492,64.84227896693905,NaN,NaN,9.858641745181679,20.1470308013368
2021-11-26T09:30:00-05:00,224.96,226.17,219.64,222.85,62595374,31084679.3,32.63583716414432,56.19644592929147,NaN,NaN,-208.34018221911484,-87.83624131727625,-1.8848789001798814,0.17531632372583772,2.060195223905719,4861636806,4916999479.8,27.758587709764342,61.77504566645821,NaN,NaN,2.09676210518081,17.56842098760023
2021-11-29T09:30:00-05:00,226.22,226.75,221.24,222.71,45982414,32344916.7,32.468800953207165,53.218622226563696,NaN,NaN,-182.89086000197378,-118.27789301985543,-2.1479264145083876,-0.6247127942297652,1.5232136202786222,4815654392,4887126597,23.552735020407894,58.04858093243668,NaN,NaN,-3.9491902333145146,14.494476527469553
2021-11-30T09:30:00-05:00,220.66,221.86,215.88,218.17,64908363,33815293.75,27.54528217627859,50.15795130465823,NaN,NaN,-210.4500591564574,-152.82194635694157,-2.503820690036057,-1.606562242266449,0.8972584477696078,4750746029,4850480459,19.624548313811317,53.88409177367357,NaN,NaN,-11.100073621698495,10.838112220445545
2021-12-01T09:30:00-05:00,223.17,224.21,213.15,213.26,69305403,36033078.7,23.41068024150617,47.44750860232764,NaN,NaN,-185.08586335216756,-175.1933153697924,-2.9171587725212182,-2.749190017881915,0.16796875463930316,4681440626,4806742006.6,16.160227330672342,49.599858183279636,NaN,NaN,-18.881060953023617,6.592516052807094
2021-12-02T09:30:00-05:00,214.37,219.94,213.82,219.21,64315720,36866439.9,35.95608088246759,45.45380726512409,NaN,NaN,-147.25736471498575,-186.80486588893987,-2.6451250310602057,-3.138437534185954,-0.49331250312574826,4745756346,4771046839.8,13.989733382745186,45.085388887273076,NaN,NaN,-20.819231455989016,2.676552122979078
2021-12-03T09:30:00-05:00,220.29,220.38,212.71,214.71,64425236,38762000.55,31.72373744918768,43.135299756976345,NaN,NaN,-137.35417411931704,-172.6076642689803,-2.6186397783453135,-3.76661222605739,-1.1479724477120765,4681331110,4734985700.6,12.206110194855597,40.42380640313037,NaN,NaN,-24.013214927493884,-1.1362717413742023
2021-12-06T09:30:00-05:00,216.54,220.69,213.71,219.02,43878330,38853833.2,39.11575390521402,41.50903470686594,NaN,NaN,-105.54545324063811,-157.13858291671318,-2.179245934039024,-3.8720298652608562,-1.6927839312218325,4725209440,4716896710.2,11.419600378066548,36.16000508134447,NaN,NaN,-23.73725702151993,-4.364983924252163
2021-12-07T09:30:00-05:00,222.14,226.04,221.98,224.1,44679195,39521565.55,46.471837352937364,40.36040741538934,NaN,NaN,-46.70424958909701,-124.38942100324111,-1.4499761918350087,-3.5052541710155936,-2.055277979180585,4769888635,4720725231.4,12.701735748691576,31.985731649928912,NaN,NaN,-20.652730753161975,-6.691804899810707
2021-12-08T09:30:00-05:00,224.6,226.535,223.06,225.63,36546381,39854088.8,48.49040027421765,39.88563442392813,NaN,NaN,-32.394626795646374,-93.85117369193688,-0.8004952951169706,-3.055897098076798,-2.2554018029598275,4806435016,4745724109.4,20.766290237290676,28.362860271577294,NaN,NaN,-17.582241775243748,-8.247581596301142
2021-12-09T09:30:00-05:00,223.95,225.81,220.48,220.52,34830252,39972019.8,42.69890336530325,39.15152502431033,NaN,NaN,-50.75838625387783,-74.5513779997153,-0.6569961598531764,-3.0766470027762978,-2.4196508429231214,4771604764,4750893793,22.363524843896357,25.245843120132673,NaN,NaN,-17.119683381971257,-9.51502470853973
2021-12-10T09:30:00-05:00,222.2,222.85,218.32,219.91,32924568,40718873.4,42.053207794768824,38.68474417567348,NaN,NaN,-61.562214978230045,-59.392986171497895,-0.5494821376403913,-3.1065035149736104,-2.557021377333219,4738680196,4762363610.2,25.931089819812158,23.135109162977606,NaN,NaN,-16.986081853693822,-10.582318586418886
2021-12-13T09:30:00-05:00,218.39,219.05,214.745,216.04,33478398,41366457.35,38.11521207394503,38.07422731910069,NaN,NaN,-89.52591666266032,-56.18907885590232,-0.6769521529484868,-3.4032115685188273,-2.7262594155703406,4705201798,4758362081.8,25.490994298787484,21.592170360958736,NaN,NaN,-18.20613144304948,-11.671434708794685
2021-12-14T09:30:00-05:00,214.58,217.52,213.31,214.18,36543485,41824129.6,36.353213392519265,37.39435749545607,NaN,NaN,-99.65900058970007,-66.78002905602293,-0.8152070065772583,-3.7452681737919136,-2.9300611672146553,4668658313,4738116017.4,23.333246228087233,20.575158387648123,NaN,NaN,-19.757759965089953,-12.82662403112258
2021-12-15T09:30:00-05:00,214.21,218.16,211.08,217.58,51261021,43290921.7,41.662158679292844,37.0500789789278,NaN,NaN,-88.97022856324683,-78.09514940954304,-0.615435106697559,-3.699355050586604,-3.083919943889045,4719919334,4720812881,21.64678534447569,19.781800632240326,NaN,NaN,-19.321677424519144,-13.754488801607804
2021-12-16T09:30:00-05:00,219.45,219.9,212.25,213.18,52743794,44601723.15,37.32334706746688,37.38490111487941,NaN,NaN,-88.46960543356593,-85.63739324548065,-0.7106420361641752,-3.972222489094264,-3.261580452930089,4667175540,4699927036.2,19.787664793310384,19.21244899535076,NaN,NaN,-20.386859087399944,-14.701970271006681
2021-12-17T09:30:00-05:00,212.2,217.35,210.3,215.14,63114782,46225597.15,40.30564068260498,37.94467538126497,NaN,NaN,-91.78516615366622,-91.6819834805679,-0.5782450377820068,-3.984386750157597,-3.4061417123755904,4730290322,4698249061.4,19.641712286901566,18.93309022867174,NaN,NaN,-20.28604818258845,-15.499695686946934
2021-12-20T09:30:00-05:00,212.09,212.94,208.76,212.12,49993003,47025546.45,37.35617996428443,38.64545379469396,NaN,NaN,-122.7613959682129,-98.32907934167841,-0.6266248046798149,-4.189422718225359,-3.562797913545544,4680297319,4693268165.6,19.18925067898614,18.901997540469942,NaN,NaN,-21.140328977641598,-16.305500442760458
2021-12-21T09:30:00-05:00,214.2,218.385,212.061,218.18,38545265,47400705.35,45.90972832046205,40.252528657476525,NaN,NaN,-51.06347575451157,-88.6099743746407,-0.20488320635520907,-3.818901921489555,-3.614018715134346,4718842584,4703305019.8,23.036598793333823,19.393166930660044,NaN,NaN,-19.007367738863753,-16.69148148506093
2021-12-22T09:30:00-05:00,217.87,220.35,217.13,220.28,32442011,47330614.35,48.5323392414185,41.15083282597301,NaN,NaN,5.4137678472565565,-69.73317509254002,0.23716198600028227,-3.317566232633993,-3.5547282186342755,4751284595,4709578072,25.426302174126477,20.210064701472994,NaN,NaN,-16.431769150081006,-16.65437972292094
2021-12-23T09:30:00-05:00,221.05,222.8,220.34,222.04,22125391,47231919.3,50.690212294827994,42.505581029233035,NaN,NaN,68.68011788935219,-38.30323042795639,0.6465217924829925,-2.7465759780305348,-3.3930977705135272,4773409986,4730824961.2,33.01297838820389,21.696269572426445,NaN,NaN,-13.66132007472276,-16.226799773178342
2021-12-27T09:30:00-05:00,222.34,224.235,220.6,224.12,24196655,45311983.35,53.188155535749374,43.51075257427128,NaN,NaN,95.26152727532939,-0.8938917421572767,1.032883813309632,-2.101993003876487,-3.134876817186119,4797606641,4744288225,37.36154937023244,23.549265929009724,NaN,NaN,-10.597899474067859,-15.422671159019702
2021-12-28T09:30:00-05:00,223.79,225.73,222.35,222.75,23120267,44168876,51.343247660128,43.85871045335632,NaN,NaN,108.44644434877125,45.34767632123955,1.1620524407511263,-1.6823112662472113,-2.8443637069983376,4774486374,4763126036,42.94279518144796,25.70934160277804,NaN,NaN,-8.622616463046509,-14.451234773880675
2021-12-29T09:30:00-05:00,222.72,223.4901,221.255,222.99,19444392,41895677.45,51.65958140262984,44.08508053395719,NaN,NaN,76.9649608475216,70.95336364164618,1.2233438851662193,-1.3151838505405635,-2.538527735706783,4793930766,4778143672.4,46.99735332951396,27.582988966508275,NaN,NaN,-6.929029470647791,-13.376634016275977
2021-12-30T09:30:00-05:00,222.94,225.43,222.7,222.93,23607696,39610792.1,51.56931659319995,44.71868147880696,NaN,NaN,88.12135867016136,87.49488180622714,1.2169446801477677,-1.0173468855220733,-2.234291565669841,4770323070,4781951367.4,48.006210680959434,29.414609383441352,NaN,NaN,-5.56028432682425,-12.260012632068587
2021-12-31T09:30:00-05:00,222.49,224.12,222.39,222.45,23997427,37594877.45,50.80452231606929,45.34377537318556,NaN,NaN,67.67855118854771,87.29456846606624,1.1388766624593631,-0.810695737595637,-1.949572400055,4746325643,4776534498.8,46.64596571995202,30.894243376308484,NaN,NaN,-4.603357324825198,-11.166204731033817
2022-01-03T09:30:00-05:00,223.71,226.69,222.73,225.32,30618792,35904555.25,55.09290521892081,46.55646774068383,NaN,NaN,93.25811330274648,86.89388567154967,1.2311739194379097,-0.41060500075761297,-1.6417789201955226,4776944435,4772402057.6,45.58480094076016,32.329515279306534,NaN,NaN,-2.578370236176357,-9.939371231768465
2022-01-04T09:30:00-05:00,226,227.13,223.38,224.98,22013134,34811295.45,54.48694717724289,47.851734439592654,NaN,NaN,88.75511743348676,82.95562028849277,1.2177536600710956,-0.11958684510665307,-1.3373405051777487,4754931301,4768491043,44.5517983395655,33.84512614441213,NaN,NaN,-1.0347650964506225,-8.667284641008774
2022-01-05T09:30:00-05:00,224.87,225.91,217.32,217.36,40582077,34606439.55,43.056851087469006,47.95135532589096,NaN,NaN,4.648402502161682,68.49230861942078,0.6714071222094495,-0.4980816024159367,-1.1694887246253862,4714349224,4752574734.6,40.52683750051695,35.19370129841507,NaN,NaN,-2.955676096044358,-7.851340563156715
2022-01-06T09:30:00-05:00,217.82,220.42,215.82,218.6,39105870,34734414,45.07601171311563,48.50511708629444,NaN,NaN,-25.349719438228615,45.798092997742806,0.38356733457579084,-0.6900295564056478,-1.0735968909814386,4753455094,4749201139.4,39.707977799599874,36.61658079886432,NaN,NaN,-3.9454197894608525,-7.293351881200163
2022-01-07T09:30:00-05:00,218.6,220.38,215.925,216.07,31583886,34572095.7,41.81783626779568,48.6131310566652,NaN,NaN,-36.74648926953891,24.913084906125484,0.03137678704172542,-1.0343759071792817,-1.0657526942210072,4721871208,4744310252.4,38.49365194790317,37.96314791750729,NaN,NaN,-5.77412447116915,-7.0763193940528755
2022-01-10T09:30:00-05:00,214.77,215.385,211.11,215.32,45778073,35214770.95,40.874626677264274,48.8644486790209,NaN,NaN,-92.78990264306486,-12.29651828303678,-0.22916123209660988,-1.3522042343417695,-1.1230430022451596,4676093135,4724139992.4,33.89060557315814,39.01324469566243,NaN,NaN,-7.551742853835974,-7.144237031164747
2022-01-11T09:30:00-05:00,215.48,217.83,212.96,217.61,35209892,35301345.65,44.956955644031815,48.79639348784732,NaN,NaN,-52.11327193563908,-40.470196156861945,-0.2240673857509663,-1.4031272344338674,-1.1790598486829011,4711303027,4715414337.6,32.102214700354935,39.66078868902109,NaN,NaN,-7.916341775885188,-7.254537708981952
2022-01-12T09:30:00-05:00,218.52,219.38,214.64,215.99,35284512,35238397,42.71032737846914,48.38053549763665,NaN,NaN,-44.9402799996288,-50.387932657220034,-0.3017640307377145,-1.5562648871050442,-1.2545008563673297,4676018515,4707748195.8,30.575626222644928,40.028597549629545,NaN,NaN,-8.870844207833507,-7.485438637389318
2022-01-13T09:30:00-05:00,216.81,218.19,213.38,214.01,34489556,34399823.75,40.07438421917701,47.62226206366159,NaN,NaN,-71.43499969302725,-59.60498870817976,-0.4495657429631703,-1.8164580350712924,-1.3668922921081221,4641528959,4685362968.8,26.598148709908273,39.57039542975129,NaN,NaN,-10.452418553094546,-7.909292911061493
2022-01-14T09:30:00-05:00,211.99,214.4,210.58,214.31,42020871,33863677.6,40.671838638389225,46.72823942813586,NaN,NaN,-105.1887168399033,-73.29343422225264,-0.48703101841711915,-1.9756810651295211,-1.488650046712402,4683549830,4677698693.2,25.380754600043915,38.714624374737824,NaN,NaN,-11.593368844877853,-8.43558947303526
2022-01-18T09:30:00-05:00,212.2,212.44,207.53,207.83,49512155,33183546.25,33.01510713829879,45.41908653371949,NaN,NaN,-158.56757646925792,-86.44896898749127,-0.8849492797034761,-2.594836646341747,-1.709887366638271,4634037675,4669287601.2,24.07827448739468,37.36715861087687,NaN,NaN,-15.117942893061926,-9.390211390181927
2022-01-19T09:30:00-05:00,208.81,209.46,204.38,204.45,46209065,32994349.35,29.85768847155964,43.86180846721447,NaN,NaN,-194.6786558284976,-114.96204576606297,-1.2880812203394036,-3.3199888920625256,-2.031907671723122,4587828610,4644592717.8,20.7168086255911,35.48997684631096,NaN,NaN,-19.17716050630176,-10.788346978199046
2022-01-20T09:30:00-05:00,205.38,208.99,200.33,200.75,50465974,33590384.8,26.832513335432026,42.09489394880247,NaN,NaN,-195.88784457267124,-145.15155868067146,-1.6908340064822682,-4.145450179825957,-2.454616173343689,4537362636,4616861542,17.724400140976925,33.326990379169345,NaN,NaN,-23.670157713003917,-12.628605654599742
2022-01-21T09:30:00-05:00,199.76,203.02,196.99,196.99,85821001,36259334.3,24.15421988296113,40.19130091786618,NaN,NaN,-202.69489320919803,-171.40353738390561,-2.072211486475037,-5.044880531437485,-2.972669044962448,4451541635,4578864077.2,14.610325986941064,31.038730398239995,NaN,NaN,-28.401645843361223,-14.881897110137096
2022-01-24T09:30:00-05:00,194.07,202.39,191.23,201.53,85903216,39448225.55,32.867511391456034,38.60377278733298,NaN,NaN,-172.14944946346506,-184.79568390861795,-1.885789302154202,-5.329905672655201,-3.444116370500999,4537444851,4549643081.4,12.754467678683369,28.693706593805935,NaN,NaN,-29.50055548021968,-16.970276877291752
2022-01-25T09:30:00-05:00,198.48,201.7,194.56,198.84,61088549,41292820.25,30.622721411524395,36.8991852326388,NaN,NaN,-144.91689441092757,-182.0655474969519,-1.810357461425344,-5.707063197282679,-3.896705735857335,4476356302,4518106806.8,11.113711368689636,26.30527181017195,NaN,NaN,-31.14518344592163,-18.995263529953164
2022-01-26T09:30:00-05:00,201.78,203.55,193.72,195.97,71471745,43710394.15,28.394504398038634,35.85187475482235,NaN,NaN,-128.6540214348122,-168.86062061821482,-1.8158074881908446,-6.166465096095891,-4.350657607905046,4404884557,4481517996.2,9.574737613182947,24.094407532505233,NaN,NaN,-33.23638371133954,-21.029709270151216
2022-01-27T09:30:00-05:00,197.63,199.61,190.601,191.52,59829045,45729626.8,25.31832619167902,34.440611503291166,NaN,NaN,-135.61953297736454,-156.80695829915348,-1.9683603194170498,-6.811108007176358,-4.842747687759308,4345055512,4443056571.4,8.277206836504291,21.849352463712687,NaN,NaN,-36.0613992537201,-23.177093553518198
2022-01-28T09:30:00-05:00,191.7,195.31,188.09,195.25,65869951,47842739.55,31.97111944013824,33.737274587029916,NaN,NaN,-124.6505815214958,-141.19809596161306,-1.678602485775052,-6.941000794978123,-5.262398309203071,4410925463,4434933337,8.029704861316176,19.67335624324219,NaN,NaN,-36.16505834695235,-25.032517095437363
2022-01-31T09:30:00-05:00,194.39,201.24,193.85,201.24,53393759,49312556.15,41.052611860639416,33.749987814413856,NaN,NaN,-73.6957285753165,-121.50735178398334,-0.9787486859774788,-6.48583416667492,-5.507085480697441,4464319222,4420308211.2,7.589683427903523,17.794718947152578,NaN,NaN,-33.03715823301041,-26.176037257947797
2022-02-01T09:30:00-05:00,201.66,203.57,197.965,203.36,43429351,49953084.1,43.90670770410544,33.67497010441912,NaN,NaN,-46.7595146341446,-101.87587582862675,-0.30328576485017056,-5.886192686760154,-5.582906921909983,4507748573,4426586665.4,9.873004300556488,16.206918204309837,NaN,NaN,-29.585199777796,-26.66306047506897
2022-02-02T09:30:00-05:00,203.62,203.9,199.29,201.34,42777817,50991318.25,41.828556900405665,33.61198649884316,NaN,NaN,-41.911798747095624,-84.52743129108345,0.057966664982782135,-5.510448590681506,-5.568415255664288,4464970756,4438603905.2,14.240815060439402,15.040145978438014,NaN,NaN,-27.476989736905498,-26.77933608390276
2022-02-03T09:30:00-05:00,198.84,201.24,197.05,197.53,39629365,50943682.65,38.15986450229317,33.47523509049431,NaN,NaN,-60.208865133572765,-69.44529772232508,0.08897486083944539,-5.457196679614981,-5.546171540454426,4425341391,4454661081,19.83146121192607,14.55681115715357,NaN,NaN,-26.889228490378013,-26.79503499911351
2022-02-04T09:30:00-05:00,197.04,200.1,194.92,198.38,34291072,50702942.75,39.43610018794948,33.38696805832003,NaN,NaN,-62.0223299914985,-56.91964741632562,0.20855438955304884,-5.285478553513116,-5.4940329430661645,4459632463,4464402481,23.10643808439417,14.394359977464303,NaN,NaN,-26.025101844967992,-26.685044548521294
2022-02-07T09:30:00-05:00,198.43,201.16,197.99,199.36,33242576,50785877.25,40.94923564592352,33.953691523150376,NaN,NaN,-41.796028005491166,-50.539707302360554,0.3852011159548443,-5.01253154812261,-5.397732664077454,4492875039,4470113644.4,25.039842266821694,14.463043390280518,NaN,NaN,-24.87150699836181,-26.425967755641366
2022-02-08T09:30:00-05:00,199.47,203.12,199.36,202.76,28341923,49914069.75,45.99084172710812,35.106059612832404,NaN,NaN,-13.998018600418414,-43.98740809561532,0.7419171381767127,-4.470336241356563,-5.2122533795332755,4521216962,4472807322.2,25.98511576803014,14.83935104331188,NaN,NaN,-22.34037198932405,-25.842311217596034
2022-02-09T09:30:00-05:00,204.57,206.65,204.3,206.61,27329310,49520040.65,51.083720087487336,36.83828866655064,NaN,NaN,43.17450108912259,-26.970148128371655,1.2198244326521,-3.6874728387181506,-4.9072972713702505,4548546272,4489522425.4,31.73761474274538,15.840294943438197,NaN,NaN,-18.550964488060906,-24.800690256233874
2022-02-10T09:30:00-05:00,202.9,209.05,202.12,203.44,44788095,49995219.8,47.14198882975495,38.480272162750204,NaN,NaN,44.72083999519059,-5.984207102618983,1.2978591520029994,-3.2849733313665013,-4.582832483369501,4503758177,4505205782.6,36.70811574775329,17.418708497781928,NaN,NaN,-16.539499155551717,-23.620520098993566
2022-02-11T09:30:00-05:00,203.65,206.06,199.69,201.38,41516553,50346569.65,44.72672680459692,39.32735897797455,NaN,NaN,20.26989302875014,10.474237501430746,1.189050302450653,-3.0965196053061845,-4.285569907756837,4462241624,4505727614.8,36.87282257491463,19.14144813322702,NaN,NaN,-15.599908080759134,-22.47471838210293
2022-02-14T09:30:00-05:00,201.63,203.53,199.24,200.68,32262664,49858659.3,43.903590243944265,40.275992466004546,NaN,NaN,10.77655972802061,20.9887550481331,1.0529173999954313,-2.9694231577625487,-4.02234055775798,4429978960,4493148399,34.539438517341694,20.814714358130736,NaN,NaN,-15.074022944733626,-21.41747617676446
2022-02-15T09:30:00-05:00,202.78,206.305,202.63,206.06,25883738,48677238.45,51.31897082444,41.91345435360464,NaN,NaN,103.95835584445179,44.58002993710714,1.2924062065047295,-2.406832799627068,-3.6992390061317977,4455862698,4480077546.2,32.25533177616849,22.434756798343987,NaN,NaN,-12.293306309373794,-20.114023338565794
2022-02-16T09:30:00-05:00,205.3,207.27,204.08,206.49,30104755,47872022.95,51.86663641242779,43.80976222651527,NaN,NaN,126.02424705463814,61.14997913021025,1.4359299331485373,-1.904326589696126,-3.3402565228446632,4485967453,4467561782.4,30.196167185283784,24.000396823256807,NaN,NaN,-9.894618009470655,-18.654108291552202
2022-02-17T09:30:00-05:00,204.55,205.03,200.78,201.2,27140233,46705735.9,45.13877049759007,44.750308730618976,NaN,NaN,45.65259861466054,61.33633085410425,1.143471044159396,-1.9109177176454182,-3.0543887618048142,4458827220,4458575591,28.77573980409163,25.48225646202648,NaN,NaN,-9.81451692241166,-17.391309524532126
2022-02-18T09:30:00-05:00,201.03,202.72,198.76,199.47,36255429,44227457.3,43.16674007917841,44.901317889086044,NaN,NaN,-2.827351787737229,56.71688189080677,0.8176625576854222,-2.0323105646980366,-2.849973122383459,4422571791,4450641624.4,27.5437973672572,26.907550314837458,NaN,NaN,-10.350272261815787,-16.38544705842979
2022-02-22T09:30:00-05:00,198.48,200.45,195.35,196.66,31847129,41524652.95,40.10212344959797,44.62956187090695,NaN,NaN,-67.90671210642667,40.980227523917314,0.417243913542801,-2.3284182304549574,-2.7456621439977584,4390724662,4442790764.8,26.34201868093521,28.08390848486451,NaN,NaN,-11.744585514001168,-15.72246683779713
2022-02-23T09:30:00-05:00,198.24,198.9,192.55,192.98,31491521,40044801.55,36.45225292410249,44.24554015831386,NaN,NaN,-118.51261244415609,-3.5139661338042627,-0.06542067580129807,-2.827437988749381,-2.7620173129480827,4359233141,4423464853.4,23.61101211887457,28.75320827475274,NaN,NaN,-14.094517139627527,-15.489902595201473
2022-02-24T09:30:00-05:00,188.32,198.48,187.92,198.04,52221072,39082267.9,43.999512365435656,44.66265786282403,NaN,NaN,-109.41453964581407,-50.60172347389471,-0.01641786617030272,-2.782539645660961,-2.7661217794906583,4411454213,4408562205.4,21.73934628173751,28.889485779739267,NaN,NaN,-13.737557787194788,-15.239567622629089
2022-02-25T09:30:00-05:00,198.69,202.62,197,202.5,33656151,37773623.2,49.67310655972775,45.393872603665336,NaN,NaN,6.9902822282787165,-58.33418675117107,0.3250017821223632,-2.359869551837704,-2.6848713339600674,4445110364,4405818834.2,21.40299424724641,28.767811219943002,NaN,NaN,-11.559307529295337,-14.713816180724267
2022-02-28T09:30:00-05:00,200.47,204.6,200.46,203.32,34975853,36228918.3,50.66280881269709,46.08769925843488,NaN,NaN,49.85614196920185,-47.79748799978326,0.5987678166009966,-1.9364115632088215,-2.535179379809818,4480086217,4417321719.4,26.53552821955229,28.874645930852328,NaN,NaN,-9.521754312683559,-13.972093056718451
2022-03-01T09:30:00-05:00,202.66,203.79,197.8,199.49,40638906,35591175.65,46.10245925485162,46.095671938987984,NaN,NaN,-16.94587555586452,-37.605320689670826,0.5176617589805796,-1.8881021810840934,-2.405763940064673,4439447311,4427066249.2,30.666100657832928,29.20900199440967,NaN,NaN,-9.21176800949886,-13.292046621401367
2022-03-02T09:30:00-05:00,200.84,205.3,200.69,204.24,29978551,34918635.65,51.88678528661731,46.15303373892584,NaN,NaN,61.85144684547818,-1.5325088317439708,0.7647561623038652,-1.4498187371848417,-2.214574899488707,4469425862,4449104793.4,39.017255673582525,29.728976346612324,NaN,NaN,-7.062179091350441,-12.402065545679806
2022-03-03T09:30:00-05:00,205.09,205.11,200.29,201.82,30142659,34286877.75,49.00143181434109,46.285851094967704,NaN,NaN,33.611350469589084,27.07266919133666,0.7452914757599816,-1.2829605547887297,-2.0282520305487113,4439283203,4454670591.4,40.95161936722834,30.0320837480034,NaN,NaN,-6.212881994331897,-11.517896466915818
2022-03-04T09:30:00-05:00,199.7,200.86,196.98,198.66,31657741,33888296.55,45.44750328485322,46.33733512927172,NaN,NaN,-59.92918113922886,13.688776517835148,0.5108493455722716,-1.3896903485833718,-1.9005396941556434,4407625462,4447173611,39.15022401607049,30.194755279514535,NaN,NaN,-6.626073734775311,-10.819064648038603
2022-03-07T09:30:00-05:00,199.22,199.585,193.68,193.72,39279830,34137734.45,40.502096977380845,46.09437132451719,NaN,NaN,-133.8697452043675,-23.056400916878722,0.03919359178728721,-1.8515477044215345,-1.8907412962088217,4368345632,4424825494,34.30577453819848,30.17806499529002,NaN,NaN,-8.604745269056226,-10.502733308183977
2022-03-08T09:30:00-05:00,194.34,199.57,193.46,194.79,45715788,34761395.05,41.9749155167429,45.42693880253883,NaN,NaN,-114.08230764008799,-42.483687333723424,-0.17296326226886083,-2.106945374044898,-1.933982111776037,4414061420,4419748315.8,33.29770467735804,30.252520202517843,NaN,NaN,-9.733000362665416,-10.392771458824182
2022-03-09T09:30:00-05:00,198.22,201,197.62,200.28,29048016,34796699.7,48.95660296566914,45.2190792706275,NaN,NaN,-25.514260352751148,-59.95682877336928,0.07111867189374066,-1.845083771908861,-1.9162024438026017,4443109436,4414485030.6,32.24006321861145,30.39851277632696,NaN,NaN,-8.476236777256492,-10.118980790028798
2022-03-10T09:30:00-05:00,197.41,200.04,196.56,199.92,25660992,34713283.8,48.544129346564354,45.46231918841138,NaN,NaN,-37.9251074278747,-74.26412035286202,0.2148716342102701,-1.6476129010397642,-1.8624845352500343,4417448444,4410118078.8,31.35030478161272,30.582410274721326,NaN,NaN,-7.607286695972526,-9.76016734802076
2022-03-11T09:30:00-05:00,200.78,201.76,196.44,196.73,24990029,33723380.5,44.93161333464598,45.58838156380193,NaN,NaN,-44.4738701688997,-71.1730581587962,0.10711084832129347,-1.7285959748484174,-1.835706823169711,4392458415,4407084669.4,30.71617138572553,30.809008418897633,NaN,NaN,-7.9672080822603855,-9.504030310054992
2022-03-14T09:30:00-04:00,197.24,197.44,191.88,192.71,34969461,33396025.9,40.81006493966527,45.63894881309245,NaN,NaN,-133.79690162051347,-71.1584894420254,-0.20585767210759887,-2.0930289133042095,-1.8871712411966106,4357488954,4404913333.8,30.24457875916208,31.087762710199552,NaN,NaN,-9.565572133125281,-9.512821999065032
2022-03-15T09:30:00-04:00,193.46,195.79,192.88,195.78,25464343,33056109.85,44.9621554663256,46.246798994679814,NaN,NaN,-101.141296213147,-68.5702871566372,-0.1781036702721288,-2.1098008290367716,-1.9316971587646428,4382953297,4398691709.2,28.876515306678854,31.463870080757,NaN,NaN,-9.632295599763435,-9.529889656307661
2022-03-16T09:30:00-04:00,197.54,201.94,196.15,201.94,31869726,33355409.25,52.2067275551809,46.833028651090196,NaN,NaN,22.988857910265995,-58.86966350403378,0.2593562124767408,-1.6075018931687168,-1.8668581056454576,4414823023,4393034426.6,27.65170354823728,31.886181314078414,NaN,NaN,-7.319484007146469,-9.214117420713205
2022-03-17T09:30:00-04:00,200.77,205.21,200.3,205.11,25783098,33139326.4,55.45612301168102,47.24610125480114,NaN,NaN,117.66629267510251,-27.75138348343834,0.7392734940529366,-0.9427662380792867,-1.6820397321322234,4440606121,4397665962,30.259718386354407,32.51880446687184,NaN,NaN,-4.349514046873808,-8.519174081593292
2022-03-18T09:30:00-04:00,204.21,207.45,204,207.27,37092178,33636923.65,57.57282207887158,47.73967363095646,NaN,NaN,169.20018685829086,14.983427921999771,1.1545033994632252,-0.23891048280319183,-1.393413882266417,4477698299,4414713938.8,38.97922671186195,33.407640073465394,NaN,NaN,-1.2535089192632238,-7.481221915546139
2022-03-21T09:30:00-04:00,207.2,208.18,203.935,205.44,26747523,33161528.35,55.180399109168455,48.38809790626481,NaN,NaN,139.51923598675594,69.64665544345365,1.2501576475070935,0.16928317711744967,-1.0808744703896438,4450950776,4433406303.2,46.82903292935433,34.562135235716916,NaN,NaN,0.5644319944988497,-6.331842785539712
2022-03-22T09:30:00-04:00,206.31,208.79,205.8,207.5,24699895,32804166.65,57.329934353986964,48.776894268219785,NaN,NaN,148.14630587610705,119.50417586130447,1.385895061070538,0.6514943559485289,-0.7344007051220092,4475650671,4451945778,53.25234380708773,35.578927245253,NaN,NaN,2.7240044238570875,-5.038150327054455
2022-03-23T09:30:00-04:00,206.15,207.2,203.75,203.9,19774978,32218339.5,52.58371491224557,49.03277163235582,NaN,NaN,90.2181443031743,132.9500331398861,1.175273534337347,0.7346912127996745,-0.4405823215376724,4455875693,4460156312,55.799026723286886,36.63945634211432,NaN,NaN,3.1569061222138926,-3.867427977158977
2022-03-24T09:30:00-04:00,204.38,205.9,202.73,205.84,19781210,30596346.4,54.757405783540456,49.69776466797633,NaN,NaN,78.62713459727868,125.14220152432135,1.1094732338125797,0.9462592207280522,-0.16321401308452743,4475656903,4467166468.4,57.9074659726367,37.979259339011904,NaN,NaN,4.1610540128308,-2.720501978589009
2022-03-25T09:30:00-04:00,206.09,206.62,204.44,206.12,19430366,29885057.15,55.07749804671962,50.73886474435767,NaN,NaN,85.8332940381282,108.46882296028882,1.0294273968446874,1.123570232971332,0.09414283612664448,4495087269,4470644262.4,58.95354793505403,39.73981458164445,NaN,NaN,5.068073933036472,-1.607848276928226
2022-03-28T09:30:00-04:00,205.6,206.21,203.03,206.19,18999130,29086221,55.16290433400831,51.68086394559092,NaN,NaN,70.27808202506596,94.62059216795083,0.92890088598861,1.255268943612407,0.32636805762379695,4514086399,4483271387,62.58889953448407,41.83204278572488,NaN,NaN,5.837712729561588,-0.5441967045725384
2022-03-29T09:30:00-04:00,208,212.25,207.88,211.71,29550571,28531804.25,61.395754621196744,52.5693747781286,NaN,NaN,146.0540153591205,94.20213406455352,1.1664963661170296,1.784488515270084,0.6179921491530544,4543636970,4496868646.8,66.07341616313403,44.24871085319079,NaN,NaN,8.377226964314874,0.7302923909828061
2022-03-30T09:30:00-04:00,211.37,211.74,206.61,207.46,26251502,28345451.8,55.05055277593337,53.03411930879782,NaN,NaN,102.45861494759268,96.65022819343719,0.9774077553318641,1.8397518433178845,0.8623440879860205,4517385468,4509170601.8,68.8961124561338,46.930554258513716,NaN,NaN,8.713189385448311,1.870706247335021
2022-03-31T09:30:00-04:00,207.13,208.91,205.15,205.27,26771581,28176897.9,52.06455728103788,53.54361530496867,NaN,NaN,62.7627221395512,93.47734570189171,0.6600308375187609,1.6873826348844716,1.0273517973657107,4490613887,4512161998.6,69.5593401578597,49.70506631366616,NaN,NaN,8.099029258857527,2.7604666775525217
2022-04-01T09:30:00-04:00,206.18,207.72,205.01,207.57,25948508,27891436.25,54.83529277283393,54.54541729305215,NaN,NaN,62.02546637536,88.71578016933806,0.5639196834424296,1.7322514016687478,1.1683317182263182,4516562395,4516457023.8,70.5309469453767,52.58266404125292,NaN,NaN,8.395669260454305,3.5654956179670623
2022-04-04T09:30:00-04:00,207.87,208.43,205.88,207.91,20333898,26944139.65,55.247101229238844,55.28005627611737,NaN,NaN,67.23259029731298,88.10668182378747,0.4851640208485104,1.7747867442869563,1.2896227234384459,4536896293,4521019002.6,71.56895686083833,55.6321241522643,NaN,NaN,8.753411945630615,4.306626521918998
2022-04-05T09:30:00-04:00,207.96,209.435,202.51,202.99,26509793,25983839.9,48.373637073126034,55.00626409882774,NaN,NaN,23.117107233574508,63.51930019867827,0.08462824743177944,1.3954080327281702,1.3107797852963907,4510386500,4514368908.6,67.81883932903735,58.501205279464315,NaN,NaN,7.0074480257511675,4.692458165323594
2022-04-06T09:30:00-04:00,201.27,201.8,198.68,200.11,34903891,26276633.65,44.8556412882236,54.2490868328665,NaN,NaN,-64.74655432941525,30.078266343276688,-0.3666011691419393,0.8525283238689667,1.219129493010906,4475482609,4505988336.8,63.316215254251816,60.86238362717127,NaN,NaN,4.439161903513272,4.656272985064977
2022-04-07T09:30:00-04:00,200.11,201.23,196.68,199.46,29291244,26458146.25,44.07652995597074,53.28506596694501,NaN,NaN,-85.09561175415341,0.5065995645357646,-0.682801238975681,0.36562794429130463,1.0484291832669856,4446191365,4497103832.4,58.85509776938225,62.282088702708435,NaN,NaN,2.1147098718541035,4.293192540320566
2022-04-08T09:30:00-04:00,199.22,200.31,197.5,197.87,25249579,26471123.75,42.147993696497444,52.354179866039935,NaN,NaN,-96.12747137596241,-31.123987985728718,-0.9562241619179044,-0.1468510191303949,0.8093731427875095,4420941786,4477979710.6,50.59198939742678,62.550871307570745,NaN,NaN,-0.4070333089473432,3.6217317047108653
2022-04-11T09:30:00-04:00,197.12,199.2549,195.88,196.54,33702313,26407766.35,40.54973302904122,51.15559405711524,NaN,NaN,-131.40425877734523,-70.85135780066035,-1.1697298956071356,-0.6527892267214099,0.5169406688857257,4387239473,4448048346.6,40.91083047141788,61.66933464073719,NaN,NaN,-2.9925062448008815,2.67684056906633
2022-04-12T09:30:00-04:00,198.7,201.68,196.42,197.16,33699784,26819538.4,41.66033732969529,50.375352801218796,NaN,NaN,-119.74044580300226,-99.42286840797571,-1.207377877011392,-0.9922816773785144,0.21509619963287763,4420939257,4430158898,36.4244718613181,60.285437864882276,NaN,NaN,-4.860519725081284,1.600074812759528
2022-04-13T09:30:00-04:00,197.68,201.45,197.61,200.91,22303590,26341231.6,47.98916966547494,49.891907364214106,NaN,NaN,-86.58211335646263,-103.78998021338518,-0.9303269106602523,-0.9478124386924378,-0.017485528032185504,4443242847,4423710945.6,34.93732160974207,58.64471326753266,NaN,NaN,-4.769834418992784,0.6900877796520549
2022-04-14T09:30:00-04:00,201.11,202.37,198.87,198.96,27106953,26407424.35,45.24078309626741,49.18928486775324,NaN,NaN,-75.88994004848463,-101.94884587225144,-0.8321924905944316,-1.057726141275225,-0.22553365068079342,4416135894,4417699851.4,33.56163019285644,56.83100485737568,NaN,NaN,-5.473323673165735,-0.19039957075048652
2022-04-18T09:30:00-04:00,198.46,199.18,196.53,197.62,22246351,25665133,43.401314671896586,48.34917132045954,NaN,NaN,-104.12508679746144,-103.54836895655123,-0.8105183540599752,-1.2386815932557624,-0.42816323919578725,4393889543,4412289402.8,32.3277545668284,54.66949450254314,NaN,NaN,-6.586316145054029,-1.1041019385081356
2022-04-19T09:30:00-04:00,197.86,202.235,197.69,201.56,22786685,25467091.1,49.857082846867684,47.52498047943603,NaN,NaN,-49.014048619410985,-87.07032692496439,-0.49909963577590233,-1.0520377839156652,-0.5529381481397628,4416676228,4418176753.8,35.122817897811956,52.45873748359156,NaN,NaN,-5.687716352093676,-1.7589039975917842
2022-04-20T09:30:00-04:00,203.05,203.87,201.86,202.33,20516175,25257905.1,51.03259694474659,47.23798363435127,NaN,NaN,-5.8865123881461265,-64.29954024199317,-0.22356415601857127,-0.8323933431629769,-0.6088291871444056,4437192403,4421427383,36.67795325783303,50.15744039799865,NaN,NaN,-4.607629391640241,-2.165864768170135
2022-04-21T09:30:00-04:00,204.23,204.8,197.02,197.8,31547675,25846539.95,44.43301812885703,46.69287369490978,NaN,NaN,-53.505448654028754,-57.68420730150639,-0.32268769044531154,-1.012188800201045,-0.6895011097557335,4405644728,4413907759.2,34.61112092194598,47.66113902400481,NaN,NaN,-5.62218018081952,-2.659624112834333
2022-04-22T09:30:00-04:00,196.87,197.37,192.29,192.68,35686941,26641826.5,38.39012974303936,45.51821919278159,NaN,NaN,-140.30177515246095,-70.56657432230165,-0.6883609682757124,-1.549952320100374,-0.8615913518246616,4369957787,4404672137.8,32.21035222540148,44.923953686863726,NaN,NaN,-8.504802627612417,-3.4946496149454878
2022-04-25T09:30:00-04:00,190.99,194.11,189.21,193.85,35556426,27448129.5,40.38535665095488,44.456666008618456,NaN,NaN,-151.4502707279407,-80.03161110839748,-0.7989512445736486,-1.8602804075417225,-1.061329162968074,4405514213,4406997071.8,33.46157986861786,42.20199818741941,NaN,NaN,-10.2134772469444,-4.454482133802475
2022-04-26T09:30:00-04:00,192.32,192.71,187.48,187.74,40513592,28523852.6,34.163204443448635,43.44163510649863,NaN,NaN,-180.60746482463188,-106.35029434944167,-1.206634733359662,-2.5696225796676515,-1.3629878463079894,4365000621,4396661950.4,30.744916032139272,39.55386080906955,NaN,NaN,-13.867131306488423,-5.799146301329039
2022-04-27T09:30:00-04:00,187.67,189.78,186.26,186.96,37807971,28936722.6,33.45458920818089,42.627274243638446,NaN,NaN,-190.14141290904666,-143.20127445362178,-1.4362607371514726,-3.1583137677473303,-1.7220530305958577,4327192650,4374661999.8,25.92069771297345,36.88275241326396,NaN,NaN,-16.9795168302495,-7.3963420911748194
2022-04-28T09:30:00-04:00,189.17,191.4,184.71,190.45,37405185,29494406.75,39.50122707231779,42.30046689480609,NaN,NaN,-150.54003169969457,-162.60819106275494,-1.2664714310907934,-3.3051423194593497,-2.0386708883685563,4364597835,4366452621.2,24.38318958513736,34.420473257246464,NaN,NaN,-17.701815981192166,-8.868552646891583
2022-04-29T09:30:00-04:00,189.59,191.73,184.51,184.95,41193373,30215496.35,34.22354959648432,41.73443517337659,NaN,NaN,-150.4104905510538,-164.62993414247353,-1.426071235910741,-3.8212599332569823,-2.3951886973462413,4323404462,4357141956.2,22.736013066776934,32.43076066220005,NaN,NaN,-20.119176228882836,-10.475784587176047
2022-05-02T09:30:00-04:00,184.9,187.82,182.38,186.89,38002089,30818175.4,37.40061426685157,41.509498118934474,NaN,NaN,-142.26465943304459,-162.7928118834943,-1.3057055449937258,-4.027320628588399,-2.721615083594673,4361406551,4348320423.8,21.26991381141194,31.02783804362819,NaN,NaN,-21.02977539149937,-11.983497559222236
2022-05-03T09:30:00-04:00,186.92,189.5099,185.68,188.49,30246266,31313793.8,39.97566571295294,41.38916443202431,NaN,NaN,-99.11365853973903,-146.49405062651573,-1.03489471223837,-4.015233473892636,-2.9803387616542656,4391652817,4353650863,24.44051554629837,30.17184116398392,NaN,NaN,-20.955466561257886,-13.265207416655901
2022-05-04T09:30:00-04:00,189.05,193.93,185.6932,193.52,38834742,31930041.25,47.31320300331272,41.34088109901272,NaN,NaN,-51.387505077049966,-118.74326906011638,-0.46273080925074117,-3.558752273217692,-3.096021463966951,4430487559,4374309844.8,35.313424012095325,30.19870562129487,NaN,NaN,-18.465665506550774,-14.008130000926597
2022-05-05T09:30:00-04:00,191.53,191.56,183.38,185.67,41468705,32258281.95,39.249362463421214,40.91292248238085,NaN,NaN,-95.32330462210619,-107.6999236445987,-0.5525952701276862,-3.7867655516265586,-3.2341702814988724,4389018854,4379194048.6,37.599620353054476,30.487133489880442,NaN,NaN,-19.060810639810835,-14.729941520767202
2022-05-06T09:30:00-04:00,184.96,185.42,180.55,182.58,45457873,33066613.4,36.604701771799384,40.427450132373906,NaN,NaN,-128.90156926789112,-103.3981393879662,-0.7476638841498504,-4.168750136686185,-3.421086252536335,4343560981,4383225352.4,39.500215532406806,30.9994521302789,NaN,NaN,-20.45436131778782,-15.547715777484433
2022-05-09T09:30:00-04:00,179.86,182.6534,174.1,174.9,53682210,34488244.95,31.011641141803253,39.08134715344073,NaN,NaN,-170.4506994685295,-109.03534739506317,-1.2896656038319114,-5.033168257326224,-3.7435026534943128,4289878771,4368919796.4,35.38183356274732,31.017953249202854,NaN,NaN,-23.724358357456918,-16.71580757462336
2022-05-10T09:30:00-04:00,177.57,178.905,171.2,174.95,53650814,35485670,31.085468432400845,37.65655225970175,NaN,NaN,-168.11336862640403,-122.83528941239618,-1.5244556970751129,-5.649072274838204,-4.124616577763091,4343529585,4359295150,32.896729353912676,30.74786582749426,NaN,NaN,-26.15498407733471,-18.06426136072498
2022-05-11T09:30:00-04:00,175.13,178.19,170.3,170.6,64377822,37019571.9,28.252735945893832,36.50081781806152,NaN,NaN,-165.16098497409374,-145.58998539180493,-1.8317065877830263,-6.4142498124918745,-4.582543224708848,4279151763,4329027990.8,26.57531507177349,30.17387969533908,NaN,NaN,-29.144822199583114,-19.647198623419
2022-05-12T09:30:00-04:00,169.83,174.34,168.9,172.6,52967378,38552761.3,31.350244837532642,35.99796889623961,NaN,NaN,-157.0138866127212,-157.9281017899279,-1.7588509080721177,-6.781106859798996,-5.022255951726878,4332119141,4317648048.2,24.65685687844524,29.63434431341363,NaN,NaN,-30.5431538523473,-21.203763656123044
2022-05-13T09:30:00-04:00,175.04,179.41,175.01,178.07,36517011,39023264.2,39.094912758898815,35.905794332521324,NaN,NaN,-94.94316992810256,-151.13642192197022,-1.226114938583633,-6.55489962495642,-5.328784686372787,4368636152,4322663082.4,27.152636679988973,29.183705514225853,NaN,NaN,-29.167083048616725,-22.34138071219357
2022-05-16T09:30:00-04:00,177.5,179.44,176.135,177.22,28225461,39322219.7,38.370513983495506,36.206316442524674,NaN,NaN,-83.41314416048702,-133.7289108603617,-0.8335948840144045,-6.370778291390792,-5.5371834073763875,4340410691,4332769466.4,32.03840295678235,29.276097437414645,NaN,NaN,-28.306244945917776,-23.19350417415417
2022-05-17T09:30:00-04:00,180.41,182.84,178.99,182.64,31833733,39774572.1,45.32707803920513,37.054351359026406,NaN,NaN,-39.720901140441065,-108.05041736316912,-0.1474993148557262,-5.721557550946045,-5.574058236090319,4372244424,4338512434.2,34.71781082845955,29.904462659949363,NaN,NaN,-25.28211790287947,-23.49187756397207
2022-05-18T09:30:00-04:00,180.47,181.41,175.1,176.24,36093763,40553451.5,39.637525090743814,37.06408693177112,NaN,NaN,-69.42426754548744,-88.90307387744785,-0.06735116965989274,-5.658247198165185,-5.590896028505292,4336150661,4349912213.8,39.79208143012904,31.00509779173449,NaN,NaN,-24.548013181071262,-23.642754080700527
2022-05-19T09:30:00-04:00,174.89,178.81,174.89,176.53,33627736,40657454.55,40.005008824979576,37.47704830523507,NaN,NaN,-70.60355906056823,-71.62100836701727,0.05589304901830694,-5.521029717232409,-5.576922766250716,4369778397,4357444065,42.947407583052595,32.44876882861132,NaN,NaN,-23.861676682455556,-23.6740287380941
2022-05-20T09:30:00-04:00,178.5,178.97,171.79,176.08,42243686,40985291.8,39.60211678926488,37.634298485407456,NaN,NaN,-75.41473054485985,-67.71532049036873,0.15233592326122647,-5.386502862174183,-5.538838785435409,4327534711,4349223776.8,40.455466052458,33.81916541725747,NaN,NaN,-23.432111613913868,-23.639469148925496
2022-05-23T09:30:00-04:00,177.88,178.96,175.5,178.21,24644132,40439677.1,42.551329309139334,37.81827445656363,NaN,NaN,-47.37446083556897,-60.50758382538511,0.3912269074744188,-5.049805151092386,-5.441032058566805,4352178843,4351577407.2,41.50205799312523,35.03784702060225,NaN,NaN,-22.206617269853385,-23.434776023343765
2022-05-24T09:30:00-04:00,176.57,176.93,172.33,175.57,26861782,39757086.6,39.947666310920226,37.29216469282131,NaN,NaN,-72.45425891161443,-67.05425537961978,0.4015766055279526,-4.939061301656864,-5.340637907184816,4325317061,4342191934.6,38.58929658066224,35.27183791835702,NaN,NaN,-21.914302257733205,-23.2175654853994
2022-05-25T09:30:00-04:00,174.88,179.78,174.81,178.73,27950056,39264190.85,44.338007074514344,37.65563930789939,NaN,NaN,-32.513267244089825,-59.67205531934027,0.6373656805509107,-4.543930806496178,-5.181296487047089,4353267117,4345615225.8,40.23685603963588,35.46021189596998,NaN,NaN,-20.36742301505932,-22.810402275350818
2022-05-26T09:30:00-04:00,179.85,183.795,179.7,182.72,25702704,38679066.8,49.37112509039645,38.56752668779918,NaN,NaN,31.846009416895658,-39.182141623847485,1.0536113122929667,-3.8642823466808807,-4.917893658973847,4378969821,4347453510.6,41.14991278985248,35.578047414358956,NaN,NaN,-17.489729519798132,-22.05030616741472
2022-05-27T09:30:00-04:00,183.76,187.65,183.4,187.64,24952062,37867001.25,54.79870392426459,40.26660260083214,NaN,NaN,93.76005452806116,-5.3471846092632855,1.6180923679789272,-2.895278199000188,-4.513370566979115,4403921883,4362730945,48.22894179854204,36.49569800263001,NaN,NaN,-13.244401240330564,-20.792319749259843
2022-05-31T09:30:00-04:00,186.91,187.6765,184.09,185.31,29794499,37456621.75,51.9579390988073,41.757493362718314,NaN,NaN,85.88484611275989,21.30467678040248,1.7795274634046754,-2.288961237723271,-4.068488701127946,4374127384,4367120653.2,50.086797274026864,37.72355999692388,NaN,NaN,-10.583271454102507,-19.33388427852308
2022-06-01T09:30:00-04:00,186.27,186.94,181.77,184.26,28352136,37361915.25,50.68283982789836,43.35964364000436,NaN,NaN,71.81833793735348,50.15919615019605,1.7575091714121633,-1.871602236862742,-3.6291114082749054,4345775248,4371212290.6,51.822268442564216,39.52691380912322,NaN,NaN,-8.782499721268223,-17.82654362748667
2022-06-02T09:30:00-04:00,184.59,188.76,184.17,188.76,24875960,36663976.15,55.700474663212475,45.09894577041006,NaN,NaN,126.1367573203053,81.88920106307508,1.9718424007971946,-1.164308407278412,-3.1361508080756066,4370651208,4374689108.8,53.30791254019219,41.57341778496228,NaN,NaN,-5.66007478169769,-16.088476649516817
2022-06-03T09:30:00-04:00,187.29,187.96,185.79,187.06,18972140,35539147.9,53.48653125359509,46.12691852003122,NaN,NaN,121.20018512998102,99.76003620569216,1.922916739474915,-0.7325048837319628,-2.6554216232068777,4351679068,4369230958.2,50.666492374295295,43.252978905984165,NaN,NaN,-3.7242251229458754,-14.322155002863825
2022-06-06T09:30:00-04:00,189.29,189.305,186.83,187.87,24678747,34500191.6,54.416222438524954,47.273040552533324,NaN,NaN,124.90456916571436,105.98893913322279,1.8673498896088638,-0.3212342611957979,-2.1885841508046617,4376357815,4363718144.6,48.07540962363737,44.39847938218809,NaN,NaN,-1.8666910567615043,-12.542803010563494
2022-06-07T09:30:00-04:00,186.41,190.94,185.9,190.9,21661588,32899160.5,57.81309998616082,48.164899263030165,NaN,NaN,123.16128386088737,113.44422668284828,1.9479525230653878,0.2463565030270729,-1.701596020038315,4398019403,4368496548.4,50.441195774125106,45.521578306878496,NaN,NaN,0.7350597320555289,-10.645965475903633
2022-06-08T09:30:00-04:00,189.96,190.7,187.06,187.95,21521727,31292706.15,53.623354621071826,49.163887086625024,NaN,NaN,101.38153086684183,119.35686526874596,1.7236088199319444,0.4529150048766155,-1.2706938150553289,4376497676,4374641034,53.382492390455354,46.49232194690181,NaN,NaN,1.7718133603201858,-8.871997070728803
2022-06-09T09:30:00-04:00,186.55,187.07,183.53,183.57,21697229,29158676.5,48.05488686781028,49.73887837539864,NaN,NaN,44.333074648991094,102.99612873448311,1.2247034160346895,0.2601854549880329,-0.9645179610466565,4354800447,4371470881.8,51.678349887676454,47.115960682946366,NaN,NaN,1.0007604271986854,-7.4616031424534475
2022-06-10T09:30:00-04:00,180.51,181.55,177.65,178.59,37153558,28367985.5,42.63391824873303,49.95543562250351,NaN,NaN,-41.25891414630475,70.50430887922596,0.5387795578093831,-0.29104351378492765,-0.8298230715943108,4317646889,4364664446,48.12603491936911,47.663858459154305,NaN,NaN,-1.4067909655153186,-6.596629974319429
2022-06-13T09:30:00-04:00,173.63,174.96,169.29,170.2,39712710,28527770.45,35.39050316993382,49.44394804113169,NaN,NaN,-145.8473974195599,16.35391556217113,-0.4472528035699791,-1.3888890760567847,-0.9416362724868056,4277934179,4344979718.8,39.639581691120114,47.53082443758251,NaN,NaN,-6.15304940058805,-6.533261320929232
2022-06-14T09:30:00-04:00,170.67,171.24,167.74,169.38,30282434,28630619.1,34.76875595107292,49.07402587257116,NaN,NaN,-154.75106140509843,-39.228553491026034,-1.0855788202247012,-2.298609797767682,-1.2130309775429808,4247651745,4314906187.2,30.725369484765338,46.969115359304155,NaN,NaN,-10.057219962935012,-7.036683984072915
2022-06-15T09:30:00-04:00,171.21,174.06,168.66,171.86,32150529,28646458.9,38.29928525644511,48.64268859985193,NaN,NaN,-110.6848128493642,-81.64182223426724,-1.2594345873009876,-2.7873242116692154,-1.5278896243682278,4279802274,4295567106.8,26.585102761394907,45.99399012514409,NaN,NaN,-12.161406279159918,-7.768787169085344
2022-06-16T09:30:00-04:00,167.84,168.42,162.78,163.9,43810559,29032298.7,32.26340717438589,47.42070874870832,NaN,NaN,-162.70884081747664,-123.0502053275608,-1.796441497706849,-3.773441496501789,-1.97699999879494,4235991715,4271805360.4,22.562197356652902,44.66629616562983,NaN,NaN,-16.14661664077407,-8.965619950755162
2022-06-17T09:30:00-04:00,164.48,167.52,163.7,165.18,40327271,29367275.45,34.062944762835315,45.939583094320525,NaN,NaN,-139.2538108127158,-142.649184660843,-1.9391440525084,-4.40093006443044,-2.4617860119220403,4276318986,4263539779.8,21.351832452979437,42.74650264094679,NaN,NaN,-18.711166410927678,-10.357840873636949
2022-06-21T09:30:00-04:00,167.98,170.08,166.81,168.14,34665447,28988363.5,38.15470930739837,44.95363810921988,NaN,NaN,-101.64848859302009,-133.80940289553504,-1.715590195676603,-4.606273756517794,-2.890683560841191,4310984433,4270149830.6,24.824990415763423,40.94208786535654,NaN,NaN,-19.540685958584227,-11.669675885772275
2022-06-22T09:30:00-04:00,165.96,169.255,165.37,167.82,29303486,29221331.2,37.88102758815531,44.03922294923824,NaN,NaN,-97.41590503622037,-122.34237162175944,-1.4796047384169402,-4.740189483862366,-3.260584745445426,4281680947,4276955671,28.334201700265297,39.26436881233519,NaN,NaN,-20.282512657896486,-12.900081138932876
2022-06-23T09:30:00-04:00,168.19,170.23,166.55,169.83,27089785,29232731.35,40.75561549788964,42.97173300885803,NaN,NaN,-79.25804470476136,-116.05701799283887,-1.096130667278989,-4.630748079544162,-3.534617412265173,4308770732,4282749362.6,31.27528463783962,37.690609676452866,NaN,NaN,-20.062137299736285,-13.92323201904765
2022-06-24T09:30:00-04:00,171.22,175.1,170.9,175.09,37138454,29692151.25,47.59056318160667,42.550592432287424,NaN,NaN,-36.341495945937915,-90.78354901853112,-0.43041022383871796,-4.072630192063571,-3.6422199682248526,4345909186,4304732856.8,41.1450018963446,37.0105032137421,NaN,NaN,-17.756785735374066,-14.470882549951423
2022-06-27T09:30:00-04:00,175.67,176.99,174.18,175.74,24745414,29644286.75,48.383051060959545,42.11965161960418,NaN,NaN,-18.165258083654727,-66.5658384727189,0.08410017380745272,-3.5370947509655366,-3.6211949247729893,4370654600,4323599979.6,48.0416876007321,37.008094497820295,NaN,NaN,-15.656481249675815,-14.640253792769194
2022-06-28T09:30:00-04:00,176.93,178.15,172.35,172.44,25958302,29694598.75,44.68848030344042,41.18217878512415,NaN,NaN,-25.030206146015047,-51.24218198331787,0.22459210555495845,-3.3404547928292914,-3.56504689838425,4344696298,4330342352.6,50.283747701096374,36.99684820688966,NaN,NaN,-14.921938190333464,-14.68049442099266
2022-06-29T09:30:00-04:00,172.55,172.7,168.97,170.69,21292488,29269498.2,42.82108115191981,40.410587823041865,NaN,NaN,-50.193867172167494,-41.7977744105073,0.22169717768335628,-3.2879254262800544,-3.5096226039634106,4323403810,4338686925.2,52.987586329303014,36.96864063109307,NaN,NaN,-14.845941676463967,-14.704129743202847
2022-06-30T09:30:00-04:00,168.2,171.31,166.76,169.36,31466339,29425208.35,41.404985833296756,39.93559489200518,NaN,NaN,-59.89644622264168,-37.925454714083365,0.15538002706100773,-3.3153975701371508,-3.4707775971981585,4291937471,4335320273,51.764400578941185,36.974787109040555,NaN,NaN,-15.1820485680734,-14.772403861041496
2022-07-01T09:30:00-04:00,169.05,171.84,167.66,171.41,24598625,29411341.6,44.45410056241778,40.065607914411224,NaN,NaN,-45.21569146632442,-39.70029381816067,0.2681370717225553,-3.135606257544964,-3.4037433292675194,4316536096,4329445655,49.612247115573474,37.08094512305515,NaN,NaN,-14.61378822374935,-14.749744484285475
2022-07-05T09:30:00-04:00,168.68,172.9,166.73,172.83,25151145,29720291.85,46.5297061897289,40.86126527296802,NaN,NaN,-35.937524192572894,-43.254747039944306,0.4464071753108607,-2.8457343601289438,-3.2921415354398045,4341687241,4323652183.2,47.51422692414422,37.643419782556876,NaN,NaN,-13.556933595037796,-14.579342928678663
2022-07-06T09:30:00-04:00,172.45,173.71,169.75,171.55,25697551,29771232.05,44.90095508425259,41.58499378248086,NaN,NaN,-20.627321156654656,-42.37417004207223,0.4830692370690435,-2.6883049891035,-3.1713742261725435,4315989690,4317910861.6,45.46244493174328,38.69606802876958,NaN,NaN,-13.097467678359298,-14.367646464347326
2022-07-07T09:30:00-04:00,172.86,175.98,172.85,175.61,24822531,29929279.2,50.78556481795109,42.476870894017,NaN,NaN,34.759625844342125,-25.383471438770307,0.7687375480333554,-2.2104522911308493,-2.9791898391642047,4340812221,4321392543.8,46.958291290367164,40.15129578083903,NaN,NaN,-10.99350139248909,-13.885625739796149
2022-07-08T09:30:00-04:00,175.07,176.99,173.65,175.59,20546955,29880540.6,50.75680696002574,43.7978280215627,NaN,NaN,67.64826512021307,0.1254708298006449,0.9333747702944932,-1.812471376296088,-2.7458461465905812,4320265266,4327058102.8,49.39082519881253,42.06762634099329,NaN,NaN,-9.276827989157503,-13.227226061133486
2022-07-11T09:30:00-04:00,174.26,174.97,171.6,172.06,22031451,29897251.7,45.824568921962324,44.63794403292891,NaN,NaN,37.755483486390624,16.719705820343655,0.7873941457734768,-1.761603464373735,-2.548997610147212,4298233815,4323397646.6,47.863529090738055,43.961318957976054,NaN,NaN,-9.117849347637184,-12.640172244919729
2022-07-12T09:30:00-04:00,171.54,173.36,170.56,171.47,23864192,29232783.4,45.03683493019156,45.12952443455699,NaN,NaN,23.860461310039913,28.679302920866224,0.6402061192082789,-1.748739961136863,-2.388946080345142,4274369623,4309934123,42.64066058690034,45.23386682734297,NaN,NaN,-9.201122246553101,-12.14887938801021
2022-07-13T09:30:00-04:00,169.15,172.275,168.79,171.32,25535614,28523928.6,44.82585859422723,45.62558379213356,NaN,NaN,-3.309702716935883,32.142826608809976,0.5265977688360004,-1.7306988693001415,-2.257296638136142,4248834009,4296502986.8,38.16637234992106,45.93616473088981,NaN,NaN,-9.326007723798039,-11.745612007408472
2022-07-14T09:30:00-04:00,168.68,170,167.02,169.56,25102172,28264915.5,42.32075667327083,45.73737959037508,NaN,NaN,-56.64213403547102,13.862474632847347,0.33604538482903923,-1.8372399070998426,-2.173285291928882,4223731837,4273086910,31.884782731884144,45.979700309035856,NaN,NaN,-10.100794120144915,-11.510638023513678
2022-07-15T09:30:00-04:00,171.54,173.345,169.31,173.09,34935913,28404184.7,48.53330505651826,45.8047182957259,NaN,NaN,28.1339538025662,5.959612369317973,0.44408456822442677,-1.6181795816483486,-2.0622641498727754,4258667750,4260767406.8,29.165113475524507,45.12399399326299,NaN,NaN,-9.079508745814111,-11.16333384098517
2022-07-18T09:30:00-04:00,175.13,176.2893,172.06,172.6,23031546,27365234.05,47.764246830862334,45.7605179935761,NaN,NaN,68.80307907827961,12.16913148769577,0.4760524017607515,-1.467198647671836,-1.9432510494325874,4235636204,4248247884.6,26.67501487857362,43.597803084537375,NaN,NaN,-8.43330877174986,-10.773330259665839
2022-07-19T09:30:00-04:00,174.75,178.89,174.66,178.69,24234559,26560598.45,56.904481752607325,46.63308952565945,NaN,NaN,163.40751283084066,40.078541791855926,0.8774995884951617,-0.8463765638136351,-1.7238761523087969,4259870763,4245348112.6,26.118769561689035,41.87173321743686,NaN,NaN,-5.013131607600317,-9.950444737942192
2022-07-20T09:30:00-04:00,178.65,181.81,178.4,181.49,26049312,26129791.7,60.34054872580157,47.884480066651,NaN,NaN,209.75565697937233,82.69161373111756,1.2775246378987215,-0.12697035493539488,-1.4044949928341164,4285920075,4252765325.8,30.132065587628375,40.23919602160295,NaN,NaN,-1.0072879249094475,-8.672850907508943
2022-07-21T09:30:00-04:00,180.45,182.5,178.845,182.42,21709855,25750110.15,61.440246539266504,49.315570117077414,NaN,NaN,193.2304764016617,132.6661358185441,1.5334375766694162,0.5123019780026539,-1.0211355986667623,4307629930,4269544944.4,38.29777475906226,39.277294177325885,NaN,NaN,2.6042405784745397,-7.061837838082731
2022-07-22T09:30:00-04:00,182.88,183.25,178.05,179.51,25116096,25651425.7,56.18999204989695,50.15384808046878,NaN,NaN,147.31419453231948,156.50218396449478,1.4370536138049508,0.7751814185894261,-0.6618721952155247,4282513834,4274314161.2,40.428863588405854,38.621338211099626,NaN,NaN,4.169623527290534,-5.457343357315121
2022-07-25T09:30:00-04:00,180.05,180.92,178.43,180.44,19267156,24757860.8,57.44165326972606,50.933272871897145,NaN,NaN,118.9668488061179,166.5349379100624,1.3666938779089166,1.0464951521706212,-0.32019872573829544,4301780990,4287543118.4,46.00016190094346,38.51319070944243,NaN,NaN,5.825852930835366,-3.845458173293623
2022-07-26T09:30:00-04:00,179.78,180.21,178.54,179.33,19391214,24490150.8,55.40694394689154,51.68370064779993,NaN,NaN,97.39031087028665,153.33149751795162,1.1830309909337315,1.1585900129288689,-0.024440978004862557,4282389776,4292046921,47.790394093495564,38.67947279242474,NaN,NaN,6.6341865626072165,-2.348366068164932
2022-07-27T09:30:00-04:00,180.48,184.25,180,183.41,21670690,24275770.2,60.890691445074914,52.405495406880206,NaN,NaN,133.44432246055436,138.06923061418803,1.2664971042154785,1.5586804022644856,0.2921832980490071,4304060466,4295674999.2,49.24999776089013,38.8431661117478,NaN,NaN,9.025169730063416,-0.7235752398465967
2022-07-28T09:30:00-04:00,184.32,186.14,181.76,185.93,22838529,24353072.25,63.847817227858805,53.34056756886828,NaN,NaN,143.57252413059626,128.13764015997495,1.4105769094880232,2.055404434909036,0.644827525421013,4326898995,4299528812.2,50.82270487066807,38.94544323116606,NaN,NaN,11.978418729321227,1.090995327177378
2022-07-29T09:30:00-04:00,186.04,187.73,185.04,187.25,21760641,23867787.35,65.32672992068342,54.733579068776926,NaN,NaN,150.2197289945412,128.71874705241927,1.505299114456791,2.5264514184920017,1.0211523040352106,4348659636,4312757972.6,55.87744429835847,39.51786574599608,NaN,NaN,14.872766800520962,3.0598198233693186
2022-08-01T09:30:00-04:00,185.79,188.32,184.22,187.18,23905554,23833133.8,65.17446695222262,56.17198135606486,NaN,NaN,130.88892163225995,131.1031616176477,1.4719820033861661,2.8611298082679184,1.3891478048817523,4324754082,4317352591,57.510922290433186,40.58002729624843,NaN,NaN,17.17891130972179,5.076832892848243
2022-08-02T09:30:00-04:00,186.47,189.02,185.48,187,17492574,23450205.25,64.75649622761142,57.59559832987803,NaN,NaN,123.74892671428331,136.374884786447,1.3497839798150433,3.0763777796505565,1.7265937998355132,4307261508,4322326937.4,59.2690422746044,42.087360862297245,NaN,NaN,18.976287497410922,7.062469264928626
2022-08-03T09:30:00-04:00,188.3,190.15,187.64,189.75,19157749,23123215.15,68.1202777269782,59.4384212622857,NaN,NaN,134.52921529190846,136.59186335271784,1.3621922687788124,3.429334135809029,2.0671418670302164,4326419257,4326798695.6,60.83783257826484,44.155435851324434,NaN,NaN,21.54341420589698,9.131175685066962
2022-08-04T09:30:00-04:00,189.84,190.04,188.44,189.35,14838914,22624034.3,67.1168360023211,60.76581632984304,NaN,NaN,121.78508650162699,132.23437582692398,1.2541883709212693,3.634877330681803,2.380688959760534,4311580343,4323734965.2,59.15670313680288,46.29769225570146,NaN,NaN,23.413353624515207,11.171486819273854
2022-08-05T09:30:00-04:00,187.47,191.02,187.1703,190.8,18540323,22523702.7,68.9049675071953,62.27586780672396,NaN,NaN,113.69619756832756,124.92966954168124,1.1915783189986309,3.8701618585088227,2.678583539510192,4330120666,4320027171.2,57.10026669157937,48.47092452805901,NaN,NaN,25.526906347066646,13.222261037529966
2022-08-08T09:30:00-04:00,192.15,194.625,191.89,192.82,22234911,22533875.7,71.25041386313728,63.30057724319038,NaN,NaN,137.14231845496425,126.18034890622212,1.1943625930185995,4.171536780783441,2.9771741877648417,4352355577,4325547470.2,59.36512948488471,50.84566452257298,NaN,NaN,28.050133089942648,15.34052847358892
2022-08-09T09:30:00-04:00,192.04,192.17,189.16,190.19,18247296,22253030.9,64.43566484474404,63.59308553740056,NaN,NaN,96.44578458383327,120.71972048013211,0.9385144766995297,4.150317283639254,3.211802806939724,4334108281,4330916824.8,61.49451395829795,53.08583940619224,NaN,NaN,28.33745484498978,17.1972322409319
2022-08-10T09:30:00-04:00,193.63,195.95,193.11,195.62,20796377,22016069.05,70.67252388538395,64.25253391926609,NaN,NaN,132.5707568426865,120.32802879028773,1.046203875720396,4.519557651590219,3.473353775869823,4354904658,4336613905,63.66990183755552,54.89813419751319,NaN,NaN,30.596513773805924,19.11141531705676
2022-08-11T09:30:00-04:00,197.42,199.53,196.04,196.35,23727554,21947338.15,71.39870450323656,65.33887052307605,NaN,NaN,147.869316111545,125.54487471227132,1.0737787600182758,4.8155772258926675,3.7417984658743917,4378632212,4350024278.8,68.2211040640126,56.88329423148508,NaN,NaN,32.636392514853206,21.043554916741968
2022-08-12T09:30:00-04:00,197.35,200.43,196.58,200.36,21726589,21286871.95,75.05293265266148,66.59681905042859,NaN,NaN,155.0056984459741,133.80677488780063,1.2565684758883586,5.31250906073484,4.055940584846481,4400358801,4364071905.8,72.15603733238255,58.751571048016444,NaN,NaN,35.63562090805472,23.128135772643788
2022-08-15T09:30:00-04:00,198.795,201.155,198.22,201.07,17414800,21006034.65,75.64623320988512,68.04248256921385,NaN,NaN,151.09873784783218,136.5980587663742,1.3135994378928109,5.697939882212495,4.384340444319684,4417773601,4377155510.6,75.23211075564758,60.71169366674159,NaN,NaN,38.2239742462499,25.28468412601609
2022-08-16T09:30:00-04:00,200.5,201.99,199.025,200.99,18833104,20735961.9,75.42855879378027,69.08090166554994,NaN,NaN,139.53456938052108,145.21581572571176,1.2354076788099793,5.928600042832159,4.693192364022179,4398940497,4390121953.8,77.84443247746309,62.754153289353944,NaN,NaN,40.236400374889215,27.42064359014082
2022-08-17T09:30:00-04:00,198.72,199.33,196.38,197.61,22427990,20554895.8,66.69618227918978,69.28435631207358,NaN,NaN,95.60563011101719,137.82279037937792,0.8631458444703997,5.772124669610179,4.908978825139779,4376512507,4394443523.6,78.65257599609406,64.74200122688437,NaN,NaN,39.36378517201998,29.126806673266415
2022-08-18T09:30:00-04:00,197.88,199.25,196.9,198.92,18368053,20387805.7,68.23127869166665,69.49182408142953,NaN,NaN,90.89253365086452,126.42743388724182,0.6234187238623843,5.688252229967759,5.064833506105375,4394880560,4397693193.2,79.26505452947721,66.41254481482143,NaN,NaN,39.08698966149345,30.54968995729885
2022-08-19T09:30:00-04:00,196.83,197.11,194.0707,194.65,27416393,20502820.55,58.7288542161767,69.03142317171195,NaN,NaN,49.03025510008788,105.23234521806458,0.12180522451089804,5.217090036743997,5.095284812233099,4367464167,4391114266.4,74.59870552772136,67.633100760342,NaN,NaN,35.75924123163045,31.29391156791765
2022-08-22T09:30:00-04:00,191.99,192.35,190.01,190.64,22937015,20686313.5,51.478225522057144,68.08297526417236,NaN,NaN,-8.523393886262792,73.30791887124556,-0.5013432010944339,4.468605810865057,4.969949011959491,4344527152,4376464976.6,65.37038451129504,68.06891092010562,NaN,NaN,30.378685906290404,31.163165044828045
2022-08-23T09:30:00-04:00,190.94,192.93,190.39,190.95,20069836,20720244.6,51.971878479113116,66.92951817503915,NaN,NaN,-12.113660399286006,42.97827291528415,-0.8911659235198091,3.85599160755973,4.747157531079539,4364596988,4369596274.8,61.52711593339294,68.11814544547191,NaN,NaN,26.309199237880353,30.469741358121233
2022-08-24T09:30:00-04:00,190.79,193.3,190.16,192.41,16038273,20438623.75,54.32858436491324,66.01607162951002,NaN,NaN,-12.33121409583888,21.39090407391293,-1.0388880034066137,3.4485475268212724,4.487435530227886,4380635261,4370420825.6,61.817326663793295,68.30818998311409,NaN,NaN,23.647731929478187,29.495168582600797
2022-08-25T09:30:00-04:00,193.38,195.45,192.98,195.4,14794953,20036444.95,58.78854244150168,65.29346983910332,NaN,NaN,23.485656886426643,7.909528721025369,-0.9271133937460734,3.3285437880452946,4.255657181791368,4395430214,4370530756.4,61.85863537105487,68.64807346021948,NaN,NaN,22.71741838323396,28.52691855411982
2022-08-26T09:30:00-04:00,195.34,195.44,188.66,188.98,24177218,20157273.8,47.95910501584082,63.6298049214393,NaN,NaN,-43.59780941424932,-10.616084181842066,-1.2569618336648238,2.684454889710338,3.941416723375162,4371252996,4371288522.2,62.16251239139864,68.84788652497049,NaN,NaN,18.056566605946383,27.031153990095042
2022-08-29T09:30:00-04:00,186.95,188.99,186.52,187.24,19753269,19949659.55,45.51207795720846,62.27812014375819,NaN,NaN,-107.72046836305255,-30.455499077200017,-1.5447883081876106,2.0104313381406484,3.555219646328259,4351499727,4372683037.2,62.75066900135161,68.9376118851886,NaN,NaN,13.504888623854331,25.09883036634637
2022-08-30T09:30:00-04:00,187.82,188.01,183.535,184.62,22548933,20202477.5,42.03425268687339,60.23252934386458,NaN,NaN,-142.92539041195334,-56.61784507973348,-1.8438265486223866,1.2504364605502758,3.0942630091726624,4328950794,4365553798.4,57.80378609152202,68.51860361761479,NaN,NaN,8.571810748458626,22.73782756379098
2022-08-31T09:30:00-04:00,184.94,185.74,183.19,183.5,22412480,20365214.05,40.605785003450215,58.03303509387984,NaN,NaN,-151.44349077007203,-84.44030041458011,-2.0342870786234,0.5514041608934122,2.5856912395168123,4306538314,4350734409,49.13300149341202,67.15516771971474,NaN,NaN,4.162835854612539,20.08425731962263
2022-09-01T09:30:00-04:00,181.78,181.89,178.9,181.5,30706643,21158600.5,38.11487387777418,55.394602324245035,NaN,NaN,-181.79216247774033,-125.49586428741353,-2.1982319399339474,-0.1620986854006219,2.0361332545333255,4275831671,4326814700.4,38.97147017589394,64.78484149425127,NaN,NaN,-0.29397127325221933,17.173081806354794
2022-09-02T09:30:00-04:00,183.6,183.95,179.14,180.09,27468200,21604994.35,36.41870675206073,52.59263614868615,NaN,NaN,-155.51923181747705,-147.88014876805906,-2.2943003963671345,-0.8317422409255926,1.4625581554415419,4248363471,4302236795.4,31.713656125136268,61.67638044921474,NaN,NaN,-4.490197791840514,14.07832757804118
2022-09-06T09:30:00-04:00,180.71,181.08,177.5,178.31,23837119,21685104.75,34.341052265384505,49.65781425380073,NaN,NaN,-155.62310510829016,-157.4606761171066,-2.361172530895783,-1.4889075081781868,0.8722650227175961,4224526352,4276842120.4,26.269886633083715,57.99248431747336,NaN,NaN,-8.648682035891664,10.831611918907916
2022-09-07T09:30:00-04:00,177.97,182.465,177.93,182.19,24781164,22011798.15,42.09560480726566,47.900630148663296,NaN,NaN,-115.3693252855058,-151.94946309181708,-2.0396498616664847,-1.67729730436551,0.3623525573009748,4249307516,4260913464.8,23.5403581690058,54.0558973298242,NaN,NaN,-9.908025344128465,7.868806595617005
2022-09-08T09:30:00-04:00,180.69,183.79,179.62,183.71,25273214,22235640,44.8438369642108,46.230098596702156,NaN,NaN,-86.18693764528905,-138.8981524668605,-1.6375045155076648,-1.6845280870836064,-0.04702357157594139,4274580730,4254521948,22.52883093345811,50.00330993010855,NaN,NaN,-10.096364778534154,5.3023535421668395
2022-09-09T09:30:00-04:00,185.34,187.63,185.1,187.4,23208770,22209700.8,50.932267279273866,45.67319952978054,NaN,NaN,-35.06602058614378,-109.55292408854116,-1.063691026421276,-1.3766373546025363,-0.3129463281812604,4297789500,4258913513.8,24.916153857238356,46.45455623935976,NaN,NaN,-8.304836294832112,3.3584692797384177
2022-09-12T09:30:00-04:00,188.6,189.86,187.97,189.67,23134571,22280099.9,54.276058318483436,45.87304472952527,NaN,NaN,-3.425261134531208,-79.13412995195199,-0.5005562380015091,-0.9386416256831467,-0.43808538768163763,4320924071,4273425633.8,32.33646154587926,44.094990313258634,NaN,NaN,-5.736828982960662,2.0591409564956917
2022-09-13T09:30:00-04:00,184.86,185.91,181.535,182.25,34144710,23116595.4,43.77502038871201,45.287554865925195,NaN,NaN,-65.16811192489831,-61.04313131527363,-0.5908874018984999,-1.1766946400547624,-0.5858072381562626,4286779361,4285876235.6,37.99789017799061,42.414331330729894,NaN,NaN,-7.001421713445414,0.7647748607898195
2022-09-14T09:30:00-04:00,182.57,183.32,180.57,182.96,25278337,23438857.05,44.87407418285868,44.612232710064156,NaN,NaN,-70.34448737833648,-52.038163733839745,-0.5658786973409641,-1.2931556098324677,-0.7272769124915036,4312057698,4298426272,43.16040848751037,41.08169431813826,NaN,NaN,-7.614855849769787,-0.43231524071869565
2022-09-15T09:30:00-04:00,181.92,184.69,180.86,181.63,25378692,23586392.15,43.17165570751122,43.496740800493406,NaN,NaN,-62.93352693816658,-47.387481592415256,-0.5987864775298483,-1.475760009403814,-0.8769735318739657,4286679006,4300845927.2,44.126359905671436,39.815103213468014,NaN,NaN,-8.64668658895398,-1.6057968618951648
2022-09-16T09:30:00-04:00,179.09,179.68,176.91,178.99,41155873,24725783.15,39.933172801828285,42.923459928063934,NaN,NaN,-109.00964224777537,-62.17620592474158,-0.7485064922107592,-1.8126066471374145,-1.0641001549266553,4245523133,4290392653.8,40.89311888252236,38.29586081997685,NaN,NaN,-10.538837284273123,-2.8819454936634443
2022-09-19T09:30:00-04:00,177.01,180.75,176.96,180.52,25412217,24625574.35,42.61962119612561,42.71685587370087,NaN,NaN,-89.79064509499038,-79.44928271683341,-0.695767926049411,-1.9338100624884191,-1.2380421364390082,4270935350,4280394909.6,38.02348622842152,36.52963347905327,NaN,NaN,-11.265956307208915,-4.07966132416994
2022-09-20T09:30:00-04:00,178.77,178.94,176.71,178.06,22247528,24591100,39.55633079867564,42.539861453115314,NaN,NaN,-104.64851436637976,-87.3453632051297,-0.7719435692647363,-2.2029715980199285,-1.4310280287551922,4248687822,4272776601.8,35.953089988721985,34.96886947171041,NaN,NaN,-12.822310554692553,-5.328611214244599
2022-09-21T09:30:00-04:00,179.37,181.1,175.33,175.34,29357100,25055463.2,36.43780545905837,42.242148628515906,NaN,NaN,-107.81462170477508,-94.83939007041742,-0.939760065392637,-2.6057281104959884,-1.6659680451033514,4219330722,4254231206.6,31.462014776194906,33.706656134766334,NaN,NaN,-15.115850323773012,-6.726788229891516
2022-09-22T09:30:00-04:00,175,175.58,170.7405,171.39,33468593,25926979.2,32.43831685429643,41.83668026969606,NaN,NaN,-173.4164593736804,-116.93597655752019,-1.232571877929914,-3.206682892515744,-1.9741110145858298,4185862129,4234067831.2,27.447534948561085,32.88351790424256,NaN,NaN,-18.406715341945336,-8.395349245899205
2022-09-23T09:30:00-04:00,169,169.19,165,167.31,40336929,27204078,28.90869276110284,41.30025069891336,NaN,NaN,-238.4156489019867,-142.81717788836244,-1.5938656698319509,-3.966443101875768,-2.3725774320438173,4145525200,4214068244.6,24.155254432198134,32.343632069032694,NaN,NaN,-22.41863445786193,-10.398675704751023
2022-09-26T09:30:00-04:00,165.47,168.97,163.58,164.17,30597799,27525107.05,26.517286343946537,40.741410275953506,NaN,NaN,-221.3024303483592,-169.1195349390362,-1.9155216758461804,-4.766979526851543,-2.8514578510053625,4114927401,4182866654.8,20.103791698414028,31.903196716556288,NaN,NaN,-26.56618883416193,-12.708320437524009
2022-09-27T09:30:00-04:00,166.31,167.63,163.28,164.73,42406580,28657772.6,27.666517454393627,39.71076117931978,NaN,NaN,-187.4228785490585,-185.67440777557198,-1.954980528736065,-5.295183511925444,-3.340202983189379,4157333981,4164595886.6,18.180797676363383,31.520370967081824,NaN,NaN,-29.49190451692505,-15.10597530600987
2022-09-28T09:30:00-04:00,165.76,170.99,165.07,169.94,35186541,29289653,37.465407645183426,39.18373051367497,NaN,NaN,-119.76517297014654,-188.06451802864626,-1.5142872420147624,-5.233062035707832,-3.7187747936930693,4192520522,4159233846.6,17.64729568371078,31.171689877814156,NaN,NaN,-28.889654793814028,-17.07507237569618
2022-09-29T09:30:00-04:00,167.78,167.93,163.8,166.13,31464022,29742230.1,33.853677422871954,37.9638312382177,NaN,NaN,-128.8571524405012,-179.15265664201044,-1.3679297272809343,-5.428686952794237,-4.060757225513303,4161056500,4154272720.8,17.145969898649582,30.61667673791496,NaN,NaN,-29.566650554085545,-18.85958354403752
2022-09-30T09:30:00-04:00,165.78,169.515,164.87,164.92,40643777,30239086.8,32.773120346674375,36.42790709737419,NaN,NaN,-104.88176240065725,-152.44587934174456,-1.2446847604858906,-5.616613176120666,-4.371928415634775,4120412723,4149250225.4,16.630882222162896,29.494849643363796,NaN,NaN,-30.447397719177566,-20.514985569057526
2022-10-03T09:30:00-04:00,167.34,170.3,165.25,169.29,33611555,30546254.55,40.197222895960195,36.1723501336062,NaN,NaN,-75.48017309317927,-123.28142789070856,-0.7834475433409196,-5.351237844810925,-4.567790301470005,4154024278,4157069600.8,20.628671960277714,28.254191199241443,NaN,NaN,-28.775821745960826,-21.695105022900854
2022-10-04T09:30:00-04:00,172.61,176.08,172.53,176,37537299,31231263.55,49.43157090275194,36.49788561359858,NaN,NaN,-8.685432481574631,-87.5339386772118,0.016576820003995962,-4.54706927646501,-4.5636460964690055,4191561577,4163915120,24.061830656929416,26.890007068485662,NaN,NaN,-24.022697801812175,-22.027618277031042
2022-10-05T09:30:00-04:00,173.41,175.33,171.42,174.7,25281358,31256273.25,47.888721132474686,36.83481885823882,NaN,NaN,-16.04920483326925,-66.79074504983635,0.47579053497980084,-3.9689079277442545,-4.444698462724055,4166280219,4158667059.4,23.23217618883504,25.397565374425927,NaN,NaN,-20.802397771889787,-21.852586776296576
2022-10-06T09:30:00-04:00,173.85,176.165,172.91,173.72,22635934,31124409.25,46.70526417404104,37.318539670539735,NaN,NaN,-7.7350070136061015,-42.56631596445732,0.7166552259534855,-3.5488794302821987,-4.265534656235684,4143644285,4155184616.4,22.67350395129965,24.09616430791002,NaN,NaN,-18.608065248192496,-21.389083700853135
2022-10-07T09:30:00-04:00,171.93,172.47,167.92,168.61,26536118,31290776.65,41.01374546483538,37.20383426116185,NaN,NaN,-51.34612169302506,-31.85918782293087,0.5428360999039885,-3.586989531355698,-4.129825631259687,4117108167,4154523705.2,22.56261191732618,22.991816142831784,NaN,NaN,-18.524350487283417,-20.979836098914603
2022-10-10T09:30:00-04:00,169.29,169.57,166.59,167.67,23386430,31303369.6,40.04697431676365,37.238880226739575,NaN,NaN,-64.20650807836526,-29.604454819968065,0.38309550175841434,-3.6509562540616685,-4.034051755820083,4093721737,4142463197,20.58417439078808,21.89403645726507,NaN,NaN,-18.757385880343772,-20.66234321054734
2022-10-11T09:30:00-04:00,166.96,170.11,164.8,167.72,28009126,30996590.4,40.12781801441859,37.50245255212245,NaN,NaN,-62.711534828023076,-40.409675289257756,0.30285925330897134,-3.6554776891838685,-3.95833694249284,4121730863,4128497054.2,18.555125898699885,20.972115823158283,NaN,NaN,-18.919624510125036,-20.413383396201297
2022-10-12T09:30:00-04:00,167.9,168.46,165.48,167.26,26796655,31072506.3,39.5987769943053,38.013913990694505,NaN,NaN,-62.88145946946319,-49.776126216496536,0.24342362167425735,-3.6540574154000183,-3.8974810370742756,4094934208,4114227852,16.739564177226086,20.207260768062927,NaN,NaN,-19.20026073822966,-20.240080159348206
2022-10-13T09:30:00-04:00,164,172.2,162.5,171.4,45376514,32072397.4,46.44248417818556,39.26632766334327,NaN,NaN,-34.08062125802561,-55.04524906538044,0.4931475695950245,-3.281046575080495,-3.7741941446755196,4140310722,4113561139.4,16.65755132303957,19.671710545980172,NaN,NaN,-17.441471474901736,-19.840278918712997
2022-10-14T09:30:00-04:00,172.74,173.92,166.71,166.81,29608626,31495035.05,40.908293953369096,40.29425677830203,NaN,NaN,-21.79824033908584,-49.135672794592594,0.3653036223727786,-3.3175646167095465,-3.682868239082325,4110702096,4112279925.2,16.490351636034234,19.413607684381617,NaN,NaN,-17.564355088435423,-19.515146942959056
2022-10-17T09:30:00-04:00,170.22,172.62,170.11,172.13,28199212,31634384.8,48.55946250008733,41.78660999585157,NaN,NaN,33.66358807593727,-29.56165356373209,0.639109671730353,-2.883981149419384,-3.523090821149737,4138901308,4121315839.4,22.405811778114142,19.71539440593524,NaN,NaN,-15.175506164169272,-18.895198260274803
2022-10-18T09:30:00-04:00,175.86,177.29,172.69,174.17,34523149,32248165.85,51.170349493418165,42.765534413582635,NaN,NaN,107.48073052534711,4.4767995069419495,0.9395301945978876,-2.3486780779023775,-3.288208272500265,4173424457,4131654558.2,28.63480215239194,20.500216296555326,NaN,NaN,-12.390735316317935,-17.965989268280964
2022-10-19T09:30:00-04:00,172.49,173.4,169.3301,171.21,27146943,32137658,47.410236261736195,43.733860044930076,NaN,NaN,44.74081544224256,26.0012544892831,0.9196539151740994,-2.138640878532641,-3.0582947937067404,4146277514,4141923219.4,34.278068753389135,21.723937643322436,NaN,NaN,-11.231280232259758,-17.003887977420792
2022-10-20T09:30:00-04:00,171.42,173.55,168.4693,169.03,26710706,31799763.65,44.79926043687487,44.59287005137297,NaN,NaN,24.627347668393366,37.742848274566896,0.7477454531439811,-2.123612977276764,-2.871358430420745,4119566808,4137774436.6,33.13792157542741,22.90301188284133,NaN,NaN,-11.079158973885763,-16.15749811977293
2022-10-21T09:30:00-04:00,169.4,173.2,168.19,172.7,45402703,32053052.35,49.810423304414066,45.27952722340539,NaN,NaN,45.70230150452309,51.24295664328868,0.8611869602461892,-1.7948747301130084,-2.6560616903591976,4164969511,4148627919.6,38.866621612631654,24.20572257229518,NaN,NaN,-9.36973614673907,-15.187817837910952
2022-10-24T09:30:00-04:00,173.32,174,171.05,173.44,27284472,31887386,50.78066449152561,45.37589105117494,NaN,NaN,75.02798029584625,59.515835087270474,0.9585849343290898,-1.4578305224478356,-2.4164154567769254,4192253983,4159298454.6,43.951085463269976,25.626383629890935,NaN,NaN,-7.701153119377698,-14.118294306691915
2022-10-25T09:30:00-04:00,173.57,178.895,173.56,178.17,33105746,31422344.3,56.56108281617008,45.99534545715318,NaN,NaN,158.40778887560322,69.7012467573217,1.2932690396518018,-0.799829157212173,-2.093098196863975,4225359729,4169685509,48.44598658242869,27.427370086576193,NaN,NaN,-4.393956649031744,-12.729103212740462
2022-10-26T09:30:00-04:00,179.15,182.37,178.33,179.05,37084746,31517254.55,57.559720551453,46.770663769825454,NaN,NaN,193.56060981705505,99.4652056322842,1.5104891737582744,-0.20498672966613185,-1.7154759034244063,4262444475,4192918901.2,56.792691350575474,29.864454900810184,NaN,NaN,-1.4171545927126274,-11.113110552736487
2022-10-27T09:30:00-04:00,180.59,182,178.87,179.09,28651848,31376645.85,57.60742740310194,47.95592676541593,NaN,NaN,166.72270841735585,127.8842777820767,1.5856485800181994,0.26658482159834307,-1.3190637584198563,4291096323,4227224804.2,65.63895453943275,32.94133651667494,NaN,NaN,0.9984509014020773,-9.382887487859549
2022-10-28T09:30:00-04:00,179.825,183.41,178.7383,183.16,33221621,31005538.05,62.25647584558671,49.54231973176043,NaN,NaN,171.53843727329678,153.05150493583145,1.8213982652939518,0.9576840731975835,-0.8637141920963682,4324317944,4259094490.8,71.48061619585066,36.576796645607985,NaN,NaN,4.560538702004899,-7.3909694607360565
2022-10-31T09:30:00-04:00,182.27,184.24,181.55,183.33,25699385,30609929.55,62.44175169936246,51.13617213782785,NaN,NaN,164.98160030130433,171.04222893692304,1.892404214279612,1.5017910757531467,-0.3906131385264653,4350017329,4290647160,75.85690494815206,40.669780863426,NaN,NaN,7.5064254190564075,-5.262770192194276
2022-11-01T09:30:00-04:00,185.24,185.6,182.88,183.58,27446653,30105397.25,62.73148223284205,52.788508226294766,NaN,NaN,154.08519365667485,170.17770989313738,1.8572219729046227,1.930914327604313,0.07369235469969038,4377463982,4321068010.6,79.17488105689486,45.129446354830904,NaN,NaN,10.023255813343763,-3.079052191403128
2022-11-02T09:30:00-04:00,182.84,185,177.43,177.49,38139591,30748308.9,52.1730966303111,53.19783768716088,NaN,NaN,82.15932754588239,147.89745343890286,1.3484903690898797,1.75930531606204,0.4108149469721603,4339324391,4336443993.8,80.62430001491445,49.69849983282197,NaN,NaN,9.274579900284898,-1.314247606876267
2022-11-03T09:30:00-04:00,175.29,177.94,174.11,176.3,29093224,31071173.4,50.388429820451265,53.87499024909532,NaN,NaN,26.30268183411507,119.81344812225468,0.8792488207684692,1.509875972932747,0.6306271521642777,4310231167,4340270962.6,80.97914060377866,54.304841901946574,NaN,NaN,8.127718962501463,0.03460476017769443
2022-11-04T09:30:00-04:00,178.92,179.94,175.47,178.68,25842371,31036486.05,53.79278603116943,54.248799072744035,NaN,NaN,47.13716315175305,94.93319329794593,0.6851823654414734,1.4871051089661194,0.801922743524646,4336073538,4342622081.4,81.20684940657574,58.504916018265256,NaN,NaN,8.13178661158873,1.191345024664985
2022-11-07T09:30:00-05:00,179.74,180.59,177.68,179.49,20689937,30901661.4,54.92640464909674,54.51708872672107,NaN,NaN,57.55301910512038,73.44747705870914,0.5720082102410712,1.516933006325985,0.9449247960849138,4356763475,4343971310.6,81.34486997317399,62.26992086260683,NaN,NaN,8.455116378007562,2.229026646571067
2022-11-08T09:30:00-05:00,180.23,181.95,177.36,179.56,20265188,30514464.5,55.02908482790225,55.06129219573294,NaN,NaN,56.90235556693809,54.01090944076178,0.4669397642011903,1.5285995013364015,1.0616597371352112,4377028663,4343884246.8,81.30337558556116,65.62887135061912,NaN,NaN,8.748586505321938,3.1603923406783343
2022-11-09T09:30:00-05:00,178,178.67,174.275,174.63,27276977,30538480.6,46.921844403375786,55.21290533619729,NaN,NaN,-6.077320375499935,36.363579856485316,0.052307111925100624,1.1270436270415871,1.0747365151164865,4349751686,4345969705.8,81.5462007563216,69.08660557782585,NaN,NaN,6.613315102541694,3.6536670209445283
2022-11-10T09:30:00-05:00,181.85,185.445,181.15,185.38,38572799,30198294.85,60.56486004410681,55.98107938903248,NaN,NaN,117.5594422354534,54.614931936752996,0.46592309138797927,1.6571403793514605,1.1912172879634813,4388324485,4361588369.4,83.29596226884003,72.26012991041216,NaN,NaN,9.275377679389239,4.456768543579487
2022-11-11T09:30:00-05:00,185.76,188.84,185.69,186.9,28765362,30156131.65,62.05019337956788,56.78604573817836,NaN,NaN,154.3734822419207,76.06219575478653,0.786887864262088,2.174827118291091,1.3879392540290032,4417089847,4377791631.2,84.8959936113818,75.18476620670586,NaN,NaN,11.860758484713179,5.514481392312871
2022-11-14T09:30:00-05:00,185.79,187.785,184.6317,184.81,26499630,30071152.55,58.77225863062722,56.94398686778244,NaN,NaN,119.38486286117264,88.42856450599697,0.8007799090398211,2.3889141403287795,1.5881342312889584,4390590217,4384556979.6,85.51966805237365,77.83288631170193,NaN,NaN,12.869405312041785,6.565184809417001
2022-11-15T09:30:00-05:00,187.84,189.56,186.11,187.55,26128760,29651433.1,61.63376862140705,57.234990301350585,NaN,NaN,137.3030045447681,104.508694301563,0.9278906497368122,2.7479975434599737,1.8201068937231615,4416718977,4392495042.4,86.23773470503397,79.93610369416324,NaN,NaN,14.632352078230696,7.717637276390386
2022-11-16T09:30:00-05:00,186.6,186.64,183.71,184.25,24802010,29534186.45,56.54354548212388,57.15899873556644,NaN,NaN,84.42009753283592,122.60817788323016,0.7317277806150533,2.734766619491978,2.003038838876925,4391916967,4400928098.6,86.97660080483888,81.4602212845494,NaN,NaN,14.456931092077049,8.680393535774195
2022-11-17T09:30:00-05:00,181.62,182.95,180.51,182.54,20835670,29240434.65,54.052395382314444,56.57299298818985,NaN,NaN,27.841232249578244,104.66453588605512,0.44302878729736817,2.5568248229986352,2.113796035701267,4371081297,4397479461,84.96761670314247,82.42357846364168,NaN,NaN,13.526312383240944,9.372667656840873
2022-11-18T09:30:00-05:00,184.59,185.31,182.57,183.72,27269071,28333753.05,55.5090582125677,56.07780059627594,NaN,NaN,55.480598529034154,84.8859591434778,0.2948873185497769,2.4824051838884884,2.1875178653387115,4398350368,4393731565.2,82.73112329355608,82.91459405974196,NaN,NaN,13.206249756683242,9.92032224253264
2022-11-21T09:30:00-05:00,182.78,183.19,181.43,182.76,19038942,27921476.55,54.00890557739361,55.454759406601056,NaN,NaN,19.53024341651801,64.91503525454688,0.10536849531652681,2.31922848448437,2.213859989167843,4379311426,4391475807,81.34332664089055,83.06948303002737,NaN,NaN,12.503778526818504,10.28938742600205
2022-11-22T09:30:00-05:00,183.74,184.94,182.33,184.71,16869715,27109675,56.57604261007332,55.769255548012644,NaN,NaN,49.60448162243845,47.37533067008094,0.08531928337786265,2.3205090933901715,2.235189810012309,4396181141,4387368239.8,78.75273259810825,82.93579964311263,NaN,NaN,12.64470349901946,10.625861150718823
2022-11-23T09:30:00-05:00,184.29,185.78,183.55,185.19,19758783,26243376.85,57.2092076754691,56.2564539662282,NaN,NaN,64.01238170332057,43.29378750417787,0.07853492772913384,2.333358469673726,2.2548235419445923,4415939924,4392172831.2,79.57224320214196,82.83530697156716,NaN,NaN,12.936363608200708,10.955932930359092
2022-11-25T09:30:00-05:00,185.09,186.37,184.66,185.58,13393405,25480454.7,57.748271365547694,56.538988632969506,NaN,NaN,74.17137790276904,52.559816634816045,0.07449778742385149,2.3479457762244067,2.273447988800555,4429333329,4403823237.6,81.44147925708518,82.85206624660354,NaN,NaN,13.323534212414634,11.294161684938455
2022-11-28T09:30:00-05:00,184.13,184.92,181.29,181.84,17490373,24693892.3,51.10008679376397,56.26568021473145,NaN,NaN,3.565598316552717,42.17681659231975,-0.1913425650545717,2.0342697824823404,2.225612347536912,4411842956,4406521755.2,81.85562606792544,82.88854882480008,NaN,NaN,11.784328727088974,11.364185548102816
2022-11-29T09:30:00-05:00,181.96,183.61,181.96,182.37,14020553,24109950.7,51.94438748997078,56.04534469059349,NaN,NaN,3.1642325842740537,38.90361442587097,-0.3344027754829675,1.8076088781832027,2.14201165366617,4425863509,4415832171.8,83.24489599662573,83.02722885416183,NaN,NaN,10.733865872917264,11.274139880219165
2022-11-30T09:30:00-05:00,182.67,187.43,180.795,187.37,28030141,24139125.1,59.11606238717068,56.91636026086456,NaN,NaN,63.95910185982156,41.77453847334759,-0.10698019006156034,2.00828641608922,2.1152666061507803,4453893650,4427374673.6,84.79884497735037,83.25956058423533,NaN,NaN,11.886198607152132,11.361576841209589
2022-12-01T09:30:00-05:00,188.151,189.24,186.13,186.96,21996369,23331964,58.347118889583086,56.75795017839857,NaN,NaN,107.35175122581964,50.442412377847404,-0.004277765132335354,2.109919399735361,2.1141971648676963,4431897281,4430566145,85.20736272200617,83.3960891880329,NaN,NaN,12.605221595580815,11.539240377548335
2022-12-02T09:30:00-05:00,184.37,188.86,184.33,188.05,22574779,23006041.75,59.842603018861446,56.600265152633824,NaN,NaN,93.80478284594737,54.36909336648307,0.11060489422746489,2.252453282652027,2.1418483884245623,4454472060,4435593891.2,85.8523991033035,83.4644038660273,NaN,NaN,13.631294239807909,11.83810521501399
2022-12-05T09:30:00-05:00,186.86,187.06,182.1838,182.87,25449292,22986387.8,50.55346103823849,56.013208181748915,NaN,NaN,7.177215003519839,55.0914167038765,-0.1732892933440091,1.9252367717445509,2.09852606508856,4429022768,4439029853.6,86.29230793533993,83.51959242909632,NaN,NaN,11.735446469380923,11.82343967992355
2022-12-06T09:30:00-05:00,182.88,182.98,179.08,180.07,18502134,22876997.65,46.36399273557989,54.92250990418984,NaN,NaN,-99.76759418718336,34.505051349585,-0.5399658793168869,1.4235687159424515,1.9635345952593384,4410520634,4435961278.6,83.78661667315804,83.34451256967661,NaN,NaN,8.794495569248625,11.390733378398561
2022-12-07T09:30:00-05:00,179.75,181.5,179.11,179.54,17177784,22722627.45,45.593770511799974,54.14038312059528,NaN,NaN,-122.74429608629289,-2.8356282396378845,-0.7932102879762557,0.9720217352890188,1.7652320232652745,4393342850,4423851118.6,74.58234686141358,82.4592087165748,NaN,NaN,6.187508572171667,10.647415548937577
2022-12-08T09:30:00-05:00,180.77,182.625,179.51,180.84,20971437,22407350.45,47.880867393660154,53.69955969283426,NaN,NaN,-115.53470351590863,-47.41291918798354,-0.8434879035909071,0.7108721437766405,1.5543600473675476,4414314287,4420334519.8,72.10527089416897,81.54046973021956,NaN,NaN,4.660786796894696,9.792182870074308
2022-12-09T09:30:00-05:00,179.77,180.81,178.56,178.62,22046494,21581035.2,44.444876956495236,52.90926103168622,NaN,NaN,-149.0309258369836,-95.98006092456973,-0.9866299268408358,0.32107263881650283,1.3077025656573387,4392267793,4407893666.4,64.00616429735312,80.2029726590622,NaN,NaN,2.3276245311881993,8.725817393090578
2022-12-12T09:30:00-05:00,178.85,181.09,178,180.72,22765420,21281038.1,48.22950544790636,52.49644673672285,NaN,NaN,-113.81052079614035,-120.17760808450177,-0.9025327834539909,0.17953658633985015,1.082069369793841,4415033213,4405095755.4,62.311032553461594,78.84352308138871,NaN,NaN,1.429538790552206,7.683491878442239
2022-12-13T09:30:00-05:00,185.73,186.64,180.14,181.38,38445310,21878322.1,49.396290400564354,51.983607293186495,NaN,NaN,-22.286711928494153,-104.68143163276393,-0.770255425114043,0.11925008840128726,0.8895055135153302,4453478523,4413687333.2,65.34603022281524,77.88590148315348,NaN,NaN,1.018031462230192,6.731283247554804
2022-12-14T09:30:00-05:00,181.31,182.91,178.83,180.19,32406860,22192227.1,47.32524743659562,51.277610133266954,NaN,NaN,-82.77402192177223,-96.68737679985979,-0.7310209492917229,-0.024270673099323403,0.7067502761923995,4421071663,4419233095.8,67.1830561559351,77.00095955128157,NaN,NaN,0.08923709598638467,5.7824195116164585
2022-12-15T09:30:00-05:00,178.03,178.6,175.04,175.68,33546710,22629462.1,40.410133742069185,50.039171731589924,NaN,NaN,-195.47887492433617,-112.6762110815453,-0.9623691850066317,-0.4962112050658902,0.4661579799407415,4387524953,4413875229,63.67132313588079,75.73166268548125,NaN,NaN,-2.890931961687624,4.5433693011444465
2022-12-16T09:30:00-05:00,173.8,175.11,172.67,174.37,38502417,23512799.45,38.64382750052188,49.14943892492977,NaN,NaN,-212.17210314310807,-125.3044465427702,-1.1447758071974325,-0.9648117790560491,0.1799640281413834,4349022536,4405226177.6,58.36744354657574,74.05393536252768,NaN,NaN,-5.901916584708327,3.051185603165479
2022-12-19T09:30:00-05:00,174.61,175.0529,171.47,172.01,25614032,23430047.5,35.62296363698728,47.98362293543095,NaN,NaN,-195.47593659516258,-141.63752970257465,-1.3513440890196413,-1.5092160831331682,-0.15787199411352698,4323408504,4386901235.8,49.045476765174534,71.61111970313831,NaN,NaN,-9.418902313464681,1.2697444722183135
2022-12-20T09:30:00-05:00,171.67,174.02,171.18,172.92,18050794,23380640.1,37.64701866522228,46.450119812434636,NaN,NaN,-165.2613117111438,-170.2324496591046,-1.3504640331272133,-1.8459520355225436,-0.49548800239533036,4341459298,4364497390.8,40.52401685571586,68.44863198016442,NaN,NaN,-11.738938250230765,-0.5886387738458405
2022-12-21T09:30:00-05:00,174.45,176.8,174.2,175.9,22997201,23687014.4,43.87061188173077,45.41608359758805,NaN,NaN,-96.80482921876659,-173.03861111850344,-1.0844249672766777,-1.8510192114911774,-0.7665942442144997,4364456499,4353174358,37.02287229555866,65.0068826639896,NaN,NaN,-11.913642913083065,-2.2064965080225867
2022-12-22T09:30:00-05:00,174.33,174.49,170.67,173.6,21297569,23763953.7,40.50982768529237,44.03517107376168,NaN,NaN,-128.34976198277448,-159.6127885301911,-1.0006212195088913,-2.017370768600614,-1.0167495490917227,4343158930,4344301153.4,34.50689967632533,61.339346990634006,NaN,NaN,-13.081149207321,-3.760018322208074
2022-12-23T09:30:00-05:00,173.48,174.45,172.34,174.39,11647741,23676670.5,42.149136297632815,43.43486216371842,NaN,NaN,-100.05215115850004,-137.18879813326947,-0.8359549702069824,-2.0616932618504507,-1.2257382916434683,4354806671,4345457980.4,35.12588429406733,57.68460244482882,NaN,NaN,-13.55783584356094,-5.159706539544198
2022-12-27T09:30:00-05:00,174.36,174.57,172.58,173.22,13553781,23479840.9,40.374669303654365,43.00705334715231,NaN,NaN,-91.66553666180658,-116.42671814659829,-0.7524150590061693,-2.16625711540118,-1.4138420563950107,4341252890,4349026857.6,37.100926704170675,54.34991030418686,NaN,NaN,-14.4673182807565,-6.489365359717383
2022-12-28T09:30:00-05:00,173.18,174.1,170.34,170.53,19648022,23761214.35,36.56334210947234,42.36202274698605,NaN,NaN,-105.42026750634363,-104.45850930563824,-0.8193908079225263,-2.4380805662981686,-1.6186897583756423,4321604868,4345055971.6,35.79514784544837,51.57939608876078,NaN,NaN,-16.401444609405807,-7.905376681101444
2022-12-29T09:30:00-05:00,171.72,175.25,171.4,174.85,22311308,23475272.7,45.46654762160173,42.18957133469617,NaN,NaN,-65.00815676552713,-98.09917481499038,-0.5279664964382582,-2.278647878923465,-1.7506813824852068,4343916176,4340947907,34.44450850303649,48.889341632251316,NaN,NaN,-15.32432622328909,-8.96522661569968
2022-12-30T09:30:00-05:00,173.34,174.7203,172.61,174.36,21275583,23439233.4,44.70022294670174,42.207810333996626,NaN,NaN,-57.997700187228794,-84.02876245588124,-0.3329405349426604,-2.1668570511635323,-1.833916516220872,4322640593,4336844239.6,33.10089444823369,46.68182235731421,NaN,NaN,-14.690313458402532,-9.783096164657229
2023-01-03T09:30:00-05:00,175.93,177.32,171.9,173.4,22503836,23435686.25,43.165201525687465,41.84607433955242,NaN,NaN,-47.423678095059344,-73.5030678431931,-0.23779423800850363,-2.1311593137315015,-1.8933650757229978,4300136757,4325910256.8,29.768872540676583,44.35738235640098,NaN,NaN,-14.61250672880696,-10.473011959535762
2023-01-04T09:30:00-05:00,174.62,176.67,174.28,175.56,22973497,23311896.5,47.5311025960979,41.71284663923338,NaN,NaN,-16.48196157631031,-58.46635282609384,-0.010585213657565706,-1.9065965927949549,-1.8960113791373892,4323110254,4322281729.6,28.735117187848587,41.74231713961765,NaN,NaN,-13.24109338449734,-10.868452163101702
2023-01-05T09:30:00-05:00,174.59,174.76,172.39,173.68,17032620,23238420.8,44.338606414377146,41.499515137646355,NaN,NaN,-53.2693459175397,-48.036168508333056,0.0296882612762015,-1.8589010525421372,-1.8885893138183387,4306077634,4319176282.8,27.843939190572996,38.932380213520354,NaN,NaN,-13.00959858763818,-11.17433022374977
2023-01-06T09:30:00-05:00,175.3,178.04,173.87,177.58,21986906,23478876.9,51.6010079312132,42.29886329401378,NaN,NaN,19.322143229574756,-31.170108509312684,0.3194813845872053,-1.489237583084332,-1.8087189676715374,4328064540,4316005955.6,26.925848554140345,36.307703457681754,NaN,NaN,-10.491897023025286,-11.076839766503415
2023-01-09T09:30:00-05:00,179.01,180.12,177.65,177.88,18366452,23348627.65,52.11853720615419,43.261342558701806,NaN,NaN,78.81264182692159,-3.808040106482605,0.5200054026742797,-1.1587122143286877,-1.6787176170029674,4346430992,4320764035.4,30.6231250742499,34.325966423944195,NaN,NaN,-8.321213182761209,-10.683178825968815
2023-01-10T09:30:00-05:00,177.66,180.62,177.3,180.51,18751117,23183858.8,56.509063117714895,44.753206807325206,NaN,NaN,103.07642531998411,26.29198057652609,0.8015754338547998,-0.6767483246844677,-1.4783237585392675,4365182109,4333773105.8,39.61853615899924,33.6526135235031,NaN,NaN,-5.071471615298078,-9.881506367301567
2023-01-11T09:30:00-05:00,181.26,182.79,180.68,182.76,18222696,22956722.6,59.89701538860553,46.34249228756686,NaN,NaN,160.7866813562892,61.745709163046,1.093105504806686,-0.11194187753091,-1.205047382337596,4383404805,4345832016,46.538360012477206,34.08220946327176,NaN,NaN,-1.2343991805621521,-8.646205340624508
2023-01-12T09:30:00-05:00,183.57,185.95,181.92,185.83,29650762,22516995.2,64.0159857834843,47.78144756626357,NaN,NaN,211.8067151914705,114.76092138484805,1.425434923451848,0.5767462719772141,-0.8486886514746339,4413055567,4367227602.6,56.142093864946574,35.44786814679947,NaN,NaN,3.43593935760292,-6.920184669449162
2023-01-13T09:30:00-05:00,184.5,187.34,184.33,187.05,22119985,22002651.45,65.53110054884996,49.56868134223197,NaN,NaN,216.88875853094828,154.27424444512275,1.6446037929536619,1.2070660897174434,-0.43753770323621843,4435175552,4388649805,63.258755330852665,37.50157212212285,NaN,NaN,7.738889527354723,-4.826031212762892
2023-01-17T09:30:00-05:00,187,187.84,186.235,186.82,22422562,21446444.05,64.97565780890923,51.199147164466,NaN,NaN,180.76274112234321,174.66426430420705,1.6850726309889992,1.6688030855000306,-0.016269545488968584,4412752990,4401914204.6,66.84608578843016,39.767300800291615,NaN,NaN,11.046495330667165,-2.5585274208443125
2023-01-18T09:30:00-05:00,187.45,188.96,183.695,183.8,23507760,20696711.2,58.02149951931419,52.45963503701313,NaN,NaN,128.52881748025294,179.75474273626085,1.4295224045022235,1.7706334601388107,0.3411110556365873,4389245230,4406726828.8,68.06443331034326,41.97897984358966,NaN,NaN,11.893655419279717,-0.4939298722551655
2023-01-19T09:30:00-05:00,182.73,183.1,180.78,182.04,24624454,20647232.3,54.36942969238236,53.731498435792425,NaN,NaN,65.31040071221396,160.65948660744579,1.0789816140521689,1.6898380732017984,0.6108564591496295,4364620776,4402970023,66.02474145053279,44.13823652966712,NaN,NaN,11.505007738740849,1.2202040721728364
2023-01-20T09:30:00-05:00,182.71,185.15,181.27,185.04,36070250,21548205.1,59.09563954333351,54.705005001630404,NaN,NaN,82.61853414280696,134.8218503977131,0.9885913682776852,1.846595669496736,0.8580043012190508,4400691026,4400497114.8,64.65134529222063,46.29586772889456,NaN,NaN,12.627411820200463,2.849805179033926
2023-01-23T09:30:00-05:00,185.43,188.115,184.58,187.33,20329901,21414840.1,62.305144822573205,55.96249942133551,NaN,NaN,108.91475369957821,113.22704943143908,1.018433108988225,2.131045687454332,1.112612578466107,4421020927,4397666189.8,63.03484836319469,48.43400729424892,NaN,NaN,14.585467292888751,4.526328338156044
2023-01-24T09:30:00-05:00,186.59,187.83,185.88,186.93,19263452,21313134.25,61.3989149453833,57.264907522742355,NaN,NaN,99.77998734817808,97.03049867660604,0.9480788454550226,2.297711135284885,1.3496322898298625,4401757475,4395467086.8,61.743362998819165,50.71789946983053,NaN,NaN,15.892096126358767,6.150009450756433
2023-01-25T09:30:00-05:00,185.41,187.51,183.87,187.45,18174577,21639476.05,62.169263545775124,58.310490447719296,NaN,NaN,82.36847024651966,87.79842922985938,0.8751631415771446,2.443586216801293,1.5684230752241486,4419932052,4401604451.2,63.96250163344687,53.234141215944696,NaN,NaN,17.186178915170967,7.726605088529938
2023-01-26T09:30:00-05:00,188.98,189.85,186.29,188.56,18369120,21880243,63.828683906989525,59.70263884004875,NaN,NaN,98.51528536340895,94.43940616009837,0.8401220860248126,2.6185756827551643,1.7784535967303516,4438301172,4416340530.4,68.66277296264624,56.14977219966426,NaN,NaN,18.751797117760212,9.30163252127712
2023-01-27T09:30:00-05:00,187.98,190.3,187.79,189.58,20019850,21898834.4,65.33350021485307,60.68353114602303,NaN,NaN,104.45103032303629,98.80590539614425,0.8229986384068464,2.8072018947389097,1.9842032563320633,4458321022,4427866529.6,71.76476720514472,59.35255210330744,NaN,NaN,20.502476304513387,10.901753061739445
2023-01-30T09:30:00-05:00,187.84,189.61,186.83,186.94,18395072,21703022.6,58.544669555775364,61.1425405995674,NaN,NaN,78.56593371599212,92.73614139942704,0.5825548097945918,2.712396768575303,2.129841958780711,4439925950,4431647534.2,72.71878703774374,62.35938510069985,NaN,NaN,20.106126030973385,12.216663485915722
2023-01-31T09:30:00-05:00,187.42,191.58,187.38,191.48,21567866,21717636.75,65.23487500032016,61.76581287689635,NaN,NaN,105.61595030374771,93.90333399054096,0.6716256215808625,2.969373985756789,2.2977483641759266,4461493816,4443594802.4,75.532046379765,64.92463583075455,NaN,NaN,21.85423806674156,13.593459854605127
2023-02-01T09:30:00-05:00,191.19,196.19,190.13,194.49,27007326,21942811.25,68.82686322484147,62.4036591509132,NaN,NaN,149.82564086257207,107.39476811375141,0.8633887907846689,3.3769843526567627,2.5135955618720938,4488501142,4457308620.4,78.29842601836513,67.19321197403225,NaN,NaN,24.535338852949458,15.156585425797175
2023-02-02T09:30:00-05:00,196.01,199.26,194.35,198.32,31020427,22345157.75,72.69303779553469,63.023448580345374,NaN,NaN,192.99068167003153,126.28984737507594,1.1598276445635864,3.963380117576577,2.8035524730129904,4519521569,4473552699.8,81.03379532393394,68.97119064967421,NaN,NaN,28.18692382622997,17.018062340144716
2023-02-03T09:30:00-05:00,196.11,199.13,195.7,196.99,24981474,22742600.45,69.47091899277493,63.30486418348288,NaN,NaN,182.29054789231245,141.85775088893115,1.174392747862039,4.271543407840539,3.0971506599785004,4494540095,4480796514.4,82.11632170883169,70.31815967667272,NaN,NaN,30.059093197738985,18.88106674837247
2023-02-06T09:30:00-05:00,195.65,196.38,193.37,194.14,18160086,22551259.45,63.024264166697506,63.16547892332489,NaN,NaN,123.21966294356066,150.78849673444486,0.9118417907482774,4.236952898413847,3.3251111076655695,4476380009,4488087326.2,83.15825155479595,71.48331437427028,NaN,NaN,29.509634977076644,20.39943363818735
2023-02-07T09:30:00-05:00,193.41,196.1,191.65,195.58,27074054,22986639.55,64.80154980133008,63.649768229183174,NaN,NaN,105.79996635262057,150.82529994421944,0.7610627165051547,4.276439503297013,3.515376786791858,4503454063,4496479375.6,84.29263965986068,72.64247197066437,NaN,NaN,29.626012513140505,21.71751633460923
2023-02-08T09:30:00-05:00,194.36,195.37,192.2,192.72,17933496,22945758.5,58.76047860515442,63.96341458009546,NaN,NaN,77.76956662079307,136.41408509586364,0.41209361099257924,4.030493800532582,3.618400189540003,4485520567,4495883260.6,83.8605450287624,73.91645794053792,NaN,NaN,27.75588506831746,22.580140439424692
2023-02-09T09:30:00-05:00,194.23,195.12,189.43,189.93,20516649,23060456.15,53.51893857854188,63.56507879689606,NaN,NaN,38.331449362390494,105.48223863433543,-0.03927563761582631,3.56930564252022,3.6085812801360464,4465003918,4484979730.4,76.16939173420073,74.73917554353649,NaN,NaN,24.444352837314955,22.846456496266157
2023-02-10T09:30:00-05:00,189.28,190.63,188.5328,190.31,15248731,22340354.6,54.119238486013074,62.98037120142749,NaN,NaN,4.427710340623928,69.90967112399773,-0.3287742788071535,3.1976134316271043,3.526387710434258,4480252649,4482122241.2,74.24754808320701,75.54008266639451,NaN,NaN,22.004650012353473,22.726198427135774
2023-02-13T09:30:00-05:00,190.51,192.855,189.31,192.6,15754366,22022073.65,57.66740279447894,62.71383461922003,NaN,NaN,32.82361088224001,51.83046071173361,-0.3789984811018323,3.0526396090569676,3.4316380901588,4496007015,4486047642.4,75.17421712689693,76.49942938982863,NaN,NaN,21.009203423802877,22.480913426659647
2023-02-14T09:30:00-05:00,191.28,193.95,190.08,192.51,21889612,21995426.15,57.47926501148648,62.3788347239137,NaN,NaN,39.398270829614,38.55012160713229,-0.4276394906205274,2.8970887268831405,3.324728217503668,4474117403,4480180310.4,71.05833979791684,77.00627497300506,NaN,NaN,20.15729991150964,22.148968638781074
2023-02-15T09:30:00-05:00,190.98,194.5537,190.53,194.46,18782880,21759182.15,60.48714706901837,62.140153521201476,NaN,NaN,52.37293532668249,33.47079534831017,-0.34157563239462485,2.897758677010387,3.2393343094050118,4492900283,4481656253.6,71.48133588623647,77.20760089611865,NaN,NaN,20.298830132741205,21.884663137918235
2023-02-16T09:30:00-05:00,191.8,194.87,191.25,192.6,21366255,21596272.2,56.38961654233568,61.50130468745023,NaN,NaN,40.62841817105618,33.93018911004331,-0.4179597615807684,2.7168846074290514,3.1348443690098198,4471534028,4482962275.6,71.87307834610257,77.21533740618706,NaN,NaN,19.21335117432625,21.503047143119378
2023-02-17T09:30:00-05:00,191.88,193.3699,190.97,193.13,23892199,20987369.65,57.277715125095895,61.410807942401696,NaN,NaN,25.164312610431523,38.077509564004814,-0.43868212850011945,2.5864917083846706,3.02517383688479,4495426227,4485996991.2,72.80777024114082,77.22169334928687,NaN,NaN,18.567925747526022,21.083744086606043
2023-02-21T09:30:00-05:00,190.75,191.3383,187.24,187.43,26004028,21271076,46.346429889091795,60.06163329159968,NaN,NaN,-75.56157201532208,16.40047298449242,-0.8200146807391095,2.000155485960903,2.8201701667000125,4469422199,4480680028,68.51197938787456,76.72025999272326,NaN,NaN,14.409604987665098,20.130295643900194
2023-02-22T09:30:00-05:00,187.83,189.15,186.7515,187.94,24651715,21540489.15,47.31526604254058,58.52509063572104,NaN,NaN,-97.77441693863496,-11.034064569157369,-1.0092039568086788,1.5586652206891642,2.567869177497843,4494073914,4484671330.2,69.9455208056873,76.1236239061034,NaN,NaN,11.377586059078517,18.87990856035424
2023-02-23T09:30:00-05:00,189.35,190.3,186.7,189.28,21311725,21697346.55,49.87629327982215,56.895323170313006,NaN,NaN,-83.63511181202642,-38.23567399689915,-1.012775094409883,1.3019003094854895,2.3146754038953725,4515385639,4489168401.4,71.51885906064909,75.44398560158307,NaN,NaN,9.607288168076533,17.55524850431457
2023-02-24T09:30:00-05:00,186.65,187.78,185.78,187.51,24280697,21992925.4,46.65048383068718,55.26529208730674,NaN,NaN,-127.19878042141485,-71.80111371539336,-1.0959817890753647,0.9446981675511665,2.0406799566265312,4491104942,4493082584.2,72.85103678924627,74.7821795358984,NaN,NaN,7.133055218709641,16.066363749228152
2023-02-27T09:30:00-05:00,189.13,190.2,187.6,188.17,17562854,21870075.6,48.0009851356482,54.19220072794608,NaN,NaN,-81.02622065538863,-93.03922036855738,-1.0671657884161827,0.7067227211063027,1.7738885095224854,4508667796,4495730898,73.74581689284562,74.10986277433051,NaN,NaN,5.480084715362598,14.554038172961645
2023-02-28T09:30:00-05:00,188.12,190.02,188.07,188.18,19542637,21927453.85,48.02245459150414,52.99369392724422,NaN,NaN,-81.21032481166428,-94.16897092782582,-1.0086959097227175,0.5130186223690885,1.521714532091806,4528210433,4507488544.8,77.31975097334366,73.61179929672214,NaN,NaN,4.134751733288692,13.065568681579794
2023-03-01T09:30:00-05:00,188.19,189.49,187.19,188.42,22532791,21975700.1,48.571271688359055,52.26589343318741,NaN,NaN,-86.30898958209818,-91.87588545651847,-0.9177275577319275,0.3745550849268966,1.292282642658824,4550743224,4518822406.8,80.12797837704795,73.34518739302825,NaN,NaN,3.1524259320015577,11.649405431640046
2023-03-02T09:30:00-05:00,186.86,189.3,186.12,188.87,18134836,21532075.6,49.644869328897464,51.98917420106995,NaN,NaN,-83.25716679581271,-91.80029645327572,-0.7956651074648833,0.2977012583277201,1.0933663657926034,4568878060,4529520891,82.34959057262827,73.78663016720166,NaN,NaN,2.590063585868784,10.35521373938701
2023-03-03T09:30:00-05:00,189.67,191.93,188.42,191.5,22774335,21119771,55.49270167896946,52.08727871485255,NaN,NaN,-11.372604764889141,-68.6350613219706,-0.5195762052837825,0.44389610918787525,0.9634723144716577,4591652395,4549630381.6,85.60680844021249,74.59800590698777,NaN,NaN,3.6803841344691812,9.401666652970176
2023-03-06T09:30:00-05:00,191.56,191.74,187.9,188.7,23266746,21034034.6,48.97211048658988,51.46618640714619,NaN,NaN,-37.934009032139336,-60.01661899732072,-0.5067652387574062,0.3300157660248999,0.8367810047823061,4568385649,4561573952.2,87.12634666555613,75.45172944546343,NaN,NaN,2.7862063757325797,8.45660089907909
2023-03-07T09:30:00-05:00,188.65,189.07,186.22,186.51,25865711,21419315.85,44.56165740683254,50.54350014967091,NaN,NaN,-99.61002295629073,-63.696558626246016,-0.6195595583766901,0.062331556811443534,0.6818911151881336,4542519938,4564435853.2,87.46776601286022,76.62383131795937,NaN,NaN,0.6788446616907794,7.345492865166475
2023-03-08T09:30:00-05:00,186.79,187.61,185.12,186.6,22505855,21190905.9,44.78174731204862,49.42168588131592,NaN,NaN,-119.60362110206317,-70.35548493023902,-0.6582515982932567,-0.1409233826784373,0.5173282156148195,4565025793,4567292367,87.81512131364295,77.79053027705983,NaN,NaN,-0.9660355259776031,6.158131666431606
2023-03-09T09:30:00-05:00,186.73,187.27,181.28,181.41,33546890,21971575.6,35.924641057051005,47.95990191808131,NaN,NaN,-205.55843150860537,-94.81573787279754,-0.9839264406380225,-0.7125798351827086,0.27134660545531386,4531478903,4559812535.6,81.44904829695605,78.47452813069222,NaN,NaN,-5.461743590250874,4.498149486905538
2023-03-10T09:30:00-05:00,180.39,180.39,174.255,176.18,69274206,24409453.45,29.57637911206109,45.98123506000739,NaN,NaN,-330.18964892353506,-158.57914670452675,-1.472714269542763,-1.56954623147314,-0.09683196193037691,4462204697,4533922996,64.12193762906246,77.85411151554376,NaN,NaN,-11.864232073320737,2.160666406873213
2023-03-13T09:30:00-04:00,172.52,176.4,171.07,173.31,74171456,27355589.7,26.77975620159654,44.583615510900586,NaN,NaN,-293.60052853736164,-209.7124506055712,-1.8841487923953992,-2.452017952424626,-0.5678691600292267,4388033241,4497852514.4,48.60696708369646,76.43232492238819,NaN,NaN,-18.131002722438314,-0.7381434687427193
2023-03-14T09:30:00-04:00,178.6,179.26,174.61,176.52,48946152,29015179,34.266353152175355,43.65155030444593,NaN,NaN,-178.78286301297553,-225.54701861690813,-1.83322593181254,-2.8594015747949015,-1.0261756429823616,4436979393,4476744405.4,42.175800963395226,74.44877350508162,NaN,NaN,-20.653995961261387,-3.583265253388243
2023-03-15T09:30:00-04:00,171.93,173.91,170.3762,173.61,54405755,30640986.15,31.156274033509277,42.314406072566435,NaN,NaN,-190.1861424209079,-239.6635228806771,-1.8815616909831343,-3.3781277567112795,-1.4965660657281452,4382573638,4440253974.4,33.840176013789105,71.75743900173447,NaN,NaN,-23.815469406098007,-6.473580132346781
2023-03-16T09:30:00-04:00,171.47,177.38,170.495,175.98,52891037,32346394,36.23252204117781,41.570265944744335,NaN,NaN,-132.43687457330225,-225.0392114936165,-1.6483312650375759,-3.556980147025115,-1.9086488819875391,4435464675,4421051128.8,30.431614747543648,68.72748028447,NaN,NaN,-24.605552956191694,-9.063861964324625
2023-03-17T09:30:00-04:00,174.04,174.76,170.86,171.23,70241665,34790164.5,31.257819764080295,40.374325561060914,NaN,NaN,-134.45911491878945,-185.89310469266735,-1.7014718194333733,-4.035488656279256,-2.3340168368458825,4365223010,4401654791.4,27.426583289668585,65.41896359852879,NaN,NaN,-27.068143351525503,-11.635902162496178
2023-03-20T09:30:00-04:00,173.05,175.37,172.525,173.45,46103382,35900723.65,35.701218818887355,39.494237291588284,NaN,NaN,-101.6769607323284,-147.5083911316607,-1.4826313254493195,-4.187305993657532,-2.704674668208212,4411326392,4406313421.6,29.234055074482157,61.9842710343244,NaN,NaN,-27.46898488648906,-13.89777112306659
2023-03-21T09:30:00-04:00,176.55,178.18,175.96,176.65,34465882,36323816.35,41.56461958024386,38.99376214100863,NaN,NaN,-59.82970624641809,-123.7177597783492,-1.0388698325631829,-4.003261958912191,-2.964392126349008,4445792274,4408075997.8,29.944953787168984,58.39976927790447,NaN,NaN,-25.744135679843282,-15.590108916891833
2023-03-22T09:30:00-04:00,176.52,177.35,171.53,171.64,56098335,37896147.35,36.02562662386244,38.020959090648994,NaN,NaN,-84.77213602088482,-102.6349584983446,-0.9989701512001519,-4.2131048153491975,-3.2141346641490456,4389693939,4409500058,30.55198134581535,54.69994004741783,NaN,NaN,-26.244527530156645,-17.112168718786805
2023-03-23T09:30:00-04:00,172.28,174.39,168.71,170.25,47720850,39216603.6,34.64612129587054,36.53191763471335,NaN,NaN,-97.13828996501742,-95.57524157668763,-0.9809980383590506,-4.440382212097859,-3.4593841737388082,4341973089,4390801740.8,27.217173165136273,50.52925181348382,NaN,NaN,-27.102056320309988,-18.5392955190044
2023-03-24T09:30:00-04:00,168.75,172.105,167.455,171.79,47538469,40379492.2,37.501552315688194,35.712592051077515,NaN,NaN,-93.55739760024156,-87.39489811297805,-0.7884901805618512,-4.444996899441122,-3.656506718879271,4389511558,4395659450.4,29.37397358571893,46.40408230778116,NaN,NaN,-26.848462777754385,-19.726319413111543
2023-03-27T09:30:00-04:00,173.84,174.73,172.36,173.7,33880623,41195380.65,40.9477042543919,35.45445254018889,NaN,NaN,-58.11955351153518,-78.68341666881939,-0.4712686149261458,-4.245592487536953,-3.7743238726108075,4423392181,4398072608.2,30.476156489815722,42.33325305613513,NaN,NaN,-25.534938953693022,-20.556122204623183
2023-03-28T09:30:00-04:00,173.1,174.505,172.69,173.45,28555089,41646003.25,40.63189590866662,35.15803458280447,NaN,NaN,-54.27257932705632,-77.57199128494705,-0.22928022932260328,-4.0609241592640615,-3.831643929941458,4394837092,4387881571.8,28.45645577053125,38.0933483744843,NaN,NaN,-24.58615929302648,-21.131841788680795
2023-03-29T09:30:00-04:00,175.34,175.55,173.5719,175.42,25564793,41797603.35,44.27880838816081,35.75476082074088,NaN,NaN,-36.62152996580653,-67.94187007393138,0.09506581520199209,-3.712811660938968,-3.80787747614096,4420401885,4394023161,31.406684676259005,34.51889383014879,NaN,NaN,-22.688024949813535,-21.354153668842613
2023-03-30T09:30:00-04:00,176.88,177.305,174.445,175.18,26728564,42227289.75,43.92480153641016,36.77964813676581,NaN,NaN,-22.89468390344947,-53.09314886161779,0.31277557793516797,-3.416908003722,-3.729683581657168,4393673321,4404363207.4,36.1784493914657,32.52293038460616,NaN,NaN,-21.245559255092775,-21.338640181164067
2023-03-31T09:30:00-04:00,176.4,178.64,176.37,178.4,39602850,43068715.5,49.73164033716581,38.41906843216361,NaN,NaN,17.42836369939962,-30.895996601689557,0.6723313176177821,-2.88926943463494,-3.561600752252722,4433276171,4413116130,39.98451138171922,31.90704069160779,NaN,NaN,-18.22774214351039,-20.89422617578497
2023-04-03T09:30:00-04:00,178.95,179.78,176.49,178.48,27608982,43285827.3,49.870533488662836,39.533652741912725,NaN,NaN,40.33516464919099,-11.205052969544322,0.9000250181682472,-2.4365694795424133,-3.3365944977106605,4460885153,4420614724.4,43.11435508416593,31.974080271662842,NaN,NaN,-15.739016380032266,-20.157767633534583
2023-04-04T09:30:00-04:00,178.92,179.1,174.32,175.35,33487181,43666900.8,44.67007285533347,40.498924086328735,NaN,NaN,15.303688579142854,2.710200611695516,0.8262280272266116,-2.3038094636773963,-3.130037490904008,4427397972,4427126900.4,45.759874419787884,32.82548730066275,NaN,NaN,-15.003449558574447,-19.42143647996885
2023-04-05T09:30:00-04:00,174.25,174.83,172.53,173.63,28243090,43953762.55,42.073642351673215,40.91614696564984,NaN,NaN,-39.669523906017865,2.1006018236532484,0.655430837092029,-2.3107489445389717,-2.9661797816310007,4399154882,4422877499.8,44.31172575837711,33.816923801436566,NaN,NaN,-15.128853421734433,-18.808210328792505
2023-04-06T09:30:00-04:00,173.72,174.46,172.68,173.89,26366279,43594732,42.61661232070299,41.727489291122886,NaN,NaN,-31.03735402428098,0.47206779948694333,0.5576543871464894,-2.2691117976978887,-2.826766184844378,4425521161,4429247067.8,47.01830744103257,35.21633266939114,NaN,NaN,-15.081147612686454,-18.27577279792021
2023-04-10T09:30:00-04:00,173.07,175.88,173.03,175.75,22237792,41242911.3,46.48142467008704,42.497503994780004,NaN,NaN,19.920738015383815,0.9705426626837828,0.6116087805367592,-2.062255209173429,-2.6738639897101883,4447758953,4432143624.2,48.25006124787465,36.574618824633454,NaN,NaN,-13.954836476945893,-17.658496180638167
2023-04-11T09:30:00-04:00,176.57,177.97,176.12,177.14,21876241,38628150.55,49.23317346059,43.045257843376156,NaN,NaN,95.96142081424944,12.09579389569547,0.7264484664372075,-1.7658034066636787,-2.4922518731008863,4469635194,4433893632.4,49.02119640156666,37.93720758280472,NaN,NaN,-12.216127701910938,-16.88101496939142
2023-04-12T09:30:00-04:00,178.82,178.98,175.58,175.84,27018113,37531748.6,46.809089439778475,43.81550518737016,NaN,NaN,85.362917145999,26.107639609066702,0.7001045493704874,-1.6171211863877772,-2.3172257357582646,4442617081,4436937454.2,50.40545861198696,39.35531310181698,NaN,NaN,-11.392243485300991,-16.0969047573785
2023-04-13T09:30:00-04:00,176.54,178.685,175.93,178.17,23259875,35974454.6,51.42541267158433,45.014025999921145,NaN,NaN,103.34458786140517,54.710461962551314,0.8167129165822482,-1.2963345900304546,-2.113047506612703,4465876956,4450281869,56.04106761011209,41.41416270502953,NaN,NaN,-9.337664519076654,-15.131299009049664
2023-04-14T09:30:00-04:00,178.33,179.22,175.34,176.51,29600374,34809921.45,48.21488255036497,45.77926387382662,NaN,NaN,73.41597836125625,75.60112843965877,0.7603142702649628,-1.1626546687814994,-1.9229689390464622,4436276582,4452432953.2,56.89144749015284,43.37969655534624,NaN,NaN,-8.48171446342107,-14.181358359674151
2023-04-17T09:30:00-04:00,176.97,178.86,176.75,178.78,22177347,32406705.55,52.575097159666086,46.609791938489074,NaN,NaN,100.63510868310608,91.7440025732032,0.8475051985905162,-0.8635874408083168,-1.711092639398833,4458453929,4454571948.4,57.76635370457501,45.32899635640048,NaN,NaN,-6.449959729254877,-13.076872841042826
2023-04-18T09:30:00-04:00,179.59,179.63,176.94,178.02,22692960,31236184.45,51.02604089866478,47.35223086634608,NaN,NaN,92.68860888518383,91.08944018739008,0.824825440823092,-0.6800608383699682,-1.5048862791930602,4435760969,4447797103.4,54.02630253542667,47.15541398246444,NaN,NaN,-5.197750147199167,-11.951283884779446
2023-04-19T09:30:00-04:00,177.08,178.79,176.58,178.25,19306758,30478228.25,51.49184232616198,47.867447576203304,NaN,NaN,78.49969221576562,89.7167952013434,0.7957693190949964,-0.5101746303243146,-1.305943949419311,4455067727,4450287232.6,55.17506299214285,48.85315529074186,NaN,NaN,-4.035384512227433,-10.820441117272015
2023-04-20T09:30:00-04:00,177.15,178.43,176.52,177.33,20336276,28690125.3,49.4651868364843,48.26318938335146,NaN,NaN,58.34703619043008,80.7172848671484,0.6890357532448852,-0.44464925786320464,-1.1336850111080898,4434731451,4444058131.6,51.69522782514873,49.9614966074335,NaN,NaN,-3.583409398306629,-9.786579443134103
2023-04-21T09:30:00-04:00,177.81,177.958,175.86,177.56,25972820,27602723.8,49.995068664634914,48.282005692456394,NaN,NaN,42.81098464614951,74.59628612412703,0.6110304817030663,-0.369896908979257,-0.9809273906823233,4460704271,4448943669.4,54.13830734551891,50.97248203341919,NaN,NaN,-3.065680807033846,-8.826451066548353