time,open,high,low,close,Volume,Volume MA,RSI,RSI-based MA,Upper Bollinger Band,Lower Bollinger Band,CCI,Smoothing Line,Histogram,MACD,Signal,OnBalanceVolume,Smoothing Line,RSI,RSI-based MA,Upper Bollinger Band,Lower Bollinger Band,True Strength Index,Signal
1998-01-20T09:30:00-05:00,77.8125,78.84399,77.40601,78.813,1743200,NaN,NaN,NaN,NaN,NaN,NaN,NaN,NaN,NaN,NaN,NaN,NaN,NaN,NaN,NaN,NaN,NaN,NaN
1998-01-21T09:30:00-05:00,78.09375,78.375,77.28125,77.84375,1839600,NaN,NaN,NaN,NaN,NaN,NaN,NaN,NaN,NaN,NaN,-1839600,NaN,NaN,NaN,NaN,NaN,NaN,NaN
1998-01-22T09:30:00-05:00,77.1875,77.85899,76.938,77.188,1662600,NaN,NaN,NaN,NaN,NaN,NaN,NaN,NaN,NaN,NaN,-3502200,NaN,NaN,NaN,NaN,NaN,NaN,NaN
1998-01-23T09:30:00-05:00,77.5,77.75,76.3125,77,1693700,NaN,NaN,NaN,NaN,NaN,NaN,NaN,NaN,NaN,NaN,-5195900,NaN,NaN,NaN,NaN,NaN,NaN,NaN
1998-01-26T09:30:00-05:00,77.375,77.67187,76.9375,77.3125,1172800,NaN,NaN,NaN,NaN,NaN,NaN,NaN,NaN,NaN,NaN,-4023100,NaN,NaN,NaN,NaN,NaN,NaN,NaN
1998-01-27T09:30:00-05:00,77.125,78.5625,77.07812,78.21875,1454500,NaN,NaN,NaN,NaN,NaN,NaN,NaN,NaN,NaN,NaN,-2568600,-3425880,NaN,NaN,NaN,NaN,NaN,NaN
1998-01-28T09:30:00-05:00,78.375,79.23437,78.21875,79.125,1181200,NaN,NaN,NaN,NaN,NaN,NaN,NaN,NaN,NaN,NaN,-1387400,-3335440,NaN,NaN,NaN,NaN,NaN,NaN
1998-01-29T09:30:00-05:00,79.0625,80.25,78.89062,79.40625,1468500,NaN,NaN,NaN,NaN,NaN,NaN,NaN,NaN,NaN,NaN,81100,-2618780,NaN,NaN,NaN,NaN,NaN,NaN
1998-01-30T09:30:00-05:00,79.9375,79.9375,78.96875,79.23437,1095600,NaN,NaN,NaN,NaN,NaN,NaN,NaN,NaN,NaN,NaN,-1014500,-1782500,NaN,NaN,NaN,NaN,NaN,NaN
1998-02-02T09:30:00-05:00,80.625,81.3125,80.40625,81.01562,955600,NaN,NaN,NaN,NaN,NaN,NaN,NaN,NaN,NaN,NaN,-58900,-989660,NaN,NaN,NaN,NaN,NaN,NaN
1998-02-03T09:30:00-05:00,81,81.67187,80.65625,81.65625,619400,NaN,NaN,NaN,NaN,NaN,NaN,NaN,NaN,NaN,NaN,560500,-363840,NaN,NaN,NaN,NaN,NaN,NaN
1998-02-04T09:30:00-05:00,81.21875,81.65625,80.8125,81.21875,753200,NaN,NaN,NaN,NaN,NaN,NaN,NaN,NaN,NaN,NaN,-192700,-124900,NaN,NaN,NaN,NaN,NaN,NaN
1998-02-05T09:30:00-05:00,81.8125,81.90625,80.73437,81.23437,1067600,NaN,NaN,NaN,NaN,NaN,NaN,NaN,NaN,NaN,NaN,874900,33860,NaN,NaN,NaN,NaN,NaN,NaN
1998-02-06T09:30:00-05:00,81.5,82.17187,81.35937,82.10937,1069700,NaN,NaN,NaN,NaN,NaN,NaN,NaN,NaN,NaN,NaN,1944600,625680,NaN,NaN,NaN,NaN,NaN,NaN
1998-02-09T09:30:00-05:00,82.09375,82.25,81.4375,81.78125,515900,NaN,67.52368863830915,NaN,NaN,NaN,NaN,NaN,NaN,NaN,NaN,1428700,923200,NaN,NaN,NaN,NaN,NaN,NaN
1998-02-10T09:30:00-05:00,82.03125,83.34375,81.92187,83.15625,892100,NaN,72.35683734666146,NaN,NaN,NaN,NaN,NaN,NaN,NaN,NaN,2320800,1275260,NaN,NaN,NaN,NaN,NaN,NaN
1998-02-11T09:30:00-05:00,82.96875,83.39062,82.84375,83.15625,515000,NaN,72.35683734666146,NaN,NaN,NaN,NaN,NaN,NaN,NaN,NaN,2320800,1777960,NaN,NaN,NaN,NaN,NaN,NaN
1998-02-12T09:30:00-05:00,82.73437,84.10937,82.375,83.6875,1065000,NaN,74.08498384972197,NaN,NaN,NaN,NaN,NaN,NaN,NaN,NaN,3385800,2280140,NaN,NaN,NaN,NaN,NaN,NaN
1998-02-13T09:30:00-05:00,83.34375,83.84375,83.17187,83.64062,596700,NaN,73.64743775386059,NaN,NaN,NaN,NaN,NaN,NaN,NaN,NaN,2789100,2449040,NaN,NaN,NaN,NaN,NaN,NaN
1998-02-17T09:30:00-05:00,84.3125,84.71875,83.89062,84.0625,840600,1110125,75.07412895891696,NaN,NaN,NaN,122.22722498347237,NaN,NaN,NaN,NaN,3629700,2889240,100,NaN,NaN,NaN,NaN,NaN
1998-02-18T09:30:00-05:00,84.07812,84.70312,83.84375,84.625,773000,1061615,76.8720190157858,NaN,NaN,NaN,116.07626439486891,NaN,NaN,NaN,NaN,4402700,3305620,100,NaN,NaN,NaN,NaN,NaN
1998-02-19T09:30:00-05:00,84.64062,84.70312,83.82812,83.82812,804800,1009875,69.25130234040526,NaN,NaN,NaN,100.08228638813388,NaN,NaN,NaN,NaN,3597900,3561040,100,NaN,NaN,NaN,NaN,NaN
1998-02-20T09:30:00-05:00,84.07812,84.46875,83.3125,84.28125,540600,953775,71.01114240653881,NaN,NaN,NaN,90.43251149823625,NaN,NaN,NaN,NaN,4138500,3711580,100,NaN,NaN,NaN,NaN,NaN
1998-02-23T09:30:00-05:00,85,85,83.96875,84.25,639200,901050,70.71057441522606,NaN,NaN,NaN,96.30060900111832,105.02377925316596,NaN,NaN,NaN,3499300,3853620,100,NaN,NaN,NaN,NaN,NaN
1998-02-24T09:30:00-05:00,84.125,84.40625,83.53125,84,702700,877545,68.22274781328422,NaN,NaN,NaN,73.64216409209246,95.30676707488996,NaN,NaN,NaN,2796600,3687000,96.85747190945271,NaN,NaN,NaN,NaN,NaN
1998-02-25T09:30:00-05:00,84.25,85.15625,84.07812,84.6875,687400,839190,71.2213792852819,NaN,NaN,NaN,92.81725212428707,90.6549646207736,NaN,2.0790260330943227,NaN,3484000,3503260,93.37280834135693,NaN,NaN,NaN,NaN,NaN
1998-02-26T09:30:00-05:00,84.60937,85.21875,84.40625,85.15625,439800,802120,73.08619177535276,NaN,NaN,NaN,99.39443588425844,90.5173945199985,NaN,2.0584140770934027,NaN,3923800,3568440,93.46265959739752,NaN,NaN,NaN,NaN,NaN
1998-02-27T09:30:00-05:00,85.10937,85.95312,84.89062,85.59375,451300,751260,74.73192277358467,72.15365669425651,NaN,NaN,118.306029099346,96.09209804022046,NaN,2.0537076833366257,NaN,4375100,3615760,93.53122917129043,NaN,NaN,NaN,NaN,NaN
1998-03-02T09:30:00-05:00,85.75,85.85937,85.28125,85.71875,1062800,749620,75.19855773256961,72.70186162956082,NaN,NaN,121.04617259947716,101.04121075989222,NaN,2.036587771608822,NaN,5437900,4003480,94.07921322853997,NaN,NaN,NaN,NaN,NaN
1998-03-03T09:30:00-05:00,85.21875,86.125,85.1875,86.10937,596600,731670,76.64975252116452,73.00849842773961,NaN,NaN,122.61150082963601,110.83507810740093,NaN,2.0311263277011733,NaN,6034500,4651060,94.86208867017737,NaN,NaN,NaN,NaN,NaN
1998-03-04T09:30:00-05:00,85.625,85.875,85.10937,85.53125,691700,735285,70.11116200832019,72.84809304642953,NaN,NaN,99.1918084235108,112.10998936724567,NaN,1.9575828451216637,NaN,5342800,5022820,95.25035383004071,NaN,NaN,NaN,NaN,NaN
1998-03-05T09:30:00-05:00,84.5,85.26562,84.21875,84.78125,778300,736540,62.64514838526985,72.0309619418258,NaN,NaN,50.94704916856827,102.42051202410767,NaN,1.817825611247443,NaN,4564500,5150960,95.37995089093758,NaN,NaN,NaN,NaN,NaN
1998-03-06T09:30:00-05:00,85.09375,86.03125,85.09375,86.03125,933100,729815,68.63921970307891,71.67323208105567,NaN,NaN,109.69226959359015,100.6977601229565,NaN,1.787328341274801,NaN,5497600,5375460,95.6061522490807,96.60013770630528,NaN,NaN,NaN,NaN
1998-03-09T09:30:00-05:00,85.625,86.57812,85.59375,85.875,685300,710595,67.18790797312423,71.10993058207049,NaN,NaN,122.21027255993495,100.93058011504806,-0.21964281700501131,1.730601667179144,1.9502444841841553,4812300,5250340,92.87685284257967,96.09134148077526,NaN,NaN,NaN,NaN
1998-03-10T09:30:00-05:00,86.375,86.75,86.15625,86.71875,563700,712985,70.78073344552423,70.67483875562324,NaN,NaN,148.14369798956082,106.03701954703301,-0.17320084515961431,1.7337434277346375,1.9069442728942518,5376000,5118640,89.96556351725506,95.37459601772206,NaN,NaN,NaN,NaN
1998-03-11T09:30:00-05:00,86.9375,87.23437,86.73437,87,406600,688710,71.88580715863358,70.86301767121097,NaN,NaN,160.22328255222968,118.24331437277678,-0.13444897141698786,1.738883058623017,1.873332030040005,5782600,5206600,90.18680792679143,94.67365372677857,NaN,NaN,NaN,NaN
1998-03-12T09:30:00-05:00,86.9375,87.0625,86.3125,86.89062,576700,691795,70.76489932986584,70.84542888002004,NaN,NaN,126.13960340366101,133.28182521979534,-0.12717119705424773,1.7143680337221952,1.8415392307764429,5205900,5334880,90.51525353394712,93.99617183634622,NaN,NaN,NaN,NaN
1998-03-13T09:30:00-05:00,87.1875,87.25,86.09375,86.15625,458900,661490,63.595024420709656,70.33717530898316,NaN,NaN,96.93809612403062,130.73099052588344,-0.1795978442134658,1.6170419255096107,1.7966397697230765,4747000,5184760,86.85175481609878,93.05701146606758,NaN,NaN,41.239685415324246,NaN
1998-03-16T09:30:00-05:00,86.5625,87.46875,86.34375,87.46875,733000,668305,69.53590743226268,70.43097242462446,NaN,NaN,128.6865362079828,132.02624325549303,-0.13566197328644103,1.627062303115025,1.7627242764014661,5480000,5318300,87.34252573931632,92.37737245391497,NaN,NaN,40.92678244303487,NaN
1998-03-17T09:30:00-05:00,87.28125,87.78125,87.07812,87.76562,499900,651270,70.70057256392003,70.39377194452719,NaN,NaN,145.34263720766677,131.46603109911422,-0.09813706665415411,1.6400529430837736,1.7381900097379277,5979900,5439080,87.78656087747109,91.97835477792312,NaN,NaN,41.04049866672751,NaN
1998-03-18T09:30:00-05:00,87.59375,88.01562,87.28125,87.98437,410900,633165,71.56327078455466,70.2849918737559,NaN,NaN,141.94581909909937,127.81053840848816,-0.07135930752486419,1.6489908753318474,1.7203501828567116,6390800,5560720,88.23422957248295,91.60489549042923,NaN,NaN,41.39172839914884,NaN
1998-03-19T09:30:00-05:00,88,88.29687,87.84375,88.23437,730000,629425,72.5577508943552,70.12969388238236,NaN,NaN,145.67329937408851,131.71727760257366,-0.050564442334660065,1.6571446299383865,1.7077090722730466,7120800,5943700,89.53484469180177,91.31943945618004,NaN,NaN,41.97112647910515,NaN
1998-03-20T09:30:00-05:00,88.5625,89.40625,88.28125,89.15625,754300,640110,75.90415028567791,70.18009335046152,NaN,NaN,171.48443819317393,146.6265460164023,0.008383418205290427,1.7181883450296596,1.7098049268243691,7875100,6569320,91.2386457418072,91.11654177855625,NaN,NaN,43.521761625523325,NaN
1998-03-23T09:30:00-05:00,89.1875,89.1875,88.39062,88.48437,551600,635730,69.2739029333289,69.65324695133042,NaN,NaN,137.39284183772324,148.3678071423504,-0.013574454564008409,1.6928368586193585,1.706411313183367,7323500,6938020,92.05916122261418,90.91633267515888,NaN,NaN,42.78350060099612,NaN
1998-03-24T09:30:00-05:00,88.96875,89.85937,88.92187,89.4375,470300,624110,72.8914603995506,69.85183969356115,NaN,NaN,159.76468393522225,151.2522164878615,0.018643875215320405,1.7297161572025175,1.711072281987197,7793800,7300800,92.77604004430262,90.7395959761776,NaN,NaN,43.30215918882099,NaN
1998-03-25T09:30:00-05:00,90.0625,90.0625,88.25,88.875,966200,638050,67.81687152693128,70.22124848939411,NaN,NaN,123.72809083196378,147.60867083443435,-0.013636597875470446,1.694026534642859,1.7076631325183294,6827600,7388160,92.94129644415811,90.5654063728362,NaN,NaN,42.10365050428908,NaN
1998-03-26T09:30:00-05:00,88.84375,89.29687,88.51562,88.625,412800,636700,65.6299731456724,70.00630230672222,NaN,NaN,98.13160203616027,138.1003313668487,-0.06467737480745273,1.6268164140090136,1.6914937888164663,6414800,7246960,89.3821921547425,90.12083779466919,NaN,NaN,40.461975148711545,NaN
1998-03-27T09:30:00-05:00,89.34375,89.40625,87.875,88.26562,584100,643340,62.509397301603556,69.67212297304216,NaN,NaN,72.72230982462233,118.34790569313839,-0.13163406812024658,1.526951203666158,1.6585852717864047,5830700,6838080,79.84686277486342,89.19012421840372,NaN,NaN,38.15876061389516,NaN
1998-03-30T09:30:00-05:00,88.28125,88.5625,87.6875,88.15625,562400,618320,61.55023691107655,69.0128017920102,NaN,NaN,45.84461900990491,100.03826112757471,-0.18880149417471825,1.422583404068007,1.6113848982427252,5268300,6427040,71.57985383452447,87.87685924106583,NaN,NaN,36.00805733654457,NaN
1998-03-31T09:30:00-05:00,88.46875,89.3125,88.0625,88.1875,620000,619490,61.73092535517554,68.2874530917632,NaN,NaN,61.74635543550032,80.43459542763034,-0.22743202954093777,1.327094861316553,1.5545268908574907,5888300,6045940,64.87334659625034,86.0687548603129,NaN,NaN,34.29521241049478,40.55422298712433
1998-04-01T09:30:00-05:00,88.35937,89.20312,87.71875,88.9375,373700,603590,65.8756613976965,67.93822181089396,NaN,NaN,61.87271623718672,68.06352050867493,-0.20603161497615674,1.2969873721372949,1.5030189871134516,6262000,5932820,62.98691501103515,84.1024449658192,NaN,NaN,33.91867521365054,39.60628759091379
1998-04-02T09:30:00-05:00,88.90625,90.25,88.82812,90.15625,440600,586705,71.31284970353731,68.48949504538164,NaN,NaN,125.22124874522761,73.48144985048839,-0.11774269144039118,1.3558406228129627,1.4735833142533539,6702600,5990380,63.56745263018646,82.43928052396829,NaN,NaN,35.27767632699124,38.987914553210565
1998-04-03T09:30:00-05:00,90.25,90.57812,89.8125,90.09375,493300,564715,70.69080282170023,68.57198757319863,NaN,NaN,143.71691682981574,87.68037125152708,-0.07365561994534486,1.381513789321673,1.4551694092670178,6209300,6066100,64.359396918046,80.79762846530616,NaN,NaN,36.177863742311914,38.58647872308219
1998-04-06T09:30:00-04:00,90.875,91.25,90.34375,90.375,610500,560975,71.87951137029488,68.65619748793968,NaN,NaN,163.02305480140353,111.11605840982679,-0.0374793321212703,1.4083202441154299,1.4457995762367002,6819800,6376400,67.47916712045435,79.34710033980495,NaN,NaN,37.27606994083508,38.39927746847546
1998-04-07T09:30:00-04:00,90.375,90.39062,89.25,89.89062,707300,568155,66.8508030388378,68.31959264895991,NaN,NaN,99.41675964551806,118.65013925183034,-0.05693308600055369,1.3746332187360082,1.4315663047365619,6112500,6421240,67.91621763406098,77.89581377277482,NaN,NaN,36.758898677625155,38.16493764121113
1998-04-08T09:30:00-04:00,90.0625,90.0625,88.82812,89.28125,949500,595300,61.06305752233323,67.4985431223869,NaN,NaN,60.348503012275465,118.3452966068481,-0.11808168214355308,1.2839642020571205,1.4020458842006736,5163000,6201440,63.41714089134785,76.03026350131381,NaN,NaN,34.578663996690956,37.652612834851105
1998-04-09T09:30:00-04:00,89.65625,90.46875,89.625,90.375,451700,589050,66.64500073471677,66.83717529731827,NaN,NaN,109.66813515647584,115.23467388909776,-0.09320001556081836,1.2855458647496505,1.3787458803104689,5614700,5983860,59.23404996404853,73.74422094575962,NaN,NaN,34.362924800150715,37.18265740132248
1998-04-13T09:30:00-04:00,90.73437,90.73437,89.5625,90.34375,337900,583000,66.3523185350806,66.62849069744338,NaN,NaN,104.8609975263336,107.46349002840131,-0.08728303516900882,1.269642086349208,1.3569251215182168,5276800,5797360,55.83437901613156,71.15673650243943,NaN,NaN,34.10442962968096,36.74291057680226
1998-04-14T09:30:00-04:00,90.53125,91.51562,90.53125,91.4375,451500,568925,71.13104832624578,66.5027469779216,NaN,NaN,162.12771926757193,107.28442292163497,-0.02156912307655179,1.329963717672527,1.3515328407490788,5728300,5579060,52.067418359492144,68.24897781066726,NaN,NaN,35.40745675336986,36.55213145916906
1998-04-15T09:30:00-04:00,91.65625,92.01562,91.20312,92.01562,261800,557020,73.29033536032104,66.8937086803066,NaN,NaN,182.0881443382743,123.81869986018623,0.04532237388797933,1.408185808109053,1.3628634342210737,5990100,5554580,51.64662036368501,65.29935809063348,NaN,NaN,37.19506328139888,36.64397886234475
1998-04-16T09:30:00-04:00,91.70312,91.70312,90.79687,91.0625,232800,548115,64.69846679836404,66.82717251264172,NaN,NaN,122.61651578821356,136.27230241537384,0.011621937030857454,1.3773908555096455,1.365768918478788,5757300,5673440,53.60712511681632,62.74399615935302,NaN,NaN,35.90649515585925,36.53862404713254
1998-04-17T09:30:00-04:00,90.73437,91.75,90.57812,91.70312,382900,530760,67.45968227219822,67.18076429625562,NaN,NaN,119.83892161984377,138.3064597080474,0.018321332218696806,1.388670583752159,1.370349251533462,6140200,5778540,55.331738640523746,60.992915864043034,NaN,NaN,35.7430288213654,36.42496758630866
1998-04-20T09:30:00-04:00,91.59375,91.65625,91,91.29687,299400,508015,64.038879621381,67.35852448984879,NaN,NaN,104.7146855599929,138.27719731477927,-0.01685918965139921,1.3492752644692132,1.3661344541206124,5840800,5891340,57.171918158234156,59.96377760145088,NaN,NaN,34.5146916300096,36.15207102112308
1998-04-21T09:30:00-04:00,91.25,91.92187,90.96875,91.90625,372000,499035,66.76160175333543,67.71785851828878,NaN,NaN,110.77858014385032,128.00736949003496,-0.011591451688491627,1.3516451395099978,1.3632365911984894,6212800,5988240,58.74425272645199,59.52598518217956,NaN,NaN,34.34915222282422,35.89451119279467
1998-04-22T09:30:00-04:00,91.85937,92.10937,91.6875,91.84375,503400,500690,66.20792462147367,67.74159160570143,NaN,NaN,115.17656163974513,114.62505295032913,-0.02409906430651998,1.3331127608153395,1.3572118251218594,5709400,5932100,57.42878771279505,59.12897608944812,NaN,NaN,34.051495220087105,35.63122319669359
1998-04-23T09:30:00-04:00,91.71875,92.03125,91.10937,91.3125,597700,482265,61.53633110353691,67.04326884855855,NaN,NaN,81.11601152354392,106.3249520973952,-0.076951855853856,1.2610220053045396,1.3379738611583956,5111700,5802980,54.410883253834285,58.474935419708686,NaN,NaN,32.39163826284239,35.168425349000564
1998-04-24T09:30:00-04:00,91.21875,91.5625,90.0625,90.54687,820200,502635,55.46254429812302,65.95553609687447,NaN,NaN,27.203384598460048,87.79784469311845,-0.16710378847041585,1.1290941255703757,1.2961979140407915,4291500,5433240,46.822969378869416,57.22233345262464,NaN,NaN,29.054095173749545,34.29494960967899
1998-04-27T09:30:00-04:00,89.4375,89.875,88.39062,89.25,1916800,569270,47.000214125478884,64.17844343653046,NaN,NaN,-82.2676037083453,50.401386839450815,-0.3094298192189078,0.9094106400171569,1.2188404592360647,2374700,4740020,36.53545476874636,55.0120682846455,NaN,NaN,23.174007389715253,32.706243578255595
1998-04-28T09:30:00-04:00,90.03125,90.125,88.65625,88.98437,437200,563010,45.46990357525704,62.65123633198898,NaN,NaN,-85.35647396617343,11.174376017446061,-0.4104800173972323,0.7057404374895242,1.1162204548867565,1937500,3884960,28.281469720321383,52.18101486223553,NaN,NaN,17.988211769414715,30.60366760556404
1998-04-29T09:30:00-04:00,89.28125,89.95312,88.92187,89.42187,298700,546945,48.44717107207175,61.750101585541735,NaN,NaN,-79.65523251842264,-27.7919828141875,-0.4345544240489734,0.5730274248255398,1.0075818488745132,2236200,3190320,23.614133785669125,49.337942926115616,NaN,NaN,14.621928838583987,28.320562067424035
1998-04-30T09:30:00-04:00,90.32812,91.3125,90.21875,90.875,443100,550415,56.8702298153451,61.051903662729465,NaN,NaN,20.647543962596487,-39.88567632637699,-0.3433143043261262,0.5784389684668554,0.9217532727929816,2679300,2703840,21.00027589748393,46.60695906421814,NaN,NaN,14.382809329090671,26.329454533376413
1998-05-01T09:30:00-04:00,91.09375,91.65625,90.8125,91.65625,338300,545300,60.59766053954342,60.64085666304824,NaN,NaN,64.57945958966162,-32.41046132813668,-0.22667556054922056,0.6384088221064559,0.8650843826556764,3017600,2449060,19.766263402521588,44.030665091817426,NaN,NaN,15.45239191417988,24.775588444919766
1998-05-04T09:30:00-04:00,91.98437,92.57812,91.8125,91.8125,542500,547760,61.31770505654547,59.93990357235536,NaN,NaN,113.1648480863631,6.676029030805006,-0.13960124738533397,0.690582823424009,0.830184070809343,3560100,2686140,24.228132419902252,42.042144667561004,NaN,NaN,16.5228355011606,23.596623738668455
1998-05-05T09:30:00-04:00,91.5,91.85937,90.96875,91.48437,325600,533515,58.88412218227679,58.9108883453522,NaN,NaN,54.5127966174806,34.64988314753581,-0.10621574646980148,0.6974143877220911,0.8036301341918926,3234500,2945540,28.88788775111321,40.41652090952016,NaN,NaN,16.653363625583843,22.604729436799225
1998-05-06T09:30:00-04:00,91.84375,91.85937,90.28125,90.28125,665500,531425,50.906377497974404,57.925739109610085,NaN,NaN,-1.8066558084701398,50.21959848952631,-0.16382920656367417,0.5988436259872998,0.762672832550974,2569000,3012100,30.07613972252426,38.73573623849931,NaN,NaN,14.177781818049647,21.400879776977856
1998-05-07T09:30:00-04:00,90.625,90.625,89.71875,89.73437,593100,513605,47.740209009655885,56.517205305142774,NaN,NaN,-77.74538540914403,30.54101261517821,-0.23320575609086358,0.4711656374373945,0.7043713935282581,1975900,2871420,28.974145466794184,36.853051011804325,NaN,NaN,11.119944467828015,19.932174732813593
1998-05-08T09:30:00-04:00,89.75,90.98437,89.6875,90.9375,638100,522925,54.45197191654077,55.83242618336847,NaN,NaN,-32.8615283087047,11.052815035504942,-0.19410527587205806,0.4617397986881855,0.6558450745602435,2614000,2790700,28.332672649276077,34.79310490402161,NaN,NaN,10.675912195614655,18.609851513213744
1998-05-11T09:30:00-04:00,91.28125,91.84375,90.6875,90.92187,703100,541185,54.35430802737907,54.946190917228726,NaN,NaN,22.64540086182376,-7.051074409402925,-0.16639921750855535,0.44784605267454936,0.6142452701831047,1910900,2460860,25.8173899268712,32.44118613262298,NaN,NaN,10.300655173003683,17.422823464612307
1998-05-12T09:30:00-04:00,90.90625,91.92187,90.60937,91.92187,479000,542560,59.37475208863594,54.458107164883174,NaN,NaN,53.420198900870204,-7.269593952725005,-0.0820929679998812,0.5116290601832532,0.5937220281831344,2389900,2291940,24.612314702815212,30.097152346195852,NaN,NaN,11.594527736408661,16.590209789154642
1998-05-13T09:30:00-04:00,91.90625,92.35937,91.625,92.25,399400,549440,60.89463220693058,54.41227152941129,NaN,NaN,108.07082359615721,14.705901928200467,-0.009420355427468996,0.581946583898798,0.591366939326267,2789300,2336000,25.58796262168316,28.038372301042198,NaN,NaN,13.119438283282255,16.094385288315728
1998-05-14T09:30:00-04:00,91.5625,92.29687,91.34375,91.8125,622900,568945,57.790185556840484,54.57853161931968,NaN,NaN,77.09095088591096,45.673169187211464,0.0033116534043047263,0.595506506081648,0.5921948526773433,2166400,2374100,26.474094300534773,26.584881224018293,NaN,NaN,13.450144123872601,15.716636550538139
1998-05-15T09:30:00-04:00,91.875,91.875,90.79687,90.79687,280900,563845,51.257326531940606,54.88261107692409,NaN,NaN,16.561197888001537,55.55771442655271,-0.05909583379860117,0.5183250604290919,0.577420894227693,1885500,2228400,25.236431681435334,25.77780814635322,NaN,NaN,11.68356858054136,15.140483983395741
1998-05-18T09:30:00-04:00,90.875,91.32812,90,90.53125,249200,561335,49.67570287118797,55.18302531234774,NaN,NaN,-30.424703752265387,44.94369350373488,-0.11732922042045302,0.4307593687021267,0.5480885891225797,1636300,2173480,24.76642912884867,25.52673381839088,NaN,NaN,9.768036623298906,14.372991503381908
1998-05-19T09:30:00-04:00,91.125,91.3125,90.375,90.5625,482100,566840,49.871679503133755,55.28477591456645,NaN,NaN,-14.761545393344688,31.307344644891902,-0.1506807044269023,0.35973770858895193,0.5104184130158542,2118400,2119180,24.284856500015607,25.574642583701344,NaN,NaN,8.281491127258727,13.50277716393574
1998-05-20T09:30:00-04:00,91.25,91.875,90.64062,91.78125,304400,556890,56.91813003884076,55.28819735910186,NaN,NaN,55.07476941069824,20.70813380780013,-0.09056144642580521,0.3972166049835977,0.4877780514094029,2422800,2045880,23.617255979736726,25.761569732433685,NaN,NaN,9.084422412035952,12.871583627950056
1998-05-21T09:30:00-04:00,91.9375,92.17187,91.10937,91.375,530600,553535,54.18398454766755,54.83007764539644,NaN,NaN,66.35624913472775,18.56119345756349,-0.07850538485895087,0.38964632033571434,0.4681517051946652,1892200,1991040,23.105486483141533,26.000085666763685,NaN,NaN,8.92883069550106,12.30833320902877
1998-05-22T09:30:00-04:00,91.59375,91.59375,90.9375,91.23437,219000,523475,53.23074332676993,54.252437521841046,NaN,NaN,33.83943834650702,22.01684154926459,-0.0800762248319139,0.3680564241547728,0.4481326489866867,1673200,1948580,22.695423582197947,25.89060646407052,NaN,NaN,8.52733422608464,11.768190497179608
1998-05-26T09:30:00-04:00,91.73437,91.84375,89.65625,89.65625,561300,455700,43.89775156938719,53.18198247806322,NaN,NaN,-63.7442874614503,15.352924807427604,-0.18166054031312406,0.22105697359528165,0.4027175139084057,1111900,1843700,21.672278304656444,25.375205789323605,NaN,NaN,5.142824103192406,10.821709583752865
1998-05-27T09:30:00-04:00,89,89.85937,87.9375,89.65625,1041100,485895,43.89775156938719,52.68136634030699,NaN,NaN,-195.69530783275405,-20.83382768045427,-0.2394801742407872,0.10336729610742168,0.3428474703482089,1111900,1642400,19.82493907759391,24.64297717182858,NaN,NaN,2.478156351716006,9.6297734077476
1998-05-28T09:30:00-04:00,89.75,90.09375,89.1875,89.98437,367700,489345,46.17346122112028,52.56945578398302,NaN,NaN,-136.20145976241986,-59.08907351507789,-0.24535227726975511,0.036157123761014986,0.2815094010307701,1479600,1453760,18.254614441928226,23.877296384338155,NaN,NaN,0.9237963684149589,8.386062402128651
1998-05-29T09:30:00-04:00,90.28125,90.42187,88.84375,88.84375,232400,478810,40.08616961075306,51.543327047855314,NaN,NaN,-151.20389432900015,-102.60110220782346,-0.31152919706437027,-0.10790209529969275,0.20362710176467752,1247200,1324760,17.248451537860277,23.08556630495131,NaN,NaN,-2.3922882387790505,6.8462980248561225
1998-06-01T09:30:00-04:00,88.625,89.85937,88.59375,89.40625,445800,484185,44.006608403429,50.8042056461446,NaN,NaN,-137.38309396057133,-136.84560866923914,-0.30263572656429855,-0.17466755644069565,0.1279681701236029,1693000,1328720,17.398963595261293,22.48425013840775,NaN,NaN,-3.9647000601563844,5.301869726997193
1998-06-02T09:30:00-04:00,89.73437,89.875,88.78125,88.95312,391600,476640,41.64269587609136,49.53763020239141,NaN,NaN,-127.50956984851247,-149.59866514665157,-0.31128116606743783,-0.2611332874606944,0.050147878606743426,1301400,1366620,18.918962131758477,22.07758209761798,NaN,NaN,-5.99486707442414,3.688050183937003
1998-06-03T09:30:00-04:00,89.375,89.40625,87.8125,87.84375,473100,484015,36.476561687061405,47.79348230811504,NaN,NaN,-168.23241329255944,-144.10608623861265,-0.3716366773112836,-0.41439796803236106,-0.04276129072107747,828300,1309900,18.3740283264777,21.562301076531877,NaN,NaN,-9.46050051678224,1.8096857981199683
1998-06-04T09:30:00-04:00,87.875,88.95312,87.53125,88.89062,636200,482550,43.588609546487525,46.77908402166126,NaN,NaN,-135.1987945794145,-143.9055532020116,-0.32278588950732434,-0.4462436526052329,-0.12345776309790855,1464500,1306880,18.343732029857364,20.981560914340637,NaN,NaN,-10.117944767987435,0.1057385743903394
1998-06-05T09:30:00-04:00,89.46875,90.85937,89,90.85937,1014000,503595,54.01549670055226,46.97609617656209,NaN,NaN,-11.490222128407394,-115.96281876189303,-0.14847962590128674,-0.309057295474517,-0.16057766957323025,2478500,1553140,28.671778297356965,21.226942815477894,NaN,NaN,-6.909490116304781,-0.8964369528518206
1998-06-08T09:30:00-04:00,90.75,91.25,90.48437,90.92187,467900,495085,54.304257170551104,47.306707197945165,NaN,NaN,32.47157262782351,-81.99188544421406,-0.025991729455278112,-0.1930673313923279,-0.1670756019370498,2946400,1803820,37.357540637362035,22.126307923228847,NaN,NaN,-4.383804385151345,-1.394632300323181
1998-06-09T09:30:00-04:00,90.8125,91.04687,90.35937,90.73437,180100,468935,53.224456936686245,47.546191300341775,NaN,NaN,22.485038299199385,-51.99296381467169,0.041701224864646974,-0.11494907085624106,-0.15665029572088804,2766300,2096800,45.682619145856805,23.654719540788935,NaN,NaN,-2.7278451881006798,-1.5850912842913951
1998-06-10T09:30:00-04:00,90.28125,91.125,89.57812,89.75,531300,471550,47.84556289734164,46.898150790234695,NaN,NaN,-13.298618524302785,-21.006204861020358,0.02055176719849877,-0.13096058672276456,-0.15151235392126333,2235000,2378140,52.24573266334185,25.699610732475012,NaN,NaN,-3.022679226458871,-1.7904609903153201
1998-06-11T09:30:00-04:00,90.03125,90.14062,88.125,88.125,529200,478040,40.55863091203403,45.9249112448323,NaN,NaN,-101.7605045157982,-14.318546848297094,-0.09610405522445187,-0.27164242295182817,-0.1755383677273763,1705800,2426400,53.288377896995726,27.855531547750314,NaN,NaN,-5.799440382300042,-2.3631723320274234
1998-06-12T09:30:00-04:00,88.1875,88.625,86.875,88.5625,909200,492355,43.0724549713333,45.19931921944397,NaN,NaN,-138.7879518289742,-39.77809278841046,-0.13466315362955522,-0.34386730976432034,-0.20920415613476512,2615000,2453700,53.90153373133903,30.084539415546107,NaN,NaN,-7.177521595554953,-3.050936512531356
1998-06-15T09:30:00-04:00,87.5625,87.9375,85.95312,86,617400,509180,34.00213245686834,44.492489282835486,NaN,NaN,-198.42023911082327,-85.95645513613981,-0.31339747363726517,-0.6009509981813466,-0.2875535245440814,1997600,2263940,49.07907021404005,32.04216740907351,NaN,NaN,-11.857577699780157,-4.309028110709756
1998-06-16T09:30:00-04:00,86.8125,86.9375,85.9375,86.79687,796500,536545,38.349889335590326,44.09621340899285,NaN,NaN,-171.16879317890425,-124.68722143176055,-0.35551991696555557,-0.7319534207510259,-0.3764335037854703,2794100,2269500,49.22241920393517,34.141987418097884,NaN,NaN,-13.979369107886757,-5.690505396020756
1998-06-17T09:30:00-04:00,87.78125,89.17187,87.5625,88.65625,895100,557195,47.105928700983725,44.1628182289831,NaN,NaN,-56.34123250510472,-133.29574422792092,-0.2411913467317791,-0.6779226872001942,-0.4367313404684151,3689200,2560340,56.17276499961688,36.85042674364707,NaN,NaN,-12.518247347326373,-6.6658971033501295
1998-06-18T09:30:00-04:00,88.4375,88.71875,88.09375,88.3125,219000,552925,45.81054468067687,44.57170216254908,NaN,NaN,-55.92011857303091,-124.12766703936748,-0.1748444905471822,-0.6552869536523929,-0.48044246310521066,3470200,2913220,62.82208233399946,40.105686086228445,NaN,NaN,-11.853937075516956,-7.407045670802534
1998-06-19T09:30:00-04:00,88.40625,88.54687,86.85937,87.07812,506100,551700,41.407135848853876,44.386025551508006,NaN,NaN,-100.05043071895146,-116.38016281736293,-0.19848907496708146,-0.7285538068140625,-0.530064731846981,2964100,2983040,63.986310459632776,43.433353719397836,NaN,NaN,-12.829585699335583,-8.181694246307256
1998-06-22T09:30:00-04:00,87.1875,87.70312,86.79687,87.17187,161500,548825,41.86419700350962,44.40184706060931,NaN,NaN,-106.06156189441772,-97.90842737408181,-0.19208851214962952,-0.7701753720340179,-0.5780868598843883,3125600,3208640,67.52502687075182,46.905215486468784,NaN,NaN,-13.432578141499418,-8.931820517048994
1998-06-23T09:30:00-04:00,87.65625,88.42187,87.65625,88.375,201600,530840,47.521823624129084,45.19079434182843,NaN,NaN,-41.23311395757514,-71.92129152981599,-0.09595591273360227,-0.6980317508013911,-0.6020758380677889,3327200,3315260,69.07176756074911,50.52648257463103,NaN,NaN,-12.090549125178278,-9.383067461067464
1998-06-24T09:30:00-04:00,88.5,89.4375,87.85937,89.29687,353100,496440,51.422729946217046,45.750374370380534,NaN,NaN,7.837837960806707,-59.08547743663371,0.033648905920641625,-0.5600147056669869,-0.5936636115876285,3680300,3313480,69.01267081685619,54.14569248798809,NaN,NaN,-9.700777927393839,-9.42845467054266
1998-06-25T09:30:00-04:00,89.875,90.29687,89.14062,89.6875,420200,499065,53.016454159683754,45.67901418888993,NaN,NaN,65.74019993250909,-34.753413735525704,0.14346017598353356,-0.4143383916082115,-0.5577985675917451,4100500,3439540,70.91084504227192,57.16276868405345,NaN,NaN,-7.277590851276007,-9.121188410647424
1998-06-26T09:30:00-04:00,89.59375,89.9375,89.34375,89.6875,150400,494965,53.016454159683754,45.58702825954226,NaN,NaN,60.31093860903138,-2.6811398699291344,0.209852676245736,-0.29548272228457506,-0.5053353985303111,4100500,3666820,74.00288872404619,59.780293547388034,NaN,NaN,-5.34979878317364,-8.582418463865455
1998-06-29T09:30:00-04:00,90.1875,90.65625,90,90.125,297700,487560,54.93681898315914,45.709339834290326,NaN,NaN,93.05139679269512,37.14145186749344,0.2729926594082979,-0.16409457426993868,-0.4370872336782366,4398200,3921340,76.95683156275643,62.01416586288086,NaN,NaN,-3.178141408083575,-7.810378884468044
1998-06-30T09:30:00-04:00,89.90625,90.15625,89.35937,89.6875,395600,487760,52.62060605454143,46.05041434551889,NaN,NaN,56.01343637209347,56.59076193342715,0.27432146428129356,-0.09418540332661962,-0.3685068676079132,4002600,4056420,78.36205938336475,63.87961777145392,NaN,NaN,-1.9860439856431669,-6.978331041778776
1998-07-01T09:30:00-04:00,90.375,90.67187,89.89062,90.59375,347100,481460,56.693668035259336,47.202916997177844,NaN,NaN,85.45583376630832,72.11436109452748,0.32196831358507483,0.033953524373430355,-0.2880147892116445,4349700,4190300,79.68440055897823,65.76504796159553,NaN,NaN,0.2457182008863999,-5.946324007112322
1998-07-02T09:30:00-04:00,90.34375,90.57812,90.14062,90.29687,263900,462845,55.024853708604596,48.05665976412579,NaN,NaN,74.1149951563691,73.78932013929948,0.31863391245215134,0.1102776013535447,-0.20835631109860664,4085800,4187360,79.56940263386578,67.59846716891887,NaN,NaN,1.644970952065691,-4.86185329865832
1998-07-06T09:30:00-04:00,90.3125,91.25,90.03125,91.25,166500,420470,59.17927085697623,49.855026792704926,NaN,NaN,98.53770064088816,81.43467254567084,0.36256673284290886,0.2448521049550294,-0.11771462788787942,4252300,4217720,79.89211982680338,69.79939928411626,NaN,NaN,4.096513272736655,-3.582086645601895
1998-07-07T09:30:00-04:00,91.17187,91.5625,90.71875,91.10937,155700,404860,58.32323949344959,51.28169466112344,NaN,NaN,112.56599515047577,85.33759221722696,0.3631951300249523,0.3362792846433109,-0.02691584538164135,4096600,4157400,77.28023675202066,71.8035291089795,NaN,NaN,5.881167339662385,-2.230193219135569
1998-07-08T09:30:00-04:00,91.1875,91.98437,91.10937,91.95312,146900,403200,61.885538332897816,52.33738106340302,NaN,NaN,134.78723072702053,101.09235108821238,0.3986412488078972,0.4713857156282302,0.07274446682033296,4243500,4205580,77.90167682261486,73.35559423919365,NaN,NaN,8.484780701435822,-0.6994826590539418
1998-07-09T09:30:00-04:00,91.375,91.90625,90.46875,90.875,151500,384210,55.37270271326314,53.020392351444904,NaN,NaN,97.20192542740783,103.44156942043227,0.33049445923625653,0.4858625408656536,0.15536808162939708,4092000,4154040,75.52192958524557,74.26272618571123,NaN,NaN,8.88206616050113,0.6693100294539256
1998-07-10T09:30:00-04:00,91.03125,91.46875,90.34375,91.23437,127800,364140,56.99726519791436,54.133973019234936,NaN,NaN,84.11788618452721,105.44214762606391,0.29197399878918917,0.5203355801158835,0.22836158132669437,4219800,4180840,75.93361916380555,75.11610537886644,NaN,NaN,9.682569948672839,1.9569185893423418
1998-07-13T09:30:00-04:00,91.375,91.92187,90.79687,90.98437,164400,326900,55.48409691991095,55.106823013263615,NaN,NaN,86.77443016150161,103.08949353018659,0.23448801606462022,0.5214716014074696,0.2869835853428494,4055400,4141460,73.96507573162617,75.57610886892887,NaN,NaN,9.923291555928511,3.094971870283223
1998-07-14T09:30:00-04:00,91.48437,92.67187,91.48437,92.4375,276000,309830,61.82763337444857,56.128666566857866,NaN,NaN,127.21008778449492,106.01831205699042,0.276283653762371,0.6323381525458132,0.35605449878344214,4331400,4188420,74.80391924908174,75.98554827523836,NaN,NaN,12.074007252018415,4.377691210531108
1998-07-15T09:30:00-04:00,93,93.15625,92.28125,92.5,367900,288400,62.07793774360775,56.88975283810005,NaN,NaN,139.26601675754145,106.9140692630946,0.28873962717596646,0.7169790327534002,0.4282394055774338,4699300,4279580,76.39396147275754,76.51278332208845,NaN,NaN,13.881467421328713,5.735373526359337
1998-07-16T09:30:00-04:00,92.4375,93.40625,92.09375,93.26562,356100,261450,65.09717895303531,57.75266175191088,NaN,NaN,139.61394083421496,115.39647234445604,0.32636648447825867,0.8361975111752571,0.5098310266969984,5055400,4472260,79.35895858893275,77.1162200039928,NaN,NaN,16.346343873015215,7.251226433024462
1998-07-17T09:30:00-04:00,93.4375,93.625,93.09375,93.32812,222100,261605,65.3397777471375,58.632899151014726,NaN,NaN,144.7064184273928,127.51417879302917,0.3321821711069576,0.9250587405806954,0.5928765694737378,5277500,4683800,82.02790800304128,77.68943566677817,NaN,NaN,18.42829126164702,8.84794997997054
1998-07-20T09:30:00-04:00,93.54687,93.57812,92.57812,93.125,234900,248045,63.78801769586684,59.26512763049384,NaN,NaN,122.03475277461666,134.56624331565217,0.30004600611445664,0.9679340771168086,0.6678880710023519,5042600,4881240,84.09504183155708,78.19930782883534,NaN,NaN,19.75907084948514,10.40668153275834
1998-07-21T09:30:00-04:00,93.57812,93.57812,91.75,91.75,389800,259460,54.374039163853226,59.39037285258754,NaN,NaN,77.78290833281095,124.68080742531538,0.1703364772310807,0.8808086675412028,0.7104721903101221,4652800,4945520,84.71157728096605,78.65284482152116,NaN,NaN,18.214117328356316,11.52202950355805
1998-07-22T09:30:00-04:00,91.5,91.75,90.82812,91.40625,229900,260875,52.29612179619987,59.07626240694044,NaN,NaN,9.018348463530529,98.63127376651319,0.051693176534813645,0.7750886609786392,0.7233954844438255,4422900,4890240,81.77577345887613,78.8022286000853,NaN,NaN,16.314940342276646,12.206731051946422
1998-07-23T09:30:00-04:00,91.17187,91.4375,89.20312,89.35937,297000,258070,42.00291938214353,58.14612424076465,NaN,NaN,-86.78188660554933,53.35210827856032,-0.16260214583453347,0.5201428021506587,0.6827449479851921,4125900,4704340,72.65660193033192,78.30845712126144,NaN,NaN,11.026806262548899,12.038170367746776
1998-07-24T09:30:00-04:00,90.07812,90.07812,88.53125,89.4375,424800,258300,42.46839575258174,56.952490304736465,NaN,NaN,-128.80513081883683,-1.350201570685607,-0.2896328104255588,0.3207039349532437,0.6103367453788024,4550700,4558980,66.41958280875814,77.34613304854393,NaN,NaN,7.012266933491093,11.320184162853106
1998-07-27T09:30:00-04:00,88.96875,90.34375,88.53125,90.25,382900,269925,47.21308743205307,56.158908014636715,NaN,NaN,-104.63288678565613,-46.68372948274016,-0.3077826112329831,0.2256084813375736,0.5333910925705567,4933600,4537180,65.5113136576951,76.50549568466353,NaN,NaN,5.045042666762704,10.423735377697335
1998-07-28T09:30:00-04:00,90.09375,90.09375,88.01562,89.21875,557300,282905,42.43008413597171,54.76923271485628,NaN,NaN,-134.60920330790634,-89.16215181088361,-0.37369887227906934,0.06626750222172006,0.4399663745007894,4376300,4481880,63.152140507716545,75.45195737645652,NaN,NaN,1.798028024197822,9.191491470054547
1998-07-29T09:30:00-04:00,89.8125,90,88.82812,89.01562,330400,279645,41.53745118809566,53.781000463058604,NaN,NaN,-119.55329795588014,-114.87648109476575,-0.4123983668050001,-0.07553158400546067,0.3368667827995394,4045900,4406480,59.98049630735093,74.34185499946405,NaN,NaN,-1.0835643639399892,7.723626350912471
1998-07-30T09:30:00-04:00,89.875,90.375,89.57812,90.23437,533300,288955,48.533444233412006,53.176441822737004,NaN,NaN,-67.67573703984615,-111.05525118162511,-0.34032922877494787,-0.08854475316914545,0.2517844756058024,4579200,4497140,62.424121434210534,73.37689087592153,NaN,NaN,-1.4219222105613243,6.417119413559072
1998-07-31T09:30:00-04:00,90.125,90.375,88.15625,88.53125,234400,287480,41.12693928703909,52.15093056324616,NaN,NaN,-121.51514957522235,-109.5972549329022,-0.3883016793329829,-0.2335926235604262,0.15470905577255667,4344800,4455960,60.613662326636444,72.42321848985084,NaN,NaN,-4.259985060002803,4.8918187744788035
1998-08-03T09:30:00-04:00,88.625,88.92187,87.78125,87.8125,429300,300620,38.459508114807406,50.48177875898608,NaN,NaN,-144.08803201233928,-117.48828397823885,-0.445293865092276,-0.4019082755927883,0.043385589499487676,3915500,4252340,52.504894825552945,70.83043103102736,NaN,NaN,-7.46374453720571,3.126738301381016
1998-08-04T09:30:00-04:00,88.625,88.625,84.875,84.9375,947200,340195,30.060806760630967,48.19484083163059,NaN,NaN,-197.3589930679214,-130.03824193024187,-0.6415437443963992,-0.7585440909960113,-0.11700034659961212,2968300,3970740,43.78172893591827,68.50098584982456,NaN,NaN,-13.695879888202267,0.723507131440547
1998-08-05T09:30:00-04:00,85.4375,85.92187,83.53125,85.65625,1456000,405650,33.944476101811915,45.96964777082893,NaN,NaN,-200.66805468526914,-146.26119327611968,-0.6839829678747364,-0.9719790564430326,-0.2879960885682962,4424300,4046420,46.360950031373235,66.14398523857031,NaN,NaN,-17.117891836358282,-1.8252641496735715
1998-08-06T09:30:00-04:00,84.96875,86.23437,84.96875,85.65625,571600,426655,33.94447610181193,43.72712622473424,NaN,NaN,-153.33683608122377,-163.3934130843952,-0.6721019281964311,-1.1281234988138351,-0.456021570617404,4424300,4015440,45.44187222992116,63.53069696906174,NaN,NaN,-19.69957009884109,-4.378736428126074
1998-08-07T09:30:00-04:00,86.28125,87.23437,85.5,86.15625,698900,455210,36.77690423405675,41.79776097746209,NaN,NaN,-114.17684697694197,-161.92575256473913,-0.5933561355069328,-1.19771674000107,-0.6043606044941372,5123200,4171120,50.727984363173015,61.14733572132001,NaN,NaN,-20.879041962577833,-6.735922933047753
1998-08-10T09:30:00-04:00,86,86.40625,85.14062,85.78125,233900,458685,35.545829664756084,40.452888870383724,NaN,NaN,-115.44948218717268,-156.19804259970581,-0.5313168727736034,-1.2685066954611415,-0.7371898226875381,4889300,4365880,56.417098872760334,59.12630154930532,NaN,NaN,-22.21148252348925,-8.94671716025368
1998-08-11T09:30:00-04:00,84.25,84.8125,83.0625,84.375,1034100,496590,31.312836625304982,38.95408278674837,NaN,NaN,-145.78781421952914,-145.88380683002734,-0.5476021272095994,-1.4216924816995373,-0.8740903544899379,3855200,4543260,60.85071189123665,57.631654294473925,NaN,NaN,-24.741868010778767,-11.203167281757263
1998-08-12T09:30:00-04:00,85.21875,85.78125,84.71875,85.6875,592000,507795,38.655535809752095,38.714983960148984,NaN,NaN,-95.03793600850092,-124.75778309467368,-0.43737360214091636,-1.4208073571660833,-0.983433755025167,4447200,4547840,60.961141179333744,56.7962642408312,NaN,NaN,-24.508701987625077,-13.103957954024093
1998-08-13T09:30:00-04:00,85.34375,86.21875,84.28125,84.28125,651900,522585,34.411042165842844,38.13945870395336,NaN,NaN,-95.83663066585103,-113.25774201159916,-0.42613446307943303,-1.5161018338744583,-1.0899673707950253,3795300,4422040,56.266422705878206,56.07103851919692,NaN,NaN,-25.726419454375527,-14.907166739788583
1998-08-14T09:30:00-04:00,85.625,85.6875,83.78125,84.3125,731000,548030,34.58294275430684,37.23730551268576,NaN,NaN,-94.37032084411295,-109.29643678503335,-0.38481998928816474,-1.5709923574052311,-1.1861723681170664,4526300,4302660,52.161174285512196,55.11745713546957,NaN,NaN,-26.617808898891532,-16.580115619660432
1998-08-17T09:30:00-04:00,84.09375,85.96875,83.6875,85.75,948800,583725,42.100304167557276,37.21374980065616,NaN,NaN,-71.53294007809794,-100.51312836321839,-0.23619997898914868,-1.4814223418535022,-1.2452223628643535,5475100,4419820,55.58602945058397,54.57702063138867,NaN,NaN,-24.952448561428056,-17.776163182770095
1998-08-18T09:30:00-04:00,86.21875,87.67187,86.03125,87.375,566000,592535,49.20614961621151,37.761513974093006,NaN,NaN,-9.107834726569605,-73.17713246462647,-0.015609684287289927,-1.264734468223466,-1.249124783936176,6041100,4857000,65.5088472161399,54.97190283915931,NaN,NaN,-21.086433020244385,-18.24905887383785
1998-08-19T09:30:00-04:00,87.90625,87.90625,86.78125,86.96875,324700,597275,47.63229127440131,37.697145905592244,NaN,NaN,4.46527509036043,-53.27649024485419,0.10893243062408375,-1.1129592456560715,-1.2218916762801553,5716400,5110840,69.73666838300967,55.49422762121639,NaN,NaN,-18.513140071153586,-18.28678475916867
1998-08-20T09:30:00-04:00,86.59375,87.125,86.15625,86.25,536300,609240,44.8962330906446,37.96638117727834,NaN,NaN,-16.55027781877204,-37.41921967543842,0.1465534047583137,-1.038699920332263,-1.1852533250905768,5180100,5387800,73.54671419630755,56.41801704047862,NaN,NaN,-17.239959218160863,-18.13723825331041
1998-08-21T09:30:00-04:00,85.125,85.59375,83.1875,85.59375,1184400,647220,42.4960280801466,38.25470403194543,NaN,NaN,-79.15934143027464,-34.37702379267076,0.13137631730037835,-1.0210329284651039,-1.1524092457654822,3995700,5281680,69.91470559432774,57.66157495253396,NaN,NaN,-16.920287864009932,-17.963388197696055
1998-08-24T09:30:00-04:00,85.8125,86.34375,85,85.625,292300,642690,42.653249833065615,39.15416425140505,NaN,NaN,-38.583440726311224,-27.787123922313413,0.12747724638122615,-0.9930626877889495,-1.1205399341701756,4288000,5044260,62.480526537436404,58.997203352642394,NaN,NaN,-16.61878663086386,-17.77130225957717
1998-08-25T09:30:00-04:00,86.46875,86.875,85.28125,85.90625,309400,630295,44.13369368842098,39.88196550759142,NaN,NaN,-16.39120238330042,-29.243797453659578,0.14651528300150352,-0.9373958304182963,-1.0839111134197998,4597400,4755520,54.84288746966463,59.603056026806065,NaN,NaN,-15.95182191700555,-17.511376496352653
1998-08-26T09:30:00-04:00,84.84375,85.8125,84.53125,85.39062,653200,646435,41.9933009256231,40.45688156643507,NaN,NaN,-52.346083196263386,-40.606069110984336,0.1277428910134044,-0.9242324996530442,-1.0519753906664486,3944200,4401080,47.2133270751279,59.729588515749406,NaN,NaN,-15.974331935756455,-17.29179870198177
1998-08-27T09:30:00-04:00,83.9375,84.21875,80.8125,81.04687,1887300,714135,29.1623869408007,39.91298747405965,NaN,NaN,-233.8473431189579,-84.06548217102151,-0.1583370924108014,-1.2498967561799503,-1.091559663769149,2056900,3776440,37.351470997914504,58.7741232753738,NaN,NaN,-20.62026819132664,-17.76729434331675
1998-08-28T09:30:00-04:00,82,82.60937,80.125,80.78125,1225000,763665,28.587172973860135,39.41594056756708,NaN,NaN,-251.1271102832922,-118.45903594162503,-0.33634589847606344,-1.5119920368642283,-1.175646138388165,831900,3143680,30.41971711252087,56.9171674353567,NaN,NaN,-24.382655533959884,-18.712345941980054
1998-08-31T09:30:00-04:00,81.21875,81.40625,74.875,74.875,1284000,806400,19.416330304339738,38.566190116069556,NaN,NaN,-343.6306541710138,-179.46847863056556,-0.7964914972212302,-2.1712605099147027,-1.3747690126934724,-452100,2195660,23.410006062461036,54.24283130472987,NaN,NaN,-32.27547530487519,-20.649935850965072
1998-09-01T09:30:00-04:00,76.21875,79.09375,73.875,78.53125,1760300,847055,33.61416718669679,38.20609235727989,NaN,NaN,-236.80768352253733,-223.55177485841295,-0.7972816035871726,-2.371371017177438,-1.5740894135902654,1308200,1537820,19.97100488817857,51.31496442679021,NaN,NaN,-32.46028792374792,-22.337129004219765
1998-09-02T09:30:00-04:00,78.65625,79.625,77.625,77.78125,551100,801810,32.35487940322935,38.05922358852179,NaN,NaN,-155.5519578151843,-244.19294978219713,-0.7894945829917841,-2.5609576423299956,-1.7714630593382115,757100,900400,17.316513366767907,48.532828045425184,NaN,NaN,-33.09595102462376,-23.874103578563194
1998-09-03T09:30:00-04:00,76.34375,77.625,75.75,77.03125,806800,813570,31.100150760466207,37.810452731818884,NaN,NaN,-156.42813621421024,-228.70910840124756,-0.7749403760176548,-2.74013852936028,-1.9651981533426253,-49700,479080,15.819753248608308,45.937012257074905,NaN,NaN,-34.03508293978549,-25.32567205873781
1998-09-04T09:30:00-04:00,77.6875,77.78125,74.9375,76.875,578100,807530,30.83189216214396,37.005566160003646,NaN,NaN,-134.52635227635201,-205.38895679985953,-0.7172495995397989,-2.861760152767374,-2.1445105532275752,-627800,187140,14.861209128642216,43.02809651979335,NaN,NaN,-34.83012972396061,-26.683451725198207
1998-09-08T09:30:00-04:00,79.1875,80.65625,78.34375,80.59375,1187900,855230,43.35505332036824,36.58763071030056,NaN,NaN,-58.3876007003168,-148.34034610572013,-0.3866176986082004,-2.6277826764878256,-2.241164977879625,560100,389580,18.54680680196995,39.67366506163835,NaN,NaN,-30.8784329345563,-27.282734755106507
1998-09-09T09:30:00-04:00,80.09375,80.46875,78.40625,78.40625,879200,847485,38.894101070154356,35.96347426714006,NaN,NaN,-65.98133410027793,-114.17507622126826,-0.27828575619066287,-2.5890221731179537,-2.310736416927291,-319100,64120,17.253660478372296,35.92487878273568,NaN,NaN,-29.308743706404115,-27.572164605291878
1998-09-10T09:30:00-04:00,76.46875,77.21875,75,75.75,1292900,882530,34.281431287762814,35.20527413836279,NaN,NaN,-110.71835195743155,-105.20835504971771,-0.34424632092018914,-2.7410443180775275,-2.3967979971573383,-1612000,-409700,15.553439334748234,31.782502006910022,NaN,NaN,-29.73219097725718,-27.88073980128692
1998-09-11T09:30:00-04:00,75.375,78.8125,75.01562,78.71875,1086900,904280,42.490561042009965,35.204883635638744,NaN,NaN,-74.47646680839189,-88.81802116855405,-0.15623332475113116,-2.5920896530962523,-2.435856328345121,-525100,-504780,15.229129796977361,27.876389449956427,NaN,NaN,-26.964298184580265,-27.749819570328828
1998-09-14T09:30:00-04:00,79.42187,80.34375,79.21875,79.40625,627700,899115,44.22799785121741,35.3173656369353,NaN,NaN,-32.45182838672921,-68.40311639062949,0.03588146893353894,-2.3910044921781974,-2.4268859611117364,102600,-358700,18.056194076625914,24.703222845612817,NaN,NaN,-24.25399647913998,-27.250416271587564
1998-09-15T09:30:00-04:00,78.625,80.5,78.59375,80.28125,418000,872575,46.44560708797519,35.48250230833204,NaN,NaN,-26.245505335929657,-61.974697317752074,0.23238024573640814,-2.136410653941226,-2.3687908996776343,520600,-366600,18.02119201939668,22.07310174202225,NaN,NaN,-21.380707434809445,-26.411886437762117
1998-09-16T09:30:00-04:00,80.9375,81.6875,79.59375,81.125,495200,869035,48.56925266596766,35.952213146928074,NaN,NaN,-1.2689592128853955,-49.03222234027357,0.41880208406702213,-1.845288294593857,-2.264090378660879,1015800,-99620,23.423730659470294,20.373844855189567,NaN,NaN,-18.39769083587176,-25.26700135177778
1998-09-17T09:30:00-04:00,78.65625,79.40625,78.5,78.78125,681100,886855,43.418783717675495,36.970527202419134,NaN,NaN,-36.07566077033144,-34.10368410285355,0.3847620136898606,-1.7831378615485534,-2.167899875238414,334700,289720,30.605872555564403,19.892016395021702,NaN,NaN,-17.515336411962657,-24.159620646089905
1998-09-18T09:30:00-04:00,78.5625,79.125,78.125,78.8125,309400,875510,43.504807842362304,38.03607255016929,NaN,NaN,-36.00120145443375,-26.40863103206192,0.3650151278377125,-1.7116309654412731,-2.0766460932789856,644100,523560,34.57485287808559,20.188811806847756,NaN,NaN,-16.800074523299223,-23.108256914262665
1998-09-21T09:30:00-04:00,76.28125,79.5625,76.15625,79.25,562200,844400,44.77079555299852,39.84710578221634,NaN,NaN,-41.332410997843695,-28.184747554284815,0.38035608014201117,-1.6012009931014717,-1.9815570732434828,1206300,744300,38.169888322493534,21.24308911113579,NaN,NaN,-15.847572452788683,-22.071016276909237
1998-09-22T09:30:00-04:00,80.0625,80.0625,78.51562,78.85937,431900,851380,43.82645942213967,40.57655522760512,NaN,NaN,-8.982403051637394,-24.732127097426368,0.36316898118676866,-1.527595846760022,-1.8907648279467906,774400,795060,38.99995670251683,22.602299955017095,NaN,NaN,-15.32718389924915,-21.107611651529226
1998-09-23T09:30:00-04:00,79.90625,81.875,79.39062,81.875,680200,869920,52.20734804601269,41.994588702089644,NaN,NaN,77.06603704908191,-9.065127845032873,0.5430467259885927,-1.2119564204610498,-1.7550031464496425,1454600,882820,40.487540445120324,24.257373317756556,NaN,NaN,-12.27092214840059,-19.845227436796563
1998-09-24T09:30:00-04:00,81.26562,81.85937,79.23437,79.76562,568800,865700,46.9326806026347,43.12548369081596,NaN,NaN,66.56576539640528,11.463157388314475,0.5087075298827504,-1.1191187340962045,-1.627826263978955,885800,993040,42.3878054658358,26.155091333272804,NaN,NaN,-11.264284896132956,-18.619378502416048
1998-09-25T09:30:00-04:00,78.96875,80.96875,78.65625,80.125,422200,792445,47.89850331332463,44.34452734447173,NaN,NaN,57.82511712979182,30.22842110515959,0.49829247105540864,-1.004960675159694,-1.5032531462151026,1308000,1125820,44.67946242177866,28.284966568496834,NaN,NaN,-10.16623296281079,-17.41178628247244
1998-09-28T09:30:00-04:00,80.9375,81.64062,80.375,81.28125,678800,765135,50.9891209564986,44.889817889909615,NaN,NaN,119.77363174353908,62.44962965343615,0.5531372450111245,-0.811831589951197,-1.3649688349623215,1986800,1281920,47.331856916920216,30.341041576707568,NaN,NaN,-8.319267355850233,-16.112855007240697
1998-09-29T09:30:00-04:00,81.48437,81.5625,79.59375,80.6875,1089600,755415,49.369583113091295,45.63806660726225,NaN,NaN,86.88442704500633,81.62299567276489,0.5330689408342855,-0.6986326589194647,-1.2317015997537502,897200,1306480,47.7562770591688,32.51979990390732,NaN,NaN,-7.253286802231262,-14.847202406525064
1998-09-30T09:30:00-04:00,79.6875,80.4375,78.125,78.1875,673200,701060,43.154327453149214,46.27184490478985,NaN,NaN,-8.598056510848197,64.49017696077887,0.3442311906603792,-0.801412611428276,-1.1456438020886552,224000,1060360,43.935377920842896,34.54708123148551,NaN,NaN,-8.186016468792182,-13.895604415420367
1998-10-01T09:30:00-04:00,77,78.15625,75.75,76.21875,1107600,728885,38.991358687632655,46.021901879477184,NaN,NaN,-121.49013723094397,26.878996435309023,0.09262976963551539,-1.029856590044261,-1.1224863596797765,-883600,706480,39.09231317194527,36.251594329697504,NaN,NaN,-10.307831804145877,-13.383065470952582
1998-10-02T09:30:00-04:00,76.375,78.3125,75.0625,78.15625,971800,737135,44.65023739924743,46.05206184719361,NaN,NaN,-99.1067378124214,-4.507374553133625,0.0639552852030707,-1.042542253175938,-1.1064975383790088,88200,462520,36.135101086842475,37.54294483042725,NaN,NaN,-10.340483776494313,-12.94841094317283
1998-10-05T09:30:00-04:00,77.34375,78,75.4375,77.21875,728800,744670,42.59161185625486,45.776776473499304,NaN,NaN,-117.7653364846056,-52.01516819876256,-0.007111300836988743,-1.1153866644252446,-1.1082753635882558,-640600,-62960,30.74087042480552,38.45149328795646,NaN,NaN,-11.005336769349228,-12.670828918340886
1998-10-06T09:30:00-04:00,78.3125,78.85937,76.625,77.1875,806100,725580,42.5212361291681,45.34477529229934,NaN,NaN,-72.42642919092035,-83.87733944594791,-0.043172041093197056,-1.162240414954752,-1.119068373861555,-1446700,-531740,26.885113242235818,38.69873490101114,NaN,NaN,-11.556886989661674,-12.511694357100998
1998-10-07T09:30:00-04:00,77.53125,78.5625,75.85937,77.34375,1280800,745660,43.02812646134767,45.316871202561636,NaN,NaN,-78.56735900648972,-97.8711999450762,-0.04333722201598422,-1.1732399013815353,-1.129902679365551,-165900,-609720,26.29429501293062,38.3907650765373,NaN,NaN,-11.86903630962573,-12.419886064604531
1998-10-08T09:30:00-04:00,75.125,77.75,74.46875,77.3125,2218200,791925,42.946552870903645,45.27699584745744,NaN,NaN,-120.0311153400488,-97.57939556689718,-0.032862140374816384,-1.1709803548340716,-1.1381182144592552,-2384100,-909820,24.09939100009383,37.642517799537885,NaN,NaN,-12.148803820312706,-12.381160029705699
1998-10-09T09:30:00-04:00,78.0625,79.375,76.5625,79.1875,1196900,797425,49.17283712411591,45.59142738825154,NaN,NaN,-27.14802802941076,-83.18765361029504,0.10546025173408746,-1.0062928997916458,-1.1117531515257333,-1187200,-1164900,22.38867656529804,36.515288388309635,NaN,NaN,-10.66747189131181,-12.136347438506572
1998-10-12T09:30:00-04:00,80.53125,80.96875,79.5,79.78125,630700,797575,50.99656733238085,46.10357795326876,NaN,NaN,62.0879343355975,-47.21699944625443,0.2346570258564049,-0.8184318692052273,-1.0530888950616322,-556500,-1148080,22.777943113300182,35.35657313193702,NaN,NaN,-8.907889813187037,-11.675139206318066
1998-10-13T09:30:00-04:00,80,80.1875,78.6875,79.17187,288500,791100,49.051277558484934,45.87814434701678,NaN,NaN,25.003099609401524,-27.731093686190054,0.27404555433318867,-0.7105319521451463,-0.984577506478335,-845000,-1027740,25.65113758202793,34.296830070287555,NaN,NaN,-7.9285378992515865,-11.139910448165711
1998-10-14T09:30:00-04:00,79,80.67187,78.84375,79.6875,939700,813325,50.76275724443772,46.1517212500027,NaN,NaN,50.43232871981446,-1.931156140929214,0.32625010728444603,-0.5767648723727774,-0.9030149796572234,94700,-975620,26.919387716203275,33.19194308817095,NaN,NaN,-6.634057228508945,-10.496217131071887
1998-10-15T09:30:00-04:00,79.5,88,79.1875,83.875,1219200,840230,61.943459516523795,47.154932407374076,NaN,NaN,215.606329557854,65.19633283865134,0.6173374224130682,-0.1313432016408882,-0.7486806240539564,1313900,-236020,42.030800557539216,33.00275295501099,NaN,NaN,-1.7356663773175887,-9.24470988053556
1998-10-16T09:30:00-04:00,83.9375,84.42187,83.25,84.1875,694800,859500,62.62553158857316,47.9861045953794,NaN,NaN,187.215200786199,108.0689786017733,0.7941920627346314,0.24405945436433285,-0.5501326083702985,2008700,403160,51.38640027963496,33.2923631952049,NaN,NaN,2.405611191196987,-7.580378298859482
1998-10-19T09:30:00-04:00,84,85.25,83.8125,84.625,423800,852580,63.608883707173106,49.00319749495667,NaN,NaN,176.77340012188336,131.00607175903048,0.8963439466754102,0.5702973249739642,-0.32604662170144594,2432500,1000960,58.183712505592624,34.037180012806594,NaN,NaN,6.100630753290963,-5.6259484342665615
1998-10-20T09:30:00-04:00,85.48437,86.5,84.48437,84.89062,959800,878975,64.22432867338068,50.50819758211606,NaN,NaN,168.99431679724694,159.80431519659956,0.9333066903722356,0.8405867412638486,-0.09271994910838702,3392300,1848420,65.53977665214501,35.58035135075675,NaN,NaN,9.325620758396356,-3.490009978171859
1998-10-21T09:30:00-04:00,85.46875,85.79687,84.625,85.0625,599800,874955,64.64104690377806,52.340318168983586,NaN,NaN,142.56046446712023,178.2299423460607,0.919363033242895,1.0564838424452319,0.13712080920233677,3992100,2627900,70.65339541031406,37.83471436778309,NaN,NaN,12.123088957321677,-1.259567273101354
1998-10-22T09:30:00-04:00,85.03125,85.6875,84.20312,85.5625,574800,875255,65.88589962733494,53.857151185275555,NaN,NaN,120.33079501919728,159.17483543832935,0.8930876173751641,1.2534803309212919,0.3603927135461278,4566900,3278500,74.107096706796,40.54699976920835,NaN,NaN,14.856613196796884,1.0427442225983943
1998-10-23T09:30:00-04:00,84.9375,85.1875,84.125,84.3125,463400,877315,60.18154399295623,55.113574909325656,NaN,NaN,91.79934083074805,140.09166344723917,0.746743855739969,1.293822533221089,0.54707867748112,4103500,3697460,76.06088785502453,43.784143871366844,NaN,NaN,15.751038138756055,3.143929067763774
1998-10-26T09:30:00-05:00,85,85.4375,84.125,84.375,381100,862430,60.36631475796324,56.38822338281102,NaN,NaN,83.80249528759764,121.49748248038202,0.6148738663573716,1.3156710104278346,0.700797144070463,4484600,4107880,77.82603676939091,47.42278126616363,NaN,NaN,16.543736463003377,5.058187267083717
1998-10-27T09:30:00-05:00,85.28125,85.42187,83.39062,83.71875,915900,853745,57.35672586322294,57.411694768659245,NaN,NaN,65.86727097235372,100.87207331540338,0.45171823198079486,1.2654449340464566,0.8137267020656618,3568700,4143160,77.9763672379829,51.114357853667364,NaN,NaN,16.436738223633032,6.683694546590762
1998-10-28T09:30:00-05:00,83.85937,84.375,83.17187,83.45312,355200,837845,56.136747172334985,58.35385150447578,NaN,NaN,49.95602715309752,82.35118585259885,0.30140514799817575,1.1904831370633815,0.8890779890652057,3213500,3987440,75.54196429929658,54.78882737503899,NaN,NaN,16.027211499251404,8.01848268268514
1998-10-29T09:30:00-05:00,83.90625,85.4375,83.46875,85.4375,413600,803145,62.545887818220244,59.30906941119752,NaN,NaN,66.28848333091504,71.54272351494242,0.3099246045099856,1.2764837447026878,0.9665591401927022,3627100,3799480,72.59586699861576,58.37505526313311,NaN,NaN,17.437677444411197,9.36408193436029
1998-10-30T09:30:00-05:00,86.09375,86.60937,85.57812,86.03125,678700,788490,64.23003834817109,60.254317340896804,NaN,NaN,86.52088070329984,70.48703148945278,0.3280974776182446,1.376680987215508,1.0485835095972633,4305800,3839940,72.84140080918169,61.95101652712465,NaN,NaN,19.111685569807236,10.756596739424138
1998-11-02T09:30:00-05:00,86.78125,87.46875,86.23437,87.46875,598900,781995,67.98359425352527,61.606625676256826,NaN,NaN,102.20280204426348,74.16709284078594,0.4044666265211856,1.5541667927487453,1.1497001662275597,4904700,3923960,73.3748930175081,65.35985620108752,NaN,NaN,21.721592324636653,12.323024680168782
1998-11-03T09:30:00-05:00,87.1875,87.625,86.70312,87,731200,778250,65.56740729597696,62.664100679938194,NaN,NaN,99.86775320490129,80.96718928729544,0.3907343937540313,1.6381181584200988,1.2473837646660675,4173500,4044920,74.16180590120699,68.7343146428735,NaN,NaN,23.209803306864476,13.878278769696738
1998-11-04T09:30:00-05:00,88.1875,88.84375,87.07812,88.23437,706600,749540,68.72009267320135,63.14814590541516,NaN,NaN,124.0358648838702,95.78315683345,0.42904680372331616,1.7836922693202126,1.3546454655968965,4880100,4378240,76.24528609811316,71.17820646720021,NaN,NaN,25.45405876381445,15.53196162599927
1998-11-05T09:30:00-05:00,87.29687,89.5,87.14062,89.5,462600,661760,71.5921635417712,63.788619616357884,NaN,NaN,145.51265572700956,111.62799131266888,0.4989884433666867,1.978381019805255,1.4793925764385683,5342700,4721360,78.1945128269464,73.09307164915103,NaN,NaN,28.29042471103172,17.354599209575333
1998-11-06T09:30:00-05:00,89.20312,89.9375,89,89.875,400000,621915,72.40076754855136,64.41661131931347,NaN,NaN,167.01762453205635,127.72734007842018,0.5271129935632435,2.1382838183926225,1.611170824829379,5742700,5008740,79.69718421924327,74.62974820012607,NaN,NaN,30.863228523512483,19.28440339728064
1998-11-09T09:30:00-05:00,89.84375,89.9375,88.51562,89.01562,325700,606665,67.64856465741218,64.66119960388716,NaN,NaN,136.06138636833995,134.4990569432355,0.4475764218317013,2.1706413521190058,1.7230649302873045,5417000,5111200,80.22053779762723,75.67837399623194,NaN,NaN,31.673486189594353,21.054272367611173
1998-11-10T09:30:00-05:00,88.75,89.42187,88.5,88.625,345400,609510,65.54270191374604,64.72560353317058,NaN,NaN,110.38725974885044,136.6029582520253,0.3336244340266741,2.140095472820647,1.806471038793973,5071600,5290820,81.13845037043073,76.42730649338314,NaN,NaN,31.74343963787809,22.58129626336359
1998-11-11T09:30:00-05:00,89.4375,89.48437,87.96875,88.35937,365000,580775,64.08182483385968,64.59674104792235,NaN,NaN,91.14126971206487,130.02403921766427,0.21129125389180636,2.070585106158731,1.8592938522669247,4706600,5256120,80.3625605190358,76.87412533711456,NaN,NaN,31.39419138972961,23.84028128141588
1998-11-12T09:30:00-05:00,88.125,89.21875,88.125,88.625,354400,537535,64.92377590562876,64.93547189882753,NaN,NaN,82.59652618442882,117.44081330914813,0.12354000879626459,2.0137188632622554,1.8901788544659908,5061000,5199780,79.04096772388918,77.0869881848906,NaN,NaN,31.322497742686323,24.909169347311657
1998-11-13T09:30:00-05:00,88.65625,89.75,88.46875,89.5,408300,523210,67.61661524925552,65.45335050534841,NaN,NaN,93.17569135454535,102.67242667364592,0.1006711130208795,2.01601774574209,1.9153466327212105,5469300,5145100,77.70532281779535,77.07836575977662,NaN,NaN,31.992015766095772,25.921004549995104
1998-11-16T09:30:00-05:00,90.15625,90.46875,89.39062,90.34375,273700,515705,70.0077144094796,66.35699254436675,NaN,NaN,110.79692809548669,97.61953501907526,0.11744429030043158,2.06215199559675,1.9447077052963184,5743000,5210300,78.1788235956048,77.09282692817818,NaN,NaN,33.24875529309742,26.967826084724006
1998-11-17T09:30:00-05:00,89.95312,92,89.03125,89.96875,618700,498650,67.6180327849961,67.17708437384253,NaN,NaN,107.98202437590689,97.13848794448656,0.08013961623498034,2.044882225590044,1.9647426093550635,5124300,5220840,78.25920814195126,77.28691577408209,NaN,NaN,33.65150995743785,27.92263806654027
1998-11-18T09:30:00-05:00,89.875,90.96875,89.75,90.67187,249600,481140,69.7060447885076,67.68852415743449,NaN,NaN,101.45440981800556,99.20111596567469,0.07951601058524038,2.064137622586614,1.9846216120013735,5373900,5354300,79.2990786773898,77.76571660828024,NaN,NaN,34.57987767230437,28.87367229593514
1998-11-19T09:30:00-05:00,90.9375,91.125,90.3125,90.75,270800,465940,69.9380087741057,68.09623633071553,NaN,NaN,101.3392824151477,102.94966721181848,0.061849443644737434,2.061933416557295,2.0000839729125577,5644700,5471040,80.19157633019358,78.29072914549536,NaN,NaN,35.413677165805616,29.807958705916636
1998-11-20T09:30:00-05:00,91.32812,91.73437,91,91.71875,331900,459365,72.72658592149352,68.43502144985611,NaN,NaN,119.54693649507551,108.2239162399245,0.09112310973221582,2.1139878600778275,2.0228647503456116,5976600,5572500,80.95990386444527,78.83251563456233,NaN,NaN,36.93884073411216,30.826656138515997
1998-11-23T09:30:00-05:00,92.375,94.09375,92.25,94.09375,530600,466840,78.09200982313855,69.32963591608194,NaN,NaN,177.10206277863054,121.48494317655324,0.23781933229366237,2.3201389157126897,2.0823195834190273,6507200,5725340,82.08707496064957,79.39860628166537,NaN,NaN,40.15021463423717,32.158593066476165
1998-11-24T09:30:00-05:00,93.78125,93.90625,92.875,93.09375,503700,446230,71.69638659508048,69.5422283390733,NaN,NaN,158.77709301075944,131.64395690352376,0.2344970262605397,2.375440866244702,2.1409438399841623,6003500,5901180,83.31116156831914,79.90331167239437,NaN,NaN,40.8086543715671,33.394316110060586
1998-11-25T09:30:00-05:00,93.26562,93.34375,92.625,93.125,155300,436235,71.77418263724496,69.55522970303572,NaN,NaN,136.58077654604327,138.66923024913132,0.20259767327355416,2.394190931576105,2.191593258302551,6158800,6058160,84.3400034456513,80.34227528801614,NaN,NaN,41.353018732341766,34.53127362752932
1998-11-27T09:30:00-05:00,93.71875,93.71875,93.25,93.25,71000,419105,72.1044722202559,69.53406575101462,NaN,NaN,135.05194052632174,145.4117618713661,0.1599801425842733,2.391568436532893,2.2315882939486196,6229800,6175180,85.07847891311839,80.72665348043579,NaN,NaN,41.890193680600554,35.58254792082521
1998-11-30T09:30:00-05:00,93.0625,93.0625,90.75,90.8125,527600,411550,57.8810514964736,68.836386239519,NaN,NaN,56.598325644498495,132.8220397012507,-0.05101864350070917,2.167814989572733,2.218833633073442,5702200,6120300,83.0993204184816,80.9322808104968,NaN,NaN,37.72022700655845,35.88793064735853
1998-12-01T09:30:00-05:00,90.25,91.90625,89.875,91.26562,379800,400595,59.481169624034486,68.40341964739676,NaN,NaN,29.243794128525405,103.25038597122969,-0.17190573616200977,2.00395146287093,2.1758571990329396,6082000,6035260,79.9939608700757,80.85053156047147,NaN,NaN,34.84294010641285,35.73864628436629
1998-12-02T09:30:00-05:00,90.53125,90.98437,89.51562,90.75,317600,379915,56.83515185842403,67.88580014915134,NaN,NaN,-4.313886032718416,70.6321901625341,-0.2914063796862534,1.8115992244251231,2.1030056041113765,5764400,5987440,78.2237537801946,80.69775965055422,NaN,NaN,31.65048429934883,35.15462314364951
1998-12-03T09:30:00-05:00,90.34375,90.98437,88.5625,88.82812,638700,376520,48.22405998272085,66.69296329751506,NaN,NaN,-55.815486838906544,32.152937485544136,-0.49285365638785583,1.4869385336265566,1.9797921900144124,5125700,5780820,70.92096134104092,80.11775919463649,NaN,NaN,25.846143637227243,33.824840357017756
1998-12-04T09:30:00-05:00,89.625,90.625,89.375,90.5,1230600,414920,54.659665776105,65.76746690657573,NaN,NaN,-25.196890328059734,0.1031713146678392,-0.5046346153760777,1.3489989207943154,1.853633536170393,6356300,5806120,71.27459155538908,79.65842124732175,NaN,NaN,22.997439805930462,32.278068849719574
1998-12-07T09:30:00-05:00,90.59375,90.98437,90,90.75,522900,421065,55.54939671085562,64.7347299281026,NaN,NaN,-6.4727877199718185,-12.511051358226222,-0.4865097189949674,1.2454963874266838,1.7320061064216512,6879200,6041520,74.39470076698166,79.38812675956297,NaN,NaN,21.05442134337545,30.674690634527558
1998-12-08T09:30:00-05:00,90.5625,91,89.4375,90.3125,405500,425055,53.568304870592,63.731177934216596,NaN,NaN,-28.002370765431316,-23.960284337017566,-0.4933563386735962,1.115310683079656,1.6086670217532522,6473700,6119860,75.35412273114272,79.18062065879091,NaN,NaN,18.861552204477018,28.987099430234622
1998-12-09T09:30:00-05:00,90.1875,90.65625,89.65625,90.0625,310100,423290,52.41789791753523,62.496310300575715,NaN,NaN,-40.00204406049106,-31.097915942572094,-0.5024054388653696,0.9806602231715402,1.4830656620369098,6163600,6199700,76.32763858454291,78.96837493787328,NaN,NaN,16.738360556216854,27.237279591089226
1998-12-10T09:30:00-05:00,89.89062,90.03125,88.17187,88.28125,422700,426175,45.00227532849151,60.71518648303184,NaN,NaN,-116.41657607399465,-43.218133789589714,-0.6089363564881205,0.7218952164267591,1.3308315729148796,5740900,6322740,77.78401865225872,78.7964065323065,NaN,NaN,12.421993315538293,25.12081012315338
1998-12-11T09:30:00-05:00,88.01562,88.60937,87.26562,87.96875,548700,435890,43.8307366920399,58.65119725235659,NaN,NaN,-162.08204304025776,-70.59516433202933,-0.6758623791404075,0.4860035989893703,1.1618659781297778,5192200,6089920,69.1186501259607,77.95060269384332,NaN,NaN,8.575755067195733,22.757230829445145
1998-12-14T09:30:00-05:00,87.625,87.98437,86.51562,86.51562,393500,435150,38.77573492306082,55.842891902351035,NaN,NaN,-195.55288017137082,-108.41118282230912,-0.7857083630074577,0.17973052437045567,0.9654388873779134,4798700,5673820,56.915097948329475,76.15260433582046,NaN,NaN,3.5522218038042634,20.013658111496447
1998-12-15T09:30:00-05:00,87.51562,88.375,86.51562,88.21875,637200,453325,46.55561087800814,54.04712220827444,NaN,NaN,-141.29556160352084,-131.06982098992702,-0.713481511187012,0.0735869983941484,0.7870685095811604,5435900,5466260,51.98454225991747,73.91498867093462,NaN,NaN,1.7031443245198656,17.39787042764265
1998-12-16T09:30:00-05:00,88.59375,88.59375,87.5625,87.875,537800,449280,45.304291903803,52.1564157273143,NaN,NaN,-111.58813682398649,-145.3870395426261,-0.65992211524491,-0.03783413447497708,0.6220879807699329,4898100,5213160,46.67468394178125,71.22460870637248,NaN,NaN,-0.16333925222576526,14.88912618766145
1998-12-17T09:30:00-05:00,88.15625,89,88.15625,88.71875,1114300,492515,48.932532543787886,50.50127717899515,NaN,NaN,-74.74672614070654,-137.05306955596848,-0.5435832192639847,-0.05739104331004796,0.4861921759539367,6012400,5267460,47.90411587563371,68.56929706083784,NaN,NaN,-0.5852638546261166,12.678499038763226
1998-12-18T09:30:00-05:00,89.125,89.375,88.53125,88.71875,289100,493430,48.932532543787886,49.86209725380331,NaN,NaN,-58.201868599164825,-116.2770346677499,-0.4466012438018467,-0.07205937879837165,0.374541865003475,6012400,5431500,51.53905813359263,66.3149926119172,NaN,NaN,-0.9207071143062098,10.73575530261045
1998-12-21T09:30:00-05:00,89.28125,91.1875,89.125,89.8125,483500,501010,53.56354102586033,49.43940949679087,NaN,NaN,-6.455700123635649,-78.45759865820287,-0.29601730215052496,0.004520237315318809,0.3005375394658438,6495900,5770940,58.06013179999733,64.74829053548304,NaN,NaN,0.18871460184820604,9.229035202501558
1998-12-22T09:30:00-05:00,90.28125,90.78125,89.4375,90.34375,317700,490365,55.666490914471154,49.355933715079956,NaN,NaN,7.866806488099629,-48.62512503987878,-0.15495329817170567,0.10684591675121169,0.26179921492291736,6813600,6046480,62.47442276347114,63.62333832000279,NaN,NaN,1.7436828877006407,8.15969915753
1998-12-23T09:30:00-05:00,91.23437,92.3125,90.6875,92.0625,657600,498060,61.708371256634535,50.31909880607378,NaN,NaN,88.62487651281204,-8.58252237251907,0.048885630813901515,0.3229062534402942,0.2740206226263927,7471200,6561100,69.03063351584407,63.48831490391729,NaN,NaN,5.09211884414456,7.721473398474937
1998-12-24T09:30:00-05:00,92.125,92.53125,91.8125,92.09375,346900,507640,61.81027930581386,50.8298569153387,NaN,NaN,117.35957797275137,29.838738450172514,0.17358136522259615,0.4909973291546379,0.31741596393204174,7818100,6922240,72.64282224455677,63.58604566742927,NaN,NaN,7.785009135946412,7.730549932399433
1998-12-28T09:30:00-05:00,92.78125,92.78125,91.8125,91.9375,274000,517790,60.9370253009559,51.21468752891729,NaN,NaN,127.1061581169419,66.90034379339387,0.22977348307227352,0.6046328177723836,0.3748593347001101,7544100,7228580,75.27703837142339,63.64906978203224,NaN,NaN,9.746729986473994,8.018575654410085
1998-12-29T09:30:00-05:00,92.3125,93.53125,91.78125,93.48437,598800,521350,66.05065989364101,52.106284316277936,NaN,NaN,157.2530535996231,99.64209453804563,0.348248616882411,0.8101701058031239,0.4619214889207129,8142900,7557980,77.75716996830893,63.8207160132584,NaN,NaN,13.117763011628666,8.747030991155597
1998-12-30T09:30:00-05:00,93.0625,93.46875,92.625,92.625,202600,512490,61.253273107469575,52.7373825441304,NaN,NaN,142.5702678105597,126.58278680253764,0.3451965317628912,0.8934171536243269,0.5482206218614357,7940300,7783320,79.28789717892647,64.03216305571436,NaN,NaN,14.548489529360678,9.575810782327752
1998-12-31T09:30:00-05:00,92.625,92.875,91.5,91.53125,870300,540125,55.70748018848155,53.50204003412968,NaN,NaN,88.41483967179232,126.5407794343337,0.25038917876948696,0.8612070953232944,0.6108179165538075,7070000,7703080,77.24926246871489,63.99396618546122,NaN,NaN,14.072382827575128,10.218178217363091
1999-01-04T09:30:00-05:00,92.09375,93.625,91.0625,91.95312,490200,532700,57.31285597425221,54.465048554287705,NaN,NaN,89.30856376304465,120.93057659239234,0.1991939996216775,0.8598104160809044,0.6606164164592269,7560200,7651500,75.89831106357377,64.47822768100501,NaN,NaN,14.162176762219858,10.781606580914058
1999-01-05T09:30:00-05:00,91.9375,93.4375,91.9375,93.21875,473000,494820,61.78755609126991,56.10875006630265,NaN,NaN,102.7526638784408,116.05987774469213,0.23141061062387425,0.9498796797390696,0.7184690691151954,8033200,7749320,76.72946738670139,65.89353978374587,NaN,NaN,15.63273361952966,11.474624729287715
1999-01-06T09:30:00-05:00,94.1875,95.8125,93.84375,95.65625,701400,503745,68.6118161786782,57.68419330206479,NaN,NaN,160.6001332962545,116.72929368401837,0.3884778418598719,1.2040663714400353,0.8155885295801634,8734600,7867660,77.73002820712924,67.73250306568956,NaN,NaN,19.361842462052614,12.6013701196827
1999-01-07T09:30:00-05:00,94.25,95.48437,94.10937,95.25,450300,505985,66.48083005192944,59.196803169788105,NaN,NaN,132.47350955620504,114.70994203314744,0.4331983982332115,1.3570865273716777,0.9238881291384662,8284300,7936460,78.31382497297795,69.99244171077504,NaN,NaN,21.61345970257219,13.888811488666914
1999-01-08T09:30:00-05:00,96.26562,96.625,95.3125,96.51562,446300,512795,69.64398920682565,60.67619293143366,NaN,NaN,147.08138531338406,126.44325116146578,0.510865400687347,1.56246987999765,1.051604479310303,8730600,8268580,80.91476745483365,72.3503453950036,NaN,NaN,24.572960448044256,15.415118482863676
1999-01-11T09:30:00-05:00,96.34375,96.45312,95.25,96.34375,603000,521810,68.69591973521642,62.08786344510713,NaN,NaN,129.30161942599022,134.4418622940549,0.5122095455120499,1.6918664112003654,1.1796568656883155,8127600,8382060,81.721442620983,74.50623000124577,NaN,NaN,26.61692636775314,17.015376752133598
1999-01-12T09:30:00-05:00,95.9375,96.0625,94.53125,94.53125,539600,521355,59.49741490195414,62.51171157911383,NaN,NaN,95.12792125643908,132.91691376965457,0.3597769365485417,1.6293780363739927,1.269601099825451,7588000,8293020,78.90340063157987,75.9950349177874,NaN,NaN,25.42723723269727,18.217071106499837
1999-01-13T09:30:00-05:00,91.8125,94.375,91.8125,93.34375,1082800,555820,54.361497867231606,62.41849779002529,NaN,NaN,34.58958268446574,107.71480364729682,0.1580168421784376,1.467122152548498,1.3091053103700605,6505200,7847140,66.531023143901,76.28479208781809,NaN,NaN,22.72616888760302,18.86122793237172
1999-01-14T09:30:00-05:00,93.5,93.5,90.71875,90.875,604100,554165,45.55702368579501,61.2648301063939,NaN,NaN,-23.60390137377196,76.49932146130142,-0.14621070098592348,1.1263419341376562,1.2725526351235796,5901100,7370500,56.357600009127474,75.3795754087669,NaN,NaN,17.14995946800491,18.616761008890744
1999-01-15T09:30:00-05:00,92.125,93.5,91.53125,93.46875,470100,550780,53.9886716477048,60.70614384510039,NaN,NaN,10.452909644724594,49.17362632756952,-0.17530457856544635,1.0534219119167716,1.228726490482218,6371200,6898620,48.45754552419723,73.65205564302694,NaN,NaN,15.43392788077959,18.16207056201772
1999-01-19T09:30:00-05:00,94.3125,94.3125,92.01562,93.0625,1505900,570360,52.61423782776424,60.1116590255867,NaN,NaN,15.217092832842079,26.35672100893989,-0.22147829250116158,0.951878624855766,1.1733569173569276,4865300,6246160,40.08964018077334,71.13867005798049,NaN,NaN,13.65070718966794,17.517590080253466
1999-01-20T09:30:00-05:00,94.1875,94.75,92.75,93.625,687500,590280,54.34725137414743,59.27570127419431,NaN,NaN,34.18910904003633,14.168958565659356,-0.21360865893813163,0.9063460936842631,1.1199547526223947,5552800,5839120,35.92205572182803,68.15044761180329,NaN,NaN,12.815867112664892,16.845915370597957
1999-01-21T09:30:00-05:00,93,93.78125,92.03125,92.125,944500,613330,49.18176077236983,58.41345039311575,NaN,NaN,-29.727122594819,1.305617509802407,-0.3034153156334727,0.740685608080554,1.0441009237140266,4608300,5459740,32.52791033205631,64.81044855131256,NaN,NaN,10.385875593469153,15.923052545293842
1999-01-22T09:30:00-05:00,90.9375,92.10937,90.75,91.3125,550700,624980,46.59819298546663,57.76278702147183,NaN,NaN,-106.6005935556343,-15.293720926570057,-0.40516957666254727,0.5376389528858425,0.9428085295483898,4057600,5091040,29.600695705348556,61.4069794967864,NaN,NaN,7.575057780827242,14.730481864655756
1999-01-25T09:30:00-05:00,91.40625,92.28125,90.375,92.28125,608400,622520,49.972594791959054,57.23848265130804,NaN,NaN,-91.6463736098115,-35.71357757747728,-0.39447956102254933,0.4497090782702031,0.8441886392927525,4666000,4750000,27.16550462296891,57.9260647510289,NaN,NaN,6.320112458289801,13.529000520889191
1999-01-26T09:30:00-05:00,92.3125,93.71875,91.84375,93.71875,459600,628155,54.5608912205607,56.72229230340023,NaN,NaN,-11.148029244180943,-40.98660199288189,-0.28305841082915284,0.4903656257563114,0.7734240365854642,5125600,4802060,28.13739572412868,54.45520248941657,NaN,NaN,6.7295607427530015,12.55765198115545
1999-01-27T09:30:00-05:00,93.82812,94,91.5,91.6875,487100,638810,47.87860347423149,55.2413485387969,NaN,NaN,-53.37171668974128,-58.4987671388374,-0.3350641917843379,0.3545937968550419,0.6896579886393798,4638500,4619200,26.785392463024536,50.81629993626624,NaN,NaN,4.852306052081605,11.456888277002044
1999-01-28T09:30:00-05:00,92.46875,93.15625,92.21875,92.46875,268200,622280,50.395007883979304,54.092361241086174,NaN,NaN,-39.084672854253895,-60.37027719072438,-0.3065257195477422,0.30650083920470195,0.6130265587524442,4906700,4678880,28.001335042126726,47.22255065549115,NaN,NaN,4.151682903723384,10.413287509390807
1999-01-29T09:30:00-05:00,93.21875,94,92.0625,93.28125,306900,627495,52.9397103604772,52.899198466347,NaN,NaN,-10.269445561193491,-41.10404759183622,-0.2263067675713325,0.33014309928827856,0.5564498668596111,5213600,4910080,32.66673318563659,43.77626249340564,NaN,NaN,4.381310253585401,9.551576472847177
1999-02-01T09:30:00-05:00,93.98437,94.34375,93.15625,93.34375,191400,593550,53.13885373689039,51.787979466466574,NaN,NaN,14.829593737536104,-19.808854122366697,-0.16524815109221624,0.3498896779943408,0.515137829086557,5405000,5057880,35.542216955702614,40.47774637445705,NaN,NaN,4.623000844203199,8.847494240183751
1999-02-02T09:30:00-05:00,93.28125,93.3125,91.875,92.65625,473600,592720,50.602217523981366,51.1526082251828,NaN,NaN,-47.63959861378913,-27.107167996288343,-0.1668862691764631,0.30652999261597813,0.47341626179244123,4931400,5019040,35.117794900904784,37.35020310798025,NaN,NaN,4.090138961444179,8.167872057506669
1999-02-03T09:30:00-05:00,92.21875,94,92.21875,93.875,238100,580975,54.72796491087488,51.178784442585886,NaN,NaN,-3.154287393047452,-17.063682136949577,-0.08570282377311633,0.3662877320760458,0.45199055584916215,5169500,5125240,37.32173788526919,35.263825589506546,NaN,NaN,4.850626515600717,7.69397983723439
1999-02-04T09:30:00-05:00,93.53125,94,92.76562,93.5,442800,568045,53.25412684002123,51.72857752503062,NaN,NaN,6.299793729941798,-7.986788820110443,-0.05837826489150577,0.3790177247347799,0.4373959896262857,4726700,5089240,36.864600278471436,33.87146846588826,NaN,NaN,5.058575773716247,7.317493542446083
1999-02-05T09:30:00-05:00,93.21875,93.48437,92.4375,93.0625,438700,567465,51.51122152834838,51.55161680221945,NaN,NaN,-18.31203546871994,-9.595306801615726,-0.07009935930416616,0.349771790496078,0.41987114980024415,4288000,4904120,34.52291727516808,32.8761378766719,NaN,NaN,4.747205465271056,6.950309531421079
1999-02-08T09:30:00-05:00,93.5,93.78125,92.0625,92.8125,335500,561925,50.49424933118589,51.40018905246385,NaN,NaN,-17.630199791750158,-16.087265507472978,-0.09355349103906313,0.3029292860014152,0.39648277704047835,3952500,4613620,31.17619856394974,32.2394634754702,NaN,NaN,4.211694509043795,6.55907881393861
1999-02-09T09:30:00-05:00,92.65625,92.84375,91,91.375,341700,548860,44.99363901611627,50.732073884033056,NaN,NaN,-121.47996070504028,-30.855337925723212,-0.19870240737265266,0.14810476782466253,0.3468071751973152,3610800,4349500,28.473529537641298,31.707425890885435,NaN,NaN,2.152266169035889,5.929534150381079
1999-02-10T09:30:00-05:00,91.5,91.92187,90.96875,91.625,751900,559475,46.093473037904374,50.51148190299981,NaN,NaN,-133.47557451095403,-56.91959534930453,-0.24139876138508692,0.04505872346595652,0.28645748485104344,4362700,4188140,26.93714291856361,31.308085361350237,NaN,NaN,0.7402710702474045,5.188210853219125
1999-02-11T09:30:00-05:00,92.125,94.34375,91.51562,94,687700,539720,55.24798363490156,51.129324092245156,NaN,NaN,67.81141863180528,-44.617270368931834,-0.10655011359242661,0.15326984286051015,0.25981995645293676,5050400,4252880,28.60173701659035,31.236731169296082,NaN,NaN,2.2005883212846427,4.761407634371342
1999-02-12T09:30:00-05:00,93.46875,93.98437,92.3125,92.90625,410400,530035,50.95627174109045,51.199586731468834,NaN,NaN,38.27359633247385,-33.300144008693074,-0.08861335933647191,0.14905325728234686,0.23766661661881877,4640000,4323280,30.457184290963312,31.471851145581393,NaN,NaN,2.123767728800332,4.384601933575484
1999-02-16T09:30:00-05:00,93.59375,93.96875,92.5,92.70312,728100,542935,50.17669854923323,50.8864301120883,NaN,NaN,35.0679072751161,-22.76052259531982,-0.08785573376689632,0.12784694941019836,0.21570268317709468,3911900,4315160,30.35918585469453,31.630550440621814,NaN,NaN,1.8324579695513334,4.020009938714891
1999-02-17T09:30:00-05:00,92.48437,93.79687,91.8125,92.4375,466000,490940,49.11847955327949,50.97499268916316,NaN,NaN,-7.333138282773132,0.06884188913360897,-0.10169309405051402,0.08858631561395214,0.19027940966446616,3445900,4282180,29.93784914847953,31.85572591815431,NaN,NaN,1.2924220063173992,3.6303545198009632
1999-02-18T09:30:00-05:00,92.73437,93.3125,91.96875,93.03125,589200,486025,51.57688617546351,51.05941256712631,NaN,NaN,10.022554613083354,28.768467713941085,-0.06887816653711237,0.1041817014930757,0.17305986803018808,4035100,4216660,29.07455234566187,31.93238429697825,NaN,NaN,1.5221420648015682,3.329181311943907
1999-02-19T09:30:00-05:00,93.0625,93.98437,92.59375,93.53125,382200,457910,53.609584656263145,51.107260731111026,NaN,NaN,80.84296278300684,31.374776544181394,-0.014368620270620303,0.1550990926919127,0.169467712962533,4417300,4090040,27.42846046655326,31.55822195990087,NaN,NaN,2.2834059419426933,3.179784830515162
1999-02-22T09:30:00-05:00,93.46875,95.73437,93.375,95.6875,418500,451300,61.17810192215779,51.68149274434442,NaN,NaN,253.44492173559146,74.40904162480491,0.1566119669377113,0.3652326716346721,0.2086207046969608,4835800,4129200,28.771594383597304,31.074606061893345,NaN,NaN,5.350646881488333,3.4899079806541864
1999-02-23T09:30:00-05:00,95.34375,96.125,94.5625,95.5625,632800,452520,60.561261195758284,52.392853006614196,NaN,NaN,269.22391227841496,121.24024262546467,0.2456902653398581,0.5157335363717834,0.2700432710319253,4203000,4187420,30.821520431020573,30.76772931404447,NaN,NaN,7.647344873335399,4.083827536751502
1999-02-24T09:30:00-05:00,95.71875,96.09375,93.75,93.875,695600,464320,52.8187224768275,52.25647854703938,NaN,NaN,141.3752343439514,150.98191715080958,0.17848908670429026,0.49315462941228816,0.3146655427079979,3507400,4199720,31.271548007065675,30.335572894172792,NaN,NaN,7.346397273492515,4.549908927714504
1999-02-25T09:30:00-05:00,93.28125,93.84375,92.25,93.1875,1438600,511895,50.01336533391101,52.02499558231722,NaN,NaN,-11.818502944594778,146.61370563927397,0.08026860741126812,0.41500130197208307,0.33473269456081495,2068800,3806460,25.548871650769,29.52730656362262,NaN,NaN,6.239178382178109,4.791233135495019
1999-02-26T09:30:00-05:00,93.71875,93.8125,92.4375,92.89062,356200,516295,48.8078225697005,51.83189565669951,NaN,NaN,-19.564817320714894,126.53214961852962,-0.007499781316438747,0.3253579679152665,0.33285774923170525,1712600,3265520,20.10006623726322,28.497102918057983,NaN,NaN,4.978442709069856,4.817977360291424
1999-03-01T09:30:00-05:00,93,93.5625,92.25,93.0625,336900,517795,49.56579052798424,51.765577170756536,NaN,NaN,-28.01955793705128,70.23925368400106,-0.05418377659113849,0.26512802849278216,0.31931180508392065,2049500,2708260,16.25423970287227,27.43124871369531,NaN,NaN,4.152355257777791,4.722888488503762
1999-03-02T09:30:00-05:00,93.625,94.23437,92.64062,93.28125,242000,520325,50.568914914821505,52.163811163521196,NaN,NaN,19.406143366390125,20.275699901596095,-0.0695549881222578,0.23236806993109838,0.3019230580533562,2291500,2325960,14.24112869000895,26.41464865315014,NaN,NaN,3.7321854425996817,4.581359481946036
1999-03-03T09:30:00-05:00,93.03125,93.35937,92,92.84375,201200,506705,48.491561358739375,52.33510318643799,NaN,NaN,-53.01468896425018,-18.60228476004422,-0.10621598111703878,0.16915308165705767,0.27536906277409645,2090300,2042540,12.959666573376154,25.41625748563675,NaN,NaN,2.8112369633549723,4.328484836433027
1999-03-04T09:30:00-05:00,93.5,94.96875,93.35937,94.96875,584900,524045,57.60197282745601,52.50324527162045,NaN,NaN,116.29478449579587,7.020372728033914,0.00947568438958235,0.2872136682610744,0.27773798387149207,2675200,2163820,16.425276564092158,24.546510310458306,NaN,NaN,4.6793178142032374,4.378603833257343
1999-03-05T09:30:00-05:00,96.34375,97.84375,96.1875,97.625,1525300,578170,65.7554940822766,53.560332581705175,NaN,NaN,270.0509684361607,64.94352987940903,0.2484758333078253,0.5883327755062737,0.3398569421984484,4200500,2661400,28.92828066436782,24.437302908558628,NaN,NaN,9.274042599575008,5.0779522284455805
1999-03-08T09:30:00-05:00,97.6875,97.78125,96.79687,97.46875,298300,571150,64.96407128700501,54.61657349154602,NaN,NaN,206.3240749617383,111.81225645916693,0.37218106183806005,0.8050832694960235,0.43290220765796344,3902200,3031940,36.54177784147637,24.878916621900192,NaN,NaN,12.601618265046433,6.152761662245702
1999-03-09T09:30:00-05:00,97.3125,98.34375,96.75,96.9375,848200,596785,62.22196773459623,55.552536933068644,NaN,NaN,164.32862883282357,140.79675355245362,0.3923569355540939,0.9233483771005808,0.5309914415464869,3054000,3184440,39.418176897844596,25.556082889711977,NaN,NaN,14.477337052794315,7.341986718038361
1999-03-10T09:30:00-05:00,97.125,97.9375,96.8125,97.9375,180300,588715,65.19966019992827,56.52559222053041,NaN,NaN,146.84943267509388,180.76957788032243,0.4434114996292491,1.0852558160830483,0.6418443164537992,3234300,3413240,43.55225514796117,26.590204518447642,NaN,NaN,17.007986014079208,8.72284376032991
1999-03-11T09:30:00-05:00,98.625,99.71875,98.03125,99.3125,758500,589045,68.83687456848016,57.61325578568877,NaN,NaN,175.81174593279448,192.67297016772218,0.5340648634204397,1.309425395729349,0.7753605323089092,3992800,3676760,47.957188573279026,28.056542240356627,NaN,NaN,20.383052980685687,10.38858793466645
1999-03-12T09:30:00-05:00,99.84375,99.85937,98.64062,98.64062,411300,575225,65.24825035786478,57.90398067395356,NaN,NaN,146.64248516034368,167.99127351255876,0.5129414470208301,1.4165373410849469,0.9035958940641168,3581500,3552960,46.135719518706615,29.296836892864434,NaN,NaN,22.04166216942749,12.053312825346598
1999-03-15T09:30:00-05:00,98.90625,99.75,98.75,99.73437,204000,564905,68.15838425799413,58.44663232125612,NaN,NaN,134.59279437319097,153.6450173948493,0.5343751191174031,1.5715647929608707,1.0371896738434676,3785500,3529620,45.78267123798595,30.36549052193339,NaN,NaN,24.37550738191531,13.813626333427843
1999-03-16T09:30:00-05:00,99.9375,100.125,99.28125,99.4375,644400,560720,66.52989072904049,59.42600148212847,NaN,NaN,121.52316317384611,145.0839242630538,0.49139509265924364,1.6514335396675222,1.1600384470082785,3141100,3547040,46.11411041506369,31.425673551076102,NaN,NaN,25.771517116764148,15.521896445333029
1999-03-17T09:30:00-05:00,99.46875,99.75,98.6875,98.92187,608100,567825,63.68377786987998,60.402459520411966,NaN,NaN,94.38465156715658,134.59096804146634,0.3952141509038234,1.6540561356380579,1.2588419847342345,2533000,3406780,43.792771642641824,32.728809264781304,NaN,NaN,26.094872452847213,17.032321589263628
1999-03-18T09:30:00-05:00,98.78125,100.46875,98.625,100.3125,399800,558355,67.69735400491032,61.751711765784094,NaN,NaN,101.80745369207115,119.79010959332166,0.3914821568469147,1.7481946807928779,1.3567125239459632,2932800,3194780,40.476187647846764,34.184246508394416,NaN,NaN,27.610570547579165,18.543500011880134
1999-03-19T09:30:00-05:00,100.51562,100.75,98.5625,98.5625,501000,564295,58.87873728759401,62.41692224861337,NaN,NaN,79.64981256310627,106.3915750738742,0.2445710729291668,1.6624263651074216,1.4178552921782548,2431800,2964840,37.18662138091155,35.679416628254366,NaN,NaN,26.092386953739844,19.621912432145805
1999-03-22T09:30:00-05:00,98.6875,99.4375,98.5625,99.125,118500,549295,60.652967297265285,63.13721170450221,NaN,NaN,66.49852406937265,92.77272101311051,0.16264035173608526,1.6211557318483614,1.458515380112276,2550300,2717800,33.99042760141168,37.090080836211705,NaN,NaN,25.409845895288946,20.448760069737684
1999-03-23T09:30:00-05:00,98.4375,99.4375,96.28125,96.625,824500,558880,50.27132668607365,63.264337799311804,NaN,NaN,19.344845233446996,72.33705742503071,-0.0700792788929121,1.370916281496136,1.440995560389048,1725800,2434740,30.73115171421388,38.35947263198583,NaN,NaN,21.183416733982355,20.55371102177264
1999-03-24T09:30:00-05:00,96.84375,97.10937,96.1875,96.84375,253600,536780,51.06066778046339,62.797101724526605,NaN,NaN,-5.1427994804113215,52.43156721551712,-0.2114469307447564,1.1766868969581026,1.388133827702859,1979400,2324020,29.538047081259194,39.29609909749776,NaN,NaN,18.14278432507944,20.209292922245037
1999-03-25T09:30:00-05:00,97.84375,98.73437,97.40625,98.625,385500,484125,57.040373799854706,62.17459313292505,NaN,NaN,37.99913935337515,39.669904347777944,-0.1879491761303711,1.153197357539895,1.3411465336702661,2364900,2210440,28.323251308804046,39.25288271495749,NaN,NaN,17.475083356180818,19.818691555664433
1999-03-26T09:30:00-05:00,97.96875,98.5,97.5,98.28125,258900,479260,55.62778399761645,61.50771546939729,NaN,NaN,27.508919690160702,29.241725773188836,-0.19753293126364957,1.0942303695907043,1.2917633008543539,2106000,2145280,27.62142212516683,38.615714449506804,NaN,NaN,16.496808694894273,19.344136861268694
1999-03-29T09:30:00-05:00,99.21875,100.5,99,99.875,441200,484475,60.51066057609665,61.38547924379018,NaN,NaN,88.98351775789675,33.73872451089365,-0.10325219837704758,1.1626980528830444,1.265950251260092,2547200,2144660,27.614410488701793,37.77258827742518,NaN,NaN,17.24050936263723,19.043618647178484
1999-03-30T09:30:00-05:00,98.9375,99.85937,98.6875,99.28125,552000,499975,57.952064955407415,60.86779386918154,NaN,NaN,61.95682492646699,42.26112044949765,-0.0881793753538076,1.1557260320678324,1.24390540742164,1995200,2198540,29.294177755224297,36.75415417794397,NaN,NaN,17.036326102082338,18.756862569307607
1999-03-31T09:30:00-05:00,99.75,99.98437,97.65625,97.75,452900,512560,51.8616955894812,59.655281084967335,NaN,NaN,9.516382203593492,45.19295678629861,-0.18317075920602166,1.0149419584141128,1.1981127176201345,1542300,2111120,28.15265580372295,35.339544694404246,NaN,NaN,14.882622410550928,18.203399689485224
1999-04-01T09:30:00-05:00,98.5,98.625,97.5625,98.26562,267500,496690,53.62891436422836,58.825328513993306,NaN,NaN,-27.727944938466262,32.04753992793032,-0.21112470557205865,0.9342068356550612,1.1453315412271199,1809800,2000100,26.728203760305504,33.95329356880417,NaN,NaN,13.687629047449027,17.558289597765768
1999-04-05T09:30:00-04:00,99.34375,100.34375,98.8125,100.125,457400,443295,59.41503854068932,58.2008038199001,NaN,NaN,91.29178030751454,44.804112051401106,-0.10935867295076873,1.008633200038659,1.1179918729894278,2267200,2032340,27.869571175010535,32.67378642144878,NaN,NaN,14.516218226158975,17.12370797325051
1999-04-06T09:30:00-04:00,99.5625,100.32812,99.1875,99.625,231600,439960,57.34295579707768,57.54459418190277,NaN,NaN,81.25541189895972,43.258490879613696,-0.08194228330573283,1.0155640188572619,1.0975063021629947,2035600,1930020,26.46079591512961,31.269978242882065,NaN,NaN,14.535980620444352,16.754032637135346
1999-04-07T09:30:00-04:00,100.375,101.09375,99.375,101,313900,413245,61.336256285997585,57.37691406876831,NaN,NaN,138.48067661534412,58.56326121738912,0.017280860762118877,1.1191073781156433,1.1018265173535244,2349500,2000880,29.13247324951135,30.222814071944168,NaN,NaN,15.826767526122959,16.621566192705004
1999-04-08T09:30:00-04:00,101.03125,102.15625,100.46875,102.0625,362600,422360,64.13057877141341,57.122144409232796,NaN,NaN,213.01840372206928,99.26366552108428,0.13632723968340055,1.2722355669577752,1.1359083272743746,2712100,2234840,37.23974827177226,29.991639830795993,NaN,NaN,17.799642520907764,16.789862811019685
1999-04-09T09:30:00-04:00,101.59375,102.59375,101,101.875,402300,404550,63.26167767775041,57.43521157995825,NaN,NaN,194.1299982531891,143.63525415941535,0.18147503314559454,1.3627521187063678,1.1812770855607733,2309800,2334840,40.37930087810908,30.219688366310102,NaN,NaN,19.11853418349214,17.12253014994432
1999-04-12T09:30:00-04:00,100.625,103.625,100.625,103.51562,900800,429025,67.4210999635506,57.91864962755005,NaN,NaN,203.84554427245013,166.14600695240247,0.29419063222824704,1.549015375846082,1.254824743617835,3210600,2523520,45.88038558444065,31.068971079383598,NaN,NaN,21.595494966734435,17.76152512377148
1999-04-13T09:30:00-04:00,103.375,104.28125,103,104.125,1310900,484370,68.83259457009459,59.2444544764087,NaN,NaN,220.6940244713142,194.03372946687335,0.37686583731544654,1.7259070402621433,1.3490412029466967,4521500,3020700,57.11030606202931,32.953196389941844,NaN,NaN,24.068623500986895,18.662539177659397
1999-04-14T09:30:00-04:00,104.78125,105.21875,103.57812,104.34375,1553700,529835,69.34601633599289,60.55055080180367,NaN,NaN,195.1943268440899,205.37645951262252,0.4105902870680074,1.862279061781706,1.4516887747136986,6075200,3765840,67.87077406731525,35.69124831751727,NaN,NaN,26.229914224326706,19.743592755754726
1999-04-15T09:30:00-04:00,104.3125,105.15625,103.5,104.84375,1917400,595300,70.54056716259592,61.51485032771375,NaN,NaN,160.1924660448462,194.8112719771779,0.4288783599581192,1.9877867246613476,1.5589083647032285,7992600,4821940,76.76743772061462,39.15154734693232,NaN,NaN,28.389238317259775,20.978684978826877
1999-04-16T09:30:00-04:00,105,105.21875,103.53125,104.53125,2049400,677780,68.73764466142387,62.45126894655714,NaN,NaN,131.37613702587865,182.2604997317158,0.38370316749528666,2.038537324072337,1.6548341565770501,5943200,5548620,80.72285624964772,42.94450692725237,NaN,NaN,29.700900757937436,22.2247158044141
1999-04-19T09:30:00-04:00,104.9375,107.48437,103.5,104.375,5045898,905024.9,67.80449503735261,62.97225712236114,NaN,NaN,129.86605052647877,167.46460098252155,0.31021556087196345,2.0426036076670044,1.732388046795041,897302,5085960.4,72.28474858608755,46.13524536277993,NaN,NaN,30.549899362395106,23.41402774126853
1999-04-20T09:30:00-04:00,104.25,104.96875,103.125,104.46875,4491000,1123649.9,68.08445430384143,63.695999218677855,NaN,NaN,90.39219019142148,141.40423412654303,0.23808199526820029,2.0299905408802914,1.7919085456120911,5388302,5259320.8,73.40650104386664,49.286125597682954,NaN,NaN,31.336528861231155,24.545813615548905
1999-04-21T09:30:00-04:00,104.51562,106.53125,104.15625,106.5,2419100,1203379.9,73.46777304521619,65.23929046551606,NaN,NaN,118.40062664720521,126.04549408716608,0.2936825636678555,2.1590117501969104,1.8653291865290549,7807402,5605761.2,75.537315505407,52.67074414780325,NaN,NaN,33.66354318540807,25.84834641124307
1999-04-22T09:30:00-04:00,106.96875,107.59375,106.125,107.46875,1891000,1285249.9,75.58307248691632,66.80744461713664,NaN,NaN,138.391972704341,121.68539541906503,0.35795410919362025,2.3127718230210803,1.95481771382746,9698402,5946921.6,77.45320207506302,56.29395831314307,NaN,NaN,36.319288394751965,27.344195266030056
1999-04-23T09:30:00-04:00,107,107.625,106.3125,107.09375,942000,1313074.9,73.15183376396266,67.78864427594188,NaN,NaN,121.60973936828796,119.73211588754688,0.33772039900061923,2.376968212578234,2.0392478135776146,8756402,6509562,80.20645574618874,60.032307211084365,NaN,NaN,37.83644567016589,28.8430881809066
1999-04-26T09:30:00-04:00,107.34375,107.34375,106.40625,107.25,629400,1331599.9,73.53383738555898,68.94513581797625,NaN,NaN,110.02994956810491,115.76489569587211,0.2987145169849006,2.4126409598087406,2.11392644282384,9385802,8207262,85.82940495544096,64.27292214253518,NaN,NaN,39.19799370233703,30.322360398253807
1999-04-27T09:30:00-04:00,108,108.625,107.51562,108.375,2460600,1432569.9,76.16356809462644,70.00422951859261,NaN,NaN,125.49154111243702,122.78476588007523,0.31112988515294493,2.502838799265021,2.191708914112076,11846402,9498882,88.50493844486992,68.51381251363223,NaN,NaN,41.178325934150585,31.873212617667633
1999-04-28T09:30:00-04:00,108.25,109.4375,107.96875,108.26562,2919100,1550924.9,75.37933943661577,70.80771242324991,NaN,NaN,124.32713145048788,123.97006684073176,0.2756398868195964,2.5362587726365717,2.2606188858169753,8927302,9722862,88.89644889819274,72.20357684409083,NaN,NaN,42.59676757965027,33.40514904080801
1999-04-29T09:30:00-04:00,108.8125,109.3125,108.125,108.78125,1922000,1624379.9,76.6024099499674,71.7606218712654,NaN,NaN,121.61828649850983,120.61532959956553,0.251242616205837,2.5746721560742714,2.3234295398684344,10849302,9953042,89.29978544504512,75.69789717030055,NaN,NaN,44.15593965799918,34.940976271835325
1999-04-30T09:30:00-04:00,109.28125,109.5625,106.5,107.625,3761500,1799079.9,68.397222395332,71.83034490210693,NaN,NaN,92.16361450299944,114.72610462650782,0.12780888913804977,2.4831906512909967,2.355381762152947,7087802,9619322,84.50689859787622,78.45693381411738,NaN,NaN,43.201806849588564,36.12109492580007
1999-05-03T09:30:00-04:00,107.9375,110.21875,107.53125,110.21875,1834900,1867954.9,74.89384141326315,72.2632911051904,NaN,NaN,119.33703071822833,116.5875208565325,0.18779656676214085,2.5901274706056228,2.402330903843482,8922702,9526702,83.172656744029,80.31853029140306,NaN,NaN,44.3904891055239,37.3024369514749
1999-05-04T09:30:00-04:00,109.8125,110.40625,108.71875,109.25,2046600,1958704.9,69.17412978539491,72.25101349443341,NaN,NaN,111.92011353143334,113.87323534033177,0.1318261204845803,2.5671135544492074,2.435287433964627,6876102,8532642,70.33698379829572,80.49468812933024,NaN,NaN,43.485473432183035,38.18572787729035
1999-05-05T09:30:00-04:00,109.34375,109.73437,107.75,109.375,2827000,2084359.9,69.49782908358111,72.17653220307521,NaN,NaN,88.94140080396835,106.79608921102786,0.07560954331459424,2.5297993631078697,2.4541898197932754,9703102,8687802,71.08702093298807,80.0889440730712,NaN,NaN,42.870798525854674,38.85502368422811
1999-05-06T09:30:00-04:00,109.21875,109.84375,108.375,109.5,2659100,2199184.9,69.83891054904083,72.2551940521907,NaN,NaN,90.0722531318181,100.48688253768952,0.022013332494869697,2.4817064854118627,2.459693152916993,12362202,8990382,72.54494500283471,79.50480755544172,NaN,NaN,42.474145629538626,39.37204110498676
1999-05-07T09:30:00-04:00,110.0625,110.4375,109.25,110.4375,1749800,2266559.9,72.33734087066057,72.57896875456984,NaN,NaN,109.15871890001809,103.88590341709326,0.024670797487514662,2.4905316497763863,2.4658608522888716,14112002,10395222,78.07320591336465,79.91826879310436,NaN,NaN,42.86758582613895,39.871404636579925
1999-05-10T09:30:00-04:00,110.28125,111.09375,109.625,110,1598000,2301419.9,69.44625806063455,72.67624045148364,NaN,NaN,108.64784033337186,101.74806534012195,-0.025357849528758525,2.4341635403779236,2.459521389906682,12514002,11113482,80.26156428796526,80.40791616768283,NaN,NaN,42.350515451370974,40.22556332440722
1999-05-11T09:30:00-04:00,110.625,111,109.6875,110.21875,1519200,2311834.9,70.08993802628896,72.43496652156027,NaN,NaN,101.82079585261923,99.72820180435913,-0.06384840895881227,2.379710878708167,2.443559287666979,14033202,12544902,83.7436300198232,80.99408149014111,NaN,NaN,42.10151507930954,40.49355643225041
1999-05-12T09:30:00-04:00,110,110.6875,107,110.15625,3325500,2400424.9,69.63852737372495,72.01035615633232,NaN,NaN,59.371899839019676,93.81430161136939,-0.11089257440128808,2.304943569665369,2.415836144066657,10707702,12745822,84.16586986677268,81.47355776097753,NaN,NaN,41.773486226087556,40.67640354565572
1999-05-13T09:30:00-04:00,110.96875,111.5,110.5,111.25,1390300,2374069.9,72.9248468555025,71.99414280572802,NaN,NaN,122.4033448923293,100.28051996347162,-0.08678992109465522,2.3073487426983377,2.394138663792993,12098002,12692982,83.55124111971423,81.71247100194364,NaN,NaN,42.39984056477296,40.922608834101034
1999-05-14T09:30:00-04:00,109.6875,110.10937,108.75,109.125,2026200,2372909.9,59.459090238289,70.98880372378015,NaN,NaN,45.56650397166775,87.56207697780155,-0.2245726146802376,2.113422895442696,2.3379955101229335,10071802,11884942,74.5818172470461,80.90907187991543,NaN,NaN,38.673367333834534,40.60128861977725
1999-05-17T09:30:00-04:00,108.90625,108.9375,107.6875,108.75,1204800,2180855,57.44327177123476,69.65163970068075,NaN,NaN,-2.387080991340338,65.35509271285912,-0.34440635288850396,1.9074875690123037,2.2518939219008076,8867002,11155542,67.53404313755028,79.41115078653546,NaN,NaN,35.020359115722556,39.804012976340864
1999-05-18T09:30:00-04:00,109.1875,109.5,107.625,108.82812,1152500,2013930,57.76450935710473,68.39343755214425,NaN,NaN,-5.017313158090848,43.98747091071711,-0.41700611944905175,1.7306362725894928,2.1476423920385446,10019502,10352802,60.73212613019521,77.39941344596421,NaN,NaN,32.172876195627445,38.71385057909609
1999-05-19T09:30:00-04:00,109.0625,109.3125,108.25,109.0625,679000,1926925,58.7700823202118,67.11969986430456,NaN,NaN,-0.6808706640323312,31.97691681010672,-0.4452721584803352,1.5910521939381255,2.0363243524184607,10698502,10350962,60.7170306579355,75.3577881040278,NaN,NaN,30.08918218228431,37.481755093837265
1999-05-20T09:30:00-04:00,109.4375,109.6875,108.78125,108.8125,1410900,1902920,57.20557169644138,66.32029624295524,NaN,NaN,9.602797045925763,9.416807240826005,-0.4741660581914058,1.4436167796792034,1.9177828378706092,9287602,9788882,56.127493794947945,73.3306877609615,NaN,NaN,27.904988793568602,36.11364562237031
1999-05-21T09:30:00-04:00,108.8125,108.90625,107.75,108.25,747200,1893180,53.73915886602901,64.80924748958138,NaN,NaN,-72.30820699565143,-14.158134952637838,-0.5208011224275808,1.2667814348361333,1.787582557263714,8540402,9482602,53.74358224346569,71.22861101092127,NaN,NaN,25.035884469965957,34.53110831488398
1999-05-24T09:30:00-04:00,108.6875,108.6875,106.15625,106.375,1241800,1923800,44.138102109685036,63.02095979845923,NaN,NaN,-192.55590903140555,-52.19190056065088,-0.6586849904120151,0.9642263192486951,1.6229113096607102,7298602,9168922,51.33860259808166,69.87158378233455,NaN,NaN,19.239361811703105,32.34657310014386
1999-05-25T09:30:00-04:00,106.3125,107.59375,105.0625,105.0625,1253300,1863435,38.89908005725915,60.83533486800767,NaN,NaN,-252.73887047927124,-101.73621202488695,-0.8091350283718743,0.6114925241958673,1.4206275525677416,6045302,8374082,45.751717207783685,68.06191923053423,NaN,NaN,12.401172969733006,29.497230224370877
1999-05-26T09:30:00-04:00,105.96875,107.34375,105.0625,107,1336500,1784305,48.598381331589025,59.318154209618264,NaN,NaN,-171.69140068850686,-135.9383180297819,-0.7503228688201413,0.4827239665425651,1.2330468353627064,7381802,7710742,41.675582288667115,65.85696475095084,NaN,NaN,9.613872963113817,26.65675061561987
1999-05-27T09:30:00-04:00,106.625,106.6875,104.21875,104.875,1617700,1769090,40.925051870918935,57.07441928106528,NaN,NaN,-201.05599313488244,-178.0700760659435,-0.8209813702033042,0.20682012260857618,1.0278014928118804,5764102,7006042,37.820600425410206,62.98177864466836,NaN,NaN,4.32390027275543,23.466343423782092
1999-05-28T09:30:00-04:00,104.96875,105.9375,104.75,105.14062,702700,1616150,42.15452198554226,55.12500956141583,NaN,NaN,-167.2891587679016,-197.06626642039356,-0.8146505721108653,0.00948827767329874,0.8241388497841641,6466802,6591322,35.72618559503606,59.80068016660199,NaN,NaN,0.7277330693947144,20.217970516012468
1999-06-01T09:30:00-04:00,105.20312,106.125,104.0625,106.09375,1968500,1622830,46.46043742252397,53.43718808971833,NaN,NaN,-132.4793836057826,-185.05096133526894,-0.7146642080428603,-0.06919141026941134,0.645472797773449,8435302,6818662,37.760898587165315,56.51619934998358,NaN,NaN,-0.7474794344231781,17.222906237378805
1999-06-02T09:30:00-04:00,106,106.34375,104.65625,105.92187,1111500,1576075,45.79836733396562,51.734319515449805,NaN,NaN,-104.59120647951605,-155.42142853531792,-0.6313844457349533,-0.1437577593952426,0.4876266863397107,7323802,7074362,40.05932329257497,53.36573173754089,NaN,NaN,-2.1104274758883808,14.461001421197778
1999-06-03T09:30:00-04:00,106.3125,106.8125,105.9375,106.75,583900,1463920,49.530103594908496,50.06326642540738,NaN,NaN,-61.040789433277304,-133.29130628427203,-0.4976843656410108,-0.1344787707115529,0.3632055949294579,7907702,7179542,41.024104057911316,50.32807909026924,NaN,NaN,-2.067581474257278,12.099775293275627
1999-06-04T09:30:00-04:00,107.4375,108.3125,106.8125,108.21875,632300,1362580,55.39566622274758,49.7730218528687,NaN,NaN,-6.917881653848666,-94.46368398806526,-0.29737339115471606,-0.008511144013937155,0.2888622471407789,8540002,7734722,45.96772932340192,48.2842156671518,NaN,NaN,-0.09097885361159942,10.358238986577453
1999-06-07T09:30:00-04:00,108.375,109.25,108.125,108.96875,651700,1307675,58.07512515393903,49.818154237347585,NaN,NaN,38.12949382771821,-53.37995346894129,-0.11100380256958287,0.1501074939288003,0.26111129649838316,9191702,8279702,50.365997717028,47.057926708543064,NaN,NaN,2.406909766370501,9.222334812262174
1999-06-08T09:30:00-04:00,108.90625,108.90625,107.375,107.75,574000,1256475,52.55070566398211,49.44573968783883,NaN,NaN,10.714469715735177,-24.741182804637727,-0.06853023189375901,0.1754485066311844,0.2439787385249434,8617702,8316182,50.65554918889668,46.33817121273603,NaN,NaN,2.7585883236620456,8.29894245674787
1999-06-09T09:30:00-04:00,108.03125,108.03125,106.71875,107.125,395400,1200285,49.927763704837226,48.81414550102636,NaN,NaN,-16.1052346991092,-7.0439884485563535,-0.08042650012097191,0.14344561337372852,0.22387211349470043,8222302,8495882,52.13679186550577,45.72529701327676,NaN,NaN,2.2201247024658293,7.4305399204218645
1999-06-10T09:30:00-04:00,106.5625,106.71875,105.34375,106.21875,750600,1071540,46.31773906831526,48.03644317044592,NaN,NaN,-66.66665046208993,-8.169160654318883,-0.14354251770201398,0.04444396636718295,0.18798648406919694,7471702,8408682,51.331551789637416,45.382729727183154,NaN,NaN,0.6328801308260481,6.459445664765319
1999-06-11T09:30:00-04:00,106.625,107,104.34375,104.96875,1043900,1054220,41.825565296906674,47.18547220122291,NaN,NaN,-91.29544639695452,-25.044673602940055,-0.257063595454529,-0.13334301024896433,0.12372058520556468,6427802,7986242,47.50380903040805,44.937031640536176,NaN,NaN,-2.175504300248134,5.225881384049112
1999-06-14T09:30:00-04:00,105.5,106.125,105,105.6875,589100,982365,45.12139517048658,47.25570741985159,NaN,NaN,-75.15635222784316,-47.70184281405233,-0.2699997003600886,-0.21377904024454608,0.056220660115542526,7016902,7551282,43.87592338652431,44.403983125424936,NaN,NaN,-3.456294207949031,3.9855705851922343
1999-06-15T09:30:00-04:00,106.125,106.875,105.76562,106.34375,697300,956990,48.01719454741773,47.907001312005775,NaN,NaN,-31.620508991676143,-56.16883855553459,-0.22258618100100885,-0.22201206613571856,0.0005741148652903122,7714202,7370582,42.42630438180091,44.16645363785473,NaN,NaN,-3.6217139467626858,2.8988156520558173
1999-06-16T09:30:00-04:00,107.28125,108.0625,107.25,107.78125,773500,938040,53.77156503262107,48.27651443350806,NaN,NaN,50.362198571237215,-42.87535190146531,-0.08946731256270604,-0.11126002583809225,-0.0217927132753862,8487702,7423662,43.02182063307179,44.262613519597934,NaN,NaN,-1.9173713809549682,2.2107889330542765
1999-06-17T09:30:00-04:00,107.5,108.875,107.25,108.71875,632500,935715,57.10643108460829,49.43232723448587,NaN,NaN,89.0183326043565,-11.73835528817602,0.058686779431773556,0.05156576101433075,-0.007121018417442811,9120202,7753362,46.70901454291012,44.8975002422765,NaN,NaN,0.5813304898030743,1.9780091554469619
1999-06-18T09:30:00-04:00,108.5625,108.84375,108.1875,108.46875,264300,878385,55.947380535441255,50.41753141662151,NaN,NaN,107.2634171993319,27.97341743108126,0.1325809411302824,0.1586051579954102,0.02602421686512779,8855902,8238982,51.66998499725617,46.036343056720796,NaN,NaN,2.242686173859768,2.015820158077363
1999-06-21T09:30:00-04:00,108.75,108.96875,107.625,108.125,309700,856510,54.31498863146811,50.97857078868895,NaN,NaN,91.48406209435602,61.3015002955211,0.1497716783465509,0.2132388147983164,0.06346713645176552,8546202,8544842,54.54042866565377,47.23488091946997,NaN,NaN,3.1377852037717995,2.176100878890854
1999-06-22T09:30:00-04:00,107.625,108.21875,107.01562,107.15625,398800,814360,49.8965494630213,51.271298083621495,NaN,NaN,40.79664933495371,75.78493196084708,0.09029324093730587,0.17633368762339785,0.08604044668609198,8147402,8631482,55.34941227217836,48.32703013229878,NaN,NaN,2.6121943351209365,2.23839994406658
1999-06-23T09:30:00-04:00,106.96875,107.03125,106.28125,106.5,493800,776385,47.10127695710623,51.097810466635615,NaN,NaN,-14.564363518949948,62.79961954280964,0.00561523155646973,0.09305948613167914,0.0874442545752094,7653602,8464662,53.37969090474987,49.2095720499301,NaN,NaN,1.3450363737525035,2.1107765768788544
1999-06-24T09:30:00-04:00,106.375,106.40625,104.75,105.625,603500,739735,43.59449539568995,50.254869693274365,NaN,NaN,-72.99406262953453,30.397140496031437,-0.10439133237248865,-0.04304491089040141,0.06134642148208724,7050102,8050642,48.74345058104587,49.40783785404752,NaN,NaN,-0.7919299674195363,1.6961042134076558
1999-06-25T09:30:00-04:00,106.125,106.40625,105.5,105.73437,297600,673730,44.154177686798846,49.26051630276435,NaN,NaN,-58.91706951873045,-2.838956847581032,-0.1614484950433183,-0.1404641973220606,0.02098429772125767,7347702,7749002,45.6336845477029,49.06981548481002,NaN,NaN,-2.37700296258204,1.1142317596948421
1999-06-28T09:30:00-04:00,106.5625,107,106.25,106.6875,522300,664710,48.911693035197054,49.000586829279705,NaN,NaN,-16.22638426802528,-24.3810461200573,-0.12811220225555778,-0.13915595509818957,-0.01104375284263178,7870002,7613762,44.26997574737908,48.61370309613019,NaN,NaN,-2.398951507608781,0.6123484357943245
1999-06-29T09:30:00-04:00,106.59375,108,106.32812,107.625,308300,581700,53.1402599139311,49.23005084421498,NaN,NaN,23.328683776049054,-27.874639231838227,-0.040572062814231855,-0.061758831360421595,-0.021186768546189744,8178302,7619942,44.35181376810134,48.05763323202988,NaN,NaN,-1.1639997541502847,0.35858440865938035
1999-06-30T09:30:00-04:00,107.8125,110.25,107.25,109.375,1151100,583680,59.8249275302349,50.19485002006639,NaN,NaN,124.67002569245874,-0.027761389556494008,0.1282973226337072,0.13918488474594426,0.01088756211223706,9329402,7955102,48.74752465707481,47.873059865418256,NaN,NaN,2.1101898391972775,0.6088137558790799
1999-07-01T09:30:00-04:00,109.84375,111,109.0625,110.71875,1408100,624890,64.06403446565588,51.783312103548454,NaN,NaN,183.96457638858308,51.36396641406702,0.31307155016454047,0.40222699981791266,0.08915544965337217,10737502,8692582,56.828409290225714,48.53910274111952,NaN,NaN,6.343326259185245,1.4280298277799606
1999-07-02T09:30:00-04:00,110.8125,111.75,110.625,111.65625,393900,612970,66.70371272628358,53.32490621467681,NaN,NaN,205.37757464188914,104.22289524619096,0.47148897493623565,0.6785166683236667,0.2070276933874311,11131402,9449322,63.23415557504638,49.92183361172824,NaN,NaN,10.738194153644825,2.7580533029035124
1999-07-06T09:30:00-04:00,111.6875,112.5,111.26562,111.40625,548000,607785,65.32568155081817,54.5612267149197,NaN,NaN,192.77054948784954,146.02228199736592,0.5282238686459436,0.8673075291948606,0.33908366054891703,10583402,9992002,67.0140720038209,51.67810272758681,NaN,NaN,13.830331080012815,4.339807271061984
1999-07-07T09:30:00-04:00,111.25,111.84375,110.8125,111.5625,563100,607240,65.80121860944583,55.420487684692894,NaN,NaN,148.44510998860014,171.0455672398761,0.5429739818063285,1.0178011378068277,0.4748271560004992,11146502,10585642,70.57759704809831,53.646372471517275,NaN,NaN,16.472145232065483,6.072998408348198
1999-07-08T09:30:00-04:00,111.09375,112.25,111,111.15625,430000,608970,63.367874086843486,55.86773361342398,NaN,NaN,128.32404391039705,171.77637088346378,0.4935006391591641,1.0917029549494544,0.5982023157902903,10716502,10863062,72.09477304142871,55.45964093569717,NaN,NaN,17.99490896348152,7.776128487652958
1999-07-09T09:30:00-04:00,111.71875,112.09375,111.40625,112.0625,321300,587505,66.35674401067178,56.61125957594045,NaN,NaN,124.47793421474701,159.87904244869657,0.4890026489784406,1.209455627013341,0.7204529780349004,11037802,10923122,72.426274553675,56.942233046869944,NaN,NaN,20.20216471144969,9.551276519623919
1999-07-12T09:30:00-04:00,112.59375,112.59375,111.59375,111.84375,414200,556020,64.97858332863719,57.37294491145253,NaN,NaN,113.10622892105546,141.42477330452985,0.4400207227372097,1.2704788814564125,0.8304581587192028,10623602,10821562,70.89263561988257,58.110247829314865,NaN,NaN,21.64364760351257,11.278758103036584
1999-07-13T09:30:00-04:00,111.09375,112.23437,110.8125,111.90625,341900,543660,65.20096481561745,58.466117436637965,NaN,NaN,89.53149533789924,120.77696247453977,0.3826706623972147,1.3087964867157211,0.9261258243185064,10965502,10897982,71.38366781899904,59.255551796944914,NaN,NaN,22.89647146430989,12.938431440361342
1999-07-14T09:30:00-04:00,112.3125,112.3125,111.25,111.65625,354100,526500,63.46498848220651,59.63495397414513,NaN,NaN,82.06663515798961,107.50126750841768,0.30226679886238594,1.303959322896489,1.001692524034103,10611402,10790962,69.61259065989206,60.415044636597926,NaN,NaN,23.507920966448793,14.448358515516691
1999-07-15T09:30:00-04:00,112.3125,112.34375,111.46875,111.70312,287100,502180,63.66033708107967,61.0682283802444,NaN,NaN,76.51549177877203,97.1395570820927,0.22988478417965608,1.2890485042586732,1.0591637200790172,10898502,10827362,69.8862589352521,61.92524523332694,NaN,NaN,24.072706288365342,15.823265340209355
1999-07-16T09:30:00-04:00,111.9375,112.1875,111.4375,112.03125,226300,481870,65.0685032778344,62.56210877960409,NaN,NaN,70.69452947283375,86.38287613371003,0.18375049596495185,1.288851840035207,1.105101344070255,11124802,10844762,70.02522834423883,63.66749836165093,NaN,NaN,24.921554706582143,17.123020963976895
1999-07-19T09:30:00-04:00,112.375,112.625,111.6875,111.76562,290700,483190,62.942173490957416,63.564285955015535,NaN,NaN,68.64627481124424,77.4908853117478,0.11817502920137679,1.2528201305719762,1.1346451013705994,10834102,10886862,70.38138152490029,65.53259877433102,NaN,NaN,25.126515456573316,18.266377320062098
1999-07-20T09:30:00-04:00,111.28125,111.8125,109.5,109.65625,816500,508530,49.19431508403807,63.282432752880325,NaN,NaN,13.540838435132347,62.2927539311944,-0.07408074159542766,1.042044174376315,1.1161249159717426,10017602,10697282,66.54692312506458,67.11796372839981,NaN,NaN,21.19434039068028,18.684657758721837
1999-07-21T09:30:00-04:00,109.84375,110.59375,109.34375,109.9375,534900,515335,50.739279647806455,62.63345790413543,NaN,NaN,-2.295156480284502,45.420395603539575,-0.18292627909129666,0.8874670671076217,1.0703933461989183,10552502,10685502,66.3051927422645,68.37208287734194,NaN,NaN,18.37902308782888,18.640995662879988
1999-07-22T09:30:00-04:00,109.78125,110.46875,108.6875,109.4375,1008500,541070,47.947784280333835,61.48229717661243,NaN,NaN,-24.631906202580918,25.19091600726899,-0.28322665920995205,0.7163600221864783,0.9995866813964304,9544002,10414602,60.8326588901333,68.65810070590676,NaN,NaN,15.158167243447457,18.143448745818198
1999-07-23T09:30:00-04:00,110,110.09375,108.625,109.0625,541700,537980,45.9078080002992,59.996875410470686,NaN,NaN,-48.442888183811355,1.363432475939969,-0.36429044974302704,0.5442236192176466,0.9085140689606737,9002302,9990102,53.39562197017412,67.95534830555874,NaN,NaN,11.843808603024339,17.243500153990503
1999-07-26T09:30:00-04:00,108.71875,109.23437,108.34375,108.4375,377600,541980,42.65081139737075,58.37724182808159,NaN,NaN,-89.85826505147703,-30.337475496604288,-0.44417174507829293,0.35329938761280744,0.7974711326911004,8624702,9548222,46.959843150801056,66.5229033874859,NaN,NaN,8.006064900996849,15.923866546419982
1999-07-27T09:30:00-04:00,109.15625,110.23437,108.90625,109.625,1080200,569875,49.920693084078685,57.24291857626965,NaN,NaN,-58.96392632666133,-44.83842844896302,-0.4024424929099949,0.2944180165536068,0.6968605094636017,9704902,9485682,46.11270493536657,64.77541109371934,NaN,NaN,6.713940913520346,14.608162884577176
1999-07-28T09:30:00-04:00,109.625,110.25,109.3125,109.4375,459100,577415,48.867346811811316,56.207166628053066,NaN,NaN,-68.61779842061021,-58.10295683702816,-0.3735096618094734,0.22997343220175992,0.6034830940112333,9245802,9224342,42.65026636416605,62.672232045343435,NaN,NaN,5.349628503496956,13.28551511585143
1999-07-29T09:30:00-04:00,108.4375,108.59375,106.9375,107.78125,1194700,579595,40.698225699029344,54.374415320078604,NaN,NaN,-173.37402851133086,-87.85138129877815,-0.4469949760015724,0.04473937400926786,0.49173435001084026,8051102,8925762,39.04325883411818,60.287730922517945,NaN,NaN,1.4121041050819583,11.589313542884362
1999-07-30T09:30:00-04:00,107.9375,108.23437,106.3125,106.34375,788700,548625,35.19843048713818,52.24726154568582,NaN,NaN,-182.08867935228483,-114.58053953247286,-0.5658428719670008,-0.21556923994791077,0.35027363201909006,7262402,8577782,35.29666021441189,57.745161250698615,NaN,NaN,-3.9579128572832696,9.368281200003272
1999-08-02T09:30:00-04:00,106.375,107.90625,106.03125,106.5625,673700,562615,36.602435026182974,50.20450941786907,NaN,NaN,-159.4241613902117,-128.49371880021977,-0.5999052762139009,-0.39960796324828607,0.20029731296561484,7936102,8440062,33.909766064591594,55.068453982526655,NaN,NaN,-7.730638257290541,6.92557842038987
1999-08-03T09:30:00-04:00,107.125,107.25,105.85937,106.71875,1141400,592285,37.641717915259306,48.35999009165856,NaN,NaN,-146.45847546103522,-145.99262862709458,-0.5816614678192407,-0.5267795218084359,0.054881946010804705,9077502,8314582,32.65093485447325,52.42833571071102,NaN,NaN,-10.431013247505023,4.446065324976314
1999-08-04T09:30:00-04:00,107.15625,108.10937,106.5,106.65625,1571300,642695,37.377769381142826,46.48266382737735,NaN,NaN,-111.82456840945522,-154.63398262486356,-0.5442238990800283,-0.6253979278392308,-0.0811740287592024,7506202,7966662,29.39277177124704,49.53594377042494,NaN,NaN,-12.689143048390788,1.9981784144952996
1999-08-05T09:30:00-04:00,107,108.34375,105.5,108.34375,1613300,701860,47.98347567618315,45.26230471297369,NaN,NaN,-89.7523929633061,-137.9096555152586,-0.3837972843856431,-0.5609206342412563,-0.17712334985561318,9119502,8180342,33.76434915067988,46.94588097088502,NaN,NaN,-11.430659558311893,0.07977298980855796
1999-08-06T09:30:00-04:00,107.5,108.25,106.5,107.09375,800600,725825,42.27238878414286,43.785891519629786,NaN,NaN,-84.42826200101348,-118.37757204500436,-0.3412829824340801,-0.6037270778982133,-0.2624440954641332,8318902,8391642,37.86139488928726,44.62302478262694,NaN,NaN,-12.208755683199666,-1.6757311063354738
1999-08-09T09:30:00-04:00,107.1875,107.5625,106.75,107.125,634100,736820,42.45678240792477,43.304639185621696,NaN,NaN,-80.49919012879327,-102.59257779272066,-0.2923582690106739,-0.6278919317274756,-0.3355336627168017,8953002,8595022,41.60547039019258,42.8414924444218,NaN,NaN,-12.759722092953888,-3.2591583901381043
1999-08-10T09:30:00-04:00,107,107.15625,105.28125,106.75,2335100,836480,40.773688891610604,42.59281127446485,NaN,NaN,-99.13865886982067,-93.12861447447776,-0.26723993048178485,-0.6695835758190327,-0.40234364533724787,6617902,8103102,35.96142035809615,40.67408013126692,NaN,NaN,-13.717269044566166,-4.753174197913541
1999-08-11T09:30:00-04:00,107.375,108.09375,106.53125,108,716300,854590,48.151994685198986,42.607397731955224,NaN,NaN,-48.16178970230797,-80.3960587330483,-0.15404691378006907,-0.5949022875623342,-0.44085537378226514,7334202,8068702,35.597746925649304,38.87158641951806,NaN,NaN,-12.226916400793867,-5.820851655467873
1999-08-12T09:30:00-04:00,108.25,109.125,107.875,107.90625,595100,869990,47.672311905740266,42.73343372520101,NaN,NaN,-9.782836400185692,-64.40214742042421,-0.07698804174578233,-0.5370904259644931,-0.46010238421871075,6739102,7592622,30.93510082963546,37.26726348090816,NaN,NaN,-11.178503659027687,-6.586230513119275
1999-08-13T09:30:00-04:00,109.21875,110,109.01562,110,567200,887035,57.78647017401732,43.814552209247196,NaN,NaN,64.72834859913851,-34.570825300393814,0.11315970596124003,-0.3186527517671607,-0.4318124577284007,7306302,7390102,29.183938113157723,35.997555978219346,NaN,NaN,-6.725054447531253,-6.606062503749557
1999-08-16T09:30:00-04:00,110,110.6875,109.64062,110.65625,663300,905665,60.37188809001634,44.56106613824274,NaN,NaN,110.36103775914498,3.6012202771938377,0.2722257053076439,-0.09153032609384582,-0.3637560314014897,7969602,7193422,27.552704488866226,34.67184166061218,NaN,NaN,-2.2302300253582956,-5.980943578265092
1999-08-17T09:30:00-04:00,111.65625,111.71875,110.1875,111.25,625600,896120,62.60355024762233,45.54222352651495,NaN,NaN,143.346173076158,52.09818666638957,0.39886270296870796,0.13482234730939524,-0.2640403556593127,8595202,7588882,35.374448161602004,34.15214036042903,NaN,NaN,2.177063025869158,-4.81551406338877
1999-08-18T09:30:00-04:00,110.84375,111.5,109.8125,109.89062,776200,908185,54.97083070210439,46.56169531244888,NaN,NaN,105.54873936473605,82.84029247979838,0.37298202743856557,0.20218717863889424,-0.17079484879967133,7819002,7685842,37.16568501033096,34.01802794444423,NaN,NaN,3.490997670923045,-3.6288695299156535
1999-08-19T09:30:00-04:00,109.03125,110.1875,109.01562,109.75,732600,894390,54.23420892650622,47.921393772403746,NaN,NaN,65.82576090077339,97.9620119399902,0.329791251354969,0.24144421539403993,-0.08834703596092908,7086402,7755302,38.48116340470123,34.24549245803633,NaN,NaN,4.29185300374077,-2.4973377393933074
1999-08-20T09:30:00-04:00,109.875,111.1875,109.75,111.15625,688300,901720,60.005960727087235,49.5930741796112,NaN,NaN,109.62132829936102,106.94060788003469,0.37598094010640465,0.38162913917207675,0.005648199065672099,7774702,7848982,40.29660648958559,34.701695345535896,NaN,NaN,6.903466080408134,-1.1543657651359585
1999-08-23T09:30:00-04:00,111.71875,113.3125,111.51562,113.29687,1016900,933685,66.85783356048057,51.67993958284128,NaN,NaN,170.2485424633273,118.91810882087115,0.5217800739820427,0.6578732915432255,0.13609321756118278,8791602,8013382,43.450471679028006,35.47309083300409,NaN,NaN,11.737979638553066,0.6873978639624734
1999-08-24T09:30:00-04:00,112.78125,113.75,111.78125,112.9375,1476300,953490,64.84917820714897,53.64218307041314,NaN,NaN,151.3118016528375,120.51123453620706,0.5616366830851002,0.8381390714175581,0.2765023883324579,7315302,7757402,39.91483708416958,36.22466692678428,NaN,NaN,14.817675745208946,2.7060089898548263
1999-08-25T09:30:00-04:00,113.1875,113.625,112.01562,113.625,864200,973745,66.89808326688251,54.99322646974882,NaN,NaN,139.95983006306085,127.393452675872,0.598529934911996,1.0246648069724529,0.42613487206045686,8179502,7829502,41.362157783149925,36.767367543389284,NaN,NaN,17.996039636925747,4.890299082293529
1999-08-26T09:30:00-04:00,113.15625,113.28125,111.96875,112.0625,749500,951485,58.54565039406549,56.155602299029006,NaN,NaN,103.84199406276495,134.99669930827034,0.4866778922024324,1.0344822373134974,0.547804345111065,7430002,7898222,42.77697683089448,37.11848053921837,NaN,NaN,17.917419244543918,6.7513162483292986
1999-08-27T09:30:00-04:00,112.40625,112.40625,110.89062,111,656000,944850,53.641189095354775,56.9544884909883,NaN,NaN,64.95306224632789,126.06304609766372,0.3182582440059003,0.9456271501184403,0.62736890611254,6774002,7698082,39.767528144438316,36.98719895023593,NaN,NaN,16.183191493600823,8.098726997653802
1999-08-30T09:30:00-04:00,111.15625,111.28125,108.9375,109.0625,789600,950645,46.063285982124064,57.3323168545964,NaN,NaN,5.96875860155799,93.20708932530984,0.06664612208993237,0.7106765587249555,0.6440304366350231,5984402,7136642,32.797007575302004,36.761169465750626,NaN,NaN,11.955568296260779,8.649704326026228
1999-08-31T09:30:00-04:00,109.15625,109.96875,107.78125,108.25,1038800,945515,43.300723278068695,56.98579746837281,NaN,NaN,-38.47014658247203,55.250699678247926,-0.1522765356456851,0.4536847670779167,0.6059613027236018,4945602,6662702,28.289230353132155,36.23913256771369,NaN,NaN,7.625594535964875,8.503402927446034
1999-09-01T09:30:00-04:00,108.9375,109.5625,108.53125,109.5625,1136500,923775,48.6574030695584,57.05616112293124,NaN,NaN,-23.10843968628469,22.63704572837882,-0.2032741784225226,0.3518685796954486,0.5551427581179712,6082102,6243222,25.01238525273577,35.81608145507799,NaN,NaN,5.854791072560415,8.125029805319517
1999-09-02T09:30:00-04:00,108.0625,108.75,107.25,108.40625,1046500,895435,44.65496147419047,56.11819621580075,NaN,NaN,-69.01795724323347,-11.934944532820865,-0.3034328489464692,0.17585169693488467,0.4792845458813539,5035602,5764342,21.89443836482073,35.29540290162535,NaN,NaN,3.0275938128552022,7.396824663538901
1999-09-03T09:30:00-04:00,110.40625,111.3125,110,111.3125,709500,890880,54.73390507154409,55.71548314305274,NaN,NaN,36.50058982071793,-17.625439017942863,-0.1692033721415539,0.26778033070441154,0.43698370284596544,5745102,5558562,20.700308478389786,34.80594604373418,NaN,NaN,4.211378376525192,6.941760908251228
1999-09-07T09:30:00-04:00,110.71875,111.1875,110.125,110.25,423700,880360,51.07205699207161,54.89180505337054,NaN,NaN,15.609884620023383,-15.697213814249784,-0.147991180986629,0.2519947266126792,0.3999859075993082,5321402,5425962,19.945414653582105,33.70387222173276,NaN,NaN,3.831681210193655,6.4974638085287175
1999-09-08T09:30:00-04:00,109.75,111.25,109.59375,110.3125,772200,802215,51.27854739799185,54.62807053164822,NaN,NaN,0.028525279031287883,-7.99747944194912,-0.1265958394484013,0.24174110828880657,0.3683369477372079,6093602,5655562,25.04266798656488,32.837942434320894,NaN,NaN,3.611818205695419,6.085228722409675
1999-09-09T09:30:00-04:00,110.4375,111.03125,109.75,110.5625,554800,794140,52.14847552540683,54.47908957442684,NaN,NaN,-5.045626217520678,-4.384916748196317,-0.09395293246406228,0.25089578215713004,0.3448487146211923,6648402,5768822,27.495153225707014,32.053227421535595,NaN,NaN,3.7084857945764855,5.745694018433505
1999-09-10T09:30:00-04:00,111.8125,111.875,110.25,110.3125,660100,797390,51.16465055589285,53.84756741934152,NaN,NaN,10.424828995980128,11.50364049964641,-0.08766615865465544,0.23526601630287303,0.32293217495752846,5988302,5959362,31.5525179191997,31.42864966650803,NaN,NaN,3.495593407632446,5.424251074033354
1999-09-13T09:30:00-04:00,110.03125,110.5,109.84375,110.3125,518700,794965,51.16465055589285,52.72662577615669,NaN,NaN,-31.653006298457854,-2.1270787241887463,-0.08207423672458791,0.22033937905179357,0.3024136157763815,5988302,6008002,32.58955971271617,30.6528702403429,NaN,NaN,3.323503109343125,5.124144221934749
1999-09-14T09:30:00-04:00,109.875,109.875,109,109.34375,806700,802135,47.165720820136976,51.46352167708439,NaN,NaN,-80.48500629188767,-21.346056906570958,-0.13884727031472222,0.1288545278829787,0.2677017981977009,5181602,5980042,32.28673508163763,30.10800581159062,NaN,NaN,2.033463552737604,4.682618412049442
1999-09-15T09:30:00-04:00,110.25,110.28125,107.84375,107.875,1055000,823605,41.827936206811046,49.67279688707929,NaN,NaN,-114.938060127865,-44.33937398795022,-0.2633256844750423,-0.061455307396101944,0.20187037707894034,4126602,5586642,28.301901484081213,29.175130361657136,NaN,NaN,-0.7333145169046621,3.9089137079131415
1999-09-16T09:30:00-04:00,108.28125,108.28125,106.375,107.53125,1439300,856760,40.66791484840048,48.395815776674645,NaN,NaN,-162.55333590661587,-75.84091592576925,-0.3513201110493528,-0.23727976173275067,0.11404034931660213,2687302,4794422,22.326112005023447,27.71435430266635,NaN,NaN,-3.3521309259186034,2.87162161736575
1999-09-17T09:30:00-04:00,108.3125,108.625,107.84375,108.375,580400,849150,44.72038931125039,47.75861579209577,NaN,NaN,-103.94698698924614,-98.71527912281451,-0.3352500623908147,-0.3050222286719162,0.030227833718898464,3267702,4250302,19.310312010801567,26.253124578835155,NaN,NaN,-4.439444609999244,1.8271835848850364
1999-09-20T09:30:00-04:00,108.46875,108.46875,107.875,108.03125,341300,831800,43.4192418586608,47.569755497562674,NaN,NaN,-98.26221293862696,-112.03712045084833,-0.3298162083025901,-0.3820424266593392,-0.05222621835674908,2926402,3637922,16.59361374269926,25.095739305077814,NaN,NaN,-5.712823218414747,0.7500397558422103
1999-09-21T09:30:00-04:00,107.09375,107.3125,105.53125,105.84375,1491900,855550,36.20099839042119,47.06263229130214,NaN,NaN,-165.4162313683019,-129.0233654661312,-0.4482458663341516,-0.6125335512744385,-0.16428768494028695,1434502,2888502,13.998166357490177,24.074949019674815,NaN,NaN,-9.185410287169935,-0.669310250302382
1999-09-22T09:30:00-04:00,106.125,106.125,104.89062,105.14062,1561300,859800,34.23110613250974,46.032182510084375,NaN,NaN,-178.94030222222676,-141.82381388500352,-0.5423518271164571,-0.8422274688358584,-0.29987564171940123,-126798,2037822,11.75127588914755,23.127726922275656,NaN,NaN,-12.682425873596651,-2.3854696250587057
1999-09-23T09:30:00-04:00,105.96875,106,102.64062,102.6875,2152200,924200,28.420499447274622,44.872578079590376,NaN,NaN,-212.4798049279708,-151.80910768927453,-0.7267231197080903,-1.2082795413545142,-0.4815564216464238,-2278998,1044562,9.777794390829996,22.262252352704888,NaN,NaN,-17.901287576962254,-4.602015046759213
1999-09-24T09:30:00-04:00,102.39062,103.48437,101.4375,102.64062,1745100,973980,28.32155960700517,42.98598197498046,NaN,NaN,-218.8302940370579,-174.78576909883685,-0.8027889613555488,-1.4850426233408598,-0.682253661985311,-4024098,-413798,7.7261665506779735,21.335527929296905,NaN,NaN,-21.98567592606908,-7.085395172374909
1999-09-27T09:30:00-04:00,103.71875,104.125,102.9375,103.09375,1184200,1000390,30.828180165391103,41.539990773074706,NaN,NaN,-157.73454253157982,-186.68023501742746,-0.7732443589485593,-1.64880911067101,-0.8755647517224509,-2839898,-1567058,6.5548652630508855,20.37906011568753,NaN,NaN,-24.568843199445446,-9.583030604813557
1999-09-28T09:30:00-04:00,102.5,103.25,100.75,102.75,2126400,1067230,29.971894220901333,40.018086974711096,NaN,NaN,-157.5963867445828,-185.11626609268362,-0.7281465927385848,-1.7857479926456818,-1.057601399907097,-4966298,-2847218,5.549193745488893,18.986669098467818,NaN,NaN,-26.942528987142804,-12.062958945146306
1999-09-29T09:30:00-04:00,102.75,103.4375,101.875,102,1055300,1068055,28.135647310068734,38.3028849593298,NaN,NaN,-127.80510979757311,-174.8892276077529,-0.6999308367491628,-1.9325149458435504,-1.2325841090943876,-6021598,-4026178,4.816322852645158,17.366752643249114,NaN,NaN,-29.507481085022913,-14.55503353655725
1999-09-30T09:30:00-04:00,102.78125,104.125,102.3125,103.625,1157000,1069080,37.12397233836683,37.299979372363666,NaN,NaN,-90.86861790793732,-150.5669902037462,-0.5306132787350308,-1.8958507075131763,-1.3652374287781455,-4864598,-4543298,4.533503889653218,15.436823069710078,NaN,NaN,-29.0545076208241,-16.6263869771668
1999-10-01T09:30:00-04:00,102.54687,103.15625,101.78125,102.59375,1263800,1079945,34.20053722968292,36.0882569919201,NaN,NaN,-97.08441257227487,-126.2178139107896,-0.4500380455044808,-1.9277849856587466,-1.4777469401542658,-6128398,-4964158,4.311601223558938,13.416968891913134,NaN,NaN,-29.5646100391939,-18.474704557456384
1999-10-04T09:30:00-04:00,103.375,104.40625,103.25,104.40625,655500,1077245,42.73586938621114,35.77183903235397,NaN,NaN,-56.75971241202057,-106.02284788687773,-0.24680145987343538,-1.78624876499606,-1.5394473051226245,-5472898,-5490758,4.044819795758016,11.39968922863602,NaN,NaN,-27.21101956105933,-19.722749557971092
1999-10-05T09:30:00-04:00,104.32812,105.1875,102.65625,104.01562,2400000,1176060,41.48681755057379,35.747473414051306,NaN,NaN,-52.6238172236667,-85.02833398269452,-0.11737321179111615,-1.6861638198615196,-1.5687906080704035,-7872898,-6072078,3.767673332524538,9.647244360667687,NaN,NaN,-25.708508483333553,-20.577857975880015
1999-10-06T09:30:00-04:00,104.4375,105.90625,104.25,105.875,856900,1180295,49.111088552015765,36.35055725002383,NaN,NaN,-14.788931417062999,-62.425098306592496,0.10286645664447369,-1.4402075372648113,-1.543073993909285,-7015998,-6270958,3.6749014457259364,8.31501503500358,NaN,NaN,-21.842997367985365,-20.75859217475221
1999-10-07T09:30:00-04:00,106.0625,106.0625,105.125,105.26562,529900,1179050,46.951843282641626,36.50994681940892,NaN,NaN,-5.439905214196886,-45.3393557678444,0.21069468751080356,-1.2797056345207807,-1.4904003220315842,-7545898,-6807218,3.42967616555093,7.180683903199963,NaN,NaN,-19.388594848483255,-20.5628782709995
1999-10-08T09:30:00-04:00,105.40625,106.59375,104.96875,106.59375,924000,1192245,51.91407939561287,37.11672092919121,NaN,NaN,19.52845858974993,-22.016781535439442,0.3655802190518169,-1.033425048216813,-1.39900526726863,-6621898,-6905918,3.3849056044910384,6.237204750470805,NaN,NaN,-15.675428774291255,-19.86467120004118
1999-10-11T09:30:00-04:00,106.375,107.125,106.20312,106.375,209600,1176790,51.06677834332717,38.17856235439878,NaN,NaN,45.72131044021995,-1.5205769649913392,0.44228950042996384,-0.8461433917311751,-1.288432892161139,-6831498,-7177638,3.25878549675933,5.47010611756146,NaN,NaN,-12.97002469713828,-18.87972169962648
1999-10-12T09:30:00-04:00,106.28125,106.28125,104.1875,104.21875,1083900,1190650,43.52569060784105,38.84246124549388,NaN,NaN,-5.264724558753728,7.951241567991255,0.34132340456156873,-0.861778636459178,-1.2031020410207467,-7915398,-7186138,3.2547001327751843,4.863207849249149,NaN,NaN,-12.960766460298286,-18.034156665436736
1999-10-13T09:30:00-04:00,103.75,104.4375,102,102.0625,1821400,1228970,37.55353587799852,39.494820990545584,NaN,NaN,-77.70346428950883,-4.631665006497912,0.13350868888148115,-1.0362161799188954,-1.1697248688003765,-9736798,-7730298,2.995773717004269,4.378777801118739,NaN,NaN,-15.014314171632517,-17.602750594893276
1999-10-14T09:30:00-04:00,102.40625,103.5,101.21875,102.625,1619400,1237975,39.871331124214336,40.319804670346244,NaN,NaN,-85.5728957540516,-20.65826311446886,0.04281729929493028,-1.1162032446817136,-1.159020543976644,-8117398,-7844598,2.9428155770103928,4.037109874428198,NaN,NaN,-15.88104807967485,-17.356793092719215
1999-10-15T09:30:00-04:00,100.9375,101.65625,99.875,100,2300500,1323980,33.60318487538221,40.51801929248847,NaN,NaN,-157.1038097285686,-55.984716778132565,-0.17322565875446783,-1.3755526174197286,-1.2023269586652607,-10417898,-8603798,2.6124691997880802,3.755510155623714,NaN,NaN,-18.869022140512115,-17.572825813832488
1999-10-18T09:30:00-04:00,100.21875,101.375,99.5625,101.125,2019900,1407910,38.09490490784904,41.098234341556164,NaN,NaN,-141.1054809223465,-93.35007505064586,-0.216800166965464,-1.4733271673720907,-1.2565270004066267,-8397998,-8917098,2.4883315205335492,3.5368771395554757,NaN,NaN,-19.739836492473014,-17.88239876792399
1999-10-19T09:30:00-04:00,102.46875,103.34375,101.75,102.1875,1207500,1393690,42.0801407579535,42.094269587833644,NaN,NaN,-54.664045797556334,-103.22993929840638,-0.15348501691689287,-1.4483832715527427,-1.2948982546358498,-7190498,-8772118,4.7440096238722305,3.5317119089288385,NaN,NaN,-19.11173154342647,-18.058017735852918
1999-10-20T09:30:00-04:00,103,104.0625,102.5,103.71875,1329300,1382090,47.34150008265196,42.824092998139726,NaN,NaN,-0.9137466638368886,-87.87199577327199,0.003771768658006547,-1.2901835438133418,-1.2939553124713483,-5861198,-7996998,15.939839302533073,4.346450152705971,NaN,NaN,-16.813538584871154,-17.88023499999838
1999-10-21T09:30:00-04:00,102.125,103.4375,101.6875,103.4375,993200,1324140,46.50587891183673,43.70304597543643,NaN,NaN,-28.876706162626544,-76.53275785498697,0.09598757858130513,-1.173970839244717,-1.2699584178260221,-6854398,-7744398,19.269873591549825,5.4148981789910335,NaN,NaN,-15.26908073810148,-17.507212962584536
1999-10-22T09:30:00-04:00,104.09375,105.34375,103.8125,104.5,1149700,1294370,50.08994923213324,44.22833739300229,NaN,NaN,54.50354592297023,-34.211286724679205,0.2281390705308044,-0.9847845796625165,-1.212923650193321,-5704698,-6801758,30.357311917690325,7.294361901986198,NaN,NaN,-12.849752482258344,-16.84186146539508
1999-10-25T09:30:00-04:00,103.6875,104.1875,103.15625,103.375,619500,1266135,46.53480951479507,44.58890824758952,NaN,NaN,3.3073607018080926,-5.32871839984829,0.23827276002293973,-0.9150827001646462,-1.153355460187586,-6324198,-6386998,34.61256661380368,9.497568564934708,NaN,NaN,-11.914224668396352,-16.13791335153812
1999-10-26T09:30:00-04:00,103.9375,104.1875,102.6875,102.6875,1208500,1220240,44.45816354191147,44.2565564611535,NaN,NaN,-19.74945884827576,1.6541989900078256,0.19877398616668152,-0.904887977479234,-1.1036619636459155,-7532698,-6455438,34.24078190316257,11.680845740465896,NaN,NaN,-11.7721258816127,-15.51422942726306
1999-10-27T09:30:00-04:00,103.3125,104.34375,102.78125,104.25,791800,1207065,49.92728616126886,44.46908809534116,NaN,NaN,9.294298890036456,3.6958081007824943,0.27337383428582296,-0.7619446707886368,-1.0353185050744598,-6740898,-6631378,33.25196848408592,13.811009477504111,NaN,NaN,-9.943873810883657,-14.718464339208861
1999-10-28T09:30:00-04:00,106.0625,106.625,105.5625,106.5625,1030400,1200735,56.719834486476074,44.812356316117096,NaN,NaN,125.07715115981546,34.486579565270894,0.46281801448979176,-0.45679598696222,-0.9196140014520118,-5710498,-6402598,35.84632909203002,16.129682583756896,NaN,NaN,-6.058847473140163,-13.481376215484762
1999-10-29T09:30:00-04:00,107.4375,108,106.875,107.5625,2217100,1248400,59.2915287842883,45.399838490471474,NaN,NaN,159.25495707184666,55.436861795046184,0.6294978805379576,-0.13274165077956468,-0.7622395313175223,-3493398,-5960338,40.64880951405263,18.80039858499213,NaN,NaN,-2.039740617718967,-11.846856844375363
1999-11-01T09:30:00-05:00,107.5,107.625,106.5,106.5,559800,1243615,55.5169405984185,46.25635634694129,NaN,NaN,112.69449349321708,77.31428835332797,0.6401131968596501,0.03790196475704022,-0.6022112321026099,-4053198,-5506138,45.18699125742707,21.79556223675298,NaN,NaN,0.09617860903058174,-10.140708922460227
1999-11-02T09:30:00-05:00,106.96875,107.6875,105.65625,105.6875,975300,1172380,52.75133952935471,47.341913750609585,NaN,NaN,80.7167727029177,97.40753466356666,0.5668492729601711,0.10635035909760404,-0.460498913862567,-5028498,-5005298,49.749747408756726,25.135131786163868,NaN,NaN,0.9977091746434201,-8.549506337159706
1999-11-03T09:30:00-05:00,106.8125,106.8125,105.75,106.21875,1025500,1180810,54.35252280876223,48.376284585220155,NaN,NaN,73.68631119758292,110.28593712507595,0.5293151038547774,0.2011449659559048,-0.3281701378988726,-4002998,-4457718,54.23522040756407,28.798874988346274,NaN,NaN,2.2147557209956052,-7.01175461456609
1999-11-04T09:30:00-05:00,107.03125,107.4375,106.09375,106.625,578600,1183245,55.5918704411247,49.946904982773184,NaN,NaN,85.76354672857914,102.4232162388287,0.5069596318523905,0.3055294019166155,-0.201430229935775,-3424398,-4000498,57.63564335491636,32.72910171371258,NaN,NaN,3.575405565332599,-5.499303160294849
1999-11-05T09:30:00-05:00,107.96875,108.34375,106.9375,107.53125,1139100,1194000,58.31104271262596,51.39091482597154,NaN,NaN,110.73151353731753,92.71852753192287,0.526043152277425,0.4561237104110063,-0.06991944186641874,-2285298,-3758878,59.35437363320226,36.790961864617486,NaN,NaN,5.527402352167823,-3.924059515657324
1999-11-08T09:30:00-05:00,106.375,107.5625,106.375,107.375,628600,1214950,57.6555437575025,52.50344361165361,NaN,NaN,90.86299012949047,88.35222685917753,0.501094214116666,0.5564483257794137,0.05535411166274776,-2913898,-3531018,60.96281595188898,40.80659088804725,NaN,NaN,6.953205022908426,-2.3701645815765024
1999-11-09T09:30:00-05:00,107.875,107.875,106,106.3125,668000,1194155,53.27024219550647,52.92692519114322,NaN,NaN,71.12100580737717,86.43307348006944,0.3908775956197048,0.5439511061873787,0.15307351056767396,-3581898,-3241698,62.966728637938104,44.165654412004756,NaN,NaN,6.973554097794113,-1.0353476273807003
1999-11-10T09:30:00-05:00,105.59375,106.84375,105.40625,106,825600,1144365,52.01707199248784,53.320581839761154,NaN,NaN,44.612312234084875,80.61827368736982,0.2799669430198424,0.503032189342477,0.22306524632263458,-4407498,-3322598,62.00820197180355,47.218392153451454,NaN,NaN,6.646358891978217,0.062039018242002086
1999-11-11T09:30:00-05:00,106.25,106.625,105.5625,106.09375,727400,1099765,52.37900632376125,53.484085917734596,NaN,NaN,40.20217799204246,71.50599994006248,0.19972322760170214,0.4727192808247622,0.2729960532230601,-3680098,-3373738,61.37219538530609,49.43374097256686,NaN,NaN,6.467623031096098,0.97712244864973
1999-11-12T09:30:00-05:00,106.96875,108.0625,105.53125,108.0625,818200,1025650,59.31872094229975,54.39722244827065,NaN,NaN,74.06311637080543,64.17232050676007,0.2621103724729953,0.6006340188143042,0.33852364634130894,-2861898,-3489058,59.880679818646534,51.23860620148422,NaN,NaN,8.287822458401507,2.021508164328555
1999-11-15T09:30:00-05:00,107.90625,108.23437,107.28125,107.8125,573400,953325,58.159678665739925,55.37590209997267,NaN,NaN,92.78499848053022,64.55672217696801,0.26843249597695185,0.6740642663124987,0.40563177033554687,-3435298,-3593338,58.49626779828468,52.97114090827865,NaN,NaN,9.475951866523841,3.0864286932135956
1999-11-16T09:30:00-05:00,108.4375,109.98437,107.625,109.92187,1382000,962050,64.46813304064761,56.414534019928276,NaN,NaN,149.75236258499902,80.28299353249238,0.3892404036117676,0.8921822748502564,0.5029418712384888,-2053298,-3287618,61.31969164604025,54.97597827698967,NaN,NaN,12.514756712146703,4.433332695918326
1999-11-17T09:30:00-05:00,109.4375,109.71875,109,109.21875,433900,917280,61.15802060498689,56.731547314107615,NaN,NaN,150.06030824174175,101.37259273402375,0.39509913371216676,0.9968157883786972,0.6017166546665305,-2487198,-2903558,64.57957873951202,57.02835325180995,NaN,NaN,14.06993873335842,5.80999070126691
1999-11-18T09:30:00-05:00,109.9375,110.71875,109.59375,110.51562,645300,899885,64.75281282468467,57.12163903127879,NaN,NaN,181.23601497292796,129.57936013020088,0.45533700056929693,1.1708879053781516,0.7155509048088546,-1841898,-2535918,67.41092525843615,58.93993294783735,NaN,NaN,16.528402140327156,7.3411923354183735
1999-11-19T09:30:00-05:00,109.90625,110.46875,109.59375,110.01562,327800,858790,62.35666523464278,57.61019079100909,NaN,NaN,149.91678549324354,144.75009395468848,0.4307910376140478,1.2540397018264144,0.8232486642123666,-2169698,-2397478,68.43417116564189,60.60044579842412,NaN,NaN,17.844663724204782,8.841688248102146
1999-11-22T09:30:00-05:00,110,111.21875,109.76562,111.125,324000,844015,65.41469395808078,58.514716107346665,NaN,NaN,160.39974186283575,158.27304263114962,0.45611596448659797,1.393393619820614,0.9372776553340161,-1845698,-2079558,70.7086811850862,62.09751249673337,NaN,NaN,19.904597314433488,10.422103829006623
1999-11-23T09:30:00-05:00,111.21875,111.21875,109.8125,110.09375,362000,801690,60.49496671701552,58.95346210079333,NaN,NaN,128.22285887600708,153.9671418893512,0.3737218381855756,1.4044299530659856,1.03070811488041,-2207698,-2110438,70.17971684655274,63.23640509951827,NaN,NaN,20.173017171636037,11.815091449382253
1999-11-24T09:30:00-05:00,109.59375,110.5,109.51562,110.14062,251600,774680,60.63985659904006,59.314032540644426,NaN,NaN,98.15354171228914,143.58578858346067,0.29608204452043885,1.4008106705309586,1.1047286260105198,-1956098,-2004218,70.98381246405063,64.18984575017073,NaN,NaN,20.430605302077023,13.045879142624363
1999-11-26T09:30:00-05:00,110.65625,110.65625,109.40625,109.4375,165100,731415,57.247796168977324,59.23808635895524,NaN,NaN,77.26106243733621,122.79079807634234,0.17695474016506396,1.3259220512168497,1.1489673110517857,-2121198,-2060078,69.91610452292319,64.9442550994365,NaN,NaN,19.67624124284089,13.993073728369582
1999-11-29T09:30:00-05:00,109.5625,109.85937,108.95312,109.54687,390700,640095,57.64468309652523,59.23731059745687,NaN,NaN,54.2092845692579,103.64929789154522,0.08951661602664429,1.2608630810850912,1.1713464650584469,-1730498,-1972238,70.66337761021009,65.63715236074515,NaN,NaN,19.161050347105768,14.731356102474752
1999-11-30T09:30:00-05:00,109.54687,110.5,108.64062,108.6875,617000,642955,53.44620563822001,59.249879414793554,NaN,NaN,41.6865489368573,79.9066593063495,-0.035502443043240905,1.1269684112543956,1.1624708542976365,-2347498,-2072598,68.56773096019761,66.03722395519226,NaN,NaN,17.527577485534216,15.130816300054676
1999-12-01T09:30:00-05:00,108.6875,110.125,108.65625,110.09375,435500,615965,58.741747757501614,59.73021339800882,NaN,NaN,51.44119770260855,64.55032707166978,-0.03285530565615202,1.1214017222274464,1.1542570278835984,-1911998,-2013458,69.14837117807761,66.5472360413547,NaN,NaN,17.583363431367637,15.481180175956528
1999-12-02T09:30:00-05:00,110.15625,110.8125,110.14062,110.60937,266100,577995,60.51526913361758,60.31137502728428,NaN,NaN,85.25143642312968,61.9699060138379,-0.007091278989465932,1.145392929146766,1.1524842081362319,-1645898,-1951418,69.77905910077698,67.14772630674547,NaN,NaN,18.140656136712117,15.861105313207327
1999-12-03T09:30:00-05:00,111.8125,113.375,111.76562,112.95312,862700,592200,67.37937655627066,60.88713614256791,NaN,NaN,171.71717054552954,80.86112763547656,0.1484945213924087,1.3381023598767428,1.189607838484334,-783198,-1683818,72.39992986264694,68.04195845274549,NaN,NaN,20.877372774809807,16.57771495057911
1999-12-06T09:30:00-05:00,112.95312,113.125,112.03125,112.25,304000,550445,63.79632231470185,61.28975354606519,NaN,NaN,148.4595900606059,99.71118873374617,0.18251145531617174,1.4177471576295488,1.235235702313377,-1087198,-1555158,73.5860092726871,69.11979712948853,NaN,NaN,22.004775160865243,17.353009266334272
1999-12-07T09:30:00-05:00,112.60937,112.8125,111.20312,111.20312,505300,544280,58.784014104925745,60.883745050656486,NaN,NaN,107.0146253019979,112.77680400677427,0.11619421439882949,1.380478470311914,1.2642842559130845,-1592498,-1404158,74.94678076830559,70.09316063822176,NaN,NaN,21.374637869292552,17.927527638185456
1999-12-08T09:30:00-05:00,111.01562,111.875,110.46875,110.46875,454800,533620,55.49047177709584,60.478920134378555,NaN,NaN,63.7566988527832,115.23990423680921,0.010144743841338677,1.276965185714758,1.2668204418734192,-2047298,-1431218,74.20897315396012,70.78097452496806,NaN,NaN,19.822997941884896,18.198309110142517
1999-12-09T09:30:00-05:00,111.46875,112.15625,110.46875,111.375,832800,533980,58.57497061857214,60.03764569108481,NaN,NaN,78.86650385797577,113.96291772377842,-0.010571416339063333,1.25360617144959,1.2641775877886534,-1214498,-1344938,75.05228453143202,71.32678590161062,NaN,NaN,19.457822807200735,18.378239638293692
1999-12-10T09:30:00-05:00,112.15625,112.96875,111.1875,112.46875,472000,521210,61.997871132400604,60.01201754092465,NaN,NaN,121.35600637581938,103.8906848898364,0.035273570954460265,1.3082695514817289,1.2729959805272686,-742498,-1336798,75.13488997416945,71.8054086736483,NaN,NaN,20.210010825623083,18.639921236483605
1999-12-13T09:30:00-05:00,111.71875,112.65625,111.625,112.21875,570900,508845,60.762008506899214,59.67968286584026,NaN,NaN,108.06443082126258,95.81165304196773,0.03459914463345615,1.3162449113190888,1.2816457666856327,-1313398,-1382038,73.67479966229097,72.01727427916293,NaN,NaN,20.450249968910747,18.89853962683034
1999-12-14T09:30:00-05:00,111.5625,112.59375,111.46875,111.8125,536300,506990,58.71381142095987,59.55245748755057,NaN,NaN,84.65474215081206,91.33967641173057,-0.005247762788966659,1.2750860631994243,1.280333825988391,-1849698,-1433478,71.96239377239228,72.14460834529433,NaN,NaN,20.055850739692254,19.063869785810613
1999-12-15T09:30:00-05:00,111.375,112.90625,111.34375,112.26562,465700,461175,60.32042408408363,59.5296408793394,NaN,NaN,87.92542636048842,96.1734219132716,-0.012703435269825869,1.2644545319011087,1.2771579671709345,-1383998,-1300818,73.66253661190436,72.33594578442674,NaN,NaN,20.177181541928995,19.222914322398953
1999-12-16T09:30:00-05:00,112.73437,112.73437,111.375,112.40625,623500,470655,60.82988476467982,59.785504350461004,NaN,NaN,78.78036164629779,96.15619347093602,-0.019379498608201207,1.252933593910683,1.2723130925188841,-760498,-1210018,74.78936754001239,72.68403599993312,NaN,NaN,20.416338352439176,19.393403469547557
1999-12-17T09:30:00-05:00,113.0625,113.98437,112.8125,112.8125,472700,462025,62.33437345112357,60.12048223293231,NaN,NaN,128.6586397477847,97.61672014532908,-0.008221530107094921,1.2620361798850155,1.2702577099921104,-287798,-1119078,75.90143168979147,73.05818271990321,NaN,NaN,21.025768262162586,19.626598439921132
1999-12-20T09:30:00-05:00,113.25,113.3125,111.125,111.4375,521700,471720,54.6792742008146,60.20855855883193,NaN,NaN,45.8367415255671,85.17118228618997,-0.1001269302431651,1.145099047188154,1.245225977431319,-809498,-1018298,77.10663369133162,73.66810434355564,NaN,NaN,19.38056619748934,19.59145097671659
1999-12-21T09:30:00-05:00,111.0625,112.65625,110.9375,112.0625,773700,494205,57.24924963319699,60.10195154995302,NaN,NaN,37.6209387200795,75.76442160004346,-0.12394908306721497,1.0902896235973003,1.2142387066645153,-35798,-655518,80.82432214880876,74.50210084146501,NaN,NaN,18.704147113830334,19.464693282018555
1999-12-22T09:30:00-05:00,112.3125,112.73437,111.90625,112.1875,407800,496495,57.76509357061056,59.90551043830966,NaN,NaN,57.780479093783164,69.73543214670242,-0.1354755057286965,1.0448943245036446,1.180369830232341,372002,-304318,83.60073241790903,75.48936322126015,NaN,NaN,18.286755855666943,19.296416506825466
1999-12-23T09:30:00-05:00,113,114.48437,113,114.48437,524600,510145,65.9058618208632,59.80025938578054,NaN,NaN,156.9428815649818,85.36793613043922,0.00022147678735917609,1.18064667621654,1.1804251994291808,896602,27102,85.70426099702945,76.43967258800176,NaN,NaN,20.438864119871607,19.4596233086892
1999-12-27T09:30:00-05:00,114.5625,114.90625,113.9375,114.125,450400,524410,63.83272794811521,59.80285978816721,NaN,NaN,169.65658060560395,93.56752430200306,0.051566241295824655,1.2448830010489615,1.193316759753137,446202,173902,86.52853359605527,77.36413861109949,NaN,NaN,21.56470499213452,19.760349263467102
1999-12-28T09:30:00-05:00,113.84375,115.29687,113.84375,115.0625,769600,543355,66.7694010995447,60.37324457349714,NaN,NaN,185.98875741725936,121.59792748034151,0.12999477611294408,1.3558102298943169,1.2258154537813728,1215802,578962,88.49903411554169,78.33215670733064,NaN,NaN,23.4376754791308,20.285681579990488
1999-12-29T09:30:00-05:00,115.48437,115.57812,114.6875,114.875,273900,526200,65.62176955726852,61.09690870065233,NaN,NaN,180.7945692110539,150.2326535785364,0.14919638388270728,1.4123109336347568,1.2631145497520495,941902,774502,89.31180299669128,79.41093026752571,NaN,NaN,24.624024877404985,20.90544490819256
1999-12-30T09:30:00-05:00,115.46875,115.71875,114.375,114.45312,494700,529160,62.998009178987694,61.412840026396296,NaN,NaN,141.84436187865865,167.04543013551148,0.11497148840322535,1.4068289102560811,1.2918574218528558,447202,789542,89.37400427323755,80.43391024908325,NaN,NaN,24.868343201138025,21.4715732357562
1999-12-31T09:30:00-05:00,114.65625,115.59375,114.39062,115.1875,549000,543305,65.57805945585483,61.668567763785894,NaN,NaN,130.9629189775507,161.84943761802526,0.12258178999287361,1.445084659343948,1.3225028693510743,996202,809462,89.46148261564232,81.45723829490274,NaN,NaN,25.825533953908042,22.093567624063606
2000-01-03T09:30:00-05:00,116.03125,116.03125,113,113.5,1278800,564110,55.92781045737978,61.32326790310593,NaN,NaN,69.60355024366315,141.8388315456371,0.0011765256963787163,1.3239735264715478,1.322797000775169,-282598,663702,84.01140290435913,82.19556709790761,NaN,NaN,23.676940528678987,22.319763753294374
2000-01-04T09:30:00-05:00,112.28125,112.96875,109.76562,109.76562,1535700,625695,41.40644850854284,60.087027695076145,NaN,NaN,-106.99601952698008,83.2418761567892,-0.3253587125387307,0.9160986101017556,1.2414573226404864,-1818298,56882,65.98796260373128,81.76882201443183,NaN,NaN,15.977945991851799,21.413789787374007
2000-01-05T09:30:00-05:00,110,112.375,109.03125,111.1875,2007000,700780,47.044390752170735,59.13873959993951,NaN,NaN,-100.22837937422538,27.03728643973335,-0.43354590209274946,0.6995249450245495,1.133070847117299,188702,-93758,62.40857425061488,80.96496756005399,NaN,NaN,11.872683578771738,20.05077461471654
2000-01-06T09:30:00-05:00,111.40625,113.17187,111.1875,111.75,2639500,810015,49.129741025899506,58.30301504716949,NaN,NaN,-44.104189297626284,-10.152423795523653,-0.4530608987142757,0.5667447237244545,1.0198056224387302,2828202,382442,68.26823072795963,80.4991720734788,NaN,NaN,9.441704819605972,18.53519321541503
2000-01-07T09:30:00-05:00,113.3125,115.5625,113.21875,115.5,3767400,956745,60.34196290450715,58.16070000812546,NaN,NaN,89.67058358131368,-18.410890874771052,-0.21152345344987,0.7554013056263926,0.9669247590762626,6595602,1502322,77.24954993485102,80.5954662338402,NaN,NaN,11.628346862711155,17.548500879314478
2000-01-10T09:30:00-05:00,116.8125,116.8125,115.4375,116,762900,971290,61.55857093577083,58.65207834633662,NaN,NaN,136.24538764999912,-5.082523393503857,-0.025950489710270697,0.9344866469384243,0.960437136648695,7358502,3030542,83.93277181278175,81.0830475282295,NaN,NaN,13.706333195286884,16.99961978159625
2000-01-11T09:30:00-05:00,115.15625,116.75,115.01562,115.14062,1658700,1025680,58.250901957744205,58.72362494094714,NaN,NaN,101.70065171155784,36.65681085420372,0.028123670392595335,0.9955917246394392,0.9674680542468439,5699802,4534162,87.74678934427,81.57750947076245,NaN,NaN,14.180214690839676,16.596847625773883
2000-01-12T09:30:00-05:00,115.5,116.1875,115.15625,115.4375,813300,1039530,59.069112470250644,58.81676914806428,NaN,NaN,90.33863320275489,74.77021336959976,0.07066798353737891,1.0558030336685675,0.9851350501311886,6513102,5799042,89.91546052834467,82.0285614786507,NaN,NaN,14.816525311708897,16.342515866621742
2000-01-13T09:30:00-05:00,116.01562,116.625,115.21875,115.875,1192200,1075855,60.30377692331272,58.41662022681068,NaN,NaN,95.45417031285655,102.68188529169633,0.1125683420397785,1.1258454776809117,1.0132771356411332,7705302,6774462,91.20777865437582,82.42166988274687,NaN,NaN,15.713559832606123,16.252665004619512
2000-01-14T09:30:00-05:00,117.46875,117.5,116.125,117.5,1935500,1141455,64.57776875716974,58.46983742745743,NaN,NaN,134.12442448314874,111.57265347206335,0.22739550597979075,1.2975215181158717,1.070126012136081,9640802,7383502,91.9052932942562,82.80572414690407,NaN,NaN,17.876809127872683,16.48468559365568
2000-01-18T09:30:00-05:00,116.4375,116.875,115.5,115.71875,656500,1150645,57.29558172197413,57.79313604334525,NaN,NaN,82.13686153282673,100.75094824862887,0.1640151513300494,1.2751449512986426,1.1111297999685932,8984302,7708662,92.2584120206744,83.07425114012786,NaN,NaN,17.33818468988321,16.606614035973898
2000-01-19T09:30:00-05:00,115.625,115.79687,114.59375,115.5625,1003400,1174730,56.691663923009756,57.155271355183906,NaN,NaN,46.765348710080076,89.76388764833331,0.09559015940036586,1.2306174992190506,1.1350273398186848,7980902,8164882,92.7371403956332,83.31891809719514,NaN,NaN,16.727335874036406,16.62386001283997
2000-01-20T09:30:00-05:00,115.9375,115.96875,112.65625,113.73437,887000,1180395,50.04519720688574,56.23007050003376,NaN,NaN,-16.29247657493089,68.43766569279616,-0.07932310739426529,1.035873455575853,1.1151965629701184,7093902,8281042,92.85823687688996,83.56779185459888,NaN,NaN,14.034838812671405,16.25399984138732
2000-01-21T09:30:00-05:00,114.1875,114.1875,112.3125,112.8125,783200,1199165,47.04965551611663,54.90661307576675,NaN,NaN,-73.98812917048502,34.54920579612793,-0.2537957299591247,0.7979519005212126,1.0517476304803373,6310702,8002122,89.02010651904752,83.53626499055638,NaN,NaN,10.856056760751489,15.4828651155822
2000-01-24T09:30:00-05:00,113.25,113.625,109.0625,110,2066100,1276240,39.3174135466918,53.720156153574756,NaN,NaN,-160.64149426409162,-24.403977953320144,-0.5389231600177042,0.3780936804582069,0.9170168404759111,4244602,6922882,75.94047120126358,82.9597698689067,NaN,NaN,5.272016697697845,14.024172484455864
2000-01-25T09:30:00-05:00,110.59375,110.875,108.75,110.34375,1728200,1340130,40.602267350388516,53.66271464227801,NaN,NaN,-162.30567743747318,-73.29248574738013,-0.6758072123199339,0.07225782507599376,0.7480650373959277,5972802,6320582,69.77864335452162,83.23053277967745,NaN,NaN,1.3237563549639286,12.209827323099873
2000-01-26T09:30:00-05:00,110.21875,111.375,110.125,110.46875,1001400,1351720,41.09072319663411,53.2374526740254,NaN,NaN,-114.29827440981049,-105.50521037135823,-0.7250193118056096,-0.15820910236108432,0.5668102094445253,6974202,6119242,67.79822704405866,83.61550797920914,NaN,NaN,-1.6494077321561513,10.22993660092044
2000-01-27T09:30:00-05:00,111.125,111.60937,109.1875,110.46875,853900,1380720,41.09072319663411,52.663237114792146,NaN,NaN,-105.34322890263698,-123.31536083689946,-0.7230252924889436,-0.3369714061666542,0.38605388632228943,6974202,6095302,67.5527247193458,83.5644004071653,NaN,NaN,-4.034614085337221,8.192143645740774
2000-01-28T09:30:00-05:00,109.84375,110.0625,107.14062,107.40625,1253300,1418650,33.30788571645917,50.73223160136015,NaN,NaN,-148.64418368253604,-138.24657173930964,-0.8828344742688974,-0.7174892065138323,0.16534526775506508,5720902,5977342,66.27919294604169,82.7808034793932,NaN,NaN,-8.868209763946897,5.754950301499679
2000-01-31T09:30:00-05:00,107.14062,109.625,107,109.5,996600,1441030,41.4700567377746,49.29733773007471,NaN,NaN,-117.00256265528134,-129.51878541754758,-0.8046093190605295,-0.8404163810705967,-0.03580706201006728,6717502,6471922,68.92447428361828,81.7087822273101,NaN,NaN,-10.345411802534173,3.4548985723519854
2000-02-01T09:30:00-05:00,109.5625,110.71875,109.03125,110.28125,786500,1416415,44.2135856548684,48.294672279869296,NaN,NaN,-73.24680200548903,-111.70701033115077,-0.6632163611830699,-0.8648275134889047,-0.2016111523058348,7504002,6778162,70.46922633980614,80.4746705841341,NaN,NaN,-10.642560461237819,1.440975853267728
2000-02-02T09:30:00-05:00,110.375,111.1875,109.65625,109.6875,618100,1370535,42.58002368858959,47.116880224036365,NaN,NaN,-67.16431677184339,-102.28021880355735,-0.5758807843563165,-0.9214621327512305,-0.34558134839491395,6885902,6760502,70.25234878267167,79.07016260230033,NaN,NaN,-11.389155885044127,-0.3919001093482515
2000-02-03T09:30:00-05:00,110.625,110.65625,108.21875,110.5,863300,1313350,45.545005446377054,46.0626822613981,NaN,NaN,-74.19045436712936,-96.04966389645583,-0.4359494634192643,-0.8905181776689943,-0.45456871424973,7749202,6915502,71.09324073707167,77.63340989392147,NaN,NaN,-11.099871974155059,-1.921610375749224
2000-02-04T09:30:00-05:00,110.4375,110.96875,109.34375,109.75,474000,1205075,43.32127168087387,44.54436104166268,NaN,NaN,-63.417721231110605,-79.00437140617075,-0.3691090627962933,-0.9159550427450966,-0.5468459799488034,7275202,7226362,72.75652993872889,76.26564108281237,NaN,NaN,-11.519835984440546,-3.292785462705127
2000-02-07T09:30:00-05:00,109.15625,109.46875,108.375,108.75,723900,1052900,40.48309663472465,43.34346924971629,NaN,NaN,-82.84598016926876,-72.17305490896823,-0.3666976610061361,-1.0052180562064734,-0.6385203952003373,6551302,7193122,72.27762086362308,74.83844171445158,NaN,NaN,-12.721562389216883,-4.639753595063949
2000-02-08T09:30:00-05:00,109.90625,110.34375,109.125,109.3125,993100,1064410,42.75496425419907,42.347990701944106,NaN,NaN,-60.14763336886619,-69.55322118164365,-0.30424463929392176,-1.0188261943177395,-0.7145815550238177,7544402,7201202,72.32530774467533,73.38045366795457,NaN,NaN,-13.058897628524921,-5.842488456986945
2000-02-09T09:30:00-05:00,109.1875,109.375,106.78125,106.90625,819900,1022470,36.36085960464953,41.37053801607009,NaN,NaN,-101.01009632416127,-76.32237709210723,-0.39619783839429645,-1.2098288530166883,-0.8136310146223918,6724502,7168922,71.79397902387035,71.8758638213103,NaN,NaN,-15.383095029308052,-7.205432253032817
2000-02-10T09:30:00-05:00,107.26562,107.59375,106.01562,107,1263500,1044980,36.75770017028024,40.63539834851035,NaN,NaN,-117.04053975262893,-84.89239416920714,-0.41966235215165526,-1.338208954811961,-0.9185466026603056,7988002,7216682,72.12032345656951,70.66873645970473,NaN,NaN,-17.115568702346504,-8.6211660315062
2000-02-11T09:30:00-05:00,106.5625,106.5625,103.625,104.5,2148400,1092790,31.174920095138972,40.05379167339943,NaN,NaN,-167.1819470049461,-105.64523932397424,-0.5635400063354561,-1.6229716105796257,-1.0594316042441696,5839602,6929562,67.0945227581424,70.03688299948179,NaN,NaN,-20.511608047090395,-10.319800605161085
2000-02-14T09:30:00-05:00,105,105.59375,104.5625,105.5,1300800,1061055,35.40131926448491,39.68229538154918,NaN,NaN,-156.48350448365707,-120.3727441868519,-0.5507017347408221,-1.7478087726701972,-1.1971070379293751,7140402,7047382,68.07759065781164,69.91537923543109,NaN,NaN,-21.984803958164314,-11.986229655590117
2000-02-15T09:30:00-05:00,105.59375,107.875,105.01562,107.4375,1360000,1096230,42.73825569075906,39.79997627398667,NaN,NaN,-96.35068908631976,-127.61335533034261,-0.3792257398934644,-1.6711392127962057,-1.2919134729027413,8500402,7238582,69.6616132018928,70.04847824670495,NaN,NaN,-20.856157133645127,-13.253362152455118
2000-02-16T09:30:00-05:00,106.875,107.6875,105.75,105.8125,725800,1082350,38.761839580786166,39.633627444283256,NaN,NaN,-97.72505889740633,-126.95634784499164,-0.34379384361497545,-1.7216557774214607,-1.3778619338064853,7774602,7448602,71.34368119008228,70.31926085175755,NaN,NaN,-21.206014888296735,-14.389455400432492
2000-02-17T09:30:00-05:00,106.78125,106.85937,104.65625,104.78125,1164100,1096205,36.444436646218705,39.857666796408935,NaN,NaN,-120.57622713265678,-127.66348532099721,-0.3568138376549659,-1.8238792308751925,-1.4670653932202267,6610502,7173102,66.16161681494208,70.310862556679,NaN,NaN,-22.238751716336854,-15.510783445561687
2000-02-18T09:30:00-05:00,105,105,102,102.5,1526600,1133375,31.900902959610377,39.17415581225435,NaN,NaN,-175.74114609309396,-129.37532513862678,-0.47847883713542183,-2.065163939639504,-1.5866851025040822,5083902,7021962,63.439242875374894,69.91906031323303,NaN,NaN,-24.66806962306676,-16.81896718520527
2000-02-22T09:30:00-05:00,102.875,103.46875,101,102.8125,1518800,1106010,33.13074912719506,38.38252463170625,NaN,NaN,-169.4455574976367,-131.9677357414227,-0.4952449253245921,-2.205741259159822,-1.7104963338352301,6602702,6914422,61.500173671968035,69.27841369410173,NaN,NaN,-26.187245486172085,-18.157292656771958
2000-02-23T09:30:00-05:00,102.96875,103.5,101.625,102.25,1558900,1097545,32.01013988692526,37.62753293158737,NaN,NaN,-143.89870298846188,-141.47733852185112,-0.5000951945763692,-2.3356153270556916,-1.8355201324793224,5043802,6223102,50.75919577785725,67.88604562232926,NaN,NaN,-27.763862524118288,-19.529659780678575
2000-02-24T09:30:00-05:00,102.5625,102.6875,99.5625,101.125,4518602,1273405.1,29.83650977867954,36.505497526751824,NaN,NaN,-158.4982182708251,-153.63197039653488,-0.5319802180272248,-2.5004954050133534,-1.9685151869861286,525200,4773221.6,36.40055745423398,65.4079968164123,NaN,NaN,-29.760711946132446,-20.9912386614577
2000-02-25T09:30:00-05:00,100.59375,101.46875,98.1875,98.5625,3316900,1396555.1,25.57629296547273,35.237999047080315,NaN,NaN,-173.23631086710222,-164.16398714342398,-0.6696640372555147,-2.805595233555522,-2.135931196300007,-2791700,2892781.2,26.091658429393448,62.07479170860262,NaN,NaN,-32.95949899552406,-22.700990137752893
2000-02-28T09:30:00-05:00,99.1875,101.625,98.25,100.14062,3068300,1487305.1,32.01444412571803,34.633095296436984,NaN,NaN,-134.68743099261528,-155.95324412332826,-0.6006718837414491,-2.8867710509768187,-2.2860991672353697,276600,1931320.8,22.571787659624306,58.52437505117414,NaN,NaN,-33.5495150272376,-24.25077940767928
2000-02-29T09:30:00-05:00,101.1875,102.125,100.4375,101.5625,1205000,1497725.1,37.279097414041146,34.24196195071141,NaN,NaN,-92.50042171500797,-140.5642169668025,-0.414357736251163,-2.804046337549323,-2.38968860129816,1481600,907100.4,19.546656439512617,54.754471386519654,NaN,NaN,-32.32123041758664,-25.403700980523187
2000-03-01T09:30:00-05:00,101.78125,102.78125,100.6875,101.625,1136200,1515210.1,37.50817262863686,34.323912880996225,NaN,NaN,-77.22736325999128,-127.22994902110838,-0.2500833820658621,-2.7022928288804877,-2.4522094468146256,2617800,421900,18.29570669482112,50.933166220159,NaN,NaN,-31.28530325281133,-26.24392987656435
2000-03-02T09:30:00-05:00,101.46875,102.25,101,101.6875,576000,1513105.1,37.75300502106316,34.395006084623574,NaN,NaN,-70.27991008088105,-109.58628738311958,-0.10766468582488242,-2.5867903040957287,-2.4791256182708463,3193800,955620,24.05345178315976,47.49981824348688,NaN,NaN,-30.38092029991567,-26.834928508471684
2000-03-03T09:30:00-05:00,103.34375,104.54687,103,103.875,1678200,1553850.1,45.76238605820937,35.4369679391286,NaN,NaN,-15.543940762975858,-78.0478133622943,0.14944740924821964,-2.2923163567105718,-2.4417637659587914,4872000,2488360,37.643705185954,45.396188416901985,NaN,NaN,-27.09100882268361,-26.87151141050196
2000-03-06T09:30:00-05:00,103.8125,103.98437,101.14062,101.71875,1220500,1591175.1,40.26290840082936,35.78422430601035,NaN,NaN,-46.922850123182634,-60.49489718840779,0.18742026576384907,-2.20748843375398,-2.394908699517829,3651500,3163340,42.52158810157201,43.570759662884875,NaN,NaN,-25.90962078579187,-26.734098464114805
2000-03-07T09:30:00-05:00,101.46875,101.53125,97.53125,99.5,3745200,1742240.1,35.53121321718656,35.26943555789803,NaN,NaN,-111.259428558351,-64.24669855707637,0.08163452041296848,-2.2928655490016183,-2.374500069414587,-93700,2848280,40.91280543667096,41.51727339394045,NaN,NaN,-26.441325592559956,-26.6922737681784
2000-03-08T09:30:00-05:00,98.75,99.375,97.15625,98.46875,2618900,1823530.1,33.55725343990396,34.89767940497787,NaN,NaN,-135.91207275570096,-75.98364045621831,-0.03311345374847319,-2.4158918866001784,-2.382778432851705,-2712600,1782200,35.95561268608401,38.98955421508344,NaN,NaN,-27.51234298944815,-26.80942651407408
2000-03-09T09:30:00-05:00,98.84375,100.4375,97.3125,100.32812,1715100,1868290.1,40.02677556799689,35.15356075653346,NaN,NaN,-99.91361474407026,-81.91038138885615,0.037084586760292915,-2.3364226994013393,-2.373507286161632,-997500,943940,32.60982314453497,36.59299752434008,NaN,NaN,-26.302546180084914,-26.737015037789913
2000-03-10T09:30:00-05:00,99.90625,101.0625,98.96875,99.5625,1352600,1872745.1,38.370055302324054,35.61564306672729,NaN,NaN,-78.79254030925408,-94.56010129811179,0.051918056365019005,-2.3086097157053587,-2.3605277720703777,-2350100,-500480,27.808047580998874,34.04791214617036,NaN,NaN,-25.845162804356125,-26.6096075758708
2000-03-13T09:30:00-05:00,96.84375,100.1875,96.84375,99.625,1506500,1840650.1,38.593497078351064,36.00583934895272,NaN,NaN,-100.76338099310968,-105.3282074720972,0.08400284253752455,-2.255524218898472,-2.3395270614359966,-843600,-1399500,25.309971749887765,31.462897723164627,NaN,NaN,-25.415475102835668,-26.439017222580066
2000-03-14T09:30:00-05:00,100.3125,100.6875,98,98.46875,854300,1818325.1,35.993610393295384,36.290372956550584,NaN,NaN,-88.4394361304306,-100.76420898651313,0.047249244964457926,-2.280465505230424,-2.327714750194882,-1697900,-1720340,24.46529711685487,29.584762104521598,NaN,NaN,-25.81751833371558,-26.350231667027998
2000-03-15T09:30:00-05:00,98.625,101.98437,97.65625,101.625,2040200,1852335.1,46.573910919692324,37.485901609480074,NaN,NaN,-35.01778705539019,-80.58535184645098,0.24438175102486337,-2.022237561413803,-2.2666193124386664,342300,-1109360,29.303862853435263,29.077855347321695,NaN,NaN,-22.73785012064703,-25.834177160402145
2000-03-16T09:30:00-05:00,102.5625,106.875,102.40625,106.78125,4860301,2059060.15,58.61068620927275,39.84550112689436,NaN,NaN,161.28902309034947,-28.344824279567025,0.7048538561936333,-1.3855519921966248,-2.090405848390258,5202601,130660.2,37.98634499078078,29.927475815992214,NaN,NaN,-15.234165756285053,-24.319889816956845
2000-03-17T09:30:00-05:00,106,107.71875,105.67187,106.125,3710500,2186380.15,56.85500561199115,41.61982694734244,NaN,NaN,198.42099427792016,27.097882637867826,0.9336967362449484,-0.9232849280840725,-1.856981664329021,1492101,899100.4,42.68408966067781,31.364068816067466,NaN,NaN,-10.129247748056116,-22.292655235685313
2000-03-20T09:30:00-05:00,106.28125,107.34375,105.89062,106.8125,1812000,2200650.15,58.26543913332786,43.11885135586292,NaN,NaN,178.96727552779438,83.04401394204864,1.0889894855048918,-0.49574480744790606,-1.5847342929527979,3304101,1728640.6,47.32318827925346,33.34810680462038,NaN,NaN,-5.655724170450491,-19.915950797794626
2000-03-21T09:30:00-05:00,106.5625,109.1875,105.9375,109.125,2310300,2240225.15,62.684274454554796,44.91714434342849,NaN,NaN,185.39076404746154,137.81005397762706,1.2912634115486148,0.02934497148297055,-1.2619184400656442,5614401,3191100.8,54.339801082973786,35.92268497520271,NaN,NaN,-0.34387793350834417,-17.11994038861087
2000-03-22T09:30:00-05:00,109.15625,109.25,107.8125,108.57812,2434800,2284020.15,61.03835059442842,46.580383312954574,NaN,NaN,161.77551912319802,177.1687152133447,1.3269586935011277,0.39677992681076546,-0.9301787666903623,3179601,3758561,56.747253722685066,38.25795654231167,NaN,NaN,3.330945363345562,-14.198385281188523
2000-03-23T09:30:00-05:00,108.375,111.5,108.25,111.125,1894400,2152810.05,65.5721487440273,47.99536636194158,NaN,NaN,164.34985806378432,177.78088220803167,1.4507866311721853,0.8833045222748694,-0.5674821088973159,5074001,3732841,56.60158417208028,39.6120907556064,NaN,NaN,8.03497915014606,-11.02219036242644
2000-03-24T09:30:00-05:00,110.53125,112.46875,110.28125,111.125,1903400,2082135.05,65.5721487440273,49.80316924359857,NaN,NaN,153.49380127955746,168.79544360835914,1.4575205771053388,1.2544186124843577,-0.20310196462098112,5074001,4449221,59.70428545168205,40.83942628061426,NaN,NaN,11.70104219507508,-7.776014282783366
2000-03-27T09:30:00-05:00,111.34375,111.90625,109.6875,109.8125,1431300,2000285.05,61.30827680903431,51.64438807158769,NaN,NaN,119.30923289917946,156.86383508263617,1.3034266049496157,1.4261812915660386,0.1227546866164228,3642701,4516941,59.99544678043456,42.20247209088309,NaN,NaN,13.493809627238596,-4.737468009923085
2000-03-28T09:30:00-05:00,109.125,110.98437,109.125,109.375,1575100,2018790.05,59.90982905464214,53.52671490121185,NaN,NaN,95.08872933925453,138.80342814099475,1.109476353090629,1.5096001279797093,0.40012377488908013,2067601,3807581,55.473794765155134,43.59662795367389,NaN,NaN,14.546489035062086,-1.9826170034966322
2000-03-29T09:30:00-05:00,109.84375,111.21875,108.9375,110.71875,1426100,2033285.05,62.72238011245527,55.1478295115303,NaN,NaN,91.33511722290599,124.71534776093635,1.0118586425906653,1.6649470781274118,0.6530884355367464,3493701,3870401,55.79155533103434,45.252465966995274,NaN,NaN,16.274249466320967,0.6255067779058816
2000-03-30T09:30:00-05:00,109.875,111.5,108.875,110.0625,3573300,2183150.05,60.49042891891228,56.72785619842946,NaN,NaN,80.48544692222418,107.94246553262433,0.8497960262733486,1.7153334683784323,0.8655374421050837,-79599,2839681,49.54409291202745,46.80504063349731,NaN,NaN,17.074793428603137,2.975404870862632
2000-03-31T09:30:00-05:00,110.79687,111.25,109.0625,109.4375,1103400,2154410.05,58.36044586133946,58.13978111150006,NaN,NaN,70.08475500786591,91.260656278286,0.6558936265925093,1.6854044753457202,1.029510848753211,-1182999,1588281,43.21667315579325,48.08409073391914,NaN,NaN,17.148287173017472,5.000102342599037
2000-04-03T09:30:00-04:00,109.3125,112.6875,109.125,112.6875,1411100,2163940.05,65.21882858555287,60.22729669666131,NaN,NaN,85.77455212050693,84.5537201225515,0.6979978847831099,1.9020082047320983,1.2040103199489884,228101,905361,40.19941246469533,49.20795611590774,NaN,NaN,19.32810033120164,7.0469591981136945
2000-04-04T09:30:00-04:00,112.5625,114.34375,106.34375,111.6875,6635602,2308460.15,61.8435370594535,61.31798427807282,NaN,NaN,70.43783517182433,79.62354128906547,0.6130034195354965,1.9702645943683592,1.3572611748328627,-6407501,-789659.4,33.87732628871112,49.53463207557031,NaN,NaN,20.110288746150648,8.913149133547545
2000-04-05T09:30:00-04:00,110.3125,112.3125,109.89062,110.375,3339400,2344485.15,57.62797353090983,61.24779051533262,NaN,NaN,67.33480214512502,74.82347827350927,0.4314613083292511,1.8965878102444265,1.4651265019151753,-9746901,-3437779.8,26.78898724690066,48.734820808150296,NaN,NaN,19.485513080853842,10.423486840305587
2000-04-06T09:30:00-04:00,111.375,112.21875,110.375,111.42187,2279700,2372715.15,59.97169829203766,61.47041142105022,NaN,NaN,71.4169376304735,73.00977641515912,0.3485078344125472,1.9007612949308594,1.5522534605183123,-7467201,-4915300.2,23.797132982656137,47.38575247400589,NaN,NaN,19.657013884260227,11.742562132299106
2000-04-07T09:30:00-04:00,111.96875,111.98437,110.5625,110.90625,1027100,2356440.15,58.26232517501297,61.4701889954563,NaN,NaN,65.15750046647054,72.02432550688005,0.23118758515749072,1.8412379419651757,1.610050356807685,-8494301,-6377560.6,21.265839048993413,45.52451324327303,NaN,NaN,19.300136074887586,12.822215552668888
2000-04-10T09:30:00-04:00,111.21875,112.98437,110.90625,112.0625,1833500,2372790.15,60.950240365768835,61.34632941768587,NaN,NaN,82.20435035691115,71.3102851541609,0.2046449425797321,1.86585653503235,1.6612115924526178,-6660801,-7755341,19.19414043451262,43.01410891124009,NaN,NaN,19.76737942625433,13.814381820323952
2000-04-11T09:30:00-04:00,112.25,113.73437,110.84375,113.25,3624800,2511315.15,63.54675101645738,61.52550087640223,NaN,NaN,102.64102153066177,77.7509224259284,0.23791922917111963,1.9586106289165173,1.7206913997453976,-3036001,-7081041,23.140524165878062,40.61362822861101,NaN,NaN,20.92268185499616,14.829853253848553
2000-04-12T09:30:00-04:00,113.875,114.53125,110.5,110.51562,3620700,2590340.15,54.551942952185655,60.73834331984211,NaN,NaN,83.84289522024996,81.05254104095336,0.056113829610348276,1.790833686758333,1.7347198571479847,-6656701,-6463001,26.67524551341809,38.47603261013514,NaN,NaN,19.150754703933252,15.447124889574939
2000-04-13T09:30:00-04:00,111.35937,111.5625,108.75,109.03125,4333102,2563980.2,50.382781864689576,59.653388542746555,NaN,NaN,-22.885354493715017,62.192082616115655,-0.1713239878001147,1.5205648723978413,1.691888860197956,-10989803,-7167521.4,25.249716865304478,36.01499199682247,NaN,NaN,16.326905760146598,15.572807871085177
2000-04-14T09:30:00-04:00,107.4375,108.25,101.51562,102.51562,4518602,2604385.3,37.01147683171253,57.91790283008072,NaN,NaN,-293.32932387852225,-9.505282252882878,-0.736133431695879,0.7717220705781074,1.5078555022739863,-15508405,-8570342.2,22.653740401104358,33.34772725544173,NaN,NaN,8.321063016304077,14.536844320402162
2000-04-17T09:30:00-04:00,102.875,106.03125,102.25,106,5978398,2812705.2,45.36244271203924,56.87880380560908,NaN,NaN,-234.38591432688867,-72.82333518964285,-0.8429375573971378,0.45418355552756395,1.2971211129247018,-9530007,-9144183.4,21.672171306711334,30.933325579838606,NaN,NaN,4.908624311243383,13.161384319093765
2000-04-18T09:30:00-04:00,106.46875,107.78125,105.89062,107.0625,1576900,2776035.2,47.64197953296743,55.801632335645664,NaN,NaN,-128.5495921102887,-119.06145791783294,-0.8097114723815497,0.28498177244776457,1.0946932448293143,-7953107,-10127604.6,20.067429298410758,28.381602291794064,NaN,NaN,3.144868083863419,11.730453428346573
2000-04-19T09:30:00-04:00,107.4375,108.0625,106.32812,106.8125,1536500,2731120.2,47.14358451690597,54.84828630693094,NaN,NaN,-111.35461147141196,-158.10095925616534,-0.772374117931985,0.12922559741433304,0.901599715346318,-9489607,-10694185.8,19.18598635579019,26.213166109205694,NaN,NaN,1.6382145975452203,10.28870502394638
2000-04-20T09:30:00-04:00,107.0625,108.78125,106.84375,108.78125,1886300,2730715.2,51.45084205848919,54.354743178155914,NaN,NaN,-60.305058951886096,-165.58490014779954,-0.5910613468215926,0.16277303181932723,0.7538343786409198,-7603307,-10016886.6,23.51116071796487,24.805629506503667,NaN,NaN,1.821778660816233,9.079144114927788
2000-04-24T09:30:00-04:00,107,109.25,106.75,108.875,1714200,2721255.2,51.65288286986062,53.38574705560647,NaN,NaN,-47.32582886270973,-116.38420114463705,-0.44732326017158575,0.19468030342643772,0.6420035635980235,-5889107,-8093027,34.27197256391075,24.38224094216191,NaN,NaN,2.0277354593236887,8.07180002127006
2000-04-25T09:30:00-04:00,109.71875,111.625,108.78125,111.53125,2798700,2789625.2,57.100337613965976,53.0469470952145,NaN,NaN,38.13181056088012,-61.88065616708328,-0.1701189420899818,0.4293548859855463,0.5994738280755281,-3090407,-6805107,40.32458177636803,24.842759191280262,NaN,NaN,3.9645876017393125,7.485055389908524
2000-04-26T09:30:00-04:00,111.5625,111.5625,108.9375,109.46875,2051600,2813450.2,52.183706096218124,52.65807084987938,NaN,NaN,13.92750029570303,-33.385237685884945,-0.12454394988893414,0.4437938907143604,0.5683378406032945,-5142007,-6242887,42.80077355851713,25.98645821353858,NaN,NaN,4.019439098947983,6.9899673483427325
2000-04-27T09:30:00-04:00,107.09375,109.5,107.09375,108.375,1656700,2824980.2,49.73788283061872,51.9270840312066,NaN,NaN,-41.627735370673335,-19.4398624657372,-0.1644316254665592,0.36279830877009545,0.5272299342366547,-6798707,-5704707,45.14713062897644,27.511458045418603,NaN,NaN,3.2971551947209505,6.462422754968192
2000-04-28T09:30:00-04:00,109.375,109.5,107,107.5625,1166000,2704615.2,47.94033201376223,51.18979880540297,NaN,NaN,-46.93585547290765,-16.766021769941503,-0.23747117677154128,0.23039096327222808,0.46786214004376936,-7964707,-5776987,44.880849560626096,29.198244510535226,NaN,NaN,2.1615081605311506,5.8480063843343295
2000-05-01T09:30:00-04:00,107.96875,109.34375,107.15625,108.125,1385800,2718735.2,49.30627302279876,50.35808685233368,NaN,NaN,-36.85786460808931,-14.67242891901742,-0.23917029495569764,0.16889927134914728,0.4080695663048449,-6578907,-5914947,44.34325186208383,30.994609612504597,NaN,NaN,1.627264478415918,5.245043254917413
2000-05-02T09:30:00-04:00,107.5,108.23437,106.8125,107.0625,705000,2683430.2,46.80798999601084,49.16246106515893,NaN,NaN,-58.24288780960498,-33.94736859311443,-0.29922412739303955,0.03403940706354547,0.333263534456585,-7283907,-6753647,41.11866914405439,32.27876282523148,NaN,NaN,0.45408433533065623,4.560620552119305
2000-05-03T09:30:00-04:00,106.51562,106.71875,103.75,104.8125,2333500,2468325.1,41.95948474325538,48.26299976452105,NaN,NaN,-119.62170047211707,-60.65720874667845,-0.46780692654529665,-0.2514951237250358,0.21631180282026086,-9617407,-7648727,37.94716547403314,33.083899965275414,NaN,NaN,-2.0479986813710918,3.6165320901921056
2000-05-04T09:30:00-04:00,105.28125,105.28125,103.78125,104.3125,1154900,2359100.1,40.94450888137571,47.58883740857006,NaN,NaN,-126.53731136489093,-77.63912394552197,-0.5828290522834463,-0.512224512534047,0.07060453974939929,-10772307,-8443447,35.34077650487053,33.80468993953013,NaN,NaN,-4.399443726552772,2.4713926877999803
2000-05-05T09:30:00-04:00,103.3125,105.89062,103.3125,105.84375,1352100,2312720.1,45.307777217589475,48.18143029327555,NaN,NaN,-100.93630152466665,-88.43921315587377,-0.5272927207380711,-0.5885113611731896,-0.06121864043511849,-9420207,-8734547,34.40851330260992,34.64431657535196,NaN,NaN,-5.171954300139712,1.3794859752371673
2000-05-08T09:30:00-04:00,105.26562,106.375,105,105.9375,665500,2294640.1,45.572918007618775,48.1964642429598,NaN,NaN,-69.08619930827483,-94.88488009591087,-0.4583010436698231,-0.6340949450223974,-0.17579390135257428,-8754707,-9169707,33.00680579734134,35.453933324682666,NaN,NaN,-5.729047720976461,0.36398116149236337
2000-05-09T09:30:00-04:00,106.0625,106.9375,105,105.375,1194600,2262695.1,44.18871966789904,47.94980282402634,NaN,NaN,-61.959924924219116,-95.62828751883372,-0.4253282555135138,-0.7074542207444665,-0.28212596523095274,-9949307,-9702787,31.323401203998557,36.25793131793894,NaN,NaN,-6.575457125015697,-0.6273671651516451
2000-05-10T09:30:00-04:00,104.53125,105.09375,102.625,103.3125,1832600,2173085.1,39.45648771270471,47.40072448086911,NaN,NaN,-122.2846333022794,-96.16087408486618,-0.5114169837625759,-0.9213971949341726,-0.4099802111715967,-11781907,-10135687,29.985935977209806,37.02935629089749,NaN,NaN,-8.69730984255998,-1.7802161190671213
2000-05-11T09:30:00-04:00,104,105.90625,103.875,105.75,1342700,2059185.1,46.71863861317208,47.06270994906075,NaN,NaN,-62.41384032534711,-83.33617987695742,-0.3792731405654677,-0.8840716368784314,-0.5047984963129637,-10439207,-10069067,30.47790545566191,37.526980915018704,NaN,NaN,-8.43257412856504,-2.730552977566824
2000-05-12T09:30:00-04:00,106,106.78125,105.75,106.25,999400,1892500,48.094026086105,46.80850589307821,NaN,NaN,-15.88003463204098,-66.32492649843229,-0.2400548315114246,-0.8048670357022445,-0.5648122041908199,-9439807,-10072987,30.4643407373638,37.25500721312249,NaN,NaN,-7.812981000673173,-3.4566141237248735
2000-05-15T09:30:00-04:00,106.46875,108.25,106.0625,108.20312,721400,1702639.9,53.17842245573622,46.528369096061795,NaN,NaN,29.510232379369025,-46.60564016090352,-0.010418580955555035,-0.5778354303852637,-0.5674168494297087,-8718407,-10065727,30.526012040834388,36.55510937487009,NaN,NaN,-5.726997903819852,-3.780954663738442
2000-05-16T09:30:00-04:00,108.875,109.78125,108.1875,109.3125,1155300,1461485,55.82528794432769,46.78848208521248,NaN,NaN,89.9969976213639,-16.214255651786914,0.21003020232093683,-0.30487909652853773,-0.5149092988494746,-7563107,-9588487,34.63029216782445,35.971503561249186,NaN,NaN,-3.169410345499714,-3.693591189704338
2000-05-17T09:30:00-04:00,108.3125,108.6875,107.5625,107.75,896000,1427440,51.41656071516662,46.90838764839447,NaN,NaN,38.84797058954429,16.012265126577823,0.24217232868686567,-0.21219388799089245,-0.4543662166777581,-8459107,-8923927,39.95024801107,35.60029765997015,NaN,NaN,-2.278666725205836,-3.491459123347409
2000-05-18T09:30:00-04:00,108.01562,108.8125,107.40625,107.4375,931300,1397180,50.55660742987325,47.09526446383097,NaN,NaN,31.572387811491094,34.80951075394547,0.23382266727956236,-0.1620878825783052,-0.39591054985786756,-9390407,-8714167,41.56670814052591,35.36357327282014,NaN,NaN,-1.798249650533683,-3.249572055802591
2000-05-19T09:30:00-04:00,106.5625,107.03125,105.51562,106.5625,1394200,1372575,48.12930366247962,47.01119522380817,NaN,NaN,-28.504713091203037,32.284575062113056,0.16410087574677812,-0.1907844551743949,-0.354885330921173,-10784607,-8983127,40.07700827568857,35.05884158807762,NaN,NaN,-2.0799492625625584,-3.0824830853397294
2000-05-22T09:30:00-04:00,106.125,106.34375,103.625,105.53125,1233400,1348535,45.364868220324546,46.90811509697344,NaN,NaN,-71.18423921695774,12.145680742847706,0.04922162448750278,-0.29335830031179455,-0.34257992479929733,-12018007,-9643047,36.61010008995883,34.736800941356506,NaN,NaN,-3.109398775407558,-3.086328183920848
2000-05-23T09:30:00-04:00,105.59375,105.6875,104.01562,104.4375,715700,1244385,42.57194404966039,46.95186219028808,NaN,NaN,-83.25121924726184,-22.503962630877446,-0.09204007753030369,-0.4576300217121769,-0.36558994418187324,-12733707,-10677167,31.946374819065312,34.30817303743023,NaN,NaN,-4.797891988985126,-3.3308372989300303
2000-05-24T09:30:00-04:00,104.73437,105.6875,103.46875,105.4375,1256700,1204640,45.85418887450579,47.3025536183688,NaN,NaN,-71.44886338080613,-44.563329424947526,-0.10860460515417913,-0.5013457006245972,-0.392741095470418,-11477007,-11280747,29.57800505284699,33.89654650514284,NaN,NaN,-5.3172530438853975,-3.614610976780797
2000-05-25T09:30:00-04:00,105.71875,105.8125,102.5625,103.5,1199600,1181785,40.968525047720206,46.99260703480672,NaN,NaN,-105.58598074865316,-71.99500313697638,-0.23335987534480457,-0.6844409396514237,-0.45108106430661915,-12676607,-11937987,27.21226788634675,33.38252897540975,NaN,NaN,-7.240029027333665,-4.132527841145492
2000-05-26T09:30:00-04:00,103.46875,103.98437,102.53125,103.125,918800,1169425,40.07844379251206,46.60014459087052,NaN,NaN,-130.03488131179913,-92.30103678109559,-0.3191401554867197,-0.8500062586650188,-0.5308661031782991,-13595407,-12500147,25.344984308908764,32.835256011950285,NaN,NaN,-9.079607383554631,-4.8392534900610835
2000-05-30T09:30:00-04:00,104.125,105.5,103.53125,105.4375,822500,1141260,47.633961139903306,46.84623326744226,NaN,NaN,-46.747942960812146,-87.41377752986648,-0.20375756642716725,-0.7855630612122582,-0.5818054947850909,-12772907,-12651127,24.851757347658136,32.372995736497394,NaN,NaN,-8.45841546449378,-5.356276629265754
2000-05-31T09:30:00-04:00,105.03125,106.09375,105,105.3125,476100,1129815,47.286877046133846,47.40554679125863,NaN,NaN,-8.2652945351376,-72.41659258744163,-0.12342968494945938,-0.7360926009719151,-0.6126629160224557,-13249007,-12754187,24.50124896769094,31.981232378674623,NaN,NaN,-8.056428429437586,-5.742012600718874
2000-06-01T09:30:00-04:00,105.98437,107,105.34375,106.5,791900,1052735,50.94383444145936,47.70734649327915,NaN,NaN,34.110453438229726,-51.30472922363445,0.014757669635830917,-0.5942158289776671,-0.608973498613498,-12457107,-12950207,23.81330062955577,31.5051891768099,NaN,NaN,-6.639899176681176,-5.870282111570631
2000-06-02T09:30:00-04:00,108.75,108.96875,107.51562,107.51562,751000,1032540,53.89013669942676,48.1213543942307,NaN,NaN,113.80923866570065,-7.4256853407636925,0.17096359579830123,-0.39526900386562147,-0.5662325996639227,-11706107,-12756107,26.02814861882601,31.188318311200057,NaN,NaN,-4.564343668673108,-5.683719476870985
2000-06-05T09:30:00-04:00,107.375,108.73437,107.375,108.25,750600,1002465,55.9502967729397,48.31934541688809,NaN,NaN,104.68210008000591,39.51771093759731,0.311936900390847,-0.17631147417536397,-0.48824837456621095,-10955507,-12228127,31.833301306477367,31.281696115888842,NaN,NaN,-2.2136107480693537,-5.1879896584707526
2000-06-06T09:30:00-04:00,107.5,107.98437,107.0625,107.64062,392700,988825,53.802174494985564,48.174837313363646,NaN,NaN,69.24816204997802,62.71693193975534,0.3495060480882099,-0.051365814455948566,-0.40087186254415846,-11348207,-11943187,34.80681530377325,31.294304911313755,NaN,NaN,-0.8255040297139196,-4.564777425791205
2000-06-07T09:30:00-04:00,107.375,108.6875,107.03125,108.34375,895300,973860,55.90580813505918,48.49549784335598,NaN,NaN,81.59993067217884,80.68997698121862,0.40325876366866364,0.10320159204167112,-0.3000571716269925,-10452907,-11383967,40.30999042013308,31.3200007976754,NaN,NaN,0.950190089046255,-3.7769249236715683
2000-06-08T09:30:00-04:00,107.71875,107.71875,106.375,106.78125,847900,924625,50.412249875910156,48.485186589501474,NaN,NaN,28.32573170825196,79.53303263522307,0.31883089792908387,0.09848145078436232,-0.22034944714472154,-11300807,-11152707,42.47264928322611,31.384710879296843,NaN,NaN,0.9587582906572291,-3.100398750196026
2000-06-09T09:30:00-04:00,107.71875,107.71875,105.89062,106.26562,818500,898415,48.71115677739771,48.52674752628133,NaN,NaN,9.02860968909095,58.57690683990113,0.21830208666485312,0.052528161186344846,-0.16577392547850828,-12119307,-11235347,41.888590461306954,31.51410960684101,NaN,NaN,0.4837361875606931,-2.5883794733736374
2000-06-12T09:30:00-04:00,106.64062,106.6875,105.65625,105.71875,429700,869930,46.90345236270311,48.63664639359409,NaN,NaN,-20.414448575727715,33.557597108754415,0.11046018264425225,-0.027698697173192954,-0.1381588798174452,-12549007,-11554047,39.62551717359884,31.729496541386727,NaN,NaN,-0.4232325476998146,-2.2790727697059485
2000-06-13T09:30:00-04:00,105.1875,106.70312,104.875,106.5625,953800,881550,49.987304904475145,49.16631502608086,NaN,NaN,-15.990989465204919,16.509766805717824,0.09218218312923258,-0.022931150905904474,-0.11511333403513706,-11595207,-11603447,39.271350027612534,32.25270905628295,NaN,NaN,-0.35385388913027666,-2.004041501052281
2000-06-14T09:30:00-04:00,106.92187,107.48437,106.40625,107.25,614100,854490,52.41259101084476,49.634772321533646,NaN,NaN,43.72149805824082,8.934080282930223,0.12081765494129447,0.03590873464148103,-0.08490892029981344,-10981107,-11709087,38.47931071330421,32.88851660345847,NaN,NaN,0.37803920531599855,-1.663744257285384
2000-06-15T09:30:00-04:00,107.125,107.75,106.64062,106.84375,647700,842075,50.84358628609875,50.34013383856068,NaN,NaN,49.71734910827279,13.21240376293439,0.10728052529084645,0.04919173631374463,-0.05808878897710182,-11628807,-11774687,37.96722821746389,33.65672805568112,NaN,NaN,0.5735043865009144,-1.3441373081730557
2000-06-16T09:30:00-04:00,107.04687,107.15625,104.51562,104.51562,2979700,944495,42.91499201348688,50.542744425773165,NaN,NaN,-41.14149007360169,3.178383810395869,-0.05487434098757846,-0.1266817152115749,-0.07180737422399644,-14608507,-12272527,34.24285460581385,34.29229021974577,NaN,NaN,-1.622798712312886,-1.3839460801930314
2000-06-19T09:30:00-04:00,104.76562,106.0625,104.32812,105.59375,929800,921275,47.034115699344035,50.49989832287607,NaN,NaN,-41.34099188090308,-1.0069248506392057,-0.08417487406324893,-0.1770259668030576,-0.09285109273980867,-13678707,-12498467,32.676232172820505,34.851181278685935,NaN,NaN,-2.271060048704417,-1.5106766471232294
2000-06-20T09:30:00-04:00,105.40625,105.4375,104.0625,104.54687,1359800,927595,43.73411830091784,50.24612984107493,NaN,NaN,-76.02865467875058,-13.01445789334834,-0.16409022476729943,-0.29796387369893296,-0.13387364893163353,-15038507,-13187127,28.409850160971274,35.130367078205964,NaN,NaN,-3.8264384808508605,-1.8414997662271766
2000-06-21T09:30:00-04:00,104.3125,105.25,104.14062,104.9375,589800,921300,45.276969797590716,49.841353795084316,NaN,NaN,-71.050538239028,-35.9688651528021,-0.1794281431222598,-0.3581588278344583,-0.1787306847121985,-14448707,-13880647,24.885969828714593,35.20698630671731,NaN,NaN,-4.659060303812464,-2.244008414453646
2000-06-22T09:30:00-04:00,104.59375,105.03125,103.375,104,888200,902875,42.280502748461004,49.01209422715819,NaN,NaN,-102.20829080587504,-66.35399313563167,-0.237835339742089,-0.47602485938980976,-0.23818951964772075,-15336907,-14622267,21.77549073653799,34.90322502941102,NaN,NaN,-6.256138169810431,-2.817169808076044
2000-06-23T09:30:00-04:00,104.21875,104.98437,103.78125,104.4375,726800,879235,44.138463328381626,48.168391838261186,NaN,NaN,-90.53026685414994,-76.23174849174131,-0.23188436122994593,-0.5280449711851531,-0.2961606099552072,-14610107,-14622587,21.77422609141759,34.18471965690675,NaN,NaN,-7.062181359055613,-3.423600029644554
2000-06-26T09:30:00-04:00,104.9375,105.96875,104.71875,105.96875,1010200,883805,50.18276712065997,47.90986274009508,NaN,NaN,-35.31763913139468,-75.02707794183964,-0.11557780433204351,-0.4406328653702616,-0.3250550610382181,-13599907,-14606827,22.014444237660555,33.27097886647013,NaN,NaN,-5.981353606451659,-3.7889933977598544
2000-06-27T09:30:00-04:00,105.65625,106.25,105.09375,105.375,415600,863460,48.01337601980109,47.34611758900521,NaN,NaN,-37.551494971630454,-67.3316460004156,-0.07154860116233608,-0.41449081249113817,-0.3429422113288021,-14015507,-14402227,25.224760757459848,32.19346246199347,NaN,NaN,-5.707875756637006,-4.063119449028019
2000-06-28T09:30:00-04:00,105.75,106.45312,105.07812,105.375,516900,865500,48.01337601980109,47.174769456426,NaN,NaN,-34.298633425620935,-59.981265037734204,-0.03707471502280146,-0.3892856051073039,-0.35221089008450246,-14015507,-14315587,26.602641436655773,31.059890472952734,NaN,NaN,-5.485216994034111,-4.266276241171746
2000-06-29T09:30:00-04:00,104.60937,105.3125,103.625,104.25,444300,848120,43.84802546734857,46.827402934279625,NaN,NaN,-102.53946672867507,-60.047500222294204,-0.08210746557726123,-0.454845222056079,-0.3727377564788178,-14459807,-14140167,29.437761751499934,30.17054556510937,NaN,NaN,-6.475192872169101,-4.581835759885654
2000-06-30T09:30:00-04:00,103.54687,104.5,103.34375,104.375,652100,843175,44.42493993179822,46.65036633207213,NaN,NaN,-112.71598599061792,-64.48464404958781,-0.09465352522006071,-0.49105466300389367,-0.39640113778383296,-13807707,-13979687,32.02460030809088,29.627622931858806,NaN,NaN,-7.136472394355346,-4.946783850524182
2000-07-03T09:30:00-04:00,104.75,105.96875,104.34375,105.96875,266700,818980,51.29575249699545,46.743826874395005,NaN,NaN,-21.807626450858077,-61.782641513480485,0.007768057069227785,-0.3866910664472982,-0.394459123516526,-13541007,-13967907,32.22102723305595,29.124028446533334,NaN,NaN,-5.735097440809485,-5.059400077707797
2000-07-05T09:30:00-04:00,105.35937,105.875,104.64062,105,780200,838355,47.45524529280477,46.38973075167787,NaN,NaN,-34.94793357246398,-61.261929233647194,0.013329552934817301,-0.3777971823480044,-0.3911267352828217,-14321207,-14029047,31.708879829395187,28.64042624053983,NaN,NaN,-5.652754248542144,-5.14416495925556
2000-07-06T09:30:00-04:00,105.34375,105.45312,104.0625,105.09375,330700,810125,47.862068036246754,46.176765162402724,NaN,NaN,-53.14098721423705,-65.03039999137042,0.025665367377357473,-0.3590450260611249,-0.38471039343848235,-13990507,-14024047,31.804344253393964,28.200220243106266,NaN,NaN,-5.470675578057934,-5.1908093333701855
2000-07-07T09:30:00-04:00,105.5625,106.75,105.15625,106.32812,634500,799455,53.019700613395315,46.89853006239618,NaN,NaN,63.75936641602744,-31.770633362429926,0.11433373682641595,-0.24179322240546242,-0.35612695923187837,-13356007,-13803287,36.05466083806074,28.32963497398104,NaN,NaN,-3.7921466203974257,-4.991000374374077
2000-07-10T09:30:00-04:00,106.0625,107.21875,106.0625,106.5,387500,777905,53.70642425170064,47.37512353042166,NaN,NaN,113.79058999271149,13.530681834235963,0.17813151115897685,-0.13346257028315733,-0.3115940814421342,-12968507,-13635447,39.15935039703617,28.792714847139305,NaN,NaN,-2.2152418245256023,-4.594463438681438
2000-07-11T09:30:00-04:00,106.46875,108.23437,106.28125,107.1875,1000500,806445,56.448630249614624,48.283302955328566,NaN,NaN,155.04993797815933,48.90219472003944,0.25549615961610633,0.007776118077998717,-0.24772004153810762,-11968007,-13320847,44.58992694216687,29.948434617224702,NaN,NaN,-0.07166242800406397,-3.94834900858467
2000-07-12T09:30:00-04:00,108.15625,108.59375,107.54687,107.8125,977100,807610,58.83584013135797,49.25179369345479,NaN,NaN,185.93217308745815,93.07821605202386,0.3327377478114203,0.16820214322616778,-0.16453560458525252,-10990907,-12654787,53.95970874773387,32.02513025429751,NaN,NaN,2.453640413855207,-3.033779091093259
2000-07-13T09:30:00-04:00,108.53125,108.6875,107.625,108,1176200,835715,59.55213254584335,50.485481536124965,NaN,NaN,177.05149308608685,139.11671211208866,0.37717446797641874,0.3069324803852709,-0.07024198759114783,-9814707,-11819627,62.518280194910396,34.93532950132411,NaN,NaN,4.761352459923577,-1.9201888695194256
2000-07-14T09:30:00-04:00,108.1875,108.4375,107.625,108.0625,551200,830890,59.80322044592307,51.6043927588065,NaN,NaN,157.92585100636572,157.9500090301563,0.3898834212123817,0.4171122889243293,0.027228867711947602,-9263507,-11001127,68.66598430085173,38.28474080199798,NaN,NaN,6.758883706618675,-0.680321358642554
2000-07-17T09:30:00-04:00,107.875,108.6875,107.5625,107.90625,688400,716325,58.82015815945054,52.221349261577245,NaN,NaN,130.80431595951512,161.35275422351702,0.3671910633346841,0.4862176968803027,0.11902663354561863,-9951907,-10397807,72.27566146418388,41.87482774674964,NaN,NaN,8.213973700907028,0.5902922212931003
2000-07-18T09:30:00-04:00,107.5625,108,107.03125,107.625,347600,687215,57.003735266864176,52.86351777922461,NaN,NaN,88.58798631054688,148.06036388999456,0.3146853096999257,0.5123832706705258,0.19769796097060008,-10299507,-10064107,74.05592257369585,45.36276787648079,NaN,NaN,9.021205841027605,1.7947084526837438
2000-07-19T09:30:00-04:00,107.5625,108.15625,106.9375,107.1875,764300,657440,54.199857155132094,53.30540928889111,NaN,NaN,72.7556504835771,125.42505936921832,0.2355567941066743,0.4921439536039429,0.2565871594972686,-11063807,-10078687,73.83284387172142,48.73635376469976,NaN,NaN,9.019830687696269,2.826868771971247
2000-07-20T09:30:00-04:00,107.8125,109.09375,107.8125,109.09375,656900,660795,62.78841857365422,54.658294510770084,NaN,NaN,120.12782130678863,114.04032501335868,0.2929254626181573,0.6227439877699652,0.32981852515180793,-10406907,-10197127,71.93711218220764,51.77202165260745,NaN,NaN,11.529426025107787,4.070091236705038
2000-07-21T09:30:00-04:00,108.01562,108.34375,107,107,471000,639935,51.389629211270474,55.15577231644668,NaN,NaN,53.16728993153211,93.08861279839195,0.17690226968329614,0.5509463622559281,0.37404409257263194,-10877907,-10520007,66.89461287586477,54.26273683601987,NaN,NaN,10.169763695675131,4.941473016557909
2000-07-24T09:30:00-04:00,107.375,107.75,106.6875,106.8125,414300,624310,50.50537344332836,55.09931666975616,NaN,NaN,29.34563876792588,72.79687736007412,0.07953177024149899,0.4734588053745057,0.3939270351330067,-11292207,-10788067,62.94948930714643,56.45762698416919,NaN,NaN,8.8114860177905,5.494332016733994
2000-07-25T09:30:00-04:00,107.34375,107.5,106.6875,106.78125,275500,587575,50.34987207259602,55.306075725455536,NaN,NaN,20.943595062118572,59.26799911038845,0.00874698117578182,0.404860761602734,0.39611378042695217,-11567707,-11041707,59.38097684164102,58.43420534218675,NaN,NaN,7.6775616465599965,5.8062219638519945
2000-07-26T09:30:00-04:00,106.53125,106.75,105.39062,105.5,406500,587120,44.324192818526875,55.05337035276126,NaN,NaN,-43.42621802127034,36.031625409418965,-0.12145575997936436,0.2442940804527467,0.36574984043211106,-11974207,-11223787,56.88785364821881,60.22588458467424,NaN,NaN,4.776802882624426,5.659162095105199
2000-07-27T09:30:00-04:00,105.57812,106.48437,105.15625,106.03125,803900,601470,47.14851712784132,54.63400010379313,NaN,NaN,-44.09484969836975,3.187091208387291,-0.16612874163149233,0.15808891339274567,0.324217655024238,-11170307,-11376467,54.80978869033092,61.565536574122106,NaN,NaN,3.206011179912674,5.308711964363409
2000-07-28T09:30:00-04:00,106.26562,106.5,104.53125,105.01562,521500,605330,42.68995335180947,53.84710932522946,NaN,NaN,-82.15786547025311,-23.877939871969755,-0.2531911222968088,0.007728752153226992,0.2609198744500358,-11691807,-11539247,52.603522188006615,62.52583455919142,NaN,NaN,0.4402029413187257,4.613210675357026
2000-07-31T09:30:00-04:00,105.4375,106,104.875,105,347600,590105,42.62319537873938,52.8595782630241,NaN,NaN,-95.2090038480498,-48.7888683951649,-0.29786302740891163,-0.11140890981110374,0.1864541175978079,-12039407,-11688687,50.590184582204415,62.954424390622684,NaN,NaN,-1.7916545536456454,3.6982299283566444
2000-08-01T09:30:00-04:00,105.53125,106.3125,105.04687,106,385400,596040,48.20725497762459,52.10039360918599,NaN,NaN,-65.48469290322299,-66.0745259882332,-0.24813024278398896,-0.12370868588217832,0.12442155690181064,-11654007,-11705947,50.35048676973944,62.69662282076593,NaN,NaN,-2.086267575875649,2.8718731420377455
2000-08-02T09:30:00-04:00,105.90625,107.25,105.875,107,724600,593260,53.12063228324656,51.641000733286226,NaN,NaN,-10.360689484603613,-59.46142028089987,-0.14126796328933072,-0.052163397209852747,0.08910456607947796,-10929407,-11496987,53.23908949807942,62.033823485278,NaN,NaN,-0.8190893372590559,2.344592787852488
2000-08-03T09:30:00-04:00,106.09375,107.48437,106.04687,106.9375,658400,609645,52.783597384731195,51.13959908605823,NaN,NaN,-10.341907929369873,-52.71083192709989,-0.0716842100075785,-0.0005006964299951733,0.07118351357758333,-11587807,-11580487,51.938704547703665,60.839017788624574,NaN,NaN,0.10127789844437127,2.0241192322227572
2000-08-04T09:30:00-04:00,107.125,107.73437,106.64062,107.5,879800,621910,55.51895320860585,50.90379873242647,NaN,NaN,24.15533793589985,-31.448191245869292,0.010935812621116453,0.0848532793539789,0.07391746673286245,-10708007,-11383727,54.743841223159,59.58674491426565,NaN,NaN,1.6881633147922677,1.9761255297326874
2000-08-07T09:30:00-04:00,107.78125,109.03125,107.35937,108.625,1166900,660880,60.453463572221864,51.15020789709488,NaN,NaN,102.52596673953136,8.098802871646933,0.1332681491810628,0.24050265320919095,0.10723450402812815,-9541107,-10884067,60.97320748373642,58.65226526498284,NaN,NaN,4.624872031684649,2.354517887154396
2000-08-08T09:30:00-04:00,108.5625,109.96875,108.34375,109.65625,807200,651215,64.35684772637262,51.875707223612054,NaN,NaN,156.9284890910901,52.581439270509556,0.2677918804783982,0.4419743546261259,0.1741824741477277,-8733907,-10300047,66.73651445237982,58.145384592172725,NaN,NaN,8.425019940696487,3.2217324662318374
2000-08-09T09:30:00-04:00,109.40625,109.79687,108.90625,109.125,1227000,663710,61.015711476245066,51.74908528808283,NaN,NaN,139.67451705099012,82.5884805776283,0.3025795339466069,0.5524068915809863,0.2498273576343794,-9960907,-10106347,68.40314498507476,57.892958363806095,NaN,NaN,10.561678786252289,4.270296226234759
2000-08-10T09:30:00-04:00,109.01562,109.59375,108.84375,109.21875,429600,626380,61.39658619937283,52.46386793009014,NaN,NaN,124.89711253365383,109.63628467023304,0.31222731968437734,0.6401115072398511,0.32788418755547377,-9531307,-9695047,71.65117754891877,58.23271298330995,NaN,NaN,12.399066726355615,5.431549154823452
2000-08-11T09:30:00-04:00,109.21875,110.78125,109.15625,110.34375,1093800,653510,65.72417851192361,53.5509254349898,NaN,NaN,159.58272775987737,136.72176263502857,0.3707125070916125,0.7912748214199894,0.4205623143283769,-8437507,-9240947,74.73869724632597,59.074799264679925,NaN,NaN,15.371218877819878,6.85150197239437
2000-08-14T09:30:00-04:00,110.28125,111.96875,110.09375,111.71875,1212700,679725,70.13144843936857,54.96389517547356,NaN,NaN,187.29514846595598,153.67559898031348,0.471851628724825,1.0103768502344082,0.5385252215095832,-7224807,-8777687,77.43832584364526,60.364609907680226,NaN,NaN,19.465512746320687,8.6535035115267
2000-08-15T09:30:00-04:00,111.48437,111.5,110.625,110.9375,1258400,725265,65.01610560801439,56.44188894615123,NaN,NaN,143.7422603165348,151.03835322540243,0.45574124719188724,1.1082017804994422,0.6524605333075549,-8483207,-8727547,77.71590540154288,61.852327890060515,NaN,NaN,21.256818376137872,10.45397706361401
2000-08-16T09:30:00-04:00,111.03125,111.07812,109.76562,110.6875,1047400,739420,63.42193038394493,57.60427560730149,NaN,NaN,104.99273415948059,144.10199664710052,0.3998500888096538,1.1522731443196221,0.7524230555099684,-9530607,-8641487,78.21140920798067,63.52387221274978,NaN,NaN,22.21111587576928,12.133568322493334
2000-08-17T09:30:00-04:00,110.01562,111.10937,110.01562,110.84375,590600,736105,64.0158007391936,59.12755042068607,NaN,NaN,100.21803799259348,139.16618173888847,0.3469696037503327,1.1861350601978842,0.8391654564475515,-8940007,-8523227,78.9055404949437,65.40258780610243,NaN,NaN,23.159172661867814,13.708654656689689
2000-08-18T09:30:00-04:00,110.9375,110.9375,109.96875,110.4375,349000,730005,61.232188865192974,60.45676424114704,NaN,NaN,82.26036632274425,123.70170945146182,0.2620599830019342,1.1667404351999693,0.9046804521980351,-9289007,-8693527,75.19071718998248,67.159768706658,NaN,NaN,23.1582147674461,15.058591815369176
2000-08-21T09:30:00-04:00,110.9375,111.125,110.21875,110.90625,754600,747020,63.2195254025531,61.52906927149909,NaN,NaN,83.9149660926225,103.02567297679511,0.21676939126713346,1.175642191281952,0.9588728000148184,-8534407,-8955447,69.7516567206106,68.54556656029165,NaN,NaN,23.71841230020879,16.29570902748912
2000-08-22T09:30:00-04:00,111.07812,112,111,111.54687,1053700,785930,65.79983729512992,62.434726772347894,NaN,NaN,99.19926517315363,94.11707394811887,0.20915972761749657,1.220322459536689,1.0111627319191925,-7480707,-8754947,71.45395627268014,69.84662847276313,NaN,NaN,24.944008999628426,17.53118045208045
2000-08-23T09:30:00-04:00,111.1875,111.875,110.65625,111.5,602900,795750,65.43812367916891,63.33862150766487,NaN,NaN,86.41310504504078,90.4011481252309,0.18121592780775586,1.2376826416788873,1.0564667138711314,-8083607,-8465547,73.7502546535948,71.40459633746964,NaN,NaN,25.851594625402157,18.719811048269264
2000-08-24T09:30:00-04:00,111.40625,112.125,111.15625,112.03125,408400,775975,67.61142784750376,64.20236969615758,NaN,NaN,95.45127957752501,89.44779644221722,0.17847318560206982,1.2795581958737188,1.101085010271649,-7675207,-8212587,75.59801466431124,72.8941801546948,NaN,NaN,27.24412845773824,19.937570678193403
2000-08-25T09:30:00-04:00,111.875,112.25,111.53125,112.23437,134900,756645,68.42886032553633,64.7720408928229,NaN,NaN,98.274182690168,92.65055971570197,0.17032249063568994,1.3139881235662614,1.1436656329305714,-7540307,-7862847,77.91293772573177,74.10416088626589,NaN,NaN,28.640805202513075,21.180889895953356
2000-08-28T09:30:00-04:00,112.23437,113.32812,112.07812,112.6875,530400,765785,70.23370440140476,65.1918163696109,NaN,NaN,119.22456521040097,99.71247953925766,0.1747763232690822,1.3621360370169242,1.187359713747842,-7009907,-7557947,79.71924763275445,75.03149897057835,NaN,NaN,30.35116116408105,22.490928648543026
2000-08-29T09:30:00-04:00,112.4375,112.625,112,112.53125,326700,762850,68.77370149193968,65.74595851358909,NaN,NaN,103.18043316080127,100.5087131367872,0.14760939377393645,1.3718714559652625,1.224262062191326,-7336607,-7529127,79.88668760476384,75.85175201484186,NaN,NaN,31.41271502665467,23.76546955970183
2000-08-30T09:30:00-04:00,111.6875,112.25,110.9375,111.15625,354800,744360,57.45485359989299,65.46440618505481,NaN,NaN,55.42826831530452,94.31174579083994,0.02393310906343471,1.2541784485206193,1.2302453394571846,-7691407,-7450687,80.36191611065472,76.47394762639443,NaN,NaN,29.075624375917876,24.52406310487555
2000-08-31T09:30:00-04:00,111.5,113.23437,111.4375,112.46875,889600,755920,63.61127041055931,65.31348417781452,NaN,NaN,102.41018663538047,95.70352720241104,0.01770536852401361,1.2523770501122016,1.234671681588188,-6801807,-7276007,81.41502010841107,76.95082783082908,NaN,NaN,28.864918906309967,25.144185362223325
2000-09-01T09:30:00-04:00,112.9375,113.25,112.32812,112.53125,302000,727030,63.87931029127067,64.86690288152181,NaN,NaN,116.37671023278429,99.32403271093429,0.005606134676151786,1.2416793499333778,1.236073215257226,-6499807,-7067907,82.61135165652472,77.3203296746062,NaN,NaN,28.77717399022439,25.663183737652048
2000-09-05T09:30:00-04:00,111.9375,113.125,111.8125,112.85937,373700,687370,65.3234390316625,64.88885526892524,NaN,NaN,103.12219846216641,96.10355936128738,0.007399494751958446,1.245322583697174,1.2379230889452155,-6126107,-6891147,83.57830188457687,77.7390722805372,NaN,NaN,29.124888198870114,26.157712946397485
2000-09-06T09:30:00-04:00,113.03125,114.09375,113.03125,113.1875,715300,682775,66.75488713525391,65.12692360830445,NaN,NaN,149.66922436801025,105.40131760272918,0.017790225887614808,1.260160871304734,1.2423706454171193,-5410807,-6505987,85.47383407672866,78.25781691401919,NaN,NaN,29.82746902674117,26.681963815018012
2000-09-07T09:30:00-04:00,112.78125,113.25,112.26562,112.78125,650600,653955,63.272426649134424,65.07382545901451,NaN,NaN,92.15695632182424,112.74705520403313,-0.013882040128982975,1.2250180952558907,1.2389001353848736,-6061407,-6179987,86.85669582800293,78.82575658066627,NaN,NaN,29.429310012405885,27.07444184321628
2000-09-08T09:30:00-04:00,112.26562,112.78125,111.89062,112.09375,419300,653440,57.7790712173626,64.8271741984552,NaN,NaN,46.20738764579152,101.50649540611535,-0.08817534331561161,1.128680956240359,1.2168562995559706,-6480707,-6115767,87.11688312847718,79.67762557627303,NaN,NaN,27.456980716450442,27.129090253678303
2000-09-11T09:30:00-04:00,111.96875,113,111.40625,112.125,765600,637030,57.95774925303395,64.45133304491813,NaN,NaN,33.65270532336491,84.96169442423147,-0.13921819386440548,1.042833557225464,1.1820517510898694,-5715107,-5958827,87.75484378561514,80.96356750948765,NaN,NaN,25.89598993853509,26.9529330658007
2000-09-12T09:30:00-04:00,111.9375,113.0625,111.15625,112.90625,617500,607270,62.25799296846116,64.19834416444179,NaN,NaN,46.84926995466348,73.7071087227309,-0.12483180627784551,1.0260119932425624,1.150843799520408,-5097607,-5753127,88.55482659378627,82.18505824670952,NaN,NaN,25.72970633021063,26.778186389287832
2000-09-13T09:30:00-04:00,112.1875,112.5,111.57812,112.0625,353300,562015,55.638959864692104,63.49840389197915,NaN,NaN,12.946901192880606,46.362644087704965,-0.17360898477901876,0.9338325685466344,1.1074415533256532,-5450907,-5761147,88.31257667489264,83.22522410537364,NaN,NaN,23.565165905049803,26.319183462968113
2000-09-14T09:30:00-04:00,112.1875,112.46875,110.71875,111.01562,663000,542795,48.718134543008944,62.1488829416581,NaN,NaN,-58.65424250568963,16.20040432220219,-0.27198647458233993,0.7674584600977283,1.0394449346800683,-6113907,-5771647,87.97326272343565,84.1091703953111,NaN,NaN,19.396629872522148,25.330247235761547
2000-09-15T09:30:00-04:00,110.78125,111,108.96875,109.0625,456900,536110,38.97709940764726,60.04518573323745,NaN,NaN,-215.0707978327819,-36.0552327735125,-0.453509575480898,0.4725579653289458,0.9260675408098438,-6570807,-5789667,87.35295536327794,84.78345736942154,NaN,NaN,11.91606977580515,23.41393617005349
2000-09-18T09:30:00-04:00,109.4375,109.46875,107.85937,108.25,1033600,570340,35.77270905513818,57.58368606564699,NaN,NaN,-271.4760453199763,-97.08098290218075,-0.6038056499521908,0.17131047836960533,0.7751161283217961,-7604407,-6167527,75.35447844822225,84.47168814195494,NaN,NaN,4.70021532151033,20.740547477404466
2000-09-19T09:30:00-04:00,108.4375,108.4375,107.59375,107.96875,712900,568255,34.708978638489114,55.1504915761148,NaN,NaN,-249.59766274720448,-156.37036944255433,-0.6913711315339339,-0.08909778609562125,0.6022733454383127,-8317307,-6811467,60.1831782261674,83.06429461491236,NaN,NaN,-1.289286572388696,17.593428327434015
2000-09-20T09:30:00-04:00,108,108.375,105.53125,106.9375,3725200,701830,31.06175908000023,53.26527053897961,NaN,NaN,-234.57292177469026,-205.87433403606852,-0.7813154387509199,-0.3743709530003372,0.40694448575058273,-12042507,-8129787,41.68132087009227,80.30139495487218,NaN,NaN,-7.6319673716750955,13.989800370418429
2000-09-21T09:30:00-04:00,106.5625,108,106.5625,107.6875,1942200,768795,36.30396925540951,51.314749027897484,NaN,NaN,-162.95065678948856,-226.73361689282828,-0.7525797289763407,-0.5337801754698432,0.21879955350649752,-10100307,-8927067,34.72796766514233,76.9666054946387,NaN,NaN,-11.096455000620475,10.406049603127158
2000-09-22T09:30:00-04:00,106.1875,108.875,106,108.75,1536500,825200,42.92536756539877,49.81803883319235,NaN,NaN,-118.51743168743805,-207.42294366375955,-0.62930575577876,-0.5678326412169525,0.06147311456180751,-8563807,-9325667,31.865838216798082,73.34192596322966,NaN,NaN,-11.76574787617509,7.2386499632268375
2000-09-25T09:30:00-04:00,108.625,108.96875,107.78125,108.09375,550900,846000,40.14923811565853,48.01988162490635,NaN,NaN,-89.11600267872318,-170.9509351355089,-0.5614915505274901,-0.6403913235975551,-0.07889977307006502,-9114707,-9627727,29.857642552007107,69.50473601090324,NaN,NaN,-13.229034357738886,4.314695060231735
2000-09-26T09:30:00-04:00,107.75,107.90625,106.15625,106.15625,710400,855000,33.3015075630361,45.630354512605074,NaN,NaN,-121.01774638489107,-145.2349518630462,-0.6124800150323023,-0.8444997918604429,-0.2320197768281406,-9825107,-9929287,27.962990382090467,65.39681860414336,NaN,NaN,-17.008597588121646,1.2685103961812518
2000-09-27T09:30:00-04:00,106.875,106.90625,105.78125,106.51562,612500,869290,35.4989667529769,43.64653594859381,NaN,NaN,-114.26094531090746,-121.17255657028966,-0.5872819484471492,-0.9661222123870772,-0.3788402639399279,-9212607,-9363307,36.15203220951514,61.77505691710853,NaN,NaN,-19.18970850800694,-1.6540923044170612
2000-09-28T09:30:00-04:00,106.39062,108.625,106.32812,108.34375,1042300,903665,45.36082725750685,42.75951852288983,NaN,NaN,-66.5920453793795,-101.90083428826786,-0.42058119817715467,-0.9045667616613713,-0.4839855634842166,-8170307,-8977307,41.07208111924924,58.486142487877956,NaN,NaN,-17.535878705066498,-3.9229189330812666
2000-09-29T09:30:00-04:00,107.9375,108.125,106.625,106.625,778900,898130,39.28010529812413,41.42540109753913,NaN,NaN,-77.18153451318797,-93.63365485341782,-0.399323041741236,-0.9831393656607617,-0.5838163239195256,-8949207,-9054387,40.40255085687253,55.10383585011062,NaN,NaN,-18.37627665762608,-5.987684322301954
2000-10-02T09:30:00-04:00,106.98437,107.35937,106.34375,107.09375,481400,907100,41.58020907333696,39.94841653360169,NaN,NaN,-75.83807528947267,-90.97806937556773,-0.32982859552904165,-0.9961020683308277,-0.6662734728017861,-8467807,-8925007,42.10843265201863,51.7862362828415,NaN,NaN,-18.214089601160598,-7.734313647853188
2000-10-03T09:30:00-04:00,107.40625,108.78125,107,107.03125,2242400,1000535,41.35526701220749,38.92815275842422,NaN,NaN,-51.39456981451217,-77.05343406149196,-0.2668949788983166,-0.9998921964246819,-0.7329972175263653,-10710207,-9102027,40.404355252025404,48.36422046692242,NaN,NaN,-18.161915795546495,-9.22397109752366
2000-10-04T09:30:00-04:00,107.5625,108.625,107.15625,107.89062,1312100,1030375,45.704685621962234,38.71290640692087,NaN,NaN,-38.027287188496615,-61.80670243700979,-0.15193274993371997,-0.9229131549435152,-0.7709804050097953,-9398107,-9139127,40.03864605714225,44.940319276472884,NaN,NaN,-16.7127618916559,-10.293798353828267
2000-10-05T09:30:00-04:00,107.95312,108.5625,107.1875,107.46875,652100,1030450,43.98026512720926,39.07027538688959,NaN,NaN,-39.099313366224834,-56.30815603437884,-0.09180596284818354,-0.8857378585700246,-0.7939318957218411,-10050207,-9515107,36.43907644140129,41.30361363919599,NaN,NaN,-16.065286729991048,-11.118296693280092
2000-10-06T09:30:00-04:00,107.25,107.96875,105.21875,106.1875,1306700,1074820,39.149176549673385,39.31145163649926,NaN,NaN,-87.10414495075804,-58.29267812189287,-0.12383529349908662,-0.9487260125956993,-0.8248907190966127,-11356907,-9996647,32.41909218817953,38.23680033490722,NaN,NaN,-17.034781907983547,-11.963508866809157
2000-10-09T09:30:00-04:00,106.03125,106.53125,105.57812,105.79687,555100,1064295,37.78635632064102,39.53126432808153,NaN,NaN,-109.30871628136744,-64.98680632027181,-0.15482772951534307,-1.0184253809907915,-0.8635976514754484,-11912007,-10685487,27.709749784613606,35.91726973193909,NaN,NaN,-18.23935831752454,-12.860058788339925
2000-10-10T09:30:00-04:00,106,106.39062,104.875,104.90625,565500,1061695,34.81096851071172,39.799065001703774,NaN,NaN,-143.67927727245225,-83.44374781185984,-0.2151008953722423,-1.1324737706907513,-0.917372875318509,-12477507,-11038947,25.650707061358702,34.772225888458124,NaN,NaN,-20.186587400799738,-13.906705732977041
2000-10-11T09:30:00-04:00,104.78125,105.8125,103.5625,104.40625,1241600,1106110,33.22903391810537,39.57942676332491,NaN,NaN,-182.36024796912253,-112.31033996798502,-0.26514832218890416,-1.2488082780546392,-0.9836599558657351,-13719107,-11903147,21.45326408483156,33.82403277557878,NaN,NaN,-22.276006669398495,-15.10232015246582
2000-10-12T09:30:00-04:00,104.39062,104.39062,100.26562,100.375,2638900,1204905,23.827397724365426,38.21528606039396,NaN,NaN,-307.16726929065567,-165.92393115287118,-0.5309146837633287,-1.647303310569896,-1.1163886268065673,-16358007,-13164707,17.06357451339599,32.766728225335775,NaN,NaN,-27.99246214743572,-16.94376900889009
2000-10-13T09:30:00-04:00,100.07812,102.25,100.07812,101.875,1456700,1254895,31.584129825015864,37.60349261106233,NaN,NaN,-246.9121316803881,-197.8855284987972,-0.5637560676930782,-1.821083711422915,-1.2573276437298369,-14901307,-13873587,15.183551007020668,31.71857882926532,NaN,NaN,-29.732461809030696,-18.77072512319589
2000-10-16T09:30:00-04:00,102.23437,102.9375,102.01562,102.70312,566400,1231535,35.48979593295002,37.759798923199035,NaN,NaN,-155.08516215462546,-207.04081767344877,-0.4904758863798526,-1.8704225017046525,-1.3799466153248,-14334907,-14358167,14.044417945842596,30.724395083819044,NaN,NaN,-29.696931564538037,-20.33161175767334
2000-10-17T09:30:00-04:00,102.96875,103.15625,100.375,100.59375,906200,1241200,30.684678458228007,37.41592118785984,NaN,NaN,-163.74030737711172,-211.05302369438067,-0.54086808761251,-2.0560317248404374,-1.5151636372279274,-15241107,-14910887,12.859346884631208,29.060631846327333,NaN,NaN,-31.42403121541784,-21.916243108779696
2000-10-18T09:30:00-04:00,99,100.8125,96.75,99.78125,3011000,1205490,29.05295660165426,36.25107328387036,NaN,NaN,-189.63183793689507,-212.5073416879352,-0.5821381383816979,-2.2428363102050497,-1.6606981718233518,-18252107,-15817487,11.191272754994245,26.926288391737682,NaN,NaN,-33.34531852944057,-23.548968168874108
2000-10-19T09:30:00-04:00,101.25,101.875,100.51562,101.84375,1539600,1185360,38.05762416468853,36.163753202910684,NaN,NaN,-104.00755428948933,-171.87539868770193,-0.4307245636613659,-2.199103876400059,-1.7683793127386933,-16712507,-15888387,11.070332107658942,24.831129909651,NaN,NaN,-31.716286206410672,-24.71572788852219
2000-10-20T09:30:00-04:00,100.875,102.6875,100.8125,102.375,1682500,1192660,40.16423305919832,36.06261205904364,NaN,NaN,-78.11165553702729,-138.11530345902978,-0.26321706448585025,-2.097400643346006,-1.834183578860156,-15030007,-15914127,11.023755337968382,22.610795815790272,NaN,NaN,-29.73341465690747,-25.4325402840058
2000-10-23T09:30:00-04:00,102.625,103.60937,102.28125,103.14062,866900,1208460,43.16420376079847,36.19182182680013,NaN,NaN,-44.21213308735719,-115.94069764557612,-0.07884635435050869,-1.9327415217982917,-1.853895167447783,-14163107,-15879767,11.558680741939185,20.550390493641256,NaN,NaN,-27.150218768141688,-25.67792292459664
2000-10-24T09:30:00-04:00,103.25,104.35937,102.84375,103.4375,1545400,1250210,44.32975570561785,36.09361254706125,NaN,NaN,-25.911236488008058,-88.37488346775538,0.0766946874889709,-1.7580268080865693,-1.8347214955755402,-12617707,-15355087,19.515799231855368,19.084472863263613,NaN,NaN,-24.735218101340774,-25.54325080698866
2000-10-25T09:30:00-04:00,103.5625,104.6875,102.71875,102.89062,1586400,1298905,42.59681924661879,35.99479498416193,NaN,NaN,-25.425083509435247,-55.53353258226342,0.15199053860216383,-1.6447333223228355,-1.7967238609249994,-14204107,-14545487,29.98371773430908,18.62337581275703,NaN,NaN,-23.266796493438164,-25.21804304791002
2000-10-26T09:30:00-04:00,103.09375,104.71875,102.51562,103.6875,2010900,1347335,45.91463766579259,36.478042206741875,NaN,NaN,-14.874671788810677,-37.70695608212769,0.258452332589582,-1.473658445188022,-1.732110777777604,-12193207,-13641627,39.45188035661113,19.12571782478786,NaN,NaN,-21.03553697828029,-24.620542180820056
2000-10-27T09:30:00-04:00,104.3125,106.40625,103.75,106.1875,1576000,1387190,54.750725793554494,37.68978288337855,NaN,NaN,43.09930758468096,-13.464763457786043,0.4869675070809516,-1.1234013939264145,-1.610368901007366,-10617207,-12759067,46.98983582313525,20.502866827539407,NaN,NaN,-16.055798258702897,-23.39700733480332
2000-10-30T09:30:00-05:00,105.8125,108.6875,105.8125,108.1875,4240301,1575135.05,60.33382437117031,39.51284401626845,NaN,NaN,105.95212736543911,16.568088632773204,0.7469855034941619,-0.6766370216396638,-1.4236225251338257,-6376906,-11201826.8,57.131084898883714,22.75146524450548,NaN,NaN,-9.812232578946412,-21.45632522682376
2000-10-31T09:30:00-05:00,108.92187,109.92187,107.84375,109.40625,4993398,1712684.95,63.305073181061665,41.661132535051046,NaN,NaN,144.0612695588136,50.56258984213754,0.961558204425901,-0.22167476960144938,-1.1832329740273504,-1383508,-8954987,66.95420911070457,26.00153274635355,NaN,NaN,-3.674901524547198,-18.916121840784253
2000-11-01T09:30:00-05:00,109.15625,109.92187,108.4375,109.15625,3410300,1817594.95,62.27459298136789,44.40736076769408,NaN,NaN,141.15737883571794,83.87908231116816,1.0404746396408107,0.11736032552366282,-0.9231143141171477,-4793808,-7072927.2,72.61487869249315,29.969483044860485,NaN,NaN,0.8288123458568222,-16.095416956978386
2000-11-02T09:30:00-05:00,109.21875,109.625,108.625,108.64062,1556300,1862804.95,60.10154350919337,46.44431888799247,NaN,NaN,129.72732613955398,112.7994818968411,1.0109040874558142,0.3405157952026201,-0.6703882922531941,-6350108,-5904307.4,75.42932662804799,34.27275273207672,NaN,NaN,3.8481127844688974,-13.246341279628775
2000-11-03T09:30:00-05:00,109,109,107.57812,108.21875,1663700,1880654.95,58.30880076093168,48.07424780427687,NaN,NaN,103.57790725861565,124.89520183162804,0.9185656197786791,0.4778187324701548,-0.4407468873085243,-8013808,-5383627.6,76.58403618615607,38.739868320670546,NaN,NaN,5.808181447043656,-10.524266604389856
2000-11-06T09:30:00-05:00,108.46875,110.125,108.21875,110.03125,2280300,1966914.95,63.36488154839912,50.408548025003384,NaN,NaN,121.39135891180571,127.98304814090136,0.9322246503954517,0.7245339256857903,-0.20769072470966135,-5733508,-5254948,76.87329928761405,43.31229349231217,NaN,NaN,9.131274076199109,-7.716332221448576
2000-11-07T09:30:00-05:00,109.875,110.0625,109.34375,109.75,1136900,1995484.95,62.106234348797805,52.76949643551364,NaN,NaN,111.87417703560803,121.54562963626024,0.8758618683085138,0.8871366106759808,0.011274742367467089,-6870408,-6352328,69.0405007789064,47.4443812083059,NaN,NaN,11.456893704954,-4.977299946248209
2000-11-08T09:30:00-05:00,110.09375,110.21875,108.76562,108.76562,1464300,2006619.95,57.780205583244545,54.17825225112478,NaN,NaN,88.83403555033709,111.08096097918408,0.7316970204122712,0.9258960178828062,0.19419899747053493,-8334708,-7060508,64.4748462216193,51.25898935930307,NaN,NaN,12.174453829249506,-2.5270494068913925
2000-11-09T09:30:00-05:00,107.9375,108.96875,106.25,108.21875,3838900,2066619.95,55.468632310067655,55.27142362618688,NaN,NaN,52.7922067988886,95.693937111051,0.5663100788035434,0.9020865959749642,0.33577651717142076,-12173608,-8225208,57.71491498898302,54.5940721915184,NaN,NaN,12.103505440885016,-0.43697014292333414
2000-11-10T09:30:00-05:00,107.59375,107.84375,106,106.125,1601700,2073869.95,47.614577544496235,55.58930746787957,NaN,NaN,23.96141038883982,79.77063773709584,0.29628239373559256,0.7061295093409115,0.4098471156053189,-13775308,-9377508,51.91548814228393,57.47670129154302,NaN,NaN,9.573399678600435,0.9930826887229185
2000-11-13T09:30:00-05:00,105,106.23437,103.75,105.4375,3009800,2196039.95,45.34418660512417,55.66176681784431,NaN,NaN,-12.8891020749388,52.91454553974694,0.06389151758281553,0.48971151258383827,0.42581999500102274,-16785108,-11587828,42.991586732681796,59.15354325588777,NaN,NaN,6.779213364042308,1.8196727851971168
2000-11-14T09:30:00-05:00,106.125,107.9375,106,107.3125,1831200,2242289.95,52.058282650185156,56.337585632384766,NaN,NaN,26.952514292384183,35.93021299110218,0.030660119687830334,0.4641451446108107,0.43348502492298036,-14953908,-13204528,37.86472508322238,59.71647235223872,NaN,NaN,6.41267094085963,2.47581537886319
2000-11-15T09:30:00-05:00,106.875,108.25,106.51562,107.3125,626600,2123069.95,52.058282650185156,56.77641741698424,NaN,NaN,27.185335177790634,23.600472916592885,0.004272068921721828,0.43882511107513267,0.43455304215341084,-14953908,-14528368,34.261696318928045,59.34574492097564,NaN,NaN,6.1234038122562024,2.9968994407764775
2000-11-16T09:30:00-05:00,107.625,107.875,106.4375,106.625,908100,2091494.95,49.47383600967282,56.399496718135545,NaN,NaN,9.83125809700684,15.00828317621654,-0.060327780000193454,0.35914331715316905,0.4194710971533625,-15862008,-15266048,32.410970232756554,58.30439737880573,NaN,NaN,5.117549846780254,3.299849498777017
2000-11-17T09:30:00-05:00,106.45312,108.0625,105.53125,106.23437,1289700,2071854.95,48.0152419874225,55.51959797643927,NaN,NaN,-11.208108970024023,7.974379304443767,-0.1264085638227358,0.2614603923749428,0.3878689561976786,-17151708,-15941328,30.772291976069425,56.42162645574757,NaN,NaN,3.8635596778458665,3.3803795243582813
2000-11-20T09:30:00-05:00,105.8125,106,104.5,104.6875,1087400,2082879.95,42.65261693148956,54.044422530041274,NaN,NaN,-78.33156883899218,-5.114114048366911,-0.26345392999495526,0.05855154370398452,0.3220054736989398,-18239108,-16232128,30.067288715848292,53.78684642754355,NaN,NaN,1.1181920746849068,3.0572098886906565
2000-11-21T09:30:00-05:00,104.96875,105.875,104.1875,105.375,814700,2046344.95,45.56265592550869,52.85071274033704,NaN,NaN,-82.53492091832187,-27.011601090508123,-0.29460163871808853,-0.046246574698670884,0.24835506401941765,-17424408,-16726228,28.857538522982978,50.66132212972139,NaN,NaN,-0.3409375245291009,2.5717602582306913
2000-11-22T09:30:00-05:00,104.625,105.125,103.75,103.875,1096100,2021829.95,40.708901222744,51.46552400559066,NaN,NaN,-125.55025199189294,-57.55871852444484,-0.3966716158449886,-0.2474844557868181,0.1491871600581705,-18520508,-17439548,27.158653834730444,47.21341693019872,NaN,NaN,-3.1320858617631986,1.7569250982315643
2000-11-24T09:30:00-05:00,104.98437,105.25,104.5625,105.0625,535800,1948074.95,45.64553656368902,50.56100513435904,NaN,NaN,-101.95031794188553,-79.9150337322233,-0.36542955359015666,-0.3075997819295253,0.05782977166063134,-17984708,-17864088,26.17113349637529,43.61249530950009,NaN,NaN,-4.007042527260134,0.9335011517327503
2000-11-27T09:30:00-05:00,106.1875,106.46875,105.46875,105.875,777600,1908154.95,48.78743752227234,49.519759132492844,NaN,NaN,-59.48029839666958,-89.56947161755242,-0.2753665843228952,-0.2863784587429876,-0.011011874420092452,-17207108,-17875168,26.144414351467887,39.98900352834679,NaN,NaN,-3.779436119253233,0.26022439873475267
2000-11-28T09:30:00-05:00,105.5,106.375,104.9375,105.28125,1055900,1748934.9,46.664632697791156,48.416787585992374,NaN,NaN,-70.76802537295659,-88.05676292434529,-0.24227303335854858,-0.3138531661182782,-0.0715801327597296,-18263008,-17879948,26.132019371945532,36.92411199927816,NaN,NaN,-4.223167572446026,-0.3802601685767871
2000-11-29T09:30:00-05:00,105.53125,106.6875,105.0625,105.96875,1399600,1569245,49.40952061694904,47.81888151697127,NaN,NaN,-48.81508934500621,-81.31279660968217,-0.16430305771529402,-0.27695895490384714,-0.11265589718855312,-16863408,-17767748,27.006799573634197,34.2478229529935,NaN,NaN,-3.7889775703347053,-0.8672197973993468
2000-11-30T09:30:00-05:00,105.25,105.9375,102.875,104.40625,1858100,1491635,43.882029679270175,46.99126704334288,NaN,NaN,-107.57676968280398,-77.71810014786438,-0.20550798713272217,-0.3695408811044558,-0.16403289397173365,-18721508,-17807948,26.883955624877885,32.04561156984314,NaN,NaN,-5.099800334880958,-1.4718741598967198
2000-12-01T09:30:00-05:00,104.9375,105.375,103.40625,103.8125,2277400,1527690,41.961010853724396,46.58744085114489,NaN,NaN,-106.48249272342771,-78.62453510417281,-0.2569576516566052,-0.4852299585424902,-0.22827230688588496,-20998908,-18410788,25.044245925850433,30.126237125812178,NaN,NaN,-6.765143444530293,-2.2280554862729445
2000-12-04T09:30:00-05:00,103.125,106.21875,103.09375,105.96875,1971400,1543075,50.44520788604374,46.951799514067716,NaN,NaN,-58.86699819220508,-78.50187506327993,-0.13604720727694203,-0.3983313159820625,-0.2622841087051205,-19027508,-18774868,23.97708019958658,28.768058087733948,NaN,NaN,-5.551410001260435,-2.702820416985443
2000-12-05T09:30:00-05:00,107,109.35937,106.625,108.9375,2005200,1529320,59.27267302597876,47.46711311233869,NaN,NaN,101.7733943187452,-43.993591124939556,0.13871881986059678,-0.08888558387937451,-0.2276044037399713,-17022308,-18526728,26.28264993624677,27.940767005807114,NaN,NaN,-1.2869015407051094,-2.500546291802538
2000-12-06T09:30:00-05:00,108.51562,108.85937,106.26562,106.71875,1846600,1564805,51.84015350869166,47.45153245937487,NaN,NaN,62.92025477278309,-21.6465223013817,0.16414455711642167,-0.02242370734444421,-0.18656826446086588,-18868908,-18927828,24.96469503351952,27.27669548542079,NaN,NaN,-0.37404750813181215,-2.196760751278149
2000-12-07T09:30:00-05:00,106.625,107.125,105.78125,105.98437,895600,1536370,49.62218887705049,47.46212909275899,NaN,NaN,19.01983724156299,3.672799083491692,0.12631067902984153,-0.028679915673563983,-0.1549905947034055,-19764508,-19136428,24.282709947876242,26.6961054650722,NaN,NaN,-0.428398470215631,-1.9441375682692177
2000-12-08T09:30:00-05:00,107.65625,108.46875,104.34375,104.53125,1716200,1430235,45.47611517445891,47.28076289183303,NaN,NaN,-8.344809068364057,23.30033581450442,0.004654018716041125,-0.1491730713083541,-0.15382709002439524,-21480708,-19232788,23.957135234382122,26.209308554951672,NaN,NaN,-1.89494877096557,-1.9371105972258393
2000-12-11T09:30:00-05:00,106.625,108.1875,106.625,107.59375,1062600,1403280,54.16758358760454,48.10326051012695,NaN,NaN,103.30457160605735,55.7346497741569,0.125002017219369,0.002425431499816,-0.12257658571955299,-20418108,-19510908,22.998670032775976,25.70440722044651,NaN,NaN,-0.02375954189674411,-1.6637747321788257
2000-12-12T09:30:00-05:00,107.03125,108.67187,107.03125,108.125,679100,1286745,55.49296998178761,48.812568657004014,NaN,NaN,117.05984185598608,58.79193928160508,0.22890164009172312,0.1635504643951009,-0.06535117569662222,-19739008,-20054248,21.213127086829147,25.158377832149803,NaN,NaN,1.8699845572563119,-1.1589519765452345
2000-12-13T09:30:00-05:00,108.92187,109.4375,107.82812,108.0625,813200,1235845,55.29039528132676,49.85410394690278,NaN,NaN,134.7153710385917,73.15096253476682,0.27863169882807803,0.2829384478384753,0.004306749010397293,-20552208,-20390908,20.168306926535223,24.659067338707292,NaN,NaN,3.268764921649269,-0.5264209910888769
2000-12-14T09:30:00-05:00,107.3125,107.65625,106.28125,106.67187,1242100,1266620,50.84310420463256,50.22535877839875,NaN,NaN,44.878690525910585,78.32273319163633,0.20640918049966722,0.26231822463498133,0.055909044135314105,-21794308,-20796868,18.95587570725546,24.143691782341588,NaN,NaN,3.04152917135253,-0.01671382502581875
2000-12-15T09:30:00-05:00,105.75,106.25,103.76562,103.76562,2231500,1332790,43.049778287119395,49.81552597588783,NaN,NaN,-84.06302893184325,63.1790892189405,-0.03565860267604699,0.011335790790255373,0.04699439346630236,-24025808,-21305888,17.532656855099546,23.5285662468867,NaN,NaN,0.17150610438902147,0.010174736319158422
2000-12-18T09:30:00-05:00,105.4375,106.79687,105.40625,106.64062,2611500,1398880,51.04415950037498,50.12834931892953,NaN,NaN,17.80566098362072,46.07930709445317,-0.002465372102002622,0.04391267833879908,0.046378050440801705,-21414308,-21505128,16.994795732160483,22.875907415473485,NaN,NaN,0.5196937945358793,0.0829631732072614
2000-12-19T09:30:00-05:00,106.53125,107.90625,105.5625,105.60937,1554800,1422250,48.4186539408188,50.05757312777737,NaN,NaN,18.977627600588956,26.462864243373748,-0.047766045003556565,-0.013329505813644005,0.03443653918991256,-22969108,-22151148,15.3504345729703,22.043309915426068,NaN,NaN,-0.10416068580069496,0.056231193348981925
2000-12-20T09:30:00-05:00,104.09375,104.90625,102.95312,102.95312,2413500,1502190,42.37296974672073,49.949783132595265,NaN,NaN,-137.8258065896726,-28.04537128227911,-0.2434852750197485,-0.2699200545847731,-0.026434779565024574,-25382608,-23117228,13.280949915003418,21.07166665043503,NaN,NaN,-2.776573531435504,-0.34845519590594465
2000-12-21T09:30:00-05:00,102.84375,105.25,102.78125,104.9375,2508500,1572810,47.633470814000425,50.35495884404355,NaN,NaN,-96.53914616076253,-56.32893861961374,-0.2265148996596036,-0.3095784041395291,-0.08306350447992547,-22874108,-23333188,12.863461621587376,20.201610628701957,NaN,NaN,-3.1291756240667996,-0.7457009713574954
2000-12-22T09:30:00-05:00,105.5,106.96875,105.21875,106.96875,1895200,1640780,52.42128014730722,50.49610686270523,NaN,NaN,20.059352015422387,-35.50446243016061,-0.07361700807184521,-0.175084764569732,-0.10146775649788678,-20978908,-22723808,20.46135049180272,19.950487078145972,NaN,NaN,-1.7450904261081999,-0.8884708934647388
2000-12-26T09:30:00-05:00,106.95312,107.5625,105.96875,107.5,933900,1648595,53.61574638208981,50.092040673856026,NaN,NaN,52.5363170290046,-28.558331221083836,0.06090374953106788,-0.025338069584051937,-0.08624181911511981,-20045008,-22449948,23.682008829196576,19.764726999070955,NaN,NaN,-0.2732268592101548,-0.8005788885712268
2000-12-27T09:30:00-05:00,107,108.4375,106.3125,108.4375,1769600,1684280,55.72800566660204,50.36974439942105,NaN,NaN,85.55387615591823,-15.243081510017982,0.2026413891391512,0.1670599173088192,-0.035581471830332015,-18275408,-21511208,33.60620497054157,20.381977708858244,NaN,NaN,1.5922910633004748,-0.45874032401812664
2000-12-28T09:30:00-05:00,107.9375,109,107.71875,108.75,1100100,1669305,56.44008294459445,50.85673683281704,NaN,NaN,114.3721980963634,35.196519427189216,0.3011244086932082,0.3408240390361783,0.039699630342970055,-17175308,-19869748,46.66614175262544,21.98079426634033,NaN,NaN,3.3003886378949083,0.07827809911230693
2000-12-29T09:30:00-05:00,109.15625,109.15625,106.78125,106.78125,1552800,1654040,50.887046548873464,51.24323193098951,NaN,NaN,59.032915960443965,66.31093185143052,0.22106325873548613,0.3160287037623277,0.0949654450268416,-18728108,-19040548,51.821732468738524,23.971122640222934,NaN,NaN,3.083731335128358,0.5076285614003142
2001-01-02T09:30:00-05:00,107.1875,107.75,105.59375,106.40625,1468300,1613585,49.8803518882227,50.93700109531938,NaN,NaN,-2.2921919451703547,61.84062305931197,0.13449657390496178,0.26308616240804383,0.12858958850308205,-20196408,-18884048,52.750091851475645,26.09622419870148,NaN,NaN,2.6110617490274426,0.8081190167756183
2001-01-03T09:30:00-05:00,106.40625,112.5,105.625,109.53125,4409301,1735480.05,57.43695551014353,51.07585720448766,NaN,NaN,141.912388960834,79.71583744567785,0.2714455929768239,0.4678965797241119,0.19645098674728803,-15787107,-18032467.8,57.54410131554393,28.69129378646682,NaN,NaN,4.5839019757735615,1.347516582346753
2001-01-04T09:30:00-05:00,109.14062,110.40625,108.75,109.23437,1516600,1711050.05,56.56443096212209,51.1668597531159,NaN,NaN,146.04712796304537,91.81448780710328,0.32231576428007913,0.599345692097387,0.27702992781730784,-17303707,-17838127.6,58.57700816013698,31.434772446009806,NaN,NaN,5.89630949230172,1.9973441409117483
2001-01-05T09:30:00-05:00,108.1875,108.40625,106.25,106.28125,1633900,1700415.05,48.647895882568505,51.01005915868275,NaN,NaN,6.275267582124236,70.19510170425545,0.14631702882408193,0.4599262138474103,0.31360918502332835,-18937607,-18190587.4,55.919830503625796,34.07505493146483,NaN,NaN,4.533829739689036,2.3596992264513608
2001-01-08T09:30:00-05:00,106,107.125,105.125,106.3125,1450200,1728145.05,48.72966916821905,51.415765650189876,NaN,NaN,-38.63155365888123,50.6622077803904,0.02746943759115894,0.347945982012277,0.32047654442111806,-17487407,-17942447.2,57.38545750309427,36.92168354917874,NaN,NaN,3.48608214595814,2.5206110720951864
2001-01-09T09:30:00-05:00,106.9375,106.96875,105.15625,105.4375,1313100,1707990.05,46.497017279309134,51.090969777256596,NaN,NaN,-58.064975834053776,39.50765100261371,-0.10722410276516064,0.18644641596466727,0.2936705187298279,-18800507,-17663267,59.03573704489684,39.9246079286599,NaN,NaN,1.9493443003637208,2.4390015332764055
2001-01-10T09:30:00-05:00,105.125,106.59375,104.59375,106.59375,1700300,1739875.05,49.7719490274828,51.187633712018304,NaN,NaN,-48.76142268042931,1.3728886743610544,-0.11491470403994009,0.1500271386799028,0.2649418427198429,-17100207,-17925887,56.80714530073363,42.88580155207158,NaN,NaN,1.5987811208149678,2.3189700457819145
2001-01-11T09:30:00-05:00,106.375,106.53125,105.25,105.9375,1605100,1786175.05,47.976970194133216,51.58791945826206,NaN,NaN,-45.08836416817705,-36.854209751883424,-0.1580067713414282,0.06743337854305764,0.22544014988448585,-18705307,-18206207,54.444593924381245,45.82606183845571,NaN,NaN,0.7908579440199724,2.10066831695878
2001-01-12T09:30:00-05:00,105.53125,106.25,104.625,105.34375,1645800,1827805.05,46.34832052538498,51.49612300907524,NaN,NaN,-68.04057341765338,-51.71737795183894,-0.21668010095188053,-0.04540997630536481,0.17127012464651573,-20351107,-18488907,52.091695407921456,48.62807853747957,NaN,NaN,-0.34520569021509984,1.7512577445053685
2001-01-16T09:30:00-05:00,105.25,106.78125,104.8125,106.4375,1052400,1818320.05,49.73343377608469,51.30413398255934,NaN,NaN,-29.079363098951898,-49.80693983985307,-0.1738575455548845,-0.04605180729708991,0.1278057382577946,-19298707,-18851167,49.15986801147908,50.677972646027875,NaN,NaN,-0.3806423988177858,1.4467005811734894
2001-01-17T09:30:00-05:00,107.23437,107.375,105.45312,105.96875,2434700,1828480.05,48.32615536482054,50.9263060527544,NaN,NaN,-19.96941832265866,-42.187828337574054,-0.16898300805310365,-0.08342302180858496,0.08555998624451869,-21733407,-19437747,44.7663432489989,52.183996533156616,NaN,NaN,-0.796383239193506,1.1262600354067758
2001-01-18T09:30:00-05:00,106.3125,107.48437,105.59375,106.71875,1189400,1757375.05,50.72848269603848,50.56919726914272,NaN,NaN,0.33662489405215545,-32.368218822677754,-0.10998616006853565,-0.05192271384115088,0.05806344622738477,-20544007,-20126507,40.22086930403815,52.6564725569778,NaN,NaN,-0.49966813796058307,0.8939845820685817
2001-01-19T09:30:00-05:00,107.125,107.125,105.5625,105.5625,1057700,1732520.05,47.0935373459335,49.901586869238365,NaN,NaN,-31.75393300848825,-29.701332590739998,-0.14156094960147117,-0.11888774077445419,0.022673208827016976,-21601707,-20705787,36.83340504527524,51.9541342207385,NaN,NaN,-1.2455648221139277,0.588334667185366
2001-01-22T09:30:00-05:00,105.75,106.4375,105.0625,106.125,851400,1654415.05,49.007815720566626,49.767356095787875,NaN,NaN,-56.78562224348308,-27.45034235590594,-0.11823982849841866,-0.12512657679600636,-0.006886748297587696,-20750307,-20785627,36.37864069389224,50.85105623682091,NaN,NaN,-1.3585864726237562,0.3102030757840628
2001-01-23T09:30:00-05:00,105.625,106.92187,105.53125,106.5,1362700,1597125.05,50.29890347650929,49.79725263780835,NaN,NaN,-35.575914886687855,-28.749652713453134,-0.07342986530297922,-0.09867407992631172,-0.0252442146233325,-19387607,-20803407,36.27124104249374,49.67399546475077,NaN,NaN,-1.1101137312598195,0.10730067477779393
2001-01-24T09:30:00-05:00,106.53125,106.96875,106.21875,106.34375,634400,1534085.05,49.733865286331294,49.24703190753605,NaN,NaN,-21.732719266703857,-29.102312902262167,-0.05123589689453263,-0.0892890857414983,-0.038053188846965666,-20022007,-20461127,39.94682883172147,48.41704743019203,NaN,NaN,-1.0458306135257671,-0.05743236640842908
2001-01-25T09:30:00-05:00,106.6875,107.9375,106.4375,107.3125,1228900,1548835.05,53.24106328360601,49.00964850192776,NaN,NaN,30.986263556710682,-22.972385169730465,0.027531008396141077,-0.00363942835178932,-0.031170436747930397,-18793107,-20110947,43.53493798972831,47.342613846591405,NaN,NaN,-0.060961647721856284,-0.057936549453204395
2001-01-26T09:30:00-05:00,107.125,107.59375,106.1875,106.625,1536000,1537155.05,50.545715488360344,49.1452070451986,NaN,NaN,3.0151223266053693,-16.018574102711742,0.03186688875812446,0.008663174199725177,-0.023203714558399285,-20329107,-19856427,46.05768966823494,46.63817521549206,NaN,NaN,0.08910306430993825,-0.03693089034418402
2001-01-29T09:30:00-05:00,106.61,107.36,106.14999,107.10001,613500,1512825.05,52.340977958663665,49.403157673087506,NaN,NaN,16.944603754644756,-1.2725289030861808,0.0634395919292676,0.05609577535318522,-0.007343816576082383,-19715607,-19649487,48.08848254821056,45.97410557585751,NaN,NaN,0.690260263242839,0.06695356016824783
2001-01-30T09:30:00-05:00,107.24001,109.05,106.8,108.73,1213200,1495845.05,57.97820469256655,50.22324248832018,NaN,NaN,127.12558830772942,31.26777173579727,0.18399224839421355,0.22264649391668456,0.038654245522471015,-18502407,-19472447,49.828698307739415,45.31645995177483,NaN,NaN,2.8380128585515467,0.4628191742230048
2001-01-31T09:30:00-05:00,109,109.5,108.3,108.67,1740200,1509440.05,57.70761918803581,50.79007607121682,NaN,NaN,148.03235117271063,65.22078582368017,0.2457256770727511,0.3458113418634099,0.10008566479065881,-20242607,-19516567,49.38439667235739,44.78626362117653,NaN,NaN,4.543347553007961,1.0457517997637127
2001-02-01T09:30:00-05:00,108.72,110.25,108.39999,110.02,1743700,1376160,62.004373980684335,51.7920334845419,NaN,NaN,196.33911577471463,98.29135626728096,0.35677903241123315,0.5460594553047002,0.18928042289346708,-18498907,-19457727,50.024394177276,44.47053506781187,NaN,NaN,7.31591807005126,1.9414898383762194
2001-02-02T09:30:00-05:00,109.8,110.39,108.5,108.63,1936700,1397165,55.72658672187952,52.461909641434374,NaN,NaN,173.20003184775464,132.3283381715108,0.3172499914563509,0.5858429122139057,0.2685929207575548,-20435607,-19479027,49.77901832926714,44.305343847907984,NaN,NaN,7.967889491952702,2.802404074601431
2001-02-05T09:30:00-05:00,108.87,109.89,108.75,109.8,1516200,1391280,59.44834839446725,53.155832114175986,NaN,NaN,156.90437623019318,160.3202926666205,0.3480611418857171,0.7036693481147012,0.3556082062289841,-18919407,-19319787,51.686987456803806,44.4858523797169,NaN,NaN,9.65184739212514,3.7808959771048176
2001-02-06T09:30:00-05:00,109.3,110.48,109.3,109.58,1184400,1377990,58.45331827638167,53.87920089357321,NaN,NaN,143.7093419785922,163.63704340079306,0.33184513568580354,0.7704146258362385,0.438569490150435,-20103807,-19640067,47.75704721422204,44.69947409151855,NaN,NaN,10.746446087126174,4.775974564250726
2001-02-07T09:30:00-05:00,109.49001,110.24001,109.11,109.62,1712100,1397940,58.589035128059884,54.440668924431876,NaN,NaN,116.03172641845853,157.23691844994264,0.302839739021755,0.8171191639276287,0.5142794249058737,-18391707,-19269887,52.27382923234863,45.56039980068359,NaN,NaN,11.682880053568079,5.762675348438919
2001-02-08T09:30:00-05:00,109.85001,109.88,108.71001,108.73,1213800,1373615,54.33599249304664,54.95798714922568,NaN,NaN,77.80423455193225,133.52994220538613,0.20729805063488593,0.7734019881994811,0.5661039375645952,-19605507,-19491207,49.51737116263134,46.46639738049474,NaN,NaN,11.324409071201078,6.557208737404942
2001-02-09T09:30:00-05:00,108.5,109,107.67,108.02,1531700,1369945,51.14628740865568,55.11073512694633,NaN,NaN,30.90201907279434,105.07033965039409,0.0860758620964217,0.6736987651851223,0.5876229030887006,-21137207,-19631527,47.79650607273123,47.28195919326895,NaN,NaN,10.1162655950711,7.06564543135725
2001-02-12T09:30:00-05:00,108.08,109.69,108.03,109.63,1267200,1351015,57.27164330943504,55.60878797215531,NaN,NaN,66.88418156025425,87.06630071640632,0.10297309676617472,0.716339274046419,0.6133661772802442,-19870007,-19821647,45.48978015597999,47.940426272803684,NaN,NaN,10.821513077244656,7.602197952198308
2001-02-13T09:30:00-05:00,109.7,110.39999,109.03999,109.28,2354500,1416120,55.63845717248854,56.03054453545226,NaN,NaN,81.91767160749298,74.70796664218648,0.08023781152272469,0.71366344168365,0.6334256301609253,-22224507,-20245787,40.763324865151,47.99874741804865,NaN,NaN,10.932990228189615,8.078025420197067
2001-02-14T09:30:00-05:00,109.36,109.36,108.00999,108.28,1814400,1385105,51.15036833619145,55.881209182065504,NaN,NaN,25.59927126009283,56.621475610513336,-0.007810907856455329,0.6236619953403562,0.6314729031968115,-24038907,-21375227,31.405647228317704,47.13236950651933,NaN,NaN,9.704186349505402,8.310334124383973
2001-02-15T09:30:00-05:00,108.7,109.42999,108.31,109.34,925400,1371905,55.26928282592677,56.218606849034536,NaN,NaN,47.20074598062731,50.500777896252345,-0.0006989729535826772,0.6305991870048331,0.6312981599584158,-23113507,-22076827,27.22471672374506,45.787157153341475,NaN,NaN,9.862032435001664,8.532005311615071
2001-02-16T09:30:00-05:00,107.78,108.53999,107.21001,108.14999,1561500,1397095,50.156277895529975,56.062556844524984,NaN,NaN,-20.40661624144268,40.23905083340494,-0.07790379156009253,0.5339184205083001,0.6118222120683926,-24675007,-22784387,23.785663843176877,44.051241531553366,NaN,NaN,8.423084834982328,8.516445243524679
2001-02-20T09:30:00-05:00,108.39999,109.10001,107.31,107.45,1179800,1413515,47.37969556020065,55.30552047792742,NaN,NaN,-31.09808430596016,20.64259766016206,-0.1724600234898641,0.3962471827060625,0.5687072061959266,-25854807,-23981347,19.33586701410377,41.873182153436524,NaN,NaN,6.367777608505584,8.209492724236236
2001-02-21T09:30:00-05:00,107.14999,107.49001,105.10001,105.3,1815400,1436150,40.046673223156205,54.04402433757888,NaN,NaN,-166.2003826926623,-28.981013199869,-0.36507817064702036,0.11235949288715119,0.47743766353417155,-27670207,-25070487,16.340331209701674,39.512891763246834,NaN,NaN,2.0414175777928802,7.328339131887185
2001-02-22T09:30:00-05:00,105.60001,105.85001,103.8,105.64999,2671700,1538015,41.630396658533556,52.58874024313955,NaN,NaN,-204.3934792069464,-74.97956329327685,-0.4486866565671873,-0.08342065717481262,0.3652659993923747,-24998507,-25262407,15.8736619421433,37.07355374645164,NaN,NaN,-0.9263421604330493,6.149098947270009
2001-02-23T09:30:00-05:00,105.10001,105.2,103,104.55,2489200,1601030,38.21372521802883,51.337821564293066,NaN,NaN,-213.47823070587486,-127.11535863057729,-0.5510987922357207,-0.32360749090227614,0.22749130133344453,-27487707,-26137247,13.921848400415584,34.51232732296224,NaN,NaN,-4.543616973223457,4.621568101485228
2001-02-26T09:30:00-05:00,104.89999,106.7,104.25999,106.7,1267800,1587620,47.31521144541956,50.47116892507538,NaN,NaN,-115.94412328774006,-146.22286003983675,-0.4512652430454299,-0.33659025247334284,0.11467499057208705,-26219907,-26446227,13.299843028649647,31.770388435236946,NaN,NaN,-4.740877813869269,3.284075827863157
2001-02-27T09:30:00-05:00,106.28,107.2,105.60001,106.60001,2046300,1659260,46.96868886992967,49.650838253185945,NaN,NaN,-82.99073362732575,-156.60138990410988,-0.37246203699394553,-0.3509025556703449,0.02155948132360065,-28266207,-26928507,12.370774612780593,29.24279753513399,NaN,NaN,-5.003599592930912,2.1001221963211476
2001-02-28T09:30:00-05:00,106.75,107.10001,104.27,105,2859200,1741560,41.70522088119117,48.444851521266756,NaN,NaN,-114.003556889646,-146.1620247435066,-0.4058500926299141,-0.485753134463792,-0.07990304183387788,-31125407,-27619547,11.167047200695606,26.30659881858734,NaN,NaN,-6.9444631927397635,0.8080385693124461
2001-03-01T09:30:00-05:00,104.45,105.10001,103.11,104.67999,2547100,1781905,40.72229376170554,47.472444469028105,NaN,NaN,-137.14437143472801,-132.71220318906293,-0.42519557639530675,-0.6113975123280113,-0.18620193593270457,-33672507,-29354347,8.841233065380337,23.401160383069417,NaN,NaN,-8.802610374188035,-0.564911279759051
2001-03-02T09:30:00-05:00,103.52,105.99001,103.00999,104.8,2799900,1834715,41.28120978517045,46.76779606735058,NaN,NaN,-107.72228664461888,-111.56101437681176,-0.40567517077630244,-0.6932958994030827,-0.28762072862678023,-30872607,-30031327,8.129659029178768,20.567814165672807,NaN,NaN,-10.134383301674587,-1.9319787114612705
2001-03-05T09:30:00-05:00,105.25,105.89,104.89,105.57001,1067900,1791275,44.87278399132586,45.88216325891422,NaN,NaN,-67.6407579842979,-101.9003413161233,-0.32041157331170533,-0.6881351952664119,-0.36772362195470654,-29804707,-30748287,7.4461520900514415,17.850412160963625,NaN,NaN,-10.221977323107966,-3.1162642274107983
2001-03-06T09:30:00-05:00,106.5,107.14,105.81,106.14999,1794900,1805210,47.478609298374735,45.299316982191804,NaN,NaN,-29.35777994244331,-91.17375057914681,-0.2098080633931798,-0.6299837011961813,-0.4201756378030015,-28009807,-30697007,8.041676292717469,15.513151548646947,NaN,NaN,-9.541109467405938,-4.034099261695818
2001-03-07T09:30:00-05:00,106.8,107.60001,106.3,107.45,2587600,1875370,52.85769439167879,45.421268843298044,NaN,NaN,4.518500300448676,-67.46933914112789,-0.04269117852287285,-0.4735396109565926,-0.43084843243371973,-25422207,-29556367,20.322460878903584,14.721495380831652,NaN,NaN,-7.310489603055284,-4.502155024747171
2001-03-08T09:30:00-05:00,107.00999,108.78,107.00999,108.61,2447400,1912135,57.08157782508977,45.5507184860954,NaN,NaN,51.84056634169015,-29.67235158584425,0.14224884238902835,-0.2530373794474343,-0.39528622183646267,-22974807,-27416827,37.25035202554156,15.437612188102833,NaN,NaN,-4.061572933251678,-4.4392147259621
2001-03-09T09:30:00-05:00,108,108,105.75,106.14999,3106100,2006750,47.38523965351404,45.352787183094264,NaN,NaN,-8.029679591519628,-9.733830175224403,0.0973204031028147,-0.2736357179579443,-0.370956121060759,-26080907,-26458487,43.083329762913934,16.81601689665548,NaN,NaN,-4.276571032211555,-4.415979912569165
2001-03-12T09:30:00-05:00,105.45,107.84,101.39999,101.89999,4690199,2164674.95,36.00579774855987,44.54036591083421,NaN,NaN,-128.81769801030683,-21.96921818042619,-0.20378470365692347,-0.6256870006319133,-0.4219022969749898,-30771106,-26651766.8,42.23070317111382,18.451362336441914,NaN,NaN,-8.935317744639582,-5.061599602864939
2001-03-13T09:30:00-05:00,102.55,103.25,101.10001,102.86,6300000,2416314.95,39.537895016610165,44.504024610366635,NaN,NaN,-167.04342778195235,-49.506347748328,-0.3167168221456236,-0.8177983246570193,-0.5010815025113957,-24471106,-25944026.6,46.41269883014248,20.599388595044825,NaN,NaN,-11.196044088261418,-5.937948815064436
2001-03-14T09:30:00-05:00,100.25,102.3,99.13,100.19,9402898,2768734.85,33.928933928702804,43.95392012966443,NaN,NaN,-214.43979423522364,-93.29800665546244,-0.5367225649718318,-1.1719847087261854,-0.6352621437543536,-33874004,-27634386,39.12725874946466,22.26035979556778,NaN,NaN,-15.253469116626636,-7.268737429573322
2001-03-15T09:30:00-05:00,101.24001,101.32001,99.89999,100.39999,3576900,2856859.85,34.71338359012077,43.703895727671004,NaN,NaN,-182.77287584346445,-140.22069509249337,-0.6272893836791522,-1.419373873353294,-0.7920844896741417,-30297104,-29098845.4,34.12893211017274,23.70372291769329,NaN,NaN,-18.000988192876516,-8.801916110045207
2001-03-16T09:30:00-05:00,99.64999,100.61,98.14999,98.38,4029600,3012069.85,30.911419552455698,42.532196306745014,NaN,NaN,-197.25081378213588,-178.06492193061663,-0.7728611246733269,-1.7581608955158003,-0.9852997708424734,-34326704,-30748004.8,29.550835459725505,24.86450809134157,NaN,NaN,-21.652504040162086,-10.637714385776189
2001-03-19T09:30:00-05:00,98.91,100,97.91,99.75,4135000,3140744.85,36.02884233615179,41.75077869718945,NaN,NaN,-161.29703261621714,-184.5607888517987,-0.7271750251235747,-1.8942685522469418,-1.1670935271233671,-30191704,-30632124.4,30.258755141986526,26.142220986284848,NaN,NaN,-22.8253082706601,-12.37879922647389
2001-03-20T09:30:00-05:00,100.05,100.7,96.95,96.96001,4743500,3318929.85,30.9939646436125,40.98568896593384,NaN,NaN,-159.37848860181336,-183.02780101577088,-0.827830621562273,-2.2018818040762085,-1.3740511825139354,-34935204,-32724944,25.311802956630487,27.152560683137335,NaN,NaN,-25.65580646157481,-14.275514545774021
2001-03-21T09:30:00-05:00,96.961,97.32001,94.5,94.8,7789602,3617639.95,27.759595738764318,40.05978196429519,NaN,NaN,-184.05740045549416,-176.951322259825,-0.9728431799546475,-2.590105157457245,-1.6172619775025974,-42724806,-34495104.4,22.030959043629167,28.094683967297964,NaN,NaN,-29.156676092300227,-16.401394766706336
2001-03-22T09:30:00-05:00,94.5,95.03999,91,93.45,12446602,4106385.05,25.93776642826387,38.963821724516144,NaN,NaN,-189.10432247810087,-178.2176115867523,-1.0841457725676007,-2.972444193212098,-1.8882984206444975,-55171408,-39469965.2,15.823457164463775,28.644240976961182,NaN,NaN,-32.57786705717628,-18.712319379630614
2001-03-23T09:30:00-05:00,94.49001,95.49001,93.3,95.3,6345301,4299190.1,32.47757755311089,38.07844983607221,NaN,NaN,-134.54488628729746,-165.6764260877846,-0.9617974341446529,-3.0905452133253135,-2.1287477791806606,-48826107,-42369845.8,13.44531271286479,29.072752450019276,NaN,NaN,-33.10417331755172,-20.768298513619342
2001-03-26T09:30:00-05:00,96,97.45,95.78999,97.2,5740199,4522810.05,38.48535048939733,37.436074206859544,NaN,NaN,-86.15216481213574,-150.6474525269683,-0.6940319066953942,-2.9962876625499035,-2.3022557558545094,-43085908,-44948686.6,11.75356510293706,29.337887365034963,NaN,NaN,-31.44671556036196,-22.293786663154002
2001-03-27T09:30:00-05:00,96.7,99.60001,96.39999,99.19,7044602,4772725.15,44.095758120573656,36.810221616066315,NaN,NaN,-53.32364226808819,-129.43648326022327,-0.341832984926834,-2.7295469870130518,-2.3877140020862178,-36041306,-45169907,11.61851325045727,28.71617682014594,NaN,NaN,-28.12428526830773,-23.12671503531882
2001-03-28T09:30:00-05:00,98.39999,98.73,97,97.66,5387398,4899135.05,40.999630569523006,35.661511097811555,NaN,NaN,-57.762904407094155,-104.17758405054329,-0.17903476692565246,-2.611507460743283,-2.4324726938176306,-41428704,-44910686.6,12.881704145042406,26.975559114396,NaN,NaN,-26.4629888682326,-23.603325582877932
2001-03-29T09:30:00-05:00,97.05,98.97,96.8,98.14,5104699,5027015,42.366821264238936,35.30305264143475,NaN,NaN,-50.10940648558452,-76.37860085204001,-0.014801831621070072,-2.4509749833439685,-2.4361731517228984,-36324005,-41141206,28.814627438990087,25.95636609125858,NaN,NaN,-24.716963127751313,-23.762416660716987
2001-03-30T09:30:00-05:00,98.32001,99.28999,97.55,99.14,5054602,5139750.1,45.21507627576116,35.960858250520566,NaN,NaN,-34.24291919667162,-56.318207433914836,0.17493991639701179,-2.2174982562266337,-2.3924381726236454,-31269403,-37629865.2,39.85023359065654,25.786332549797347,NaN,NaN,-22.392910759484735,-23.566772960540952
2001-04-02T09:30:00-04:00,98.39999,99.97,97.02,97.39,8406699,5506690.05,41.362625270608035,36.09119612580613,NaN,NaN,-39.50221922415952,-46.98821831631959,0.19482621911686504,-2.148905398727564,-2.343731617844429,-39676102,-36947904,41.73932220266881,25.45251993354923,NaN,NaN,-21.607302228484116,-23.28684857024712
2001-04-03T09:30:00-04:00,97.05,97.2,94.25,94.3,6530699,5743480,35.595560759850244,36.210240899459514,NaN,NaN,-90.89119764899438,-54.50172939250082,0.02124822864313014,-2.317171332040516,-2.338419560683646,-46206801,-38981003,37.91613159498684,25.366010851086525,NaN,NaN,-22.82063235806521,-23.220246254221134
2001-04-04T09:30:00-04:00,94.5,96.64999,93.75999,95.31,5376801,5882940.05,38.608580434102876,36.488469245458234,NaN,NaN,-89.00621408747972,-60.75039132857794,-0.002886195052213658,-2.342027304498913,-2.3391411094466994,-40830000,-38861262.2,38.27473288559012,25.662139477902056,NaN,NaN,-22.831960143156355,-23.16477680978331
2001-04-05T09:30:00-04:00,97.24001,99.49001,97.10001,99.39,5670602,6044100.15,48.990163206700046,37.779808077904256,NaN,NaN,3.8085065079815124,-49.966808729864724,0.2638396862190455,-2.0093415016728926,-2.273181187891938,-35159398,-38628340.8,39.012678839611674,26.337985433608207,NaN,NaN,-19.204568030869908,-22.599032698509966
2001-04-06T09:30:00-04:00,98.5,98.8,97.05,98.2,5727898,6175190.05,46.519236004871196,38.52912191138421,NaN,NaN,-3.0113299193445555,-43.72049087439932,0.36196852796976087,-1.820720527929737,-2.182689055899498,-40887296,-40551919.4,35.2632185752463,26.69544710741248,NaN,NaN,-17.14488578368478,-21.81986885353494
2001-04-09T09:30:00-04:00,99.44,99.49001,97.71001,98.82001,3701300,6125745.1,47.99109165210969,39.74320241199115,NaN,NaN,33.48616108482512,-29.12281481260239,0.46396554577430305,-1.6027321236816192,-2.0666976694559223,-37185996,-40053898.2,36.952694814244666,27.52693938295635,NaN,NaN,-15.043212037105839,-20.851775022616497
2001-04-10T09:30:00-04:00,98.3,101.78999,98.3,100.97,8756102,6248550.2,52.838176615969815,41.53452961750583,NaN,NaN,110.26066731746225,11.107558180688937,0.6596224871333127,-1.2421695605392813,-1.901792047672594,-28429894,-36498516.8,47.48871673396791,29.345350646551974,NaN,NaN,-11.678593113750587,-19.541320464207082
2001-04-11T09:30:00-04:00,102.49001,102.5,99.60001,100.17999,4623500,6009580.3,50.95884549052999,43.321749550524835,NaN,NaN,126.45947297372447,54.200695592929776,0.7145996492081799,-1.0085424861623693,-1.7231421353705492,-33053394,-34943195.6,51.32110439187474,31.880896877081334,NaN,NaN,-9.537261335751634,-18.112169160142017
2001-04-12T09:30:00-04:00,99.5,101.73,99,101.7,3777400,6019605.3,54.32498941481071,44.88227896921768,NaN,NaN,127.34475613275318,78.9079455178841,0.8243108199894533,-0.6927536103837326,-1.517064430373186,-29275994,-33766514.8,54.05319665557803,34.78146001584656,NaN,NaN,-6.68966891111758,-16.480383410281384
2001-04-16T09:30:00-04:00,101,101.97,100.5,100.98,2164100,5926330.3,52.48719840737429,45.88241096335889,NaN,NaN,131.32823634026767,105.77585876980655,0.8177459899645814,-0.49488194291745913,-1.3126279328820405,-31440094,-31877074.4,58.11801477266851,38.09320642082738,NaN,NaN,-4.9001915909426295,-14.826070293232991
2001-04-17T09:30:00-04:00,100.77,102.45,100.71001,102.25,3424700,5890815.3,55.35609289134412,46.686720589842494,NaN,NaN,144.20828212819973,127.92028297848147,0.8637790969856636,-0.23290406164996114,-1.0966831586356247,-28015394,-30042954,61.66351437703716,41.66784935844023,NaN,NaN,-2.5310316198614213,-13.069636197037052
2001-04-18T09:30:00-04:00,103.25,107.45,103.11,106.42,8816602,6094470.4,63.21096844780183,48.27324472400527,NaN,NaN,229.49413027429037,151.7669755698471,1.123468938204289,0.30765301411973667,-0.8158159240845524,-19198792,-28196733.6,64.88586329992633,45.38243215521766,NaN,NaN,2.2994054492644116,-10.874058818993987
2001-04-19T09:30:00-04:00,106.39999,107.23,105.7,107.17999,3677300,5888855.3,64.43899469506272,49.84982854049268,NaN,NaN,209.71941394086707,168.4189637632756,1.2832818258459204,0.7882863582228481,-0.4949954676230723,-15521492,-24690353.2,70.0370268627215,48.32688925691275,NaN,NaN,6.563879311027867,-8.382924800419437
2001-04-20T09:30:00-04:00,106,106.67,105.25999,105.95,2753000,5404175.2,60.896108359277456,50.969902260743844,NaN,NaN,160.0250192209696,174.9550163809189,1.242195384768958,1.0577487633381253,-0.18444662143083274,-18274492,-22490052.8,72.73951928899743,50.67612394965139,NaN,NaN,9.011381830343238,-5.898023853167626
2001-04-23T09:30:00-04:00,105.35001,105.85001,104.8,105.14999,2296500,5201735.15,58.63789309461203,52.20384996245842,NaN,NaN,125.00784577646779,173.69093826815893,1.101952060187474,1.1929934538035099,0.0910413936160358,-20570992,-20316232.4,75.12646959332835,53.06092019184136,NaN,NaN,10.348776887547242,-3.5770523187797876
2001-04-24T09:30:00-04:00,105.61,106.48,104.45,104.8,2812900,5055370.2,57.63101482058054,53.7778109667963,NaN,NaN,109.86282979561898,166.82184780164278,0.9331185622531412,1.2574395964324623,0.3243210341793211,-23383892,-19389932,76.08730982479487,55.78743292254193,NaN,NaN,11.153403070929793,-1.4727015488212762
2001-04-25T09:30:00-04:00,105.10001,106.55,104.45,106.46001,2232600,4814770.1,61.04745775998175,55.380587918644785,NaN,NaN,107.84643235703346,142.4923082181914,0.8813625668104456,1.4260242426923782,0.5446616758819326,-21151292,-19780432,74.77592720016821,58.39466108786894,NaN,NaN,12.84777646496166,0.5730810245762856
2001-04-26T09:30:00-04:00,106.7,107.78999,106.28999,107.02,2626400,4676720.2,62.156062365870454,56.32100928715696,NaN,NaN,115.96738309062818,123.74190204814363,0.8334921064414236,1.5865268089337121,0.7530347024922885,-18524892,-20381112,72.7002495238785,60.80091613674514,NaN,NaN,14.570398145348815,2.5726977561152182
2001-04-27T09:30:00-04:00,107.64999,108.28999,107.10001,108.23,3067900,4574880.25,64.50665608138544,57.605825006907985,NaN,NaN,115.54582041819624,114.84606228758894,0.8301488953654124,1.790720821699054,0.9605719263336416,-15456992,-19817612,73.44494838428503,63.52818255167647,NaN,NaN,16.724738979684698,4.594417930910858
2001-04-30T09:30:00-04:00,108.49001,109.12,107.10001,107.22,3978100,4521055.15,61.09542879712832,58.541849088695024,NaN,NaN,100.29399002561672,109.90329113741873,0.7113224672294798,1.8497250103704914,1.1384025431410116,-19435092,-19590432,73.75577388420126,66.15697391381623,NaN,NaN,17.60736431954044,6.453410272143655
2001-05-01T09:30:00-04:00,107.45,109.10001,107.3,109,3892600,4295350.2,64.64399287559226,59.38512167866806,NaN,NaN,100.08141871850606,107.94700892199617,0.7027725078990448,2.0168681780148177,1.3140956701157729,-15542492,-18022152,75.8566712259429,68.18325637752874,NaN,NaN,19.417015360123322,8.30535385614075
2001-05-02T09:30:00-04:00,109.05,109.49001,107.96001,108.69,4863602,4211995.35,63.55671675976995,60.28496962647092,NaN,NaN,96.41144046911269,105.66001054441202,0.6288092277212427,2.100107204767326,1.4712979770460834,-20406094,-17873112.4,76.05286596665145,69.94981077572707,NaN,NaN,20.605851347743577,10.062567783512582
2001-05-03T09:30:00-04:00,108,108.19,107.27,108.14,3190600,4102685.3,61.57782650861302,60.803029418885366,NaN,NaN,75.82710605680688,97.63195513764776,0.5009739999271301,2.097515476954996,1.5965414770278659,-23596694,-18887472.8,71.77768081543809,71.21584535857421,NaN,NaN,21.068205831246836,11.63480179033176
2001-05-04T09:30:00-04:00,106.95,109.81,106.77,109.8,5031000,4070705.2,65.10888701828449,61.704578605378956,NaN,NaN,89.61126378750245,92.44504381150901,0.4859694288734122,2.204003263119631,1.718033834246219,-18565694,-19509213.2,69.20960865787926,72.00810206466069,NaN,NaN,22.475430279198637,13.183463003027029
2001-05-07T09:30:00-04:00,109.45,110.03,108.95,109.22,2489400,3908780.3,62.93266140039591,62.24576207031122,NaN,NaN,100.89013020151913,92.56427184668948,0.39841230239854464,2.2160492122443998,1.8176369098458551,-21055094,-19833213.6,67.84731231646575,72.44980191747702,NaN,NaN,23.057683131075493,14.594065878462523
2001-05-08T09:30:00-04:00,109.64,109.64,108.2,108.81,3099900,3878710.3,61.37106831707267,62.114340632402,NaN,NaN,85.40687453948718,89.62936301088571,0.2799114696347067,2.1675262468892385,1.8876147772545318,-24154994,-21555714,60.975674255631034,72.17050270002737,NaN,NaN,23.124962883570152,15.812765450620756
2001-05-09T09:30:00-04:00,108.3,109.32001,108.10001,108.61,2595900,3570700.2,60.58136914094549,61.83879594996505,NaN,NaN,74.51833496558618,85.25074191018041,0.16099146525710517,2.088854108825913,1.927862643568808,-26750894,-22824674,56.44052139602535,71.1993237381205,NaN,NaN,22.974013594506154,16.83580089974724
2001-05-10T09:30:00-04:00,109.74001,109.95,109.11,109.25999,2157800,3447415.2,62.280119915791104,61.93765391828746,NaN,NaN,91.85957068958595,88.45723483673622,0.1019201593219976,2.055262842721305,1.9533426833993075,-24593094,-23023954,55.739392263196706,69.9850289505633,NaN,NaN,23.280393611419488,17.756457001414706
2001-05-11T09:30:00-04:00,109.11,109.37,107.84,108.53,3418400,3429465.2,59.194756743244795,61.977429893189786,NaN,NaN,59.92561515299793,82.52010510983533,-0.0048419227980229795,1.9472902799017788,1.9521322026998018,-28011494,-24913114,49.465986470581015,68.15213729893851,NaN,NaN,22.737239991785305,18.467997428610506
2001-05-14T09:30:00-04:00,108.35001,108.99001,108.11,108.99001,2258600,3434190.2,60.52198968645486,62.1839280978951,NaN,NaN,59.78686789850647,74.29945264923279,-0.059944959081668525,1.8772010038477163,1.9371459629293848,-25752894,-25852674,46.65365024088904,66.04973304294523,NaN,NaN,22.607431687733676,19.059345179913816
2001-05-15T09:30:00-04:00,109.10001,109.75,108.14,109.22,3467400,3436325.2,61.20146375450836,62.194928526075564,NaN,NaN,73.31625160457621,71.8813280622506,-0.0943232263656395,1.8192419299723355,1.913565156337975,-22285494,-25478774,47.922545984789224,64.13163438470387,NaN,NaN,22.66642078420602,19.5746416948127
2001-05-16T09:30:00-04:00,108.39999,112.64999,108.35001,112.46001,8124102,3401700.2,69.2348514634657,62.700556318760945,NaN,NaN,174.4843120619368,91.87452348152073,0.07839798178927615,2.01156263357457,1.933164651785294,-14161392,-22960873.6,55.5842594373194,62.90906366423537,NaN,NaN,25.101076130705035,20.364132328511605
2001-05-17T09:30:00-04:00,112.39999,113.64,112.14999,112.88,5072102,3471440.3,70.09911213974257,63.10001746578645,NaN,NaN,229.91964941918405,119.48653922744033,0.19172502464809593,2.172820932595414,1.981095907947318,-9089290,-19860112.8,62.8355914235894,62.151252452757106,NaN,NaN,27.368892265540257,21.3648123195157
2001-05-18T09:30:00-04:00,112.55,113.17,112.06,113.14999,3790100,3523295.3,70.66953651450041,63.783882302741596,NaN,NaN,203.9569671394271,148.2928096247262,0.25187453481898014,2.2959390764710434,2.0440645416520633,-5299190,-15317652,70.44734878400645,61.914936374171795,NaN,NaN,29.412769062169964,22.514520425609167
2001-05-21T09:30:00-04:00,113,113.60001,112.14999,113.3,4281199,3622530.25,71.00056151518008,64.23792291985502,NaN,NaN,182.18339183558902,172.77211441214268,0.2673093446868955,2.3782012225106826,2.110891877823787,-1017991,-10370671.4,76.17125577252784,61.937406698927866,NaN,NaN,31.208052532355307,23.756453583715757
2001-05-22T09:30:00-04:00,113.45,113.45,112.47,112.67,3741800,3668975.25,67.55239944178271,64.52332882571307,NaN,NaN,146.3185937696193,187.3725828451513,0.2035210604124491,2.3652932033393483,2.1617721429268992,-4759791,-6865530.8,79.23946259090344,62.16502074351729,NaN,NaN,31.84715682314696,24.91226833220593
2001-05-23T09:30:00-04:00,112.3,112.5,111.06,111.10001,3897400,3752215.25,59.76307422032037,64.3937036622636,NaN,NaN,77.17528415627558,167.91077726401906,0.03296933132602975,2.2029838070844363,2.1700144757584066,-8657191,-5764690.6,80.10585048101845,62.75989000534446,NaN,NaN,30.20483532887832,25.668349331730557
2001-05-24T09:30:00-04:00,111.45,111.85001,110.55,111.28,2439600,3742875.25,60.327856289203226,64.05220146732923,NaN,NaN,54.83657830466348,132.89416304111495,-0.08395456160228587,2.0650712737555494,2.1490258353578353,-6217591,-5190350.8,80.56163834293729,63.57074926856289,NaN,NaN,28.992556132039276,26.143236017488945
2001-05-25T09:30:00-04:00,111.35001,111.35001,110.00999,110.14999,2465700,3712765.25,55.098871206111866,63.49264502488035,NaN,NaN,20.39511293235791,96.18179219970112,-0.24454601226864492,1.8433433200220293,2.087889332290674,-8683291,-5867171,78.28545347436088,64.31633077984111,NaN,NaN,26.41316055888108,26.18179666625925
2001-05-29T09:30:00-04:00,110.45,110.8,109.75999,110.41,2103400,3619030.25,56.04297607794983,63.11206700780016,NaN,NaN,7.96229304649866,61.33757244188304,-0.33482377404694885,1.669359614731988,2.004183388778937,-6579891,-6979551,74.55697152879053,65.28642344220964,NaN,NaN,24.508066946398085,25.942692420564796
2001-05-30T09:30:00-04:00,110.02,110.59,108.64999,109,3908700,3619835.25,49.91385956663005,62.350102038206195,NaN,NaN,-35.51080652926901,24.971692382105374,-0.48211077402659974,1.4015449212456872,1.883655695272287,-10488591,-8125311,70.81581075273647,66.31322982483186,NaN,NaN,20.97732368216412,25.2333540293647
2001-05-31T09:30:00-04:00,109.25,109.92999,108.75,109.08,2087200,3481015.15,50.24633329803055,61.4905458512233,NaN,NaN,-44.7933188933649,0.577971772177284,-0.5612218850758992,1.1821283389274129,1.743350224003312,-8401391,-8074151,70.88605983603887,67.39513465146345,NaN,NaN,18.164729134443878,24.22355047294744
2001-06-01T09:30:00-04:00,109.5,110.45,108.39999,110.45,2390100,3440990.15,55.672891184737175,61.238984025615615,NaN,NaN,-26.97815551749148,-15.78497499225372,-0.5098506100396127,1.1060369614537962,1.615887571493409,-6011291,-8032891,70.94679922032054,68.92947841930199,NaN,NaN,17.168291680335944,23.215656359717226
2001-06-04T09:30:00-04:00,110.25,110.92,109.5,110.67,1067300,3242805.15,56.49350762837657,60.95123530718145,NaN,NaN,-1.4680395715383194,-20.15760549303296,-0.4516167311110215,1.0513666576046319,1.5029833887156534,-4943991,-7285031,72.08365084422394,70.7459070338259,NaN,NaN,16.571757256087412,22.266527916341538
2001-06-05T09:30:00-04:00,110.7,112.17999,110.45,111.96001,1919600,3214315.15,61.04720827673807,60.940217058769285,NaN,NaN,52.72593576139474,-11.204876950053794,-0.32281935682941976,1.0994591926788786,1.4222785495082984,-3024391,-6573931,73.15912868786245,72.54852008404542,NaN,NaN,17.369136434445572,21.566900561784973
2001-06-06T09:30:00-04:00,111.85001,111.94,110.71001,111.05,2137400,3166190.15,56.55059674079295,60.03419886429266,NaN,NaN,32.375169759058686,2.372318307611745,-0.29621028802831084,1.0520156894729098,1.3482259775012206,-5161791,-5508571,74.72985654146342,73.91606273434142,NaN,NaN,16.728371871752937,20.87568217749468
2001-06-07T09:30:00-04:00,110.45,111.12,110.14999,110.91,2334000,3153095.15,55.868799164237444,59.01774793747086,NaN,NaN,0.47986224302019176,11.426954534888763,-0.2852303982620512,0.9916879796736566,1.2769183779357078,-7495791,-5327451,74.9977353687171,74.78478730185056,NaN,NaN,16.00971563853542,20.1805441005005
2001-06-08T09:30:00-04:00,110.8,110.8,109.35001,109.75,1405600,3115485.15,50.44220931667576,57.57293885191196,NaN,NaN,-44.859453771363285,7.850694884114402,-0.34906607841245996,0.8405857799201328,1.1896518583325928,-8901391,-5905471,72.36141097798726,74.92150602999205,NaN,NaN,13.768528116141306,19.264541817020618
2001-06-11T09:30:00-04:00,109.55,109.85001,108.8,109.35001,2264700,3057800.15,48.68615101310557,55.97905238747806,NaN,NaN,-86.08209177827496,-9.072115557232927,-0.4071506816516808,0.6807135062679919,1.0878641879196727,-11166091,-7149891,66.90835622269194,74.2598703478609,NaN,NaN,11.385288729552345,18.138934233096577
2001-06-12T09:30:00-04:00,108.69,110,107.95,109.53,2369500,3063345.15,49.53748052267518,54.69227246468467,NaN,NaN,-99.60842392926205,-39.53898749536428,-0.4206447829952099,0.5620582091756603,0.9827029921708702,-8796591,-8304331,62.22369995202953,73.04445873079848,NaN,NaN,9.638538939523162,16.924592048300376
2001-06-13T09:30:00-04:00,109.75,110.25,108.75999,108.81,2241600,3002055.15,46.23313650236845,53.725848341973816,NaN,NaN,-94.37653568527566,-64.88932858423115,-0.46195956323285725,0.4052535381297986,0.8672131013626558,-11038191,-9479611,57.787738798216374,71.45030789631262,NaN,NaN,7.179554350414607,15.532443805745267
2001-06-14T09:30:00-04:00,108.35001,108.35001,106.53,106.60001,3475600,2769630.05,37.88072127229847,52.12248155505205,NaN,NaN,-187.76689941979325,-102.53868091679382,-0.6125807985979728,0.10148710311518983,0.7140679017131626,-14513791,-10883211,52.93423635980168,69.47692204037436,NaN,NaN,2.144077202820087,13.619820005327384
2001-06-15T09:30:00-04:00,106.39999,107.28999,105.64999,106.7,4091800,2720614.95,38.42275946101866,50.931330716116825,NaN,NaN,-195.05172399772843,-132.57713496206685,-0.6750036657535459,-0.12968668047876974,0.5453169852747761,-10421991,-11187331,51.91678502149956,67.59344572231285,NaN,NaN,-1.7269545954518337,11.427423633787496
2001-06-18T09:30:00-04:00,106.39999,107.2,106.2,107,2411100,2651664.95,40.11124798712024,49.79335013820043,NaN,NaN,-160.03330499584226,-147.36737760558032,-0.6645705537228842,-0.28539620687882916,0.37917434684405504,-8010891,-10556291,53.896958166208705,66.11773048212844,NaN,NaN,-4.448476696578723,9.159437872306608
2001-06-19T09:30:00-04:00,107.25,107.56,105.64999,106.17999,4168801,2646045.05,37.11543293264336,48.879176807201375,NaN,NaN,-156.71841705068195,-158.78937622986433,-0.6789813772973974,-0.46955237477769174,0.20942900251970567,-12179692,-11232911.2,51.45031593523594,64.73448085230696,NaN,NaN,-7.6958264752471734,6.751542965513211
2001-06-20T09:30:00-04:00,105.95,107.14,105.67,106.73,3386000,2628255.05,40.334346718826914,48.17117776582969,NaN,NaN,-138.34361035569754,-167.58279116394868,-0.6192294475315465,-0.5646078068947276,0.05462164063681901,-8793692,-10784011.4,52.97549073438658,63.45515448790322,NaN,NaN,-9.524668902697778,4.42636984148307
2001-06-21T09:30:00-04:00,106.35001,107.75,106,107.14,3673100,2617040.05,42.6893866766122,47.24378458667791,NaN,NaN,-100.75780828218953,-150.18097293642793,-0.5236497975798967,-0.5999406063380519,-0.07629080875815517,-5120592,-8905371.6,58.807640548995764,62.58807172566575,NaN,NaN,-10.39679752905208,2.308774502835192
2001-06-22T09:30:00-04:00,106.95,106.95,105.8,106.24001,1695900,2579855.05,39.04612526521356,45.99754298930913,NaN,NaN,-110.50094262715105,-133.27081666231246,-0.4930314675147689,-0.6925801431516163,-0.1995486756368474,-6816492,-8184271.8,60.81647629501247,61.783273543579206,NaN,NaN,-12.220615239623086,0.23314739676972351
2001-06-25T09:30:00-04:00,106.57001,106.60001,104.77,105.06,2237400,2568440.05,34.846916549978374,44.12609358025487,NaN,NaN,-125.2348677789963,-126.31112921894325,-0.5214812014787644,-0.8514001774853028,-0.32991897600653847,-9053892,-8392872,59.90634383713445,60.8366460542415,NaN,NaN,-15.12169833975075,-1.9604019941617725
2001-06-26T09:30:00-04:00,104.60001,105.5,104.00999,104.62,2550400,2590790.05,33.40432338741553,42.4727883407279,NaN,NaN,-133.45568095123218,-121.65858199905333,-0.53704800102762,-1.0012289772910634,-0.46418097626344346,-11604292,-8277792,60.25967712660747,59.80306181032322,NaN,NaN,-17.96405523574867,-4.246638171531329
2001-06-27T09:30:00-04:00,104.88,105.39999,104.06,104.5,1937200,2492215.05,33.003044078856036,40.83952012034352,NaN,NaN,-118.24692629216946,-117.63924518634772,-0.5220782960640852,-1.11677884634355,-0.5947005502794648,-13541492,-9227352,55.88345473943554,58.43775605108882,NaN,NaN,-20.40471755829593,-6.554935226783414
2001-06-28T09:30:00-04:00,105.07001,106.83,105,105.69,2888600,2532285.05,40.62082758689115,40.13799285393033,NaN,NaN,-70.40799520251527,-111.56928257041284,-0.4039625766895749,-1.0996537711414334,-0.6956911944518585,-10652892,-10333812,51.21603827070534,56.92737228628297,NaN,NaN,-20.33052604356163,-8.522876772037444
2001-06-29T09:30:00-04:00,105.85001,106.2,105.16,105.24001,1571400,2491350.05,38.823177271495155,39.433494729529585,NaN,NaN,-74.08707027862708,-104.28650810070806,-0.3311283729980422,-1.1096016606994112,-0.778473287701369,-12224292,-11415372,47.07698048715335,55.51084544803022,NaN,NaN,-20.788199397204792,-10.275065718489921
2001-07-02T09:30:00-04:00,104.78,106.58,104.55,106.21001,1604000,2518185.05,44.52254326079852,39.07528492510983,NaN,NaN,-61.2230367843413,-91.48414190177706,-0.19911868241130537,-1.0273716407155007,-0.8282529583041953,-10620292,-11728652,45.91938114595399,54.34625124759625,NaN,NaN,-19.456928942785574,-11.586760464817871
2001-07-03T09:30:00-04:00,105.95,106.05,105.35001,106.05,642500,2454330.05,43.797688667860584,38.90132436550211,NaN,NaN,-56.769732175449874,-76.14695214662059,-0.10859987571038432,-0.9640028029421757,-0.8554029272317913,-11262792,-11660352,46.22981133453705,53.520685000190575,NaN,NaN,-18.57459440148267,-12.585022455769986
2001-07-05T09:30:00-04:00,105.25,105.74001,104.64999,104.64999,1072000,2401060.05,37.97251370764062,38.90788096802656,NaN,NaN,-88.32911848486202,-70.1633905851591,-0.12771827868925967,-1.015050775593366,-0.8873324969041063,-12334792,-11419012,47.379215852118676,53.123897821070365,NaN,NaN,-19.54147560418242,-13.578801476971762
2001-07-06T09:30:00-04:00,104.63,104.63,102.32001,102.56,2707600,2419740.05,31.28338851856013,38.397925900708096,NaN,NaN,-172.03318182847036,-90.48842791035013,-0.2582947582829218,-1.2102009447577586,-0.9519061864748368,-15042392,-12296912,43.71825890874121,52.5382888130162,NaN,NaN,-22.71446299560612,-14.883895979633813
2001-07-09T09:30:00-04:00,102.95,103.39,102.32001,102.85001,2770800,2488000.05,33.045894649169526,37.89325780514019,NaN,NaN,-172.06705862432656,-110.08442557949002,-0.29941122028143896,-1.3261702118266356,-1.0267589915451967,-12271592,-12306372,43.679092736250844,51.80844128230492,NaN,NaN,-24.648508167741333,-16.278840577934886
2001-07-10T09:30:00-04:00,103.39999,103.5,101.7,101.77,2083200,2478925.05,29.96367576873959,37.38241800771849,NaN,NaN,-181.2166779808323,-134.08315381878822,-0.36904954054797123,-1.4880709172301607,-1.1190213766821895,-14354792,-13053272,40.587405378508045,51.0325190996815,NaN,NaN,-27.29990961867,-17.85327901232562
2001-07-11T09:30:00-04:00,102.03,102.92999,101.34,102.55,3559600,2538430.05,34.70070397868865,36.98001495485148,NaN,NaN,-160.1548727944411,-154.76018194258646,-0.33337162176497515,-1.5357359038884084,-1.2023642821234333,-10795192,-12959752,41.14910195589757,50.18777704407514,NaN,NaN,-27.96606624538636,-19.29796290276287
2001-07-12T09:30:00-04:00,103.45,105.3,103.21001,105.14999,3186600,2585680.05,47.45781922798759,37.320617279949715,NaN,NaN,-36.967114405456655,-144.48778112670539,-0.11664648878625594,-1.3481723931062533,-1.2315259043199973,-7608592,-12014512,46.64020607947721,49.318674581966675,NaN,NaN,-23.955685104912366,-19.963351788784227
2001-07-13T09:30:00-04:00,104.75,105.7,104.39999,105.67999,1200700,2471935.05,49.61856364735912,38.075791450102976,NaN,NaN,6.685843629752933,-108.74397603506073,0.07035837600806416,-1.143577934309917,-1.2139363103179812,-6407892,-10287612,54.91646916491846,48.89724550124568,NaN,NaN,-20.070775719230653,-19.978698064562288
2001-07-16T09:30:00-04:00,105.46001,105.84,104.57001,105.05,912400,2312965.05,47.13713952622022,38.95366451983453,NaN,NaN,4.789981674216079,-73.3725679753522,0.15474383563546734,-1.020506515773647,-1.1752503514091144,-7320292,-9297352,58.85723268383612,48.8223089902958,NaN,NaN,-17.76078200782749,-19.661852913600175
2001-07-17T09:30:00-04:00,104.60001,106.49001,104.45,106.14999,1513100,2268065.05,51.68089983778228,40.2591342662893,NaN,NaN,42.62831697807472,-28.603568983570806,0.28043640448688256,-0.8247048458005111,-1.1051412502873936,-5807192,-7587832,64.60858544925442,49.13294529905628,NaN,NaN,-14.306525569905865,-18.896806150215273
2001-07-18T09:30:00-04:00,105.35001,106.089,104.89999,105.60001,2256500,2172450,49.394832019306065,41.42997626203573,NaN,NaN,36.19628384449267,10.666662344215954,0.31949405493038907,-0.7057736816244073,-1.0252677365547964,-8063692,-7041532,66.23304928911816,49.87220205260503,NaN,NaN,-12.23573522077563,-17.945224588866754
2001-07-19T09:30:00-04:00,106.78,107,105.39999,106.39999,1638000,2085050,52.67408540166147,42.290923248805036,NaN,NaN,85.56515416362355,35.173116058031994,0.387626252206247,-0.5407349212969876,-0.9283611735032347,-6425692,-6804952,66.94072926420878,50.995394266426715,NaN,NaN,-9.468702238048028,-16.734292824464077
2001-07-20T09:30:00-04:00,105.55,106.07001,105.35001,105.8,1203300,1961560,50.05426936224299,43.09314411242989,NaN,NaN,57.50570215703121,45.337087763487645,0.3801839163524171,-0.45313127806271325,-0.8333151944151304,-7628992,-7049172,65.4166030458139,52.305367306331036,NaN,NaN,-7.985182205875812,-15.484419878951469
2001-07-23T09:30:00-04:00,106.22,106.33,103.75,103.89999,1805900,1967060,42.79542199726463,42.96977830789175,NaN,NaN,-11.092846280077646,42.1605221726289,0.24193231143332983,-0.5308998051234681,-0.772832116556798,-9434892,-7472092,62.752075177234104,53.507702594279614,NaN,NaN,-9.031831272276825,-14.562621506569377
2001-07-24T09:30:00-04:00,103.8,104.17,102,102.64999,2675700,1988975,38.80804655082162,42.613375299531825,NaN,NaN,-115.63112517626301,10.508633741761354,0.06987007542310175,-0.6854945222779207,-0.7553645977010225,-12110592,-8732772,55.49565262319262,54.16954840061214,NaN,NaN,-11.248024083192542,-14.089107588944115
2001-07-25T09:30:00-04:00,102.7,104.24001,102.57001,103.95,2227400,1972825,44.590298255907015,43.08607419583657,NaN,NaN,-64.98665879392597,-9.727954785922373,0.048212210473267736,-0.6950993346094378,-0.7433115450827056,-9883192,-9096672,53.56999979058933,54.61174725336004,NaN,NaN,-11.180506882359087,-13.67359320228911
2001-07-26T09:30:00-04:00,103.7,104.74001,102.85001,104.64,2447500,1998340,47.42972088562597,44.23938365062698,NaN,NaN,-31.77381586951372,-33.19574879254982,0.08292093407039913,-0.6396603774947067,-0.7225813115651059,-7435692,-9298672,52.48137497065564,55.23768411492536,NaN,NaN,-10.20225865282163,-13.177688266650899
2001-07-27T09:30:00-04:00,104.55,104.7,103.81,104.35001,1409500,1924385,46.3546039181308,45.19000574126708,NaN,NaN,-14.896481171414889,-47.67618545823904,0.0884099887754799,-0.612068825595756,-0.7004788143712359,-8845192,-9541912,51.13386037806974,55.77016751791242,NaN,NaN,-9.751395104447727,-12.688217814907588
2001-07-30T09:30:00-04:00,104.64999,104.64999,103.63,104.07001,824500,1887040,45.28717234451762,46.28454121096551,NaN,NaN,-21.538261064923624,-49.76526841520824,0.07573300999381316,-0.6058125518789694,-0.6815455618727826,-9669692,-9588872,50.862340027273866,56.50409142139569,NaN,NaN,-9.699481083629223,-12.261255424724965
2001-07-31T09:30:00-04:00,104.25,106.05,104.16,105.03,2736600,1943670,49.57453702226784,47.34695785693545,NaN,NaN,43.35462112940926,-17.968119154073783,0.1312951156409452,-0.517426667321601,-0.6487217829625462,-6933092,-8553372,56.364581530536924,57.590911391012796,NaN,NaN,-8.372677857303144,-11.705744343664705
2001-08-01T09:30:00-04:00,105.78,106.06,104.87,105.28999,2099400,2016515,50.701246181203636,47.578631210736596,NaN,NaN,67.3776477448992,8.504742153691243,0.18174388720804568,-0.42154192395248913,-0.6032858111605348,-4833692,-7543472,60.956430976334616,58.61349888364547,NaN,NaN,-6.957545156880748,-11.02743017412414
2001-08-02T09:30:00-04:00,106.25,106.25,105.23,105.60001,1675000,2046665,52.07633178219069,47.754186077510276,NaN,NaN,81.76764751294827,31.21303483018364,0.22912167870619204,-0.3168837127777948,-0.5460053914839869,-3158692,-6688072,64.37596666456506,59.28917727647737,NaN,NaN,-5.3894638730663935,-10.222006416830176
2001-08-03T09:30:00-04:00,105.7,105.7,104.36,105.38,1950900,2008830,50.989378436682784,48.02934599968618,NaN,NaN,41.80159997394521,42.55265105925566,0.23774352626786543,-0.2488259836491551,-0.4865695099170205,-5109592,-5940952,67.08732323184105,59.87704088704915,NaN,NaN,-4.367400840794221,-9.385634191682183
2001-08-06T09:30:00-04:00,105,105.08,103.85001,103.94,1552700,1947925,44.44986129034118,47.51284324629752,NaN,NaN,-23.28581530495636,42.203140211249114,0.14322315023359994,-0.3075405721250206,-0.45076372235862056,-6662292,-5339472,69.12469513640002,60.19962015041669,NaN,NaN,-5.31719423799747,-8.804428484012938
2001-08-07T09:30:00-04:00,104.10001,104.88,103.73,104.56,2502500,1968890,47.56787015250838,47.38234597009768,NaN,NaN,-26.778393449991466,28.176537295368966,0.12014809387950814,-0.3005786050092354,-0.42072669888874353,-4159792,-4784812,70.9128247491629,60.53388982613417,NaN,NaN,-5.22911123134623,-8.293668876489122
2001-08-08T09:30:00-04:00,104.19,104.92999,102.7,102.96001,4010000,1991410,41.14895966457542,46.55912270316297,NaN,NaN,-113.6997796188145,-8.038948177373772,0.0011147950509106108,-0.4193332050751053,-0.4204480001260159,-8169792,-5452032,65.96379286103274,60.46410865447874,NaN,NaN,-7.142552627303123,-8.129223698033979
2001-08-09T09:30:00-04:00,102.99001,103.25,102.13,103.14999,5422801,2103220.05,42.14722752249023,45.99433400032348,NaN,NaN,-151.054930895445,-54.60346385905243,-0.05759418606255562,-0.4924407327042104,-0.4348465466416548,-2746991,-5369691.8,66.27658409285063,60.52553587212422,NaN,NaN,-8.3976080653969,-8.167564321942967
2001-08-10T09:30:00-04:00,102.92999,104.46001,102.02,104.23,4504000,2268385.05,47.58990349637007,46.33679696454529,NaN,NaN,-82.03615643966953,-79.37101514177537,-0.01848452757867286,-0.4579522061149959,-0.439467678536323,1757009,-3996371.6,71.05450510303989,61.11856658111035,NaN,NaN,-7.853450296892896,-8.122690889792956
2001-08-13T09:30:00-04:00,104.2,104.55,103.75101,104.19,2801800,2362855.05,47.411996329673755,46.95136480589188,NaN,NaN,-31.220846866915448,-80.9580214541672,0.008451474544453885,-0.42890333535575564,-0.43735480990020953,-1044791,-2872871.4,74.26661472608772,62.45934958846,NaN,NaN,-7.465560522705619,-8.028815123066193
2001-08-14T09:30:00-04:00,104.5,104.97,103.97,104.31,1329100,2353655.05,48.03955940450554,47.197740602220335,NaN,NaN,-6.116555994736524,-76.8256539631162,0.03653679855342162,-0.39168381170843247,-0.4282206102618541,284309,-1984051.2,76.48940479925199,64.09644994622161,NaN,NaN,-6.972499462328545,-7.877912885817958
2001-08-15T09:30:00-04:00,104.31,104.84,103.52,103.57001,2354500,2358555.05,44.51197924246412,46.98933048485163,NaN,NaN,-40.380725626617554,-62.16184316467682,0.008904388699949917,-0.4170901243869167,-0.42599451308686664,-2070191,-764131,79.15125512199506,66.001441385603,NaN,NaN,-7.5236116214220665,-7.827298419475688
2001-08-16T09:30:00-04:00,103.32001,104.25,102.89,104.25,3778100,2465560.05,48.270988650787096,47.126215108612804,NaN,NaN,-52.10387634659189,-42.371632254906196,0.03839723064307077,-0.3779979747830282,-0.416395205426099,1707909,126849,80.85605231722391,68.12445509554259,NaN,NaN,-6.943306426719391,-7.7010138490819315
2001-08-17T09:30:00-04:00,103.14999,103.62,101.88,102.5,3423400,2576565.05,40.64048407515754,46.79430880365851,NaN,NaN,-157.1623307656096,-57.3968671200942,-0.05301478975289903,-0.48266369261722275,-0.4296489028643237,-1715491,-567651,75.66252281430407,69.89589672318759,NaN,NaN,-8.769200703840818,-7.853611971190344
2001-08-20T09:30:00-04:00,102.39999,103.60001,102.14999,103.58,2005200,2586530.05,46.28389844527821,46.55926319101639,NaN,NaN,-97.31836043232985,-70.61636983317707,-0.03469084635259373,-0.47301246080506587,-0.43832161445247214,289709,-300751,76.29274310578745,71.3193368357055,NaN,NaN,-8.559831934863631,-7.954500537429385
2001-08-21T09:30:00-04:00,103.5,103.89,101.46001,101.5,3860900,2645790.05,38.66057772182877,45.6992154439182,NaN,NaN,-169.65357463531325,-103.32377356129243,-0.15013184838335653,-0.6259864249316678,-0.47585457654831126,-3571191,-1071851,70.60428338879646,72.00846915088134,NaN,NaN,-11.001408729480309,-8.389773136293803
2001-08-22T09:30:00-04:00,102.2,103.23,101.45,102.88,5700602,2819450.15,45.11913668540114,45.20227293700466,NaN,NaN,-130.0195121136742,-121.25153085870375,-0.1222112210088796,-0.6286186028094107,-0.5064073818005311,2129411,-231930.6,72.96853227793247,72.62222383755044,NaN,NaN,-10.799651923268835,-8.734041534433093
2001-08-23T09:30:00-04:00,102.64999,103.03999,102.23,102.45,2266300,2810390.15,43.57938359917245,44.6729875914682,NaN,NaN,-108.03176733657196,-132.43710905669977,-0.12112937453962114,-0.6578190999750575,-0.5366897254354364,-136889,-600890.2,70.29397078885133,72.8512700916226,NaN,NaN,-11.150879291264825,-9.07930407112334
2001-08-24T09:30:00-04:00,102.75,104.97,102.38,104.63,2789300,2879380.15,52.440704017532404,45.243762071981855,NaN,NaN,9.567765009669577,-99.09108990164394,0.029913912742881132,-0.499297334506835,-0.5292112472497161,2652411,272690.2,72.83299845798514,73.11614890030725,NaN,NaN,-8.317959054576828,-8.970540497330981
2001-08-27T09:30:00-04:00,104.5,104.61,103.91,103.91,2574400,2966875.15,49.66621890623435,45.39364412581943,NaN,NaN,21.905564653340647,-75.24630488450984,0.08189278225536056,-0.4268452694305154,-0.5087380516858759,78011,230350.6,72.50951922248892,73.23019850554483,NaN,NaN,-7.010296663468399,-8.69050566392204
2001-08-28T09:30:00-04:00,103.99001,103.99001,102.25,102.32001,2799200,2970005.15,44.11547234487956,45.60553788869829,NaN,NaN,-76.58451609848554,-56.6324931771443,0.013347796114744681,-0.49205330654244506,-0.5054011026571897,-2721189,400351,73.02751597695905,73.73475015668241,NaN,NaN,-7.829373923326359,-8.567486843836944
2001-08-29T09:30:00-04:00,102.7,102.85001,100.89999,101.19,3113300,3020700.15,40.63924251581233,45.49782467393559,NaN,NaN,-157.07914526006445,-62.04441980642234,-0.09782153969991803,-0.6276780272820872,-0.5298564875821692,-5834489,-1192429,61.36130503230292,73.38365879521473,NaN,NaN,-9.69486731567217,-8.728541196956263
2001-08-30T09:30:00-04:00,100.53999,101.46001,98.83,99.25999,5706199,3222260.1,35.49473876392122,44.633884335903524,NaN,NaN,-247.87778482212337,-90.01362330353263,-0.28071048781525554,-0.8807445973512387,-0.6000341095359831,-11540688,-3473188.8,49.23282242994583,71.82496717570801,NaN,NaN,-13.12548999946409,-9.356676740171666
2001-08-31T09:30:00-04:00,99.39999,100.67,99.07001,99.88,3670700,3308250.1,38.20119960058383,43.975970283825674,NaN,NaN,-207.77960353828396,-133.48309701312334,-0.33558844353906336,-1.0195196639598123,-0.6839312204207489,-7869988,-5577668.6,41.150488771979965,69.45952960755746,NaN,NaN,-14.91402840856542,-10.150584121370773
2001-09-04T09:30:00-04:00,99.7,102.07001,99.36,99.97,8618801,3661555.15,38.60389431778128,43.30199420620251,NaN,NaN,-146.2701763550401,-167.1182452147995,-0.3404139221509557,-1.1094486231094436,-0.7690347009584879,748813,-5443508.2,41.806364855295044,66.98216961156054,NaN,NaN,-16.17953237818344,-11.011862443772582
2001-09-05T09:30:00-04:00,100,100.95,99.00999,100.56,7027301,3887795.2,41.30410589810753,43.072860395891325,NaN,NaN,-140.83718392049622,-179.9687787792016,-0.2809298141280786,-1.1201969686185862,-0.8392671544905076,7776114,-3344047.6,51.00812775283921,64.9719462280494,NaN,NaN,-16.39729670012173,-11.781210194679604
2001-09-06T09:30:00-04:00,99.8,100.2,98.33,98.35001,5873602,3980975.3,35.08045567538777,42.130679469077094,NaN,NaN,-169.52092758134845,-182.45713524345842,-0.3623044829618205,-1.2921477581927832,-0.9298432752309627,1902512,-1796647.4,56.47136659636712,63.23018296227391,NaN,NaN,-18.64118314991705,-12.761206331142096
2001-09-07T09:30:00-04:00,97.61,98.23,95.7,95.85001,10479199,4233795.2,29.639690319411002,41.344908486523764,NaN,NaN,-215.1306371079905,-175.90770570063185,-0.5453829051161867,-1.611571906626196,-1.0661890015100093,-8576687,-1203847.2,58.3858750741133,61.996136695117436,NaN,NaN,-22.567181159976883,-14.162059878118495
2001-09-10T09:30:00-04:00,95.17,96.96001,95.05,96.45,8726898,4444940.1,32.35139447097899,40.349729631216675,NaN,NaN,-185.53439172234386,-171.45866333744385,-0.5835328384922394,-1.7956050496253084,-1.212072211133069,150211,400192.6,63.11348242135978,61.05476093194403,NaN,NaN,-24.749888255531307,-15.674606789177467
2001-09-17T09:30:00-04:00,90.5,92.3,88.95,89.10001,13237602,4966730.2,21.446883796989198,39.1201800651567,NaN,NaN,-280.5684490412904,-198.31831787469392,-1.0348636819077628,-2.5056518135177726,-1.4707881316100098,-13087391,-2367048.2,52.11401491831158,59.73402746976654,NaN,NaN,-31.816051152354145,-17.98052741248842
2001-09-18T09:30:00-04:00,89.75,90.5,88.2,89.39999,6816000,5241075.2,22.593663314145005,37.51121768149555,NaN,NaN,-234.47828167840456,-217.04653742627556,-1.230946929153229,-3.0094717930515458,-1.7785248638983169,-6271391,-5176549.2,43.7729378377579,57.64862786689692,NaN,NaN,-36.36142611535061,-20.606370084325874
2001-09-19T09:30:00-04:00,89.42999,89.8,84.89999,87.47,9975602,5622130.3,20.518251436097103,35.8639939555616,NaN,NaN,-211.28351097318136,-225.39905410464218,-1.3962728189911404,-3.5238658876372426,-2.127593068646102,-16246993,-8806450.2,35.80026240497983,55.18479155376325,NaN,NaN,-40.74194119366595,-23.482880242803027
2001-09-20T09:30:00-04:00,86.5,86.89999,83.5,83.64999,10182102,5942330.4,17.158603893679384,33.34384394671495,NaN,NaN,-197.57826517641757,-221.88857971832758,-1.651088209518881,-4.191453330544704,-2.5403651210258227,-26429095,-12376931.8,30.01019177082273,52.12601964753736,NaN,NaN,-45.80630680517406,-26.671941180284602
2001-09-21T09:30:00-04:00,80.05,85,79.5,82.8,12533500,6397835.4,16.510782871631108,30.975598515671862,NaN,NaN,-180.5636757551062,-220.89443652488004,-1.755333139643306,-4.734531545579955,-2.979198405936649,-38962595,-20199493,21.721384954027997,48.49829577121873,NaN,NaN,-49.826076650069304,-29.979674818825274
2001-09-24T09:30:00-04:00,85.46001,86.69,84.5,86.2,7953199,6695235.35,28.189862758104695,29.83805497375937,NaN,NaN,-119.53712847838895,-188.68817241229974,-1.4845135383867225,-4.834840328920052,-3.3503267905333294,-31009396,-23783894,19.115996452626206,44.64747294805209,NaN,NaN,-48.752370752908,-32.66148852369423
2001-09-25T09:30:00-04:00,86.25,87.2,85.05,86.89999,7318102,6868095.45,30.35007535054585,29.10311446195462,NaN,NaN,-97.43600459937045,-161.2797169964929,-1.1617323899181438,-4.802492277931009,-3.640759888012865,-23691294,-27267874.6,16.983640993785343,41.47763980244368,NaN,NaN,-47.17234343498542,-34.73446779673583
2001-09-26T09:30:00-04:00,87.39,87.5,85.3,86.05,3981900,6782160.35,29.20133950246094,28.653585943278888,NaN,NaN,-86.03530651664066,-136.23007610518476,-0.9195717509460004,-4.7902245766953655,-3.870652825749365,-27673194,-29553114.8,15.7431460564447,39.08552006147933,NaN,NaN,-46.31658900023998,-36.38905654009356
2001-09-27T09:30:00-04:00,86,86.99001,84.8,86.75,4621500,6899920.35,31.50074290114543,28.174981893318996,NaN,NaN,-77.31507809498956,-112.17743868889916,-0.6396243155224246,-4.670183220152396,-4.030558904629971,-23051694,-28877634.6,17.65763551932291,37.40745911486097,NaN,NaN,-44.89896553724789,-37.60475782540132
2001-09-28T09:30:00-04:00,87.25,88.74001,87.05,88.35001,8187102,7169810.45,36.57162003121134,28.029819444278285,NaN,NaN,-52.95193474268011,-86.65509048641391,-0.2917737864807801,-4.395276137730946,-4.103502351250166,-14864592,-24058034,29.897206027275274,36.556804912859555,NaN,NaN,-42.09131844962225,-38.24569505743288
2001-10-01T09:30:00-04:00,87.85001,88.7,87.35001,88.67999,5514602,7316820.55,37.59762148030612,27.76507055729247,NaN,NaN,-45.54647688854871,-71.85696016844585,0.000016850511822319447,-4.1034812881103875,-4.10349813862221,-9349990,-19726152.8,38.714773856039585,35.678708205945306,NaN,NaN,-39.53581674885877,-38.42999815620801
2001-10-02T09:30:00-04:00,88.32001,89.7,88.03999,89.7,4846199,7419170.5,40.786141939638156,28.1726195761675,NaN,NaN,-31.20109477624098,-58.60997820381997,0.28541015003475767,-3.746735451078763,-4.032145601113521,-4503791,-15888652.2,45.28089740353112,34.87938897788559,NaN,NaN,-36.44304166175877,-38.14614722842955
2001-10-03T09:30:00-04:00,88.75,91.64999,88.64999,91.2,7744301,7650720.55,45.21905389825341,29.285431260370522,NaN,NaN,-10.515886908947643,-43.50609428228135,0.581814267009026,-3.304877767352238,-3.886692034361264,3240510,-9705911.4,53.85843856805414,34.55600065602422,NaN,NaN,-32.44919360720619,-37.33229671111192
2001-10-04T09:30:00-04:00,91.89999,91.98,90.39999,90.89999,8187102,7774765.7,44.501475569458925,30.15329419597623,NaN,NaN,2.821716748287223,-27.478735313625997,0.7533832519985735,-2.944962969363047,-3.6983462213616205,-4946592,-6084891,58.00993793720168,34.191461764298644,NaN,NaN,-29.38959575527979,-36.197625145993044
2001-10-05T09:30:00-04:00,90.5,91.5,89.57201,91.12,8077301,7995095.75,45.18840427020758,31.849117086920398,NaN,NaN,4.7543616257098655,-15.93747603994801,0.8691834137344268,-2.6118669541935873,-3.481050367928014,3130709,-2485830.8,61.69861000698099,34.876075699203604,NaN,NaN,-26.67302273232653,-34.8369676583264
2001-10-08T09:30:00-04:00,90.2,91.62,90.05,90.7,4774301,7802870.75,44.0670678381947,33.38293169578109,NaN,NaN,15.700467824595682,-3.6880870973191335,0.9011333338100433,-2.3546337006654596,-3.255767034475503,-1643592,-944551.2,63.18991790998965,36.26300284722016,NaN,NaN,-24.672186408999274,-33.38485605127967
2001-10-09T09:30:00-04:00,90.99001,91.10001,90.14999,90.63,2580700,7580540.7,43.87166696666497,35.05103280510737,NaN,NaN,25.335853987350145,7.6193026553990935,0.8991349964449507,-2.131848288919315,-3.0309832853642655,-4224292,-888651.4,63.24581292959377,38.223399313264004,NaN,NaN,-23.045673118815586,-31.907829918070515
2001-10-10T09:30:00-04:00,90.2,92.78999,90.07001,92.55,6862500,7629985.6,50.37188592773118,37.42341009325393,NaN,NaN,67.24439330129495,23.171358697447573,1.0009111456137765,-1.7798443533470447,-2.780755498960821,2638208,-1009111.8,63.02372287496941,40.58150867784592,NaN,NaN,-19.743960046159163,-30.170134222083178
2001-10-11T09:30:00-04:00,93.10001,94.55,92.95,94.2,14720301,7842040.7,55.17610529947824,40.18521883810014,NaN,NaN,128.9932170805481,48.40565876389975,1.142883810384506,-1.3521507359801888,-2.495034546364695,17358509,3451908.4,67.56598889264735,43.856123244890156,NaN,NaN,-15.393522720884095,-28.05918972191188
2001-10-12T09:30:00-04:00,93.2,93.99001,92,93.59,6561398,7733765.7,53.12846848432424,41.96654781854439,NaN,NaN,120.66109731752853,71.58700590226348,1.155775647099178,-1.0503149874907223,-2.2060906345899003,10797111,4985188.8,68.9766110383437,47.417595715298546,NaN,NaN,-12.287844724773493,-25.8061404366064
2001-10-15T09:30:00-04:00,93,93.7,92.47,93.57001,3774700,7260620.6,53.05897750911154,43.58861225844195,NaN,NaN,111.29432870289006,90.70577807792236,1.1221051234561414,-0.8034592302697234,-1.9255643537258649,7022411,6718389.4,70.53654304124504,51.24280300440281,NaN,NaN,-9.744400451871464,-23.511606153072837
2001-10-16T09:30:00-04:00,93.89999,94.3,93.03,93.95,4446000,7142120.6,54.28309193761017,45.38016600380975,NaN,NaN,110.15103991690985,107.66881526383429,1.08398356350987,-0.5705848993385274,-1.6545684628483974,11468411,9856930,73.16765132819587,55.34455338095647,NaN,NaN,-7.252412183971691,-21.188864157486957
2001-10-17T09:30:00-04:00,95.10001,95.17999,92.00999,92.00999,14080801,7347380.55,47.47602110104827,46.52125730380281,NaN,NaN,84.24357072675869,111.06865074892706,0.894542977539375,-0.5363897409241787,-1.4309327184635536,-2612390,8806810.4,70.8867027547183,59.14662961205614,NaN,NaN,-6.829697650688706,-19.13755465651578
2001-10-18T09:30:00-04:00,92.25,92.57001,91.45,91.99001,2822400,6979395.45,47.41008206425022,47.29543316330559,NaN,NaN,54.13618319971473,96.09724397276037,0.7406823308124457,-0.5050798049479965,-1.2457621357604423,-5434790,4248150.6,61.8697853651987,61.43038527905067,NaN,NaN,-6.4991554668584195,-17.332069057993298
2001-10-19T09:30:00-04:00,91.64999,92.35001,90.853,91.89999,3465800,6526010.45,47.092723443597556,47.97365473211212,NaN,NaN,41.34141223783901,80.23330695682247,0.6110301760191748,-0.4819744157364738,-1.0930045917556486,-8900590,308610.4,55.32078943646741,62.61652924908123,NaN,NaN,-6.30405802133046,-15.756638909898607
2001-10-22T09:30:00-04:00,91.89999,94.14999,91.7,94.05,3788200,6317760.5,54.86394583474257,48.97921215319101,NaN,NaN,85.85656609023575,75.1457544342916,0.6449088352794128,-0.2868685476563826,-0.9317773829357954,-5112390,-2118349.8,51.69075466545197,63.07437619636129,NaN,NaN,-3.920422494262559,-14.06575085052203
2001-10-23T09:30:00-04:00,94.39999,94.53999,92.8,93.60001,3764900,6140100.4,53.10576842947327,49.54254890542099,NaN,NaN,90.55476900775894,71.22650025246142,0.612113661756635,-0.16663530574000163,-0.7787489674966366,-8877290,-6187490,46.21515698084,62.52842751156028,NaN,NaN,-2.4007953492065988,-12.399328636048397
2001-10-24T09:30:00-04:00,93.64999,94,92.85001,93.45,2824700,6082240.4,52.5017482439318,50.113996953597635,NaN,NaN,76.99344245070546,69.77647459725077,0.5569966906587842,-0.08250310417315632,-0.6394997948319405,-11701990,-8005410,43.97400417161092,61.52586081401808,NaN,NaN,-1.295057221742832,-10.813004148290458
2001-10-25T09:30:00-04:00,92.5,94.99,91.74001,94.98,3780300,6040180.4,57.776692864618376,51.013160424626975,NaN,NaN,90.84485763821733,77.11820948495128,0.5967229772508567,0.10640392673163035,-0.4903190505192263,-7921690,-8502790,43.3545348527427,60.215569731572494,NaN,NaN,1.2105180989551094,-9.095358112969663
2001-10-26T09:30:00-04:00,94.42999,96.10001,94.25,95.24001,3639500,5812800.3,58.617773125356834,52.05249651656713,NaN,NaN,134.73688357520226,95.79730375242393,0.6114048155143967,0.2739369688737696,-0.3374678466406271,-4282190,-7579110,44.90670887430586,58.90962622902365,NaN,NaN,3.5343711683794723,-7.291111072776929
2001-10-29T09:30:00-05:00,95.05,95.50999,92.05,93.06,3040800,5689110.2,49.68190846457743,52.467513766418016,NaN,NaN,54.99535640427573,89.62506181523193,0.45250974121742543,0.22816932988115468,-0.22434041133627075,-7322990,-8021230,44.28125045344376,57.55501462358437,NaN,NaN,3.036836373345342,-5.815690009045176
2001-10-30T09:30:00-05:00,92.10001,92.14999,90.67999,91.14999,4090800,5651340.25,43.434449314448294,51.97198257975496,NaN,NaN,-65.8325172035582,58.34760457296852,0.2093489712246645,0.03734580269455989,-0.1720031685301046,-11413790,-8528530,43.53203696088119,56.162751344006644,NaN,NaN,0.5779219260485925,-4.902316875460352
2001-10-31T09:30:00-05:00,91.92,92.42999,90.60001,90.67999,4741699,5501210.15,42.03373353281126,51.03324173927875,NaN,NaN,-75.20858780394573,27.90719852203829,0.01753991045645259,-0.15007828045953886,-0.16761819091599145,-16155489,-9419229.8,42.18254690839678,54.34964834513159,NaN,NaN,-1.8567561454855785,-4.467236771178242
2001-11-01T09:30:00-05:00,91.14999,92.99001,90.14999,92.5,3984800,5291095.05,48.905249842967656,50.73158326489613,NaN,NaN,-42.82619650881833,1.1729876926311533,0.014075165412353347,-0.15002423415054977,-0.16409939956290312,-12170689,-10269029.6,40.880441249770854,52.34277907451925,NaN,NaN,-1.8373456429265178,-4.091538038570853
2001-11-02T09:30:00-05:00,92.5,93.57001,92.12,93.41,2647400,5019600,51.97097571012642,50.653868850682905,NaN,NaN,19.358716252115038,-21.902645771986283,0.07073582388902874,-0.07567961970161718,-0.14641544359064593,-9523289,-11317249.4,39.27017859023807,50.10946732801875,NaN,NaN,-0.858272374637997,-3.629642943723302
2001-11-05T09:30:00-05:00,94.25,94.87,94.05,94.5,2273500,4894559.95,55.42125805200101,50.735166430282256,NaN,NaN,105.92191406660486,-11.71733423952046,0.17343763336139498,0.07038159811109779,-0.10305603525029719,-7249789,-11302609.2,39.3061373959091,47.69078776142684,NaN,NaN,1.0502474140588889,-2.9610871783258466
2001-11-06T09:30:00-05:00,94.25,96.14999,93.85001,96.14999,3113200,4921184.95,60.094546808207056,51.63648969507931,NaN,NaN,162.4401503199091,33.937199265173,0.3349552998653108,0.3156380895813413,-0.019317210283969488,-4136589,-9847169,42.9242879394522,45.693472417479256,NaN,NaN,4.219488464734609,-1.9352906578886386
2001-11-07T09:30:00-05:00,95.38,96.60001,95.267,95.75,2955300,4725824.95,58.49367620412085,52.42817499078436,NaN,NaN,175.5456872008878,84.08805426613972,0.39328221777485384,0.4722855619345978,0.07900334415974397,-7091889,-8034449,47.15007198829033,44.642064319128664,NaN,NaN,6.276696110037186,-0.7621496910420924
2001-11-08T09:30:00-05:00,96.3,97.39999,95.66,96.23,3953300,4187474.9,59.875053823330575,53.34119858933672,NaN,NaN,180.78306546841864,128.8099066615871,0.43913611644075023,0.6279234897106818,0.18878737326993156,-3138589,-6228029,51.0402364556124,44.33631053478188,NaN,NaN,8.37920307839267,0.5437578474485878
2001-11-09T09:30:00-05:00,95.77,96.5,95.28,96.31,2739100,3996360,60.11331840294927,53.71615377278005,NaN,NaN,132.7486034395599,151.48788409907607,0.4482404855846883,0.7490879802507919,0.3008474946661036,-399489,-4403269,54.67002050594214,44.54911523767404,NaN,NaN,10.15514420281917,1.9168130410729567
2001-11-12T09:30:00-05:00,95.2,96.12,94,95.53,4122500,4013750,56.585245691325554,53.96468786291236,NaN,NaN,78.0433907273475,145.91217943122462,0.37792887388662644,0.7732585870243867,0.3953297131377602,-4521989,-3857709,55.72684625844866,45.228521614646084,NaN,NaN,10.687891871345137,3.169824302540411
2001-11-13T09:30:00-05:00,96.78999,97.85001,96.61,97.8,4026200,3992760,63.33036124068841,54.73816021982355,NaN,NaN,158.5090646318544,145.12596229361367,0.4553092131027785,0.9644662295162334,0.5091570164134549,-495789,-3129549,57.1623760819277,46.17054817966871,NaN,NaN,13.271895371496267,4.612977312391248
2001-11-14T09:30:00-05:00,98.45,98.89,97.58,98.55,2772100,3427324.95,65.25128817169777,55.27205988461493,NaN,NaN,165.07717227857145,143.0322593091504,0.5231630098376391,1.1631107787105037,0.6399477688728646,2276311,-1255909,60.69400130647641,47.40908149779255,NaN,NaN,16.01116051397966,6.241289198332449
2001-11-15T09:30:00-05:00,98.3,99.25,98.21001,99.14,3540500,3463229.95,66.7278788877179,55.851353153355014,NaN,NaN,159.95033102549442,138.86571242056556,0.5700855256218635,1.352554675900194,0.7824691502783305,5816811,535171,63.76898786095166,48.75638713969581,NaN,NaN,18.728075426801325,8.025115802399432
2001-11-16T09:30:00-05:00,99.16,99.34,98.00999,98.87,3945800,3487229.95,65.35912894026362,56.97115461590403,NaN,NaN,137.0203370445109,139.72005914155574,0.5452464330868227,1.464027191636859,0.9187807585500363,1871011,989271,64.52670501093112,50.20249103665919,NaN,NaN,20.571592261606582,9.817469582286167
2001-11-19T09:30:00-05:00,99.45,100.14,98.89999,100.10001,2794300,3437534.95,68.52644999818357,58.76344037902796,NaN,NaN,149.59964164743914,154.03130932557409,0.5712150679760888,1.6327995935201471,1.0615845255440584,4665311,2826731,67.48949858083617,51.913738295227404,NaN,NaN,23.132187013447478,11.719572072452069
2001-11-20T09:30:00-05:00,99.7,99.99001,99.05,99.13,3313500,3414964.95,63.58863262838339,60.30307602871169,NaN,NaN,121.16810518728511,146.5631174366602,0.48596563191664854,1.6690415654398691,1.1830759335232206,1351811,3196251,68.06711921844196,53.7626363173735,NaN,NaN,23.871000744740538,13.455490454207563
2001-11-21T09:30:00-05:00,99.10001,99.10001,98.12,98.39999,3219200,3434689.95,60.07995346308727,61.101269144434525,NaN,NaN,84.9598732791628,130.5396576367785,0.3496844052852619,1.620181440129798,1.2704970348445361,-1867389,2367511,65.26637430270164,55.504488678297115,NaN,NaN,23.45843111327908,14.884481976932065
2001-11-23T09:30:00-05:00,98.55,99.95,98.45,99.89999,874200,3289384.95,64.42376781311356,61.99075429464789,NaN,NaN,99.98216658546349,118.54602474877234,0.33007855506401906,1.68309522867456,1.353016673610541,-993189,1005511,60.83600087939245,57.04490455609386,NaN,NaN,24.407620718373042,16.24493036856649
2001-11-26T09:30:00-05:00,99.95,100.14999,99.10001,99.8,2250800,3219949.95,63.92442701232234,62.59812350609941,NaN,NaN,94.88123797814681,110.1182049354995,0.28177040173807133,1.70522967578313,1.4234592740450587,-3243989,-17489,57.66949565628471,58.356573003263556,NaN,NaN,25.027430737917243,17.49957327847374
2001-11-27T09:30:00-05:00,99.5,100.14301,98.41,98.92,5033602,3319590.05,59.54979064814298,62.559212351809116,NaN,NaN,72.98144443833557,94.79456549367879,0.16758396640864204,1.6329392320558611,1.465355265647219,-8277591,-2606069.4,50.50588108395522,58.89811537072806,NaN,NaN,24.27733545963476,18.4678250186396
2001-11-28T09:30:00-05:00,98.42,98.49001,97.16,97.3,3206500,3275375.05,52.43570265477856,62.126499955427526,NaN,NaN,25.1698773795393,75.59491993212961,-0.029514887165339898,1.4284616566905441,1.457976543855884,-11484091,-5173249.8,44.59019833590066,58.71526725270021,NaN,NaN,21.38898254294484,18.885133236397493
2001-11-29T09:30:00-05:00,97.55,98.81,97.06,98.8,2597700,3168175.1,57.49864203950009,61.956756256582494,NaN,NaN,36.68615852077195,65.94017698045145,-0.06907100911055775,1.3716377824676869,1.4407087915782446,-8886391,-6577050.2,41.71301112333846,58.0490368718235,NaN,NaN,20.449264050941558,19.108580495618074
2001-11-30T09:30:00-05:00,98.42,99.14999,98.10001,98.59,3416100,3139740.1,56.590450374510134,61.7051228259797,NaN,NaN,45.314136128160946,55.006570888990936,-0.11677958003182232,1.2947343165384666,1.411513896570289,-12302491,-8838910.6,37.512954839648316,56.82353218137395,NaN,NaN,19.42007175114936,19.153079246408257
2001-12-03T09:30:00-05:00,98.10001,98.10001,97.21001,97.8,1779200,3096330.1,53.18701122533189,61.46239179269445,NaN,NaN,-2.0054094201979717,35.629241409321985,-0.20384506663898883,1.1567075632715529,1.3605526299105417,-14081691,-11006451,33.98180534694731,55.27031497340956,NaN,NaN,17.52200236109332,18.920068262791837
2001-12-04T09:30:00-05:00,98.3,99.45,97.58,99.45,2617500,3113530.1,58.76505361598754,61.136298390930094,NaN,NaN,48.104978453860696,30.653948212426986,-0.15483488499549902,1.1670090236661679,1.321843908661667,-11464191,-11643771,32.99824567968412,53.5443056589636,NaN,NaN,17.564676851018714,18.72644091825282
2001-12-05T09:30:00-05:00,99.73,101.7,99.60001,101.2,2938700,3104805.1,63.7047876914685,61.02583407091372,NaN,NaN,152.96885052824925,56.21374284216897,-0.01636963901895916,1.301381859887968,1.3177514989069272,-8525491,-11052051,34.882735501026914,51.70064381571721,NaN,NaN,19.218404652080054,18.796721451656712
2001-12-06T09:30:00-05:00,101.22,101.95,101,101.3,3566000,3135340.1,63.970397580325,60.82887112038565,NaN,NaN,174.84222850710148,83.84495683943487,0.06564389567132767,1.3998063684960869,1.3341624728247592,-4959491,-10266671,37.399450513230924,49.81710543373715,NaN,NaN,20.603178402720204,19.05478673038007
2001-12-07T09:30:00-05:00,100.82001,101.24001,100.17,100.89999,3954900,3135420.1,62.01538360917575,60.59003216816509,NaN,NaN,125.80690585426181,99.94351078465505,0.07591622056725011,1.4290577485338218,1.3531415279665717,-8914391,-9589051,39.569574779883844,48.03445327437663,NaN,NaN,21.16116687374045,19.355698179431553
2001-12-10T09:30:00-05:00,100.35001,101,99.35001,99.39999,2329600,3114945.1,55.20244852622063,59.6383177773106,NaN,NaN,66.19785656458919,113.58416398161248,-0.029687767668725273,1.3160318183806652,1.3457195860493905,-11243991,-9021511,41.401827902060084,46.171048225892626,NaN,NaN,19.54929141753521,19.383354356303503
2001-12-11T09:30:00-05:00,99.78999,100.49001,98.8,99.05,3352000,3076420.1,53.71953402122807,58.93338216251379,NaN,NaN,24.74232205748072,108.91163270233649,-0.12892623251820456,1.1845617954016348,1.3134880279198393,-14595991,-9647871,39.961748222026394,44.16352172614866,NaN,NaN,17.78931049574533,19.155633804795194
2001-12-12T09:30:00-05:00,99.39999,99.64999,98.11,99.23,3120900,3031155.1,54.398023305120375,58.52753000837329,NaN,NaN,-18.7692608276781,74.56401043115102,-0.18485609370879463,1.082417910783846,1.2672740044926407,-11475091,-10237791,38.599965828058195,42.258778263674124,NaN,NaN,16.538109809414323,18.781701805455068
2001-12-13T09:30:00-05:00,98.3,98.78999,97.52,97.60001,2976500,3041375.1,47.59360519647975,57.3253755357566,NaN,NaN,-103.96427099957073,18.802710529816583,-0.3257970343129666,0.8600277116014325,1.1858247459143991,-14451591,-12136211,34.52284419711469,40.37926707208287,NaN,NaN,13.327188263979783,18.00248558524431
2001-12-14T09:30:00-05:00,97.81,98.78999,97.60001,98.60001,3638200,3046260.1,51.59403367787278,56.444633154724485,NaN,NaN,-68.999779909231,-20.158626622881975,-0.3440505405479686,0.7557615702294385,1.099812110777407,-10813391,-12516011,33.75469033418726,38.67106669193304,NaN,NaN,11.779155885192829,17.11343848523696
2001-12-17T09:30:00-05:00,98.35001,99.60001,98.34,99.3,2435500,2970745.1,54.22793357303706,56.06450050650263,NaN,NaN,-8.791175670998715,-35.15643306999956,-0.3028108373573788,0.7212985640806835,1.0241094014380623,-8377891,-11942791,36.066855087796306,37.63970769220741,NaN,NaN,11.266990113332746,16.278231574964927
2001-12-18T09:30:00-05:00,99.86,100.39999,99.61,100.39999,1557500,2908905.1,58.087394226770215,56.4681927616449,NaN,NaN,75.91623454779834,-24.921650571936038,-0.2002265637827192,0.7738261967096633,0.9740527604923825,-6820391,-10387671,41.98309101157653,37.45348574046998,NaN,NaN,12.001036114527526,15.667203652045298
2001-12-19T09:30:00-05:00,99.60001,101.17,99.36,101.16,2250900,2855775.1,60.56173307219434,56.68698497826592,NaN,NaN,98.1801925898495,-1.53175988843052,-0.08581071157061493,0.8667893710291139,0.9526000825997288,-4569491,-9006551,46.70041230206992,37.80972868180793,NaN,NaN,13.370199582629283,15.339060213557296
2001-12-20T09:30:00-05:00,100.8,101.07001,100.10001,100.21001,2260600,2807845.1,56.103251717022104,56.652185074159625,NaN,NaN,80.95123533178794,35.45134137784122,-0.07890954827932906,0.8539631472505675,0.9328726955298966,-6830091,-7482251,51.39744603760544,38.801478053090584,NaN,NaN,13.192371183080962,15.032390352060677
2001-12-21T09:30:00-05:00,100.55,100.77,100.00999,100.5,2951100,2911690.1,57.14050398142761,56.93457741388075,NaN,NaN,70.94742576687749,63.44078251306291,-0.060445801878394545,0.8573154431819034,0.917761245060298,-3878991,-6095371,55.26060890495212,40.32139259294807,NaN,NaN,13.349162095464756,14.791929172546974
2001-12-24T09:30:00-05:00,100.52,100.78,100.39999,100.49001,372500,2817775.1,57.09045644480242,56.81496333022467,NaN,NaN,73.55527368619259,79.91007238450118,-0.05470900706763482,0.8493749862257545,0.9040839932933893,-4251491,-5270091,57.42903459753593,42.066448944223204,NaN,NaN,13.463088127475102,14.602094737536707
2001-12-26T09:30:00-05:00,100.49001,101.8,100.46001,101.13,1462000,2639195,59.535598757994705,56.51716412069083,NaN,NaN,98.42476399016118,84.41177827297375,-0.01564505319335474,0.8845276768016959,0.9001727299950506,-2789491,-4463911,59.4943458368789,43.82442111106976,NaN,NaN,14.239938106973707,14.550358076027706
2001-12-27T09:30:00-05:00,101.12,101.55,100.89,101.49001,1850300,2571385,60.88583682920656,56.296838352753795,NaN,NaN,100.64417242145346,84.90457423929453,0.024427910040593304,0.9307076175457922,0.9062797075051989,-939191,-3737851,61.314649008943924,45.53264957504926,NaN,NaN,15.268783285516852,14.65299024881187
2001-12-28T09:30:00-05:00,101.7,101.94,101.13,101.16,1401100,2511555,58.94416742358777,56.07746576806894,NaN,NaN,99.10819562069162,88.53596629707526,0.018941469307554804,0.9299565441396425,0.9110150748320877,-2340291,-2839891,63.49937767878676,47.241921210685184,NaN,NaN,15.629633896514886,14.792510769912301
2001-12-31T09:30:00-05:00,101.34,101.47,99.66,99.8,1706300,2426065,51.63600584043962,55.82271986194173,NaN,NaN,23.01806876001844,78.95009489570346,-0.08058784190609003,0.8102802724494751,0.8908681143555651,-4046591,-2873411,63.355541784613536,48.81004363086758,NaN,NaN,13.86843172336463,14.660499477548347
2002-01-02T09:30:00-05:00,100.48,100.89999,99.39999,100.85001,2843500,2479280,56.15580006608688,55.99673886514593,NaN,NaN,21.846537222523793,68.6083476029697,-0.0798590274954527,0.7910443299862493,0.870903357481702,-1203091,-2263731,64.91234862036404,50.592229373605974,NaN,NaN,13.638333186320587,14.514475721658668
2002-01-03T09:30:00-05:00,100.8,101.99001,100.63,101.95,1465800,2421695,60.33753229186214,56.420989507056056,NaN,NaN,108.08952562053017,70.5412999290435,-0.012956946206810982,0.8547071747231882,0.8676641209299992,262709,-1653291,66.44927834221201,52.58146598175983,NaN,NaN,14.710029109228243,14.542411919882893
2002-01-04T09:30:00-05:00,102.36,102.95,102.02,102.82001,2288900,2389205,63.317573801038044,57.544130121667365,NaN,NaN,177.11604457990038,85.83567436073288,0.07726688429669548,0.9642477263008686,0.8869808420041732,2551609,-955131,68.16670412487157,54.98459883374246,NaN,NaN,16.543619292729964,14.828298687432474
2002-01-07T09:30:00-05:00,102.87,103.14,101.89,102.14,2485200,2335165,59.55131894336142,58.11250764063084,NaN,NaN,150.19580375001638,96.05319598659783,0.078283890978461,0.9848357057272494,0.9065518147487884,66409,-473791,69.33227670583621,57.525855003145956,NaN,NaN,16.948775955824978,15.131224011488547
2002-01-08T09:30:00-05:00,101.55,102.25,101.3,101.74001,5034199,2389129.95,57.38893828711871,58.33829369163667,NaN,NaN,94.67806840448188,110.38519591549053,0.04102627294081984,0.9578346559248132,0.9168083829839934,-4967790,-658030.8,68.30140753104082,59.828323034806274,NaN,NaN,16.646703847698646,15.347721130947132
2002-01-09T09:30:00-05:00,101.95,102.99001,100.72,100.86,3587500,2452024.95,52.842731572056096,57.96367493058567,NaN,NaN,69.90300228010202,119.99648892700615,-0.048995294625961305,0.8555642647015418,0.9045595593275031,-8555290,-2128470.6,60.561856775764845,61.155377732248304,NaN,NaN,15.022016013553156,15.301191828462278
2002-01-10T09:30:00-05:00,100.95,101.16,100.39999,100.89999,2766300,2422739.95,53.02484321288839,57.42532565492096,NaN,NaN,17.081100085008153,101.79480381990176,-0.1085452833251741,0.7688779551710354,0.8774232384962095,-5788990,-3338810.4,55.0339404867621,61.750629745440605,NaN,NaN,13.755865036133116,15.08043085812954
2002-01-11T09:30:00-05:00,100.92,101.10001,99.85001,100.07001,2473600,2390374.95,48.811631372629535,56.904495630321485,NaN,NaN,-24.10348794802832,61.550897314316025,-0.20114662424776086,0.6259899581865085,0.8271365824342694,-8262590,-5501650.2,46.81124528760942,61.423043977583745,NaN,NaN,11.420644927890152,14.55760429666677
2002-01-14T09:30:00-05:00,99.74001,99.86,98.91,99.14999,3472000,2415149.95,44.58284268615599,56.00751982351637,NaN,NaN,-117.54287780262976,8.003161003786806,-0.3148972857309603,0.4335149752705689,0.7484122610015292,-11734590,-7861850,39.81946047639807,60.320104804115594,NaN,NaN,8.10774033637434,13.636195159482138
2002-01-15T09:30:00-05:00,99.35001,99.98,98.72,99.5,2979800,2382229.95,46.48242008989915,55.24980294102328,NaN,NaN,-121.53571944596949,-35.23959656630346,-0.35417287178240386,0.30569617127352444,0.6598690430559283,-8754790,-8619250,37.86495659543622,58.92267066110848,NaN,NaN,5.88765199967636,12.529260422367027
2002-01-16T09:30:00-05:00,98.60001,99,97.05,97.14,5160602,2518485.05,37.218618703863186,53.65573293715674,NaN,NaN,-243.8503361465195,-97.99026425162776,-0.5168493077604759,0.01380740835533345,0.5306567161158093,-13915392,-9691270.4,35.22919391634238,57.18944552392729,NaN,NaN,0.648573224907967,10.832019394158591
2002-01-17T09:30:00-05:00,97.849,98.75,97.52,98.23,3493700,2615295.05,42.88077660417183,52.36965720679712,NaN,NaN,-180.3104252023553,-137.46856930910047,-0.5269942939255845,-0.1280861512911713,0.3989081426344132,-10421692,-10617810.8,33.08554745978718,55.17308112755895,NaN,NaN,-1.9002544760321451,9.013123126988486
2002-01-18T09:30:00-05:00,97.48,98.38,97,97.89999,3446800,2675090.05,41.655843619142814,51.13477693505105,NaN,NaN,-173.92071983691122,-167.43201568687704,-0.5304242996364692,-0.26412223191117334,0.26630206772529585,-13868492,-11738991.2,30.654774483516945,52.82703804218254,NaN,NaN,-4.323183199785425,7.107936508877927
2002-01-22T09:30:00-05:00,98.34,98.55,97,97.28,1951100,2659615.05,39.37987490692829,50.25933901122881,NaN,NaN,-151.0085879543272,-174.12515771721652,-0.546762581003444,-0.4171511585290091,0.12961142247443486,-15819592,-12555991.6,28.98371619707177,50.371907643072404,NaN,NaN,-7.040603777883936,5.0867164679119465
2002-01-23T09:30:00-05:00,97.45,97.83,96.88,97.39999,3672900,2695705.05,40.062425066785565,49.10981222556444,NaN,NaN,-134.809874984763,-176.77998882497522,-0.5218650623771923,-0.5227199054970555,-0.0008548431198632245,-12146692,-13234372,27.636574168724422,47.709352325098145,NaN,NaN,-9.029883181676999,3.070059375113526
2002-01-24T09:30:00-05:00,97.94,98.66,97.75999,98.08,3954400,2874800.05,43.916397271595834,47.93687400983113,NaN,NaN,-84.32187351842605,-144.87429629935656,-0.4354983081222179,-0.5452277282726357,-0.10972942015041773,-8192292,-12089752,33.27216044381841,45.3395581894986,NaN,NaN,-9.599967354911104,1.260055556538579
2002-01-25T09:30:00-05:00,97.66,99.06,97.57001,98.48,3244800,2963940.05,46.11140302368806,46.707861811448986,NaN,NaN,-67.06867513064581,-122.22594628501463,-0.3320083111135983,-0.5247398090424156,-0.1927314979288173,-4947492,-10994912,38.2276663862831,43.20105549388514,NaN,NaN,-9.443375421650888,-0.2690060117742019
2002-01-28T09:30:00-05:00,98.86,99.03999,98.00999,98.88,1713400,2957095.05,48.29087664400911,45.903544504352396,NaN,NaN,-49.59452974376163,-97.3607082663847,-0.2224541998322374,-0.4707992477191141,-0.24834504788687667,-3234092,-8868032,46.53443499048874,41.57263822850318,NaN,NaN,-8.69039115021194,-1.4720610315510216
2002-01-29T09:30:00-05:00,98.95,99.21001,96.10001,96.19,4651500,3119615.05,37.35058069268049,44.47223324760681,NaN,NaN,-102.92768192650477,-87.74452706082027,-0.3115317898263886,-0.6377597851698624,-0.3262279953434738,-7885592,-7281232,51.7478106038363,40.390238447988565,NaN,NaN,-11.551928138072528,-2.91204204676838
2002-01-30T09:30:00-05:00,96.5,97.88,95.3,97.84,6106801,3339640.1,45.505717769130946,43.94816083311216,NaN,NaN,-99.02286468173644,-80.58712500021497,-0.2427595826492044,-0.6296774736549793,-0.3869178910057749,-1778791,-5207651.8,57.570175498161234,40.17654692815974,NaN,NaN,-11.199564233938366,-4.095973787792664
2002-01-31T09:30:00-05:00,98.05,99.31,97.78999,99.24001,3945600,3394745.1,51.298514634620275,43.82485164895015,NaN,NaN,-22.879261648810527,-68.29860262629185,-0.09405581298839644,-0.5044876572412704,-0.410431844252874,2166809,-3135831.6,62.44606400919239,40.705984322619045,NaN,NaN,-8.851039484409668,-4.7752688873093785
2002-02-01T09:30:00-05:00,99.11,99.56,98.64,99.28,3651500,3504030.1,51.457247447115826,44.01382422569917,NaN,NaN,-1.9983526593238208,-55.28453813202744,0.010373287256542463,-0.3974652351821959,-0.40783852243873836,5818309,-982671.4,66.72564404901757,42.12844137700534,NaN,NaN,-7.002379605451649,-5.093427561329703
2002-02-04T09:30:00-05:00,99.10001,99.10001,96.78,97,6935102,3736340.2,42.8767166957195,43.89195808352514,NaN,NaN,-67.78921277637292,-58.92347473854969,-0.06650244824154405,-0.4909665827406684,-0.42446413449912435,-1116793,-559211.6,67.50982849389062,44.10632480682624,NaN,NaN,-8.327186382104221,-5.555393107154634
2002-02-05T09:30:00-05:00,96.55,97.84,96.10001,96.8,5755801,3899870.25,42.21177879712632,43.5869122768985,NaN,NaN,-101.21548872326014,-58.581036097900764,-0.12009427596672773,-0.574581979457534,-0.45448770349080625,-6872594,-356612,67.89961773559483,46.25165774540899,NaN,NaN,-9.568335728854878,-6.1286706245403835
2002-02-06T09:30:00-05:00,97.03,97.48,96.14999,96.63,4406199,3868470.25,41.62093188018927,43.90136321806466,NaN,NaN,-106.21436155892394,-60.019335473338266,-0.15409458015641853,-0.6471059286863294,-0.4930113485299109,-11278793,-2256612.4,60.56165696662793,48.061119391857964,NaN,NaN,-10.732708049308515,-6.786390256650116
2002-02-07T09:30:00-05:00,96.73,97.60001,96.14999,96.17,2955200,3836855.25,39.989817791014936,43.69486615998203,NaN,NaN,-110.5274560402913,-77.54897435163443,-0.19218885460530322,-0.7332474167865399,-0.5410585621812367,-14233993,-5536772.8,50.42917203957461,49.29994971898564,NaN,NaN,-12.181682596886251,-7.557146305255278
2002-02-08T09:30:00-05:00,96.60001,97.72,95.85001,97.62,4380000,3917540.25,47.03591838914336,44.07915721498206,NaN,NaN,-74.71885840935184,-92.09307550164002,-0.10852241031766252,-0.6767115750783148,-0.5681891647606523,-9853993,-8671233.2,43.02187237432155,50.18331385404311,NaN,NaN,-11.258592598905702,-8.085924347205339
2002-02-11T09:30:00-05:00,97.60001,99.11,97.34,98.85001,2169100,3902315.25,52.16665765836436,44.992498840084636,NaN,NaN,48.42428666752879,-68.85037561285968,0.033283456976811565,-0.5265848435396379,-0.5598683005164494,-7684893,-9984853.2,40.34712760732653,50.99498609763274,NaN,NaN,-8.80919260529536,-8.189248384075341
2002-02-12T09:30:00-05:00,98.46001,99.24001,98.2,98.78999,1341100,3795770.25,51.90244213829641,45.83821434519255,NaN,NaN,82.83839608580695,-32.03959865104626,0.12169372979181547,-0.4077511382766801,-0.5294448680684956,-9025993,-10415533,39.48047540184956,51.84097904285596,NaN,NaN,-6.9479603100044,-8.01192151635092
2002-02-13T09:30:00-05:00,99.16,100.19,98.996,100.05,3350100,3814285.25,56.84405406911936,46.761618402158504,NaN,NaN,172.12032170527755,23.627338001794033,0.25596593198255313,-0.20948745309030414,-0.4654533850728573,-5675893,-9294953,42.91619853699774,52.52983890665449,NaN,NaN,-3.7668335129556576,-7.40548037300874
2002-02-14T09:30:00-05:00,100.39999,100.78999,99.75,100.3,6436102,3878060.25,57.771110084800625,47.59445462080941,NaN,NaN,181.76493091382886,82.08581539261806,0.3469048555315979,-0.03182231565835991,-0.3787271711899578,760209,-6296112.6,50.94262334336778,53.43805011787482,NaN,NaN,-0.9077350332706788,-6.477231038760445
2002-02-15T09:30:00-05:00,100.10001,100.17999,99.03,99.14999,3843500,3895550.25,52.21458293134192,47.874719355618886,NaN,NaN,102.17642107467499,117.46487128942343,0.3157801170325058,0.015997975100674466,-0.29978214193183134,-3083291,-4941972.2,54.08229649706878,53.97718308263054,NaN,NaN,-0.08106032367247412,-5.563492365176449
2002-02-19T09:30:00-05:00,98.60001,98.89999,97.37,97.52,3716300,3909025.25,45.53021380562043,48.45897886368603,NaN,NaN,-12.264615954186574,105.32709076508036,0.17842892110938008,-0.07674599054510622,-0.2551749116544863,-6799591,-4764911.8,54.492412167636736,54.17322605147343,NaN,NaN,-1.4910622021663245,-4.981716627603574
2002-02-20T09:30:00-05:00,97.97,99.92,97.39999,99.82001,7177102,4170325.35,54.40085098874723,49.09434552223006,NaN,NaN,65.25570915416026,101.81055337875102,0.23209395947346317,0.03494253768734268,-0.1971514217861205,377511,-2884211,58.710792235251816,54.254698675551325,NaN,NaN,0.30977344182444433,-4.225789474828143
2002-02-21T09:30:00-05:00,99.37,100.46001,98.35001,98.38,10841000,4528730.35,49.018414957115134,48.93148125955111,NaN,NaN,60.45804600162187,79.47809823801988,0.16346273478827977,0.007176996699229221,-0.15628573808905055,-10463489,-3841730.2,55.87116033507079,53.785062698828355,NaN,NaN,-0.07221716863975125,-3.6324220025155154
2002-02-22T09:30:00-05:00,98.5,100.25,98.049,99.98,8244602,4743240.45,54.415169724580906,49.14276142222719,NaN,NaN,79.02985524071349,58.9310831033968,0.2154101154465229,0.11297690621910306,-0.10243320922741983,-2218887,-4437549.4,54.11715562945477,52.8844563831453,NaN,NaN,1.513796175673534,-2.897247977059937
2002-02-25T09:30:00-05:00,100.06,101.94,99.98,101.61,8931500,5027575.45,59.15840189209001,50.305738936253654,NaN,NaN,172.30283130270573,72.95636514900295,0.3416342290936022,0.32460957713958294,-0.017024651954019268,6712613,-2478368.6,58.70763011232202,52.25572792731897,NaN,NaN,4.521754686009508,-1.837390453764302
2002-02-26T09:30:00-05:00,101.75,102.10001,100.35001,101.12,12740301,5578920.5,57.23054375993876,51.37850786216883,NaN,NaN,148.90233797445904,105.18975593473208,0.3717245825787603,0.4476310762694311,0.0759064936906708,-6027688,-2323988,59.05525297269007,51.62398758711149,NaN,NaN,6.221383547418928,-0.6861370250238406
2002-02-27T09:30:00-05:00,101.89999,102.7,100.64999,101.64999,7881199,5740405.45,58.7946578961385,52.60520257759377,NaN,NaN,156.90463126317965,123.51954035653596,0.4042289149647186,0.581192637396569,0.17696372243185043,1853511,-2028788,59.7529721279406,51.56622438434811,NaN,NaN,8.081833027009607,0.5664301252666519
2002-02-28T09:30:00-05:00,101.85001,102.61,101.10001,101.10001,5257898,5697960.3,56.48610287525434,53.78350865503945,NaN,NaN,137.76940176867987,138.98181150994756,0.36669986988716774,0.6353385597908101,0.26863868990364237,-3404387,-616967.6,63.0003158090008,52.46416322502141,NaN,NaN,8.882150812633146,1.7543902234618651
2002-03-01T09:30:00-05:00,101.78999,104,101.24001,103.84,8305602,5915960.4,64.05780791439443,54.999357906843095,NaN,NaN,175.6569009631747,158.3072206544398,0.49636501139521877,0.8890949541476658,0.39272994275244705,4901215,807052.8,65.98176655021526,54.104155666156664,NaN,NaN,12.203334237916367,3.2470965112410797
2002-03-04T09:30:00-05:00,104.2,106.25,104.08,105.92,8199398,6143355.3,68.53397807888018,56.168452222594226,NaN,NaN,221.51930444776994,168.15051528345265,0.6807766327778089,1.2437007337247081,0.5629241009468993,13100613,2084652.8,68.43898600254609,56.11071698010092,NaN,NaN,16.63207879587372,5.159236837617171
2002-03-05T09:30:00-05:00,105.35001,106.2,104.34,104.78,10712898,6332245.1,63.841207531139034,57.02122117922584,NaN,NaN,172.46520221848647,172.86308813225813,0.682790620065636,1.4164123760289442,0.7336217559633083,2387715,3767733.4,71.37263565368069,58.388728426660286,NaN,NaN,18.598088125890687,7.079072735941959
2002-03-06T09:30:00-05:00,104.64,106.3,104.60001,105.92999,7636801,6426295.1,66.34472388385632,57.699840451707054,NaN,NaN,159.94043049502005,173.47024797862622,0.7149613214189948,1.6273234077370518,0.9123620863180569,10024516,5401934.4,73.90858286379586,60.602470164288725,NaN,NaN,21.040102079333465,9.073505499283602
2002-03-07T09:30:00-05:00,106.49001,106.5,104.85001,105.62,7721199,6592045.1,65.03753339474969,58.21887068813198,NaN,NaN,139.59223112311562,173.83481384951338,0.6695451712976688,1.749293550440143,1.0797483791424742,2303317,6543475.2,75.53866556440539,62.35933032293427,NaN,NaN,22.548887599175934,10.998560084982506
2002-03-08T09:30:00-05:00,106.49001,106.89,105.5,105.99001,6329199,6760745.05,65.90115329223389,59.196482856767126,NaN,NaN,134.92146041826018,165.68772574053045,0.6197498579306384,1.8544357015557722,1.2346858436251338,8632516,7289735.4,76.56924569623988,63.96554098001792,NaN,NaN,24.027077554519806,12.859776866344976
2002-03-11T09:30:00-05:00,105.75,106.72,105.33,106.11,4433898,6763439.95,66.1927926595921,60.67238134633653,NaN,NaN,115.85882001807995,144.55562885459247,0.552451894892837,1.92525071224118,1.372798817348343,13066414,7282895.6,76.5374174118322,65.54018421174617,NaN,NaN,25.306293246171734,14.637850634891656
2002-03-12T09:30:00-05:00,105.28,106.64999,105.13,106.63,7747000,7042334.95,67.49045103690653,61.6073527783479,NaN,NaN,102.32621336841038,130.52783108457723,0.5019800346368215,2.00027386064437,1.4982938260075485,20813414,10968035.4,81.09665961775055,67.1391747390675,NaN,NaN,26.748277519154062,16.367911618357713
2002-03-13T09:30:00-05:00,105.97,106.17999,104.89999,105.32001,9755000,7463029.95,61.125131576599294,62.472118251168204,NaN,NaN,75.7531413426041,113.69037325409404,0.3467704672953278,1.9317569101267082,1.5849864428313805,11058414,11174815,81.31605317950952,68.95666708509884,NaN,NaN,26.18160118691952,17.7698672710094
2002-03-14T09:30:00-05:00,105.33,105.78999,104.96001,105.38,5410699,7566059.9,61.305112727619914,62.964257037099564,NaN,NaN,66.13975159233767,98.99987734793845,0.22068823928842596,1.8608467419419128,1.6401585026534868,16469113,14007974.2,84.04787215445,71.09457540831279,NaN,NaN,25.76781754807367,18.912431596304295
2002-03-15T09:30:00-05:00,105.5,106.17999,105.17,106.14999,9864801,7737494.85,63.63246873088464,63.28383323987061,NaN,NaN,70.52905623939148,86.1213965121647,0.16427945019180856,1.8455078153932476,1.681228365201439,26333914,17548253.8,86.67055930508803,73.09192749351037,NaN,NaN,26.04784685200199,19.931776632832538
2002-03-18T09:30:00-05:00,106.35001,106.78,105.27,105.64999,4858000,7788219.85,61.0640578684097,63.55765567618996,NaN,NaN,65.78576949955522,76.10678640845975,0.07307544377177555,1.7725726699161584,1.6994972261443828,21475914,19230153.8,87.70477613074371,75.1383220047999,NaN,NaN,25.581413693753717,20.738867641535563
2002-03-19T09:30:00-05:00,106.39999,106.85001,106,106.69,9935602,8099184.95,64.29252971056516,63.95036080579187,NaN,NaN,76.33975314511851,70.90949436380139,0.06295682069066233,1.7781932520077106,1.7152364313170483,31411516,21349774.2,88.87615455850909,77.21854932126908,NaN,NaN,26.067592586530004,21.500114062249054
2002-03-20T09:30:00-05:00,105.92999,105.92999,104.92999,104.94,5363301,8008494.9,55.894109955197806,63.9080755972164,NaN,NaN,36.920242101063145,63.14291451549319,-0.07400403161352331,1.6227313918001443,1.6967354234136676,26048215,24347734.4,90.2858294398656,79.16751458061658,NaN,NaN,23.97546626824589,21.853735805962888
2002-03-21T09:30:00-05:00,105,105.08,103.61,104.57001,10392898,7986089.8,54.27970976345081,63.209640015006144,NaN,NaN,2.642389665321801,50.44344213009002,-0.1950497372549964,1.452923251844922,1.6479729890999184,15655317,24184975.2,89.6218080287528,80.85608897194068,NaN,NaN,21.776509828576216,21.842703523479077
2002-03-22T09:30:00-05:00,104.75999,105.03999,103.96001,104.23,4597898,7803754.6,52.77126622870319,62.08373202570779,NaN,NaN,-8.523454777821373,34.632939926647445,-0.2974169100206656,1.2762018515740863,1.573618761594752,11057419,21129676.2,78.02149721003823,81.54055405819011,NaN,NaN,19.515398988127995,21.51023144700035
2002-03-25T09:30:00-05:00,104.19,104.59,102.84,103,5864699,7650414.55,47.61609149944847,60.924795166301315,NaN,NaN,-62.44928153436839,8.985929719862732,-0.4388296932148765,1.0250816450761562,1.4639113382910327,5192720,17873037.4,67.92873563023647,81.29456119937268,NaN,NaN,15.972022319702987,20.7190587145293
2002-03-26T09:30:00-05:00,102.86,104.42799,102.8,103.77,4583801,7242589.55,50.85287946037203,59.81823485033816,NaN,NaN,-67.35288133837611,-19.75259717683619,-0.46866690754566687,0.8780777038589491,1.346744611404616,9776521,13546038.4,57.31917187975334,80.10960327194107,NaN,NaN,13.878317518056104,19.741809972175986
2002-03-27T09:30:00-05:00,103.55,104.64999,103.39999,104.3,5929102,7144984.7,53.00533759353266,58.958792293108374,NaN,NaN,-56.195239384913215,-38.37569347403146,-0.44125465344432024,0.7951762945992158,1.236430948043536,15705623,11477520,53.05324665351603,78.50350192116325,NaN,NaN,12.729267711740894,18.740018220685258
2002-03-28T09:30:00-05:00,104.60001,105.12,103.7,103.71001,4062300,7085204.8,50.36118774763001,57.84879475420809,NaN,NaN,-72.99023818705072,-53.50221904450596,-0.44986597398012873,0.6740984805683752,1.123964454548504,11643323,10675121.2,51.45352640548697,76.70952197182376,NaN,NaN,10.994925781243845,17.6335764436222
2002-04-01T09:30:00-05:00,103.36,103.89999,102.67,103.36,6331301,6986489.75,48.80573160267376,56.606861821571066,NaN,NaN,-146.8026914347105,-81.15806637588379,-0.4642644550376682,0.5436338857514187,1.007898340789087,5312022,9526041.8,49.16713071946807,74.75450149379776,NaN,NaN,9.10229813912745,16.41482240012295
2002-04-02T09:30:00-05:00,102.98,103.354,102.67999,103.16,3131400,6733089.85,47.89542012138112,55.2072167561764,NaN,NaN,-138.5926352624436,-96.38673712149883,-0.47090398367154496,0.4192683611996557,0.8901723448712007,2180622,8923622.2,47.96380387984218,72.38786894109002,NaN,NaN,7.268591881717415,15.108218040350732
2002-04-03T09:30:00-05:00,103.56,103.56,101.45,102.34,7807102,6587800.05,44.25113655365925,54.00193139739497,NaN,NaN,-151.42356288167394,-113.2008734301584,-0.5108259623139453,0.251639891978769,0.7624658542927143,-5626480,5843022,42.26700204026572,69.59865100257261,NaN,NaN,4.629351666333459,13.611237129776836
2002-04-04T09:30:00-05:00,101.95,102.78,101.63,102.23,9099301,6660925.05,43.77001108357342,52.74942413710594,NaN,NaN,-142.93209747418157,-130.54824504801206,-0.5230411427369978,0.10866442587146707,0.6317055686084648,-14725781,-243258.8,33.7405088125568,66.00526790672309,NaN,NaN,2.294891911018657,11.994616384239952
2002-04-05T09:30:00-05:00,103.02,103.48,102.24001,102.94,7602398,6654985,47.721048432795975,51.612894115813894,NaN,NaN,-93.71208025039563,-134.69261346068103,-0.463727297968499,0.05204644614784115,0.5157737441163401,-7123383,-3996600,29.754223563538588,61.939815353755264,NaN,NaN,1.2890378979279995,10.46524802905253
2002-04-08T09:30:00-04:00,101.3,102.75999,101.10001,102.7,4378602,6557455.15,46.53084378570857,50.57480739562095,NaN,NaN,-120.83329253394,-129.49873368052695,-0.42225962802400174,-0.012050790913662013,0.41020883711033973,-11501985,-7359401.4,26.70948431871483,57.58300879575321,NaN,NaN,0.1192380683057506,8.987246606088705
2002-04-09T09:30:00-04:00,103.17,103.228,102.06,102.27,7859801,6728750.3,44.39444560623971,49.15351567388342,NaN,NaN,-93.19019247965261,-120.41824512396877,-0.4053143395206523,-0.09643408729047565,0.3088802522301767,-19361786,-11667883,23.404905721936615,52.90649102171232,NaN,NaN,-1.4643053898950142,7.494167749519603
2002-04-10T09:30:00-04:00,102.42,104.13,102.36,103.89999,7545102,6718655.4,53.1715663085931,48.95904827055451,NaN,NaN,-34.3175286430545,-96.99703827624488,-0.27223996199705464,-0.031419700266141604,0.24082026173091303,-11816684,-12905923.8,22.541856316355492,48.06763579860446,NaN,NaN,-0.4029077203372187,6.366014110968628
2002-04-11T09:30:00-04:00,103.42999,103.82001,101.62,101.75,4403898,6451100.3,43.43309375825174,48.18428998446886,NaN,NaN,-89.4519622344681,-86.3010112283022,-0.3139631029702822,-0.15163361698193967,0.1623294859883425,-16220582,-13204884,22.32774641358553,43.2609171118068,NaN,NaN,-2.5824825378339704,5.087657446853971
2002-04-12T09:30:00-04:00,102.39999,102.55,101.50999,101.99001,5885898,6474860.25,44.65178198053534,47.604326823885444,NaN,NaN,-103.62366450931155,-88.28332808008537,-0.30981894420851136,-0.22494419427229673,0.08487474993621463,-10334684,-13847144.2,21.847643874023106,39.248499016377146,NaN,NaN,-3.935724650639659,3.798602861497738
2002-04-15T09:30:00-04:00,102.22,102.44,100.75,101.02,5137301,6238485.25,40.82375738640808,47.11916010152542,NaN,NaN,-132.33060542417013,-90.58279065813137,-0.3536578037491687,-0.35719750475024625,-0.003539701001077547,-15471985,-14641144.2,21.239607208432105,35.91356127196254,NaN,NaN,-6.303336470871694,2.3554686711592474
2002-04-16T09:30:00-04:00,102.27,103.23,102.01801,103.14,2598200,6125495.25,50.759545274237055,47.11249337394434,NaN,NaN,-38.12698672036151,-79.57014950627315,-0.22727010707324952,-0.28762733484263947,-0.06035722776938994,-12873785,-13343544,24.917257041322614,33.5991387835032,NaN,NaN,-5.04267996841338,1.2985902940774434
2002-04-17T09:30:00-04:00,103.42,103.42,102,102.41,2513800,5754405.15,47.784370539953755,46.73956715583156,NaN,NaN,-44.24063195811545,-81.55477016928535,-0.1821755020370438,-0.2880766053156947,-0.10590110327865089,-15387585,-14057724.2,24.2462025066511,31.541492773012845,NaN,NaN,-5.0162780309733215,0.39646624764162
2002-04-18T09:30:00-04:00,102.39999,102.75,100.62199,101.98,5819199,5777200.05,46.07137509509215,46.433151966364576,NaN,NaN,-106.85595611501317,-85.03556894539436,-0.17083725167824743,-0.3194476678764602,-0.14861041619821275,-21206784,-15054964.6,23.302496380436224,29.530704914080648,NaN,NaN,-5.542116456337868,-0.4519027100697355
2002-04-19T09:30:00-04:00,102.85001,102.91,102.2,102.60001,2326300,5373870.15,48.91503938050917,46.44095966478138,NaN,NaN,-30.484700758017816,-70.40777619513561,-0.11385264244277998,-0.2909262192516877,-0.17707357680890773,-18880484,-16764124.6,21.74066746496861,27.571671824473544,NaN,NaN,-5.081370256132025,-1.1132552166500624
2002-04-22T09:30:00-04:00,102.2,102.46001,101.11,101.38,3830400,5335495.25,43.99863537764715,46.16261789737182,NaN,NaN,-114.81977964330719,-66.90561103896303,-0.148411291734681,-0.362587691477259,-0.214176399742578,-22710884,-18211904.4,20.48800202936222,25.60911454943926,NaN,NaN,-6.252888026085978,-1.8474884751409075
2002-04-23T09:30:00-04:00,101.55,101.89,100.72,101.12,4236102,5254065.4,43.006582703905394,46.07372119381797,NaN,NaN,-142.47218409284153,-87.77465051345902,-0.17693200568660844,-0.43534140685083855,-0.2584094011642301,-26946986,-21026544.6,18.282520854948018,23.895937321916566,NaN,NaN,-7.497045911888714,-2.6545681089620228
2002-04-24T09:30:00-04:00,101.12,101.74001,100.25,100.25,2849700,5167360.35,39.77485529725042,45.78835292336633,NaN,NaN,-172.19940977077113,-113.36640607599016,-0.2386986668862271,-0.556782734772014,-0.3180840678857869,-29796686,-23908364.8,16.342721522839682,22.653238229793914,NaN,NaN,-9.550589437764575,-3.639714013076673
2002-04-25T09:30:00-04:00,100,100.60001,99.3,100.5,4995699,5120690.2,41.14352752571771,45.31853000143217,NaN,NaN,-200.19645258692645,-132.03450537037284,-0.24604550727361074,-0.6256409519778003,-0.3795954447041896,-24800987,-24627205.4,15.889833865755989,21.662924679952305,NaN,NaN,-10.823692625589837,-4.665996672007125
2002-04-26T09:30:00-04:00,100.89999,100.976,98.75,98.84,4237801,5129465.25,35.3920425101216,44.52290133889024,NaN,NaN,-213.53957991636025,-168.6454812020413,-0.3402288751606111,-0.8048815386549535,-0.46465266349434237,-29038788,-26658866.2,14.653828134926997,20.801806381110314,NaN,NaN,-13.80431658202346,-5.971470944866602
2002-04-29T09:30:00-04:00,99.35001,99.5,98.13,98.2,4587301,5042265.25,33.45053909332118,43.74119373082464,NaN,NaN,-226.85304593097626,-191.05213445957514,-0.41803298088427054,-0.9871938895996806,-0.56916090871541,-33626089,-28841907.2,13.44374101109075,20.090294616049892,NaN,NaN,-16.881952310264058,-7.530111139923381
2002-04-30T09:30:00-04:00,98.67,100.2,98.27901,99.49001,3800000,5075695.25,40.53186579640287,42.83835797995391,NaN,NaN,-147.61555625120533,-192.0808088912479,-0.35737075154822306,-1.0158743481506889,-0.6585035966024658,-29826089,-29417727.8,13.13561667477559,19.41842035593704,NaN,NaN,-17.307169077274143,-8.92683370240206
2002-05-01T09:30:00-04:00,99.64,101.06,98.35001,100.94,8628398,5116760.05,47.317536470008285,43.1158181736508,NaN,NaN,-84.58575551282607,-174.55807803965888,-0.20207645014780184,-0.9110991592872182,-0.7090227091394163,-21197691,-27697928.8,19.099539760095823,19.187834166402066,NaN,NaN,-15.42249878597142,-9.854785857197683
2002-05-02T09:30:00-04:00,100.69,101.35001,100.41,101.06,2519700,4787780,47.84790911058112,43.34411296865407,NaN,NaN,-30.730415769823896,-140.66487067623837,-0.0800256647915164,-0.8090547901288119,-0.7290291253372955,-18677991,-26473329.6,23.145844701115763,19.280562796908686,NaN,NaN,-13.773358135527289,-10.414581896959055
2002-05-03T09:30:00-04:00,100.73,100.89,99.45,99.96001,4595199,4637420.05,43.5225556670268,43.53688427441255,NaN,NaN,-72.96533111425018,-112.55002091581635,-0.06288389210880851,-0.8076339904733061,-0.7447500983644976,-23273190,-25320210,26.855669111280847,19.681710075683593,NaN,NaN,-13.703627392716152,-10.884445539210068
2002-05-06T09:30:00-04:00,99.96001,100.34,97.96001,98.10001,4681602,4652570.05,37.370789729494994,42.58054459264526,NaN,NaN,-130.46186211698716,-93.27178415301853,-0.1607543937619036,-0.945693090566877,-0.7849386968049734,-27954792,-24185950.6,30.413877307782883,20.074325809002186,NaN,NaN,-15.693621301801914,-11.57147064815176
2002-05-07T09:30:00-04:00,98.84,99.39,98.08,98.2,5486398,4533899.9,37.87912620917966,41.873027140447114,NaN,NaN,-126.62262041815175,-89.07319698640782,-0.20013345270403826,-1.0351055126850213,-0.834972059980983,-22468394,-22714411.6,34.84240918614451,20.831197714680286,NaN,NaN,-17.090877363515542,-12.359957321775157
2002-05-08T09:30:00-04:00,99.89,101.67999,99.81,101.28,4824500,4397869.8,51.05696212021251,42.229140499384286,NaN,NaN,6.505313843164677,-70.85498311520968,-0.010153472207106051,-0.8476639002398656,-0.8375104280327595,-17643894,-22003652.2,36.930233164209554,21.80460748494981,NaN,NaN,-13.717832307368102,-12.55393946257415
2002-05-09T09:30:00-04:00,101.06,101.58,100.25,100.5,3601000,4357724.9,48.26464812251729,42.18268398095629,NaN,NaN,2.8434365314938903,-64.14021265494611,0.06731220576338193,-0.7533701708285321,-0.820682376591914,-21244894,-22517032.8,36.03214191070983,22.825427088217037,NaN,NaN,-11.995306808086676,-12.474134797647368
2002-05-10T09:30:00-04:00,100.72,100.78999,99.28,99.49001,4668602,4296860.1,44.84464115907868,42.24311296534425,NaN,NaN,-48.44159757788009,-59.23546594767208,0.05536437719516363,-0.7514769050979595,-0.8068412822931231,-25913496,-23045094,35.08696371705278,23.86821006590922,NaN,NaN,-11.737817046326434,-12.368946547458663
2002-05-13T09:30:00-04:00,99.92,101.25,99.33,101.24001,4081200,4244055.05,51.2857354206257,42.83448101653856,NaN,NaN,1.53655984187828,-32.83578155589899,0.16401014721779084,-0.6018285982708846,-0.7658387454886755,-21832296,-21820594.8,39.07775007401969,25.353583581557196,NaN,NaN,-9.282200106053255,-11.927982770115033
2002-05-14T09:30:00-04:00,102.75,103.2,102.14999,103.10001,4455500,4336920.05,57.02956177598311,44.066960050733755,NaN,NaN,145.31922481817992,21.552587491367333,0.3491923884762824,-0.3293482598933224,-0.6785406483696048,-17376796,-20802275.2,42.25707985990396,27.20460917706179,NaN,NaN,-5.1549089331491516,-10.960400793405622
2002-05-15T09:30:00-04:00,102.66,103.73,102.39,102.92999,3680200,4395240.05,56.37521924968834,45.15493803101737,NaN,NaN,154.2575564710131,51.10303601693702,0.44229163407084093,-0.1256761057810536,-0.5679677398518945,-21056996,-21484895.6,40.72289350130965,28.97839915102991,NaN,NaN,-2.201587514776083,-9.709141753601402
2002-05-16T09:30:00-04:00,102.64,103.41,101.95,103.17999,2364100,4222485.1,57.15369161702412,46.70934153865328,NaN,NaN,133.2266766963401,77.17968404990624,0.49859124869028604,0.05527132101096299,-0.44331992767932304,-18692896,-20974496,42.40660267407534,30.960740189540502,NaN,NaN,0.38243303918593624,-8.26748821177464
2002-05-17T09:30:00-04:00,103.22,103.64,102.64,103.42999,2310500,4221695.1,57.96156110828378,48.460128825436314,NaN,NaN,150.35799973746208,116.93960351297468,0.5277378584023926,0.21635239532366768,-0.3113854630787249,-16382396,-19068276,48.31161031358248,33.451302282575625,NaN,NaN,2.7134449364247604,-6.698783476317583
2002-05-20T09:30:00-04:00,103.08,103.17999,102.17,102.49001,2868700,4173610.1,53.850263470889665,49.41144294504251,NaN,NaN,106.1673386211632,137.86575926883165,0.461193012316667,0.2651058023171089,-0.19608720999955812,-19251096,-18552036,49.81235863361839,36.071069565350115,NaN,NaN,3.4992726890650654,-5.241918309834348
2002-05-21T09:30:00-04:00,102.8,102.95,100.92,101.38,2206600,4072135,49.39461037852641,49.55980536707953,NaN,NaN,54.57161817649616,119.71623794049492,0.326256936836646,0.21173396104624942,-0.11452297579039661,-21457696,-19368216,47.46588630028712,38.09723717536378,NaN,NaN,2.835768214345049,-4.087963092094434
2002-05-22T09:30:00-04:00,101.00999,101.75,100.72,101.59,2705500,4064925,50.233562502049665,49.73020918075586,NaN,NaN,30.167804216908806,94.89828748967406,0.2390244846404383,0.18425763001015127,-0.05476685463028703,-18752196,-18907256,48.929119849259855,39.9388996859455,NaN,NaN,2.5350668913456467,-3.1418159516029935
2002-05-23T09:30:00-04:00,102,102.42999,101,102.25999,2511400,3940710.05,52.91552000769638,50.40113520508938,NaN,NaN,53.79025608317697,79.01100336704144,0.2150753106639852,0.21407728369969448,-0.0009980269642907227,-16240796,-18416836,50.50852042956283,41.62838906582278,NaN,NaN,3.0426433999986657,-2.2583217585170425
2002-05-24T09:30:00-04:00,102,102.39999,100.92,101.02,1944000,3826020,47.78307847260044,51.14487011531121,NaN,NaN,25.622154031451412,54.06383422583931,0.10966566307210524,0.13608405187584083,0.026418388803735586,-18184796,-18777316,49.30160268380468,42.97751230696719,NaN,NaN,1.9724511389778048,-1.653925630303493
2002-05-28T09:30:00-04:00,101.34,101.35001,99.75999,100.14,2558300,3724569.95,44.485404905150354,51.616747165023405,NaN,NaN,-38.34022601229612,25.162321299147447,-0.01855231275384463,0.003227997861429799,0.02178031061527443,-20743096,-19075716,48.27329681623988,43.93686142340258,NaN,NaN,0.069626070411737,-1.4077039587727458
2002-05-29T09:30:00-04:00,99.66,100.06,99.31,99.35001,2816200,3675379.95,41.702975316099476,50.9486052504439,NaN,NaN,-89.49258619711811,-3.6505195755754185,-0.1485581962894833,-0.16391743474657972,-0.015359238457096403,-23559296,-19496036,46.792804123584546,44.64133077764365,NaN,NaN,-2.3820472622991113,-1.5468958592765123
2002-05-30T09:30:00-04:00,98.96001,99.71001,98.21001,99.34,5263000,3507110.05,41.66741215716017,50.47737411006124,NaN,NaN,-110.73905998422522,-31.831892415802223,-0.22275448689647243,-0.29380234707768693,-0.0710478601812145,-28822296,-21510056,40.39926688157732,44.953268275562756,NaN,NaN,-4.378291562209042,-1.951380959695445
2002-05-31T09:30:00-04:00,99.85001,100.66,99.2,99.25,4762199,3619235,41.326178662431786,50.22605536030075,NaN,NaN,-68.81310625008817,-56.35256488245525,-0.2626779861046279,-0.3993953428119994,-0.1367173567073715,-33584495,-24978795.8,32.23102075885383,44.74927234997712,NaN,NaN,-6.126140786321224,-2.547775220641985
2002-06-03T09:30:00-04:00,99.28,100.112,96.91,96.95,5602000,3669575.05,33.72505494421996,48.97172104055749,NaN,NaN,-144.33413011385778,-90.34382171151708,-0.41946544861177176,-0.6610491674720862,-0.24158371886031443,-39186495,-29179135.6,25.505982321219506,43.77986036763425,NaN,NaN,-10.180799351562504,-3.638207239344916
2002-06-04T09:30:00-04:00,96.98,97.7,96.11,97.11,5598898,3715439.85,34.62586932186112,47.37145729383449,NaN,NaN,-178.50941804486956,-118.37766011803178,-0.48333442182191483,-0.845751746137708,-0.36241732431579315,-33587597,-31748035.8,22.424304806682315,42.36323357811842,NaN,NaN,-13.2090711259822,-5.005473508864528
2002-06-05T09:30:00-04:00,97.28,98.3,97.10001,98.23,3750000,3628619.95,40.701766454252876,46.25192495130339,NaN,NaN,-131.00613538403678,-126.68036995541551,-0.4232491947760362,-0.8914788177858384,-0.4682296230098022,-29837597,-33003696,21.083407501960608,40.960413149593485,NaN,NaN,-14.069580927493183,-6.30034599724005
2002-06-06T09:30:00-04:00,98.12,98.2,96.13,96.53,4878898,3631339.85,35.3337933362853,44.69336078839347,NaN,NaN,-145.53453385835775,-133.63946473024203,-0.4676227847258835,-1.0527581039171565,-0.585135319191273,-34716495,-34182535.8,19.881442647405123,39.35147314768847,NaN,NaN,-16.55183139595719,-7.764843911342498
2002-06-07T09:30:00-04:00,95.32001,96.64999,94.87,96.22,5917102,3747144.95,34.441762439598975,43.013375169201694,NaN,NaN,-155.90365588463817,-151.057574657152,-0.4853706409327121,-1.1918486203571632,-0.7064779794244511,-40633597,-35592356.2,18.52149937991439,37.22360808099789,NaN,NaN,-18.829191183706754,-9.345464950251678
2002-06-10T09:30:00-04:00,96.25,97.39,95.74001,96.69,3823500,3704889.85,37.03710775299289,41.8124354750662,NaN,NaN,-114.5521788298633,-145.10118440035313,-0.43461559545745365,-1.2497474737462682,-0.8151318782888145,-36810097,-35117076.6,20.495887624820526,35.12957443751233,NaN,NaN,-19.953130207380127,-10.860845701270028
2002-06-11T09:30:00-04:00,97.14999,97.85001,95.25,95.37,4207102,3711184.95,33.0766111588142,40.64686410222962,NaN,NaN,-112.35056148777025,-131.86941308893327,-0.4568279630600235,-1.3861668321138438,-0.9293388690538203,-41017199,-36602997,18.949829262315433,33.09271322051435,NaN,NaN,-22.165489509653302,-12.475794816753353
2002-06-12T09:30:00-04:00,95.14,96.62,94.67999,96.49001,4807199,3728769.9,39.033712412660286,39.84687481013037,NaN,NaN,-107.21144065244007,-127.11047414261392,-0.3668535413258056,-1.3879057957110774,-1.0210522543852718,-36210000,-37877477.6,17.715489612049936,30.863168203570783,NaN,NaN,-22.211634167561886,-13.866629009726001
2002-06-13T09:30:00-04:00,96.06,96.56,95.10001,95.38,3785900,3734054.9,35.64706125584604,38.61341347071249,NaN,NaN,-102.77353572749038,-118.55827451644045,-0.3527577545566909,-1.4619994475811353,-1.1092416930244444,-39995900,-38933358.6,16.742483247641772,28.451308404862136,NaN,NaN,-23.315365698233805,-15.216448536655687
2002-06-14T09:30:00-04:00,94.00999,95.14,92.56,95,7309398,3981319.8,34.54216488322051,37.66763392861392,NaN,NaN,-129.33969054317828,-113.24548144814847,-0.3395686115631631,-1.5337024574783982,-1.194133845915235,-47305298,-40267698.8,15.57805674522001,26.042483694963234,NaN,NaN,-24.54752935143802,-16.54946008162459
2002-06-17T09:30:00-04:00,95.55,97.2,95.39999,97.07001,3785900,4055089.8,44.61326886396603,37.67676706852932,NaN,NaN,-57.14265235960971,-101.76357615409772,-0.17051127190999038,-1.4072729358027232,-1.2367616638927328,-43519398,-41609559,14.48688618232842,23.62916864968384,NaN,NaN,-22.357737073933265,-17.379213937668688
2002-06-18T09:30:00-04:00,96.75,98,96.58,97.89999,2704700,4046889.8,48.06364749262128,38.131100795423734,NaN,NaN,-23.115711291993726,-83.91660611494243,0.008631780657819776,-1.2259719380704581,-1.234603718728278,-40814698,-41569058.8,14.681135278717946,21.33547801790766,NaN,NaN,-19.43112986898851,-17.672344785000092
2002-06-19T09:30:00-04:00,96.50999,97.67999,94.91,95.81,6933602,4283239.9,41.11743178681826,38.09181648325646,NaN,NaN,-64.3905624857888,-75.35243048161219,-0.0016599495395004382,-1.2366786556526534,-1.235018706113153,-47748300,-43876718.8,12.885105246640123,19.37018075826929,NaN,NaN,-19.183655758129863,-17.88824635259006
2002-06-20T09:30:00-04:00,95.64,96.12,94.42,94.47,5505801,4423254.95,37.386700632100826,37.81042519537567,NaN,NaN,-99.10449707130375,-74.61862275037487,-0.08227982906178033,-1.3378684924403785,-1.2555886633785982,-53254101,-46528359,11.190966398709605,17.867319732544694,NaN,NaN,-20.254299486695057,-18.226253943176488
2002-06-21T09:30:00-04:00,93.77,94.41,92.14999,92.82001,4571000,4526234.95,33.37151941500484,37.78517265757459,NaN,NaN,-162.7993960798673,-81.31056385771267,-0.22234910802858776,-1.533525048414333,-1.3111759403857453,-57825101,-48632319.6,10.060662319356837,16.7640825895545,NaN,NaN,-22.55503675945385,-18.844651488358966
2002-06-24T09:30:00-04:00,92.019,94,90.82001,93.14999,6756699,4766869.9,34.87780740856596,37.80316823519637,NaN,NaN,-171.40661016953754,-104.16335541969825,-0.2654736173611749,-1.6430179620872138,-1.377544344726039,-51068402,-50142120.4,9.332244527705768,15.82893542677046,NaN,NaN,-23.85711185283868,-19.56071725471321
2002-06-25T09:30:00-04:00,93.74001,94.24001,91.05,91.17,7920602,5034985,30.432107032185627,37.06962113362014,NaN,NaN,-173.29742570408763,-134.199698302117,-0.392386185995367,-1.8680270772202476,-1.4756408912248806,-58989004,-53776981.6,7.857287176126448,14.884212546353737,NaN,NaN,-26.509535682930373,-20.553405601601376
2002-06-26T09:30:00-04:00,89.36,91.99001,89.05,91.23,7571301,5272740.05,30.720291125190883,36.7400852613991,NaN,NaN,-195.8545650046379,-160.4924988058868,-0.4340807968936162,-2.018241887341901,-1.5841610904482848,-51417703,-54510862.2,7.596242736952391,14.006698267035684,NaN,NaN,-28.471568324004963,-21.68457170480189
2002-06-27T09:30:00-04:00,92.16,92.88,90.3,92.86,6815199,5350350,38.20900721033012,37.00917417359419,NaN,NaN,-125.31267323909816,-165.7341340394457,-0.3189936522934478,-1.9829031558150945,-1.6639095035216467,-44602504,-52780542.8,14.784841272337928,13.73979411649451,NaN,NaN,-27.73767041029061,-22.549300091300278
2002-06-28T09:30:00-04:00,92.62,93.78999,92.42999,92.53,5059199,5365200,37.32925245393498,37.03004165223291,NaN,NaN,-81.18864301161223,-149.4119834257947,-0.23602736902990196,-1.958943714809024,-1.7229163457791221,-49661703,-51147863.2,21.027769960522775,13.777785711901812,NaN,NaN,-27.421286131451776,-23.245298097036205
2002-07-01T09:30:00-04:00,92.67,93.37,91,91.06,4088300,5289515,33.61618858460797,37.06858289693247,NaN,NaN,-105.95013679736363,-136.3206887513599,-0.2497572316662997,-2.035112885361997,-1.7853556536956972,-53750003,-51684183.4,20.496566966470226,13.8882669764843,NaN,NaN,-28.316140871570827,-23.969704207684007
2002-07-02T09:30:00-04:00,91.03999,91.58,89.7,90.25,8247801,5421960.15,31.74258468697694,36.547788059383656,NaN,NaN,-130.28660045837188,-127.71852370221677,-0.2806857177789017,-2.136212800919324,-1.8555270831404225,-61997804,-52285943.4,19.88944790307326,14.043549711557395,NaN,NaN,-29.639133787762745,-24.779622719123825
2002-07-03T09:30:00-04:00,89.8,90.92,89.10001,90.63,7801398,5624530.05,33.6119847623516,36.40242545270548,NaN,NaN,-123.93862041461013,-113.3353347842112,-0.24418988607403125,-2.1607644407329616,-1.9165745546589303,-54196406,-52841684,19.320280952210027,14.227678119026555,NaN,NaN,-30.159384134720348,-25.548160064209043
2002-07-05T09:30:00-04:00,91.60001,94.17,91.49001,94.17,3042400,5532705.15,47.92124957470352,37.358074359239986,NaN,NaN,-22.531151813785666,-92.7790304991487,0.034873405816979064,-1.8729827973877065,-1.9078562032046855,-51154006,-54151984.4,18.011546932186718,14.401498846667037,NaN,NaN,-25.72380796387799,-25.573252621304608
2002-07-08T09:30:00-04:00,93.64999,94.19,92.5,92.96001,4144898,5444094.95,44.39867010155576,37.34274587621068,NaN,NaN,-20.82142713738453,-80.70558732430318,0.14813157504558894,-1.7226917343976993,-1.8708233094432882,-55298904,-55279424.6,16.947753237117865,14.577275064866285,NaN,NaN,-23.284979509160575,-25.24635646242689
2002-07-09T09:30:00-04:00,92.78,93.49001,90.91,91.19,5230602,5514450.05,39.79085960587952,36.75183245572912,NaN,NaN,-62.030087286816645,-71.92157742219379,0.1154523352725787,-1.7265078903525648,-1.8419602256251435,-60529506,-56635325.2,15.743477114928325,14.653156624595596,NaN,NaN,-22.802146765388734,-24.897183648564294
2002-07-10T09:30:00-04:00,91.55,91.60001,88,88.3,8988301,5753510,33.650151213052894,36.21845527188874,NaN,NaN,-143.0869559873106,-74.48164852798152,-0.07872282996124813,-1.9403637630767037,-1.8616409331154555,-69517807,-58139325.8,14.511687074521134,14.769341040872813,NaN,NaN,-24.612563074965774,-24.856523566621647
2002-07-11T09:30:00-04:00,87.61,88.8,86.17,88.14,10064898,6016394.95,33.34335410547797,35.92964480570139,NaN,NaN,-176.8771985681762,-85.06936415869474,-0.18953988208144001,-2.0985657857172555,-1.9090259036358155,-79582705,-63216585.6,11.297999563000474,14.776986266893589,NaN,NaN,-26.087245837311396,-25.03234103386304
2002-07-12T09:30:00-04:00,88.5,88.7,86.11,86.64999,8371301,6245665,30.549980283552898,35.72810629631197,NaN,NaN,-170.2217035113669,-114.60747449821099,-0.3267466021512684,-2.317459156324901,-1.9907125541736326,-87954006,-70576585.6,8.395533500579958,14.65804849412381,NaN,NaN,-28.250204678299756,-25.492035840211145
2002-07-15T09:30:00-04:00,86.41,86.97,82.5,86.78999,19684400,6864415.1,31.133760907210203,35.46067440335799,NaN,NaN,-190.15531393339424,-148.47425185741292,-0.36853310004990547,-2.4513789292360144,-2.082845829186109,-68269606,-73170726,7.649592867999857,14.537859089859102,NaN,NaN,-29.7587568346004,-26.101567410838182
2002-07-16T09:30:00-04:00,85.5,86.56,84.16,85.05,11732602,7261750.2,27.98521942670385,35.28589671725215,NaN,NaN,-164.61646058611078,-168.99152651727178,-0.4674581423387538,-2.667168507109551,-2.199710364770797,-80002208,-77065266.4,6.688757780330889,14.454392704445135,NaN,NaN,-32.074521833100235,-26.954846614018475
2002-07-17T09:30:00-04:00,86.62,87.5,84.55,85.46001,9673398,7610185.1,29.78710453701251,35.219240532382265,NaN,NaN,-131.77370200872826,-166.72887572155528,-0.45873729423974297,-2.773131982570476,-2.314394688330733,-70328810,-77227467,6.651286621668845,14.386895839067739,NaN,NaN,-33.38976708704746,-27.87412096730833
2002-07-18T09:30:00-04:00,85.56,86.45,83.85001,83.85001,8068301,7666920.05,26.936940641596124,34.414092920329836,NaN,NaN,-139.82805380723636,-159.31904676936733,-0.5108700127626804,-2.9529822042840834,-2.442112191521403,-78397111,-76990348.2,7.467389078139718,13.864220682339294,NaN,NaN,-35.422030188555354,-28.95239371320076
2002-07-19T09:30:00-04:00,82.597,83.10001,79.60001,80,16164500,8199855,21.611582908877622,33.29140223854002,NaN,NaN,-191.78198749137587,-163.63110356536913,-0.7401995136952793,-3.367361583640502,-2.6271620699452227,-94561611,-78311869.2,7.095094023436616,12.869029543975998,NaN,NaN,-39.22565099282107,-30.42000189600366
2002-07-22T09:30:00-04:00,79.37,81.49001,77.10001,78.06,24645696,9203589.8,19.51769425348992,32.284366929174446,NaN,NaN,-190.7629360741502,-163.75262799352032,-0.9449912530951496,-3.80840113631416,-2.8634098832190102,-119207307,-88499409.4,5.01809153714089,11.76342415616676,NaN,NaN,-43.11183209637936,-32.23312049605733
2002-07-23T09:30:00-04:00,78.33,79.21001,76.75999,77.17,21735008,9952505.25,18.626110508525628,31.347475916427925,NaN,NaN,-176.56955456267573,-166.1432467888333,-1.0545053043336647,-4.181541513636091,-3.1270362093024264,-140942315,-100687430.8,3.6437929303179715,10.603020229541382,NaN,NaN,-46.48776717622713,-34.26949859322445
2002-07-24T09:30:00-04:00,75.75,82.5,75.28,82.10001,24785200,10795735.15,36.05225601547061,31.521781005936425,NaN,NaN,-120.95129136338645,-163.97876465976495,-0.7247373664503853,-4.032957917365408,-3.308220550915023,-116157115,-109853091.8,2.9823200528109908,9.43602302244145,NaN,NaN,-43.038779729995284,-35.522253041334565
2002-07-25T09:30:00-04:00,81.75,83.2,79.25,81.78,20979392,11466139.7,35.52052008165879,30.636014613576087,NaN,NaN,-86.85170598417304,-153.38349509515228,-0.4703151566499866,-3.896114496727506,-3.4257993400775195,-137136507,-121600971,2.384757976396074,8.319823811313546,NaN,NaN,-40.641901595539295,-36.253631406220954
2002-07-26T09:30:00-04:00,82.55,82.95,81.16,82.85001,9383301,11594544.8,38.77229526983989,30.234130697024955,NaN,NaN,-65.4457974936619,-128.11625709560946,-0.18667564973632,-3.6591439022479193,-3.4724682525115993,-127753206,-128239290,2.125584537820288,7.261097475649434,NaN,NaN,-37.6372124213281,-36.45128583695055
2002-07-29T09:30:00-04:00,84.39999,87.38,84.28,86.72,14891301,12086149.9,48.82462470850186,30.879399632926546,NaN,NaN,-0.896068542804246,-90.14288358934027,0.2795214952328786,-3.1230663834705013,-3.40258787870338,-112861905,-126970209.6,4.267591450760818,6.441391356780327,NaN,NaN,-31.30497250534434,-35.71609821814966
2002-07-30T09:30:00-04:00,86.35001,87.75,85.41,87.05,15083801,12635924.95,49.58472285456665,32.017583321606104,NaN,NaN,14.668683856932564,-51.89523590541862,0.6091524285456735,-2.641147343021288,-3.2502997715669615,-97778104,-118337367.4,17.495171586450994,6.654497393346745,NaN,NaN,-26.212617809135164,-34.35845815971902
2002-07-31T09:30:00-04:00,86.63,87.39,85.396,87.14999,10756898,12761379.8,49.827886332510175,33.19504990925126,NaN,NaN,17.374730530733526,-24.230031526594615,0.8198394254476424,-2.225500489757408,-3.0453399152050507,-87021206,-112510185.6,25.025665845481015,7.635044984952499,NaN,NaN,-22.168807695746658,-32.61707952200868
2002-08-01T09:30:00-04:00,86.86,87.27,84.75999,84.87,12715602,13007090,44.5512502720188,34.19514062271311,NaN,NaN,2.6245642950072363,-6.334777470758555,0.7911767633930844,-2.0563689609636953,-2.8475457243567797,-99736808,-105030245.8,33.42559508737743,9.422906526866603,NaN,NaN,-20.324462910958832,-30.860991434715846
2002-08-02T09:30:00-04:00,84.7,85.14999,82.03,83.2,12993602,13504650.1,41.11669078935486,34.9082070428663,NaN,NaN,-33.67669685386617,0.0190426572005822,0.6511218010554916,-2.033643473037415,-2.6847652740929067,-112730410,-102025686.6,36.50299270595439,11.48386365814907,NaN,NaN,-19.869790685355873,-29.29081989909299
2002-08-05T09:30:00-04:00,82.89999,83.25,80.3,80.47,8641500,13729480.2,36.203211771604764,35.49520649607351,NaN,NaN,-69.90081644336274,-13.781906922911116,0.3794594535438218,-2.2104409571631294,-2.589900410706951,-121371910,-103727687.6,35.50186110632768,13.541942467148841,NaN,NaN,-21.10603328308321,-28.121564668234452
2002-08-06T09:30:00-04:00,82.05,84.33,81.85001,83,12134500,14074675.1,43.00118341006768,36.4390692727203,NaN,NaN,-22.887096143459896,-21.29306292298961,0.3743651826506307,-2.1219439323936626,-2.4963091150442933,-109237410,-106019548.8,34.14389495651899,15.505700205352422,NaN,NaN,-19.869546947543736,-26.942704993850064
2002-08-07T09:30:00-04:00,84.01401,84.85001,82.25,84.64999,12801398,14265329.95,46.969886115275756,37.86999394941171,NaN,NaN,5.671547748393265,-23.63369947945766,0.4796042316844442,-1.896803825438738,-2.3764080571231823,-96436012,-107902510,33.026172912361346,17.331327622082537,NaN,NaN,-17.538744342489593,-25.599282043655712
2002-08-08T09:30:00-04:00,85.08501,87.35001,84.34,87.25,14269301,14475550.1,52.57366144634504,40.08157098780224,NaN,NaN,75.15140433705044,-9.128331471049021,0.7080162052093413,-1.4913878006115056,-2.199404005820847,-82166711,-104388490.6,37.16046525169355,19.478854138386602,NaN,NaN,-13.657604883649194,-23.893328163654783
2002-08-09T09:30:00-04:00,86.55,88.24001,85.82001,87.60001,12694102,14691690.15,53.28925280471491,42.49382517003259,NaN,NaN,100.41949141745513,17.69090618321524,0.8564533927257298,-1.1288372649136846,-1.9852906576394145,-69472609,-95736930.4,45.998869836831936,22.406052588364535,NaN,NaN,-10.393884561942452,-21.96483622055302
2002-08-12T09:30:00-04:00,86.38499,87.49001,85.98,86.99001,8905898,14152765.05,51.82170829751173,44.864939297817315,NaN,NaN,84.96872326632077,48.66481412515194,0.8837649851243019,-0.8805844262340372,-1.7643494113583391,-78378507,-87138249.8,53.06469133522617,25.936116760143694,NaN,NaN,-8.198214205024673,-19.9981759326204
2002-08-13T09:30:00-04:00,86.536,87.69,84.72,84.95,12008398,14166554.85,47.14564504450529,45.65732422846265,NaN,NaN,55.43827472081591,64.3298882980071,0.7404515056876793,-0.83878502924874,-1.5792365349364192,-90386905,-83368148.8,55.795742070315974,29.708504047108335,NaN,NaN,-7.73982569699283,-18.24698304181646
2002-08-14T09:30:00-04:00,85,87.85001,83.7,87.47,15180301,14441900,52.81024567159718,46.89230462774396,NaN,NaN,69.10844587253446,77.01726792283534,0.7870278126138535,-0.5954517691691024,-1.3824795817829558,-75206604,-79122267.2,58.70966508192689,33.73171169750339,NaN,NaN,-5.540419578997242,-16.431759689985142
2002-08-15T09:30:00-04:00,88.05,88.95,87.03,88.33,15213102,14799140.05,54.59854765668595,48.022751226804395,NaN,NaN,105.35103369961081,83.05719379534742,0.8424506343613385,-0.3294162888312826,-1.171866923192621,-59993502,-74687625.4,61.5598582796135,37.97701696477434,NaN,NaN,-3.1998971844998705,-14.54149361777296
2002-08-16T09:30:00-04:00,87.62,88.56,87.12,87.73,8888602,14435345.15,53.087010274050805,48.327207338629314,NaN,NaN,88.80462028679948,80.73421956921628,0.8054190197357431,-0.1650931485229421,-0.9705121682586852,-68882104,-74569524.4,61.63580895684995,42.074746786637846,NaN,NaN,-1.7335066387976101,-12.711781192205054
2002-08-19T09:30:00-04:00,87.53,90.13,87.5,89.92,9594602,13682790.45,57.69113160100063,48.90623653480317,NaN,NaN,116.21100118157938,86.982675152268,0.888595583147883,0.14023231067616848,-0.7483632724717145,-59287502,-70751323.4,64.10508421476382,45.40402626008876,NaN,NaN,0.9554530917678361,-10.759319151637499
2002-08-20T09:30:00-04:00,89.32001,89.64,88.25,89,10107602,13101420.15,55.238545412597446,49.292712183380836,NaN,NaN,109.1159159854153,97.7182034051879,0.8422578272865,0.30445901163641054,-0.5377988156500895,-69395104,-66552963.2,66.64712398868534,48.37698755603193,NaN,NaN,2.4600432524869107,-8.870838808191154
2002-08-21T09:30:00-04:00,89.45,90.004,88.00999,89.95,12030301,12463675.2,57.25913890295571,50.20041851416204,NaN,NaN,118.46575343393853,107.5896649174687,0.8345914623249863,0.5054405122561434,-0.3291509500688429,-57364803,-62984603,68.6775132629292,50.894981711428485,NaN,NaN,4.309416506092438,-6.9879451918649265
2002-08-22T09:30:00-04:00,89.75,91,89.35001,90.63,9014102,11865410.7,58.696390357272755,51.45611134044189,NaN,NaN,145.9555637000454,115.7105709175556,0.8324324875156033,0.7113896593256612,-0.12104282818994203,-48350701,-60656042.8,69.96254150341203,53.28494948267546,NaN,NaN,6.262439778390709,-5.095033053256978
2002-08-23T09:30:00-04:00,89.89,91.005,88.39999,88.72,8042000,11798345.65,53.27713642842288,52.675677387357474,NaN,NaN,103.99473019522281,118.7485928992403,0.6666535838741647,0.712274151652764,0.045620567778599186,-56392701,-58158162.2,71.32172577267397,55.84351124455734,NaN,NaN,6.405748993309053,-3.452064189461831
2002-08-26T09:30:00-04:00,88.998,89.72701,87.60001,89.33,8066102,11457085.7,54.715147453987306,53.512389104780304,NaN,NaN,77.01826409425264,110.91004548177493,0.56631235720381,0.7535110142833616,0.18719865707955166,-48326599,-55965981.6,72.49789660364937,58.58308279078093,NaN,NaN,6.931052606613207,-1.96876179002254
2002-08-27T09:30:00-04:00,89.985,90.44,87.95,88.5,9351801,11170485.7,52.35403920571226,53.89697146838291,NaN,NaN,71.77607146088131,103.44207657686816,0.4190580753158404,0.7110212512243521,0.29196317590851173,-57678400,-53622640.8,73.7378121418135,61.491057021456086,NaN,NaN,6.7123902618636,-0.7285972111816628
2002-08-28T09:30:00-04:00,87.763,87.99001,86.58,87.08,8161301,11040705.85,48.498118041384146,53.60586122517142,NaN,NaN,10.802377865758443,81.90940146323213,0.2115113722842878,0.5563523912638715,0.3448410189795837,-65839701,-55317620.4,71.23608500046004,63.925029860653694,NaN,NaN,5.4153861074692475,0.14911469148275303
2002-08-29T09:30:00-04:00,86.20399,87.64,85.06,86.75,9045398,10857195.65,47.62034791727538,53.20093944749716,NaN,NaN,-16.18698391623583,49.480891939975876,0.04613366522529189,0.40250810051119856,0.3563744352859067,-74885099,-60624500,63.92351883141721,65.2053619316955,NaN,NaN,4.093130099444637,0.7125454640487364
2002-08-30T09:30:00-04:00,86.2,88.03799,86.05,86.52,9528898,10683960.45,46.9821036146986,52.855253398724805,NaN,NaN,-9.559954401467028,26.769955020637912,-0.07786734100273451,0.2590402590324885,0.336907600035223,-84413997,-66228759.2,57.2409938192393,65.50366925198216,NaN,NaN,2.8145940243009817,1.0128381155133428
2002-09-03T09:30:00-04:00,85.52,85.66,83.11,83.16,12021801,10852975.5,38.800664998345795,52.259183395427705,NaN,NaN,-138.7739775582549,-16.388493309863602,-0.3690057074296004,-0.12434953425177753,0.2446561731778229,-96435798,-75850599,47.969142371976744,64.9446264163865,NaN,NaN,-0.9084383952367732,0.7383700425490405
2002-09-04T09:30:00-04:00,83.595,84.78999,82.95,84.14,11734699,10832985.45,41.974522490043185,51.48520316817385,NaN,NaN,-145.13337748741566,-59.770383099522995,-0.4718308793708443,-0.34513242603573246,0.12669845333511182,-84701099,-81255138.8,43.688475149267475,63.871684278339394,NaN,NaN,-3.1185152997802237,0.18738642221628854
2002-09-05T09:30:00-04:00,83.138,83.95,82.14999,83.39999,13514301,10868630.6,40.27595516798078,50.46216084755205,NaN,NaN,-174.21913663705035,-96.77468600008476,-0.5599263457449772,-0.5732094788461097,-0.013283133101132522,-98215400,-87730278.6,39.177584654250715,62.27295044795635,NaN,NaN,-5.466946727535096,-0.6203754563196235
2002-09-06T09:30:00-04:00,84.313,85,83.89999,84.52,9178301,10614080.6,43.97147218775109,49.811050984244936,NaN,NaN,-108.09772127556037,-115.15683347194968,-0.5141930916557447,-0.6560244976708134,-0.14183140601506872,-89037099,-90560678.6,37.361631743936385,60.53908064703394,NaN,NaN,-6.4227330502764595,-1.449283684027743
2002-09-09T09:30:00-04:00,83.883,85.83,83.3,85.17999,8296801,10394215.55,46.088410809687424,48.982285213436846,NaN,NaN,-85.24536477724115,-130.2939155471045,-0.41516145266615734,-0.6607832218477654,-0.24562176918160805,-80740298,-89825938.8,38.162915545537004,58.68606859923203,NaN,NaN,-6.628936131733687,-2.1892340337000205
2002-09-10T09:30:00-04:00,85.77,86.5,85.17999,86.49001,8951199,10396480.6,50.1172050576358,48.61647518808245,NaN,NaN,-34.73369831499212,-109.48585969845195,-0.2454851877996383,-0.5524782539311559,-0.3069930661315176,-71789099,-84896599,43.394623421031255,57.02517570154246,NaN,NaN,-5.649541117529446,-2.683563617104224
2002-09-11T09:30:00-04:00,87.396,87.99001,85.67999,85.67999,6677699,10129945.65,47.74150525500418,47.93664421322876,NaN,NaN,-21.890183498636752,-84.83722090069617,-0.17516143982879329,-0.5259448659175092,-0.35078342608871593,-78466798,-83649738.8,44.669800237205635,55.31033905684791,NaN,NaN,-5.490495344287451,-3.084553863844685
2002-09-12T09:30:00-04:00,85.32001,85.42,83.74001,84.14,7141102,9727985.7,43.517933963238654,46.85246875651204,NaN,NaN,-89.08620014965848,-67.81063360321778,-0.2169821634472514,-0.6220111303977802,-0.4050289669505288,-85607900,-81128238.8,47.2574173230505,53.68854447253637,NaN,NaN,-6.585181658713256,-3.5846435488259094
2002-09-13T09:30:00-04:00,83.44,83.87,82.7,83.53,9613398,9448000.5,41.93537159389036,46.042342696902566,NaN,NaN,-111.82474219719377,-68.55603778754445,-0.2670562224056279,-0.7388492449575637,-0.4717930225519358,-95221298,-82365078.6,46.11809067967226,51.88828482303625,NaN,NaN,-7.956877066242371,-4.209248337028261
2002-09-16T09:30:00-04:00,83.05,84.2,82.75,84.14999,5978000,9302470.4,44.15812897061088,45.28826994808997,NaN,NaN,-90.3836834395993,-69.58370152001609,-0.24057458367745954,-0.7725112521487603,-0.5319366684713007,-89243298,-84065678.6,44.52848432830286,49.8904696605115,NaN,NaN,-8.495427531036466,-4.8215596504580045
2002-09-17T09:30:00-04:00,85.02,85.28999,81.998,82.16,13075500,9476515.3,38.997862742751515,44.33425734359277,NaN,NaN,-97.15752704986605,-82.06846726699087,-0.33351203610204916,-0.9488267135988622,-0.615314677496813,-102318798,-90171618.4,39.29181248102302,47.43004111331218,NaN,NaN,-10.520149797866928,-5.635643957230708
2002-09-18T09:30:00-04:00,81.412,82.89999,80.77,81.42,11650102,9553640.3,37.25443123201439,43.53113685720922,NaN,NaN,-127.47149800663429,-103.18473016859039,-0.4158955435127034,-1.1351841068876922,-0.7192885633749888,-113968900,-97272038.8,34.2478991912682,44.78802784122705,NaN,NaN,-12.73328161622074,-6.6495921942292835
2002-09-19T09:30:00-04:00,80.495,81.49001,79.5,79.64,12834898,9593870.15,33.38786303935872,42.51453079450089,NaN,NaN,-154.88058179043068,-116.34360649674481,-0.5527678233614433,-1.4102483425767929,-0.8574805192153496,-126803798,-105511218.4,29.513443810157966,42.33016533970853,NaN,NaN,-15.881575532528954,-7.968446956843522
2002-09-20T09:30:00-04:00,79.88,81.25,79.2,79.67,9374000,9611865.05,33.51311071834944,41.55245987333309,NaN,NaN,-150.20154654548372,-124.0189673664028,-0.5998476978782215,-1.6072901415631264,-1.007442443684905,-117429798,-109952918.4,27.32074694375646,40.19300484860262,NaN,NaN,-18.383696316096987,-9.45633972245116
2002-09-23T09:30:00-04:00,79.02699,79.23,77.03,78.8,9102500,9664890.05,31.6543139574963,41.04200622755813,NaN,NaN,-184.81123324134788,-142.90447732675253,-0.6442481506786095,-1.8127526320331668,-1.1685044813545573,-126532298,-117410718.4,24.085151051886967,38.4870054685962,NaN,NaN,-21.06395381016576,-11.11457030641039
2002-09-24T09:30:00-04:00,77.71001,78.8,76.60001,77.07001,15202102,10021690.05,28.293718628023512,40.064805951699576,NaN,NaN,-185.23292861547705,-160.5195576398747,-0.738055829605289,-2.0910742683611687,-1.3530184387558797,-141734400,-125293838.8,21.22388233590567,36.88239169621322,NaN,NaN,-24.47766774012335,-13.023584225512241
2002-09-25T09:30:00-04:00,78.05,79.09,76.64999,78.66,11780000,10143100,35.112117441214366,39.69596039978769,NaN,NaN,-144.59749518701983,-163.94475707595183,-0.644357901101343,-2.1584658151325584,-1.5141079140312155,-129954400,-128490938.8,20.176975391417784,35.525205320296585,NaN,NaN,-25.38713139571827,-14.789805249827388
2002-09-26T09:30:00-04:00,79.17999,80.27,78.60899,79.81,11282000,10299134.95,39.586636338082435,39.38275783909707,NaN,NaN,-89.52125933393518,-150.87289258465273,-0.4646574025941268,-2.094929667273874,-1.6302722646797472,-118672400,-126864659.2,22.277151140699843,34.44774242006541,NaN,NaN,-24.785718466306673,-16.21779285218157
2002-09-27T09:30:00-04:00,79.21001,79.5,76.85001,76.85001,10729801,10383355.1,33.234141808975565,38.46459576761765,NaN,NaN,-119.97895373514793,-144.8283740225856,-0.5017032683311746,-2.2574013500937156,-1.755698081762541,-129402201,-129259139.8,21.38500183210877,33.249320011963384,NaN,NaN,-26.329396949289624,-17.662307723197006
2002-09-30T09:30:00-04:00,76.05,76.96001,74.60001,76,17216192,10767719.8,31.66282473447484,37.146425744534724,NaN,NaN,-145.4620563983853,-136.95853865399306,-0.53686207306968,-2.426775673099641,-1.889913600029961,-146618393,-133276358.8,19.942066335990532,31.574137363031912,NaN,NaN,-28.084733438930794,-19.151225682587548
2002-10-01T09:30:00-04:00,76.67,80.05,75.95,80,15772301,10955244.8,44.871914982724164,36.94145501080044,NaN,NaN,-68.90177003110742,-113.69230693711913,-0.2582550969383268,-2.2127324712028695,-1.9544773742645427,-130846092,-131098697.2,22.976048267742698,30.02458365092742,NaN,NaN,-24.964719950286383,-19.981724863687383
2002-10-02T09:30:00-04:00,79.06,79.88,77.28999,77.92,13695898,11053304.75,40.48920110466234,36.72511694947355,NaN,NaN,-68.47953340143393,-98.46871458000194,-0.1850136264818838,-2.1857444073668972,-2.0007307808850134,-144541990,-134016215.2,21.784883888849393,28.205116977055912,NaN,NaN,-23.959835481018334,-20.550026380448948
2002-10-03T09:30:00-04:00,78.48,79.39999,77,77.38,13746398,11064909.6,39.412928397185766,36.54494243542323,NaN,NaN,-71.38343540927767,-94.84114979507045,-0.1456298295402525,-2.182768067810329,-2.0371382382700767,-158288388,-141939412.8,18.91666344967713,26.262157889199113,NaN,NaN,-23.542389666961103,-20.977506849950686
2002-10-04T09:30:00-04:00,77.939,78.00999,74.81,75.96001,16881600,11450074.55,36.65376204464292,36.00891622642551,NaN,NaN,-100.93551462038884,-91.03246197211864,-0.18535891628336953,-2.2688368836242887,-2.083477967340919,-175169988,-151092970.2,16.2541297966292,24.24256113693671,NaN,NaN,-24.109537885964777,-21.424939855095555
2002-10-07T09:30:00-04:00,75.23,76.64999,74.14,74.74001,13420102,11706239.6,34.42399410024227,35.68221132338913,NaN,NaN,-117.90529357155843,-85.52110940675328,-0.259406396421201,-2.40773596286742,-2.148329566446219,-188590090,-159487309.6,14.27045815947993,22.45532154254078,NaN,NaN,-25.29638010552872,-21.97800274801458
2002-10-08T09:30:00-04:00,75.293,76.5,73.39999,75.39,21139104,12315634.85,36.63565032157238,35.638012686928995,NaN,NaN,-113.37560456669958,-94.41587631387172,-0.2311526566022417,-2.437270387199021,-2.2061177305967794,-167450986,-166808288.4,12.80294122950967,20.923538830986598,NaN,NaN,-25.566561613728812,-22.490654014545182
2002-10-09T09:30:00-04:00,74.03,74.74001,72.89999,73.12,20803200,13021909.9,32.51167657740996,35.575427939646936,NaN,NaN,-144.8434832495449,-109.68866628349392,-0.3260796982559162,-2.613717353416675,-2.2876376551607587,-188254186,-175550727.6,11.3075285722405,19.623116313992494,NaN,NaN,-27.129296683801556,-23.15331725301038
2002-10-10T09:30:00-04:00,73,75.8,72.03,75.42,21248704,13727290,39.894354379092995,36.03123105827148,NaN,NaN,-117.20736723950206,-118.85345264953878,-0.20084790970715227,-2.538697542294699,-2.3378496325875466,-167005482,-177294146.4,11.030826046252827,18.45955053559938,NaN,NaN,-26.031961466718485,-23.564552140682967
2002-10-11T09:30:00-04:00,76.75,79.21001,76.53999,78.99001,23525600,14422900.1,49.1860416264742,37.283497320341326,NaN,NaN,2.101858330047985,-98.24597805945143,0.1373171553743857,-2.1662031883695647,-2.3035203437439504,-143479882,-170956125.2,18.809201278267267,18.082696980340824,NaN,NaN,-21.751214552529817,-23.305503913803946
2002-10-14T09:30:00-04:00,77.95,79.39999,77.58,78.94,12542102,14751105.2,49.07160062590654,38.76763174876154,NaN,NaN,26.540988175855237,-69.3567217099687,0.35988330853401385,-1.853666208076433,-2.213549516610447,-156021984,-164442504,25.972242035717187,18.42186553032736,NaN,NaN,-18.524617041675306,-22.622520074928428
2002-10-15T09:30:00-04:00,81.5,82.85001,81.10001,82.8,17232000,14958930.2,57.32492954763549,40.35426118493449,NaN,NaN,166.58623956389056,-13.36435288385064,0.7470344745489608,-1.2797564234242458,-2.0267908979732066,-138789984,-158710303.6,31.68432518812925,19.243819087235323,NaN,NaN,-12.691029433663953,-21.20373569760493
2002-10-16T09:30:00-04:00,81.61,82.10001,80.22,80.8,17520000,15252425.1,52.57110040661818,41.28172290411561,NaN,NaN,123.51644410139237,40.30763258633682,0.8413750815720444,-0.975072046008151,-1.8164471275801954,-156309984,-152321463.2,37.47511966156446,20.32938826729708,NaN,NaN,-9.562955748676313,-19.540767133472272
2002-10-17T09:30:00-04:00,83.34,83.78999,82.10001,82.84,13088602,15265110.3,56.530835954358054,42.94577248592865,NaN,NaN,178.8845845935002,99.52602295293727,1.0031479102113892,-0.562512239815959,-1.5656601500273482,-143221382,-147564643.2,41.4542874031938,21.762908665231727,NaN,NaN,-5.627507694553103,-17.553158642198106
2002-10-18T09:30:00-04:00,82.14301,83.48,81.49001,83.10001,11017199,15347270.25,57.02332941528646,44.75723710598662,NaN,NaN,155.93913213771037,130.29347771446976,1.082824369564247,-0.21212968807203936,-1.2949540576362863,-132204183,-145309503.4,43.296709259016666,23.43109744544788,NaN,NaN,-2.416699358013456,-15.390807315886013
2002-10-21T09:30:00-04:00,82.5,85.64,82.34,85.42,14143398,15599315.15,61.24275054537706,45.92658250331897,NaN,NaN,176.46885390497076,160.27905086029287,1.2358627788009449,0.24987441586489467,-0.9859883629360502,-118060785,-137717263.6,49.10382228585724,25.29736701817035,NaN,NaN,1.712652424901449,-12.947455924344947
2002-10-22T09:30:00-04:00,84.39,85.00999,83.8,84.73,10883398,15383379.95,59.37561482833222,47.275612055009674,NaN,NaN,147.11439614856172,156.3846821772271,1.2319531994947697,0.553953136432412,-0.6780000630623577,-128944183,-135748103.4,50.51923862597023,27.349820927964693,NaN,NaN,4.449063694680146,-10.46223883591279
2002-10-23T09:30:00-04:00,84,85.24001,83,85.23,12144699,15401614.9,60.3196799703447,48.76895145309245,NaN,NaN,123.3241510061551,156.34622355817964,1.2030117575680959,0.8257646338977622,-0.3772471236703337,-116799484,-127846003.4,55.82798964525645,29.98634422764893,NaN,NaN,6.949214105546324,-7.974888415704346
2002-10-24T09:30:00-04:00,85.67999,85.89,82.78,83.03,12455398,15460284.8,54.33634964538605,50.031993424574104,NaN,NaN,96.2912749166897,139.82756162281754,0.9848483878604644,0.8538133611552468,-0.1310350267052176,-129254882,-125052703.4,57.56130562766602,32.9368567870087,NaN,NaN,7.310425471290567,-5.791272146133643
2002-10-25T09:30:00-04:00,82.82001,84.69,82.55,84.63,12129898,15530289.65,57.62821945286727,51.689438092618744,NaN,NaN,85.95908718356758,125.83155263198898,0.8997833178124532,0.9936941205603489,0.0939108027478957,-117124984,-122036863.6,59.413096199729836,36.16133093274084,NaN,NaN,8.621449894027116,-3.732311854682106
2002-10-28T09:30:00-05:00,85.56,85.8,83.3,84.03,8824102,15110685.15,55.99794739893395,53.07245931243028,NaN,NaN,84.59730208601448,107.4572422681977,0.7601512863961972,1.0440999107431423,0.28394862434694507,-125949086,-123614523.8,57.98763584871053,39.38880911982661,NaN,NaN,9.211951016263745,-1.8831314445469847
2002-10-29T09:30:00-05:00,83.71001,84.2,81.85001,83.71001,13946500,15019395.1,55.10265023383971,54.68610028788955,NaN,NaN,57.017380467127005,89.43783913191078,0.6097745280509594,1.0461667844106444,0.4363922563596849,-139895586,-125804804.4,55.97958993065642,42.579670645427754,NaN,NaN,9.442325464789981,-0.26520902892741827
2002-10-30T09:30:00-05:00,83.88699,84.95,83.16,84.35001,9937199,14831460.15,56.59730219744221,55.87916798920021,NaN,NaN,67.93282508561953,78.35957394780365,0.5204207007790475,1.0869181323334942,0.5664974315544468,-129958387,-128436585,53.57873827314575,45.61880723306296,NaN,NaN,10.047136850494436,1.207983239561418
2002-10-31T09:30:00-05:00,84.59,85.14999,83.42999,83.75,10204102,14654345.35,54.756864416809364,56.27708390279559,NaN,NaN,62.09573611516945,71.52046618749962,0.3936782544111612,1.0585952495683983,0.6649169951572371,-140162489,-130618106.4,51.603106768527205,47.96122905379581,NaN,NaN,10.060003180182477,2.472557516792998
2002-11-01T09:30:00-05:00,83.5,85.61,83.2,85.3,9542500,14287390.35,58.51025744194552,56.9512736753698,NaN,NaN,69.01092201065255,68.13083315291661,0.38645673741229225,1.1479879169226024,0.7615311795103101,-130619989,-133317107.4,49.18659735146972,49.61939729063528,NaN,NaN,11.111366183995777,3.7066730406791093
2002-11-04T09:30:00-05:00,86.58,87.5,85.60001,85.7,12260898,14229430.15,59.44528766363577,57.10272782651267,NaN,NaN,97.76993324628299,70.76535938497031,0.38025606082377705,1.2368512555400315,0.8565951947162544,-118359091,-131799108.4,50.58811066050538,50.96966768151929,NaN,NaN,12.24693687394985,4.926710731146358
2002-11-05T09:30:00-05:00,85.52,87.058,85.5,86.89999,10788199,13711884.9,62.197652478771396,57.79033868880932,NaN,NaN,102.77414262003174,79.91671181555125,0.4252070893373867,1.3881040563879878,0.9628969670506011,-107570892,-125334169.6,56.13687333815131,52.30265008698978,NaN,NaN,14.001838147328904,6.223157504886721
2002-11-06T09:30:00-05:00,87.48,88.14999,85.91,88.05,17484800,13545964.9,64.67216879705197,58.3718624632874,NaN,NaN,131.47895142446058,92.62593708331947,0.4957038686383122,1.5825268028484913,1.0868229342101792,-90086092,-117359710.6,61.8306559475498,53.7581049830152,NaN,NaN,16.225302899380182,7.652035418385787
2002-11-07T09:30:00-05:00,87.2,87.38,85.55,86.05,9715898,12969324.6,57.609356880915946,58.41372156797521,NaN,NaN,103.18562033806144,100.84391392789786,0.37636058337843403,1.5572736634332216,1.1809130800547876,-99801990,-109287610.8,66.56225803105673,55.41992989530378,NaN,NaN,16.175395507965685,8.869658288325773
2002-11-08T09:30:00-05:00,85.92,86.94,85.14,85.28,9416898,12263889.5,55.11380818354076,57.97593997070119,NaN,NaN,80.8508336841017,103.2118962625877,0.22192332028011386,1.4583172304049299,1.236393910124816,-109218888,-105007390.6,68.77276230891445,56.824854182665014,NaN,NaN,15.411589812719715,9.804219934667765
2002-11-11T09:30:00-05:00,85.14999,85.17,83.61,83.96001,7271199,12000344.35,51.03262986619605,57.380012473405756,NaN,NaN,-7.070757252364263,82.24375816285824,0.017980803222612085,1.258869914153081,1.240889110930469,-116490087,-104633589.8,68.96571681887085,58.1424597678722,NaN,NaN,13.548978113041679,10.339185388721182
2002-11-12T09:30:00-05:00,84.25999,85.34,83.8,84.3,9215102,11599499.45,52.01818740914732,56.78704871903451,NaN,NaN,0.24331418740715777,61.737592476333326,-0.1004045805008229,1.1153833853044404,1.2157879658052633,-107274985,-104574408.4,68.99837826947325,59.08320181245911,NaN,NaN,12.279744213162484,10.616408077927082
2002-11-13T09:30:00-05:00,83.73,85.24001,83.17999,84.60001,16988192,11572909.05,52.91867585651149,56.685786305543466,NaN,NaN,-22.093638503474576,31.023074490746296,-0.16128104098091933,1.014186664579114,1.1754677055600333,-90286793,-104614548.6,68.94537802308844,59.89634984070357,NaN,NaN,11.459772972807949,10.736888777195777
2002-11-14T09:30:00-05:00,85.21001,85.8,84.56,85.64999,8668102,11351884.05,56.028947598388015,56.571552601652094,NaN,NaN,42.535558065806526,18.893062036295312,-0.13469185240361026,1.0071028900555206,1.1417947424591308,-81618691,-100977888.8,71.11052082183235,60.73188017085375,NaN,NaN,11.588295987579386,10.858518378679149
2002-11-15T09:30:00-05:00,84.75,85.98,84.45,85.88,7217000,11161874.1,56.703709769162764,56.62196419952558,NaN,NaN,41.081287323009185,10.939152764076805,-0.106696318513688,1.0084243443170209,1.1151206628307089,-74401691,-94014449.4,74.74186480092408,61.92861081029758,NaN,NaN,11.87515757129704,11.003752549053132
2002-11-18T09:30:00-05:00,86.5,86.75999,84.89999,84.91,5613000,10735354.2,53.009295454552536,56.472438858147925,NaN,NaN,42.68690811330502,20.89068583721066,-0.15562553903968435,0.9205887390311034,1.0762142780707877,-80014691,-86719370.2,77.8789373146463,63.492849909153996,NaN,NaN,11.127796949084026,11.021473177628975
2002-11-19T09:30:00-05:00,84.45,85.59,84.14999,85.06,6070301,10494699.35,53.51368198741394,56.252180271717336,NaN,NaN,-3.086147672158982,20.224793465297427,-0.17837426920268173,0.8532464415674355,1.0316207107701172,-73944390,-80053251.2,80.28816607938589,65.40066618102828,NaN,NaN,10.630105267735425,10.96556347621561
2002-11-20T09:30:00-05:00,84.7,86.97,84.56,86.92999,8537699,10314349.35,59.368896984589185,56.58161116941589,NaN,NaN,79.67799937185251,40.57912104036285,-0.07334875455024159,0.9399347675823151,1.0132835221325567,-65406691,-75077230.8,81.87504154759654,67.5629472366761,NaN,NaN,11.805040813108052,11.085488810057388
2002-11-21T09:30:00-05:00,87.19,88.84,86.91,88.74001,9369898,10160074.35,64.08441506612094,56.97976528542843,NaN,NaN,190.06743645237904,70.08549671767734,0.10259760167891474,1.1415305242312002,1.0389329225522854,-56036793,-69960851.2,83.35849431318528,70.00379701965578,NaN,NaN,14.282312736487723,11.542177942404578
2002-11-22T09:30:00-05:00,88.25,88.99001,88.10001,88.19,7770102,9942084.55,61.73961085524365,57.14364551340042,NaN,NaN,176.79624615994126,97.22848848506376,0.16292692688505683,1.2425915811586066,1.0796646542735497,-63806895,-67841892,83.94458231459994,72.38640213780539,NaN,NaN,15.670398118239081,12.131923681809507
2002-11-25T09:30:00-05:00,88.17999,88.95,87.72,88.48,6356699,9818714.4,62.518337618415806,57.16655159480359,NaN,NaN,147.96695140047768,118.2844971424983,0.200863306363664,1.3307437872281298,1.1298804808644658,-57450196,-63328993,85.14456067764347,74.45837980491197,NaN,NaN,17.040883547009013,12.833203662552293
2002-11-26T09:30:00-05:00,87.94,88.60001,86.85001,86.89999,5854000,9414089.4,55.84879508146385,56.53631061511873,NaN,NaN,86.68171558826978,136.23806979458405,0.1029780559631992,1.258603050818465,1.1556249948552657,-63304196,-61200954.2,85.687770615424,76.16245942404585,NaN,NaN,16.31872837114657,13.331135763780047
2002-11-27T09:30:00-05:00,87.653,89.64999,87.59,89.53,8265199,9330489.4,62.9366599218125,56.916832260897046,NaN,NaN,148.00972084826137,149.90441408986584,0.19353267903624705,1.3975408436505745,1.2040081646143275,-55038997,-59127415.4,86.21664725553036,77.56634436865112,NaN,NaN,17.914265726887283,13.985868615652508
2002-11-29T09:30:00-05:00,89.7,89.8,88.82001,88.89999,3058100,8973189.3,60.43385006691541,57.29683525256667,NaN,NaN,140.16599988753964,139.92412677689794,0.1889627806175398,1.4402116403862522,1.2512488597687124,-58097097,-59539476.2,85.54017336109347,78.76401658666389,NaN,NaN,18.43455239440241,14.621394869759637
2002-12-02T09:30:00-05:00,90.39999,90.66,88.03,88.87,8928699,8942499.25,60.31089861237011,57.959568734436246,NaN,NaN,121.20419112673548,128.80571577025677,0.16287142686615774,1.4548381433514095,1.2919667164852517,-67025796,-60183256.4,84.42563443357413,79.86829641628556,NaN,NaN,18.81440112468708,15.2203957633207
2002-12-03T09:30:00-05:00,88.203,88.39,87.418,87.92999,7014898,8680199.25,56.43524867992984,58.27507311092071,NaN,NaN,55.01342034415897,110.21500955899305,0.06621202637499857,1.374731749454,1.3085197230790013,-74040694,-63501356,78.73171505356423,80.56353475800634,NaN,NaN,18.000863084113252,15.61760538057678
2002-12-04T09:30:00-05:00,86.94,88.39999,86.7,87.75,9950898,8638334.2,55.69720388277951,58.473539398511285,NaN,NaN,38.087914122458265,100.49624926583074,-0.02125922293329241,1.2819456944123857,1.3032049173456781,-83991592,-67638835.2,72.19340384291102,80.79553660227938,NaN,NaN,17.123508370923158,15.83273437919769
2002-12-05T09:30:00-05:00,87.97,88.14999,86.28999,86.62,6923301,8110259.25,51.1725621971335,58.1266547269931,NaN,NaN,12.529570519561725,73.4002192000908,-0.1589650943901435,1.1044985493579986,1.2634636437481421,-90914893,-74814014.4,62.49997683133118,80.18049774581502,NaN,NaN,15.041191136464851,15.719656773093
2002-12-06T09:30:00-05:00,85.44,87.03999,85.10001,86.83,9464801,8097704.4,51.95371526806073,57.78736940548582,NaN,NaN,-18.743979269046687,41.61822336877354,-0.2350603013523167,0.9696382670577464,1.204698568410063,-81450092,-79484613.4,57.123258202082106,78.92202584589772,NaN,NaN,13.527473479644947,15.406487731171849
2002-12-09T09:30:00-05:00,85.97,86.25999,84.75999,84.75999,5609301,7907324.55,44.411402627499896,57.173234203553484,NaN,NaN,-64.16705774526245,4.5439735943739645,-0.4135192626221371,0.6877994901323916,1.1013187527545287,-87059393,-83491332.8,52.91755829722976,77.13907020179656,NaN,NaN,9.814288384750236,14.607602110254476
2002-12-10T09:30:00-05:00,85.34,86.00999,84.92,85.75,6091398,7848334.5,48.278713307492126,56.799307869273356,NaN,NaN,-56.274060597301464,-17.713522593918128,-0.45055690665611137,0.5381226194343895,0.9886795260905009,-80967995,-84876793,51.50544905119432,75.08316184264001,NaN,NaN,7.798949831380976,13.634937498986833
2002-12-11T09:30:00-05:00,85.498,86.5,85.13,85.99001,5672301,7671194.45,49.20139013391753,56.07305737993966,NaN,NaN,-47.31604837231049,-34.794315092871884,-0.44384917186550343,0.43386806125862165,0.8777172331241251,-75295694,-83137613.4,53.19396592812073,73.03451358410602,NaN,NaN,6.416532752398349,12.603736820902764
2002-12-12T09:30:00-05:00,86.25,86.5,85.25999,85.64999,5282398,7085904.75,47.89775732640263,54.91686754138835,NaN,NaN,-57.30120409374035,-48.760470015532306,-0.44607884915819374,0.32011867167638286,0.7661975208345766,-80578092,-81070253.2,55.19121414402492,71.02256500059457,NaN,NaN,4.8951927292844,11.502516236385855
2002-12-13T09:30:00-05:00,84.84,85.45,84.37,84.37,6492801,6977139.7,43.25186110218513,53.59631398759846,NaN,NaN,-108.16121950748277,-66.64391806321952,-0.5127634253592044,0.12524323913557112,0.6380066644947755,-87070893,-82194413.4,53.84573114831832,68.87264706014588,NaN,NaN,2.1742950880600787,10.169913215196459
2002-12-16T09:30:00-05:00,84.937,86.7,84.78,86.7,5628398,6897709.6,52.318358674649446,52.86774406304372,NaN,NaN,-44.23605513454795,-62.65771754107662,-0.38480154804864886,0.15700472943396448,0.5418062774826133,-81442495,-81071033.8,55.02566067378773,66.72129705987047,NaN,NaN,2.5153600208571865,9.076405616005134
2002-12-17T09:30:00-05:00,86.13,86.69,85.48,85.57001,4210102,6827564.7,48.2889694035754,52.32775651462311,NaN,NaN,-53.54760962445755,-62.11242734650784,-0.36147845572822296,0.08995820782233466,0.4514366635505576,-85652597,-82007954.2,53.79053568622321,64.44292313635613,NaN,NaN,1.51790960845348,7.996620472069184
2002-12-18T09:30:00-05:00,85.14999,85.23,84.36,84.8,6712398,6859669.55,45.70574375644344,51.09697678852533,NaN,NaN,-110.65821448094002,-74.78086056823375,-0.38116659654721574,-0.02502158213346206,0.3561450144137537,-92364995,-85421814.4,49.43623191277266,61.81575061187343,NaN,NaN,-0.11506397758238955,6.837808407833245
2002-12-19T09:30:00-05:00,84.37601,85.38,83.56,84.00999,7279398,6796754.5,43.15500220408911,49.86277336975202,NaN,NaN,-122.03856137558023,-87.72833202460171,-0.42718885765785775,-0.1778410576585685,0.24934779999928924,-99644393,-89235074.6,45.049526443562314,58.923561546335485,NaN,NaN,-2.2636658164411747,5.537597804365471
2002-12-20T09:30:00-05:00,84.34,85.36,83.67,85.35001,4713898,6563954.5,48.41386721671704,49.01298541291966,NaN,NaN,-89.60913003706528,-84.01791413051822,-0.35039708393543734,-0.18864855492000743,0.1617485290154299,-94930495,-90806995,43.34217619765302,55.98902881519827,NaN,NaN,-2.471646630806843,4.393420027912283
2002-12-23T09:30:00-05:00,84.82001,85.99001,84.67999,85.14,4688301,6409864.45,47.6695565226201,48.386864544540394,NaN,NaN,-61.55502198718047,-87.48170750104474,-0.2987740717687899,-0.21171906069555746,0.08705501107323244,-99618796,-94442255.2,39.60398969466369,53.19419128956251,NaN,NaN,-2.8603478544287997,3.3571674732921286
2002-12-24T09:30:00-05:00,84.67999,84.99001,84.49001,84.63,1449500,6164504.5,45.82700009314865,47.68184998813818,NaN,NaN,-84.01011639093547,-93.5742088543403,-0.2840962097694387,-0.26806525113856594,0.016030958630872755,-101068296,-97525395,36.71197558869279,50.659803557118344,NaN,NaN,-3.7196480305283033,2.3461938298892098
2002-12-26T09:30:00-05:00,84.89999,85.7,84.10001,84.55,2966300,6020119.5,45.52971093382143,47.27878918361589,NaN,NaN,-74.12890578357309,-86.26834711486693,-0.265255181758057,-0.3155380185666985,-0.0502828368086415,-104034596,-99859315.2,34.64928891382365,48.67046870586781,NaN,NaN,-4.506034590187098,1.3673040555925944
2002-12-27T09:30:00-05:00,84.10001,84.60001,82.89999,82.96001,5971801,5905449.6,39.97866275228343,46.423428289631794,NaN,NaN,-138.12422382283708,-89.48547960431829,-0.3405519037391341,-0.4759727164825591,-0.13542081274342505,-110006397,-101931716,32.88258453984841,46.93899201570826,NaN,NaN,-6.865151185598826,0.19123902113667723
2002-12-30T09:30:00-05:00,83.3,83.78999,82.60001,83.35001,5939301,6049509.65,41.851389204949456,46.24057018802106,NaN,NaN,-144.4284563879824,-100.4493448745017,-0.3437706422185054,-0.5651341155165568,-0.2213634732980514,-104067096,-103759036.2,31.364041301653202,45.39945508745279,NaN,NaN,-8.29277149923568,-1.0207624817736596
2002-12-31T09:30:00-05:00,83.28,83.73,82.48,83.50999,5609398,5883544.6,42.64197433353144,45.83794597559529,NaN,NaN,-138.8170779060002,-115.90175605826566,-0.3155393816318595,-0.6157877003378758,-0.30024831870601626,-98457698,-103526816.6,31.795109154292277,43.99157366624551,NaN,NaN,-9.256984375747644,-2.197365609484229
2003-01-02T09:30:00-05:00,84.14999,86.33,83.95,86.17999,7459000,5905749.7,53.90579814689407,46.17397511937933,NaN,NaN,20.571703683129815,-94.9853920434526,-0.1081730096348521,-0.4354645807495814,-0.3272915711147293,-90998698,-101512897,35.574153635110974,42.733015645316236,NaN,NaN,-6.632309369779589,-2.8309290038121375
2003-01-03T09:30:00-05:00,86,86.53999,85.62,86.36,4612000,5638804.8,54.55377504496302,46.64940495641935,NaN,NaN,84.03952931982884,-63.351705022772215,0.0419424953343549,-0.27486345194678563,-0.31680594728114053,-86386698,-97983317.4,41.67368615839647,41.76747793205707,NaN,NaN,-4.329161338239405,-3.0449621944446044
2003-01-06T09:30:00-05:00,86.3,88.19,86.06,87.67,6107301,5598004.8,59.06381076800137,47.77882993254908,NaN,NaN,172.50314010617527,-1.226232236969753,0.22032268966589852,-0.04140258519876738,-0.2617252748646659,-80279397,-92037917.4,50.222607873021815,41.50868341239302,NaN,NaN,-0.8965877109932333,-2.7380515539515513
2003-01-07T09:30:00-05:00,87.64999,88.23,87.2,87.72,6762000,5462864.75,59.230115665678895,48.27252686047975,NaN,NaN,185.7878227511244,64.81702359085162,0.32615524277886687,0.14596877860891766,-0.18018646416994918,-73517397,-85927977.6,57.17018730385378,41.66186388596917,NaN,NaN,1.9068812065705913,-2.0744897310198165
2003-01-08T09:30:00-05:00,87.2,87.2,85.91,86.17,9215102,5643154.8,52.15634243655554,48.54876779140691,NaN,NaN,80.36120808918251,108.65268078988815,0.2781167866622465,0.16745951915785895,-0.11065726750438755,-82732499,-82782937.8,60.2459751964485,42.12296670812812,NaN,NaN,2.2790317068533494,-1.4525580970379357
2003-01-09T09:30:00-05:00,86.64999,88.02,86.63,87.78,8807000,5778934.9,57.794720517561856,49.412266131486795,NaN,NaN,133.94037219435418,131.32641449213304,0.3371831514365292,0.31082167179127396,-0.026361479645255245,-73925499,-79368298,63.32546165872599,43.115054547124785,NaN,NaN,4.421527309526063,-0.6134030389573646
2003-01-10T09:30:00-05:00,86.92,88.38,86.7,87.99001,7427801,5866709.9,58.482049270758196,50.50705520767745,NaN,NaN,130.41463157328096,140.60143494282346,0.37017178676067786,0.4363532538055921,0.06618146704491423,-66497698,-75390498,66.57383867183694,44.65250542057296,NaN,NaN,6.345502886350135,0.38072637894370676
2003-01-13T09:30:00-05:00,88.50999,88.88,87.58,88.09,6230699,5914124.95,58.82586323454993,51.250769208951226,NaN,NaN,136.81525792284725,133.46385850615786,0.3772211719469161,0.5377079319785594,0.16048676003164325,-60266999,-71388018.4,69.5010712216895,46.52099792228985,NaN,NaN,8.002150786552912,1.4695012943164503
2003-01-14T09:30:00-05:00,87.8,88.58,87.14,88.44,4362398,5807604.8,60.072266058846736,52.136677032967405,NaN,NaN,113.960886508959,119.09847125772478,0.38273808802967035,0.6389093700687312,0.2561712820390608,-55904601,-67865459.2,71.8385098118794,48.82346364494811,NaN,NaN,9.741534596453759,2.651220337478923
2003-01-15T09:30:00-05:00,88.60001,88.7,87.14999,87.67999,5526301,5802499.95,56.100901912756775,52.87052716293942,NaN,NaN,92.95156685348128,121.61654301058454,0.3152946937730703,0.6502896492553987,0.3349949554823284,-61430902,-63605139.8,74.39449060861385,51.515071860656754,NaN,NaN,10.134697551036918,3.720288510844351
2003-01-16T09:30:00-05:00,87.75,88.23,86.87,87.3,6498898,5916939.75,54.17256617971631,53.48787396621761,NaN,NaN,68.12300757005849,108.45307008572539,0.2291900528630446,0.6214825215611341,0.39229246869808954,-67929800,-62406000,75.08007516156145,54.4029851640666,NaN,NaN,9.93133140901744,4.607580353440507
2003-01-17T09:30:00-05:00,86.42,86.95,85.67,86.11,6495199,5906079.8,48.54504438871302,54.09975836881973,NaN,NaN,11.299948849846842,84.63013354103857,0.08368733527695299,0.49690163779428076,0.41321430251732777,-74424999,-63991460.2,72.32284319518686,57.22014649659078,NaN,NaN,8.106400769038794,5.1074118413831195
2003-01-21T09:30:00-05:00,86.35001,86.39999,84.45,84.67999,6436602,5863940,42.79224015668409,54.16696200822935,NaN,NaN,-40.573219026045415,49.15243815126003,-0.10692507100820536,0.2795579637570711,0.38648303476527646,-80861601,-68110380.6,65.58436732293566,59.664455498110954,NaN,NaN,4.680742922309599,5.046459138658331
2003-01-22T09:30:00-05:00,84.13,84.53999,83.14999,83.36,8258898,6041190,38.282502651705215,53.85557117381319,NaN,NaN,-103.79995478391196,5.600269892685842,-0.3085542157017467,0.0007902651380931047,0.3093444808398398,-89120499,-74753560.2,56.44911400636877,61.42545584468785,NaN,NaN,0.23139125976932126,4.358592298817044
2003-01-23T09:30:00-05:00,83.7,84.03,82.69,83.44,9123398,6262944.85,38.70412297250165,52.769737232785154,NaN,NaN,-105.53843525930567,-34.09773052987155,-0.41647135701899707,-0.21124471543390655,0.20522664158509052,-79997101,-78466800,52.082231276957266,62.604604247676875,NaN,NaN,-3.1938146653049415,3.279677018228189
2003-01-24T09:30:00-05:00,83.3,83.42999,81.17999,81.39999,10263602,6703649.95,32.590113669332894,51.20090427738301,NaN,NaN,-144.60815765494698,-76.64396357487264,-0.5943392982546513,-0.5376974812332236,0.056641817021427704,-90260703,-82932980.6,47.33873052108087,63.00925027358289,NaN,NaN,-8.383026868873051,1.613576462928012
2003-01-27T09:30:00-05:00,80.8,81.8,79.61,80.14999,10516801,7081175,29.513634627146985,49.09017741017912,NaN,NaN,-170.46520778988193,-112.99699490281839,-0.7549557022387818,-0.8870528107770497,-0.13209710853826778,-100777504,-88203481.6,42.42783630096965,62.45248087557917,NaN,NaN,-13.823509670764695,-0.5917215561709459
2003-01-28T09:30:00-05:00,80.58,81.28,80.10001,80.75999,7465699,7155869.9,32.84520958568183,47.2055412616079,NaN,NaN,-147.12698146612968,-134.30774739083523,-0.7759178481305016,-1.1019944187013948,-0.3260765705708932,-93311805,-90693522.4,40.300697723807794,61.24751733414731,NaN,NaN,-17.18925586898513,-2.962797886572972
2003-01-29T09:30:00-05:00,80.16,81.72,79.52,81.08,12063000,7462054.85,34.59181565235599,45.950932205593645,NaN,NaN,-132.13353352680198,-139.97446313941325,-0.7249865508790756,-1.2323097591697376,-0.507323208290662,-81248805,-89119183.6,42.27136193776124,59.96361638709823,NaN,NaN,-19.376011666894804,-5.307542712333234
2003-01-30T09:30:00-05:00,81.3,81.57001,79.3,79.3,10129000,7688034.95,29.92897154926267,43.96052156500085,NaN,NaN,-136.65530128409677,-146.19783634437147,-0.7640290802294505,-1.4623595585774751,-0.6983304783480246,-91377805,-91395324.4,40.204987981894384,58.31215398161026,NaN,NaN,-22.85499927367321,-7.814322221096088
2003-01-31T09:30:00-05:00,79.14,81.03,79.14,80.84,10299199,7830044.9,37.747415483535434,42.47947629448494,NaN,NaN,-110.0182616029378,-139.27985713396964,-0.643802766412206,-1.5030839363632822,-0.8592811699510762,-81078606,-89558905,42.641227369632894,56.602681745738536,NaN,NaN,-23.253287239417762,-10.019888652284898
2003-02-03T09:30:00-05:00,80.97,81.63,80.82001,81.12,5466801,7872784.95,39.078406375670234,41.06894366170782,NaN,NaN,-79.08966634395284,-121.0047488447838,-0.5089951889602946,-1.4955251561514444,-0.9865299671911498,-75611805,-84525765.2,48.79851402655211,55.12392766037158,NaN,NaN,-23.146897999404164,-11.895175701873365
2003-02-04T09:30:00-05:00,80.39,80.75,79.39999,80.48,6721000,7903469.9,37.12458040994998,39.4298232582152,NaN,NaN,-90.84791079648794,-109.74893471085548,-0.4296673416346348,-1.5236141442344433,-1.0939468025998085,-82332805,-82329965.2,51.256851882697944,53.65380923685863,NaN,NaN,-23.6550748164954,-13.575161289676512
2003-02-05T09:30:00-05:00,80.81,81.69,79.60001,80.12,9331898,8031964.8,36.03324165819603,37.996418954318,NaN,NaN,-77.39561088503704,-98.80135018250249,-0.370423366517725,-1.5569760107469648,-1.1865526442292398,-91664703,-84413144.8,48.86005320818858,51.82992085111396,NaN,NaN,-24.39270508218064,-15.120524688605673
2003-02-06T09:30:00-05:00,79.74001,80.14999,79,79.67,8839301,8013174.75,34.66159799901918,36.602778369982495,NaN,NaN,-88.22467087744677,-89.1152241011725,-0.3317725604459709,-1.6012683447867033,-1.2694957843407324,-100504004,-86238384.6,46.795338190221216,49.80958249601823,NaN,NaN,-25.40321659380571,-16.58948067506282
2003-02-07T09:30:00-05:00,80.11,80.24001,78.39999,78.85001,7624500,7954049.75,32.25235749162083,35.4390150201902,NaN,NaN,-89.89462968192318,-85.09049771696958,-0.33091101355743247,-1.683134551287523,-1.3522235377300906,-108128504,-91648364.2,41.23351791641441,47.58891640467734,NaN,NaN,-26.975534273763024,-18.073202617734278
2003-02-10T09:30:00-05:00,78.96001,79.53,78.10001,79.42999,7266898,7946004.6,35.65886565251512,34.92948826989242,NaN,NaN,-86.5124985994064,-86.5750641680603,-0.2636831779857114,-1.68182751021223,-1.4181443322265186,-100861606,-96698324.4,36.832776690065366,45.53523135947232,NaN,NaN,-27.32499613050604,-19.394887405273103
2003-02-11T09:30:00-05:00,79.83,80.02,78.2,78.7,7897699,8029354.6,33.38357606284909,34.57956494211698,NaN,NaN,-83.42099618285683,-85.08968124533408,-0.24138067039642652,-1.7198701702220518,-1.4784894998256253,-108759305,-101983624.4,32.87779483592166,43.851565704440375,NaN,NaN,-28.27875239376044,-20.664010975057007
2003-02-12T09:30:00-05:00,78.524,78.843,77.71001,77.73,6866102,8154539.8,30.590426477803604,34.000015192495695,NaN,NaN,-103.26845878260232,-90.26425082484712,-0.26317234445802073,-1.8074549303981513,-1.5442825859401306,-115625407,-106775765.2,29.75778965886849,42.256962731719746,NaN,NaN,-29.934091249312644,-21.988308157093527
2003-02-13T09:30:00-05:00,77.7,78.17,76.52,78.02,8577301,8307089.8,32.41116363191918,33.987233046966146,NaN,NaN,-118.75501971249156,-96.37032059185609,-0.2304489623512329,-1.8323437888791716,-1.6018948265279387,-107048106,-108084585.6,28.94975010176195,40.94346413033983,NaN,NaN,-30.784906726980182,-23.244965095648762
2003-02-14T09:30:00-05:00,78.10001,79.62,77.47,79.60001,10645602,8514425,41.42638558936887,34.838143829981995,NaN,NaN,-75.44682545527085,-93.48075974652562,-0.08242134863144246,-1.7049215123172416,-1.6225001636857992,-96402504,-105739385.6,32.48729510858405,40.23342547374086,NaN,NaN,-28.79596042121248,-24.03796442787215
2003-02-18T09:30:00-05:00,80,81.05,79.88,80.85001,8395898,8609459.95,47.40351966428855,35.878023121311045,NaN,NaN,3.5695895148945995,-75.46434212366543,0.10924425922316883,-1.4859448396568382,-1.595189098880007,-88006606,-103168385.6,36.23549082280015,39.943053552240315,NaN,NaN,-25.153762688253618,-24.19736417935522
2003-02-19T09:30:00-05:00,80.53,80.73,79.7,80.53999,5357699,8555514.8,46.14578961283688,36.70330697563111,NaN,NaN,2.692663593967378,-58.241610168300575,0.2184080668434556,-1.3221790153256876,-1.5405870821691432,-93364305,-100089385.6,40.49612544826547,39.816250945847756,NaN,NaN,-22.573280805059596,-23.965352268741558
2003-02-20T09:30:00-05:00,80.55299,80.72,79.28,79.62,5211000,8403119.9,42.538836213686395,37.60401159451851,NaN,NaN,-15.044769919685713,-40.596872395717256,0.23071414065965734,-1.2521944063445716,-1.482908547004229,-98575305,-96679365.2,44.88822000153686,40.15076751867936,NaN,NaN,-21.44235063752958,-23.604923464282702
2003-02-21T09:30:00-05:00,79.53,80.55,78.55,80.24001,7828602,8338380.1,45.623581571567996,38.16659488652084,NaN,NaN,-10.440245007684558,-18.933917454755864,0.27941991673327515,-1.133633651087635,-1.4130535678209102,-90746703,-93419084.6,48.78083636689843,40.58931101848405,NaN,NaN,-19.561960373490322,-23.02735730845522
2003-02-24T09:30:00-05:00,79.82201,79.95,78.60001,78.71001,6713602,8160880.1,39.9272906345541,38.22722947644111,NaN,NaN,-58.598255213047125,-15.564203406311123,0.21054161384248582,-1.1498765505178028,-1.3604181643602886,-97460305,-93630644.8,48.54124467916336,40.570934636527696,NaN,NaN,-19.668005852002068,-22.547449957533342
2003-02-25T09:30:00-05:00,77.95,79.39999,77.22,79.33,8162000,8043140.05,43.031259404656204,38.649135118920135,NaN,NaN,-85.34312016264755,-33.346745341819556,0.20830207479768204,-1.100040570863186,-1.308342645660868,-89298305,-93888984.6,48.22972939244242,40.35471160150945,NaN,NaN,-18.79228655997451,-22.010998043596366
2003-02-26T09:30:00-05:00,78.83,79.39,78.03999,78.25999,6354699,7987590.05,39.260856761589295,38.879679054876796,NaN,NaN,-82.80976345282883,-50.44723075117879,0.13962120784605903,-1.1338161358532943,-1.2734373436993534,-95653004,-94346724.4,47.64627163647559,40.26801291781566,NaN,NaN,-19.22186461393189,-21.612550410787154
2003-02-27T09:30:00-05:00,78.67999,79.46001,77.89999,79.03999,9915199,7880200,43.169925853697166,39.487416758782366,NaN,NaN,-56.57601512592743,-58.75347979242713,0.150641659544394,-1.0851352692688607,-1.2357769288132547,-85737805,-91779224.4,51.21150891469938,40.58345368384982,NaN,NaN,-18.36464046330496,-21.148563275432554
2003-02-28T09:30:00-05:00,79.17,79.78,78.62,79.31,9218801,7834690.05,44.50147157129051,40.36235347875877,NaN,NaN,-16.276266192888947,-59.920684029468006,0.178149930228781,-1.0130895160272786,-1.1912394462560596,-76519004,-88933684.6,54.87891696854829,41.558125044716526,NaN,NaN,-17.270570492621275,-20.594564306459514
2003-03-03T09:30:00-05:00,79.67999,79.92999,78.33,78.59,7118102,7675635.2,41.695977530881436,40.793575755784936,NaN,NaN,-37.13797706387249,-55.62862839963309,0.1509642523438035,-1.0025341308263052,-1.1534983831701087,-83637106,-86169044.8,58.16894248769961,43.082136887404694,NaN,NaN,-17.16921777711489,-20.105229087981712
2003-03-04T09:30:00-05:00,78.45,78.47,77.2,77.25999,5177602,7661175.25,37.049494473674294,41.05542707084388,NaN,NaN,-152.61782879673868,-69.0835701264513,0.05164909407691787,-1.0889370155739613,-1.1405861096508791,-88814708,-86072325.4,58.2835430867914,44.89683319103824,NaN,NaN,-18.520252153894056,-19.878803811683476
2003-03-05T09:30:00-05:00,77.05,77.89,76.75301,77.84,7606801,7705465.3,40.18018762232809,41.74041000973848,NaN,NaN,-151.96177445249398,-82.91397232638434,0.0341061351058527,-1.0979534407685634,-1.132059575874416,-81207907,-83183306,61.66214770761701,47.175715908806,NaN,NaN,-18.694981014875466,-19.709686269282333
2003-03-06T09:30:00-05:00,77.33,77.89999,76.73,76.87,8066801,7642210.45,36.87710779371557,42.059406021295366,NaN,NaN,-162.34719290537464,-104.06820788227378,-0.030259714514618397,-1.169884219017689,-1.1396245045030706,-89274708,-83890686.6,60.372833159288525,49.420221841486466,NaN,NaN,-19.861374537498232,-19.731356021884604
2003-03-07T09:30:00-05:00,75.95,77.58,75.78,77.55,11890699,7794780.35,40.56574381617993,41.99793160892473,NaN,NaN,-151.73364528719398,-131.15968370113478,-0.015230967377935167,-1.1586632137254895,-1.1434322463475544,-77384009,-84063687.6,60.04217684761273,51.38842767998852,NaN,NaN,-19.72203522744817,-19.730024479822255
2003-03-10T09:30:00-05:00,76.75,77.03,75.67,75.78,7245500,7775830.35,34.85612567602958,41.101689181191944,NaN,NaN,-178.65648152284322,-159.46338459292892,-0.10754561877925273,-1.2778642698216203,-1.1703186510423675,-84629509,-84262168.2,59.638608685040026,53.060078955862785,NaN,NaN,-21.449941835799766,-19.975726959247613
2003-03-11T09:30:00-05:00,75.95,76.57001,75.23,75.35001,8551000,7840035.45,33.61820748258391,40.20686188617388,NaN,NaN,-170.44359880282383,-163.02853859414597,-0.17654032031605094,-1.3909940514374313,-1.2144537311213803,-93180509,-85135328.4,57.79811351245373,54.29593524616195,NaN,NaN,-23.235308677625998,-20.441381490444524
2003-03-12T09:30:00-05:00,75.11,75.78,74.31,75.75,10318000,7961050.5,35.89883427519612,39.73257603342457,NaN,NaN,-163.40095292335533,-165.31637428831823,-0.17393195708156162,-1.4318686774733322,-1.2579367203917706,-82862509,-85466248.8,57.07916288515806,55.166716880706325,NaN,NaN,-24.01146253491115,-20.95139306822547
2003-03-13T09:30:00-05:00,76.8,78.5,76.33,78.44,12664398,8250965.3,48.67079593131274,39.95023420197777,NaN,NaN,-25.471134042651457,-137.94116251577358,0.019958599690916845,-1.2329884707781247,-1.2529470704690415,-70198111,-81650929.4,62.821278106042854,56.1696055763595,NaN,NaN,-20.38483661620158,-20.870456432222056
2003-03-14T09:30:00-05:00,78.85001,79.55,78.14999,78.96001,12987398,8471470.15,50.715118819872586,40.72079335807195,NaN,NaN,32.68077017074377,-101.05827942418605,0.18504788425255514,-1.0216372151533477,-1.2066850994059029,-57210713,-77616270.2,67.73682125176995,57.54071818868855,NaN,NaN,-16.821953087998505,-20.292098811618693
2003-03-17T09:30:00-05:00,78.28,81.75,77.86,81.46001,14692398,8673809.95,59.14052327871942,41.871455063362184,NaN,NaN,104.35685677886015,-44.455611763845376,0.4493674108947521,-0.6449758357874629,-1.094343246682215,-42518315,-69194031.4,75.12904227758742,59.462097680484625,NaN,NaN,-10.55995085195223,-18.90179196023777
2003-03-18T09:30:00-05:00,81.8,82.35001,81.10001,82.14,11247398,8816384.95,61.089006048345766,43.43060858384479,NaN,NaN,173.04385809427862,24.24187961557515,0.6448534789580211,-0.2882763979846885,-0.9331298769427097,-31270917,-56812113,81.74949563647185,61.89804225191292,NaN,NaN,-4.944494101047732,-16.907892266067766
2003-03-19T09:30:00-05:00,82.34,83,81.39,82.92,9367602,9016880.1,63.25368890071696,44.865163087203335,NaN,NaN,184.79702847533136,93.88147589531249,0.7918610190358166,0.05669639685206107,-0.7351646221837556,-21903315,-44620274.2,85.76700916845296,64.36629227003819,NaN,NaN,0.3157583092031208,-14.447370755314783
2003-03-20T09:30:00-05:00,82.3,83.45,81.47,83.12,14868398,9499750,63.80963790523948,46.24431782534255,NaN,NaN,174.12775474227854,133.8012536522985,0.8619577223345084,0.34228253073438,-0.5196751916001284,-7034917,-31987635.4,88.5737159486054,66.77306362575654,NaN,NaN,4.646342074114048,-11.719697493967807
2003-03-21T09:30:00-05:00,83.82001,85.36,83.3,85.13,17270304,9971835.1,68.90185024669643,48.187594447900764,NaN,NaN,211.74901510248066,169.6149026386459,0.9937190136390082,0.7224735754486318,-0.2712454381903764,10235387,-18498415.4,90.68585026222193,69.09569989536529,NaN,NaN,10.236910374672119,-8.583039227019245
2003-03-24T09:30:00-05:00,83.452,83.64,81.888,82.24001,16259102,10449110.1,56.57567619090632,49.582321713417336,NaN,NaN,115.89394634106473,171.92232055108678,0.8422525282778789,0.7815702221569722,-0.06068230612090664,-6023715,-11199495.4,91.59155879049781,71.47484387420145,NaN,NaN,10.88602340813321,-5.801744564854609
2003-03-25T09:30:00-05:00,82.27,83.49001,81.85001,82.81,12114102,10646715.2,58.16528339675626,50.86697141159077,NaN,NaN,102.86742203315858,157.8870333388628,0.7400926595594316,0.8644335183283829,0.12434085876895129,6090387,-3727234.6,92.40571922384814,73.67081326821797,NaN,NaN,11.929938644347708,-3.268646963539992
2003-03-26T09:30:00-05:00,82.69,82.99001,81.96001,82.38,9405898,10799275.15,56.485401007826646,52.267563784027274,NaN,NaN,82.85694033038541,137.49901570987362,0.6086887655365969,0.8852018156896975,0.27651305015310057,-3315511,-9673.8,92.78026630853873,75.98562992173584,NaN,NaN,12.207845704466008,-1.0577194395391354
2003-03-27T09:30:00-05:00,81.62601,82.61,81.17,82.03,9007398,10753885.1,55.09071103487053,53.30506144250518,NaN,NaN,61.57274515734724,114.98801379288734,0.4695617805468929,0.8634652758367167,0.3939034952898238,-12322909,-1067272.2,91.39921558999677,78.2254184033347,NaN,NaN,11.999068569448152,0.8075359903161912
2003-03-28T09:30:00-05:00,81.55,82.14999,81.2,81.57001,6382000,10612045.05,53.23048004756322,54.617515326186144,NaN,NaN,48.81596192743276,82.40140315787775,0.32479784708613935,0.799900804147498,0.47510295706135863,-18704909,-6855331.4,84.02744152204109,79.96747789169191,NaN,NaN,11.27084994684082,2.3022951269625667
2003-03-31T09:30:00-05:00,80.39999,80.89999,79.38901,79.82001,13387301,10925505,46.761297691437605,55.55630748396141,NaN,NaN,5.741827825951973,60.37097945485522,0.10102384363785366,0.6013827616086758,0.5003589179708221,-32092210,-12069030.4,77.93020502909518,81.40548442859486,NaN,NaN,8.576642070624755,3.1986304046285934
2003-04-01T09:30:00-05:00,80.27,81.106,79.75999,80.78999,9572199,11145234.85,50.36219698940694,56.58940482069075,NaN,NaN,16.14626766728207,43.02674858167991,0.012810977486668151,0.5163726398291573,0.5035616623424891,-22520011,-17791110,71.77454048838302,82.45515425739664,NaN,NaN,7.4201506445612395,3.8017047246189715
2003-04-02T09:30:00-05:00,82.24001,83.34,82.17999,82.75,11875398,11358664.7,56.73077946861663,57.16511793049818,NaN,NaN,70.72850023493851,40.60106056259051,0.07734167304646644,0.6002387536505722,0.5228970806041058,-10644613,-19256930.4,70.24384448497631,82.9853375701776,NaN,NaN,8.462481013869814,4.467529908797664
2003-04-03T09:30:00-05:00,83.50999,83.85001,82.37,82.37,9880199,11449334.6,55.25072333360159,57.48908968147882,NaN,NaN,68.35993761437807,41.95849905399668,0.0847160194315657,0.628792104893563,0.5440760854619973,-20524812,-20897311,68.48367640753197,83.03868436701774,NaN,NaN,8.834631769944437,5.091401603247203
2003-04-04T09:30:00-05:00,83.07001,83.25,82.3,82.89,7442199,11226909.6,56.90750583371762,57.32958843540727,NaN,NaN,61.76493691310061,44.54829405113024,0.11312211052473753,0.6854787236179192,0.5723566130931816,-13082613,-19772851.8,69.05608337419818,82.60490158820423,NaN,NaN,9.637452181144397,5.740837400089659
2003-04-07T09:30:00-04:00,84.91,85.39999,82.92,82.92999,11802898,11454779.5,57.039235691220746,57.04031912418405,NaN,NaN,86.85148943607082,60.77022637315402,0.12233045253312513,0.725269678759588,0.6029392262264629,-1279715,-13610352.8,72.05192657168809,81.91221808357682,NaN,NaN,10.322538056450638,6.395366065284085
2003-04-08T09:30:00-04:00,83.17,83.564,82.73,83.2,7798398,11417149.4,57.973393066093074,56.66315513599663,NaN,NaN,65.12740733198488,70.56645430609458,0.13342382401834074,0.7697190062493888,0.6362951822310481,6518683,-7802614,74.55241719398465,81.11117579968622,NaN,NaN,11.15029100393143,7.07464105651942
2003-04-09T09:30:00-04:00,83.48,84.10001,82.02,82.24001,11039602,11453229.5,53.51768327941846,55.928015519866555,NaN,NaN,45.887553096673344,65.59826487844154,0.06631733621682412,0.7191918525020782,0.6528745162852541,-4520919,-6577875.2,75.05918049672826,80.14585183883787,NaN,NaN,10.628486942161064,7.582333325896798
2003-04-10T09:30:00-04:00,82.31,82.47,81.56,82.46001,6493000,11144659.6,54.38296178623297,54.89095205840488,NaN,NaN,0.7980308097138534,52.085883517508705,0.02886757908054083,0.6889589901359301,0.6600914110553893,1972081,-2078496.6,76.88067364688393,79.15976779488516,NaN,NaN,10.425995882973107,7.988570834050556
2003-04-11T09:30:00-04:00,83.03,83.58,81.92,82.2,8298898,10910234.6,53.124287605293226,54.64442430228966,NaN,NaN,19.74526172229142,43.681948479346865,-0.01872964753040307,0.6366793516423854,0.6554089991727885,-6326817,-727337.4,77.41412210786075,78.14709374612536,NaN,NaN,9.920111575084245,8.264505225626797
2003-04-14T09:30:00-04:00,82.39,83.85001,82.25,83.84,6748102,10513019.8,59.49258677932096,54.739231686758565,NaN,NaN,81.41002550283729,42.59365569270015,0.051104901936267266,0.7192901265931226,0.6681852246568554,421285,-387137.4,77.55455151053116,77.08629605231701,NaN,NaN,11.265122120558681,8.693164782045638
2003-04-15T09:30:00-04:00,83.582,84.45,83.24001,84.39999,6778801,10289589.95,61.4199326819227,55.091698234908286,NaN,NaN,137.72617129930612,57.1134084861644,0.12184237762896599,0.8204881966930628,0.6986458190640968,7200086,-250856.8,77.61459562272476,76.00303386047315,NaN,NaN,12.957588966111484,9.302368236912187
2003-04-16T09:30:00-04:00,84.64999,84.64999,82.52,82.7,9555301,10298974.9,53.15202286944528,54.95322050880649,NaN,NaN,61.14085554216397,60.16406897526254,0.044933267324166026,0.7548124032193044,0.7098791358951384,-2355215,182284,77.81770425058883,75.0329259076583,NaN,NaN,11.993663252178118,9.686838953378748
2003-04-17T09:30:00-04:00,82.64999,83.64999,82.42,83.48,8773000,9994205,56.07377390422265,55.1563129271393,NaN,NaN,47.50705278676128,69.50587337067202,0.037678596040164214,0.7569773809453437,0.7192987849051795,6417785,1071424.8,78.2538896694254,74.62052934675717,NaN,NaN,12.060736501351201,10.02596717451767
2003-04-21T09:30:00-04:00,83.66,84.10001,83.11,83.53,6019301,9431654.85,56.262082674739155,55.834940425946556,NaN,NaN,93.26185511440418,84.20919204909457,0.027789507831287863,0.7540356696942894,0.7262461618630015,12437086,4824205.4,80.03805398155137,74.77108998621834,NaN,NaN,12.168667847008168,10.332067270587741
2003-04-22T09:30:00-04:00,83.03,85.03,82.71001,84.92,9072699,9072334.7,61.23707764260746,56.611717615460876,NaN,NaN,136.08307250020755,95.14380144856861,0.102219952081965,0.8540211019654578,0.7518011498834928,21509785,9041905.4,81.84126308691765,75.49014160039938,NaN,NaN,13.761900706394497,10.822043475702992
2003-04-23T09:30:00-04:00,85.13,85.42,84.58,85.22,6886500,8810954.6,62.23548908325921,57.00491115936392,NaN,NaN,179.95470260909738,103.58950771052687,0.15580424535038295,0.9465564565714715,0.7907522112210885,28396285,13281145.2,83.45864057834123,76.4340556070683,NaN,NaN,15.363481489615225,11.470820334833311
2003-04-24T09:30:00-04:00,84.57001,84.99001,84.05,84.44,8661398,8773729.6,58.04903732747574,57.20479073035494,NaN,NaN,117.34689577695472,114.83071575748502,0.12423541152900375,0.9460464756323432,0.8218110641033395,19734887,17699165.6,84.96192897826808,77.61107364783516,NaN,NaN,15.523563673236417,12.049783668890898
2003-04-25T09:30:00-04:00,84.2,84.37,82.85001,83.16,7866898,8716704.6,51.88138866610393,56.84578236123968,NaN,NaN,36.2469170244859,112.57868860502995,0.00875714822995266,0.8327574993907803,0.8240003511608276,11867989,18789206.4,85.31649774948167,78.77253181749826,NaN,NaN,13.785273645218357,12.297710808366249
2003-04-28T09:30:00-04:00,83.42999,85.14999,83.19,84.78999,7364199,8765814.55,58.000992223969476,56.91447925643602,NaN,NaN,98.8467158482373,113.69566075179655,0.03242844573155046,0.8645359083252657,0.8321074625937153,19232188,20148226.8,85.76707616300995,79.75218535973555,NaN,NaN,14.177278074376144,12.566220417796234
2003-04-29T09:30:00-04:00,85.13,85.7,84.45,85.11,11296199,8661259.45,59.10072977635891,56.99500330716929,NaN,NaN,148.3939531958191,116.15783689091886,0.05840132940275833,0.9051091243471632,0.8467077949444048,30528387,21951947.2,86.36510278873408,80.59594861650336,NaN,NaN,14.829860245339354,12.88959753601668
2003-04-30T09:30:00-04:00,84.92999,85.41,84.44,84.86,10043898,8684844.4,57.82681481459559,57.30279841682479,NaN,NaN,121.53847429330317,104.47459122776004,0.04794544621994634,0.9066396027193377,0.8586941564993914,20484489,20369588,83.06764798639526,81.16798200862242,NaN,NaN,14.988081539046261,13.189380965020906
2003-05-01T09:30:00-04:00,84.75,84.92999,83.5,84.61,11244000,8653274.5,56.514930687617415,57.45508190978082,NaN,NaN,62.17423304242922,93.44005868085493,0.0150955550191878,0.8775636002733762,0.8624680452541884,9240489,18270708.4,78.771522763002,81.30304265977371,NaN,NaN,14.747133574079236,13.411917052029239
2003-05-02T09:30:00-04:00,84.25,86.03,84.21001,85.81,10967398,8707634.45,61.07922467656445,58.023291700585915,NaN,NaN,134.37696655194154,113.06606858634606,0.06243278572764077,0.9405090274137393,0.8780762416860985,20207887,19938688,79.6713149086263,81.46427071697124,NaN,NaN,15.875634996660729,13.763876758405166
2003-05-05T09:30:00-04:00,86,86.19,85.10001,85.5,8215398,8746294.4,59.346251397594365,58.01283917331973,NaN,NaN,136.46304733839213,120.58933488437704,0.061041285799083966,0.9543778489349535,0.8933365631358695,11992489,18490748.2,76.63467611336345,81.39856533145927,NaN,NaN,16.31618641488338,14.12849242361634
2003-05-06T09:30:00-04:00,85.50999,86.58,85.39999,85.99001,9820699,8647184.45,61.219270709672166,57.998506175301834,NaN,NaN,144.61165955905062,119.83287615702334,0.08009615005827775,0.9934567507087166,0.9133606006504389,21813188,16747708.4,73.02629896887191,81.07082985618408,NaN,NaN,17.220192762631495,14.570163900618505
2003-05-07T09:30:00-04:00,85.60001,86.46001,85.21001,85.86,8498000,8682164.55,60.42383254432044,58.517921152078635,NaN,NaN,119.42130549454555,119.4094423972718,0.07121672855933792,1.0023815113496113,0.9311647827902734,13315188,15313848.2,70.10213299537394,80.51971762366871,NaN,NaN,17.75488001418828,15.025123345414187
2003-05-08T09:30:00-04:00,85.03,85.95,84.87,85.13,8725602,8566464.55,56.02224290750498,58.5142403665988,NaN,NaN,74.83052249789606,121.94070028836518,0.006841834427748217,0.9397170758249587,0.9328752413972105,4589586,14383667.6,68.19440427002776,79.80118295228317,NaN,NaN,17.00500946517816,15.307964219666182
2003-05-09T09:30:00-04:00,85.36,86.28999,85.2,86.17,6891398,8586384.45,60.44321187209932,58.812892452124515,NaN,NaN,107.99725289316004,116.66475755660888,0.023999762533471136,0.9628749445640494,0.9388751820305783,11480984,12638287,64.63978694540404,78.70130673541551,NaN,NaN,17.6024498034896,15.635747874498099
2003-05-12T09:30:00-04:00,85.95,87.59,85.81,87.34,8111102,8576994.65,64.7378835759665,59.06295001879302,NaN,NaN,166.08791856658166,122.5897318022468,0.09960303310368224,1.063378973410181,0.9637759403064988,19592086,14158206.4,66.28774811296606,77.59034138013325,NaN,NaN,19.437164824546407,16.178807438790713
2003-05-13T09:30:00-04:00,87.03,87.39,86.61,87.03999,6893398,8584259.45,62.85348458879081,59.10709255490242,NaN,NaN,155.0105903828128,124.66951796699922,0.11383584423575044,1.106070745601187,0.9922349013654365,12698688,12335306.4,62.5241203697932,76.09501850809411,NaN,NaN,20.399813437923306,16.781808295809654
2003-05-14T09:30:00-04:00,87.38,87.53999,86.32001,86.84,7836301,8637134.45,61.56695647011128,59.35837249366211,NaN,NaN,130.20907641635793,126.8270721513617,0.09498032067663109,1.1109603022112253,1.0159799815345942,4862387,10644746.2,59.16891228223382,74.2526601726631,NaN,NaN,20.834085738570813,17.360705073346963
2003-05-15T09:30:00-04:00,87.20599,87.7,86.66,87.32001,7470602,8532899.5,63.49817402728675,60.18814287660374,NaN,NaN,137.2915754444674,139.319282740676,0.099553639695527,1.140422031154003,1.040868391458476,12332989,12193426.8,61.221845882530395,72.531613610738,NaN,NaN,21.74653844539457,17.987252697925193
2003-05-16T09:30:00-04:00,87.09,87.60001,86.533,86.99001,7415500,8465024.5,61.220600801711896,60.41811491787105,NaN,NaN,112.59926266606017,140.23968469525602,0.06665211365875479,1.1241835335319195,1.0575314198731647,4917489,10880727.8,58.5353265000013,70.58648863480882,NaN,NaN,21.894494559094298,18.545430106663638
2003-05-19T09:30:00-04:00,86.28,87.14999,84.89999,85.17,9803000,8654209.45,50.468853090650896,59.80155229746334,NaN,NaN,15.301349494725862,110.08237088088485,-0.08325403780279994,0.9534638726196647,1.0367179104224646,-4885511,5985208.4,49.76482641792502,67.97218317975104,NaN,NaN,18.695902174985125,18.56692611642385
2003-05-20T09:30:00-04:00,85.37,85.65401,84.25,85.07001,10808801,8741014.55,49.94983438774719,59.23891083840274,NaN,NaN,-46.64722072995903,69.75080865833047,-0.18868068264417615,0.8008670571172445,0.9895477397614206,-15694312,306608.4,41.918913021920275,65.03298782514567,NaN,NaN,15.96334470078171,18.19498591418926
2003-05-21T09:30:00-04:00,84.89999,85.42999,84.519,85.2,8295199,8811449.5,50.660221101431304,58.8207172965323,NaN,NaN,-41.85207460387223,35.338578454284445,-0.2455949677486846,0.6825540300755648,0.9281489978242494,-7399113,-2145691.6,39.05527745795905,62.19611316049975,NaN,NaN,13.912499338483903,17.583202117659923
2003-05-22T09:30:00-04:00,85.47,86.45,85.28,86.03999,6995602,8728159.7,55.09556596959595,58.39331310317742,NaN,NaN,22.963602006299183,12.47298376665079,-0.2232488028183619,0.649087994301297,0.872336797119659,-403511,-4692991.6,36.28261207055843,59.09692010063776,NaN,NaN,13.366409964954487,16.980803238702002
2003-05-23T09:30:00-04:00,85.99001,86.42999,85.61,86.23,4640500,8566839.8,56.05783968792693,58.15842655248688,NaN,NaN,29.446097684988384,-4.157649229563555,-0.19336652217521144,0.6306286444006446,0.823995166575856,4236989,-4829091.6,36.13500452463346,56.20408641572847,NaN,NaN,13.181764483298181,16.438083416501456
2003-05-27T09:30:00-04:00,85.72,88.17,85.60001,87.87,10006301,8698944.9,63.356713974063254,58.31110107137196,NaN,NaN,122.70026747784947,17.322134367061174,-0.06735153295447893,0.7398057503827573,0.8071572833372362,14243290,-1003331.4,43.137893798893,54.06920033215855,NaN,NaN,15.279050232320154,16.272507247332697
2003-05-28T09:30:00-04:00,88.17,88.75,87.91,88,6345699,8451419.9,63.86903040330196,58.557186632727785,NaN,NaN,178.6190563302444,62.37538977910185,0.01610049704050609,0.8272829046378689,0.8111824075973628,20588989,6253328.8,53.54344520733075,52.88643691872689,NaN,NaN,17.12500736732705,16.39429297876046
2003-05-29T09:30:00-04:00,88.25,88.89999,87.05,87.39999,8641801,8381315.05,59.71895587230525,58.821237558784944,NaN,NaN,121.94633396079836,95.13507149203596,0.02187596641100087,0.8385273656111139,0.816651399200113,11947188,10122589,57.960893421901204,52.15547185814643,NaN,NaN,17.482751424713015,16.54978704246797
2003-05-30T09:30:00-04:00,87.77,88.98,87.71001,88.84,7897699,8214000,65.5110686997336,59.18322733218739,NaN,NaN,154.91225513868275,121.52480211851268,0.1088019635679972,0.9526538536601095,0.8438518900921123,19844887,14172268.6,62.03036738466579,51.96908474666513,NaN,NaN,19.659599579886212,16.99404597638486
2003-06-02T09:30:00-04:00,89.41,90.91,89.05,89.34,9536602,8142460.2,67.27085577332795,59.36415391771321,NaN,NaN,206.07792908391284,156.85116839829757,0.1817975111366299,1.0710987790128996,0.8893012678762697,29381489,19201168.6,66.38236787453855,51.97584330106316,NaN,NaN,22.00828525542441,17.71036587339051
2003-06-03T09:30:00-04:00,89.05,89.69,88.8,89.55,7890699,8126225.25,68.00916772491522,59.73241699886495,NaN,NaN,156.09102862394488,163.52932062751665,0.2233136997491162,1.168443392562665,0.9451296928135487,37272188,23806948.2,69.79681307174148,52.49532135120232,NaN,NaN,24.137868047605497,18.62858046970694
2003-06-04T09:30:00-04:00,89.44,90.91,89.34,90.71001,8739000,8072140.3,71.79420926408746,60.46293505557753,NaN,NaN,182.183310784775,164.24217151842277,0.303041330525073,1.32393135596989,1.020890025444817,46011188,28891388,73.05085175011035,53.48688845605064,NaN,NaN,27.234932517868003,19.858059333729948
2003-06-05T09:30:00-04:00,90.13,90.77,89.94,90.74001,7970000,8045740.3,71.88684932594913,61.06212614833913,NaN,NaN,158.76513084487547,171.6059308952382,0.3297344080396758,1.4330580354944118,1.103323627454736,53981188,37298188,77.38864474393247,54.64165980329365,NaN,NaN,29.73554895646131,21.269129279834427
2003-06-06T09:30:00-04:00,91.47,92.49001,90.74699,90.87,10658398,8142380.1,72.31121267180683,61.85431271048878,NaN,NaN,167.04819836671814,174.0331195408453,0.3274167565793553,1.51259457317893,1.1851778165995748,64639586,46257127.8,80.9143179161391,56.24015919016063,NaN,NaN,31.91248097813814,22.789608093877813
2003-06-09T09:30:00-04:00,90.41,90.94,89.7,90.23,7853199,8190470.15,66.9526212679653,63.031724723154085,NaN,NaN,104.46676726507613,153.71088717707795,0.257152025367249,1.506617848308636,1.249465822941387,56786387,51738107.4,82.69235081334807,58.59212521840514,NaN,NaN,32.28563454660639,24.146183301410467
2003-06-10T09:30:00-04:00,90.49001,91.10001,90.16,91.03,6331699,8101500,69.95026704053524,64.4603270554961,NaN,NaN,107.96463691323096,144.08560883493516,0.2392941086526219,1.5485834587571645,1.3092893501045426,63118086,56907287,84.18843201438678,61.611376575009885,NaN,NaN,33.49317280256855,25.48146751586162
2003-06-11T09:30:00-04:00,91.00999,92.23,90.74001,92.11,8548602,8184260.2,73.4513627224762,66.08826574271357,NaN,NaN,125.14228463543422,132.677403605067,0.2725434556703985,1.6499686696925409,1.3774252140221424,71666688,62038387,85.52589660552256,64.93070651412157,NaN,NaN,35.6566344643175,26.93506279421246
2003-06-12T09:30:00-04:00,92.61,92.7,91.5,92.42999,8583602,8221625.25,74.40295419757223,67.46736490185474,NaN,NaN,125.26307330213947,125.97699209651982,0.28695961542739257,1.736124733306383,1.4491651178789904,80250290,67292207.4,86.76076238941647,68.53628867975428,NaN,NaN,37.72257933787877,28.476136586164788
2003-06-13T09:30:00-04:00,92.39999,92.53,91.05,91.58,6188898,8157540.05,67.4835554605811,68.28348745704433,NaN,NaN,96.41732468584428,111.85081736034506,0.21349635002984568,1.7160355554162976,1.502539205386452,74061392,69176568.6,87.18312347849196,72.18258289074417,NaN,NaN,37.398560938993654,29.75076863656891
2003-06-16T09:30:00-04:00,91.98,93.56,91.81,93.5,8100699,8191800,73.48259017034025,69.00676432820697,NaN,NaN,121.00889888001413,115.15924368333265,0.2650907184479503,1.83390260344639,1.5688118849984396,82162091,74251709.4,88.26864337272849,75.40620786030385,NaN,NaN,39.12776094916515,31.0903389669398
2003-06-17T09:30:00-04:00,93.84,93.95,93.00999,93.46001,7676801,8085490.05,73.17975651311447,69.67181619319358,NaN,NaN,125.74175616112908,118.71466753291229,0.26667794864893013,1.9021593208096021,1.635481372160672,74485290,76525150.2,88.72914654634062,77.9194722416617,NaN,NaN,40.36963435596442,32.41595259394332
2003-06-18T09:30:00-04:00,92.99001,93.7,92.63,93.25999,7921500,7941125,71.59054373527772,70.51978675483447,NaN,NaN,110.0197961608598,115.69016983799739,0.22601791445565356,1.9180037652302389,1.6919858507745853,66563790,75504570.6,87.07667442469292,79.99917088471825,NaN,NaN,40.88834299654355,33.62629408002906
2003-06-19T09:30:00-04:00,93.304,93.50999,91.84,92.12,9831398,8017934.95,63.17044256360693,70.35259917368258,NaN,NaN,82.07537562314793,107.05263030219908,0.10050774958106135,1.817620537750912,1.7171127881698507,56732392,70800991,79.70882809044139,81.26191807798794,NaN,NaN,38.67107353781387,34.346976859712605
2003-06-20T09:30:00-04:00,92.67,92.89999,91.8,91.84,8024000,8069354.85,61.26448975767561,69.9235730297074,NaN,NaN,65.67786270862595,100.90473790675541,-0.016951907931315624,1.6959229032557062,1.7128748111870218,48708392,65730391,72.5792065255488,81.70454941020296,NaN,NaN,36.28505976933975,34.6238458468022
2003-06-23T09:30:00-04:00,91.84,91.89,90.49001,90.89999,11290602,8401859.95,55.23886484120925,69.01140853801412,NaN,NaN,15.233797229872163,79.74971757672702,-0.16528989352273205,1.5062624442836068,1.6715523378063388,37417790,56781530.8,62.03342293505128,81.1500215432965,NaN,NaN,32.30266770399306,34.29224896925803
2003-06-24T09:30:00-04:00,90.61,91.56,90.58,91.19,9751301,8389109.95,56.65529292378333,67.93005737084954,NaN,NaN,8.232252496202669,56.24781684374174,-0.24633196266880142,1.363637384470337,1.6099693471391385,47169091,51318291,56.62418793862237,79.97668841390451,NaN,NaN,29.468848687643085,33.603191786170186
2003-06-25T09:30:00-04:00,91.11,91.73,90.08,90.09,9717000,8557675,50.170365805275594,66.3788799765157,NaN,NaN,-24.78982205137309,29.28589320129517,-0.3690916464576248,1.1486047890671074,1.5176964355247322,37452091,45495951.2,51.472847358000685,78.12556002919509,NaN,NaN,24.895398906311623,32.359221374761816
2003-06-26T09:30:00-04:00,90.21001,91.11,90.02,90.83,7086000,8479884.95,53.98609398439843,65.06994292741511,NaN,NaN,-35.96819483566593,5.677179109532352,-0.3932981214787037,1.0260737836763525,1.4193719051550562,44538091,43057091,49.44374624866799,75.87766205294714,NaN,NaN,22.210414375959534,30.90939180350435
2003-06-27T09:30:00-04:00,90.86501,91.2,89.78,89.87,7030199,8436509.95,48.76868401533721,63.7710902665131,NaN,NaN,-70.90289933986854,-21.63897330016655,-0.46205803363233966,0.8417993631146317,1.3038573967469713,37507892,40816991,47.588125267733865,73.37021737111756,NaN,NaN,18.214122307504997,29.095781875504443
2003-06-30T09:30:00-04:00,90.37,90.78,89.78999,89.91,5867199,8253039.8,48.98989298532165,62.2739206911407,NaN,NaN,-82.38316780158114,-41.162366306457216,-0.49026788128064225,0.6910225451461685,1.1812904264268107,43375091,42008451.2,48.69110463162733,70.83469398663475,NaN,NaN,15.116755693756353,27.098778135254715
2003-07-01T09:30:00-04:00,89.592,90.67,88.85001,90.58,7582699,8237639.8,52.67584427203885,60.78995508753804,NaN,NaN,-96.9935434464058,-62.2075254949789,-0.45026037937644636,0.6184649522062529,1.0687253315826992,50957790,42766191,49.42012669593515,68.2557104216642,NaN,NaN,13.573892196704934,25.166651572604746
2003-07-02T09:30:00-04:00,90.81,91.67999,90.72,91.66,4518301,8026604.85,57.9504321211628,59.61477493922308,NaN,NaN,-4.152598069569141,-58.08008069861811,-0.3424013470733609,0.6407236477409981,0.983124994814359,55476091,46370991,52.85219001169457,65.83366953754123,NaN,NaN,13.868561992318524,23.552638775421
2003-07-03T09:30:00-04:00,91,91.67,90.64999,90.7,3271200,7791664.85,52.36358034005829,58.5347767163286,NaN,NaN,-33.66193709349942,-57.61882915018481,-0.32707607097814706,0.5742799060916752,0.9013559770698223,52204891,47904351,54.273513793511306,63.48298313147118,NaN,NaN,12.338392014684022,21.950603523887146
2003-07-07T09:30:00-04:00,91.60001,92.8,91.59,92.36,6735602,7595525.05,59.61399583429691,57.54416283518265,NaN,NaN,58.044595843646064,-31.829330113481888,-0.20260478516526859,0.6480999956132365,0.8507047807785051,58940493,52190871.2,58.07818397012857,61.326521745571185,NaN,NaN,13.456353233111374,20.737139196633464
2003-07-08T09:30:00-04:00,92.06,92.55,91.761,92.46001,4683199,7437025.05,60.008913902719215,56.603388363011554,NaN,NaN,52.3853772699367,-4.875621099178323,-0.11534102554309533,0.7065284988496359,0.8218695243927312,63623692,56240591.4,61.350101642500654,59.370875681011185,NaN,NaN,14.451105114326426,19.83913432773246
2003-07-09T09:30:00-04:00,92.17,92.49001,91.23,91.83,7521398,7496510,56.27567703506569,55.509469312996416,NaN,NaN,17.561085037227883,18.03530459754841,-0.10229801839547559,0.6939970013983867,0.7962950197938623,56102294,57269492.2,62.15820548668706,57.59098504258219,NaN,NaN,14.10573430367858,19.02007718143905
2003-07-10T09:30:00-04:00,91.24001,91.34,90.11,90.59,7535199,7445839.85,49.71943617491538,54.54868314237559,NaN,NaN,-68.23432136694578,5.218959938073089,-0.175153855866656,0.5773526999605423,0.7525065558271983,48567095,55887693,60.333741928129264,56.20705031670275,NaN,NaN,11.659609482686411,17.968581795902956
2003-07-11T09:30:00-04:00,90.69,91.69,90.67,91.39,4635398,7248429.65,53.484600314817506,53.99297675360001,NaN,NaN,-21.84831837207934,7.581683682357105,-0.16744295636341522,0.5432028603729293,0.7106458167363445,53202493,56087213.4,60.5139637264175,55.34524725962194,NaN,NaN,10.84353236622906,16.950717591663828
2003-07-14T09:30:00-04:00,92.57001,93,91.5,91.85001,6306602,7254314.85,55.54597452316169,54.01491315945375,NaN,NaN,42.78749426495448,4.530263366618788,-0.13095433620886665,0.5469528964752612,0.6779072326841279,59509095,56200933.8,60.623777266920634,55.244558283326896,NaN,NaN,10.829201010175902,16.07621522287984
2003-07-15T09:30:00-04:00,92.41,92.5,91.07001,91.59,6848699,7191714.85,54.086958363901026,53.83146069089073,NaN,NaN,18.90470994556526,-2.165870098255499,-0.1239927149107023,0.5229163390457501,0.6469090539564524,52660396,54008274.6,57.314059478882754,55.29383482191692,NaN,NaN,10.37948394048039,15.262396468251346
2003-07-16T09:30:00-04:00,91.81,91.81,90.57001,91.28,6341699,7124959.75,52.32233920865869,53.985173076846664,NaN,NaN,-14.84123202980622,-8.64633351166232,-0.13881062469050942,0.4733957730933156,0.612206397783825,46318697,52051555.2,54.45684684554812,55.50697764245603,NaN,NaN,9.493767796488175,14.438306657999464
2003-07-17T09:30:00-04:00,90.7,91.34,90.39,90.72,8382699,7148019.7,49.199631761771954,53.64328291808764,NaN,NaN,-47.792115587591404,-4.557892355791445,-0.18214078175648396,0.38453042058822007,0.566671202344704,37935998,49925335.8,51.4551002336133,55.650645784237845,NaN,NaN,7.829067186517061,13.494129590644835
2003-07-18T09:30:00-04:00,91.09,91.96001,90.8,91.83,6417102,6977304.9,54.94017840403338,54.08410394585165,NaN,NaN,37.920388419458604,7.395849002516144,-0.13407979035392548,0.39907146440229724,0.5331512547562227,44353100,48155457.2,49.03226660644519,55.753798737002946,NaN,NaN,8.085545227829295,12.721474681671186
2003-07-21T09:30:00-04:00,91.81,91.88,90.8,91.14999,8946000,7023404.9,51.128416739878126,54.23685564260569,NaN,NaN,14.42056852551866,1.7224638546289797,-0.14518469566486603,0.35167038517514015,0.4968550808400062,35407100,43335058.2,43.08225534710334,55.35316664525123,NaN,NaN,7.146105159441747,11.924993321352694
2003-07-22T09:30:00-04:00,91.32001,91.94,90.45,91.66,8465699,6882159.75,53.721763265809514,54.31156414216074,NaN,NaN,22.024276978213607,2.3463772611586493,-0.116516299729994,0.3512097061775137,0.4677260059075077,43872799,41577538.8,41.122864823852,54.760505082959575,NaN,NaN,7.138019348803735,11.241139896702844
2003-07-23T09:30:00-04:00,91.82001,92.17,91.06,92.06,5297199,6659454.65,55.706969022972565,54.15131677800429,NaN,NaN,68.1033157104531,18.935286809210517,-0.07117663077900682,0.3787552174337492,0.449931848212756,49169998,42147799,42.04390652715796,53.988484834064096,NaN,NaN,7.716500197758738,10.737619939710829
2003-07-24T09:30:00-04:00,92.67999,92.97,91.14999,91.24001,6707898,6508999.55,50.887764644965635,54.04590137121197,NaN,NaN,65.16987263117151,41.5276844529631,-0.09545919698621191,0.3306078519799911,0.426067048966203,42462100,43053019.4,43.553417356101306,53.222763659963384,NaN,NaN,6.782701297079513,10.17263156219207
2003-07-25T09:30:00-04:00,91.38,92.92999,90.92,92.91,8850801,6597239.6,58.72014813477324,53.982055106960274,NaN,NaN,111.70508241985752,56.28462325304288,-0.002984421766074996,0.42233652175860925,0.42532094352468425,51312901,44444979.6,45.887374634043255,52.35199156452872,NaN,NaN,8.48333138959175,9.93130296610631
2003-07-28T09:30:00-04:00,93.06,93.14999,92.39999,92.66,5666398,6529049.55,57.248251574022035,53.78486494062476,NaN,NaN,151.85653380922486,83.77181630978411,0.035301438318388334,0.46944774142266965,0.4341463031042813,45646503,46492860.2,49.21441596932791,51.48515687358781,NaN,NaN,9.387229011741189,9.853578115482721
2003-07-29T09:30:00-04:00,92.86,93.03,91.74001,92.27,5964801,6533929.65,54.934868677495366,53.689092915084025,NaN,NaN,96.78699728397031,98.72436037093546,0.028600796106403037,0.4698972982372851,0.44129650213088206,39681702,45654640.8,47.91581352128569,50.46784316177343,NaN,NaN,9.435361671982314,9.793832909268376
2003-07-30T09:30:00-04:00,92.48,92.58,91.75,92.16,5326398,6421114.6,54.26875566414504,54.01404430717186,NaN,NaN,67.74624424420728,98.6529460776863,0.011858503394682918,0.4561196313742357,0.4442611279795528,34355304,42691702,43.542167944444905,49.268445020081685,NaN,NaN,9.2833224506694,9.720902843754237
2003-07-31T09:30:00-04:00,92.91,93.77,92.3,92.47,10245000,6707449.55,55.891953097537936,54.18599807736617,NaN,NaN,144.77791078556817,114.57455370856562,0.016476348213545877,0.46485656324648517,0.4483802150329393,44600304,43119342.8,44.331958253175095,48.112587486278656,NaN,NaN,9.61221005173206,9.705375302036783
2003-08-01T09:30:00-04:00,92.49001,92.55,91.5,91.78999,6744801,6881129.6,51.5680373748644,53.90185970963066,NaN,NaN,19.72140847626615,96.17781891984734,-0.028977439920593928,0.41215841513219686,0.4411358550527908,37855503,40427863.2,40.49258974177873,46.67464552019709,NaN,NaN,8.665195399937954,9.556778173165522
2003-08-04T09:30:00-04:00,91.60001,92.24001,90.60001,91.94,7650000,6926849.5,52.44209535341505,53.784369494595936,NaN,NaN,-26.633117254041885,60.47988870719401,-0.05039641208908169,0.3781403399414387,0.4285367520305204,45505503,40399663.2,40.45305881936249,45.47028833023136,NaN,NaN,8.119525155915571,9.351456313558387
2003-08-05T09:30:00-04:00,91.75999,92.05,90.03,90.03,5988398,6992109.45,42.039080454850534,53.04985101218107,NaN,NaN,-136.44443881742018,13.833601486915905,-0.18697817135156042,0.19481403784106988,0.3817922091926303,39517105,40366743.8,40.40347184995803,44.46647583054636,NaN,NaN,4.272536264335464,8.62589630652654
2003-08-06T09:30:00-04:00,90.39,91.5,90.10001,90.66,9097500,7070914.55,45.8544271106917,52.810907822818194,NaN,NaN,-112.85937953583375,-22.287523269092297,-0.2260588658082313,0.09921862693234118,0.3252774927405725,48614605,43218604,46.51954029334073,44.1139358348126,NaN,NaN,2.249789930698654,7.715023967122557
2003-08-07T09:30:00-04:00,90.8,91.55,90.42999,91.55,6172699,7002789.55,50.783276783156765,52.513986278469865,NaN,NaN,-65.37964086533745,-64.31903359927341,-0.18487128069815872,0.09418839186787409,0.2790596725660328,54787304,45256004,50.4331327707363,44.21399770369054,NaN,NaN,2.0874957016573816,6.911091357770389
2003-08-08T09:30:00-04:00,91.78,92.2,91.45,92.19,4954199,7018729.6,54.02432424870913,52.72083681481494,NaN,NaN,33.235849687318876,-61.61614535706288,-0.11106527119146498,0.14022808357670158,0.25129335476816655,59741503,49633204,57.61019426329632,45.25170762627575,NaN,NaN,2.979373074344371,6.349417317280958
2003-08-11T09:30:00-04:00,92.05,92.66,91.60001,92.44,5898898,6998344.4,55.26362914021317,52.83097009155806,NaN,NaN,70.68004559833741,-42.15351278658702,-0.045319446843496675,0.19464404621379572,0.2399634930572924,65640401,53660183.6,62.92839052053113,46.809245176038544,NaN,NaN,4.079531045722813,6.025147849915508
2003-08-12T09:30:00-04:00,92.47,93.39,92.21001,93.25,5580602,6934939.55,59.10956038484692,53.07401233169194,NaN,NaN,142.72524311797412,13.680423600491839,0.047769088771005275,0.299674854021049,0.2519057652500437,71221003,60000963.2,69.43154825677503,48.76550529958263,NaN,NaN,6.220623139170002,6.053072891237579
2003-08-13T09:30:00-04:00,93.5,93.64999,92.55,93.03,7476199,6991664.55,57.65966969412743,53.5577198352035,NaN,NaN,137.77755587050103,63.807810681758795,0.08727458208441013,0.36099899285555637,0.27372441077114623,63744804,63027003,71.9595880066998,50.79451748891109,NaN,NaN,7.544019631327016,6.266065282678928
2003-08-14T09:30:00-04:00,93.05,93.58,92.41,93.10001,6276801,6886369.65,58.01262388880894,53.50718238906319,NaN,NaN,119.86013435993867,100.85576572681401,0.10943316357765293,0.4105158652432124,0.30108270166555945,70021605,66073863.2,74.26718677645923,52.82164692765509,NaN,NaN,8.724371442475828,6.617251876935628
2003-08-15T09:30:00-04:00,93.14999,93.52,92.89999,93.33,3957300,6763379.55,59.215424422355795,53.647694735372745,NaN,NaN,126.11389800913975,119.4313753911782,0.12951757689204801,0.46297967278061947,0.33346209588857145,73978905,68921343.6,76.23551372205627,54.751725338564256,NaN,NaN,10.050560025353782,7.107724469566793
2003-08-18T09:30:00-04:00,93.72,94.39,93.53999,94.28,5727602,6602459.65,63.82520534835032,54.28271878329095,NaN,NaN,183.31274796429008,141.95791586436872,0.1929032430103172,0.574591149651468,0.38168790664115076,79706507,71734564.8,78.02400314399112,56.90231031161465,NaN,NaN,12.605739498784722,7.893155188026497
2003-08-19T09:30:00-04:00,94.37,94.61,93.62,94.49001,7071000,6532724.7,64.77309946036053,55.03302905444921,NaN,NaN,169.57271773477444,147.32741078772878,0.23244241558404338,0.672240926121205,0.4397985105371616,86777507,74845865.6,79.83179335479375,59.49442641235385,NaN,NaN,15.004614855338595,8.90907799764251
2003-08-20T09:30:00-04:00,93.94,94.49001,93.84,94.17999,5288000,6532264.75,62.182751500460945,55.482371797515135,NaN,NaN,138.77717222601137,147.52733405883083,0.22124547622721374,0.7163553558211788,0.4951098795939651,81489507,78394806.2,81.68276891172835,62.162341459393375,NaN,NaN,16.333722657609787,9.969741520494978
2003-08-21T09:30:00-04:00,94.59,95.05,94.10001,94.44,6866602,6540199.95,63.50109413147872,56.33473299441615,NaN,NaN,144.64261804332688,152.48383079550848,0.21470880660959035,0.763495887855953,0.5487870812463627,88356109,82061707,83.38003034131945,65.22573007364629,NaN,NaN,17.82508179587842,11.091932988406898
2003-08-22T09:30:00-04:00,95.16,95.24001,93.64999,93.71001,5892000,6392259.9,57.44614118127535,56.69216483926333,NaN,NaN,106.28524219456969,148.51809963259447,0.14776691482189563,0.7334957247737321,0.5857288099518365,82464109,83758747.8,84.11368211502194,68.34434602333624,NaN,NaN,17.45687561801211,12.001210506921927
2003-08-25T09:30:00-04:00,93.52,94,93.00999,93.48,4386602,6328270.1,55.645713143022554,57.664067174132754,NaN,NaN,51.93494009933268,122.24253805960299,0.07804416947186199,0.683284021791664,0.605239852319802,78077507,83432947.8,83.35296310706553,71.41216682741536,NaN,NaN,16.645960872507256,12.664746273434117
2003-08-26T09:30:00-04:00,93.11,93.84,92.55,93.60001,5630699,6311565,56.4132943847237,58.41827197942075,NaN,NaN,37.18133713536107,95.76426193972034,0.03239300074618212,0.6457311032525297,0.6133381025063476,83708206,82819087.6,81.85091364313053,73.93583635240033,NaN,NaN,16.169498795646273,13.16542520517871
2003-08-27T09:30:00-04:00,93.46001,93.71001,93.25,93.53,3081100,6199300.1,55.80655623798314,58.77707765476549,NaN,NaN,44.694201793300955,76.94766785317827,-0.007977923075464188,0.6033656986620173,0.6113436217374815,80627106,82646607.4,81.40701941351618,76.1482568268846,NaN,NaN,15.610025311857026,13.51465379184704
2003-08-28T09:30:00-04:00,93.75,94.17,92.81,93.97,5054699,5939785.05,58.8052942568962,59.11857551249314,NaN,NaN,51.074628150711334,58.23406987465516,-0.010357151125986341,0.5983971828299985,0.6087543339559849,85681805,82111746.6,79.95888490510434,77.74459187272805,NaN,NaN,15.900446688039363,13.855481348445943
2003-08-29T09:30:00-04:00,93.77,94.45,93.69,94.41,4477301,5826410.05,61.61057885721621,59.57192906370765,NaN,NaN,81.29407221527144,53.2358358787955,0.011224408819715093,0.6227848449806288,0.6115604361609137,90159106,83650746,81.00588901005094,79.0358417648366,NaN,NaN,16.91531705511508,14.292600735112963
2003-09-02T09:30:00-04:00,94.25999,95.60001,94.07001,95.46001,6040301,5745925.1,67.32840898463195,60.15898967797797,NaN,NaN,130.42979423932246,68.93480670679345,0.08559661585691225,0.718556205982054,0.6329595901251418,96199407,87275126,83.22811551353914,80.02131085460546,NaN,NaN,19.580982639287427,15.048083864280743
2003-09-03T09:30:00-04:00,95.61,96.23,95.36,96.02,5565898,5724800.1,69.9030336610478,61.03351567561514,NaN,NaN,177.09965140102383,96.91846955992601,0.1576912401532563,0.8300736403167122,0.6723824001634559,101765305,90886545.8,85.09887265062157,80.95983118631418,NaN,NaN,22.671116780461713,16.13708856659231
2003-09-04T09:30:00-04:00,95.91,96.49001,95.64999,96.21001,4866102,5513230.2,70.74543332094187,61.94300206362464,NaN,NaN,176.89664792084577,123.35895878543496,0.200608330882188,0.9231428137661908,0.7225344828840028,106631407,96087406,87.29644295940705,81.89049234223901,NaN,NaN,25.471387767966036,17.470559881074273
2003-09-05T09:30:00-04:00,95.69,95.95,94.86,95.38,7310199,5570105.2,62.51418700250647,62.178627962206825,NaN,NaN,113.87589820078745,135.91921279545016,0.1574352036084049,0.9193284873945089,0.761893283786104,99321208,98815286.6,88.27330688696692,82.75033471116119,NaN,NaN,25.481961284152195,18.61504579579969
2003-09-08T09:30:00-04:00,95.67,96.24001,95.31,96.12,3900100,5517400.25,66.28100695435444,62.35404236263569,NaN,NaN,139.05278352494412,147.47095505738474,0.16240114590258703,0.9648947161643378,0.8024935702617507,103221308,101427727,89.13498447913582,83.5439762351001,NaN,NaN,26.669902419475555,19.76573959918196
2003-09-09T09:30:00-04:00,95.78,95.99001,95.14999,95.45,4283000,5436605.35,60.36633696898757,62.0392736132519,NaN,NaN,98.99716449924138,141.18442910936852,0.10692635044752741,0.93615150832116,0.8292251578736326,98938308,101975507.2,89.31232063023693,84.22115675477463,NaN,NaN,25.796491689142808,20.627275612033507
2003-09-10T09:30:00-04:00,95.09,95.25,94.21001,94.67999,7630000,5539075.25,54.36227346585706,61.48066803935162,NaN,NaN,28.468409662073956,111.45818076157855,0.009850440608378253,0.8415382086341054,0.8316877680257272,91308308,99884107.8,83.69557499092168,84.36492861757415,NaN,NaN,23.076671994196115,20.97718938091388
2003-09-11T09:30:00-04:00,94.74001,95.34,94.53,94.97,6201801,5475355.35,56.13197421515708,60.95430233104293,NaN,NaN,41.173592605856825,84.31356969858075,-0.040585813321794784,0.7809555013734837,0.8215413146952785,97510109,98059848.2,79.02701132770632,84.05399868803035,NaN,NaN,21.42063732454529,21.04053908714694
2003-09-12T09:30:00-04:00,94.55,95.2,94.10001,95.05,5045102,5413770.4,56.631561430765245,60.89611806314936,NaN,NaN,21.49388079773526,65.83716621797032,-0.07245512701564172,0.7309724059257263,0.803427532941368,102555211,98706648.8,79.46438926164184,83.72190634136034,NaN,NaN,20.2379365030735,20.925881575136447
2003-09-15T09:30:00-04:00,95.13,95.21001,94.25,94.83,3837800,5407795.4,54.78385408518469,60.83455670187522,NaN,NaN,13.866036175305757,40.799816748042645,-0.1099965594400697,0.665931833641281,0.7759283930813506,98717411,97805869.4,77.05433759655529,83.27200451918102,NaN,NaN,18.71825068426221,20.610505733582986
2003-09-16T09:30:00-04:00,94.95,96.05,94.91,96,4995102,5371170.4,61.90279831494848,61.22666412546271,NaN,NaN,90.71492564061383,39.14336897631713,-0.06016792496010881,0.7007184868812146,0.7608864118413234,103712513,98760710.4,77.82217634621219,82.98423756940115,NaN,NaN,19.532510174284408,20.456506367968903
2003-09-17T09:30:00-04:00,96.02299,96.24001,95.71001,95.95,4179699,5226605.35,61.457485022418574,61.63030189577953,NaN,NaN,107.26628418759175,54.90294388142068,-0.03590993952717303,0.7159989874323571,0.7519089269595302,99532814,100405611.6,79.11853123709213,82.82077412822801,NaN,NaN,20.049854136826305,20.39841319209139
2003-09-18T09:30:00-04:00,95.98,96.95,95.7,96.95,5947102,5259560.45,66.62819061221361,62.18908020687365,NaN,NaN,137.43999826722168,74.15622501369367,0.03813960781264969,0.7995834367253423,0.7614438289126926,105479916,101999573,80.3190623930393,82.84650109165193,NaN,NaN,22.164322423645004,20.650685939456192
2003-09-19T09:30:00-04:00,96.73,96.99001,96.21001,96.47,4989301,5165695.4,62.30728751633789,62.23884511109662,NaN,NaN,121.66886196985394,94.1912212481174,0.04497867156902413,0.8176671683739727,0.7726884968049486,100490615,101586653.8,79.05114052262778,82.70687619969314,NaN,NaN,22.57661157554991,20.925818173183867
2003-09-22T09:30:00-04:00,95.72,95.85001,95.14,95.56,6262199,5184205.35,55.02213299660258,61.35982539766595,NaN,NaN,35.679519615086164,98.55391793607347,-0.01821111965673672,0.7499245972340276,0.7681357168907643,94228416,100688854.8,76.23329439302626,82.2072461196565,NaN,NaN,20.5539682841378,20.872696760463
2003-09-23T09:30:00-04:00,95.62,95.98,95.16,95.77,5297102,5229730.35,56.2921852860804,60.387621942311135,NaN,NaN,39.64163376371597,88.33925956069392,-0.05046383692749412,0.7050559207313967,0.7555197576588908,99525518,99851455.8,73.59809365399933,81.38576190561207,NaN,NaN,19.324383744372707,20.651509186735815
2003-09-24T09:30:00-04:00,95.89,96.09,94.31,94.44,6195000,5257945.4,47.20151838515197,58.70591373261186,NaN,NaN,-30.639928505382002,60.75801702209916,-0.15979923984661115,0.5557707078506269,0.715569947697238,93330518,98610996.6,69.7516596025065,80.13256309440487,NaN,NaN,15.103733184554185,19.858969757852726
2003-09-25T09:30:00-04:00,94.575,94.74001,93.22,93.25,7252000,5466490.4,40.84566828457187,57.15816239561652,NaN,NaN,-153.23173928198483,2.623669512257851,-0.3024183465749769,0.33754701447851687,0.6399653610534938,86078518,94730717,59.30968643691698,78.06373306225846,NaN,NaN,9.170724161088568,18.33207752974356
2003-09-26T09:30:00-04:00,93.62,93.74001,93.13,93.3,6564102,5541960.55,41.203908108708795,55.366941049498976,NaN,NaN,-182.6296233258894,-58.23602754689082,-0.37859952907820893,0.16671594970573267,0.5453154787839416,92642620,93161118,55.67867752267427,75.67399685108263,NaN,NaN,4.74592579077899,16.39119870989148
2003-09-29T09:30:00-04:00,93.50999,94.11,93.05,93.92,6896301,5662910.55,45.60305242643698,54.31242072503108,NaN,NaN,-144.86648712652587,-94.34522889521322,-0.37190619103769845,0.08043273998681855,0.452338931024517,99538921,94223219,57.57154701559323,73.40679873575094,NaN,NaN,2.4776154574035902,14.403543959536067
2003-09-30T09:30:00-04:00,93.74001,93.74001,92.42,93.13,7711102,5746450.6,41.35696887330758,53.38347039699183,NaN,NaN,-166.64951295999003,-135.60345823995445,-0.402754841451579,-0.05110462078995681,0.3516502206616222,91827819,92683679.2,53.97325536824729,71.28377590555989,NaN,NaN,-0.8438709888696405,12.225341824049538
2003-10-01T09:30:00-04:00,93.42,94.88,93.32001,94.81,6856699,5810990.65,51.663972945657584,53.06432744917044,NaN,NaN,-58.856919763365234,-141.24685649155109,-0.2969693563075883,-0.01956147472286318,0.2774078815847251,98684518,93754479.2,56.03165957080046,69.64125078006661,NaN,NaN,-0.1806447485992278,10.453058027956857
2003-10-02T09:30:00-04:00,94.57001,95.28999,94.45,95.19,6459699,5890670.5,53.64842027320086,52.85124593791585,NaN,NaN,-2.309364572753053,-111.06238154970472,-0.1933758017017025,0.03568812945759703,0.22906393115929952,105144217,97567619,62.4685332530193,68.42726106516501,NaN,NaN,1.0184534403921883,9.105257372590476
2003-10-03T09:30:00-04:00,96.31799,96.86,95.7,95.92,6949398,5872630.45,57.27713587415667,53.02933749427099,NaN,NaN,92.39814555570713,-56.05682777338542,-0.07380972710086309,0.13680177228322066,0.21061149938408374,112093615,101457818,67.66885043075416,67.75686912475065,NaN,NaN,3.2375860979071107,8.267018619064281
2003-10-06T09:30:00-04:00,96.00999,96.44,95.77,96.2,3654700,5860360.45,58.61541543846795,52.79452443166524,NaN,NaN,87.9735277526805,-9.48882479754414,0.020950040969832717,0.23679905059637463,0.2158490096265419,115748315,104699696.8,71.24457256758255,67.28704028341996,NaN,NaN,5.433894579918606,7.862286613472041
2003-10-07T09:30:00-04:00,95.8,96.7,95.55,96.69,6654199,5978920.4,60.922361946146985,52.75630135478868,NaN,NaN,94.19785809238793,42.68064941293145,0.10854819308065927,0.351534250977366,0.24298605789670674,122402514,110814635.8,76.51963395010137,67.10140476292062,NaN,NaN,7.977557928887956,7.8787539442457435
2003-10-08T09:30:00-04:00,96.74001,96.92,96.13,96.73,4543801,5824610.45,61.112931153761814,52.36235425061356,NaN,NaN,101.93863622636206,74.83976061087692,0.15810019116166346,0.4406112968487861,0.2825111056871226,126946315,116466995.2,80.1453391235104,67.08899595795427,NaN,NaN,10.06201134294242,8.190647858345269
2003-10-09T09:30:00-04:00,97.45,97.89999,96.64999,97.14,6370801,5833060.45,63.099333334430696,52.418928951905905,NaN,NaN,128.7841173340936,101.05845699224624,0.20446019264953602,0.5380863464990426,0.3336261538495066,133317116,122101575,82.9686190225067,67.36881585080276,NaN,NaN,12.407219046793236,8.793015170980693
2003-10-10T09:30:00-04:00,97.08,97.34,96.78,97.28999,2693500,5715480.35,63.82729102809234,53.04786881129803,NaN,NaN,110.02923958630106,104.58467579836501,0.2293300077215133,0.6202886635013982,0.3909586557798849,136010616,126884975.2,84.92801328449605,67.98986720019346,NaN,NaN,14.551772403594985,9.615694775639877
2003-10-13T09:30:00-04:00,97.5,98.02,97.45799,97.89999,4453500,5746265.35,66.7041236286569,53.79157869291065,NaN,NaN,136.338032794269,114.2575768066827,0.26826054753707784,0.7262843402012322,0.4580237926641544,140464116,131828135.4,86.63870995895383,68.9213397934045,NaN,NaN,17.26945359195395,10.709088892256172
2003-10-14T09:30:00-04:00,97.8,98.37,97.53799,98.36,4615801,5727300.3,68.72418390795286,55.328911944539286,NaN,NaN,134.33738551071167,122.28548229034746,0.3037798425462336,0.8377485958469464,0.5339687533007128,145079917,136363616,87.98609023540011,70.22379912432547,NaN,NaN,20.19234731695086,12.063840095783984
2003-10-15T09:30:00-04:00,98.8,98.83,97.85001,98.22,5046199,5770625.3,67.38426710210331,57.22452614579152,NaN,NaN,128.28343624704846,127.55444229448474,0.2963154430835625,0.904363057155166,0.6080476140716035,140033718,138981096.6,88.69464103402679,72.32272445269045,NaN,NaN,22.253192459566556,13.519461862038638
2003-10-16T09:30:00-04:00,97.67999,98.5,97.55,98.17999,7649801,5855760.25,66.98233405197945,59.06584228459657,NaN,NaN,107.06713913308113,123.21104665428224,0.268006758184542,0.943056061802281,0.675049303617739,132383917,138794456.8,88.29476346253476,74.65244487696621,NaN,NaN,23.85971497635668,14.996640878369787
2003-10-17T09:30:00-04:00,98.25,98.37,97.14,97.3,6300801,5921335.25,58.6903948368487,60.00065245676883,NaN,NaN,78.66257555851627,116.9377138487253,0.173900864167582,0.8924253838272165,0.7185245196596345,126083116,136808956.8,83.95822475678663,76.53720757276574,NaN,NaN,23.000911813031692,16.14010815475006
2003-10-20T09:30:00-04:00,97.55,98,97.19,97.97,4408602,5828655.4,62.49704583202968,61.51065795382042,NaN,NaN,76.47743006877072,104.96559330362564,0.14200812614101632,0.8960346773359049,0.7540265511948886,130491718,134814477.2,79.72244584044091,78.37643546363672,NaN,NaN,23.346986628977128,17.169662222496783
2003-10-21T09:30:00-04:00,97.8,97.97,97.39999,97.60001,4540398,5790820.2,59.25005797997741,62.05252117055755,NaN,NaN,67.53229746510804,91.60457569450492,0.08408786160920978,0.8591363782064008,0.775048516597191,125951320,130988757.8,72.19817444899256,79.53118652636472,NaN,NaN,22.69543916281896,17.959058928257093
2003-10-22T09:30:00-04:00,96.77,96.96001,95.96001,96.21001,6840398,5823090.1,48.95893762411713,61.71755812419442,NaN,NaN,7.299435816482703,67.40777560839174,-0.05239598484012853,0.7095535355470304,0.7619495203871589,119110922,126804198.6,64.97465111296584,79.71019494493233,NaN,NaN,18.73235292121066,18.06952949867903
2003-10-23T09:30:00-04:00,95.64999,96.5,95.64,95.95,6928801,5806930.15,47.30381572005226,61.00517811318696,NaN,NaN,-15.802350446136517,42.83387769254823,-0.1587345106607445,0.5635313820612282,0.7222658927219727,112182121,122763839.4,58.85200611382229,79.08042035086577,NaN,NaN,15.005830721075228,17.631858244735632
2003-10-24T09:30:00-04:00,95.42999,96.17999,95.09599,96.17999,6605801,5809015.1,48.947867434946545,60.31463897007829,NaN,NaN,-36.584110455071034,19.784540489830782,-0.2089716489544413,0.4610513315289211,0.6700229804833624,118787922,121304800.6,56.77155525330549,78.04663339984597,NaN,NaN,12.442303119411017,16.890493226832117
2003-10-27T09:30:00-05:00,96.45,96.77,96.06,96.28999,3798300,5654115.05,49.75527935463631,59.51699021354182,NaN,NaN,-14.093675288104375,1.6703194184557653,-0.22859320343136103,0.3842814761941611,0.6128746796255221,122586222,119723701.4,54.522257339994646,76.47539221340979,NaN,NaN,10.574447108487485,15.988200924211455
2003-10-28T09:30:00-05:00,96.55,97.73,96.42999,97.63,5378398,5537479.85,58.38885950402857,59.3224136671323,NaN,NaN,34.85781871577223,-4.8645763314113974,-0.14897953396293984,0.4266502621718473,0.5756297961347872,127964620,120126361.4,55.01111839329936,74.68009073268044,NaN,NaN,11.53462793617833,15.351976211635295
2003-10-29T09:30:00-05:00,97.34,98.02,97.28999,97.87,4433102,5416300,59.72372549077006,59.081298821156544,NaN,NaN,63.64406379393602,6.404349264079267,-0.08120114262294142,0.47412836785611034,0.5553295104790518,132397722,122783721.4,58.20423928400258,72.91120646564443,NaN,NaN,12.724933589130089,14.976684408420265
2003-10-30T09:30:00-05:00,98.55,98.60001,97.741,98.3,7225602,5454595.15,62.071394263576146,58.9558776236911,NaN,NaN,99.70198001169274,29.505215355645117,-0.012083499644242823,0.5402251359237482,0.552308635567991,139623324,128271962,63.90264057805595,71.40939412947013,NaN,NaN,14.44101616463308,14.900160373593524
2003-10-31T09:30:00-05:00,98.23,98.55,97.97,98.03,5322801,5373265.3,59.717592864659544,58.456839711977004,NaN,NaN,89.64692722503902,54.75142289166713,0.009605475327138957,0.5643154797269148,0.5547100043997758,134300523,131374482.2,66.66915700099705,69.98299748961607,NaN,NaN,15.174868571149878,14.93940440181586
2003-11-03T09:30:00-05:00,98.45,99.14999,98.45,98.50999,5379844,5459522.5,62.44411732517628,58.00826352749296,NaN,NaN,126.03856077773614,82.77787010483523,0.04827082499552149,0.6150485356441777,0.5667777106486562,139680367,134793311.2,69.44788797125479,68.65884018503426,NaN,NaN,16.613068992385802,15.178499343325852
2003-11-04T09:30:00-05:00,98.59,98.89999,98.38,98.58,4792945,5366459.8,62.83920326279307,57.68361611039937,NaN,NaN,109.30658531139782,97.66762342396035,0.06927575112957407,0.6533723995606238,0.5840966484310497,144473312,138095049.6,71.88558237474834,67.45819313794296,NaN,NaN,17.90103656784004,15.567433232542164
2003-11-05T09:30:00-05:00,98.34,98.81,97.98,98.56,4228398,5350689.65,62.63648374276918,57.373198231170065,NaN,NaN,87.10468359445723,102.3597473840646,0.07220823162452361,0.6743569379617043,0.6021487063371807,140244914,139664488,72.98881710001234,66.36491125490564,NaN,NaN,18.90931755771835,16.044845278995904
2003-11-06T09:30:00-05:00,98.38,98.96001,97.95,98.92999,5904102,5327354.7,64.89282828423622,57.816229191697744,NaN,NaN,94.84904027510798,101.38915943674763,0.08838320138725764,0.7126277080712526,0.624244506683995,146149016,140969626.4,73.90583785415242,65.64688361900319,NaN,NaN,20.408195137872838,16.66818097312118
2003-11-07T09:30:00-05:00,99.28,99.35001,98.11,98.11,4671000,5426229.7,56.71794737574777,57.403436444820464,NaN,NaN,79.76745806661141,99.41326560506211,0.0358672014467617,0.6690785084924471,0.6332113070456854,141478016,142405125,74.91459710542463,65.30346585221632,NaN,NaN,19.423891815368783,17.061853950585125
2003-11-10T09:30:00-05:00,98.336,98.5,97.60001,97.81,4654199,5436264.65,54.035911425399256,57.03099740520775,NaN,NaN,24.62780255629895,79.13111396077468,-0.023847193641780562,0.6034023149934598,0.6272495086352403,136823817,141833815,73.6935639129458,65.41027938535584,NaN,NaN,17.81535042670102,17.169496304315967
2003-11-11T09:30:00-05:00,97.69,97.92999,97.42999,97.62,3350000,5372974.6,52.34757990864463,57.273043282674,NaN,NaN,-3.359700917951871,56.59785671490473,-0.07786878049107226,0.5299135330214,0.6077823135124722,133473817,139633916,69.02802245160507,65.69980590954434,NaN,NaN,15.988904091666411,17.00084027393746
2003-11-12T09:30:00-05:00,97.73,98.95,97.66,98.8,6127500,5427039.65,60.584351337284005,58.22165296961913,NaN,NaN,74.80540190380914,54.13800037677512,-0.03788264644277817,0.5604290054589995,0.5983116519017777,139601317,139505196.6,68.75374204704192,66.40707276191718,NaN,NaN,16.80113125197579,16.972310413657222
2003-11-13T09:30:00-05:00,98.48,98.91,98.28,98.72,4045600,5246829.6,59.82929629785262,58.99889788839813,NaN,NaN,85.34555671859152,52.237303665471835,-0.02139434758497316,0.5715687174205613,0.5929630650055344,135555717,137386536.8,64.22988963031838,66.9398109317038,NaN,NaN,17.230289321989574,17.009164543418986
2003-11-14T09:30:00-05:00,98.72,99.30499,97.74001,97.97,6106301,5237104.6,53.14252740975273,59.240844178049315,NaN,NaN,52.27939341005338,46.739690734160234,-0.06320745317967746,0.5139537485309376,0.577161201710615,129449416,134980816.8,59.44679402416884,67.29156355200196,NaN,NaN,15.539193448991737,16.79916867278652
2003-11-17T09:30:00-05:00,97.46201,97.71001,96.63,97.53999,5915199,5312434.45,49.71196500539782,58.62106599957569,NaN,NaN,-40.156173533336705,33.7828955162331,-0.11880576069477677,0.428654000842144,0.5474597615369208,123534217,132322896.8,54.608281132242034,67.26278946192643,NaN,NaN,13.052600785877305,16.26394468894235
2003-11-18T09:30:00-05:00,97.8,97.89999,96.47,96.60001,4693801,5320104.6,43.15400232996027,57.43751434523214,NaN,NaN,-61.01605454951389,22.25162478992069,-0.21240412221459926,0.28195460876867173,0.494358730983271,118840416,129396216.6,49.801605093846746,66.66260130548673,NaN,NaN,8.67221066703173,15.179411257240831
2003-11-19T09:30:00-05:00,96.71001,97.53,96.60001,97.38,4055500,5180859.7,49.148673947546165,56.514462894087146,NaN,NaN,-52.14108425151139,-3.137672441143411,-0.2146650214304306,0.22602745419523274,0.4406924756256633,122895916,126055136.4,44.938625520373556,65.30802880136656,NaN,NaN,6.899429156296372,13.996556671391623
2003-11-20T09:30:00-05:00,96.59,97.7,96.53,96.53999,6759699,5172404.6,43.79260246491757,55.37696357981986,NaN,NaN,-83.75233369109127,-36.95725052307997,-0.262454199080477,0.11262472677506707,0.3750789258555441,116136217,122171236.4,40.043569051038624,63.40620109065525,NaN,NaN,3.5582566639211555,12.5053709560387
2003-11-21T09:30:00-05:00,96.56,96.62,95.92,96.49001,4752898,5079759.45,43.488926981932664,54.02302141244531,NaN,NaN,-148.00609107484524,-77.0143474200597,-0.2852583768088696,0.01850595484445705,0.30376433165332667,111383319,118558017,36.1035460406211,61.02446238132427,NaN,NaN,0.8657132215614621,10.842562708256237
2003-11-24T09:30:00-05:00,96.786,97.64999,96.77,97.47,4877898,5133739.35,50.70675399897667,53.15641789360128,NaN,NaN,-62.00573230097329,-81.38425917358703,-0.22482656720276312,0.02273112264987276,0.24755768985263588,116261217,117103417,34.626452781429435,58.36309598180149,NaN,NaN,0.8835971222773104,9.419853338830675
2003-11-25T09:30:00-05:00,97.58501,98.07001,97.37,97.67999,5583102,5143974.55,52.1180130259419,52.40509855668505,NaN,NaN,-20.84546883970745,-73.35014203162574,-0.16401916451801096,0.04253373420512219,0.20655289872313315,121844319,117704197.6,35.79483522282101,55.70638299057354,NaN,NaN,1.346351705013661,8.266495962571103
2003-11-26T09:30:00-05:00,98.08,98.14999,97.14999,97.89999,4062300,5125434.45,53.61629482335518,51.59963188090783,NaN,NaN,-17.88936744318175,-66.4997986699598,-0.1051513242278031,0.07511374343837929,0.1802650676661824,125906619,118306338.2,37.009961846464115,53.070963275738656,NaN,NaN,2.180568426908208,7.397077743190689
2003-11-28T09:30:00-05:00,97.86,98.16,97.763,98.08,864700,4807389.35,54.86090353163939,51.46698589204294,NaN,NaN,13.723147724423262,-47.0047023868569,-0.05289752077165849,0.11414316670160929,0.16704068747326778,126771319,120433358.6,41.24043161769057,50.66566574090051,NaN,NaN,3.2320070324042245,6.802067641649765
2003-12-01T09:30:00-05:00,98.33,99.16,98.33,99.10001,5855199,4834009.25,61.21210752228388,51.9795713275347,NaN,NaN,103.25447013313945,3.247409854740039,0.04619890356632933,0.22478931693117943,0.1785904133648501,132626518,124681998.4,48.65786404295755,48.877401464472776,NaN,NaN,6.211472894767317,6.717696963523701
2003-12-02T09:30:00-05:00,98.89999,99.03999,98.50999,98.75,4125000,4771267.05,58.18667515793972,52.396649559627214,NaN,NaN,91.9520074505881,34.03895780505231,0.0819238044380381,0.28099516891239773,0.19907136447435964,128501518,127130058.6,52.38739175102092,47.68878498585963,NaN,NaN,7.7518326102205615,6.865430627337538
2003-12-03T09:30:00-05:00,99,99.59,98.85001,98.95,6231602,4843199.9,59.420879231045596,52.3135444091816,NaN,NaN,123.95137241839306,62.99832605667241,0.11096953612976992,0.33778328463657203,0.2268137485068021,134733120,129707818.8,56.01090641297358,46.778582440569025,NaN,NaN,9.382367245550807,7.224993001368005
2003-12-04T09:30:00-05:00,98.88,99.52,98.86,99.45,6236699,4943614.95,62.40825243155371,52.497755561588825,NaN,NaN,127.23440329439667,92.0230802041881,0.1531986458510553,0.41831205582062125,0.26511340996956595,140969819,132720458.8,59.85609038621805,46.46616820884758,NaN,NaN,11.684382262145824,7.86204861005055
2003-12-05T09:30:00-05:00,99.14999,99.33,98.59,98.8,5431199,4919969.8,56.57708573590997,52.74308115631435,NaN,NaN,87.43906716925092,106.76626409315364,0.12773763771180546,0.4247854571093228,0.29704781939751734,135538620,134473919,61.94134415168532,46.64435036081304,NaN,NaN,11.9198701534248,8.441737401961158
2003-12-08T09:30:00-05:00,98.73,99.85001,98.73,99.81,5194398,4946139.7,62.44839129182461,53.652825891059116,NaN,NaN,127.10327650201208,111.53602536692816,0.16683066521435608,0.5055861509154624,0.33875548570110636,140733018,136095219,63.81307370317028,47.301835544450775,NaN,NaN,14.042009361532262,9.241776253328458
2003-12-09T09:30:00-05:00,100,100.14999,99.28,99.44099,9541301,5190494.8,59.293914866683714,54.805676786539365,NaN,NaN,121.77855702437716,117.50133528168597,0.15595015312424643,0.5336931771064144,0.37774302398216797,131191717,136633258.8,64.4381170019035,48.34730068074054,NaN,NaN,14.783275834704343,10.03341905066787
2003-12-10T09:30:00-05:00,99.48,99.77,98.98,99.60001,5558602,5300924.9,60.22631044964735,55.59693653668945,NaN,NaN,96.37101699004874,111.9852641960171,0.14765976806996406,0.562317734069623,0.414657965999659,136750319,137036698.6,64.927305859031,49.775063562073214,NaN,NaN,15.66334854870336,10.83769469324437
2003-12-11T09:30:00-05:00,99.58,100.42999,99.52,100.38,6780602,5333580,64.51925756817514,57.077411901207846,NaN,NaN,130.32951171686489,112.60428588051077,0.18071972836731331,0.6405576264588007,0.45983789809148734,143530921,137548919,65.57479305017478,51.59872241915438,NaN,NaN,17.785350678803898,11.83021697689573
2003-12-12T09:30:00-05:00,100.32001,100.77,99.92999,100.63,6134199,5438009.95,65.79364679733737,58.67060617373676,NaN,NaN,135.1833816178682,122.1531487702342,0.20372960583046507,0.7144999053795686,0.5107702995491036,149665120,140374219,68.976841167397,53.94681492820979,NaN,NaN,19.9106790445538,12.984568700846882
2003-12-15T09:30:00-05:00,101.7,101.78,100.2,100.45,7614699,5513429.85,64.01093657486102,59.62090492915707,NaN,NaN,136.87286578874532,124.10706662758086,0.1913281338534184,0.7499304668658766,0.5586023330124582,142050421,140637699.6,69.2817215790196,56.4221912708948,NaN,NaN,21.1398166695273,14.149604124944084
2003-12-16T09:30:00-05:00,100.67,101.56,100.60001,101.5,5993500,5517344.9,69.24577272256084,60.84431633605842,NaN,NaN,145.0873023827698,128.7688156992594,0.23544127070956677,0.8529039213994167,0.61746265068985,148043921,144008140.4,72.94458294582668,59.075744679680916,NaN,NaN,23.92613579041046,15.546251505724994
2003-12-17T09:30:00-05:00,101.34,101.86,101.11,101.86,4867801,5526044.9,70.81330109661101,62.07267392700527,NaN,NaN,151.83125008418077,139.86086231808582,0.26809337966993374,0.9525793752772671,0.6844859956073334,152911722,147240421,75.91110464773766,61.85439773691475,NaN,NaN,26.71797131362365,17.142211478281943
2003-12-18T09:30:00-05:00,101.89,102.83,101.7,102.81,10493500,5847944.9,74.50607771074623,63.47590065408433,NaN,NaN,174.33866999120383,148.6626939729536,0.3288916434859165,1.095600549964729,0.7667089064788125,163405222,151215281.2,78.96548603632264,64.54904448110275,NaN,NaN,30.40900750062675,19.03746805290263
2003-12-19T09:30:00-05:00,103.03999,103.07001,102.38,102.74001,10812699,6050594.9,73.76558815044245,64.37257784180994,NaN,NaN,165.54833930899292,154.73568551117853,0.3383012369293502,1.1895854526405003,0.8512842157111501,152592523,151800761.8,79.38021638531839,66.7434982198428,NaN,NaN,33.10717155740176,21.047425696402506
2003-12-22T09:30:00-05:00,102.61,103.63,102.61,103.61,6461602,6136030.1,76.8460465324959,65.70539008284968,NaN,NaN,164.91980479396074,160.34507331222161,0.37422441159537523,1.319064730205369,0.9448403186099938,159054125,155201502.6,81.64410291718994,68.8332633031406,NaN,NaN,36.48320497307914,23.252537021642024
2003-12-23T09:30:00-05:00,103.39999,103.87,103.07001,103.46001,7623199,6273295.15,75.20646906800665,66.83293221406117,NaN,NaN,149.37241120937307,161.20209507754228,0.3589369592695084,1.3935115176968793,1.034574558427371,151430926,155878903.6,82.06647309453632,70.6943752089665,NaN,NaN,38.70220175780865,25.459631983951542
2003-12-24T09:30:00-05:00,103.16,103.44,103.10001,103.2,3742600,6181270.05,72.32565508438726,67.541318117835,NaN,NaN,122.01312935173156,155.2384709310524,0.3045137622631915,1.4152167612563602,1.1107029989931687,147688326,154834224.4,79.04570284716634,72.06506181331996,NaN,NaN,39.691994629399716,27.492826647586995
2003-12-26T09:30:00-05:00,103.25,103.52,103.2,103.27,2088500,6082580.05,72.62962696194707,68.68792820540908,NaN,NaN,110.85276520786132,142.54128997438391,0.24878041136914275,1.421678513204597,1.1728981018354543,149776826,152108545.2,71.63663489314779,72.75758258056727,NaN,NaN,40.5864748786947,29.363347823459524
2003-12-29T09:30:00-05:00,103.63,104.75,103.58,104.67999,6598602,6369275.15,77.89617613753398,69.79134140867403,NaN,NaN,134.27447984461986,136.2865180815093,0.28009552620744915,1.5230175095947658,1.2429219833873166,156375428,152865126.2,72.40968448224038,73.3716262076437,NaN,NaN,43.13413597446193,31.330603273602723
2003-12-30T09:30:00-05:00,104.53,104.74001,104.16,104.33,5492801,6351155.25,74.08549257659146,70.84788267366744,NaN,NaN,120.89772805975933,127.482102734669,0.2513731365646341,1.5571384040931093,1.3057652675284752,150882627,151230826.6,68.09241402129808,73.63264742331475,NaN,NaN,44.034876801093695,33.14549949181572
2003-12-31T09:30:00-05:00,104.48,104.74001,104.17999,104.57001,5658199,6427815.2,74.9890892802567,71.90236687585384,NaN,NaN,110.99278101123328,119.80617669504105,0.22360556878599858,1.5852722285109735,1.361666659724975,156540826,152252806.6,69.3241145135377,73.94670518435093,NaN,NaN,45.042494111949374,34.84507015183481
2004-01-02T09:30:00-05:00,105.03999,105.47,103.99001,104.37,8232699,6527870.05,72.7137036970996,72.4876844564913,NaN,NaN,103.32020804342692,116.0675924333801,0.16930139588547477,1.5732934045818183,1.4039920086963436,148308127,152376766.8,69.47801799833945,74.2255069663627,NaN,NaN,45.20838604232848,36.32554385047676
2004-01-05T09:30:00-05:00,104.84,105.63,104.8,105.58,6942602,6563165.2,77.21748186466591,73.3036726755862,NaN,NaN,118.32228306782575,117.56149600537299,0.19080897950303077,1.6425032330751321,1.4516942535721014,155250729,153471547.4,70.86812824060583,74.36059890016334,NaN,NaN,46.79458567358669,37.82112125377818
2004-01-06T09:30:00-05:00,105.25,105.66,105.14,105.5,7702801,6676745.3,76.32054236810397,74.18293023224642,NaN,NaN,113.58479108600027,113.42355825364908,0.17594676172974344,1.6716277057342808,1.4956809440045373,147547928,151706047.4,65.67352756016454,74.10287075595942,NaN,NaN,47.78438364808915,39.24444445296546
2004-01-07T09:30:00-05:00,105.32001,105.58,104.808,105.55,6669398,6750495.3,76.50423922529659,74.70139212529897,NaN,NaN,101.35226798924593,109.5144662395464,0.14696303709508496,1.6793847403733935,1.5324217032783085,154217326,152372987.2,66.66749632663998,73.6545074260175,NaN,NaN,48.63744424654133,40.58630156633344
2004-01-08T09:30:00-05:00,106.02,106.06,105.50999,106.00999,7921102,6669485.35,78.18120359253102,75.22767087500753,NaN,NaN,115.42886606839195,110.40168325097811,0.13647724577695697,1.7030182604995048,1.5665410147225478,162138428,153492507.6,68.32549238920869,73.11267797897972,NaN,NaN,49.85960850839684,41.911059700913924
2004-01-09T09:30:00-05:00,105.35699,105.73,104.62,104.69,9384102,6860760.35,64.05316557455339,74.48103429385091,NaN,NaN,75.1925757610479,104.77615679450233,0.02423005871314521,1.5968285881139792,1.572598529400834,152754326,154381747.4,69.61820090775115,72.44501475551033,NaN,NaN,46.4202360687577,42.555227753463036
2004-01-12T09:30:00-05:00,104.81,105.19901,104.60001,105.17,7877699,6915615.2,66.42891258472923,73.9569860391571,NaN,NaN,67.14550201131647,94.54080058320048,-0.031099085242532354,1.5337246728476686,1.564823758090201,160632025,155458006.6,71.15274006226294,71.85733787529207,NaN,NaN,44.316351772750465,42.80681689907553
2004-01-13T09:30:00-05:00,105.17999,105.28,103.80099,104.5,8506699,7034240.2,60.425753360039906,72.78410795541025,NaN,NaN,38.23155224667202,79.47015281533481,-0.1211720895948829,1.4133586460965972,1.5345307356914801,152125326,156373486.2,72.42842250700505,71.1990749888503,NaN,NaN,40.56494666115087,42.48654972222915
2004-01-14T09:30:00-05:00,104.86,105.74001,104.78,105.67101,6678301,6987420.3,66.17862250342418,72.1392617722258,NaN,NaN,80.81072693723651,75.36184460493298,-0.11053496384896899,1.396362030880269,1.5068969947292379,158803627,157290746.4,73.68411846376733,70.6003353723668,NaN,NaN,39.18034004648562,42.014234054265785
2004-01-15T09:30:00-05:00,106.07001,106.12,104.97,105.96001,9704000,7172945.3,67.43674121742262,71.79005363887117,NaN,NaN,95.55740357040074,71.38755210533472,-0.0933681814678089,1.3901867678944768,1.4835549493622857,168507627,158564586.2,75.36226763147266,70.33723285696011,NaN,NaN,38.49372852284427,41.51130469263414
2004-01-16T09:30:00-05:00,105.95,106.16,105.50999,106.12,8975301,7378320.3,68.14324031099092,71.46959744951717,NaN,NaN,110.3718679653322,78.4234105461916,-0.08102895974442337,1.3822687496817565,1.4632977094261799,177482928,163510306.6,80.54862440557982,70.97380353641952,NaN,NaN,38.16595398261108,41.033397448345134
2004-01-20T09:30:00-05:00,106.39999,106.39999,105.3,105.46001,8633602,7285325.4,62.15261251738527,70.3450571909351,NaN,NaN,87.39040093359954,82.47239033064821,-0.12450692849577716,1.3076640488064584,1.4321709773022355,168849326,165153766.8,81.9112732961036,71.65248845169548,NaN,NaN,35.99406126714724,40.31349227960258
2004-01-21T09:30:00-05:00,105.50999,106.64,105.03,106.3,9305000,7209940.45,66.22263465382638,69.78342448216613,NaN,NaN,101.93382915035865,95.21284571138554,-0.10468184806370617,1.3013186672226027,1.4060005152863089,178154326,170359566.8,85.40021088705784,72.8887596563926,NaN,NaN,35.41828095876099,39.61417637662521
2004-01-22T09:30:00-05:00,106.5,106.75,106.19,106.49001,6019398,7187830.25,67.08490413391485,69.21883982885599,NaN,NaN,134.9344827025093,106.03759686444009,-0.08746052028446938,1.296674864930722,1.3841353852151914,184173724,175433586.2,87.85837722523736,74.21263556437114,NaN,NaN,35.2225594645813,38.986802532047506
2004-01-23T09:30:00-05:00,106.57001,106.59,105.36,105.86,6833199,7148330.25,61.480726383197705,68.41648430643443,NaN,NaN,80.00842077049163,102.92780030445826,-0.12490636515063014,1.2280024287769038,1.352908793927534,177340525,177200165.8,88.57935376722581,75.57701669072017,NaN,NaN,33.305156067949035,38.17513875146201
2004-01-26T09:30:00-05:00,105.72,107.23,105.72,107.17999,7091301,7315765.3,67.58981576546472,67.7287938707772,NaN,NaN,147.48650133731053,110.35072697885394,-0.06992443037099272,1.265503255963793,1.3354276863347858,184431826,178589945.4,89.12638935639237,76.88117819899064,NaN,NaN,33.60888333579238,37.52281654922349
2004-01-27T09:30:00-05:00,107.17,107.22,106.25,106.28999,5659801,7494330.35,60.60996016363387,66.60660942760076,NaN,NaN,128.65805012782096,118.60425681769823,-0.10076982474685403,1.2094654054012182,1.3102352301480722,178772025,180574485.2,89.87237597457937,78.60966737144884,NaN,NaN,31.474788309549755,36.65881251498439
2004-01-28T09:30:00-05:00,106.48,106.78,104.53999,105.07001,7732500,7551025.25,52.59250691858585,64.89862854855,NaN,NaN,-3.7724743579364204,97.46299611603922,-0.20462203763524256,1.0544576831040189,1.2590797207392614,171039525,179151525,85.35087271239456,79.9441942561456,NaN,NaN,26.772758189128247,35.246519039862086
2004-01-29T09:30:00-05:00,105.45,105.45,104.35001,105.082,12597801,7906275.25,52.65878699101769,63.07559879129905,NaN,NaN,-71.95018750140885,56.08606207525556,-0.2697015830748992,0.9219527418956375,1.1916543249705367,183637326,179044245.4,85.00365386178163,81.1354915041865,NaN,NaN,23.221284836067426,33.528628439319995
2004-01-30T09:30:00-05:00,104.94,105.23,104.57001,105.08,8249699,8035850.25,52.645565109173866,62.26077018662908,NaN,NaN,-78.141079926286,24.456161935900035,-0.3073456990522525,0.8074722011552211,1.1148179002074736,175387627,178653665.8,83.66909572237792,82.13912684808842,NaN,NaN,20.436903636452026,31.658382038910286
2004-02-02T09:30:00-05:00,105.2,105.86,104.53,105.3,6735398,7960985.2,54.013392088603936,61.373947294048705,NaN,NaN,-48.945664326677814,-14.830271196897636,-0.3109524282064542,0.7261273649494058,1.03707979315586,182123025,178191905.6,82.02940814324239,82.91603171101553,NaN,NaN,18.550400356996597,29.78581322720833
2004-02-03T09:30:00-05:00,105,105.45,104.72,105.14999,3873100,7807510.1,52.891531570791834,60.8357885948167,NaN,NaN,-63.38048705344495,-53.23797863315082,-0.3159405623176259,0.6421540902588276,0.9580946525764535,178249925,178087485.6,81.63978052397974,83.57398585508516,NaN,NaN,16.676624774003635,27.913072019607657
2004-02-04T09:30:00-05:00,104.7,105.44,104.61,104.783,8409500,7842845.05,50.147402365198445,59.69070144208629,NaN,NaN,-78.86910205797193,-68.25730417315792,-0.3346601123063957,0.5397695121934589,0.8744296244998546,169840425,177847665.6,80.69180746826606,84.0745350696922,NaN,NaN,14.299519353660209,25.968278781615165
2004-02-05T09:30:00-05:00,105,105.44,104.67999,105.13,5334699,7776110.1,52.64894549936613,58.63443031936797,NaN,NaN,-57.7596075507972,-65.41918818303559,-0.3146770061226114,0.48108336684659037,0.7957603729692018,175175124,176155225.2,74.14833558894306,83.98782563808295,NaN,NaN,12.957291717607019,24.109566343899715
2004-02-06T09:30:00-05:00,105.23,106.14999,104.83,106.00999,6895801,7724845.05,58.35592564764441,57.93533641484322,NaN,NaN,19.18463320510713,-45.95404555675697,-0.2367519831038436,0.49982039408939727,0.7365723771932409,182070925,177491884.8,75.81632473687259,83.64980423317529,NaN,NaN,13.425574511476817,22.58328179641073
2004-02-09T09:30:00-05:00,106.06,106.42,105.8,106.12,3840300,7447654.95,59.0208598303201,57.711639794338566,NaN,NaN,70.91504362880389,-21.981903965660614,-0.17519376673284337,0.5175801687771866,0.69277393551003,185911225,178249524.8,76.73270832413947,83.27990673517786,NaN,NaN,13.999837802332102,21.357075511542355
2004-02-10T09:30:00-05:00,105.95,106.56,105.82001,106.25,3348600,7221200,59.836968153282264,57.25552075858541,NaN,NaN,76.12127350645343,5.918448146319065,-0.1254459139810683,0.5359665430336946,0.6614124570147629,189259825,180451504.8,79.19965974272728,82.83701022486854,NaN,NaN,14.704503900554222,20.40670813854405
2004-02-11T09:30:00-05:00,106.47,107.78,106.25,107.39999,6891500,7140440.05,66.24169971554522,57.195291871559,NaN,NaN,176.39016089518503,56.970300736950456,-0.020329137456304158,0.6360010351943828,0.6563301726506869,196151325,185713684.8,83.65867568496509,82.53703154342053,NaN,NaN,17.33941236194091,19.968523027600746
2004-02-12T09:30:00-05:00,107.36,107.58,107.19,107.3,3758900,6994470,65.2671228483305,57.46574876192563,NaN,NaN,171.07271117647136,102.73676448240417,0.03425694349003572,0.6991513520132315,0.6648944085231958,192392425,189157145,85.80338072676143,82.33874775481591,NaN,NaN,19.202861155865353,19.859142760209977
2004-02-13T09:30:00-05:00,107.39999,107.67,106.37199,106.7,4075800,6713060,59.600624020606695,56.895092208721486,NaN,NaN,106.47142102242431,120.1941220458676,0.02232232223847197,0.6927973113212857,0.6704749890828138,188316625,190406285,86.49577083387788,82.15084643177917,NaN,NaN,19.171089918858726,19.7608494971598
2004-02-17T09:30:00-05:00,107.24001,107.66,107.10001,107.50999,2929300,6410759.95,64.12839298518665,57.14640883883239,NaN,NaN,136.81467687674265,133.37404869545534,0.059250836855010425,0.7445385351515768,0.6852876982965663,191245925,191473225,87.07558698866175,81.95107578992791,NaN,NaN,20.547778787169506,19.873267967161187
2004-02-18T09:30:00-05:00,107.46001,107.59,106.87601,107.16901,4074000,6182779.85,61.027620029582984,57.74891691818933,NaN,NaN,102.42430818468048,138.63465563110077,0.05128270347312003,0.7493910776379664,0.6981083741648464,187171925,191055645,85.52779650757515,81.96371320386939,NaN,NaN,20.756544156997624,19.999450279994964
2004-02-19T09:30:00-05:00,107.64999,107.92,106.95,107.10001,6433398,6039199.75,60.391266270109085,58.30123686669585,NaN,NaN,99.19629400564476,123.1958822531927,0.032832168187508004,0.7391485843992314,0.7063164162117234,180738527,187973085.4,74.93828372881832,81.24475819437201,NaN,NaN,20.743095825425335,20.10568535791359
2004-02-20T09:30:00-05:00,106.99001,107,105.94,106.42,9334898,6204974.75,54.37381130935324,58.42468302385152,NaN,NaN,26.34911660261584,94.2511633384216,-0.030289387907535104,0.6684546813273045,0.6987440692348396,171403629,183775326.2,63.42229183608089,79.79855791677936,NaN,NaN,18.93714173093996,19.938750554060213
2004-02-23T09:30:00-05:00,106.64999,106.67999,105.74001,106.23,7358000,6231214.8,52.79102674517043,58.337371213606275,NaN,NaN,5.34186534149458,74.02525220223566,-0.08676060906127947,0.5902933079082402,0.6770539169695197,164045629,178921127,53.23458899139162,77.74178512021858,NaN,NaN,16.983652213265806,19.51659364823244
2004-02-24T09:30:00-05:00,105.88,106.53,105.33,105.83,7980898,6275694.65,49.52268622677909,58.09673940331965,NaN,NaN,-18.711228481825152,42.920071130522096,-0.14930717880885702,0.4904199434584484,0.6397271222673054,156064731,171884888.2,42.5621131850826,74.95052316744022,NaN,NaN,14.355719248528162,18.779325876846116
2004-02-25T09:30:00-05:00,105.72501,106.33,105.71001,106.19,4213199,6203364.55,52.38016037820685,58.25622211853454,NaN,NaN,-0.9668900136603138,22.241831490853944,-0.1635411390528383,0.4353006984512575,0.5988418375040958,160277930,166506089.2,36.532611504083505,71.79629488428432,NaN,NaN,12.925311033795934,17.943038042124662
2004-02-26T09:30:00-05:00,105.88,106.25,105.52,105.94,4878102,6060644.65,50.25267092421672,58.08505964888101,NaN,NaN,-18.90789279332778,-1.3790058689405646,-0.1853035555061633,0.36721239312139176,0.552515948627555,155399828,161438349.4,31.941413292399957,68.78151472024554,NaN,NaN,11.11375579860069,16.967426293049808
2004-02-27T09:30:00-05:00,106.00999,106.66,105.737,106.07001,5151000,5688304.6,51.359100117429975,57.585286396722836,NaN,NaN,-1.3487816813953433,-6.9185855257428015,-0.18597014591649397,0.3200532662319375,0.5060234121484315,160550828,159267789.2,30.19128786874178,65.52258351537905,NaN,NaN,9.900082874531241,15.957805804690013
2004-03-01T09:30:00-05:00,106.49001,107.09,106.17,106.96001,5244102,5538024.75,58.21103740363277,57.52744193767374,NaN,NaN,49.411682928646755,1.8953779916876328,-0.12445468758113076,0.35045505267201804,0.4749097402531488,165794930,159617649.4,30.848977567032918,62.245174175585724,NaN,NaN,10.8062646681126,15.221871356607526
2004-03-02T09:30:00-05:00,106.66,106.83,105.85001,106.10001,7420699,5572289.8,50.76882563291704,56.87971747193337,NaN,NaN,-5.451385360065993,4.547346616039465,-0.1385867220071496,0.30167633774421176,0.4402630597513614,158374231,160079549.4,31.76302614553012,58.856843204357354,NaN,NaN,9.285750548635558,14.373854098325817
2004-03-03T09:30:00-05:00,105.87,106.25999,105.62,106.03,5421602,5649714.9,50.20609643395013,55.73431723753372,NaN,NaN,-44.46176817712782,-4.151629016654036,-0.1486611313518682,0.2544366455615261,0.4030977769133943,152952629,158614489.2,30.39086255991964,55.05199940971126,NaN,NaN,7.899919286536597,13.449006268070214
2004-03-04T09:30:00-05:00,106.11,106.22,105.78999,105.89,4216398,5440059.8,49.03560954720162,54.57492343031023,NaN,NaN,-54.677467730290296,-11.30554400404654,-0.15979195222107273,0.20335783663705342,0.36314978885812615,148736231,157281769.8,29.15692367478337,51.00582390599853,NaN,NaN,6.421536968279348,12.445082082385804
2004-03-05T09:30:00-05:00,105.52,106.69,105.39,106.2,6829199,5514784.8,51.71970732367141,54.01200080910056,NaN,NaN,-48.844724370876406,-20.80473254194275,-0.14191926844529434,0.18575070330150822,0.32766997174680257,155565430,156284690.2,28.23331440546235,46.84421987539742,NaN,NaN,5.924669522273924,11.513594573798393
2004-03-08T09:30:00-05:00,106.25999,106.53999,105.16,105.19,3972600,5368624.75,43.6530994468453,52.54947984207619,NaN,NaN,-110.99771746964123,-52.88661262160035,-0.1907205189852464,0.0892693230152446,0.279989842000491,151592830,153444270.2,25.732581260690353,42.462576609113746,NaN,NaN,2.9388279570080695,10.288627914256919
2004-03-09T09:30:00-05:00,105.25999,105.38,104.37,104.64,8048199,5579019.7,39.99491449236569,51.04714373227495,NaN,NaN,-193.86377840964042,-90.56909123151522,-0.24896264167431484,-0.031213460092402556,0.21774918158191228,143544631,150478350.2,23.401727835200944,38.02500027537273,NaN,NaN,-0.7706233886487733,8.708734870984678
2004-03-10T09:30:00-05:00,104.85001,104.89999,102.75999,102.83,10164699,5919824.65,30.83656622092623,48.93609372876189,NaN,NaN,-279.82195313441883,-137.64112822297344,-0.3899117920043783,-0.2696405584235606,0.1202712335808177,133379932,146563810.8,20.732480618490428,34.153157196063596,NaN,NaN,-7.766298159437546,6.3551587237815035
2004-03-11T09:30:00-05:00,102.62,103.47,101.39,101.5,14363898,6293444.55,26.106024539052655,46.91696610231185,NaN,NaN,-314.62640620955534,-189.63091591882645,-0.5437901511131898,-0.5594664553106696,-0.015676304197479757,119016034,140619771.4,17.473343811682383,30.87108948003513,NaN,NaN,-15.588780640234498,3.220310243207789
2004-03-12T09:30:00-05:00,101.85001,102.66,101.75999,102.5,8724500,6541724.55,34.27066630280544,45.594083213571494,NaN,NaN,-220.82175923793474,-224.0263228922381,-0.5477711655007205,-0.7003902610733803,-0.15261909557265987,127740534,135054792.2,15.082785094676368,28.14596063026975,NaN,NaN,-18.781637376879264,0.0771748689096392
2004-03-15T09:30:00-05:00,102.34,102.35001,101.13,101.45,9751602,6825514.65,30.46443471978469,44.232779534500466,NaN,NaN,-196.09736997395663,-241.04625339310118,-0.5871684663959064,-0.8865796785675428,-0.29941121217163646,117988932,128334012.6,12.804416539480542,26.020410869869607,NaN,NaN,-22.812993227890818,-3.1928491449189975
2004-03-16T09:30:00-05:00,101.89,102.36,101.23,102.14,8702398,7114169.55,35.53158871732012,43.029310130151416,NaN,NaN,-146.8180472729512,-231.63710716576333,-0.5343177271831091,-0.9673083711505228,-0.4329906439674137,126691330,124963352.4,11.838542125436646,24.256548771394836,NaN,NaN,-24.09490433193254,-6.178857028778075
2004-03-17T09:30:00-05:00,102.48,103.55,102.41,103.25999,6935000,7257219.55,42.815805458344165,42.498105454017654,NaN,NaN,-82.06526311101557,-192.08576916108268,-0.3977594512067989,-0.9301899579759123,-0.5324305067691134,133626330,125012632,11.94312510745705,22.82809961532749,NaN,NaN,-22.428421906784692,-8.500223439921877
2004-03-18T09:30:00-05:00,102.92,103.53,102.35001,103.31,9926102,7431854.75,43.12482506131217,41.90994295000924,NaN,NaN,-72.30699627439456,-143.6218871740505,-0.2832705730339996,-0.886518723061613,-0.6032481500276133,143552432,129919911.6,21.88107552609702,22.234513019424295,NaN,NaN,-21.07364488406951,-10.296426503371539
2004-03-19T09:30:00-05:00,103.05,103.28,101.87,101.94,7337898,7332004.75,37.19498704935542,40.40879649613229,NaN,NaN,-88.67381317162403,-117.19229796078835,-0.27859215188890185,-0.9514883398887406,-0.6728961879998387,136214534,131614711.6,25.02806028737409,21.81873321373438,NaN,NaN,-21.982416761539742,-11.965853683109852
2004-03-22T09:30:00-05:00,101.24001,101.32001,100.19,100.72,9304801,7429344.8,32.86159423301109,39.129708538996155,NaN,NaN,-131.57399867355852,-104.28762370070872,-0.33277843095364745,-1.088869226691898,-0.7560907957382506,126909733,133398871.8,28.302539466674588,21.57155559381613,NaN,NaN,-24.29968874627276,-13.727830120704553
2004-03-23T09:30:00-05:00,101.13,101.42999,100.58,100.64999,8777699,7469184.85,32.62668422631043,37.87403623845046,NaN,NaN,-111.38546788754208,-97.2011078236269,-0.3468712848520299,-1.189679901803288,-0.8428086169512581,118132034,131687012.6,27.080408967927966,21.33509462295958,NaN,NaN,-26.134963364321585,-15.500277726935558
2004-03-24T09:30:00-05:00,100.78,101.21001,100.12,100.71001,8310301,7674039.95,33.068422011540505,36.733522843046096,NaN,NaN,-106.85118629825072,-102.15829246107394,-0.3260067852569376,-1.2503170985224301,-0.9243103132654925,126442335,130250213.6,26.063149519581884,21.114110754730905,NaN,NaN,-27.432128608674454,-17.20482785289826
2004-03-25T09:30:00-05:00,101.2,102.37,100.99001,102.16,7684602,7814364.95,42.821910336901944,36.0979659154197,NaN,NaN,-61.56618474066844,-100.01013015432872,-0.19487777168971077,-1.167907527877631,-0.9730297561879202,134126937,128365114.6,24.749539462137633,20.865269687350573,NaN,NaN,-25.35907863484452,-18.369720821747723
2004-03-26T09:30:00-05:00,102.10001,102.85001,101.87,102.2,5376898,7825659.85,43.06837923288371,36.05620018585102,NaN,NaN,-40.74882587851176,-90.42513269570627,-0.09104919845984194,-1.0868412542627226,-0.9957920558028807,139503835,129022974.8,26.148429058601806,20.894973101487103,NaN,NaN,-23.663560485317664,-19.125983630829143
2004-03-29T09:30:00-05:00,102.89999,103.62,102.86,103.52,6766602,7901784.85,50.63119795480528,36.815934718882424,NaN,NaN,4.619836477529095,-63.186365665488744,0.07211925151394805,-0.9056429914104456,-0.9777622429243936,146270437,132895115.6,33.93342326857062,21.64723706101351,NaN,NaN,-19.657428517960007,-19.201904328990697
2004-03-30T09:30:00-05:00,103.35001,104.06,103.2,104,4685000,7764999.9,53.07243607223522,38.404211136833055,NaN,NaN,30.621361297919577,-34.78499982839641,0.21015601488640656,-0.7150672243163854,-0.9252232392027919,150955437,139459796.2,44.596507535720725,23.351810412244244,NaN,NaN,-15.609221494730141,-18.688663924096332
2004-03-31T09:30:00-05:00,103.89999,104.21001,103.28999,103.92,6974102,7842624.9,52.6055376034746,40.297033498577484,NaN,NaN,41.50564053993937,-5.113634460758393,0.28898772894191205,-0.5639885780254019,-0.852976306967314,143981335,142967596.2,49.30490269524422,25.62549318964152,NaN,NaN,-12.523719532934386,-17.807957582501768
2004-04-01T09:30:00-05:00,103.60001,104.37,103.56,104.08,7655301,8014570.05,53.486877840987674,41.669620037019065,NaN,NaN,61.07679722254878,19.41496193188505,0.34123595418970487,-0.4264313642301829,-0.7676673184198878,151636636,146469536,53.54903611796021,28.373082548447506,NaN,NaN,-9.74293076981304,-16.655810894974806
2004-04-02T09:30:00-05:00,105.14999,105.24001,104.39999,104.96001,7605199,8053370.05,58.10179320724971,43.643717071838005,NaN,NaN,117.88067990010049,51.14086308760749,0.41925483571781585,-0.24359877377261796,-0.6628536094904338,159241835,150417136,57.834425031001835,31.589511726413313,NaN,NaN,-5.889907196958457,-15.117824652401042
2004-04-05T09:30:00-04:00,104.94,105.80901,104.77,105.66,3396100,8024545.05,61.38385028874837,45.49030718408289,NaN,NaN,151.57703582304623,80.53230295671092,0.4968923642344809,-0.04173815419733273,-0.5386305184318136,162637935,153690635.6,61.04390563789713,35.10418054873192,NaN,NaN,-1.5678299849774515,-13.182111128483387
2004-04-06T09:30:00-04:00,105.3,105.91,105.2,105.64,3782100,7811240.1,61.236251723123104,46.80605334585281,NaN,NaN,153.92610733573224,105.19325216427346,0.5231403825556507,0.11529495976274973,-0.4078454227929009,158855835,155270715.2,62.526598518932985,38.71728579240877,NaN,NaN,1.8803520778209466,-11.030330670439911
2004-04-07T09:30:00-04:00,105.67,105.67,104.84,105.3,5365000,7571255.15,58.654223953146605,47.91529612384098,NaN,NaN,122.03486537730976,121.29909713174752,0.49418849179944413,0.20989019195640424,-0.2842982998430399,153490835,157172615.2,64.28848322355526,41.74638634222722,NaN,NaN,4.0939642566643215,-8.869717109425022
2004-04-08T09:30:00-04:00,105.95,105.95,104.10001,104.69,5463199,7126220.2,54.235738131931605,49.13249262973928,NaN,NaN,92.53194306379812,127.59012629999741,0.4137989486200205,0.2329503859319857,-0.1808485626880348,148027636,156450815.2,63.07639257812186,44.464124362994916,NaN,NaN,4.786162585860038,-6.918877152955727
2004-04-12T09:30:00-04:00,104.88,105.47,104.86,105.31,3299500,6854970.2,57.72181563924189,50.908222730184335,NaN,NaN,95.49262656802598,123.1125156335825,0.38293602909444135,0.2978214736800169,-0.08511455541442445,151327136,154867875.4,60.387454224688234,46.75590398856731,NaN,NaN,6.393582908221488,-5.017097144216125
2004-04-13T09:30:00-04:00,105.78999,105.78999,103.82001,103.84,6849199,6709850.05,48.32296987232396,52.02938599061388,NaN,NaN,54.50217866262515,103.69754420149827,0.25048161697581284,0.22798746580534157,-0.022494151170471238,144477937,151235875.8,54.632628565951705,48.72391967414045,NaN,NaN,4.917445852931617,-3.597876716052162
2004-04-14T09:30:00-04:00,103.39999,104.36,103.33,104.22,8779199,6713690.1,50.56390676995286,53.27906347335762,NaN,NaN,25.185710738718615,77.94946488209555,0.17878688439829593,0.20098945432739868,0.022202569929102745,153257136,150116136,52.95704833693666,50.64491244680864,NaN,NaN,4.39335327678591,-2.4562724313610085
2004-04-15T09:30:00-04:00,104.22,104.53,103.39999,103.88,7101301,6722005.15,48.535874131684174,53.68720374441349,NaN,NaN,21.36486614995016,57.81546503662364,0.10257728877504943,0.15042418089791454,0.04784689212286511,146155835,148649136,50.76051968453353,52.50283960555121,NaN,NaN,3.349591305191002,-1.6268633261392926
2004-04-16T09:30:00-04:00,104.25999,104.75,103.86,104.66,5904500,6520925.05,53.17574178727883,54.409158212584565,NaN,NaN,42.85034151471204,47.879144726806416,0.09877488648056462,0.1713155002235709,0.07254061374300627,152060335,149455675.8,51.940759808501674,54.345148944829766,NaN,NaN,3.8531369485708344,-0.8440061440378459
2004-04-19T09:30:00-04:00,104.42,104.67,104.10001,104.47,3748300,6341445.15,51.94715333826003,54.50315502568848,NaN,NaN,38.90192536447958,36.56100448609715,0.07842697656601165,0.17057433445052084,0.09214735788450919,148312035,148852655.6,50.95730567080364,55.561140544989264,NaN,NaN,3.903166568818543,-0.16583861362979035
2004-04-20T09:30:00-04:00,104.77,104.99001,102.85001,103.03,6432898,6197850,43.70536915121789,53.83407881704438,NaN,NaN,-13.555637946173219,22.949441164337472,-0.0311754966398175,0.05317798708473731,0.08435348372455481,141879137,148332895.6,50.07718663914175,55.952617623805054,NaN,NaN,1.2950836705946907,0.04286456983084977
2004-04-21T09:30:00-04:00,103.2,103.5,102.60001,103.3,8378699,6177900,45.45286980448478,53.3231739742594,NaN,NaN,-59.56481019442523,5.999336977708697,-0.08177619782223862,-0.01786676355324346,0.06390943426899516,150257836,147733035.6,49.02478293606578,55.932609069578014,NaN,NaN,-0.2799867602757509,-0.0032570487558074707
2004-04-22T09:30:00-04:00,103.2,105.17,103.12,104.81,9166398,6220704.85,54.044669298345674,53.363016221213535,NaN,NaN,20.474230261657038,5.821209800050076,-0.013422871354613938,0.047130845075727734,0.06055371643034167,159424234,150386715.4,53.66399603184164,55.94082049199812,NaN,NaN,1.130776457779193,0.1587477378920497
2004-04-23T09:30:00-04:00,104.75,105.00999,104.28,104.92,4820602,6077504.85,54.60560729402654,53.11328865598331,NaN,NaN,46.167093813907854,6.484560259889238,0.03659120489389213,0.10629272254770683,0.0697015176538147,164244836,152823615.6,57.49003907920101,55.91622149544092,NaN,NaN,2.414780827104194,0.4810381792080703
2004-04-26T09:30:00-04:00,104.92999,105.34,104.36,104.95,3701000,5993709.95,54.76776599384477,52.64071120634734,NaN,NaN,55.49744062422137,9.803663311837592,0.06729996201107477,0.15382647016765816,0.08652650815658339,167945836,156750375.8,62.81783164916548,56.0429304962458,NaN,NaN,3.4866558650245802,0.9104121343247145
2004-04-27T09:30:00-04:00,104.92,105.59441,104.75,105.06,5691102,5939934.95,55.3969229141087,52.223616291417734,NaN,NaN,76.72822613731034,27.860436128534303,0.0892507381896374,0.19808993089363014,0.10883919270399274,173636938,163101936,69.48070830690808,56.539652623958304,NaN,NaN,4.543467352592457,1.4294200226486775
2004-04-28T09:30:00-04:00,104.75,104.75,103.5,103.77,8846602,6148015.05,47.11952955583859,51.399709548752874,NaN,NaN,-61.64732984914616,27.44393219759012,0.015013335796314337,0.12760586244938565,0.11259252665307132,164790336,166008436,71.9571274421246,57.08741292528468,NaN,NaN,2.9954306899617493,1.6531358322648306
2004-04-29T09:30:00-04:00,103.82001,104.27,102.35001,103.06,11963398,6397479.85,43.28591961441555,50.617579654644594,NaN,NaN,-146.66630001688148,-5.984173858117586,-0.07864127956115444,0.014290927201628278,0.09293220676278272,152826938,164688976.8,69.21152020325499,57.5256363270799,NaN,NaN,0.47338204719427773,1.4845995772547518
2004-04-30T09:30:00-04:00,103.3,103.55,102.35001,102.35001,6162602,6322844.9,39.79888359758309,49.33737022309754,NaN,NaN,-175.61114419811676,-50.339821460522515,-0.17937682057643126,-0.13128881895775635,0.0480880016186749,146664336,161172876.8,62.380814558214624,57.668019208046076,NaN,NaN,-2.7773641137906933,0.8757476213911168
2004-05-03T09:30:00-04:00,102.67,103.52,102.66,103.3,6128000,6248984.95,46.06026395774136,49.175748372055914,NaN,NaN,-114.07255765174762,-84.2538211157163,-0.17292494345374082,-0.16806817769850113,0.004856765755239689,152792336,158142176.8,57.145578929697024,57.8475156625993,NaN,NaN,-3.6070547419338954,0.23534728377325798
2004-05-04T09:30:00-04:00,103.36,104.14,102.88,103.13,7695602,6463960.05,45.155182404458685,48.789410917377765,NaN,NaN,-82.03555913450619,-116.00657817007962,-0.1707093016414126,-0.20852986129652606,-0.03782055965511347,145096734,152434136,48.833137089888,57.552950573524406,NaN,NaN,-4.547911697761349,-0.44797542787454303
2004-05-05T09:30:00-04:00,103.45,103.72,103.11,103.46001,3496600,6449685.05,47.319275273946744,48.70251099896795,NaN,NaN,-69.8944243878212,-117.65599707781462,-0.1389664465422384,-0.21152861783291144,-0.07256217129067306,148593334,149194735.6,44.8462464072862,57.13050248229246,NaN,NaN,-4.687348801840393,-1.0536001955839502
2004-05-06T09:30:00-04:00,102.82001,103.17999,101.91,102.60001,9048102,6633840.15,42.60165674083124,47.94721920993597,NaN,NaN,-141.73544082637554,-116.66982523971342,-0.16600744458689623,-0.28007147702429336,-0.11406403243739713,139545232,146538394.4,41.83035847404037,56.40833095840236,NaN,NaN,-6.252169420756065,-1.7962529420371094
2004-05-07T09:30:00-04:00,102.07001,103.03,101.14999,101.14999,8870801,6804220.25,36.07168386751922,46.81325710488306,NaN,NaN,-184.30553706505935,-118.40870381310194,-0.26575082260862964,-0.4462525606981842,-0.18050173808955455,130674431,143340413.4,38.475671422782746,55.5167856549723,NaN,NaN,-9.852076585647772,-2.947084891124347
2004-05-10T09:30:00-04:00,100.61,101,99.52,99.91,17582192,7518354.85,31.609644716389354,45.94927678810959,NaN,NaN,-265.3154196818511,-148.65727621912265,-0.3918246074145989,-0.6702824973578032,-0.2784578899432043,113092239,135400394,31.6820148766124,54.202844814791625,NaN,NaN,-14.515750106626166,-4.59975135048175
2004-05-11T09:30:00-04:00,100.46001,100.64999,100,100.24001,8794102,7615600,33.951309750538684,45.1277367842563,NaN,NaN,-206.9586029896226,-173.6418849901459,-0.42670600522960217,-0.811840396480207,-0.38513439125060484,121886341,130758315.4,28.51226687360453,52.737665096044395,NaN,NaN,-17.447413489189525,-6.435131656011432
2004-05-12T09:30:00-04:00,100.17,101.03999,98.81,100.99001,16598000,8006540.05,39.05828149099881,44.05728051230295,NaN,NaN,-170.3289386265539,-193.72878783789244,-0.37482591113009484,-0.8536667801632234,-0.47884086903312856,138484341,128736516.8,27.234247581341137,50.849825921008645,NaN,NaN,-18.24130420108327,-8.121727733878837
2004-05-13T09:30:00-04:00,100.28,101.08,99.99001,100.23,10827102,8192830.1,36.01898259200374,42.72966446215846,NaN,NaN,-133.9594126164076,-192.17358219589886,-0.36679604147882927,-0.9373359208816652,-0.5705398794028359,127657239,126358918.2,25.771304615982913,48.584202030778776,NaN,NaN,-19.887195863228296,-9.802508895214473
2004-05-14T09:30:00-04:00,100.2,101,99.72,100.45,8798602,8337535.2,37.534253460711426,41.49869928122037,NaN,NaN,-116.58002992829105,-178.62848076854522,-0.32329363093587715,-0.9746569180726823,-0.6513632871368051,136455841,127515200.2,27.80246535588816,46.083104438401826,NaN,NaN,-20.73862276988383,-11.364810877310095
2004-05-17T09:30:00-04:00,99.56,99.97,98.99001,99.56,6815699,8490905.15,34.02372131818113,39.9720420243684,NaN,NaN,-134.84160234958972,-152.53371730209295,-0.3299389424814405,-1.0637869652386058,-0.7338480227571653,129640142,130824780.8,33.41838245511501,43.50722402041661,NaN,NaN,-22.573565728758368,-12.966061570374134
2004-05-18T09:30:00-04:00,99.85001,100.24001,99.60001,99.97,6483301,8493425.3,36.949311811342355,39.24559789976153,NaN,NaN,-100.10034094838676,-131.16206489384578,-0.2839525559445233,-1.0887887176878195,-0.8048361617432962,136123443,133672201.2,37.89440591659376,41.07417248287869,NaN,NaN,-23.1903602507564,-14.4266756675716
2004-05-19T09:30:00-04:00,100.82001,101.39999,99.64999,99.7,8893898,8519185.25,35.82276456670168,38.712515396353396,NaN,NaN,-77.3845683677345,-112.57319084208191,-0.2501371491494295,-1.117507598180083,-0.8673704490306535,127229545,131421242,35.843038086129795,38.690709474512595,NaN,NaN,-24.027556459895106,-15.798230066474957
2004-05-20T09:30:00-04:00,99.88,100.14999,99.42,100.02,8191301,8470430.4,38.226657146922705,38.600213507020506,NaN,NaN,-83.1146959292289,-102.40424750464618,-0.18750040135408186,-1.1017459507232559,-0.914245549369174,135420846,132973963.4,38.32331438937932,36.972316605310084,NaN,NaN,-24.034330166983946,-16.9748157951191
2004-05-21T09:30:00-04:00,100,100.53,99.55,99.8,6338699,8546335.25,37.19513726398495,37.96699017175219,NaN,NaN,-72.5204703908207,-93.59233559715211,-0.1441167043231043,-1.0943914297730544,-0.9502747254499501,129082147,131499224.6,36.86556322007596,35.52374405462286,NaN,NaN,-24.32591863742201,-18.024973344019514
2004-05-24T09:30:00-04:00,100.42,100.63,99.42,99.86,6830398,8702805.15,37.68898081853558,37.433690058471974,NaN,NaN,-65.84807516550052,-79.79363016033427,-0.0968772746142641,-1.0713713187177802,-0.9744940441035161,135912545,132753705.2,38.99147097739904,34.8207679037308,NaN,NaN,-24.43533341924437,-18.940739069051638
2004-05-25T09:30:00-04:00,99.61,101.35001,99.25999,101.27,9302301,8883365.1,48.030755433347586,37.48451006985774,NaN,NaN,-32.14681030100754,-66.20292403085843,0.036677133733252765,-0.9286476269369501,-0.9653247606702029,145214846,134571985.8,42.03798525708156,34.620177821573314,NaN,NaN,-21.43408685232088,-19.296931609518673
2004-05-26T09:30:00-04:00,101.06,101.45,100.86,101.35001,6354398,8758754.9,48.55255518135788,37.90957424418108,NaN,NaN,3.3579803880918377,-50.05441427969315,0.13237050641104398,-0.7998616276563979,-0.9322321340674419,151569244,139439925.6,49.33271599857428,35.15606050189717,NaN,NaN,-18.840952939373526,-19.231791799497937
2004-05-27T09:30:00-04:00,101.7,102.37,101.67999,102.3,5975500,8459360,54.40615616763117,39.21917940847478,NaN,NaN,58.380145588294305,-21.755445976188525,0.2545353027078202,-0.6140630056826666,-0.8685983083904868,157544744,143864705.2,54.890081528898335,36.32851836661972,NaN,NaN,-14.724644043288043,-18.58791354861081
2004-05-28T09:30:00-04:00,102.21001,102.3,101.84,102.17999,4536301,8378044.95,53.57684121575059,40.788264872714876,NaN,NaN,61.71426264652486,5.091500631280587,0.3180227562756712,-0.4710698630458978,-0.789092619321569,153008443,148649964.4,59.99985253556707,38.35122105654505,NaN,NaN,-11.595304775719878,-17.58896943819782
2004-06-01T09:30:00-04:00,101.91,102.27,101.46001,102.16,5099801,8326635,53.43074373981962,42.17965301480637,NaN,NaN,60.630403340873755,30.38719633255544,0.3470624755101005,-0.35526452493394345,-0.702327000444044,147908642,151049183.8,62.30531819730424,40.76501043680931,NaN,NaN,-9.066712346238418,-16.371504139346477
2004-06-02T09:30:00-04:00,102.39999,103.06,102.09,102.84,5817398,8232724.8,57.660294512385136,43.50836823061967,NaN,NaN,112.10334354776757,59.237227102310456,0.39686941307023793,-0.2062402341062466,-0.6031096471764845,153726040,152751422.6,63.89531352470024,43.38365800419211,NaN,NaN,-5.593770863176432,-14.83182795703647
2004-06-03T09:30:00-04:00,102.49001,102.99001,101.97,102.13,7500199,8432904.75,52.317415480589474,44.6725420083758,NaN,NaN,102.24345326079288,79.01432167685067,0.3674707804027234,-0.1437711716730803,-0.5112419520758037,146225841,151682742,62.1236356802013,45.98025308020771,NaN,NaN,-4.051889430087096,-13.291836738900844
2004-06-04T09:30:00-04:00,102.75999,103.2,102.41,102.66,4637301,8212364.7,55.623073408433065,45.964600576070204,NaN,NaN,127.87199771362594,92.91269210191699,0.36826511858044786,-0.0509105538502439,-0.41917567243069176,150863142,150346421.6,59.887494355064426,48.272040865863154,NaN,NaN,-1.749751839326924,-11.642967467533142
2004-06-07T09:30:00-04:00,103.17,104.09,103.121,103.98,5774102,8057529.75,62.58090817445383,48.00439963723254,NaN,NaN,168.4814947654861,114.26613852570924,0.43751878914738007,0.12772281400353336,-0.3097959751438467,156637244,151072181.8,60.7145623448414,50.22176800084361,NaN,NaN,2.635089738254912,-9.60324500956342
2004-06-08T09:30:00-04:00,103.73,104.49001,103.67,104.47,5393500,7448095.15,64.78797136886925,49.99287531991303,NaN,NaN,164.70879208312815,135.0818162741601,0.49208519634076203,0.3053105202821058,-0.18677467605865622,162030744,153896602.2,63.839336849431255,52.07497735318915,NaN,NaN,6.970651357487307,-7.235545528556173
2004-06-09T09:30:00-04:00,104.10001,104.39999,103.77,103.95,5151699,7265975,60.69652113999555,51.76957221800545,NaN,NaN,132.59514604058333,139.18017677272329,0.4690080480024749,0.39948538394443744,-0.06952266405803749,156879045,154527203.2,64.51792472925779,54.12318354198401,NaN,NaN,9.325599544445147,-4.869667660984556
2004-06-10T09:30:00-04:00,104.10001,104.25,103.94,104.25,3496300,6610890,62.18041304865221,53.4805547824147,NaN,NaN,120.92356829995607,142.91619978055593,0.4497366856301564,0.492648192979658,0.042911507349501624,160375345,157357104,67.46830281357029,56.20496842942622,NaN,NaN,11.708838372027529,-2.501309656268544
2004-06-14T09:30:00-04:00,103.97,103.97,103.3,103.60001,4342199,6286644.85,57.14623042963542,54.90563286567545,NaN,NaN,86.74782502258152,134.69136524234702,0.3722097695018871,0.5081737192268605,0.1359639497249734,156033146,158391104.8,68.49899139817686,58.46449901357629,NaN,NaN,12.221396150870993,-0.3980659695343247
2004-06-15T09:30:00-04:00,104.23,104.50999,103.64999,104.11,7290000,6211214.75,59.89011861431234,56.49142842251665,NaN,NaN,99.26420196781613,120.84790668281303,0.3354123622478321,0.5552294025347635,0.21981704028693141,163323146,159728285.2,69.83020255902137,60.66726555512074,NaN,NaN,13.483150611979312,1.5849649706819091
2004-06-16T09:30:00-04:00,104.13,104.14999,103.75999,103.99001,3838500,6062354.8,58.934000863943986,57.270231667559244,NaN,NaN,86.37537722658473,105.18122371150434,0.2851040785151515,0.5761971384308708,0.2910930599157193,159484646,159219065.6,68.64059605622559,62.56745204077389,NaN,NaN,14.231947496114964,3.3916767600294886
2004-06-17T09:30:00-04:00,103.91,104.13,103.59,103.95,2780100,5877194.75,58.59807169622561,57.98776856147837,NaN,NaN,75.57824676270377,93.77784385592844,0.2334190094051829,0.5828668216721979,0.34944781226701505,156704546,159184165.8,68.55439792333121,63.94042932111366,NaN,NaN,14.7523381780011,5.01462839116829
2004-06-18T09:30:00-04:00,103.85001,104.53,103.75999,104.22,3919700,5628484.85,60.24492262126993,58.40482330816685,NaN,NaN,82.01365587298741,85.9958613705347,0.20283251944363273,0.602988461571556,0.4001559421279232,160624246,159233946,68.61494011750608,64.92077636315707,NaN,NaN,15.643061305437303,6.532975950349577
2004-06-21T09:30:00-04:00,104.25,104.55,103.75,103.81,4152199,5426529.75,56.565416861517726,58.61829299715021,NaN,NaN,69.22222823228343,82.49074201247508,0.14321529675385192,0.5791750630702381,0.4359597663163862,156472047,159321726.2,68.72927029301383,65.5443062029747,NaN,NaN,15.405986198695363,7.800548842970404
2004-06-22T09:30:00-04:00,103.75,104.21001,103.17,104.17,4098602,5314524.9,58.93692093465744,59.01159136821006,NaN,NaN,52.87715069103296,73.21333175711845,0.11734059104377409,0.5826355051211038,0.46529491407732976,160570649,158771226.8,67.0789466925209,65.88527966691875,NaN,NaN,15.846981718044049,8.95003925369521
2004-06-23T09:30:00-04:00,103.97,105.03,103.73,104.92999,4785801,5212295.05,63.471250502678345,59.426659653231006,NaN,NaN,91.94370984420736,74.32699828064298,0.13923042051252688,0.6393329397179883,0.5001025192054614,165356450,159945587.6,68.80006395567077,66.23561898341664,NaN,NaN,17.55705336089442,10.179612697580811
2004-06-24T09:30:00-04:00,104.77,105.05,104.47,104.61,4658199,4980089.95,60.444798985975794,60.007187046472886,NaN,NaN,99.7128451420526,79.15391795651276,0.1206714993849981,0.650941893436709,0.530270394051711,160698251,160744328.6,69.95075674854743,66.79469905972708,NaN,NaN,18.137992883464293,11.316524152707023
2004-06-25T09:30:00-04:00,104.53999,104.99001,103.92,104.05,3582200,4841480.05,55.460787841718954,59.99559522027902,NaN,NaN,67.7121178886863,76.29361035965253,0.06214106206960046,0.6079467216387116,0.5458056595691111,157116051,160042689.6,67.59247093336658,67.3450545296058,NaN,NaN,17.1796608865393,12.154115114683062
2004-06-28T09:30:00-04:00,104.57001,104.78999,103.5,103.62,6770602,4881235.15,51.92061087151644,59.23414541292635,NaN,NaN,32.07289701346905,68.86374411588966,-0.010219820728377127,0.5330308836586397,0.5432507043870168,150345449,158817370,63.56229562089789,67.54846404932412,NaN,NaN,15.30936210472184,12.604864684688602
2004-06-29T09:30:00-04:00,103.7,104.45,103.57001,104.3,5171398,4912990,56.63478463036879,58.65177493160489,NaN,NaN,42.58165176250347,66.80464433018376,-0.016595181891315813,0.522506727022872,0.5391019089141879,155516847,157806609.6,60.364919251485055,67.30029136375654,NaN,NaN,15.069908189839209,12.957013756852975
2004-06-30T09:30:00-04:00,104.3,104.89,103.89,104.63,6940801,5005040,58.748637023889046,58.512640351883,NaN,NaN,90.53723817505237,66.52334999635276,-0.0035762480382437456,0.5346315988663832,0.538207846904627,162457648,157226849.2,58.545744040345724,66.87370702883426,NaN,NaN,15.495367881385752,13.319635774643372
2004-07-01T09:30:00-04:00,104.48,104.64999,102.94,103.25999,10591102,5243725.2,48.23625343899162,57.516628951192956,NaN,NaN,-56.88032078659638,35.20471681062296,-0.08756633549840043,0.42874992753162644,0.5163162630300269,151866546,155460508.2,53.277736848867654,65.86009517421265,NaN,NaN,12.395130361081486,13.18756357270596
2004-07-02T09:30:00-04:00,103.39,103.49001,102.8,103.03,4276301,5082530.3,46.72471240873554,56.77223480684296,NaN,NaN,-179.07512054849587,-14.152730876813468,-0.15500390447206697,0.32256138243994315,0.4775652869120101,147590245,153555347,48.23616812711641,64.41275065485118,NaN,NaN,9.429438039239182,12.65068849649642
2004-07-06T09:30:00-04:00,102.61,102.91,102.06,102.34,6318699,5166600.2,42.42901086125376,55.525012824481635,NaN,NaN,-295.9428814206573,-79.75588656363873,-0.23753496501349158,0.1806465806451456,0.4181815456586372,141271546,151740566.4,43.968069883551834,62.56545546374621,NaN,NaN,5.494099360729478,11.628318619958286
2004-07-07T09:30:00-04:00,102.22,102.92,102.22,102.60001,5603898,5158090,44.49967027190122,54.4939892107643,NaN,NaN,-210.62030562108373,-130.39627804035618,-0.26403111005330127,0.0881426580920106,0.35217376814531187,146875444,150012285.8,40.310021484399975,60.54184299433009,NaN,NaN,2.9328536427619984,10.386109337501674
2004-07-08T09:30:00-04:00,102.36,102.89999,101.86,102.07001,8077301,5292280.05,41.24333400431563,53.254365089913584,NaN,NaN,-196.9630109988066,-187.89632787512795,-0.3038314962124037,-0.02761560212019276,0.2762158940922109,138798143,145280384.8,32.36942526707776,57.957202090312,NaN,NaN,-0.257799095350959,8.865550989951299
2004-07-09T09:30:00-04:00,102.32001,102.62,102.10001,102.37,3660200,5217705.1,43.752289150824225,52.0763198420246,NaN,NaN,-150.16464026759994,-206.5531917713287,-0.29622380471892623,-0.09406386180644688,0.20215994291247935,142458343,143398744.2,29.851237384620447,55.18836618082016,NaN,NaN,-2.14366264838062,7.29280618447531
2004-07-12T09:30:00-04:00,102.3,102.78999,101.8,102.57001,5886500,5337215.1,45.42551667694478,51.280612685983684,NaN,NaN,-124.81140725419492,-195.70044911246848,-0.26500579241672334,-0.1290972976084248,0.13590849480829853,148344843,143549663.8,30.319466335785762,52.444808755303875,NaN,NaN,-3.213117103586248,5.791960000466516
2004-07-13T09:30:00-04:00,102.75,102.8,102.37,102.57001,3267000,5283455.15,45.42551667694478,50.31551238186135,NaN,NaN,-90.92765344823367,-154.69740351798376,-0.2327859573638254,-0.1550739518964832,0.07771200546734218,148344843,144964323.2,34.71813955147539,50.13332253094348,NaN,NaN,-4.083969972964612,4.381112861404927
2004-07-14T09:30:00-04:00,102.11,103.09,101.92,102.28,7295000,5283705.15,43.261396790543856,48.87195140242317,NaN,NaN,-91.0535088033981,-130.78404415444663,-0.21960441061273317,-0.1967935077985743,0.02281090281415888,141049843,143799203,32.87732422877036,47.56741255045059,NaN,NaN,-5.427665251436106,2.979858845284779
2004-07-15T09:30:00-04:00,102.48,102.53999,101.57001,101.61,4529398,5318250.05,38.67701383982403,47.31710960626947,NaN,NaN,-117.1897809848712,-114.82939815165957,-0.24279624379930853,-0.2806844019349768,-0.03788815813566825,136520445,143343663.4,32.15936249947204,44.86802724694521,NaN,NaN,-7.9712495244491475,1.4154147924656468
2004-07-16T09:30:00-04:00,102.42999,102.49001,101.46001,101.7,5944898,5476489.95,39.60288159616502,46.18440201730133,NaN,NaN,-104.85758018175805,-105.76798613449118,-0.23851564638935407,-0.33603271612236085,-0.09751706973300678,142465343,143345063.4,32.16426536459342,42.33744113488999,NaN,NaN,-9.819986778121748,-0.1896425747611239
2004-07-19T09:30:00-04:00,101.61,101.69,100.78,100.95,9645602,5762785.05,34.877140035955776,44.967011243332706,NaN,NaN,-141.40720948068542,-109.08714657978928,-0.27030346990245135,-0.43539640711107097,-0.16509293720861962,132819741,140240043,27.42949479191749,39.75652678996281,NaN,NaN,-12.908446929849958,-2.0066146254881003
2004-07-20T09:30:00-04:00,101.17,102.14999,100.86,101.89999,5299398,5820145,43.99354697072788,44.0640656962155,NaN,NaN,-96.20131167833017,-110.1418782258086,-0.21392644405518127,-0.4325009922775962,-0.21857454822241493,138119139,138194902.2,24.836189174499253,37.2187603558924,NaN,NaN,-12.858065486923614,-3.556821891407459
2004-07-21T09:30:00-04:00,102.14999,102.55,100.36,100.39999,9343602,6082395,35.534878848615165,42.405940112267366,NaN,NaN,-120.46424359016675,-116.02402518316231,-0.2611098320571091,-0.5449618382938013,-0.2838520062366922,128775537,135740041,22.13140126278715,34.61773587178107,NaN,NaN,-15.787996839955316,-5.304132598342867
2004-07-22T09:30:00-04:00,100.17,100.97,99.63,100.52,11671199,6426664.9,36.58541980668006,41.573737709959396,NaN,NaN,-159.293938707556,-124.44485672769926,-0.26674907430957,-0.6172883491236547,-0.3505392748140847,140446736,136525299.2,24.947098569980156,32.594118851860536,NaN,NaN,-17.703294094578823,-7.075441383519432
2004-07-23T09:30:00-04:00,100.32001,100.33,99.5,99.82001,6837398,6535624.85,33.188148053271206,40.60684025599766,NaN,NaN,-181.8298538138147,-139.8393114541106,-0.29777614168518557,-0.7227594519205667,-0.4249833102353811,133609338,134754098.2,22.932813229941345,30.78673635920518,NaN,NaN,-20.449813002347785,-8.98606590049491
2004-07-26T09:30:00-04:00,100.07001,100.25,99.31,99.78,8701801,6791604.9,32.99952648451044,39.933305657658856,NaN,NaN,-162.97615301042754,-144.153100160059,-0.30029224203526217,-0.8003486127794588,-0.5000563707441966,124907537,133171657.4,21.2796711966363,29.16613645299693,NaN,NaN,-22.658044695991418,-10.939205728422984
2004-07-27T09:30:00-04:00,100.05,101.21001,99.98,100.95,7015801,6803864.85,43.17092985301636,39.83839562773851,NaN,NaN,-88.99612615379726,-142.71206305515244,-0.20690188430645007,-0.7586837261272592,-0.5517818418208091,131923338,131932497.2,20.060196787028843,27.719720403184706,NaN,NaN,-21.259594481833872,-12.413546978910253
2004-07-28T09:30:00-04:00,100.78999,101.69,100.07001,101.38,9645602,7027575.05,46.391997934966284,40.20615733707069,NaN,NaN,-59.433810984827616,-130.5059765340846,-0.10504839352181783,-0.6830923337230814,-0.5780439402012636,141568940,134491177.8,29.095724188218185,27.485884611837598,NaN,NaN,-19.062309295872236,-13.363370167047679
2004-07-29T09:30:00-04:00,101.73,102.67,101.05,101.53999,7651699,7063119.95,47.58245864628976,40.479740872461086,NaN,NaN,0.28007409966064667,-98.59117397264127,-0.020221684057246114,-0.6033210452728213,-0.5830993612155752,149220639,136245958.4,34.55875229524371,27.822135676882112,NaN,NaN,-16.935177652009497,-13.873628379185082
2004-07-30T09:30:00-04:00,101.39999,101.8,101.06,101.75,3944200,6730774.85,49.177860916184216,40.747765460978194,NaN,NaN,-9.577137164808747,-64.14063064284008,0.052724461312403714,-0.5171937845750705,-0.5699182458874742,153164839,140157058.6,44.77234259302381,28.854483980970542,NaN,NaN,-14.71391611384114,-13.993669484135948
2004-08-02T09:30:00-04:00,101.17,102.23,101.16,101.94,6028500,6818384.8,50.64156488581752,41.12034033304053,NaN,NaN,18.639152162539983,-27.817569608246583,0.11300298062869474,-0.4286645201016057,-0.5416675007303005,159193339,147014219,57.34275920986884,30.470528242284363,NaN,NaN,-12.449838980894706,-13.7731222693872
2004-08-03T09:30:00-04:00,101.78,101.94,101.16,101.25,5628199,6783859.8,45.514909055926545,41.28130549485358,NaN,NaN,-7.901301972289108,-11.598604771944952,0.10576467694877623,-0.40946165454433014,-0.5152263314931064,153565140,151342579.4,63.05848677986391,32.62632556736248,NaN,NaN,-11.954091439949117,-13.513260722324617
2004-08-04T09:30:00-04:00,100.96001,101.88,100.87,101.39999,5963500,6801839.9,46.776244098990865,41.859821941936914,NaN,NaN,-9.105035995981979,-1.5328497741758185,0.10995272081014162,-0.37778543048042934,-0.48773815129057096,159528640,154934519.4,67.00908986858246,35.11559180801322,NaN,NaN,-11.182248052877211,-13.18025891240356
2004-08-05T09:30:00-04:00,101.5,101.5,99.64999,99.72,8181500,6807049.85,36.56557386918493,41.64287139000976,NaN,NaN,-108.5722912155084,-23.303322837209627,0.004047380840699666,-0.48267892523969635,-0.486726306080396,151347140,155359819.6,67.45291512317621,37.63620964791199,NaN,NaN,-13.833025045444861,-13.273511217123746
2004-08-06T09:30:00-04:00,99.11,99.38,98.14999,98.37,9082699,7078174.8,30.755704836447293,41.34848316147344,NaN,NaN,-220.990485025812,-65.58599240941028,-0.14426066024559792,-0.6670521313873934,-0.5227914711417955,142264441,153179740,62.78987872087599,40.16195135712331,NaN,NaN,-18.294591997474125,-13.990808471459514
2004-08-09T09:30:00-04:00,98.42999,98.84,98.31,98.42,5095102,7038604.9,31.19177385263785,40.43407079589558,NaN,NaN,-188.20824008323504,-106.95547085856529,-0.22169781176357195,-0.7999137358462605,-0.5782159240826885,147359543,150812980.8,58.09451120810745,42.53754578809532,NaN,NaN,-21.544556738947197,-15.069915366814897
2004-08-10T09:30:00-04:00,98.62,99.72,98.3705,99.57001,7338199,7242164.85,40.47662739011509,40.78705283457415,NaN,NaN,-116.55806972664101,-128.68682440943567,-0.17994971672210003,-0.8031530699853136,-0.6232033532632135,154697742,151039501.2,58.41503056479591,45.12923359538167,NaN,NaN,-21.171659968859196,-15.941593167106939
2004-08-11T09:30:00-04:00,99.17999,99.86,98.72,99.71001,6687500,7211789.85,41.511334679717315,41.13890389693396,NaN,NaN,-89.57959010688388,-144.78173523161604,-0.129733459094593,-0.7853701771314547,-0.6556367180368617,161385242,151410821.6,58.96904508745317,47.55937263234403,NaN,NaN,-20.544553220220862,-16.599158888980355
2004-08-12T09:30:00-04:00,99.28,99.48,98.32001,98.58,6967602,7333700.05,36.06226988637872,41.34419831358449,NaN,NaN,-118.12547682172058,-146.69237235285848,-0.15759532284641697,-0.8526308715948829,-0.695035548748466,154417640,152024921.6,59.92005886518416,50.20131874914709,NaN,NaN,-21.837960250247612,-17.347559083447106
2004-08-13T09:30:00-04:00,98.7,98.89999,98.17,98.7,4192699,7246090.1,37.00790795985933,41.63051127610941,NaN,NaN,-117.14730199991652,-125.92373574767939,-0.15280256594908093,-0.8860387561848171,-0.7332361902357362,158610339,155294101.2,64.62119387734305,53.297141797768994,NaN,NaN,-22.54727205211112,-18.090375221827678
2004-08-16T09:30:00-04:00,98.67,100.03,98.66,99.8,5697000,7048660,45.03325590441821,41.763534565495256,NaN,NaN,-51.16106659278765,-98.5143010495899,-0.0649041911922894,-0.8143664292260979,-0.7494622380338085,164307339,158683660.4,68.718115733671,56.77270743681486,NaN,NaN,-20.49143502178882,-18.43338376467927
2004-08-17T09:30:00-04:00,100.2,100.59,99.86,100.25,5947898,7081085,47.95448527600276,41.87514080414071,NaN,NaN,2.3146185348127433,-74.73976339729914,0.029141845064516447,-0.713034931703163,-0.7421767767676795,170255237,161795159.4,71.93138165528612,59.83239725589114,NaN,NaN,-17.869759923090204,-18.35286607302369
2004-08-18T09:30:00-04:00,99.82001,101.3,99.77,101.22,6069102,6917360,53.670193328349434,42.309978995716406,NaN,NaN,41.55823395270682,-48.512198585381036,0.15522983285075131,-0.5481394857042403,-0.7033693185549916,176324339,164782978.8,74.6266439588353,62.694389517576255,NaN,NaN,-13.694784765584647,-17.687425886246686
2004-08-19T09:30:00-04:00,101.03,101.17999,100.32001,100.85001,5513301,6609465.1,51.353545092628,42.46538500831953,NaN,NaN,40.715006131543554,-16.744101994728215,0.20892252290173086,-0.442216164927828,-0.6511386878295589,170811038,168061658.4,77.21250887253159,65.0115442518268,NaN,NaN,-11.064752858243747,-16.741329739389123
2004-08-20T09:30:00-04:00,100.39,101.44,100.31,101.25,5466500,6540920.2,53.68124833844534,42.682505254935805,NaN,NaN,51.1950577906925,16.924369963393602,0.26308673142275496,-0.3222802735511152,-0.5853670049738702,176277538,171595098.2,79.62273214476744,66.60297089003386,NaN,NaN,-8.178889277946293,-15.518123959183004
2004-08-23T09:30:00-04:00,101.25999,101.45,100.81,100.89999,4521699,6331915.1,51.36512967345754,43.10037815618802,NaN,NaN,50.15228315933663,37.18703991381845,0.26624422553204163,-0.2525617230588182,-0.5188059485908598,171755839,173084798.2,80.55646326274251,67.85282635309662,NaN,NaN,-6.496944575955761,-14.229384047293399
2004-08-24T09:30:00-04:00,101.35001,101.57001,100.73,101.22,3746000,6168425.05,53.347045181327765,43.569721090640655,NaN,NaN,55.63142639513539,47.85040148588298,0.2794184648190653,-0.16953286756702823,-0.4489513323860935,175501839,174134118.6,81.20960257673954,68.86714868939355,NaN,NaN,-4.513505705077798,-12.841401426976885
2004-08-25T09:30:00-04:00,101.2,102.16,100.78999,101.88,6233102,5997800.05,57.21918880836597,45.044979300582156,NaN,NaN,81.04267585513566,55.747289866368746,0.31924090685357004,-0.04990019881913099,-0.36914110567270103,181734941,175216239,81.88539239354242,69.89803992299113,NaN,NaN,-1.625394627265235,-11.239114741303792
2004-08-26T09:30:00-04:00,101.85001,102.08,101.67999,101.87,4238801,5827155.15,57.14180199169193,46.929700525956775,NaN,NaN,97.59959932422893,67.12420850490582,0.33019291853344535,0.04360004249410565,-0.2865928760393397,177496140,176553259.4,82.71266902577042,71.32109637334074,NaN,NaN,0.6825166116223657,-9.536024548028628
2004-08-27T09:30:00-04:00,101.91,102.25,101.72,102.16,2971600,5778525.15,58.87870186362558,48.907338241027325,NaN,NaN,104.48987629307476,77.78317220538227,0.34086810392342687,0.1394922538649439,-0.20137585005848296,180467740,177391299.8,83.22965115164197,73.11646351216463,NaN,NaN,3.1263465029994513,-7.72711439788176
2004-08-30T09:30:00-04:00,101.94,102.09,101.31,101.41,4482801,5701240.2,52.90695250647753,49.79521860648179,NaN,NaN,77.53951251146778,83.2606180758085,0.28366289137012485,0.1532027641541731,-0.13046012721595174,175984939,178237119.8,83.75760425504075,74.92664734718211,NaN,NaN,3.5918413503071274,-6.110120719569061
2004-08-31T09:30:00-04:00,101.45,101.91,100.89999,101.89,5159602,5677810.35,55.98389653653245,50.82897302482572,NaN,NaN,74.42948836341691,87.0202304694648,0.26475955360418546,0.20048931478928012,-0.06427023881490536,181144541,179365660.2,84.46053595702395,76.74746812358003,NaN,NaN,4.885482514944471,-4.5393202574956995
2004-09-01T09:30:00-04:00,101.74001,102.25999,101.22,101.88,4624301,5610850.4,55.9019495098362,52.24609299792983,NaN,NaN,85.7216975808278,87.95603481460323,0.23897993727763886,0.2344546827821432,-0.004525254495495644,176520240,178322720,80.9729110117165,78.25124327690378,NaN,NaN,5.9167439076715045,-3.045596805328956
2004-09-02T09:30:00-04:00,101.85001,103.24001,101.82001,103.03999,4908199,5447185.35,62.71900065270974,54.082599618847716,NaN,NaN,125.7298172526161,93.58207840028066,0.2843631577239121,0.3509286926593944,0.06656553493548237,181428439,179109179.8,81.59025265671384,79.46331890400168,NaN,NaN,8.960516942038206,-1.3304376985622186
2004-09-03T09:30:00-04:00,103,103.39,102.81,102.86,5171898,5251645.3,61.13964872077839,55.23305624858773,NaN,NaN,136.06753718053483,99.89761057777268,0.28580828787850904,0.42382589478361865,0.1380176069051096,176256541,178266940,78.64731513770178,80.17254743286104,NaN,NaN,10.995607505670343,0.4304259020424328
2004-09-07T09:30:00-04:00,103.25,103.82001,103.12,103.64,4500102,5221895.3,65.22624963107174,56.466753702521224,NaN,NaN,154.969849032338,115.38367788194674,0.3202510223370604,0.538331384826435,0.2180803624893747,180756643,179221280.8,79.54751960387034,80.71655728633134,NaN,NaN,14.047095190987102,2.3756643718916712
2004-09-08T09:30:00-04:00,103.45,103.77,103.22,103.49001,5086102,5109290.45,63.836060249282475,57.192887054016445,NaN,NaN,137.9078574557784,128.07935170041904,0.31349076481544624,0.6099438185086825,0.29645305369323627,175670541,178126480.8,75.60947288505174,80.78675935248965,NaN,NaN,16.137036262312858,4.341574641951841
2004-09-09T09:30:00-04:00,103.37,103.57001,102.87,103,5992398,5074535.35,59.3831674588533,57.76643150874683,NaN,NaN,106.71694480347112,132.2784011449477,0.2588458631083809,0.6200103825787124,0.3611645194703315,169678143,176758061.4,70.88577176474175,80.33484955907609,NaN,NaN,16.633566902247715,6.097573536279823
2004-09-10T09:30:00-04:00,103,103.38,102.56,103.23,3672200,4909765.25,60.76654368791,58.272524033708585,NaN,NaN,95.2285218243267,126.1781420592898,0.22241176419370612,0.6391792247124641,0.416767460518758,173350343,175142442.2,65.66934236112765,79.33817886024467,NaN,NaN,17.44069495206144,7.718019452820053
2004-09-13T09:30:00-04:00,103.46001,103.72,103.17999,103.5,4575199,4928890.25,62.38612567194601,59.059738033600624,NaN,NaN,112.04647107848386,121.37392883887962,0.20134756448984303,0.6684519161310618,0.4671043516412188,177925542,175476242.4,66.22240617156245,78.3143176394461,NaN,NaN,18.57721462332716,9.269333048606782
2004-09-14T09:30:00-04:00,103.36,103.63,103.25,103.5,3690900,4828585.25,62.386125671946004,59.70538664007336,NaN,NaN,99.50896122818922,110.28175127804987,0.17333145894365853,0.6837686753207919,0.5104372163771334,177925542,174910022.2,64.32925586574314,77.10857858866065,NaN,NaN,19.513010750783053,10.732715577489106
2004-09-15T09:30:00-04:00,103.14999,103.2,102.52,102.53999,6374602,4849920.45,53.31114448771523,59.42624061716973,NaN,NaN,41.99890981227449,91.09996174934909,0.0807660311455558,0.6113947553090782,0.5306287241635224,171550940,174086102,61.57096187863305,75.65754783759569,NaN,NaN,17.729687678731786,11.732283020523775
2004-09-16T09:30:00-04:00,102.67,103.10001,102.58,102.75,5572699,4825100.3,54.858129718115286,59.263121169057115,NaN,NaN,40.42532784516673,77.8416383576882,0.027078632268113134,0.5644770144986637,0.5373983822305506,177123639,175575201.2,64.5310429547731,74.35886026109588,NaN,NaN,16.67534282355935,12.43843442095743
2004-09-17T09:30:00-04:00,102.87,103.3,102.69,103.00999,4898398,4794355.15,56.767897863147205,59.11234945473723,NaN,NaN,49.68252968289875,68.7324399294026,0.003701500046155326,0.5420252572882447,0.5383237572420894,182022037,177309540,67.6559262603767,73.24645134029122,NaN,NaN,16.311690159109812,12.991756669264912
2004-09-20T09:30:00-04:00,102.56,102.7,102.00999,102.14999,6735301,4857795.2,49.33314718584141,58.857077646120366,NaN,NaN,-17.02375362331263,42.91839498904331,-0.0709358581101297,0.44965393460442726,0.520589792714557,175286736,176781778.8,65.75739315141908,71.96072197574682,NaN,NaN,13.71939864865491,13.095705523463483
2004-09-21T09:30:00-04:00,102.39,102.88,102.14,102.37,6606199,4962020.2,51.09764852611058,58.50805993109024,NaN,NaN,-8.123521661049429,21.391898411195577,-0.10470412689031477,0.3897096341016635,0.49441376099197826,181892935,177575257.4,67.24560368378573,70.73108395622981,NaN,NaN,12.080833195449575,12.950723762318638
2004-09-22T09:30:00-04:00,101.99001,102,101.08,101.10001,8853500,5217395.2,42.00411854667383,57.51535771943577,NaN,NaN,-121.79541384935159,-11.366966321129636,-0.20593593097017027,0.23699384727926542,0.4429297782494357,173039435,177872956.4,67.81084509226397,69.79093639055462,NaN,NaN,7.521250549127692,12.175084731862789
2004-09-23T09:30:00-04:00,101.17999,101.22,100.39999,100.45,7441199,5277800.05,38.25189296360518,55.76770717021402,NaN,NaN,-176.73706076775477,-54.79944404371393,-0.3041107886856024,0.06279129239243275,0.3669020810780351,165598236,175567875.8,59.28044761383953,68.19737888749218,NaN,NaN,2.414231966741555,10.780677193988327
2004-09-24T09:30:00-04:00,100.49001,100.94,100.49001,100.72,5528898,5342304.9,40.624536457376365,54.302342008542446,NaN,NaN,-153.86274420822176,-95.50849882193805,-0.33581710448341695,-0.05286929952623609,0.28294780495718086,171127134,173388895.2,52.55067567724475,66.33333321174524,NaN,NaN,-0.9625248999967501,9.103076894847602
2004-09-27T09:30:00-04:00,100.38,100.58,100,100.16,5243000,5455874.9,37.413493961898965,52.31571660360153,NaN,NaN,-164.06495046640364,-124.91673819055625,-0.3764033943093003,-0.18755643792944454,0.18884695637985577,165884134,171508374.8,47.53518497608734,64.04673788118932,NaN,NaN,-4.849730210134455,7.109818736993023
2004-09-28T09:30:00-04:00,100.25,101.14999,99.91,100.89,8556801,5659574.9,43.664621603431215,50.8748995574693,NaN,NaN,-120.98054102498888,-147.48814206334413,-0.3372451936449641,-0.23270953567634933,0.10453565796861475,174440935,170017974.8,43.95463851017769,61.78567828298402,NaN,NaN,-6.179465471393559,5.211349564366368
2004-09-29T09:30:00-04:00,100.77,101.49001,100.62,101.47,7242398,5763714.7,48.10003911633639,50.06896181871809,NaN,NaN,-78.15098797694915,-138.75925688886366,-0.2589614283921973,-0.2191661275216319,0.03979530087056542,181683333,171746754.4,48.77457348819359,60.206306977516306,NaN,NaN,-5.85716673485514,3.630132950191867
2004-09-30T09:30:00-04:00,100.73,101.07001,100.55,100.87,6375500,5851274.65,44.221282206623634,48.88715742719763,NaN,NaN,-94.38046452072825,-122.28793763945835,-0.23497289940291904,-0.2539208233830834,-0.018947923980164358,175307833,173688673.8,53.60161087278999,59.344326156920765,NaN,NaN,-6.8373785087807155,2.134774170338641
2004-10-01T09:30:00-04:00,101.34,102.19,101.22,102.16,7370602,5974394.8,52.99722485400561,48.2165216544876,NaN,NaN,-22.980139595335324,-96.11141671688107,-0.12512215557558182,-0.17535061844964162,-0.050228462874059805,182678435,175998934,58.599791911339395,58.799853709761976,NaN,NaN,-4.657272144402257,1.16448183966137
2004-10-04T09:30:00-04:00,102.64999,102.88,102.25999,102.31,5423699,5986984.85,53.905383430018425,47.61075435149278,NaN,NaN,20.826058823905118,-59.1332148588193,-0.03968015447643429,-0.09982865596960266,-0.060148501493168374,188102134,180442534,66.15238230555022,58.930077026891055,NaN,NaN,-2.6626599763050476,0.6177472945233105
2004-10-05T09:30:00-04:00,102.32001,102.37,101.73,102.03999,5210500,6022504.75,51.95924256188335,47.514189928219075,NaN,NaN,-3.980353035373913,-35.73317726089632,-0.0007297092087514279,-0.06106063800410766,-0.06033092879535623,182891634,182132673.8,68.50578653046482,59.42542164487903,NaN,NaN,-1.6580658796067052,0.2926311267904511
2004-10-06T09:30:00-04:00,101.91,102.64999,101.78999,102.64,5244801,6030439.7,55.77979534841728,47.58002318752636,NaN,NaN,23.859695308428485,-15.331040603820776,0.06256318988093068,0.01787305855580712,-0.04469013132512356,188136435,183423294.2,70.20916694538639,59.83100192992284,NaN,NaN,0.40278224448374206,0.30836700074663553
2004-10-07T09:30:00-04:00,102.41,102.42999,101.42999,101.44,6822000,6071919.8,47.6226635223284,46.92679216318215,NaN,NaN,-16.56481733800845,0.23208883272317352,0.02278052186428372,-0.01621447899476891,-0.03899500085905263,181314435,184624614.6,71.7412383910204,60.12280993925453,NaN,NaN,-0.4713716487364363,0.19697576510619672
2004-10-08T09:30:00-04:00,101.2,101.73,100.59,100.7,7266398,6251629.7,43.40709243141257,46.503502537865806,NaN,NaN,-68.9180276806299,-8.955488784335742,-0.05021823757506965,-0.1017677978278897,-0.051549560252820044,174048037,182898535,66.45315126266891,60.172506947200944,NaN,NaN,-2.622738200708946,-0.2058405157245379
2004-10-11T09:30:00-04:00,100.96001,101.25,100.91,101.14,3552200,6200479.75,46.44284171707805,46.17101633722062,NaN,NaN,-54.81477335456219,-24.083655220029208,-0.06479018319463682,-0.13253728924611607,-0.06774710605147925,177600237,180798155.6,60.599579373155066,59.697790925013045,NaN,NaN,-3.3769413996788207,-0.6588549277180068
2004-10-12T09:30:00-04:00,100.60001,101.25,100.36,101.05,5208199,6276344.7,45.90047184061911,46.44932728678814,NaN,NaN,-65.31397995600169,-36.35038060415476,-0.07565314024922581,-0.16231353136301152,-0.0866603911137857,172392038,178698236.4,55.350132348750066,58.80774001476204,NaN,NaN,-4.139967541394829,-1.1561567296718385
2004-10-13T09:30:00-04:00,101.42999,101.47,99.77,100.08,7918000,6353514.6,40.42145510638076,46.604296011272105,NaN,NaN,-95.59515183412145,-60.241350032664755,-0.13960903631719596,-0.26117168651028067,-0.12156265019308471,164474038,173965757,45.73485006983636,57.84019733304753,NaN,NaN,-6.574934512989778,-1.930267841574401
2004-10-14T09:30:00-04:00,100.14,100.24001,99,99.17999,8129602,6481359.75,36.11399472882066,46.28211445923241,NaN,NaN,-165.08983862441087,-89.94635428994523,-0.22870508869924566,-0.4074440110671418,-0.17873892236789612,156344436,168971757.2,38.19454108165984,56.81475914764861,NaN,NaN,-10.09931292105488,-3.0972742815001837
2004-10-15T09:30:00-04:00,99.42,99.95,99.07001,99.47,7490301,6610954.9,38.392212736943385,46.35202294316416,NaN,NaN,-152.2126994256297,-106.6052886389452,-0.2524223802673552,-0.4942668977020901,-0.24184451743473492,163834737,166929097.2,35.608542245318645,55.962856095450846,NaN,NaN,-12.218381097586278,-4.4002895409410545
2004-10-18T09:30:00-04:00,99.03999,99.8,98.75,99.63,9899801,6769179.9,39.670449573865305,46.06672494105231,NaN,NaN,-146.15075880944403,-124.87248572992158,-0.2416398443479072,-0.5438943228696189,-0.3022544785217117,173734538,166155957.4,34.65221900734778,55.29839755953443,NaN,NaN,-13.543660914867944,-5.706485451502038
2004-10-19T09:30:00-04:00,99.98,100.37,99.02,99.10001,9488199,6913279.9,36.93665628817861,45.269340453326755,NaN,NaN,-125.48111707293576,-136.90591315330838,-0.253281527055747,-0.6188563873413955,-0.36557486028564845,164246339,164526817.6,32.66166553828057,54.147475563112074,NaN,NaN,-15.495782566565373,-7.104956467939657
2004-10-20T09:30:00-04:00,98.92,99.09,98.2,98.89,9637199,6952464.85,35.88147797462396,44.67364015104106,NaN,NaN,-165.95349034996846,-150.9775808564778,-0.2573703434232237,-0.6872877895646781,-0.4299174461414544,154609140,162553838,30.385235398272897,52.489163029218,NaN,NaN,-17.411956081182407,-8.577384984117193
2004-10-21T09:30:00-04:00,99.06,99.25,98.2,98.94,12990500,7229929.9,36.347704588708616,43.48438870351985,NaN,NaN,-135.4053549549216,-145.0406841225799,-0.23933099713890849,-0.72908119256509,-0.4897501954261815,167599640,164804878.8,35.87657340955431,50.86607599337621,NaN,NaN,-18.853149130138895,-10.045351290691722
2004-10-22T09:30:00-04:00,98.94,99.03999,97.67,97.75999,10886301,7497800.05,30.678214453703077,41.82530520521161,NaN,NaN,-150.70127803816462,-144.73839984508692,-0.2863186804572261,-0.8476485459977141,-0.561329865540488,156713339,163380599.2,34.04659057188802,48.57280515525747,NaN,NaN,-21.943836103135563,-11.745134835326557
2004-10-25T09:30:00-04:00,97.52,97.97,97.27,97.67999,8935699,7682435,30.332777986667594,40.28055773555333,NaN,NaN,-153.54569559762584,-146.21738720272327,-0.30074822757941166,-0.9372651500147526,-0.636516922435341,147777640,158189219.6,28.36694928024977,45.70574535167068,NaN,NaN,-24.5470269114804,-13.573976560491392
2004-10-26T09:30:00-04:00,97.96001,99.10001,97.67,99.08,8282301,7668710,42.52870743040845,39.33405145569556,NaN,NaN,-87.07714287595545,-138.5365923633272,-0.19887829831339432,-0.8851147953270839,-0.6862364970136896,156059941,156551940,26.845877756496932,42.608367552464294,NaN,NaN,-23.093742697758767,-14.933943151529588
2004-10-27T09:30:00-04:00,98.95,100.37,98.62,100.14,10348398,7824010,49.707465872567454,39.48296590928407,NaN,NaN,-26.601565273873188,-110.66620734810814,-0.05069966037055329,-0.7496110724768812,-0.6989114121063279,166408339,158911779.8,32.466693772056374,39.803042936824006,NaN,NaN,-19.38680804118343,-15.570066707194423
2004-10-28T09:30:00-04:00,100.02,100.64999,99.73,100.27,7890500,7899760,50.523705566772016,39.991295418952596,NaN,NaN,1.7934044279784094,-83.22645547152814,0.05950173739861486,-0.6245342403580594,-0.6840359777566742,174298839,160251619.6,35.497059967225184,37.59189355857802,NaN,NaN,-16.21249700098397,-15.661842463450073
2004-10-29T09:30:00-04:00,100.12,100.64,100.09,100.38,5305602,7796510,51.24476238074652,40.33428975207177,NaN,NaN,15.009912972136808,-50.08421726946786,0.13871082762627418,-0.5106474432238315,-0.6493582708501057,179604441,164829840,44.6384790405614,36.451814963392756,NaN,NaN,-13.448316861340837,-15.345624520291612
2004-11-01T09:30:00-05:00,100.49001,100.97,100.3,100.71001,6267301,7838690.1,53.43721572278095,40.87262860079762,NaN,NaN,40.10022910177128,-11.355032329588436,0.20806664269316955,-0.38927496748364376,-0.5973416101768133,185871742,172448660.4,55.85156486630666,36.48763157178966,NaN,NaN,-10.484227453462749,-14.651139225030345
2004-11-02T09:30:00-05:00,100.78999,101.53,100.28999,100.53,7395102,7947920.2,52.06195891735658,41.704093158724454,NaN,NaN,55.004029048977024,17.061202055398052,0.23458835848157455,-0.3041061620748451,-0.5386945205564196,178476640,176932000.2,60.873660265023894,37.5689751571602,NaN,NaN,-8.412523760893823,-13.759908444439413
2004-11-03T09:30:00-05:00,101.92999,102.37,101.14,101.71001,10058199,8188590.1,59.43239363359621,43.36969308049414,NaN,NaN,124.41657512697593,47.26483013556788,0.31913080333390614,-0.13978101638903695,-0.4589118197229431,188534839,181357300.2,65.09441667796665,39.490394842610684,NaN,NaN,-4.164574971109985,-12.389146519678066
2004-11-04T09:30:00-05:00,101.57001,103.45,101.5,103.32001,9475000,8321240.1,66.9082005478135,45.406549352699145,NaN,NaN,181.44302779610453,83.19475480919311,0.4623212560669008,0.11898975036068293,-0.34333150570621784,198009839,186099500.2,68.9588095123932,41.87255679025886,NaN,NaN,2.4326158877474877,-10.271751890045845
2004-11-05T09:30:00-05:00,103.71001,104.42999,103.5,104.22,8310500,8373445.2,70.21270437493627,47.58813898134707,NaN,NaN,222.6980659195049,124.73238539866672,0.5883999606477804,0.3921684451035077,-0.19623151554427273,206320339,191442679.8,72.63491346184958,44.585606394151846,NaN,NaN,9.108285953060232,-7.503175055316406
2004-11-08T09:30:00-05:00,104.03,104.33,103.82001,104.28999,5258000,8458735.2,70.4597533100528,49.98264591148095,NaN,NaN,193.4488726371598,155.40211410574443,0.6428343554672008,0.6073114287897283,-0.035522926677472505,211578339,196583999.2,75.62604134035692,47.654490380014444,NaN,NaN,14.337634156834875,-4.383059453580509
2004-11-09T09:30:00-05:00,104.17999,104.58,103.97,104.21001,6610102,8528830.35,69.74786328465335,52.4016734336259,NaN,NaN,166.2500829366423,177.65132488327748,0.6384740594131924,0.762569647589018,0.12409558817582561,204968237,201882318.6,78.26290617595208,51.074324006991525,NaN,NaN,18.270478155288966,-1.1468397951705844
2004-11-10T09:30:00-05:00,104.27,104.81,104.14999,104.39,5466898,8406275.25,70.47092162927972,54.83904607938098,NaN,NaN,143.5218597128467,181.47238180045164,0.6126264306176106,0.8898786264478389,0.27725219583022825,210435135,206262377.8,80.17256130040384,54.2383231420522,NaN,NaN,21.702598516341265,2.1173656779025367
2004-11-11T09:30:00-05:00,104.49001,105.25999,104.42,105.09,4605000,8230045.15,73.15792223778084,57.87331092110082,NaN,NaN,134.2383862911639,172.0314534994635,0.6064554571559377,1.0353215172751504,0.4288660601192127,215040135,209668437,81.53133129720803,57.63009033671792,NaN,NaN,25.522302026377417,5.460928013398949
2004-11-12T09:30:00-05:00,105.19,105.75999,105,105.64999,4877699,8099415.05,75.10921894648017,61.071628132516004,NaN,NaN,128.5767265525647,153.2071856260755,0.6026235769120201,1.1821455312592377,0.5795219543472176,219917834,212387936,82.55904241199912,61.50095413184288,NaN,NaN,29.38520714442559,8.878682174974182
2004-11-15T09:30:00-05:00,105.53999,105.84,105.39999,105.73,4606898,7834769.9,75.3845552959792,63.41847440862819,NaN,NaN,116.21099397089365,137.75960989282223,0.568453965166279,1.2900894108050664,0.7216354456387875,224524732,214977214.6,83.50045908381259,65.54770994093685,NaN,NaN,32.60436790501981,12.268065850694985
2004-11-16T09:30:00-05:00,105.42999,105.47,104.94,105.13,8044801,7762600,69.20242698619764,64.81097163103036,NaN,NaN,91.37303690424012,122.78420068634179,0.47236820741936314,1.3120957049129913,0.8397274974936282,216479931,217279553.4,84.31136745571266,69.25090091834088,NaN,NaN,33.620460547452325,15.318407950231748
2004-11-17T09:30:00-05:00,105.62,106.25999,105.35001,105.89999,6901398,7625809.95,72.33761621027797,66.3691081055665,NaN,NaN,97.69483187326828,113.6187951184261,0.4288645216278597,1.3758081495284529,0.9469436279005932,223381329,219868792.2,85.19274510536785,72.8005927139225,NaN,NaN,35.45697584877938,18.195346221452837
2004-11-18T09:30:00-05:00,105.92,106.10001,105.73,106,4714500,7212009.95,72.7259806297302,67.90348083763675,NaN,NaN,91.59348817967506,105.08981549612834,0.3768647675498882,1.4180245873379533,1.0411598197880652,228095829,222479931,86.04422322339927,75.75814586983948,NaN,NaN,37.06172923098394,20.890543794242994
2004-11-19T09:30:00-05:00,105.66,105.7,104.28999,104.57001,6968500,7016119.9,59.798488175895564,68.35785744143065,NaN,NaN,57.020946766445235,90.77865953890445,0.22376577882227933,1.3208670433159142,1.0971012644936349,221127329,222721830,86.12383133232561,77.92045061741227,NaN,NaN,34.40285691925274,22.820874240672957
2004-11-22T09:30:00-05:00,104.37,105,104.23,104.8,8336199,6986144.9,60.99925383574315,68.99623564988684,NaN,NaN,46.7152750333671,76.87951575139915,0.12075148851805251,1.2480406251412006,1.1272891366231481,229463528,223709589.2,86.46339006317241,79.74828846013716,NaN,NaN,32.62133011304237,24.22093936529716
2004-11-23T09:30:00-05:00,104.83,105.03,104.25999,104.99001,7527602,6948409.95,62.00885636286183,69.18026870197724,NaN,NaN,44.82177330405229,67.56926303136157,0.05170284893725885,1.1919176977947217,1.1402148488574628,236991130,227811829,87.79876651420628,81.37002773415428,NaN,NaN,31.461482601052126,25.255302684690726
2004-11-24T09:30:00-05:00,105.02,105.14999,104.71001,105.03,6210398,6741509.95,62.23046099118649,68.84614444793245,NaN,NaN,48.570673627543044,57.74443138221652,-0.0021289021868553526,1.1375537211238935,1.1396826233107489,243201528,231775868.8,88.93471360430935,82.796878026434,NaN,NaN,30.579214204143216,26.01586147318394
2004-11-26T09:30:00-05:00,105.09,105.35001,104.89999,104.92,1807400,6437354.95,61.17343589691718,68.20048241378822,NaN,NaN,49.68555373933507,49.36284449414852,-0.0531682122770587,1.0732223579644256,1.1263905702414843,241394128,234435528.6,89.63216689726464,84.01096755753507,NaN,NaN,29.553887750031464,26.52129379844787
2004-11-29T09:30:00-05:00,105.37,105.50999,104.02,104.47,9181301,6631139.9,56.914421414780776,67.23295870698307,NaN,NaN,25.068128862848702,42.97228091342922,-0.1213585340397807,0.9746924026917583,1.096050936731539,232212827,236652628.2,90.18740606579259,85.05106503792334,NaN,NaN,27.464736584692844,26.65607133934001
2004-11-30T09:30:00-05:00,104.60001,104.75999,104.19,104.33,7402199,6687884.8,55.61707897894931,66.22361697086136,NaN,NaN,-0.22613909599250867,33.583998087557305,-0.17666405187172418,0.8752208718918837,1.0518849237636079,224810628,235722048.2,88.05581767561526,85.75055871647069,NaN,NaN,25.35050517578964,26.469561887404243
2004-12-01T09:30:00-05:00,104.63,105.86,104.57001,105.67,8613398,6748799.6,64.06124515014093,65.76578293663717,NaN,NaN,69.51342416608398,38.52232825996366,-0.12614162202736368,0.8942078962294033,1.020349518256767,233424026,235008627.4,86.37043207795877,86.19326377201034,NaN,NaN,25.82417633285804,26.3773639510405
2004-12-02T09:30:00-05:00,105.45,106.27,105.36,105.84,8259301,6658854.7,64.97176200135988,65.18105720546424,NaN,NaN,114.5300480610178,51.71420314665861,-0.08631591845858266,0.9124546201835386,0.9987705386421213,241683327,234704987.2,85.61930896241836,86.48526217666823,NaN,NaN,26.479739215590563,26.391988988833365
2004-12-03T09:30:00-05:00,105.61,106.39,105.56,105.69,7207898,6545499.6,63.44438868281742,64.34785504377405,NaN,NaN,113.84809851080233,64.54671210095205,-0.07550736586282603,0.9043863313135887,0.9798936971764147,234475429,233321247.4,82.11464407764288,86.45351943849992,NaN,NaN,26.58594622605835,26.41969716557979
2004-12-06T09:30:00-05:00,105.67999,105.73,105.24001,105.35001,3495200,6304734.6,60.00135567892878,63.24905507112759,NaN,NaN,48.81080446330861,69.29524722104404,-0.09540542491700399,0.8606369160301597,0.9560423409471637,230980229,233074727.8,81.47479176614824,86.30882891580961,NaN,NaN,25.69709572623565,26.316468388530627
2004-12-07T09:30:00-05:00,105.47,105.63,104.37,104.41,7578102,6420739.7,51.65476075872603,61.995650340593905,NaN,NaN,-47.102535064168634,59.919968027408814,-0.17158113051381163,0.7415659278048992,0.9131470583187108,223402127,232793027.6,80.70093942110698,86.05094119905208,NaN,NaN,22.30166475350222,25.742925012098
2004-12-08T09:30:00-05:00,104.57001,105.06,104.42,105.00999,7090102,6444739.7,55.87404348898962,60.819680860501876,NaN,NaN,-50.32366148649315,35.952550896893385,-0.18036704793963498,0.6876882483941671,0.8680552963338021,230492229,232206668.2,79.01855458631198,85.60992759054807,NaN,NaN,20.672191035017377,25.018534443943626
2004-12-09T09:30:00-05:00,104.53,105.60001,104.16,105.38,8913398,6617064.7,58.291526035562356,59.788648389489886,NaN,NaN,-22.387394322061812,8.569062420277465,-0.16071947272556186,0.6671559554268498,0.8278754281524117,239405627,231751128.2,77.66394694331757,85.0113364276851,NaN,NaN,20.049122919706956,24.308618511909817
2004-12-10T09:30:00-05:00,105.19,105.75,105.11,105.5,6002801,6686954.75,59.07462093131417,59.73694358630551,NaN,NaN,41.00861437424309,-5.998834407034382,-0.13986903547439744,0.6530391338094148,0.7929081692838122,245408428,233937728,79.48215529677395,84.53693099657427,NaN,NaN,19.770522624421442,23.660319099411478
2004-12-13T09:30:00-05:00,105.89999,106.46001,105.53,106.45,7458102,6815974.9,64.72171026893136,60.00283333153324,NaN,NaN,137.856931602674,11.810391020838702,-0.06607023118301059,0.7103203803050491,0.7763906114880597,252866530,238314988.2,82.54529900597505,84.2570673496316,NaN,NaN,21.28810434539668,23.321431277409364
2004-12-14T09:30:00-05:00,106.24001,106.95,106.2,106.75999,5822801,6876770.05,66.35320047268102,60.313143625091755,NaN,NaN,182.49884374385817,57.73066678244406,-0.003646427077278469,0.7718325776414616,0.7754790047187401,258689331,245372429,86.1384600258822,84.13847402903703,NaN,NaN,23.043947732936537,23.2817907710561
2004-12-15T09:30:00-05:00,106.62,107.06,106.35001,106.85001,9271699,6938114.95,66.83289038085512,60.64188858149665,NaN,NaN,164.90617557978862,100.77663419570042,0.03434572775572042,0.8184111644133907,0.7840654366576703,267961030,252866189.2,88.77969066901466,84.12740096223027,NaN,NaN,24.608867276901467,23.47137312903401
2004-12-16T09:30:00-05:00,106.83,107.28999,106.62,107.16,8573301,7021710.1,68.49838414619192,61.16509917073057,NaN,NaN,170.15351144510694,139.28481534913416,0.06899267725785863,0.8703062832299935,0.8013136059721349,276534331,260291930,90.67568291537007,84.20193782066636,NaN,NaN,26.42025242753473,23.8926416002484
2004-12-17T09:30:00-05:00,106.36,106.98,106.22,106.53,8283801,7200175.15,61.7156015053121,61.50804060576853,NaN,NaN,112.43863644910196,153.57081976410595,0.03958145244251221,0.8507904215252751,0.8112089690827629,268250530,264860350.4,91.61448185349016,84.30387180550191,NaN,NaN,26.00803712575991,24.19484096103576
2004-12-20T09:30:00-05:00,106.75999,107.14999,106.35001,106.62,6136000,7158550.15,62.29007485596462,61.984683168412474,NaN,NaN,107.94848495525754,147.58913043462266,0.017420093794698,0.8329840863261353,0.8155639925314373,274386530,269164350.4,92.39168560816864,84.61357665782715,NaN,NaN,25.834103841496102,24.429021372530094
2004-12-21T09:30:00-05:00,106.75,107.47,106.61,107.42,8002898,7141885.1,67.02644840898469,62.19648340118704,NaN,NaN,130.27955197867593,137.1452720815862,0.0462353832407304,0.8733582215823503,0.8271228383416199,282389428,273904369.8,93.14520119312387,85.09748873748181,NaN,NaN,27.110746850827706,24.812125012286895
2004-12-22T09:30:00-05:00,107.36,108.13,107.3,108.00999,6666602,7098835.1,70.01733444162747,62.55688143263472,NaN,NaN,160.4990653501077,136.26385003565002,0.09198357567321647,0.9421023079331405,0.8501187322599241,289056030,278123369.8,93.73952754591724,85.67750435058886,NaN,NaN,29.14832417911176,25.431582036119018
2004-12-23T09:30:00-05:00,108.12,108.55,108.03,108.14999,3318100,6954220.2,70.6965703820629,63.07489441115225,NaN,NaN,164.32369357174787,135.0978864609782,0.11701982809353662,0.9963935173768448,0.8793736892833082,292374130,281291329.6,94.14969712362405,86.53715099673038,NaN,NaN,31.008366898793483,26.228265587929656
2004-12-27T09:30:00-05:00,108.42999,108.56,107.72,107.75999,5591199,7143410.15,66.19759241266532,63.51748274927629,NaN,NaN,129.071018532885,138.4243628777348,0.09367172236658572,0.9964633422415403,0.9027916198749546,286782931,284997809.8,94.59581843877322,87.47436718763217,NaN,NaN,31.26498769497104,26.947797317506996
2004-12-28T09:30:00-05:00,107.88,108.47,107.8,108.39999,3461100,6857400.1,69.61484461836312,64.80034588210751,NaN,NaN,127.35979463699513,142.30662481408234,0.10673988152591884,1.0362164717823532,0.9294765902564344,290244031,288169310,94.95063137266465,88.49220232702915,NaN,NaN,32.535083454851716,27.745981051413384
2004-12-29T09:30:00-05:00,108.27,108.31,107.83,108.24001,4043900,6689485.15,67.77050654377584,65.65009324316367,NaN,NaN,111.05444167661379,138.46160275366992,0.090651859036331,1.0427914140518482,0.9521395550155172,286200131,288931450.6,95.03499289791938,89.6362336350011,NaN,NaN,33.0316884062535,28.501082102104828
2004-12-30T09:30:00-05:00,108.31,108.41,107.77,107.85001,2786600,6398145.25,63.363331736811396,66.01236507896716,NaN,NaN,94.22617877548623,125.20702543874563,0.04224671450633921,1.0049479481484411,0.9627012336421019,283413531,287802950.8,92.56882207409173,90.70086757291354,NaN,NaN,32.15419181952953,29.022954918879787
2004-12-31T09:30:00-05:00,107.92999,108.19,107.47,107.50999,4264602,6198410.3,59.717111656949115,66.05825727365537,NaN,NaN,67.59729900490586,105.86174652537723,-0.0207833803402947,0.9367220082167336,0.9575053885570283,279148929,285157910.6,86.87812433302085,91.22915107550261,NaN,NaN,30.332361039513465,29.21001293611317
2005-01-03T09:30:00-05:00,108.14999,108.59,106.92999,107.32001,11693102,6422670.5,57.718590749648385,65.55803445084946,NaN,NaN,54.239864926256914,90.8955158040516,-0.08005339718184001,0.8574386420797282,0.9374920392615682,267455827,281292489.8,79.21417104667249,90.99121336412385,NaN,NaN,28.235071020097635,29.07073551953952
2005-01-04T09:30:00-05:00,107.45,107.60001,105.89,106.3,10629199,6779370.45,48.3605963824515,64.27284844440449,NaN,NaN,-20.185695031977673,61.386417870257034,-0.18664775536596867,0.7041823450541074,0.890830100420076,256826628,274609009.2,68.0381877052262,89.69833676979128,NaN,NaN,23.280861222193955,28.243610619918726
2005-01-05T09:30:00-05:00,106.3,106.78,105.71001,105.71001,10886398,6944785.25,43.924520241776605,62.63653629161316,NaN,NaN,-67.80698883847612,25.61413176723905,-0.28944796169963705,0.5290201482955297,0.8184681099951667,245940230,266557029,57.510874885781234,87.46484992813176,NaN,NaN,17.59246025359318,26.722017710443648
2005-01-06T09:30:00-05:00,106.13,106.66,105.83,106.03999,8568898,7018725.05,46.860496165196444,61.0909728643992,NaN,NaN,-69.98706405365786,-7.228516798589752,-0.3251110638367327,0.4120792801992508,0.7371903440359835,254509128,260776148.4,51.36595604276691,84.65701229437438,NaN,NaN,13.809673315359932,24.877397082574547
2005-01-07T09:30:00-05:00,106.41,106.5,105.63,105.84,8555699,7000840.1,45.312041596354014,59.91929001375934,NaN,NaN,-95.042373430702,-39.75645128571132,-0.3499048643965038,0.29980926354035375,0.6497141279368576,245953429,254137048.4,45.37028766264871,81.35385556645714,NaN,NaN,10.24548175927545,22.78712346496039
2005-01-10T09:30:00-05:00,105.84,106.63,105.77,106.2,6028199,7002110,48.60432393399794,58.941736376476,NaN,NaN,-83.36075874208478,-67.27657601937968,-0.3300515077801355,0.23714974321168825,0.5672012509918237,251981628,251042208.6,42.85888285411007,77.81579822688151,NaN,NaN,8.209347397237606,20.70458402671428
2005-01-11T09:30:00-05:00,105.89999,105.91,105.27,105.52,7594199,7008914.85,43.30158495836552,57.24710327286034,NaN,NaN,-134.9953234456711,-90.23850170211837,-0.3488730399864452,0.1311099510087672,0.4799829909952124,244387429,248554368.8,40.89901427199128,74.08392773251491,NaN,NaN,4.75310618831573,18.42580147837163
2005-01-12T09:30:00-05:00,105.58,106.23,104.96001,106.03,10574602,7246504.9,47.89320216563954,55.66680811028978,NaN,NaN,-109.21919065371078,-98.52094206516531,-0.3142104152594482,0.08721997192090214,0.40143038718035035,254962031,250358729,42.937113623891165,70.45518388094162,NaN,NaN,3.2436234242032023,16.25691889920471
2005-01-13T09:30:00-05:00,105.96001,106.10001,104.81,104.95,7671398,7166489.85,40.42693051932963,53.50469097723741,NaN,NaN,-129.540508893603,-110.43163103315433,-0.34859596556788897,-0.03431456977951086,0.3142813957883781,247290633,248915030,41.6980753102589,66.70863946570125,NaN,NaN,-0.653641176018356,13.841124602744271
2005-01-14T09:30:00-05:00,105.13,105.64999,105.05,105.44,5986898,7037169.7,44.64346645659784,51.96511055180401,NaN,NaN,-107.50226442619008,-112.92360923225195,-0.3234687740235307,-0.09005457174103526,0.23341420228249543,253277531,250379850.4,43.48022715528547,63.05752580259499,NaN,NaN,-2.4465150445428256,11.514318938846115
2005-01-18T09:30:00-05:00,105.25,106.28999,105,106.16,6601898,6953074.55,50.219047472227935,50.57969646993722,NaN,NaN,-70.42495524114193,-110.33644853206337,-0.24694204429564975,-0.07526335308706678,0.17167869120858298,259879429,251959410.6,45.417762498555895,59.519463740158656,NaN,NaN,-2.0727786214732604,9.573305001657634
2005-01-19T09:30:00-05:00,106.14999,106.25,105.23,105.25,6635102,6978029.65,44.164420887510666,48.8935474944897,NaN,NaN,-79.04693148965434,-99.14677014086003,-0.24567069858823004,-0.13540968202670456,0.11026101656152547,253244327,253730790.2,47.58767772970052,56.130369799571596,NaN,NaN,-3.8472314835060675,7.6560855037771045
2005-01-20T09:30:00-05:00,105.06,105.48,104.58,104.75999,8664699,7011119.7,41.278458931038834,47.31605657979166,NaN,NaN,-108.63762741833322,-99.03045749378451,-0.26427190184559957,-0.220078860745474,0.04419304110012556,244579628,251654309.6,45.313522129606135,52.75499123210834,NaN,NaN,-6.258200781584884,5.668330320153963
2005-01-21T09:30:00-05:00,104.95,105.03,103.78,103.84,7982398,7076909.5,36.46108364052071,45.65491172147535,NaN,NaN,-140.1071224068885,-101.14378019644161,-0.3211917179543858,-0.35729660634285665,-0.03610488838847088,236597230,249515629,43.0325225521942,49.62316253347786,NaN,NaN,-9.989542157772028,3.431491394735964
2005-01-24T09:30:00-05:00,104.11,104.31,103.62,103.75,9878301,7404919.55,36.01823681004619,44.10488644007519,NaN,NaN,-150.10077605497773,-109.66348252219913,-0.3454449837399418,-0.46791111806339813,-0.12246613432345634,226718929,244203908.6,37.926174811247826,46.67401994523324,NaN,NaN,-13.017783040355702,1.081595046865726
2005-01-25T09:30:00-05:00,104.09,105.00999,104.05,104.59,9752500,7612984.6,42.97933424200995,43.720510572900785,NaN,NaN,-102.38641670558961,-116.05577481508867,-0.2878143260253326,-0.4822340418551221,-0.1944197158297895,236471429,239522308.6,34.08693440217323,44.24893042358661,NaN,NaN,-13.308317039660375,-0.9741066797808595
2005-01-26T09:30:00-05:00,104.95,105.25,104.67999,104.78999,7853398,7832599.5,44.526790839486836,43.763529901308665,NaN,NaN,-73.07704680885251,-114.86179787892831,-0.22206946167565786,-0.47200654292436184,-0.24993708124870398,244324827,237738408.6,32.72743470549776,42.47868469642349,NaN,NaN,-13.047951014968026,-2.6989415848075975
2005-01-27T09:30:00-05:00,104.45,104.83,104.21001,104.57001,8431301,8051969.55,43.139953684479934,43.497776866971776,NaN,NaN,-93.88439197160169,-111.91115078958201,-0.18098058728319222,-0.4761628153526942,-0.295182228069502,235893526,236001188.2,31.413491835213165,41.05350868159822,NaN,NaN,-13.25331228001966,-4.2067088269807495
2005-01-28T09:30:00-05:00,104.53999,104.64999,103.75999,104.44,7812301,8303254.6,42.30138828741559,43.28273020204761,NaN,NaN,-106.02241480827387,-105.09420926985908,-0.1513453898410983,-0.4843639653708749,-0.3330185755297766,228081225,234297987.2,30.136034827920582,39.96534776483194,NaN,NaN,-13.662307652914368,-5.557508659256981
2005-01-31T09:30:00-05:00,104.98,105.05,104.48,104.8,5334199,8356734.45,45.46265873064421,43.058325544665195,NaN,NaN,-57.54792346275958,-86.58363875141546,-0.0988264210318911,-0.4565516018196405,-0.3577251807877494,233415424,235637286.2,32.461851886813776,39.22270269573933,NaN,NaN,-13.09556694253701,-6.634374128296985
2005-02-01T09:30:00-05:00,105.02,105.64,104.84,105.39999,4808801,8012519.4,50.34558689217335,43.561468539937174,NaN,NaN,0.3928829651945767,-66.02777881725862,-0.019176632246890868,-0.381695971096363,-0.36251933884947213,238224225,235987845.4,33.08974184052141,38.664897522062915,NaN,NaN,-11.141252376437032,-7.278213878031277
2005-02-02T09:30:00-05:00,105.46001,106.13,105.35001,105.88,4660500,7714084.45,53.90159869366043,43.9906397205101,NaN,NaN,60.837915291728876,-39.244786397142335,0.06568971946353935,-0.28040718952004795,-0.3460969089835873,242884725,235699825,32.819771223555804,37.94223020775325,NaN,NaN,-8.39129108228844,-7.437224907210871
2005-02-03T09:30:00-05:00,105.7,105.95,105.44,105.89999,4829898,7411259.45,54.04918489423567,44.963657890146244,NaN,NaN,61.17306259278775,-8.233295484264447,0.1198697554946343,-0.19625971461529446,-0.31612947010992876,247714623,238064044.4,37.33905168738456,37.630871377547926,NaN,NaN,-6.1206567185067025,-7.24914373739599
2005-02-04T09:30:00-05:00,105.8,107.21001,105.75999,107,6413102,7303469.65,61.376998753246006,46.158910197049686,NaN,NaN,156.4328302954525,44.257753536480834,0.22062714219004026,-0.04034554237237842,-0.2609726845624187,254127725,243273344.4,45.96452720972187,37.808321381436244,NaN,NaN,-1.6728492441507319,-6.452530238360953
2005-02-07T09:30:00-05:00,106.92999,107.27,106.91,107.00999,3710500,7061209.7,61.43714436328553,46.960202832125226,NaN,NaN,181.51952598296452,92.07124342562565,0.2752310574245035,0.08306613721821066,-0.1921649202062928,257838225,248157904.6,52.558874940834066,38.31840084159897,NaN,NaN,1.896889944915129,-5.259755926464369
2005-02-08T09:30:00-05:00,107.06,107.42,106.91,107.25,5046602,7012129.85,62.93069810899513,48.30065120508839,NaN,NaN,176.23858766781646,127.24038436615004,0.3120964752012223,0.19795567379523504,-0.11414080140598723,262884827,253090025,58.116946252473475,39.070491450368465,NaN,NaN,5.3279192322007445,-3.7472309037979246
2005-02-09T09:30:00-05:00,107.42,107.48,106.63,106.74001,7445898,7004714.8,57.80737306751318,49.48128792912228,NaN,NaN,132.03594649595988,141.4799906069962,0.28733662144531386,0.24502997540065508,-0.042306646044658766,255438929,255600865.8,60.64474260444992,40.16557862714302,NaN,NaN,6.856980393857177,-2.2323435755614813
2005-02-10T09:30:00-05:00,107.03,107.7,106.92999,107.5,5224801,6737224.75,62.68296540958196,51.35427948405522,NaN,NaN,144.98816603683008,158.2430112958047,0.30564145223292566,0.33974516924649834,0.03410371701357266,260663730,258190687.2,63.11738211306308,41.60021145291937,NaN,NaN,9.727199094328796,-0.5238374798628704
2005-02-11T09:30:00-05:00,107.42,108.39,107.14,108.09,4726102,6589959.95,65.97053365047749,53.49372925837174,NaN,NaN,153.30013900729716,157.61647303817364,0.33843384014672273,0.4571460171969761,0.11871217705025336,265389832,260443108.6,65.16718068921452,43.5459975870598,NaN,NaN,13.233421264258258,1.441485197868719
2005-02-14T09:30:00-05:00,108.00999,108.12,107.84,107.98,3689300,6475080.05,64.82389096876105,55.05405473885396,NaN,NaN,136.92965605370117,148.69849905232095,0.33314399318311605,0.5351421685291484,0.20199817534603237,261700532,261215570,65.86777384109698,45.816057546982925,NaN,NaN,15.730469194612931,3.4827686259750354
2005-02-15T09:30:00-05:00,108.06,108.61,107.92,108.47,4716000,6380785.15,67.53116887444659,56.69722459849394,NaN,NaN,132.59844339379796,139.97047019751727,0.34179353743477503,0.6292400971395011,0.2874465597047261,266416532,261921911,66.53067163045435,48.23057447019411,NaN,NaN,18.700821468676875,5.656776174932441
2005-02-16T09:30:00-05:00,108.28,108.67999,108.09,108.45,4286000,6263330.05,67.30348033989699,58.42319078816659,NaN,NaN,117.07487956186098,136.97825681069747,0.3254005734903502,0.6941972765676638,0.36879670307731366,262130532,263260231.6,67.80646701359527,50.830072697221404,NaN,NaN,21.041217271372638,7.854553474423897
2005-02-17T09:30:00-05:00,108.46001,108.56,107.67,107.72,5746602,6117425.2,59.42754355152493,59.64648759274583,NaN,NaN,85.9243551262037,125.16549462857219,0.248118601781398,0.6789449553040612,0.4308263535226632,256383930,262404271.6,66.07175314784743,53.396909720073324,NaN,NaN,20.811269653635335,9.70551292859696
2005-02-18T09:30:00-05:00,107.48,107.84,107.2,107.81,4911000,5963855.3,60.04827615221381,60.68831740857223,NaN,NaN,62.18196925904705,106.94186067892217,0.18848880012892416,0.6664373536838184,0.47794855355489424,261294930,261585291.2,64.37477146263633,55.67640397548922,NaN,NaN,20.799125777303644,11.290314764126485
2005-02-22T09:30:00-05:00,107.33,107.67,105.99001,106.00999,8991102,5919495.35,45.16515933024115,60.31828686843422,NaN,NaN,3.4463595821493973,80.24520138461182,0.022003302529789215,0.5054526817171308,0.48344937918734154,252303828,259705950.4,60.53267796228322,57.63661369847221,NaN,NaN,15.621744429262641,11.909090430574507
2005-02-23T09:30:00-05:00,106.35001,106.95,106.19,106.83,6459301,5754835.4,51.110025365501684,60.118888773565736,NaN,NaN,3.4882085485680085,54.42315441556583,-0.03557642468319405,0.438978848333349,0.47455527301654304,258763129,258175269.8,57.52143590742595,59.40101831874865,NaN,NaN,13.31857446616096,12.110445292801144
2005-02-24T09:30:00-05:00,106.58,107.55,106.36,107.41,7124301,5718380.55,54.83942146064656,60.17533424259508,NaN,NaN,26.264466670815466,36.261071837356724,-0.03711349205166942,0.4281634079519563,0.4652769000036257,265887430,258926649.4,58.609894270582565,60.9203642175485,NaN,NaN,12.720290502194839,12.197566037000243
2005-02-25T09:30:00-05:00,107.42999,108.42,107.3,108.36,4989500,5546290.5,60.19532859280501,60.090929231135014,NaN,NaN,81.8996719594882,35.45613520401364,0.020253594423176202,0.49059389303259593,0.4703402986094197,270876930,261825249.4,62.59206022101873,62.10804514692685,NaN,NaN,14.098111860657001,12.469072583236922
2005-02-28T09:30:00-05:00,108.11,108.98,107.25999,107.7,7471500,5529250.45,55.28940820598802,59.65180521989948,NaN,NaN,74.81604998131154,37.98295134846653,0.008740785111304494,0.4812662799985503,0.4725254948872458,263405430,262247349.4,63.14808560679897,62.86441733735291,NaN,NaN,13.512874441960543,12.618187134483154
2005-03-01T09:30:00-05:00,107.75999,108.49001,107.75999,108.23,5323898,5528735.4,58.233190099665556,59.3162689335188,NaN,NaN,83.55625812655151,54.00493105734696,0.030582009959452094,0.5107530073365609,0.48017099737710883,268729328,265532449.4,67.2305124013414,63.515386347986336,NaN,NaN,14.03690596480265,12.820861253100224
2005-03-02T09:30:00-05:00,107.81,108.69,107.74001,108.07001,7641199,5670355.3,57.01288099609361,59.259519499845965,NaN,NaN,77.99651892424777,68.90659313248291,0.028080691702285276,0.5152718620049654,0.48719117030268017,261088129,265997449.4,67.77469472944955,64.02466864262917,NaN,NaN,14.058433954018684,12.997657353231432
2005-03-03T09:30:00-05:00,108.42,108.67,107.64,108.25,8279898,5851325.2,58.07724291464874,58.93053932163645,NaN,NaN,73.71923477066338,78.39754675245248,0.03208579002459788,0.5272984078334275,0.49521261780882964,269368027,266693568.8,68.61495345014137,64.41735230956333,NaN,NaN,14.399610237914153,13.197936336757534
2005-03-04T09:30:00-05:00,108.91,109.61,108.64999,109.53999,6124699,5916065.25,64.80349550332313,58.84717945398257,NaN,NaN,179.12680302798114,97.84297296615107,0.11072350716838364,0.6336170017693092,0.5228934946009256,275492726,267616728,69.74172957619115,64.74410580149024,NaN,NaN,16.94611397217167,13.73339028467384
2005-03-07T09:30:00-05:00,109.39,109.83,109.3,109.33,4130398,5801930.05,63.03064529725439,58.719090477446386,NaN,NaN,184.49097004618253,119.77795697912526,0.1360396041968981,0.6929429998470482,0.5569033956501501,271362328,269208107.6,71.63241424938325,65.15586583065354,NaN,NaN,18.416315422455085,14.402379590071162
2005-03-08T09:30:00-05:00,109.28999,109.52,108.96001,109.16,7533398,5993074.95,61.56231571415087,58.29274382313954,NaN,NaN,141.20183346900387,131.30707204761575,0.12884963770963154,0.7179654427871895,0.589115805077558,263828930,268228028,68.78191133021599,65.3166686663508,NaN,NaN,19.162630507827377,15.082415435464906
2005-03-09T09:30:00-05:00,108.83,109.23,108,108.00999,5061801,5993834.9,52.630378395183286,57.244665112802856,NaN,NaN,49.0881212818932,125.52539251914484,0.03882678717600074,0.6376492890475589,0.5988225018715582,258767129,267763828,67.41359083452966,65.28860608213182,NaN,NaN,16.951971873471436,15.349494926608696
2005-03-10T09:30:00-05:00,108.21001,108.73,107.74001,108.47,5215199,5882299.95,55.41683301037664,56.95818578843512,NaN,NaN,31.90240022504928,117.16202561002201,0.00426425724031787,0.6041528234219555,0.5998885661816377,263982328,266686688.2,64.22100690501875,65.15640992192978,NaN,NaN,16.00585056006756,15.44326001710282
2005-03-11T09:30:00-05:00,108.49001,108.81,107.64999,107.84,3489500,5795534.9,50.992795134193805,56.3113657157194,NaN,NaN,1.14553300195472,81.56577160481673,-0.06329660410114368,0.5207678110552081,0.5840644151563518,260492828,263686708.6,56.23334471157841,64.57487943971135,NaN,NaN,13.794004891914247,15.20765214207588
2005-03-14T09:30:00-05:00,107.95,108.16,107.58,108.14,3475700,5733014.8,52.920217823407306,56.86529846523126,NaN,NaN,-18.109367186649013,41.04570415825042,-0.08850383517853122,0.4734346211831877,0.5619384563617189,263968528,262207948.6,52.75050658193947,64.01901005540108,NaN,NaN,12.577124004495344,14.831862408135803
2005-03-15T09:30:00-05:00,108.39,108.48,107.52,107.57001,3926400,5744869.8,48.97877174929234,56.71306606407346,NaN,NaN,-30.662746824431164,6.672788099563417,-0.14116223782838466,0.3854856590762381,0.5266478969046228,260042128,261450588.2,51.00802783630425,63.553766621749524,NaN,NaN,10.323511023527294,14.187812210334588
2005-03-16T09:30:00-05:00,106.95,107.11,106.19,106.35001,6534199,5835779.75,41.80229377044818,55.78184265763071,NaN,NaN,-168.5549239089735,-36.85582093860994,-0.2494264448854115,0.2148648407978584,0.4642912856832699,253507929,260398748.2,48.606608799315524,62.83924623094474,NaN,NaN,5.894802801338905,13.003096580478061
2005-03-17T09:30:00-05:00,106.56,106.67999,106.03999,106.28999,4476301,5845294.8,41.48028622033011,54.44505391673965,NaN,NaN,-157.64529738202512,-74.76536046002482,-0.312272197252477,0.07395103911767364,0.38622323637015066,249031628,257408608.2,42.48344759097889,61.40291675737046,NaN,NaN,2.317944317402119,11.476646257181498
2005-03-18T09:30:00-05:00,106.38,106.44,105.44,105.96001,10707199,6093324.65,39.67096762844974,53.329451018344066,NaN,NaN,-158.07819709894125,-106.61010648020401,-0.35987254895530424,-0.06361744982397965,0.2962550991313246,238324429,252974928.4,35.368734679216374,59.418677405400274,NaN,NaN,-1.1901229154055093,9.667107803954783
2005-03-21T09:30:00-05:00,106.03999,106.12,105.23,105.42,7323199,6213934.6,36.83905015716402,51.80129816530824,NaN,NaN,-153.90613452867734,-133.76945994860966,-0.40800549137998887,-0.21375176509366156,0.19425372628632734,231001230,246381468.8,27.888754402234966,56.60855183403554,NaN,NaN,-5.048510143750852,7.564876668568264
2005-03-22T09:30:00-05:00,105.53999,106.03,104.5,104.53,7071898,6117974.4,32.69637997172899,50.06440523499648,NaN,NaN,-171.21879177845116,-161.88066893941368,-0.47535466008699284,-0.3999395988224137,0.07541506126457913,223929332,239158909.6,22.320210378842276,53.3618029518493,NaN,NaN,-9.776021638944584,5.087605481780715
2005-03-23T09:30:00-05:00,104.49001,105.55,104.21001,104.41,7418801,6165949.4,32.171072715569096,48.21396450649079,NaN,NaN,-164.02011523744937,-160.97370720510884,-0.500994601870423,-0.5508281910734496,-0.04983358920302662,216510531,231759430,18.29081147899474,49.76722138248169,NaN,NaN,-13.735582808954124,2.398578583104309
2005-03-24T09:30:00-05:00,104.72,105.14999,104.35001,104.44,5058801,6062674.4,32.46320453943939,45.903943723356235,NaN,NaN,-141.41206411229615,-157.72706055116305,-0.48843340253278505,-0.660375342369008,-0.1719419398362229,221569332,226266970.8,15.984159241509929,45.92739493000446,NaN,NaN,-16.861753077064375,-0.3528973683483603
2005-03-28T09:30:00-05:00,104.60001,105.23,104.56,104.75999,4973301,6061864.45,35.64691194968843,43.94796276995867,NaN,NaN,-111.78732340922829,-148.46888581322045,-0.4329672239904486,-0.7131509698242837,-0.2801837458338351,226542633,223910611.6,15.10411640580054,41.88965936974855,NaN,NaN,-18.642524717335064,-2.965701275346461
2005-03-29T09:30:00-05:00,104.61,105.13,103.86,104.07001,7664500,6071514.45,32.12980505436636,41.84564057997407,NaN,NaN,-116.31410605921357,-140.95048011932772,-0.41698377046507434,-0.801413458915178,-0.38442968845010367,218878133,221485992.2,14.235602772689404,37.99349447278236,NaN,NaN,-21.25622376996567,-5.578633060292062
2005-03-30T09:30:00-05:00,104.17999,105.39,104.17999,105.34,5659898,6088314.45,43.232147149295294,41.17433834812492,NaN,NaN,-80.37122616396623,-122.78096699643072,-0.3005541062053064,-0.7601223212067367,-0.4595682150014303,224538031,221607732,14.50143878516461,34.21405504068486,NaN,NaN,-20.15013257404392,-7.660275847970898
2005-03-31T09:30:00-05:00,105.17,105.32001,104.8,104.99001,7392500,6075879.5,41.230470965440624,40.16102677348663,NaN,NaN,-70.45148167431425,-104.0672402838037,-0.22996845384253295,-0.7470287823045965,-0.5170603284620635,217145531,221734732,14.798134789060427,30.68384988954498,NaN,NaN,-19.859113422891838,-9.402966930102462
2005-04-01T09:30:00-05:00,105.42999,105.62,103.74001,104.05,7749801,6049374.65,36.36097453078902,39.1158967303863,NaN,NaN,-85.97551238315536,-92.97992993797556,-0.22894670990638288,-0.8032437158450421,-0.5742970059386592,209395730,219300011.6,13.808809339889905,27.653525934424373,NaN,NaN,-21.167614569664593,-11.083630878611338
2005-04-04T09:30:00-04:00,104.08,104.82001,103.46001,104.22,11559301,6321104.75,37.791889728366606,38.035301866454816,NaN,NaN,-91.59483766763867,-88.94143278965763,-0.20021977672337365,-0.8245717268428763,-0.6243519501195026,220955031,218182491.2,13.367076503107754,24.84042378593639,NaN,NaN,-21.772304128573424,-12.610584200034493
2005-04-05T09:30:00-04:00,104.28999,104.67999,104.14999,104.59,4399500,6334559.85,40.906253826479734,37.458693443396776,NaN,NaN,-73.23891264167312,-80.32639410614954,-0.14241380683063298,-0.8023692086577938,-0.6599554018271608,225354531,219477770.8,16.69348194870814,22.389384793965238,NaN,NaN,-21.330918169869783,-13.856346195725248
2005-04-06T09:30:00-04:00,104.8,105.24001,104.72,105.02,4537000,6184739.95,44.39060531181869,37.64357283920895,NaN,NaN,-44.126994138273545,-73.07754770101101,-0.06525829484221579,-0.7415282703799306,-0.6762699755377148,229891531,220548470.8,19.446846519975693,20.30654463115525,NaN,NaN,-19.90732608099274,-14.720771893620604
2005-04-07T09:30:00-04:00,104.81,105.58,104.75,105.52,3853000,6124299.9,48.21424515936351,38.124569906282765,NaN,NaN,-23.542429321509626,-63.695737230450085,0.02459648915855206,-0.6455243640895247,-0.6701208532480768,233744531,223868270.8,27.453150836587753,19.2329520058416,NaN,NaN,-17.53369212413157,-15.122617640836456
2005-04-08T09:30:00-04:00,105.45,105.53999,104.52,104.53999,3654000,6046239.95,42.103524272514406,38.29832395228738,NaN,NaN,-43.865820474651926,-55.27379884874938,0.02319375357463782,-0.6411286612797795,-0.6643224148544173,230090531,228007231,35.99457597374095,19.277654955450494,NaN,NaN,-17.315928538659517,-15.435947769096893
2005-04-11T09:30:00-04:00,104.78999,104.81,104.38,104.47,3188400,6031184.95,41.69706898899113,38.64532529741789,NaN,NaN,-62.980072946367564,-49.550845904495155,0.022688593555545422,-0.6359616729099855,-0.6586502664655309,226902131,229196651,38.24474115461486,20.0173682949062,NaN,NaN,-17.26306075233165,-15.696963909559
2005-04-12T09:30:00-04:00,104.2,105.3,103.56,104.99001,9172602,6316030.05,45.877602733755346,39.5868412089912,NaN,NaN,-55.63700532872695,-46.03046444190592,0.060373207592774314,-0.583183756974563,-0.6435569645673374,236074733,231340691.4,42.19006377342857,21.43664353737665,NaN,NaN,-15.958107065739636,-15.734270074727663
2005-04-13T09:30:00-04:00,104.92,105.22,103.75,103.98,8180199,6528720,39.894181647121975,40.13849184695927,NaN,NaN,-92.27700696322411,-55.660467006896035,0.02223903766429136,-0.6157581674869732,-0.6379972051512646,227894534,230941292,41.65617948670368,23.105598395070142,NaN,NaN,-16.67425593799468,-15.868553769480094
2005-04-14T09:30:00-04:00,104.10001,104.17,102.39,102.39999,10940602,6749040.15,32.70768125886188,40.15595446977517,NaN,NaN,-253.5939458381051,-101.67077031021513,-0.09784457664000057,-0.7603029259512653,-0.6624583493112647,216953932,227583172.2,37.37386613077281,24.633434601446066,NaN,NaN,-19.860999268022635,-16.438903126414743
2005-04-15T09:30:00-04:00,102.21001,102.60001,100.62,100.7,12191801,7134815.15,27.059604914545133,39.54257539583636,NaN,NaN,-371.1288985305583,-167.1233859213964,-0.27043136928665534,-1.0004975609195839,-0.7300661916329285,204762131,222517492.2,32.02549951194726,25.842104823313687,NaN,NaN,-24.83042468926375,-17.637691921107457
2005-04-18T09:30:00-04:00,100.62,101.00999,100.11,100.55,13005602,7249735.3,26.622753893868733,39.14921459865796,NaN,NaN,-305.7038182580053,-215.66813498372395,-0.36734574357202554,-1.1892483710979604,-0.8219026275259349,191756529,215488371.8,26.38349548987226,26.709811445969603,NaN,NaN,-28.71750495700571,-19.22052235480721
2005-04-19T09:30:00-04:00,101.00999,101.5,100.8,101.25,7636102,7265380.45,32.12937524849875,38.35615946288677,NaN,NaN,-187.82270224633166,-242.10527436724487,-0.3566674309024236,-1.2677369161539644,-0.9110694852515409,199392631,208151951.4,22.022614232735876,27.247038263653263,NaN,NaN,-30.002551444832314,-20.760812224810795
2005-04-20T09:30:00-04:00,101.50999,101.78,99.89,100.14,12035898,7513580.45,28.479591120150857,37.44538233108036,NaN,NaN,-171.63256211542455,-257.97638539768496,-0.3938089355499448,-1.403330654688972,-1.009521719139027,187356733,200044391.2,18.402589610504023,27.504499322327806,NaN,NaN,-32.361989807703644,-22.418123308081203
2005-04-21T09:30:00-04:00,100.95,102.28999,100.67999,102.12,7350602,7510170.5,41.29098990833868,37.79752628661962,NaN,NaN,-96.29191002685644,-226.51597823543526,-0.26088180480091117,-1.335623975140166,-1.0747421703392548,194707335,195595071.8,16.773125723339618,27.71623620685993,NaN,NaN,-29.617781887245126,-23.446645962247477
2005-04-22T09:30:00-04:00,101.89999,102.16,100.62,101.83,6176199,7566040.4,40.15640023492882,37.96641989423121,NaN,NaN,-89.5770811722889,-170.20561476378137,-0.17259870246983366,-1.290490548426547,-1.1178918459567133,188531136,192348872.8,15.682097023624095,27.88159481546824,NaN,NaN,-27.934777276903382,-24.08780757862689
2005-04-25T09:30:00-04:00,102.05,102.58,101.88,102.39999,4631898,7548970.25,43.44569735779439,38.147808717896545,NaN,NaN,-49.56947669716692,-118.97874645161369,-0.06164961829506943,-1.19495386882555,-1.1333042505304807,193163034,192630173.8,16.190835405285327,27.845691490938037,NaN,NaN,-25.4728765469817,-24.28567457410615
2005-04-26T09:30:00-04:00,102.06,102.62,101.42999,101.50999,6077699,7469630.2,39.76993264276146,37.817760670106736,NaN,NaN,-61.38034556070859,-93.69027511448908,-0.03534270918743654,-1.1774826370147764,-1.1421399278273399,187085335,190168714.6,15.319803713138938,27.550902719021128,NaN,NaN,-24.66162178089601,-24.339381317933274
2005-04-27T09:30:00-04:00,101.11,102.17,100.74001,101.89999,10439102,7708590.4,42.08237522799114,37.379769960723,NaN,NaN,-64.86959919139338,-72.33768252968285,0.018300235603939008,-1.119264633322416,-1.137564868926355,197524437,192202255.4,19.187804358450478,26.960520827725606,NaN,NaN,-23.26603813102225,-24.186046576945984
2005-04-28T09:30:00-04:00,101.64,101.83,100.52,100.52,7085000,7693215.4,36.71138464908526,36.994617130478055,NaN,NaN,-83.86306118856442,-69.85191276202447,-0.02673351055117834,-1.170981757115328,-1.1442482465641497,190439437,191348675.8,18.79962740779034,25.73231021587199,NaN,NaN,-23.842947098384506,-24.137032365722916
2005-04-29T09:30:00-04:00,101.31,101.98,100.44,101.88,10207801,7816115.4,44.261553416527704,37.17779458958781,NaN,NaN,-57.65126837111574,-63.46675020178984,0.0436655402437538,-1.0896663212594575,-1.1333318615032113,200647238,193771896.2,23.529320744463163,24.68120875800401,NaN,NaN,-21.718869672712405,-23.7915805524357
2005-05-02T09:30:00-04:00,102.24001,102.60001,101.86,102.58,5349199,7505610.3,47.71872586617336,37.30930338476053,NaN,NaN,-14.775665810443112,-56.50798802444508,0.1405060165719898,-0.9576993407882242,-1.098205357360214,205996437,196338576.8,28.293592447138934,23.688603663269042,NaN,NaN,-18.837145250221898,-23.08380408069087
2005-05-03T09:30:00-04:00,102.32001,103.08,102.05,102.89,7119199,7641595.25,49.220830256567034,37.975492571149466,NaN,NaN,4.4351356368523644,-43.3448917849329,0.2236337978564389,-0.8186631100396653,-1.0422969078961042,213115636,201544637,36.88311755799817,23.347670668361502,NaN,NaN,-16.071817074075046,-22.082091651174323
2005-05-04T09:30:00-04:00,103.00999,103.92999,102.67,103.77,8805301,7855010.3,53.320820538764806,39.4478596625711,NaN,NaN,49.88621283067654,-20.39372938051891,0.3296753936036927,-0.6302026658914883,-0.959878059495181,221920937,206423937,43.69113949032161,23.798904479757844,NaN,NaN,-12.42026506583681,-20.701830710411823
2005-05-05T09:30:00-04:00,103.81,104.08,102.99001,103.5,8842602,8104490.4,51.935260586851115,41.224692210592956,NaN,NaN,63.258423370125314,9.030567531219038,0.3703783383685725,-0.49690513653446544,-0.8672834749030379,213078335,210951716.6,49.17020172523067,25.023526066420946,NaN,NaN,-9.901635315470399,-19.15894565399162
2005-05-06T09:30:00-04:00,103.92,104.05,103.39999,103.42999,5384500,8191015.4,51.56112255368642,43.00600425772279,NaN,NaN,77.67894323402174,36.09660985224654,0.3799132943286321,-0.39239185699224777,-0.7723051513208798,207693835,212361036,50.775728767646385,26.765828443404814,NaN,NaN,-7.981069602525113,-17.562106218067832
2005-05-09T09:30:00-04:00,103.46001,103.88,103.21001,103.75,3914600,8227325.4,53.2200133323177,44.512478406567006,NaN,NaN,83.77908733694589,55.80756048172434,0.39343718657876336,-0.2805086680974256,-0.673945854676189,211608435,213483435.6,52.07408075422673,28.912361766368445,NaN,NaN,-5.902967518053619,-15.896514975208659
2005-05-10T09:30:00-04:00,103.36,103.49001,102.5,102.7,6965398,8116965.2,47.474904555233785,45.86928650907293,NaN,NaN,47.2951146016116,64.37955627467618,0.32042476149882604,-0.27341490280265646,-0.5938396643014825,204643037,211788915.8,49.93275609783853,31.164516515463767,NaN,NaN,-5.721078413802422,-14.442881180722054
2005-05-11T09:30:00-04:00,102.99001,103.25,100.60001,103.02,7705500,8093230.25,49.272180791055476,46.439371572124124,NaN,NaN,13.2393531806165,57.050184344664174,0.28370036775694296,-0.23921420460530385,-0.5229145723622468,212348537,209874435.8,47.55354658641564,33.36311800568348,NaN,NaN,-5.055653227015036,-13.101848615906766
2005-05-12T09:30:00-04:00,103.02,103.34,101.92999,101.92999,5567699,7824585.1,43.7772565337603,46.698004164897796,NaN,NaN,25.05207016148979,49.40891370293706,0.18101560776155468,-0.29664506266030344,-0.4776606704218581,206780838,208614936.4,46.00064862706206,35.528728834500484,NaN,NaN,-6.1138943175978655,-12.103569430434066
2005-05-13T09:30:00-04:00,102.23,102.47,100.86,101.67,11754602,7802725.15,42.55811765359586,46.6346056145979,NaN,NaN,-36.90440032919966,26.492244990292782,0.09492843899673986,-0.3590001216759333,-0.4539285606726732,195026236,206081416.6,42.96150964128089,37.44091985135731,NaN,NaN,-7.341791863872774,-11.42331549235388
2005-05-16T09:30:00-04:00,101.62,102.71001,101.59,102.64,5840500,7444470.05,48.33867788154996,47.24665884593994,NaN,NaN,10.607671907364178,11.857961904376447,0.10203587770999512,-0.32638371353517925,-0.42841959124517437,200866736,203933076.8,40.517023951400944,39.240721296947456,NaN,NaN,-6.702250626208639,-10.748877654333132
2005-05-17T09:30:00-04:00,102.37,103.55,102.28,103.49001,5974000,7361364.95,52.81934063924068,48.013584946743485,NaN,NaN,77.21576318708757,17.84209162147164,0.15929326534258115,-0.22930300956694794,-0.3885962749095291,206840736,204372616.6,41.25351884287795,40.81684376012084,NaN,NaN,-4.778136603766829,-9.895914647109375
2005-05-18T09:30:00-04:00,103.92,105.06,103.86,104.84,8503699,7184755,58.914151114472595,49.59949683712829,NaN,NaN,185.1686684190837,52.22795466916508,0.2765266365009193,-0.042937979283379946,-0.31946461578429924,215344435,204971796.2,42.302286174653645,42.49560510061108,NaN,NaN,-1.0818650099502676,-8.63676469894379
2005-05-19T09:30:00-04:00,104.96001,105.2,104.59,105.14,5084801,7071464.95,60.14623682760831,50.734117080776905,NaN,NaN,180.9716126681964,83.4118631705064,0.35756805619814797,0.12749545446338573,-0.23007260173476224,220429236,207701475.8,46.94884535031343,44.168428286743236,NaN,NaN,2.280118620589945,-7.077209939010399
2005-05-20T09:30:00-04:00,104.83,104.85001,104.12,104.63,6350000,7080155,57.01598762581969,51.39820720646593,NaN,NaN,127.08068607976334,116.20888045229901,0.3591694591180733,0.21888922216282936,-0.14028023695524391,214079236,211512075.8,52.67813868066649,45.91018158913806,NaN,NaN,4.135566670369548,-5.475384709098979
2005-05-23T09:30:00-04:00,104.63,105.5,104.63,105.22,5311102,7114115.2,59.633326379604185,52.141956929540015,NaN,NaN,144.50439485076595,142.98822504097936,0.3802762606932065,0.3350650889112643,-0.045211171781942255,219390338,215216796.2,57.48533377870858,47.38176846204595,NaN,NaN,6.490942931668429,-3.7659093318464922
2005-05-24T09:30:00-04:00,104.92,105.13,104.63,104.83,5150699,7067765.2,57.15584219771091,52.41588704803616,NaN,NaN,112.96087395989629,150.1372471955411,0.3490941777857292,0.39115655045021924,0.04206237266449005,214239639,216696576.8,59.2653363917799,48.4942110978644,NaN,NaN,7.725686919954519,-2.1242527244463476
2005-05-25T09:30:00-04:00,104.71001,104.71001,104.16,104.59,5066301,6799125.15,55.624338559341766,52.67939261749978,NaN,NaN,80.08608054301075,129.12072962032653,0.2955500447275305,0.41149992857390316,0.11594988384637267,209173338,215462357.4,57.117358995748404,49.06186518861567,NaN,NaN,8.313378701688238,-0.6331625207128353
2005-05-26T09:30:00-04:00,104.99001,105.35001,104.84,105.27,4763000,6683025.15,58.978266786214334,53.20918863410891,NaN,NaN,113.89322528620305,115.70505214392786,0.28883531616883995,0.4769940290574226,0.18815871288858266,213936338,214163777.8,54.86426450617599,49.353903455653494,NaN,NaN,9.790490397712631,0.8559307533479454
2005-05-27T09:30:00-04:00,105.3,105.44,105.07001,105.37,2107900,6278030.1,59.46347838670725,53.65515042370817,NaN,NaN,111.58919499262925,112.60675392650103,0.2741517891555622,0.5308484493330354,0.2566966601774732,216044238,214556778.2,55.43718323700916,49.59412506156652,NaN,NaN,11.14149221342496,2.3252966762160905
2005-05-31T09:30:00-04:00,105.32001,105.35001,104.57001,104.63,5593500,6290245.15,54.34120410216784,54.14560039134632,NaN,NaN,72.50595775066141,98.20706650648012,0.20101162341209872,0.5079611894425966,0.3069495660304979,210450738,212768858.2,52.1914583670315,49.75546093793746,NaN,NaN,10.882392099794927,3.5477388795844957
2005-06-01T09:30:00-04:00,104.64,105.83,104.61,105.33,7954102,6331990.3,58.02467771368215,54.77077874296251,NaN,NaN,89.41251902708612,93.4973955199181,0.18650538709972475,0.5400812999051539,0.3535759128054291,218404840,213601898.4,53.55586550308128,50.18419800341358,NaN,NaN,11.716766745053038,4.714742860365716
2005-06-02T09:30:00-04:00,105.11,105.56,105.03999,105.47,3466500,6065050.25,58.74158067314579,55.83965903863291,NaN,NaN,86.23543537467611,94.72726648625118,0.17334722746345194,0.570259947134744,0.3969127196712921,221871340,216141498.8,57.53470769430219,51.008059365359294,NaN,NaN,12.60564596186169,5.842014732007998
2005-06-03T09:30:00-04:00,105.27,105.44,104.38,104.72,5010699,5873455.1,53.47272213778436,56.61927364464636,NaN,NaN,49.464313405774774,81.84148411016551,0.1045309744484823,0.527576437731895,0.4230454632834127,216860641,216726359.4,58.418196048064424,52.11210839441526,NaN,NaN,11.87431207878519,6.703771495833311
2005-06-06T09:30:00-04:00,104.66,104.99001,104.25,104.63,3762800,5792370.1,52.859999405907786,56.9422251821005,NaN,NaN,32.516566382102944,66.02695838806025,0.04631817936115323,0.4809431874848542,0.434625008123701,213097841,216137080,57.12854141029994,53.29864535576519,NaN,NaN,11.10070485929668,7.331904833470935
2005-06-07T09:30:00-04:00,104.89,105.74001,104.78999,104.88,6884398,5940860,54.42230587703438,57.05672269908576,NaN,NaN,60.526726552273324,63.631112148382634,0.01939547438835404,0.4588693511091435,0.43947387672078947,219982239,218043380.2,60.19028664391941,54.65127162726815,NaN,NaN,10.861952667736706,7.8361973812231875
2005-06-08T09:30:00-04:00,105.27,105.41,104.57001,104.8,6071000,5896140.1,53.80775732331863,56.69198028543191,NaN,NaN,43.9542725314848,54.53946284926237,-0.00760791087737378,0.4299639881240722,0.437571899001446,213911239,217144660,58.08419783702565,55.77855103172329,NaN,NaN,10.499763514369036,8.216706828815452
2005-06-09T09:30:00-04:00,104.72,105.24001,104.38,104.98,4067400,5714235.1,55.0380035743086,56.32710648162479,NaN,NaN,36.542464108718576,44.60086859607087,-0.01663637035065202,0.416776436063131,0.433412806413783,217978639,216366119.8,56.2480855517631,56.44278247468399,NaN,NaN,10.502581511400063,8.543260354898967
2005-06-10T09:30:00-04:00,105.14,105.38,104.48,105.17,5116000,5691650.15,56.35924161838536,56.280196052522335,NaN,NaN,46.36430300796193,43.9808665165083,-0.01324911351359681,0.416851414521787,0.4301005280353838,223094639,217612919.4,58.5100434433419,56.859347100589375,NaN,NaN,10.838983351820143,8.871220783030564
2005-06-13T09:30:00-04:00,104.96001,105.94,104.75999,105.34,4819602,5344900.15,57.56090170245842,56.13216571844049,NaN,NaN,86.28912197515238,54.73537763511818,-0.003503647692834011,0.42572096841934126,0.4292246161121753,227914241,220576199.4,63.35867657681414,57.27887158616834,NaN,NaN,11.431454977592576,9.236968525110852
2005-06-14T09:30:00-04:00,105.28,105.91,105.19,105.57001,4230500,5264400.15,59.19792215818637,56.278028572760164,NaN,NaN,134.1990295497431,69.46983823461217,0.013553830445520165,0.44616690416907545,0.4326130737235553,232144741,223008699.8,66.78963107779862,57.81632120659825,NaN,NaN,12.361942084301711,9.683393319280974
2005-06-15T09:30:00-04:00,105.87,105.92,104.99001,105.74001,6120500,5271725.15,60.4133348380825,56.62009973552737,NaN,NaN,135.91808961879568,87.86260165207435,0.03043956513019158,0.4706625301362948,0.4402229650061032,238265241,227879500.2,72.36886561668851,58.9057145366654,NaN,NaN,13.476322447249556,10.2252403375622
2005-06-16T09:30:00-04:00,105.7,106.02,105.46001,105.78,6817801,5187430.25,60.70982657527132,56.743782577602865,NaN,NaN,163.31592812424998,113.21729445518062,0.037966163831649635,0.48768066979566527,0.44971450596401563,245083042,233300380.8,76.99996061848861,60.486835687544875,NaN,NaN,14.505479598733595,10.836703089158114
2005-06-17T09:30:00-04:00,106.21001,106.50999,105.89,106.03999,7460398,5306210.1,62.667501836019525,56.97264139541088,NaN,NaN,210.1648258077756,145.97739901514336,0.05318543414714022,0.5161962986479409,0.4630108645008007,252543440,239190141,80.7709496298419,62.296390429890074,NaN,NaN,15.908852781029953,11.561295902282662
2005-06-20T09:30:00-04:00,105.67999,106.27,105.53999,105.96001,3985700,5187995.1,61.64985242086168,57.49468770388901,NaN,NaN,143.11037682309225,157.34164998473133,0.050611191169060765,0.5262748534621267,0.4756636622930659,248557740,243318840.8,82.88885319413389,64.48906148896882,NaN,NaN,16.882137948969277,12.321416194666464
2005-06-21T09:30:00-04:00,105.98,106.2,105.69,106,3868200,5115850,61.98227963084437,57.77737355511488,NaN,NaN,129.63141209408641,156.4281264936,0.044560116832820795,0.5313638083340919,0.4868036915012711,252425940,247375080.6,84.67472993044065,66.71183751949448,NaN,NaN,17.80477012994351,13.104752471134614
2005-06-22T09:30:00-04:00,106.21001,106.33,105.67,106.02,3443200,5030475.05,62.15894686686314,58.021471140380406,NaN,NaN,120.9831318719408,153.44113494422902,0.03526976265474768,0.5308908948197057,0.49562113216495807,255869140,250895860.4,86.03696516519466,68.74771305312966,NaN,NaN,18.647886923027958,13.896628821405091
2005-06-23T09:30:00-04:00,105.78999,105.87,103.89999,104.05,12883500,5421335,41.63536263875419,57.17594546187825,NaN,NaN,-122.34332258074585,96.30928480322984,-0.10264143157588856,0.36731934269509736,0.4699607742709859,242985640,250476380,85.0667649143646,70.65118225786539,NaN,NaN,13.095149949603607,13.782131839719165
2005-06-24T09:30:00-04:00,103.99001,104.02,102.78,102.86,10112199,5688794.95,34.27369918238499,55.84835258876948,NaN,NaN,-275.442926363275,-0.8122656309802665,-0.26392842550013607,0.14005024239581587,0.40397866789595194,232873441,246542380.2,76.36912438703229,72.02550961334626,NaN,NaN,5.3079922516841735,12.571540469999881
2005-06-27T09:30:00-04:00,102.84,103.25999,102.44,102.95,9059699,6036384.9,35.20678877156193,54.4758156526643,NaN,NaN,-245.75526863261993,-78.58539472212271,-0.34912383111664813,-0.0324261209998582,0.31669771011678993,241933140,245217460.2,73.63835138702531,72.98608566642525,NaN,NaN,-0.4296889306184787,10.714221984197259
2005-06-28T09:30:00-04:00,103.17999,104,103.17,103.98,6487699,6081094.85,44.8554328147318,53.836363902050955,NaN,NaN,-132.87640923804142,-131.08695898854828,-0.3213760915595615,-0.08502240433266195,0.23635368722689953,248420839,244416440,71.96296367675994,73.97742608354913,NaN,NaN,-2.2089878003828707,8.868049157828668
2005-06-29T09:30:00-04:00,104.23,104.25,103.55,103.60001,5146000,5940689.75,42.349852607893084,52.930067404449844,NaN,NaN,-108.0726929315507,-176.89812394924658,-0.31354214572442407,-0.15557399492863055,0.15796815079579352,243274839,241897579.8,66.81505451455018,74.73220958089107,NaN,NaN,-4.4853403488089105,6.960422085451872
2005-06-30T09:30:00-04:00,103.94,104.07001,102.56,102.75,9980199,6266374.7,37.32697491044168,51.57061978245387,NaN,NaN,-144.00052081408393,-181.22956359591421,-0.3478814007600118,-0.2768836001542212,0.07099780060579057,233294640,239959379.8,63.07597244775575,75.05834736692063,NaN,NaN,-8.188528941825428,4.796286224412258
2005-07-01T09:30:00-04:00,103.07001,103.45,102.83,103.12,6489602,6340319.85,40.62797066801765,50.361124708565235,NaN,NaN,-120.73561048324517,-150.28810041990823,-0.32820280046309647,-0.33925569997308,-0.01105289950998356,239784242,241341540,64.5974639165692,75.14683217690313,NaN,NaN,-10.05058111429324,2.6753051760257582
2005-07-05T09:30:00-04:00,102.85001,103.87,102.8,103.63,4748301,6389594.9,44.93330107659865,49.34222320273754,NaN,NaN,-87.21886839598426,-118.58082037258109,-0.2660159261831102,-0.3435728072388713,-0.07755688105576111,244532543,241861420.6,65.17867733262317,75.03176405224774,NaN,NaN,-10.157615660601262,0.8420307707933268
2005-07-06T09:30:00-04:00,103.63,103.85001,102.61,102.67,8958199,6493284.95,39.17471134301816,47.8251786673758,NaN,NaN,-99.36392939416585,-111.87832440380598,-0.27365128970805735,-0.4196209931908328,-0.14596970348277544,235574344,239292121.6,59.94119719575271,74.14407345075233,NaN,NaN,-12.229356107729078,-1.025310211852731
2005-07-07T09:30:00-04:00,101.75,103.2,101.73,103.14,13604699,6869969.9,43.02458617159972,46.56194720997069,NaN,NaN,-105.63202587534107,-111.39019099256407,-0.2327666549323124,-0.43692802214816595,-0.20416136721585354,249179043,240472962.4,61.47347689832606,73.03503889931214,NaN,NaN,-12.60933107258986,-2.680170334815178
2005-07-08T09:30:00-04:00,103.22,104.63,103.06,104.56,8893699,7111284.85,52.75429668729896,45.853861127919224,NaN,NaN,-21.485851853144116,-86.88725720037611,-0.10245656240664952,-0.33223207022416545,-0.22977550781751593,258072742,245428582.8,67.1520555518041,72.06226075088087,NaN,NaN,-9.388524861214046,-3.638506695729302
2005-07-11T09:30:00-04:00,104.63,105.38,104.63,105.24001,6850102,7197989.95,56.57840222296539,45.491614685212355,NaN,NaN,36.831506893418315,-55.37383372504339,0.03008169038236716,-0.19217339483955698,-0.22225508522192414,264922844,250456303.2,71.70820625649654,71.2636431124782,NaN,NaN,-5.4144820350453715,-3.892217458488741
2005-07-12T09:30:00-04:00,105.19,105.49001,104.85001,105.10001,6653000,7289659.85,55.58095263189004,45.0343770424299,NaN,NaN,41.48285789118582,-29.633488467609375,0.10466895187312833,-0.09141889538051373,-0.19608784725364206,258269844,253203763.4,73.84330391881977,70.48996982593385,NaN,NaN,-2.6861951886982838,-3.7199285628043897
2005-07-13T09:30:00-04:00,105.31,105.66,105.14999,105.63,6558398,7406054.75,58.55940451347966,44.777266874331076,NaN,NaN,61.57690068891289,2.5546775490063665,0.18154230208598837,0.030840030353843417,-0.15070227173214495,264828242,259054543,77.70237577967148,69.89464201268221,NaN,NaN,0.5420664179434562,-3.111072136983269
2005-07-14T09:30:00-04:00,106.07001,106.57001,106.03999,106.42,10992898,7649674.65,62.58651555503005,46.27377779692221,NaN,NaN,106.56946880607028,44.99497648528864,0.27199815951615974,0.18929542766305474,-0.08270273185310502,275821140,264382962.4,80.52099321530511,69.56994403417795,NaN,NaN,4.633091199204655,-2.0047630889564223
2005-07-15T09:30:00-04:00,106.35001,106.46001,105.91,106.28999,4917699,7554669.55,61.526855202350376,48.22043179834831,NaN,NaN,96.25894061713278,68.54393497934402,0.30689259610153485,0.3009130132738136,-0.0059795828277212915,270903441,266949102.2,81.71947853107798,69.95211218732408,NaN,NaN,7.535894228907545,-0.641812043547284
2005-07-18T09:30:00-04:00,106.05,106.25,105.66,105.92,6085398,7485919.55,58.491718843865954,49.88364108922716,NaN,NaN,82.02370454116236,77.58237450889283,0.28911855321140445,0.3554186086865343,0.06630005547512982,264818043,266928142,81.67527506674449,70.52617816444688,NaN,NaN,9.017137587384804,0.7380379037287286
2005-07-19T09:30:00-04:00,106.45,106.59,106.11,106.5,4089500,7491109.55,61.682746393236116,51.08559205912032,NaN,NaN,104.3819180865208,90.16218654795982,0.2992318552272497,0.440339874509192,0.14110801928194225,268907543,269055681.8,82.69830052015004,71.29298793897473,NaN,NaN,11.264855000259889,2.2418689175188944
2005-07-20T09:30:00-04:00,105.86,106.89,105.75,106.69,5895801,7592489.6,62.69450952285517,52.53878183876047,NaN,NaN,103.39079179681214,98.52496476953968,0.3007233499440659,0.5170122067120246,0.21628885676795873,274803344,271050702.2,83.62166478250256,72.49346010097133,NaN,NaN,13.401594609515824,3.836115444947027
2005-07-21T09:30:00-04:00,106.91,106.99001,106.02,106.19,8764500,7858554.6,58.3296064095913,54.03896980298544,NaN,NaN,98.39160115960507,96.88939124024662,0.25201307888159025,0.5313052053699465,0.2792921264883563,266038844,269094243,79.15998751705345,73.64231832020688,NaN,NaN,13.944698014006022,5.280198669098312
2005-07-22T09:30:00-04:00,106.31,106.55,105.82001,106.48,5838398,7506299.5,60.066200846146174,55.42741481570891,NaN,NaN,82.14770627381601,94.06714437158328,0.22423235212965076,0.5595825666504197,0.33535021452076896,271877242,269289003.2,79.27851371282412,74.69096473422509,NaN,NaN,14.901941370852912,6.654733340777541
2005-07-25T09:30:00-04:00,106.52,106.85001,105.86,106.13,5809500,7291164.55,56.979839614254594,56.287881854112904,NaN,NaN,74.57690984001647,92.5777854313541,0.16967179414938605,0.5474399572075015,0.37776816305811545,266067742,269538943,79.44011947683997,75.70963917309771,NaN,NaN,14.82756867716305,7.8222812459754705
2005-07-26T09:30:00-04:00,106.02,106.2,105.64,105.82001,5627898,7119574.5,54.31774991166013,57.36952746615875,NaN,NaN,49.932778149822916,81.68795744401453,0.10335293976250359,0.5069593377612449,0.4036063979987413,260439844,267845403.2,75.16268931390529,76.79688861010861,NaN,NaN,14.00559000835719,8.705611069172859
2005-07-27T09:30:00-04:00,106.09,106.46001,105.74001,106.35001,7168500,7153614.55,57.93620191219331,58.43464287620115,NaN,NaN,60.92323000505385,73.19444508566286,0.08651139409202113,0.5117456406137677,0.4252342465217466,267608344,266406403.2,71.63323415805218,77.5225855572319,NaN,NaN,14.324701937134115,9.508338336024467
2005-07-28T09:30:00-04:00,106.62,107.13,106.33,107.07001,6657602,7229194.65,62.3044448442164,59.11679631598097,NaN,NaN,89.76639305194892,71.46940346413164,0.11349230780236336,0.5670996312747008,0.4536073234723374,274265946,268051823.6,73.18384437675141,77.95342761615673,NaN,NaN,15.920539167894265,10.42436702629158
2005-07-29T09:30:00-04:00,107.02,107.16,106.39,106.63,5555500,7007959.7,58.31860229264313,59.24109632095794,NaN,NaN,78.80815546822869,70.80149330301417,0.0922381058582028,0.5689049557950909,0.4766668499368881,268710446,267418464.4,71.56227751300608,77.94300413447884,NaN,NaN,16.08137070991252,11.232510409666
2005-08-01T09:30:00-04:00,106.72,106.72,106.10001,106.19,4705301,6918744.65,54.55980641028304,59.16815730512888,NaN,NaN,51.727566429959644,66.23162462100281,0.04165565715362807,0.5287364213789232,0.4870807642252951,264005145,267005945,70.46709875829823,77.70184662301301,NaN,NaN,15.089870596333462,11.78356186490421
2005-08-02T09:30:00-04:00,106.47,107,106.36,106.71001,4396000,6901129.6,58.00477488152084,59.12854090284611,NaN,NaN,72.87109788453581,70.81928856794539,0.03651310087968945,0.532722140324907,0.4962090394452175,268401145,268598205.2,72.23345021462868,77.31120908265281,NaN,NaN,15.270258323301778,12.281661358961005
2005-08-03T09:30:00-04:00,106.53,107.03999,106.37,107,3294000,6617919.65,59.833567051960046,58.9319017240554,NaN,NaN,83.45005471792764,75.32465351052016,0.045358410387735915,0.5529070524298874,0.5075486420421514,271695145,269415565.4,73.12213928108628,76.78271951592289,NaN,NaN,15.9594001468186,12.807052614369233
2005-08-04T09:30:00-04:00,106.64999,106.73,106.00999,106.12,5165602,6195964.8,52.37924716437717,58.278501149914455,NaN,NaN,26.135601378782948,62.59849517588695,-0.012262052045024507,0.4922210769858708,0.5044831290308953,266529543,267868284.8,68.64329156780788,75.8487061614036,NaN,NaN,14.250463292244383,13.013254139779969
2005-08-05T09:30:00-04:00,105.94,106.09,105.53999,105.64999,7195398,6111049.75,48.87677431918856,57.59171939815178,NaN,NaN,-73.89826475685994,32.057211130869234,-0.08232886113470989,0.40157205261250795,0.48390091374721783,259334145,265993024.6,63.561805146588895,74.55488688139249,NaN,NaN,11.717759895373527,12.828183533436192
2005-08-08T09:30:00-04:00,105.94,106.05,105.25,105.53999,6558898,6096489.55,48.066690392527086,56.61914396952971,NaN,NaN,-115.34108249472376,-1.3565186540674574,-0.1333611399918121,0.31719948875745274,0.45056062874926484,252775247,263747045,58.0217691107747,72.79227749500853,NaN,NaN,9.428300629347678,12.34248597570926
2005-08-09T09:30:00-04:00,105.87,106.42999,105.82001,106.27,5434898,6035584.45,53.566862919194534,55.96716921212538,NaN,NaN,-19.55386521974893,-19.841511274924407,-0.11587631487702155,0.30571523515298793,0.4215915500300095,258210145,261708845,53.46737215951902,70.63839945050971,NaN,NaN,9.07423526654084,11.87559301725663
2005-08-10T09:30:00-04:00,106.73,107.33,105.78999,106.24001,8486898,6132009.45,53.317042058937034,55.609128901364365,NaN,NaN,41.53358175075919,-28.224805868358107,-0.10460019875482168,0.29084130158648236,0.39544150034130404,249723247,257314465.4,45.22497230479693,68.21446979249139,NaN,NaN,8.717199832521418,11.424393990865886
2005-08-11T09:30:00-04:00,106.13,107,106.03999,106.87,5901801,5877454.6,57.7722901112686,55.44527813458739,NaN,NaN,83.21254082295026,-16.809417979524635,-0.0554499070087201,0.3261291165804039,0.381579023589124,255625048,255133566.4,41.78241597856002,65.53617709718681,NaN,NaN,9.731657263873801,11.182574458438445
2005-08-12T09:30:00-04:00,106.64999,106.67999,105.8,106.00999,5364602,5899799.75,50.66396580722449,54.994144291228096,NaN,NaN,-39.27824382660217,-9.88541379347308,-0.08009929277049971,0.28145490762599934,0.36155420039649905,250260446,253318826.6,39.11431669007879,62.65576261241815,NaN,NaN,8.408191440890809,10.786234027360212
2005-08-15T09:30:00-04:00,106.06,106.7,105.73,106.62,4771699,5834114.8,54.902522864816035,55.03591378788209,NaN,NaN,3.9963702819383986,13.98207676185935,-0.05571692046816118,0.2919080498112976,0.34762497027945877,255032145,253770206.2,40.13824634355604,60.15401668596463,NaN,NaN,8.623479467485447,10.477269090235247
2005-08-16T09:30:00-04:00,106.24001,106.39999,105.23,105.39999,6925898,5975934.7,46.329690764197544,54.206877277310966,NaN,NaN,-154.45466967227821,-12.998084128646507,-0.11854116736778092,0.1994485110697326,0.3179896784375135,248106247,251749426.6,37.12789639456622,57.689349702858486,NaN,NaN,5.881165663370518,9.820682886397428
2005-08-17T09:30:00-04:00,105.39,106.11,105.28,105.67999,7505199,6056404.6,48.32403417778019,53.20827651542267,NaN,NaN,-129.31573322411538,-47.16794712362142,-0.13673416967362784,0.1470719663454787,0.28380613601910654,255611446,252927066.4,39.95420387003818,55.31580395237897,NaN,NaN,4.352056658761561,9.039450568163733
2005-08-18T09:30:00-04:00,105.47,106.17,105.37,105.75999,6737801,5955069.65,48.90819673379396,52.536104689790584,NaN,NaN,-97.84179591973363,-83.3788144721582,-0.13845135320795884,0.11074194450915797,0.24919329771711682,262349247,254271906.2,43.099903015345646,53.28277720254608,NaN,NaN,3.321672644424667,8.222625150486724
2005-08-19T09:30:00-04:00,105.87,106.2,105.52,105.73,4033700,5864834.75,48.68600881088917,52.1165477184053,NaN,NaN,-77.91609211358607,-91.10638412955498,-0.13645554133110244,0.07862387105323876,0.2150794123843412,258315547,255882926.4,46.702040426900105,51.58527303601765,NaN,NaN,2.4295399485423577,7.3950415502089575
2005-08-22T09:30:00-04:00,105.87,106.38,105.17,105.66,6955898,5922154.65,48.13631869237209,51.41165799060896,NaN,NaN,-84.06012429096906,-108.71768304413646,-0.13447945456822485,0.04698009417406013,0.18145954874228498,251359649,255148427.2,45.29416398488735,49.66103830532184,NaN,NaN,1.5430229093587757,6.55903888723036
2005-08-23T09:30:00-04:00,105.64,105.73,104.91,105.28,7005500,5991034.75,45.15576338350296,50.36324344286203,NaN,NaN,-146.57791398197625,-107.14233190607608,-0.1520962907621902,-0.008660814710452769,0.14343547605173743,244354149,254398007.6,43.84005388554462,47.56946077706886,NaN,NaN,-0.06003199966327937,5.61345733195984
2005-08-24T09:30:00-04:00,104.99001,105.55,104.16,104.17999,9087301,6086974.8,37.849685370494036,49.3254176004418,NaN,NaN,-206.42272430716156,-122.56373012268531,-0.22667278573659544,-0.13990550611900687,0.08676727961758857,235266848,250329088,36.9191024735507,45.303447270336214,NaN,NaN,-3.846145382420838,4.262085515619743
2005-08-25T09:30:00-04:00,104.34,104.59,104.2,104.46001,5455000,6026844.7,40.489316004270925,48.72631343509054,NaN,NaN,-200.52161917491355,-143.0996947737213,-0.2444541445160545,-0.21880040102747955,0.025653743488574937,240721848,246003608.2,31.267983416200607,42.99674571816562,NaN,NaN,-6.19041300658091,2.76887144101965
2005-08-26T09:30:00-04:00,104.36,104.39,103.78999,103.89999,5546699,6026404.65,37.095987292719826,47.94269178510431,NaN,NaN,-215.2737748118134,-170.57123131336678,-0.27875751389369663,-0.3227931488785458,-0.04403563498484922,235175149,241375528.6,26.57996836465216,40.75090280772829,NaN,NaN,-9.256519873706894,1.0509583960587152
2005-08-29T09:30:00-04:00,103.5,104.81,103.45,104.64,6548000,6118539.6,43.798699760769814,47.244965845216825,NaN,NaN,-155.6811778105423,-184.89544201728143,-0.2380180978694415,-0.3415582573216511,-0.10354015945220961,241723149,239448228.6,24.90535321904352,38.71075859769433,NaN,NaN,-9.836782872803525,-0.5044332137787475
2005-08-30T09:30:00-04:00,104.33,104.33,103.45,104,8570602,6327269.7,39.844424759682006,46.28263603812718,NaN,NaN,-160.50578134538708,-187.6810154899636,-0.23990546813615676,-0.4034219946224056,-0.16351652648624881,233152547,237207908.2,23.084688139941207,37.12930972877607,NaN,NaN,-11.593356158464333,-2.088565063019545
2005-08-31T09:30:00-04:00,104.08,104.98,103.53999,104.89,9550102,6640074.8,47.00917489157362,45.51384209386325,NaN,NaN,-92.39401565500812,-164.8752737595329,-0.17022372443307104,-0.37629618202758763,-0.2060724575945166,242702649,238695068.4,26.90465321078115,36.066612388220435,NaN,NaN,-10.743419829061628,-3.3249728867398423
2005-09-01T09:30:00-04:00,104.78,105.19,104.22,104.60001,7401301,6751859.75,45.123338185558055,45.11808297802994,NaN,NaN,-64.88218130686926,-137.74738618592406,-0.13425290959389655,-0.3738885945868873,-0.23963568499299073,235301348,237610968.4,25.895030106437943,35.12237763224609,NaN,NaN,-10.657213225829636,-4.372435792324098
2005-09-02T09:30:00-04:00,104.78,104.92999,104.3,104.60001,11825699,6983374.8,45.123338185558055,44.41956978665437,NaN,NaN,-62.93750048365567,-107.2801313202925,-0.10248462756220489,-0.3677414694457468,-0.2652568418835419,235301348,237636208.2,25.96468827300116,34.109980627206454,NaN,NaN,-10.589102100705423,-5.260530979235716
2005-09-06T09:30:00-04:00,104.98,105.92999,104.92,105.83,10764102,7193635,54.16775401838303,44.979431447667615,NaN,NaN,21.381235913464952,-71.86764857549105,0.0037129139994593885,-0.2606156993842177,-0.2643286133836771,246065450,238504668.4,28.45665722387001,33.49060640072815,NaN,NaN,-7.549079451348888,-5.587466475251883
2005-09-07T09:30:00-04:00,105.81,106.37,105.71001,106.23,7275000,7285640.1,56.66888151122535,45.57549197148512,NaN,NaN,70.19078211212648,-25.728335883988326,0.09801773761428906,-0.14180644136581577,-0.23982417898010483,253340450,242542249,38.774563440661346,33.40634637005837,NaN,NaN,-4.2512117595112775,-5.396572944431797
2005-09-08T09:30:00-04:00,105.98,106.28999,105.67,105.91,5879000,7155245.2,54.12421445985363,45.94806466620367,NaN,NaN,61.02803478544534,4.956074204102362,0.13375270113535068,-0.07263330256091649,-0.20638600369626717,247461450,243494009.2,40.93693032084954,33.25184832045151,NaN,NaN,-2.331405281160149,-4.958691849678704
2005-09-09T09:30:00-04:00,106.14,106.92999,106.06,106.75999,7455102,7232910.25,59.34620349894118,46.70950714392167,NaN,NaN,119.04511796170466,41.74153405781715,0.20526510422814728,0.05019537658891693,-0.15506972763923035,254916552,247417050,48.94161983897993,33.41181827845721,NaN,NaN,1.0486577407717592,-4.100499051042924
2005-09-12T09:30:00-04:00,106.7,107.00999,106.63,106.81,4963102,7212835.25,59.63731556476749,47.53100692052135,NaN,NaN,132.45971215509252,80.8209765855668,0.243932619587304,0.14984604684489966,-0.09408657274240435,259879654,252332711.2,56.8356300495283,34.236208711645844,NaN,NaN,3.8148961752028137,-2.96972830443639
2005-09-13T09:30:00-04:00,106.59,106.81,106.00999,106.11,6012102,7274855.4,53.82717603694446,48.150393538624314,NaN,NaN,87.9855446099219,94.14183832485818,0.21156672275364402,0.17037183069965067,-0.04119489205399335,253867552,253893131.6,59.00249781533844,35.31924042091683,NaN,NaN,4.436424768108398,-1.9117064369299916
2005-09-14T09:30:00-04:00,106.27,106.41,105.42999,105.57001,6906301,7273875.55,49.796828302364496,49.00376089090077,NaN,NaN,42.13479543843557,88.53064099012,0.1461043941282917,0.14143560060637128,-0.004668793521920421,246961251,252617291.8,56.50484592852922,36.718222096272434,NaN,NaN,3.710485669060062,-1.1085361360742698
2005-09-15T09:30:00-04:00,105.81,105.89999,105.25999,105.66,7019500,7249590.6,50.462512301261086,49.7161320549715,NaN,NaN,25.30296776543306,81.38562758611754,0.10320035706200034,0.12433165280558,0.021131295743579668,253980751,253921152,58.44102663142644,38.65915375450286,NaN,NaN,3.321223144228542,-0.47571338174529676
2005-09-16T09:30:00-04:00,105.95,106.38,105.64999,106.23,6797102,7252555.65,54.5714636075281,50.9643803631721,NaN,NaN,65.13344314400526,70.60329262257765,0.10708242295685844,0.1549843244396527,0.047901901482794274,260777853,255093412.2,60.15822841153019,41.05760090070843,NaN,NaN,4.21190686562334,0.19394665359307983
2005-09-19T09:30:00-04:00,106.12,106.14999,105.13,105.53999,8614000,7481570.65,49.24626812464128,51.353492389162916,NaN,NaN,24.65406849177159,49.042163889913475,0.059430650391943646,0.12219021447272382,0.06275956408078018,252163853,253550252,56.82932862280593,43.33788485812003,NaN,NaN,3.3512785012690878,0.644994060403938
2005-09-20T09:30:00-04:00,105.67999,105.97,104.57001,104.72,11004398,7683995.65,43.77896338158997,51.634530862156346,NaN,NaN,-18.395175110873605,27.766019945754373,-0.026454023501368405,0.02969203470406967,0.056146058205438075,241159455,251008632.6,51.75006483822463,45.38541176514027,NaN,NaN,0.8406727267879401,0.6729481556016527
2005-09-21T09:30:00-04:00,104.50999,104.50999,103.62,103.72,10703801,7868910.7,38.20799904762188,51.00587544473122,NaN,NaN,-104.07858196615989,-1.4766555351647128,-0.1432276463229039,-0.12288849969819182,0.02033914662471209,230455654,247707513.2,45.999426455728916,46.7493241397794,NaN,NaN,-3.247830809862643,0.11283687482103899
2005-09-22T09:30:00-04:00,103.74001,104.39999,103.44,104.03999,7931398,7811115.55,40.80384830058997,50.697340452947785,NaN,NaN,-96.57247326295213,-25.851743740841748,-0.1886752748060799,-0.2155049468828878,-0.026829672076807892,238387052,244588773.4,41.327008124199644,47.851608283905236,NaN,NaN,-5.705712907044894,-0.71838452258838
2005-09-23T09:30:00-04:00,103.92,104.5,103.67,104.10001,4975301,7787130.6,41.30194673379927,50.4243839206793,NaN,NaN,-83.5027966915809,-55.578991707958984,-0.20319536101468985,-0.2808238733451702,-0.07762851233048038,243362353,241105673.4,36.82779557562675,48.62754451980705,NaN,NaN,-7.505270918467022,-1.6879397219996144
2005-09-26T09:30:00-04:00,104.64999,105.03,104.02,104.44,6407000,7830145.65,44.16784599313523,49.71010477601874,NaN,NaN,-55.551119444251526,-71.6200292951636,-0.17923934131032174,-0.30167768896838254,-0.1224383476580608,249769353,240626773.4,36.2435481211347,49.18375101246882,NaN,NaN,-8.163097792587557,-2.6129623035121776
2005-09-27T09:30:00-04:00,104.37,104.89999,104.07001,104.53,8162898,7910890.55,44.93428840240292,48.87191955395999,NaN,NaN,-56.75058858230463,-79.29111198944982,-0.14796831302662705,-0.3073987389413446,-0.15943042591471757,257932251,243981332.6,43.05797477407741,49.48970896485569,NaN,NaN,-8.48377677796758,-3.451650085577235
2005-09-28T09:30:00-04:00,104.8,105.03999,104.16,104.7,6376602,7801190.55,46.43020112311345,48.32234717276426,NaN,NaN,-51.078832699524376,-68.6911621361227,-0.1083089952345202,-0.2948166699578678,-0.18650767472334762,264308853,250751972.4,53.79277569823206,50.407983634668724,NaN,NaN,-8.339729072130227,-4.149947083656234
2005-09-29T09:30:00-04:00,104.60001,105.55,104.10001,105.39999,9185602,7782965.55,52.18957416263001,47.811159363027755,NaN,NaN,-22.106816319658495,-53.79803074746398,-0.031401485303772236,-0.22575953135306293,-0.1943580460492907,273494455,257773453,61.829401217518786,51.328539447421505,NaN,NaN,-6.534177576216981,-4.490551439736341
2005-09-30T09:30:00-04:00,105.36,105.78999,105.2,105.75,4172898,7621545.4,54.80600481507914,47.46606573805002,NaN,NaN,23.250422151118162,-32.44738697892417,0.042557515441855875,-0.14116115174697086,-0.18371866718882673,277667353,264634453,67.73471247259917,52.10704533478373,NaN,NaN,-4.2336861148299985,-4.453856393321149
2005-10-03T09:30:00-04:00,105.74001,106.00999,105.16,105.28,5411102,7300815.55,50.78680500246679,47.24889637844446,NaN,NaN,11.345924525963197,-19.067978184881223,0.05836327502849986,-0.1107645734032019,-0.16912784843170175,272256251,269131832.6,70.9115249790698,52.957690132193115,NaN,NaN,-3.397782175262326,-4.302988647884174
2005-10-04T09:30:00-04:00,105.46001,105.64,104.17,104.17,6459602,7085590.55,42.803223952975934,46.749353210631,NaN,NaN,-58.706397212818956,-19.459139910984096,-0.004085180915897657,-0.17423432457657384,-0.17014914366067618,265796649,270704712.2,71.95164638825531,54.06103302217355,NaN,NaN,-5.157123819838481,-4.425007958163361
2005-10-05T09:30:00-04:00,104.28,104.35001,103.16,103.22,8901801,7166930.6,37.38638819876145,45.81534434616674,NaN,NaN,-135.6165773865154,-36.3666888483823,-0.1020880747027863,-0.2977592370391591,-0.19567116233637277,256894848,269221911.2,69.43113076260828,54.846040460115105,NaN,NaN,-8.523475038369876,-5.0105032553357205
2005-10-06T09:30:00-04:00,103.34,103.71001,102.19,102.89999,11180699,7432015.55,35.745369229523035,44.47062331916637,NaN,NaN,-163.73778704685762,-64.69288299382212,-0.17680115829000012,-0.4166726101988729,-0.2398714519088728,245714149,263665850,60.83208614353262,54.89417315525814,NaN,NaN,-11.770451949109752,-5.976210211589153
2005-10-07T09:30:00-04:00,103.35001,103.50999,102.82001,102.97,6857699,7402145.4,36.40305366551883,43.553250857800485,NaN,NaN,-134.4891357594888,-96.24079457594353,-0.20770692589837492,-0.49950510928184144,-0.2917981833834665,252571848,258646749,54.29076430228278,54.71284713236362,NaN,NaN,-14.152740144169766,-7.144285916243526
2005-10-10T09:30:00-04:00,103.17999,103.24001,102.28999,102.32001,5053199,7406650.25,33.023442354026244,42.784999355831644,NaN,NaN,-156.3309181180399,-129.77616310474414,-0.2550102969823883,-0.6105610546114519,-0.35555075762906363,247518649,253699228.6,48.72837848631158,54.497012392941265,NaN,NaN,-17.274786884972958,-8.59150034034773
2005-10-11T09:30:00-04:00,102.69,103.17999,102.35001,102.53,7940898,7503090.05,35.11910977079093,42.56436440748657,NaN,NaN,-134.2196719550065,-144.87881805318165,-0.2546485127931851,-0.6738613986205451,-0.41921288582735994,255459547,251631808.2,46.58071047428915,54.53853267998129,NaN,NaN,-19.20859310594462,-10.108227878290142
2005-10-12T09:30:00-04:00,102.53999,103.12,101.88,102.03,16985904,8007070.2,32.51066600139022,41.97199424325803,NaN,NaN,-138.0932934694677,-145.37416126977212,-0.2691596056944177,-0.7556623929453821,-0.48650278725096435,238473643,247947567.2,42.94799024739179,54.65431711735215,NaN,NaN,-21.65552589138496,-11.75784188016083
2005-10-13T09:30:00-04:00,102.03,102.44,101.58,101.96001,8092000,8060695.2,32.15068557157048,41.31833273167025,NaN,NaN,-142.49010412183543,-141.12462468476767,-0.26417633154710973,-0.8167232016848516,-0.5525468701377418,230381643,244881066,40.14188837403917,54.89103803152447,NaN,NaN,-23.749072269544346,-13.470874792929903
2005-10-14T09:30:00-04:00,102.49001,102.97,102,102.83,8778000,8159740.1,40.9092947631198,41.08557907238344,NaN,NaN,-92.33981375166046,-132.69476028320202,-0.18664615833538745,-0.7858545680569762,-0.5992084097215887,239159643,242198625,37.81438988134082,55.00324101439633,NaN,NaN,-22.991098053271315,-14.83090668726439
2005-10-17T09:30:00-04:00,103.07001,103.64,102.94,103.5,10069000,8232490.1,46.62384667594654,41.20626180620798,NaN,NaN,-33.967258887840465,-108.22202843716211,-0.0800467442867745,-0.6992668400800568,-0.6192200957932823,249228643,242540623.8,38.30554292901113,54.6637815968916,NaN,NaN,-20.53116063651925,-15.645228680015084
2005-10-18T09:30:00-04:00,103.56,103.75999,102.86,102.87,4804801,7922510.25,42.46524718882202,40.92305081090145,NaN,NaN,-42.5143108477298,-89.88095621570677,-0.04359593091894476,-0.6737150094419633,-0.6301190785230185,244423842,240333482.8,36.31225366926222,53.41517288053661,NaN,NaN,-19.725688957020207,-16.228151576730102
2005-10-19T09:30:00-04:00,102.61,104.35001,102.36,104.31,12385699,8006605.15,52.82320334477481,40.968310038197515,NaN,NaN,-3.7408579424149404,-63.01046911029621,0.07917821472522824,-0.5311463101164833,-0.6103245248417115,256809541,244000662.4,41.737101675686745,51.980008627548614,NaN,NaN,-15.332783486815812,-16.100241849599488
2005-10-20T09:30:00-04:00,104.06,104.38,102.49001,102.78,10698500,8144960.25,43.800502953779045,40.18220276239037,NaN,NaN,-34.89131156945001,-41.49071059981914,0.05990320438411045,-0.5354455193615735,-0.5953487237456839,246111041,247146542,45.987417814788984,50.42663043770502,NaN,NaN,-14.803130030445692,-15.914940161148946
2005-10-21T09:30:00-04:00,102.97,103.05,101.87,102.14,10676102,8430000.3,40.671036711188854,39.45964788444194,NaN,NaN,-89.81483777444072,-40.9857154043752,0.009266152191148569,-0.5837660335067483,-0.5930321856978968,235434939,246401601.2,45.147518207728574,48.58634423975208,NaN,NaN,-15.521631034595964,-15.858753143069949
2005-10-24T09:30:00-04:00,102.53999,103.84,102.44,103.75,11281602,8673730.4,50.29254739152722,39.99459955862418,NaN,NaN,-15.042366727093967,-37.2007369722259,0.08519508185345592,-0.4865383333810769,-0.5717334152345328,246716541,245899180.8,44.556461387337364,46.62954531111508,NaN,NaN,-12.443049941405492,-15.37079554283217
2005-10-25T09:30:00-04:00,103.58,104.06,103.07001,103.73,6670699,8599120.45,50.18367249631878,40.90869129416399,NaN,NaN,9.871409087293372,-26.723592985221263,0.1322558281450481,-0.4064136300532226,-0.5386694581982707,240045842,245023580.8,43.487930060303654,44.77645954666475,NaN,NaN,-10.21059362291547,-14.633623839986926
2005-10-26T09:30:00-04:00,103.45,104.25999,103.31,103.53,7676500,8664115.35,49.04036643441911,41.85833395165656,NaN,NaN,21.55253350154372,-21.66491469642953,0.14696693701262098,-0.35496078693249444,-0.5019277239451154,232369342,240135541,38.00810771593437,43.14617537326488,NaN,NaN,-8.845011235118001,-13.806679182148509
2005-10-27T09:30:00-04:00,103.32001,103.42,102.2,102.34,5418699,8475770.2,42.79328281828553,42.314778891139895,NaN,NaN,-64.70356126354784,-27.627364635249087,0.07711628466635129,-0.4055323681121763,-0.4826486527785276,226950643,236303461.4,34.3534054002202,41.72207830883184,NaN,NaN,-9.78120652914609,-13.231611660291021
2005-10-28T09:30:00-04:00,102.64999,103.96001,102.46001,103.84,8511500,8692700.3,51.22721572946461,43.61504841795692,NaN,NaN,22.38279951424846,-5.18783717751125,0.1294193973012442,-0.3208744061519724,-0.45029380345321657,235462143,236308902.2,34.363055616320395,40.69598381811818,NaN,NaN,-7.57151937662864,-12.423027048339252
2005-10-31T09:30:00-05:00,104.24001,104.78999,103.89,103.91,5545199,8699405.15,51.58592796618902,44.79124971762821,NaN,NaN,133.75445610182726,24.571527388272994,0.16399007547898592,-0.2453062091044842,-0.4092962845834701,241007342,235167062.4,33.25808883029801,39.74436798640453,NaN,NaN,-5.773054600817139,-11.473030984407522
2005-11-01T09:30:00-05:00,104.25,104.48,103.97,104.14,5384199,8645635,52.81392405903628,46.2414824360315,NaN,NaN,142.49829457587003,51.09690448598833,0.19547121485492847,-0.16495726601480953,-0.360428480869738,246391541,236436202.2,35.731764709063356,39.22892330509535,NaN,NaN,-3.9568907112320013,-10.399296659668162
2005-11-02T09:30:00-05:00,103.86,104.89,103.75999,104.7,6404398,8520764.85,55.75644945105811,47.92760842742348,NaN,NaN,157.63922640602232,78.31424306688405,0.2439799084394242,-0.055453595320457794,-0.299433503759882,252795939,240521521.6,43.04899590229896,39.43657384282819,NaN,NaN,-1.524480147375329,-9.131465729340615
2005-11-03T09:30:00-05:00,105.14999,105.59,104.88,105.24001,6455801,8284519.95,58.447384299218214,49.18032910857336,NaN,NaN,207.48491490687482,132.75193830096856,0.29878644258568243,0.07404954947222109,-0.22473689311346134,259251740,246981741,52.29796348450829,40.47111481448301,NaN,NaN,1.3414893490011701,-7.635329289577503
2005-11-04T09:30:00-05:00,105.37,105.49001,104.74001,105.19,4156102,8149440.1,58.0949877788755,49.99969633021114,NaN,NaN,164.71670056893046,161.218718511905,0.31633259935651015,0.17067885608217637,-0.14565374327433378,255095638,250908440,56.88168935129651,41.797982416074824,NaN,NaN,3.5421010376677775,-6.038553528542463
2005-11-07T09:30:00-05:00,105.49001,105.87,105.17,105.61,3315000,8062530.15,60.26194461886426,51.27088900378559,NaN,NaN,170.07706235751374,168.48323976304226,0.3388788290998234,0.2779447931004455,-0.06093403599937791,258410638,254389099.2,60.50451734933809,43.52600125036595,NaN,NaN,6.036018522123462,-4.3136146641616175
2005-11-08T09:30:00-05:00,105.45,105.74001,105.3,105.60001,3077000,7819335.25,60.18222716362272,51.796533562274725,NaN,NaN,145.5515946706985,169.09389978200798,0.3351637664311374,0.3580206720395438,0.022856905608406433,255333638,256177518.6,62.25916545057203,44.991862948572056,NaN,NaN,8.053822754968364,-2.546837890000192
2005-11-09T09:30:00-05:00,105.42,106.11,105.27,105.60001,4387699,7189425,60.18222716362272,52.9666567201207,NaN,NaN,131.6474605891201,163.89554661862752,0.3150570166095012,0.4166781763702829,0.10162115976078175,255333638,256685058.4,62.76473679313995,46.19024287559712,NaN,NaN,9.728366444907598,-0.7932372707276503
2005-11-10T09:30:00-05:00,105.59,106.67999,105.33,106.58,7607000,7165175,65.39088992229392,54.73236052091392,NaN,NaN,148.1311116144794,152.02478596014845,0.34755289758497865,0.5360622817420051,0.18850938415702642,262940638,257422838,63.52954640259742,47.503244889516324,NaN,NaN,12.773594029146512,1.1448814863972299
2005-11-11T09:30:00-05:00,106.56,107.11,106.5,107.02,3297100,6891130,67.44971650023861,55.95787260010759,NaN,NaN,166.03831033624942,152.28910791361224,0.37606255704293085,0.65858758046069,0.28252502341775915,266237738,259651258,65.81360530089117,49.02161231191302,NaN,NaN,15.98810262120343,3.265341648512401
2005-11-14T09:30:00-05:00,106.96001,107.24001,106.89,107.2,3607500,6568055,68.28100778271411,57.25053940627869,NaN,NaN,152.06307520212636,148.68631048253476,0.3831294913911413,0.7614368876566857,0.37830739626554444,269845238,261938178,68.02666285883704,50.774378940379684,NaN,NaN,18.914518866072648,5.50093839387815
2005-11-15T09:30:00-05:00,107.17999,107.57001,106.77,107.12,7408602,6698245.05,67.45644436757581,58.56597354436131,NaN,NaN,132.8564243202853,146.14727641245213,0.3589202584764933,0.826957719361161,0.46803746088466774,262436636,263358777.6,69.3538165013853,53.01335813934047,NaN,NaN,21.146503066548057,7.7360190614024225
2005-11-16T09:30:00-05:00,107.16,107.35001,106.73,107.03999,6907301,6424325.15,66.59033190898789,60.265762765125764,NaN,NaN,111.63363642701054,142.1445115800302,0.3155581277869759,0.8624851206183877,0.5469269928314118,255529335,263397917,69.39151310790658,55.51608011846092,NaN,NaN,22.814019922917208,9.890019184475964
2005-11-17T09:30:00-05:00,107.14,107.48,106.86,107.38,5314801,6155140.2,68.44453591433549,61.4955713497594,NaN,NaN,109.95478521421657,134.50924629997766,0.2885499207213492,0.9076143937330983,0.619064473011749,260844136,262978616.6,68.42053790407476,57.94875742472909,NaN,NaN,24.768648937457197,12.01553772061614
2005-11-18T09:30:00-05:00,107.57001,107.7,106.89999,107.53,8013898,6022030,69.25520062743065,62.7576622541338,NaN,NaN,108.10695270095039,122.92297477291785,0.2604241930593827,0.9445947143359774,0.6841705212765947,268858034,263502675.8,69.00430935961218,60.502058891108675,NaN,NaN,26.657071235057412,14.10718536553632
2005-11-21T09:30:00-05:00,107.75999,108.3,107.53,108.16,5133000,5714599.9,72.45579682245369,64.16065316580647,NaN,NaN,126.63699262361753,117.8377582572161,0.2631113414753177,1.0130596981207418,0.7499483566454241,273991034,264331835,69.95079361007618,62.94627524118102,NaN,NaN,29.265924267028637,16.27271949432094
2005-11-22T09:30:00-05:00,107.98,108.74001,107.84,108.64,7228500,5742489.95,74.62339194230104,65.50829191518096,NaN,NaN,130.05433077062156,117.27733954728335,0.2747982053701733,1.0934461133581408,0.8186479079879675,281219534,268088414.6,73.84724197065685,65.14614996034945,NaN,NaN,32.18933699486469,18.546521994398617
2005-11-23T09:30:00-05:00,108.42,109.46001,108.42,109.17999,5402801,5628805,76.83221825768227,66.82149434078555,NaN,NaN,140.85392529607256,123.12139732109577,0.29471537281317406,1.187042124004435,0.892326751191261,286622335,274307014.6,78.75770149734223,67.03613124698043,NaN,NaN,35.422491982212364,20.95737484980058
2005-11-25T09:30:00-05:00,109.22,109.5,109.22,109.33,1592000,5437470.05,77.42020451659224,68.20186696490816,NaN,NaN,142.58707189656099,129.64785465756464,0.2931877157587237,1.2588113958896656,0.9656236801309419,288214335,279781054.4,81.9673922288699,68.82796716680711,NaN,NaN,38.29179318968405,23.43372032692679
2005-11-28T09:30:00-05:00,109.42,109.49001,108.75999,109.03999,7202102,5372000.15,73.53465686423094,69.14991783957721,NaN,NaN,120.28536229620865,132.08353657661627,0.24954965792864292,1.2775607525417456,1.0280110946131027,281012233,282211894.2,83.18260800529492,70.44783078508975,NaN,NaN,39.68872903671009,25.755864428324404
2005-11-29T09:30:00-05:00,109.31,109.59,108.87,108.89,6527801,5421130.25,71.53502220013692,69.9608317707568,NaN,NaN,113.08437298668017,129.3730126492288,0.1901721709449844,1.265726308294333,1.0755541373493487,274484432,282310573.8,83.23200853800878,71.94589100562095,NaN,NaN,40.32811251319346,27.83761415473427
2005-11-30T09:30:00-05:00,108.98,109.28,108.07001,108.22,6155398,5459690.2,63.259733979984404,70.1806536862112,NaN,NaN,77.27300545145319,118.81674758539513,0.09042291646831702,1.1885827829347448,1.0981598664664278,268329034,279732473.8,76.87821176660769,72.95399636086864,NaN,NaN,38.518236559504395,29.363417355415717
2005-12-01T09:30:00-05:00,108.74001,109.39,108.64,109.06,5846398,5431790.2,68.22298932635744,70.38294650078716,NaN,NaN,94.9184332847657,109.62964918313378,0.06675702125299132,1.181606143032667,1.1148491217796757,274175432,277243093.2,71.22432010939804,73.50362305421154,NaN,NaN,38.34959198261055,30.64715658787212
2005-12-02T09:30:00-05:00,109.03,109.25999,108.64999,108.82001,5151301,5366565.2,65.50049220562593,70.24371619402912,NaN,NaN,78.72039326029922,96.85631345588142,0.022944715474871202,1.1435300161232647,1.1205853006483935,269024131,273405052.4,63.473627744110594,73.3364818001558,NaN,NaN,37.38607697142953,31.609859499808895
2005-12-05T09:30:00-05:00,108.59,108.75999,108.14,108.39,4607398,5389130,60.817380795107574,69.71059998062864,NaN,NaN,45.09695943984257,81.8186328846082,-0.04337718480433628,1.066363819642973,1.1097410044473093,264416733,270085952.4,57.632764073012844,72.5940604583112,NaN,NaN,35.13371772593742,32.11326781782726
2005-12-06T09:30:00-05:00,108.81,109.28,108.48,108.7,5144602,5480610.1,62.877961212585994,69.38356546955795,NaN,NaN,62.46998703196514,71.6957556936652,-0.07300638444894036,1.0184830238861338,1.0914894083350741,269561335,269101333,55.98686708821488,71.63927835737046,NaN,NaN,33.83912760756159,32.359819216360734
2005-12-07T09:30:00-05:00,108.67999,108.73,107.69,108.10001,8612398,5757380,56.666555192296144,68.67472427550854,NaN,NaN,14.342109034135111,59.10957641020159,-0.13599113816581698,0.9215004856278028,1.0574916237936198,260948937,267625313.6,53.51939224077443,70.50555543828959,NaN,NaN,30.77506324508059,32.13342550617786
2005-12-08T09:30:00-05:00,108.17,108.53,107.37,107.64,7453199,5910655,52.39315138356852,67.52819680902519,NaN,NaN,-20.081502331649105,36.10958928691863,-0.20733759421027265,0.798319631030779,1.0056572252410516,253495738,263489374.8,47.23712065553995,68.9924542062514,NaN,NaN,26.824366589219096,31.37498851804089
2005-12-09T09:30:00-05:00,107.67,108.11,107.35001,107.74001,5127801,5786695.05,53.2191439204755,66.38276418709982,NaN,NaN,-40.35837150174629,12.29383633450953,-0.24397317175181554,0.7006907605512822,0.9446639323030978,258623539,261409256.4,44.41342164137191,67.23596222637708,NaN,NaN,23.856608533037118,30.300934234468922
2005-12-12T09:30:00-05:00,108.10001,108.2,107.42,107.72,5096699,5876675,53.0209262605703,64.9945591469653,NaN,NaN,-43.024919967635206,-5.33053954698602,-0.26403547739931565,0.6146195855539531,0.8786550629532688,253526840,259231277.8,41.608823408148965,65.21153578338227,NaN,NaN,21.38126206599923,29.026695353258965
2005-12-13T09:30:00-05:00,107.75999,108.78999,107.58,108.39,7731500,6082875,58.58332466122664,63.84884005545997,NaN,NaN,-1.2665576107128245,-18.077848475521613,-0.2280216616151487,0.593627985934333,0.8216496475494817,261258340,257570678.8,39.55773811119255,62.76228550770626,NaN,NaN,20.751784568703226,27.844565241179573
2005-12-14T09:30:00-05:00,108.42,109.28999,108.42,109,7045398,6064714.8,62.89129901552673,62.85306010959173,NaN,NaN,64.09553865245965,-8.127162551856754,-0.16205767536421567,0.6190775533442121,0.7811352287084278,268303738,259041639,42.272321650763104,60.15618694723633,NaN,NaN,21.516494393717405,26.94055512011355
2005-12-15T09:30:00-05:00,109,109.5,108.7,108.77,8461602,6142429.85,60.342678674034026,61.633236835123284,NaN,NaN,68.44058874090658,9.577255662654382,-0.1340169190393159,0.6136140799092829,0.7476309989485987,259842136,260310918.6,44.58508008961182,57.486021794432176,NaN,NaN,21.38885766252457,26.147455483315124
2005-12-16T09:30:00-05:00,108.98,109.24001,108.5,108.50999,4573102,6105344.9,57.505598515536626,60.488304095930836,NaN,NaN,31.64327167240636,23.977584297484913,-0.13282536774254738,0.5815992892704145,0.7144246570129619,255269034,259640017.6,43.59098330108512,54.65804860127434,NaN,NaN,20.446815758727247,25.33307837980257
2005-12-19T09:30:00-05:00,108.8,109.05,108.05,108.21001,7584301,6083865.05,54.331739964101885,59.259498221928325,NaN,NaN,-22.46850011084878,28.088868268842198,-0.1507728972316893,0.5259585354733503,0.6767314327050395,247684733,258471596.2,41.84125905095969,51.70156649505653,NaN,NaN,18.716418255793158,24.387841219229795
2005-12-20T09:30:00-05:00,108.24001,108.42,107.7,107.89,5050500,6079740.05,51.092167495466086,58.39038633017702,NaN,NaN,-91.3230314528878,10.077573500407201,-0.18071021849437974,0.45084365958706485,0.6315538780814446,242634233,254746774.8,36.7736785622711,48.83695698046107,NaN,NaN,16.28742319629445,23.230638644524745
2005-12-21T09:30:00-05:00,108.08,108.84,107.99001,108.14999,5923102,6014470.15,53.51712878325905,57.339967719955716,NaN,NaN,-38.99380265836052,-10.540294761756835,-0.1791670249540831,0.40759509688884066,0.5867621218429238,248557335,250797494.2,32.306050592516485,46.0570805863981,NaN,NaN,14.919581399535373,22.043344752383405
2005-12-22T09:30:00-05:00,108.36,108.75,108.16,108.71001,4253801,5957020.15,58.311921611676894,56.82649839181649,NaN,NaN,-1.7725283537670635,-24.58291818069156,-0.13841777980273962,0.4137398970894992,0.5521576768922388,252811136,249391294.2,30.868037848784027,43.728109879589056,NaN,NaN,15.134803332496174,21.056410263828084
2005-12-23T09:30:00-05:00,108.85001,108.95,108.60001,108.75,1906900,5972765.15,58.6400092624718,56.67097185377109,NaN,NaN,44.05370988938988,-22.10083053729486,-0.10810270141068046,0.4170293001288883,0.5251320015395687,254718036,249281094.6,30.752512555874375,41.808091914079164,NaN,NaN,15.403620785865218,20.24886890983339
2005-12-27T09:30:00-05:00,108.94,109.25,107.64,107.75,8654301,6045375.1,48.38527325922277,55.63577985710229,NaN,NaN,-49.20794464492303,-27.448719444109706,-0.15204006737283826,0.3350819173235209,0.48712198469635914,246063735,248956895,30.392144292729824,39.97989742868737,NaN,NaN,12.401032908045018,19.12774948100648
2005-12-28T09:30:00-05:00,107.99001,108.14999,107.69,107.85001,4322102,5935090.15,49.33944922232479,55.11241514496148,NaN,NaN,-98.41255307407265,-28.866623768346678,-0.16966755917637844,0.2750375357258861,0.4447050949022645,250385837,250507215.8,34.35373613500538,38.61092199256102,NaN,NaN,10.27500423986429,17.863071589414737
2005-12-29T09:30:00-05:00,107.94,108.14999,107.55,107.67999,2908000,5772720.25,47.72421718198624,54.77891984484846,NaN,NaN,-103.48595794738345,-41.765054826151264,-0.1867264463889824,0.21129703691603652,0.3980234833050189,247477837,250291316.2,34.06299316138977,37.66991288583599,NaN,NaN,8.041355811441091,16.459969335418503
2005-12-30T09:30:00-05:00,107.39999,107.58,106.82001,106.95,5063199,5733560.3,41.44990974147282,53.93826026063398,NaN,NaN,-193.05453757252394,-80.02145666990263,-0.2378450780692969,0.1007171357183978,0.3385622137876947,242414638,248212016.6,31.314290609080757,36.73426066924377,NaN,NaN,4.039350160892833,14.685595167629122
2006-01-03T09:30:00-05:00,107.44,108.56,106.74001,108.33,9761898,5964090.15,53.812248975779966,53.99478331172039,NaN,NaN,-60.956052620225016,-101.02340917182562,-0.17243524507019714,0.12301815744994826,0.2954534025201454,252176536,247703716.6,30.66289354525624,35.952408536179995,NaN,NaN,4.595077210293518,13.244092602295465
2006-01-04T09:30:00-05:00,108.42999,108.86,108.27,108.74001,5844500,6025945.25,56.73511360522493,53.86276823629169,NaN,NaN,63.71405364841326,-78.43900951315837,-0.09892600039490274,0.17179590202651696,0.2707219024214197,258021036,250095176.8,37.274060503267584,35.7892887070425,NaN,NaN,6.058803003940416,12.217622659673316
2006-01-05T09:30:00-05:00,108.50999,109.02,108.36,108.88,4843602,6010895.25,57.71893231846679,53.493313472215995,NaN,NaN,86.72555979442045,-41.41138693945974,-0.04120025068526045,0.21922158906484412,0.2604218397501046,262864638,252590937,43.34524154817832,35.86592584257216,NaN,NaN,7.527059961131599,11.547542274167355
2006-01-06T09:30:00-05:00,109.33,109.7,108.75999,109.52,9018199,6031185.3,61.975950648013104,53.60997575607164,NaN,NaN,154.2736724296505,10.140539135947051,0.035610004760693315,0.3049343457009712,0.2693243409402779,271882837,257471937,52.938798464927316,36.462620012237544,NaN,NaN,10.204966212153934,11.355745693879724
2006-01-09T09:30:00-05:00,109.5,110.21001,109.47,109.98,10420699,6179560.3,64.7250387662154,54.12565005969155,NaN,NaN,198.7537014443642,88.50218693932467,0.1087871962692546,0.40530833627684615,0.29652114000759155,282303536,265449716.6,63.74492371909749,37.902187184952716,NaN,NaN,13.334053700313264,11.63836112337023
2006-01-10T09:30:00-05:00,109.56,110.14,109.47,110.08,6390699,6242705.2,65.31216879732315,54.90996640492164,NaN,NaN,172.5634765796568,135.20609277930106,0.15262887738750236,0.4873072367419695,0.33467835935446716,288694235,272753256.4,70.43738520019872,39.944767624184074,NaN,NaN,16.000797195963635,12.26156627659786
2006-01-11T09:30:00-05:00,110.11,110.46001,109.88,110.42999,4388699,6207305.2,67.35984055444533,56.07194305199159,NaN,NaN,185.14412848111246,159.49210774584088,0.19139128123978477,0.5739174609041982,0.3825261796644134,293082934,279765636,75.17557960085065,42.68776055551118,NaN,NaN,18.868992203557685,13.205484266163548
2006-01-12T09:30:00-05:00,110.22,110.23,109.50999,109.77,6331699,6137315.15,60.14911690642543,56.54565648936062,NaN,NaN,119.8296152715934,166.11291884127547,0.1600473196949424,0.5825853292830914,0.42253800958814897,286751235,284542955.4,77.78755961563928,45.936439771448526,NaN,NaN,19.116623385859906,14.049932711834456
2006-01-13T09:30:00-05:00,109.63,109.92999,109.19,109.53999,3712200,5970655.25,57.82587691676371,56.51093901115253,NaN,NaN,81.9975595959264,151.65769627453065,0.11348068763531055,0.5643888691322871,0.4509081814969766,283039035,286774195,78.90400470210774,49.36758026097165,NaN,NaN,18.608125503462098,14.701103110638405
2006-01-17T09:30:00-05:00,109.14999,109.27,108.74001,109.00999,3914400,5743295.15,52.7682015859179,56.09152417711296,NaN,NaN,26.619569181673107,117.23086982199243,0.04041057399884457,0.5014213989955323,0.4610108249966877,279124635,286138414.8,77.70550385555849,52.72136535380623,NaN,NaN,16.59456728309879,14.97159799241846
2006-01-18T09:30:00-05:00,108.39999,108.89999,108.21001,108.60001,4962199,5762750,49.18452594753505,56.148613654849555,NaN,NaN,-16.37352609986504,79.44346928608807,-0.03787366019372196,0.41366874975453527,0.45154240994825723,274162436,283232055,72.2992069214404,55.7147269701427,NaN,NaN,13.78147633068218,14.801580612170419
2006-01-19T09:30:00-05:00,108.73,109.17999,108.53999,108.73,4596398,5613354.85,50.33619668643945,56.21980990228632,NaN,NaN,6.459693527262687,43.70658229531812,-0.08077626955734785,0.35057207300157245,0.4313483425589203,278758834,280367235,67.32677792294754,58.06994424071,NaN,NaN,11.83136904612796,14.377264674164353
2006-01-20T09:30:00-05:00,108.46001,108.5,106.45,106.47,16613000,6191479.85,35.33997703580536,55.33522132041626,NaN,NaN,-149.4725810461298,-10.153856968226526,-0.2515928091480423,0.11685733112386743,0.3684501402719097,262145834,275446154.8,59.7277351305955,59.90314009565327,NaN,NaN,4.08321150660811,12.906685650227747
2006-01-23T09:30:00-05:00,106.64,107.28,106.56,106.86,7596801,6275164.8,38.732127043602084,55.141093984854066,NaN,NaN,-150.22704362123346,-56.59877761165849,-0.32393859681328,-0.036473105744690315,0.2874654910685897,269742635,272786874.8,56.04638620843755,61.66971835275018,NaN,NaN,-0.7289706978294265,10.958734743362436
2006-01-24T09:30:00-05:00,106.95,107.41,106.78,106.94,7147801,6419864.8,39.43403137985295,54.11407844228785,NaN,NaN,-118.83175514516375,-85.68904247702588,-0.34981749332726103,-0.1498063755904866,0.20001111773677444,276890436,272340035,55.428179075299205,63.438667319181825,NaN,NaN,-4.181191226949864,8.795888176174964
2006-01-25T09:30:00-05:00,107.28,107.52,106.60001,107.14999,9526000,6800819.8,41.333908817023136,53.01399238598771,NaN,NaN,-100.18442699380955,-102.45122265581476,-0.3361222652150413,-0.22014171378202718,0.11598055143301411,286416436,274790835,58.154493444164906,64.9301268149602,NaN,NaN,-6.344883200015169,6.632920836719231
2006-01-26T09:30:00-05:00,107.63,108.2,107.45,108.00999,8234398,6779824.65,48.463957636172665,52.35292276582385,NaN,NaN,-40.78814638072095,-111.9007906374115,-0.25609245866217145,-0.20413502189470023,0.051957436767471235,294650834,277969235,61.44792524511412,66.22317565045562,NaN,NaN,-5.898702810034688,4.842688887182957
2006-01-27T09:30:00-05:00,108.22,109.27,107.97,109.11,7922801,6959859.6,55.85447587863942,51.915674568011454,NaN,NaN,19.929161346499576,-78.02044215888563,-0.12278015415117052,-0.10151775592149193,0.021262398229678604,302573635,286054795.2,68.28604234194356,67.31940735595677,NaN,NaN,-2.9156400661960813,3.7343561795573805
2006-01-30T09:30:00-05:00,109.09,109.2,108.75999,108.91,4822898,7055604.5,54.328971843099694,51.17309835921747,NaN,NaN,29.23476262736776,-42.12808090916538,-0.04574362379656656,-0.0359171315160296,0.009826492280536963,297750737,291656415.6,71.99244213846188,67.90851581448281,NaN,NaN,-1.077123733555464,3.0470019062555456
2006-01-31T09:30:00-05:00,108.78999,109.19,108.24001,108.27,5224898,7063689.45,49.655325217316296,50.05475238921698,NaN,NaN,-5.948746714045391,-19.551479222941705,-0.03599355376644434,-0.035165449927518466,0.0008281038389258769,292525839,294783496.2,73.8310859553691,68.1509230112807,NaN,NaN,-1.0594690278084682,2.460363201389258
2006-02-01T09:30:00-05:00,108.5,109.62,108.5,109.57001,7069398,6929064.45,57.62878342509762,49.35967687997786,NaN,NaN,44.60472414357363,9.406351004534924,0.05496049427813526,0.06952872168659496,0.014568227408459696,299595237,297419256.4,75.30279408990835,68.1600097604991,NaN,NaN,1.7786630778499772,2.3629774694550747
2006-02-02T09:30:00-05:00,109.3,109.39,108.19,108.3,7334801,7003579.5,49.397894325556784,48.59173240991582,NaN,NaN,-6.785289856820581,16.206922309314994,0.027905722618255215,0.049450380681278716,0.0215446580630235,292260436,296941176.8,74.4845531480104,67.92408072709704,NaN,NaN,1.205260759604192,2.197589368047806
2006-02-03T09:30:00-05:00,108.10001,108.62,107.74001,107.78999,5109398,7016869.3,46.5241883045404,47.78446893761416,NaN,NaN,-50.70438216937886,2.080213606139311,-0.023258613470501892,-0.007528608775103862,0.01573000469539803,287151038,293856657.4,69.25579883934554,67.23492316547116,NaN,NaN,-0.259131133805076,1.846629296354537
2006-02-06T09:30:00-05:00,107.95,108.13,107.67,108.02,3454100,6738664.35,47.99359970623096,47.443425946207945,NaN,NaN,-53.61254486975336,-14.489247893284915,-0.03957287975738288,-0.03373609500133057,0.005836784756052309,290605138,292427537.6,66.91209641482999,66.46396549113341,NaN,NaN,-0.9110342208902691,1.4526773653195648
2006-02-07T09:30:00-05:00,107.83,108.21001,107.32001,107.48,11363699,6785814.35,44.8759225887075,47.13566856343455,NaN,NaN,-66.6823911745998,-26.63597678539579,-0.08223862137218399,-0.09696149195917769,-0.014722870586993696,279241439,289770657.6,62.66621576057856,65.77589469392899,NaN,NaN,-2.461496836612373,0.8935096221864308
2006-02-08T09:30:00-05:00,107.72,108.71001,107.67999,108.59,5261199,6729339.35,51.806231594344844,47.240671056856364,NaN,NaN,-7.4645566616741315,-37.04983294644535,-0.03369776477995841,-0.05684507656194171,-0.0231473117819833,284502638,286752137.8,58.15149588016917,65.1205174051591,NaN,NaN,-1.4650905715820688,0.5565667373623595
2006-02-09T09:30:00-05:00,108.81,109.56,108.67,108.84,7852602,6902534.5,53.23235937299827,48.51869836665585,NaN,NaN,63.04942527156029,-23.082889920769173,0.014658641829567054,-0.004824009495024484,-0.019482651324591538,292355240,286771098.6,58.17188098674816,65.00938496631287,NaN,NaN,-0.21659799979864386,0.44611463205364477
2006-02-10T09:30:00-05:00,108.84,109.50999,108.22,109.13,7640602,6967979.65,54.89957162257398,49.67351583658241,NaN,NaN,64.02616266356557,-0.13678095418028563,0.06288381256651757,0.05912211438355541,-0.0037616981829621463,299995842,289340059.4,60.94754498236179,65.3594677358789,NaN,NaN,1.312343083232229,0.5698615536505853
2006-02-13T09:30:00-05:00,109.06,109.49001,108.56,109.05,10955500,7330144.65,54.32424325337923,50.73710239897714,NaN,NaN,76.89722762821022,25.965173545412426,0.08474282352119014,0.10216683121852554,0.017424007697335396,289040342,289027100.2,60.42152148668598,65.71613505097795,NaN,NaN,2.374309216325544,0.8276397911755794
2006-02-14T09:30:00-05:00,109.28999,110.55,109.12,110.39999,13191000,7793974.65,61.63139450105796,52.18692280497964,NaN,NaN,162.59396102637464,71.82044398560731,0.17999562589329293,0.24241854006395158,0.062422914170658636,302231342,293625080.8,65.17685530103549,66.2177323264687,NaN,NaN,5.716833041855289,1.5260959698441092
2006-02-15T09:30:00-05:00,110.3,110.83,109.99001,110.7,9483801,8020054.75,63.04624572493199,53.22851481131959,NaN,NaN,177.44610919078775,108.80257715609969,0.24883940845762306,0.37347217474268746,0.1246327662850644,311715143,299067581.8,69.80191537549977,66.81444590721053,NaN,NaN,8.872010130103822,2.5755122784526394
2006-02-16T09:30:00-05:00,110.82001,111.28999,110.58,111.27,5659102,8073189.95,65.63879463246107,53.92739472230685,NaN,NaN,189.6563601890049,134.12396413958862,0.3141845999004058,0.5173635161605716,0.20317891626016585,317374245,304071382.8,73.31152880171362,67.17340922576554,NaN,NaN,12.346873492548417,3.9714210233234644
2006-02-17T09:30:00-05:00,111.03,111.23,110.67999,111.02,3941800,7439629.95,63.53346187443167,54.584858295973426,NaN,NaN,162.3868564582335,153.79610289852218,0.32086486470728204,0.6042599971442684,0.28339513243698633,313432445,306758703.4,74.9924783309599,67.38769752522968,NaN,NaN,14.573943922934285,5.486067151839296
2006-02-21T09:30:00-05:00,111.2,111.32001,110.39999,110.57001,9063602,7512970,59.81456095853982,55.3105179917751,NaN,NaN,132.29027946347117,164.87471326557437,0.27693068898962,0.6295584936740113,0.3526278046843913,304368843,309824403.6,76.78856715990324,67.59894618269641,NaN,NaN,15.369014786568508,6.8979168139434694
2006-02-22T09:30:00-05:00,110.78999,111.52,110.73,111.10001,5032102,7407185.05,62.59193886662793,55.665029094741556,NaN,NaN,135.75060772172975,159.50604260464542,0.2654849559118793,0.6844839995742404,0.4189990436623611,309400945,311258324.2,77.59897773720043,67.76295930036012,NaN,NaN,16.872233295307574,8.322819168424056
2006-02-23T09:30:00-05:00,111.10001,111.34,110.48,110.74001,9454398,7403604.95,59.57978927343365,56.392307305304186,NaN,NaN,101.73250747652477,144.3633222617928,0.21759953880191962,0.6909984671647607,0.47339892836284103,299946547,308904605,73.08807069179883,67.66321055348787,NaN,NaN,17.26041645283084,9.599618780482167
2006-02-24T09:30:00-05:00,110.57001,110.86,110.09,110.75999,5469898,7265379.95,59.69571691454754,57.33313077744755,NaN,NaN,72.79110699706162,120.99027162340414,0.17313814891898516,0.6898216145115725,0.5166834655925874,305416445,306513045,68.71704208074625,67.62472792787364,NaN,NaN,17.60874995206831,10.743780376423045
2006-02-27T09:30:00-05:00,110.78,111.33,110.75,110.85001,2547800,6996629.9,60.24889609607401,58.20850909100778,NaN,NaN,87.50836101318524,106.0145725343945,0.13722878480430567,0.6882194465979694,0.5509906617936637,307964245,305419405,66.75108835636247,67.61322735226881,NaN,NaN,18.04675572105635,11.787062568513516
2006-02-28T09:30:00-05:00,110.60001,110.75999,109.78,109.89999,6669602,7088965.1,52.1189331337992,58.72586698708575,NaN,NaN,32.570185969523266,86.07055383560494,0.04187639772918472,0.6033361589551447,0.56145976122596,301294643,304804565,65.61455693885134,67.82382315071686,NaN,NaN,16.102981406224533,12.403622402472232
2006-03-01T09:30:00-05:00,110.24001,110.74001,110.09,110.46001,4725801,7064010.25,55.89694741760274,59.018060974461314,NaN,NaN,45.23289455793887,67.96701120284675,0.010536585448086333,0.574630493036068,0.5640939075879816,306020444,304128464.8,64.31771415568579,68.26426731325377,NaN,NaN,15.508135916728477,12.847124333080266
2006-03-02T09:30:00-05:00,110.16,110.5,109.82001,110.38,5008801,6960980.4,55.226487810616696,59.16049872000549,NaN,NaN,29.88888562444059,53.59828683242991,-0.01990773471820284,0.5392092391902281,0.559116973908431,301011643,304341484,64.55541427621694,68.72023397678724,NaN,NaN,14.83165460482294,13.130628657614935
2006-03-03T09:30:00-05:00,109.87,111.05,109.81,110.07001,6315000,6909990.35,52.59433215230203,58.99583875784321,NaN,NaN,31.032628619688108,45.24659115695522,-0.06282624877596865,0.48058416293847017,0.5434104117144388,294696643,302197523.6,60.208162434534884,68.66742093765676,NaN,NaN,13.516586463334566,13.185765487003453
2006-03-06T09:30:00-05:00,110.14,110.37,109.28,109.63,5497602,6929400.55,49.02274451270295,58.617160276366334,NaN,NaN,-13.069984487663932,25.130922056785387,-0.11946786539340803,0.3940755799726787,0.5135434453660868,289199041,298444482.8,53.425753195311394,68.16772320255856,NaN,NaN,11.355794951036653,12.924341124722481
2006-03-07T09:30:00-05:00,109.36,109.91,109.3,109.85001,6272000,7070295.55,50.82106081289468,57.84499358435467,NaN,NaN,-28.930026749782037,12.830879512924321,-0.13934838379159747,0.33935796562658993,0.4787063494181874,295471041,297279762.4,51.48731506939635,67.18989890029863,NaN,NaN,10.018441244405858,12.509212570391535
2006-03-08T09:30:00-05:00,109.7,110.33,109.27,110.10001,6354801,6819850.65,52.856210648436964,57.117133936033596,NaN,NaN,-24.346850619534074,-1.0850695225702622,-0.13291409348953337,0.3125637325562707,0.44547782604580405,301825842,296440842,50.077924481573206,65.78104240787529,NaN,NaN,9.42635069653382,12.068803731269004
2006-03-09T09:30:00-05:00,110.17999,110.55,109.67999,109.71001,6042398,6858910.6,49.42037374674251,55.95867530133942,NaN,NaN,-28.823447740212778,-12.827536195500937,-0.15086385376499822,0.25689800883955627,0.4077618626045545,295783444,295395202.2,48.30311281709309,63.994726980402405,NaN,NaN,7.955866300498006,11.48124124115886
2006-03-10T09:30:00-05:00,109.99001,111.03999,109.87,110.85001,8351398,6883850.4,58.01218483754775,55.56429837013343,NaN,NaN,39.858828396792205,-11.062296240080116,-0.08517123357028905,0.3012978206416932,0.38646905421198224,304134842,297282842,51.63549213257259,62.32637082337474,NaN,NaN,9.187307074812102,11.15353636025218
2006-03-13T09:30:00-05:00,111.03999,111.31,110.67,111.00999,5690199,6786330.25,59.06310453497018,55.51062291130702,NaN,NaN,89.55456340513742,9.462613338480157,-0.03284536984650388,0.3454123419038524,0.3782577117503563,309825041,301408042,58.00617564613635,60.98477142953424,NaN,NaN,10.50544302207805,11.060951597655876
2006-03-14T09:30:00-05:00,110.82001,111.75999,110.75,111.62,4981699,6487640.2,62.878405666167495,55.531084825559844,NaN,NaN,139.12543401466687,43.073705491369935,0.03715418612731136,0.4247004444094955,0.38754625828218414,314806740,305275181.8,62.9350948318043,59.937351222005944,NaN,NaN,12.828140136243857,11.313407103168444
2006-03-15T09:30:00-05:00,111.69,112.42999,111.53999,112.33,5835199,6119850.15,66.76136766714984,56.04405471082533,NaN,NaN,212.13689371470187,90.37045435821713,0.12085822391362722,0.5386190381742182,0.417760814260591,320641939,309038401.2,66.9948707062066,59.50212265160654,NaN,NaN,16.09839340355469,11.996976574652194
2006-03-16T09:30:00-05:00,112.49001,112.96001,112.42999,112.77,6334801,5962400.15,68.93033075532108,56.70366998516629,NaN,NaN,234.7368581152704,143.08251552931375,0.19125783185477152,0.6568331040790554,0.46557527222428385,326976740,315277060.4,72.39332755106423,59.76471447091497,NaN,NaN,19.525498822300108,13.07247975288761
2006-03-17T09:30:00-05:00,112.62,112.81,112.45,112.7,5742801,5966585.1,68.16821492265265,57.269335615636194,NaN,NaN,189.13752878652718,172.93825560726074,0.21664509330720527,0.7363816388582904,0.5197365455510852,321233939,318696879.8,74.82423010088553,60.34136745266661,NaN,NaN,22.0579281183118,14.356115233662493
2006-03-20T09:30:00-05:00,112.72,113.00999,112.5,112.69,6847898,6111890,68.05245956766592,58.40744464662668,NaN,NaN,163.08906321554596,187.64515556934248,0.2158239276574122,0.7895164551228504,0.5736925274654382,314386041,319609079.8,75.44532680513286,61.04356530025815,NaN,NaN,24.083299153461343,15.7457129364909
2006-03-21T09:30:00-05:00,112.75,113.27,112.09,112.31,8857102,6101565,63.63070926943461,58.959856207471816,NaN,NaN,125.1062952741092,184.84132782123092,0.17451443250145193,0.7918355680922531,0.6173211355908012,305528939,317753519.6,71.57702988819366,61.56208785258014,NaN,NaN,24.603480244628777,17.011108266224884
2006-03-22T09:30:00-05:00,112.31,113.19,112.27,113.06,7281699,6214044.85,68.04402332389365,59.87539445842017,NaN,NaN,124.35232432378001,167.28441394304656,0.18170935521875298,0.8444578296142424,0.6627484743954895,312810638,316187259.4,68.3895268771972,61.83595303836445,NaN,NaN,26.39366791343632,18.35147393011223
2006-03-23T09:30:00-05:00,113,113.17999,112.25,112.78,6604699,6071559.9,64.878731173038,60.75285153132989,NaN,NaN,100.77563409758322,140.49216913950914,0.1527823915256329,0.8537264638025306,0.7009440722768977,306205939,312033099.2,60.67214026325207,61.86909431184425,NaN,NaN,26.96554332450501,19.582055272168343
2006-03-24T09:30:00-05:00,112.67,113.08,112.34,112.75,4651602,6030645.1,64.53235402625054,61.86068078229757,NaN,NaN,88.02755296468543,120.27017397514078,0.11833752244345941,0.848865975331222,0.7305284528877626,301554337,308097178.8,54.407615887721484,61.939227361302116,NaN,NaN,27.335188657221902,20.689645755747424
2006-03-27T09:30:00-05:00,112.53999,112.72,112.2,112.45,3460100,6076260.1,61.02377978841707,62.58944642340631,NaN,NaN,64.7425633538094,100.60087400279346,0.06473930973610742,0.8114525900578968,0.7467132803217894,298094237,304838818,49.82142156602397,61.82023496820408,NaN,NaN,26.67167631435263,21.544221549833882
2006-03-28T09:30:00-05:00,112.34,112.72,111.32001,111.42999,8467801,6166170.05,50.892295780243074,62.4491667899639,NaN,NaN,23.738393445098446,80.32729363699131,-0.044151050924271074,0.6915244666664506,0.7356755175907217,289626436,301658317.4,45.76616555501191,61.51225218773543,NaN,NaN,22.87247106199428,21.73397148014251
2006-03-29T09:30:00-05:00,111.63,112.36,111.48,111.97,7838699,6321814.95,55.138758389626986,62.85762283588422,NaN,NaN,26.81514304581877,60.819857381399075,-0.08233178501135452,0.6327607863265285,0.7150925713378831,297465135,298589216.8,42.19686837918118,61.07609187074171,NaN,NaN,20.92831527767604,21.618877736933015
2006-03-30T09:30:00-05:00,111.95,112.5,111.06,111.42,8894102,6516080,50.36207095161695,62.311186129746304,NaN,NaN,5.5345197009602956,41.77163450207448,-0.14356583880972307,0.5356352728257292,0.6792011116354523,288571033,295062235.6,38.48255311919733,60.1365962269292,NaN,NaN,17.737513887959118,21.064397187079603
2006-03-31T09:30:00-05:00,111.61,111.82001,110.97,111.31,6037000,6502180,49.4395858835436,61.623791940358686,NaN,NaN,-18.6840275782215,20.429318393493105,-0.18763228883472205,0.4446607505920497,0.6322930394267717,282534033,291258174.8,34.912993669922514,58.4870832286282,NaN,NaN,14.891246941978048,20.182518580636525
2006-04-03T09:30:00-04:00,111.64,112.39,111.25999,111.31,7856699,6620134.85,49.43958588354359,60.66387624159984,NaN,NaN,-5.69456774414468,6.341892173902289,-0.21118078631937032,0.36831705652755886,0.5794978428469292,282534033,288146134,32.27541684814538,56.29710622979542,NaN,NaN,12.598155456587282,19.099038134343775
2006-04-04T09:30:00-04:00,111.34,112.2,111.13,112,6192102,6616139.95,55.38476232066138,59.85126157399352,NaN,NaN,-4.851510785376794,0.6239113278072435,-0.1761190657366194,0.359349010676155,0.5354680764127744,288726135,287966073.8,32.12419747118906,53.80634385586559,NaN,NaN,12.294801470029087,18.127004325155962
2006-04-05T09:30:00-04:00,111.96001,112.47,111.59,112.36,7691898,6682994.8,58.149732532358435,59.081218843781905,NaN,NaN,21.238898732186254,-0.49133753491925913,-0.12681800735132764,0.37694556722361483,0.5037635745749425,296418033,287756653.4,31.936778894294577,50.916590380382054,NaN,NaN,12.865962464129218,17.375426916437856
2006-04-06T09:30:00-04:00,112.25,112.47,111.66,112.17,5248199,6643284.85,56.171140432082126,58.22428495159829,NaN,NaN,6.758103571128322,-0.24662076088565393,-0.10598712204822147,0.3712796720146656,0.4772667940628871,291169834,288276413.6,32.98183972431241,47.927848210626834,NaN,NaN,12.766714193919688,16.717039384649546
2006-04-07T09:30:00-04:00,112.46001,112.7,111.09,111.24001,7293801,6590405,47.62862195853748,56.765439408089115,NaN,NaN,-60.90969934924724,-8.691755115090801,-0.1510756460614192,0.2884222364861131,0.4394978825475323,283876033,288544813.6,33.5492447358162,44.935270919961354,NaN,NaN,9.969904123122225,15.753162918717072
2006-04-10T09:30:00-04:00,111.42999,111.84,111.17,111.50999,5947699,6603280,50.00563591471575,55.792219882752065,NaN,NaN,-93.57158156271251,-26.26715787880437,-0.1581939498207512,0.24175544527159332,0.3999493950923445,289823732,290002753.4,36.685047335020165,42.44298645187753,NaN,NaN,8.397418908425701,14.702342345818305
2006-04-11T09:30:00-04:00,111.72,111.86,110.50999,110.92999,7484398,6728414.95,45.25367690501546,54.16433799568934,NaN,NaN,-148.65436149042108,-55.02772801981323,-0.19502328376560918,0.15617029038533303,0.3511935741509422,282339334,288725393.2,35.121261162373116,40.066681757961526,NaN,NaN,5.534662756926859,13.392673833119527
2006-04-12T09:30:00-04:00,111.10001,111.45,111.02,111.28999,3721200,6622715,48.52348354396368,52.99610602218403,NaN,NaN,-110.00478577677696,-81.27646492160588,-0.18811115978801496,0.11605462441592351,0.30416578420393847,286060534,286653893.4,32.68776998015845,38.06779816631199,NaN,NaN,4.158413025209404,12.073493717703796
2006-04-13T09:30:00-04:00,111.17999,111.81,111.03999,111.28,4238500,6517899.95,48.43702811403265,51.84643988559703,NaN,NaN,-85.13603866634283,-99.65529336910011,-0.17732823640989748,0.0825054886915666,0.2598337251014641,281822034,284784333.4,30.625337439679114,36.36906399145182,NaN,NaN,3.0333622555135658,10.782046365962335
2006-04-17T09:30:00-04:00,111.31,111.62,110.36,110.83,5456801,6503599.95,44.58360094692656,50.67214139691914,NaN,NaN,-131.7395472922394,-113.82126295769854,-0.19236067295461678,0.019382883908193094,0.21174355686280988,276365233,283282173.4,29.039893302196845,34.88466911546417,NaN,NaN,0.9127253378279111,9.372143361943133
2006-04-18T09:30:00-04:00,111.03,112.78999,111.03,112.64,10870699,6704740,58.786084300527776,51.23598343408232,NaN,NaN,37.98280717471275,-87.51038521021349,-0.07811930269659478,0.11409442849206641,0.1922137311886612,287235932,282764613.4,28.492586146675862,33.65084201486873,NaN,NaN,3.8346228180134534,8.581068998524607
2006-04-19T09:30:00-04:00,112.82001,113.03999,112.35001,112.86,6003102,6562040,60.12381406021669,51.59205883912445,NaN,NaN,119.49031896883974,-33.88144911836132,0.009867628034394615,0.20454826623165445,0.19468063819725984,293239034,284944553.4,34.12417208379263,33.074220850912404,NaN,NaN,6.565102865465783,8.293073836659062
2006-04-20T09:30:00-04:00,112.91,113.88,112.84,113.49001,10126898,6704299.95,63.75221620139529,52.54849778553719,NaN,NaN,194.51892182904803,27.023292402803673,0.10292975442400415,0.32334283122726504,0.2204130768032609,303365932,288405633,41.94211643600117,33.32133251639839,NaN,NaN,10.089692925664236,8.549733706516944
2006-04-21T09:30:00-04:00,113.91,113.98,113.10001,113.39999,6997102,6723920.1,62.87190811306963,53.507949373360475,NaN,NaN,185.1536916247207,81.08123846101637,0.14810921447683,0.4055495948992984,0.2574403804224684,296368830,291314992.2,47.574351121677736,34.22571519152377,NaN,NaN,12.568776844403686,9.12388272621505
2006-04-24T09:30:00-04:00,113.25,113.47,112.92999,113.35001,5136102,6748145.1,62.35707429991439,54.430627117386955,NaN,NaN,144.2204358951378,136.27323509849182,0.1631260533597222,0.4613479471221211,0.29822189376239894,291232728,294288491.2,52.63211628417821,35.679765151240396,NaN,NaN,14.39083073642213,9.876303870530348
2006-04-25T09:30:00-04:00,113.44,113.47,112.5,112.84,8235398,6986910,57.209031592403754,54.560932065368554,NaN,NaN,100.61107177847018,148.7988880192433,0.1287205009733413,0.4591225199790756,0.3304020190057343,282997330,293440770.8,51.118003418021054,37.03646557601411,NaN,NaN,14.411311833989163,10.524162151024465
2006-04-26T09:30:00-04:00,112.97,113.69,112.91,113.39,6018801,6864460,60.95284730432824,54.761154549080686,NaN,NaN,122.52960117589717,149.40674446065478,0.13249552888293925,0.49602143010940836,0.3635259012264691,289016131,292596190.2,49.587436832973246,38.29722685734829,NaN,NaN,15.582599224470256,11.246796018659577
2006-04-27T09:30:00-04:00,112.89,114.10001,112.67999,113.77,14549000,7199975.05,63.3393818301951,55.273171791803044,NaN,NaN,119.84046020609075,134.47105213606332,0.14885252467991955,0.5495915570763685,0.400739032396449,303565131,292636030,49.66399962818657,39.48880970762502,NaN,NaN,17.29817185047923,12.111278280348099
2006-04-28T09:30:00-04:00,113.66,114.10001,113.39,113.88,4110301,6960785,64.0248305521439,56.444329548489215,NaN,NaN,122.14709887729344,121.86973358657788,0.1546681592028753,0.5940742314000431,0.4394060721971678,307675432,294897350.4,53.93995346833997,40.945288902805295,NaN,NaN,18.895631042206993,13.080471532042226
2006-05-01T09:30:00-04:00,113.95,114.21001,113.19,113.3,5649398,6941404.9,57.87982360860243,57.00677152662398,NaN,NaN,91.91436304203519,111.40851901595735,0.10918509947263533,0.575887446537962,0.46670234706532665,302026034,297056011.6,57.63929596761014,42.44202094799029,NaN,NaN,18.459543996792732,13.848910455578013
2006-05-02T09:30:00-04:00,113.72,114.2,113.53,114.14999,6042301,6850685,63.420715233755885,58.30441712153401,NaN,NaN,108.22636301663934,112.93157726359121,0.12494307530865478,0.6228811912011452,0.4979381158924904,308068335,302070212.6,64.72617014437635,44.55665730384766,NaN,NaN,19.8292834389756,14.70324945320624
2006-05-03T09:30:00-04:00,113.92999,114.07001,113.56,113.96001,4748398,6778499.8,61.47418564702928,59.22946727175297,NaN,NaN,91.14047168939275,106.65375136629032,0.11160646028695664,0.6374461912511862,0.5258397309642295,303319937,304930973.8,68.01404600823957,47.07996273442489,NaN,NaN,20.343037288748782,15.508933429712318
2006-05-04T09:30:00-04:00,114.14,114.63,114.14,114.33,4126699,6600239.85,63.804181065356545,60.3271210539904,NaN,NaN,114.25356266020253,105.53637185711268,0.11621465027802136,0.6711080438117563,0.5548933935337349,307446636,305707274.8,68.86221755327797,49.8111684568248,NaN,NaN,21.482018069796244,16.362231235438593
2006-05-05T09:30:00-04:00,114.86,115.83,114.7776,115.63,6889898,6682324.8,70.5448440663684,62.18149556252195,NaN,NaN,163.72163911247074,113.85127990414813,0.19091491629970703,0.7935370389083687,0.6026221226086617,314336534,307039495.2,70.31688743351486,52.75952518049037,NaN,NaN,24.85263728512766,17.575146385394174
2006-05-08T09:30:00-04:00,115.63,116,115.63,115.75,3502300,6492749.75,71.0802235406461,63.05964836538755,NaN,NaN,168.71104149909314,129.21061559555972,0.22989164926981653,0.8899866841959323,0.6600950349261158,317838834,310202055.2,73.48379580986695,55.97318301357545,NaN,NaN,27.669022503578905,19.017128687991992
2006-05-09T09:30:00-04:00,115.83,116.42,115.77,116.34,3953400,6393034.8,73.61912068341292,64.023598838473,NaN,NaN,176.0024204178882,142.76582707580948,0.27390467147806674,1.0024758742736992,0.7285712027956325,321792234,312946835,75.8882082300362,58.95632845259285,NaN,NaN,30.885606724577418,20.712625550361338
2006-05-10T09:30:00-04:00,116.25,116.8,116.03999,116.56,8292000,6433414.9,74.51747565487393,64.7925459422929,NaN,NaN,172.6161529098902,159.06096331990898,0.29453028709537166,1.096734061664847,0.8022037745694754,330084234,318299694.4,79.74549742417894,61.6565699517484,NaN,NaN,33.76979984698397,22.577936164164573
2006-05-11T09:30:00-04:00,116.46001,116.46001,114.85001,115.19,9635699,6729139.85,60.66364746915443,64.6348130391561,NaN,NaN,101.77129994309489,156.56451077648745,0.1972745209262159,1.0487969257272454,0.8515224048010295,320448535,320900074.2,81.30973862930861,64.06624048800775,NaN,NaN,31.709313605873323,23.882418655837252
2006-05-12T09:30:00-04:00,114.91,115.06,113.82001,113.87,9974000,7015914.85,50.853594241332424,63.81313589211454,NaN,NaN,19.57679278258039,127.73554151050939,0.03397255101847474,0.8939880935741229,0.8600155425556482,310474535,320127674.4,79.34946721318097,65.97462269722224,NaN,NaN,26.250449436379558,24.220708767343297
2006-05-15T09:30:00-04:00,113.52,114.42999,113.42,114.32001,7380102,7112079.9,53.60794575697743,63.55591547529837,NaN,NaN,-3.25126754135984,93.34307970241879,-0.049284867940563304,0.7984094576299441,0.8476943255705074,317854637,320130835,79.35166088084219,67.99131251599518,NaN,NaN,22.92813117640197,24.03605482578025
2006-05-16T09:30:00-04:00,114.39999,114.72,114,114.3,6972199,6917154.9,53.464462108189906,63.02103081843135,NaN,NaN,9.970565687884882,60.1367087564181,-0.1078906697716372,0.7128309883559609,0.8207216581275981,310882438,317948875.8,73.54341320817805,69.70245368565266,NaN,NaN,20.344300580845918,23.508661362218202
2006-05-17T09:30:00-04:00,113.7,113.84,111.92,111.99001,17248192,7479409.4,40.115830932023094,61.362205754276204,NaN,NaN,-124.33193993996254,0.7470901864475621,-0.2938683717233421,0.45338619347342046,0.7472545651967626,293634246,310658878.2,58.212422463082355,70.31305531671664,NaN,NaN,12.650897771105306,21.9575522777735
2006-05-18T09:30:00-04:00,112.47,112.67999,111.3,111.42,10613500,7503739.5,37.61982635855403,59.47613402616264,NaN,NaN,-166.05307345912846,-52.81778449399711,-0.43821981046492664,0.19947980211560434,0.637699612580531,283020746,303173320.4,47.30718734483444,69.83928630789481,NaN,NaN,5.762895556528956,19.64402988902428
2006-05-19T09:30:00-04:00,111.61,111.71001,110.63,111.47,22180496,8262909.2,37.984331139853154,58.05502742125198,NaN,NaN,-178.142975976303,-92.3617382457738,-0.5083471915784552,0.0022656231074620337,0.5106128146859172,305201242,302118661.8,45.999672833844464,69.00788465548298,NaN,NaN,0.6924241543037469,16.936657641207063
2006-05-22T09:30:00-04:00,110.71001,111.66,110.27,110.97,16605398,8836374,35.73557623816018,56.077517492995135,NaN,NaN,-172.1428883306135,-126.14006240362453,-0.5622172671537472,-0.19215876925626674,0.37005849789748047,288595844,296266903.2,39.4796145161852,67.20455925346933,NaN,NaN,-4.174097484429062,13.920835480401902
2006-05-23T09:30:00-04:00,111.62,111.94,110.35001,110.37,9677898,8908499,33.19584751846401,54.05763619809762,NaN,NaN,-155.8087514988091,-159.29592584096332,-0.608173979701353,-0.39015897672921085,0.21801500297214219,278917946,289874004.8,33.83695222028342,64.76333826861533,NaN,NaN,-9.03819656301529,10.64097375991373
2006-05-24T09:30:00-04:00,110.85001,111.57001,110.19,111.13,15392398,9377178.85,39.09991688288551,52.293045899349686,NaN,NaN,-130.5170212095966,-160.53294209489013,-0.5585834484861871,-0.4802143076355918,0.07836914085059538,294310344,290009224.4,34.05165693047549,62.27686965270086,NaN,NaN,-11.2299465684177,7.516556570152098
2006-05-25T09:30:00-04:00,111.56,112.09,111.28999,112.05,8585898,9079023.75,45.39159379032737,50.49638516534675,NaN,NaN,-79.78720409926476,-143.2797682229174,-0.4402214226492659,-0.47190763746098696,-0.03168621481172108,302896242,293984323.6,40.1956645531588,60.125353732675435,NaN,NaN,-11.007231953567095,4.870301066763642
2006-05-26T09:30:00-04:00,112.44,112.81,111.64999,112.78,5280699,9137543.65,49.82141926857345,48.977899145913,NaN,NaN,-47.74353559696096,-117.199880147049,-0.2960814917425238,-0.4017880794898758,-0.10570658774735203,308176941,294579463.4,41.08070095904255,57.81084695761655,NaN,NaN,-9.346370605301509,2.839347970754335
2006-05-30T09:30:00-04:00,112.28999,112.38,110.8,110.83,8300301,9270088.8,40.39492239338516,46.60474212519673,NaN,NaN,-82.96272391794422,-99.36384726451513,-0.313697032117634,-0.49782787789439453,-0.18413084577676053,299876640,296835622.6,44.437648207334966,55.56437838456646,NaN,NaN,-11.23298864634021,0.8290141683122574
2006-05-31T09:30:00-04:00,111.25,111.81,110.8,111.73,7135699,9324758.7,45.518527514143955,44.53338868657316,NaN,NaN,-70.54206731926455,-82.31051042860622,-0.24917901156228747,-0.4956046102296199,-0.2464255986673324,307012339,302454501.2,51.802677065536905,53.56846264466346,NaN,NaN,-10.907978183531835,-0.8476990248083272
2006-06-01T09:30:00-04:00,111.59,112.66,111.47,112.39999,5982199,9386448.75,49.03097026268744,43.70248317182552,NaN,NaN,-38.89137656958916,-63.98538150060473,-0.15067417893932072,-0.4347683223414833,-0.2840941434021626,312994538,306191340,55.981627431402494,51.75931184481302,NaN,NaN,-9.421020350967266,-2.072459214259604
2006-06-02T09:30:00-04:00,112.75999,112.85001,111.88,112.36,6554500,9507838.8,48.8286205280405,43.55784219230467,NaN,NaN,-28.592351654860582,-53.746411011723886,-0.08099670506918105,-0.38534002473863893,-0.3043433196694579,306440038,306900099.2,56.74763521493742,50.14489527350991,NaN,NaN,-8.34485570695153,-2.9685158560727363
2006-06-05T09:30:00-04:00,112.16,112.22,110.39999,110.69,9940602,9660374,41.18467556768318,42.670465750212216,NaN,NaN,-72.48910341714216,-58.69552457576013,-0.1368790918280286,-0.4754421844544936,-0.338563092626465,296499436,304564598.2,53.44706415933985,48.29456693625975,NaN,NaN,-10.00025621162706,-3.9730501925804966
2006-06-06T09:30:00-04:00,110.78,110.94,109.21001,109.99001,15140199,10242268.95,38.466451409092386,41.59917927170526,NaN,NaN,-111.87091228411329,-64.47716224899395,-0.20631477245738694,-0.5964565581981986,-0.3901417857408117,281359237,300861117.6,48.618099810127504,46.514187407827556,NaN,NaN,-12.256561771391912,-5.156408989553556
2006-06-07T09:30:00-04:00,110.12,110.73,109.14,109.19,9064801,10497839,35.57643499921909,41.2749367050764,NaN,NaN,-125.08058306428123,-75.38486539799729,-0.2865182716336542,-0.7482896252828795,-0.4617713536492253,272294436,293917537,41.11722332819306,45.293101755335464,NaN,NaN,-15.0776326066665,-6.573726649141119
2006-06-08T09:30:00-04:00,109.12,109.67,107.52,109,26005104,11383494.2,34.90569024617561,41.081069839906505,NaN,NaN,-167.12553596154558,-101.03169727638856,-0.3296839847078451,-0.8738763345340317,-0.5441923498261866,246289332,280576495.8,31.1675707782548,44.14027200057978,NaN,NaN,-17.514057505012126,-8.136631057122692
2006-06-09T09:30:00-04:00,109.42999,109.75,108.67999,108.83,7298102,11266614.35,34.282885055093345,40.81668083385223,NaN,NaN,-141.2532825433858,-123.56388345409361,-0.3453445432213953,-0.9758730288529307,-0.6305284856315354,238991230,267086734.2,24.667613478203734,42.61655347517687,NaN,NaN,-19.660527862296053,-9.782902029290314
2006-06-12T09:30:00-04:00,109.19,109.25999,107.85001,107.95,9054301,11220629.4,31.18139775807596,40.49138237098907,NaN,NaN,-167.44154527131937,-142.55437182492906,-0.3874678826051149,-1.114863338887929,-0.7273954562828141,229936929,253774232.8,20.192216042211868,41.23888215560735,NaN,NaN,-22.474178092088763,-11.595941466832949
2006-06-13T09:30:00-04:00,107.97,108.69,106.96001,106.97,13086199,11505934.25,28.12941908495239,40.12949462573824,NaN,NaN,-184.76963476634705,-157.1341163213758,-0.44946805401360135,-1.2892305237998158,-0.8397624697862145,216850730,240872531.4,16.97745270703112,40.034632190375035,NaN,NaN,-25.878447205587303,-13.636299429512142
2006-06-14T09:30:00-04:00,107.14999,108.36,106.95,108.33,10352699,11674959.25,37.30099711839325,40.00100035684594,NaN,NaN,-140.28048812898643,-160.17409733431685,-0.3703187252748601,-1.3026608763797896,-0.9323421511049295,227203429,231854330,15.160527829521826,38.6852658260212,NaN,NaN,-25.89325806325752,-15.387293520047196
2006-06-15T09:30:00-04:00,108.55,110.46001,108.46001,110.35001,11215102,11373304.75,47.92974101013333,40.18229658683208,NaN,NaN,-37.81503792110158,-134.31199772622804,-0.16388443538564013,-1.1371976953369796,-0.9733132599513394,238418531,230280169.8,14.861547809860511,36.87568605864275,NaN,NaN,-22.10672479370833,-16.34721227342736
2006-06-16T09:30:00-04:00,109.92,110.38,109.71001,109.98,5752199,11130239.7,46.378833997234096,39.936397638879264,NaN,NaN,-19.781330671535212,-110.01760735185792,-0.04064399145809161,-1.024118249273954,-0.9834742578158624,232666332,229015190.2,14.612167724015919,34.985076541855136,NaN,NaN,-19.67276105080559,-16.822290670195677
2006-06-19T09:30:00-04:00,110.3,110.44,108.96001,109.17,7078801,10375154.95,43.09160760827241,40.129018011371215,NaN,NaN,-41.939443842673164,-84.91718706612866,-0.003994804187727907,-0.9884677630505223,-0.9844729588627944,225587531,228145310.6,14.432814550274017,32.84187413777936,NaN,NaN,-18.748993722460867,-17.097533963376417
2006-06-20T09:30:00-04:00,109.47,110.23,109.27,109.86,7216699,9905720,46.56598020513876,40.203836060727994,NaN,NaN,-24.900396596276426,-52.943339432114556,0.07219505069801824,-0.8942291454902715,-0.9664241961882898,232804230,231336010.6,18.389677612749452,30.455231319723108,NaN,NaN,-16.863773699658033,-17.064139639988078
2006-06-21T09:30:00-04:00,109.7,111.25,109.69,110.71001,9160602,9879855.2,50.56960851356242,40.31373879293334,NaN,NaN,17.68967557158753,-21.349306691999757,0.1792211491875415,-0.7423977597038629,-0.9216189088914044,241964832,234288291.2,21.98452829554644,28.026867095733387,NaN,NaN,-13.993216232637456,-16.625436296080846
2006-06-22T09:30:00-04:00,110.59,110.67,109.78999,110.2,5100500,9365260.3,48.23436687051517,40.271292103110106,NaN,NaN,1.6148993638748304,-13.463319235004482,0.2127625424385322,-0.6556657308432392,-0.8684282732817714,236864332,233977451.4,21.87527039174178,25.535983894076555,NaN,NaN,-12.37078083299075,-16.017628372782262
2006-06-23T09:30:00-04:00,110.00999,110.69,109.66,109.97,6714000,9271665.4,47.17633139811096,40.69926751956924,NaN,NaN,0.010276444348268203,-9.504997811827785,0.21587150599651128,-0.5985888907861323,-0.8144603967826436,230150332,233474251.4,21.68736845129321,23.26743420064465,NaN,NaN,-11.371485290770147,-15.35389364678053
2006-06-26T09:30:00-04:00,109.94,110.45,109.64999,110.39999,4299500,9222605.45,49.41051621905654,41.48098643456668,NaN,NaN,11.973469735336966,1.2775849037742468,0.241370040304566,-0.5127478464019362,-0.7541178867065021,234449832,235246711.6,24.158551946009297,21.52032363892192,NaN,NaN,-9.884111347047247,-14.57249617539006
2006-06-27T09:30:00-04:00,110.41,110.59,109.14,109.25999,6514898,9133335.3,44.08663160189855,42.08885762047235,NaN,NaN,-18.111055932077644,2.6354530366140034,0.17882202333484487,-0.530590357537946,-0.7094123808727909,227934934,234272852.4,23.715745113371412,20.277360909291804,NaN,NaN,-10.168503530304143,-13.943354368949215
2006-06-28T09:30:00-04:00,109.44,109.84,108.97,109.82001,3983900,8975745.35,47.10194407397735,42.96001860817248,NaN,NaN,-21.539240353709772,-5.210330148445457,0.17245073745476658,-0.4938489590543327,-0.6662996965090993,231918834,232263652.8,22.78772789482555,19.678800703332566,NaN,NaN,-9.506053214844966,-13.30945420407718
2006-06-29T09:30:00-04:00,110.23,111.87,110.13,111.8,8166000,9084935.4,56.11336185318638,44.519338379464834,NaN,NaN,125.75790322908065,19.61827062459571,0.29185004960874006,-0.3014871344981742,-0.5933371841069143,240084834,232907753.2,23.816911839621213,19.618036300576673,NaN,NaN,-5.906963408889579,-12.25195551905038
2006-06-30T09:30:00-04:00,112.22,112.28,111.59,111.78999,3904600,8952440.4,56.06136550432794,46.29647893276855,NaN,NaN,185.16240025075908,56.64869538587787,0.35615849049253234,-0.1481390709912489,-0.5042975614837812,236180234,234113733.6,25.810880154911047,20.019369451483755,NaN,NaN,-3.112889528212891,-10.946374663216453
2006-07-03T09:30:00-04:00,111.95,112.25,111.86,112.2,1052200,8508020.3,57.78680539740819,48.41486366937254,NaN,NaN,187.45099957148983,91.74420135310844,0.4085588237293448,0.006400968177899813,-0.402157855551445,237232434,234670254,26.763485186305715,20.71837177143194,NaN,NaN,-0.2879326551409032,-9.423740090634231
2006-07-05T09:30:00-04:00,111.73,111.85001,111.17999,111.47,3459400,7923980.35,53.74041839836248,49.589108046513196,NaN,NaN,120.76804494643805,119.52002152881157,0.3770645106046753,0.06917278270439908,-0.3078917279002762,233773034,235837874,28.828318502197234,21.694642533765894,NaN,NaN,0.9249745925668594,-7.945352278748361
2006-07-06T09:30:00-04:00,111.64999,112.56,111.63,112.19,9407000,7941090.3,56.94283948087002,50.23290079442296,NaN,NaN,141.78571479935266,152.18501255942405,0.3863138486295437,0.17500058288665343,-0.21131326574289028,243180034,238090114,32.76603015109795,22.97353412956857,NaN,NaN,2.9205375917905307,-6.393082297242805
2006-07-07T09:30:00-04:00,111.64999,112.39999,110.69,110.96001,7183000,6999985.1,50.509932239704064,50.52797924031366,NaN,NaN,81.27937700232827,143.2893073140736,0.29529135860409694,0.15780093251223093,-0.137490426091866,235997034,237272554,32.07235336182343,24.22069024655482,NaN,NaN,2.6838823754607817,-5.09637305828515
2006-07-10T09:30:00-04:00,111.34,111.78,110.89999,111.14999,4375500,6853855,51.42276650404495,51.12306201858314,NaN,NaN,68.26155561537874,119.90913838699753,0.23613811803309703,0.15768222144950528,-0.07845589658359176,240372534,238111014,33.62434561590739,25.591513894100064,NaN,NaN,2.763088720540148,-3.97359280416725
2006-07-11T09:30:00-04:00,110.85001,111.53,110.28999,111.47,5236102,6662945.05,52.99549486919435,51.58231306601568,NaN,NaN,49.33654462645136,92.28624739798983,0.207820820516395,0.18132012906190198,-0.026500691454493006,245608636,239786254.4,36.7345508564946,26.901861982939003,NaN,NaN,3.2809360110201093,-2.93723154485477
2006-07-12T09:30:00-04:00,111.34,111.52,109.98,110.33,4850199,6251145.05,47.1403250024976,51.33736424379676,NaN,NaN,6.875953931183496,69.50782919493892,0.10666724120437066,0.10683336005097033,0.0001661188465996652,240758437,241183335,39.28944800840851,28.137927676714867,NaN,NaN,1.9728361898498703,-2.2357932970398213
2006-07-13T09:30:00-04:00,109.75999,109.78999,108.25999,108.3,16123699,6539695.05,38.89872107048405,50.6705324009374,NaN,NaN,-146.5572306163908,11.839240111790213,-0.09187690770478935,-0.11468001578438702,-0.022803108079597675,224634738,237474275.8,35.22262281613098,29.09130999274267,NaN,NaN,-2.0303164158497795,-2.2064394568698154
2006-07-14T09:30:00-04:00,108.42999,108.59,107.00999,107.32001,8206602,6389270.05,35.65769364320262,49.84777256130109,NaN,NaN,-205.43715031253421,-45.50406535118229,-0.273836975261465,-0.3650993271564289,-0.09126235189496393,216428136,233560496.2,31.515621522066482,29.793328069226476,NaN,NaN,-6.459607010783638,-2.814034821714647
2006-07-17T09:30:00-04:00,107.38,108.07001,107.17,107.52,8335301,6518425.15,36.81469741024019,48.94807121781421,NaN,NaN,-176.90631962297672,-94.53764039885337,-0.35993611768765654,-0.5411824990045346,-0.1812463813168781,224763437,230438676.8,28.902649304399816,30.132192166254367,NaN,NaN,-9.594516879359913,-3.7826751156639706
2006-07-18T09:30:00-04:00,107.75,108.24001,106.89,108.19,11284898,6728730,40.6642128225534,48.70361273357527,NaN,NaN,-146.89557959204802,-133.78406524255325,-0.3506227226679842,-0.6195247846518583,-0.2689020619838741,236048335,228526616.6,27.40399565464611,30.39563863348828,NaN,NaN,-11.025206729716515,-4.817322489100048
2006-07-19T09:30:00-04:00,108.44,110.44,108.10001,110.03999,11505199,6943155,49.764941503061884,48.89382683565274,NaN,NaN,-41.72641960842735,-143.50453995047542,-0.20589147594500234,-0.526266406915127,-0.3203749309701247,247553534,229885636,30.17528315936329,30.923321152383828,NaN,NaN,-9.288610970776231,-5.45607798648236
2006-07-20T09:30:00-04:00,110.3,110.45,109.24001,109.42,7766699,6873459.85,47.15467869267034,48.25392089561587,NaN,NaN,-28.659748361527495,-119.92504349950275,-0.14102907931950914,-0.49666128011951116,-0.355632200800002,239786835,232916055.4,36.03866465843866,31.796303496585075,NaN,NaN,-8.722675405690776,-5.922734760654991
2006-07-21T09:30:00-04:00,109.60001,109.61,108.28999,108.56,9160500,7076459.85,43.72839934601789,47.372994741450874,NaN,NaN,-71.87475788501531,-93.21256501399898,-0.1446225683233595,-0.5364104112042014,-0.3917878428808419,230626335,235755695.2,41.03528522893041,32.88376100187217,NaN,NaN,-9.35119201888516,-6.412514368973587
2006-07-24T09:30:00-04:00,109,110.60001,109,110.5,9628102,7222164.95,52.171016427691725,46.97186695789969,NaN,NaN,-4.908592855278318,-58.813019660459304,-0.01191542082046021,-0.40668211890641714,-0.39476669808595694,240254437,238853895.2,45.992563430991005,34.257266590778265,NaN,NaN,-7.011074009495824,-6.498022889048192
2006-07-25T09:30:00-04:00,110.27,111.25999,109.89,110.78999,8120801,7413230,53.298942190306946,46.940332943038584,NaN,NaN,26.88331157497868,-24.057241427053963,0.09399297128099787,-0.2772754839847096,-0.37126845526570745,248375238,241319275.8,49.622093620101616,35.74253624205715,NaN,NaN,-4.809901789076965,-6.256862731909445
2006-07-26T09:30:00-04:00,110.8,111.48,110.39,110.91,6205199,7397745.05,53.78467171684951,46.71474953132283,NaN,NaN,38.28355025216952,-8.055247454934584,0.16649057426561809,-0.16315523743368487,-0.32964581169930296,254580437,242724656.4,51.61815520321017,37.08911660292231,NaN,NaN,-2.9176950230818006,-5.779838773505496
2006-07-27T09:30:00-04:00,111.35001,111.78,110.78,111.27,9135398,7655319.95,55.287021757797866,47.05597021118667,NaN,NaN,52.238892159731336,8.124480649317187,0.22918263320454624,-0.043167520193620135,-0.2723501533981664,263715835,247510456.4,57.75634832987555,38.92368767206889,NaN,NaN,-0.9151984105215947,-5.084890150222082
2006-07-28T09:30:00-04:00,111.46001,112.33,111.14999,112.07001,11306000,7812319.95,58.5144703141999,47.5625204833406,NaN,NaN,79.75765025455848,38.450962277231945,0.3100004024537625,0.1151503496690367,-0.19485005278472575,275021835,256389556.4,66.29911454552494,41.25759973847015,NaN,NaN,1.7700899026564247,-4.105607285525152
2006-07-31T09:30:00-04:00,111.8,112.05,111.66,111.89999,3906800,7812429.95,57.56351024915891,47.8888072961952,NaN,NaN,80.88998499212784,55.61067784671318,0.33533081270615744,0.22431346309797107,-0.11101734960818638,271115035,262561676,70.7301713516942,43.68585834527011,NaN,NaN,3.7031196696155058,-2.990074863362201
2006-08-01T09:30:00-04:00,111.5,111.52,110.75,111.22,5439000,8031769.95,53.79776908838304,48.364339016615595,NaN,NaN,47.762995420342335,59.786614615785915,0.29124557857647637,0.25303962361240906,-0.038205954964067285,265676035,266021835.4,72.88274577221165,46.085379614113194,NaN,NaN,4.305724190711512,-1.947817855637385
2006-08-02T09:30:00-04:00,111.55,112.2,111.44,111.98,3929900,8055294.95,57.17021389678043,49.66944564706534,NaN,NaN,84.04417700759801,68.93873996687162,0.2971959743073717,0.33328901292014734,0.036093038612775644,269605935,269026935,74.6279302435406,48.900044430356736,NaN,NaN,5.803135862351787,-0.8405387530675035
2006-08-03T09:30:00-04:00,111.42999,112.66,111.27,112.59,6181102,7894000.05,59.71210756690723,51.3876180701871,NaN,NaN,99.76238360135802,78.44343825519695,0.32394578459222934,0.4410252693530623,0.11707948476083298,275787037,271441175.4,75.96614376026963,52.07508173308554,NaN,NaN,7.820606216395605,0.396767671141512
2006-08-04T09:30:00-04:00,113.14,113.37,111.82001,112.48,7698000,7919750.05,59.031738467402,52.974549574270085,NaN,NaN,112.61473951029349,85.01485610634396,0.3156429397914762,0.5116331595001782,0.195990219708702,268089037,270054615.8,73.56625626195508,55.26533937291091,NaN,NaN,9.295447527843177,1.668007650670321
2006-08-07T09:30:00-04:00,112.14,112.42,111.85001,112.34,3623200,7882135.05,58.12400623815109,54.22167767538421,NaN,NaN,89.57897118394246,86.75265334470689,0.28317107468777963,0.5499540630684265,0.2667829883806469,264465837,268724776.2,71.24164600379333,58.396600112135715,NaN,NaN,10.289060702563432,2.8995866580836225
2006-08-08T09:30:00-04:00,112.47,112.75999,111.14999,111.84,9064898,8073574.85,54.87836863131433,54.58692247025938,NaN,NaN,71.49777773086379,91.49960980681116,0.21363300158269055,0.5338242403590101,0.32019123877631955,255400939,266669757,67.68247362044153,61.075685145069876,NaN,NaN,10.28680510721545,3.9549035793881693
2006-08-09T09:30:00-04:00,112.39999,112.50999,110.72,110.95,8368699,8249499.85,49.572130279828286,54.75959758362781,NaN,NaN,43.152526930305214,83.32127979135261,0.09913204637948458,0.44410629675067526,0.34497425037119067,247032240,262155018,60.5280712578503,62.82492847359928,NaN,NaN,8.789600144857227,4.64557451731232
2006-08-10T09:30:00-04:00,110.85001,111.53,110.5,111.3,7656398,7826134.8,51.55589086223861,55.31870412050072,NaN,NaN,25.781316741095836,68.52506641930017,0.041359518176423915,0.39667364809172057,0.35531412991529665,254688638,257935338.2,54.707379725991686,63.80150665196079,NaN,NaN,8.058116107266079,5.133080458734286
2006-08-11T09:30:00-04:00,111.06,111.14999,110.55,111.05,5274898,7679549.6,50.04160958623895,55.16660363182552,NaN,NaN,8.910796215299955,47.78427776030147,-0.016213064600933413,0.33504779916412986,0.35126086376506327,249413740,254200278.8,50.11354298628278,64.09586233448164,NaN,NaN,7.026022972204261,5.403500817801425
2006-08-14T09:30:00-04:00,111.62,112.13,110.89,111.14999,7949500,7660259.55,50.6657439337417,54.97851804207085,NaN,NaN,31.090064493099085,36.086496422132775,-0.04826977852231973,0.2909236406121636,0.3391934191344833,257363240,252779759.4,48.44731770573799,64.01194976916995,NaN,NaN,6.319153121222179,5.534308289718676
2006-08-15T09:30:00-04:00,112.07001,112.45,111.73,112.25999,4697398,7330884.55,57.07658495679637,55.21365470206706,NaN,NaN,83.84903634274504,38.55674814450903,0.0019133209673484752,0.3415850703436689,0.33967174937632044,262060638,254111699.2,50.12191540171634,63.905075497634684,NaN,NaN,7.4588282312515215,5.809239709937654
2006-08-16T09:30:00-04:00,112.75,113.55,112.67999,113.41,6681602,7089704.7,62.511883089987364,55.72971622579488,NaN,NaN,161.88282709384586,62.30280817721715,0.1035610451380774,0.4691230557989172,0.3655620106608398,268742240,258453699.2,55.22765826318366,63.72445477858526,NaN,NaN,10.149288251785858,6.429246644487398
2006-08-17T09:30:00-04:00,113.3,113.88,113.19,113.46001,5960000,6999369.75,62.73288437804557,56.03103151606957,NaN,NaN,167.17145565669682,90.58083596033735,0.16170179058794798,0.5676892488957748,0.4059874583078268,274702240,262456419.6,59.35789964847064,63.22865371450995,NaN,NaN,12.391541554811761,7.281003060248021
2006-08-18T09:30:00-04:00,113.45,113.8,113.08,113.8,3983800,6740534.75,64.2748313526409,56.51041159488971,NaN,NaN,163.7165018894183,121.54197709516102,0.2076626657605119,0.6655657905084666,0.45790312474795475,278686040,268310879.6,64.5141822690475,62.78465449432091,NaN,NaN,14.729566973328389,8.345083619259501
2006-08-21T09:30:00-04:00,113.42999,113.56,113.10001,113.5,5056000,6511929.65,61.84332028219731,57.08509382301931,NaN,NaN,134.19216684828265,142.16239756619774,0.2022641172954901,0.7107332713673173,0.5084691540718272,273630040,271564239.6,67.01834730097312,62.365768889232434,NaN,NaN,16.044070108024744,9.44493883194025
2006-08-22T09:30:00-04:00,113.28,113.75,112.92999,113.28999,3930900,6302434.6,60.12849820604105,57.296399845109356,NaN,NaN,113.1043892837597,148.01346815440067,0.17023942865283026,0.721268439887865,0.5510290112350348,269699140,273091940,68.15477852048664,61.903400909014294,NaN,NaN,16.69274092830927,10.48033913142154
2006-08-23T09:30:00-04:00,113.28,113.62,112.58,113.11,7033699,6343859.6,58.6280372190827,57.21896624883617,NaN,NaN,82.98998344503109,132.23489942463772,0.12473257445183994,0.7069447292998348,0.5822121548479948,262665441,271876580.2,66.2005135018762,61.20585589055762,NaN,NaN,16.846387660158097,11.389774635526761
2006-08-24T09:30:00-04:00,113.2,113.34,112.67,112.8,4049000,6089539.7,56.03446936357892,57.004875598563096,NaN,NaN,59.56593983330223,110.7137962599588,0.06457967932463993,0.6629367540037947,0.5983570746791548,258616441,268659420.4,61.1981218507489,60.32241771832861,NaN,NaN,16.292079973275637,12.090103969490887
2006-08-25T09:30:00-04:00,112.73,113.14999,112.52,112.84,3559800,5702229.7,56.30308175912111,56.87480956434666,NaN,NaN,45.32743963944705,87.03598380996456,0.02058923583024541,0.6240936194669615,0.6035043836367161,262176241,265357460.6,56.480744906304096,59.26806763993652,NaN,NaN,15.892069975350772,12.633241970328013
2006-08-28T09:30:00-04:00,112.74001,113.87,112.73,113.44,3875800,5700679.7,60.228300162052356,57.25694753082796,NaN,NaN,81.24553200268446,76.44665684084492,0.024726120343986357,0.634412034066699,0.6096859137227126,266052041,263841860.8,54.4076467318758,58.31986571932468,NaN,NaN,16.564052395001088,13.194786316709882
2006-08-29T09:30:00-04:00,113.46001,113.75999,112.92999,113.50999,4967000,5677079.7,60.6720960200502,58.049802226558086,NaN,NaN,78.57418108245572,69.54061520058413,0.02493106352000163,0.6408497431227147,0.6159186796027131,271019041,264105841,54.71939437432654,57.9049602276444,NaN,NaN,17.24650316169263,13.773603008850275
2006-08-30T09:30:00-04:00,113.75,114.07001,113.56,113.75999,4297199,5695444.65,62.29072021499603,58.81657575175505,NaN,NaN,102.75756747895262,73.49413200736845,0.034091793306959994,0.6585334212364131,0.6244416279294531,275316240,266636000.8,57.70454436679825,58.11904341627344,NaN,NaN,18.259616523485462,14.414462082369587
2006-08-31T09:30:00-04:00,113.86,114.08,113.67999,113.81,3894800,5581129.55,62.62212695816931,59.71518413546436,NaN,NaN,97.67056284335857,81.1150566093797,0.03554501936653498,0.6688729021376218,0.6333278827710869,279211040,270754920.6,62.08649910485809,58.974254567600255,NaN,NaN,19.20583551554649,15.098944001394859
2006-09-01T09:30:00-04:00,114.21001,114.77,113.95,114.7,4494398,5420949.45,68.01029544519304,60.95408067199661,NaN,NaN,132.56643981006027,98.56285664350237,0.08561633603860419,0.740348302819342,0.6547319667807379,283705438,275060760,66.04668470972899,60.231352210742465,NaN,NaN,21.60984745720874,16.029073066511128
2006-09-05T09:30:00-04:00,114.62,114.89999,114.38,114.73,5085500,5494064.45,68.17682297849879,61.74695481640392,NaN,NaN,134.68327644737806,109.25040553244108,0.1084573810273406,0.7903036930649137,0.6818463120375731,288790938,279608539.4,69.65225765644408,61.62637665750873,NaN,NaN,23.65710064066136,17.118791291389734
2006-09-06T09:30:00-04:00,114.27,114.44,113.97,114.14,4347602,5258199.65,61.406553109484875,61.66800267493945,NaN,NaN,91.02973310062106,111.74151593607414,0.07321950606465588,0.7733706946183929,0.700151188553737,284443336,282293398.4,71.5715952359418,62.793800726991456,NaN,NaN,23.639806482780795,18.050364890159884
2006-09-07T09:30:00-04:00,113.67999,113.95,113.23,113.56,7050000,5192264.7,55.564965001805824,61.15600843377947,NaN,NaN,39.2784118872625,99.04568481773613,0.003897411458532174,0.7050229528769023,0.7011255414183701,277393336,282708817.6,71.86806090732935,63.687383674052796,NaN,NaN,21.920794573745237,18.60328341638636
2006-09-08T09:30:00-04:00,113.61,114.05,113.49001,113.87,3220000,4970444.8,57.87175451004879,60.69864580216575,NaN,NaN,55.74531946061929,90.66063614118828,-0.02636519514182345,0.6681690474910909,0.6945342426329143,280613336,282989276.8,72.07975510499091,64.22778173376304,NaN,NaN,21.107778612189108,18.961068444358183
2006-09-11T09:30:00-04:00,113.64999,114.25,113.42,113.96001,5681398,4990769.8,58.544694461564426,60.463029672120534,NaN,NaN,59.5832020049257,76.06398858016136,-0.04453881177399999,0.6388607279154144,0.6833995396894144,286294734,283507136,72.4913829376559,64.61871285066896,NaN,NaN,20.617061483614208,19.197638878537614
2006-09-12T09:30:00-04:00,114.10001,115.17999,114,114.98,9111602,5048874.9,65.30751919518316,60.83295974277355,NaN,NaN,161.14691818421426,81.35671692752857,0.005268071276023689,0.689984628784444,0.6847165575084203,295406336,284830215.6,73.56375202579788,65.00506810104832,NaN,NaN,22.215007014557898,19.628691469397655
2006-09-13T09:30:00-04:00,114.86,115.78999,114.85001,115.47,4673898,5047699.9,68.00761674771468,61.50292970910441,NaN,NaN,215.32189973862486,106.21515025512933,0.06123812476746715,0.7612642134677543,0.7000260887002872,300080234,287957595.2,75.95027166631013,65.70147939850789,NaN,NaN,24.42156680219876,20.313387945512098
2006-09-14T09:30:00-04:00,115.28,115.59,115.06,115.50999,4182000,4922719.8,68.2249719546377,62.373679894180036,NaN,NaN,179.38179672781177,134.23582722323917,0.08927893043287172,0.8116247517413768,0.7223458213085051,304262234,293331374.8,79.39273611019732,67.00109470275422,NaN,NaN,26.26159574470554,21.163131916825446
2006-09-15T09:30:00-04:00,115.84,116.03,115.45,115.59,7672102,5008324.9,68.68340460965082,63.257988669217866,NaN,NaN,170.66550937387757,157.21986520589084,0.10069477743639044,0.8482142931039931,0.7475195156676027,311934336,299595574.8,82.53166359956754,68.86187460941589,NaN,NaN,27.907942791324054,22.126676327468104
2006-09-18T09:30:00-04:00,115.39,115.78999,115.13,115.52,7036801,5160974.95,67.76228485275277,63.79613043283933,NaN,NaN,126.38034427512588,170.57929365993087,0.09128919335038488,0.8616310073555837,0.7703418140051989,304897535,303316135,84.08249097873876,70.98150634133466,NaN,NaN,29.032502693373303,23.113222951168847
2006-09-19T09:30:00-04:00,115.55,115.56,114.67999,115.34,8697699,5343059.9,65.33581583974754,64.12925327710342,NaN,NaN,89.00645390358473,156.15120080380498,0.06209818633788633,0.8479645469275567,0.7858663605896704,296199836,303474835,84.14714160961387,73.08348828671234,NaN,NaN,29.348758895508393,24.004013800360212
2006-09-20T09:30:00-04:00,115.67999,116.21001,115.63,116.08,8912898,5592159.8,70.07934620691624,64.68558370509773,NaN,NaN,134.05312675108274,139.89744620629654,0.08060701675027115,0.8866251315275093,0.8060181147772382,305112734,304481335,84.57504248492769,75.00280958086445,NaN,NaN,31.015737690563117,25.00568864181777
2006-09-21T09:30:00-04:00,116.09,116.22,114.95,115.37,8600699,5670509.8,61.398014662315525,64.59814711253674,NaN,NaN,87.73745142484994,121.56857714570417,0.03532358545463132,0.8501725965955274,0.814849011140896,296512035,302931295.2,80.95117342673018,76.35028631814102,NaN,NaN,29.844862538299193,25.696999198457974
2006-09-22T09:30:00-04:00,115.25999,115.25999,114.67,115.00999,5825398,5759329.7,57.5078806501124,63.84797462717383,NaN,NaN,39.89847335762981,95.41516994245464,-0.025314732759206815,0.7832055951918875,0.8085203279510943,290686637,298681755.4,71.86034790419342,76.76554797488848,NaN,NaN,27.652743341103115,25.97639121883585
2006-09-25T09:30:00-04:00,115.19,116.10001,114.77,115.60001,7954398,5979059.6,61.78172027690083,63.39118157705969,NaN,NaN,76.28297810066022,85.3956967075615,-0.03171204322564514,0.7688802739190379,0.800592317144683,298641035,297430455.4,69.38932339106842,76.74676695593307,NaN,NaN,27.069255411825033,26.132514674977163
2006-09-26T09:30:00-04:00,115.67,116.64,115.56,116.59,5624801,6066509.65,67.6594084994459,63.83781410491405,NaN,NaN,131.58288165720444,93.91098225828543,0.02182064588510635,0.827868124501066,0.8060474786159596,304265836,299043655.4,70.78414231437213,76.6905203186781,NaN,NaN,28.526462865931613,26.474507273684942
2006-09-27T09:30:00-04:00,116.53999,117.11,116.48,116.98,13105301,6473424.7,69.64026009667478,64.84319232597612,NaN,NaN,165.24892827002773,100.15014256207442,0.07177033189225823,0.8957603934812823,0.8239900615890241,317371137,301495336,72.81176124428502,76.75792748560352,NaN,NaN,30.371101623429926,27.031163609362796
2006-09-28T09:30:00-04:00,116.98,117.17999,116.5,116.89999,11941602,6855644.85,68.71045662651157,65.61738533429488,NaN,NaN,148.42734417312096,112.28812111172863,0.08669729661495873,0.9323616823577225,0.8456643857427638,305429535,303278836,74.21376611000987,76.91035684310486,NaN,NaN,31.537196036380998,27.674882527508252
2006-09-29T09:30:00-04:00,117.07001,117.33,116.67,116.74001,6476602,6984734.95,66.79024145316174,66.20635297655184,NaN,NaN,139.29551663775828,132.16752976775433,0.07358910273149022,0.9376507641571266,0.8640616614256363,298952933,304932095.2,75.47620023401657,77.1235580785592,NaN,NaN,31.912250504132622,28.28022080988316
2006-10-02T09:30:00-04:00,116.75,117.2,116.47,116.62,7034699,7111750,65.31562001689264,66.20693160667395,NaN,NaN,115.00930464380976,139.91279507638424,0.04597923532071568,0.921535705576531,0.8755564702558153,291918234,303587535,72.37292072256821,77.03849869975707,NaN,NaN,31.794512902050865,28.78226253733569
2006-10-03T09:30:00-04:00,116.50999,117.49001,116.44,117.14,8935000,7304225,68.55518816927943,66.24604385107143,NaN,NaN,121.32305613956076,137.8608299728555,0.05146650180194068,0.9398895975082411,0.8884230957063004,300853234,302905014.6,70.78198127846221,76.66933510062508,NaN,NaN,32.646804399666415,29.33433994624008
2006-10-04T09:30:00-04:00,117.03999,118.48,117,118.39,9500699,7561879.85,74.67790497352233,66.70696763813461,NaN,NaN,165.75464835085904,137.96197398902177,0.12388035105109396,1.0432735345201678,0.9193931834690738,310353933,301501573.8,67.49633442904744,75.81959212340008,NaN,NaN,35.52618127295082,30.218888707198754
2006-10-05T09:30:00-04:00,118.36,118.71001,118.2,118.62,7159602,7567359.95,75.61861557968211,67.20233985027971,NaN,NaN,176.52069075821973,143.5806433060415,0.16907006668748914,1.1307307668284352,0.9616607001409461,317513535,303918373.8,70.07264273324924,74.9296620615202,NaN,NaN,38.13505017155369,31.349768916392318
2006-10-06T09:30:00-04:00,118.42999,118.57001,117.97,118.52,8882000,7850459.95,74.3257523974377,67.67115896061435,NaN,NaN,145.26532614154885,144.77460520679966,0.17338212928721664,1.1783883617499669,1.0050062324627502,308631535,305854094.2,71.9877788103086,74.06575404948948,NaN,NaN,39.82604806054944,32.56066593698619
2006-10-09T09:30:00-04:00,118.32001,118.74001,118.10001,118.62,3432300,7738005.05,74.78992832051023,68.34645270924025,NaN,NaN,136.81233243087738,149.13521076421316,0.1642151852677649,1.2102752140474564,1.0460600287796915,312063835,309883214.4,75.50189446551721,73.44823639633971,NaN,NaN,41.338854559932265,33.814692883121346
2006-10-10T09:30:00-04:00,118.67,118.77,118.3,118.56,6718398,7618344.85,73.92631392991312,68.62123611802573,NaN,NaN,125.07153810725838,149.8849071577527,0.13649530154896228,1.2166791557158945,1.0801838541669322,305345437,310781655,76.21832609689513,72.85132808290882,NaN,NaN,42.341641190139526,35.03282835555252
2006-10-11T09:30:00-04:00,118.21001,118.78,117.91,118.58,8384199,7803859.9,74.03394709705267,69.52380272050696,NaN,NaN,106.0400528477204,137.941988057125,0.10339422946926824,1.2094266410035175,1.1060324115342492,313729636,311456795.6,76.76814006781504,72.55253998584345,NaN,NaN,43.20103602046459,36.19971516482567
2006-10-12T09:30:00-04:00,118.88,119.58,118.87,119.46001,5467801,7868149.95,78.28213003969408,71.00767767690566,NaN,NaN,141.7273217539305,130.98331425626714,0.12330371836762444,1.26016205949378,1.1368583411261555,319197437,311793576,77.05313295251504,72.92345320358072,NaN,NaN,45.2868347344918,37.4978751033494
2006-10-13T09:30:00-04:00,119.37,119.67999,119.07001,119.64,5289898,7749039.75,79.03754380497958,72.24023650033986,NaN,NaN,129.24685782202903,127.77962059236317,0.13044083645329563,1.2999093866927751,1.1694685502394795,324487335,314964736,79.59182611010053,73.6522033977973,NaN,NaN,47.24284955125509,38.890014310193074
2006-10-16T09:30:00-04:00,119.57001,119.97,119.42,119.77,6899301,7742164.75,79.58974303558921,73.09240325292151,NaN,NaN,124.5585970005721,125.32887350630213,0.12571079436594879,1.3266070431969155,1.2008962488309667,331386636,318829296.2,82.17931145454793,74.466144050667,NaN,NaN,49.02941809368526,40.33850056497767
2006-10-17T09:30:00-04:00,119.60001,119.75,118.87,119.57001,9414500,7778004.8,76.26154734866947,73.56535234234971,NaN,NaN,97.02199341126506,119.71896456710347,0.09244489159727176,1.3164523633275564,1.2240074717302847,321972136,322154636,84.05290727454624,75.2690830528285,NaN,NaN,49.62889904438495,41.66570034775014
2006-10-18T09:30:00-04:00,120.17,120.49001,119.5,119.89999,8739898,7769354.8,77.90342480048972,74.2219929262053,NaN,NaN,114.1548277706477,121.34191955168892,0.07664786446326044,1.3198173023093602,1.2431694378460998,330712034,325551115.6,85.70595105928246,76.08995340634797,NaN,NaN,50.6102965492664,42.9434998051096
2006-10-19T09:30:00-04:00,119.82001,120.31,119.67,120.14999,6591898,7668914.75,79.08376942470782,75.10010206703001,NaN,NaN,110.06602186619004,115.00965957414083,0.06734926367490113,1.327356017439726,1.260006753764825,337303932,329172414.6,87.22628852362658,76.9292454270344,NaN,NaN,51.78338483698292,44.20634052394865
2006-10-20T09:30:00-04:00,119.75,120.00999,119.38,119.92999,8227500,7789019.85,75.27318566904505,75.81135675646946,NaN,NaN,90.77182470764588,107.31465295126421,0.03246339405352683,1.3005859963317334,1.2681226022782066,329076432,330090234,87.58666040843478,78.01594111888201,NaN,NaN,51.724806715037076,45.28040712267556
2006-10-23T09:30:00-04:00,119.72,121.13,119.7,120.87,9888398,7885719.85,79.7606007601659,76.61174337010422,NaN,NaN,131.07357665372712,108.61764888189516,0.05732383253050921,1.3397773929413432,1.282453560410834,338964830,331605872.8,88.17970230762684,79.25863547810806,NaN,NaN,53.05886533237675,46.39161543834716
2006-10-24T09:30:00-04:00,120.86,121.25,120.75,121.21001,7025102,7955734.9,81.0969036975656,77.07024327896445,NaN,NaN,143.60815782270154,117.93488176418245,0.07990762327996959,1.382338089510796,1.3024304662308264,345989932,336409432,89.83690241650288,80.85439033435489,NaN,NaN,54.59356322787008,47.56332226542186
2006-10-25T09:30:00-04:00,121.05,121.39999,120.69,121.39,8617301,7731334.9,81.78260496427511,77.51052823500682,NaN,NaN,132.31179457261473,121.56627512457585,0.0894863475095613,1.414288400617778,1.3248020531082167,354607233,341188471.8,91.16416358634453,82.36092753814741,NaN,NaN,56.05944249304952,48.777053726511525
2006-10-26T09:30:00-04:00,121.45,121.55,120.84,121.42999,6657199,7467114.75,81.93936048309922,78.05435738398263,NaN,NaN,126.7563088802002,124.90433252737789,0.08127318502065295,1.426393534384033,1.34512034936338,361264432,345980571.8,92.25623792547191,83.80867461780193,NaN,NaN,57.29336752006192,49.99366998273301
2006-10-27T09:30:00-04:00,121.25,121.41,120.63,120.86,8672602,7576914.75,72.37947853403035,77.88218239923408,NaN,NaN,101.67739609601482,127.08544680505167,0.023226223567931914,1.3741531288232949,1.350926905255363,352591830,350683651.4,93.15093672494528,85.06932049347537,NaN,NaN,55.506022607924244,50.7811489291889
2006-10-30T09:30:00-05:00,120.60001,121.06,120.36,120.77,5699801,7510169.85,70.97147499324265,77.67112247518618,NaN,NaN,80.35465341093827,116.9416621564939,-0.032433776802633485,1.310384684252071,1.3428184610547045,346892029,352269091.2,93.4266536826584,86.29848674960131,NaN,NaN,53.63167647433683,51.18836714992432
2006-10-31T09:30:00-05:00,120.85001,121.03,120.12,120.73,8360000,7481419.85,70.31676444018336,77.40560942826694,NaN,NaN,67.33132734974531,101.68629606190267,-0.08041508068790759,1.24229961019482,1.3227146908827276,338532029,350777510.6,89.76545587706373,87.22686645026192,NaN,NaN,51.907054000572636,51.29103670001693
2006-11-01T09:30:00-05:00,121.06,121.11,119.98,120.25999,7595898,7386179.8,62.9664410466056,76.31163164304634,NaN,NaN,48.100389104480065,84.84401496827574,-0.14832721852530506,1.1373056677260962,1.2856328862514013,330936131,346043290.2,79.16182443687967,87.3774872705737,NaN,NaN,48.19415996332503,50.848625737632375
2006-11-02T09:30:00-05:00,119.88,120.24001,119.72,120,6938699,7375134.65,59.27534066513758,74.90004570448619,NaN,NaN,6.147965834846817,60.72234635920506,-0.21143049698503846,1.0213447650201033,1.2327752620051418,323997432,338589890.2,65.95283756063662,86.40327380275484,NaN,NaN,43.93024577566376,49.86028574306543
2006-11-03T09:30:00-05:00,120.46001,120.62,119.60001,119.78,6840898,7273079.55,56.26947023754302,73.23431193319719,NaN,NaN,0.2574577195131284,40.43835868390472,-0.26517773617316065,0.9013030917886908,1.1664808279618515,317156534,331502831,56.32836054119028,84.55677730894358,NaN,NaN,39.42455082612595,48.36946646921694
2006-11-06T09:30:00-05:00,120.06,121.1376,120.02,121.00999,7444301,7473679.6,66.49831217630637,72.53693799231411,NaN,NaN,62.113181982531096,36.790064398223286,-0.21710390405144397,0.8951009478975465,1.1122048519489904,324600835,327044592.2,51.260672166274766,82.2144748012099,NaN,NaN,38.30172263660738,46.93121735027272
2006-11-07T09:30:00-05:00,121.12,121.88,120.955,121.55,9506398,7613079.6,69.83440779582918,71.96057963483835,NaN,NaN,124.19394570676515,48.162588069627255,-0.15126879472071741,0.9231188585480936,1.074387653268811,334107233,326159633,50.29342250692584,79.68500847604157,NaN,NaN,38.50798773367178,45.72789883361544
2006-11-08T09:30:00-05:00,121.19,121.96001,121,121.83,9262102,7656974.75,71.42340521398337,71.41341076264375,NaN,NaN,129.85181895582912,64.51287403989707,-0.09400090473449985,0.9568865223506862,1.050887427085186,343369335,328646273.8,52.978315385717835,77.23872468047666,NaN,NaN,39.20498059698675,44.796053371239914
2006-11-09T09:30:00-05:00,121.78,121.89999,120.91,121.16,5962500,7681709.7,62.88702344084864,70.52868488920116,NaN,NaN,92.37594216058262,81.75846930504423,-0.10551739283305306,0.9189906860438697,1.0245080788769227,337406835,331328154.4,55.754168791209246,74.96497527924627,NaN,NaN,36.87569512410846,43.66457362164971
2006-11-10T09:30:00-05:00,121.12,121.25999,120.77,121.11,3718400,7603134.8,62.28871854153326,69.28069330215597,NaN,NaN,55.43883715906432,92.79474519295448,-0.11973543615487403,0.8748387836833302,0.9945742198382043,333688435,334634534.6,58.9700319319044,72.87857025240895,NaN,NaN,34.87570313494868,42.40902069497813
2006-11-13T09:30:00-05:00,121.12,121.82001,120.98,121.35001,5695199,7542929.7,64.05648962463546,68.06352086837525,NaN,NaN,89.06549620427755,98.18520803730375,-0.11612076666494153,0.8494232615070274,0.9655440281719689,339383634,337591094.4,61.65392192629936,70.86550021739443,NaN,NaN,33.78275252794166,41.17669667111578
2006-11-14T09:30:00-05:00,121.67,122.45,120.99001,122.32001,7650301,7454719.75,70.14718763927885,67.23241963087551,NaN,NaN,144.021746898365,102.15076827562373,-0.0546674660829749,0.8972096955682503,0.9518771616512252,347033935,340176434.8,63.87897003892628,68.91655782115026,NaN,NaN,34.85110730958184,40.2730410480395
2006-11-15T09:30:00-05:00,122.34,123.11,122.28,122.69,8818301,7458639.9,72.08991004513975,66.52888745673555,NaN,NaN,210.33475744582736,118.24735597362337,0.0016498461297717038,0.9539394693134398,0.952289623183668,355852236,342673015,65.93459768069812,67.03644066080929,NaN,NaN,36.37454973209112,39.716113717189735
2006-11-16T09:30:00-05:00,123.05,123.45,122.8,123.36,6310102,7444550.1,75.23307444162548,66.7327157358495,NaN,NaN,228.78692805484258,145.52955315247536,0.07093795075606313,1.040962061628747,0.9700241108726838,362162338,347624115.6,69.62627165783346,65.35610744172989,NaN,NaN,38.76287427603105,39.579936654167064
2006-11-17T09:30:00-05:00,122.81,123.3,122.67,123.25999,6493500,7357850.1,73.89532090542177,66.94156187243371,NaN,NaN,184.16557703166416,171.27490112699533,0.09542177858819667,1.0893013341079296,0.993879555519733,355668838,352020196.2,72.47817990117284,63.85978788590948,NaN,NaN,40.20347438918579,39.66901347345545
2006-11-20T09:30:00-05:00,123.10001,123.45,122.89999,123.13,5772199,7152040.15,72.10075944442855,67.06899008702264,NaN,NaN,160.01134669585267,185.46407122531036,0.08840893191978139,1.1043907204194596,1.0159817884996782,349896639,354122797.2,73.7478146763067,62.71567065728398,NaN,NaN,40.81500684272351,39.83272681192231
2006-11-21T09:30:00-05:00,123.16,123.32001,122.86,123.14999,5692602,7085415.15,72.21251731961956,67.72942410652364,NaN,NaN,129.78369656163207,182.61646115796378,0.07139207625717292,1.1052218838211445,1.0338298075639716,355589241,355833858.4,74.76792690035761,62.40182083324669,NaN,NaN,41.338985839793374,40.047906673046754
2006-11-22T09:30:00-05:00,123.23,123.50999,122.92999,123.25,3947300,6851915.1,72.79956968969435,68.69544046542056,NaN,NaN,118.16703116486585,164.18291590177145,0.05394092573549503,1.1012559647333404,1.0473150389978454,359536541,356570719.4,75.21459326670075,63.06337481225126,NaN,NaN,41.93787788692826,40.31790256074411
2006-11-24T09:30:00-05:00,122.67,123.10001,122.53,122.67999,2479900,6643050.15,64.44301563413673,69.27926513660582,NaN,NaN,74.78447182884005,133.38242465657095,-0.0057496676351500575,1.040127954453908,1.045877622089058,357056641,355549580,73.27865305336418,64.27410999169226,NaN,NaN,40.02803228408805,40.27649252122181
2006-11-27T09:30:00-05:00,122.7,122.72,121.07001,121.11,9329898,6675914.95,48.07441599227008,67.9632725520318,NaN,NaN,-5.106582567603017,95.52799273671754,-0.15258932873982145,0.8551409611642811,1.0077302899041025,347726743,353961161,70.249656642074,65.63046602567792,NaN,NaN,32.22220760697128,39.12588039061459
2006-11-28T09:30:00-05:00,121,121.45,120.67999,121.25999,8415699,6811709.85,49.39681829791748,66.5034447307524,NaN,NaN,-42.4943828222396,55.02684683309907,-0.23624187210707492,0.7124279497702588,0.9486698218773337,356142442,355210321.6,71.25591087299182,67.12778662325407,NaN,NaN,26.60192284282768,37.3367435980736
2006-11-29T09:30:00-05:00,121.59,122.39999,121.55,122.33,9318301,6859624.9,57.67746244735087,65.52159167599294,NaN,NaN,21.616053149153096,33.393318150603264,-0.21665277958296847,0.6778538473986231,0.8945066269815916,365460743,357184622,72.82062444950203,68.54509441352437,NaN,NaN,24.514664825098382,35.505018059077145
2006-11-30T09:30:00-05:00,122.33,122.77,121.63,122.28,12809301,7120295.05,57.20637925465454,65.11583137697907,NaN,NaN,26.225398612110034,15.004991640052088,-0.2043633485479488,0.6390524412966556,0.8434157898446044,352651442,355807602.2,69.96008296354339,69.55980256869108,NaN,NaN,22.76828469589754,33.68548472148006
2006-12-01T09:30:00-05:00,122.37,122.46001,120.89999,122.05,14517199,7499220.05,54.98177513556028,64.593906847981,NaN,NaN,-15.128290962981117,-2.97756091831214,-0.20831483027591724,0.5830222519997079,0.7913370822756252,338134243,352023122.6,62.673431561138216,69.82433111363636,NaN,NaN,20.656146491275177,31.824150688593647
2006-12-04T09:30:00-05:00,122.03999,123.11,122,122.8,6279500,7471150.15,60.39083813358874,64.33207459862052,NaN,NaN,49.303886424623265,7.904532880133116,-0.15922255610599356,0.5923088871431332,0.7515314432491268,344413743,351360522.6,61.46632701417246,69.81093147705586,NaN,NaN,20.596899151920805,30.220257611926097
2006-12-05T09:30:00-05:00,122.98,123.37,122.73,123.36,6599199,7428895.05,63.88052566431442,63.884455886123064,NaN,NaN,88.44770566462141,34.09295057750532,-0.09121943721329917,0.6375071467325029,0.728726583945802,351012942,350334622.6,59.55379320277682,69.50199027447375,NaN,NaN,21.712516493522894,29.00486602358278
2006-12-06T09:30:00-05:00,123.31,123.39999,122.97,123.14999,4234801,7165315.2,61.685641497409144,63.14129384699945,NaN,NaN,81.15418776099109,46.00057749987292,-0.06386053484152554,0.6489009153938952,0.7127614502354207,346778141,346598102.2,53.07613324059166,68.58352852875187,NaN,NaN,21.913366065185507,27.9917946009546
2006-12-07T09:30:00-05:00,123.34,123.64999,122.67999,122.75999,6432500,7023835.1,57.71944192599799,61.890320095883204,NaN,NaN,61.419434449646964,53.039384667380304,-0.07475182908049316,0.6193216638848043,0.6940734929652974,340345641,344136942,49.274354232770115,67.12982014124735,NaN,NaN,20.841743526449548,26.970358733168162
2006-12-08T09:30:00-05:00,122.67999,123.38,122.32001,123,7319602,7091690.2,59.44749691059674,60.85833266768141,NaN,NaN,44.153820478633705,64.89580695570326,-0.0686705249636439,0.6082353367607425,0.6769058617243864,347665243,346043142,52.13409789457077,65.67667142649006,NaN,NaN,20.487768690265003,26.044274441324852
2006-12-11T09:30:00-05:00,123.11,123.55,123.07001,123.34,3908300,7101185.2,61.82762480070135,60.12453733598661,NaN,NaN,83.54633895770814,71.74429746232026,-0.0457322747997585,0.6197405182246882,0.6654727930244467,351573543,347475102,54.221969235755665,64.28196818073641,NaN,NaN,20.908571274671825,25.31060256037442
2006-12-12T09:30:00-05:00,123.27,123.33,122.53999,123.19,8976699,7265260.2,60.15029894039787,59.26295030889935,NaN,NaN,45.56836514042617,63.168429357481216,-0.04459730056987421,0.6097261673121039,0.6543234678819781,342596844,345791882.4,51.38466695534314,62.61173532752109,NaN,NaN,20.77016334017981,24.661968386060906
2006-12-13T09:30:00-05:00,123.64999,123.74001,123.06,123.35001,4444801,7104985.2,61.35470264554283,58.445459805745664,NaN,NaN,87.09833468966146,64.35725874321528,-0.03730193429113193,0.6076960500180633,0.6449979843091952,347041645,345844583.2,51.47029166536451,60.915713784568496,NaN,NaN,20.995475846771885,24.138183737591046
2006-12-14T09:30:00-05:00,123.21001,124.38,123.2,124.23,6850898,7006615.05,67.22207634229652,58.6439641420428,NaN,NaN,142.95465876596685,80.66430360647927,0.019504671470944035,0.6693788236478753,0.6498741521769312,353892543,348553963.6,55.78211785894719,59.66596127068157,NaN,NaN,23.026152158432545,23.979322083425547
2006-12-15T09:30:00-05:00,124.19,124.59,124.10001,124.14999,9366398,7159429.85,66.23738193449314,59.941318852201576,NaN,NaN,167.44937438937393,105.32341438862731,0.04305665444994977,0.7036949702393684,0.6606383157894187,344526145,347926144,54.57214900815341,58.5461392968301,NaN,NaN,24.38112034647485,24.036721835289732
2006-12-18T09:30:00-05:00,124.31,124.63,124.03,124.22,6767801,7173144.9,66.69707966311526,61.177051806858564,NaN,NaN,150.23629471240707,118.66140553956711,0.054006441353005696,0.7281463674806758,0.6741399261276702,351293946,347870224.6,54.45884118309164,57.34634860469437,NaN,NaN,25.623804812574374,24.263447974901823
2006-12-19T09:30:00-05:00,123.89999,124.64,123.7,124.38,6186102,7193840.05,67.77689193333008,61.898439627285654,NaN,NaN,129.4093649978412,135.4296055110501,0.06210326994037896,0.7517690135531439,0.6896657436127649,357480048,350846865.4,59.30281541009318,56.38079081616517,NaN,NaN,26.97320257174136,24.65055577445033
2006-12-20T09:30:00-05:00,124.42,124.72,124.28,124.42,4770102,7147715.05,68.05575007364027,62.673394685784636,NaN,NaN,134.55052944705548,144.92004446252892,0.060187804820031277,0.7649004996378039,0.7047126948177727,362250150,353888566.4,63.567276516447805,55.924161784229774,NaN,NaN,28.173592815892984,25.153846780370706
2006-12-21T09:30:00-05:00,124.45,124.60001,123.72,123.99001,5991699,7249935,61.85850895057032,63.164589958285354,NaN,NaN,90.2812993125002,134.3853725718356,0.021966395821220397,0.7321706895942981,0.7102042937730777,356258451,354361748,64.19581176020787,56.03290322702047,NaN,NaN,27.564358577111676,25.49820560847656
2006-12-22T09:30:00-05:00,124.00999,124.24001,123.17999,123.17999,6811000,7466490,52.212828697034,62.58044642710286,NaN,NaN,36.46500233608363,108.18849816117752,-0.06130993866003376,0.6335668704480355,0.6948768091080693,349447451,355346009.2,65.52801796562241,56.32302400926689,NaN,NaN,24.056576737474565,25.292258626904847
2006-12-26T09:30:00-05:00,123.17,124.00999,123.17,123.97,4076200,7203805.1,58.93788944554306,62.22740098290491,NaN,NaN,46.700949367694214,87.48142909223495,-0.06621043012350114,0.6121137714536928,0.678324201577194,353523651,355791950.2,66.14268768874189,56.793659329692964,NaN,NaN,23.032942619942144,24.969499197338745
2006-12-27T09:30:00-05:00,124.36,124.99001,124.25,124.92999,5714602,7068750.25,65.32395347612675,62.48728040995617,NaN,NaN,131.83008515215306,87.96557312309733,-0.01073093625664967,0.6649105312563819,0.6756414675130316,359238253,356143591.2,66.64770707485314,57.76305746071164,NaN,NaN,24.334300840655708,24.878756574955453
2006-12-28T09:30:00-05:00,124.89999,125.14,124.59,124.8,6691602,6937415.3,63.87533796930678,62.92698727019251,NaN,NaN,128.68778287389165,86.79302380846455,0.010149716682906318,0.6883286133666644,0.6781788966837581,352546651,354202891.4,61.22027514616111,58.61633752595386,NaN,NaN,24.87733840667153,24.87855397948632
2006-12-29T09:30:00-05:00,124.8,125.10001,124.34,124.41,4936000,6543750.25,59.604628746237054,62.938210972738254,NaN,NaN,96.19979549664097,87.97672304529272,-0.008366475937177653,0.667720801762286,0.6760872776994636,347610651,352473331.4,56.782307187933164,58.948352475479744,NaN,NaN,23.9518830453106,24.746172417461217
2007-01-03T09:30:00-05:00,125.16,125.67999,123.88,124.47,11524898,6394135.2,60.0472021548655,62.81103792660713,NaN,NaN,94.58826636102283,99.60137585028056,-0.021868181087641436,0.6487520513399119,0.6706202324275533,359135549,354410951,60.258108833649146,59.37950530390071,NaN,NaN,23.35078952776412,24.546832004647346
2007-01-04T09:30:00-05:00,124.48,124.95,123.89,124.67999,10318699,6596095.15,61.63158320098789,62.9168439452207,NaN,NaN,69.74509382732457,104.21020474220663,-0.02189726754022636,0.6432486480022703,0.6651459155424967,369454248,357597070.4,65.21254537919374,60.367210905604324,NaN,NaN,23.31992029316211,24.371558903006598
2007-01-05T09:30:00-05:00,124.47,124.5,123.52,123.74001,9389199,6735595.15,51.74042562845912,62.23010987257186,NaN,NaN,-1.7850955379730105,77.48716860418142,-0.08681894339938545,0.5566222362932649,0.6434411796926504,360065049,357762429.6,65.45326073837906,61.36599441081965,NaN,NaN,20.090882532942917,23.760033707283213
2007-01-08T09:30:00-05:00,123.87,124.39,123.25,124.14,8092398,6928475,55.046570146609206,61.3604308585942,NaN,NaN,-6.02449121187741,50.54471378702759,-0.10329910267426434,0.5143173013498199,0.6176164040240842,368157447,360884588.8,69.71442553077809,62.36115924452186,NaN,NaN,18.456444153708595,23.002378056772553
2007-01-09T09:30:00-05:00,124.34,124.57001,123.42,124.07001,7439398,6978819.9,54.34500258071631,60.51097519046728,NaN,NaN,-0.24388181535801046,31.255978324627797,-0.11831072673166498,0.46972799560950307,0.588038722341168,360718049,363506068.4,72.75329080288199,63.65981222985961,NaN,NaN,16.940850638492304,22.136445568446803
2007-01-10T09:30:00-05:00,123.74001,124.55,123.5,124.42999,8961102,7060894.9,57.35544217333017,59.84371536976835,NaN,NaN,12.601138166489346,14.858552685721103,-0.10390563223666105,0.45815668204534177,0.5620623142820028,369679151,365614788.8,74.93224578832707,65.12219827309072,NaN,NaN,16.55953942884137,21.339744691360313
2007-01-11T09:30:00-05:00,124.50999,125.35001,124.3416,124.99001,8330602,7282010,61.59780220636514,59.40235181784227,NaN,NaN,124.44012143416434,25.797558207089054,-0.05881493988238207,0.48854363942902523,0.5473585793114073,378009753,367325889.8,76.56964437480896,66.35554319914185,NaN,NaN,17.545778794650914,20.79774956325897
2007-01-12T09:30:00-05:00,124.94,125.66,124.81,125.66,6393301,7152840.1,65.96069069512617,59.252704719376986,NaN,NaN,188.559747335611,63.86652678180585,0.01029724176429414,0.560230131516775,0.5499328897524809,384403054,372193490.8,80.47644983432085,67.56334129327564,NaN,NaN,19.828013388224935,20.659215823968395
2007-01-16T09:30:00-05:00,125.53999,125.75,125.28999,125.7,7052398,7283219.95,66.2075300051139,59.56334908041581,NaN,NaN,190.0242805230252,103.07628112878638,0.050614693236072705,0.6132012562975717,0.562586563061499,391455452,376853091.8,83.34017751088668,68.9307959897527,NaN,NaN,21.711269026061437,20.809509138553114
2007-01-17T09:30:00-05:00,125.53999,126.10001,125.42999,125.75,8769000,7379125.05,66.53421508221786,60.58630525078609,NaN,NaN,183.69353912904242,139.86376531766646,0.07129347376726558,0.651703405270581,0.5804099315033154,400224452,384754372.4,86.85987833163794,70.45450030161095,NaN,NaN,23.332547354613016,21.169943169418815
2007-01-18T09:30:00-05:00,125.96001,126.08,125.39,125.50999,10424500,7432030.15,63.36742389627118,60.90270056869524,NaN,NaN,142.9848889359145,165.9405154715515,0.05990884704002286,0.655295990303344,0.5953871432633211,389799952,388778532.6,88.22440126038977,72.03176555672866,NaN,NaN,23.816241224887076,21.547985748771424
2007-01-19T09:30:00-05:00,125.25,125.71001,125.17999,125.55,10984500,7642865.1,63.67778735578644,60.78511727438522,NaN,NaN,105.28989572303378,162.11047032932538,0.04675797660135195,0.6538346140150111,0.6070766374136591,400784452,393333472.4,89.54750388102268,73.66746532859791,NaN,NaN,24.300312964951832,21.94117535108291
2007-01-22T09:30:00-05:00,125.48,125.50999,124.38,124.75,10233602,7845240.1,53.85307681822932,60.069241477879686,NaN,NaN,29.055817464793094,130.2096843551618,-0.020524597488955187,0.5814208905524652,0.6019454880414203,390550850,394563031.6,89.87811939365352,75.7144542034188,NaN,NaN,21.820697599045047,21.923964243648932
2007-01-23T09:30:00-05:00,124.71001,125.41,124.58,125.33,6596500,7936560,58.814424149533025,60.012798292400824,NaN,NaN,51.814311615889,102.56769057373458,-0.03009365523197194,0.5643284190014555,0.5944220742334274,397147350,395701411.2,90.18757745316776,78.10054493664984,NaN,NaN,21.160112034041397,21.814842499419285
2007-01-24T09:30:00-05:00,125.50999,126.12,125.38,126.07001,10118500,8142900.05,64.1154366283753,60.3033864690801,NaN,NaN,125.43794647872235,90.91657204367054,0.007292680708923749,0.603537925119582,0.5962452444106583,407265850,397109690.8,90.57160707795033,80.26579481124278,NaN,NaN,22.30737319877532,21.88520402789872
2007-01-25T09:30:00-05:00,126.03,126.12,124.78999,124.97,8769000,8240800.05,53.161825939753676,59.698403807563366,NaN,NaN,54.865246858136615,73.29264362811497,-0.04529250504652238,0.5396296131025053,0.5849221181490277,398496850,398849070.4,91.03813439693661,82.11047974108156,NaN,NaN,19.45414820606011,21.537910339064634
2007-01-26T09:30:00-05:00,125.21001,125.28,124.21001,124.77,10586301,8566305.1,51.4410567381691,59.677020315399794,NaN,NaN,-20.1855149557094,48.19756149236634,-0.09397372883973154,0.46745495709936336,0.5614286859390949,387910549,396274289.8,84.38203297398368,83.46253490076761,NaN,NaN,16.648528811769932,20.83942726373682
2007-01-29T09:30:00-05:00,124.83,125.31,124.69,124.82001,6682199,8614684.95,51.86065574121601,59.449455000728854,NaN,NaN,3.784159969738374,43.14322999335539,-0.12148683544617411,0.4095701416313773,0.5310569770775514,394592748,397082669.4,84.75880224943405,84.53713323781447,NaN,NaN,14.5876600296726,19.946317658870502
2007-01-30T09:30:00-05:00,124.89999,125.27,124.64,125.16,7639898,8662099.75,54.72495309529436,59.47659432319871,NaN,NaN,13.96120088111343,35.57260784640028,-0.11550715455686933,0.3866730338814648,0.5021801884383341,402232646,398099728.6,85.24121325455008,85.4291276986479,NaN,NaN,13.75157823087631,19.06135488344276
2007-01-31T09:30:00-05:00,125.19,126.49001,125.13,126.24001,9790199,8904809.7,62.38198011999041,59.83563274796016,NaN,NaN,123.56336134053132,35.19769081876207,-0.0413586963332504,0.4504818180217711,0.4918405143550215,412022845,399051127.6,85.69726929443266,86.19805794908402,NaN,NaN,15.578054626870156,18.563740561075246
2007-02-01T09:30:00-05:00,126.46001,126.77,126.17,126.74001,8708000,8763964.8,65.3072560196465,60.10059373462311,NaN,NaN,169.78397245641355,58.18143593841745,0.0347090278142993,0.5352267991228956,0.5005177713085963,420730845,403497926.6,87.62245090246321,86.98754412963076,NaN,NaN,18.07436866594337,18.49383029034212
2007-02-02T09:30:00-05:00,126.8,126.83,126.32001,126.53,5961000,8546079.85,63.088173217497044,59.895413914792464,NaN,NaN,147.1628367341877,91.65110627639687,0.06260182648237389,0.5787700544115637,0.5161682279291898,414769845,408869785.8,89.46691474743601,87.62972019485326,NaN,NaN,19.35828118697132,18.617323275574865
2007-02-05T09:30:00-05:00,126.44,126.74001,126.25,126.67999,4625301,8307884.95,64.0282865457182,59.73975366769277,NaN,NaN,133.8760853600376,117.66949135445671,0.08166900531520782,0.6182544845731996,0.5365854792579918,419395146,413830265.4,90.82635779173877,88.16444735777127,NaN,NaN,20.680807198582222,18.912106693147344
2007-02-06T09:30:00-05:00,126.62,126.78999,126.3,126.64999,7255699,8266050,63.67894185939341,59.53580558034817,NaN,NaN,124.55644944299726,139.7885410668335,0.08253224210095755,0.6397507818841888,0.5572185397832312,412139447,415811625.6,91.30886769276702,88.48223231213763,NaN,NaN,21.644789480752184,19.302489948519465
2007-02-07T09:30:00-05:00,126.75999,127.06,126.33,126.78999,5931102,8190635.2,64.6482994950154,59.62729669454419,NaN,NaN,127.95541743599576,140.66695228592636,0.08260124355652254,0.6604700942288844,0.5778688506723618,418070549,417021166.4,91.59934961730649,88.72330005191739,NaN,NaN,22.720878067200974,19.79083110833111
2007-02-08T09:30:00-05:00,126.55,126.58,125.78,126.47,6289602,8057060.2,60.663159149538,59.41196610838359,NaN,NaN,69.58645900316137,120.62744959527592,0.05262506440162551,0.6436501811743938,0.5910251167727683,411780947,415231186.8,86.96691742640226,88.53897244801593,NaN,NaN,22.536767780020984,20.183107775715378
2007-02-09T09:30:00-05:00,126.52,126.78999,125.48,125.88,6604801,7970770.15,54.04764532294559,59.42586385872046,NaN,NaN,37.24720485939017,98.64432322031644,-0.01196280161758434,0.5760716147507878,0.5880344163683722,405176146,413312447,82.16978698273866,87.98837727580772,NaN,NaN,20.416279617127298,20.216418038774222
2007-02-12T09:30:00-05:00,125.88,126.03999,125.39,125.59,9208055,8111507.85,51.09797860490252,58.87468917696115,NaN,NaN,-11.453374978218937,69.57843115266512,-0.07568623497039584,0.4934266226553774,0.5691128576257732,395968091,408627036,71.76032799438795,86.67214517160917,NaN,NaN,17.749928451384356,19.864062383432813
2007-02-13T09:30:00-05:00,126.02,127,125.98,126.63,6416078,8079691.85,59.610928287353445,58.55293858117387,NaN,NaN,87.2318515647544,62.11351157701655,-0.05047737388370421,0.506016140271143,0.5564935141548472,402384169,406675980.4,67.90278965985632,85.05294392745961,NaN,NaN,17.972547327927778,19.593845946932095
2007-02-14T09:30:00-05:00,126.78,127.83,126.7,127.48,7396063,8011045,64.97721853890906,59.39689519539926,NaN,NaN,154.66450467845357,67.45532902550812,0.01714072831925162,0.5779194245539117,0.56077869623466,409780232,405017917,64.71879431700162,83.1729910646071,NaN,NaN,20.004078353891586,19.65245057649774
2007-02-15T09:30:00-05:00,127.61,127.89999,127.49001,127.77,6077699,7793704.95,66.60735822853869,60.480202444711374,NaN,NaN,165.1288534182819,86.5638079085322,0.0720185096743109,0.6508018333275487,0.5787833236532378,415857931,405833313.8,65.573718257779,81.82954001344963,NaN,NaN,22.171309455386005,20.01228755919606
2007-02-16T09:30:00-05:00,127.41,127.57001,127.31,127.57001,5814699,7535214.9,64.38183315563349,61.37457226002691,NaN,NaN,125.16941317723222,104.14824957210062,0.08459995891766092,0.6845332723003139,0.599933313382653,410043232,406806731,66.61379599431235,80.53346813808378,NaN,NaN,23.216581481777464,20.470043833850546
2007-02-20T09:30:00-05:00,127.45,127.85001,126.92,127.66,5611898,7304129.7,64.94934775870954,62.10488616455656,NaN,NaN,113.56506355295234,129.15193727833486,0.08832437198497889,0.7103387783638766,0.6220144063788977,415655130,410744138.8,70.49658692195955,79.48028054289874,NaN,NaN,24.227098274311885,21.006765896773594
2007-02-21T09:30:00-05:00,127.3,127.59,126.98,127.37,5303699,7239489.65,61.546093483146855,62.04517997621059,NaN,NaN,90.9589693541743,129.89736083621887,0.06185074329515383,0.6993278354978401,0.6374770922026862,410351431,412337591.2,71.91986429921286,78.49618018609735,NaN,NaN,24.07904363487335,21.44566271650213
2007-02-22T09:30:00-05:00,127.39999,127.59,126.44,126.78999,7220898,7094609.55,55.30441266953703,61.33069116548848,NaN,NaN,51.58585208297259,109.28163031712265,-0.0008113726120877462,0.6364628764375766,0.6372742490496643,403130533,411007651.4,68.93097863144287,77.16107502388161,NaN,NaN,22.043625825873473,21.531086017840895
2007-02-23T09:30:00-05:00,126.72,126.74001,126.27,126.41,5916801,6951999.6,51.61150097371023,60.510928862360856,NaN,NaN,2.753674919380612,76.80659461734238,-0.07010422116048587,0.549643972599057,0.6197481937595428,397213732,407278811.6,61.2456551230944,75.14527076500006,NaN,NaN,19.1888707673261,21.196483839195924
2007-02-26T09:30:00-05:00,126.86,127,126.09,126.34,7599594,6802664.25,50.93673864414148,59.57581829796252,NaN,NaN,-6.939361801860757,50.384839621523795,-0.11997801954033327,0.4697756693341262,0.5897536888744594,389614138,403192992.8,54.124772118265746,72.52372893118056,NaN,NaN,16.67521818906461,20.55058874632002
2007-02-27T09:30:00-05:00,125.34,126.44,120.5,121.60001,32115696,8074339.1,26.07613618889856,56.88990360721289,NaN,NaN,-353.9553633092695,-43.11924575092055,-0.4528202642366919,0.023728358578594566,0.4765486228152865,357498442,391561655.2,39.90189809497238,68.8518025313381,NaN,NaN,1.392377605198464,17.813701440445513
2007-02-28T09:30:00-05:00,122.41,123.47,121.5,122.66,19949600,8689824.2,33.85132092242503,54.69011942345644,NaN,NaN,-295.6049503742364,-120.4320296966027,-0.5744002658442467,-0.24145170949002193,0.3329485563542248,377448042,384980977.4,34.39494309758582,64.7657734942152,NaN,NaN,-6.267118727614691,14.37358427357977
2007-03-01T09:30:00-05:00,121.41,122.89999,120.05,122.44,24877888,9444208.65,33.073793587989485,52.719450454774396,NaN,NaN,-247.71237349138224,-180.29167481147365,-0.6375685588427131,-0.46401214219916653,0.17355641664354654,352570154,374868901.6,28.00007562209437,60.5538562224789,NaN,NaN,-11.93240827463712,10.615585338120214
2007-03-02T09:30:00-05:00,122,122.47,120.96001,120.96001,17521904,9884903.85,28.35537725051887,50.88428844960106,NaN,NaN,-196.09925097314894,-220.06225998997957,-0.7397706087293703,-0.7511568442681664,-0.011386235538796086,335048250,362435805.2,22.468644649437877,56.289488912957424,NaN,NaN,-18.471321519359034,6.460312929908893
2007-03-05T09:30:00-05:00,120.39999,121.91,120.28,120.3,15606922,10367199.95,26.537170443862493,49.12994500952677,NaN,NaN,-172.17825350397658,-253.11003833040272,-0.8070653660533575,-1.020217943105493,-0.21315257705213547,319441328,348401243.2,18.117683484297473,52.45787144795096,NaN,NaN,-24.104438806257722,2.093919824742234
2007-03-06T09:30:00-05:00,121.28,122.28999,120.98,122.06,9048699,10588369.85,37.961172361180395,47.58353387194298,NaN,NaN,-114.32337101011596,-205.183639870572,-0.6926743564503052,-1.078995522615017,-0.3863211661647118,328490027,342599560.2,16.679753393284642,48.799083143195844,NaN,NaN,-24.236010278584274,-1.6674987614472667
2007-03-07T09:30:00-05:00,122.00999,122.60001,121.87,122,6968699,10574019.85,37.74567543368811,45.63842365014148,NaN,NaN,-88.03290529443542,-163.66923085461184,-0.5849721968973605,-1.1175364122864124,-0.532564215389052,321521328,331414217.4,14.320039702393004,45.19917209929522,NaN,NaN,-24.40870537868491,-4.916242563909787
2007-03-08T09:30:00-05:00,122.73,123.08,122.28,122.8,7570301,10655979.8,42.43772744500615,43.912021451317734,NaN,NaN,-62.96695291214334,-126.72014673876404,-0.43089194329677927,-1.071179144510026,-0.6402872012132468,329091629,326718512.4,13.459194718488178,41.47670613220301,NaN,NaN,-22.881863365305716,-7.482759821252062
2007-03-09T09:30:00-05:00,123.23,123.35001,122.33,122.99001,9315801,10807289.75,43.526431099260584,42.42234987586253,NaN,NaN,-52.054298748640385,-97.91115629386233,-0.2937659871923024,-1.0074946852036248,-0.7137286980113224,338407430,327390348.4,14.253421777230514,37.73667940241145,NaN,NaN,-21.342868080337986,-9.462775286835765
2007-03-12T09:30:00-04:00,122.69,124.3,122.52,123.14999,6396102,10796854.8,44.47858293488337,40.96015238844637,NaN,NaN,-35.837288672850605,-70.64296332763715,-0.1757019178448337,-0.9333560953173645,-0.7576541774725308,344803532,332462789.2,20.207623524841352,34.14461058833157,NaN,NaN,-19.82965355579866,-10.943757896687607
2007-03-13T09:30:00-04:00,122.52,122.99001,120.86,121.02,13712500,11022077.05,35.81941730430634,39.12253266138634,NaN,NaN,-75.86589300327782,-62.95146772626951,-0.22151465883429222,-1.0345475010153962,-0.8130328421811039,331091032,332982990.2,20.814903661327335,30.494256257054026,NaN,NaN,-21.38468285327233,-12.435318604771139
2007-03-14T09:30:00-04:00,121.03,121.69,119.5,121.66,22822000,11842373.15,39.62292473256699,38.00242638017419,NaN,NaN,-86.38431238117533,-62.621749143617514,-0.190361462823328,-1.050984670710264,-0.8606232078869359,353913032,339461331,28.148864757377865,27.581248123192243,NaN,NaN,-21.347732569291225,-13.70852059970258
2007-03-15T09:30:00-04:00,121.25,122.03999,121.21001,121.78999,7906602,11867900.1,40.395558858900024,37.20128765768775,NaN,NaN,-61.84290216554156,-62.39693899429716,-0.14471438503529344,-1.0415161891810527,-0.8968018041457593,361819634,346006932,34.72694976388331,25.68705488324859,NaN,NaN,-21.07447009254852,-14.76079909868057
2007-03-16T09:30:00-04:00,121.69,121.78,120.25,121.05,8491508,11988590.55,37.456993710388375,36.238448733848244,NaN,NaN,-77.35152465410151,-67.45638417538939,-0.14756597600030008,-1.0812592741461344,-0.9336932981458343,353328126,348991071.2,37.53470270523747,24.50204992517514,NaN,NaN,-21.762158695453664,-15.760993326791011
2007-03-19T09:30:00-04:00,121.56,122.28,121.5,122.28,6829527,12039331.95,44.662803585326174,37.566067833593074,NaN,NaN,-42.6379020538714,-68.81650685159354,-0.05460961560095734,-1.001955317647031,-0.9473457020460737,360157653,352061895.4,40.376936693335225,24.535981253629632,NaN,NaN,-20.013132647653414,-16.368441801199925
2007-03-20T09:30:00-04:00,122.03999,122.82001,122.00999,122.82001,7562402,12136857.15,47.521492486985494,38.5425086596331,NaN,NaN,-17.860834018361917,-57.21549505461037,0.049615303092669594,-0.8853265731802367,-0.9349418762729063,367720055,359387700,46.6172580353876,25.4090037491869,NaN,NaN,-17.673588582231528,-16.554891341347297
2007-03-21T09:30:00-04:00,122.8,124.74001,122.32001,124.28999,9723730,12357858.7,54.423632413140645,40.067497147143904,NaN,NaN,50.07198514705476,-29.924235548964344,0.2146749228640752,-0.6665982226928122,-0.8812731455568874,377443785,364093850.6,50.221621569201545,26.99625703112313,NaN,NaN,-13.287899245671852,-16.088178184822233
2007-03-22T09:30:00-04:00,124.46001,124.64,123.98,124.45,6478250,12320726.3,55.11565074603012,41.97894525396613,NaN,NaN,97.63639025223861,1.97162293459169,0.325123344045822,-0.4748689654996099,-0.7999923095454319,383922035,368514330.8,53.4040880496309,29.205931559708347,NaN,NaN,-9.620328082816131,-15.164199598821362
2007-03-23T09:30:00-04:00,124.5,125.00999,124.37,124.69,5276551,12288713.8,56.19013149843403,44.097013900721244,NaN,NaN,134.46268212155414,44.33446428972282,0.3999163882625918,-0.3000968242171922,-0.700013212479784,389198586,375688422.8,58.08736881064885,32.06090908301916,NaN,NaN,-6.327437030021834,-13.901804946135716
2007-03-26T09:30:00-04:00,124.75,124.75,123.57001,124.36,7993691,12308418.65,54.26649563285599,45.26167984869807,NaN,NaN,126.40641719467806,78.14332813943271,0.4111529992699806,-0.18607196339230825,-0.5972249626622889,381204895,379897871.2,60.590297447938624,35.19737651549445,NaN,NaN,-4.1517721287640095,-12.508943115082616
2007-03-27T09:30:00-04:00,124.21001,124.23,123.66,123.89,7891500,11097208.85,51.559188710010346,46.24835936843538,NaN,NaN,95.49602816478489,100.81470057606207,0.3720930537303222,-0.13210864549938606,-0.5042016992297083,373313395,381016539.2,61.25252561582509,38.54969693788245,NaN,NaN,-3.079359483503352,-11.161859739142722
2007-03-28T09:30:00-04:00,123.52,123.61,122.45,123,13869223,10793190,46.7980552577085,46.55981135505697,NaN,NaN,31.707665716307897,97.14183668991271,0.2759042937023176,-0.1593213321018112,-0.4352256258041288,359444172,377416616.6,57.88180182640842,41.7227403027339,NaN,NaN,-3.5357871331109334,-10.072420795423895
2007-03-29T09:30:00-04:00,123.67,123.72,122.56,123.3,9107648,10004678,48.52360827793327,46.916752582105026,NaN,NaN,38.76324890788876,85.36720842104273,0.224264851515107,-0.15489456141024505,-0.37915941292535205,368551820,374342573.6,55.0937370748589,44.63990568113593,NaN,NaN,-3.4225587192488907,-9.122440498827466
2007-03-30T09:30:00-04:00,123.37,124.06,122.33,123.59,9828438,9620004.7,50.20492157483628,47.325776770673095,NaN,NaN,42.74922168827312,67.02451633438652,0.2021057619774907,-0.1265272104534887,-0.3286329724309794,378380258,372178908,53.15305700150072,46.99315092946874,NaN,NaN,-2.8585721987864554,-8.22760217025018
2007-04-02T09:30:00-04:00,123.57001,123.82001,123.11,123.64999,6195160,9149416.6,50.564624471805054,48.37900585406586,NaN,NaN,50.752644756943624,51.89376184683964,0.18444666167298346,-0.09807464533975008,-0.28252130701273354,384575418,372853012.6,53.700264522800154,49.342105276716794,NaN,NaN,-2.2953007357661805,-7.380130536752465
2007-04-03T09:30:00-04:00,124.21001,125.25999,124.21001,124.99001,7329102,9063436.75,57.88324915645571,49.68331474148648,NaN,NaN,131.17777602706207,59.030111419295075,0.25180191962360043,0.032231092516767035,-0.2195708271068334,391904520,376571237.6,56.704323088107884,51.381780871768946,NaN,NaN,0.38861597930705094,-6.27030960588682
2007-04-04T09:30:00-04:00,125.08,125.34,124.87,125.17999,4879699,8958986.75,58.81418675496274,50.99893101977667,NaN,NaN,135.81175887759179,79.85093005155186,0.29494488279967584,0.14911027639276142,-0.14583460640691442,396784219,384039247,62.032684228984046,53.332190476418994,NaN,NaN,2.871056501560215,-4.964400161965815
2007-04-05T09:30:00-04:00,125.12,125.7,124.95,125.46001,4045960,8782769.7,60.21024279429955,52.6241630971989,NaN,NaN,133.33355361405592,98.76499099278529,0.3257243266621399,0.26132080192076046,-0.06440352474137945,400830179,390494918.8,65.93545449692522,55.360815604396656,NaN,NaN,5.355049369340308,-3.4901930860649406
2007-04-09T09:30:00-04:00,125.72,125.89999,125.53,125.64999,3529200,8493439.65,61.17186666106996,53.803381888323464,NaN,NaN,133.36217058794008,116.88758077271868,0.34065251275425207,0.36141211620143565,0.020759603447183583,404359379,395690743,68.7221980637874,57.38547713085753,NaN,NaN,7.709155826440927,-1.8902860985641023
2007-04-10T09:30:00-04:00,125.64999,125.86,125.47,125.59,5668895,8457079.3,60.67322713438197,54.74279150599464,NaN,NaN,113.93384312303706,129.52382044593736,0.32813395997521166,0.4309270534161982,0.10279309344098651,398690484,398513756.2,70.15098526937297,59.06645764757077,NaN,NaN,9.5544483538002,-0.25532403394063063
2007-04-11T09:30:00-04:00,125.75999,125.78,124.53,124.89999,9540918,8248500.2,55.10883876131169,54.791734816578284,NaN,NaN,76.06868431358934,118.50200210324283,0.25811427799815767,0.42543594093868364,0.16732166294052594,389149566,397962765.4,69.48382349093859,60.44232921340913,NaN,NaN,9.727619687589819,1.170810783420862
2007-04-12T09:30:00-04:00,124.75,125.53999,124.25999,125.41,6026961,7408748.25,58.16297970538118,55.00940117081764,NaN,NaN,70.37027145782505,105.41370461928948,0.23171872793683185,0.45697007286156577,0.22525134492473392,395176527,397641227,69.07099819840711,61.561394224036,NaN,NaN,10.715855937523482,2.534388662578379
2007-04-13T09:30:00-04:00,125.75999,126.14999,125.2,126.14999,6000699,7313453.1,62.1831581895599,55.43747450589807,NaN,NaN,107.65048746601128,100.27709138968055,0.24819828944312855,0.5354992067286446,0.28730091728551604,401177226,397710636.4,69.11365803540541,62.348986311518615,NaN,NaN,12.752536017959365,3.994123999061377
2007-04-16T09:30:00-04:00,126.47,127.28999,126.45,127.03999,8064777,7292116.55,66.36891769548276,56.30193322465713,NaN,NaN,165.2772754612046,106.66011236433344,0.2996948480480264,0.661919477345549,0.36222462929752264,409242003,398687161.2,69.74590552970075,63.00295831735877,NaN,NaN,15.84418475465641,5.686989821289239
2007-04-17T09:30:00-04:00,127.28,127.87,127.03999,127.75,7932125,7347246.45,69.28928873140157,57.56836894047078,NaN,NaN,186.39134105848802,121.15161195142363,0.3582702408549773,0.8100624303662443,0.451792189511267,417174128,402383890,72.0762166036893,63.77607910220621,NaN,NaN,19.42417316633983,7.649444584867895
2007-04-18T09:30:00-04:00,127.44,128.34,127.28999,128.03999,9221965,7430224.6,70.41911480856999,59.255587479818026,NaN,NaN,183.83404886471988,142.70468486164972,0.39059062541156164,0.940030471275719,0.5494398458641574,426396093,409833195.4,76.07528936479153,65.07561392637642,NaN,NaN,22.720532404131745,9.802457130477016
2007-04-19T09:30:00-04:00,127.33,128.27,127.27,128.23,8808641,7384470.15,71.16759566738338,60.87301515049303,NaN,NaN,159.46487646113692,160.5236058623121,0.3974898664033273,1.0463021788683164,0.6488123124649892,435204734,417838836.8,79.47695672527087,66.81727247283443,NaN,NaN,25.660641163704877,12.06791199236671
2007-04-20T09:30:00-04:00,129.09,129.57001,128.89,129.57001,10281457,7574630.5,75.81519236746377,62.70232020710929,NaN,NaN,193.81696114582817,177.75690059827548,0.4605783110656668,1.2245352012970727,0.7639568902314059,445486191,426700629.8,82.45135364771866,68.91000794756428,NaN,NaN,29.90025669143485,14.615389806519302
2007-04-23T09:30:00-04:00,129.39,129.73,128.49001,129.17,7509191,7686262.5,72.08002557683861,64.23913457175453,NaN,NaN,152.90308538853893,175.28206258374234,0.44348409697268454,1.3183120114472615,0.874827914474577,437977000,432447629.2,84.06434255805924,71.0788706643685,NaN,NaN,32.25235407264322,17.13495613025129
2007-04-24T09:30:00-04:00,129.33,129.77,128.89999,129.48,10591301,7816143,73.18269277238561,65.33195197289238,NaN,NaN,137.61481337580642,165.52675704720602,0.42132944224029156,1.4014897172749414,0.9801602750346499,448568301,438726463.8,85.61953217698607,73.14424274214551,NaN,NaN,34.52395389487233,19.619098668054296
2007-04-25T09:30:00-04:00,129.92,130.99001,129.56,130.62,12649555,8054045.75,76.80980995670961,66.61735363016003,NaN,NaN,147.80110057280427,158.32016738882288,0.44917275090564246,1.541626213666703,1.0924534627610605,461217856,445690816.4,87.12089432210973,74.93625774879733,NaN,NaN,37.73465094056197,22.20703470698396
2007-04-26T09:30:00-04:00,130.8,131.22,130.62,131.2,9708746,7846021.9,78.40977815301011,67.91732044149649,NaN,NaN,146.3576873515199,155.6987295668995,0.47013257486256355,1.6801191813392649,1.2099866064767013,470926602,452835190,88.45275532908461,76.54463637966587,NaN,NaN,40.9261749531109,24.88119759928781
2007-04-27T09:30:00-04:00,130.71001,131.37,130.63,131.23,7527125,7766995.75,78.49243450632036,69.15450385901438,NaN,NaN,131.40952477355754,143.21724229244538,0.4495079730173439,1.7718715727483811,1.3223635997310372,478453727,459428697.2,89.52897158295805,78.03083448817804,NaN,NaN,43.487339108584365,27.5392178149016
2007-04-30T09:30:00-04:00,131.17,131.98,130.53999,130.67,10290051,7790076.4,72.88326683429061,70.02664955186499,NaN,NaN,117.41551613289485,136.11972844131657,0.36522329316377133,1.7788927161857515,1.4136694230219802,468163676,465466032.4,90.4103035573566,79.47792865160545,NaN,NaN,44.003040502991055,29.891192484628665
2007-05-01T09:30:00-04:00,130.84,131.32001,130.31,131.28999,21231168,8541876.8,75.0122811195418,71.4483240060243,NaN,NaN,104.1436489267899,129.42549555151328,0.3199278392729572,1.8135792221131766,1.4936513828402194,489394844,473631341,91.45754084374664,81.04747989109174,NaN,NaN,45.079792183361675,32.06099244159052
2007-05-02T09:30:00-04:00,131.5,132.49001,131.36,132.14,9342117,8642527.55,77.60800252271827,72.83725420726265,NaN,NaN,121.46254340444709,124.15778411784181,0.3153946981798359,1.8878947555650143,1.5725000573851784,498736961,481135162,92.29073766926852,82.70603271043899,NaN,NaN,46.82444432786636,34.170056996772786
2007-05-03T09:30:00-04:00,132.28,132.42999,131.89999,132.39,9409105,8868997.85,78.32129152663875,73.989978017054,NaN,NaN,114.90961053197437,117.86816875393272,0.2976381350156365,1.944547726154724,1.6469095911390874,508146066,488579054.8,93.01823628365254,84.4135025853138,NaN,NaN,48.462048200996605,36.211770025947615
2007-05-04T09:30:00-04:00,132.64999,132.8,132.23,132.74001,10687801,9201089.9,79.31476937280253,74.91468170829113,NaN,NaN,113.84337373628816,114.35493854647882,0.278228242502659,1.9946948942674112,1.7164666517647522,518833867,496655082.8,93.71157236727035,86.12533593085448,NaN,NaN,50.12182848809139,38.1989212348253
2007-05-07T09:30:00-04:00,132.81,133.13,132.74001,133.03999,10477695,9548514.65,80.15420948197863,75.69074747618947,NaN,NaN,115.18468624598232,113.90877256909633,0.25497263765779143,2.0351824488369914,1.7802098111792,529311562,508884660,94.58803246524633,87.73332277810854,NaN,NaN,51.752672839316716,40.13517146403836
2007-05-08T09:30:00-04:00,132.69,133.22,132.35001,133.12,9464539,9738296.85,80.38287535492557,76.40244465807201,NaN,NaN,103.04818757281794,113.68968029830191,0.2159066063342987,2.0500930690970733,1.8341864627627746,538776101,518760911.4,95.17312133964793,89.09745363345543,NaN,NaN,53.1590224308802,41.99572160215862
2007-05-09T09:30:00-04:00,132.99001,133.77,132.8,133.57001,9629012,9742701.55,81.66264614622406,77.15209112084635,NaN,NaN,108.97744210606787,111.19266003862609,0.19209925269167205,2.0743105286273646,1.8822112759356926,548405113,528694541.8,95.6791096117701,90.25475026820538,NaN,NaN,54.73915241236593,43.81621171790252
2007-05-10T09:30:00-04:00,133.19,133.42999,132.21001,132.5,14855793,10184143.15,69.97354597749795,76.73483066442022,NaN,NaN,82.71996789521688,104.75473151127457,0.08166180501674147,1.9842885322066195,1.902626727189878,533549320,533775192.6,95.91497531059721,91.21643752983957,NaN,NaN,52.649868662785984,45.07816271002873
2007-05-11T09:30:00-04:00,132.64,133.56,132.60001,133.56,10152355,10391725.95,73.95136733663388,76.86849793297702,NaN,NaN,96.33683393440765,101.25342355089848,0.05846174453867392,1.9757039078632204,1.9172421633245464,543701675,538748754.2,96.13726498653442,92.0787891318735,NaN,NaN,52.01720966809216,46.06945513260922
2007-05-14T09:30:00-04:00,133.61,133.95,133.09,133.72,10735961,10525285.15,74.50049308919768,76.96262652703503,NaN,NaN,104.87088334544707,99.19066297079144,0.033587430215833214,1.959226451094338,1.9256390208785048,554437636,543773969,96.35319309846372,92.84547919769334,NaN,NaN,51.6750436504228,46.870253492296875
2007-05-15T09:30:00-04:00,133.78999,134.94,133.63,134.12,21494496,11203403.7,75.87001392332688,76.89549823893626,NaN,NaN,119.13229889470702,102.40748523516925,0.024207365447126872,1.9558982276874133,1.9316908622402864,575932132,551205175.2,96.65130494670251,93.52622281373567,NaN,NaN,51.79452306860358,47.57372057462641
2007-05-16T09:30:00-04:00,134.31,135.14999,133.85001,135.12,15450738,11514842.35,78.91837027308517,76.93182624751306,NaN,NaN,128.45675641578785,106.30334809711326,0.06326593942858483,2.0107732865260175,1.9475073470974327,591382870,559800726.6,96.96078134132924,94.13393895746744,NaN,NaN,52.85950330715347,48.32883239355884
2007-05-17T09:30:00-04:00,134.95,135.39999,134.71001,134.92999,12817238,11715272.2,76.92969526322759,76.82020201586356,NaN,NaN,134.07793697054237,116.57494191217833,0.054549544783931925,2.0156942780773477,1.9611447332934158,578565632,568803989,97.24769985397238,94.68527669111131,NaN,NaN,53.112722156624145,49.012245216853884
2007-05-18T09:30:00-04:00,135.08,135.5,135,135.5,9482613,11675330,78.66645386963616,77.23328680410255,NaN,NaN,136.91980913863688,124.69153695302418,0.06472402457769166,2.0420497640155304,1.9773257394378387,588048245,577673303,97.4982608437992,95.19155935442863,NaN,NaN,53.85393096003289,49.703914608736596
2007-05-21T09:30:00-04:00,135.39,135.74001,135.16,135.2,12669219,11933331.4,75.44721782831695,77.26435371187219,NaN,NaN,129.87148501951606,129.69165728783798,0.03053605060672937,2.0154958026962504,1.984959752089521,575379026,581861581,97.60895764849377,95.63094626905344,NaN,NaN,53.50628696894195,50.2471106601945
2007-05-22T09:30:00-04:00,135.37,135.73,135.12,135.16,11198152,11963673.95,75.00647482912032,77.07853030518662,NaN,NaN,118.24884007987387,129.51496552487134,-0.013142265095448913,1.9685319207202099,1.9816741858156588,564180874,579511329.4,95.06689694449487,95.82924336014104,NaN,NaN,53.09864708123475,50.654473006057394
2007-05-23T09:30:00-04:00,135.56,135.99001,134.94,135.2,11263438,11894368.1,75.16272869027199,76.85291867401757,NaN,NaN,108.51536326431729,125.52668689457724,-0.05534388666618151,1.912494327482932,1.9678382141491135,575444312,576323617.8,91.5830374249631,95.72672915594892,NaN,NaN,52.80340713885177,50.96146359645659
2007-05-24T09:30:00-04:00,135.27,136.33,134.14999,134.39,28156848,12816773.2,66.14476592275403,75.91220414187124,NaN,NaN,78.13280797071279,114.3376610946113,-0.14852654055844328,1.7821800384510595,1.9307065790095028,547287464,570067984.2,84.99998759292818,95.10447310063877,NaN,NaN,49.91796232966965,50.8123919869156
2007-05-25T09:30:00-04:00,134.75999,135.05,134.39,134.89,10227543,12951794.1,68.64554232093482,75.09015648751097,NaN,NaN,61.449397363793295,99.2435787396426,-0.1848386675181306,1.6996582446118396,1.8844969121299702,557515007,563961336.6,79.02812232217084,93.99305094756195,NaN,NaN,48.12500087342491,50.42847897070264
2007-05-29T09:30:00-04:00,135.17,135.89999,134.57001,135.22,12177293,13046156.2,70.20960420760002,74.363494262702,NaN,NaN,77.74970044683737,88.81922182510687,-0.1940296264002157,1.6419598791297005,1.8359895055299162,569692300,562823991.4,77.92995207823907,92.76139600031846,NaN,NaN,47.049081951053864,49.94570796789567
2007-05-30T09:30:00-04:00,134.58,136.31,134.42,136.28,14585648,12713880.2,74.59363659902402,73.85856500933058,NaN,NaN,95.36954036021245,84.2433618811746,-0.13871062995004313,1.6626012180923624,1.8013118480424055,584277948,566843406.2,79.03852692332343,91.5727829511437,NaN,NaN,47.411747041817954,49.58371354988457
2007-05-31T09:30:00-04:00,136.39999,136.66,136.08,136.28999,9025871,12698067.9,74.63152760221195,74.19127798252443,NaN,NaN,125.87095829421992,87.7144808871551,-0.11255099206861363,1.6606231079566385,1.773174100025252,593303819,570415307.6,79.99994915687795,90.43599536873516,NaN,NaN,47.711896688480216,49.31631114111252
2007-06-01T09:30:00-04:00,136.61,136.84,136.16,136.61,9593551,12707290.2,75.87284395284607,74.32852631225387,NaN,NaN,128.5733261355898,97.80258452013058,-0.08599792805751538,1.665676689953358,1.7516746180108733,602897370,581537288.8,82.66594735158408,89.47375839481015,NaN,NaN,48.32538333323419,49.17475002570133
2007-06-04T09:30:00-04:00,136.23,136.8101,136.13,136.56,7430902,12544445.25,75.2532536961808,74.38229492703837,NaN,NaN,120.15446826770884,109.54359870091369,-0.08400739477813723,1.6466653745382018,1.730672769316339,595466468,589127581,84.21262463866678,88.60657493339606,NaN,NaN,48.657647660293286,49.10087825921447
2007-06-05T09:30:00-04:00,136.25999,136.32001,135.42999,135.98,13433820,12692251.5,68.2870052939736,73.84065145351315,NaN,NaN,75.52306534156185,109.09827167985858,-0.1311484189275094,1.5667372456569524,1.6978856645844618,582032648,591595650.6,84.69095856654798,87.75226447767076,NaN,NaN,46.95413001087643,48.79419993802332
2007-06-06T09:30:00-04:00,135.5,135.5,134.32001,134.49001,15041781,12971113.6,54.36420077446087,72.0867822036114,NaN,NaN,-14.561415679914083,87.11208047183327,-0.26438746317613804,1.3674013356142893,1.6317887987904274,566990867,588138234.4,80.9890433865559,86.61142605232979,NaN,NaN,40.65479869547241,47.63142833194462
2007-06-07T09:30:00-04:00,134.28,134.78999,132.37,132.53,26024832,13790904.6,42.18091847849567,69.60472671898769,NaN,NaN,-137.83318669474954,34.37125147403937,-0.4739994533994516,1.039289482041113,1.5132889354405645,540966035,577670677.6,70.88648835813576,84.72848237405576,NaN,NaN,29.963884380989565,45.107493481808184
2007-06-08T09:30:00-04:00,132.81,134.23,131.75,134.10001,19559664,14026098.15,51.54777449031605,67.6676781918934,NaN,NaN,-136.06501287814123,-18.556416328706838,-0.4941343494108261,0.8956209986770318,1.389755348087858,560525699,569196343.4,63.93340068665989,82.33099236283151,NaN,NaN,24.543228641604962,42.16974136177915
2007-06-11T09:30:00-04:00,134.07001,134.75,133.77,134.24001,10273492,14032155,52.29001093225352,66.01359198503172,NaN,NaN,-69.83667760415888,-56.55464550308038,-0.484586834331695,0.7840218051732393,1.2686086395049343,570799191,564262888,60.22954442900294,79.66103427572503,NaN,NaN,20.824103744453428,39.12036455930405
2007-06-12T09:30:00-04:00,133.69,134.46001,132.92,132.92,20112784,14500996.15,45.2512951905274,63.88822201084651,NaN,NaN,-141.93894872618134,-100.04704831662903,-0.5490054114750034,0.58235187516118,1.1313572866361834,550686407,557993639.8,55.80519056799741,76.8566266774038,NaN,NaN,15.048600776247568,35.68154116172455
2007-06-13T09:30:00-04:00,133.58,134.89,133.24001,134.8,17254992,14289020.95,54.62044598118718,62.42091610305475,NaN,NaN,-64.052671078271,-109.9452993963004,-0.4509391172232162,0.5676833901071632,1.0186225073303794,567941399,558183746.2,55.91095434017436,74.30862074277601,NaN,NaN,13.776306706231424,32.552221953796966
2007-06-14T09:30:00-04:00,134.96001,135.87,134.85001,135.7,12749367,14153952.4,58.29950638722531,61.86054042194555,NaN,NaN,37.18830223810132,-74.94100160973024,-0.31768477970515663,0.6215165326989336,0.9392013124040902,580690766,566128692.4,60.19792299692304,72.53704470020422,NaN,NaN,14.204147169634643,29.93106841320235
2007-06-15T09:30:00-04:00,136.36,136.85001,136.17999,136.19,11594641,14092822.55,60.191795700067985,61.25670137759793,NaN,NaN,107.31346423475027,-26.26530618715193,-0.19480184522978683,0.6956990058668566,0.8905008510966435,592285407,572480634,63.272668690063945,71.41165515505371,NaN,NaN,15.218564401555437,27.82928212582422
2007-06-18T09:30:00-04:00,136.49001,136.53999,135.92999,135.94,10176883,14127536.05,58.72754053017087,60.436553972067266,NaN,NaN,78.10698962773483,3.32342725922681,-0.1316423101491383,0.7259479634102206,0.8575902735593589,582108524,574742500.6,64.32938695487968,70.44018621767091,NaN,NaN,15.509301626538385,26.06928491164053
2007-06-19T09:30:00-04:00,135.82001,136.39999,135.62,136.27,10670102,14027580.2,60.10707931340441,59.4017998802373,NaN,NaN,69.4775681728587,45.606730639034815,-0.0719128875021331,0.7676991641816926,0.8396120516838257,592778626,583160944.4,68.01770968712115,69.6529849865136,NaN,NaN,16.185946234173155,24.65737938628805
2007-06-20T09:30:00-04:00,136.61,136.62,134.69,134.85001,17467168,14341031,52.04561816457856,57.78852063469206,NaN,NaN,13.90733467266892,61.198731789222805,-0.12898087739675623,0.6783859549378803,0.8073668323346366,575311458,584634956.2,68.62934942557243,68.84079929142035,NaN,NaN,14.077448907454643,23.145960746454705
2007-06-21T09:30:00-04:00,134.8,135.55,133.87,135.37,26946240,15125171.1,54.45456588447812,56.258643629808624,NaN,NaN,-19.692996677974147,49.82247200600771,-0.13216465943715983,0.6421610080381868,0.7743256674753466,602257698,588948342.6,70.41253281443232,67.96555539590952,NaN,NaN,13.163380638627348,21.71987787390794
2007-06-22T09:30:00-04:00,134.95,135.17999,133.54089,133.97,22144304,14824543.9,47.53150194160216,54.278518504481575,NaN,NaN,-67.69730263932883,14.820318631191885,-0.22363601114988785,0.49478065353798684,0.7184166646878747,580113394,586513940,68.06111258278752,66.81187596334671,NaN,NaN,10.018510478271525,20.048253960245596
2007-06-25T09:30:00-04:00,133.81,134.77,132.89,133.62,19745120,15300422.75,45.958411318179365,52.68361893478199,NaN,NaN,-92.86190769023165,-19.373460832401413,-0.2981309629978759,0.3457529609405299,0.6438839239384058,560368274,582165890,63.95312729182059,65.33060230086619,NaN,NaN,7.016955233029602,18.186639856357598
2007-06-26T09:30:00-04:00,133.81,134.4285,132.8,132.8,21826416,15782878.9,42.416501183870366,51.83021182116839,NaN,NaN,-106.27902940869409,-54.524780348711964,-0.38739508904916575,0.15964006262694852,0.5470351516761143,538541858,571318536.4,55.0295365851856,63.47635181505403,NaN,NaN,3.3611174905820986,16.06870808981824
2007-06-27T09:30:00-04:00,132.71001,134.22,132.53,134.12,20980896,16102641.3,49.20313204748915,52.33179850466792,NaN,NaN,-79.62081770688137,-73.23041082462203,-0.3437841220353233,0.11730499913196013,0.46108912116728346,559522754,568160795.6,52.72322903114805,62.17897614884061,NaN,NaN,2.441040624033542,14.121898451848999
2007-06-28T09:30:00-04:00,134.09,135.10001,133.89999,134.09,13935586,16348127.05,49.061608090051045,52.15421519036328,NaN,NaN,-28.8476537948971,-75.06134224800662,-0.3045460724605219,0.08040653059163105,0.38495260305215295,545587168,556826689.6,45.37280389172187,60.85321923491647,NaN,NaN,1.6808993214721513,12.344612861795163
2007-06-29T09:30:00-04:00,134.36,135.12,132.85001,134.2,19466672,16841783.1,49.63365776265064,51.96447567824879,NaN,NaN,-43.638659820314246,-70.2496136842037,-0.2604772111785768,0.05935608907893197,0.3198333002575088,565053840,553814778.8,43.63197976748246,59.667678901950715,NaN,NaN,1.2380966670667202,10.75796769111967
2007-07-02T09:30:00-04:00,134.42,135.37,134.38,135.27,8861238,16913299.9,54.93519463734626,52.656182781592996,NaN,NaN,30.924817290113545,-45.492268688134665,-0.15383201571733746,0.12754328061083697,0.28137529632817443,573915078,556524139.6,45.651984511967555,58.942449897948585,NaN,NaN,2.467303273203675,9.573587059988814
2007-07-03T09:30:00-04:00,135.50999,135.86,135.34,135.69,7520930,16617655.4,56.85493585467293,52.81578920112769,NaN,NaN,81.3134218128493,-7.973778443825975,-0.054686570867144235,0.21301708274424414,0.26770365361138837,581436008,565102969.6,51.57004713436517,58.63238509753364,NaN,NaN,4.063039994977771,8.786366050701522
2007-07-05T09:30:00-04:00,135.58,135.72,135.05,135.56,9392188,16335175.75,56.05890745094172,52.655746419964586,NaN,NaN,61.41910409570396,20.23420591669109,-0.0004142657975053643,0.26718582136450664,0.267600087162012,572043820,567607182.8,53.17299775502248,58.13060472311218,NaN,NaN,5.143319695422208,8.265930857090192
2007-07-06T09:30:00-04:00,135.63,136.31,135.36,136.13,8218660,15444867.15,58.78377142535683,52.55517325748521,NaN,NaN,88.42441462438882,43.68861960054827,0.06756068955030275,0.35205094909989043,0.2844902595495877,580262480,574542245.2,57.380093063514714,57.709706464072944,NaN,NaN,6.857215032248565,8.064685739255674
2007-07-09T09:30:00-04:00,136.39,136.69,136.13,136.48,9688859,14951326.9,60.407325247559285,52.675157880155815,NaN,NaN,114.70350746035142,75.35705305668141,0.12636697062789415,0.4424489728344554,0.31608200220656124,589951339,579521745,60.1486237897225,57.411080523704584,NaN,NaN,8.765884117293272,8.164856936118188
2007-07-10T09:30:00-04:00,136.07001,136.25,134.87,135.02,12624094,15068857,51.325002788514716,52.04786669980655,NaN,NaN,31.61824847620611,75.49573929389992,0.06054579447532732,0.3917642453007204,0.3312184508253931,577327245,580204178.4,60.527062484673905,56.876034294958345,NaN,NaN,7.804052913389146,8.113313504299754
2007-07-11T09:30:00-04:00,134.89,135.92999,134.75,135.89999,16698176,14898126.6,55.652946876022774,52.305533036338275,NaN,NaN,37.584403762708426,66.74993568387174,0.06925569642816903,0.41778807136060436,0.34853237493243533,594025421,582722061,61.96230818242625,56.39981706330504,NaN,NaN,8.317502030147987,8.142483293706643
2007-07-12T09:30:00-04:00,136.33,138.67,136.32001,138.34,13511844,14710969.2,64.95705681365365,53.055710959850785,NaN,NaN,194.72077521919874,93.4102699085707,0.22362263094546264,0.6280606636142636,0.40443803266880096,607537265,589820750,65.74403669399874,56.066353054702645,NaN,NaN,12.124152758356233,8.711293217228013
2007-07-13T09:30:00-04:00,138.47,139.3,138.41,138.91,8509961,14498998.9,66.71393041353733,54.42588442213186,NaN,NaN,228.41425334022884,121.4082376517387,0.34134305111601215,0.8311168465638161,0.489773795447804,616047226,596977699.2,69.08158723766626,56.13924410147971,NaN,NaN,15.742930567415547,9.715812838683375
2007-07-16T09:30:00-04:00,138.98,139.86,138.92,139.46001,11638219,14501177.8,68.36219418065537,56.026154626594426,NaN,NaN,218.11013432422794,142.089563024514,0.4278693421460724,1.0246104731303944,0.596741130984322,627685445,604524520.4,72.16162701630158,56.725565510371204,NaN,NaN,19.199060143364914,11.07056245363788
2007-07-17T09:30:00-04:00,139.63,140.46001,139.53,139.8,13300516,14657359.45,69.37183165505351,57.951535374536085,NaN,NaN,196.49252661396667,175.0644186520661,0.4759297196730854,1.1916532805756788,0.7157235609025934,640985961,617256263.6,76.42787722093863,58.25401841292499,NaN,NaN,22.29251545893877,12.673698597252292
2007-07-18T09:30:00-04:00,139.33,139.7,138.28,139.33,20819712,15164839.95,66.22552593827396,59.16742065244929,NaN,NaN,132.23806050327502,193.99515000017942,0.4445845938014905,1.2714543031544565,0.826869709352966,620166249,622484429.2,77.92400571450806,60.05407389030785,NaN,NaN,23.8863913380291,14.275511845934693
2007-07-19T09:30:00-04:00,139.92999,140.17,139.53,139.89,8731879,14728075.5,68.08296732678292,60.52608916935871,NaN,NaN,134.67055775374175,181.98510650708803,0.4298316955461331,1.3641593287856324,0.9343276332394993,628898128,626756601.8,79.09181181175543,62.462574456024534,NaN,NaN,25.78280196555074,15.91941043445127
2007-07-20T09:30:00-04:00,139.22,139.56,137.88,138.53999,19279008,14344713.9,59.576741444154166,61.236309432323246,NaN,NaN,80.03062074790328,152.30837998862293,0.3033798059717969,1.3135523907042455,1.0101725847324485,609619120,625470980.6,77.75875492780688,64.90020125319056,NaN,NaN,24.785867937042116,17.186047220535677
2007-07-23T09:30:00-04:00,139.11,139.62,138.81,139.21001,12709199,13872958.65,62.10715285756817,61.748592162339094,NaN,NaN,86.91847734055692,126.07004859188874,0.24176810110746727,1.3123827111167827,1.0706146100093155,622328319,624399555.4,76.60003193964243,67.11077606945307,NaN,NaN,24.742073798273502,18.265479588783936
2007-07-24T09:30:00-04:00,138.5,138.82001,136.89999,137.27,20849600,13928182.65,51.96418940149875,61.39925312996951,NaN,NaN,30.601030795995804,92.89174942829456,0.05690969973264792,1.1417517346751254,1.0848420349424774,601478719,616498107,68.49393192676013,68.31962498319555,NaN,NaN,21.23851227518581,18.690198543984202
2007-07-25T09:30:00-04:00,137.96001,138.10001,136.44,137.5,22438896,13958806.65,52.945337250571,61.17685525851446,NaN,NaN,14.072409880910149,69.25861930382159,-0.05715150052191831,1.0134026592900796,1.0705541598119979,623917615,617248380.2,68.8312194120622,69.43806938726982,NaN,NaN,18.801070692402014,18.706037422329604
2007-07-26T09:30:00-04:00,136.55,137.14,131.14,134.71001,46786176,15249070.65,41.79367945868316,59.96327726089491,NaN,NaN,-99.5086615027138,22.42277545253047,-0.3134575568119373,0.6787322137970762,0.9921897706090135,577131439,606895042.4,59.38367907683325,69.58118267393543,NaN,NaN,12.398008201437147,17.80489039077354
2007-07-27T09:30:00-04:00,134.62,135.10001,132.11,132.11,31418896,16123236.15,34.500815246693975,58.112812260833095,NaN,NaN,-137.9522406952592,-21.173796836102035,-0.6326454331778086,0.20138297913675274,0.8340284123145614,545712543,594113727,50.21964347679174,68.87196979444037,NaN,NaN,3.9240193000199715,15.821908806380174
2007-07-30T09:30:00-04:00,132.92,133.85001,132.13,133.53999,22848304,16292317.75,40.63632901131423,57.34933556246164,NaN,NaN,-130.83419071893496,-64.7243304480004,-0.7158869481334322,-0.06083027285222897,0.6550566752812033,568560847,583360232.6,44.059162143795234,67.69569119866333,NaN,NaN,-0.4533980686068252,13.496864967096316
2007-07-31T09:30:00-04:00,134.28,134.83,131.7,132.17,23251808,17011846.25,37.05509988041146,56.02091791991798,NaN,NaN,-129.54316009453996,-96.75316862610755,-0.8239347282060192,-0.3748617349763208,0.4490729932296984,545309039,572126296.6,38.71599822831035,66.03524048765505,NaN,NaN,-5.267622842669356,10.816223851415506
2007-08-01T09:30:00-04:00,131.89,133.78999,131.2,133.41,42193344,18745466.95,42.0344912680266,54.38359180951604,NaN,NaN,-119.68866756637297,-123.50538411556417,-0.7734251732069252,-0.5177084732789581,0.2557166999279671,587502383,564843250.2,35.69381336062996,63.888795963842995,NaN,NaN,-7.289049751048621,8.22975619392063
2007-08-02T09:30:00-04:00,133.50999,135,132.98,134.78,22631600,19407437.55,47.02106772016896,52.976958759989735,NaN,NaN,-70.61555170345233,-117.72676215571187,-0.6161236579732029,-0.5144378725385366,0.10168578543466633,610133983,571443759,40.246258201872564,61.82912960414344,NaN,NaN,-7.135974573913504,6.034651798515755
2007-08-03T09:30:00-04:00,134.44,134.72,131.53999,132.19,34058656,20699437.35,40.013006390387986,50.95201677497064,NaN,NaN,-102.1634128555642,-110.56899658777289,-0.651446694597881,-0.7126225828126849,-0.06117588821480391,576075327,577516315.8,44.16272969181114,59.829208366679836,NaN,NaN,-9.613931286868329,3.7991399291751717
2007-08-06T09:30:00-04:00,132.39999,134.61,131.53999,134.2,31237600,21776874.4,46.65747091024548,49.32956243605578,NaN,NaN,-75.2794620172861,-99.4580508474431,-0.5106053442689369,-0.699432568550975,-0.18882722428203813,607312927,585266731.8,48.77729195029973,57.85416656163421,NaN,NaN,-9.141820959566369,1.9504312307835234
2007-08-07T09:30:00-04:00,133.89,136.03,133.39,135.05,31646608,22728000.1,49.21906961597592,48.11481555589164,NaN,NaN,-37.57702065668417,-81.06482295987196,-0.3395954225463683,-0.6133215024649985,-0.2737260799186302,638959535,603996831,57.844272197862374,56.419899881873796,NaN,NaN,-7.864303372161725,0.5483262875056307
2007-08-08T09:30:00-04:00,135.39,136.96001,134.88,136.55,27654304,23275806.5,53.465908172871906,47.07073990204084,NaN,NaN,-4.030646593697459,-57.93321876533686,-0.11638555927128325,-0.41920802900773424,-0.302822469736451,666613839,619819122.2,63.69118003386606,55.3198547548817,NaN,NaN,-5.33077783121856,-0.29154572945496793
2007-08-09T09:30:00-04:00,134.63,135.82001,132.77,132.78999,39052000,24552814.3,43.61856827344497,45.93087038984733,NaN,NaN,-60.13354565948686,-55.83681755654376,-0.207575097407258,-0.5622913414955235,-0.3547162440882655,627561839,623304693.4,64.8478535044676,54.397647510357466,NaN,NaN,-6.784608336025393,-1.2191261018221715
2007-08-10T09:30:00-04:00,131.89999,133.12,130.64,131.94,37278992,25991265.85,41.746706815530686,44.47655281541608,NaN,NaN,-99.35785249907298,-55.27570548524551,-0.3048599994486838,-0.7357912433991203,-0.43093124395043647,590282847,626146197.4,65.80423242068808,53.62651897328931,NaN,NaN,-8.564587475675536,-2.2684777266583662
2007-08-13T09:30:00-04:00,133.24001,133.44,132.14999,132.17999,17085808,26263645.3,42.49704401695056,43.80032814509121,NaN,NaN,-75.41886774274295,-55.30358663033688,-0.33061070736497666,-0.8441946281566572,-0.5135839207916806,607368655,626157343,65.80816194930657,53.43467826061404,NaN,NaN,-9.675943190994998,-3.326687078706456
2007-08-14T09:30:00-04:00,132.53999,132.89999,130.28999,130.49001,20863904,26641814.7,38.71530317152225,42.783897139444875,NaN,NaN,-106.83070634198596,-69.15432376739724,-0.43258792155168724,-1.0543188227312896,-0.6217309011796024,586504751,615666386.2,58.94235040376982,52.72833047430745,NaN,NaN,-11.862300967860717,-4.546060491442779
2007-08-15T09:30:00-04:00,130.21001,131.28999,128.47,128.85001,28964560,27049057.1,35.42115780066949,42.32871702101532,NaN,NaN,-147.42937431219104,-97.83406931109596,-0.5728210568244784,-1.3377572222102003,-0.764936165385722,557540191,593851656.6,47.77954099372088,51.899463468370854,NaN,NaN,-14.781080358653556,-6.008206186758604
2007-08-16T09:30:00-04:00,127.84,129.25999,125.31,129.14999,52564496,29240687.95,36.485704499643624,42.470494824797434,NaN,NaN,-186.3601923716075,-123.07939865352009,-0.6045704431071368,-1.520649219269643,-0.9160787761625062,610104687,590360226.2,46.269195694340326,51.61728862676718,NaN,NaN,-16.749272535576463,-7.542644236589727
2007-08-17T09:30:00-04:00,131.24001,131.86,128.95,130.55,33292704,29941372.75,41.3453070270703,42.521136111637155,NaN,NaN,-101.65521832416138,-123.53887181853777,-0.49508067884870655,-1.5349296247233895,-1.039848945874683,643397391,600983135,51.312093037720146,52.135355119190386,NaN,NaN,-16.89867509937119,-8.879220074129936
2007-08-20T09:30:00-04:00,130.95,131.696,129.7,130.96001,16906000,30151212.8,42.72735929075796,42.926297498090484,NaN,NaN,-85.86541637064104,-125.62818154411738,-0.3648556838217343,-1.4959185506518509,-1.1310628668301166,660303391,611570082.2,55.76771315998813,53.353334757167374,NaN,NaN,-16.606174786231122,-9.983070747287249
2007-08-21T09:30:00-04:00,130.82001,131.66,130.42,130.67999,14383301,29827897.85,41.99950382762012,42.9237983952043,NaN,NaN,-72.9469140386113,-118.85142308344246,-0.2716653799410582,-1.4706445917564395,-1.1989792118153813,645920090,623453150,60.17330108949522,55.10186959494347,NaN,NaN,-16.57349636621847,-10.92456012142028
2007-08-22T09:30:00-04:00,131.58,132.39999,131.35001,132.28999,12799398,29345922.95,47.533544272672074,42.96040386324024,NaN,NaN,-19.435871296882812,-93.25272248038081,-0.08533705138702574,-1.3056505260491633,-1.2203134746621376,658719488,643689009.4,66.32445836617958,56.964598178108254,NaN,NaN,-14.908988490861832,-11.493764174197644
2007-08-23T09:30:00-04:00,132.72,133.08,131.62,132.17,14056301,27709429.2,47.17229953590916,43.471781945063185,NaN,NaN,-2.5337286178627476,-56.487429729631856,0.03939132794726241,-1.1710743147280596,-1.210465642675322,644663187,650600709.4,68.13474690777926,58.67688512210598,NaN,NaN,-13.653482322106928,-11.802295338184685
2007-08-24T09:30:00-04:00,132.19,133.75,132.03,133.64,9667102,26621839.5,51.98647471298,43.852425073829934,NaN,NaN,37.65368320204009,-28.625649424391565,0.22035125124033783,-0.9350265786248997,-1.1553778298652375,654330289,652787289,68.70785124462357,60.10049650027196,NaN,NaN,-11.138728850779268,-11.707500125698196
2007-08-27T09:30:00-04:00,133.35001,133.78999,132.98,133.12,8506391,25904743.85,50.24225962800979,43.9255100746895,NaN,NaN,44.60666779047873,-2.5312325921676164,0.299570422628443,-0.7809148015796836,-1.0804852242081266,645823898,649891390.4,66.98944653350001,60.7537232385318,NaN,NaN,-9.519033986987587,-11.394862105882394
2007-08-28T09:30:00-04:00,132.53999,132.7,130.31,130.49001,13056016,25394954.25,42.47937358694499,43.14075760426614,NaN,NaN,-50.574589383742804,1.943232338806088,0.1755302478321208,-0.8610724144179756,-1.0366026622500963,632767882,647260948.8,65.38967392570584,60.87504423080606,NaN,NaN,-10.379327657857502,-11.249785756164552
2007-08-29T09:30:00-04:00,131.08,132.95,130.97,132.74001,10693801,23819977.1,49.64724765024791,43.57137755975207,NaN,NaN,-0.7307844206339013,5.68424971405587,0.24162293587740424,-0.734573992403341,-0.9761969282807452,643461683,644209387.8,63.49527537561678,60.77843150731672,NaN,NaN,-8.822299933155119,-10.903002067163206
2007-08-30T09:30:00-04:00,131.91,133.10001,131.75,132.57001,12705199,23323657.05,49.148900870732554,44.100105706552206,NaN,NaN,16.242739358528304,9.439543309334084,0.26843307696093655,-0.6406555820795745,-0.9090886590405111,630756484,641428047.2,61.73960559216976,60.48810101956541,NaN,NaN,-7.74092458188367,-10.451276712123272
2007-08-31T09:30:00-04:00,133.56,134.25,132.89999,133.39999,11117898,22176619.15,51.69810179157806,44.7573241190256,NaN,NaN,64.84465141708318,14.877736952342701,0.3324208209245323,-0.4935626328848457,-0.825983453809378,641874382,638936865.8,60.135732902021175,60.08292751618789,NaN,NaN,-6.072820596006753,-9.825782981249484
2007-09-04T09:30:00-04:00,133.22,134.89,133.11,134.34,11602898,21194884.05,54.481293755665924,45.88346630360729,NaN,NaN,90.25172103634404,24.006747601515762,0.42262062610733975,-0.29770767117520336,-0.7203282972825431,653477280,640467542.2,60.80940813481334,60.21628878269099,NaN,NaN,-3.8329088415225816,-8.96965810414564
2007-09-05T09:30:00-04:00,133.77,133.82001,132.49001,133.22,11230711,20174089.2,50.73053896954627,46.97699352995563,NaN,NaN,52.40891565254518,44.60344860877336,0.3920929570792575,-0.23021210093347122,-0.6223050580127287,642246569,642363279.6,61.673277269227924,61.20869851665578,NaN,NaN,-3.023818765177067,-8.120252484292987
2007-09-06T09:30:00-04:00,133.48,133.98,132.75999,133.53,10083922,19295570.1,51.72126929830361,48.065248158431345,NaN,NaN,78.70073772859273,60.48975303861869,0.37786155704852786,-0.14997811170206887,-0.5278396687505967,652330491,644137041.2,62.50605485646047,62.368474171092934,NaN,NaN,-2.0761711167989265,-7.256812288936692
2007-09-07T09:30:00-04:00,132.37,132.42,130.83,131.52,18245392,18255239.7,45.35324052902937,48.351529122856995,NaN,NaN,-17.198331456926027,53.80153887552782,0.22567217324096472,-0.24574945219939082,-0.47142162544035554,634085099,644802764.2,62.83247278761733,63.191358438942736,NaN,NaN,-3.1410846380805575,-6.668851195957244
2007-09-10T09:30:00-04:00,131.84,132.07001,130.24001,131.42999,14401602,17111370.2,45.08553799241523,48.519970458689656,NaN,NaN,-34.16417723502894,33.999773145105394,0.11700634069426219,-0.3251636995725278,-0.44217004026678997,619683497,640364587.2,59.136215960728826,63.43196578185278,NaN,NaN,-4.078090392319543,-6.2987425097232865
2007-09-11T09:30:00-04:00,131.89999,133.27,131.81,133.08,11502391,16832199.35,50.816695753079486,49.149769881936756,NaN,NaN,48.076126966546695,25.564654331145924,0.15209399966808101,-0.2520525406816887,-0.4041465403497697,631185888,635906308.8,55.597999467614535,63.10515852314702,NaN,NaN,-3.2110320783976936,-5.857641019533916
2007-09-12T09:30:00-04:00,132.92999,133.69,132.73,133.25,11402855,16359146.9,51.37971104937349,49.42449608027257,NaN,NaN,69.69034688801037,29.020940578238957,0.18064677547850927,-0.17833807100163312,-0.3589848464801424,642588743,635974743.6,55.64187259330482,62.3421166822274,NaN,NaN,-2.343977962305535,-5.355689154215575
2007-09-13T09:30:00-04:00,133.88,134.78,133.67,134.3,8320301,15326933.95,54.81984438291779,49.970749283630326,NaN,NaN,119.17995017661815,37.11678306784404,0.25935464305181455,-0.03479154266537421,-0.29414618571718876,650909044,635690454.2,55.39699413247111,61.432277198276815,NaN,NaN,-0.5993328741897835,-4.676209685640462
2007-09-14T09:30:00-04:00,133.53999,134.69,133.35001,134.46001,10337301,13215574.2,55.338446251462685,50.210175822093376,NaN,NaN,111.22791170250369,62.802031699729994,0.30798454968506234,0.09083450138913918,-0.21715004829592316,661246345,641122703.4,59.10094974511909,60.746069948312204,NaN,NaN,0.983353712259197,-3.8677006287976536
2007-09-17T09:30:00-04:00,134.12,134.59,133.69,134.06,8774102,11989644.1,53.67960779292936,50.455700691016204,NaN,NaN,99.46156765847041,89.52718067842986,0.2987717858664064,0.15631468403708482,-0.14245710182932156,652472243,647680452.6,63.08615531409355,60.467263432640316,NaN,NaN,1.8808904309923344,-3.046473334541941
2007-09-18T09:30:00-04:00,134.69,137.48,134.41,137.35001,18357808,12062234.5,63.397974922747444,51.94988650071638,NaN,NaN,226.5251205165784,125.2169793884362,0.4885947996151453,0.4682863976896101,-0.020308401925535208,670830051,655609285.2,67.24229471509378,60.59959348902516,NaN,NaN,5.850164077847107,-1.7755251327720771
2007-09-19T09:30:00-04:00,138.19,139.31,137.89,138.16,13554398,12020789.35,65.32675488521063,53.06985130321372,NaN,NaN,292.08414443981223,169.69573889879658,0.6338360577290264,0.7719866702357479,0.13815061250672142,684384449,663968426.4,70.95514269898524,61.132441154980064,NaN,NaN,9.742526213272642,-0.1300892261942601
2007-09-20T09:30:00-04:00,138.28999,138.31,137.53,137.7,9652508,11863444.85,63.28710484629918,54.0797230157542,NaN,NaN,202.2056726334968,186.3008833901723,0.6610281128937564,0.964435753623917,0.3034076407301606,674731941,668733005.8,72.84443896978806,61.925643539095645,NaN,NaN,12.328879516285511,1.6497634513028498
2007-09-21T09:30:00-04:00,138.37,139.02,137.89999,137.89999,8249801,11573119.85,63.816056046690626,54.94529117683366,NaN,NaN,179.37807426058419,199.9309159017884,0.6534161653400672,1.1201778474052446,0.46676168206517743,682981742,673080085.2,74.47576668074845,62.9499316661476,NaN,NaN,14.595992854585424,3.499224794628932
2007-09-24T09:30:00-04:00,138.36,138.64999,137.37,137.55,9445500,11562039.75,62.12902320388606,55.49155756599225,NaN,NaN,136.04705904593655,207.2480141792816,0.5878010676572261,1.20151301663671,0.613711948979484,673536242,677292885,75.98162458962915,64.03366141292015,NaN,NaN,16.02996997100716,5.28933124839725
2007-09-25T09:30:00-04:00,137.03,137.82001,136.83,137.72,13487102,11811075.3,62.64557467812192,56.342631545176225,NaN,NaN,102.44023502315817,182.43103708059758,0.521115200500948,1.265105949605669,0.743990749104721,687023344,680531543.6,77.100142886627,65.13558038559151,NaN,NaN,17.367107000827676,7.0147277844587395
2007-09-26T09:30:00-04:00,138.36,139.00999,138.03999,138.53,8384000,11577474.5,65.08895319259405,57.297466109054106,NaN,NaN,116.71058888806853,147.35632597024883,0.49690955702307393,1.3651276953835634,0.8682181383604894,695407344,682736122.6,77.85610268899902,66.23201237362998,NaN,NaN,19.207634348337713,8.756571579298592
2007-09-27T09:30:00-04:00,139.06,139.13,138.55,139.13,8949301,11490249.5,66.82025449864403,58.83082424974087,NaN,NaN,111.27664358048044,129.17052015964558,0.48606432780053443,1.4757985481111575,0.9897342203106231,704356645,688661063.4,79.78732697191147,67.44307338679384,NaN,NaN,21.272322200126887,10.544535953702635
2007-09-28T09:30:00-04:00,138.96001,139.10001,138.36,138.91,10128500,11361414.55,65.53688505484382,60.29163475420006,NaN,NaN,94.38585916093055,112.17207713971484,0.43072334898149656,1.5281384065374937,1.097415057555997,694228145,690910344,80.4832024262964,68.96785813433439,NaN,NaN,22.681507773047894,12.278389070751958
2007-10-01T09:30:00-04:00,138.96001,141,138.96001,140.60001,10164141,11313726.7,70.26194578922846,61.68058118535356,NaN,NaN,116.95056640172292,108.35277861087211,0.4713050323272867,1.6865463479651055,1.2152413156378188,704392286,697081552.8,82.28520416374427,70.8740870412008,NaN,NaN,25.363132913828885,14.147638191191518
2007-10-02T09:30:00-04:00,140.8,140.91,140,140.12,12706102,11368886.9,67.43395998826071,62.827313252416936,NaN,NaN,107.8661789583815,109.43796739791676,0.4303220167466919,1.7531438365711836,1.3228218198244917,691686184,698014120.8,82.54744517458866,72.79591365414964,NaN,NaN,26.835552490770237,15.96019737684562
2007-10-03T09:30:00-04:00,139.89,140.27,139.38,139.61,7918301,11203266.4,64.4651224136002,63.516261683179955,NaN,NaN,85.5644620806928,103.20874203644162,0.3374695427885446,1.7446587483101723,1.4071892055216277,683767883,695686228.6,79.38817115807959,74.50956915597882,NaN,NaN,27.26158600853996,17.574681467087668
2007-10-04T09:30:00-04:00,139.89999,140.03999,139.42999,139.50999,7235602,11060850.4,63.87127984345057,64.12574979689337,NaN,NaN,76.73733691860986,96.30088070406751,0.24236921995159633,1.7101507304611232,1.4677815105095269,676532281,690121355.8,72.26775640709882,75.45005534612024,NaN,NaN,27.45613504450924,18.986317692433605
2007-10-05T09:30:00-04:00,140.42999,141.21001,140.14,140.67999,9357898,10616475.7,67.62826601265962,65.12208252687411,NaN,NaN,98.606939672763,97.145096806434,0.23134196780097072,1.7569589702607402,1.5256170024597695,685890179,688453762.6,70.23483032182743,75.9606749895298,NaN,NaN,28.68082291521159,20.371247009973317
2007-10-08T09:30:00-04:00,140.56,140.58,140.00999,140.25999,5129398,10152865.5,65.01462351496038,65.2375574263179,NaN,NaN,85.98335387569787,90.95165430122898,0.17159079375953623,1.7401054946591898,1.5685147008996536,680760781,683727461.6,64.68126992714303,75.77774464753331,NaN,NaN,28.993650289288087,21.603018907018285
2007-10-09T09:30:00-04:00,140.67,141.64999,140.3,141.57001,9070602,10031276.05,69.03447245436891,65.50239439554349,NaN,NaN,111.69155496420763,91.7167295023942,0.1944474093231645,1.8115739625536094,1.6171265532304449,689831383,683356501.4,64.25183720339987,75.29893711213435,NaN,NaN,30.44796519635896,22.866582662638383
2007-10-10T09:30:00-04:00,141.39,141.44,140.05,140.73,9729602,9947613.4,63.9596541072279,65.55043362846696,NaN,NaN,93.14802481144756,93.23344204854516,0.13022972875936922,1.7799137141796564,1.6496839854202872,680101781,682623281,63.35647347050366,74.62122529075691,NaN,NaN,30.19415367009345,23.913378520846248
2007-10-11T09:30:00-04:00,141.36,141.95,139.46001,140.21001,21857616,10624479.15,60.97167316765606,65.34726342282164,NaN,NaN,79.87113386439201,93.86020143770159,0.03492807210253224,1.6933440755484526,1.6584160034459203,658244165,678965657.8,58.943805719701075,73.51179950782496,NaN,NaN,29.1007866614651,24.65443682664894
2007-10-12T09:30:00-04:00,140.37,141.12,140.09,141.12,7715902,10493409.2,64.1298150939691,65.49017712925612,NaN,NaN,84.3042211604859,90.99965773524616,0.01631782651218261,1.6788132865861485,1.6624954600739659,665960067,674979635.4,54.48979875408554,71.9766690910004,NaN,NaN,29.07369742481099,25.28575976924352
2007-10-15T09:30:00-04:00,141.08,141.11,139.00999,140.02,12383355,10673871.85,58.01819090089255,65.15964971659687,NaN,NaN,41.242944646544814,82.05157588941555,-0.08155820627967758,1.560547702224369,1.6421059085040466,653576712,669542821.6,49.04595871654174,69.97279879313717,NaN,NaN,27.17005524768184,25.55494483759185
2007-10-16T09:30:00-04:00,139.60001,139.64999,138.72,139.16,13954398,10453701.35,53.708646945342956,64.34677069893608,NaN,NaN,-19.964103060442763,55.720444284485474,-0.2084835485186407,1.3815014728557458,1.5899850213743865,639622314,659501007.8,40.91526021547796,67.33416718788567,NaN,NaN,24.20690193144433,25.362367279570776
2007-10-17T09:30:00-04:00,140.11,140.17999,137.74001,139.16,20253600,10788661.45,53.708646945342956,63.41022730227173,NaN,NaN,-32.97081152816117,30.49667701656376,-0.2916044319038955,1.2254794814945171,1.5170839133984126,639622314,651405114.4,35.76716627934576,64.18986999555955,NaN,NaN,21.83065945119379,24.857837589802635
2007-10-18T09:30:00-04:00,138.53,139.16,138.22,138.8,11615699,10886821,51.8392594343376,62.43182547223557,NaN,NaN,-59.75662534646544,2.5711251743922645,-0.36522192854377256,1.060556502718697,1.4257784312624695,628006615,645357604.4,32.479642636416685,60.76104429628242,NaN,NaN,19.298368956877404,24.06362778509903
2007-10-19T09:30:00-04:00,137.91,138.75301,134.92999,134.92999,33078496,12128255.75,36.950226266808684,60.05241693491988,NaN,NaN,-209.78318124219,-56.24635530614292,-0.6521919591865504,0.6105384822792814,1.2627304414658318,594928119,631151214.8,26.352042212598263,56.76581844262914,NaN,NaN,11.196380015090824,22.225449532240713
2007-10-22T09:30:00-04:00,134.06,135.75999,133.92,135.45,16391633,12475562.4,39.466110090807426,58.05471337081607,NaN,NaN,-239.81139572805273,-112.45722338106243,-0.7761964837024133,0.292484836837815,1.0686813205402284,611319752,622699822.8,23.510405682351205,52.548887050326464,NaN,NaN,5.681002345448505,19.861957076984684
2007-10-23T09:30:00-04:00,136.17,136.67999,135.27,136.42,13325602,12467487.4,43.958347552109764,56.589943737852465,NaN,NaN,-165.04214858907218,-141.47283248678832,-0.7610704447254815,0.11734326463337652,0.878413709358858,624645354,619704430.8,22.58099547824041,48.49123164462367,NaN,NaN,2.635692663280539,17.401062160741233
2007-10-24T09:30:00-04:00,136.10001,136.78999,134.56,136.5,22583728,13177473.8,44.32531272146964,55.19380322913954,NaN,NaN,-149.71176439363995,-164.82102305988408,-0.7145960832213902,-0.01483139466787975,0.6997646885535105,647229082,621225784.4,24.219567655147827,45.05921816234146,NaN,NaN,0.36917040348983754,14.967934766848177
2007-10-25T09:30:00-04:00,136.71001,137.28999,135.35001,136.89999,16618707,13560944.1,46.22143757799635,53.66474405523502,NaN,NaN,-105.99905839251618,-174.0695096690942,-0.6288597400339393,-0.08630998648891364,0.5425497535450257,663847789,628394019.2,31.56875279507659,42.297355481859256,NaN,NaN,-0.9151839039414069,12.698917813878237
2007-10-26T09:30:00-04:00,137.61,138.06,136.84,137.95,9929809,13551009.55,50.94452133928711,52.659736756972634,NaN,NaN,-53.5738243051913,-142.82763828169448,-0.4800931317532623,-0.05756666114655218,0.4225264706067101,673777598,644163915,44.354196682275635,40.84542167865443,NaN,NaN,-0.574380032744636,10.802732407217826
2007-10-29T09:30:00-04:00,138.28,138.87,138.16,138.64999,8663434,13475974.2,53.85411613720435,51.575425591460885,NaN,NaN,-11.919717275184837,-97.24930259112091,-0.3208621951718539,0.02144872664189279,0.34231092181374667,682441032,658388171,52.90191203286262,40.03471273790178,NaN,NaN,0.6031506642706574,9.345649301082517
2007-10-30T09:30:00-04:00,138.19,138.55,137.66,137.82001,8530934,13267215.8,50.06255162254901,50.58277541398382,NaN,NaN,-30.337895635947746,-70.308452000496,-0.26032737041611975,0.01690170879359698,0.27722907920971673,673910098,668241119.8,57.74394691491012,39.633817983930804,NaN,NaN,0.46108466979123885,8.07642578232662
2007-10-31T09:30:00-04:00,138.44,139.53,137.25999,138.95,19378672,13840234.35,54.735089880745754,50.13730517920451,NaN,NaN,-3.945433130519829,-41.155185747871975,-0.13915264674533212,0.10328827077805158,0.2424409175233837,693288770,677453057.4,61.707691247508365,39.83123837877419,NaN,NaN,1.7984974295908218,7.179578874792934
2007-11-01T09:30:00-04:00,137.86,137.89999,135.38,135.85001,25302240,14743566.25,42.88113721299131,48.61954247342038,NaN,NaN,-87.56841592895705,-37.46905725516015,-0.25595247303703134,-0.07749967377290545,0.17845279926412588,667986530,678280805.6,62.0521488967462,40.37140624610709,NaN,NaN,-1.1242695268797904,5.993314817411116
2007-11-02T09:30:00-04:00,136.19,136.23,134.38,136.05,20988192,15325080.95,43.72782582649297,47.59880211096327,NaN,NaN,-106.61778330148321,-48.077849054418536,-0.3046069153103565,-0.20230584487381975,0.10230107043653675,688974722,681320230.4,63.35564345555312,41.39352658460791,NaN,NaN,-3.0864824552573005,4.696200921315628
2007-11-05T09:30:00-05:00,134.84,136.11,134.39999,135.21001,13954781,15766350.1,40.98013377345307,46.689622598685425,NaN,NaN,-105.89322192999126,-66.87254998537982,-0.3736734380562875,-0.36479072713382266,0.008882710922464856,675019941,679836012.2,62.231495929911894,42.91611484992462,NaN,NaN,-5.592416357854427,3.226398452862764
2007-11-06T09:30:00-05:00,135.83,136.62,135.05,136.50999,11092316,15867435.8,46.57514268288734,46.18008657993859,NaN,NaN,-66.98908517694737,-74.20278789357975,-0.3144937127537909,-0.38423443001977375,-0.06974071726598287,686112257,682276444,63.381995042418595,44.88860261871553,NaN,NaN,-5.876038054958162,1.9260503803169173
2007-11-07T09:30:00-05:00,135.17999,135.73,132.92999,133.35001,18174320,16289671.7,37.31498845872993,45.14263865310948,NaN,NaN,-133.4829290838844,-100.11028708425266,-0.4619414558407613,-0.6471675370669345,-0.1852260812261732,667937937,677206277.4,59.337834085081276,46.807044865048724,NaN,NaN,-9.538880493454991,0.28820311263521625
2007-11-08T09:30:00-05:00,133.52,133.60001,130.83,132.45,38375616,17115571.7,35.170190299272306,45.01549322685688,NaN,NaN,-178.3252469392662,-118.2616532863145,-0.5858909750195176,-0.9175898000005702,-0.33169882498105263,629562321,669521435.6,53.74072894718691,48.76337963180505,NaN,NaN,-13.174388628571274,-1.6350242789657108
2007-11-09T09:30:00-05:00,131.28999,132.0795,130.17999,130.31,20911952,17775374.2,30.657903537094512,44.386335615877385,NaN,NaN,-211.59937258072492,-139.25797114216283,-0.7664125249882382,-1.2897144812163504,-0.5233019562281122,608650369,653456565,44.327618435903176,50.2503233999159,NaN,NaN,-17.904078515043306,-3.959174884119653
2007-11-12T09:30:00-05:00,130.35001,131.64999,129.74001,129.77,20703984,18191405.65,29.625033925998082,43.36252749972654,NaN,NaN,-199.65325025358766,-158.0099768068821,-0.8690740186446744,-1.609644479533955,-0.7405704608892807,587946385,636041853.8,36.802250914584015,51.26612735965473,NaN,NaN,-21.917754914420335,-6.52468631701975
2007-11-13T09:30:00-05:00,130.84,133.39999,130.8,133.14,15045613,18245966.4,42.61778649509392,43.240561340699706,NaN,NaN,-109.89884161124759,-166.59192809374215,-0.6660447912558025,-1.5731264499590338,-0.9070816587032313,602991998,619417802,31.333721150616967,51.774281180759665,NaN,NaN,-20.69250146058156,-8.548659908957152
2007-11-14T09:30:00-05:00,133.96001,133.99001,132.24001,132.71001,13709418,17918757.3,41.56338262145999,42.90784312951854,NaN,NaN,-80.84409324172707,-156.0641609253107,-0.5230461032429639,-1.560889287756936,-1.0378431845139722,589282580,603686730.6,27.212954716196535,51.463152746553945,NaN,NaN,-20.125409549528534,-10.202481286181635
2007-11-15T09:30:00-05:00,132.16,132.89,130.82001,131.47,18698144,18272879.55,38.59767227060287,42.02592533889823,NaN,NaN,-107.35295466126826,-141.8697024697111,-0.47567107802090236,-1.6324320320401,-1.1567609540191977,570584436,591891153.6,24.600463243682128,50.05217178665441,NaN,NaN,-20.666576250689143,-11.697351995396993
2007-11-16T09:30:00-05:00,131.75,132.02,130.39999,131.44,22488432,17743376.35,38.52604917741716,40.93106341319915,NaN,NaN,-104.61900911214242,-120.4736297759946,-0.4124104272023774,-1.6722739880221695,-1.2598635608197921,548096004,579780280.6,22.239716630763212,47.862014972218745,NaN,NaN,-21.10700584873254,-13.041588260159214
2007-11-19T09:30:00-05:00,131.02,131.6631,129.27,129.60001,21364512,17992020.3,34.31962224859842,39.80656845791697,NaN,NaN,-117.7761734797497,-104.098214421227,-0.45707856841258065,-1.8312117713355178,-1.3741332029229372,526731492,567537302,20.136050979305807,45.17573669110415,NaN,NaN,-22.848271618529104,-14.442543025640626
2007-11-20T09:30:00-05:00,129.83,131,128.32001,130.33,29927968,18822138.6,37.24700470667022,38.55741951691157,NaN,NaN,-110.43572831246891,-104.20559176147125,-0.4020009135923577,-1.8766343449133842,-1.4746334313210265,556659460,558270794.4,18.694669499593317,42.103377994824505,NaN,NaN,-23.34445575445668,-15.71424484404292
2007-11-21T09:30:00-05:00,129.12,129.64,127.78999,127.78999,18186704,18602287.4,31.91656360858326,37.77423568802528,NaN,NaN,-129.39307348935915,-113.91538781099766,-0.495059307179893,-2.0934575652958927,-1.5983982581159997,538472756,548108829.6,17.237453204693765,38.90232830253505,NaN,NaN,-25.564028610289224,-17.121356810649534
2007-11-23T09:30:00-05:00,128.72,129.67999,128.61,129.42,7232438,18132973.95,38.04420389067746,37.36826269260989,NaN,NaN,-98.85580296305535,-112.21595747135507,-0.4088389564994881,-2.1094469537403597,-1.7006079972408716,545705194,543132981.2,16.55690405354268,35.55956120239144,NaN,NaN,-25.364767344478707,-18.298986886910843
2007-11-26T09:30:00-05:00,129.7,130.32001,127.25,127.46001,11485898,18210778.4,34.07309620393687,36.87490286621588,NaN,NaN,-110.48866346890806,-113.38988834270819,-0.44294356179734207,-2.254287449487549,-1.811343887690207,534219296,540357639.6,16.173355354609967,32.26969401844131,NaN,NaN,-26.540251209087902,-19.476310361507565
2007-11-27T09:30:00-05:00,127.94,129.908,127.71001,129.32001,23078288,18931521.1,40.42800180092953,36.43582137464746,NaN,NaN,-89.70295361123712,-107.77524436900569,-0.3058853030732789,-2.1937005165318055,-1.8878152134585267,557297584,546470858,20.539811687430927,29.209538064513612,NaN,NaN,-25.342276907956006,-20.31430558242877
2007-11-28T09:30:00-05:00,130.48,133.25,130.41,132.83,17986320,19404290.4,50.186276652365095,37.35519910276425,NaN,NaN,-2.4522375605784412,-86.17854621862759,0.03726538404613633,-1.8412334834008561,-1.8784988674469925,575283904,550195746.8,23.166015795640206,26.62583675812496,NaN,NaN,-20.683297274000044,-20.367018681224664
2007-11-29T09:30:00-05:00,132.49001,133.48,132.17999,133.17,15928488,19231781.2,51.02318734815133,38.487556034827044,NaN,NaN,31.918832696973386,-53.91616498136109,0.28921599508788587,-1.516978873587135,-1.8061948686750209,591212392,560743674,30.20105084593959,24.94443117946444,NaN,NaN,-16.856307405685047,-19.86548849900472
2007-11-30T09:30:00-05:00,134.52,134.7,132.85001,134.16,18892240,18911281.2,53.474303854988676,40.11729891467663,NaN,NaN,71.7026109265178,-19.804482203446486,0.5116187976500666,-1.1666713716124377,-1.6782901692625043,610104632,573623561.6,37.702006583911746,24.471173190036485,NaN,NaN,-12.969407037269933,-18.88033400447118
2007-12-03T09:30:00-05:00,133.69,134.09,132.98,133.31,12645617,18494152.45,51.10924831256846,41.651885656574514,NaN,NaN,63.37717045293057,14.968684580921245,0.585252299725739,-0.9467247946053305,-1.5319770943310695,597459015,586271505.4,44.059508948469556,24.98954876388545,NaN,NaN,-10.561346908709778,-17.691907276505265
2007-12-04T09:30:00-05:00,132.50999,133.17999,132.36,132.42999,8192082,18206017.5,48.707405580799154,42.08685844841061,NaN,NaN,41.22737583944418,41.15475047105751,0.5585310200777491,-0.833813319233883,-1.3923443393116322,589266933,592665375.2,47.003832163582246,26.10884240766868,NaN,NaN,-9.3169433601281,-16.495483859879958
2007-12-05T09:30:00-05:00,133.69,134.67,133.53999,134.45,11852672,18244035.3,54.0459125655806,42.97846773013351,NaN,NaN,111.8818466521282,64.02156731359884,0.6541095773250714,-0.574707367655293,-1.2288169449803643,601119605,597832515.4,49.325089757143694,27.688280624879187,NaN,NaN,-6.537205683666679,-15.07287269184949
2007-12-06T09:30:00-05:00,134.39,136.39999,134.31,136.08,12317949,17951216.75,57.85748652680439,44.354168748433615,NaN,NaN,158.52179735085662,89.34216024437548,0.7949525419847974,-0.2351262674993677,-1.030078809484165,613437554,602277547.8,51.3011795795954,29.595474648872997,NaN,NaN,-2.9611795866015806,-13.342630819671218
2007-12-07T09:30:00-05:00,136.45,136.77,136.09,136.39,8482645,16456568.2,58.56143948540332,45.78526805614691,NaN,NaN,164.00970254089293,107.8035785672505,0.8707319654690299,0.058336147352122225,-0.8123958181169076,621920199,604640661.2,52.36467863395364,31.747257649100884,NaN,NaN,0.11391986010815637,-11.420266436845592
2007-12-10T09:30:00-05:00,136.78,137.63,136.50999,137.39999,7328336,15777387.4,60.85564544712113,47.68069828461283,NaN,NaN,163.36655538912993,127.80145555449037,0.9444454914515827,0.36816104619757084,-0.5762844452540119,629248535,610998565.2,55.19943809780122,34.251785300421986,NaN,NaN,3.3888805831200455,-9.30467400542193
2007-12-11T09:30:00-05:00,137.53999,137.89999,134.21001,134.39999,20366224,15760499.4,51.69967431089817,48.713031827771964,NaN,NaN,98.47056699032656,139.25009378466683,0.7549391920164519,0.36738954476655294,-0.38754964724989893,608882311,614921640.8,56.90365530179268,36.98099857200766,NaN,NaN,3.459787375161474,-7.481179522481444
2007-12-12T09:30:00-05:00,136.94,137.1199,133.33,135,15787988,15797618.15,53.21576436086047,50.23440331007748,NaN,NaN,78.57662904079369,132.58905026239995,0.6384096075787518,0.4104623622235408,-0.22794724535521096,624670299,619631779.6,58.92398168033585,39.958607748839235,NaN,NaN,3.983003127410434,-5.843439143925462
2007-12-13T09:30:00-05:00,134.28,135.36,133.63,135,14106434,15817468.95,53.21576436086047,51.318086200804835,NaN,NaN,59.567743620058366,112.7982395162403,0.533982786579873,0.43953123786963033,-0.0944515487102427,624670299,621878328.6,59.889815983857325,43.05381574386171,NaN,NaN,4.400510072108036,-4.380017827349248
2007-12-14T09:30:00-05:00,134.35001,135.13,133.42,133.45,12516316,15508377.55,48.64146906161388,52.35868426206748,NaN,NaN,37.04304841972441,87.40490869200659,0.34248153604725345,0.33365037134882414,-0.008831164698429317,612153983,619925085.4,58.59968246464124,46.08426768029251,NaN,NaN,3.4082729236892733,-3.267404862915174
2007-12-17T09:30:00-05:00,132.99001,133.14999,131.69,131.92999,10831930,14925552.45,44.5933487580172,52.6562090447166,NaN,NaN,-14.688622035320813,51.79387320711644,0.10757583902898875,0.12563863408780662,0.018062795058817874,601322053,614339789,54.954183121860694,48.54243706846607,NaN,NaN,1.3211328008842034,-2.6118994823724058
2007-12-18T09:30:00-05:00,132.67,132.92,131.06,132.55,13719813,14543317.5,46.54747182432238,52.39629441414212,NaN,NaN,-20.987095795076904,27.90234065003575,-0.005894889536074609,0.010694183138724611,0.01658907267479922,615041866,615571700,55.610122195911025,50.85987323991399,NaN,NaN,0.15777904492579925,-2.216231121329805
2007-12-19T09:30:00-05:00,132.50999,133.12,131.58,132.27,14342766,13764057.4,45.76251829794774,52.02053233912758,NaN,NaN,-21.52750312820246,7.881514216236527,-0.09472730933495793,-0.1018200639938982,-0.007092754658940267,600699100,610777460.2,52.41151540118418,52.44633499386003,NaN,NaN,-1.0220229789773654,-2.0456299581365993
2007-12-20T09:30:00-05:00,132.81,132.84,131.66,132.71001,12707855,13490114.95,47.267446725531556,51.577185401309215,NaN,NaN,-28.241741976474646,-9.680382903070077,-0.1172949134633893,-0.1537113964881769,-0.03641648302478759,613406955,608524791.4,50.92921487865647,53.3911355863418,NaN,NaN,-1.6067372105899753,-1.9829309942013673
2007-12-21T09:30:00-05:00,133.39999,134.64999,133.3,134.34,11032824,13680134.25,52.52287178505733,51.67815850648699,NaN,NaN,27.184636270850106,-11.652065332844936,-0.020936901368969286,-0.0625876097359992,-0.04165070836702991,624439779,610981950.6,52.50704193777983,53.99453079986396,NaN,NaN,-0.6405012285130139,-1.7911553133887455
2007-12-24T09:30:00-05:00,134.78999,135.48,134.74001,135.31,3655685,13288623.6,55.37320863556945,52.15428729611343,NaN,NaN,64.93685042173057,4.273029158565341,0.10283883627416818,0.08689783697568032,-0.01594099929848786,628095464,616336632.8,55.83943415251424,54.62564522764482,NaN,NaN,1.006612352578313,-1.3914742182505941
2007-12-26T09:30:00-05:00,135.00999,135.5,134.78999,135.42,5743035,12421860.95,55.698026905830005,52.27229546327411,NaN,NaN,62.00027687285915,20.87050369215255,0.18219336303142897,0.21180070449079835,0.02960734145936938,633838499,620095959.4,58.0641443242309,55.24986341100818,NaN,NaN,2.4524736150972806,-0.8423388134866121
2007-12-27T09:30:00-05:00,134.92999,134.99001,133.3483,133.67999,8129504,11929020.15,49.55382206312203,51.679176573011084,NaN,NaN,-9.30979998811095,23.314044320170854,0.11106706819992826,0.16844117670927972,0.05737410850935145,625708995,625097938.4,60.887532041728235,55.9346028725891,NaN,NaN,2.007258661248248,-0.4352534599530607
2007-12-28T09:30:00-05:00,134.22,134.39999,132.82001,133.41,7821688,11523680.15,48.65690766037431,50.971710014080436,NaN,NaN,-38.456843917861974,21.271023931893378,0.04291096545052725,0.1110128153225105,0.06810184987198326,617887307,625994008.8,61.38904311617115,56.57920033560464,NaN,NaN,1.3884004356883493,-0.1747314748614307
2007-12-31T09:30:00-05:00,133.13,133.24001,132.16,132.55,6463488,10902242.55,45.81249106387264,49.89719898670554,NaN,NaN,-83.09093329727746,-0.7840899817321343,-0.0575614855145576,-0.0038500070212137416,0.05371147849334386,611423819,623390816.8,59.02136159664672,56.85219487123646,NaN,NaN,0.05637721023874448,-0.14171594841854854
2008-01-02T09:30:00-05:00,132.47,132.67,129.82001,130.63,14814465,11010684.95,40.16695632012146,49.073433415935774,NaN,NaN,-151.48262934765285,-44.06798593560882,-0.2405377949448418,-0.24696076518770838,-0.006422970242866588,596609354,617093594.8,53.632602395366284,56.618548235063145,NaN,NaN,-2.852992099929218,-0.5290411129200727
2008-01-03T09:30:00-05:00,130.71001,131.27,130.13,130.74001,8206313,11011396.5,40.6184878162807,48.1736279484658,NaN,NaN,-150.07287658677413,-86.48261662753548,-0.33553527398443034,-0.4258420627234045,-0.09030678873897419,604815667,611289028.4,49.175677008073876,55.922240758473,NaN,NaN,-5.097688329898451,-1.181705001059841
2008-01-04T09:30:00-05:00,129.57001,129.73,127.82001,128.17,15027086,11170117.2,34.137189032033916,46.810872567835325,NaN,NaN,-198.06903837070954,-124.2344643040552,-0.5406772643645897,-0.7661533691947113,-0.22547610483012162,589788581,604104945.6,44.271999926940545,54.80668246869323,NaN,NaN,-9.254251181799377,-2.334925884022632
2008-01-07T09:30:00-05:00,128.53999,128.74001,127.22,128.06,19669440,11537691.75,33.88794425237802,45.757049367175625,NaN,NaN,-182.65272361327337,-153.07364024313748,-0.6458774144610859,-1.032822872906479,-0.3869454584453931,570119141,594551312.4,38.73965575622714,53.38810913237794,NaN,NaN,-12.664362474959368,-3.81055968272788
2008-01-08T09:30:00-05:00,128.53,129,125.63,125.85001,21236768,12175397.9,29.26490354349218,44.66216042328098,NaN,NaN,-190.75741048017215,-174.6069356797164,-0.8154655601252354,-1.4062774086019374,-0.590811848476702,548882373,582043023.2,32.93641703404924,51.81541155467712,NaN,NaN,-17.250441437966288,-5.730542790619081
2008-01-09T09:30:00-05:00,126.12,127.39,125.00999,126.96001,24162224,13017092.3,34.12578781724791,43.77489727991853,NaN,NaN,-176.23560717333103,-179.55753124485204,-0.8027881465203583,-1.5942970316271499,-0.7915088851067915,573044597,577330071.8,31.049105874161725,50.061053245980744,NaN,NaN,-19.596587771866723,-7.711406359368744
2008-01-10T09:30:00-05:00,126.52,129.32001,126.28999,127.82001,25310656,13264313.9,37.698040675108736,43.19886316400146,NaN,NaN,-114.44970624815164,-172.43289717712756,-0.690659481787067,-1.6548332373406254,-0.9641737555535583,598355253,576037989,30.53255585437408,48.498270421208595,NaN,NaN,-20.452690506721275,-9.531589808990534
2008-01-11T09:30:00-05:00,127.52,127.58,125.41,126.19,22464384,13598133.7,33.94114022831904,42.24698412848627,NaN,NaN,-131.23119785550537,-159.06532907408672,-0.6794071378441016,-1.8134326778586853,-1.1340255400145838,575890869,573258446.6,29.39945088420839,46.960430135890874,NaN,NaN,-22.37846826858727,-11.366858160361495
2008-01-14T09:30:00-05:00,127.28,127.92,126.69,127.50999,7933402,13289482.1,39.22331730014176,41.297015950992304,NaN,NaN,-93.32064066163858,-141.19891248375978,-0.542161369377328,-1.8117272517362437,-1.2695658823589158,583824271,575999472.6,32.07647175087021,45.501103693968766,NaN,NaN,-22.337399128455694,-12.934078298660665
2008-01-15T09:30:00-05:00,126.49001,126.91,124.88,125.3,19819504,13654641.5,34.28090957303094,39.790423160810974,NaN,NaN,-117.77613262902535,-126.60265691353041,-0.5571793947825108,-1.9660401258370541,-1.4088607310545433,564004767,579023951.4,35.00497600282726,44.01292811184826,NaN,NaN,-23.929694540679023,-14.504880618949002
2008-01-16T09:30:00-05:00,124.64,126.14,123.94,124.64999,25575184,14391804.2,32.96518735069695,38.1666489068729,NaN,NaN,-117.58944571195808,-114.8734246212558,-0.5660219428901105,-2.1163881596671814,-1.5503662167770709,538429583,572100948.6,31.642039017382075,42.12563487564477,NaN,NaN,-25.629020665522734,-16.09404348274525
2008-01-17T09:30:00-05:00,125.05,125.2,121.27,121.77,30903728,15250999.95,27.862613002854644,36.61727683113951,NaN,NaN,-141.61376837651713,-120.30623704692889,-0.7115523159408501,-2.4398066117031334,-1.7282542957622833,507525855,553935069,24.8860183444324,39.55409818298079,NaN,NaN,-28.910262714440606,-17.924931944416013
2008-01-18T09:30:00-05:00,122.33,123.28,120.12,120.57001,35593968,16313560.05,26.05308900637732,35.002718355854014,NaN,NaN,-148.31451321731043,-123.7229001192899,-0.8262915800759179,-2.7611187708571805,-1.9348271907812626,471931887,533143272.6,19.701144156525032,36.57639111443463,NaN,NaN,-32.184976665003845,-19.962081190214274
2008-01-22T09:30:00-05:00,116.31,120.69,115.8,119.22,38326144,17594474.5,24.152660555168126,33.45558760523227,NaN,NaN,-175.12207476978415,-140.083186940919,-0.9234073921152914,-3.089086430925377,-2.1656790388100857,433605743,503099567,14.877636967591954,33.423267926645,NaN,NaN,-35.51722415253417,-22.184244470545686
2008-01-23T09:30:00-05:00,117.24001,122.81,116.38,122.7,42846464,19185156.5,36.92514795009883,33.22402986451636,NaN,NaN,-127.29496215157162,-141.98695284542828,-0.6940416078120144,-3.0332310485751037,-2.3391894407630893,476452207,485589055,12.895871688504414,30.513501447583444,NaN,NaN,-33.95140846274504,-23.865267898002738
2008-01-24T09:30:00-05:00,122.89999,123.92,122.25999,123.42999,20567792,20030761.85,39.23667516596481,33.125328960922374,NaN,NaN,-75.38337818978547,-133.54573934099375,-0.44598456980374124,-2.896670153017766,-2.4506855832140246,497019999,477307138.2,12.076508671968469,27.86356085214734,NaN,NaN,-31.94073888704139,-25.018906610722546
2008-01-25T09:30:00-05:00,124.64,124.71001,121.72,122.19,19580608,20722640.5,36.77154102407758,33.31349696035406,NaN,NaN,-74.67072633609341,-120.15713093290901,-0.3239188082296778,-2.855584093501122,-2.531665285271444,477439391,471289845.4,11.50456805903606,25.523030004439875,NaN,NaN,-31.109507471578894,-25.88899244798774
2008-01-28T09:30:00-05:00,122.02,123.8,121,123.53,19413264,21286828.5,41.07963423074532,33.82718910166601,NaN,NaN,-68.87846878450432,-104.2699220463478,-0.12183361583485075,-2.6839573050650074,-2.5621236892301567,496852655,476273999,15.091599276404452,23.833883113023973,NaN,NaN,-29.01232729782087,-26.335183140821044
2008-01-29T09:30:00-05:00,124.25,124.89999,123.34,124.53999,15258480,21658668.1,44.167487292625594,34.89165936946125,NaN,NaN,-31.24148975106062,-75.4938050426031,0.09902978206760737,-2.4383364616456475,-2.537366243713255,512111135,491975077.4,25.35596584689803,23.29242231394174,NaN,NaN,-26.309072276836464,-26.331453017394676
2008-01-30T09:30:00-05:00,124.21001,126.67999,123.48,123.78,24848112,22577899.3,42.36817543985143,35.48040134250436,NaN,NaN,-14.97531678977883,-53.02987597024454,0.20690327360145222,-2.2787371517114394,-2.4856404253128916,487263023,494137240.6,26.670595200626636,22.979671551546378,NaN,NaN,-24.645510600632374,-26.090604100714348
2008-01-31T09:30:00-05:00,122.67,126.89999,122.41,126,22259568,22950154.45,48.91494952834247,36.281609117735336,NaN,NaN,4.504859613743484,-37.052228409538735,0.42800639971022525,-1.95063242567511,-2.378638825385335,509522591,496637759,28.244539804570053,22.816241833703234,NaN,NaN,-21.078022907012958,-25.37452107304272
2008-02-01T09:30:00-05:00,126.49001,127.61,125.96001,127.42999,18101376,23444907.6,52.6464399409062,37.61770195434871,NaN,NaN,68.53876710759073,-8.41032972080191,0.6570969701674794,-1.557267612675986,-2.2143645828434653,527623967,506674674.2,34.336925378124604,23.168918583268674,NaN,NaN,-16.889083855088334,-24.162315756192093
2008-02-04T09:30:00-05:00,127.21001,127.25999,125.98,126.03,11724227,23279764.65,48.881889627343796,38.30759997772027,NaN,NaN,56.70753306093454,16.70687064828586,0.6970842405794824,-1.3430092821191124,-2.040093522698595,515899740,510484091.2,36.5392462617498,23.487688191188646,NaN,NaN,-14.554147694955596,-22.789720318872593
2008-02-05T09:30:00-05:00,124.69,124.88,122.55,122.96001,16358945,23114239.9,41.819945594337106,38.846102550670714,NaN,NaN,-32.074423922589745,16.540283813980032,0.508284732706588,-1.4047376068153596,-1.9130223395219477,499540795,507970023.2,35.688517571542874,23.53651258895405,NaN,NaN,-14.8299012485611,-21.652603308828095
2008-02-06T09:30:00-05:00,123.41,123.92,121.81,122.25999,14259344,22765368.7,40.38717094514336,39.37624423598832,NaN,NaN,-52.559822265924474,9.023382718750902,0.3360707517169341,-1.49293389987578,-1.829004651592714,485281451,507573708.8,35.548011747710206,23.815510641120344,NaN,NaN,-15.51105645454935,-20.77523947250256
2008-02-07T09:30:00-05:00,121.60001,123.39,121.25,122.73,21048352,22609675.1,41.828250263829304,40.373789754629364,NaN,NaN,-53.4395545821437,-2.5655001204265346,0.25718260708953466,-1.5075263927307958,-1.7647089998203305,506329803,506935151.2,35.30681620224172,24.559853345249586,NaN,NaN,-15.618584704554737,-20.03857450565287
2008-02-08T09:30:00-05:00,122.17999,122.88,121.08,121.75,15527289,22120506.75,39.67465083616629,41.346758456757144,NaN,NaN,-66.14202271090844,-29.50165808412637,0.14780231367343655,-1.5799561077285347,-1.7277584214019712,490802514,499570860.6,32.56277342101653,25.47854114985612,NaN,NaN,-16.35682668036899,-19.512610530612317
2008-02-11T09:30:00-05:00,121.69,122.59,120.75999,122.32001,11659109,21580243,41.55938914738596,42.59009621334413,NaN,NaN,-61.350557403400245,-53.113276176993324,0.12362517357472491,-1.573226954433565,-1.69685212800829,502461623,496883237.2,31.59759300482088,26.6728237239439,NaN,NaN,-16.420084117744608,-19.070821043059787
2008-02-12T09:30:00-05:00,123.17,124.74001,122.96001,123.77,18463760,22106760.9,46.166914196526676,43.250222373803275,NaN,NaN,21.77967560236469,-42.34245627200244,0.2099956259796627,-1.4343575955337116,-1.6443532215133743,520925383,501160154.8,34.90423373167934,28.24484958417068,NaN,NaN,-15.11629693177009,-18.50588902716126
2008-02-13T09:30:00-05:00,124.50999,125.85001,124.16,125.25999,12487273,21740149.35,50.48684315611263,44.053805801670975,NaN,NaN,79.41076747624734,-15.948338323568072,0.3632015699110105,-1.1903512591246113,-1.5535528290356218,533412656,510786395.8,41.731685101496744,30.36307647199413,NaN,NaN,-12.690009648883088,-17.675049115978663
2008-02-14T09:30:00-05:00,125.69,125.7,123.75,124.00999,11299898,21026385.05,47.07397475213932,44.789693925103954,NaN,NaN,54.598239468458246,5.659220486552317,0.37457982584106553,-1.0853280467342898,-1.4599078725753554,522112758,513942986.8,43.81276982981194,32.67080516990669,NaN,NaN,-11.636563881847303,-16.812408368245613
2008-02-15T09:30:00-05:00,123.34,123.57001,122.67,123.33,9759535,19969175.4,45.280760287396845,45.089774357721915,NaN,NaN,-4.482929226007677,17.991039183532468,0.33198973097319007,-1.044920708858868,-1.376910439832058,512353223,518253128.6,46.61641450117943,34.92257768596205,NaN,NaN,-11.28265545450047,-16.022443666282022
2008-02-19T09:30:00-05:00,124.73,124.95,122.96001,123.67999,9395457,18659249.85,46.41226038288095,45.25011529274015,NaN,NaN,21.307024078167135,34.52255547984595,0.3227802081430571,-0.9734351796532366,-1.2962153877962936,521748680,522110540,49.06594410728507,36.61614756170398,NaN,NaN,-10.672374846625681,-15.25814812061683
2008-02-20T09:30:00-05:00,122.53999,124.57001,122.23,124.09,15688215,17527353.4,47.77470524945874,45.636295993426394,NaN,NaN,-2.216835098306135,29.72325333971178,0.3380704143780682,-0.8736273698237085,-1.2116977842017767,537436895,525412842.4,51.133200817743806,38.36347653435521,NaN,NaN,-9.787677474872368,-14.476652314081907
2008-02-21T09:30:00-05:00,124.67999,124.98,122.47,123.2,13492520,16059656.2,45.09456255147806,45.36341120936464,NaN,NaN,-17.036816872013798,10.433736470059552,0.2841809062771874,-0.8564716513552924,-1.1406525576324797,523944375,523519186.2,49.88292160957929,39.90907523471301,NaN,NaN,-9.752759731915049,-13.801810516629498
2008-02-22T09:30:00-05:00,123.21001,124.05,121.56,123.8,13730340,15717783.6,47.24330046416648,44.9774726753118,NaN,NaN,-43.28702737448953,-9.143316898530005,0.284196483846223,-0.785406952824701,-1.069603436670924,537674715,526631577.6,51.96198090611491,41.168007772426606,NaN,NaN,-9.142564891878514,-13.136203998807929
2008-02-25T09:30:00-05:00,123.72,125.85001,123.41,125.57001,14538023,15465654.35,53.07722649112585,45.27713959415338,NaN,NaN,64.4728081163697,4.647830569945472,0.3920174717657743,-0.5795815969637061,-0.9715990687294804,552212738,534603480.6,56.89447477402225,42.62195266616035,NaN,NaN,-6.914976247910615,-12.24745717725117
2008-02-26T09:30:00-05:00,125.14,127.33,125.11,126.81,13935469,15191764.6,56.69044454812515,46.33931809085253,NaN,NaN,134.50867512337197,27.28816077898644,0.5270385227109203,-0.31280091534083,-0.8398394380517503,566148207,543483386,61.621621689124545,44.474317245987606,NaN,NaN,-3.9133929068133253,-11.05687656718862
2008-02-27T09:30:00-05:00,126.22,127.57001,126.11,126.83,11540430,15005862.1,56.74829546165337,47.50796984203181,NaN,NaN,134.7790024040716,54.68732827946199,0.5929718805223696,-0.09862458739878832,-0.6915964679211579,577688637,551533734.4,65.33329499797296,46.60183747814923,NaN,NaN,-1.4486430736814655,-9.684271782401884
2008-02-28T09:30:00-05:00,126.10001,126.47,125.38,125.84,9002023,14213557.65,52.976082383340994,48.304243564854076,NaN,NaN,78.8302108142877,73.86073381672229,0.5463387318450256,-0.008673053114875984,-0.5550117849599016,568686614,560482182.2,68.93027668259637,49.003513226745994,NaN,NaN,-0.3404283965046364,-8.349437012987991
2008-02-29T09:30:00-05:00,124.7,124.7,122.28,123.00999,17090816,13955120.05,43.97685850124676,48.61154411235982,NaN,NaN,-42.95943467422471,73.92625235677525,0.3129253083034539,-0.16385514958058423,-0.4767804578840381,551595798,563266398.8,69.97418058879747,51.67575659587321,NaN,NaN,-2.0881284609832953,-7.454964362701606
2008-03-03T09:30:00-05:00,122.47,122.85001,121.64999,122.5,11898066,13644954.55,42.57333007469716,48.683968464310624,NaN,NaN,-88.30134064776166,43.37142260394898,0.12202258070602034,-0.32425223200151265,-0.446274812707533,539697732,560763397.6,67.76972387405664,54.25948022939004,NaN,NaN,-3.9446558715566007,-6.9534917211094625
2008-03-04T09:30:00-05:00,121.50999,122.42,120.36,122.39999,20448720,14081179.2,42.288304562532375,48.406924919025315,NaN,NaN,-116.17522971725232,-6.765358364175879,-0.0063419781423100785,-0.4542022853854206,-0.44786030724311054,519249012,551383558.6,60.12537402208894,56.06099025013359,NaN,NaN,-5.533116924931253,-6.7505810359411464
2008-03-05T09:30:00-05:00,122.63,123.59,121.53999,122.87,14589203,13992692.1,44.17971809735355,47.95641598625682,NaN,NaN,-57.79547459481701,-45.2802537639536,-0.05238794271676345,-0.5133452356390649,-0.4609572929223014,533838215,542613474.2,53.99291460592971,56.93679235759309,NaN,NaN,-6.349235204549405,-6.693245917170898
2008-03-06T09:30:00-05:00,122.2,122.39,120.31,120.8,13432781,13951363.95,38.2361795653992,47.32514490148966,NaN,NaN,-131.35675808692278,-87.3176475441957,-0.20640250318127806,-0.718960421898899,-0.5125579187176209,520405434,532957238.2,48.16758448865822,57.24785054751068,NaN,NaN,-8.900866140938703,-7.008620234852013
2008-03-07T09:30:00-05:00,119.47,121.0399,118.3,118.92999,20099104,13903901.55,33.81093218448153,46.50587146556715,NaN,NaN,-194.06361463469128,-117.53848353628901,-0.4067826624512445,-1.0210362467816765,-0.614253584330432,500306330,522699344.6,42.87548698187882,56.98064143898921,NaN,NaN,-12.580168889192379,-7.804555756900637
2008-03-10T09:30:00-04:00,119.28999,119.31,117.46001,117.98,17814384,14018256.3,31.79759234802303,45.46196660593443,NaN,NaN,-212.89142378559248,-142.45650016385517,-0.5660789547031945,-1.321852277709425,-0.7557733230062306,482491946,511258187.4,37.876934679186135,56.18142647983928,NaN,NaN,-16.286796770930444,-9.016304473190608
2008-03-11T09:30:00-04:00,120,122.06,118.95,122.06,20308640,14450732.85,46.52527226270688,45.37272139259501,NaN,NaN,-90.98510888471793,-137.41847599734828,-0.36898168090054395,-1.2170004241319106,-0.8480187432313666,502800586,507968502.2,36.55722773862681,55.14028554561664,NaN,NaN,-14.6552581403109,-9.821869282779222
2008-03-12T09:30:00-04:00,122.03,123.21001,121.12,121.39999,13040836,14179586.65,44.83848393708541,45.35443006299554,NaN,NaN,-49.37491768543932,-135.73436461547277,-0.260491369950419,-1.1736329556693903,-0.9131415857189713,489759750,499152809.2,33.21718306301558,53.94987564943352,NaN,NaN,-13.945367519249926,-10.410940459417894
2008-03-13T09:30:00-04:00,119.82001,122.37,118.97,121.50999,24145136,14762479.8,45.19511387324399,45.20813102078679,NaN,NaN,-78.0005438895709,-125.06312177600239,-0.16349147624552263,-1.1175059310258746,-0.954014454780352,513904886,497852699.6,32.74207391040201,52.57702514973975,NaN,NaN,-13.27975138096688,-10.820770591067749
2008-03-14T09:30:00-04:00,122.37,122.37,118.50999,120.02,29251984,15660084.1,41.30010780057922,44.36690825717632,NaN,NaN,-92.3490603110691,-104.72021091127795,-0.18051344196264618,-1.1796562572336597,-0.9991428152710136,484652902,494722014,31.57105511122205,50.768209459539726,NaN,NaN,-13.945234643654306,-11.267122598580114
2008-03-17T09:30:00-04:00,117.67999,120.96001,117.64999,120.09,27008576,16522536.15,41.55494556778234,43.28580118715183,NaN,NaN,-105.59374588816547,-83.26067533179254,-0.16814343659737063,-1.2093221110177268,-1.0411786744203562,511661478,500555920.4,36.15352177101251,48.94905946538887,NaN,NaN,-14.398090618720815,-11.7144037443145
2008-03-18T09:30:00-04:00,121.81,124.25,121.2,124.05,23106880,17208107.3,53.779720769786174,43.073760137732755,NaN,NaN,23.670703103075184,-60.32951293423391,0.1106343758581756,-0.9028857045976366,-1.0135200804558122,534768358,506949474.8,40.83009693811361,47.198831032541776,NaN,NaN,-10.650875835592716,-11.562471185925673
2008-03-19T09:30:00-04:00,124.48,124.82001,121.02,121.44,17646416,17306017.35,46.827492517516056,42.63457514731669,NaN,NaN,-0.9068696880825612,-50.635903334762574,0.12224323762994216,-0.8607160334183845,-0.9829592710483267,517121942,512421913.2,44.57241043011836,45.45898344307907,NaN,NaN,-9.879957365447007,-11.322112068714436
2008-03-20T09:30:00-04:00,121.50999,123.69,120.89999,123.11,15874902,17425136.45,51.176544879855115,43.14883846007443,NaN,NaN,6.326908302779806,-33.77041289629243,0.238648205392767,-0.684649014307368,-0.923297219700135,532996844,516240304.8,47.08710419734759,43.824192272261214,NaN,NaN,-7.728721886928152,-10.808770614173538
2008-03-24T09:30:00-04:00,124.05,126.10001,123.96001,125.34,15262375,17501738.2,56.314791906686246,44.13037144807366,NaN,NaN,95.13499893764123,3.7263989534496345,0.4498291655968527,-0.36101076270406907,-0.8108399283009218,548259219,528961568.2,54.49438140407319,42.875953524405254,NaN,NaN,-4.111531075792006,-9.852022108690463
2008-03-25T09:30:00-04:00,125.39,125.61,124.39999,125.13,12031723,17376423.2,55.72009262463359,45.08978488108089,NaN,NaN,91.53282507574832,43.151713146232396,0.5526030754785664,-0.1200860839527138,-0.6726891594312802,536227496,533874771.8,56.99820022765295,42.65258396765983,NaN,NaN,-1.5278611348409532,-8.66285625528339
2008-03-26T09:30:00-04:00,124.78999,124.80009,123.67999,123.92,12739629,17316631.2,52.29341911027716,45.669334953432575,NaN,NaN,67.16923172996077,51.85141887160951,0.516964810223153,-0.026483146652338974,-0.543447956875492,523487867,531618673.6,55.48840502811429,42.75940471210158,NaN,NaN,-0.49913459537365035,-7.496610303867714
2008-03-27T09:30:00-04:00,124.56,124.7,122.83,123.14999,17362560,17607737.7,50.17859116643246,46.522364353506376,NaN,NaN,56.371120138148235,63.30701683685568,0.42334155836476467,-0.014271008919536143,-0.4376125672843008,506125307,529419346.6,53.98711867342981,43.17508572529955,NaN,NaN,-0.31828681258882663,-6.471135519399302
2008-03-28T09:30:00-04:00,123.42999,123.71001,121.87,122.23,11110730,17713173.05,47.69667269886033,47.5142029616763,NaN,NaN,25.205151729544255,67.08266552220856,0.2877460715629211,-0.07792997783064948,-0.36567604939357057,495014577,521822893.2,49.0506971667552,43.61617216707644,NaN,NaN,-0.9239767010548918,-5.678684259635815
2008-03-31T09:30:00-04:00,121.89999,123.17,121.67999,122.39999,11661695,17441717,48.20643742664805,48.686263324435224,NaN,NaN,19.16558431565035,51.88878259781038,0.20185548622074512,-0.11335669161763917,-0.3152121778383843,506676272,513506303.8,44.27735247503163,44.073344866779685,NaN,NaN,-1.2678110805029403,-5.0485595197596895
2008-04-01T09:30:00-04:00,123.89,126.46001,123.85001,126.07001,21138336,17903730.5,57.77487717256193,49.48980653228201,NaN,NaN,143.5496354443886,62.29214467153845,0.37452516498810373,0.1529442783967454,-0.22158088659135833,527814608,511823726.2,43.35804284750051,44.55911737455638,NaN,NaN,1.496473436154841,-4.113554811771899
2008-04-02T09:30:00-04:00,126.36,126.87,125.45,126.19,13767059,17569647.45,58.04776349330498,50.43332650058341,NaN,NaN,151.65369631819425,79.18903758918513,0.47279553857821693,0.36941353663141285,-0.10338200194680408,541581667,515442486.2,45.956942075065776,45.469100161131394,NaN,NaN,3.761615356523393,-2.988530502015429
2008-04-03T09:30:00-04:00,125.53,126.64,125.22,126.33,11473621,17413868.35,58.3856891890139,51.375510451709836,NaN,NaN,127.82963644685486,93.48074085092647,0.5194817684534703,0.5459702086200338,0.026488440166563515,553055288,524828482.4,52.096332209522494,46.85154718249714,NaN,NaN,5.6890913526505935,-1.7488702370631404
2008-04-04T09:30:00-04:00,126.28999,126.81,125.2,126.10001,12506801,17367569.35,57.565351136707335,52.53731354714756,NaN,NaN,110.4321322220404,110.5261369494257,0.5065927856172349,0.6597294221881072,0.15313663657087226,540548487,533935264.4,57.17920554739487,48.68070078508092,NaN,NaN,7.055035805899218,-0.49116937378280356
2008-04-07T09:30:00-04:00,126.75999,127.22,125.75,126.05,12894355,17007331.9,57.37657215914004,53.66742973224454,NaN,NaN,108.57968680629394,128.40895744755443,0.46737015109769553,0.7373493254429917,0.26997917434529617,527654132,538130836.4,59.32073728448325,50.33550189318597,NaN,NaN,8.137823474179488,0.7415438902118094
2008-04-08T09:30:00-04:00,125.42,126.13,125.24001,126.13,12908273,16762026.35,57.616020602002244,53.941451148831405,NaN,NaN,83.15535880051488,116.33010211877968,0.4209299125438509,0.7961415650251098,0.3752116524812589,540562405,540680395.8,60.60992236504859,51.74834656653847,NaN,NaN,9.110073462280386,1.9370481147930345
2008-04-09T09:30:00-04:00,126.05,126.2,124.67,125.64999,15038793,16498534,55.59781077580795,54.56790245299511,NaN,NaN,64.25150694655485,98.84966424445179,0.335702379322785,0.7948396266347402,0.45913724731195515,525523612,537468784.8,58.111605291445116,52.7154319137761,NaN,NaN,9.447089421129649,3.0099111585554077
2008-04-10T09:30:00-04:00,125.50999,126.47,124.99001,125.95,14357852,16564384.8,56.62057833410565,54.95676198544158,NaN,NaN,68.37049230807695,86.9578354166962,0.27964540986531783,0.8086940096436024,0.5290485997782846,539881464,534834020,56.06969970319382,53.357045878479404,NaN,NaN,9.991470608830891,4.007276794309048
2008-04-11T09:30:00-04:00,124.55,124.7,123.00999,123.34,16744695,16194362.75,46.570433870839196,54.260736411452505,NaN,NaN,-16.437424551385853,61.583924062010944,0.058463175274272805,0.6021275688711256,0.5436643935968528,523136769,531351676.4,53.39902751410673,53.27880631491037,NaN,NaN,7.665327265290858,4.529855433020735
2008-04-14T09:30:00-04:00,123.32001,123.67999,122.78951,123.17,11704277,15316977.4,45.99773340983711,53.566282181824185,NaN,NaN,-45.39518888529866,30.788948923692438,-0.09903978795816515,0.41986465864914635,0.5189044466073115,511432492,528107348.4,50.96351938782667,52.84775768349421,NaN,NaN,5.578284922927343,4.679631074435965
2008-04-15T09:30:00-04:00,123.75,123.84,122.7,123.48,12534961,14593296.65,47.2711285291108,53.20754714031229,NaN,NaN,-55.048986578107844,3.1480798479678924,-0.17751504163865334,0.29701064455899484,0.4745256861976482,523967453,524788358,48.52520586893487,52.35038631498139,NaN,NaN,4.146190907224674,4.603425336262923
2008-04-16T09:30:00-04:00,124.53,126.64999,124.52,126.64,16756012,14275753.25,58.11371923712782,53.77434200250482,NaN,NaN,69.71458640047103,4.240695738751128,-0.020058520953145587,0.4494525350062162,0.46951105595936177,540723465,527828328.6,50.84498194747619,52.125947977413276,NaN,NaN,6.05147342503821,4.810289348945107
2008-04-17T09:30:00-04:00,125.8,126.7,125.66,126.7,13297176,14058291.25,58.28910042011696,54.53094398259458,NaN,NaN,84.54909277797141,7.476415832730015,0.07923229373995794,0.5685514231343092,0.48931912939435124,554020641,530656164,52.968283621935,52.405775581354696,NaN,NaN,7.629462012993224,5.21302830095198
2008-04-18T09:30:00-04:00,127.96001,128.83,127.75999,127.86,16945792,14111835.75,61.63375954198856,55.490038419404605,NaN,NaN,168.2770191293616,44.41930456887951,0.20687982597246024,0.7479189118599265,0.5410390858874663,570966433,540222096.8,59.3630264149618,53.48332371992114,NaN,NaN,10.0009832418136,5.897021863932212
2008-04-21T09:30:00-04:00,127.74001,128.34,127.41,128.03,10798215,13888627.75,62.11323397838835,55.799921048392214,NaN,NaN,136.36151376815076,80.7706450995694,0.2819582966802011,0.8934869567377177,0.6115286600575166,581764648,554288528,66.56258994252227,55.140791369565555,NaN,NaN,12.077900588897275,6.780004538927221
2008-04-22T09:30:00-04:00,127.75,127.85001,126.44,127.37,10087141,13791398.65,59.02890538284753,55.870002611930964,NaN,NaN,91.61463119286209,110.1033686537634,0.26654045959929773,0.9447042345566388,0.678163774957341,571677507,563830538.8,70.39436380272114,56.88632149296951,NaN,NaN,12.987633214259715,7.666808635403291
2008-04-23T09:30:00-04:00,127.49001,128.24001,126.91,127.3,10443191,13676576.75,58.695997732351934,55.892167507883684,NaN,NaN,97.18859172345296,115.59816971835976,0.2322544405272421,0.9684818256163936,0.7362273850891515,561234316,567932709,71.88595245011183,58.299865795868755,NaN,NaN,13.650326816809798,8.521596947032792
2008-04-24T09:30:00-04:00,127.77,129.31,126.94,128.10001,14615734,13539235.45,61.376941857633966,56.164423987949874,NaN,NaN,119.68792565583284,122.62593629393204,0.24293219114308584,1.0398926240180089,0.796960432874923,575850050,572298590.8,73.42078099748676,59.459978328018174,NaN,NaN,14.964594181647664,9.442025123406346
2008-04-25T09:30:00-04:00,128.91,128.94,127.32001,128.8,12364246,13601911.25,63.603028090911806,56.609170840219285,NaN,NaN,126.6908976731703,114.3087120026938,0.2742958818361123,1.1398302851700635,0.8655344033339512,588214296,575748163.4,74.60065857714196,60.5514012774938,NaN,NaN,16.722190098135137,10.482048691224744
2008-04-28T09:30:00-04:00,128.88,129.28,127.69,128.78999,7905316,13414092.3,63.54662346406655,57.032785330366735,NaN,NaN,127.99374738685987,112.6351587264356,0.2710452654145017,1.2043409851020783,0.9332957196875766,580308980,575457029.8,74.30088012305629,61.52932683163721,NaN,NaN,18.16735364436174,11.579949398815742
2008-04-29T09:30:00-04:00,128.38,128.78999,127.94,128.17999,7318215,12723086.25,60.0516618573897,57.35091755047972,NaN,NaN,98.25269729252882,113.96277194636896,0.20736174746754288,1.1924979040220052,0.9851361565544623,572990765,575719681.4,74.40082398892119,62.6928424528855,NaN,NaN,18.51303450828985,12.570390128740614
2008-04-30T09:30:00-04:00,128.53,129.98,128,128.19,17717808,12920623.7,60.09045149037103,57.59876563307011,NaN,NaN,104.1106514530689,115.34718389229212,0.14823342324329913,1.1704279356085863,1.0221945123652871,590708573,581614532.8,76.60032985040843,64.1593160348294,NaN,NaN,18.81315933097333,13.462214300488146
2008-05-01T09:30:00-04:00,128,130.17999,127.92,129.96001,18318048,13262845.05,66.31829083085552,59.009326844499846,NaN,NaN,116.679280304495,114.74545482202457,0.20704104501943577,1.2809958186395818,1.073954773620146,609026621,588249847,78.80758667023073,65.97421311740969,NaN,NaN,20.862750941911127,14.519433820691429
2008-05-02T09:30:00-04:00,131.28999,131.28999,129.73,130.73,12616512,13268330.6,68.6128857244136,60.6246948669696,NaN,NaN,147.59157268142076,118.92558982367466,0.2723950116485172,1.4144485381807925,1.1420535265322753,621643133,594935614.4,80.77536300754255,68.10363051881795,NaN,NaN,23.3062662511623,15.77469559647298
2008-05-05T09:30:00-04:00,130.38,130.5,129.33,129.63,8222273,13034726.5,62.103767874159445,61.68416910590164,NaN,NaN,104.58436253538724,114.24371285338012,0.2184669009908511,1.4151371527708392,1.196670251779988,613420860,601557990.4,82.5079072907532,70.53096633466212,NaN,NaN,23.545273052369744,16.884778090172517
2008-05-06T09:30:00-04:00,129.10001,130.39999,128.58,130.25,12116699,12995147.8,64.16715819670208,62.11655760301409,NaN,NaN,93.10600013078192,113.21437342103074,0.2018705473480764,1.4490084359650837,1.2471378886170073,625537559,612067349.2,84.84245209407217,72.95935705941898,NaN,NaN,24.350359118380243,17.951289665630764
2008-05-07T09:30:00-04:00,130.27,130.37,128,128.39999,13407828,12913599.55,54.61195080689682,61.853904059212645,NaN,NaN,57.188038016819,103.82985073378077,0.05145265243016639,1.3114537041547152,1.2600010517245488,612129731,616351580.8,85.68141352068292,75.29600919504382,NaN,NaN,22.03260384436244,18.534334548306717
2008-05-08T09:30:00-04:00,128.62,129.10001,127.97,128.24001,11523418,12771877.85,53.86496899775669,61.29899044891037,NaN,NaN,34.21772944849158,87.33754056258007,-0.06722034202046379,1.1759756241989692,1.243195966219433,600606313,614667519.2,83.71981105002891,77.03577952612004,NaN,NaN,19.94801403848707,18.736288761189623
2008-05-09T09:30:00-04:00,127.66,128.03,127.2,127.5,9168711,12393078.65,50.42892567398763,60.46439699859603,NaN,NaN,-11.359622673522571,55.54730149159142,-0.1966381641796271,0.997398260994899,1.1940364251745261,591437602,608626413,76.91697860719458,77.77537871645379,NaN,NaN,17.13010028370994,18.50683326440681
2008-05-12T09:30:00-04:00,127.82001,129.10001,127.53,128.75999,9112883,12263508.95,55.619962125538294,60.22090105164536,NaN,NaN,24.640391164730644,39.55850721746011,-0.19792283430689017,0.9466328822909134,1.1445557165978035,600550485,606052338,74.15211024456787,78.0437891765857,NaN,NaN,16.245677544594578,18.18381101871935
2008-05-13T09:30:00-04:00,128.98,128.99001,127.89999,128.41,8277820,12050651.9,53.93055674965153,59.88051241002391,NaN,NaN,9.25417741700523,22.78814267470478,-0.22112283877944194,0.8681521681235012,1.089275006902943,592272665,599399359.2,67.40773672426808,77.7239166247397,NaN,NaN,15.012625770852802,17.730784554738413
2008-05-14T09:30:00-04:00,128.78,130.08,128.75,129,11792328,11802467.7,56.33816711992213,59.52059992875878,NaN,NaN,73.95562964510205,26.14166100036139,-0.19635081818831157,0.8438364841675536,1.0401873023558652,604064993,597786411.6,65.84414253217915,77.18272816293202,NaN,NaN,14.682838312547355,17.295363662996834
2008-05-15T09:30:00-04:00,129,130.2,128.75,130.05,9127191,11593968.45,60.313204737894836,59.28561254640043,NaN,NaN,98.4945969918124,38.997034509025546,-0.11300580332456667,0.8989300482001568,1.0119358515247234,613192184,600303585.8,67.12572961745059,76.64880466581121,NaN,NaN,15.599678937534156,17.053122987930738
2008-05-16T09:30:00-04:00,130.02,130.02,128.8,129.60001,9775949,11235476.3,57.88114283687727,58.880935358744054,NaN,NaN,70.88952743793322,55.446864531316706,-0.09278574826382557,0.8959536661949414,0.988739414458767,603416235,602699312.4,68.34320055020632,76.22325612489337,NaN,NaN,15.642230541543809,16.851566924161176
2008-05-19T09:30:00-04:00,129.71001,131.25999,129.50999,130.23,10825105,11236820.8,60.29505935625763,58.89832089437747,NaN,NaN,130.9999040321461,76.7187671047998,-0.044057885713530975,0.9336670573168533,0.9777249430303843,614241340,605437483.4,69.72332622370801,75.88914914166385,NaN,NaN,16.3884800931525,16.78541166258851
2008-05-20T09:30:00-04:00,129.52,129.56,127.69,128.31,12603082,11362617.85,50.74897626596224,58.23107266406255,NaN,NaN,-37.016768578792615,67.46457790564023,-0.14265026451555762,0.7994121123859372,0.9420623769014949,601638258,607310602,70.66547625075603,75.46523102740295,NaN,NaN,14.008640008224932,16.388729997679427
2008-05-21T09:30:00-04:00,128.42999,128.56,125.66,126.06,16513270,11666121.8,42.29763658529268,56.515311646522356,NaN,NaN,-192.31896768422436,14.209658439774945,-0.3491464413686728,0.5056293251906538,0.8547757665593266,585124988,603522601,66.18039078970028,74.56328846450792,NaN,NaN,8.85875712592014,15.3130195874281
2008-05-22T09:30:00-04:00,126.12,126.64999,125.88,126.02,10847484,11477709.3,42.163207245023266,54.626048897994465,NaN,NaN,-210.9563965660415,-47.680540271795834,-0.47061694518489383,0.2665045850782093,0.7371215302631031,574277504,595739665,58.03073014362564,72.938671831371,NaN,NaN,4.862470400136751,13.82008398924362
2008-05-23T09:30:00-04:00,125.63,125.81,124.57001,124.61,10705410,11394767.5,37.62393728154359,52.87748956995047,NaN,NaN,-245.1987329139705,-110.89819234217657,-0.6187848880481456,-0.03635957979707882,0.5824253082510668,563572094,587770836.8,51.093142245968224,70.69476004245779,NaN,NaN,-0.10269881248514831,11.831115017568083
2008-05-27T09:30:00-04:00,124.87,125.67999,124.37,125.42999,9472246,11473114,41.56403268243715,51.26298060464584,NaN,NaN,-187.62280126837712,-174.6227334022812,-0.6321959720260272,-0.2078196567814672,0.42437631524456,573044340,579531436.8,45.0907578444571,67.85535331034242,NaN,NaN,-2.9068848386940793,9.725686466673489
2008-05-28T09:30:00-04:00,125.77,126,124.91,125.84,8869711,11550688.8,43.48629707094641,50.46829105207795,NaN,NaN,-133.75497624751276,-193.97037493602525,-0.5851640996574716,-0.3070788093272796,0.278085290330192,581914051,575586595.4,42.51546417315237,64.77207121409023,NaN,NaN,-4.569545069554618,7.683510532926617
2008-05-29T09:30:00-04:00,125.67999,127.23,125.49001,126.23,12100680,11269832.4,45.32854614604559,49.85854656267002,NaN,NaN,-84.60150443515353,-172.42688228621108,-0.5026565257950063,-0.3502353669135658,0.15242115888144045,594014731,577364544,44.0660265273321,61.93965803389761,NaN,NaN,-5.374967526033086,5.818013667360945
2008-05-30T09:30:00-04:00,126.7,126.851,125.89999,126.13,8063156,10757087.8,44.92416151722278,49.4653491229011,NaN,NaN,-75.30262688484964,-145.29612834997272,-0.43236365224529616,-0.3880334064251798,0.04433024582011638,585951575,579699358.2,46.12131598284136,59.739967846443804,NaN,NaN,-6.1440580046064195,4.109146285651321
2008-06-02T09:30:00-04:00,125.98,126,124.24001,125.16,13448129,10798668.65,41.09447921371262,48.42781462919926,NaN,NaN,-110.6860075430653,-118.39358327579166,-0.4279475080982107,-0.490604139302647,-0.06265663120443629,572503446,581485628.6,47.70453468952482,57.85085530679787,NaN,NaN,-7.937006563150393,2.3882673072510765
2008-06-03T09:30:00-04:00,125.39,125.532,123.41,123.96001,18031808,11289145.4,36.90327992705628,47.21158057044246,NaN,NaN,-127.78032350726106,-106.42508772356845,-0.47875516883547997,-0.6611005922487863,-0.18234542341330628,554471638,577771088.2,44.75910987000649,56.23309624577918,NaN,NaN,-10.797497721239333,0.5045865888953038
2008-06-04T09:30:00-04:00,123.82001,125.03999,123.48,123.99001,14268547,11396737.8,37.07606214124461,45.83571592910835,NaN,NaN,-118.11103423409331,-103.29629932088456,-0.4819263508887642,-0.7847533620242615,-0.3028270111354973,568740185,575136315,42.74316881947041,54.583026694871414,NaN,NaN,-13.053503362042862,-1.4322834040958627
2008-06-05T09:30:00-04:00,124.35001,126.25,124.12,126.11,13050410,11378866.9,47.92771986354583,44.95103843808342,NaN,NaN,-60.47832855259173,-98.47166414437218,-0.32059698553188787,-0.7035732430503572,-0.3829762575184693,581790595,572691487.8,40.902255826794814,52.70992142411029,NaN,NaN,-11.739114840048376,-2.904687894946222
2008-06-06T09:30:00-04:00,125.17999,125.22,121.96001,122.12,24017088,12003550.4,35.513965900228015,43.353382942608484,NaN,NaN,-138.3115018618299,-111.07343913976824,-0.45381359824881046,-0.9502432553294824,-0.49642965708067194,557773507,567055874.2,36.95153161145957,50.46765935705695,NaN,NaN,-15.122186049195546,-4.650044774124696
2008-06-09T09:30:00-04:00,122.3875,123.44,122.08,122.96001,16554746,12372852.15,39.09077438686313,41.8387911590803,NaN,NaN,-131.58813905102286,-115.25386544135975,-0.45538820134649693,-1.065664908763793,-0.6102767074172961,574328253,567420835.6,37.37340165268732,48.1569504591269,NaN,NaN,-16.436488857024003,-6.333822500253168
2008-06-10T09:30:00-04:00,122.25,123.81,122.21001,122.96001,14821082,12658262.1,39.09077438686313,41.00606245343037,NaN,NaN,-115.4041918231231,-112.77863910453216,-0.42693915380513303,-1.1439506496737124,-0.7170114958685794,574328253,571392158.6,41.92696739111933,46.1041998262957,NaN,NaN,-17.42712509518388,-7.918580013814698
2008-06-11T09:30:00-04:00,122.67999,122.72,120.98,121.05,19604000,13224571.1,34.102635737927116,40.42070525004711,NaN,NaN,-146.73277871207188,-118.50298800012789,-0.5020825051558603,-1.3446146273134048,-0.8425321221575445,554724253,568588972.2,39.73101031719233,44.2149583639737,NaN,NaN,-20.003958189275693,-9.645062610309125
2008-06-12T09:30:00-04:00,121.56,122.85001,120.92999,121.63,17194432,13494676.3,36.742334909481144,40.03350008322268,NaN,NaN,-128.75563914043545,-132.15845011769662,-0.4781654578948564,-1.440238944526115,-0.9620734866312586,571918685,566614590.2,38.21289680398101,42.79939883971337,NaN,NaN,-21.175848832867445,-11.292317784960314
2008-06-13T09:30:00-04:00,121.99001,123.32001,121.77,123.10001,15357063,13806169.9,42.977003927696146,40.41586198651928,NaN,NaN,-89.69320787640622,-122.43479132061188,-0.3355248482655011,-1.381479546963135,-1.0459546986976338,587275748,572515038.4,44.97904164410659,42.36267736815182,NaN,NaN,-20.078353634405868,-12.547465763452536
2008-06-16T09:30:00-04:00,122.53,123.37,122.25,122.66,11578957,13896320.3,41.65363748068653,40.42226232925139,NaN,NaN,-80.15013406496406,-112.14719032340012,-0.24707635150659346,-1.3548001380808756,-1.1077237865742822,575696791,572788746,45.278398214870855,42.3760802517528,NaN,NaN,-19.621519064729224,-13.558044806492063
2008-06-17T09:30:00-04:00,123.38,123.42999,121.61,121.92999,15303777,14120253.9,39.48149400834334,40.13620496763688,NaN,NaN,-89.09461475972255,-106.88527491072003,-0.21517502309714098,-1.3766925654457083,-1.1615175423485673,560393014,570001698.2,42.72906680658523,42.3913375827123,NaN,NaN,-19.915238522522607,-14.46621533735357
2008-06-18T09:30:00-04:00,121.3,121.55,120.08,120.33,18098512,14395025.4,35.15447029499853,39.40948526399065,NaN,NaN,-144.1164985193789,-106.36201887218142,-0.27541834842312096,-1.5057904778774684,-1.2303721294543475,542294502,567515748,40.53668512876032,42.139241768528606,NaN,NaN,-21.556140145996423,-15.479061738588262
2008-06-19T09:30:00-04:00,120.55,121.32001,119.94,120.63,20646880,14601705.9,36.55844152960427,38.81193383630363,NaN,NaN,-129.15262377354566,-106.44141579880348,-0.26837744570652067,-1.5658439365874983,-1.2974664908809777,562941382,565720287.4,38.98102697067272,41.62922112480227,NaN,NaN,-22.442314113442183,-16.473812077853108
2008-06-20T09:30:00-04:00,119.61,119.71001,118.09,118.24001,21840736,15151368.5,30.83139340120988,38.07885627826772,NaN,NaN,-183.54436794262233,-125.2116478120467,-0.39059037912683214,-1.785704464789518,-1.3951140856626858,541100646,556485267,32.14730671922625,40.517990555495224,NaN,NaN,-25.14727677298094,-17.71287846287137
2008-06-23T09:30:00-04:00,118.62,118.75999,118.03999,118.33,13844496,15308322.8,31.267994702118287,37.67633590505786,NaN,NaN,-171.577422684728,-143.49710553599948,-0.42825374466077437,-1.9304312664886538,-1.5021775218278794,554945142,552334937.2,29.63304953555344,39.437557674462866,NaN,NaN,-27.131256025156013,-19.058360971769176
2008-06-24T09:30:00-04:00,118.03999,118.95,117.16,117.94,19038624,15786641.7,30.373203636722536,37.197560297592005,NaN,NaN,-160.20640142560907,-157.7194628691768,-0.44060446672875364,-2.0529331052388216,-1.612328638510068,535906518,547437638,26.95418909302856,38.30977340828844,NaN,NaN,-29.017549017413135,-20.481102121146883
2008-06-25T09:30:00-04:00,118.2,119.13,117.78,117.91,18914304,16288871.35,30.301370437151988,35.938535338563874,NaN,NaN,-131.26750380099185,-155.1496639254994,-0.4124636833210926,-2.1279082426614337,-1.7154445593403411,516992214,542377180.4,24.490482841308335,37.13750390932512,NaN,NaN,-30.565062339361337,-21.92166786660609
2008-06-26T09:30:00-04:00,117.00999,117.06,114.44,114.67,28990672,17133370.95,23.764478136451928,35.09928621257986,NaN,NaN,-188.31824641949615,-166.98278845468948,-0.5643334077863869,-2.4208613190733246,-1.8565279112869377,488001542,527389212.4,18.96221209054812,35.8525525149743,NaN,NaN,-34.25282786798208,-23.683262152516946
2008-06-27T09:30:00-04:00,114.57001,114.74001,112.86,113.46001,25280016,17994213.95,21.86722939202403,33.86903299866278,NaN,NaN,-195.30422210465247,-169.33475928709552,-0.690232243578357,-2.719318215759884,-2.029085972181527,462721526,511713388.4,15.118343932596886,34.262905534967835,NaN,NaN,-37.95868346926289,-25.722608054909223
2008-06-30T09:30:00-04:00,113.48,114.27,112.75,113.42,21139824,18378798.7,21.805238442844853,32.63435185980434,NaN,NaN,-168.40657011990163,-168.70058877413024,-0.7170146352632796,-2.9253542662606264,-2.208339630997347,441581702,489040700.4,11.49032774453893,32.08885984592638,NaN,NaN,-40.8852681157502,-27.888702349315075
2008-07-01T09:30:00-04:00,112.38,114.03,111.75999,113.77,32399040,19097160.3,23.839234023223526,31.901251737325506,NaN,NaN,-146.82128268475367,-166.02356502595916,-0.6537450343021622,-3.0255209238750496,-2.3717758895728873,473980742,476655545.2,10.068884628402586,29.9701365824414,NaN,NaN,-42.684310474063885,-30.00236065285062
2008-07-02T09:30:00-04:00,113.78,114.25999,112.03,112.14999,24734592,19620462.55,21.10301316330535,30.784157326884376,NaN,NaN,-133.64267679746874,-166.4985996252545,-0.6615807047031925,-3.198751770451878,-2.5371710657486855,449246150,463106332.4,8.788065905840568,27.86836294685994,NaN,NaN,-45.1308438084019,-32.163572532215085
2008-07-03T09:30:00-04:00,112.81,113.32001,111.48,113.05,20496688,19992776.45,26.17279861744794,29.583856947580934,NaN,NaN,-123.18955315485758,-153.47286097232683,-0.5512433574419178,-3.2262252625510826,-2.674981905109165,469742838,459454591.6,8.475152348470658,25.260942282885942,NaN,NaN,-45.64285369478093,-34.08918412686735
2008-07-07T09:30:00-04:00,113.17,113.92,111.14,112.21001,27901264,20186985.25,24.584947039089457,28.364664773181143,NaN,NaN,-112.87884580122389,-136.9877857116411,-0.4824078580950175,-3.2779917277279367,-2.795583869632919,441841574,455278601.2,8.119124078215478,22.606708415981984,NaN,NaN,-46.54882051954,-35.86913218296345
2008-07-08T09:30:00-04:00,112.25,113.89999,111.74001,113.74001,31556160,20937055.95,32.605201030037236,27.873500989016417,NaN,NaN,-87.3478986283005,-120.77605141332087,-0.29084665345658456,-3.15914218645365,-2.8682955329970654,473397734,461641807.6,14.04444811900568,20.557807081154873,NaN,NaN,-44.82136370181451,-37.14802239994217
2008-07-09T09:30:00-04:00,114.05,114.2,111.45,111.66,24306416,21411322.65,28.212511523588873,27.377646791058584,NaN,NaN,-88.91538378403664,-109.19487163317747,-0.2621248154233977,-3.1959515522763127,-2.933826736852915,449091318,456663922.8,13.320731464264242,18.61381039083373,NaN,NaN,-44.71196556723335,-38.2285857095552
2008-07-10T09:30:00-04:00,111.61,112.71001,110.87,112.22,32958912,22079068.25,30.91123472677951,26.974274876571105,NaN,NaN,-88.10105605586878,-100.08654748485746,-0.16789647773388738,-3.143697334020274,-2.9758008562863867,482050230,463224738.8,19.228452658596197,17.202912225685402,NaN,NaN,-43.76230494289597,-39.01911702860388
2008-07-11T09:30:00-04:00,111.14,112.44,109.78,111,35471968,22992945.05,28.405852998718032,26.80102199067883,NaN,NaN,-94.53456414551943,-94.35554968298985,-0.15076231185890698,-3.1642537461100204,-3.0134914342511134,446578262,458591823.6,18.280941177364397,16.21245754412384,NaN,NaN,-43.748053707229516,-39.69467941126469
2008-07-14T09:30:00-04:00,112.17,112.39,110.05,110.5,26015216,23525852.7,27.424792564485514,26.526507552276485,NaN,NaN,-89.9255822629603,-89.76489697533714,-0.13655514484949682,-3.1841853653129846,-3.0476302204634877,420563046,454336118,17.431232322412257,15.340899171756613,NaN,NaN,-44.03496659727445,-40.31472043783751
2008-07-15T09:30:00-04:00,109.75999,111.25999,108.32001,109.3,41112384,25002524.05,25.177324979565356,26.155373362479544,NaN,NaN,-110.10226156906104,-94.31576956348924,-0.16928845506948953,-3.2592407893003497,-3.08995233423086,379450662,435546703.6,14.276159808717367,14.435325651448673,NaN,NaN,-44.97230345088981,-40.98008943970212
2008-07-16T09:30:00-04:00,109.73,112.47,109.2,112.17,31073328,25791001.6,38.21793331101429,26.720842139183993,NaN,NaN,-72.55755190955857,-91.04420318859363,0.030396521552781053,-3.051956682289884,-3.082353203842665,410523990,427833238,13.218413377112057,13.63017783257751,NaN,NaN,-41.384022623224595,-41.03779418020533
2008-07-17T09:30:00-04:00,113.16,114.61,112.17,114.14,36229984,26697575.2,45.26917538933906,28.256891942961648,NaN,NaN,-11.890576794166066,-75.80210733625309,0.30778378398190975,-2.697623473865278,-3.0054072578471875,446753974,420773986.8,12.318845479863228,13.155651646100015,NaN,NaN,-35.855434927234946,-40.297457144066705
2008-07-18T09:30:00-04:00,114.60001,115.10001,113.7,114.95,21166928,26723577.6,47.90203342096641,30.116520802171816,NaN,NaN,25.918653265869526,-51.711463853975296,0.544602243623665,-2.3246544533176063,-2.8692566969412714,467920902,425042514.8,16.039618718080916,13.221456987920304,NaN,NaN,-30.566222530206762,-38.90728077065814
2008-07-21T09:30:00-04:00,115.41,115.50999,114.14,114.64999,16274984,26445290,47.00019138978694,31.916160298381964,NaN,NaN,43.62710416397934,-25.000926568587364,0.6714990449590519,-2.0298828907424564,-2.7013819357015083,451645918,431259089.2,21.27894599753151,13.920644005991202,NaN,NaN,-26.677590876097323,-37.160182214292306
2008-07-22T09:30:00-04:00,113.96001,116.08,113.75,115.7,24758032,26990966.8,50.511909197072754,33.821351382228336,NaN,NaN,72.13644469337268,11.446814683899385,0.8074715807447572,-1.692042459770562,-2.499514040515319,476403950,450649746.8,34.92069663316062,15.695773434902488,NaN,NaN,-22.315507057379097,-35.039514334733276
2008-07-23T09:30:00-04:00,115.95,116.88,115.49001,116.23,24769792,27277525.2,52.23237511601957,36.04487723599364,NaN,NaN,125.79952398552349,51.11822986291579,0.9069784916188359,-1.3657909259917744,-2.2727694176106104,501173742,468779697.2,44.589259435144484,18.25300154413848,NaN,NaN,-18.224208059811353,-32.63732772403014
2008-07-24T09:30:00-04:00,116.25,116.28999,113.37,113.60001,22466192,27455119.6,44.04881121951599,37.3217352789985,NaN,NaN,64.98854118847726,66.49405345944446,0.7746827716269928,-1.3044159530768695,-2.0790987247038624,478707550,475170412.4,47.54743076730583,21.043878574055277,NaN,NaN,-17.117971045986444,-30.4202767700239
2008-07-25T09:30:00-04:00,113.89,114.36,113.14999,113.17,19460080,26978590,42.86624018405408,38.62754193221026,NaN,NaN,27.679864569970583,66.84629572026466,0.6426647389287332,-1.2757678010429458,-1.918432539971679,459247470,473435726,46.81681767181029,23.807999545026338,NaN,NaN,-16.603224770143726,-28.446412198612446
2008-07-28T09:30:00-04:00,113.27,113.52,111.17,111.34,16092410,26519209.7,38.16978697923278,39.0250123571528,NaN,NaN,-51.13131599803329,47.89461168786214,0.4269325045640726,-1.3847669092665882,-1.8116994138306608,443155060,471737554.4,46.07049174559764,26.095574089782907,NaN,NaN,-17.67332261071531,-26.907399400341426
2008-07-29T09:30:00-04:00,111.60001,113.91,111.505,113.85001,17203280,26322382.5,46.78212694565667,40.35141345872906,NaN,NaN,7.67002977488847,35.00132870416529,0.4460351042223418,-1.2541555335527335,-1.7001906377750753,460358340,468528432.4,44.622810665936925,28.331436889902385,NaN,NaN,-15.702957434532413,-25.30676483379728
2008-07-30T09:30:00-04:00,114.59,115.92999,114.02,115.82001,24425328,25923696.9,52.387642544829426,41.885442588589775,NaN,NaN,110.47676995305511,31.936777897671618,0.5758474576354691,-0.9803813157307388,-1.556228773366208,484783668,465250417.6,43.13187881555646,30.038824472542405,NaN,NaN,-12.104811508448222,-23.42077150160456
2008-07-31T09:30:00-04:00,114.72,115.56,113.58,113.7,24806880,25927311.3,46.68832666788635,43.191333564958946,NaN,NaN,55.96772048866211,30.132613757708594,0.5059182057983382,-0.9238310161182852,-1.4297492219166235,459976788,461504265.2,41.42831896288771,31.692208600079784,NaN,NaN,-11.072204271354188,-21.65669046871165
2008-08-01T09:30:00-04:00,114.12,114.25999,112.59,113.12,20548256,25929889.7,45.23830347291735,44.4637272012755,NaN,NaN,8.034757284106899,26.203592300535853,0.4115873428903005,-0.9152650433037479,-1.3268523861940484,439428532,457540477.6,39.644103737623766,33.27884227259489,NaN,NaN,-10.745371600142594,-20.097930630344642
2008-08-04T09:30:00-04:00,113.14,113.75,112.13,112.77,16207777,25345215.35,44.34331077887057,45.83272618694016,NaN,NaN,-14.88908633070714,33.45203823400108,0.32064697447682455,-0.9260436680980177,-1.2466906425748423,423220755,453553616.6,37.877121048840074,34.96462521831794,NaN,NaN,-10.767414195030616,-18.764999711014067
2008-08-05T09:30:00-04:00,113.75,116.07001,113.71001,116.00999,23003424,24917578.55,53.51212519098626,46.92516846408102,NaN,NaN,92.10367938000006,50.3387681550234,0.46497290232553756,-0.6654745146679204,-1.130447416993458,446224179,450726784.4,36.63045641477904,36.636914006722726,NaN,NaN,-7.678440757480008,-17.181205574794916
2008-08-06T09:30:00-04:00,115.53,116.88,115.24001,116.49001,17770816,24590798.55,54.70273148530746,47.59899389950733,NaN,NaN,120.36240544865818,52.31589525414402,0.5719987782751298,-0.4154489441495457,-0.9874477224246755,463994995,446569049.8,34.81541844714398,38.243812075814205,NaN,NaN,-4.8618647943277065,-15.421299749013887
2008-08-07T09:30:00-04:00,115.49001,115.92,114.23,114.59,17905264,23838116.15,49.3185463333743,47.70017339325075,NaN,NaN,57.919282739541096,52.70620770431981,0.49684357571218196,-0.366393252784448,-0.86323682849663,446089731,443791638.4,33.617101282184905,39.49934654467877,NaN,NaN,-4.211857737303042,-13.819950890198053
2008-08-08T09:30:00-04:00,114.22,117.64,114,116.95,31286016,23628818.55,55.2149215529727,48.2869398334783,NaN,NaN,106.01742045640238,72.3027403387789,0.5821720415077307,-0.13552177661196652,-0.7176938181196972,477375747,451381081.4,39.722445553009756,40.81673937007008,NaN,NaN,-1.6680663025481757,-12.083967377676641
2008-08-11T09:30:00-04:00,117.02991,118.73,116.8,117.8,22535312,23454823.35,57.14863584673775,48.7609917370258,NaN,NaN,164.91883081907116,108.26432376873456,0.665923942160906,0.11471110958143527,-0.5512128325794707,499911059,466719142.2,49.77582340550123,41.877819853808695,NaN,NaN,0.9979332284406175,-10.215124433945604
2008-08-12T09:30:00-04:00,117.46001,117.52,116.08009,116.57001,22492768,22523842.55,53.54574370230784,48.85480377890354,NaN,NaN,112.56589836591085,112.35676756591673,0.6100393913694269,0.2113364066323129,-0.39870298473711396,477418291,472957964.6,53.19532247739424,42.49253864254082,NaN,NaN,2.0550939019615124,-8.462236100244588
2008-08-13T09:30:00-04:00,116.08,116.21001,114.6805,115.39999,28253680,22382860.15,50.29736246528231,49.301128867886845,NaN,NaN,38.10198783885496,95.90468404395608,0.47199972064531776,0.19129666606953322,-0.28070305457578454,449164611,469991887.8,51.403452844427726,42.76796879090667,NaN,NaN,1.9107353881137958,-6.980383030479105
2008-08-14T09:30:00-04:00,114.85001,117.34,114.69,116.41,24665408,21804631.35,52.95081437234868,50.02145559562217,NaN,NaN,73.11041068923184,98.94290963389423,0.4277517188090342,0.25398659393550815,-0.17376512487352602,473830019,475539945.4,54.49139888106078,43.31615316299599,NaN,NaN,2.6021404639585346,-5.6114511027023
2008-08-15T09:30:00-04:00,116.46001,117.07001,115.95,116.53,16610859,21576827.9,53.27001788025726,51.10004351712392,NaN,NaN,85.19117870241645,94.77766128309705,0.38683677969087277,0.3097808497400649,-0.07705592995080783,490440878,478152971.6,55.912316995337825,44.019140680834575,NaN,NaN,3.2499042076901694,-4.345543201217661
2008-08-18T09:30:00-04:00,116.86,116.89,114.28999,114.86,23623744,21944265.9,48.353440958043414,51.212280232294404,NaN,NaN,17.55359703086466,65.30461452545575,0.23504047092600777,0.2167446587067019,-0.01829581221930588,466817134,471534186.6,51.52394098740798,44.51207856093965,NaN,NaN,2.3484405389085254,-3.389259809771063
2008-08-19T09:30:00-04:00,114.11011,114.21001,113.14999,113.49001,19249824,21668855.5,44.70799395729395,50.663733904613295,NaN,NaN,-71.38294909529576,28.51484503321443,0.04031351367756218,0.032096079877646844,-0.008217433799915335,447567310,465563990.4,47.87395917437707,44.85079858656969,NaN,NaN,0.4691897801696019,-2.8380527254938253
2008-08-20T09:30:00-04:00,113.87,114.53999,112.89,114.03999,21415328,21501132.3,46.45329496116576,50.64694592556183,NaN,NaN,-53.969548615376546,10.100537742368129,-0.04867751611777599,-0.06906432894713532,-0.020386812829359332,468982638,469527595.8,50.38680207937017,45.49069023774701,NaN,NaN,-0.5798421761523154,-2.515451218445038
2008-08-21T09:30:00-04:00,113.23,114.78,113.07001,114.05,16821840,21218914.7,46.48640380329794,50.736095949160436,NaN,NaN,-44.26789652507881,-13.375123700494001,-0.10107893622419958,-0.14673548310960882,-0.04565654688540923,485804478,471922487.6,51.89574988139009,46.36580781944461,NaN,NaN,-1.424651025691173,-2.3596226194802004
2008-08-22T09:30:00-04:00,114.95,116.37,114.84,116.32001,18079472,21149884.3,53.507044847953686,51.39064838266638,NaN,NaN,48.81014828655741,-20.65132978366581,0.016658570764808298,-0.024833333429398863,-0.04149190419420716,503883950,474611102,53.60185171898204,47.48900286731189,NaN,NaN,-0.1389527217774809,-2.0423840626655263
2008-08-25T09:30:00-04:00,115.67,115.71001,113.66,113.85001,19187312,21304629.4,46.377328871818214,50.88102007415438,NaN,NaN,-38.4782462758754,-31.857698445013817,-0.06767046647470001,-0.12607998728758218,-0.05840952081288217,484696638,478187002.8,55.84492643429702,48.86146501156317,NaN,NaN,-1.221228775526983,-1.9250761645028773
2008-08-26T09:30:00-04:00,114.05,114.42,113.46001,114.07001,14475621,21168246.45,47.054041820555554,50.33468509810067,NaN,NaN,-69.53318076855973,-31.487744779666617,-0.10240648112699494,-0.18641762222162583,-0.0840111410946309,499172259,488507992.6,61.61319679166256,50.775592036171645,NaN,NaN,-1.8869908079133433,-1.919635399275801
2008-08-27T09:30:00-04:00,114.24001,115.59,113.84,115,15494375,20721698.8,49.93057212028388,50.37840122573706,NaN,NaN,-16.335531229153435,-23.960941302421993,-0.05869432249242304,-0.1573790442101597,-0.09868472171773665,514666634,497644791.8,65.86455743395715,53.078981761298266,NaN,NaN,-1.6031773469219672,-1.8744271060823963
2008-08-28T09:30:00-04:00,115.72,117.17999,115.66,117.13,16559496,20309329.6,55.84727380364592,50.4235692436423,NaN,NaN,88.82196241956879,2.6570304865075274,0.10861177876958406,0.03708000174424342,-0.07153177702534064,531226130,506729122.2,69.48337005906433,55.2047620831593,NaN,NaN,0.4856490060748581,-1.537273375774217
2008-08-29T09:30:00-04:00,116.50999,117.0401,115.39999,115.45,15917223,20077777.95,50.75299103865537,49.966737471636414,NaN,NaN,41.63689584537954,1.222379998271954,0.10122085921049004,0.05499429698777192,-0.04622656222271812,515308907,509014113.6,70.33524845830205,56.673292444073645,NaN,NaN,0.6813123861713705,-1.220332552639133
2008-09-02T09:30:00-04:00,116.96001,118.00999,114.78,115.16,24105888,20472683.5,49.90671230021275,49.70680665720106,NaN,NaN,36.48206032665021,16.21444131877708,0.07319652555419587,0.045269094720026715,-0.027927430834169154,491203019,510315389.8,70.83456854880342,57.933238592031444,NaN,NaN,0.5847788118676722,-0.9624595005667324
2008-09-03T09:30:00-04:00,115.25,115.74001,114.33,115.50999,17848736,20214949.1,50.969293818475485,49.754801753857706,NaN,NaN,-20.27938245864303,26.06520098076042,0.0743844865345074,0.0650531773339651,-0.009331309200542304,509051755,512291289,71.61582669221514,59.37697958115911,NaN,NaN,0.8101883418085506,-0.7092240945131205
2008-09-04T09:30:00-04:00,114.60001,114.74001,111.99001,112.2,35209680,21086892.3,41.91408549617716,48.966463976988315,NaN,NaN,-153.7540497541904,-1.4185027242469743,-0.13992103753137547,-0.18423260611476167,-0.04431156858338618,473842075,504126377.2,63.98807428251807,60.055313538406075,NaN,NaN,-1.8928541112483006,-0.8783140969038605
2008-09-05T09:30:00-04:00,111.58,112.63,110.57001,112.35001,31562832,21769770.7,42.413417438353164,48.19099251685231,NaN,NaN,-186.2334125707539,-56.429577722311514,-0.25693142837025884,-0.36547585404620975,-0.10854442567595089,505404907,498962132.6,59.65985029868584,60.32299448864522,NaN,NaN,-3.8876724026445624,-1.3082224262953894
2008-09-08T09:30:00-04:00,115.53,115.92999,112.4012,115.16,37990496,22104994.7,50.923960465605475,48.374601053106744,NaN,NaN,-32.82270781015121,-71.32149845341766,-0.1364859284853145,-0.279151836282594,-0.1426659077972795,543395403,504579431.8,62.621527186846265,61.11567921717652,NaN,NaN,-2.9519907871687496,-1.5430464778487265
2008-09-09T09:30:00-04:00,115.16,115.98,112.42999,112.53,31931136,22574785.9,44.321761141614495,48.34701299484393,NaN,NaN,-73.32811233210839,-93.28353298516939,-0.22037800266260818,-0.41813841112553973,-0.19776040846293155,511464267,508631681.4,64.63843023054588,62.31314143547429,NaN,NaN,-4.3783257461453156,-1.9480863733196678
2008-09-10T09:30:00-04:00,113.11,114,112.34,113,39047888,23402541.9,45.67718619767908,48.291576654594884,NaN,NaN,-95.42411361093923,-108.31247921562863,-0.22961010455129133,-0.4847730391520457,-0.2551629346007544,550512155,516923761.4,68.39639010938332,63.59954058047523,NaN,NaN,-5.066598319553249,-2.393588079924465
2008-09-11T09:30:00-04:00,111.78,114.86,111.21989,114.86,39239840,23951849.9,50.783425593556174,48.598506782470466,NaN,NaN,-57.39727827814513,-89.04112492041956,-0.10233293959700523,-0.38307910909701093,-0.2807461695000057,589751995,540105745.4,76.05710187786006,65.32535143736595,NaN,NaN,-3.9907908955366787,-2.62175991072621
2008-09-12T09:30:00-04:00,113.64,114.84,113.009,114.78999,28280032,24132581.1,50.5906637333646,48.39019384571411,NaN,NaN,-18.763683231077803,-55.54717905248435,-0.01910198198752372,-0.30462364698441036,-0.28552166499688664,561471963,551319156.6,78.74144485151645,67.12103666111841,NaN,NaN,-3.2031181380256313,-2.7048110860546988
2008-09-15T09:30:00-04:00,111.14999,114.43649,109.64,109.8,44773744,25540725.35,39.17639960983258,47.875841755572274,NaN,NaN,-186.76821733125556,-86.33628095670522,-0.2817795305042,-0.6377460781271367,-0.35596654762293667,516698219,545979719.8,74.46059333313698,68.45072715389269,NaN,NaN,-6.469814402952112,-3.242668702754329
2008-09-16T09:30:00-04:00,107.88,111.16,107.58,110.66,48722560,26795666.15,41.62105280959965,47.48777111193257,NaN,NaN,-233.05757227012364,-118.28217294430826,-0.3735209104472156,-0.8228676856819561,-0.44934677523474054,565420779,556771022.2,77.16287886668249,69.56141873067983,NaN,NaN,-8.215983494170946,-3.9531422443852744
2008-09-17T09:30:00-04:00,109.23,109.59,105.5,106.75999,54996896,28583019.75,34.791789547539196,46.40642949959366,NaN,NaN,-272.48147075228286,-153.693644372577,-0.6562349650183962,-1.2696404815077358,-0.6134055164893396,510423883,548753367.8,71.14014936461606,69.9382467257269,NaN,NaN,-12.255854916675208,-5.139244054712408
2008-09-18T09:30:00-04:00,107.42,111,104.86,109.97,65447328,30784619.75,43.071512193927184,45.493875098899466,NaN,NaN,-169.55216125715256,-176.12462096837848,-0.5885860960627134,-1.3491381365677313,-0.7605520405050179,575871211,545977211,69.1281798275181,69.91287599490217,NaN,NaN,-12.589169923708468,-6.203519178854702
2008-09-19T09:30:00-04:00,116.14,116.14,112.66,113.57001,20861152,30986585.35,50.64093005008145,45.485870742572764,NaN,NaN,25.790854616368314,-167.21371339888924,-0.27865240413274306,-1.1088675456709467,-0.8302151415382036,596732363,553029291,71.34516345348547,69.98501278027241,NaN,NaN,-9.989589860080608,-6.744386419029831
2008-09-22T09:30:00-04:00,113.82001,113.98,109.86,110.5,21958688,31180546.15,45.13006746774618,45.144681825968,NaN,NaN,-60.55246583515079,-141.9705630996683,-0.25813650409411415,-1.1528857716558463,-0.8947492675617321,574773675,564644382.2,74.58273347388698,70.2527388463498,NaN,NaN,-9.961068567457778,-7.2039124402338235
2008-09-23T09:30:00-04:00,110.25999,111.38,108.25999,108.5,25528272,31497594.15,41.928914575049866,44.498940451437605,NaN,NaN,-113.56140956744262,-118.07133055913212,-0.35122366266953386,-1.3337788458986495,-0.9825551832291156,549245403,561409307,72.13799862554218,70.29003684158745,NaN,NaN,-11.106343280072362,-7.761402560210757
2008-09-24T09:30:00-04:00,108.92999,109.23,107.46001,108.3,20638864,31805756.3,41.61105605580107,44.47729549141074,NaN,NaN,-124.22593431908919,-88.42022327249337,-0.3949629302112452,-1.476258845993172,-1.0812959157819269,528606539,565045838.2,73.20139052533546,70.94813085893155,NaN,NaN,-12.078200559501605,-8.378087988680878
2008-09-25T09:30:00-04:00,109.00999,111.21001,108.78,110.27,27647344,32413404.75,45.95696738730497,44.730406202050155,NaN,NaN,-65.58231794339896,-67.62625460974265,-0.26609448010522874,-1.4139140159134627,-1.147819535808234,556253883,561122372.6,70.09308686683633,71.69336204237088,NaN,NaN,-11.439090456668271,-8.81537405553622
2008-09-26T09:30:00-04:00,108.64999,111.60001,108.47,111.14999,22038240,32687341.95,47.82510148766274,44.5090591321971,NaN,NaN,-50.08242600837473,-82.80091073469126,-0.10474976223671706,-1.2787567386041303,-1.1740069763674132,578292123,557434324.6,67.2043186960542,72.02070429302859,NaN,NaN,-10.33441518063995,-9.032379930551038
2008-09-29T09:30:00-04:00,109.83,109.99001,104.00999,104.75,36211104,33702036,37.63559103633839,44.03147555324881,NaN,NaN,-154.0606637496979,-101.50255031760068,-0.3958600759671831,-1.668832071326392,-1.272971995359209,542081019,550895793.4,62.30193438418962,71.85381173257457,NaN,NaN,-12.94722411083791,-9.591643384877734
2008-09-30T09:30:00-04:00,105.56,108.63,105.22,108.36,24726832,33733083.2,44.782041019023275,43.96753661191626,NaN,NaN,-109.17145073318973,-100.62455855075011,-0.3155835324850085,-1.6674514109654694,-1.351867878480461,566807851,554408283,63.82843505630352,71.52752922878315,NaN,NaN,-12.509461724113194,-10.008474576197086
2008-10-01T09:30:00-04:00,107.57001,108.78999,106.28,108.7,22857584,33983525.6,45.41645346789839,43.58418146008355,NaN,NaN,-85.02015356608199,-92.78340240014867,-0.21470161289828504,-1.6202448946033172,-1.4055432817050322,589665435,566620062.2,68.59042594783473,70.99419523378135,NaN,NaN,-11.963831521980357,-10.287811282737554
2008-10-02T09:30:00-04:00,107.5,107.64999,104.38,105.27,19549328,33200508,40.37656833967256,42.85460321767698,NaN,NaN,-131.57048468484263,-105.98103574843739,-0.3462962838730308,-1.8384136365463206,-1.4921173526732898,570116107,569392507,69.5699007735368,70.33908494249708,NaN,NaN,-13.23003061377824,-10.70812833002908
2008-10-03T09:30:00-04:00,105.75,107.94,103.09,103.2,30186048,33131668.8,37.6604199800027,42.746318958403414,NaN,NaN,-139.9801974401221,-123.96059003478688,-0.5291230658178394,-2.153521184945589,-1.6243981191277497,539930059,561720094.2,63.65412729242411,69.56719451101759,NaN,NaN,-15.17230827806772,-11.345868322606028
2008-10-06T09:30:00-04:00,100.86,101.44,95.21001,99.89999,49880096,33726148.8,33.76124978563189,42.18490445669143,NaN,NaN,-243.2611734849771,-141.8006919818427,-0.811767446546046,-2.6391074273103072,-1.8273399807642612,490049963,551313883,56.621510385555034,68.09995390522276,NaN,NaN,-18.14633670194225,-12.317363805368347
2008-10-07T09:30:00-04:00,100.53999,101.21001,94.41,95.07001,38835152,34071349.6,29.024630370658457,41.77296451548567,NaN,NaN,-234.98508276933242,-166.96341838907125,-1.2379478078147512,-3.3747747405327004,-2.136826932717949,451214811,528195275,44.78385709259571,66.21736160007846,NaN,NaN,-22.429426999742187,-13.761944261707466
2008-10-08T09:30:00-04:00,93.25,96.39,91.39999,91.39999,53485872,34793248.8,26.035630742581702,40.556115840389566,NaN,NaN,-242.94399251442758,-198.54818617874037,-1.6549051913777837,-4.205458421940179,-2.5505532305623952,397728939,489807975.8,32.59739542717152,63.60801985719656,NaN,NaN,-27.04240195619135,-15.659152503776593
2008-10-09T09:30:00-04:00,93.92,94.50999,85.39999,85.55,44482720,35055392.8,22.124487218498658,38.51922706670508,NaN,NaN,-238.80319864694562,-219.99472897116098,-2.1795729250664335,-5.275019386895437,-3.0954464618290034,353246219,446433998.2,24.488738562324272,60.26113236497076,NaN,NaN,-32.48777760405147,-18.06324180381586
2008-10-10T09:30:00-04:00,82.39,89.08,78.94,83.75,73762624,37329522.4,21.075395524957102,36.80103621364872,NaN,NaN,-222.37719704786466,-236.47412889270944,-2.480818882081902,-6.196470064431381,-3.715651182349479,279483595,394344705.4,18.528016785391543,56.257224030078234,NaN,NaN,-37.064662151786074,-20.777730424954463
2008-10-13T09:30:00-04:00,88.03999,95.03,87.46001,95.03,44096080,37295639.2,40.20901793789685,36.67818645385207,NaN,NaN,-108.99182317722621,-209.6202588311593,-1.7858472562402286,-5.947960252649764,-4.162112996409536,323579675,361050647.8,15.869189476998272,52.23802337661082,NaN,NaN,-33.57978350675267,-22.606595150925635
2008-10-14T09:30:00-04:00,97.89999,98.8,90.89999,93.67,58579984,37788510.4,38.98196580852346,36.490394293332244,NaN,NaN,-78.2125859187181,-178.26575946103642,-1.3054822739368186,-5.793965838830559,-4.48848356489374,264999691,323807623.8,13.530199828928332,47.975795469724595,NaN,NaN,-31.478271471406817,-23.873977482422948
2008-10-15T09:30:00-04:00,91.84,92.06,84.75999,84.87,36270160,36852173.6,32.14606421166128,35.503901209357686,NaN,NaN,-122.20982038003126,-154.11892503415714,-1.4566380649486526,-6.309281146079556,-4.852643081130903,228729531,290007742.2,11.826528680001744,43.81389845637926,NaN,NaN,-32.36851083321983,-25.087482246822503
2008-10-16T09:30:00-04:00,86.31,90.16,82.08,89.87,60380208,36598817.6,38.72133136343398,34.85363191476991,NaN,NaN,-105.61673162430766,-127.48163162962956,-1.1116912722646841,-6.242257171461759,-5.130565899197075,289109739,277180446.2,11.247700175261755,39.81699713346552,NaN,NaN,-30.503139766605297,-25.861147606791473
2008-10-17T09:30:00-04:00,87.60001,92.75999,87.16,87.53999,44028512,37757185.6,36.92561176503511,34.80291910967683,NaN,NaN,-82.68816782974731,-99.5438257860061,-0.9391300167730305,-6.304478420163363,-5.365348403390333,245081227,270299972.6,10.938445601276413,36.148176506114574,NaN,NaN,-29.740902962624556,-26.415398371910484
2008-10-20T09:30:00-04:00,89.48,93.28,88.74001,93.28,34527216,38385612,43.835764410301344,34.73532792333954,NaN,NaN,-56.26746265736591,-88.99895368203404,-0.3665123318509895,-5.823488818204069,-5.45697648635308,279608443,261505726.2,10.539567520685026,32.34182882499897,NaN,NaN,-26.573321363253083,-26.43795879924514
2008-10-21T09:30:00-04:00,91.53999,92.8,89.97,90.38,26532432,38435820,41.36979333763711,34.446280771178024,NaN,NaN,-56.31279044374524,-84.61899458703947,-0.12371449041157057,-5.611619599367543,-5.487905108955973,253076011,259120990.2,10.428513742245201,28.18740652459972,NaN,NaN,-24.951888132420503,-26.225662989698765
2008-10-22T09:30:00-04:00,88.06,88.4201,83.33,85.5,37459504,39276852,37.54252126451677,34.243848837238325,NaN,NaN,-92.67593566896875,-78.71221764482696,-0.2264462052579903,-5.77096286552846,-5.54451666027047,215616507,256498385.4,10.299977952220317,23.953840608791406,NaN,NaN,-24.951504985228727,-26.043640417631618
2008-10-23T09:30:00-04:00,85.67,87.99001,82.3999,87.99001,59594480,40874208.8,40.56401303993361,34.451248341519104,NaN,NaN,-83.38420653992779,-74.26571262795099,-0.06951084849615974,-5.63140522089067,-5.5618943723945105,275210987,253718635,10.157079300983682,20.132622895117088,NaN,NaN,-23.9389838188037,-25.74297518922763
2008-10-24T09:30:00-04:00,80.53999,85.85001,80.14999,83.09,49335168,42239055.2,36.79201782535319,34.66773177292776,NaN,NaN,-105.92633516518023,-78.91334609503755,-0.22950339524375796,-5.848773616449208,-5.61927022120545,225875819,249877553.4,9.95162360241629,16.799059553464325,NaN,NaN,-24.356873460411006,-25.54496065653954
2008-10-27T09:30:00-04:00,82.58,85.98,80.25999,80.25999,37164048,42286702.4,34.78042187722721,35.07885973768268,NaN,NaN,-108.18524678944866,-89.29690292145412,-0.4471274895575146,-6.1781795831523425,-5.731052093594828,188711771,231698219,9.021506669027318,14.244605951780867,NaN,NaN,-25.35155748463164,-25.517331631981268
2008-10-28T09:30:00-04:00,83.84,91.14,81.7,91.14,53383664,43719544,46.81887471063049,36.56337716397188,NaN,NaN,-44.357412397502536,-86.90582731220556,0.18649483454030502,-5.497933550419447,-5.684428384959752,242095435,229502103.8,8.913130030930958,12.552872709192256,NaN,NaN,-21.945380569287515,-25.007052908739304
2008-10-29T09:30:00-04:00,90.49001,93.62,88.7,89.14999,50650704,45109200,45.17634063782668,38.20993812249531,NaN,NaN,-7.386435471053984,-69.84792727262263,0.4986867239358901,-5.061069980039889,-5.559756703975779,191444731,224667748.6,8.666321858171088,11.422700087467033,NaN,NaN,-19.854489478971182,-24.27097241877243
2008-10-30T09:30:00-04:00,92.03999,92.66,89.72,92.5,42806448,46272056,48.454710348410565,40.1656034670277,NaN,NaN,20.464929061796106,-49.078100152277855,0.9326976225094885,-4.393884675838919,-5.3265822983484075,234251179,216475787,8.24946302432052,10.68851767596196,NaN,NaN,-17.076283317691587,-23.243159690046596
2008-10-31T09:30:00-04:00,91.57001,94.53,91.13,93.5,39476960,46736601.6,49.426893564167365,40.82402315461845,NaN,NaN,60.73502288669259,-15.745828541903297,1.2682127928420481,-3.741316307295847,-5.009529100137895,273728139,226046251,13.48516079927181,10.518229913267215,NaN,NaN,-14.575496418187587,-22.004922079781025
2008-11-03T09:30:00-05:00,93.13989,94.08,92.52,93.42999,17964512,45140822.4,49.356707631139706,41.56507614194818,NaN,NaN,76.97147388707569,21.285515593401577,1.453228437301628,-3.19299355351086,-4.646221990812488,255763627,239456622.2,20.344382674375822,11.004957259370604,NaN,NaN,-12.606166621489487,-20.66224272859652
2008-11-04T09:30:00-05:00,95.16,96.5,94.32001,96.21001,25730416,44485585.6,52.255912370578635,43.00149386758513,NaN,NaN,126.9136598456017,55.53973004202241,1.7127851236416713,-2.505240586260399,-4.21802570990207,281494043,247336343.8,24.149745291329126,11.885187017322561,NaN,NaN,-10.087809000702745,-19.15160933889741
2008-11-05T09:30:00-05:00,94.99001,95.59,91.14999,91.85001,28980640,43260324,47.64876741110511,43.639167870990214,NaN,NaN,70.32500947021398,71.08201903027602,1.5458931207684188,-2.285659308941547,-3.8315524297099657,252513403,259550078.2,29.751677859137743,13.20689970902799,NaN,NaN,-9.241634152375637,-17.735898597965726
2008-11-06T09:30:00-05:00,90.78999,91.66,86.48,87.13,43603712,43216373.6,43.2075948569647,44.08788094898519,NaN,NaN,-19.83078446752277,63.02287632441223,1.0939616954716085,-2.464100310370455,-3.5580620058420633,208909691,254481780.6,28.80109886962032,14.4828035139097,NaN,NaN,-9.853342964561168,-16.609819221765076
2008-11-07T09:30:00-05:00,87.96001,90.16,87.39999,90.13,30920864,41074285.6,46.613558218749105,44.286294792445744,NaN,NaN,-9.616435751297548,48.95258459681421,0.9772437172856163,-2.3365073592350427,-3.313751076520659,239830555,247702263.8,27.53384136806568,15.69668021729403,NaN,NaN,-9.347542553520395,-15.57235112630155
2008-11-10T09:30:00-05:00,91.67,91.75,87.71001,88.92999,23700640,40054513.6,45.43965305987341,44.57699905831977,NaN,NaN,-1.1572236994504665,33.32684507950898,0.8064874205502739,-2.3056418008328166,-3.1121292213830904,216129915,239775521.4,26.08845214455752,16.815247246030626,NaN,NaN,-9.272842018430568,-14.672421253748553
2008-11-11T09:30:00-05:00,87.5601,88.81,85.72,86.75,31468544,38698941.6,43.30600307302178,44.98867633035584,NaN,NaN,-50.43117445882748,-2.142121781376858,0.54643409772555,-2.429086599226153,-2.975520696951703,184661371,220408987,22.92238795845168,17.716847960761438,NaN,NaN,-9.820616198462945,-13.979306245850609
2008-11-12T09:30:00-05:00,85.41,86,82.84,83.09,35844592,38677663.2,39.91710523389603,44.94246862992458,NaN,NaN,-115.42704282695203,-39.29253224081007,0.14834733935136768,-2.7900865227624934,-2.938433862113861,148816779,199669662.2,20.108092659771117,18.427634629246256,NaN,NaN,-11.287925738605002,-13.594823316244094
2008-11-13T09:30:00-05:00,83.57001,89,79.85001,88.7,64436480,38880476.8,46.79042604961322,45.65664064594316,NaN,NaN,-68.4961022384344,-49.025595794992384,0.2758638934037263,-2.593603995359203,-2.8694678887629292,213253259,200538375.8,20.548121021712447,19.184527302053123,NaN,NaN,-10.521138232216195,-13.155725447097252
2008-11-14T09:30:00-05:00,86.99001,89.49001,84.22,84.22,45091360,38933619.2,42.59941120359786,46.215139883541056,NaN,NaN,-59.41844487054193,-58.98599761884127,0.08158481504740589,-2.7674868699536717,-2.8490716850010775,168161899,186204644.6,18.716368546155095,19.877017436133677,NaN,NaN,-11.158061638204249,-12.87034490296968
2008-11-17T09:30:00-05:00,83.98,85.98,82.72,82.95,38188144,39116665.6,41.46554968357512,45.832759524465686,NaN,NaN,-94.04588411552277,-77.56372970205572,-0.09953634860861538,-2.973492120761847,-2.8739557721532316,129973755,168973412.6,16.779838634259278,20.438925193514272,NaN,NaN,-12.015421803571602,-12.748213031627097
2008-11-18T09:30:00-05:00,82.99001,85.05,81.31,84.34,42208432,39900465.6,43.24607472937296,45.69488338814756,NaN,NaN,-90.87166448445927,-85.6518277071821,-0.09293386632665968,-2.9901231050615564,-2.8971892387348968,172182187,166477575.8,16.5133236378079,20.999425320631186,NaN,NaN,-12.214220229251675,-12.671928345573466
2008-11-19T09:30:00-05:00,84.23,85.37,80.17999,80.36,49780352,40516508,39.537565046194146,45.05794443798924,NaN,NaN,-113.24932759345776,-85.21628466048324,-0.31150499223436956,-3.2865704790278585,-2.975065486793489,122401835,161194587,15.936330832822208,21.54848730695274,NaN,NaN,-13.483677385230546,-12.787892494095907
2008-11-20T09:30:00-05:00,79.39999,82.2,75.37,76.06,77925120,41433040,35.95058657148094,44.09535108136878,NaN,NaN,-165.00520435336358,-104.51810508346907,-0.6794643833592837,-3.8243959659925935,-3.1449315826333097,44476715,127439278.2,12.847457074599816,21.502937040904737,NaN,NaN,-15.683259519685386,-13.201516354894403
2008-11-21T09:30:00-05:00,77.13,80.73,74.5,80.53999,91699568,43551260,41.867944046786185,43.5604393967721,NaN,NaN,-140.6282900743599,-120.76007412423264,-0.55990131877024,-3.84480823109611,-3.28490691232587,136176283,121042155,12.358571297999973,20.932521942592178,NaN,NaN,-15.77837504553532,-13.569639024985962
2008-11-24T09:30:00-05:00,81.96001,85.97,81.03,83.89999,48472864,44116700.8,45.904584140897356,43.10677309465201,NaN,NaN,-60.11820208437832,-113.97453771800376,-0.21123533417079132,-3.548951080039359,-3.3377157458685676,184649147,131977233.4,18.09599885497704,20.50011148285274,NaN,NaN,-14.616133575513246,-13.71913824648986
2008-11-25T09:30:00-05:00,85.42999,86.07001,82.78999,84.81,44575008,43676268,46.97844588377213,43.058892985556795,NaN,NaN,-40.96661342071117,-103.99352750525415,0.1068790850525625,-3.2041168895528642,-3.3109959746054267,229224155,143385627,23.707473947793915,20.068382632042468,NaN,NaN,-13.355281299587737,-13.6671586826467
2008-11-26T09:30:00-05:00,83.16,87.3,82.99001,87.17999,29793952,42633430.4,49.77481492089495,43.527980132980396,NaN,NaN,-16.946637056541984,-84.732989397871,0.48209720523179334,-2.708374468065685,-3.1904716732974783,259018107,170708881.4,35.164623257902974,20.52292008834837,NaN,NaN,-11.470445897557,-13.353342570491028
2008-11-28T09:30:00-05:00,86.67999,88.36,86.67999,88.3,6958730,40841044.5,51.08768078797948,43.84756031649685,NaN,NaN,20.558527699117448,-47.62024298737479,0.7925676645415347,-2.19976209262056,-2.9923297571620946,265976837,215008905.8,48.63348519771442,22.030037504751853,NaN,NaN,-9.531359215421185,-12.807344948338194
2008-12-01T09:30:00-05:00,86.3,86.37,81.46001,81.66,28021888,40268290.9,43.78106896652125,43.729090024114555,NaN,NaN,-57.00385955753245,-30.8953568840093,0.5491480384546308,-2.3058947090938062,-2.855042747548437,237954949,235364639,53.42166340225567,23.982409737444577,NaN,NaN,-9.948442272267902,-12.398930280328152
2008-12-02T09:30:00-05:00,82.63,84.42,81.5,84.36,29387264,40839428.5,47.09452228195302,43.999698539038214,NaN,NaN,-46.47184377066338,-28.166085221266314,0.566126657102699,-2.1473844261700634,-2.7135110832727625,267342213,251903252.2,56.9341917010822,26.411824290489616,NaN,NaN,-9.300001525133757,-11.956226172443237
2008-12-03T09:30:00-05:00,82.64999,86.34,82.44,86.03999,49781744,42041994.9,49.10456246953556,44.655945484441034,NaN,NaN,-4.124230204110878,-20.797608577946257,0.6790428311151109,-1.8647075443788736,-2.5437503754939845,317123957,269483212.6,60.3564434348836,29.286706488711935,NaN,NaN,-8.170325452415785,-11.415383212439316
2008-12-04T09:30:00-05:00,84.74001,86.46001,82.73,83.74001,40461232,42616024.5,46.49986187375443,44.63519090045113,NaN,NaN,-10.868826536907932,-19.58204647401945,0.5906314903509831,-1.8054610125552557,-2.3960925029062388,276662725,273012136.2,61.025963783140355,32.17798097167107,NaN,NaN,-7.970172480827009,-10.923210250780414
2008-12-05T09:30:00-05:00,82.97,86.98,81.31,86.59,43500352,42610856.5,50.036516371881426,45.166412698185674,NaN,NaN,14.746029347710417,-20.744546144300863,0.7079795177547878,-1.5111181057127538,-2.2190976234675417,320163077,283849384.2,63.08765781348968,35.34735877648068,NaN,NaN,-6.7655305730876245,-10.329256011110015
2008-12-08T09:30:00-05:00,88.32001,90.39,88,89.12,44116080,43270617.3,53.006392819964624,45.9907586364992,NaN,NaN,151.05539830165787,20.867305427537218,0.9261073106244406,-1.0614634851869909,-1.9875707958114315,364279157,309114225.8,67.41524248398403,38.96417333717532,NaN,NaN,-4.869470056300249,-9.549286588994335
2008-12-09T09:30:00-05:00,88.34,89.41,86.62,87.11,34191488,43795159.7,50.441136569781655,46.50469162509983,NaN,NaN,111.49774774774802,52.461223731219505,0.9041243090928979,-0.8574154094453093,-1.7615397185382071,330087669,321663317,69.33812628282223,42.73737352610491,NaN,NaN,-3.9989227976858452,-8.756377475950265
2008-12-10T09:30:00-05:00,88.06,88.92999,86.55,87.64,32158656,43829665.3,51.11296853893707,47.331506160295746,NaN,NaN,108.54947121447186,74.99596401493605,0.8928330825261508,-0.6454983653805186,-1.5383314479066694,362246325,330687790.6,70.67818457098574,46.64750593597373,NaN,NaN,-3.094044924703755,-7.947472825772192
2008-12-11T09:30:00-05:00,86.61,88.27,85.27,85.86,26305856,43352728.5,48.7239966006705,48.24389259095214,NaN,NaN,61.12856216656429,89.39544175563049,0.7393814075123017,-0.6141046885162922,-1.353486096028594,335940469,342543339.4,72.38562175409949,50.90023198450941,NaN,NaN,-2.971041205652576,-7.236554022897962
2008-12-12T09:30:00-05:00,83.50999,87.03,83.23,86.36,34298416,41845825.3,49.438873673973944,48.78467327860841,NaN,NaN,32.02406054863474,92.85104799581535,0.6486895816035179,-0.5426241190241967,-1.1913137006277146,370238885,352558501,73.77490844222493,55.287113209096916,NaN,NaN,-2.679001614181224,-6.5854751073669995
2008-12-15T09:30:00-05:00,86.95,87,84.85001,85.99001,22947248,40738619.7,48.8956334203639,48.99831965571315,NaN,NaN,45.29285834464465,71.6985400044127,0.5450894045111323,-0.5099519449887993,-1.0550413494999316,347291637,349160997,72.44340540533695,59.16907081983691,NaN,NaN,-2.571789777872551,-6.012091488867792
2008-12-16T09:30:00-05:00,86.71001,89.75,86.33,89.57001,30326032,40345514.1,54.14587741391402,49.51027905072329,NaN,NaN,114.27671094992772,72.25433264484865,0.6896661803375432,-0.19295862407800257,-0.8826248044155458,377617669,358666997,73.86469808794396,62.75172968699048,NaN,NaN,-1.0526529573394403,-5.303600270078028
2008-12-17T09:30:00-05:00,88.46001,89.7999,87.95,88.35001,22727952,39371490.1,52.1785573034325,49.68197493519026,NaN,NaN,106.12157756394635,71.76875391474354,0.6743198337213843,-0.03972501226381553,-0.7140448459851998,354889717,357195675.4,73.23508801856326,65.47104859846623,NaN,NaN,-0.2753103850822149,-4.5852731436500545
2008-12-18T09:30:00-05:00,88.84,89.03999,85.42,86.36,26048464,38184895.7,49.048071873769494,49.53628858417526,NaN,NaN,49.67065975924765,69.47717343328023,0.5088641024140431,-0.07796471796764592,-0.586828820381689,328841253,355775832.2,72.5920432386084,67.18237417281578,NaN,NaN,-0.44051822237879745,-3.9931652977541607
2008-12-19T09:30:00-05:00,86.74001,87.82001,85.36,85.36,19708560,35274067.7,47.505680499177416,49.802332265079265,NaN,NaN,17.383109583022758,66.54898324015781,0.3200165008561773,-0.18680819431146745,-0.5068246951676447,309132693,343554593.8,67.12833618488887,68.16142222871817,NaN,NaN,-0.9943428702361617,-3.5647620938230182
2008-12-22T09:30:00-05:00,85.8,85.9285,83.59,84.96001,20397152,31708946.9,46.8707757046951,49.7863503667037,NaN,NaN,-52.70997569023524,46.94841643318184,0.16396888565975054,-0.30186358809295655,-0.4658324737527071,288735541,331843374.6,62.29008009720883,68.54398568558435,NaN,NaN,-1.6283308878266394,-3.288129064394964
2008-12-23T09:30:00-05:00,85.59,85.92999,83.84,84.07001,17186992,30144653.3,45.4163198016216,49.522904461852704,NaN,NaN,-66.2434241693627,10.844389409323762,0.00501492861316849,-0.4595638129862465,-0.464578741599415,271548549,310629550.6,54.611690813873906,68.13364621265508,NaN,NaN,-2.5518158489899005,-3.1829414621942407
2008-12-24T09:30:00-05:00,84.42999,84.92999,84.14101,84.48,4161414,28123973.6,46.243870012598606,49.50461932891301,NaN,NaN,-70.46091448976298,-24.472109001418104,-0.06447714336291821,-0.5451751708030628,-0.48069802744014456,275709963,294793599.8,49.68777465454003,67.32377556061219,NaN,NaN,-3.1393207326689057,-3.176709929404907
2008-12-26T09:30:00-05:00,85.00999,85.28,84.56,85.07001,5294777,26899014.85,47.477951918435906,49.321864725095466,NaN,NaN,-46.65546493245304,-43.737333939758244,-0.06261793740581834,-0.5589704491974175,-0.4963525117915991,281004740,285226297.2,46.93451356157907,66.16997954261858,NaN,NaN,-3.34785132288761,-3.201158699902436
2008-12-29T09:30:00-05:00,85.27,85.278,83.59,84.91,10404887,27071322.7,47.161739992728045,48.904389523149995,NaN,NaN,-57.86920153744844,-58.78779616385248,-0.06385640066347387,-0.5761730126209414,-0.5123166119574676,270599853,277519729.2,44.78194500891802,64.55331543725673,NaN,NaN,-3.603530642817475,-3.2586404060331557
2008-12-30T09:30:00-05:00,85.25,86.78,84.86,86.67999,17772896,26558873.1,51.045788950019414,48.94757897888126,NaN,NaN,4.849669114666692,-47.2758672028721,0.05634213213935019,-0.44188894678327983,-0.49823107892263,288372749,277447170.8,44.76112997716413,62.79781570113829,NaN,NaN,-2.873293492076477,-3.2035908468964873
2008-12-31T09:30:00-05:00,86.81,88.37,86.63,87.52,18708064,26024913.1,52.8183753226708,49.069393749147956,NaN,NaN,66.09345271481074,-20.808491826037407,0.18687644962598227,-0.2646355168901522,-0.45151196651613446,307080813,284553623.6,47.34269243381432,61.13099483419747,NaN,NaN,-1.7883797119646943,-3.001417827620517
2009-01-02T09:30:00-05:00,87.95,90.62,87.57001,90.2,24577616,24764706.7,58.038740531400094,49.73473260134292,NaN,NaN,141.3325578774172,21.550202647398628,0.43404414611256764,0.09104321612457511,-0.34300092998799253,331658429,295743316.8,51.209257018875775,59.61839735311007,NaN,NaN,0.6282828884057807,-2.4828891539024744
2009-01-05T09:30:00-05:00,89.87,90.33,88.87,89.7,25625088,24022899.5,56.77657282934814,50.25885396958394,NaN,NaN,129.8207966624382,56.845454966376884,0.5374290005699537,0.32878532072444955,-0.2086436798455041,306033341,300749037,52.876271377503485,58.125637562772816,NaN,NaN,2.3650060425192208,-1.7903326972708036
2009-01-06T09:30:00-05:00,90.17999,90.89999,89.38,90.14999,37269200,23711341.9,57.66880354200404,50.88550897827252,NaN,NaN,133.22573141563151,95.06444155699288,0.6046751833210658,0.5472002993058283,-0.05747488401523762,343302541,315289574.6,57.426562690350046,57.05300594027375,NaN,NaN,4.08553657061848,-0.9509228018580488
2009-01-07T09:30:00-05:00,88.88,89.17999,87.23,87.86,33167232,23163899.5,51.807841914117716,50.71850644257279,NaN,NaN,51.256847624484465,104.34587725895642,0.4695078911871197,0.529409979968662,0.05990208878154231,310135309,319642086.6,58.71176090293456,55.97065328420165,NaN,NaN,4.094670051936608,-0.23012382274452647
2009-01-08T09:30:00-05:00,87.07001,87.57001,86.55,87.42999,23643328,22636491.5,50.764521072600715,50.61750385465623,NaN,NaN,13.243517300426987,93.77589017607968,0.3321869220947853,0.4751357414000239,0.14294881930523862,286491981,315524320.2,56.95987101440617,54.80813778390472,NaN,NaN,3.825621571926821,0.34926837649423736
2009-01-09T09:30:00-05:00,87.67,87.75999,85.84,86.14,24497392,22253428.3,47.663526377956295,50.51860774781243,NaN,NaN,-11.174912149792128,63.27439617063781,0.1450756264006662,0.32429335230607137,0.17921772590540516,261994589,301591552.2,51.374063087651685,53.292567773122094,NaN,NaN,2.751235363292445,0.6924065174654098
2009-01-12T09:30:00-05:00,85.77,86.02,84.25999,84.78999,22625520,22069411.5,44.593463570316764,50.31059225289381,NaN,NaN,-74.91667218172232,22.326902401805697,-0.0675955909821728,0.09472323717768916,0.16231882815986196,239369069,288258697.8,46.65865158246424,51.83044744437748,NaN,NaN,0.9570233148707613,0.7302089170947458
2009-01-13T09:30:00-05:00,84.61,85.28999,83.83,84.42,29853280,21847154.7,43.76152507055708,50.08850292188396,NaN,NaN,-91.99855250810161,-22.717954382940928,-0.22244204454418115,-0.11573372752036448,0.10670831702381667,209515789,261501347.4,38.93503203029742,50.162229725312386,NaN,NaN,-0.786874190084765,0.5134827589262443
2009-01-14T09:30:00-05:00,83.16,83.36,81.48,82.08,38889232,22644253.9,38.827816017158774,49.617895508708045,NaN,NaN,-159.93906038366057,-64.95713598456993,-0.4581421949102949,-0.46596942661405194,-0.007827231703757057,170626557,233599597,32.831841135251025,48.60652617683932,NaN,NaN,-3.809469363404176,-0.10408182997810145
2009-01-15T09:30:00-05:00,82.07001,82.98,80.03999,82.17999,44232832,23339593.9,39.14354404580668,49.110729368222906,NaN,NaN,-159.3347720811315,-99.47279386088164,-0.5754054244052784,-0.727084012210355,-0.15167858780507665,214859389,219273078.6,30.213027687987264,47.215472822085545,NaN,NaN,-6.2329834106696005,-0.9796391986483156
2009-01-16T09:30:00-05:00,83.22,83.39999,81.03,82.69,37630304,24084711.5,40.82130973109957,48.635254926270306,NaN,NaN,-121.36558546423552,-121.51092852377033,-0.5848095702709908,-0.8826905506438152,-0.2978809803728244,252489693,217372099.4,29.87253887606225,45.99676034454863,NaN,NaN,-7.865811236204897,-1.9633780611563987
2009-01-20T09:30:00-05:00,82.21001,82.41,79.36,79.41,36926816,24628629.1,34.27645026963906,47.71487708890681,NaN,NaN,-162.92116292769472,-139.1118266729648,-0.7666534359697831,-1.2561977753350533,-0.4895443393652702,215562877,212610861,28.99128053264897,44.868855739100844,NaN,NaN,-11.3938544672239,-3.3105889763088987
2009-01-21T09:30:00-05:00,80.64999,82.41,79.35001,82.24001,34839296,25385165.9,42.79808250581146,47.12575520003481,NaN,NaN,-118.1969642309675,-144.35150901753798,-0.6553726990635798,-1.308760213194745,-0.6533875141311651,250402173,220788137.8,32.665316346931505,44.00486905122708,NaN,NaN,-11.930657034942731,-4.542027270399446
2009-01-22T09:30:00-05:00,80.89999,82.03999,79.55,81.16,40166240,26373620.3,40.6328546741668,46.25536086799882,NaN,NaN,-116.63401943635706,-135.6905008280773,-0.6142352750540251,-1.4211816079486965,-0.8069463328946714,210235933,228710013,36.113909772666105,43.20281314685934,NaN,NaN,-13.043789962576438,-5.756564797853302
2009-01-23T09:30:00-05:00,79.5,81.53,79.05,80.52,44704048,27749473.1,39.362007267475974,44.921308492004236,NaN,NaN,-116.69127716323548,-127.16180184449806,-0.5897384357139773,-1.5441193775371431,-0.9543809418231658,165531885,218844512.2,33.79276252726373,41.958777826029916,NaN,NaN,-14.339005386887404,-6.982627739143888
2009-01-26T09:30:00-05:00,80.86,82.28999,80.19,81.07001,28919904,28987397.6,41.06786780124477,43.79925813285399,NaN,NaN,-85.77245900338114,-120.04317655232721,-0.4996679659538996,-1.5789658992655404,-1.0792979333116408,194451789,207236931.4,31.247943592699926,40.413897269972516,NaN,NaN,-14.920843095857691,-8.116658504388717
2009-01-27T09:30:00-05:00,81.49001,82.24001,80.8,81.50999,23359536,29890635.55,42.46230261150511,42.713079494961214,NaN,NaN,-70.06434895775016,-101.4718137583383,-0.37910187106112625,-1.5531752721380485,-1.1740734010769223,217811325,207686621,31.463277457479947,38.55937689619608,NaN,NaN,-15.015349413732048,-9.10218577715205
2009-01-28T09:30:00-05:00,83.03999,84.03999,82.59,83.679,21101904,30425486.4,48.88355849034184,42.50420210754866,NaN,NaN,-23.943483939724803,-82.62111770008975,-0.13453527793468711,-1.3422424984952812,-1.207707220560594,238913229,205388832.2,30.9301987922383,36.57497960257491,NaN,NaN,-13.195952836646818,-9.687009642794159
2009-01-29T09:30:00-05:00,82.58,82.94,81.351,81.53,20834224,30578552.8,43.68204204767229,41.998310748625194,NaN,NaN,-52.736167345399956,-69.8415472818983,-0.10032683717226876,-1.3331157670259302,-1.2327889298536614,218079005,206957446.6,31.779946824927634,34.776413589040736,NaN,NaN,-13.160612447516659,-10.183238614897373
2009-01-30T09:30:00-05:00,81.83,81.96001,79.60001,80.08,26178416,30952070.4,40.54700810854765,41.489988015096,NaN,NaN,-77.44027235139481,-61.991346319530166,-0.1549228618240197,-1.426442507133686,-1.2715196453096662,191900589,212231187.4,34.689153279942076,33.58463431706147,NaN,NaN,-14.093381176112112,-10.741830409356622
2009-02-02T09:30:00-05:00,79.14,79.92,78.64999,79.32001,22970496,30871714.4,38.96839259950943,41.08819723146691,NaN,NaN,-101.20064288675789,-65.07698309620552,-0.217929864390499,-1.5439319757977898,-1.3260021114072909,168930093,207126848.2,33.212854953773885,32.624220272155014,NaN,NaN,-15.338948153945827,-11.398561515726508
2009-02-03T09:30:00-05:00,79.78,81.10001,79.02,80.63,24080688,30794494.4,43.08190396264814,41.03965286661628,NaN,NaN,-74.3232058825768,-65.92875448117086,-0.1503077797846235,-1.5138868361380702,-1.3635790563534467,193010781,202166739.4,31.796737271353933,32.11434207508762,NaN,NaN,-15.169367981975704,-11.937248153762107
2009-02-04T09:30:00-05:00,80.8,81.71001,79.34,79.69,27510000,30306534.4,40.94911926980048,41.19117452751925,NaN,NaN,-73.61666888696939,-75.86339147061976,-0.14760129903914754,-1.5480806801523812,-1.4004793811132337,165500781,187484249.8,27.992034120413024,31.76864157402776,NaN,NaN,-15.654782414490438,-12.468324476723298
2009-02-05T09:30:00-05:00,79.25999,81.14999,78.5,80.55,39873392,30641842.4,43.69543832201252,41.51630983296253,NaN,NaN,-78.21078546080409,-80.95831509370059,-0.07051633127309342,-1.4886247952046006,-1.4181084639315071,205374173,184943283.4,27.38140453132135,31.56638277712306,NaN,NaN,-15.262483600706862,-12.867490065863807
2009-02-06T09:30:00-05:00,80.87,83.27,80.72,82.86,30049664,30962159.2,50.37195569827369,42.19849883061782,NaN,NaN,22.391328609920937,-60.991994901437444,0.14184304333812503,-1.240804659758851,-1.382647703096976,235423837,193647933,32.79034390800069,31.774797422261514,NaN,NaN,-12.845620908399722,-12.864365900511794
2009-02-09T09:30:00-05:00,82.8,83.28999,82.10001,82.75,20837568,30779168,50.067497498474765,43.326430775534654,NaN,NaN,62.0500105893895,-28.34186420620797,0.27309553070838133,-1.0412782897114994,-1.3143738204198807,214586269,202779168.2,38.00675221174536,32.41875968505412,NaN,NaN,-10.984492175136493,-12.595812511172465
2009-02-10T09:30:00-05:00,82.23,82.73,78.61,79.19,49006560,32098220,41.355559774449944,43.22339343758026,NaN,NaN,-77.11795812473761,-28.900814654640136,0.12583794005814153,-1.1570763953472039,-1.2829143354053454,165579709,197292953.8,36.1893597037653,32.6704770676851,NaN,NaN,-12.01764892516048,-12.513217713170752
2009-02-11T09:30:00-05:00,79.62,80.00999,78.67999,79.55,33290096,32270060.8,42.44617179415584,43.35291608900805,NaN,NaN,-119.17411299005524,-38.012303475257305,0.061613546420467014,-1.2058974023797617,-1.2675109488002287,198869805,203966758.6,39.951015461098585,32.944556045430275,NaN,NaN,-12.509716002560761,-12.512717468797897
2009-02-12T09:30:00-05:00,78.42999,79.62,77.14999,79.5,45482032,32599700.8,42.32843077523166,43.56480348241917,NaN,NaN,-146.1968069993435,-51.60950778296518,0.02649382898950381,-1.234393662563349,-1.2608874915528527,153387773,193569478.6,36.35530538642745,33.12759482108483,NaN,NaN,-12.939512608336285,-12.573688203017667
2009-02-13T09:30:00-05:00,79.48,79.95,78.47,78.55,23851424,31580630.4,40.05498737781294,43.49245488074548,NaN,NaN,-116.59193811410044,-79.40616112776947,-0.04603888985735494,-1.3184361038745465,-1.2723972140171915,129536349,172391981,30.361303879342515,33.06426341298787,NaN,NaN,-13.96104965858509,-12.771882696670156
2009-02-17T09:30:00-05:00,76.60001,77.06,75.72,75.75,36732416,31535736,34.221019532199676,42.903791803652226,NaN,NaN,-253.53667089667408,-142.52349742498217,-0.25617681432481576,-1.5926182319232112,-1.3364414175983954,92803933,148035513.8,25.212667851134285,32.617791298248896,NaN,NaN,-16.735778551090537,-13.338153533015925
2009-02-18T09:30:00-05:00,76.25,76.49001,75.09,75.75999,35795040,31479147.2,34.25781071368267,41.85909553389086,NaN,NaN,-221.0214296509854,-171.30419173023174,-0.3616363626523127,-1.7884868709137862,-1.4268505082614735,128598973,140639366.6,23.887940755132107,32.11477286702702,NaN,NaN,-18.93998369031999,-14.138414984059363
2009-02-19T09:30:00-05:00,76.42999,76.5,74.8,75.03,30933888,31283876.8,32.81354897176834,41.08277459989772,NaN,NaN,-189.19378593485771,-185.30812631919224,-0.4423567214352433,-1.9797964100555276,-1.5374396886202844,97665085,120398422.6,20.68484585162416,31.322265654648202,NaN,NaN,-21.21570770361619,-15.149456801138909
2009-02-20T09:30:00-05:00,73.32001,74.71001,72.48,73.73,46352432,31593186.4,30.35893104205816,40.355054809434186,NaN,NaN,-205.27214000522014,-197.12319292036756,-0.5387080270029152,-2.2108247223739284,-1.6721166953710132,51312653,99983398.6,18.055200275573483,30.134126154336165,NaN,NaN,-23.918959602435873,-16.402242915609904
2009-02-23T09:30:00-05:00,74.24001,74.41,71.07001,71.14999,36014368,31158702.4,26.174205946554764,39.44118433422314,NaN,NaN,-199.01346992980186,-213.60749928350782,-0.7202650358429339,-2.5724479901746804,-1.8521829543317465,15298285,77135785.8,15.65631203059668,28.88008737410922,NaN,NaN,-27.71991467463229,-18.019053166898814
2009-02-24T09:30:00-05:00,71.57001,73.8,71.14999,73.38,37531248,31589269.6,34.569412437524534,38.83314922528574,NaN,NaN,-149.9840438628031,-192.89697387673363,-0.6371039413455879,-2.6485628810137314,-2.0114589396681435,52829533,69140905.8,14.909802429709003,27.673877742563157,NaN,NaN,-28.328173570509524,-19.491784653128917
2009-02-25T09:30:00-05:00,73.03,74.05,71.56,72.67,43673664,32604976,33.27211406410794,38.28479171059342,NaN,NaN,-125.6668009903822,-173.82604814461303,-0.5785545911543877,-2.734652178611128,-2.1560975874567405,9155869,45252285,12.926493085464713,26.597767668638276,NaN,NaN,-29.22507823545662,-20.88225516489002
2009-02-26T09:30:00-05:00,73.48,74.07001,71.75999,71.84,31374048,33118583.2,31.771100684670486,37.43305330792612,NaN,NaN,-112.54520821530437,-158.49633260070235,-0.544840135886103,-2.8371477573143693,-2.2923076214282663,-22218179,21275632.2,11.301548079410466,25.449206493501784,NaN,NaN,-30.4220834894285,-22.24508778268123
2009-02-27T09:30:00-05:00,70.63,72,70.37,70.75999,35772464,33865495.2,29.882028266267483,35.969487062782825,NaN,NaN,-125.81895324398224,-142.60569524845477,-0.5431723323308448,-2.971273036841822,-2.4281007045109773,-57990643,-585027,10.059868253122701,23.82560108958193,NaN,NaN,-32.00085954324099,-23.638769462761196
2009-03-02T09:30:00-05:00,69.64999,69.82001,67.59,67.83,36932208,34403184.8,25.45933824037263,34.21176140148982,NaN,NaN,-153.82071968942395,-133.5671452003792,-0.6785015803323211,-3.2762276799263788,-2.5977260995940576,-94922851,-22629254.2,8.9875376092359,21.752800046545538,NaN,NaN,-34.884400677354314,-25.24528820770307
2009-03-03T09:30:00-05:00,68.48,68.60001,67.09,67.21001,30808368,34795078.4,24.628682927294008,33.01698448383582,NaN,NaN,-146.37728728614135,-132.84579388504685,-0.7436384976072743,-3.5272742216031503,-2.783635723995876,-125731219,-58341404.6,7.578218464390545,19.709147100875914,NaN,NaN,-37.469383017181286,-26.991587466199956
2009-03-04T09:30:00-05:00,68.35001,69.88,67.63,68.77,31997664,35190927.2,30.750912417550808,32.18160881407831,NaN,NaN,-113.09535904284354,-130.33150549553912,-0.6205495036691864,-3.559322603582359,-2.9387730999131727,-93733555,-78919289.4,6.906205655901871,17.34880354336186,NaN,NaN,-37.74505946561384,-28.527797751830512
2009-03-05T09:30:00-05:00,67.5,68.05,65.53,66.07001,35057232,35568288.8,26.707389043075707,31.065820118924318,NaN,NaN,-131.91940688191443,-134.20634522886115,-0.6563842972486253,-3.7592534714739543,-3.102869174225329,-128790787,-100233811,6.284557466823074,15.200892977675835,NaN,NaN,-39.317972924282415,-30.06925134789507
2009-03-06T09:30:00-05:00,66.53999,67.63,64.78,66.5,35835904,35366414.4,28.32382191885236,30.227879728998566,NaN,NaN,-122.1322243454411,-133.46899944915293,-0.5887068789027046,-3.8387527728537094,-3.250045893951005,-92954883,-107226659,6.090850047233133,13.467289132525167,NaN,NaN,-40.058576066922335,-31.496297736327534
2009-03-09T09:30:00-04:00,65.50999,67.17,65.25,65.44,28121168,35269989.6,26.757179073021675,29.69474826762871,NaN,NaN,-118.43706373420761,-126.39226825810965,-0.5534436724395895,-3.941850484500492,-3.3884068120609023,-121076051,-112457299,5.943284988346079,12.09090464232601,NaN,NaN,-41.1540998711975,-32.875983755594675
2009-03-10T09:30:00-04:00,66.62,69.23,66.53999,69.14,31012800,35778751.2,39.36456829399852,30.0595166662227,NaN,NaN,-74.88048248756232,-112.09290729839384,-0.2353121317177438,-3.682546976708082,-3.447234844990338,-90063251,-105323705.4,9.175116377233834,11.039988615333277,NaN,NaN,-37.87699010695146,-33.59041323435993
2009-03-11T09:30:00-04:00,69.69,70.32001,68.82001,69.48,21884496,34422648,40.3801453652963,30.59998783718898,NaN,NaN,-46.54717221588178,-98.78326993300149,0.029547793314694815,-3.4103001033469695,-3.4398478966616644,-68178755,-100212745.4,11.520849675544838,10.38541745989904,NaN,NaN,-34.980645228828664,-33.789017804998316
2009-03-12T09:30:00-04:00,69.38,71.99001,68.85001,71.77,21946384,33855462.4,46.83853977379091,31.777102746598455,NaN,NaN,-15.276819517365912,-75.45475246009178,0.37151080579178863,-2.9754593894219283,-3.346970195213717,-46232371,-83701062.2,18.815746182287867,10.439742167521498,NaN,NaN,-30.332549543003907,-33.295236624713404
2009-03-13T09:30:00-04:00,72.19,72.59,71.2,72.32001,21839040,32673312.8,48.287475682255376,33.35662201343421,NaN,NaN,16.941673335690485,-47.63997292386544,0.6319854284216397,-2.5569884096866673,-3.188973838108307,-24393331,-69988751.8,24.39089255846517,11.06364077665496,NaN,NaN,-26.15389843425784,-32.27504545464832
2009-03-16T09:30:00-04:00,72.97,74.07001,72.2,72.31,24523184,32706900.8,48.26169448894549,34.33464215996428,NaN,NaN,47.28695563482042,-14.49516905005982,0.790550606135477,-2.2007855804389607,-2.9913361865744377,-48916515,-55556844.6,29.85102965190002,12.130871292525748,NaN,NaN,-22.83322645914722,-30.926214169576735
2009-03-17T09:30:00-04:00,72.28999,74.12,71.86,74.08,20456960,31893128,53.03647160052267,35.746381983993906,NaN,NaN,66.35519475977152,13.751966399406943,0.9887229244864395,-1.755432530966388,-2.7441554554528276,-28459555,-43236105.4,34.21850908684418,13.651729578338566,NaN,NaN,-18.467170924378053,-29.146350848834064
2009-03-18T09:30:00-04:00,73.49001,75.89,72.72,74.97,35912080,31898980,55.27171378155497,37.424997205199936,NaN,NaN,100.98288879797244,43.257978602177786,1.1429186671762075,-1.3155071214825682,-2.4584257886587757,7452525,-28109849.4,39.22159788305695,15.6460188500276,NaN,NaN,-14.139984406788036,-27.00258421425606
2009-03-19T09:30:00-04:00,75.83,75.87,73.83,74.11,25414624,31623016.8,52.663365366723134,39.0522355695182,NaN,NaN,105.61181195816859,67.4357048972847,1.14718169406913,-1.0244486710723635,-2.1716303651414934,-17962099,-22455795,41.02710887937466,17.8579646090456,NaN,NaN,-11.245042564602084,-24.751506835734062
2009-03-20T09:30:00-04:00,74.42999,74.56,72.53,72.74001,22998512,30455320.8,48.719104774152996,40.713647464788224,NaN,NaN,70.30921098095739,78.10921242633808,1.022085294963788,-0.8940237464367584,-1.9161090414005464,-40960611,-25769251,40.27208466613679,20.092575113109945,NaN,NaN,-9.890318095020758,-22.628479872775017
2009-03-23T09:30:00-04:00,74.55,77.78,74.17,77.75999,25717952,29940500,60.41756644675226,43.26999628760667,NaN,NaN,144.03553344495754,97.45892798836549,1.2279300918355038,-0.3811964266061665,-1.6091265184416703,-15242659,-19034479.8,42.584907446388286,22.593052897538353,NaN,NaN,-4.496996399056618,-20.038267947958104
2009-03-24T09:30:00-04:00,76.91,77.95,76.44,76.7,20396496,29083762.4,57.43797484140401,45.17621503216761,NaN,NaN,139.56072345904195,112.10003372821957,1.2396035120093418,-0.05962212842999293,-1.2992256404393348,-35639155,-20470399.8,42.209616157357594,25.114725076213766,NaN,NaN,-1.171447616013106,-17.34300790053739
2009-03-25T09:30:00-04:00,77.25,78.62,75.48,77.41,30264576,28413308,58.90007071769858,47.47569229464068,NaN,NaN,127.6360157580335,117.43065912023178,1.2390934546494603,0.24964117787249052,-0.9894522767769697,-5374579,-23035820.6,41.50583922764948,27.630530916272793,NaN,NaN,1.957389631537739,-14.585808253098087
2009-03-26T09:30:00-04:00,78.17999,79.3,77.52,79.10001,29413120,28315261.6,62.2263459054451,49.897301150825875,NaN,NaN,139.30070557759674,124.16843784411739,1.2906915717462173,0.6239121879058018,-0.6667793838404154,24038541,-14635692.6,44.75399237812365,30.39218393990783,NaN,NaN,5.667070335806332,-11.692539883254598
2009-03-27T09:30:00-04:00,78.14,78.42,77.33,77.81,19999776,27526627.2,58.34477472404184,52.1535579830416,NaN,NaN,108.81856480145775,131.8703086082175,1.1791255628272508,0.8071275696936482,-0.3719979931336026,4038765,-5635817.4,48.08050884599523,33.40198564402563,NaN,NaN,7.531963236561359,-8.946182294709462
2009-03-30T09:30:00-04:00,76.09,76.12,74.37,75.25,25811744,26970604,51.481714225562264,53.01906840672472,NaN,NaN,54.72936719879082,114.00907535898413,0.8874046547356089,0.7372578252859086,-0.15014682944970037,-21772979,-6941881.4,47.632276930861046,36.148925683570425,NaN,NaN,6.913393397926475,-6.680528624332901
2009-03-31T09:30:00-04:00,76.03999,77.23,75.20261,75.84,28187440,26839557.6,52.85803686439088,53.91034637094577,NaN,NaN,65.17510758786338,99.13195218474843,0.6970617043850247,0.7211803010315805,0.0241185966465558,6414461,1468841.8,50.812393061047814,38.95546449682064,NaN,NaN,6.842999132860809,-4.7485960875909425
2009-04-01T09:30:00-04:00,74.88,77.87,74.8,77.53,25420272,26510688,56.651278227468175,54.61125626049414,NaN,NaN,71.90138203689114,87.98502544051996,0.6488492714873502,0.8351801860057435,0.18633091451839334,31834733,8910704.2,53.50292352759604,41.433120021485514,NaN,NaN,7.9639712467596535,-2.932515039826572
2009-04-02T09:30:00-04:00,79.38,80.75999,78.98,79.71001,30182032,26266928,61.00957904109398,55.519977928982605,NaN,NaN,124.33051413431862,84.99098715186435,0.7220413035121055,1.0888825439085252,0.36684124039641974,62016765,16506349,56.13997605048508,43.70091169948693,NaN,NaN,10.326875920701466,-1.0383163311797095
2009-04-03T09:30:00-04:00,79.75999,80.19,78.96001,80.16,20620208,25506143.2,61.86194962754695,56.491424724596996,NaN,NaN,117.21358770119198,86.66999173181118,0.7554389419495737,1.311139917833387,0.5557009758838132,82636973,32225990.6,61.061856393039854,45.93025646671121,NaN,NaN,12.482347781240271,0.8932071134517163
2009-04-06T09:30:00-04:00,79.46001,79.92999,78.60001,79.75999,17840112,24992090.4,60.59385465507371,57.031237799922074,NaN,NaN,103.62078877579668,96.44827604721236,0.7061766536348809,1.4384217929274143,0.7322451392925334,64796861,49539958.6,65.63595125243923,48.17435947853942,NaN,NaN,13.868233260451662,2.7467822773088515
2009-04-07T09:30:00-04:00,78.74001,78.74001,77.69,77.89,17326320,24307766.4,54.92552010577253,57.00650968022334,NaN,NaN,65.40731066401531,96.49471666244274,0.5122669262791848,1.3725787971415144,0.8603118708623296,47470541,57751174.6,67.58097717621763,50.200029428050904,NaN,NaN,13.378872405762642,4.265652295659393
2009-04-08T09:30:00-04:00,78.17999,78.94,77.57001,78.37,15718945,23999488.85,56.06172468762151,57.249249631716076,NaN,NaN,65.56533072603477,95.22750640027148,0.386663366596704,1.3436410791082096,0.9569777125115057,63189486,64022125.2,69.02299643224055,52.19973568182703,NaN,NaN,13.30175101425713,5.556523541173355
2009-04-09T09:30:00-04:00,80.00999,80.92,79.7601,80.89,19292560,23866797.65,61.542597748105756,58.165213415569845,NaN,NaN,125.83117954691755,95.52763948279126,0.4397638858116213,1.5066825697760322,1.066918683964411,82482046,68115181.4,69.9621549963698,54.32045499112939,NaN,NaN,14.900265475615976,6.891343817522301
2009-04-13T09:30:00-04:00,80.03,81.17999,79.69,80.55,12000852,23374888.25,60.44701630813306,58.16731697709705,NaN,NaN,115.71736582075636,95.22839510670413,0.41856821327505056,1.5901289505582241,1.1715607372831736,70481194,65684025.6,68.6311774344609,56.180902847420285,NaN,NaN,15.87709341372195,8.175022331265108
2009-04-14T09:30:00-04:00,79.97,80.34,79.08,79.27,18589952,23078226.65,56.37795794077891,58.09160148419526,NaN,NaN,77.80428717550039,90.06509478664488,0.29097363366931783,1.535277779369821,1.244304145700503,51891242,63102901.8,67.17012948654033,57.963796656647624,NaN,NaN,15.516850091558846,9.223854868449928
2009-04-15T09:30:00-04:00,79.03999,80.46001,78.74001,80.3,18265200,22968638.65,58.78239672144761,58.08319619874876,NaN,NaN,80.51349307880476,93.08633126960277,0.2501346147547401,1.556972414143928,1.306837799389188,70156442,67640082,68.44191968108366,59.887802403321494,NaN,NaN,15.90567205203845,10.178400180391145
2009-04-16T09:30:00-04:00,80.86,81.78999,79.71001,81.25999,19527424,22149405.85,60.94321568697994,57.99154404028697,NaN,NaN,111.97951981123035,102.36916908664186,0.26077516737370665,1.6328067586063213,1.3720315912326146,89683866,72938958,69.90807083050899,61.6845222927776,NaN,NaN,16.85667805123932,11.132439876226599
2009-04-17T09:30:00-04:00,81.44,81.85001,80.82001,81.31,16843088,21720829.05,61.05774892249371,58.185327911604965,NaN,NaN,117.64069661762373,100.7310725007831,0.24445716567727094,1.6776030483292033,1.4331458826519323,106526954,77747939.6,71.21510476499289,63.33699342984886,NaN,NaN,17.66611676875937,12.065822289445565
2009-04-20T09:30:00-04:00,80.05,80.16,78.35001,78.52,16642648,21403035.85,51.91172131614705,58.21604270378959,NaN,NaN,17.946143498676495,81.17682803636714,0.030297510275098638,1.4710177704958056,1.440720260220707,89884306,81628562,72.2620968859935,65.09626628378689,NaN,NaN,15.66926806479438,12.580600257352538
2009-04-21T09:30:00-04:00,77.83,79.75999,77.81,79.59,18053088,21019792.65,54.713444758891406,58.34857183911106,NaN,NaN,15.227041538595413,68.66137890898614,-0.05037172964013559,1.3777555981705376,1.4281273278106732,107937394,92837792.4,75.08151501309527,66.82977499464742,NaN,NaN,14.806826289557282,12.898632547667502
2009-04-22T09:30:00-04:00,79.03,80.45,78.66,78.81,20467776,21023356.65,52.32039064965916,58.039222726410415,NaN,NaN,23.493857873353416,57.25745186789588,-0.16109081911297563,1.2267638039194537,1.3878546230324293,87469618,96300427.6,75.89655806847774,68.42932031899612,NaN,NaN,13.3796287470203,12.967346290432188
2009-04-23T09:30:00-04:00,78.94,79.85001,78.02,79.64999,19520944,20486175.05,54.62218357097047,57.58298019283017,NaN,NaN,12.212417209594177,37.30403134756865,-0.18108935873134824,1.1614929246182442,1.3425822833495924,106990562,99761766.8,76.71640186826963,69.89906502026643,NaN,NaN,12.830468481224719,12.947792317688263
2009-04-24T09:30:00-04:00,80.10001,81.27,79.92999,80.73,17662176,19898627.85,57.46542662625471,57.268942835595006,NaN,NaN,87.47340464135681,31.270572952315263,-0.12744740380856534,1.1832730285888857,1.310720432397451,124652738,103386923.6,77.57664261613154,71.07869260763013,NaN,NaN,13.175962617264913,12.98038807477064
2009-04-27T09:30:00-04:00,79.77,81.23,79.66,80.25999,17587008,19777989.45,55.82607728527662,56.928387309180934,NaN,NaN,67.8731091339686,41.25596607937369,-0.12908919033443889,1.1493589444794026,1.2784481348138415,107065730,106823208.4,78.39160843678991,71.98981097794089,NaN,NaN,13.003281556613272,12.983658572176731
2009-04-28T09:30:00-04:00,79.47,80.95,79.37,80.12,16462039,19310504.2,55.319878970247714,56.956555799500585,NaN,NaN,49.40900391903625,48.09235855546185,-0.14394036402372778,1.0985226797841818,1.2424630438079096,90603691,103356467.8,75.41373598996485,72.54929375035141,NaN,NaN,12.723183397533411,12.94644783294197
2009-04-29T09:30:00-04:00,80.82001,82.55,80.69,81.77,18093104,18805787.4,59.93154447417119,57.23297149853985,NaN,NaN,150.11664382574907,73.41691574594098,-0.051731353350789266,1.1777988521194231,1.2295302054702124,108696795,107601903.2,76.58670008388128,73.08955829689718,NaN,NaN,13.76857133014015,13.063894046827425
2009-04-30T09:30:00-04:00,82.73,83.06,81.35001,81.67,17497472,18409647.4,59.53050808003007,57.08925080796301,NaN,NaN,163.88938572972603,103.75230944996736,-0.008815847390110765,1.218510396232574,1.2273262436226848,91199323,104443655.4,73.76724994205657,73.36135079301765,NaN,NaN,14.52415501110199,13.272502756009505
2009-05-01T09:30:00-04:00,81.78999,82.19,80.96001,82.16,12360031,17518547.35,60.91078439546062,57.12237709991498,NaN,NaN,123.48409820620697,110.95444816293738,0.03862625780571949,1.2756090658798342,1.2369828080741148,103559354,100224978.6,70.05720959483799,73.46321023304459,NaN,NaN,15.53967398233945,13.596384359770926
2009-05-04T09:30:00-04:00,82.74001,84.3,82.60001,84.2406,13866789,17180876.4,66.18465325525331,57.822855336663146,NaN,NaN,213.32227462621344,140.04428126138635,0.18783889317216085,1.4717814245393157,1.2839425313671549,117426143,102297061.2,70.83313554278074,73.72485352277604,NaN,NaN,18.023403778297467,14.228815705274718
2009-05-05T09:30:00-04:00,84.06,84.56,83.61,84.16,11987848,16888263.2,65.81420874250193,58.325127623881315,NaN,NaN,197.42334103133138,169.6471486838454,0.2546664944424646,1.6022756494202355,1.347609154977771,105438295,105263982,71.95382482921033,73.97570389049939,NaN,NaN,19.95964481473164,15.047505578054277
2009-05-06T09:30:00-04:00,85.05,85.27,84.19,85.202,18365744,16940234.4,68.2855906145352,58.84958297584954,NaN,NaN,196.98146276080323,179.0201124708562,0.3374148120658138,1.769377670060038,1.4319628579942243,123804039,108285430.8,73.08788795224069,74.2028336849088,NaN,NaN,22.36090212809037,16.09227651377372
2009-05-07T09:30:00-04:00,85.8,85.91,83.64999,84.17,19843856,17146479.95,63.39725164811667,59.016690313394044,NaN,NaN,153.72511500452998,176.98725832581698,0.2926772513522544,1.7978094221845424,1.505132170832288,103960183,110837602.8,74.04266733628651,74.40480244000119,NaN,NaN,23.073170772164385,17.089547122115242
2009-05-08T09:30:00-04:00,85.14,85.968,84.61,85.72,18473392,17105521.55,67.19564886571607,60.10839942407752,NaN,NaN,158.3016683376427,183.95077235210414,0.33448936608579816,1.9232438784395356,1.5887545123537374,122433575,114612447,75.43106948776163,74.63115762584178,NaN,NaN,24.83604689255732,18.19618994646411
2009-05-11T09:30:00-04:00,84.75999,84.99001,84.2,84.42999,13335539,17172255.9,61.477578465865804,60.59155183171855,NaN,NaN,107.01704832212404,162.68972709128627,0.24635210815380937,1.8966946475459991,1.6503425393921898,109098036,112946825.6,73.56139032588192,74.52257729104083,NaN,NaN,24.63707865320524,19.116316904569985
2009-05-12T09:30:00-04:00,84.77,85.28,83.77,84.72,16819328,17083724.7,62.25520311507827,61.301181293534206,NaN,NaN,95.78259320591339,142.36157752620267,0.18165710057225648,1.8774139151075104,1.695756814535254,125917364,117042639.4,75.18991263460181,74.47210261719253,NaN,NaN,24.698140758852283,19.9137203123246
2009-05-13T09:30:00-04:00,83.71001,83.86,82.8,83.13,17690288,17054979.1,55.62543015506988,61.37284176382702,NaN,NaN,43.61236018204658,111.68775701045134,0.01465478112785723,1.7140752909450754,1.6994205098172182,108227076,113927246.8,71.57835876130484,74.10509953812364,NaN,NaN,22.735612447992235,20.31684776027712
2009-05-14T09:30:00-04:00,83.12,83.97,82.94,83.39,15030496,16830132.7,56.44229258506646,61.299760760885,NaN,NaN,44.52806801574577,89.8483476126945,-0.08968796497452058,1.5873105535990675,1.676998518573588,123257572,117786724.6,73.28998559408012,73.79890975083424,NaN,NaN,21.364988196535617,20.46658210831405
2009-05-15T09:30:00-04:00,83.14999,83.95,82.28,82.78,23140016,17144979.1,53.933777177723066,61.16459646748831,NaN,NaN,26.64301199704326,63.516616344574615,-0.2046040357620691,1.4212434738710016,1.6258475096330707,100117556,113323520.8,68.1767140934692,73.06927444059706,NaN,NaN,19.482120237860656,20.32594469824928
2009-05-18T09:30:00-04:00,83.58,85.12,83.5,85.12,12745191,16950106.25,61.0797096012456,61.57601294113102,NaN,NaN,74.55612453240681,57.02443158663117,-0.13139472905570138,1.461604098313444,1.5929988273691453,112862747,114076463,68.57503094406154,72.58079550874682,NaN,NaN,19.931251947877712,20.26956001962477
2009-05-19T09:30:00-04:00,84.94,85.39,84.63,84.74001,17908832,16942893.45,59.466504069876954,61.54279576939571,NaN,NaN,81.14223608154143,54.09636016175678,-0.11739376540200652,1.4462566206166372,1.5636503860186437,94953915,107883773.2,61.731320919215484,71.51969699698498,NaN,NaN,19.811964121915786,20.204189177094914
2009-05-20T09:30:00-04:00,85.34,85.97,84.10001,84.19,18092096,16824109.45,57.11510251567101,61.37026680051292,NaN,NaN,70.435218615831,59.460931848513646,-0.1518201128323482,1.3738752449782083,1.5256953578105565,76861819,101610721.8,55.67045644572637,70.22706889010426,NaN,NaN,19.02171292494924,20.035263998216962
2009-05-21T09:30:00-04:00,83.28,83.33,82.3,83.10001,20038768,16850000.65,52.67025916615894,60.781657855562806,NaN,NaN,-17.542802773869035,47.04675769059069,-0.24890930799917443,1.2145587228115886,1.463468030810763,56823051,88323817.6,45.484111873402796,68.47184762428745,NaN,NaN,17.009130296821873,19.60295918373195
2009-05-22T09:30:00-04:00,83.42,83.74001,82.66,82.87,10162453,16475014.5,51.75495317143279,59.75096499243277,NaN,NaN,-16.331266005515246,38.45190209007899,-0.3247355569111652,1.0575485846718067,1.3822841415829719,46660598,77632426,39.25923791241944,66.21656922211879,NaN,NaN,15.092678224949923,18.958633332477376
2009-05-26T09:30:00-04:00,82.27,85.06,82.27,84.85001,13642191,16277773.65,58.44898585749111,59.224877643503426,NaN,NaN,29.8680589235962,29.51428896831687,-0.2414812143656948,1.0804326236258532,1.321913837991548,60302789,67120434.4,34.29015999829028,63.52630744848164,NaN,NaN,15.364774754108312,18.445224964138937
2009-05-27T09:30:00-04:00,84.97,85.07001,82.97,83.16,13723836,16140863.5,51.837680302997676,58.05002690696504,NaN,NaN,-1.4832046829427892,12.989200815420025,-0.296544287235329,0.9512334789473869,1.2477777661827159,46578953,57445442,30.467848791230153,60.48201893698088,NaN,NaN,13.491120540719843,17.73749576079335
2009-05-28T09:30:00-04:00,83.78999,84.45,82.53,84.02,17786544,16125535.5,54.64888261521722,57.42514340461508,NaN,NaN,-15.68578925866244,-4.235000759478666,-0.2720039738392368,0.9077727988836699,1.1797767727229067,64365497,54946177.6,29.55145598895264,57.304075269314176,NaN,NaN,12.816970998797888,17.034563651936857
2009-05-29T09:30:00-04:00,84.39,85.75999,83.75999,85.39,15278914,16014607.6,58.77681908531839,56.82379842030095,NaN,NaN,87.15822982919757,16.70520576113466,-0.1656892832606931,0.9726651686470404,1.1383544519077335,79644411,59510449.6,33.486021676649116,54.30800042566329,NaN,NaN,13.555601663666048,16.537569082183886
2009-06-01T09:30:00-04:00,86.28,87.67,86.05,87.35001,12959148,16044563.45,63.84688022201551,56.99303426002593,NaN,NaN,240.7265417975234,68.1167673217424,0.024337510167149246,1.1687763396166702,1.144438829449521,92603559,68699041.8,40.66994476984687,51.95861145737506,NaN,NaN,15.89933370058357,16.446392599098125
2009-06-02T09:30:00-04:00,87.14,87.97,86.92999,87.5,10553824,15878915.2,64.20964606676657,57.13263732800367,NaN,NaN,228.90059128891363,107.9232737948059,0.14130519140023146,1.3210703186998103,1.1797651272995788,103157383,77269960.6,46.47695570355515,49.907685962300306,NaN,NaN,17.854809496670583,16.647595013037048
2009-06-03T09:30:00-04:00,87.02,87.11,86.0799,86.95,9489535,15753999.55,61.762333857543425,57.57098759246606,NaN,NaN,149.17736494997172,138.05538772138877,0.16135540775963753,1.3814593869991256,1.220103979239488,93667848,86687739.6,52.032547672102716,48.51155659878587,NaN,NaN,18.725762964355233,16.944476148939646
2009-06-04T09:30:00-04:00,86.91,87.66,86.49001,87.50999,11765973,15424011,63.29625063273121,58.060556024442114,NaN,NaN,153.99823645129555,171.99219286338038,0.19007777631441725,1.4577011996325098,1.2676234233180925,105433821,94901404.4,56.293518346107646,47.29752322393069,NaN,NaN,19.903438963881502,17.367185122502768
2009-06-05T09:30:00-04:00,88.25,88.55,87.12,87.91,16835664,15273601.4,64.39499517096435,58.8077858811022,NaN,NaN,157.2271093941232,186.0059687763655,0.21208723227809356,1.5327324636657096,1.320645231387616,122269485,103426419.2,60.24116599023364,46.730698359413864,NaN,NaN,21.198030913344144,17.91444880690868
2009-06-08T09:30:00-04:00,87.22,88.39999,86.5,87.74001,23549648,15527414.2,63.52470087709971,58.98242811509177,NaN,NaN,122.57247376839855,162.37515517054055,0.19187593455060292,1.5604901495758696,1.3686142150252667,98719837,104649674.8,60.78845067027944,46.17451405414372,NaN,NaN,22.032056112592755,18.502678422006404
2009-06-09T09:30:00-04:00,87.97,88.23,87.44,87.74001,22430528,15982163.65,63.524700877099704,59.2722993156077,NaN,NaN,113.35191890565811,139.26542069388944,0.15667203659088025,1.564454260763867,1.4077822241729867,98719837,103762165.6,60.14161336304835,46.06096351441749,NaN,NaN,22.723841820219267,19.10570176460824
2009-06-10T09:30:00-04:00,88.55,88.58,86.58,87.64999,25156816,16399038.05,63.00176105862873,59.692774925818966,NaN,NaN,91.13269485705824,127.65648667530675,0.10781456040352011,1.542550424677387,1.4347358642738668,73563021,99741200.2,57.17330224467614,46.168309642913904,NaN,NaN,23.176869693256087,19.687297182986505
2009-06-11T09:30:00-04:00,87.86,89.02,87.8,87.86,21698720,16599459.65,63.751457216408994,60.48428907226539,NaN,NaN,101.59614738512924,117.17606886207348,0.07186195801514961,1.5245633117928037,1.452701353777654,95261741,97706784.2,55.676043628267756,46.8963047682614,NaN,NaN,23.75395099406935,20.26824772742691
2009-06-12T09:30:00-04:00,87.60001,88.33,87.37,88.31,12743832,16485126.45,65.37067576866878,61.456840686353665,NaN,NaN,83.68438962624657,102.46752490849815,0.061034388542180906,1.5289943394553802,1.4679599509131993,108005573,94854001.8,53.55796922253465,47.91764271898392,NaN,NaN,24.669660759500943,20.8970210177232
2009-06-15T09:30:00-04:00,87.23,87.28,86,86.49001,14007422,16028496.75,54.72359168314232,61.19074110247162,NaN,NaN,25.990765144703914,83.15118318375923,-0.07848226637562594,1.369857117943667,1.4483393843192929,93998151,93909664.6,52.84134766894691,49.242727552602254,NaN,NaN,22.56754886788049,21.135667853459957
2009-06-16T09:30:00-04:00,86.69,86.75999,85.22,85.25999,12836855,16033079.95,48.92399876741989,60.98262099278749,NaN,NaN,-10.29188112253022,58.42242317812155,-0.25351566925433766,1.1314447977513709,1.3849604670057085,81161296,90397956.4,50.15386202692907,50.64887135515217,NaN,NaN,18.943009937483218,20.82243100832042
2009-06-17T09:30:00-04:00,85.22,85.86,84.83099,85.23,13501230,15812699.85,48.78823402770132,60.564003236536344,NaN,NaN,-29.68141299768516,34.259601607172876,-0.36447381687101776,0.9293681959169362,1.293842012787954,67660066,89217365.4,49.247048060155485,52.05569936023808,NaN,NaN,15.9533763205896,20.126851767216017
2009-06-18T09:30:00-04:00,85.28,86.14999,84.98,85.62,13384563,15577323.2,50.70403012831955,59.987375453893584,NaN,NaN,-20.41852973644236,9.856666182858554,-0.4018207362048134,0.7915660925319372,1.1933868287367506,81044629,86373943,47.04099033899447,53.023911407548475,NaN,NaN,13.930552113138589,19.241666102347814
2009-06-19T09:30:00-04:00,85.96001,86.10001,84.92,85.31,13883254,15269547.5,49.13071967299444,58.9362211289635,NaN,NaN,-35.10123862133146,-13.900459466657054,-0.43482831044762094,0.6498514406772244,1.0846797511248454,67161375,78205103.4,41.31502911388138,53.0699888606938,NaN,NaN,11.781227886280034,18.17588921433813
2009-06-22T09:30:00-04:00,84.58,84.77,83.32001,83.32001,20654672,15794158.45,40.45314888298333,57.23932847297898,NaN,NaN,-117.93159071718436,-42.684930639034704,-0.5696077310310386,0.3726700873360471,0.9422778183670857,46506703,68706813.8,35.85067314825274,52.31096867817219,NaN,NaN,7.017965208442617,16.58190007063877
2009-06-23T09:30:00-04:00,83.42,83.71001,82.85001,83.17999,12151891,15719643.45,39.91889533281135,55.67908286406955,NaN,NaN,-138.58699431600016,-68.3439532777287,-0.641751398541462,0.1400885701902581,0.7818399687317201,34354812,59345517,31.4374710726358,50.83989177821028,NaN,NaN,2.99072485156935,14.64030361077171
2009-06-24T09:30:00-04:00,83.74001,84.28,82.58,83.03,15361938,15801548.55,39.319844344461266,53.96648241490742,NaN,NaN,-132.92672038416984,-88.99301475502564,-0.6700278800772734,-0.05569488136487166,0.6143329987124018,18992874,49612078.6,27.629108222736846,48.79243391225522,NaN,NaN,-0.5063169132898426,12.476500678762918
2009-06-25T09:30:00-04:00,82.69,84.89999,82.5704,84.72,13854043,15604923.5,48.667209901427675,52.84306918136908,NaN,NaN,-99.719403879703,-104.85318958367775,-0.5503759670867815,-0.07363696014607513,0.47673900694070637,32846917,39972536.2,24.46784116066769,46.23719642442909,NaN,NaN,-0.9512819224785504,10.558246021442708
2009-06-26T09:30:00-04:00,84.46001,84.69,84.0201,84.27,7780125,15229984.05,46.60839555059289,51.63476165804717,NaN,NaN,-83.6780023275226,-114.56854232491598,-0.4795931356620048,-0.12275241263679959,0.3568407230252052,25066792,31553619.6,22.09053544630153,43.47305962271637,NaN,NaN,-1.9338393831785639,8.773662392211097
2009-06-29T09:30:00-04:00,84.50999,85.35001,84.3,85.25,7529664,14958509.85,51.4275313036364,50.7706781170855,NaN,NaN,-48.96666681861545,-100.7755575452022,-0.3507987017704104,-0.0816576541878078,0.2691410475826026,32596456,28771570.2,21.352246658537524,40.702390572394165,NaN,NaN,-1.3079455790933219,7.3334326820247515
2009-06-30T09:30:00-04:00,85.33,85.64,83.96001,84.66,13423309,15101984.1,48.584358349466804,49.740863637859654,NaN,NaN,-53.25287860014987,-83.70873440203215,-0.291789527364536,-0.09559586162306744,0.19619366574146857,19173147,25735237.2,20.545198202140725,38.08609742649878,NaN,NaN,-1.634818736289466,6.052253907979863
2009-07-01T09:30:00-04:00,84.98,85.83009,84.92999,85.03,9146004,15084807.55,50.43497854121316,48.78968658963139,NaN,NaN,-26.744727448442926,-62.47233581488676,-0.21768375544879204,-0.07591102856952148,0.14177272687927056,28319151,27600492.6,22.483510362668625,35.7152021932417,NaN,NaN,-1.3590763309278786,4.993492445278758
2009-07-02T09:30:00-04:00,84,84.03999,82.95,82.99001,16520813,15322549.55,41.55425189844589,47.08851345604403,NaN,NaN,-107.93850191524751,-64.11615542199567,-0.29130426201373005,-0.222357600637892,0.06894666137583805,11798338,23390776.8,21.225017426897168,33.40570563641045,NaN,NaN,-3.9885316793850043,3.7103461417553634
2009-07-06T09:30:00-04:00,82.21001,83.31,82.08,83.25,12392621,15100397.4,42.93340323423562,46.24635713826499,NaN,NaN,-119.0910665166447,-71.1987682598201,-0.30621413762522,-0.3138210106556869,-0.0076068730304669485,24190959,23215610.2,21.17191309220783,31.143603166643377,NaN,NaN,-5.662026153745177,2.371435813826715
2009-07-07T09:30:00-04:00,83.16,83.19,81.53999,81.55,15246555,14685242.75,36.81593409585158,45.38149537601011,NaN,NaN,-139.88946311797534,-89.38332751969207,-0.40792778579766603,-0.5175166052775495,-0.10958881947988347,8944404,18485199.8,19.73586098694787,28.97088880664472,NaN,NaN,-9.201507813004953,0.7181581528507623
2009-07-08T09:30:00-04:00,81.92999,82.28,80.96001,81.92999,17903936,14458913.15,38.91123195061579,44.67599522764686,NaN,NaN,-140.95401800323472,-106.92355540030906,-0.4250465069285142,-0.6408969531405262,-0.215850446212012,26848340,20020238.4,21.594360953210042,26.995696870434333,NaN,NaN,-11.373652689237119,-1.0092433960189349
2009-07-09T09:30:00-04:00,82.24001,82.41,81.53,81.77,11454859,13773815.3,38.33481476301551,43.792479844410856,NaN,NaN,-119.735771738649,-125.52176425835026,-0.42173687015763683,-0.743021533909058,-0.3212846637514212,15393481,17435104.4,20.72406994240106,25.11591684210623,NaN,NaN,-13.288869156107166,-2.763475647460111
2009-07-10T09:30:00-04:00,81.41,81.94,81.02,81.44,16023430,13490050.8,37.11357614383044,42.93411244947056,NaN,NaN,-128.8227285683181,-129.6986095889644,-0.4156850484354259,-0.8408909742957036,-0.42520592586027767,-629949,14949447,19.893863373422974,23.58583357493063,NaN,NaN,-15.229499680964768,-4.544336223675062
2009-07-13T09:30:00-04:00,81.69,83.39,81.39,83.31,14389789,13572348.65,47.3494006220743,43.42670185940563,NaN,NaN,-63.90705906523847,-118.66180809868312,-0.26688543409680227,-0.7588127184812805,-0.49192728438447825,13759840,12863223.2,19.198699434576994,22.39640688109665,NaN,NaN,-13.759010649732986,-5.8607182845404795
2009-07-14T09:30:00-04:00,83.53999,83.71001,82.92999,83.66,10290371,13386496.1,49.021880359796064,44.076915075618835,NaN,NaN,-19.137680453233855,-94.51145156573482,-0.13280915360704382,-0.657938726393283,-0.5251295727862392,24050211,15884384.6,23.37449445630355,21.82047997993006,NaN,NaN,-12.046986600529443,-6.744470901110331
2009-07-15T09:30:00-04:00,84.59,86.36,84.53999,86.2,11619965,13325651.6,59.16067742758396,45.49411743869903,NaN,NaN,111.54212849415426,-44.01222226625703,0.12507370897709336,-0.36878743656487245,-0.4938611455419658,35670176,17648751.8,25.786635366621425,21.688874775921814,NaN,NaN,-6.840178705408044,-6.758143444581433
2009-07-16T09:30:00-04:00,86.11,87.5,86.02901,87.23,11805398,13240860,62.42428590490016,46.47676572466135,NaN,NaN,165.07351905579333,12.949635892631443,0.35038775225079555,-0.0558764552284714,-0.40626420747926695,47475574,24065170.4,33.93197241741919,22.364884151404063,NaN,NaN,-1.4337513111817908,-5.997515996952912
2009-07-17T09:30:00-04:00,87.22,87.53999,86.72,87.46001,9078227,13025543.2,63.13280857971658,47.657080941027324,NaN,NaN,165.667731994167,71.84772800512846,0.4916248586403406,0.20826686582115883,-0.2833579928191818,56553801,35501920.4,45.42895406342173,24.031914052626934,NaN,NaN,3.02455360123773,-4.708648911497106
2009-07-20T09:30:00-04:00,87.88,88.53999,87.53999,88.33,13151402,12988950.6,65.76247746628033,48.68100566693043,NaN,NaN,183.39586574740778,121.30831296765773,0.612481803323355,0.48224426133501197,-0.130237541988343,69705203,46690993,53.88407079318124,26.355615776530055,NaN,NaN,7.603107411782211,-2.949826579600061
2009-07-21T09:30:00-04:00,89.13,89.27,88.10001,89.17,14599281,12686181.05,68.12644358146056,50.07686889778712,NaN,NaN,174.40486695376148,160.01682244905678,0.7109194750711536,0.758411801850599,0.0474923267794454,84304484,58741847.6,60.9090081783545,29.238745060545323,NaN,NaN,12.190991913363577,-0.786852509176684
2009-07-22T09:30:00-04:00,88.75999,89.53,88.63,88.88,11857668,12671469.9,66.42134314826681,51.218752084005246,NaN,NaN,151.44053057191078,167.9965028646081,0.7164106260612151,0.9430056093559642,0.22659498329474917,72446816,66097175.6,64.466905465052,32.237558996429854,NaN,NaN,15.382541300942052,1.523060892268849
2009-07-23T09:30:00-04:00,88.89999,91,88.84,90.63,16524371,12729591.55,71.1189061995805,53.33051310551486,NaN,NaN,159.85006169699432,166.95181139284827,0.7919120327613398,1.216485024246424,0.42457299148508415,88971187,74396298.2,68.0053243773146,35.57900949288824,NaN,NaN,19.80901662993448,4.13534028336394
2009-07-24T09:30:00-04:00,90.39999,91.03,90.07249,90.97,10899582,12581868.5,71.94023835682952,55.402429899985854,NaN,NaN,147.3854298545956,163.29535096493402,0.8155487692242173,1.4440089530153557,0.6284601837911384,99870769,83059691.8,71.22646700934472,39.15433477268373,NaN,NaN,23.62574560162533,6.919683900258423
2009-07-27T09:30:00-04:00,90.86,91.27,90.37,91.14,10053723,12695548.4,72.36343665669037,57.94153722576005,NaN,NaN,130.53736695904053,152.72365120726056,0.7927308549221457,1.6193737524438205,0.8266428975216749,109924492,91103549.6,73.85812803958777,43.02021099072944,NaN,NaN,26.83524515919236,9.76476408010613
2009-07-28T09:30:00-04:00,90.61,91.28,90.08,90.99001,11700316,12904081,71.34109101344171,60.25795573024761,NaN,NaN,109.90855712660624,139.8243892418295,0.7197644100529412,1.7263484100878514,1.0065840000349102,98224176,93887488,74.71990596304502,46.81489277714622,NaN,NaN,29.182271549400745,12.538693718576788
2009-07-29T09:30:00-04:00,90.67999,90.95,90.16,90.67999,9066934,12686262.25,69.16597143420168,62.46018120676091,NaN,NaN,93.52726122291743,128.24173537203086,0.6073376299494802,1.7657560374717605,1.1584184075222803,89157242,97229573.2,75.75327249553523,50.74555010237009,NaN,NaN,30.56373445611077,15.113699538224498
2009-07-30T09:30:00-04:00,91.58,92.48,91.27,91.42,11665707,12812247.4,71.40694393270536,64.90970747739483,NaN,NaN,104.02519659629341,117.07676235189065,0.5416976900124466,1.8355405200378385,1.293842830025392,100822949,99599925.6,76.48737533123179,54.787943813642144,NaN,NaN,32.402698602885934,17.583556547461846
2009-07-31T09:30:00-04:00,91.47,92.21001,91.36,91.67,9151473,12443780.4,72.14352329388082,66.68071623966672,NaN,NaN,95.52530330518205,106.70473704200795,0.47631785713935404,1.8892401514495845,1.4129222943102304,109974422,101620656.2,77.12325962417839,58.92541239861367,NaN,NaN,34.15053469441828,19.950267711312765
2009-08-03T09:30:00-04:00,92.47,93,91.97,92.86,9844789,12316388.8,75.39297255290803,68.56436568203186,NaN,NaN,102.94797071188131,101.18685779257609,0.4734313524520566,2.004711484875301,1.5312801324232446,119819211,103599600,77.75766533452166,62.80992460420068,NaN,NaN,36.69038936392373,22.34171366168576
2009-08-04T09:30:00-04:00,92.59,93.24001,92.53999,93.19,12345898,12171355.95,76.22133924256677,69.78298438310206,NaN,NaN,102.63550864767309,99.73224809678948,0.45390353381936,2.0986595496974445,1.6447560158780845,132165109,110387786.6,79.82448490840747,66.66977100004254,NaN,NaN,39.05476783354474,24.729292829094184
2009-08-05T09:30:00-04:00,93.13,93.22,92.12,92.83,11396121,11845965.2,73.3215376669641,70.56135950896376,NaN,NaN,91.60519442576279,99.34783473735857,0.3799002165194134,2.119631286527351,1.7397310700079378,120768988,116710135.8,81.54459109404046,70.07067233408692,NaN,NaN,40.25472350000195,26.947211496366723
2009-08-06T09:30:00-04:00,93.24001,93.35001,92.19,92.63,10485418,11797493.15,71.68975990429729,71.1725703178624,NaN,NaN,87.1488613971422,95.97256769752832,0.28497704496964804,2.095952376219998,1.8109753312503498,110283570,118602260,82.03814838843171,72.68561478587334,NaN,NaN,40.822830080491975,28.92944272267033
2009-08-07T09:30:00-04:00,93.55,94.5,93.11,93.79201,11814727,11587058,75.15009901925737,71.84311471450361,NaN,NaN,108.35426531916993,98.53836010032589,0.26818851953263234,2.1462109806661402,1.878022461133508,122098297,121027035,82.67748750243933,74.7422874079632,NaN,NaN,42.332598654662426,30.844179284383486
2009-08-10T09:30:00-04:00,93.49001,93.81,93,93.5,13052449,11520191,72.74383195690457,72.17292816989246,NaN,NaN,96.75716826889929,97.30019961172948,0.20784994337545015,2.1378348903528206,1.9299849469773704,109045848,118872362.4,79.95406363758244,76.10264851219378,NaN,NaN,42.919542712211225,32.569231202644595
2009-08-11T09:30:00-04:00,93.19,93.23,92.3,92.58,9307082,11471026.55,65.61538774367759,72.11535992670751,NaN,NaN,72.07009235036737,91.18711635226835,0.08282750023295193,2.0335193222685604,1.9506918220356084,99738766,112387093.8,72.24074059593588,76.65792245011406,NaN,NaN,41.346774477105306,33.82316595613898
2009-08-12T09:30:00-04:00,92.55,94.42,92.53,93.76801,13592461,11569651.35,69.73917537184683,72.01680772472653,NaN,NaN,96.22424659329567,92.11092678577492,0.05815583833508531,2.023386619954465,1.9652307816193797,113331227,110899541.6,70.55929000178392,76.84034856614757,NaN,NaN,41.17624952352127,34.87360646576502
2009-08-13T09:30:00-04:00,94.14,94.25999,93.17,94.19,10214379,11490100.4,71.06656641219473,71.95440258582406,NaN,NaN,100.30144121683183,94.74144274971285,0.04865727553144783,2.0260523760336895,1.9773951005022417,123545606,113551948.8,71.81883456538343,76.88266053443604,NaN,NaN,41.429418889518985,35.81015109772987
2009-08-14T09:30:00-04:00,94.07001,94.12,92.5,93.41,10849734,11578675.75,65.35960823150954,71.45412912688256,NaN,NaN,74.08902680456598,87.88839504679206,-0.027652245859399516,1.9428297931779923,1.9704820390373918,112695872,111671463.8,69.547094648394,76.57472957792221,NaN,NaN,39.899420825800526,36.39433248745425
2009-08-17T09:30:00-04:00,91.87,91.98,91.39999,91.61099,12130855,11527648.4,54.490710842572234,70.25053054324904,NaN,NaN,-12.099137087686573,66.11713397547489,-0.20680512308758758,1.7119756351779074,1.918780758265495,100565017,109975297.6,67.47390368529508,76.05715798665436,NaN,NaN,34.813184596136466,36.168454217265996
2009-08-18T09:30:00-04:00,91.88,92.59,91.75,92.3,8539523,11224660.5,57.411782071289274,69.4109455887553,NaN,NaN,8.79295393458547,53.4617062923185,-0.2817757588478089,1.5665610597057338,1.8483368185535427,109104540,111848452.4,68.58756186121019,75.545321512774,NaN,NaN,31.58170968154641,35.51320499787748
2009-08-19T09:30:00-04:00,91.69,93.45,91.57001,93.13,14298641,11346709.15,60.68543629911692,68.64512361492754,NaN,NaN,31.939754733785136,40.60480792041639,-0.2778770230182386,1.5009905397807444,1.778867562798983,123403181,113862843.2,69.78564786749322,75.06662669393553,NaN,NaN,29.939901357141906,34.717018763486685
2009-08-20T09:30:00-04:00,93.14999,93.95,92.92999,93.78999,8273035,10934142.35,63.113471974097635,68.00011994922875,NaN,NaN,84.09309900716434,37.36313947848289,-0.23496517428580188,1.4851610949417307,1.7201262692275325,131676216,115488965.2,70.75532516045298,74.61177423224088,NaN,NaN,29.35820003614656,33.95147323100952
2009-08-21T09:30:00-04:00,93.98,95.21001,93.89999,95.03,11869930,10982659.75,67.21083526699596,67.4156815716636,NaN,NaN,160.2857615957878,54.60248643672726,-0.1322991176861914,1.5547523721197933,1.6870514898059847,143546146,121659020,74.14583517709471,74.35378636385323,NaN,NaN,30.20462621635902,33.41620937177374
2009-08-24T09:30:00-04:00,95.42999,95.91,94.89,95.13,9356145,10947780.85,67.52413277935459,66.79445253857702,NaN,NaN,182.22244518596662,93.46680289145789,-0.07001344403957166,1.5995346847565202,1.6695481287960918,152902291,132126474.8,78.66490946988982,74.27095954681624,NaN,NaN,30.96802792039628,33.0664691644341
2009-08-25T09:30:00-04:00,95.45,96.82001,95.28,95.48,14627035,11094116.8,68.65308139861924,66.46099137655237,NaN,NaN,191.654440654914,130.0391002355236,-0.020188539308978903,1.6443124546598682,1.664500993968847,167529326,143811432,82.36959939103609,74.32988871088737,NaN,NaN,31.933726942666514,32.904648847038736
2009-08-26T09:30:00-04:00,95.25999,95.85001,94.87,95.46001,11500066,11215773.4,68.50660242705976,66.23362298532113,NaN,NaN,144.18563896481226,152.48827708172902,-0.00435159063856938,1.6590615056706355,1.6634130963092049,156029260,150336647.8,84.03659808102489,74.47263511750116,NaN,NaN,32.67329790458099,32.87159871240191
2009-08-27T09:30:00-04:00,95.5,96.12,94.60201,95.82001,13100449,11287510.5,69.75801338690735,65.84847401158184,NaN,NaN,134.26254744079307,162.52216676845478,0.013612158840210054,1.6804282948594675,1.6668161360192575,169129709,157827346.4,85.70730176219243,74.68905042176925,NaN,NaN,33.64986965644094,32.982780275836056
2009-08-28T09:30:00-04:00,96.39,96.45,95.00999,95.58,10814855,11370679.6,67.82306506472469,65.49699066214042,NaN,NaN,125.82236120656329,155.6294866906099,-0.006355004899359473,1.6588723798950582,1.6652273847944177,158314854,160781088,86.31549010169468,75.14343802634869,NaN,NaN,33.949962101289024,33.120949108043625
2009-08-31T09:30:00-04:00,94.71001,95.09,94.41,95.05,9891141,11372997.2,63.62604168692113,65.35489451522925,NaN,NaN,64.40345557017828,132.0656887674522,-0.06754181847172536,1.580800111704761,1.6483419301764863,148423713,159885372.4,85.13244502294394,76.06427405684927,NaN,NaN,33.06096901865951,33.11238052384589
2009-09-01T09:30:00-04:00,94.60001,95.66,92.98,93.21001,17945984,11653001.5,51.67135714279114,64.0643360702967,NaN,NaN,4.568803553936959,94.6485613472568,-0.2348033560859797,1.3548377350690117,1.5896410911549914,130477729,152475053,75.86793817265013,76.44346321191112,NaN,NaN,28.435158270412984,32.44420591621262
2009-09-02T09:30:00-04:00,92.94,93.42,92.71001,92.83,10931219,11629756.4,49.5986528740777,62.53091367471692,NaN,NaN,-59.671872375157804,53.87705907926279,-0.36607467236761115,1.1320477506954774,1.4981224230630885,119546510,145178503,68.01880793153678,76.17203273806494,NaN,NaN,23.99125393124864,31.23664134693205
2009-09-03T09:30:00-04:00,93.24001,93.61,92.63,93.45,7262801,11468625.55,52.917079467751456,61.64216162016277,NaN,NaN,-46.24553010506694,17.77544357009079,-0.4032538956274334,0.9940550535287969,1.3973089491562303,126809311,136714423.4,60.2339378396352,75.50680725172504,NaN,NaN,21.2098825087816,29.80424722719627
2009-09-04T09:30:00-04:00,93.57001,94.5687,93.3,94.45,8119363,11283857.35,57.749002733956814,61.874896755261666,NaN,NaN,11.534784290929169,-5.082071813036032,-0.3543392120801774,0.9543849340560087,1.308724146136186,134928674,132037187.4,56.39296272645212,74.71531146895053,NaN,NaN,20.270262215049282,28.44224936831813
2009-09-08T09:30:00-04:00,95.2,95.22,94.62,95.06,11024387,11182454.25,60.41754381406843,62.08959402260303,NaN,NaN,61.896933419357225,-5.583376243200279,-0.27810800235073474,0.9610891431977677,1.2391971455485025,145953061,131543057,55.98677883941764,73.81525553882248,NaN,NaN,20.308438625918033,27.280276405118116
2009-09-09T09:30:00-04:00,95.09,95.91,94.87,95.53,13565211,11395360.7,62.388643686396016,62.21125169312297,NaN,NaN,82.66161393306379,10.035185832625087,-0.19705209774111876,0.9928820233721041,1.1899341211132228,159518272,137351165.6,59.66437787924916,73.09230768251935,NaN,NaN,20.940709976111762,26.37462405811721
2009-09-10T09:30:00-04:00,95.57001,96.46001,95.19,96.339,12253086,11328391.95,65.56709056486558,62.38651016389211,NaN,NaN,104.36526297689969,42.84261290303659,-0.09513794268417342,1.071011692758006,1.1661496354421794,171771358,147796135.2,65.28245131741718,72.7013881223025,NaN,NaN,22.470920446209124,25.816952113558912
2009-09-11T09:30:00-04:00,96.37,96.63,95.86,96.22,8119555,11223650.75,64.70094731509685,62.20723245304218,NaN,NaN,105.35941773953633,73.16360247195723,-0.04449870215852192,1.1105262577440271,1.155024959902549,163651803,155164633.6,68.6046145550685,72.30558664930062,NaN,NaN,23.45691064086724,25.479803331745817
2009-09-14T09:30:00-04:00,95.44,96.45,95.39999,96.32001,8420543,11102191.2,65.11799565161925,62.035365515346804,NaN,NaN,87.07066531959114,88.27077867768963,-0.014574049270573708,1.1368073983143319,1.1513814475849056,172072346,162593368,71.55943229149965,71.7980525651299,NaN,NaN,24.384213666562683,25.32329052243394
2009-09-15T09:30:00-04:00,96.5,97.31,95.96001,96.89999,11691258,11080211.35,67.51495716208575,61.95407092702298,NaN,NaN,121.11087125869507,100.11356624555721,0.03146218295067138,1.190709176273245,1.1592469933225735,183763604,170155476.6,74.21936833298454,71.2158932038405,NaN,NaN,25.876680727184333,25.40234626596971
2009-09-16T09:30:00-04:00,97.32001,98.14999,96.94,98.08,10580797,11182275.05,71.7659481977447,62.18688133921476,NaN,NaN,171.73052311271587,117.92734808148762,0.12340434974198233,1.3135024305000513,1.190098080758069,194344401,177120702.4,76.40800916413794,70.67099399549143,NaN,NaN,28.549766739281644,25.85197776215713
2009-09-17T09:30:00-04:00,97.97,98.72,97.64,98.06,15809215,11257803.75,71.59493955371296,62.31809035112945,NaN,NaN,183.78543709736132,133.81138290557993,0.162436608432603,1.3931438412988228,1.2307072328662199,178535186,178473468,76.81960764196492,70.03615870118946,NaN,NaN,30.65618135817811,26.538292561588698
2009-09-18T09:30:00-04:00,98.34,98.46001,97.92,98.11,9913707,11339837.35,71.77600799729873,62.60044341774187,NaN,NaN,164.0413861598353,145.54777658963974,0.1703568368417474,1.4436532789184042,1.2732964420766568,188448893,183432886,78.31341046280603,69.46458158412598,NaN,NaN,32.44118002050775,27.381562198577132
2009-09-21T09:30:00-04:00,97.56,98.035,97.23,97.74001,7714773,11132079.5,68.30615135582396,62.93473696552065,NaN,NaN,116.44151615157391,151.42194675603628,0.13117039763227423,1.4372594391169997,1.3060890414847255,180734120,185165240.8,78.8266878204251,69.01417035537465,NaN,NaN,33.043723778626614,28.190442424298485
2009-09-22T09:30:00-04:00,98.31,98.42,97.69,98.21001,8206555,11074600,70.27217154418139,64.26336656561996,NaN,NaN,123.08119430244635,151.81601136478653,0.11781986522410048,1.453363873014851,1.3355440077907506,188940675,186200655,79.14440837902625,69.24820394154436,NaN,NaN,34.111432321028495,29.036298123831344
2009-09-23T09:30:00-04:00,98.36,99.16,97.39999,97.58,13207824,11003639.45,64.49673285891375,65.32751513596538,NaN,NaN,104.57785016322005,138.3854767748874,0.05089403196240694,1.3991615477437591,1.3482675157813522,175732851,182478345,74.79895445245464,69.73250012160993,NaN,NaN,33.43037663047343,29.664023624780214
2009-09-24T09:30:00-04:00,97.75,98.02,96.62,96.99001,16702512,11263761.75,59.56001515255479,65.80201054202276,NaN,NaN,57.04148679115126,113.03668671364537,-0.04366541406658975,1.293685748198115,1.3373511622647047,159030339,178577375.6,70.43435737882169,70.4611015172661,NaN,NaN,31.40707222987164,29.913030568364704
2009-09-25T09:30:00-04:00,96.88,97.35001,96.38,96.74001,13350016,11276240.1,57.54988096758321,65.78778755871036,NaN,NaN,34.722284661304506,87.17286641393922,-0.12879122098056106,1.1763621360390033,1.3051533570195644,145680323,170023661.6,61.90456999386847,70.85478775065299,NaN,NaN,29.135320895360913,29.80192918650702
2009-09-28T09:30:00-04:00,97.00999,98.24001,96.9474,97.84,6397715,11055383.1,63.40255606617808,66.00100271957534,NaN,NaN,68.74825890894904,77.63421496541424,-0.11709502097340985,1.1587845808028021,1.275879601776212,152078038,164292445.2,56.92983090280637,70.92214861232361,NaN,NaN,28.78546653340619,29.656720236064047
2009-09-29T09:30:00-04:00,97.95,98.36,97.39,97.44,8176891,10969670.6,60.15466997458029,65.84143316873136,NaN,NaN,64.96406512027197,66.01078912897937,-0.14078477122469701,1.0998986377453406,1.2406834089700376,143901147,155284539.6,50.113315277617254,70.23992985506419,NaN,NaN,27.51947333757493,29.351399250565603
2009-09-30T09:30:00-04:00,97.62,97.78999,96.07001,97.09,15354934,10840118.1,57.384652461436445,65.25697330420071,NaN,NaN,24.783194113759855,50.05185791908733,-0.18190013354222456,1.0133082420422568,1.1952083755844813,128546213,145847212,44.14908823115339,68.73040392033106,NaN,NaN,25.639860382138814,28.821179412218918
2009-10-01T09:30:00-04:00,96.92,96.94,95.00999,95.12,15476934,11067403.85,44.862488374454045,63.83994052272622,NaN,NaN,-55.46733039360059,27.550094482136963,-0.3347522248657324,0.7767680945023159,1.1115203193680483,113069279,136655000,39.2491864309652,66.63358762575226,NaN,NaN,19.47752173077479,27.486371172012614
2009-10-02T09:30:00-04:00,94.22,95.27,94.2,94.86,15759164,11492222,43.51292369062931,62.296721096941226,NaN,NaN,-123.670790866128,-4.128520623349542,-0.43973480086464845,0.5618518182872378,1.0015866191518863,97310115,126980958.4,34.86375432291068,64.01246777085304,NaN,NaN,14.157439529614068,25.582238080241392
2009-10-05T09:30:00-04:00,95.07001,96.28,94.8,95.97,8749480,11523727.85,50.376244350068404,61.072527324654274,NaN,NaN,-77.29983421458638,-33.33813924805663,-0.4207778879448195,0.47561425922086187,0.8963921471656814,106059595,117777269.8,31.28259861627184,60.9455556482307,NaN,NaN,11.816288249208776,23.615673818665304
2009-10-06T09:30:00-04:00,96.58,97.77,96.56,97.28999,12444340,11594725.5,57.05812271045406,60.02196836127637,NaN,NaN,23.172337246636253,-41.69648482278377,-0.31077174803136554,0.5079274621264744,0.81869921015784,118503935,112697827.4,29.48267238845706,57.59374587853922,NaN,NaN,12.135419402634955,21.975637473518113
2009-10-07T09:30:00-04:00,97.13,97.48,96.83,97.28,10039875,11418458.7,56.99557238328617,58.979156420531595,NaN,NaN,17.159585699792466,-43.22120650557726,-0.23363232503355236,0.5266588038658995,0.7602911288994518,108464060,108681396.8,28.1056094174765,54.11417457679004,NaN,NaN,12.359018208159261,20.60183472132399
2009-10-08T09:30:00-04:00,97.94,98.45,97.53999,97.91,9702613,11290935.05,59.97544924207347,58.13625936658694,NaN,NaN,75.38313473375243,-17.051113480106643,-0.139761737490379,0.5855889570364781,0.7253506945268571,118166673,109700875.6,29.011956983539775,50.59264218541388,NaN,NaN,13.508237871260867,19.588463742743542
2009-10-09T09:30:00-04:00,97.87,98.71989,97.69,98.69,6499359,11209925.25,63.36055876400854,57.78300275288583,NaN,NaN,102.05125887640735,28.09329646840042,-0.030434036616205917,0.6873081487565997,0.7177421853728057,124666032,115172059,33.83287543556399,47.3787984436381,NaN,NaN,15.58353124708119,19.016330529077493
2009-10-12T09:30:00-04:00,99,99.39,98.56,98.94,5440309,11060913.55,64.3998288656947,57.363549704422496,NaN,NaN,138.79801531676156,71.31286637467001,0.04909674820677934,0.7791131206312798,0.7300163724245005,130106341,119981408.2,37.829718856670716,44.42774919204127,NaN,NaN,17.579525696113514,18.811072695796923
2009-10-13T09:30:00-04:00,98.64,99.02,98.22,98.83,6031730,10777937.15,63.545739354499766,57.29562159696435,NaN,NaN,104.71994325588341,87.62238757651944,0.08269600775746588,0.8333863821213328,0.7506903743638669,124074611,121095543.4,38.7527110128494,41.853017517783755,NaN,NaN,18.9436304067955,18.830009511653863
2009-10-14T09:30:00-04:00,99.77,100.36,99.42999,100.23,9167145,10707254.55,69.1530098154193,57.98083550145468,NaN,NaN,184.33756292011242,121.05798302058342,0.1819211398385191,0.9780917991620157,0.7961706593234966,133241756,126051082.6,42.819055845347116,39.88049597967842,NaN,NaN,22.015064506960023,19.285017368126173
2009-10-15T09:30:00-04:00,99.87,100.67,99.84,100.64999,7669539,10300270.75,70.61333350929974,58.913939254434425,NaN,NaN,185.64683805643298,143.11072368511955,0.2541211682572315,1.113822119645036,0.8597009513878044,140911295,130600007,46.34084727453482,38.76880149972602,NaN,NaN,24.998173081805025,20.101182470080296
2009-10-16T09:30:00-04:00,99.74001,100.21001,99.37,99.99001,13187910,10463980.9,65.37576598365902,59.05488281996878,NaN,NaN,132.08123863622257,149.11671963708258,0.23609718453000406,1.1548224320503095,0.9187252475203055,127723385,131211477.6,46.81503762420421,38.046316265540156,NaN,NaN,25.908499879845703,20.930799242903927
2009-10-19T09:30:00-04:00,100.11,101.17,99.92999,100.86,9772383,10566861.4,68.67423752097434,59.66342335899692,NaN,NaN,152.48098460186216,151.8533134941027,0.2595683827994957,1.243185726019675,0.9836173432201794,137495768,132689363,48.01087270382035,37.89614179598323,NaN,NaN,27.743198900776665,21.903999194028604
2009-10-20T09:30:00-04:00,100.97,105.89999,99.89999,100.39,9388195,10625943.4,65.06789002922821,60.21222604241062,NaN,NaN,186.1768576811344,168.1446963791529,0.22171091806295262,1.2607559907988701,1.0390450727359175,128107573,133495955.4,48.688968771850746,38.22041897746161,NaN,NaN,28.142800567354964,22.795256533075225
2009-10-21T09:30:00-04:00,100.22,101.2,99.41,99.425,12893512,10610227.8,58.298559954479956,61.171945440983905,NaN,NaN,79.45857688509953,147.16889917215033,0.1153033187263297,1.1831742211438296,1.0678709024175,115214061,129890416.4,45.812476426733646,38.68922540573079,NaN,NaN,26.326467577530238,23.299715253711657
2009-10-22T09:30:00-04:00,99.62,101.09,99.2,100.74001,13423148,10446259.6,63.82200333816862,62.62259398723671,NaN,NaN,83.92640515102677,126.82481259106908,0.11674999734070468,1.2138083990933808,1.097058401752676,128637209,127435599.2,43.910375989000926,39.33541266759437,NaN,NaN,26.563958168495077,23.76603567010929
2009-10-23T09:30:00-04:00,100.98,101.07001,99.37,99.83,13215871,10439552.35,58.088130629132145,63.173443007169844,NaN,NaN,65.9747623899026,113.60351734180509,0.04346013539906157,1.151383571001503,1.1079234356024414,115421338,124975189.8,42.026942134993185,40.10286577607447,NaN,NaN,24.829491323800266,23.917957906350857
2009-10-26T09:30:00-04:00,99.89999,100.77,98.52,98.81,16118203,10925576.75,52.40498356410479,62.84107592528775,NaN,NaN,32.25296443243264,89.55791330791916,-0.07994952588992188,1.007986528240039,1.087936054129961,99303135,117336663.2,36.75589266327115,40.62238150998975,NaN,NaN,21.43045010251722,23.56259964866034
2009-10-27T09:30:00-04:00,98.95,99.53,98.39999,98.82001,14505984,11242031.4,52.454145925658636,62.5166883211715,NaN,NaN,11.059070208303162,54.53435581335292,-0.1623889150079143,0.884949910370068,1.0473388253779823,113809119,114476972.4,34.98673366573588,41.11389038486543,NaN,NaN,18.81809627088681,22.884813451835548
2009-10-28T09:30:00-04:00,98.62,99.07001,97.62,97.67999,17191488,11333859.1,46.55606656181543,61.55816098686735,NaN,NaN,-26.85318474182344,33.27200348796833,-0.2878494329880408,0.6875270341429314,0.9753764671309721,96617631,110757686.4,32.77702697835289,41.382823955923506,NaN,NaN,14.607800809225166,21.70238307431978
2009-10-29T09:30:00-04:00,98.34,99.74001,98.05,99.53999,12932555,11206640.15,55.37293354258311,60.98761632819411,NaN,NaN,11.25001274253118,18.73672500626921,-0.24158757852498047,0.6733919939747466,0.9149795724997271,109550186,106940281.8,30.638144182815196,41.15462886644145,NaN,NaN,13.883876886858365,20.58545361896815
2009-10-30T09:30:00-04:00,99.35001,99.64,96.87,97.06,29758720,11906617.95,44.76805360838464,59.585346666957676,NaN,NaN,-69.012906481242,-8.26080876795969,-0.36653598651718844,0.45680958935324156,0.82334557587043,79791466,99814307.4,27.085042049131076,40.387151951617184,NaN,NaN,9.144690078627802,18.951058827490957
2009-11-02T09:30:00-05:00,97.39999,99,96.82001,97.85001,20621712,12500229.55,48.17315713080546,58.48730507955094,NaN,NaN,-80.98403235442868,-30.90820812533196,-0.3827264977683482,0.34493745365999473,0.727663951428343,100413178,100036316,27.367650764424596,39.57393336244398,NaN,NaN,6.730639256651906,17.205284603085378
2009-11-03T09:30:00-05:00,97.25999,97.925,97.07001,97.8,13948246,12575424.85,47.97153761843768,56.97434277976654,NaN,NaN,-102.67820096395123,-53.65566235978283,-0.3826367358335482,0.24936803163640775,0.6320047674699559,86464932,94567478.6,24.81605666283818,38.28800484940763,NaN,NaN,4.84828441874418,15.439998862465206
2009-11-04T09:30:00-05:00,98.38,99.38,97.94,98.17,14714297,12809145.95,49.650541901284484,55.47700052205116,NaN,NaN,-51.26768484033389,-58.53856237948493,-0.34467135603556875,0.20116557242549504,0.5458369284610638,101179229,95479798.2,26.054630020994026,36.838989331297576,NaN,NaN,3.890506884056694,13.790071436978277
2009-11-05T09:30:00-05:00,98.86,100.23,98.81,100.1601,9819160,12814973.3,57.57993581405867,54.920155509936855,NaN,NaN,29.34764584204703,-54.91903575958175,-0.18077990778619424,0.31986204372832105,0.5006419515145153,110998389,95769438.8,26.468787470851197,35.385685748915215,NaN,NaN,5.768013984493893,12.644063229480508
2009-11-06T09:30:00-05:00,99.64999,100.60001,99.42999,100.37,10788535,13029432.1,58.32542035608703,54.180954283873476,NaN,NaN,52.469382941065504,-30.62257787512025,-0.05974807111016833,0.4259568626268049,0.4857049337369732,121786924,104168530.4,37.415395476688815,34.62886594697725,NaN,NaN,7.472162961960185,11.905220334120463
2009-11-09T09:30:00-05:00,101.07001,102.44,100.91,102.42,10961813,13305507.3,64.82679723931791,54.163733370308464,NaN,NaN,157.1659780205784,17.007424199881164,0.1456425636168739,0.6677581382580655,0.5221155746411916,132748737,110635642.2,44.292198614652044,34.314810935748774,NaN,NaN,11.277307597802572,11.81551851464648
2009-11-10T09:30:00-05:00,102.27,102.8,102.14999,102.69,9967113,13502276.45,65.58823712599425,54.68442459684519,NaN,NaN,173.8120839754088,72.30548118775317,0.27921335173808703,0.8711322643138004,0.5919189125757134,142715850,121885825.8,53.80208593227772,34.88549732900192,NaN,NaN,14.494332936679081,12.198206289222565
2009-11-11T09:30:00-05:00,103.11,103.62,102.64,103.13,10532363,13570537.35,66.84777151582576,54.90055089524928,NaN,NaN,176.35648964613964,117.83031608504788,0.37097946910117297,1.0556432489521796,0.6846637798510067,153248213,132299622.6,60.520478875977425,36.07193324950024,NaN,NaN,17.48971756291096,12.95413647117805
2009-11-12T09:30:00-05:00,102.96001,103.41,101.89999,102.17,11969777,13785549.25,61.55402878369565,55.148115049146675,NaN,NaN,124.83774167190519,136.92833525101952,0.34154243061939327,1.1115918181252482,0.7700493875058549,141278436,138355632,63.81598354615679,37.628293350297646,NaN,NaN,18.381342473443645,13.72945161435885
2009-11-13T09:30:00-05:00,102.35001,103.25,102.10001,102.91,11678047,13710056.1,63.925518087787665,55.97101037226688,NaN,NaN,118.23323637301176,150.08110593740875,0.34539232455270663,1.2017897931967383,0.8563974686440317,152956483,144589543.8,66.88069806587347,39.78006516476923,NaN,NaN,19.86167494210065,14.605483518321963
2009-11-16T09:30:00-05:00,103.39999,104.575,103.35001,104.25999,10504824,13746678.15,67.82472367595463,57.06890878300231,NaN,NaN,149.25808536701447,148.49952740669596,0.40804492282592386,1.3664536221764365,0.9584086993505126,163461307,150732057.8,69.6118606140541,42.253288518220536,NaN,NaN,22.40609769677739,15.719856972387024
2009-11-17T09:30:00-05:00,104.09,104.64,103.86,104.59,8403906,13697463.7,68.7149374131561,58.65168527238378,NaN,NaN,143.91040764424267,142.51919214046274,0.4382468065928389,1.5062172075915612,1.0679704009987223,171865213,156561930.4,71.9740981357201,45.053079315175346,NaN,NaN,24.73183903093514,17.00728298075104
2009-11-18T09:30:00-05:00,104.5,104.62,103.91,104.55,7774832,13441529.7,68.46766532287378,59.58702325669026,NaN,NaN,121.26935430965871,131.50176507316655,0.4219139516190997,1.595362840522597,1.1734488889034973,164090381,158730364,72.82041694136723,48.06609879792906,NaN,NaN,26.528213536097773,18.367415917229145
2009-11-19T09:30:00-05:00,104.03999,104.07001,102.87,103.64999,12739492,13407346.9,62.976384014119276,60.88761828567131,NaN,NaN,82.95846482154614,123.12590970309475,0.32142476287692423,1.5752298424996525,1.2538050796227282,151350889,160744854.6,73.61748318785986,51.389844593552546,NaN,NaN,26.490325917685087,19.527831631579993
2009-11-20T09:30:00-05:00,102.92,103.45,102.72,103.25,8684609,13180783.8,60.648327677001596,61.77870189611389,NaN,NaN,63.99961270881124,112.27918497025465,0.2046333400421485,1.5095967546754139,1.3049634146332654,142666280,158686814,71.31649189068767,54.52904753114277,NaN,NaN,25.79129975187599,20.422612791622278
2009-11-23T09:30:00-05:00,104.2,104.98,104.13,104.46001,9492008,12849474.05,64.8781111699497,62.98631429265047,NaN,NaN,94.31653335673478,101.29087456819869,0.1860264300499792,1.5374964521957395,1.3514700221457603,152158288,156426210.2,68.77369559041239,57.668878883112356,NaN,NaN,26.420712579332456,21.27948418986659
2009-11-24T09:30:00-05:00,104.44,104.56,103.59,104.36,10220676,12635208.65,64.26327844714204,64.03008118878316,NaN,NaN,77.37210429997793,87.98321389934576,0.14590866770792088,1.5338558567806615,1.3879471890727406,141937612,150440690,62.42688689543613,60.26689723128679,NaN,NaN,26.757758240332596,22.06209476850459
2009-11-25T09:30:00-05:00,104.53999,104.84,104.2,104.63,6490059,12100137.2,65.2215186986051,64.57590853767933,NaN,NaN,83.31118896446227,80.39158083030648,0.11769197766201911,1.5350621611502646,1.4173701834882455,148427671,147308148,59.34040835485811,62.614870151572994,NaN,NaN,27.30401798510463,22.810940942304594
2009-11-27T09:30:00-05:00,102.46001,103.84,102.23,103.17999,12916098,12099314.35,56.465009233103395,64.44302202889477,NaN,NaN,34.691423961604265,70.73817265831809,-0.011621449079416646,1.4028433721389746,1.4144648212183912,135511573,144140284.8,56.30847567492227,63.96437588001824,NaN,NaN,25.202779948237513,23.15263222886644
2009-11-30T09:30:00-05:00,103.11,103.74001,102.71001,103.58,11962988,11209527.75,58.13485828544155,63.96502638933217,NaN,NaN,39.01336683560774,65.74092348367739,-0.07943108625306894,1.315175963402055,1.394607049655124,147474561,145101941,57.02628650739975,64.87395358664308,NaN,NaN,23.930292019846856,23.263726484720785
2009-12-01T09:30:00-05:00,104.28,105.13,104.27,104.73,10101234,10683503.85,62.578798068032704,63.75006645662064,NaN,NaN,89.34043516295014,64.74570384492047,-0.05709299722185701,1.3232408031278027,1.3803338003496597,157575795,146185442.4,57.86620608089524,65.1642478829729,NaN,NaN,24.13170543373281,23.38772347743679
2009-12-02T09:30:00-05:00,104.74001,105.25,104.32001,104.58,7130422,10342612.65,61.659422090605496,63.379470069104904,NaN,NaN,89.74035904389476,67.21935479370383,-0.062255895869645084,1.3025139305126032,1.3647698263822483,150445373,147886994.6,59.214369328991324,65.07095434390246,NaN,NaN,24.030420065001785,23.47953727566036
2009-12-03T09:30:00-05:00,104.85001,105.17999,103.59,103.69,9727871,10093291.35,56.36789323809367,63.00903181584762,NaN,NaN,55.980581198400486,61.75323324049147,-0.13146841057885394,1.2004343131586808,1.3319027237375347,140717502,146344960.8,57.421215298763755,64.61418518337439,NaN,NaN,22.378215303381733,23.32220556533484
2009-12-04T09:30:00-05:00,104.96001,105.27,103.2,103.989,16604156,10432541.15,57.681829996458134,62.56305409503837,NaN,NaN,49.587913714083975,64.7325311909874,-0.16101890401856123,1.130629093714333,1.2916479977328943,157321658,150706977.8,61.01738063047019,64.1953767951313,NaN,NaN,21.37873268521739,23.04456658246092
2009-12-07T09:30:00-05:00,103.83,104.53,103.69,104.05,8192875,10302758.15,57.959977107269495,61.85842934013228,NaN,NaN,36.68807934377017,64.26747369261989,-0.1789825345471623,1.0679198295489414,1.2469023640961037,165514533,154314972.2,63.744963297385745,63.776312701083555,NaN,NaN,20.631768264977794,22.699881108534758
2009-12-08T09:30:00-05:00,103.42,103.44,101.75,102.94,10727629,10291048.95,51.34641241388624,60.61782041161301,NaN,NaN,-99.4352210748631,26.512342445057243,-0.2630646076119225,0.9180716045812005,1.181136212193123,154786904,153757194,63.010951053692814,63.13608790951018,NaN,NaN,18.03044210331493,22.032818393503355
2009-12-09T09:30:00-05:00,102.96001,103.56,102.48,103.45,8584969,10221941.75,53.946579028905816,59.58059996204388,NaN,NaN,-61.26359175062347,-3.688447713846405,-0.28019652548430196,0.8308905553377457,1.1110870808220477,163371873,156342494,65.02140392226829,62.57901555100312,NaN,NaN,16.552967461459524,21.249982546068523
2009-12-10T09:30:00-05:00,103.99001,104.62,103.95,104.17999,8043371,10097492.15,57.45167709299916,59.18597803910672,NaN,NaN,45.804906553613584,-5.723582642803788,-0.2397894272553589,0.811350296752849,1.0511397240082079,171415244,162482042.4,69.2902213596233,62.26992542041479,NaN,NaN,16.284023549268056,20.540559832239886
2009-12-11T09:30:00-05:00,104.50999,105.03999,104.2514,104.92,9239020,9960954.3,60.715765635854254,59.19079503616763,NaN,NaN,93.3470773016277,3.028250074704954,-0.164250213708248,0.845826956872898,1.010077170581146,180654264,167148563.6,72.07937152206875,62.324416822656296,NaN,NaN,17.016617090247223,20.037139440526648
2009-12-14T09:30:00-05:00,105.32001,105.38,104.92,105.2,9754676,9864785.75,61.906554770898296,58.97854100766396,NaN,NaN,139.92787687525535,23.676209581001995,-0.0996331653699638,0.8855357138686912,0.985168879238655,190408940,172127445,74.71773381458087,62.74899098152547,NaN,NaN,17.96876318444121,19.74165711822873
2009-12-15T09:30:00-05:00,104.91,105.14999,104.47,104.74001,7191660,9699127.55,58.75560889152793,58.58513603940581,NaN,NaN,84.36449255618874,60.43615230721237,-0.0922465999464166,0.8698606293056343,0.9621072292520509,183217280,177813520.2,77.35007137449355,63.81493273002957,NaN,NaN,17.888611052653967,19.47693625171805
2009-12-16T09:30:00-05:00,105.09,105.31,104.47009,104.67,6287738,9593319.15,58.269490669175866,58.08856260873229,NaN,NaN,82.94496748524038,89.27786415438513,-0.09602034724387865,0.8420817951972026,0.9381021424410813,176929542,180525054,78.49969909167899,65.18345349694535,NaN,NaN,17.690189520355577,19.22168671866627
2009-12-17T09:30:00-05:00,104.03999,104.14999,103.28999,103.38,8230672,9616111.15,50.052177122370935,57.630503172251395,NaN,NaN,-52.25408322509464,69.66606619864349,-0.18422939816116424,0.707815394739626,0.8920447929007902,168698870,179981779.2,77.64931091041618,66.7077988709092,NaN,NaN,15.069339963880957,18.628494325125512
2009-12-18T09:30:00-05:00,103.45,103.64,102.42999,103.14,8306383,9394455.7,48.67681516725518,56.95492866380952,NaN,NaN,-104.84175554112798,30.028299630092373,-0.25330835432332566,0.5754093499966331,0.8287177043199587,160392487,175929423.8,71.43315754380936,67.7368610877956,NaN,NaN,12.499688559281932,17.752950644290713
2009-12-21T09:30:00-05:00,103.56,104.39,103.52,103.88,5968391,9258644.8,52.96813963867858,56.2684530617128,NaN,NaN,-18.340028675694803,-1.6252814800976565,-0.24365705315508612,0.524146387876101,0.7678034410311871,166360878,171119811.4,64.80240979876854,68.23230421050083,NaN,NaN,11.49320158088253,16.858700778089545
2009-12-22T09:30:00-05:00,104.22,104.61,104.05,104.45,6850340,9126561.4,56.01866067681228,55.865541532156136,NaN,NaN,34.33056355270341,-11.63206728079472,-0.19545874824408127,0.5234800057260856,0.7189387539701668,173211218,169118599,62.214654867074906,68.44661032036394,NaN,NaN,11.525372803201591,16.096796781676982
2009-12-23T09:30:00-05:00,104.64999,104.71899,104.17,104.45,4868480,8858951.6,56.01866067681228,55.840596349207466,NaN,NaN,40.98637210803024,-20.02378635623675,-0.1615571413055953,0.5169923273381727,0.678549468643768,173211218,168374934.2,61.23604886908081,68.71909843252945,NaN,NaN,11.55152983055738,15.447472931517039
2009-12-24T09:30:00-05:00,104.57001,105.03999,104.55,105,3567933,8712845.3,58.99495809328001,55.93439121326617,NaN,NaN,85.7484479847011,7.576719885722393,-0.1029256694342865,0.5498923818509098,0.6528180512851963,176779151,169990990.4,62.61233103859964,68.83302346168155,NaN,NaN,12.41465407558153,15.014213094954822
2009-12-28T09:30:00-05:00,105.2,105.35001,104.89,105.28999,8116895,8472885.15,60.51227065767986,56.11669789543834,NaN,NaN,112.7649287072028,51.098056735388546,-0.04822619830845398,0.5925353033996288,0.6407615017080828,184896046,174891702.2,66.49697206455754,69.02959551647953,NaN,NaN,13.570261832831058,14.807934343222856
2009-12-29T09:30:00-05:00,105.49001,105.64,105.25,105.28999,3357943,8042632.9,60.512270657679856,56.77140205570931,NaN,NaN,125.77419242131721,79.92090095479095,-0.017255232806768328,0.6191924606996224,0.6364476935063907,184896046,178598735.8,69.1113783297421,69.46534032191163,NaN,NaN,14.527516412987001,14.767874638903448
2009-12-30T09:30:00-05:00,104.92999,105.33,104.88,105.22,3244085,7699775.45,59.891932552531195,57.1960701645397,NaN,NaN,90.9685804242214,91.24850432909456,-0.007207654246093598,0.6274381256987738,0.6346457799448674,181651961,180286884.4,70.24991257069999,69.83880522537105,NaN,NaN,15.180498548097908,14.826820911645514
2009-12-31T09:30:00-05:00,105.34,105.39,104.03,104.07001,5196254,7603067.05,50.69589819497624,56.713514528966634,NaN,NaN,19.568529642895005,86.96493583606751,-0.07970780915876974,0.5350110184964052,0.6147188276551749,176455707,180935782.2,70.6970177503971,69.93929068185489,NaN,NaN,13.207892475624906,14.595545420785427
2010-01-04T09:30:00-05:00,104.84,105.87,104.75999,105.66,8981391,7565743.05,59.870393313936226,56.65313079168676,NaN,NaN,112.42842833418037,92.30093190596337,-0.025105913548401637,0.5833364357196729,0.6084423492680745,185437098,182667371.6,71.91019291632095,69.92720649573003,NaN,NaN,14.235219107112448,14.544070233117859
2010-01-05T09:30:00-05:00,105.61,105.67,104.97,105.49001,6551727,7063121.6,58.6145987940913,56.4179910790577,NaN,NaN,96.04201388638805,88.95634894180041,-0.005961827149792764,0.6009900653308335,0.6069518924806263,178885371,181465236.6,69.75117510714395,69.57245230234169,NaN,NaN,14.677244323201135,14.563095103129756
2010-01-06T09:30:00-05:00,105.5,105.85001,105.36,105.56,6799152,6993435.45,58.99595470295932,56.43515863701709,NaN,NaN,105.97107487257452,84.99572543205188,0.005282977896681418,0.613555614851478,0.6082726369547966,185684523,181622932,69.87893266296179,69.03879953723228,NaN,NaN,15.145797304858794,14.646338274805332
2010-01-07T09:30:00-05:00,105.38,106.02,104.94991,105.94,6313469,6772727.45,61.09224657983237,56.63678405920684,NaN,NaN,106.292006648304,88.0604106768684,0.03075926814930008,0.6467217221414217,0.6159624539921216,191997992,183692138.2,71.57538663936802,68.54420579063863,NaN,NaN,16.149486685909785,14.861073762105969
2010-01-08T09:30:00-05:00,105.67,106.11,105.44,106.11,4912227,6589090.35,62.02753140187881,57.492166507743114,NaN,NaN,128.68652369057622,109.88400948640465,0.050348252391055004,0.6788977694809404,0.6285495170898854,196910219,187783040.6,74.61894369898762,68.3277509898223,NaN,NaN,17.249468293250263,15.202272980840869
2010-01-11T09:30:00-05:00,106.39999,106.66,105.82001,106.53999,6858293,6529836.45,64.36112808134072,58.61247457303494,NaN,NaN,158.31883242666783,119.06209030490213,0.0816975009224008,0.7306713932428863,0.6489738923204855,203768512,191449323.4,76.99620984548811,68.72511186851364,NaN,NaN,18.864151906377412,15.725398541631803
2010-01-12T09:30:00-05:00,105.85001,106.42,105.58,106.14,8875465,6511658.7,60.628544264718705,59.15964633203781,NaN,NaN,110.87942394022124,122.02957231566877,0.06562088612040373,0.7309999999709902,0.6653791138505865,194893047,194650858.6,78.85839583072209,69.72911087079603,NaN,NaN,19.216778640931803,16.224167127246087
2010-01-13T09:30:00-05:00,106.33,106.99001,106.035,106.75,8620254,6454937.6,64.05244138205904,59.733487810984,NaN,NaN,145.53079960194404,129.94151726154269,0.08496706069197801,0.771587939715559,0.6866208790235809,203513301,198216614.2,80.72948683839766,71.05159886874766,NaN,NaN,20.520425134636607,16.83791827115902
2010-01-14T09:30:00-05:00,106.64,107.14999,106.58,107.03,7040617,6447385.45,65.53407901780281,60.41316054962619,NaN,NaN,153.35358532488135,139.35383299685813,0.10424790877215007,0.8169307649887685,0.7126828562166184,210553918,201927799.4,82.46856892206387,72.56820744396074,NaN,NaN,22.045969423606543,17.58192557865152
2010-01-15T09:30:00-05:00,106.94,106.98,105.5376,106.00999,14028758,6834436.45,56.412337207341,60.22868762920198,NaN,NaN,80.10197532568375,129.63692332387967,0.03927587434576352,0.7617776991488228,0.7225018248030592,196525160,201850787.6,82.30258363267153,73.97465405782302,NaN,NaN,20.662579350788597,18.022018974671102
2010-01-19T09:30:00-05:00,105.89999,107.23,105.86,107.17,10881109,6966958.3,62.760604251968836,60.3892828859369,NaN,NaN,120.88182061021237,122.14952096058855,0.06393597263311346,0.8024217905944511,0.7384858179613376,207406269,202578339,82.65770660000764,75.12899223892659,NaN,NaN,21.486189368677724,18.51690045952919
2010-01-20T09:30:00-05:00,106.5,106.53999,105.13,106.02,11904461,7146862.2,54.31497555869149,59.94661895029487,NaN,NaN,37.692539042712724,107.51214398108687,-0.004082132468617106,0.7333831523755663,0.7374652848441834,195501808,202700091.2,82.72019588096099,76.10105063544223,NaN,NaN,19.28477203359081,18.62659639868085
2010-01-21T09:30:00-05:00,105.97,106.11,103.71001,103.71001,22253760,7961130.65,42.068768253760524,58.67353578609697,NaN,NaN,-110.01200733634602,56.40358259342886,-0.20064206636166604,0.4866627018921008,0.6873047682537669,173248048,196647040.6,69.34251692130775,76.03623666048564,NaN,NaN,12.364593773528457,17.73202459508765
2010-01-22T09:30:00-05:00,103.38,103.86,101.5499,101.63,24615712,8849399.25,34.521187738758314,57.51819932493854,NaN,NaN,-282.4509366839773,-30.757321808342887,-0.45233144155775973,0.12189046630656719,0.5742219078643269,148632336,184262724.2,51.12513073641484,74.63824473091549,NaN,NaN,3.293228702244227,15.66933946753859
2010-01-25T09:30:00-05:00,102.39,102.52,101.67,101.91,18238752,9517912.85,36.181060630504014,55.82610413326481,NaN,NaN,-251.41450230831168,-97.06061733514198,-0.5737396299442021,-0.1429526295659258,0.43078700037827633,166871088,178331909.8,45.02465337898336,72.71784904967708,NaN,NaN,-2.6652289597157384,13.050115406502258
2010-01-26T09:30:00-05:00,101.66,103.06,101.48,101.88,18358624,10257447.4,36.07554062767638,54.21617140709232,NaN,NaN,-193.6816930285293,-159.9733200628903,-0.6256014836628785,-0.3512148542003217,0.2743866294625567,148512464,166553148.8,35.87018776536503,70.2977785252643,NaN,NaN,-7.121180161269999,10.168501753963364
2010-01-27T09:30:00-05:00,101.67,102.50999,100.99001,102.3,16207895,10661997.4,38.76797330955404,52.771315593277656,NaN,NaN,-162.24957716348123,-199.96174330412913,-0.6010105370332341,-0.476876541828986,0.12413399520424814,164720359,160396859,32.186669791652406,67.60547403445649,NaN,NaN,-9.770172755693373,7.3201196811552585
2010-01-28T09:30:00-05:00,102.59,102.62,100.50999,101.2,13413949,11164797.7,34.65147794515457,50.88268926222924,NaN,NaN,-151.34120370350337,-208.22758257756058,-0.6254225787560825,-0.657644228240855,-0.03222164948477249,151306410,156008531.4,29.834781580597948,64.62400224454434,NaN,NaN,-13.415649460614956,4.357866946616657
2010-01-29T09:30:00-05:00,101.56,102.355,100.41,100.55,14569344,11731060.65,32.45824423894558,48.770597322019725,NaN,NaN,-137.9108001410286,-179.31955526897084,-0.6491256113816198,-0.8436286637117973,-0.19450305233017748,136737066,153629477.4,28.614077701475736,61.3379403875792,NaN,NaN,-17.112883949188753,1.2906168186444553
2010-02-01T09:30:00-05:00,101.21001,102.35001,101.07001,101.84,9985414,11970518.65,40.506368367218236,47.06668591386812,NaN,NaN,-97.68907317601169,-148.57446944251086,-0.5458559423238847,-0.8768229802350334,-0.3309670379111487,146722480,149599755.8,26.626785925235396,57.740124393275444,NaN,NaN,-17.561710596302902,-1.40257281206231
2010-02-02T09:30:00-05:00,101.95,103.10001,101.6801,102.88,8907738,11966836,46.08421495729196,46.02780524905192,NaN,NaN,-61.464122546168745,-122.13095534603875,-0.38312611026469945,-0.809874675742023,-0.42674856547732354,155630218,151023306.6,28.515543049151674,54.14420633744898,NaN,NaN,-16.01815299165608,-3.490512837718563
2010-02-03T09:30:00-05:00,102.62,103.06,102.34,102.63,6564801,11967489.7,44.992209621196935,44.66636012327606,NaN,NaN,-51.42292267524374,-99.96562444839124,-0.2731099310868686,-0.7681359793359093,-0.4950260482490407,149065417,147892318.2,26.876805544307942,50.29758624501401,NaN,NaN,-15.154112113345983,-5.156741305665337
2010-02-04T09:30:00-05:00,101.95,102.07001,100.00999,100.03999,16419203,12448492.25,35.58457458875887,42.52710980691578,NaN,NaN,-103.51378857214362,-90.40014142211928,-0.35061237694009495,-0.9332915194241593,-0.5826791424840644,132646214,144160279,25.030329273384027,46.19485484153687,NaN,NaN,-17.739013123220577,-6.954208708173228
2010-02-05T09:30:00-05:00,100.14999,100.34,98.36,100.16,28943968,13580017.2,36.24973411744963,41.08692387192354,NaN,NaN,-122.35264567032667,-87.2885105279789,-0.36783879601719316,-1.0424776375055558,-0.6746388414883626,161590182,149130902.2,31.755214602688497,42.584328482252374,NaN,NaN,-19.473425423500704,-8.742668238934296
2010-02-08T09:30:00-05:00,100,100.38,99.12,99.22,10929465,13880879.1,33.34527454206142,38.98582889264443,NaN,NaN,-112.6459750071391,-90.27989089420439,-0.4131913146994839,-1.1911279848627174,-0.7779366701632335,150660717,149918549.6,32.784123285322664,39.021929674060594,NaN,NaN,-21.876455362507823,-10.618923542301943
2010-02-09T09:30:00-05:00,100.16,101.49001,99.84,100.64999,19229376,14499433.25,41.07949900393998,38.04043771016218,NaN,NaN,-75.17239127619067,-93.02154464020876,-0.3216063020929555,-1.179944547779428,-0.8583382456864724,169890093,152770524.6,36.5163482549127,35.72165484362858,NaN,NaN,-21.278822082840314,-12.141766190950282
2010-02-10T09:30:00-05:00,100.55,100.97,99.75,100.52,11212090,14616264.5,40.618110077605515,37.93681926900825,NaN,NaN,-78.81518226901984,-98.49999655896399,-0.2478138088788877,-1.168105506785082,-0.9202916979061944,158678003,154693041.8,38.976175306587685,33.55263044257715,NaN,NaN,-20.961407975227253,-13.401715017275563
2010-02-11T09:30:00-05:00,100.42,101.75,99.87,101.58,9937359,14682119.75,45.94929778496119,38.75311284373703,NaN,NaN,-53.94339976235373,-88.585918797006,-0.11253444698780835,-1.0609597566409548,-0.9484253096531464,168615362,161886871.4,47.21766742209702,33.27352592012587,NaN,NaN,-18.961684898289835,-14.19599642884903
2010-02-12T09:30:00-05:00,100.53,101.37,99.99001,101.27,13643813,15012279.55,44.68578437397425,39.360593111127756,NaN,NaN,-57.69104013198187,-75.65359768933703,-0.03298158535959572,-0.9896522913526411,-0.9566707059930454,154971549,160563144.8,45.98693477914271,33.34226030585154,NaN,NaN,-17.74011676725353,-14.702299334335388
2010-02-16T09:30:00-05:00,102.00999,102.97,101.59,102.81,8960309,14758857.1,51.77953734111479,40.48230716208764,NaN,NaN,21.86531450626871,-48.75133978665548,0.12561054281135076,-0.7996575274788569,-0.9252680702902076,163931858,163217373,48.865009197643495,34.27046183672858,NaN,NaN,-14.335608232933556,-14.649914891277984
2010-02-17T09:30:00-05:00,103.16,103.44,102.95,103.38,8788301,14654216.7,54.12461814986397,41.57921036496692,NaN,NaN,82.98030408871023,-17.1208007136753,0.263239864847838,-0.5962182392304101,-0.8594581040782481,172720159,163783386.2,49.48318519562975,35.50592722272695,NaN,NaN,-10.80923807378748,-14.101246774493626
2010-02-18T09:30:00-05:00,103.17,104.30009,103.16,104.17,8677652,14492876.25,57.229250772325344,43.19190842405055,NaN,NaN,137.83512437522555,26.209260615173783,0.3939552587734211,-0.36701403061147175,-0.7609692893848928,181397811,168327347.8,54.263431858734485,37.25083081402243,NaN,NaN,-6.872238415308527,-13.068531294610041
2010-02-19T09:30:00-05:00,103.7,104.39,103.41499,103.99001,9324418,13846409.15,56.294485969418886,44.894497119084356,NaN,NaN,146.99142477827144,66.39622552329881,0.4506844201073965,-0.19761376425064725,-0.6482981843580438,172073393,169018954,54.961989826906,39.132824537267446,NaN,NaN,-3.977162676578203,-11.769764349176922
2010-02-22T09:30:00-05:00,104.38,104.38,103.71001,103.84,5291047,12880175.9,55.48111994421716,45.96412223172714,NaN,NaN,134.09362911243116,104.75315937218143,0.4589526604306029,-0.07460735881979019,-0.5335600192503931,166782346,171381113.4,57.357596730438274,41.32788245192479,NaN,NaN,-1.8388708874343251,-10.351065283213694
2010-02-23T09:30:00-05:00,103.61,104.14,102.69,102.87,10812020,12508839.3,50.40926587642953,46.27305444023697,NaN,NaN,80.09694639314887,116.39948574955744,0.38303720738439767,-0.05476351001989599,-0.43780071740429366,155970326,169788807,55.225163248315525,43.23571246615079,NaN,NaN,-1.4198287069356128,-9.075174343745397
2010-02-24T09:30:00-05:00,103.17999,103.95,102.99001,103.7,9660363,12073926.25,54.26216938879385,46.935194423636744,NaN,NaN,88.82132949205719,117.56769083022684,0.37233543533214414,0.027618576760886526,-0.3447168585712576,165630689,168370913,53.32404369026604,45.12480090514779,NaN,NaN,0.08276183423327887,-7.766897746891301
2010-02-25T09:30:00-05:00,102.25,103.34,101.92,103.3,10053805,11766221.75,52.15895725529158,48.11907889981766,NaN,NaN,46.3649511250247,99.27365618018666,0.3237249854341918,0.05993937322148213,-0.2637856122127097,155576884,163206727.6,46.980488871770206,46.69266944788966,NaN,NaN,0.7315173781666262,-6.552838443311597
2010-02-26T09:30:00-05:00,103.35001,103.61,102.78,103.3,6966914,11443870,52.15895725529158,49.25545198109209,NaN,NaN,60.314642410305474,81.93829970659348,0.278691581586732,0.08457886477070531,-0.19411271681602668,155576884,159907425.8,43.42609689052461,47.5263038970208,NaN,NaN,1.260534967935501,-5.4366422417048685
2010-03-01T09:30:00-05:00,103.67,104.2,103.58,104.02,5819602,11006382.9,55.74022658883856,50.85509141300474,NaN,NaN,88.33415214409726,72.78640431292669,0.28357444980945634,0.16035534544579377,-0.12321910436366258,161396486,158830253.8,42.300858185335834,48.206070675593175,NaN,NaN,2.726292387844134,-4.270508723197868
2010-03-02T09:30:00-05:00,104.42999,104.64,103.95,104.00999,5677582,10790991.3,55.67782367592829,51.89782888957534,NaN,NaN,92.87579701782349,75.34217443786163,0.27225404601021475,0.2170984531491058,-0.05515559286110891,155718904,158779969.4,42.24582678307192,48.61531914189026,NaN,NaN,3.919008100381295,-3.1005777484008448
2010-03-03T09:30:00-05:00,104.35001,104.77,103.83,104.09,5894066,10640307.7,56.10086903208152,53.00374024346648,NaN,NaN,86.41717569641685,74.86134367873356,0.2564955235450812,0.26546381157024257,0.008968288025161392,161612970,157976425.6,41.32072337215985,48.7827868608597,NaN,NaN,5.032810267814974,-1.938665174655728
2010-03-04T09:30:00-05:00,104.24001,104.57001,103.96001,104.5,6174949,10620815.1,58.29747652226181,53.88575301041652,NaN,NaN,84.08581377686977,82.40551620910256,0.25925594776946137,0.33303822273698813,0.07378227496752675,167787919,160418632.6,45.24523810293183,48.64189905234791,NaN,NaN,6.581303807973953,-0.7215267485657735
2010-03-05T09:30:00-05:00,104.99001,105.77,104.87,105.75999,6756961,10137703,64.22231714245481,55.281219636736544,NaN,NaN,125.54131051968986,95.45084983097945,0.32713246232932586,0.4826978528791841,0.15556539054985824,174544880,164212231.8,50.75481948722953,48.982462245782685,NaN,NaN,9.744109303833794,0.773564116062736
2010-03-08T09:30:00-05:00,105.72,105.96001,105.5,105.59,5732762,8977142.7,62.92344094139654,56.07721275104239,NaN,NaN,131.6561784083544,104.11525508383087,0.34026069778958157,0.5808912627868352,0.24063056499725366,168812118,165695358.2,52.756302868214085,49.26041179368058,NaN,NaN,12.029864137405752,2.381606976254595
2010-03-09T09:30:00-05:00,105.44,106.23,105.41,105.71001,8672250,8864281.95,63.484919015956415,56.74580567004898,NaN,NaN,133.88913470463808,112.31792262119379,0.3361171683136093,0.6607770253892653,0.324659857075656,177484368,170048451,58.134634583302756,49.878372464228654,NaN,NaN,14.099021509786844,4.055523338187774
2010-03-10T09:30:00-05:00,105.82001,106.14,105.38,105.77,7330809,8269353.6,63.780193294968036,57.21373013595204,NaN,NaN,124.82521581834284,119.99953064557899,0.3167688266488677,0.7206208903867406,0.4038520637378729,184815177,174688892.4,62.973686012734106,50.50053347522862,NaN,NaN,15.919589050975372,5.7503898685860015
2010-03-11T09:30:00-05:00,105.64,106.28999,105.24001,106.28,7748824,8096190.3,66.2768427806925,57.92675562247158,NaN,NaN,129.90001096930442,129.1623700840659,0.3169012819749578,0.7999786662065702,0.4830773842316124,192564001,179644108.8,67.31783035945821,51.38309351326806,NaN,NaN,18.206871693565642,7.529887272154522
2010-03-12T09:30:00-05:00,106.64,106.67999,106.13,106.42,10140656,8106355.15,66.95031747379912,58.74598401744171,NaN,NaN,143.91388543931998,132.83688506799194,0.30490216218538047,0.864205086963338,0.5593029247779575,202704657,185276064.2,71.42184763389898,52.387682863515245,NaN,NaN,20.334399462413966,9.359103299334443
2010-03-15T09:30:00-04:00,106.3,106.63,105.87,106.57001,6760820,7762205.5,67.69477962103404,59.980663570627755,NaN,NaN,123.49801466109263,131.20525231853958,0.28587210093977156,0.916643050952672,0.6307709500129004,209465477,193406736,76.08986295535632,53.878018556875304,NaN,NaN,22.355889244187257,11.215787005741987
2010-03-16T09:30:00-04:00,106.78,107.12,106.41,107.07001,6854879,7656934,70.11143575271564,61.11275402519359,NaN,NaN,133.3145444528235,131.09033426817666,0.28511675287319493,0.987166891104394,0.7020501382311991,216320356,201173933.6,79.52974794292054,55.74985457492205,NaN,NaN,24.814765111432305,13.158498163697747
2010-03-17T09:30:00-04:00,107.31,107.87,107.23,107.52,6991922,7567115.05,72.13196889690524,62.53939771388029,NaN,NaN,147.96071993704714,135.7174350919175,0.2920138774605119,1.067067485056839,0.775053607596327,223312278,208873353.8,82.25505187349818,58.26946621790262,NaN,NaN,27.546043235323193,15.213861745358525
2010-03-18T09:30:00-04:00,107.53,108.03,107.46069,107.95,7502578,7508361.35,73.94459812193497,64.09551491864053,NaN,NaN,140.7005630468712,137.87754550743088,0.301404591191641,1.1518093465858783,0.8504047553942373,230814856,216523524.8,84.4677578503481,61.201013429318586,NaN,NaN,30.45339405773902,17.39093778998431
2010-03-19T09:30:00-04:00,108.13,108.17,106.92,107.34,12067965,7645538.7,67.26097556350379,64.91842555968805,NaN,NaN,110.48751136806844,131.19227069318057,0.24480862915648893,1.1564155418398485,0.9116069126833596,218746891,219731971.6,85.29588360213958,64.272086673376,NaN,NaN,31.192628140663558,19.362607840081346
2010-03-22T09:30:00-04:00,106.95,108.07001,106.92,107.78999,8835414,7822757.05,69.45434890647527,65.90246307615568,NaN,NaN,105.83499699563784,127.65966716008961,0.2169084680602007,1.1827424977586105,0.9658340296984098,227582305,223355337.2,86.19128428962823,67.4110479238443,NaN,NaN,32.451824356709935,21.23249591388543
2010-03-23T09:30:00-04:00,108.03,108.92,107.8295,108.87,9105844,7737448.25,73.96300654054971,67.17833004104628,NaN,NaN,140.0288928545198,129.0025368404289,0.24816887789345699,1.276045127065231,1.0278762491717741,236688149,227428895.8,87.13945057574651,70.68381415267193,NaN,NaN,35.00787691410572,23.200407485345472
2010-03-24T09:30:00-04:00,108.52,108.81,108.22,108.39999,7076082,7608234.2,69.17751210685392,67.95547543994572,NaN,NaN,123.61977697272958,124.13434824756537,0.21538698277302748,1.2971099776380584,1.0817229948650309,229612067,228688853.6,87.42701576114385,73.69679827111564,NaN,NaN,35.68988725472757,24.984618880971485
2010-03-25T09:30:00-04:00,108.99001,109.53,108.315,108.44,9530789,7582083.4,69.35925511594412,68.32239958090923,NaN,NaN,124.28182087850713,120.85059981389259,0.17624046712320585,1.3020235787690382,1.1257831116458323,239142856,230354453.6,87.81490272160097,76.34394707357073,NaN,NaN,36.29165762389124,26.599910129960023
2010-03-26T09:30:00-04:00,108.63,109.07001,108.131,108.42999,8865000,7676987.7,69.24923927064032,68.77424231871235,NaN,NaN,103.6224820026243,119.47759394080374,0.13156300844715219,1.2902368722047726,1.1586738637576204,230277856,232660646.6,88.35078935936072,78.88641039436693,NaN,NaN,36.75316127424978,28.050374579144272
2010-03-29T09:30:00-04:00,108.78999,109.16,108.67,108.92,5886246,7680319.9,71.62217247485995,69.35547470863403,NaN,NaN,110.36645213328285,120.38388496833277,0.11737117759761873,1.3053878357546438,1.188016658157025,236164102,234377006,88.74742621227611,81.07303836786502,NaN,NaN,37.820778550148916,29.44614657500208
2010-03-30T09:30:00-04:00,109.00999,109.38,108.67,109.13,5781711,7685526.35,72.59808219504255,69.98532391578222,NaN,NaN,107.2504741811207,113.82820123365293,0.1048940101879452,1.3191341708919566,1.2142401607040114,241945813,235428538.8,88.99465525724537,82.93167902818725,NaN,NaN,38.99249751807776,30.809910995441463
2010-03-31T09:30:00-04:00,108.82001,109.0399,108.32001,108.61,6080512,7694848.65,66.49964496909762,70.00123835781116,NaN,NaN,79.72711739890727,105.04966931888848,0.04731966508299812,1.2733897420577591,1.226070076974761,235865301,236679185.6,89.29588302521054,84.50153993288384,NaN,NaN,38.2890294566426,31.878356489898767
2010-04-01T09:30:00-04:00,109.24001,109.58,108.66,109.28,11474387,7959820.55,69.99681618166554,70.21884540837304,NaN,NaN,102.56209955015241,100.70572505321753,0.04033259383816401,1.276485819272466,1.236153225434302,247339688,238318552,89.69408547311198,85.80669977854191,NaN,NaN,38.67840634995871,32.84979218419304
2010-04-05T09:30:00-04:00,109.59,109.88,109.25,109.73,4246059,7834275.45,72.10323047928557,70.53373475539102,NaN,NaN,118.65873480914127,103.71297561452093,0.05128710745105303,1.3002621097481182,1.2489750022970652,251585747,242580130.2,90.66614577800009,86.84786283730217,NaN,NaN,39.63489173205368,33.819092119601706
2010-04-06T09:30:00-04:00,109.45,109.87,109.2782,109.72,4411352,7768204.95,71.98228927875526,70.66736715010813,NaN,NaN,108.54072861955416,103.34783091177519,0.04343978611312327,1.3032747349384692,1.259834948825346,247174395,244782188.8,91.13161839580505,87.67656786965108,NaN,NaN,40.37590700793383,34.75577996079201
2010-04-07T09:30:00-04:00,109.55,109.7,108.52,109.05,10895398,7879362.35,64.2110734832415,70.10158890627501,NaN,NaN,69.56576956321167,95.81088998819338,-0.017999457747466696,1.2373356266410127,1.2553350843884794,236278997,243648825.6,88.68037979431082,88.13551986399484,NaN,NaN,38.72795372742294,35.323233356025
2010-04-08T09:30:00-04:00,108.71001,109.57001,108.5,109.37,8765063,7951075.05,66.09386182637701,69.54082202802087,NaN,NaN,68.21194369453646,93.50785524731921,-0.046587822125867984,1.1971003067311443,1.2436881288570123,245044060,245484577.4,89.18767988323992,88.47265715205855,NaN,NaN,37.87413861916397,35.68764839361628
2010-04-09T09:30:00-04:00,109.52,110.08,109.41,110.06,6018207,7864544.2,69.78499182291489,69.72110890369309,NaN,NaN,114.64016149265228,95.92346763581921,-0.029368523688477977,1.2069774742464148,1.2363459979348927,251062267,246229093.2,89.39525624754428,88.76546948387316,NaN,NaN,38.22756651818478,36.050493839983204
2010-04-12T09:30:00-04:00,110.14,110.36,109.98,110.17999,4366465,7575834.65,70.38868920393719,69.78784749636895,NaN,NaN,136.36743800480423,99.46520827495178,-0.02065030346425578,1.2105331186045731,1.231183422068829,255428732,246997690.2,89.61687001974892,89.01015417888178,NaN,NaN,38.69159148989913,36.42779350425691
2010-04-13T09:30:00-04:00,110,110.44,109.53,110.25,6105750,7543081.15,70.75583245288334,69.55876363296422,NaN,NaN,121.867696720839,102.13060189520876,-0.020859958500003994,1.2051084739438238,1.2259684324438278,261534482,249869707.6,90.4223052532846,89.24464379870594,NaN,NaN,39.175431965645544,36.82031328445529
2010-04-14T09:30:00-04:00,110.60001,111.32001,110.42999,111.28999,7987371,7599705.75,75.59630044634255,70.01724851435625,NaN,NaN,189.02867631456343,126.02318324547912,0.03529495929120152,1.2700871315578297,1.2347921722666282,269521853,256518278.8,91.97436273213937,89.56945429663418,NaN,NaN,41.13469980098004,37.43665421538739
2010-04-15T09:30:00-04:00,111.08,111.62,111.03999,111.56,8667406,7683479.95,76.67572338159684,70.53985339047429,NaN,NaN,194.60185270876912,151.30116504832566,0.07461559664692041,1.3280616680752786,1.2534460714283582,278189259,263147318.6,93.16386302046811,89.95152288941041,NaN,NaN,43.084281361395746,38.24345809338858
2010-04-16T09:30:00-04:00,111.25999,111.5,109.7,110.17999,22113424,8414022.25,61.66332782673329,69.99800257305237,NaN,NaN,98.62888755255125,148.09891026030544,-0.0041469053149523205,1.2482624397846678,1.25240934509962,256075835,264150032.2,93.32501885376237,90.3068249961534,NaN,NaN,39.782150182351444,38.463271248954705
2010-04-19T09:30:00-04:00,109.86,110.91,109.74001,110.84,10482473,8334747.65,65.1751633725429,69.53750192288688,NaN,NaN,90.70429788927522,138.96628223719966,-0.02259400867146577,1.2241668342602878,1.2467608429317536,266558308,266375947.4,93.6811342849813,90.65923271563233,NaN,NaN,38.22526303126182,38.42927007499858
2010-04-20T09:30:00-04:00,111.22,111.42999,110.78,111.10001,8904691,8338211.5,66.47795362564239,69.10034988221543,NaN,NaN,128.905785591719,140.3739000113756,-0.0277451302562588,1.2120794301114302,1.239824560367689,275462999,269161650.8,94.10500656676871,91.02425780916971,NaN,NaN,37.41224760468502,38.28398115066807
2010-04-21T09:30:00-04:00,111.14,111.5,110.69,111.16,9117047,8338771.65,66.78667821396293,69.12085225684866,NaN,NaN,114.15957419470725,125.40007958740436,-0.03699413009988617,1.1935818977428312,1.2305760278427174,284580046,272173289.4,94.53205095062704,91.39826980384233,NaN,NaN,36.86480007973657,38.08124099767785
2010-04-22T09:30:00-04:00,110.61,111.50999,110.14999,111.35001,9947953,8482365.2,67.79826296986613,68.96381274172013,NaN,NaN,94.1219644729519,105.30410194024094,-0.03994486303680689,1.1806449490467088,1.2205898120835157,294527999,275441037.4,94.9587831864843,91.77431964051178,NaN,NaN,36.713929135957756,37.885910731717836
2010-04-23T09:30:00-04:00,111.28999,112.03999,111.05,111.96001,13874969,8699574.2,70.86606397634071,68.8754437057955,NaN,NaN,132.36960388129944,112.05224520599056,-0.011899458948231523,1.2057154883982264,1.217614947346458,308402968,285906464,96.02793698601188,92.15730472679832,NaN,NaN,37.5140022629795,37.832780950469505
2010-04-26T09:30:00-04:00,112.11,112.5799,112.02,112.08,8021980,8657423.2,71.44239184213981,68.83687960318011,NaN,NaN,154.67306753243645,124.8459991346228,0.002859364734471015,1.2211891532645467,1.2183297885300757,316424948,295879792,96.7379459205469,92.5577566928513,NaN,NaN,38.3349915334466,37.90452531946623
2010-04-27T09:30:00-04:00,111.75999,112.17999,109.73,109.87,19879248,9357073.3,51.309700356657316,67.91535295128124,NaN,NaN,25.233644048417897,104.1115708259626,-0.14018430029179152,1.0430994131653364,1.183283713457128,296545700,300096332.2,96.98345017024499,93.15083314827517,NaN,NaN,31.85346821104939,37.040088589692395
2010-04-28T09:30:00-04:00,110.38,110.84,109.69,110.55,14837328,9809854.15,55.4680314751536,67.15636506905099,NaN,NaN,1.4342651589461626,81.56650901881036,-0.18988436599969316,0.9459282559575115,1.1358126219572047,311383028,305456928.6,97.2652419473407,93.72780186713952,NaN,NaN,28.09217008208328,35.76181451717681
2010-04-29T09:30:00-04:00,110.94,112,110.92,111.69,7472551,9879456.1,61.41713725409118,66.55866117127786,NaN,NaN,95.74800692102957,81.8917175084259,-0.14868420221509182,0.9499573691883398,1.0986415714034317,318855579,310322444.6,97.49405935953322,94.30628780371015,NaN,NaN,27.09505919660731,34.52370661423831
2010-04-30T09:30:00-04:00,111.81,112,110.03999,110.10001,14619012,10036687.35,51.15294723090243,65.18467960177539,NaN,NaN,14.698550162272982,58.357506764620624,-0.22655201895333743,0.8154515477117599,1.0420035666650973,304236567,309489164.4,96.01241358150786,94.7631123438358,NaN,NaN,22.20384255734734,32.763726034682456
2010-05-03T09:30:00-04:00,110.57001,111.82001,110.57001,111.53999,8330164,10240892.6,57.99901698508956,64.27347849693297,NaN,NaN,66.53320480332698,40.729534218798726,-0.18108541481372742,0.8156467981479381,0.9967322129616655,312566731,308717521,94.57900096246856,95.06001918020608,NaN,NaN,20.915857081920567,31.071173327145043
2010-05-04T09:30:00-04:00,110.50999,110.53999,108.7001,109.36,19917600,11016205,47.21125765782351,62.245975440610174,NaN,NaN,-111.08638383595205,13.465528641924738,-0.2913039177715331,0.6326023157472491,0.9239062335187822,292649131,307938207.2,93.06779497761474,95.13812148345434,NaN,NaN,15.241992704969306,28.809861809691366
2010-05-05T09:30:00-04:00,108.55,109.56,108.25,108.8,18900368,11416453.5,44.900876450491374,59.97634351695979,NaN,NaN,-173.4455869793555,-21.51044178573559,-0.3892770759224877,0.43730988861567255,0.8265869645381603,273748763,300411354.2,79.80474495675418,94.18389876461762,NaN,NaN,10.173679537601556,26.147550056535678
2010-05-06T09:30:00-04:00,108.37,109.14999,99.16,105.2625,34425232,12699461.95,33.686268719449785,57.97798215215382,NaN,NaN,-415.4611210508019,-123.75226738010187,-0.6635690271554111,-0.0028743194061036093,0.6606947077493075,239323531,284504944.6,60.260458291722706,91.82214443875765,NaN,NaN,0.5450629090982154,22.49005189261604
2010-05-07T09:30:00-04:00,105.02,105.94,102.53999,103.78,33887360,14092919.6,30.27372610633428,55.48502234742464,NaN,NaN,-298.0204568768975,-186.296068787936,-0.9013376375154791,-0.46597733914504147,0.43536029837043766,205436171,264744865.4,45.38927417249919,88.37272585929465,NaN,NaN,-8.111481515648558,18.118404262863955
2010-05-10T09:30:00-04:00,107.57001,108.47,107,108,20455232,14897357.95,46.79606021382814,54.07917281800933,NaN,NaN,-95.66319321871394,-218.73534839234418,-0.7377753432240615,-0.4868588806596392,0.25091646256442224,225891403,247409799.8,36.80759853118894,84.28005385675324,NaN,NaN,-7.825923251958167,14.412071760746509
2010-05-11T09:30:00-04:00,107.14,108.92999,106.98,107.67,16440578,15414099.35,45.880495153052415,52.58587402794429,NaN,NaN,-81.27555221233351,-212.77318206762047,-0.6199296498359586,-0.5239955997305259,0.0959340501054326,209450825,230770138.6,30.7898955688745,79.72704275805661,NaN,NaN,-8.010266764373705,11.208880542872192
2010-05-12T09:30:00-04:00,108.08,109.35001,107.95,109.25999,12985457,15664003.65,50.86827283693001,51.376589018448854,NaN,NaN,-36.48747068914657,-185.38155880957868,-0.412973680770351,-0.42028305085750617,-0.0073093700871551676,222436282,220507642.4,27.773946072527224,74.92812582134539,NaN,NaN,-6.1437449076844235,8.729934049935533
2010-05-13T09:30:00-04:00,108.95,109.46001,107.97,108.10001,11165680,15788917.35,47.43363852081354,49.70284434305405,NaN,NaN,-44.03466435076973,-111.09626746957224,-0.335569501554154,-0.4267712470298477,-0.09120174547569368,211270602,214897056.6,26.25953834223472,69.94466877536131,NaN,NaN,-6.022021043026271,6.622511893798133
2010-05-14T09:30:00-04:00,107.45,107.66991,105.62,106.50999,17965712,15581531.75,43.13437746848125,47.680843316364154,NaN,NaN,-102.9397535644173,-72.08012680707618,-0.3701028467345451,-0.553830303893875,-0.18372745715932995,193304890,212470800.4,25.609236485741604,64.86404667287522,NaN,NaN,-7.52263516550173,4.601776599612438
2010-05-17T09:30:00-04:00,106.69,106.92,104.66,106.52,17555200,15935168.1,43.16930006733922,47.09938615284143,NaN,NaN,-107.23579480805769,-74.39464712494492,-0.3700324527084989,-0.6462680230449536,-0.2762355703364547,210860090,209464537.8,24.790054619600852,59.70737556211493,NaN,NaN,-8.626074221673491,2.71208362514302
2010-05-18T09:30:00-04:00,107.28999,107.50999,105.14,105.39,19226000,16451233.55,40.17020742637,46.00668443507118,NaN,NaN,-96.13778880308264,-77.36709444309476,-0.4201861916240536,-0.8014683098665216,-0.38128211824246805,191634090,205901190.8,23.81753924808514,54.461111083596684,NaN,NaN,-10.52229565885779,0.8214580131429043
2010-05-19T09:30:00-04:00,104.96001,105.58,103.59,104.77,24115600,17201161.2,38.586243439249714,44.37590630543964,NaN,NaN,-122.91469505566675,-94.65253931639879,-0.4656856043225154,-0.9633891236456122,-0.49770351932309687,167518490,194917632.4,21.073304472140762,49.00248573449723,NaN,NaN,-12.546301736177803,-1.0882219510457682
2010-05-20T09:30:00-04:00,102.97,103.25,101,101.11,28708080,18139167.55,30.85227348294616,42.925858180585635,NaN,NaN,-175.85938291952397,-121.01748303014963,-0.6988269274344696,-1.3712371786161839,-0.6724102511817143,138810410,180425594,18.108606234316397,43.43792806684069,NaN,NaN,-17.22396766756329,-3.393328481976843
2010-05-21T09:30:00-04:00,99.3,101.97,99.02,101.84,30848256,18987831.9,33.70636737474716,41.19066892270403,NaN,NaN,-168.52839817392095,-134.13521195205035,-0.7556045992750814,-1.616916000275566,-0.8613114010004846,169658666,175696349.2,17.25546389617162,37.91481827639091,NaN,NaN,-19.90867160901043,-5.752663214410212
2010-05-24T09:30:00-04:00,101.37,101.98,100.53,100.67999,16543605,19413913.15,31.482623224249622,40.0671950345916,NaN,NaN,-143.07139865791706,-141.30233272202221,-0.817758418919158,-1.8835094246494322,-1.0657510057302741,153115061,164147343.4,15.353191817962525,32.36377519355861,NaN,NaN,-22.8313984131955,-8.192482528522396
2010-05-25T09:30:00-04:00,98.53,100.57001,97.75,100.46001,25172160,19678558.75,31.064082665330943,39.07885262136586,NaN,NaN,-153.66982112821643,-152.80873918704899,-0.8181693425523373,-2.088462683920696,-1.2702933413683586,127942901,151409105.6,13.575518854678762,27.633116186267507,NaN,NaN,-25.255814203237875,-10.630101339196035
2010-05-26T09:30:00-04:00,100.88,101.8,99.52,99.67999,18505056,19861945.15,29.56327050729432,38.78435274906904,NaN,NaN,-121.39234558487264,-152.50426929289017,-0.8137351448428258,-2.287462272421891,-1.473727127579065,109437845,139792976.6,12.189480793502938,24.199474936394672,NaN,NaN,-27.715422338590134,-13.07086148196662
2010-05-27T09:30:00-04:00,101.44,102.73,101.07001,102.72,18333920,20405013.6,41.43831686440778,39.58182351750286,NaN,NaN,-73.09379955290026,-131.95115261956545,-0.5608565096022196,-2.1747977645818395,-1.61394125497962,127771765,137585247.6,11.939969078876928,21.810238858278804,NaN,NaN,-26.037047865480645,-14.923173822468623
2010-05-28T09:30:00-04:00,102.59,102.63,101.03999,101.47,19455952,20646860.6,38.55966548371999,38.99350960820942,NaN,NaN,-74.88317482578073,-113.2221079499374,-0.43801414052657206,-2.161458930637835,-1.7234447901112628,108315813,125316677,10.63693673255193,19.94090587266187,NaN,NaN,-25.593317288728873,-16.447480031934372
2010-06-01T09:30:00-04:00,100.67,102.28999,100.23,100.32001,17013840,21081044.4,36.076636758750496,38.29323400861643,NaN,NaN,-84.49138425888535,-101.50610507013104,-0.3957348564505392,-2.2181133606744368,-1.8223785042238976,91301973,112954059.4,9.510616658437726,18.42095737905925,NaN,NaN,-26.023232757853098,-17.81544470706562
2010-06-02T09:30:00-04:00,100.86,102.64999,100.41,102.61,14884629,20829395.85,43.83293377538962,37.79070978993498,NaN,NaN,-56.11196648850008,-81.99453414218779,-0.18573385625414374,-2.0545458245415773,-1.8688119682874336,106186602,108602799.6,9.143627661757677,17.090220349718567,NaN,NaN,-23.79419351605084,-18.669551679777793
2010-06-03T09:30:00-04:00,102.99001,103.2599,101.84,102.69,11858469,20477300.9,44.088168417016774,37.55174763966378,NaN,NaN,-33.46519406451219,-64.4091038381157,-0.022229806975506694,-1.896599227006817,-1.8743694200313104,118045071,110324244.8,10.613165572596444,15.972622294744403,NaN,NaN,-21.980292832726988,-19.14251470162768
2010-06-04T09:30:00-04:00,100.97,101.17999,99,99.44,20050272,19758552.9,36.77664263740212,37.09762372315812,NaN,NaN,-92.22366244225753,-68.23507641598715,-0.10890245246339747,-2.010497485610557,-1.9015950331471596,97994799,104368851.6,10.009967439573742,14.858388791446702,NaN,NaN,-22.77487304754206,-19.661423036758304
2010-06-07T09:30:00-04:00,99.66,99.92,98.201,98.26801,13694512,18748910.5,34.55140258175636,36.48205961704507,NaN,NaN,-105.45153205065155,-74.34874786096131,-0.21497552589911528,-2.1703144405210537,-1.9553389146219384,84300287,99565746.4,9.539079198791285,13.769033404246017,NaN,NaN,-24.153749853289703,-20.303184010548502
2010-06-08T09:30:00-04:00,98.36,99.67,97.7,99.44,25095568,18980927.3,38.55522174460344,36.36670349691889,NaN,NaN,-96.4050471917127,-76.73148044752679,-0.17757058559291883,-2.177302146613087,-1.9997315610201682,109395855,103184522.8,12.864928052348134,12.986704033121944,NaN,NaN,-23.98902216000403,-20.829732317613576
2010-06-09T09:30:00-04:00,99.98,100.78,98.8,99.14999,16083566,18963076.7,37.93676664678828,36.320312297457356,NaN,NaN,-77.74333010548558,-81.05775317092389,-0.14509393990193864,-2.1810989858975915,-2.036005045995653,93312289,100609660.2,12.512427287125746,12.375212805620876,NaN,NaN,-24.046120360110358,-21.289216323684546
2010-06-10T09:30:00-04:00,100.60001,101.98,100.60001,101.88,13826566,19005132.15,46.61755860768547,37.44640409208159,NaN,NaN,-21.517687549990907,-78.66825186801964,0.07565258629008564,-1.9414393131330456,-2.0170918994231313,107138855,98428417,12.207282186792142,11.953689659369141,NaN,NaN,-21.266410002086396,-21.28595827774195
2010-06-11T09:30:00-04:00,101.07001,102.35001,101.02,102.31,9072559,18900476.1,47.85472694806423,38.45700120446139,NaN,NaN,1.8930723776449643,-59.84490490403914,0.2558774360127778,-1.697245104407159,-1.9531225404199368,116211414,102071740,15.896686158177957,11.856634106655305,NaN,NaN,-18.663338622378063,-20.911298326975682
2010-06-14T09:30:00-04:00,102.99001,103.49001,102.03999,102.14,8996320,18452006.5,47.387146788019706,39.593038601873545,NaN,NaN,40.959416828583464,-30.562715128192156,0.3623826048039376,-1.5001442844150148,-1.8625268892189524,107215094,106654701.4,20.426687807816663,12.21902667735917,NaN,NaN,-16.707204571885832,-20.31071350481999
2010-06-15T09:30:00-04:00,102.81,104.28999,102.099,104.17,9404699,18044481.45,53.2600311697806,41.17846349504852,NaN,NaN,98.02748935347114,8.323792180844611,0.5566714459753461,-1.1666875817497697,-1.7233590277251158,116619793,108099489,21.85566481952739,12.81046567484836,NaN,NaN,-13.157741024811976,-19.288860293390275
2010-06-16T09:30:00-04:00,103.69,104.48,103.52,104.28999,9603832,17563373.05,53.589797837463095,42.894644018632,NaN,NaN,140.14787663447044,51.902033528835815,0.6726353073442446,-0.88256489354481,-1.5552002008890546,126223625,114681756.2,28.18327329529629,13.952879424976455,NaN,NaN,-10.204095984926642,-17.991036820752612
2010-06-17T09:30:00-04:00,104.50999,104.62,103.38,104.56,9746016,16844893.85,54.36996668011115,43.81833329118224,NaN,NaN,148.48211157115932,85.90199335306586,0.7414684255461514,-0.6283646689563653,-1.3698330945025168,135969641,120447913.4,33.28002663490855,15.477169250407286,NaN,NaN,-7.5456148585320655,-16.498833683292535
2010-06-18T09:30:00-04:00,104.50999,104.84,104.23,104.49001,6894762,15754227.95,54.116020419683494,44.92950150089392,NaN,NaN,144.23042072730078,114.36946302299702,0.7537645989842694,-0.42762734577218,-1.1813919447564494,129074879,123020606.4,35.48015242620886,17.25168465709707,NaN,NaN,-5.4106451662651525,-14.914806752288623
2010-06-21T09:30:00-04:00,105.73,105.96001,103.96001,104.45,10260762,14724853.25,53.96086074339922,46.20694607122597,NaN,NaN,136.56792880491227,133.4911654182628,0.7301751965862484,-0.2686729490236388,-0.9988481456098872,118814117,125340411,37.4820618240877,19.249645026072066,NaN,NaN,-3.660730894011314,-13.30708162967758
2010-06-22T09:30:00-04:00,104.5,104.94,102.84,102.92999,11925293,14493937.65,48.29556202237992,46.525705231725276,NaN,NaN,74.2755517726329,128.74077790209515,0.5892156465041948,-0.2623285874796437,-0.8515442339838385,106888824,123394217.2,36.45997723155618,21.200812852486244,NaN,NaN,-3.5656702902409,-11.915451438329482
2010-06-23T09:30:00-04:00,103.08,103.67999,102.27,102.99001,12969000,13883779.65,48.525373323002874,46.842648439295715,NaN,NaN,43.24506781550746,109.36021613830255,0.4815709759486888,-0.24958051404797743,-0.7311514899966662,119857824,122121057,35.77275467542532,22.997926359831162,NaN,NaN,-3.4270119781379753,-10.702817229730694
2010-06-24T09:30:00-04:00,102.50999,102.64,101.3,101.55901,13411566,13629105.15,43.554785370053224,47.32680149162793,NaN,NaN,-12.541335877618819,77.15552664854692,0.30419932719748055,-0.3509023309998156,-0.6551016581972962,106446258,116216380.4,32.69483094270696,24.61827375291211,NaN,NaN,-4.66323938856655,-9.840020395278675
2010-06-25T09:30:00-04:00,101.8,102.03011,100.83,101.72,10896574,13257237.85,44.246701404067615,48.01932283607874,NaN,NaN,-25.182047706518354,43.27303296178309,0.1933260250907326,-0.41344412683388043,-0.606770151924613,117342832,113869971,31.533721763546566,26.18931965039463,NaN,NaN,-5.518464676953676,-9.222655292660818
2010-06-28T09:30:00-04:00,101.69,102.05,101.03999,101.44,6771957,12623038.1,43.253602807385434,48.35492148342031,NaN,NaN,-25.32553449614578,10.894340301571471,0.1013611793955922,-0.48006867768012285,-0.581429857075715,110570875,112221322.6,30.708516965431414,27.463861715614865,NaN,NaN,-6.507015870826069,-8.834706803827283
2010-06-29T09:30:00-04:00,100.19,100.23,98.13,98.73,16676809,12606186.55,35.05320158084534,48.148952550138674,NaN,NaN,-128.52325036756778,-29.665420126468653,-0.1292392086704156,-0.7429788679137346,-0.613739659243319,93894066,109622371,29.402278899448845,28.670279687923657,NaN,NaN,-9.953684023175416,-8.994560692305587
2010-06-30T09:30:00-04:00,98.50999,99.13,97.59,97.73,13389004,12531405.3,32.59730590391848,47.147505928441035,NaN,NaN,-141.54567745693862,-66.62356918095786,-0.32522244805903955,-1.0202677193171183,-0.6950452712580788,80505062,101751818.6,25.82034737237288,29.642641486893712,NaN,NaN,-13.657123285411158,-9.66064106274924
2010-07-01T09:30:00-04:00,97.75,98,96.25999,97.34,18565152,12866739.45,31.66551582583152,45.99113370542441,NaN,NaN,-151.22632704711296,-94.3605674148567,-0.4495645413729582,-1.2570009479742765,-0.8074364066013183,61939910,92850549,22.48420051433014,30.113178226618864,NaN,NaN,-16.995384925804384,-10.708461614614261
2010-07-02T09:30:00-04:00,97.53,97.74001,96.17,96.87,11307410,12429596.35,30.532800069139583,44.78725179693298,NaN,NaN,-141.47771463388577,-117.61970080033018,-0.5265658988278749,-1.465643780136162,-0.9390778813082871,50632500,79508482.6,18.604066035232137,29.98299095714854,NaN,NaN,-20.12827662103351,-12.054149472674155
2010-07-06T09:30:00-04:00,97.99001,98.62,96.61,97.45,10252504,12257495.95,33.68532714544166,43.38905865233733,NaN,NaN,-114.84191763233453,-135.52297742756792,-0.5016497645870279,-1.566140087042072,-1.0644903224550442,60885004,69571308.4,16.342028621983047,29.58915980018109,NaN,NaN,-21.927001946131224,-13.464556968882308
2010-07-07T09:30:00-04:00,97.53999,100.37,97.5,100.28999,12256176,11615526.35,46.4904519356464,42.88196251649329,NaN,NaN,-60.14267313618702,-121.84686198129177,-0.2687892226119737,-1.4004768507200112,-1.1316876281080375,73141180,65420731.2,15.494601057097896,28.68282606888121,NaN,NaN,-19.602629804796447,-14.341424516870042
2010-07-08T09:30:00-04:00,100.89999,101.50999,100.39999,101.50999,9461141,11284405.1,50.87851976664891,42.63257345124599,NaN,NaN,-8.289520136712726,-95.1956305172466,-0.020571441015058145,-1.15740192937686,-1.136830488361802,82602321,65840183,15.968837843825384,27.446312583803834,NaN,NaN,-16.214227251004885,-14.608967764603591
2010-07-09T09:30:00-04:00,101.46001,102.13,101.28,102.11,7378934,10962023.5,52.92323125302242,42.54737422505591,NaN,NaN,13.969749171486427,-62.156415273526726,0.18474054767086123,-0.9059048037732254,-1.0906453514440866,89981255,71448452,22.25137355001283,26.50139980693269,NaN,NaN,-12.804514012060105,-14.351188657097378
2010-07-12T09:30:00-04:00,101.85001,102.3,101.55,102.25,6613551,10839073.1,53.41053810295734,42.508065465024345,NaN,NaN,19.986801336900502,-29.863512079369464,0.3226193982645369,-0.6873711036134154,-1.0099905018779523,96594806,80640913.2,31.31577718981842,26.060950904484883,NaN,NaN,-9.91515829303917,-13.717470033660492
2010-07-13T09:30:00-04:00,103.22,104.17999,103.17,103.73,9339098,10856212,58.32210445073977,43.22424706705005,NaN,NaN,70.67332123312892,7.239535693723219,0.49578498176467856,-0.3902592746721041,-0.8860442564367826,105933904,89650693.2,38.84184228358501,26.231084122486944,NaN,NaN,-5.834458049932661,-12.591325464556515
2010-07-14T09:30:00-04:00,103.53,104.09,103.12,103.75,8757824,10823868.25,58.38594921344608,43.92857391636743,NaN,NaN,69.03207965705019,33.07448625237066,0.5876861963691167,-0.1514365109753868,-0.7391227073445035,114691728,97960802.8,44.84491729940344,26.879095738485383,NaN,NaN,-2.5372214178329027,-11.155024886453143
2010-07-15T09:30:00-04:00,103.72,103.88,102.49001,103.7,11501309,10918742.1,58.146140433190745,44.97081356373439,NaN,NaN,61.539167597060725,47.04022379912536,0.6180281731875968,0.03341250913999261,-0.5846156640476042,103190419,102078422.4,47.59001355557295,27.943037353690098,NaN,NaN,0.10309944492191386,-9.546721410542421
2010-07-16T09:30:00-04:00,103.00999,103.11,100.83,101.00999,12219617,11042422.15,46.96887703666706,45.16525468034864,NaN,NaN,11.179275521005607,46.48212906902919,0.43830755392367593,-0.03673122164300935,-0.4750387755666853,90970802,102276331.8,47.72468440017333,29.099534684877728,NaN,NaN,-0.7908149628857701,-8.295877632305757
2010-07-19T09:30:00-04:00,101.41,101.89999,100.75999,101.62,7289477,11062157.9,49.34675524377195,45.600479854376246,NaN,NaN,9.382866926070317,44.361342186863155,0.34594559623580856,-0.04260678027192455,-0.3885523765077331,98260279,102609426.4,47.96702381630997,30.332285174226193,NaN,NaN,-0.8065599327336508,-7.225975103795456
2010-07-20T09:30:00-04:00,100.10001,102.39999,100.03999,102.33,9204473,11009343.45,52.04216284777626,46.81397708772845,NaN,NaN,22.036728988784922,34.634023737994355,0.3187727698618807,0.009913585819617765,-0.3088591840422629,107464752,102915596,48.204706122847576,31.675315690183247,NaN,NaN,-0.011503427217886502,-6.195336292855803
2010-07-21T09:30:00-04:00,102.67,102.7,100.72,101.23,10812934,10953725.5,47.79841390015171,47.89977051603082,NaN,NaN,25.185498274467438,25.86470746147781,0.21764715339810486,-0.03680024229463186,-0.2544473956927367,96651818,99307614,45.563385336262876,33.08553268760396,NaN,NaN,-0.6219744166676633,-5.39914173911464
2010-07-22T09:30:00-04:00,102.25,103.71001,102.22,103.25,10389230,10824737,55.047619387623186,49.56992077044452,NaN,NaN,83.58513572134115,30.273901086333886,0.274085581949851,0.08815958174457705,-0.18592600020527394,107041048,100077739.8,46.24051032465521,34.78241195977004,NaN,NaN,1.1739687163677859,-4.460125959760008
2010-07-23T09:30:00-04:00,103.11,104.5,102.92,104.27,13384176,10823367.5,58.20390236023156,51.54642807695109,NaN,NaN,108.14821422971568,49.6676888280759,0.36188114540899763,0.2664254315559731,-0.09545571385302454,120425224,105968624.2,51.23706955265626,37.11334078244319,NaN,NaN,3.687766315656634,-3.296141348986202
2010-07-26T09:30:00-04:00,104.41,105.33,104.21001,105.25999,9053313,10731204.45,61.06160233888134,53.501876305053926,NaN,NaN,132.68302887983478,74.32772121882878,0.4619883966050654,0.48202978190330725,0.02004138529824183,129478537,112212275.8,55.913985701518875,39.93990914526718,NaN,NaN,6.698607655930012,-1.8683200625696001
2010-07-27T09:30:00-04:00,105.75,105.84,105,105.44,10259738,10905593.5,61.57604090062489,54.57941837398096,NaN,NaN,133.4959029418501,96.61955600944182,0.5118205912849592,0.6598171244044408,0.14799653311948163,139738275,118666980.4,60.16733937478202,43.13081902510176,NaN,NaN,9.26018266488953,-0.27853395864686736
2010-07-28T09:30:00-04:00,105.24001,105.55,104.69,105.09,7161285,10429817.3,59.9184694931626,55.22512906873194,NaN,NaN,113.1634151094707,114.2151393764425,0.49253852588311725,0.7636696904733782,0.27113116459026093,132576990,125852014.8,64.29664349376644,46.58280514295469,NaN,NaN,10.887905021289905,1.3166716099155287
2010-07-29T09:30:00-04:00,105.66,105.92999,103.92,104.67,11633281,10342031.15,57.90411526544562,55.58090649819074,NaN,NaN,94.84326731632771,116.46676569543979,0.42535794756019885,0.8028285990405095,0.37747065148031067,120943709,128632547,65.77527932478722,49.69165555543857,NaN,NaN,11.67956049704053,2.797084308076243
2010-07-30T09:30:00-04:00,103.8,105.13,103.53999,104.7,11705922,9999069.65,58.01269525055885,55.9096320087337,NaN,NaN,74.31145960106662,109.69941476970999,0.3594256981274822,0.8267527741396634,0.4673270760121812,132649631,131077428.4,67.06679799498858,52.24529989866502,NaN,NaN,12.360261301813939,4.163252450038771
2010-08-02T09:30:00-04:00,106.08,106.98801,105.88,106.73,6852961,9776347.2,64.65601449806852,56.36205415497147,NaN,NaN,139.75728052860887,111.1142650994648,0.4245482782870691,0.9980124238710175,0.5734641455839484,139502592,133082239.4,68.1288808867107,54.33723122745971,NaN,NaN,14.989740854637912,5.709893650695791
2010-08-03T09:30:00-04:00,106.48,106.83,106.06,106.39,5440016,9535722.8,62.86201231279649,56.681772947782214,NaN,NaN,130.07273282620537,110.42963107633587,0.4161841587678563,1.0936943440437688,0.6775101852759124,134062576,131947099.6,66.81499100741061,55.90652220660308,NaN,NaN,16.644105259636667,7.271923880544487
2010-08-04T09:30:00-04:00,106.64999,107.14999,106.38,106.96001,7293328,9287580.4,64.63371840654372,57.145171374450285,NaN,NaN,136.4931149755679,115.09557104955529,0.41932460489766277,1.2016659413979909,0.7823413365003281,141355904,133702882.4,67.8478564958092,57.35351098804852,NaN,NaN,18.554187118826903,8.88367577172769
2010-08-05T09:30:00-04:00,106.42999,106.88,106.23,106.88,3635388,8996292.75,64.17095575835074,58.37389128314197,NaN,NaN,115.40494793638909,119.20790717356758,0.3870727790903705,1.2661823103632912,0.8791095312729207,137720516,137058243.8,69.7833902923904,58.929132837492595,NaN,NaN,20.00242281052365,10.4720682058414
2010-08-06T09:30:00-04:00,105.92,106.73,105.31,106.69,7524992,9003595.65,63.0170998397006,59.350344468565446,NaN,NaN,87.67141396597522,121.87989804654929,0.32642693489396757,1.2871431998903802,0.9607162649964126,130195524,136567422.4,69.12783002931461,60.44061899556436,NaN,NaN,20.91729972209022,11.964244136734088
2010-08-09T09:30:00-04:00,107,107.3741,106.64,107.12,3723692,8859102.7,64.56979526801629,60.245175355725436,NaN,NaN,110.11045561247566,115.95053306332265,0.2899863839730368,1.3231992449627086,1.0332128609896718,133919216,135450747.2,67.57251382690836,61.82403383156869,NaN,NaN,22.117646866601763,13.414730241000898
2010-08-10T09:30:00-04:00,106.36,107.17999,105.67,106.66,8437297,8814012.65,61.59076466484544,61.230343267489275,NaN,NaN,79.02222509080596,105.74043151624275,0.21316885741213665,1.2996739327548426,1.086505075342706,125481919,133734615.8,65.14665112309054,63.22283853062782,NaN,NaN,22.376887945713236,14.695038484531231
2010-08-11T09:30:00-04:00,105.19,105.21001,103.91,104.13,9496137,8850928.3,48.37209319248816,60.75351996783677,NaN,NaN,-7.560541562331774,76.92970020866282,-0.01751769261886027,1.0646079595691305,1.0821256521879907,115985782,128660591.4,58.46368824733288,64.09592266796193,NaN,NaN,18.499150818795123,15.238483103711788
2010-08-12T09:30:00-04:00,102.85001,103.869,102.78,103.45,14562738,9003999.75,45.542879361296784,59.84916118219858,NaN,NaN,-51.42350457996791,43.564009705391435,-0.21445079105087106,0.8140621633744018,1.028512954425273,101423044,121401097,50.48426506899035,64.04215091912864,NaN,NaN,14.365184228613911,15.113726121554949
2010-08-13T09:30:00-04:00,103.21001,103.7959,103.10001,103.35001,6483668,8717202.3,45.124933713014336,58.71082770892236,NaN,NaN,-56.49794243446904,14.730138425302593,-0.3424006615747024,0.600512127456895,0.9429127890315974,94939376,114349867.4,44.177208540650284,63.20380969335232,NaN,NaN,10.902433206237097,14.512112847938113
2010-08-16T09:30:00-04:00,102.81,103.59,102.38,103.28,5820500,8643753.45,44.81482836704286,57.51359824223793,NaN,NaN,-79.7779556807144,-23.24754383333542,-0.4177121837033967,0.4207725594023515,0.8384847431057482,89118876,105389799.4,37.72724943279678,61.600946126067655,NaN,NaN,7.975209128006059,13.57826945937639
2010-08-17T09:30:00-04:00,103.99001,105.1181,103.67,104.33,5463801,8456719.85,50.328190993587675,56.82857834941115,NaN,NaN,-28.290449525493408,-44.710078756595294,-0.3836545821823246,0.3589165153778424,0.742571097560167,94582677,99209951,34.036191600603075,59.43948527655599,NaN,NaN,6.918613552126186,12.626890044054932
2010-08-18T09:30:00-04:00,104.25999,105.11,103.67999,104.57001,6346230,8233384.65,51.52046835320578,56.37260356996545,NaN,NaN,-35.43255028100181,-50.2844805003293,-0.33364913165641574,0.32550968298964733,0.6591588146460631,100928907,96198576,32.374063021744945,57.05368411205297,NaN,NaN,6.371206226517977,11.733220927263938
2010-08-19T09:30:00-04:00,104.08,104.31,102.55,103.06,8884734,8158159.85,44.313700849289724,55.3941039698748,NaN,NaN,-104.85898800190559,-60.97157718471683,-0.3871909808549623,0.17517008857736016,0.5623610694323224,92044173,94322801.8,31.34717642317436,54.50228257120909,NaN,NaN,3.670239549535845,10.581366444731353
2010-08-20T09:30:00-04:00,102.42999,102.48,101.47,102.14,8548641,7916383.1,40.5884473221413,53.674992028737144,NaN,NaN,-163.13366073041442,-82.29872084390591,-0.4642919728724296,-0.018003896658214558,0.44628807621421507,83495532,92034033,30.092894146442404,51.785426375475645,NaN,NaN,0.18145109925053846,9.095664252519809
2010-08-23T09:30:00-04:00,102.53999,103.05009,101.7,101.75999,5552355,7741335.2,39.12536716443435,51.9795173752827,NaN,NaN,-133.81512224239145,-93.10615415624133,-0.5165985021797714,-0.19946005151049917,0.3171384506692722,77943177,89798893.2,28.877696671500317,49.07561963719634,NaN,NaN,-3.1380090416342385,7.347996639069231
2010-08-24T09:30:00-04:00,100.73,101.14999,99.91,100.39999,9552891,7705992.85,34.35275811571324,49.816591640223386,NaN,NaN,-183.41579272473152,-124.13122279608895,-0.6119855877913065,-0.447843534069861,0.16414205372144555,68390286,84560415,26.206660797967587,46.10124851592194,NaN,NaN,-7.6323334498523545,5.2079494835090046
2010-08-25T09:30:00-04:00,99.91,100.98,99.37,100.61,9741121,7834984.65,35.65796093775195,47.779949153037755,NaN,NaN,-161.7085469997574,-149.38642213984005,-0.6277851735208945,-0.6205894131796725,0.007195760341221935,78131407,80000915,24.115842146905393,42.83928079124444,NaN,NaN,-10.875340763885589,2.9103365910240626
2010-08-26T09:30:00-04:00,100.96001,101.06,99.6701,99.929,8262996,7666470.4,33.34292849656741,45.6603654856711,NaN,NaN,-139.27428868631443,-156.26948227672182,-0.648303943038891,-0.8031841684573919,-0.15488022541850086,69868411,75565762.6,22.255795597609676,39.491278331836945,NaN,NaN,-14.336529123702732,0.4464986317773776
2010-08-27T09:30:00-04:00,100.53,101.6301,99.39999,101.58,10432363,7602792.45,43.004081839232164,44.11995738361509,NaN,NaN,-101.70098957885763,-143.98294804641048,-0.5204045698785033,-0.8053859377666299,-0.28498136788812667,80300774,74926811,21.992621897771244,36.235571765470006,NaN,NaN,-14.395186988187799,-1.6737421710747902
2010-08-30T09:30:00-04:00,101.23,101.53999,100.16,100.17,4731137,7496701.25,37.945798375851616,42.43103122011553,NaN,NaN,-99.76539540535029,-137.17300267900222,-0.5003440383733921,-0.9104114158548668,-0.4100673774814747,75569637,74452103,21.786497193923964,33.138417913386675,NaN,NaN,-16.124172657897915,-3.7380893834780937
2010-08-31T09:30:00-04:00,99.89,100.85001,99.52,100.2,10529504,7751175.65,38.11259320941084,41.69820979275287,NaN,NaN,-104.65689899076185,-121.42122393220829,-0.45588858867216153,-0.9799281133216766,-0.5240395246495151,86099141,77993874,27.26398184894991,30.90986745635933,NaN,NaN,-17.421160743310804,-5.6928138634541945
2010-09-01T09:30:00-04:00,101.36,102.89999,101.33,102.8,8515594,7812288.95,50.52449691238594,42.05403961783066,NaN,NaN,-27.157646410414376,-94.51104381433971,-0.23342284666442337,-0.8158180829800443,-0.582395236315621,94614735,81290539.6,32.035131269827914,29.592072184990577,NaN,NaN,-14.276039268226109,-6.918988921278753
2010-09-02T09:30:00-04:00,102.91,103.28999,102.62,103.28,3787349,7819887,52.4216318726671,42.57523234352015,NaN,NaN,5.355547395511588,-65.5850765979745,-0.045807153283975555,-0.6396541779205904,-0.5938470246366149,98402084,86997274.2,39.440599531551335,29.253742970054937,NaN,NaN,-11.156199592986752,-7.524304731522753
2010-09-03T09:30:00-04:00,104.22,104.63,103.29289,104.57899,6282641,7757769.45,57.20417272115155,43.46018551167077,NaN,NaN,55.528786962015715,-34.139121289799824,0.16250051236548735,-0.39072138417975566,-0.553221896545243,104684725,91874064.4,44.959834160362384,29.770356164881054,NaN,NaN,-6.876837016791905,-7.431809343704061
2010-09-07T09:30:00-04:00,104.16,104.28999,103.41,103.56,4208301,7781999.9,52.726741946026884,43.631510579702145,NaN,NaN,49.8001944592854,-4.226003316872671,0.22455923340337797,-0.27252285479102056,-0.49708208819439853,100476424,96855421.8,49.974972727705726,30.908840531102673,NaN,NaN,-4.832209497246945,-7.06043793706733
2010-09-08T09:30:00-04:00,103.71001,104.39999,103.67999,103.98,5743141,7647292.1,54.31400289096984,43.83104876097101,NaN,NaN,73.1380337553107,31.33298323234184,0.28301989270804195,-0.14330722230934612,-0.42632711501738807,106219565,100879506.6,53.64918844680654,32.428492347178505,NaN,NaN,-2.6896333890031126,-6.43603728734387
2010-09-09T09:30:00-04:00,104.98,105,103.97,104.25,4403844,7392677.45,55.351854767773595,44.619488326577006,NaN,NaN,92.21915374397216,55.20834326321915,0.3259430431047817,-0.01889831113641094,-0.34484135424119267,110623409,104081241.4,56.39348839988805,34.21751463122948,NaN,NaN,-0.6489457969299904,-5.609309931570459
2010-09-10T09:30:00-04:00,104.42,104.82001,104.14999,104.78,3524027,6840741.9,57.39774191899093,45.82015222635197,NaN,NaN,94.11433831352099,72.96010144682103,0.3727271839245156,0.12106762566445184,-0.25165955826006375,114147436,107230311.8,58.96679409868571,36.27993605638971,NaN,NaN,1.6648428947741305,-4.570145242092661
2010-09-13T09:30:00-04:00,105.64999,105.86,105.06,105.67,4944844,6763800.7,60.657871938337024,47.35818828163074,NaN,NaN,125.42697830873824,86.93973971616553,0.44160365509990646,0.30034501061481933,-0.14125864448508713,119092280,110111822.8,61.22181273348219,38.590230060816985,NaN,NaN,4.645387955825687,-3.2536404995328967
2010-09-14T09:30:00-04:00,105.48,106.07001,105.17,105.44,5079871,6726769.25,59.39296144569738,49.14677423377246,NaN,NaN,112.90449644531586,99.56060011337163,0.44823426497767604,0.419034186737008,-0.029200078240668087,114012409,112819019.8,63.26442434777398,41.237213171517446,NaN,NaN,6.724262940445426,-1.8282257223931362
2010-09-15T09:30:00-04:00,105.2,106.06,104.98,105.94,4382559,6672707.15,61.28312661148006,50.977143210467325,NaN,NaN,110.41611831242214,107.01621702479392,0.4610680653990169,0.5471350035081031,0.08606693810908614,118394968,115254100.4,65.04783180772057,44.160926718718535,NaN,NaN,9.02852554231725,-0.2772612560059382
2010-09-16T09:30:00-04:00,105.67,106.24001,105.39999,106.19,5452391,6628015.2,62.22980476452978,53.04049151532178,NaN,NaN,114.16082776844812,111.4045518296891,0.4601118531124243,0.6612067544996165,0.20109490138719222,123847359,117898890.4,66.92591204643676,47.351649322206185,NaN,NaN,11.218078595235209,1.3649301513142256
2010-09-17T09:30:00-04:00,106.35001,106.49001,105.64999,106.07001,7777996,6572678.3,61.45313597287128,54.35828109629601,NaN,NaN,105.92758718603507,113.76720160419192,0.42590186882536163,0.7334722374188942,0.3075703685935326,116069363,118283275.8,67.2017481382382,50.58087262509668,NaN,NaN,12.841741942317602,3.004474692886136
2010-09-20T09:30:00-04:00,106.39999,107.72009,106.2,107.52,5261266,6408309.55,66.83915242414975,56.422092099745875,NaN,NaN,126.84729841957213,114.05126562635868,0.47186414771698404,0.8974005532397626,0.4255364055227786,121330629,118730945.6,67.54127200461045,53.849070825860004,NaN,NaN,15.94054693539917,4.852485013245141
2010-09-21T09:30:00-04:00,107.53999,108.31,107.17,107.62,8385320,6549957.8,67.17974893835586,58.49831750895623,NaN,NaN,129.4460172218582,117.35956978166716,0.4784387475474421,1.0235848399570813,0.5451460924096392,129715949,121871653.6,69.89578637231651,56.8941997203862,NaN,NaN,18.58349597905279,6.814058008360519
2010-09-22T09:30:00-04:00,107.56,108.03999,107.08,107.39999,5594988,6352062.65,65.58373088403265,59.57397707835956,NaN,NaN,114.63130302854366,118.20260672489147,0.4384685125392357,1.0932317330836838,0.6547632205444481,124120961,123016852.2,70.72953923568134,59.65808600366144,NaN,NaN,20.381323619362135,8.752238809932178
2010-09-23T09:30:00-04:00,106.64,107.62,106.41,106.67,7549313,6242472.25,60.45194121757856,60.1475706029961,NaN,NaN,88.15418666509257,113.00127850422037,0.33787509191737786,1.0771070854411704,0.7392319935237925,116571648,121561710,68.14689013430743,61.70853533242973,NaN,NaN,20.55877846262947,10.438887331746077
2010-09-24T09:30:00-04:00,107.77,108.66,107.67,108.57001,5336371,6096141,67.56572395021445,60.887681405072,NaN,NaN,124.75213144932354,116.76618735687805,0.37162787651179396,1.203766839163535,0.832138962651741,121908019,122729441.2,69.12130879174057,63.434354948956745,NaN,NaN,22.937377095532963,12.224385869429918
2010-09-27T09:30:00-04:00,108.57001,108.73,108.08,108.19,3990299,5774037.8,65.04562642193406,61.76760172477965,NaN,NaN,115.87555819368805,114.57183931170123,0.34146431811426436,1.2589693602945715,0.9175050421803072,117917720,122046859.4,67.81538307475776,64.70866997374618,NaN,NaN,24.1270183260159,13.924761934656487
2010-09-28T09:30:00-04:00,108.36,108.87,107.3,108.56,7873055,5931133.7,66.36122229660137,62.628117396610484,NaN,NaN,107.19812966534067,110.12226180039772,0.3199060775566085,1.3173876391260677,0.9974815615694592,125790775,121261824.6,66.26475373169988,65.60978177980999,NaN,NaN,25.500223790038024,15.578399342568135
2010-09-29T09:30:00-04:00,108.35001,108.71001,108,108.31,6283223,5718819.65,64.59223680223943,63.288144684786616,NaN,NaN,104.53408949268588,108.10281909322616,0.264575519873562,1.3282009614114116,1.0636254415378497,119507552,120339142.8,64.40086823271949,66.18173748215509,NaN,NaN,26.134257151808832,17.08637902960252
2010-09-30T09:30:00-04:00,108.91,109.52,107.47,107.91,11671676,5876623.75,61.755680096717896,63.599425983195694,NaN,NaN,93.24775002605183,109.12153176541801,0.18080197665741649,1.2896279123596202,1.1088259357022037,107835876,118591988.4,60.90729410659361,66.32034462557708,NaN,NaN,25.871890674459202,18.341452121724902
2010-10-01T09:30:00-04:00,108.55,108.7278,107.84,108.32001,5989238,5986718.2,63.52390935797196,63.80414294174104,NaN,NaN,84.34063586387566,101.03923264832845,0.13487333029761106,1.2774175985742175,1.1425442682766065,113825114,116975407.4,57.78383742457187,66.07477496065492,NaN,NaN,26.135006855857874,19.454817083743897
2010-10-04T09:30:00-04:00,108.16,108.55,107.07001,107.57001,5564016,5950786.95,58.22112774239725,63.72044053436246,NaN,NaN,52.97157292488549,88.45843559456793,0.040736255838580426,1.193464588074832,1.1527283322362516,108261098,115044083,54.20727199972667,65.42783550722297,NaN,NaN,24.842370593929726,20.224467585199015
2010-10-05T09:30:00-04:00,108.41,109.67999,108.27,109.39999,6496563,6065200.05,65.73674856664815,64.03855638830302,NaN,NaN,111.88896652128474,89.39660296575674,0.0858733437258472,1.2600700118935606,1.1741966681677134,114757661,112837460.2,50.3710941302907,64.37949710169225,NaN,NaN,25.98876604961434,21.047938794401205
2010-10-06T09:30:00-04:00,109.44,109.83,109.2701,109.77,7220844,6139085.2,67.02827019132488,64.38130391878839,NaN,NaN,129.2779922086056,94.34538350894067,0.1225710202856789,1.327410443524812,1.204839423239133,121978505,113331650.8,51.2039633179555,63.2565007639436,NaN,NaN,27.321166545100272,21.944114187358213
2010-10-07T09:30:00-04:00,110.09,110.11,109.00999,109.60001,5286301,6183208.05,65.80111092657103,64.69187355833837,NaN,NaN,119.58334809219592,99.6125031221695,0.11731438186841614,1.3514824005746533,1.2341680187062372,116692204,115102916.4,54.17249828042518,62.32584005981409,NaN,NaN,28.0380662178105,22.81467876313711
2010-10-08T09:30:00-04:00,109.66,110.41,109.3799,110.16,4813703,6247691.85,67.88688351100507,64.76671149311376,NaN,NaN,136.02732002659994,109.94983995471435,0.13235538831276417,1.3996122540971925,1.2672568657844283,121505907,116639075,56.63638185468437,61.54691933481938,NaN,NaN,29.261553256001875,23.735660833546362
2010-10-11T09:30:00-04:00,110.28999,110.39999,109.875,110.25999,3527533,6176826.3,68.25913351794063,64.84381039165552,NaN,NaN,135.197400874285,126.39500554459426,0.12967230085490966,1.4293472418530655,1.2996749409981558,125033440,119993543.4,61.50365610011107,60.94748145823327,NaN,NaN,30.368842059654476,24.683258151561805
2010-10-12T09:30:00-04:00,109.92999,110.63,109.21001,110.25999,5379855,6191825.5,68.25913351794063,65.03491057979181,NaN,NaN,119.25757011178978,127.86872626269526,0.10934406898125215,1.436355027224721,1.3270109582434688,125033440,122048699.2,64.15800614968795,60.478086237805165,NaN,NaN,31.28083926863827,25.625769739715587
2010-10-13T09:30:00-04:00,110.82001,111.64011,110.66,111.06,6922363,6318815.7,71.34169004507514,65.81274978175585,NaN,NaN,168.50020442031877,135.7131687050379,0.1298273939161798,1.4892952006386935,1.3594678067225137,131955803,124044158.8,66.56835203057479,60.36533351610998,NaN,NaN,32.96754672114233,26.67459502277655
2010-10-14T09:30:00-04:00,111.05,111.23,110.30991,111.07001,8978738,6495133.05,71.379144047494,66.08513693156154,NaN,NaN,131.61394665798113,138.11928841819494,0.12410498495924527,1.5145990379215704,1.390494052962325,140934541,128892626.2,71.57095171623664,60.54030801071684,NaN,NaN,34.37072505450038,27.774042170165668
2010-10-15T09:30:00-04:00,111.42999,111.47,110.11,110.67999,9378262,6575146.35,67.66831858534889,66.27247208609117,NaN,NaN,110.86618244964788,133.08706090280452,0.07644546740011693,1.4860508872124711,1.4096054198123542,131556279,130902700.6,73.35130522568323,60.93573102149724,NaN,NaN,34.600801703730255,28.749293532103465
2010-10-18T09:30:00-04:00,110.67999,111.59,110.55,111.00999,4437441,6533955.1,69.130626250217,66.47028665420656,NaN,NaN,114.92243493472981,129.0320677148935,0.050774732908459796,1.473073835947929,1.4222991030394692,135993720,133094756.6,75.17697734453051,61.572318422413716,NaN,NaN,35.187131497802646,29.668984670060492
2010-10-19T09:30:00-04:00,110.28999,110.67999,109.17,109.84,9258605,6577619.35,58.95054621474287,66.06730875509967,NaN,NaN,41.74492260607519,113.52953821375058,-0.05560973946591474,1.3527869287070757,1.4083966681729905,126735115,133435091.6,75.45809925061026,62.36212063797734,NaN,NaN,32.743804148396706,30.108244595537094
2010-10-20T09:30:00-04:00,110.09,111.58,109.8186,111.09,7394605,6667600.2,64.897930132608,66.29175518623468,NaN,NaN,89.85689219129053,97.80087576794492,-0.052442315119316074,1.3428437742738453,1.3952860893931613,134129720,133869875,75.83461638313781,63.42835794344478,NaN,NaN,32.3478082040221,30.428182253892096
2010-10-21T09:30:00-04:00,111.58,112.21001,110.7,111.53999,6992844,6639776.75,66.76472012841944,66.52324166983807,NaN,NaN,123.01914582425147,96.08191560119899,-0.031711168485726304,1.3556471287860035,1.3873582972717298,141122564,133907479.6,75.86909920382227,64.72016235624838,NaN,NaN,32.59583663153181,30.737847164983485
2010-10-22T09:30:00-04:00,111.59,111.67999,111.14999,111.36,3550447,6550480.55,65.2695064382701,67.02669729097184,NaN,NaN,106.48863393811033,95.20640589889148,-0.041189757635991864,1.3358711002267398,1.3770608578627317,137572117,135110647.2,76.9999559569941,66.34821121033892,NaN,NaN,32.351450011080765,30.968361857283096
2010-10-25T09:30:00-04:00,111.89999,112.55,111.6573,111.71001,6127621,6657346.65,66.82539590157731,67.10445781489535,NaN,NaN,131.12477213744046,98.44687333943361,-0.03518909899700118,1.33307448411648,1.3682635831134813,143699738,136651850.8,78.39656678889716,68.35003068595367,NaN,NaN,32.597563796776576,31.20110499149645
2010-10-26T09:30:00-04:00,111.2,111.91,110.92999,111.75999,5371859,6532286.85,67.05237838160862,67.10617982848706,NaN,NaN,93.90783368004274,108.87945555422712,-0.03886792276862794,1.3196786796526965,1.3585466024213244,149071597,141119147.2,81.83893610337549,70.53824302776938,NaN,NaN,32.86206865776155,31.43838551524861
2010-10-27T09:30:00-04:00,111.12,111.46001,110.25999,111.31,7612758,6598763.6,62.88084024157062,66.89758906527274,NaN,NaN,53.40345286259643,101.58876768848829,-0.08023913809217653,1.2582476798061037,1.3384868178982803,141458839,142584971,82.80700846326575,72.58356518368656,NaN,NaN,31.920429644803416,31.507248962327868
2010-10-28T09:30:00-04:00,111.77,111.86011,110.58,111.10001,5658832,6298121.4,60.97445616724681,66.4038442550043,NaN,NaN,59.136910958458444,88.81232071532969,-0.12756734620488297,1.1790276351421767,1.3065949813470596,135800007,141520459.6,79.49303633907013,74.2161833611427,NaN,NaN,30.59847660435921,31.377424339760918
2010-10-29T09:30:00-04:00,111.02,111.38,110.81,111.31,5972215,6297270.25,62.20833571705735,65.97164441208407,NaN,NaN,53.039009286806355,78.12239578506889,-0.14905536487991533,1.1202757752471655,1.2693311401270808,141772222,142360480.6,80.16753780921475,75.54931776893581,NaN,NaN,29.80010038886034,31.15209234677512
2010-11-01T09:30:00-04:00,111.67999,112.50999,110.67,111.32001,9428434,6490491.15,62.26957578135638,65.5438188594709,NaN,NaN,79.56789329561033,67.81102001670286,-0.1656433450597561,1.0622769588023857,1.2279203038621418,151200656,143860664.2,81.34747304021998,76.77713683254524,NaN,NaN,29.14801773411886,30.86579597353851
2010-11-02T09:30:00-04:00,112.00999,112.28,111.85001,111.88,4073521,6369339.05,65.6254629846283,65.13551692658184,NaN,NaN,127.45454310783545,74.52036190226139,-0.14281453327292293,1.049402137270988,1.192216670543911,155274177,145101180.2,82.28598781252445,77.8998251026845,NaN,NaN,29.451971532222686,30.663821053350535
2010-11-03T09:30:00-04:00,112.07001,112.37,111.06,112.3,10113074,6513950.55,67.92942896350871,64.88910870629718,NaN,NaN,110.46825057096986,85.93332144393608,-0.1050850954963356,1.0608603011734914,1.165945396669827,165387251,149886862.6,85.34869765225785,78.8839498124003,NaN,NaN,30.351017265976843,30.619134798011437
2010-11-04T09:30:00-04:00,113.31,114.52,113.23511,114.42999,9356703,6717470.65,76.52330550473462,65.5216077719676,NaN,NaN,303.7640114416459,134.85874154057356,0.049373003645086566,1.2276616512261853,1.1782886475810987,174743954,157675652,88.75605930880329,79.98428938976602,NaN,NaN,34.24725679450703,31.13743794036795
2010-11-05T09:30:00-04:00,114.45,114.63,114.05,114.53999,6348559,6794213.45,76.86804775223023,66.0742807363971,NaN,NaN,264.6684254582679,177.18462477486588,0.13987384373564238,1.3531309522506518,1.2132571085150095,181092513,165539710.2,91.0254785901879,81.11632519302727,NaN,NaN,37.41119556743319,32.0336890299487
2010-11-08T09:30:00-05:00,114.14,114.35001,113.78,114.22,4081641,6821918.85,73.48740799759746,67.112628006601,NaN,NaN,189.91775115389598,199.25459634652302,0.15778355127962373,1.4104865476145392,1.2527029963349154,177010872,170701753.4,92.14605990790257,82.30832238283385,NaN,NaN,38.96181776193844,33.02342170594723
2010-11-09T09:30:00-05:00,114.38,114.41,113.23,113.69,5847289,6845290.55,68.14187209778008,67.34433814697044,NaN,NaN,136.64868328390676,201.0934243817373,0.11549371859546431,1.3970701445792457,1.2815764259837814,171163583,173879634.6,92.74651368634024,83.51631504734833,NaN,NaN,38.61790215581028,33.82263319878481
2010-11-10T09:30:00-05:00,113.62,113.89,112.75999,113.73,9956859,6997015.35,68.32911584072187,67.45608069784917,NaN,NaN,99.1200732865553,198.82378892485437,0.0738017180945616,1.3738285736019833,1.3000268555074217,181120442,177026272.8,93.29327331771336,84.76089891262625,NaN,NaN,38.39613154159795,34.47599010490097
2010-11-11T09:30:00-05:00,112.89999,113.25999,112.53,113.08,5517805,6823968.7,61.956576526001996,67.2194428469729,NaN,NaN,58.492765183703305,149.76953967326585,-0.00953240629508767,1.2881113476385622,1.2976437539336498,175602637,177198009.4,93.32285624227305,85.92682036157476,NaN,NaN,36.272930958635314,34.732695941148734
2010-11-12T09:30:00-05:00,112.46001,112.99001,111.64999,112.16,8696652,6789888.2,54.24527334427623,66.32086266430852,NaN,NaN,10.80617775338547,98.99709013228934,-0.13180753764118647,1.1328843318821669,1.2646918695233533,166905985,174360703.8,86.53184572087841,86.50791171385913,NaN,NaN,31.89660752875179,34.32754045366346
2010-11-15T09:30:00-05:00,112.32001,113.03,112.17999,112.24989,6610652,6898548.75,54.83674486547214,65.44831741315592,NaN,NaN,20.718614877598856,65.15726287702994,-0.2073310367466601,1.0055280735900283,1.2128591103366884,173516637,173661856.8,84.89321891378306,86.72607477174539,NaN,NaN,28.566748873684432,33.50457022795217
2010-11-16T09:30:00-05:00,111.59,111.74001,110.07001,110.5,9552219,6913229.45,43.14429953206763,64.03856450533428,NaN,NaN,-98.08591807125032,18.210342605998534,-0.36653036404050665,0.7546961552860552,1.1212265193265618,163964418,172222023.8,81.47013742241026,86.63058398311286,NaN,NaN,21.22254062629507,31.749994570572586
2010-11-17T09:30:00-05:00,110.64,110.78999,110.25999,110.44,5566695,6821833.95,42.80726350126043,62.74090788633525,NaN,NaN,-113.97287023229079,-24.408246097770682,-0.46115035882154953,0.544788570799625,1.0059389296211745,158397723,167677480,71.6498862441599,86.07035897633355,NaN,NaN,15.43397538139499,29.41913468640436
2010-11-18T09:30:00-05:00,111.36,112.37,111.35001,112.14999,7162008,6830292.15,53.86796199479799,62.14516690617387,NaN,NaN,-18.07976609260078,-39.7227523530315,-0.39632546088508414,0.5105321035148194,0.9068575643999035,165559731,165668898.8,67.76216427120602,85.18426086647578,NaN,NaN,13.96832529557607,27.21187620200032
2010-11-19T09:30:00-05:00,111.66,112.06,111.1801,112.00999,4475441,6876541.85,52.964835765511936,61.480542619327835,NaN,NaN,-33.890889260448176,-48.662165755798235,-0.35212055541434517,0.4667068701319721,0.8188274255463173,161084290,164504559.8,65.54205434687827,84.05530238837994,NaN,NaN,12.541645029561177,25.11612889165187
2010-11-22T09:30:00-05:00,111.55,111.86,110.53999,111.82001,6815645,6910943.05,51.69818258602996,60.48573687657081,NaN,NaN,-54.44620856571246,-63.695130444460496,-0.3255442088005568,0.4118971645456213,0.7374413733461781,154268645,160654961.4,58.69492650296744,82.37022658055444,NaN,NaN,11.010009813470226,23.100969023340205
2010-11-23T09:30:00-05:00,110.78,110.81,109.89999,110.39,6622797,6973489.95,43.303424191398136,58.72673653570577,NaN,NaN,-115.44509168319694,-67.16696516684982,-0.3898041139223485,0.25018623094324255,0.639990344865591,147645848,157391247.4,53.58394376641701,80.10131558870867,NaN,NaN,6.733747593047634,20.76279453329841
2010-11-24T09:30:00-05:00,111,111.96001,111,111.85001,4298910,6807797.55,51.89251203710095,56.967394145160505,NaN,NaN,-38.296027868950326,-52.03159669418172,-0.32230704421918666,0.23710653959160766,0.5594135838107943,151944758,156100654.4,51.667980271555074,77.45216708604809,NaN,NaN,6.098823798712819,18.667941571214755
2010-11-26T09:30:00-05:00,110.94,111.35001,110.64,110.92,2330192,6641365.55,47.00741642727676,54.83449190766383,NaN,NaN,-78.85186678481843,-64.18601683262526,-0.32755645310769504,0.1499680174261755,0.47752447053387054,149614566,152911621.4,47.178924664872085,74.32027037709695,NaN,NaN,3.8264357753670653,16.547726457522227
2010-11-29T09:30:00-05:00,110.25999,110.86,109.39999,110.64999,6044570,6644983.3,45.66337307825604,52.84706084199659,NaN,NaN,-115.83122562746472,-80.57408410602856,-0.33526053722164745,0.058448799006811214,0.39370933622845866,143569996,149408762.6,42.7820563685882,70.79427012428879,NaN,NaN,1.6153521270897722,14.414530124603305
2010-11-30T09:30:00-05:00,109.67,110.75999,109.56,110.17,8064809,6576802.05,43.29359556938597,51.07218394711129,NaN,NaN,-114.6394664885457,-92.6127356905952,-0.35673560986016706,-0.05221017609675016,0.3045254337634169,135505187,145656071,38.628602917857414,66.92870506939717,NaN,NaN,-0.9440615065758304,12.220445605863429
2010-12-01T09:30:00-05:00,111.67999,112.89999,111.59,112.67,7314785,6738865.25,56.078768250638284,50.19715911924818,NaN,NaN,18.222825897924967,-65.87915217437083,-0.1947272399088666,0.061116383877333647,0.25584362378620024,142819972,144690895.8,37.617068640645044,62.95183330674943,NaN,NaN,1.4217594223248482,10.677776151072203
2010-12-02T09:30:00-05:00,112.77,113.87,112.75,113.74001,6150520,6540737.55,60.21346029056654,50.07265081671708,NaN,NaN,73.2342042461776,-43.57310575134524,-0.01702254757982058,0.23456543931142448,0.25158798689124506,148970492,144096042.6,36.974437873840614,58.92694628043283,NaN,NaN,4.870108022866764,9.848109275614284
2010-12-03T09:30:00-05:00,113.34,114.02,113.31,113.94,4552879,6300546.35,60.95333424441186,50.551798023869615,NaN,NaN,92.44021100869008,-9.314690192643535,0.1057208758669218,0.38373908172489735,0.27801820585797554,153523371,144877803.6,38.462313440373535,55.493408260396755,NaN,NaN,7.740207093833136,9.546980392502691
2010-12-06T09:30:00-05:00,113.78,114.05,113.63,113.74001,6181090,6292172.9,59.75661509190281,50.90321732575752,NaN,NaN,99.5890052586944,33.76935598458829,0.16181447923896702,0.48028630490668434,0.3184718256677173,147342281,145632260.6,39.93601386852787,52.28217932859281,NaN,NaN,9.599129076557409,9.554430204510508
2010-12-07T09:30:00-05:00,114.62,114.71001,113.67,113.73,7621059,6469143.8,59.69344203731388,52.08529893327511,NaN,NaN,113.7468842091053,79.44662612411848,0.18494801907291725,0.5496568495088638,0.3647088304359466,139721222,146475467.6,41.61878693831865,49.435654294014846,NaN,NaN,11.043304351881474,9.76712651127779
2010-12-08T09:30:00-05:00,113.7,114.08,113.45,113.89,6518668,6502712.75,60.413819434240345,53.3429100713451,NaN,NaN,99.95614461476183,95.79328986748587,0.19663823831831262,0.6105066283338374,0.4138683900155248,146239890,147159451.2,43.01348334673467,47.390196944198756,NaN,NaN,12.430903004766076,10.147666010347544
2010-12-09T09:30:00-05:00,114.35001,114.39,113.50999,113.92,5239203,6266829.95,60.55616679983736,53.82063898599076,NaN,NaN,104.18784803457181,101.98401862516471,0.19179871068548515,0.6536167783723812,0.46181806768689604,151479093,147661171.4,44.068987223371764,45.69782715506775,NaN,NaN,13.605958493245963,10.641707793618746
2010-12-10T09:30:00-05:00,114.10001,114.34,113.77,114.28999,8295770,6405728.2,62.35411335476593,54.49130167093749,NaN,NaN,106.52407317433375,104.80079105829343,0.19811257344208222,0.7094587844894988,0.5113462110474166,159774863,148911469.8,46.717540754185016,44.35321904130394,NaN,NaN,15.10787709129691,11.27973197900134
2010-12-13T09:30:00-05:00,114.67,115.0303,114.42999,114.49001,4763180,6209054.6,63.32732735136691,55.32195486846155,NaN,NaN,116.88169368617824,108.2593287437902,0.19978755515082358,0.7610806549859461,0.5612930998351225,164538043,152350622.2,53.272249186157644,43.9658849472461,NaN,NaN,16.64199323749212,12.04576930164288
2010-12-14T09:30:00-05:00,114.63,115.38,114.59,115.00999,5215945,6139319.25,65.80238083313128,56.92902320001393,NaN,NaN,116.39169188537787,108.78829027904472,0.21843091424391603,0.8343317426400176,0.6159008283961016,169753988,158357175.4,62.05256492458004,44.570786458543466,NaN,NaN,18.67216956101389,12.992397910124453
2010-12-15T09:30:00-05:00,114.91,115.44,114.67999,114.89,5858984,5954657.5,64.71694751655801,57.84505430568942,NaN,NaN,104.0164111645705,109.60034358900646,0.2053931693080857,0.8726422900312087,0.667249120723123,163895004,161888198.2,66.08682244261985,45.60070375647667,NaN,NaN,20.10287201815795,14.008179925557808
2010-12-16T09:30:00-05:00,114.99001,115.39,114.42,115.24001,8115781,6082111.8,66.45517705963346,59.23418006514347,NaN,NaN,95.36924548706499,107.83662307950507,0.20270795167997802,0.9206340603230956,0.7179261086431176,172010785,165994536.6,70.07159599376043,47.235894565682976,NaN,NaN,21.813198702307368,15.123182607950602
2010-12-17T09:30:00-05:00,114.92999,114.99001,114.48,114.95,4622379,5955130.35,63.65682005045263,60.51942627744323,NaN,NaN,78.50940365623147,102.23368917588462,0.16534566752969393,0.924608193055235,0.7592625255255411,167388406,167517245.2,71.41297313099487,49.280960048712025,NaN,NaN,22.57112795796004,16.187174800809093
2010-12-20T09:30:00-05:00,115.14,115.14999,114.38,114.75,6742676,6068492.1,61.72642096658633,61.836056662957546,NaN,NaN,70.85546455653669,93.02844334995632,0.11357443426104641,0.9012305683518491,0.7876561340908027,160645730,166738782.6,69.69323005187712,51.49986198685629,NaN,NaN,22.7268716800088,17.121417212123337
2010-12-21T09:30:00-05:00,115.11,115.46001,114.99001,115.31,4785215,5966970.6,64.93301043457981,62.46850253323908,NaN,NaN,87.81600919156394,87.31330681119354,0.10372844982061324,0.9173166963665693,0.8135882465459561,165430945,165874174,67.74198918575793,53.651642025792924,NaN,NaN,23.723016001309485,18.064502753435644
2010-12-22T09:30:00-05:00,115.35001,115.66,115.25,115.58,3488310,5810246.25,66.39488494325015,62.910032865573626,NaN,NaN,97.73082491117923,86.05618956051528,0.10193300126635896,0.9410044981289047,0.8390714968625458,168919255,166879024.2,68.8340992976675,55.92733212749484,NaN,NaN,24.973642531608395,19.051522721746036
2010-12-23T09:30:00-05:00,115.50999,115.78999,115.39999,115.73,3578796,5774240.55,67.21265285665675,63.35712705216255,NaN,NaN,101.99089843957749,87.38052015101779,0.0973871474338911,0.9608054311549097,0.8634182837210186,172498051,166976477.4,68.94391262464472,58.104589212085656,NaN,NaN,26.255321351289407,20.080636811680804
2010-12-27T09:30:00-05:00,115.36,115.63989,115.1494,115.53999,4139074,5864684.65,65.05310615734518,63.73544784255129,NaN,NaN,87.02814055961244,89.084267531694,0.0694350851437654,0.9502121401507253,0.8807770550069599,168358977,167170591.6,69.1768814601017,60.19322261148378,NaN,NaN,26.808557293088263,21.04176830902473
2010-12-28T09:30:00-05:00,115.77,115.88,115.34,115.78999,4738563,5799384.3,66.57482187748735,64.22697497399226,NaN,NaN,97.28407958673229,94.3699905377331,0.05619991179191797,0.9510269447468573,0.8948270329549394,173097540,169660953.6,72.07148320076996,62.36841520165888,NaN,NaN,27.68418988284443,21.99068567671326
2010-12-29T09:30:00-05:00,115.71001,115.98,115.62,115.64999,6626977,5727492.7,64.87129028203313,64.54536574883458,NaN,NaN,104.47188817060275,97.70116633354085,0.02786582911433877,0.9296593193478628,0.9017934902335241,166470563,169868877.2,72.30533159947373,64.46069007685453,NaN,NaN,28.007657079913788,22.85025302002762
2010-12-30T09:30:00-05:00,115.53,115.71001,115.2641,115.45,6599480,5691727.45,62.414377437799246,64.67809508011757,NaN,NaN,76.37806713734489,93.430614778774,-0.012338571493985429,0.8863702758660423,0.8987088473600278,159871083,168059242.8,67.04374711509672,66.10174435483488,NaN,NaN,27.667460749110518,23.538425552753747
2010-12-31T09:30:00-05:00,115.32001,115.73,115.03999,115.63,3725832,5570493.05,63.745293056535026,64.77746505881537,NaN,NaN,70.09659392478814,87.05175387581612,-0.033597280126151374,0.8567122472023385,0.8903095273284899,163596915,166279015.6,62.24508098505253,67.21085437132542,NaN,NaN,27.70242378352295,24.13328244286363
2011-01-03T09:30:00-05:00,116.41,116.86,116.36,116.41,9112031,5798450.65,68.88669645663612,65.17456285204888,NaN,NaN,175.052894128646,104.65670458962283,-0.0034996061438443693,0.8859350196486844,0.8894346257925287,172708946,167149009.4,63.61565418340287,67.9496690139858,NaN,NaN,29.15697524037284,24.850952842507805
2011-01-04T09:30:00-05:00,116.71001,116.73,116.11,116.64,9781328,5978462.55,70.22745672975087,65.49063970180742,NaN,NaN,151.6493862958353,115.52976593144345,0.022117744929155747,0.9170818069539735,0.8949640620248177,182490274,169027556.2,66.44794811221831,68.26362495595997,NaN,NaN,30.775124373188987,25.697263061176546
2011-01-05T09:30:00-05:00,116.46001,117.19,116.3,117.03999,7568746,5975846.9,72.4508637633215,66.04306229086195,NaN,NaN,169.54499821262874,128.54438793984863,0.054381966384660085,0.9629415200056428,0.9085595536209827,190059020,173745247.6,72.28319360685043,68.70622289626215,NaN,NaN,32.832157766888365,26.71653373342109
2011-01-06T09:30:00-05:00,117.14,117.19,116.5,116.78,7163152,6008071.1,68.85163468058246,66.21423783521546,NaN,NaN,153.60545229889095,143.98986497215785,0.04687864435373368,0.9671578590631498,0.9202792147094161,182895868,178350204.6,76.56715710552011,69.17019154710212,NaN,NaN,33.59518134306977,27.699197677656617
2011-01-07T09:30:00-05:00,116.91,117.10001,115.82001,116.57001,9250637,6208642.8,65.99973171414474,66.38158866833632,NaN,NaN,107.30326234939349,151.43119865707894,0.017927170308207452,0.9426881775946754,0.9247610072864679,173645231,180359867.8,78.15407819763078,69.65169905186183,NaN,NaN,33.457091473263674,28.52175393417191
2011-01-10T09:30:00-05:00,116.16,116.34,115.56,116.2,6166684,6102188.5,61.19020923603368,66.3432878304397,NaN,NaN,47.694488224851604,125.95951747632004,-0.03320286800234651,0.8832574222835348,0.9164602902858813,167478547,179313788,75.29565526141899,70.05187228111483,NaN,NaN,31.973240984190358,29.014823512745977
2011-01-11T09:30:00-05:00,116.63,116.86,116.17,116.55,5124156,6120237.3,63.87210395670969,66.26750879630613,NaN,NaN,93.62275798228015,114.354191813609,-0.04952864744961816,0.8545494809738585,0.9040781284234767,172602703,177336273.8,70.0777692221277,70.2187137122841,NaN,NaN,31.43164765012678,29.36008410380038
2011-01-12T09:30:00-05:00,117.14999,117.64999,117.00999,117.39999,5259523,6122416.2,69.40207497814689,66.48230808451304,NaN,NaN,158.2449809833987,112.094188367763,-0.011162887837882551,0.8901245186261235,0.9012874064640061,177862226,174896915,64.17032451667552,69.88558694221324,NaN,NaN,32.63748464602774,29.82828418126143
2011-01-13T09:30:00-05:00,117.37,117.38,116.82001,117.2,6066180,6132776,66.81084306140832,66.45360738485242,NaN,NaN,117.87553530505038,104.94820496899487,-0.007510555786278905,0.8918992117311575,0.8994097675174364,171796046,172676950.6,59.273287143804644,69.1948279792961,NaN,NaN,32.84497392984939,30.25923985963114
2011-01-14T09:30:00-05:00,116.88,117.77,116.8045,117.69,5886227,6021298.3,69.787276583399,66.79176241528484,NaN,NaN,128.72830018025397,109.23321253516697,0.01824327903356404,0.9222138663093915,0.9039705872758275,177682273,173484359,60.455292612518036,68.57185734732582,NaN,NaN,33.941205945416456,30.78523501474333
2011-01-18T09:30:00-05:00,117.75999,118.42999,117.74001,118.23,4665973,6023478,72.6936171543641,67.22881922077603,NaN,NaN,170.99564024239197,133.89344293867504,0.0596491521015492,0.978532027402764,0.9188828753012148,182348246,176458298.8,64.53782036543828,68.03373857337355,NaN,NaN,35.81181313322913,31.50331760309844
2011-01-19T09:30:00-05:00,118.35001,118.49001,117.86,118.158,9080234,6140355.9,71.7031990246258,67.7168127023898,NaN,NaN,157.66243431403083,146.70137820502515,0.0695024924871005,1.0057609909100904,0.9362584984229899,173268012,176591360.6,64.71335268048,67.491454364874,NaN,NaN,37.018057233018965,32.29113755022995
2011-01-20T09:30:00-05:00,117.84,118.34,117.33,118.12,10935590,6447874.65,71.15220555392825,68.3409432821133,NaN,NaN,123.83225751336515,139.81883351101845,0.06107417860705244,1.0126012216818054,0.951527043074753,162332422,173485399.8,57.552230631211756,66.81348890173936,NaN,NaN,37.84273072459093,33.084222289424375
2011-01-21T09:30:00-05:00,118.71001,118.8,117.96719,118.46001,9669367,6756927.5,73.14100272067866,69.0120654009807,NaN,NaN,142.96143734444735,144.83601391889786,0.0656136188411851,1.0335440666262343,0.9679304477850492,172001789,173526548.4,57.61914212039174,66.48306469712072,NaN,NaN,39.13023768853239,33.94793877501123
2011-01-24T09:30:00-05:00,118.36,119.58,118.34,119.56,12307691,7193372.25,78.34288201435918,69.68750722653235,NaN,NaN,173.95772594183256,153.88189907121358,0.12639363260733616,1.1259224885442194,0.9995288559368832,184309480,174851989.8,59.81641815850603,66.21169069534238,NaN,NaN,42.0841245485981,35.11025102838078
2011-01-25T09:30:00-05:00,119.3,119.59,118.71001,119.49001,10481535,7510495.3,77.31681349805665,70.1938898528399,NaN,NaN,155.3062501070635,150.74402104414787,0.1442844925776432,1.1798844716589372,1.035599979081294,173827945,173147929.6,55.81017465420346,65.45184973405561,NaN,NaN,44.11088508146761,36.39605589310747
2011-01-26T09:30:00-05:00,119.55,119.94,119.34,119.61,9163262,7731730.25,77.85236099921893,70.57971108397543,NaN,NaN,155.44831906269994,150.30119799388171,0.14615061963457077,1.2182882536245074,1.0721376339899367,182991207,175092568.6,59.17084613377441,64.51525348597875,NaN,NaN,45.92372474744613,37.75715144372728
2011-01-27T09:30:00-05:00,119.62,119.92999,119.45,119.64,7393738,7770068.3,77.99226501036753,71.23261325038865,NaN,NaN,137.60077882717565,153.0549022566438,0.13179887069576557,1.2368862223596437,1.1050873516638782,190384945,180703073.2,66.9745406042799,63.83006659303295,NaN,NaN,47.441970595606726,39.14069703685291
2011-01-28T09:30:00-05:00,119.66,119.86,117.75999,118.02,17160032,8298095.9,57.038951644561514,70.59255753113271,NaN,NaN,59.989388303646,136.46049244848354,0.002434872084181139,1.1081309417691045,1.1056960696849234,173224913,180947698,67.26829324111961,63.052510524710726,NaN,NaN,41.72745135454795,39.5102333679522
2011-01-31T09:30:00-05:00,118.25,118.64999,117.882,118.60001,8967973,8560202.95,61.07145297656905,70.58407494117094,NaN,NaN,42.75698083770651,110.2203434276583,-0.05184115288416158,1.0408946285797214,1.092735781463883,182192886,180524379.2,66.17142329188432,62.400779669743976,NaN,NaN,38.36903846246973,39.34720552431185
2011-02-01T09:30:00-05:00,119.16,120.23,119.08,120.09,7632691,8486235.95,69.0963868617241,70.95723800581483,NaN,NaN,125.03078040068903,104.16524948638343,0.001982702441628792,1.095214159515919,1.0932314570742903,189825577,183723905.6,70.13518375595645,62.4048807078746,NaN,NaN,38.36763479400126,39.207266848553196
2011-02-02T09:30:00-05:00,119.89,120.32001,119.89,120.10001,4234398,8208889.45,69.14240941281624,70.93869046543408,NaN,NaN,130.72312586174766,99.22021084619297,0.026286547980400865,1.1260896420497915,1.0998030940693906,194059975,185937659.2,72.53324004809711,63.00223181726186,NaN,NaN,38.38276930095707,39.08948148461089
2011-02-03T09:30:00-05:00,120.03,120.57001,119.56,120.37,6339090,8147406.65,70.42187992849924,71.19662167022628,NaN,NaN,120.58992695710567,95.81804047217898,0.04734517941819516,1.1589845683421345,1.1116393889239393,200399065,187940483.2,74.52616969551028,64.09172342809798,NaN,NaN,38.822978705416425,39.05140965901168
2011-02-04T09:30:00-05:00,120.37,120.69,120.02,120.69,5192902,8048894.15,71.90859815245102,71.34814463944429,NaN,NaN,124.51352884502036,108.72286858045383,0.0683494573967276,1.1970762106698487,1.128726753273121,205591967,194413894,79.66253986497559,65.46366966041637,NaN,NaN,39.661487387528275,39.13856362022834
2011-02-07T09:30:00-05:00,120.88,121.64999,120.85001,121.35001,7321777,7952451.15,74.72990423906975,71.49359371692326,NaN,NaN,151.8269237351251,130.53685715993757,0.10976145035598917,1.2659285662181077,1.1561671158621185,212913744,200558065.6,83.13782543135844,66.79224145083924,NaN,NaN,41.311224030927235,39.44894367889961
2011-02-08T09:30:00-05:00,121.45,122.22,121.33,122.14,6034547,7945844.3,77.62637358782001,71.91667761429427,NaN,NaN,166.3323729338137,138.7971756665625,0.16983856999623836,1.3684653283574164,1.198626758361178,218948291,206382608.4,85.64252204114737,68.28718211945834,NaN,NaN,43.717762640299945,40.05877495909966
2011-02-09T09:30:00-05:00,122.11,122.39999,121.75,122.28,7682008,8073736.9,78.10532523682157,72.41332902021522,NaN,NaN,161.9707336135741,145.0466972169278,0.1965973477915961,1.4443734431006732,1.247776095309077,226630299,212896673.2,87.82131882290128,70.44925984743617,NaN,NaN,45.763567403595616,40.87374530831337
2011-02-10T09:30:00-05:00,121.77,122.25,121.42999,122.17,7202129,8170867.2,76.71572770955251,72.6686665194205,NaN,NaN,133.88641457016504,147.70599473953968,0.18466759397571275,1.478610587778718,1.2939429938030051,219428170,216702494.2,88.88280592434072,72.68237869057538,NaN,NaN,46.979849028713915,41.74604583979916
2011-02-11T09:30:00-05:00,121.82001,122.75999,121.71001,122.64999,6895746,8212345.5,78.51221529020839,72.68076175340973,NaN,NaN,140.4143558692885,150.88616014439327,0.18634488415003325,1.5268740989905467,1.3405292148405135,226323916,220848884,89.91421428909892,74.83222127133202,NaN,NaN,48.57031217842334,42.72094103103119
2011-02-14T09:30:00-05:00,122.49001,122.71001,122.3,122.61,4097617,8122915,77.97244793280049,72.72759278446286,NaN,NaN,131.06049023092393,146.73287344355305,0.16285425304603374,1.5440970311480555,1.3812427781020218,222226299,222711395,90.34741818679123,77.29916723794543,NaN,NaN,49.69609131289927,43.71739107129806
2011-02-15T09:30:00-05:00,122.34,122.37,121.88,122.2,4862270,8132729.85,72.47130883759475,72.3432319157754,NaN,NaN,98.47487679013378,133.16137421481704,0.10083592259345453,1.5072876813438398,1.4064517587503853,217364029,222394542.6,89.64201556449518,79.47567934013978,NaN,NaN,49.066669387166584,44.481573687850705
2011-02-16T09:30:00-05:00,122.49001,123.06,122.37,122.88,5681102,7962773.25,75.55210313200483,72.16893463874949,NaN,NaN,113.88417952421182,123.54406339694461,0.08725170805417437,1.5155163938181033,1.428264685763929,223045131,221677509,87.96817497593332,80.97522465240073,NaN,NaN,49.43260029590007,45.18886320328633
2011-02-17T09:30:00-05:00,122.64999,123.34,122.57001,123.16,4857090,7658848.25,76.70799653673345,73.57386641676179,NaN,NaN,111.66042291973285,119.09886506685818,0.07901123619866923,1.5270287310122654,1.4480174948135962,227902221,223372319.2,88.51410090740407,82.49278234284962,NaN,NaN,50.08129643726969,45.887782236712525
2011-02-18T09:30:00-05:00,122.97,123.64,122.82001,123.60001,6320996,7491429.7,78.4336078431592,74.81402033580393,NaN,NaN,114.02347179305133,113.82068825161075,0.0845834796810907,1.5537468444149596,1.4691633647338689,234223217,224952179.4,89.0144865599899,84.12442971914288,NaN,NaN,51.15565259167506,46.64033514456432
2011-02-22T09:30:00-05:00,122.87,123.28,121.49001,121.89,9844301,7368260.2,59.869876301302156,74.15498386720238,NaN,NaN,54.950215367351454,98.59863327889624,-0.03888087709140886,1.4205622683696078,1.4594431454610166,224378916,225382702.8,89.1531639673554,85.48285687709995,NaN,NaN,45.6228119075612,46.4949746821353
2011-02-23T09:30:00-05:00,121.67,121.7701,120.36,120.85001,14464621,7567414.5,51.83464453315454,72.91871494722652,NaN,NaN,-9.357632648579136,77.03213139115367,-0.19390294095734983,1.2170644692643293,1.4109674102216792,209914295,223892756,85.14713507069774,86.38384937871429,NaN,NaN,37.92675921999816,45.270943901829995
2011-02-24T09:30:00-05:00,120.77,121.03999,119.56,120.42,12252652,7721884,48.91159644139857,71.38226612671933,NaN,NaN,-46.660081900473045,44.9232791062167,-0.32120880890492387,1.0094563990905243,1.3306652079954482,197661643,218816058.4,73.09509019883222,86.28162941466584,NaN,NaN,30.842079543809454,43.209677564969915
2011-02-25T09:30:00-05:00,120.94,121.33,120.74001,121.14,5650148,7634704.5,53.62700774811132,70.07643824069507,NaN,NaN,-11.932593212387866,20.204675879792553,-0.3503460668257248,0.8927326244632923,1.243078691289017,203311791,213897972.4,63.69002847034335,85.14073574362068,NaN,NaN,26.649132147869132,40.84388536252695
2011-02-28T09:30:00-05:00,121.5,122.17999,121.439,122.14999,5763488,7064877.3,59.30170532409947,68.97442403248291,NaN,NaN,30.430386033076527,3.4860587277975865,-0.29712072473201045,0.8716777853740041,1.1687985101060145,209075279,208868384.8,55.78486633092333,83.18695295073248,NaN,NaN,25.133937132715356,38.59960704398243
2011-03-01T09:30:00-05:00,122.39999,122.48,120.37,120.37,9670984,7100027.85,48.12458824441081,66.86715365081082,NaN,NaN,-37.92593183560967,-15.089170712794637,-0.3724350684261932,0.7032546745732731,1.0756897429994663,199404295,203873460.6,49.24747455693613,80.58730670186024,NaN,NaN,19.41973148215236,35.85962482086385
2011-03-02T09:30:00-05:00,120.25,120.98,120,120.45,8298938,7133340.2,48.59354990621495,64.75916969862463,NaN,NaN,-88.62597270563822,-30.942838724206446,-0.4048184232161427,0.5696667139792879,0.9744851371954306,207703233,203431248.2,48.703306233388844,77.79316294546649,NaN,NaN,15.38012666949944,32.93398222781179
2011-03-03T09:30:00-05:00,121.44,122.66,121.42999,122.36,7299984,7286619.5,58.28875498244815,63.442957360974326,NaN,NaN,36.55747710308524,-14.299326923494789,-0.29088688904418025,0.6108765258902054,0.9017634149343856,215003217,206899563,53.08215204196207,75.23597338243944,NaN,NaN,15.518447010678779,30.446048625364217
2011-03-04T09:30:00-05:00,122.42999,122.53,120.60001,121.47099,10388906,7489110.3,53.25430459226761,61.63882088254998,NaN,NaN,-23.891904045252726,-16.691189090067763,-0.26918378548731936,0.5652836830752364,0.8344674685625557,204614311,207160067,53.40388868263808,72.62809298197796,NaN,NaN,13.736968041433062,28.059037113374053
2011-03-07T09:30:00-05:00,121.77,122.25999,120.21001,120.71001,8364039,7647667.15,49.32692725940373,59.59271226302163,NaN,NaN,-75.25187029505572,-37.827640355694214,-0.29764128823355074,0.46241585827061726,0.760057146504168,196250272,204595065.6,49.78388418055658,69.73069769581834,NaN,NaN,10.904576861188369,25.608399934490386
2011-03-08T09:30:00-05:00,120.87,122.39,120.58,121.99001,8023926,7682774.6,55.29853264264765,58.366085391953995,NaN,NaN,-18.66427515157675,-33.97530901888763,-0.22511773771926857,0.47865997435508234,0.7037777120743509,204274198,205569046.2,51.13830050796992,66.98043233463795,NaN,NaN,10.763527917083541,23.487703932003694
2011-03-09T09:30:00-05:00,121.87,122.46001,121.45,122.00999,7829871,7772540.8,55.38691108690068,56.925714531589406,NaN,NaN,13.812620975354248,-13.487590282689135,-0.173001467609466,0.4875258775625184,0.6605273451719844,212104069,206449213.4,52.38805454320817,64.43899516087187,NaN,NaN,10.687942238163057,21.659166547169317
2011-03-10T09:30:00-05:00,120.95,121.05,119.62,119.73,15705820,8173731.4,44.56025418585056,54.629447220812054,NaN,NaN,-146.37847811756168,-50.074781326818524,-0.28279251341111755,0.3070367034080874,0.589829216819205,196398249,202728219.8,46.92383765738714,61.468262071584945,NaN,NaN,6.59154150128094,19.506648683470978
2011-03-11T09:30:00-05:00,119.27,120.84,119.22,120.42,10496961,8338473,47.880629830401546,52.447091648472224,NaN,NaN,-124.1016212126113,-70.11672476029024,-0.2981261354151632,0.21717154755025092,0.5152976829654141,206895210,203184399.6,47.64480771377053,58.513285011140695,NaN,NaN,4.577513440435441,17.373915077323044
2011-03-14T09:30:00-04:00,119.77,120.1125,118.92,119.85001,8039754,8395673.4,45.45857147664175,51.41771273242505,NaN,NaN,-144.90021634686494,-84.04639397065208,-0.33318198879049116,0.09882019697730016,0.4320021857677913,198855456,203705436.4,48.50520314200394,55.60985923790131,NaN,NaN,2.1627883409511144,15.200896972127055
2011-03-15T09:30:00-04:00,117.10001,119.1299,116.92,118.42999,14807918,8931188.45,40.02629299178889,50.57425905089894,NaN,NaN,-212.47267845281095,-122.80807463089891,-0.43224920857192484,-0.10830932494711476,0.3239398836248101,184047538,199660104.4,42.64542424152358,52.57402275010316,NaN,NaN,-1.7967116038524595,12.772667175558553
2011-03-16T09:30:00-04:00,117.99001,118.209,115.50999,116.16,16503797,9513264.8,33.19695433706255,49.45178461487493,NaN,NaN,-252.04146214627337,-175.97889125522445,-0.6195021616824478,-0.4504378184782496,0.16906434320419814,167543741,190748038.8,33.14539420397823,49.72047303618502,NaN,NaN,-7.868104504171838,9.82398550702564
2011-03-17T09:30:00-04:00,117.45,117.98,116.91,117.69,7911766,9624798,40.55859350109718,48.51832645437393,NaN,NaN,-165.74679335602295,-179.8525543029167,-0.6082936597098296,-0.591302731433089,0.016990928276740702,175455507,186559490.4,29.786878521764095,47.29881946842935,NaN,NaN,-10.040405167281182,6.986215410696094
2011-03-18T09:30:00-04:00,118.83,119.00999,118,118.27,10533637,9908625.35,43.11763401555357,47.36232136090636,NaN,NaN,-105.6144970410526,-176.15512946860494,-0.5325212870541236,-0.6486606805409139,-0.1161393934867902,185989144,182378277.2,26.860917763999566,45.23282314222051,NaN,NaN,-10.799418022787032,4.445410634484219
2011-03-21T09:30:00-04:00,119.55,120.52,119.55,120.07001,7619820,9973566.55,50.27271337058796,47.515758869919004,NaN,NaN,-17.07682170786926,-150.59045054080582,-0.34118173228145,-0.5426165588386027,-0.20143482655715272,193608964,181328978.8,26.16626678956159,43.5841654445509,NaN,NaN,-8.830941184894165,2.5487889460015927
2011-03-22T09:30:00-04:00,120.14999,120.24001,119.77,119.92,6370113,9799857.15,49.71150557438676,47.59561284621699,NaN,NaN,-15.596402519587325,-111.2151953541611,-0.2111053409169199,-0.4653165027033026,-0.2542111617863827,187238851,181967241.4,27.396224214863437,42.06223101465623,NaN,NaN,-7.5248784637691575,1.1096936017486285
2011-03-23T09:30:00-04:00,119.67999,120.9068,119.44,120.63,6700727,9411662.45,52.418883119818034,47.17633628460055,NaN,NaN,6.673741051158389,-59.47215471467475,-0.07088135205428081,-0.3428128518542337,-0.2719314997999529,193939578,187246408.8,36.77741972708084,40.897607277879004,NaN,NaN,-5.582075723092525,0.15372655534274948
2011-03-24T09:30:00-04:00,121.25,121.64999,120.72,121.46001,4834918,9040775.75,55.43913693929695,47.33239573795979,NaN,NaN,58.15046742540861,-14.692702558388442,0.0761724918971069,-0.17671588492856927,-0.25288837682567616,198774496,191910206.6,43.69855708726218,40.20436930678073,NaN,NaN,-3.0064439549157216,-0.2977263746941749
2011-03-25T09:30:00-04:00,121.7,122.33,121.60001,121.96001,6608184,9088677.55,57.20155199253109,47.89486893318318,NaN,NaN,91.70744676325172,24.77168620247243,0.19856427145335487,-0.004683037508982579,-0.20324730896233745,205382680,195788913.8,48.72586579385435,40.12879656487342,NaN,NaN,-0.36242199336560244,-0.3069686059329503
2011-03-28T09:30:00-04:00,122.11,122.46001,121.7,121.75999,2668452,8933925.75,56.24322674371644,47.96234708325952,NaN,NaN,91.94806206052418,46.57666295615113,0.253956158337432,0.1141978889594526,-0.13975826937797942,202714228,197609966.6,50.94077992410492,40.11468795174021,NaN,NaN,1.4957545110553478,-0.04943673207747917
2011-03-29T09:30:00-04:00,121.74001,122.60001,121.49001,122.50999,6032066,8751979.85,59.01586622186299,48.22155816432826,NaN,NaN,96.97410684537336,69.09076482914327,0.3244993157821578,0.26586587534971784,-0.058633440432439954,208746294,201911455.2,55.79793569462322,40.35825089112699,NaN,NaN,3.900737986400535,0.5148739419908086
2011-03-30T09:30:00-04:00,123,123.58,122.94,123.21001,4103246,8542195.25,61.46990840607243,49.429390608629824,NaN,NaN,130.466287976361,93.84927421418377,0.3969118007873779,0.43750631055178246,0.04059450976440454,212849540,205693447.6,59.58649801991704,41.26272663130771,NaN,NaN,6.67220550154889,1.3944927362133916
2011-03-31T09:30:00-04:00,123.17999,123.56,122.95,123.02,4360531,8395222.6,60.412497592745524,50.32452402022583,NaN,NaN,120.437333668766,106.30664746285524,0.40899568436404854,0.5518391152194653,0.1428434308554167,208489009,207636350.2,61.41608570909788,42.24638934525966,NaN,NaN,8.660729303088171,2.4325265314812174
2011-04-01T09:30:00-04:00,123.59,123.95,123.142,123.46001,5211316,8136343.1,62.040922019781064,51.508977630450055,NaN,NaN,123.11472796880817,112.58810370396654,0.42190753284220756,0.6702278469081762,0.2483203140659686,213700325,209299879.2,62.96218073285917,43.27903060174931,NaN,NaN,10.804800061450727,3.628565607191147
2011-04-04T09:30:00-04:00,123.64,123.83681,123.45,123.75999,6280895,8032185.9,63.15372313969946,53.160936926729384,NaN,NaN,114.86069201199166,117.17062969426004,0.42476347317237556,0.779274655531438,0.3545111823590625,219981220,212753277.6,66.0073787869872,44.94774164071101,NaN,NaN,12.921487344786403,4.956125855419041
2011-04-05T09:30:00-04:00,123.52,124.14,123.25999,123.64999,8526531,8057316.15,62.43097483248821,55.249081247831214,NaN,NaN,104.57248492154211,118.69030530949378,0.39403476429122225,0.8470546377230903,0.45301987343186806,211454689,213294956.6,66.47301276456771,47.32828582361026,NaN,NaN,14.51174195439558,6.321213869558546
2011-04-06T09:30:00-04:00,124.21001,124.36,123.8,124.17,4248813,7878263.25,64.49934463392393,56.95913490017598,NaN,NaN,109.94090263462894,114.58522824114736,0.38317437907242213,0.9319878472723957,0.5488134681999736,215703502,213865749,66.98620063451341,49.98538026023521,NaN,NaN,16.45592512790241,7.769029763607669
2011-04-07T09:30:00-04:00,124.03999,124.25,123.11099,123.91,6547652,7420354.85,62.64234173160263,58.35375687989377,NaN,NaN,87.53205004488643,108.00417151637146,0.33468464567839107,0.9671692752979624,0.6324846296195713,209155850,213999117.2,67.11286855442414,52.86051960240839,NaN,NaN,17.64808556396592,9.180323449373134
2011-04-08T09:30:00-04:00,124.28999,124.35001,123.05,123.64999,6084012,7199707.4,60.75841039390525,59.10273523870215,NaN,NaN,77.22948230669897,98.82712238394963,0.26438802561584474,0.9629696616393773,0.6985816360235325,203071838,211873419.8,62.966082402870505,55.48907786050188,NaN,NaN,18.19836653226962,10.468615318358346
2011-04-11T09:30:00-04:00,123.78999,124.28,123.36,123.64,5472758,7071357.6,60.682897082967514,59.88640606074363,NaN,NaN,73.17893473038377,90.49077092762805,0.19946143495952873,0.9479084297229434,0.7484469947634147,197599080,207396991.8,55.227270940331344,57.47700976946387,NaN,NaN,18.64586449946131,11.636793772801626
2011-04-12T09:30:00-04:00,122.92,123.10001,122.17,122.46001,5206680,6591295.7,52.39895164625605,59.88498238406064,NaN,NaN,29.257276151225625,75.42772917356476,0.06618295424474174,0.8311756875693419,0.7649927333246002,192392400,203584534,49.6323893349862,58.39522188431425,NaN,NaN,16.834007025849836,12.379252808951371
2011-04-13T09:30:00-04:00,123.17,123.21001,122.08,122.55,4280156,5980113.65,52.926723180707654,59.70552425844711,NaN,NaN,23.738594559449737,58.1872675585289,-0.022054176416199,0.7374250128043514,0.7594791892205504,196672556,199778344.8,44.757415096982285,58.47085459929427,NaN,NaN,15.446802468958488,12.817474188952387
2011-04-14T09:30:00-04:00,121.97,122.89,121.46001,122.72,4339797,5801515.2,53.965102379607636,59.474349286095446,NaN,NaN,2.1173314309989864,41.10432383575141,-0.07227840805396202,0.6691311791530978,0.7414095872070599,201012353,198149645.4,42.81928980468041,58.048956314353276,NaN,NaN,14.520772414430061,13.060802506877769
2011-04-15T09:30:00-04:00,122.88,123.42,122.45,123.19,5305777,5540122.2,56.80221543815479,59.514277049983896,NaN,NaN,30.73318746906084,31.80506486822379,-0.0767340175444936,0.6454920652764429,0.7222260828209365,206318130,198798903.8,43.862876024522784,57.543391750097406,NaN,NaN,14.428133444474254,13.256135497962982
2011-04-18T09:30:00-04:00,121.83,121.8801,120.64999,121.74001,10042988,5661280.6,47.148229120750074,58.666588685618684,NaN,NaN,-83.92122064337349,0.3850337934723399,-0.17462355495226634,0.5039466391306036,0.6785701940828699,196275142,198534116.2,43.51407855018813,56.665973382637766,NaN,NaN,11.49622754089532,13.004720075524745
2011-04-19T09:30:00-04:00,121.96001,122.49001,121.73,122.38989,5008449,5593197.4,51.15516931891552,57.92982160796463,NaN,NaN,-41.78207063436592,-13.822835563645972,-0.19153733683161,0.4391485230433574,0.6306858598749674,201283591,200312354.4,46.5859879501717,55.737365520513094,NaN,NaN,10.135120097227034,12.594777221482214
2011-04-20T09:30:00-04:00,123.92999,124.53,123.75999,124.34,6718820,5594102.05,60.767166118680024,57.9551550741028,NaN,NaN,111.46011803809735,3.721469132083547,-0.07339624215171203,0.5389405571853274,0.6123367993370394,208002411,202578325.4,50.29546982577176,54.943035814561235,NaN,NaN,12.055644186247093,12.517758216448625
2011-04-21T09:30:00-04:00,124.63,124.81,124.19,124.78999,4028466,5553779.45,62.59626995117208,57.99482278348787,NaN,NaN,134.91344989206058,30.280692824295862,0.02763461234199327,0.646880064764531,0.6192454524225377,212030877,204782030.2,53.66559041034151,54.27899364866711,NaN,NaN,14.202684348818789,12.758461949644362
2011-04-25T09:30:00-04:00,124.66,124.71001,124.21001,124.55,4440367,5445388.6,60.96383484959088,57.83840219133726,NaN,NaN,115.26479835191576,47.18701500086685,0.06854899887694776,0.7049317010187224,0.6363827021417746,207590510,205036506.2,54.0530126997388,53.42511035672079,NaN,NaN,15.42103361235826,13.138829330032062
2011-04-26T09:30:00-04:00,124.78999,125.88,124.64999,125.7,6238816,5623906.8,65.59413673413476,58.0643423271692,NaN,NaN,176.23687472251044,99.21863407404365,0.15818842569034264,0.8341182342547029,0.6759298085643602,213829326,208547343,59.13029143488559,52.9006302617435,NaN,NaN,18.00064923859986,13.833375031256033
2011-04-27T09:30:00-04:00,125.88,126.87,125.67,126.69,5709980,5607802.5,69.00281812263754,58.38601900493446,NaN,NaN,227.80079688231845,153.13520757738053,0.263097347282475,1.004801492667454,0.741704145384979,219539306,212198486,63.63125193350658,52.66099106881444,NaN,NaN,21.337317164766297,14.90536676461464
2011-04-28T09:30:00-04:00,126.56,127.53999,126.53999,127.42,11794246,5992352.5,71.26359998201178,59.00182316567797,NaN,NaN,228.4503028247441,176.53324453470987,0.3548851486928414,1.1853105812510307,0.8304254325581893,231333552,216864714.2,68.41823482420763,52.75423151665611,NaN,NaN,24.85312552749691,16.326475159312107
2011-04-29T09:30:00-04:00,127.56,128.12,127.53999,128.03999,11425805,6345616.2,73.06068841772625,59.88055731023661,NaN,NaN,213.91826027093904,192.33420661048555,0.425807781713204,1.3626851596996943,0.9368773779864903,242759357,223010410.2,73.38669794164917,53.49856119799745,NaN,NaN,28.33816368234745,18.04243066260287
2011-05-02T09:30:00-04:00,128.60001,128.63,127.62,127.84,10523660,6611233.4,71.5072450879293,60.65372502487674,NaN,NaN,176.96665698379746,204.67457833686188,0.42663493975137556,1.4701710526757097,1.0435361129243341,232235697,227939447.6,76.57036030413504,55.023067581126284,NaN,NaN,30.662705491999336,19.845327066802366
2011-05-03T09:30:00-04:00,127.75999,128.17999,127.269,127.82001,7716680,6683022.65,71.34395567153237,62.00693959811076,NaN,NaN,136.60940158537517,196.74908370943484,0.3939990432146674,1.5360349169426684,1.142035873728001,224519017,230077385.8,77.81029141201094,57.03577487234234,NaN,NaN,32.48452253012467,21.650926418705552
2011-05-04T09:30:00-04:00,127.67,127.75999,126.50999,126.97,8266047,6669998.45,64.58984522147504,62.84001974387986,NaN,NaN,94.1791148027476,170.02474729352068,0.28823203914300066,1.5023259226567518,1.2140938835137511,216252970,229420118.6,76.47043880897351,59.30099085177028,NaN,NaN,32.09175744364782,23.14247370798302
2011-05-05T09:30:00-04:00,126.58,126.84,125,125.64,11365914,7025853.5,55.7038076523062,62.96421297764404,NaN,NaN,41.52451569506253,132.63958986758436,0.11088357520214065,1.352698352516427,1.2418147773142862,204887056,224130819.4,66.54049347323289,60.995362542381166,NaN,NaN,28.89315294430599,23.963999313172014
2011-05-06T09:30:00-04:00,126.73,127.44,125.83009,126.27,9881152,7192528.5,58.608678232846415,63.09324603440773,NaN,NaN,60.11727888483207,101.87939359036297,0.022796033498107215,1.2703098191869202,1.247513785688813,214768208,218532589.6,57.9616062567148,62.002414701823454,NaN,NaN,27.119861777247046,24.414836808039876
2011-05-09T09:30:00-04:00,126.24001,127.07001,126.03999,126.71001,5465496,7161602.7,60.55433553649742,64.05082506410398,NaN,NaN,57.29238865432164,77.94453992446782,-0.01690347164564221,1.2263844461317603,1.2432879177774026,220233704,216132191,54.70482987933461,62.80175408247677,NaN,NaN,26.246599441215018,24.676517184207754
2011-05-10T09:30:00-04:00,126.96001,127.67,126.81,127.451,4193043,7097616.95,63.65290504416591,64.94352047305043,NaN,NaN,74.59025355603448,65.54071031859966,-0.004946812358555208,1.2371044023292086,1.2420512146877638,224426747,216113737,54.67939304585229,63.37985444645396,NaN,NaN,26.450504661330815,24.929943966653905
2011-05-11T09:30:00-04:00,127.2001,127.25,125.74001,126.31,7818727,7228219.3,56.31691394557952,64.62564531782895,NaN,NaN,39.39884094570917,54.58465554719196,-0.0813327881318977,1.1403852295228916,1.2217180176547893,216608020,216184747,54.76655174730208,63.69921744084899,NaN,NaN,24.266755499360663,24.835202757040584
2011-05-12T09:30:00-04:00,125.96001,127.16,125.37,126.99001,6687141,7348568.55,59.32559475612111,64.3920256610396,NaN,NaN,37.489321029511615,53.777616614081786,-0.0926879591432983,1.1058580687256665,1.1985460278689648,223295161,219866368,59.15269390016575,64.09115340440786,NaN,NaN,23.39507657893708,24.62947044588294
2011-05-13T09:30:00-04:00,126.98,127.12,125.41,125.96001,6685371,7465847.25,53.33361379923328,63.847009871728346,NaN,NaN,18.346665279395083,45.42349389299439,-0.17160541345513747,0.984039261050043,1.1556446745051805,216609790,220234684.4,59.575011877946615,64.485581917137,NaN,NaN,20.68744126552502,24.066323420117524
2011-05-16T09:30:00-04:00,125.57001,126.42,125.28999,125.47,4401391,7420627.95,50.70957245025753,62.783826708594255,NaN,NaN,-8.145249332335895,32.335966295662885,-0.2538805909464352,0.8382939358221364,1.0921745267685716,212208399,218629623.4,56.81812942086828,64.32042748756432,NaN,NaN,17.639327138153355,23.14818109412264
2011-05-17T09:30:00-04:00,124.92999,125.25999,123.85001,124.81,25419600,8189458.55,47.331684064268195,61.23588856156788,NaN,NaN,-83.21000449809782,0.775914684836431,-0.3442170429701703,0.6619032230558588,1.006120266026029,186788799,211102033.8,46.05416809638518,63.06492149919851,NaN,NaN,14.019724987038156,21.844115935967714
2011-05-18T09:30:00-04:00,124.89,125.85001,124.56,125.71001,4539227,8165997.45,52.02478956766824,59.86168781768619,NaN,NaN,-58.96690167163108,-18.897233838631617,-0.3345298256079319,0.5879579840161142,0.9224878096240461,191328026,206046035,40.50385740536561,61.07103739785264,NaN,NaN,12.400924837262293,20.495088636152655
2011-05-19T09:30:00-04:00,126.11,126.48,125.46001,126.17999,4717508,8065931.85,54.314125642674036,58.522647619468174,NaN,NaN,-20.496274234401845,-30.494352891414316,-0.28933857882706326,0.560814586090217,0.8501531649172802,196045534,200596109.6,35.53282726824382,58.367189492609405,NaN,NaN,11.776366528103106,19.24955690643129
2011-05-20T09:30:00-04:00,125.50999,125.66,124.57001,124.85001,6893121,8209164.6,47.418261350865706,56.802005923963634,NaN,NaN,-105.34561657225359,-55.232809261744045,-0.3384728750821351,0.42706207106461136,0.7655349461467464,189152413,195104634.2,31.356786516043556,55.13764850774573,NaN,NaN,8.977061766729479,17.782057600759604
2011-05-23T09:30:00-04:00,123.22,123.88,123.03,123.52,5912934,8282792.95,41.714545181349855,54.685619460379165,NaN,NaN,-212.93034619368072,-96.18982863401301,-0.44338335970399145,0.21130574651675715,0.6546891062207486,183239479,189310850.2,27.66284700724529,51.55568819311962,NaN,NaN,4.612182637200224,15.900646891679692
2011-05-24T09:30:00-04:00,123.81,123.96001,123.21001,123.3,4248098,8183257.05,40.8394710486815,52.98916416232248,NaN,NaN,-182.55168359695662,-116.05816445378477,-0.5059048922913502,0.022307990856560878,0.528212883147911,178991381,187751366.6,26.749416040619266,48.0041865668086,NaN,NaN,0.893126209879015,13.756715365708168
2011-05-25T09:30:00-04:00,122.84,124.13,122.8,123.64999,4111941,8103355.1,42.89192076119397,52.074029384385895,NaN,NaN,-149.64754677576283,-134.19429347461113,-0.5010518791207879,-0.09810196575307373,0.4029499133677141,183103322,186106425.8,25.782351358961506,45.0928907015035,NaN,NaN,-1.5056041517096446,11.576384006077053
2011-05-26T09:30:00-04:00,123.41,124.17,122.92,123.8,6195461,7823415.85,43.79201453106202,51.01569626282987,NaN,NaN,-123.91589780373285,-154.87821818847732,-0.46584446672600893,-0.17935567003979713,0.2864887966862118,189298783,184757075.6,24.984412799423993,42.737376883125584,NaN,NaN,-3.188888387270098,9.467059378456032
2011-05-27T09:30:00-04:00,124.17999,124.6501,123.98,124.23,4403262,7472288.7,46.39990123458393,50.00466524126462,NaN,NaN,-77.43964950670308,-149.29702477536722,-0.39452707423250594,-0.20667004610442063,0.1878570281280853,193702045,185667002,26.633378868512267,40.732273239495406,NaN,NaN,-3.8612122603761985,7.56302057290857
2011-05-31T09:30:00-04:00,125.33,125.55,124.60001,125.5,5294828,7210847.1,53.29269739973879,49.264650409519824,NaN,NaN,-18.88036096975859,-110.48702773058281,-0.24980917672698372,-0.12440444278064433,0.1254047339463394,198996873,188818480.8,32.192791145070245,39.12608738943955,NaN,NaN,-2.353912083717579,6.1463159076762635
2011-06-01T09:30:00-04:00,125.13,125.1799,122.62,122.7,8228559,7236441.05,40.82700598263306,48.1582284121665,NaN,NaN,-109.48067351859225,-95.87282571490992,-0.32584014209917284,-0.28189544367762664,0.04394469842154618,190768314,191173867.4,36.0906597155919,37.79209510146025,NaN,NaN,-5.307082159485088,4.51011618379607
2011-06-02T09:30:00-04:00,122.75999,122.87,121.72,122.3,8833961,7264836.75,39.40883400947752,46.735602644549104,NaN,NaN,-156.66129544679714,-97.27557544911679,-0.38234150051002164,-0.43398217721598087,-0.051640676705959246,181934353,190940073.6,35.870244720709564,36.129063017213376,NaN,NaN,-8.086619896374998,2.7105824580573463
2011-06-03T09:30:00-04:00,120.88,122,120.84,121.32001,6224195,7007750.8,36.10027969399455,45.504650208460625,NaN,NaN,-171.599065752374,-106.812209038845,-0.45978235827509367,-0.6263686245498263,-0.16658626627473266,175710158,188222348.6,33.32258073786497,34.25388936435041,NaN,NaN,-11.508274528826865,0.6793171742167448
2011-06-06T09:30:00-04:00,121.10001,121.34,120.50999,120.73,4685488,6747967.6,34.23665514248137,44.328013257905184,NaN,NaN,-168.24150149171422,-124.97257943584722,-0.5203525613063689,-0.8170269679076938,-0.29667440660132494,171024670,183686873.6,29.550549195297975,32.30620506252396,NaN,NaN,-14.881472909298015,-1.5436528377139354
2011-06-07T09:30:00-04:00,121.28,121.60001,120.47,120.49001,3836504,6666518,33.47956750913612,43.33857636111004,NaN,NaN,-147.07385205260954,-150.6112776524174,-0.5436499272257844,-0.9762368156335555,-0.43258688840777104,167188166,177325132.2,25.23549349396737,30.819156876636974,NaN,NaN,-17.8056617319911,-3.8667969654678163
2011-06-08T09:30:00-04:00,120.41,120.83,120.08,120.3,6862035,6799967.6,32.85999755821055,41.96966264614878,NaN,NaN,-147.48328926410963,-158.2118008015209,-0.5379354195289678,-1.105006162818981,-0.5670707432900131,160326131,171236695.6,21.934378567501852,29.492765531075275,NaN,NaN,-20.355558179894636,-6.222334281814504
2011-06-09T09:30:00-04:00,120.59,121.67999,120.425,121.12,4031032,6610582.85,38.17717813150856,40.81702353820839,NaN,NaN,-108.86817086901934,-148.65317588596534,-0.44865385317238293,-1.1278880597554917,-0.6792342065831087,164357163,167721257.6,20.284431467113194,28.40359440242309,NaN,NaN,-20.971016305415667,-8.32928885661467
2011-06-10T09:30:00-04:00,120.64999,120.74001,119.21001,119.37,7389555,6645703.55,32.298367074281245,39.73703108988093,NaN,NaN,-142.16620948995197,-142.7666046334809,-0.4746631837766886,-1.2725631863039695,-0.7979000025272809,156967608,163972747.6,18.67159608026151,27.4975093712958,NaN,NaN,-23.4317279334154,-10.486780153300488
2011-06-13T09:30:00-04:00,119.73,120.03999,119.09,119.46001,5363137,6579591.85,32.87094370191022,39.10534526992095,NaN,NaN,-129.6884097456289,-135.05598628426384,-0.45306416994014076,-1.3642302149524568,-0.911166045012316,162330745,162233962.6,17.95830871455756,26.804328064675246,NaN,NaN,-25.20198100715674,-12.58895170385138
2011-06-14T09:30:00-04:00,120.25,121.14,120.21001,120.7,4853809,6602212.75,40.3547484999425,39.07072223072531,NaN,NaN,-77.01589921830926,-121.04439571740379,-0.3283357622051477,-1.3215857477687507,-0.993249985563603,167184554,162233240.2,17.958001771628247,26.176369902604456,NaN,NaN,-24.387223055682718,-14.274419039827286
2011-06-15T09:30:00-04:00,119.64999,120.06,118.55,118.88,20965840,6379524.75,34.30890790935074,38.45764988416507,NaN,NaN,-117.78028245114537,-115.10379435481093,-0.340039387048243,-1.4182992193739068,-1.0782598323256638,146218714,159411756.8,16.753565323938318,25.531456614388514,NaN,NaN,-25.679732032711723,-15.903749467382205
2011-06-16T09:30:00-04:00,118.84,119.85001,118.69,119.53,7473316,6526229.2,37.887932518537745,38.035929740413344,NaN,NaN,-100.59552649783514,-113.4492654805741,-0.278237795254364,-1.4260570763936187,-1.1478192811392547,153692030,157278730.2,15.886110410800427,24.88157787234397,NaN,NaN,-25.54416812526954,-17.28095213279468
2011-06-17T09:30:00-04:00,120.23,120.47,119.42999,119.74001,7748258,6677766.7,39.04348489401632,37.510471430372796,NaN,NaN,-75.35052754176479,-100.08612909093667,-0.2010492729552833,-1.3991308723333589,-1.1980815993780756,161440288,158173266.2,17.808116830800742,24.251202012507438,NaN,NaN,-25.07594723730609,-18.394522862010596
2011-06-20T09:30:00-04:00,119.35001,120.74001,119.34,120.53999,5686879,6617454.6,43.365798451497106,36.8014072197841,NaN,NaN,-57.90075399149099,-85.7285979401091,-0.08015413151316197,-1.2982742637695281,-1.2181201322563662,167127167,159132550.6,19.921305837205352,23.374667347659948,NaN,NaN,-23.33325641306525,-19.100056226446977
2011-06-21T09:30:00-04:00,120.98,121.91,120.74001,121.59,4750922,6559354,48.525097056009336,37.35127086788241,NaN,NaN,-4.9472997335845434,-71.31487804316414,0.07793696694931751,-1.1206989235697193,-1.1986358905190369,171878089,160071257.6,22.03374136812593,22.37060175141238,NaN,NaN,-20.193885957265547,-19.256317616563916
2011-06-22T09:30:00-04:00,121.14999,121.81,120.78999,120.81,4718594,6582878.8,45.228895816008524,37.766989568348905,NaN,NaN,-12.957467812411785,-50.35031511541742,0.13408977697649305,-1.0310236692984205,-1.1651134462749135,167159495,164259413.8,30.804225253198908,22.00874321801876,NaN,NaN,-18.57784030234739,-19.159392285961555
2011-06-23T09:30:00-04:00,119.62,120.34,118.49001,120.32001,9034531,6829008.3,43.24175818850546,38.27709517509969,NaN,NaN,-75.8394622071204,-45.39910225727448,0.14160816255396025,-0.9881032430824632,-1.1297114056364235,158124964,165146000.6,32.534370295977936,21.952442472169686,NaN,NaN,-17.845643053758558,-18.97171382421827
2011-06-24T09:30:00-04:00,120.23,120.308,118.99001,119.2,6645313,6851500.9,39.02153273351874,38.61887214588807,NaN,NaN,-82.54065450261781,-46.83712764944508,0.077720148690954,-1.032561219772731,-1.110281368463685,151479651,163153873.2,30.678218040030828,22.032990246793464,NaN,NaN,-18.51831291936004,-18.906942266381378
2011-06-27T09:30:00-04:00,119.27,120.73,119.08,120.2,4490789,6855877.25,44.25292380144187,39.38839759533848,NaN,NaN,-50.155875703446384,-45.28815199183616,0.10754204781719356,-0.9758538086921931,-1.0833958565093866,155970440,160922527.8,28.702924186075606,22.28066386765834,NaN,NaN,-17.442700343759064,-18.697764848863905
2011-06-28T09:30:00-04:00,120.63,121.64999,120.49001,121.61099,4086523,6795462,50.6820810006498,40.66140355551271,NaN,NaN,51.286828179661036,-34.04132640918704,0.22051950328376746,-0.8077464774046774,-1.0282659806884449,160056963,158558302.6,26.73845755141585,22.623812366509334,NaN,NaN,-14.390435761582909,-18.082432122109477
2011-06-29T09:30:00-04:00,122,122.61,121.49001,122.45,5713559,6669712,54.07380351594986,41.79687679725852,NaN,NaN,140.95177719549312,-3.25947740760609,0.3426897496667489,-0.5999037936050087,-0.9425935432717576,165770522,158280508,26.508879940635325,23.068415828903774,NaN,NaN,-10.755981161762218,-17.035796270631298
2011-06-30T09:30:00-04:00,122.89999,124.02,122.75999,123.83,4759633,6465995.6,59.060927889077846,43.708488284029706,NaN,NaN,232.78312634368297,58.465040302554584,0.4979611518002477,-0.320142103521448,-0.8181032553216957,170530155,160761546.2,32.114987412398776,24.028658066913575,NaN,NaN,-5.9550015072843525,-15.452825590153163
2011-07-01T09:30:00-04:00,124.09,125.72,123.8,125.58,8692801,6589425.9,64.34802151441721,45.95685098492306,NaN,NaN,274.34345873748043,129.84186295057424,0.6883177150289446,0.04229388846448501,-0.6460238265644596,179222956,166310207.2,42.65131861108822,25.792444488094336,NaN,NaN,0.06662002004665832,-13.235761931553188
2011-07-05T09:30:00-04:00,125.53999,125.81,125.16,125.49001,5324285,6621365.75,63.8910805169356,47.638017557565426,NaN,NaN,228.88223920932836,185.64948593312917,0.771693493373073,0.3185930401518817,-0.4531004532211913,173898671,169895853.4,48.24190915648552,27.955580729869855,NaN,NaN,4.570007912029421,-10.692080525327102
2011-07-06T09:30:00-04:00,125.38,126.25999,125.23,126.09,9795762,6919328.65,65.64284825486632,49.87615615367368,NaN,NaN,192.21395790915813,213.8349118790286,0.8259191583529926,0.5792984947200495,-0.24662066363294313,183694433,174623347.4,54.5349449893915,30.654250705973656,NaN,NaN,8.814955223957725,-7.905361132572127
2011-07-07T09:30:00-04:00,126.83,127.37,126.60001,127.10001,4410648,6796759.3,68.42024035634788,52.05703528494583,NaN,NaN,184.97755386146687,222.64006721222336,0.8833155797362144,0.8575238110373249,-0.025791768698889522,188105081,179090259.2,59.54061593728202,33.77242967215091,NaN,NaN,13.305643555659902,-4.875217605681836
2011-07-08T09:30:00-04:00,126.03,126.42,125.5,126.39,5987266,6894571,64.47447433836157,53.873534530970495,NaN,NaN,127.20758572404534,201.52495908829582,0.8279096415510212,1.009095283239887,0.18118564168886578,182117815,181407791.2,61.8852786210909,36.92079837145735,NaN,NaN,15.830893620003062,-1.9172017162982793
2011-07-11T09:30:00-04:00,125.17,125.465,124.53999,124.95,6938328,6872009.65,57.26182780677083,54.86610805634719,NaN,NaN,82.1516294614502,163.0865932330898,0.6562326106146009,1.001476404957117,0.34524379434251606,175179487,180599097.4,60.566307582135565,39.824012781809515,NaN,NaN,15.73569332122306,0.604640431919055
2011-07-12T09:30:00-04:00,124.86,125.53999,124.31,124.33,12503691,7229037.35,54.438094754804894,55.28846503483259,NaN,NaN,66.07096319244211,130.5243380297125,0.4715135024003126,0.9346356723429068,0.4631221699425942,162675796,178354522.4,56.938936773311006,42.31724102503701,NaN,NaN,14.77126186995583,2.628443494495737
2011-07-13T09:30:00-04:00,124.96001,125.94,124.49001,124.8,7366789,7354686.35,56.201329792893986,56.072210318895834,NaN,NaN,67.62348399760941,105.60624324740277,0.3567897326136171,0.9091093357096156,0.5523196030959985,170042585,175624152.8,52.79665829034254,43.88812909911871,NaN,NaN,14.506560933778717,4.3253174143933055
2011-07-14T09:30:00-04:00,124.89,125.67,123.97,124.21001,6522316,6632510.15,53.407242549366885,56.798316344671655,NaN,NaN,49.14539703844958,78.43981188279932,0.22349241306072565,0.8316851194219055,0.6081927063611798,163520269,170707190.4,46.268700040227195,44.86915265227937,NaN,NaN,13.450164995154626,5.6288670687877795
2011-07-15T09:30:00-04:00,124.71001,124.77,123.78,124.56,7853590,6651523.85,54.841504585494405,57.92831433409849,NaN,NaN,37.20679868938453,60.43965447586713,0.1450191613162476,0.7894666580064893,0.6444474966902417,171373859,168558399.2,43.724353053016095,45.80101943892117,NaN,NaN,12.983095894663052,6.679471186769961
2011-07-18T09:30:00-04:00,123.89999,124.02,122.72,123.62,6153086,6571765.25,50.357830823767124,58.36437912140743,NaN,NaN,5.408845632018186,45.09109770998075,0.022367594531595092,0.6724069898547356,0.6500393953231405,165220773,166566656.4,41.44910912724901,46.711461220433556,NaN,NaN,11.251535681518494,7.332623257448322
2011-07-19T09:30:00-04:00,124.39999,125.82001,124.32001,125.63,5849863,6579914.45,58.223102309363476,58.903023500601265,NaN,NaN,58.39914178453479,43.55673342839928,0.06666664154857393,0.7333726972588579,0.666706055710284,171070636,168245624.4,44.09021749034492,47.950872644642786,NaN,NaN,12.138523833373595,8.019180482580504
2011-07-20T09:30:00-04:00,125.77,125.83,125.25999,125.46001,3291724,6506954.55,57.39487775374613,59.14024308901529,NaN,NaN,61.77695374436157,42.38742737774972,0.07401105397298835,0.7592198731765194,0.685208819203531,167778912,167792889.8,43.52014640752295,49.165963106563325,NaN,NaN,12.594538978208755,8.672803124813111
2011-07-21T09:30:00-04:00,126.03,127.3,125.73,127.03,6883461,6615197.9,62.675711484600185,59.39844191726689,NaN,NaN,96.16717777769269,51.79178352559835,0.16868078365623096,0.8960597987738197,0.7273790151175887,174662373,170021310.6,47.142818086571125,50.239379583289924,NaN,NaN,14.682061063490881,9.53126854462422
2011-07-22T09:30:00-04:00,126.88,127.02,126.22,126.60001,5848414,6455892.05,60.46520221507885,59.121097681599856,NaN,NaN,92.2318961634444,62.79680302041031,0.18510307785185431,0.9587578624324067,0.7736547845805524,168813959,169509330.6,46.40635105420973,50.50759618637003,NaN,NaN,15.701222893870506,10.412690594516548
2011-07-25T09:30:00-04:00,125.34,126.34,125.13,125.75999,5241305,6385691.65,56.288543110632304,58.57805929543533,NaN,NaN,53.40573229397872,72.39618035280242,0.12503146753818284,0.9299441190032809,0.804912651465098,163572654,169179706.8,45.90908744271672,50.34096606395798,NaN,NaN,15.283243562349073,11.10848387563548
2011-07-26T09:30:00-04:00,125.36,125.53,124.67,124.83,7202859,6521295.15,52.00555752590408,57.60396710050946,NaN,NaN,5.372360178144975,61.79082403152446,0.014137365668105861,0.8225843585502304,0.8084469928821245,156369795,166239538.6,41.62461113398453,49.418799360000335,NaN,NaN,13.601931894234722,11.464690735435372
2011-07-27T09:30:00-04:00,124.37,124.39,122.69,122.84,7563246,6695131.3,44.247168236421125,55.87731909194326,NaN,NaN,-126.5366394706803,24.128105388516083,-0.1904776209898269,0.5703499666448408,0.7608275876346677,148806549,162445066,36.84549670225418,47.7977194146412,NaN,NaN,9.483503691170782,11.181664014826145
2011-07-28T09:30:00-04:00,122.82001,123.66,122.0699,122.28,7457773,6782342,42.3332513687387,54.295803165541635,NaN,NaN,-179.9924127976559,-31.103812726553635,-0.35141539055951143,0.3215583494352785,0.6729737399947899,141348776,155782346.6,30.272911594652257,45.53969319846701,NaN,NaN,5.538012401029346,10.375428069998032
2011-07-29T09:30:00-04:00,121.08,122.23,120.6364,121.13,16021039,7345412.3,38.6372020776251,52.965472756316935,NaN,NaN,-237.68779369023983,-97.08775069729049,-0.5133919777020213,0.031233767867263396,0.5446257455692847,125327737,147085102.2,24.203519889934526,42.94235122045266,NaN,NaN,0.9822232594524283,9.033541668491518
2011-08-01T09:30:00-04:00,122.74001,122.96001,119.77,121.11,11632750,7492409.75,38.57412536438566,51.8323320855727,NaN,NaN,-188.5247502117178,-145.47384719842978,-0.5942445109426389,-0.19817989310901396,0.3960646178336249,113694987,137109568.8,19.399359470108692,40.26095284165249,NaN,NaN,-2.6293195112791303,7.367418642809997
2011-08-02T09:30:00-04:00,120.32001,121,118.42,118.46001,9644480,7708419.5,31.28604742933713,50.05266905960435,NaN,NaN,-222.8084582076912,-191.110010875597,-0.7864970496567663,-0.587056694237333,0.1994403554194333,104050507,126645711.2,15.846268286646193,37.62163926995989,NaN,NaN,-8.554113509461729,5.092914049628321
2011-08-03T09:30:00-04:00,118.60001,118.89,116.83,118.8,16594723,8048367.55,33.034189175260394,48.59745096145388,NaN,NaN,-207.44221185164844,-207.29112535179064,-0.8458886335335988,-0.8579204364975652,-0.012031802963966415,120645230,121013447.4,14.325368448798145,35.33997272771496,NaN,NaN,-12.681333627336185,2.5537358100619634
2011-08-04T09:30:00-04:00,117.32001,117.5744,113.56,113.71001,19368288,8796249.55,23.42562697986564,46.35345970390897,NaN,NaN,-244.4562715375391,-220.18389709976728,-1.163492826771205,-1.4663978364279728,-0.3029050096567677,101276942,112999080.6,12.488585749627504,33.108846491758634,NaN,NaN,-20.785354376534446,-0.7804199308803805
2011-08-05T09:30:00-04:00,115.13,115.56,111.25999,114.25,30453520,10019562.25,25.88845503687743,44.605647147702555,NaN,NaN,-214.16216299445134,-215.47877096060955,-1.26434633807827,-1.883337932254605,-0.6189915941763352,131730462,114279625.6,14.377661516965262,31.175171662452648,NaN,NaN,-25.930234173081207,-4.37325053690907
2011-08-08T09:30:00-04:00,111.27,113.03,108.02,108.07001,30395600,11192425.85,18.53938113985319,41.77109563559468,NaN,NaN,-228.43829905317023,-223.46148072890006,-1.650029536840521,-2.6815285152269865,-1.0314989783864656,101334862,111807600.6,13.760142545356757,29.00873773781064,NaN,NaN,-34.15927428050505,-8.628396785994209
2011-08-09T09:30:00-04:00,109.66,112.38,105.94,112.37,32097728,12172127.7,32.82769790976603,40.01629707531038,NaN,NaN,-175.9180655435554,-214.08340219607288,-1.5214517235043221,-2.9333136327668683,-1.4118619092625462,133432590,117684017.2,22.303133657537572,27.4932368270974,NaN,NaN,-34.33590302390204,-12.3008976771239
2011-08-10T09:30:00-04:00,110.22,110.67,106.87,107.17,27711536,13189365.05,26.72328628788199,37.44826670411623,NaN,NaN,-166.02878707066014,-205.80071723987527,-1.680084803971313,-3.5119679142266875,-1.8318831102553745,105721054,114699182,21.156716554934405,25.63708671769478,NaN,NaN,-37.295971150443556,-15.871622459026707
2011-08-11T09:30:00-04:00,108.2,112.82291,107.83,111.25,17398208,13733159.65,36.67345964756959,35.748856520722704,NaN,NaN,-114.20594625218627,-179.75065218280469,-1.414363126925299,-3.599837018911998,-2.185473891986699,123119262,119067646,27.065560319567595,24.255601665220333,NaN,NaN,-34.976748803660506,-18.60092622254582
2011-08-12T09:30:00-04:00,112.49001,113.49001,111.58,112.8,14099012,14045430.75,40.00638737562204,34.5858453967934,NaN,NaN,-79.21427611860656,-152.7610748076357,-1.054828748179128,-3.5040098272106093,-2.449181079031481,137218274,120165208.4,28.515123400798288,23.01317566222616,NaN,NaN,-31.935926875093017,-20.505926315766846
2011-08-15T09:30:00-04:00,113.78,114.88,113.44,114.81,13586488,14417100.85,44.11402399256165,34.02216443012608,NaN,NaN,-52.000112231648,-117.47343744333128,-0.6235814782544664,-3.2286579268495643,-2.605076448595098,150804762,130059188.4,40.07691469662347,22.902625916700373,NaN,NaN,-28.031603114095493,-21.581023001242368
2011-08-16T09:30:00-04:00,113.94,114.91,112.97,114.08,10853578,14667286.6,42.96349364732192,33.93047338804757,NaN,NaN,-50.71558676472644,-92.43294168756549,-0.3434317824743869,-3.0343661766880814,-2.6909343942136945,139951184,131362907.2,41.421374173442246,23.229474307499522,NaN,NaN,-25.547675983800406,-22.147687713036373
2011-08-17T09:30:00-04:00,114.7,115.46001,113.38,114.25999,9350582,14970229.5,43.35576565093867,34.00351012249042,NaN,NaN,-40.738518143393804,-67.37488790211223,-0.11381684250108348,-2.833205447340049,-2.7193886048389655,149301766,140079049.6,49.568113766193065,24.607703034038156,NaN,NaN,-23.539475152622526,-22.346514490120107
2011-08-18T09:30:00-04:00,111.60001,111.7,109.00999,110.07001,18144064,15533259.65,36.979784429099546,33.88512314759574,NaN,NaN,-84.1456303071605,-61.36282471310708,-0.2065347677670868,-2.977557064547824,-2.771022296780737,131157702,141686737.6,50.92385629876955,26.516298491812083,NaN,NaN,-24.0021599832024,-22.58303527484615
2011-08-19T09:30:00-04:00,108.28999,110.63,107.77,107.91,15277523,16004715.1,34.18847255804347,33.571862232857015,NaN,NaN,-96.7425731584653,-64.86848412107882,-0.3664055839548537,-3.2290292767243045,-2.862623692769451,115880179,137419118.6,47.2896726486432,28.508463718850265,NaN,NaN,-25.338893520358642,-22.976729309919364
2011-08-22T09:30:00-04:00,110.17999,110.3,108.00999,108.3,11314719,16308385.8,35.140417141890126,33.847174355182226,NaN,NaN,-91.21415496508504,-72.71129266776624,-0.39641504549240025,-3.358142499634951,-2.961727454142551,127194898,132697145.8,43.58346407542289,30.489691989477173,NaN,NaN,-26.068389469979913,-23.41839504707087
2011-08-23T09:30:00-04:00,108.85001,111.47,108.42999,111.37,12384582,16567471.95,42.22491017929716,34.50365442689913,NaN,NaN,-64.75597729104055,-75.51937077302907,-0.17152193109908165,-3.176129868016403,-3.0046079369173215,139579480,132622805,43.52562823782452,32.575424831550485,NaN,NaN,-24.357221294188314,-23.552513082373363
2011-08-24T09:30:00-04:00,111.25,113.071,110.91,112.95,9256871,16652153.2,45.52291926992511,36.08203244761767,NaN,NaN,-27.643010056351535,-72.90026915562062,0.1066525250174073,-2.8712922806455623,-2.9779448056629696,148836351,132529722,43.4478833694171,34.786803232964026,NaN,NaN,-21.89568137972562,-23.315822839137972
2011-08-25T09:30:00-04:00,113.39,113.78259,110.81,111.25999,10396156,16799072.35,42.714248346643764,37.283874826886695,NaN,NaN,-27.55672892297035,-61.58248887878259,0.19471284770524822,-2.734553746031409,-2.9292665937366573,138440195,133986220.6,45.10030547222809,36.98127780119709,NaN,NaN,-20.743700428936517,-22.948376780537764
2011-08-26T09:30:00-04:00,110.72,113.07001,109.09,112.7,13140949,16655067.85,45.78370501193856,39.22989796060707,NaN,NaN,-27.983108969825917,-47.830596041054704,0.3583038211910101,-2.481386817247895,-2.839690638438905,151581144,141126413.6,52.437373168599585,39.743937131428716,NaN,NaN,-18.840257612877576,-22.361502613729165
2011-08-29T09:30:00-04:00,113.97,115.2,113.92,115.14,7117793,16429320,50.612521953673266,40.50024253517188,NaN,NaN,63.50988581922838,-16.885787884191995,0.6236606129287869,-2.0601148722779214,-2.6837754852067084,158698937,147427221.4,57.79735407830533,42.27923859005499,NaN,NaN,-15.685987171379795,-21.4078575505364
2011-08-30T09:30:00-04:00,114.83,116.16,114.13,115.35001,10483934,16471292.7,51.016904096021726,42.235500950039004,NaN,NaN,90.11298309131635,14.088004192279381,0.795157605684016,-1.6898284781016883,-2.4849860837857043,169182871,153347899.6,62.11747798626403,45.205007263721384,NaN,NaN,-13.049533604901683,-20.213811272588583
2011-08-31T09:30:00-04:00,116.16,116.97,115.12199,115.95,8396996,16061406.35,52.220566878897756,43.34600860941959,NaN,NaN,123.92888185998055,44.4023825755458,0.9219102265662893,-1.3325983005778426,-2.254508527144132,177579867,159096602.8,65.78030014178387,47.97034582245112,NaN,NaN,-10.530945943511174,-18.830544797006095
2011-09-01T09:30:00-04:00,116.09,117.03,114.72,114.87,7692945,15477639.2,49.8461621189853,44.048849662516965,NaN,NaN,106.26803620568992,71.16733560127786,0.904659103239049,-1.1236846480953204,-2.0283437513343694,169886922,165385948.2,69.27991031170049,50.88211631608699,NaN,NaN,-9.056101678912446,-17.434195780135575
2011-09-02T09:30:00-04:00,112.74001,113.28,111.95151,112.28,9427949,14426360.65,44.60791709471319,44.08412774124207,NaN,NaN,12.502912555511573,79.26453990634535,0.6996269817936942,-1.1538100240922518,-1.853437005885946,160458973,167161514,70.20627974837214,53.034213819783325,NaN,NaN,-9.266563952778228,-16.26739123337024
2011-09-06T09:30:00-04:00,109.39999,111.46001,109.17999,111.21001,10884598,13450810.55,42.6154734810292,44.05926915793545,NaN,NaN,-51.512689295308235,56.26002488343803,0.4830543870240338,-1.2496190221059038,-1.7326734091299376,149574375,165336601.6,67.93866798707238,54.92830623504262,NaN,NaN,-10.02026771153495,-15.3749450159652
2011-09-07T09:30:00-04:00,112.74001,114.02,112.39999,113.94,7281055,12209976.9,48.88826352384369,44.45444757742867,NaN,NaN,38.39863533696948,45.917155332568655,0.5120064079318756,-1.0926653992150932,-1.6046718071469688,156855430,162871113.4,64.88928938630619,56.022675922193564,NaN,NaN,-8.81194405155689,-14.437373449621155
2011-09-08T09:30:00-04:00,113.38,114.67999,112.73,112.87,7775500,11213175.1,46.732066986647,45.151039188682056,NaN,NaN,31.326712048357322,27.396721370244006,0.44965733806477415,-1.0426001345660012,-1.4922574726307754,149079930,157171126,58.3667665841222,56.55431237114732,NaN,NaN,-8.439517396165591,-13.580536870556076
2011-09-09T09:30:00-04:00,111.64,111.7,109.22,109.82001,11878047,10937167.05,41.15952433977513,45.64897145880575,NaN,NaN,-85.47881319614898,-10.952648510123769,0.20596775835327286,-1.2347977746891843,-1.4407655330424571,137201883,150634118.2,51.920988744611556,56.885120663716485,NaN,NaN,-9.836574715034521,-13.045685134052997
2011-09-12T09:30:00-04:00,108.37,110.55,108.14999,110.50999,10067680,10735600.45,42.82064222277029,46.1975589645829,NaN,NaN,-92.20681068370125,-31.894593157966334,0.0995987766310733,-1.3162670622536154,-1.4158658388846888,147269563,147996236.2,49.54329649078515,57.31082297909951,NaN,NaN,-10.483391507927129,-12.679643187463586
2011-09-13T09:30:00-04:00,110.67999,111.37,109.82001,110.92,10845305,10598541.3,43.83532470233732,46.312588573371485,NaN,NaN,-53.337585427371764,-32.25957238437904,0.06678168607703916,-1.3323887312883897,-1.399170417365429,158114868,149704334.8,51.104724068992795,57.852186967040105,NaN,NaN,-10.724762949795432,-12.40037458208242
2011-09-14T09:30:00-04:00,111.49001,113.83,109.87,112.39999,14635027,10787613.75,47.459694457211484,46.45092965817765,NaN,NaN,-3.905075045173484,-40.720314460807636,0.1499172370453179,-1.2117738710587815,-1.3616911081040994,172749895,152883227.8,53.960234382279275,58.603069182244546,NaN,NaN,-9.896995470517965,-12.042748994716069
2011-09-15T09:30:00-04:00,113.42999,114.33,112.83,114.25999,9647020,10802435.65,51.67992066745941,47.0913348239502,NaN,NaN,62.71478859883916,-34.44269915071126,0.32528121310606584,-0.9550895917215172,-1.280370804827583,182396915,159546624.8,59.322797004872804,59.61896143457631,NaN,NaN,-7.940044173943914,-11.456648306034333
2011-09-16T09:30:00-04:00,114.61,115.13,113.81,114.86,12332258,10511845.35,52.99166216931217,47.60618890661975,NaN,NaN,82.50864707117057,-0.8452070972473507,0.4681083099369965,-0.6952354174063373,-1.1633437273433338,194729173,171052082.8,66.56449029053297,60.628041229000125,NaN,NaN,-5.940997976592705,-10.668698258971244
2011-09-19T09:30:00-04:00,113.10001,114.22,112.28999,113.72,9727355,10234336.95,50.203088619738146,47.576943668481526,NaN,NaN,32.95426204207529,24.187007447907956,0.4709444020380391,-0.5746632247957848,-1.045607626833824,185001818,178598533.8,70.29938233805075,61.52104324755337,NaN,NaN,-5.00772717421932,-9.859988104006684
2011-09-20T09:30:00-04:00,114.25999,115.25999,113.48,113.88,8070637,10072132.85,50.59603759344199,47.54688177544011,NaN,NaN,56.92925882424394,46.2403762982311,0.4677777572249251,-0.4608854303026675,-0.9286631875275926,193072455,185590051.2,73.27761542996322,62.31819592210331,NaN,NaN,-4.129383183451959,-9.04133025821315
2011-09-21T09:30:00-04:00,113.92999,114.23,110.88,110.94901,14936574,10199732.45,43.780589772709334,46.94402626785523,NaN,NaN,-38.61460156660143,39.298470993945514,0.2626887931459029,-0.600302196095214,-0.8629909892411168,178135881,186667248.4,73.71494669090025,62.88495638989733,NaN,NaN,-5.29530335202418,-8.506183557329011
2011-09-22T09:30:00-04:00,107.95,108.39999,105.72,107.07001,19750048,10724391.3,36.729135100730886,46.00709576655134,NaN,NaN,-207.16743341270734,-14.677973408363794,-0.11930857074497303,-1.012126702672333,-0.89281813192736,158385833,181865032,68.34496239646343,62.81817439595183,NaN,NaN,-8.663758232605087,-8.528694225225594
2011-09-23T09:30:00-04:00,106.44,107.87,106.13,107.45,12057563,10807461.65,37.786246093996475,45.519833552214436,NaN,NaN,-171.23014351378163,-65.42573152535424,-0.3200930389276406,-1.2929344305869108,-0.9728413916592702,170443396,177007876.6,63.3205305448506,62.32633516712885,NaN,NaN,-11.040671102609945,-8.88754806485193
2011-09-26T09:30:00-04:00,108.41,110.33,107.48,110.24001,11481051,10724466.75,45.04618463000904,45.69345577714156,NaN,NaN,-90.34672592892856,-90.085929119555,-0.2422399182171282,-1.2756412894306806,-1.0334013712135524,181924447,176392402.4,62.691600494440024,61.95154463194083,NaN,NaN,-10.860696644061358,-9.16942643331042
2011-09-27T09:30:00-04:00,112.41,113.45,111.09,111.71001,13564395,11046796.85,48.4588735405921,45.66278506405216,NaN,NaN,-2.4462944666961692,-101.96103977774303,-0.0775111847715646,-1.130290352178008,-1.0527791674064435,195488842,176875679.8,63.00234489918439,61.81676288286071,NaN,NaN,-9.641863904343612,-9.236917500600876
2011-09-28T09:30:00-04:00,112.10001,112.96001,109.74001,109.83,11265590,11085879.65,44.64068630271926,45.513400729485895,NaN,NaN,-36.912994440006784,-101.6207183524241,-0.08057900102934212,-1.1535029186931212,-1.072923917663779,184223252,178093154,63.81989520090757,62.206272069773945,NaN,NaN,-9.803244631794742,-9.317821376485714
2011-09-29T09:30:00-04:00,111.87,112.5,109.42999,111.38,13221582,11327108.95,48.260314120080245,46.02059999950769,NaN,NaN,-21.384824130158062,-64.46419649591425,0.030421257029780602,-1.0348973463765532,-1.0653186034063338,197444834,185904954.2,68.61251373542432,63.398523854832,NaN,NaN,-8.811633142845423,-9.245508771679958
2011-09-30T09:30:00-04:00,109.81,111.16,108.87,108.92999,10346234,11459773.4,43.426911175269545,46.063904924686206,NaN,NaN,-66.41340663910697,-43.50084912097931,-0.04824227238743117,-1.1256214438906227,-1.0773791715031915,187098600,189235995,70.41232666048347,64.88916886695331,NaN,NaN,-9.492393928681846,-9.280778079823085
2011-10-03T09:30:00-04:00,108.21001,109.61,106.3,106.36,13527988,11664775.35,39.013028520358134,45.71945519740198,NaN,NaN,-132.5815481881378,-51.947813572821154,-0.24920660660693938,-1.3888874297618656,-1.1396808231549262,173570612,187565228,68.29692613320694,66.11718330011146,NaN,NaN,-11.522633724177748,-9.601043171873751
2011-10-04T09:30:00-04:00,105.08,108.08771,103.84,107.72,18084016,12024746.25,42.352185585381356,45.354633135128395,NaN,NaN,-141.4285517327848,-79.74426502603887,-0.26492106054604925,-1.4708321488374878,-1.2059110882914386,191654628,186798385.2,67.29757418841706,67.0698504291213,NaN,NaN,-12.128242917032257,-9.962071706896396
2011-10-05T09:30:00-04:00,107.85001,109.41,107.25999,109.28,9971469,12159266.95,46.004181494253565,44.94922319418513,NaN,NaN,-66.74971195777795,-85.71160852959312,-0.15033335932104563,-1.3938277874427456,-1.2434944281217,201626097,190278954.2,69.48042649246855,67.795395392521,NaN,NaN,-11.485375742079478,-10.179686569065407
2011-10-06T09:30:00-04:00,109.3,111.21001,108.47,111.09,8538211,12197402.5,49.96478921096999,44.73301798287497,NaN,NaN,-9.906937954904535,-83.4160312945424,0.056215387832782016,-1.1732251933307225,-1.2294405811635045,210164308,192822849,71.00384216986183,68.11249195533021,NaN,NaN,-9.697282078293538,-10.110771641812283
2011-10-07T09:30:00-04:00,111.87,112.21001,110.38,111.02,10022219,12104611.1,49.8126135566773,44.70512690694205,NaN,NaN,20.893088572457955,-65.95473225222943,0.18947057614459717,-0.9926023609827581,-1.1820729371273553,200142089,195431546.8,72.51874848128594,68.27101810841843,NaN,NaN,-8.317836808335183,-9.854638094172698
2011-10-10T09:30:00-04:00,112.60001,114.24001,112.59,114.21001,7178320,11960143.1,56.33874766957475,45.115320483808674,NaN,NaN,94.90113262218485,-20.458196090164897,0.4774157049945731,-0.585303305884139,-1.0627190108787121,207320409,202181506.2,76.01109842340074,68.46626689366398,NaN,NaN,-5.0151926298572596,-9.163288742127635
2011-10-11T09:30:00-04:00,113.62,114.35001,113.53,114.00999,7837949,11809775.3,55.848361836755956,45.97730420266915,NaN,NaN,92.7878820531295,26.38509066701796,0.6297910104359087,-0.2754802478338263,-0.905271258269735,199482460,203747072.6,76.74913086774819,68.6829943348674,NaN,NaN,-2.515080313681435,-8.213544680921036
2011-10-12T09:30:00-04:00,114.77,116.12,114.41,114.99001,7856480,11470847.95,57.78711261141948,47.48144545343263,NaN,NaN,117.52880753810868,63.24079456619528,0.7630779865941346,0.048576224972933346,-0.7145017616212013,207338940,204889641.2,77.2980689587464,69.32250194645904,NaN,NaN,0.1503465045685977,-7.018703082993945
2011-10-13T09:30:00-04:00,114.53,115.00999,113.64,114.66,5496121,11263303,56.881334576897,48.845380345068385,NaN,NaN,94.02815137747534,84.02781243267125,0.7920713810062873,0.27558746463665784,-0.5164839163696294,201842819,203225343.4,74.53753778234946,70.12371674913753,NaN,NaN,2.099506029511735,-5.71610178120742
2011-10-14T09:30:00-04:00,115.82001,116.35001,115.16,116.34,5256980,10909539.1,60.29342174566086,49.934468710472075,NaN,NaN,131.45251998304835,106.13969871478932,0.880644548791309,0.5843217696195069,-0.29632277917180216,207099799,204616885.4,75.33082171568381,71.02651826494066,NaN,NaN,4.792260076200951,-4.214907230149081
2011-10-17T09:30:00-04:00,115.84,115.88,113.64,113.89999,8404945,10843418.6,53.65272566196385,50.30545814771291,NaN,NaN,86.92593878893935,104.54465994814022,0.7369814322907129,0.6249040111915889,-0.11207742109912394,198694854,202891774.4,72.32261424175253,71.69225178940981,NaN,NaN,5.241077789150081,-2.864052227392058
2011-10-18T09:30:00-04:00,113.53999,116.42,112.83,115.50999,11694309,11024602.2,57.01676973526269,51.1894641071803,NaN,NaN,96.51251556584702,105.28958665068373,0.7120706168013677,0.7780108499025857,0.06594023310121802,210389163,205073115,73.75004411269283,72.40154814025162,NaN,NaN,6.632588631109544,-1.5073892476061148
2011-10-19T09:30:00-04:00,115.47009,116.25,114.58,114.95,15286883,11042117.65,55.50763071706746,51.707129578393676,NaN,NaN,94.52250415140857,100.68832597334371,0.6227906638021392,0.8444285628538921,0.22163789905175285,195102280,202625783,69.42397662782824,72.45950977542331,NaN,NaN,7.342023206675494,-0.24318746842302796
2011-10-20T09:30:00-04:00,115.07001,115.77,113.84,115.33,7946191,10451924.8,56.35189809712069,52.63034292995447,NaN,NaN,79.00450295823161,97.68359628949496,0.5564140850250656,0.9171555053330849,0.36074142030801926,203048471,202866913.4,69.61310690742084,72.40242265020457,NaN,NaN,8.164445078001858,0.9579028953519555
2011-10-21T09:30:00-04:00,116.45,117.88,116.42999,117.85001,13018090,10499951.15,61.5610745220595,54.24091764436172,NaN,NaN,126.02642848778741,96.59837799044278,0.643174725935601,1.1647098277275205,0.5215351017919195,216066561,204660265.8,71.04748836630944,72.59889138114046,NaN,NaN,10.454069612490411,2.314498140657449
2011-10-24T09:30:00-04:00,118.17,119.16,118.00999,118.88,8414898,10346643.5,63.479545799258005,55.75001480249576,NaN,NaN,140.60049746556706,107.33328972576832,0.7248151524808061,1.4275540423929272,0.7027388899121211,224481459,209817586.8,74.7402451506898,73.13051073558852,NaN,NaN,12.949093707688842,3.833726078804791
2011-10-25T09:30:00-04:00,118.22,118.36,116.57001,116.78999,9406551,10138751.3,57.237010015882014,56.552359696897796,NaN,NaN,95.20741923037902,107.07227045867474,0.5982034903343147,1.4504932528300145,0.8522897624956998,215074908,210754735.8,75.35535985232741,73.55014883272129,NaN,NaN,13.27204535783002,5.182057404379824
2011-10-26T09:30:00-04:00,118.38,118.66,116.67999,118.41,9943680,10072655.8,60.48105305877398,57.30352140031238,NaN,NaN,101.82251165689189,108.5322719597714,0.5831020284130328,1.5811672980119909,0.998065269598958,225018588,216737997.4,78.88988867882787,74.11343786907601,NaN,NaN,14.530046977544606,6.517484486260507
2011-10-27T09:30:00-04:00,121.08,122.58,120.44991,121.94,12855383,10054345.85,66.45297649155492,58.49211875280366,NaN,NaN,168.48812538304404,126.42899644473387,0.7592467355121888,1.947123688989194,1.1878769534770053,237873971,223703097.4,82.10700105363779,74.79831305281542,NaN,NaN,17.63918222490787,8.106298448924417
2011-10-28T09:30:00-04:00,121.58,122.24001,121.36,122.03999,6669359,9870502.1,66.60690959562999,59.225558890379034,NaN,NaN,158.84124600281635,132.99195994773967,0.825401337726609,2.2196286256352664,1.3942272879086575,244543330,229398451.2,84.22412893293708,75.38495808921087,NaN,NaN,20.12930373997269,9.823870633359885
2011-10-31T09:30:00-04:00,120.75,120.92081,119.27,119.34,13398555,9864030.45,58.765554153042316,59.43392977011378,NaN,NaN,106.73939823507254,126.21974010164077,0.6385789005519587,2.1924509135986057,1.553872013046647,231144775,230731114.4,84.68088263799771,75.95151178708583,NaN,NaN,19.818886336651424,11.25173001954439
2011-11-01T09:30:00-04:00,116.89999,117.6685,116.03,116.38,15126414,9716150.35,51.59440574883497,58.99159356564345,NaN,NaN,25.29815531935403,112.23788731943576,0.2849402156792249,1.910047282645678,1.6251070669664531,216018361,230919805,84.74821501528824,76.48366507683883,NaN,NaN,17.13730825580824,12.092526910439226
2011-11-02T09:30:00-04:00,117.8,118.52,117.17,118.13,7617184,9598436.1,55.084171754125194,58.86322479258832,NaN,NaN,49.70549987588164,101.8144849632337,0.1452144229305279,1.806625095629613,1.6614106726990852,223635545,230643196.4,84.1642084295402,77.17128440878103,NaN,NaN,16.060531876689826,12.65938476276074
2011-11-03T09:30:00-04:00,119.23,120.41,118.16,120.19,12011930,9772122.05,58.84542620849237,58.75979653993344,NaN,NaN,87.62620710645588,85.64210130791606,0.16634224646536966,1.8693384807807973,1.7029962343154277,235647475,230197897.2,83.17057135051007,77.73126652555433,NaN,NaN,16.39015155632457,13.192351447555572
2011-11-04T09:30:00-04:00,119.39999,119.67999,118.24001,119.60001,7022945,9622158.35,57.36381770050381,59.02487454268629,NaN,NaN,68.02773216566605,67.479398540486,0.11768714644512701,1.8501051673718365,1.7324180209267095,228624530,227014137.2,76.24018599143943,78.01109307910339,NaN,NaN,16.18775108364677,13.620265681282886
2011-11-07T09:30:00-05:00,119.52,120.5,118.55,120.45,8697074,9698096.05,58.96673343169837,59.16415766386027,NaN,NaN,81.1500981250442,62.36153851848034,0.11947196933398829,1.8817579825941948,1.7622860132602065,237321604,228249503,77.03966284655704,78.24606584580798,NaN,NaN,16.505089360771784,14.0323833497813
2011-11-08T09:30:00-05:00,121.00999,121.75,119.89999,121.59,7383730,9675385.1,61.080122994102624,59.56219282650564,NaN,NaN,109.52990321525188,79.2078880976599,0.1710134552524225,1.9760528323257347,1.8050393770733122,244705334,233986897.6,80.34711129034409,79.02628975027339,NaN,NaN,17.399557231438433,14.513408190018033
2011-11-09T09:30:00-05:00,119.33,119.67,117.24001,117.69,12104203,9887771.25,51.33850446964853,59.204093281686205,NaN,NaN,11.817013917982703,71.63019090608012,-0.07099123614707303,1.716300331889471,1.787291568036544,232601131,235780014.8,81.25589028298732,79.85791713424244,NaN,NaN,15.05188733574499,14.590333782264741
2011-11-10T09:30:00-05:00,118.96001,119.55,117.88,118.89,9960816,10111006,53.78110312748693,58.64838103921674,NaN,NaN,25.955758236148736,59.29610113201869,-0.15866680988069115,1.58895805568568,1.747624865566371,242561947,237162909.2,81.94914784962151,80.63660709733615,NaN,NaN,13.900305492382625,14.491758312281581
2011-11-11T09:30:00-05:00,120.24001,121.71001,120.22,121.53,7261105,10211212.25,58.69348966569229,58.30651988681918,NaN,NaN,102.56914858531283,66.20438441594806,-0.05275671440891072,1.6816789725552326,1.7344356869641433,249823052,241402613.6,83.91351314333318,81.29184052538211,NaN,NaN,14.49429945470996,14.492121332628493
2011-11-14T09:30:00-05:00,121.33,121.57001,120.17999,120.71001,7391191,10160524.55,56.67846507781247,58.26662381981422,NaN,NaN,83.47481900728651,66.66932859239652,-0.051751089478338175,1.6697468251162206,1.7214979145945588,242431861,242424665,84.35549873217116,81.9347075882281,NaN,NaN,14.344089462212132,14.470973922569012
2011-11-15T09:30:00-05:00,120.38,121.58,119.92999,120.87,6470598,9899339,56.98873636396979,58.0171726273282,NaN,NaN,75.27012141960404,59.817372233266966,-0.05389228547712244,1.6541325577481558,1.7080248432252783,248902459,243264090,84.72667010930448,82.35162054754785,NaN,NaN,14.314955084238553,14.448685517093232
2011-11-16T09:30:00-05:00,119.87,121.14,118.91,119.10001,7146227,9492306.2,52.508223456867434,57.02111883913624,NaN,NaN,24.915480689731172,62.43706558761666,-0.18093758623289502,1.4818528604341594,1.6627904466670544,241756232,245095110.2,85.53295497513044,82.59633154194019,NaN,NaN,12.951358553884448,14.234781665206263
2011-11-17T09:30:00-05:00,119.06,119.50999,116.78999,117.83,10992527,9644623,49.500947849600834,55.79926442870559,NaN,NaN,-64.72208903765708,44.30149613285549,-0.34729048654321115,1.2286773384880405,1.5759678250312517,230763705,242735461.8,79.69419894358506,82.27276511412933,NaN,NaN,10.90227808845615,13.758709725670533
2011-11-18T09:30:00-05:00,117.96001,118.3,117.28999,117.73,8307527,9409094.85,49.26170833192486,55.12041829862578,NaN,NaN,-80.56627136658528,7.6744121424758704,-0.45410128470837985,1.0083412191457768,1.4624425038541566,222456178,237262087,68.08434645420391,81.08729824385833,NaN,NaN,9.168388546052277,13.10294955715364
2011-11-21T09:30:00-05:00,116.11,116.3208,114.28,115.16,18832208,9929960.35,43.449726394052256,54.53865548756987,NaN,NaN,-177.74707495219087,-44.569966649419605,-0.674587689181414,0.6192078923773892,1.2937955815588031,203623970,229500508.8,55.69389532838169,79.01198969479358,NaN,NaN,5.852274596346377,12.067138848466888
2011-11-22T09:30:00-05:00,114.98,115.53,114.13,114.74001,8398418,9879553.7,42.56589969919544,53.644493197932036,NaN,NaN,-176.65682555925494,-94.9553560451914,-0.8160193625834544,0.27377137832948506,1.0897907409129395,195225552,218765127.4,43.81631835402617,76.12999754654257,NaN,NaN,2.8695958764726313,10.753204138181994
2011-11-23T09:30:00-05:00,113.75,113.89,112.33,112.33,7994105,9782074.95,37.81273621708055,52.142158198545474,NaN,NaN,-210.61533880510407,-142.06151994415845,-1.0256255342297158,-0.19224117687420517,0.8333843573555105,187231447,207860170.4,35.527756150598776,72.72693931797748,NaN,NaN,-1.2550074625039371,9.037745338084004
2011-11-25T09:30:00-05:00,112.28,113.46001,112.14,112.14,3532093,9315910.45,37.45761186093304,50.720286352861855,NaN,NaN,-183.5270566275882,-165.82251346214466,-1.1229607988333878,-0.5703166411862242,0.5526441576471636,183699354,198447300.2,30.214700058083906,69.43940460845208,NaN,NaN,-4.711432789181096,7.0735770341889905
2011-11-28T09:30:00-05:00,114.78,115.48,114.31,115.099,6667324,9315808.7,45.968339905093046,49.791829672390044,NaN,NaN,-95.7721141808765,-168.8636820250029,-0.9413030803682757,-0.6239846928131811,0.31731838755509456,190366678,192029400.2,27.225170887963742,65.8812266114097,NaN,NaN,-5.303157925874799,5.3054720398941635
2011-11-29T09:30:00-05:00,115.32001,116.17999,115.11,115.56,5327195,8912240.7,47.17442277043441,48.79856537069945,NaN,NaN,-66.44291822565896,-146.60285067969653,-0.7515718669753174,-0.6221464461640522,0.12942542081126518,195693873,190443380.8,26.526669196276472,62.03690931897631,NaN,NaN,-5.430820858695266,3.771715911524245
2011-11-30T09:30:00-05:00,118.41,120.39,118.41,120.19,11584852,8735162.6,57.44784513248937,49.23494684661665,NaN,NaN,53.28493638908559,-100.61449829002842,-0.2989575423251771,-0.24427150709520618,0.05468603522997091,207278725,192854015.4,29.48787259745825,58.33919377000995,NaN,NaN,-2.1133368978186575,2.930994081618116
2011-12-01T09:30:00-05:00,120.00999,120.55,119.66,120.13,5440070,8626306.9,57.2923479745678,49.48575004997957,NaN,NaN,61.61979480496219,-46.16747156801516,-0.003923425832085103,0.04978175293986453,0.053705178771949635,201838655,195775457,33.011494545782185,54.843647105449996,NaN,NaN,0.42826426339916773,2.5734612504439807
2011-12-02T09:30:00-05:00,121.22,121.39999,120,120.06,5587133,8305067.05,57.098168926871146,49.37179856863521,NaN,NaN,70.25995598784777,4.589930955072018,0.1762470587597132,0.2740140022215911,0.09776694346187793,196251522,198285890.6,35.972428574148736,51.41928392193683,NaN,NaN,2.4065195154457144,2.549612431158514
2011-12-05T09:30:00-05:00,121.77,121.85001,120.213,120.95,6286367,8268238.15,59.00081336907089,49.53768058943938,NaN,NaN,80.14743462412963,39.77384071607323,0.3358416642011317,0.5175690237132926,0.18172735951216087,202537889,200720132.8,38.79730043615227,48.16512690079263,NaN,NaN,4.627502306156107,2.8464538418724556
2011-12-06T09:30:00-05:00,120.96001,122.09,120.67999,121.39,7065777,8186673.3,59.946547618859604,49.7489528219315,NaN,NaN,86.30466688948353,70.32335773910174,0.44469009447285973,0.7375899776032355,0.2928998831303758,209603666,203502091.4,41.94946931356409,45.10961255823973,NaN,NaN,6.7442221991334,3.4032778929097334
2011-12-07T09:30:00-05:00,121.06,122.57001,120.58,122.07001,9030105,8268992.05,61.42742734764932,50.38603881413021,NaN,NaN,93.97555419704376,78.46148130069336,0.53032912950266,0.9558112950087008,0.4254821655060408,218633771,205773100.6,44.464052448759475,42.176119520641805,NaN,NaN,8.955666102049806,4.196476208501172
2011-12-08T09:30:00-05:00,121.5,121.81,119.64,119.94,9600250,8143794.4,54.615824014119234,50.75138711159581,NaN,NaN,54.339143601983224,77.00535106009758,0.4163939864658792,0.9459746485883898,0.5295806621225105,209033521,207212073.8,46.058468194763336,39.7735673242974,NaN,NaN,9.018329638602067,4.8853124128013
2011-12-09T09:30:00-05:00,120.47,122.11,120.4084,121.78,9002828,8095895,58.859812111488786,51.43696595299324,NaN,NaN,73.28634817224808,77.61062949697765,0.4357500008879486,1.0742681632324462,0.6385181623444977,218036349,211569039.2,50.675920969484494,38.53010836110316,NaN,NaN,10.335146194638204,5.663860095920858
2011-12-12T09:30:00-05:00,120.91,120.96001,119.38,120.24001,6291660,8047422.75,54.284406916003604,52.21087170456119,NaN,NaN,43.81571159191212,70.34428489053415,0.32093942834381906,1.0396924477742715,0.7187530194304524,211744689,213410399.2,52.52552447455696,38.30379615725854,NaN,NaN,10.097391176148268,6.297221678810487
2011-12-13T09:30:00-05:00,120.91,121.49001,119.05,119.50999,7762180,8065972.2,52.21242438305073,52.899909181979424,NaN,NaN,40.819757268669974,61.24730296637144,0.1790133055420816,0.9425196513580545,0.7635063458159729,203982509,212286167.8,51.26162164716579,38.835603535339935,NaN,NaN,9.290488221910438,6.724831184967623
2011-12-14T09:30:00-05:00,119.08,119.49001,117.91,118.32001,10064145,8245649.55,48.933673647382065,53.694261855572385,NaN,NaN,6.449815079868118,43.74215514293631,-0.002229897150132887,0.7607189743783067,0.7629488715284396,193918364,207343086.4,46.0183640171664,39.58493266866619,NaN,NaN,7.634163686072244,6.854735827982569
2011-12-15T09:30:00-05:00,119.59,119.75,118.58,118.81,5267164,8151696.4,50.3171547730629,54.61280063501023,NaN,NaN,20.300134307204242,36.93435328398051,-0.09139837257354433,0.6487009058115092,0.7400992783850535,199185528,205373487.8,44.08350373642808,40.57556150283364,NaN,NaN,6.647662007222153,6.825153853588224
2011-12-16T09:30:00-05:00,119.10001,119.39999,117.89,118.22,7758578,7989998.95,48.609465136293565,54.80145243723884,NaN,NaN,4.921533803918605,23.26139041031461,-0.18689595727049169,0.5064793317969389,0.6933752890674306,191426950,200051608,39.27799114060654,41.43647723516527,NaN,NaN,5.338291047735731,6.612744881323582
2011-12-19T09:30:00-05:00,118.64999,118.98,117.05,117.36,7980367,7973640.95,46.150779354929085,54.72833505041704,NaN,NaN,-14.407601323225846,11.616727827287018,-0.29815915939177384,0.32067633982771326,0.6188354992194871,183446583,194391986.8,34.91858583111319,42.03589985193931,NaN,NaN,3.5256103978898916,6.171725669404483
2011-12-20T09:30:00-05:00,119.11,120.88,119.07001,120.67999,7870223,7425541.7,55.50693644400727,54.58969871552546,NaN,NaN,47.697064596953304,12.992189292943683,-0.14603458255808255,0.43629227102188395,0.5823268535799665,191316806,191858846.2,33.145386019269466,42.29715081064012,NaN,NaN,4.671726856380075,5.957440124686711
2011-12-21T09:30:00-05:00,120.8,120.87,119.69,120.81,6679770,7339609.3,55.830578136493756,54.48528658423446,NaN,NaN,50.60850222938909,21.82392672284788,-0.040042499107865615,0.5322737296951345,0.5723162288030001,197996576,192674488.6,34.302235362162435,42.38934658323871,NaN,NaN,5.687603119351168,5.918891981067348
2011-12-22T09:30:00-05:00,121.14,121.55,120.91,121.53,4209168,7150362.45,57.6670776804372,54.525922923774885,NaN,NaN,76.5120373193602,33.06630732527908,0.06922139949744255,0.6588429781748033,0.5896215786773608,202205744,193278531.8,35.19656238242575,42.33392756954421,NaN,NaN,7.073320209345313,6.083810299392772
2011-12-23T09:30:00-05:00,121.7,122.67999,121.5,122.63,2283357,7087925.65,60.377610353365206,54.62426556551019,NaN,NaN,117.84620350426418,55.65124126534819,0.19890115702065048,0.8382480249531739,0.6393468679325234,204489101,195890962,39.06029853008022,42.352713147681925,NaN,NaN,9.056333962892339,6.508456537035567
2011-12-27T09:30:00-05:00,122.48,123,122.39999,122.67,3886252,6948872.05,60.476712132688554,54.66213445935512,NaN,NaN,142.70357045071827,87.07347562013702,0.2664790926005427,0.9724457336832018,0.705966641082659,208375353,200876716,45.712700576594514,42.621515380755525,NaN,NaN,10.707581745619034,7.108331566833205
2011-12-28T09:30:00-05:00,122.66,122.72,121.13,121.2471,3871327,6876078.65,55.18872688710535,54.2165129978877,NaN,NaN,83.28480945578269,94.1910245919029,0.19762404209416928,0.9529966937003707,0.7553726516062014,204504026,203514160,48.89112281243212,42.93773469244643,NaN,NaN,10.688414293631297,7.619771956375789
2011-12-29T09:30:00-05:00,121.52,122.67999,121.46001,122.52,5136105,6553641.3,58.67025109760639,54.506114932422484,NaN,NaN,103.64708023612972,104.79874019325102,0.2184541675327012,1.0284403610220778,0.8099861934893766,209640131,205842871,51.58636664106679,43.332584581468105,NaN,NaN,11.675347634967547,8.199139910460326
2011-12-30T09:30:00-05:00,122.33,122.63,121.84,121.85001,4735395,6518407.55,56.19544067851979,54.315802687210414,NaN,NaN,85.86708322233419,106.66974937384582,0.16991667207602412,1.0223820335844067,0.8524653615083826,204904736,206382669.4,52.21542384488478,43.44254907256812,NaN,NaN,11.807757897585002,8.714656765763852
2012-01-03T09:30:00-05:00,123.94,124.53,123.61,123.63,7176125,6597857.15,60.91273716727863,54.78925484801578,NaN,NaN,164.82117357561825,116.06474338811663,0.23641003696636476,1.1479779077163386,0.9115678707499738,212080861,207901021.4,54.02497150703225,43.54965243203064,NaN,NaN,13.3292607749045,9.373885909926802
2012-01-04T09:30:00-05:00,123.39999,124.05,123.11,123.97,7627270,6664902.3,61.759846606694985,55.47121357827608,NaN,NaN,133.06006287338056,114.13604187264909,0.2790812005256067,1.2604193714069822,0.9813381708813755,219708131,210167577,56.66323044192133,43.93548163165604,NaN,NaN,14.826811546181743,10.15287528653465
2012-01-05T09:30:00-05:00,123.46001,124.1115,122.59,123.95,8680609,6745643.9,61.67517254413835,56.381320642330095,NaN,NaN,111.9762227914436,119.87432453978127,0.280973735416032,1.3325553401514156,1.0515816047353836,211027522,211472276.2,58.15190513141326,44.80216313981652,NaN,NaN,16.032658296370457,10.992844287939766
2012-01-06T09:30:00-05:00,124.08,124.08,123.14,123.53,7488555,6668566.4,59.820371745647755,57.06012185465759,NaN,NaN,103.39801789816335,119.82451207218801,0.2310403445587259,1.340382035433791,1.109341690875065,203538967,210252043.4,56.207206739558835,45.66814192575445,NaN,NaN,16.56591735158378,11.788997582746054
2012-01-09T09:30:00-05:00,123.69,123.91,123.14,123.66,5883293,6482718.55,60.21915748828217,57.88938559408535,NaN,NaN,92.91715918446086,121.23452726461332,0.18581418575734387,1.3416094230717448,1.155795237314401,209422260,211155548.2,57.34466155265937,46.958618383758214,NaN,NaN,17.118524621935425,12.550358588344535
2012-01-10T09:30:00-05:00,124.88,125,124.27,124.38,5277164,6296435.35,62.44248956059643,59.05307918020444,NaN,NaN,117.0399499809601,111.67828254568171,0.18313817232814777,1.3847179527245856,1.2015797803964379,214699424,211679260.8,58.0252226944946,48.60909244542832,NaN,NaN,18.187309855831085,13.355637340842614
2012-01-11T09:30:00-05:00,124.03999,124.45,123.8,124.28999,4894816,6226593.15,61.97615464704301,59.51516619470699,NaN,NaN,93.63864075936424,103.79399812287843,0.15516169192208484,1.3955318952990439,1.240370203376959,209804608,209698556.2,54.48460577803876,50.13332242819756,NaN,NaN,18.97531870876946,14.158448964832164
2012-01-12T09:30:00-05:00,124.5,124.67,123.66,124.53,5592109,6118089.6,62.77448329607661,60.01115942039148,NaN,NaN,89.47765731154458,99.29428502689863,0.1335014028294803,1.4072469569138093,1.273745554084329,215396717,210572395.2,55.766952261044516,51.666516492403424,NaN,NaN,19.855047137321996,14.972248703759282
2012-01-13T09:30:00-05:00,123.71001,124.16,122.92,124.16,6392387,5934501.7,60.660089870756586,60.22494600541429,NaN,NaN,64.7316464210604,91.56101073147805,0.07770175842631444,1.3708727521172221,1.2931709936909077,209004330,211665467.8,57.38435584640846,53.251358882687896,NaN,NaN,20.10342998848164,15.705274601576763
2012-01-17T09:30:00-05:00,125.03999,125.57001,124.46001,124.618,5348758,5938581.4,62.35056786032946,60.36587154162602,NaN,NaN,103.54485856438862,93.6865506074636,0.0560932646840111,1.3632875745459216,1.3071943098619105,214353088,212651633.4,58.846414322296305,54.66465286784619,NaN,NaN,20.742549868804726,16.4248853540379
2012-01-18T09:30:00-05:00,124.53,125.72501,124.41,125.62,6474164,5874360.7,65.81186218247223,60.74695368803914,NaN,NaN,113.25711370720423,92.92998335271241,0.09163683595167149,1.4217403548015,1.3301035188498285,220827252,213877199,60.65308012046168,55.73182283526528,NaN,NaN,22.237444446945197,17.255250938738943
2012-01-19T09:30:00-05:00,125.99001,126.17999,125.52,126.17,8099328,5880308.75,67.57405102090405,61.63161969759619,NaN,NaN,144.3961162905905,103.08147845895766,0.13208451867832016,1.4952091671977286,1.3631246485194084,228926580,217701593.4,65.71164766290624,56.93328889601343,NaN,NaN,24.017943319785346,18.221349850317
2012-01-20T09:30:00-05:00,126.03999,126.96001,125.95,126.96001,6998047,5836699.95,69.96851542011105,62.4386385777751,NaN,NaN,172.85055123384535,119.75605724341781,0.18850149925073767,1.5987515225828304,1.4102500233320927,235924627,221807175.4,70.1485421243805,58.25915857339298,NaN,NaN,26.261586022851528,19.369955017821933
2012-01-23T09:30:00-05:00,126.89,127.36,126.38,126.81,5168324,5761127.65,68.92768096064216,63.34808431221241,NaN,NaN,168.6446721726926,140.53866239374423,0.19155074160133023,1.6496884503337554,1.4581377087324252,230756303,226157570,73.98934774775172,59.81443885216919,NaN,NaN,27.8852392120693,20.5864241884287
2012-01-24T09:30:00-05:00,126.10001,126.554,125.87,126.42999,4798125,5790575.5,66.23951757544575,63.728568627081486,NaN,NaN,121.6025477787688,144.1502002366203,0.1458756276518196,1.6404822432971997,1.49460661564538,225958178,228478588,75.77982420400028,61.368356901952616,NaN,NaN,28.594166262187677,21.73038734182284
2012-01-25T09:30:00-05:00,126.06,127.52,125.47,127.25,9642930,6158554.15,69.04496479962413,64.24893421229072,NaN,NaN,128.55824989266344,147.21042747371214,0.14830538894027612,1.6799883518207253,1.5316829628804491,235601108,231433359.2,77.86844383704498,62.88301500160431,NaN,NaN,29.99060596127817,22.9104185731736
2012-01-26T09:30:00-05:00,127.85001,128.13,126.655,127.06,5910551,6259769.1,67.64237257445868,64.67516278588502,NaN,NaN,135.12934101894913,145.35707241938388,0.11596448536688797,1.676638569589059,1.5606740842221711,229690557,231586154.6,77.97421919015711,64.29889457722888,NaN,NaN,30.805004223990412,24.038216523290288
2012-01-27T09:30:00-05:00,126.47,126.75999,126.00999,126.45,6136609,6373033.2,63.20322511181643,64.91679516918279,NaN,NaN,81.78721265858229,127.14440470433127,0.03645764096118009,1.6062461354236461,1.569788494462466,223553948,229112018.8,71.97554300583808,65.42520431053454,NaN,NaN,30.327983017583843,24.936754593903654
2012-01-30T09:30:00-05:00,125.39,126.31,125,126.23,5910535,6411754.7,61.63226062828826,65.01773110775464,NaN,NaN,46.74939823418167,102.76534991662909,-0.04363822668903583,1.5152407111011712,1.558878937790207,217643413,226489440.8,66.16493180231494,66.05522361408137,NaN,NaN,29.50247695177745,25.58900064502848
2012-01-31T09:30:00-05:00,126.88,126.92,125.38,126.07001,5952723,6472621.1,60.4554211771411,64.87579765179355,NaN,NaN,54.47835507676979,89.34051137622929,-0.11597536661181129,1.413909729525443,1.5298850961372543,211690690,223635943.2,60.44692267328636,66.22820218399507,NaN,NaN,28.490089468361646,26.003441905504648
2012-02-01T09:30:00-05:00,127.07001,127.59,126.77,126.91,9893363,6608483,64.3087561607669,65.04241204563097,NaN,NaN,98.41436863959669,83.31173512561594,-0.11557673511606881,1.3854141772421684,1.5009909123582372,221584053,220832532.2,55.382996456037134,66.29237294670925,NaN,NaN,28.589949571695012,26.3729430006747
2012-02-02T09:30:00-05:00,127.02,127.16,126.48,126.84,4534156,6453827.3,63.75125324229635,65.1121813275038,NaN,NaN,76.39342511349022,71.56455194452415,-0.12741964128229344,1.3417163607553704,1.4691360020376638,217049897,218304400.2,51.216058960132955,65.96730913950127,NaN,NaN,28.52718107179867,26.68069129654955
2012-02-03T09:30:00-05:00,128.0401,128.49001,127.83,128.37,8654617,6452527.7,69.8945351746867,65.77178456349881,NaN,NaN,143.55096207236525,83.91730182728074,-0.043915804141265946,1.4142412468610814,1.4581570510023474,225704514,218734513.4,51.879403634084035,65.57409826719238,NaN,NaN,30.268076346278956,27.193174875082324
2012-02-06T09:30:00-05:00,127.83,128.19,127.67999,128.12,3853485,6270774.2,67.87048323330535,66.1660642329971,NaN,NaN,122.86891532034885,99.14120524451417,-0.018523233189650323,1.4350030095152846,1.453526242704935,221851029,219576036.6,53.21967759709549,65.17218850110662,NaN,NaN,31.13806925994754,27.756731215777354
2012-02-07T09:30:00-05:00,127.95,128.75999,127.55,128.50999,5741316,6263675.35,69.36104679858165,66.41957741986205,NaN,NaN,130.68650117017364,114.38283446319494,0.01000008625020743,1.4660263505176943,1.4560262642674868,227592345,222756367.6,57.98269024230691,64.98144636695271,NaN,NaN,32.302495851788905,28.406126163779003
2012-02-08T09:30:00-05:00,128.62,128.8,128.03,128.71001,4892910,6244462.65,70.12653163250977,66.60189746354818,NaN,NaN,132.6840277702631,121.23676628932822,0.026844224837423436,1.489581545314266,1.4627373204768426,232485255,224936608,60.92025210395133,64.63920382702734,NaN,NaN,33.4927789096718,29.13279084176369
2012-02-09T09:30:00-05:00,128.96001,129.12,128.30499,128.75999,5416531,6270548.4,70.32603295989783,66.6274344306758,NaN,NaN,134.15595084308555,132.7892714352473,0.02584869585352112,1.495048190293744,1.469199494440223,237901786,229106985.8,65.83989595646102,64.33144338646167,NaN,NaN,34.5400353457295,29.905254342330235
2012-02-10T09:30:00-05:00,127.75999,127.92,127.3,127.85001,6385281,6310207,62.183565350717174,66.14571188710974,NaN,NaN,62.723570823802206,116.6237931855347,-0.047597522842697026,1.4097025908868517,1.4573001137295487,231516505,230269384,67.08371426823214,63.83818385221027,NaN,NaN,33.19620418315925,30.37539003387724
2012-02-13T09:30:00-05:00,128.67999,128.77,128.08,128.59,4656527,6223414,65.66498115687307,66.1046735714974,NaN,NaN,106.4128035200838,113.33257082548168,-0.05719854294752924,1.3858019350451372,1.4430004779926664,236173032,233133784.6,69.98408101159626,63.42420219560999,NaN,NaN,33.00504837990657,30.75105551188143
2012-02-14T09:30:00-05:00,128.38,128.69,127.7771,128.66,5609133,6236432.75,65.9839993416675,65.88603318164336,NaN,NaN,89.05630076759356,105.00653074496567,-0.06890615765523544,1.356867780923622,1.4257739385788575,241782165,235971748.6,72.56353647593173,63.04528024124476,NaN,NaN,32.93643093843222,31.063252001388683
2012-02-15T09:30:00-05:00,129,129.03999,127.57001,127.86,9589164,6392182.75,59.21273314251778,65.28391607936186,NaN,NaN,65.09239373292164,91.48820393749739,-0.13668472898940598,1.2549180273421001,1.391602756331506,232193001,235913297.8,72.42548658369671,62.648942197926154,NaN,NaN,30.880619980263763,31.03716171265655
2012-02-16T09:30:00-05:00,127.98,129.17999,127.95,129.07001,8700559,6422244.3,65.0540614650991,65.41611867602491,NaN,NaN,99.07628865337412,84.47227149955509,-0.1074687503579963,1.2572668183840108,1.364735568742007,240893560,236511652.6,72.99193977505162,62.7215419671557,NaN,NaN,30.808776719251185,31.004535285027213
2012-02-17T09:30:00-05:00,129.31,129.39,128.86,129.23,5768113,6360747.6,65.75246258005807,65.71041881543704,NaN,NaN,118.28007487708291,95.58357231021124,-0.08575489712287743,1.2575419473384102,1.3432968444612876,246661673,239540686.2,75.71199661846501,63.40347516830928,NaN,NaN,30.96052766804118,30.998248482600637
2012-02-21T09:30:00-05:00,129.62,129.75,128.96001,129.35001,6592211,6431941.95,66.29657856775981,66.12764434333837,NaN,NaN,119.545374708705,98.21008654793548,-0.0722374842553184,1.2529999891421397,1.3252374733974581,253253884,242956856.6,78.35914952925344,64.6829199437355,NaN,NaN,31.24125011037378,31.032963000853943
2012-02-22T09:30:00-05:00,129.23,129.5,128.85001,129.14,6094719,6496771.65,64.36928425137586,66.13196777838188,NaN,NaN,98.1757616441655,100.03397872324987,-0.08546250811205636,1.2184093382573877,1.303871846369444,247159165,244032256.6,79.13026486701001,66.37915340166214,NaN,NaN,30.9341946680392,31.018853239023265
2012-02-23T09:30:00-05:00,128.99001,129.69,128.55,129.58,12891488,6659199.55,66.56253200560717,66.33277340433264,NaN,NaN,99.50493357436193,106.91648669153793,-0.07307898961520132,1.2125231093504425,1.2856020989656438,260050653,249603787,82.5912634802568,68.62023943881384,NaN,NaN,31.28388427929643,31.056714816205147
2012-02-24T09:30:00-05:00,129.77,129.89999,129.25,129.62,3769859,6552164.95,66.76283118404055,66.10908026214364,NaN,NaN,113.82431615507566,109.86609219187824,-0.07065420112078602,1.1972843475646613,1.2679385486854473,263820512,254189177.4,84.82216684596631,70.97329395394829,NaN,NaN,31.62771144180135,31.13828576271889
2012-02-27T09:30:00-05:00,128.92999,130.03999,128.57001,129.66,5778508,6534259.9,66.9758715173605,66.04517942529043,NaN,NaN,97.04578092677092,105.61923340181583,-0.07443742786265162,1.1748917638571328,1.2493291917197844,269599020,258776646.8,86.66351694771157,73.36213962184944,NaN,NaN,31.971795116529794,31.25735852754902
2012-02-28T09:30:00-05:00,129.64,130.035,129.34,129.86,4953926,6486429.45,68.07763299621638,65.95350701083576,NaN,NaN,119.35291400583276,105.58074126124139,-0.07153291112204263,1.159913052817231,1.2314459639392736,274552946,263036459.2,88.10643190555639,75.51383545493867,NaN,NaN,32.55406516841694,31.442602333387295
2012-02-29T09:30:00-05:00,130.02,130.37,129.09,129.28999,7731742,6575380.4,61.754108071637646,65.35547675648776,NaN,NaN,97.9648767320498,105.53856427881824,-0.11356610723891647,1.089488329890628,1.2030544371295444,266821204,266968867,89.26147168977563,77.53820828249755,NaN,NaN,31.3744941428816,31.432872591886483
2012-03-01T09:30:00-05:00,129.60001,130.16,129.23,129.57001,6686016,6415013.05,63.54552587093643,64.87115482156194,NaN,NaN,97.12592457580699,105.06276247910728,-0.12705617268430247,1.0442342212741664,1.171290393958469,273507220,269660180.4,89.97876446717704,79.26241317612013,NaN,NaN,30.829197348860006,31.346633271454127
2012-03-02T09:30:00-05:00,129.53999,129.78999,129.08,129.55,3820114,6379310.95,63.317293545540146,64.95213540690644,NaN,NaN,70.40256189682435,96.37841162745701,-0.1408064122320727,0.995282378668378,1.1360887909004507,269687106,270833499.2,90.2834829161202,80.91953950811214,NaN,NaN,30.312427687862133,31.198889616655272
2012-03-05T09:30:00-05:00,129.42,129.59,128.64,129.42,5288320,6210996.1,61.76520319571454,64.67357983825227,NaN,NaN,35.403424435874406,84.0499403292777,-0.16069729213610828,0.9352171757303154,1.0959144678664237,264398786,269793452.4,87.73676620165298,82.18758845025904,NaN,NaN,29.468801762903052,30.951734208976383
2012-03-06T09:30:00-05:00,127.92999,129.4599,127.17999,127.45,14410008,6738822.25,44.11677679950369,63.11163537095485,NaN,NaN,-111.2866948735696,37.92201855339723,-0.3004525334488011,0.7203488010554224,1.0208013345042235,249988778,264880618.8,76.7268600870355,82.48496870819504,NaN,NaN,22.704012952729137,29.773488315226775
2012-03-07T09:30:00-05:00,127.64,128.45,127.46001,128.23,5738348,6738673.85,50.185918786538686,62.46686291695635,NaN,NaN,-105.38815739073638,-2.74858827116,-0.3318268660520711,0.6060177519391345,0.9378446179912057,255727126,262661803.2,72.31325240447757,82.47695198110796,NaN,NaN,18.900171032584865,28.22015727484936
2012-03-08T09:30:00-05:00,128.82001,129.27,128.55,128.92,4421426,6715099.65,54.856590845564085,61.738472158418126,NaN,NaN,-3.2844625428597336,-22.830665694893348,-0.2986127395988907,0.5645786934925923,0.8631914330914829,260148552,259990069.6,67.29356726175064,82.06992537301502,NaN,NaN,17.278088915814617,26.657004652130112
2012-03-09T09:30:00-05:00,129.22,129.59,128.94,129.14999,6251324,6756839.3,56.326497707335,61.065188953223625,NaN,NaN,33.060235090034645,-30.29913105625129,-0.2553331223840102,0.5440250301114702,0.7993581524954804,266399876,259332623.6,66.07803271843224,81.38178509444126,NaN,NaN,16.46188135409736,25.20055846669686
2012-03-12T09:30:00-04:00,129.17,129.6685,129.10001,129.46001,5199676,6697559.05,58.29765544158521,60.493837301354006,NaN,NaN,51.86425227722585,-27.006965487981006,-0.20232415614139643,0.5464529573187349,0.7487771134601313,271599552,260772776.8,67.46442315806445,80.60359035364203,NaN,NaN,16.414477511821744,23.945404044571845
2012-03-13T09:30:00-04:00,130.05,131.77,129.85001,131.67999,8708133,6900139.35,69.06479587004104,60.829230988401505,NaN,NaN,262.55655243261367,47.761683973255614,-0.02364551715763441,0.7192202170130884,0.7428657341707228,280307685,266836558.2,72.55124671485405,80.1336604856309,NaN,NaN,20.45182455197967,23.44632125991582
2012-03-14T09:30:00-04:00,131.78999,132.17,131.62,131.88,5125004,6875932.9,69.82081832669765,61.06196572562226,NaN,NaN,298.6439690570714,128.56810926281716,0.09557793510102619,0.8623381530470056,0.7667602179459794,285432689,272777670.8,76.43817109212654,79.69415388647873,NaN,NaN,23.785288070318302,23.494745089973318
2012-03-15T09:30:00-04:00,132.00999,132.49001,131.67,132.41,5719672,6682458.3,71.78833859822649,61.42093054092125,NaN,NaN,256.43750198419843,180.5125021682288,0.19212748721958506,1.0069195769704606,0.8147920897508756,291152361,278978432.6,79.67343304681323,79.32638718653924,NaN,NaN,27.157783808707602,24.018036335506785
2012-03-16T09:30:00-04:00,132.53,132.61,132.02,132.05,5048918,6499876.25,68.52062212017887,61.531269869693986,NaN,NaN,195.90329449522832,213.08111404926754,0.21216857272966527,1.0800028056629571,0.8678342329332919,286103443,282919146,81.41954205135963,78.95181755108551,NaN,NaN,28.79399114905833,24.70031559458558
2012-03-19T09:30:00-04:00,131.91,132.39999,131.78,132.07001,4424551,6432698.15,68.60616111881777,61.569021878451224,NaN,NaN,145.57594612990337,231.82345281980307,0.2069728220989181,1.1265502605569395,0.9195774384580214,290527994,286704834.4,82.93604003644822,78.58250384614924,NaN,NaN,30.104886026337425,25.472397084835844
2012-03-20T09:30:00-04:00,131.36,131.7,130.92,131.38,5405285,6373351.85,62.31772582276471,61.60928028924601,NaN,NaN,82.46755758700185,195.80565385068067,0.14044793073580797,1.0951373518777814,0.9546894211419734,285122709,287667839.2,83.3092300940128,78.15734373216617,NaN,NaN,29.27891156234967,26.01618486733782
2012-03-21T09:30:00-04:00,131.53,131.608,130.81,130.99001,5033512,6320291.5,59.02469353974317,61.286363694160784,NaN,NaN,61.815824363319905,148.44002491193038,0.05779693309171241,1.026935587506614,0.9691386544149015,280089197,286599140.8,81.18721115612557,77.52937563851962,NaN,NaN,27.579156572684376,26.239466539530184
2012-03-22T09:30:00-04:00,130.24001,130.55,129.86,130.17,6988266,6025130.4,52.716807290158506,60.52918610449067,NaN,NaN,4.187469742615522,97.9900184636138,-0.05820349638042588,0.8963842839393692,0.9545877803197951,273100931,282988854.8,74.30184756314546,76.38783025616429,NaN,NaN,24.078370247977332,25.930738497879776
2012-03-23T09:30:00-04:00,130.22,130.71001,129.71001,130.60001,4374715,6055373.2,55.40803714469527,60.07510281513215,NaN,NaN,10.822113870161555,60.97378233860044,-0.109119755774984,0.818188085601065,0.927307841376049,277475646,281263295.4,71.19402790123269,75.20620609184856,NaN,NaN,22.001304769095896,25.369390822339223
2012-03-26T09:30:00-04:00,131.39,132.14,131.34,132.09,4994512,6016173.4,63.21977797591623,61.43960289916161,NaN,NaN,90.36225503206317,49.9310441190324,-0.048679250512725813,0.8664587782351418,0.9151380287478676,282470158,279651728.2,68.31989671337551,74.60570870801571,NaN,NaN,22.741705577143794,24.994007215882732
2012-03-27T09:30:00-04:00,132.22,132.35001,131.6485,131.67,5781969,6057575.55,60.027559940726896,62.14257726731791,NaN,NaN,81.96780946584636,49.8310944948013,-0.043391023518011274,0.8608992493503536,0.9042902728683648,276688189,277964824.2,65.34611276783464,74.10805587682694,NaN,NaN,22.28093754234429,24.60642583394867
2012-03-28T09:30:00-04:00,131.73,131.86,130.41,130.98,5294609,5935718.9,55.10474966859397,62.160302897534336,NaN,NaN,33.970174074016455,44.26196443694061,-0.09008026597275531,0.7916899404024207,0.881770206375176,271393580,276225700.8,62.333730752632384,73.75378184046134,NaN,NaN,20.26887338301794,23.98677548381571
2012-03-29T09:30:00-04:00,130.27,131.24001,130.03999,131.13,4489840,5825910.1,55.9504771982044,62.133444289739295,NaN,NaN,15.823800676438333,46.58923062370518,-0.11308830331334718,0.740409827233492,0.8534981305468392,275883420,276782198.6,62.92273138100553,73.5284031735023,NaN,NaN,18.936771635098737,23.265346362570426
2012-03-30T09:30:00-04:00,131.71001,131.97,131.17999,131.8,4218637,5845836.25,59.610368507597215,62.227209508740145,NaN,NaN,58.210655092027444,56.06693886807834,-0.08660436442931996,0.7452426750101893,0.8318470394395092,280102057,277307480.8,63.50287526651435,73.245435466963,NaN,NaN,18.949580718147562,22.64880841336716
2012-04-02T09:30:00-04:00,131.56,132.67999,131.23,132.3,8684297,6015635.1,62.13852740638958,61.73247604705075,NaN,NaN,76.78633774094602,53.35175540985491,-0.041139759489806194,0.7804223400772514,0.8215620995670576,288786354,278570720,64.9242624364155,72.70065087564595,NaN,NaN,19.748655300771404,22.23450082585348
2012-04-03T09:30:00-04:00,132.14999,132.39999,131.05,131.67,6099207,5600095.05,57.27393222229412,60.83626989673622,NaN,NaN,51.13046527418719,47.18428657152308,-0.05818196478126991,0.7488346435904703,0.8070166083717402,282687147,279770511.6,66.26795917452316,71.97420716724571,NaN,NaN,18.91320947099828,21.760030632302737
2012-04-04T09:30:00-04:00,130.66,130.769,129.95,130.51289,10402441,5833299.7,49.594363206869645,59.25098594021073,NaN,NaN,-53.85044001728247,29.620163753263295,-0.14701516751328014,0.62324764898014,0.7702628164934201,272284706,279948736.8,66.47342124757424,71.03134918158578,NaN,NaN,15.628251498001045,20.884062184545353
2012-04-05T09:30:00-04:00,130.10001,130.71001,129.92999,130.39,4179836,5821220.2,48.845281750375015,57.84560448522474,NaN,NaN,-72.16891264244057,12.021621089487523,-0.20985221176277302,0.5079475517899539,0.7177997635527269,268104870,278393026.8,62.87343805193348,69.70662746734106,NaN,NaN,12.798366147986382,19.728962750751215
2012-04-09T09:30:00-04:00,128.96001,129.59,128.84,129.12,5362211,5776764.55,41.81599828269857,55.932021425501944,NaN,NaN,-175.6144951227971,-34.743408953477385,-0.3258289305144165,0.3105136004097062,0.6363425309241227,262742659,274921147.2,55.63239846199868,67.75636735488038,NaN,NaN,7.899903567548505,18.039097153150827
2012-04-10T09:30:00-04:00,128.87,129.07001,126.92149,127.013,12915660,6162563.75,33.26336082091815,53.85670963965576,NaN,NaN,-267.02128600949766,-103.50493370356612,-0.5217056310923321,-0.015789507941292413,0.5059161231510397,249826999,267129276.2,43.51881676066801,64.91419497392718,NaN,NaN,0.11500610722021674,15.478512718017884
2012-04-11T09:30:00-04:00,128.17,128.28999,127.74001,127.85001,5605242,6007419.2,38.63297927891148,52.40015862102492,NaN,NaN,-190.25737515992844,-151.78250179038926,-0.5683249989246073,-0.20449012550471934,0.3638348734198879,255432241,261678295,37.38586151549064,61.785527142453255,NaN,NaN,-4.144290726662108,12.675255083063599
2012-04-12T09:30:00-04:00,128.12,129.78999,128.03999,129.72,7167398,6109538.9,48.58597890725189,52.105099450817306,NaN,NaN,-97.28741043961887,-160.46989587485652,-0.45173119988709065,-0.20082912643897544,0.2509020734481152,262599639,259741281.6,35.472792158658635,59.012023184989914,NaN,NaN,-4.001946047755387,10.292797778660887
2012-04-13T09:30:00-04:00,129.32001,129.36,128.27299,128.39999,8827234,6264917,43.25313185511295,51.236891930132856,NaN,NaN,-112.32547428947102,-168.5012082042626,-0.4414993502257162,-0.30097211433403004,0.14052723589168614,253772405,256874788.6,32.798093466375036,56.269456439642944,NaN,NaN,-5.917361284033048,7.977060769704611
2012-04-16T09:30:00-04:00,129.23,129.7,128.675,129.07001,7508953,6387918.75,46.465163952110004,50.04013378557527,NaN,NaN,-76.2931893630671,-148.63694705231663,-0.37046414847414216,-0.3225529497009916,0.04791119877315059,261281358,256582528.4,32.528784507185605,53.71294842491509,NaN,NaN,-6.223095783336176,5.948466976413069
2012-04-17T09:30:00-04:00,129.83,131.13,129.81,130.94,6295887,6481485.55,54.2487103731434,49.62735881646216,NaN,NaN,16.616650727819486,-91.90935970485319,-0.18761872146220687,-0.18661220305460802,0.0010065184075988623,267577245,260132577.6,39.07305147751997,51.83630118989261,NaN,NaN,-3.523433409502726,4.59533834985367
2012-04-18T09:30:00-04:00,130.27,130.8,130.08009,130.14999,5057730,6464107.8,50.88289097420716,49.325797481148825,NaN,NaN,1.9431856719926945,-53.469247538468935,-0.11360523554017657,-0.14100002601762185,-0.02739479047744528,262519515,261550032.4,41.51235659671135,50.349060178755394,NaN,NaN,-2.6318670260382877,3.562880439011962
2012-04-19T09:30:00-04:00,130.23,130.67,128.82001,129.53999,8958211,6660342.75,48.386527736739275,48.785515376758454,NaN,NaN,-36.7402553910488,-41.35981652875493,-0.09993866412619294,-0.15231812063518646,-0.05237945650899352,253561304,259742365.4,39.34873471058699,48.66520327372549,NaN,NaN,-2.791022352557522,2.6551800402163215
2012-04-20T09:30:00-04:00,129.96001,130.53,129.89999,129.98,5693430,6595600.95,50.28136783715249,48.1191581860124,NaN,NaN,-6.571241568253465,-20.20896998451142,-0.05757582825203324,-0.12434924182403506,-0.06677341357200182,259254734,260838831.2,41.34567625954902,47.082546201799396,NaN,NaN,-2.292749722361409,1.9483329312766458
2012-04-23T09:30:00-04:00,128.74001,129.08,128.16,129.02,5181684,6635949.4,46.28857590311468,46.98701879292134,NaN,NaN,-84.8602414017579,-21.922380392249597,-0.08866160017344607,-0.17760041378880942,-0.08893881361536335,254073050,259397169.6,39.50397490117106,45.26681137785336,NaN,NaN,-3.1772922186963664,1.216100766994787
2012-04-24T09:30:00-04:00,129.27,130.23,129.25999,129.72,4420898,6607268.7,49.44123862840155,46.42754067907187,NaN,NaN,-20.084038491926695,-29.262518236198833,-0.0580145693357003,-0.16145702528498873,-0.10344245594928843,258493948,257580510.2,37.25214659044818,43.19425333613372,NaN,NaN,-2.893957153962755,0.628949635429424
2012-04-25T09:30:00-04:00,130.5,130.83,130.11,130.64,7343109,6685325.7,53.319365937791375,46.69361230270914,NaN,NaN,36.61876433111835,-22.327402504373698,0.023890931288573877,-0.07357879183857108,-0.09746972312714496,265837057,258244018.6,38.62815552077424,41.20530578421943,NaN,NaN,-1.4144288735209005,0.3370384198650919
2012-04-26T09:30:00-04:00,130.56,132.03,130.49001,131.85001,4581121,6649651.3,57.89399124354774,47.33994869507861,NaN,NaN,96.51889907120999,4.324428388078061,0.1520839344670299,0.09263519495664241,-0.059448739510387476,270418178,261615393.4,45.20352680686325,39.94316926671441,NaN,NaN,1.3473016485238807,0.4813617382449189
2012-04-27T09:30:00-04:00,132.09,132.41,131.66,132,3969434,6623631,58.43771242708171,48.52721399110599,NaN,NaN,123.34986982563889,30.308650666856533,0.23457432840290315,0.23376917099324146,-0.0008051574096616873,274387612,264641969,50.34667045511192,39.5656172662225,NaN,NaN,3.70239626050957,0.941509527139869
2012-04-30T09:30:00-04:00,131.81,132.02,131.49001,131.8,3670475,6596222.9,57.37381855680184,50.2493895436691,NaN,NaN,106.48007908750783,68.57671476470969,0.2612247430097481,0.32572577135252345,0.06450102834277535,270717137,267970786.4,55.314490863763446,40.408165416443616,NaN,NaN,5.306620114368902,1.5650967538868739
2012-05-01T09:30:00-04:00,131.85001,133.14,131.39999,132.53,5459473,6434981.7,60.220518946300885,51.791356662768344,NaN,NaN,140.62500773598325,100.71852401029166,0.31023372492264784,0.45229318449608513,0.1420594595734373,276176610,271507318.8,59.90423397122418,42.01662059185315,NaN,NaN,7.521168419832461,2.4159641347362433
2012-05-02T09:30:00-04:00,132.03999,132.50999,131.64999,132.39999,3745978,6317320.25,59.458929358409584,52.567995980708176,NaN,NaN,126.09009503015835,118.61279015009968,0.31509657737742136,0.535930181295214,0.22083360391779264,272430632,272826033.8,61.492506087659585,43.87517158678179,NaN,NaN,9.125713438801213,3.3744997496026676
2012-05-03T09:30:00-04:00,132.41,132.58,131.5,131.81,5043789,6049387.65,55.99793349360703,53.478338954886325,NaN,NaN,100.95719901125523,119.50045013810873,0.26196155453914427,0.548285547091723,0.2863239925525787,267386843,272219766.8,60.30970619619681,45.84028678176905,NaN,NaN,9.547545326618556,4.25636340346208
2012-05-04T09:30:00-04:00,131.13,131.32001,129.97,130.09,5939594,6137375.55,47.34561938179868,53.54122862843552,NaN,NaN,15.155386978776024,97.86155356873614,0.10254835110863747,0.4145094314383755,0.311961080329738,261447249,269631694.2,55.40995436020209,47.47465605698452,NaN,NaN,7.287599897813207,4.689397188369384
2012-05-07T09:30:00-04:00,129.5,130.25,129.45,129.84,4041016,6071315.8,46.22757854273972,52.96829064054954,NaN,NaN,-22.005743534980382,72.16438904423849,-0.021543016048520047,0.28503231026908793,0.306575326317608,257406233,266969513.4,50.83491583212615,48.31478922517068,NaN,NaN,5.1140174320222425,4.750057223176935
2012-05-08T09:30:00-04:00,129.17,129.33,127.91,129.08,7642117,5807638.65,42.91018837526944,52.39881188348256,NaN,NaN,-92.08179223851711,25.623029049338413,-0.14948817366534534,0.11971510923592632,0.26920328290127166,249764116,261687014.6,43.21085479663091,48.43611052516493,NaN,NaN,2.253514764018018,4.393408300439947
2012-05-09T09:30:00-04:00,128,129.12,127.38,128.34,11926570,6123705.05,39.90722684631643,51.79314753416664,NaN,NaN,-125.03776231885132,-24.602542420463518,-0.27152464883782723,-0.07020252814601236,0.20132212069181485,237837546,254768397.4,35.66610964748132,48.17306587780024,NaN,NaN,-1.101059079724535,3.608484388987878
2012-05-10T09:30:00-04:00,128.81,129.28,128.21001,128.44,5328105,6031740.4,40.5130750583448,51.095412335680386,NaN,NaN,-98.3613244790004,-64.46624711851464,-0.32923462543482307,-0.21022116110171396,0.11901346433310908,243165651,249924159,31.516725062579624,47.470997935159566,NaN,NaN,-3.6642074889506957,2.569528406425225
2012-05-11T09:30:00-04:00,127.8,129.16,127.73,128.17999,3673742,5774065.8,39.40077718375039,50.60342671286865,NaN,NaN,-113.08550578575687,-90.11442567142123,-0.36582535144393763,-0.33826822497181297,0.02755712647212466,239491909,245533091,28.30246143318773,46.67088983030361,NaN,NaN,-6.124110525539899,1.3275799875730645
2012-05-14T09:30:00-04:00,127.17999,127.69,126.60001,126.95,6068996,5702067.95,34.56605104813583,49.540913314278235,NaN,NaN,-167.54413409325127,-119.22210378307541,-0.44832886158681584,-0.5328539505113952,-0.0845250889245793,233422913,240736427,25.270597292511127,45.81506488045096,NaN,NaN,-9.815194485786925,-0.2642449371926483
2012-05-15T09:30:00-04:00,126.82001,127.59,126.07001,126.31,6713352,5722941.2,32.34222860308978,48.04254636179955,NaN,NaN,-160.20725813555705,-132.8471969624834,-0.516611029375076,-0.7302888756434243,-0.2136778462683483,226709561,236125516,22.747932295143883,44.68076322147737,NaN,NaN,-13.635911154497704,-2.1744829682362274
2012-05-16T09:30:00-04:00,126.78,127.37,126.13,126.17999,6047078,5772408.6,31.893346896778965,46.18535747988749,NaN,NaN,-141.3293693768821,-136.10551837408954,-0.5386762398162589,-0.8870231460386719,-0.34834690622241304,220662483,232690503.4,21.061173733436164,42.95630943051829,NaN,NaN,-16.899919233241732,-4.278116720379871
2012-05-17T09:30:00-04:00,126.21001,126.25,124.55,124.57001,8989883,5773992.2,26.912101065842634,43.933528096941856,NaN,NaN,-167.2432065729054,-149.88189479287055,-0.6238373377778805,-1.1281435784447638,-0.5043062406668832,211672600,226391893.2,18.371191554269046,40.672346651886656,NaN,NaN,-21.527107143599043,-6.742258209411181
2012-05-18T09:30:00-04:00,124.53,124.64999,123.09,123.31,10868289,6032735.15,23.781579062569136,41.53408241878237,NaN,NaN,-182.38364520417275,-163.74152267655373,-0.7203253109012808,-1.4047128792934842,-0.6843875683922034,200804311,218654373.6,15.715713856045127,37.84386257990678,NaN,NaN,-26.62488223157245,-9.582633069719934
2012-05-21T09:30:00-04:00,123.69,124.81,123.44,124.81,5388230,6043062.45,33.6730550303767,39.63783499621636,NaN,NaN,-137.99927675704976,-157.8325512093134,-0.64107553354433,-1.4857319853226159,-0.8446564517782859,206192541,213208299.2,14.1638515307816,34.576692405589455,NaN,NaN,-27.779925091912265,-12.18224621574741
2012-05-22T09:30:00-04:00,124.89999,125.48,124.19,124.83,9856039,6314819.5,33.79642402387978,37.8047989008928,NaN,NaN,-109.17376964526076,-147.62585351125418,-0.5488201447083203,-1.5306816326636863,-0.981861487955366,216048580,211076103,13.597724873401262,31.155636604571004,NaN,NaN,-28.637574374290004,-14.533007381253494
2012-05-23T09:30:00-04:00,123.95,124.8,122.815,124.71001,8598566,6377592.35,33.395096933064224,36.19031057513974,NaN,NaN,-114.11540401537236,-142.18306043895223,-0.46093223311853904,-1.5580267793535398,-1.0970945462350008,207450014,208433609.2,12.909074417740683,27.76987719182414,NaN,NaN,-29.44398694695156,-16.66314731921036
2012-05-24T09:30:00-04:00,124.92,125.16,123.96001,125.12,7046855,6500879.05,36.18361104537908,35.39302426539548,NaN,NaN,-86.84429312142574,-126.10327774865632,-0.34551635794166335,-1.5289899936620799,-1.1834736357204165,214496869,208998463,13.912715338624949,24.805788690282917,NaN,NaN,-29.307143385384567,-18.46943247152096
2012-05-25T09:30:00-04:00,124.92999,125.10001,123.97,124.25999,6725215,6638668.1,33.05718976917696,34.452282210141,NaN,NaN,-85.35487022806304,-106.69752275343437,-0.29915771076404196,-1.557420774175469,-1.2582630634114271,207771654,210391931.6,16.47008385904337,22.351157835062715,NaN,NaN,-30.10316512868837,-20.131394279687733
2012-05-29T09:30:00-04:00,125.23,125.92,124.89999,125.60001,6829355,6796612.1,41.53398253070131,34.353981792671846,NaN,NaN,-52.7618618048462,-89.65003976299366,-0.1574303772596235,-1.4550510349859564,-1.297620657726333,214601009,212073625.2,19.57520560359754,20.662897178417474,NaN,NaN,-28.14612741493733,-21.276356156151962
2012-05-30T09:30:00-04:00,124.53,124.61,123.7399,123.99001,6874988,6867387.85,35.68694043062206,34.05253276297939,NaN,NaN,-84.19777737488157,-84.65484130891782,-0.15126194872038434,-1.4866980936268135,-1.3354361449064291,207726021,210409113.4,18.829115636414613,19.460254749055565,NaN,NaN,-28.31849638445267,-22.28237618876635
2012-05-31T09:30:00-04:00,124.02,124.74001,123.011,123.7,7793645,7069771.2,34.738275851981925,33.640047105382045,NaN,NaN,-87.39499745444111,-79.31075999673158,-0.14579914017683282,-1.5176850701274702,-1.3718859299506374,199932376,208905585.8,18.15596327566952,18.505914621419127,NaN,NaN,-28.754097268193245,-23.20690777154162
2012-06-01T09:30:00-04:00,122.13,122.42,120.91,121.00999,11820668,7408615.15,27.449383071386507,32.78637609735605,NaN,NaN,-150.8664864810631,-92.11519866865903,-0.29389505745694944,-1.7392547517718242,-1.4453596943148748,188111708,203628553.6,15.994634683941584,17.62678413933012,NaN,NaN,-31.783448677688288,-24.432127900991144
2012-06-04T09:30:00-04:00,121.09,121.28,120.19,120.78,6372203,7430245.6,26.929129160305294,32.240881676796725,NaN,NaN,-162.08292269442592,-107.46080916193162,-0.3728126008262045,-1.9113754453476304,-1.5385628445214259,181739505,198422123.8,14.198720173206866,16.83593577366553,NaN,NaN,-34.28259502171058,-25.83933748966535
2012-06-05T09:30:00-04:00,120.64,121.32001,120.52,121.086,6619887,7559189.15,28.8610415368844,31.992225457782062,NaN,NaN,-145.4977456818715,-126.00798593733666,-0.36917814664833193,-2.000035527831841,-1.630857381183509,188359392,193173800.4,12.656044655377002,16.115086656539322,NaN,NaN,-35.6489226983817,-27.240706805196258
2012-06-06T09:30:00-04:00,121.99001,123.99001,121.95,123.92999,6139375,7484052.05,43.74709077552186,32.83892144912084,NaN,NaN,-58.990144276181155,-120.96645931759659,-0.15118219953366863,-1.8198351306005947,-1.668652931066926,194498767,190528349.6,11.951188851276612,15.46437345067078,NaN,NaN,-31.556240667641905,-27.857211642688494
2012-06-07T09:30:00-04:00,125.17,125.42999,124.25999,124.52,8806984,7328072.75,46.259495927460094,34.22087822495066,NaN,NaN,3.2929621399405504,-102.82886739872026,0.04624450763460253,-1.6108472965236729,-1.6570918041582754,203305751,191203024.6,13.277705345860156,15.100553007213009,NaN,NaN,-27.481016061996026,-27.803469416875284
2012-06-08T09:30:00-04:00,124.12,125.42999,123.86,125.42999,4434391,7283387.05,49.970828944970435,36.09153893083647,NaN,NaN,21.046162660309456,-68.4463375704457,0.24074435495611368,-1.3561613604631333,-1.596905715419247,207740142,195128711.4,20.75849725762967,15.460751821611902,NaN,NaN,-22.90089182444164,-27.103101189384763
2012-06-11T09:30:00-04:00,126.38,126.49001,123.85001,123.98,7232863,7461343.1,44.6763966567552,36.87749190414922,NaN,NaN,26.29598987403704,-30.770555056753118,0.27205658449708503,-1.2568349847978908,-1.5288915692949758,200507279,198882266.2,27.22283096809676,16.393536067134413,NaN,NaN,-20.815525018905703,-26.20487602217347
2012-06-12T09:30:00-04:00,124.39999,125.66,124.035,125.59,4925504,7404168.5,50.89730402407115,38.098983332734306,NaN,NaN,52.811234713368,8.89124102229478,0.394105878987141,-1.0362592205610497,-1.4303650995481907,205432783,202296944.4,32.60882420142687,17.751471733421955,NaN,NaN,-16.86964715591525,-24.871271898422293
2012-06-13T09:30:00-04:00,125.34,125.94,124.48,124.89,4687090,7302855.4,48.35158293915186,39.16730376174057,NaN,NaN,61.19781313586541,32.9288325047041,0.4183123317877122,-0.9074746848135504,-1.3257870166012626,200745693,203546329.6,34.518332859591055,19.294990193554124,NaN,NaN,-14.57624323485594,-23.400553517912815
2012-06-14T09:30:00-04:00,125.12,126.94,124.95,126.37,8163254,7408664.2,53.63215868954955,40.41362859346703,NaN,NaN,125.44599717184369,57.35943951108472,0.5180929333955717,-0.678170849856798,-1.1962637832523697,208908947,204666968.8,36.26281142462781,20.891425628268614,NaN,NaN,-10.837192579826011,-21.6057876696147
2012-06-15T09:30:00-04:00,126.77,127.48,126.64,127.34,6268648,7272602.45,56.75302187516968,42.10618802960937,NaN,NaN,173.46612127749225,87.84343123452128,0.626283436203704,-0.4134094879977397,-1.0396929242014437,215177595,206154459.4,38.60100402786881,22.472205640327577,NaN,NaN,-6.741711155895619,-19.48234816765483
2012-06-18T09:30:00-04:00,126.8,127.53999,126.64999,127.13,4572293,6957802.65,55.876188901067444,43.130631341778376,NaN,NaN,151.38529631625087,112.86129252296405,0.6573413072837274,-0.21801629009678436,-0.8753575973805118,210605302,208174064,41.72674825036322,24.05445868652512,NaN,NaN,-3.791286831341304,-17.2407679767529
2012-06-19T09:30:00-04:00,127.73,128.71001,127.50999,128.06,3871708,6881976.55,58.90430517607153,44.789014537881904,NaN,NaN,175.14942598672104,137.32893077763464,0.7096797571276038,0.011742099028992925,-0.6979376580986109,214477010,209982909.4,44.454236512626736,25.884824463397415,NaN,NaN,-0.3653133761542711,-14.829988748095953
2012-06-20T09:30:00-04:00,128.12,128.49001,127.11,127.96001,9212844,6849816.8,58.43993156447485,46.48198994591712,NaN,NaN,142.99109063420866,153.6875862773033,0.7052637341658404,0.1836420096086897,-0.5216217245571507,205264166,210886604,45.81865728108591,27.86073117807001,NaN,NaN,2.2428305432626363,-12.391014563616155
2012-06-21T09:30:00-04:00,128.14999,128.3443,125.34,125.44,7704254,6805101.2,48.139558056021855,47.959859587676796,NaN,NaN,68.88301413055802,142.37498966904616,0.5094591408847697,0.11520220154881144,-0.3942569393359583,197559912,208616797,42.963999754218094,29.78711439737548,NaN,NaN,1.3535526989923778,-10.427504954672079
2012-06-22T09:30:00-04:00,126.13,126.48,125.78,126.23,5298016,6717659.25,51.052192799858375,49.682935561930584,NaN,NaN,54.356928665703315,118.55315114668838,0.41403624484989726,0.1232883667264133,-0.29074787812348396,202857928,206152863.6,40.04718801523117,31.633433528948643,NaN,NaN,1.5472666081826032,-8.716823302835696
2012-06-25T09:30:00-04:00,125.06,125.09,124.3157,124.75999,5922426,6677519.8,45.88773946646612,50.89912827118642,NaN,NaN,-7.737850774575006,86.72852172852322,0.2413606470638237,0.01095293070629566,-0.23040771635752805,196935502,203418903.6,37.042164180945754,33.37529920934641,NaN,NaN,0.024335223518855535,-7.468086370499331
2012-06-26T09:30:00-04:00,125.03,125.506,124.25,125.08,7551684,6713636.25,47.141325568578495,51.14157361354761,NaN,NaN,3.0609480984656603,52.31082615087214,0.14300127747246347,-0.051656119516948706,-0.19465739698941217,204487186,201420938.8,34.97662177874446,35.019972989879825,NaN,NaN,-0.8068076447769839,-6.516475123967568
2012-06-27T09:30:00-04:00,125.39999,126.23,125.3157,126.00999,3717220,6555747.85,50.71467531925358,51.45980071296142,NaN,NaN,38.868706409569114,31.48634930594423,0.13497961039204173,-0.02593288399936,-0.16091249439140173,208204406,202008986.8,36.1059183840294,36.650559635463345,NaN,NaN,-0.41446579928055394,-5.644759506155137
2012-06-28T09:30:00-04:00,125.02,125.86501,124.25,125.8,6462059,6489168.55,49.894480946499165,51.45434728449919,NaN,NaN,12.102265861248341,20.130199652082297,0.11094186792236477,-0.022235159488445788,-0.13317702741081056,201742347,202845473.8,37.761790102061795,37.865080552922784,NaN,NaN,-0.33750180483885106,-4.886579834538525
2012-06-29T09:30:00-04:00,127.75,128.57001,127.44,128.45,5845438,6190407.05,58.922953621963636,52.47195849629979,NaN,NaN,127.97628725860946,34.85407137066353,0.2603906792460643,0.19231132164676978,-0.06807935759929448,207587785,203791445.2,39.66607162537332,38.75388345701396,NaN,NaN,2.683866636627994,-3.8050874815147364
2012-07-02T09:30:00-04:00,128.62,128.77,127.69,128.36,3839153,6063754.55,58.53717178461272,53.01766333633848,NaN,NaN,123.52372907976618,61.106387341531786,0.3352892659623019,0.3510322248535829,0.015742958891280995,203748632,205154071.2,42.39995648917068,39.45325004899566,NaN,NaN,4.942660081477104,-2.555409258230188
2012-07-03T09:30:00-04:00,128.37,129.23,128.24001,129.14999,2717740,5868647.2,60.95374743688111,53.91781794331913,NaN,NaN,142.67693414624642,89.02958455108792,0.4149296224164796,0.5344049869118805,0.11947536449540092,206466372,205549908.4,43.20506211975418,40.07373071043589,NaN,NaN,7.572967066342878,-1.10849835471975
2012-07-05T09:30:00-04:00,128.62,129.41,128.3,128.78,6638930,5893624.95,59.21309403364222,54.3164561821829,NaN,NaN,123.81263714271465,106.01837069771702,0.41839422697793194,0.6424681482178158,0.2240739212398839,199827442,203874515.6,40.61729174303121,40.384765018893276,NaN,NaN,9.22921829254316,0.36831830917495134
2012-07-06T09:30:00-04:00,127.78999,127.80499,126.87,127.57001,4341570,5670354.25,53.80198064589697,54.10566752294913,NaN,NaN,44.965474491883135,112.59101242384399,0.31937128304391055,0.6232880250447721,0.30391674200086155,195485872,202623220.6,38.75049880970809,40.39544321759608,NaN,NaN,9.061900214009206,1.6102585812941306
2012-07-09T09:30:00-04:00,127.42,127.5,126.71001,127.24001,4505863,5673927.85,52.39567045484783,53.85705906250488,NaN,NaN,26.354709091764306,92.26669679047495,0.21673306980204943,0.5748330792534233,0.3581000094513739,190980009,199301665.4,34.25044366473675,39.8614214614799,NaN,NaN,8.515955578751637,2.59678672378806
2012-07-10T09:30:00-04:00,127.96001,128.14,125.91,126.35001,6730871,5648828.25,48.69858133211492,53.128078787936545,NaN,NaN,1.9276773778943264,67.94748645010058,0.08097747029261437,0.4593218473171419,0.3783443770245275,184249138,195401766.6,29.86512267085537,38.819341901353376,NaN,NaN,6.960369014097065,3.220155622403632
2012-07-11T09:30:00-04:00,126.42999,126.49001,125.19,125.91,6843930,5744749.55,46.93530105722372,52.30631946599004,NaN,NaN,-57.94958533615182,27.822182553620916,-0.03988618598071564,0.32848664454863297,0.3683728305293486,177405208,189589533.8,24.774076771964587,37.31615757927328,NaN,NaN,5.150409115397307,3.495906121402728
2012-07-12T09:30:00-04:00,125.21001,126.16,124.77,125.57001,4412598,5731024.95,45.56252068051907,52.12224536773984,NaN,NaN,-83.02662149663989,-13.54566917424999,-0.1386060367379367,0.19511528460692773,0.33372132134486443,172992610,184222567.4,21.183169364685355,35.76038398002094,NaN,NaN,3.246826894310695,3.4603233746752946
2012-07-13T09:30:00-04:00,125.92,127.71001,125.86,127.62,3943562,5520040.35,54.25116091433585,52.35074309020252,NaN,NaN,12.167156663542693,-20.105332739918076,-0.06543267012515075,0.25193048368842597,0.3173631538135767,176936172,180512627.4,19.120075345707107,34.26559021791208,NaN,NaN,4.076730099305865,3.5483814781939476
2012-07-16T09:30:00-04:00,127.25,127.50999,126.75,127.12,1992486,5306232.25,52.06828028602831,52.792210291599815,NaN,NaN,16.35297008579139,-22.105680541112662,-0.0509411040484703,0.25368677375298887,0.30462787780145917,174943686,177305362.8,17.530520622940315,32.87190139234026,NaN,NaN,4.113752588798331,3.6291487797088595
2012-07-17T09:30:00-04:00,127.53,128.14999,126.28999,127.82001,3327012,5243968.2,54.80975693615537,53.33995538928388,NaN,NaN,33.80588960063451,-15.730038096564623,0.0027081143059312085,0.30801302068387315,0.30530490637794194,178270698,176109674.8,16.96429506890756,31.585306627351912,NaN,NaN,4.954032105425358,3.818417826239788
2012-07-18T09:30:00-04:00,127.49001,129.14999,127.42999,128.96001,3104446,5205605.1,58.929557672754385,53.92673270024822,NaN,NaN,100.24940162132346,15.90975929493043,0.10616117138379133,0.4380063706076811,0.3318451992238898,181375144,176903662,18.838955415891178,30.35195212962775,NaN,NaN,6.937987537668072,4.2640706421581145
2012-07-19T09:30:00-04:00,129.27,129.71001,128.81,129.32001,3849651,4937445.45,60.16460332900466,54.660312870427184,NaN,NaN,135.56080601235908,59.627244796730224,0.1853873889511778,0.563579435412862,0.37819204646168425,185224795,179350099,24.495312873368405,29.40434661329251,NaN,NaN,8.935957419539172,4.931483038926837
2012-07-20T09:30:00-04:00,128.35001,128.66,127.81,128.03999,7436363,4924050.9,53.95217325214629,54.305257129725945,NaN,NaN,64.13362876928618,70.02053921787892,0.14019074325158865,0.5534304755261701,0.41323973227458144,177788432,179520551,24.888094124711472,28.348776791816665,NaN,NaN,8.826611033720514,5.487929895325934
2012-07-23T09:30:00-04:00,126.02,127.17999,125.53,126.91,4657484,4892024.3,49.129323139707516,53.633267940804146,NaN,NaN,-32.67532884611132,60.214879431498375,0.028632581220206454,0.4490304587998395,0.42039787757963304,173130948,179158003.4,24.595023896528403,27.076995892342214,NaN,NaN,7.234640427720815,5.7374599713823455
2012-07-24T09:30:00-04:00,126.92999,127.00999,124.94,125.86,7080840,4949945,45.09540998970578,52.5005295517202,NaN,NaN,-76.53454540748847,38.146792429873784,-0.11363211493253522,0.278357733913964,0.39198984884649923,166050108,176713885.4,22.657965180382178,25.6093461109585,NaN,NaN,4.604615526033266,5.575625050618191
2012-07-25T09:30:00-04:00,126.60001,127.03999,126,126.50999,3872263,4765973.95,47.94480027531359,51.69565142612529,NaN,NaN,-48.13843743829503,8.469224617950086,-0.15893694044579532,0.19331867328925512,0.35225561373505043,169922371,174423330.8,20.98955820697725,24.207365144097505,NaN,NaN,3.2847531437857387,5.248357635356412
2012-07-26T09:30:00-04:00,128.17,129.03,127.92999,128.58,8074000,4983812.95,55.81012275251294,51.83909014802642,NaN,NaN,78.15096760345601,-3.012743063830527,-0.05010963523970746,0.2896185696854161,0.33972820492512357,177996371,172977646,19.98911528985431,22.867266321250806,NaN,NaN,4.6676567119924215,5.1654003605901275
2012-07-27T09:30:00-04:00,129.02,130.89,128.98,130.53999,7464211,5033920.55,61.709539786507186,52.504366528859244,NaN,NaN,163.79025666560747,16.91858251543373,0.1427127869197985,0.5181191885748717,0.3754064016550732,185460582,174512076,24.12299058399188,22.143876815483313,NaN,NaN,7.925075395276036,5.559639651259543
2012-07-30T09:30:00-04:00,130.31,130.992,130.12,130.39999,4236637,4953480.5,61.08226147200667,53.38891511028008,NaN,NaN,159.89238781151323,55.43212584695864,0.2437319239866585,0.6800713066383963,0.43633938265173783,181223945,176130675.4,28.32953517790544,22.034191994558316,NaN,NaN,10.245960146070923,6.229114007661169
2012-07-31T09:30:00-04:00,130.25,130.53,129.69,129.69,4783645,5000705.1,57.86958345084451,54.16993528125299,NaN,NaN,115.0792891580906,93.75489276007445,0.24498400583530633,0.7425693899458707,0.4975853841105644,176440300,178208713.8,33.431996273189284,22.652614816074365,NaN,NaN,11.148275356805565,6.931851343253225
2012-08-01T09:30:00-04:00,130.47,130.5,129.17999,129.45,5769988,5153317.5,56.78238354393855,54.97135405721152,NaN,NaN,95.52064369906608,122.48670898754668,0.21307368979591979,0.7639274963554641,0.5508538065595443,170670312,178358302,33.79737490283789,23.553629497370974,NaN,NaN,11.550860464609931,7.591709789161325
2012-08-02T09:30:00-04:00,128.66,129.28999,127.50999,128.53999,10916004,5367171.2,52.73670261261123,54.86317846423119,NaN,NaN,32.21887819732719,113.30029110632093,0.1188065057449309,0.699361938740708,0.580555432995777,159754308,174709889.4,29.538821757231446,24.297825669622714,NaN,NaN,10.67978376121134,8.0328632137399
2012-08-03T09:30:00-04:00,130.06,131.07001,129.88,130.73,7769164,5538550.9,60.10376774681676,55.43714185428751,NaN,NaN,123.06532695751665,105.15530516470275,0.18796213656397875,0.8155081037007506,0.6275459671367718,167523472,171122467.4,26.06152234852108,24.907182935735623,NaN,NaN,12.267752367528386,8.637847378566827
2012-08-06T09:30:00-04:00,130.94,131.61,130.88,130.89999,4573551,5541935.3,60.616915204932596,55.85193887348588,NaN,NaN,131.64506026558578,99.50583965551725,0.2265814082807056,0.9107727274876538,0.6841913192069482,172097023,169297083,24.48225079790315,25.444179773521025,NaN,NaN,13.683621355706975,9.358672232443991
2012-08-07T09:30:00-04:00,131.32001,131.89,131.28999,131.38,3587363,5384759.9,62.09932684562158,56.07835095726211,NaN,NaN,131.98911338092012,102.88780450008316,0.26330492293556984,1.0133224728764105,0.7500175499408407,175684386,169145900.2,24.350637401062855,25.83787134389043,NaN,NaN,15.294406483913134,10.206634268368155
2012-08-08T09:30:00-04:00,130.94,131.8378,130.886,131.55,3004360,5192781.4,62.63573923507367,56.254860664838475,NaN,NaN,113.96581932517539,106.57683962530503,0.2765308673294231,1.0956811341026196,0.8191502667731965,178688746,170749587,28.727591992152142,26.140176995232128,NaN,NaN,16.76394729682642,11.143393272433622
2012-08-09T09:30:00-04:00,131.5,131.87,131.11,131.57001,3357169,5140009.95,62.702652569673454,56.8798949018047,NaN,NaN,106.51084103309587,121.43523219245874,0.26413338286820043,1.149316995358447,0.8851836124902466,182045915,175207908.4,39.25071074633614,27.166078182491027,NaN,NaN,17.988541026550557,12.121271523021756
2012-08-10T09:30:00-04:00,131.14999,131.95,130.78999,131.92999,4411262,5163394.95,63.953307969138,57.938750961049735,NaN,NaN,98.16297754730746,116.4547623104169,0.2574196039901082,1.2069581174778818,0.9495385134877736,186457177,178994649.4,46.47886285535203,28.729209536692714,NaN,NaN,19.369238847718133,13.15669542654981
2012-08-13T09:30:00-04:00,131.74001,131.89999,131.02,131.62,3988004,5263170.85,62.02455172377442,59.14797537062607,NaN,NaN,88.10442196364168,107.74663465002808,0.21127757746657494,1.2136354853209923,1.0023579078544174,182469173,181069079.4,49.98934290203806,30.68145080252528,NaN,NaN,20.047736616472704,14.14112988225308
2012-08-14T09:30:00-04:00,132.05,132.16,131.32001,131.66,3422366,5267938.55,62.183040288928055,60.164992514455676,NaN,NaN,89.22731635893791,99.19427524563164,0.1646955302708648,1.2082273206929983,1.0435317904221335,185891539,183110510,53.23975533703582,32.98503631181518,NaN,NaN,20.659652095170525,15.072347341241287
2012-08-15T09:30:00-04:00,131.50999,131.99001,131.44,131.72,2841223,5254777.4,62.436284490132046,60.638289781428476,NaN,NaN,81.9647553562328,92.79406245184313,0.12118057337801469,1.195007507144652,1.0738269337666373,188732762,185119313.2,56.25285229490284,35.57530324074721,NaN,NaN,21.243830442312518,15.953987784251462
2012-08-16T09:30:00-04:00,131.77,132.75,131.5,132.57001,5340980,5329343.85,65.9183066550317,60.93891598632308,NaN,NaN,96.36492366202015,90.76487897762797,0.13200953276650762,1.2388388497247718,1.1068293169582641,194073742,187524878.6,59.609316321213164,38.11004079340587,NaN,NaN,22.680147335154796,16.914867720094794
2012-08-17T09:30:00-04:00,132.49001,132.52,132.14999,132.42,3754107,5145231.05,64.77709727945168,61.202832829712015,NaN,NaN,93.05928048322812,89.74413956481212,0.1122127175195069,1.2470952138576479,1.134882496338141,190319635,188297370.2,60.653319061340156,40.4188824993655,NaN,NaN,23.62278245808563,17.873141254093486
2012-08-20T09:30:00-04:00,132.19,132.47,131.99001,132.38,2266741,5025693.9,64.45665374920029,61.67333785102314,NaN,NaN,86.26587765446821,89.37643070297743,0.0810228675337914,1.2361610807553802,1.1551382132215888,188052894,189414114.4,62.17540557329865,42.471983163659026,NaN,NaN,24.348945621850913,18.798256163773118
2012-08-21T09:30:00-04:00,132.57001,133.02,131.56799,131.77,4094567,4876380.25,59.613490551262,61.875559780117676,NaN,NaN,75.75997374603705,86.68296218039725,0.0077663716882638845,1.1648461778319188,1.157079806143655,183958327,189027472,61.291367437060856,44.43583977324638,NaN,NaN,23.78097324495262,19.510072889655905
2012-08-22T09:30:00-04:00,131.57001,131.80099,130.94,131.47,4499234,4907728.8,57.331919824938325,62.20378958099819,NaN,NaN,27.636138385669067,75.8172387862845,-0.06825068160160197,1.0717664541416525,1.1400171357432545,179459093,187172738.2,57.097396008173476,46.404309362599385,NaN,NaN,22.701227282605092,19.965952088648645
2012-08-23T09:30:00-04:00,131.25999,131.28999,130.2,130.38,4159617,4712009.65,49.86449684500591,61.4724130880117,NaN,NaN,-42.16171129657895,48.1119117945647,-0.19227345657789474,0.899675315020886,1.0919487715987808,175299476,183417885,49.68516490243815,48.09171240216489,NaN,NaN,19.595735026740304,19.913063936947452
2012-08-24T09:30:00-04:00,130.21001,131.56,130.06,131.38,4202691,4548933.65,55.58065927208123,61.11268052137946,NaN,NaN,-15.079409016136994,26.48417389469168,-0.20606666160032394,0.8343654445983759,1.0404321061986999,179502167,181254391.4,45.98125190670769,49.627355338508075,NaN,NaN,18.4001399410679,19.69693193753609
2012-08-27T09:30:00-04:00,131.42,131.57001,130.95,131.06,1806408,4427422.2,53.479396610301706,60.496971218856615,NaN,NaN,-0.7999247668984464,9.071013410418344,-0.23381669371236113,0.7481612390582484,0.9819779327706095,177695759,179182964.4,42.699150626829045,50.9379634260628,NaN,NaN,16.789599567841684,19.28159874186546
2012-08-28T09:30:00-04:00,130.75,131.3,130.60001,130.86,3027999,4339639.9,52.15232301481581,59.74815577455247,NaN,NaN,-34.237111045132416,-12.928403547815545,-0.2606688569180774,0.6561418616230128,0.9168107185410902,174667760,177324851,39.9448030897481,51.739192790176794,NaN,NaN,15.069211841118783,18.679829184615933
2012-08-29T09:30:00-04:00,130.87,131.276,130.63,130.92,2400309,4171155.95,52.53286924877544,59.02174268020262,NaN,NaN,-43.35523512550227,-27.126678250049814,-0.2683639088761798,0.5813558324458654,0.8497197413220452,177068069,176846646.2,39.24320187050257,51.73865644190297,NaN,NaN,13.735526807114034,17.973500273544232
2012-08-30T09:30:00-04:00,130.38,130.39,129.64999,129.92,4121813,3831446.4,45.97051893841598,57.73725774943676,NaN,NaN,-196.769790548463,-58.04829410042663,-0.3306833353140499,0.4363655721794828,0.7670489074935327,172946256,176376002.2,38.52599053842377,51.17059413355095,NaN,NaN,10.59859578991828,16.919942490169095
2012-08-31T09:30:00-04:00,130.64,131.39999,130.03999,130.88,5447645,3715370.45,52.15017820159747,57.03194535499556,NaN,NaN,-90.22567513836678,-73.0775473248726,-0.2981370588198281,0.39437758396874756,0.6925146427885757,178393901,176154349,38.172159763355836,50.32650962364507,NaN,NaN,9.615466868320398,15.876445972762138
2012-09-04T09:30:00-04:00,130.74001,130.8,129.63,130.23,4108613,3692123.55,48.135710854001196,56.028564681072204,NaN,NaN,-146.23311006887138,-102.16418438526716,-0.309903851258328,0.30513482871566566,0.6150386799739936,174285288,175472254.8,37.04464493771068,49.16971602369328,NaN,NaN,7.543474167234969,14.6860214291154
2012-09-05T09:30:00-04:00,130.37,130.83,130.03999,130.37,2828741,3654192.45,49.04552734980548,55.07208202819174,NaN,NaN,-105.14758444353345,-116.34627906494737,-0.2977060941336289,0.24290606230695744,0.5406121564405864,177114029,175961508.6,38.44902608764055,47.898014151745976,NaN,NaN,6.117110397531139,13.461891281746219
2012-09-06T09:30:00-04:00,131.16,132.83,131.16,132.82001,5559324,3781940.65,61.705796145172656,54.771188420344664,NaN,NaN,103.56299495003766,-86.96263304983938,-0.12302927419378751,0.38682556369835197,0.5098548378921395,182673353,177082565.4,41.66042088023398,46.61595019167603,NaN,NaN,9.104852075572936,12.83945710943575
2012-09-07T09:30:00-04:00,132.89,133.09,132.57001,132.94,4828195,3855491.95,62.201133714866174,54.58719102287427,NaN,NaN,147.43269838342692,-18.1221352634614,-0.004086597411245618,0.5047465911280824,0.508833188539328,187501548,179993623.8,49.088591432851125,45.789898218212535,NaN,NaN,11.579763517686896,12.659500882043057
2012-09-10T09:30:00-04:00,132.77,133.16,132.42,132.48,2297606,3749809.15,59.04780363275011,54.200844585984974,NaN,NaN,113.794297505074,22.681859265226755,0.03668353387423573,0.5546876058821226,0.5180040720078869,185203942,181355632,52.15791159209579,45.0743629338409,NaN,NaN,12.606587276126366,12.651941795483529
2012-09-11T09:30:00-04:00,132.60001,133.45,132.59,133.09,2824326,3691625.25,61.812509532622194,54.35791737036784,NaN,NaN,126.37229734255443,77.20294074751192,0.09452068153546822,0.6361549239272222,0.541634242391754,188028268,184104228,57.70011134261046,44.817844641380155,NaN,NaN,14.343677346125084,12.893618302718037
2012-09-12T09:30:00-04:00,133.46001,133.64999,133.08,133.37,1953807,3618197.3,63.04575342223151,54.76604834160308,NaN,NaN,132.7656691742611,124.78559147107083,0.13874792475359998,0.7150691483337539,0.5763212235801539,189982075,186677837.2,62.12444091995126,45.17691927793571,NaN,NaN,16.13751397364798,13.357031969993743
2012-09-13T09:30:00-04:00,133.27,135.71001,133.21001,135.39,6976566,3824964.45,70.45794419886815,56.23700886687895,NaN,NaN,194.14523582316136,142.90203964569554,0.2828527788192997,0.9298871971042786,0.6470344182849789,196958641,189534894.8,66.3342088104495,46.36613669993652,NaN,NaN,20.43721548395881,14.368486757703039
2012-09-14T09:30:00-04:00,135.62,136.48,135.41,135.86,5193320,3817581.45,71.87164573990881,57.40065075743807,NaN,NaN,218.04971358629547,157.02544268626926,0.3824427122257552,1.125087808567173,0.7426450963414177,202151961,192464977.4,70.01505678355535,48.082837048282784,NaN,NaN,24.352156802371212,15.794725335512778
2012-09-17T09:30:00-04:00,135.57001,135.88,135.24001,135.53,2606611,3760206.65,69.36184959398491,58.53511168484402,NaN,NaN,167.08241523880073,167.68306623301459,0.3969850915311115,1.238876460755307,0.8418913692241956,199545350,195333259,73.1139887251041,50.255325483873854,NaN,NaN,26.69900127650019,17.352479041368124
2012-09-18T09:30:00-04:00,135.14999,135.78999,135.14999,135.61,3376378,3815688.5,69.63864743853338,59.7841348579667,NaN,NaN,139.3944559255833,170.2874979496204,0.3827194088572845,1.3202906302958013,0.9375712214385168,202921728,198311951,75.89960599247523,52.82352569121151,NaN,NaN,28.65433819724583,18.967030349350654
2012-09-19T09:30:00-04:00,135.85001,136.235,135.55,135.73,3080927,3765006.5,70.07536926982563,61.03717057375599,NaN,NaN,129.4706338571298,169.62849088619413,0.35282563330225747,1.3786032630663385,1.025777629764081,206002655,201516067,78.48222183264909,55.626312831364835,NaN,NaN,30.376927702280277,20.59701568548346
2012-09-20T09:30:00-04:00,135.2,135.98,135,135.95,6953758,3887732.7,70.90174369958433,62.81797234241088,NaN,NaN,107.31094713712548,152.26163314898696,0.3202811584016314,1.4261290777661202,1.1058479193644888,212956413,204715621.4,80.70568979257969,58.63914849237597,NaN,NaN,32.05013869242306,22.23317611504626
2012-09-21T09:30:00-04:00,136.21001,136.24001,135.39999,135.47,5318633,3945683.5,66.58153138737566,63.84878328425218,NaN,NaN,97.43229735480145,128.13814990268816,0.24237896143668292,1.4088216211603424,1.1664426597236595,207637780,205812785.2,81.41488431600021,61.72791453185057,NaN,NaN,32.29614372480898,23.670742916440933
2012-09-24T09:30:00-04:00,134.92,135.73,134.88,135.319,2707280,3870912.95,65.23490049904206,65.07015397318368,NaN,NaN,74.73562682282734,109.66879221949348,0.16057476561379458,1.3671611167409026,1.206586351127108,204930500,206889815.2,82.11004681300068,64.94687180865701,NaN,NaN,32.136085772821204,24.880077610209543
2012-09-25T09:30:00-04:00,135.53,135.89999,134.28,134.34,6292629,4095224,57.16260205944746,65.64994502387239,NaN,NaN,52.56312863412043,92.3025267612009,0.027406175608274186,1.2408440706374506,1.2134378950291764,198637871,206033043.8,79.56062842240749,67.88341483256893,NaN,NaN,29.631931859214827,25.55891393149601
2012-09-26T09:30:00-04:00,134.37,134.50999,133.742,133.89999,5448852,4216266.65,53.9323873619763,65.09470153935835,NaN,NaN,20.610486378285156,70.53049726543196,-0.09664108563530616,1.0926365379850438,1.18927762362035,193189019,203470316.6,72.32683084915288,70.07387268749171,NaN,NaN,26.546239121644405,25.699960387231496
2012-09-27T09:30:00-04:00,134.44,134.94,133.85001,134.60001,4977426,4345122.5,57.99881908963114,64.79453620898444,NaN,NaN,30.855212312394762,55.23935030048582,-0.13549419644296656,1.0199098780666418,1.1554040745096084,198166445,200512323,64.98262361024058,71.2091607001624,NaN,NaN,25.019238543210943,25.602714409514274
2012-09-28T09:30:00-04:00,133.92,134.48,133.36,134.05,4565441,4367303.9,53.96795149153312,64.43168962746893,NaN,NaN,4.507985450508642,36.65448791962727,-0.19837769559273122,0.9074319550186942,1.1058096506114254,193601004,197704967.8,58.87259192671962,71.68878072406409,NaN,NaN,22.499782445135068,25.15943841460296
2012-10-01T09:30:00-04:00,134.62,135.69,134.53,134.78,4857563,4337799.8,58.127491616814595,64.1684740620541,NaN,NaN,44.968397639980445,30.70104208305789,-0.19088712891465787,0.8672007394681032,1.058087868382761,198458567,196410581.2,56.24659748141046,71.58495830540694,NaN,NaN,21.55581013808922,24.644634375100996
2012-10-02T09:30:00-04:00,135.11,135.37601,133.94,134.48,6269621,4445850.2,55.892273695008335,63.65751122439531,NaN,NaN,17.61241747264727,23.71089985076326,-0.2049772523836546,0.8018663029031927,1.0068435552868473,192188946,195120796.2,53.6773287098131,70.98159314753994,NaN,NaN,20.108419352799224,23.996603657629315
2012-10-03T09:30:00-04:00,134.75,135.1132,134.10001,134.67999,3324132,4470619.75,57.07721779383532,62.701745052607244,NaN,NaN,9.292951824829151,21.447392940072056,-0.19947972844131368,0.7574938947352052,0.9569736231765189,195513078,195585608,54.48422867281724,70.13516599485192,NaN,NaN,19.247341788531838,23.318137676329677
2012-10-04T09:30:00-04:00,135.14999,135.71001,134.955,135.52,3912318,4388269.45,61.7279924220437,61.977198387045455,NaN,NaN,59.592362998151245,27.19482307722335,-0.14069400001829635,0.7811061231536485,0.9218001231719448,199425396,195837398.2,54.942099958108024,69.05852622160567,NaN,NaN,19.8666804617313,22.82507235995848
2012-10-05T09:30:00-04:00,136.09,136.44,135.48,135.96001,4560207,4374870.05,63.93252223542743,61.58938929000563,NaN,NaN,98.88612062240148,46.070450111601915,-0.07679629785520492,0.8258047508529387,0.9026010487081436,203985603,197914318,58.63822188445984,68.02454287584537,NaN,NaN,21.049737549905505,22.571453101379483
2012-10-08T09:30:00-04:00,135.39999,135.86,135.32001,135.64999,2405416,4380260.55,61.25526557181436,60.9905762995257,NaN,NaN,62.951404897580744,49.66705156312197,-0.060734260816600494,0.826683222687393,0.8874174835039935,201580187,198538642,59.70818104829345,66.86801252268954,NaN,NaN,21.262831993661468,22.38450722884834
2012-10-09T09:30:00-04:00,135.42,135.74001,134.55,134.59,6036664,4540877.45,53.07193930187792,59.77604558752944,NaN,NaN,-10.659855695323069,44.01259692952791,-0.12321959813767625,0.7333929858318982,0.8566125839695744,195543523,199209557.4,60.87934195538627,65.6106639600279,NaN,NaN,18.9062631345246,21.88761521537352
2012-10-10T09:30:00-04:00,134.39999,134.45,133.07001,133.28,10140398,4950207,45.060091039454115,57.93021325466299,NaN,NaN,-169.0023114838064,8.353544267800796,-0.24733553509950867,0.5474431650951885,0.7947787001946972,185403125,197187566.8,55.63110500047181,63.81962218916305,NaN,NaN,14.061086027122126,20.76953961705189
2012-10-11T09:30:00-04:00,133.91,134.10001,133.08,133.13,3670399,4784898.65,44.23660881068003,56.334147356327584,NaN,NaN,-161.50867504134405,-35.86666334009826,-0.32898175768183324,0.3835515030924057,0.712533260774239,181732726,193649032.8,47.855960845679625,61.422556226997294,NaN,NaN,9.97554839834699,19.22754087152262
2012-10-12T09:30:00-04:00,133.25999,133.83,132.75,133.13,3271212,4688793.25,44.23660881068003,54.83426937858744,NaN,NaN,-155.83211914704458,-86.81031129398748,-0.3694062906198402,0.25077539749943867,0.6201816881192789,181732726,189198457.4,40.23850310880352,58.431731676697495,NaN,NaN,6.733130071103806,17.44262504289136
2012-10-15T09:30:00-04:00,133.34,134.19,133.06,134.02,2642673,4690596.35,50.46584807768081,54.355929808461255,NaN,NaN,-93.77965809835537,-118.1565238931747,-0.3242350738133989,0.2148878458525303,0.5391229196659292,184375399,185757499.8,35.52967258607573,55.2866634026738,NaN,NaN,5.759388037443845,15.773591184970288
2012-10-16T09:30:00-04:00,134.64999,135.36,134.57001,135.3,5459750,4794764.95,57.77203293172677,54.630190206300576,NaN,NaN,30.56114359964248,-109.9123240341816,-0.20215416295112698,0.28643021597702045,0.48858437892814743,189835149,184615825,34.10367055206741,52.5564376671677,NaN,NaN,7.307345124992641,14.564127462116339
2012-10-17T09:30:00-04:00,134.95,135.46001,134.85001,135.42999,3815381,4831487.65,58.44241271311314,54.661875465120715,NaN,NaN,51.38684606394392,-65.83449252463153,-0.11119763025760288,0.34958734110614387,0.46078497136374674,193650530,186265306,37.97688966887613,50.62745667135595,NaN,NaN,8.741987035845387,13.732393115506204
2012-10-18T09:30:00-04:00,135.25999,135.77,135,135.36,6306109,4799105.2,57.90934774836178,54.94340376917991,NaN,NaN,66.66073881769701,-20.200609752823315,-0.057026161081099924,0.3895022700123718,0.44652843109347173,187344421,187387645,40.53790664523412,49.31783629410699,NaN,NaN,9.736687731105214,13.161578060591777
2012-10-19T09:30:00-04:00,134.8,134.8,132.81,133.11,10437641,5055055.6,44.011455451033285,53.9351154716241,NaN,NaN,-101.68459093263033,-9.371104109940458,-0.167743786143162,0.23684869841451928,0.40459248455768126,176906780,186422455.8,39.04478551996994,48.08913543971838,NaN,NaN,5.882836070571638,12.121757776303186
2012-10-22T09:30:00-04:00,132.92999,133.39,132.03999,133.10001,5594109,5199397.05,43.96100842507138,53.082882238057174,NaN,NaN,-147.44359365041183,-20.103891220351752,-0.23267217303547277,0.11375226826334028,0.34642444129881306,171312671,183809910.2,35.259127396138226,46.77354963159875,NaN,NaN,2.9192480081433856,10.807113523708928
2012-10-23T09:30:00-04:00,131.60001,131.63,130.53011,130.74001,8963297,5332930.45,34.03584666193804,51.437070014350226,NaN,NaN,-241.72200937653577,-74.5605218155874,-0.4149389403990239,-0.17224923419996685,0.24268970619905705,162349374,178312755.2,28.907947749603778,44.94667242279779,NaN,NaN,-3.6492838681094675,8.7419138963063
2012-10-24T09:30:00-04:00,131,131.25,130.34,130.5,6098492,5365412.45,33.214549483104534,49.40039551871171,NaN,NaN,-207.39643779214916,-126.31717858680602,-0.5249578673975507,-0.4135076280478813,0.11145023934966938,156250882,170832825.6,22.87105735192378,42.655883665213196,NaN,NaN,-8.932476024112836,6.217001050532138
2012-10-25T09:30:00-04:00,131.19,131.35001,130.09,130.78,6313016,5432191.95,35.179666478487434,47.346620107501714,NaN,NaN,-169.62804295764252,-173.57493494187392,-0.549543565247908,-0.5754792172102157,-0.025935651962307626,162563898,165876721,19.904962527341,39.88922228256184,NaN,NaN,-12.440313527303944,3.551670396555555
2012-10-26T09:30:00-04:00,130.67999,131.22501,130.09,130.78999,4182566,5413048.2,35.25286785181339,45.489305984644496,NaN,NaN,-144.56195964524136,-182.15040868439615,-0.5352714337386197,-0.6950249441355822,-0.15975351039696256,166746464,163844657.8,18.826864583718873,36.969128249377945,NaN,NaN,-15.165872026784266,0.8777357646498665
2012-10-31T09:30:00-04:00,131.35001,131.58501,130.23,130.60001,3940142,5367177.15,34.45597561235503,44.15959429253572,NaN,NaN,-121.99897438649346,-177.06148483161246,-0.508933762667088,-0.7959207137308226,-0.2869869510637346,162806322,162143388,17.950289781345205,33.902767379803585,NaN,NaN,-17.624072820845576,-1.765379747563768
2012-11-01T09:30:00-04:00,131.02,132.436,130.97,131.98,3807718,5244082,44.304631540638326,44.10563289976317,NaN,NaN,-69.5462382846848,-142.62633061324226,-0.3750625287291573,-0.7558151119751813,-0.38075258324602396,166614040,162996321.2,19.962308639193722,31.354996211140868,NaN,NaN,-16.768235814267346,-3.9086448999499934
2012-11-02T09:30:00-04:00,132.56,132.61,130.47,130.67,5142070,5334978.9,38.405155644875,43.689100530777104,NaN,NaN,-82.22420965229657,-117.59188498527173,-0.35162312627519243,-0.8202814910900145,-0.46865836481482204,161471970,164040538.8,22.468945148569503,29.54163794706157,NaN,NaN,-17.960339278785018,-5.916029811212139
2012-11-05T09:30:00-05:00,130.46001,131.13,130.11,130.87,2710777,5274901.85,39.72476860329661,43.366826230249714,NaN,NaN,-92.63632648368976,-102.1935416904812,-0.30146289598816867,-0.8454869848000328,-0.5440240888118641,164182747,164364308.6,23.271333233924892,28.329697241713095,NaN,NaN,-18.484326097425534,-7.711500709242624
2012-11-06T09:30:00-05:00,131.28,132.63,131.2,132.05,4414547,5267618.85,46.946669976677725,43.11545636589235,NaN,NaN,-36.306398082577196,-80.54242937794837,-0.1739556451804125,-0.7614686452873798,-0.5875130001069673,168597294,164734474.6,24.236744315517242,27.523059508101774,NaN,NaN,-16.55666392812937,-8.975095454797874
2012-11-07T09:30:00-05:00,131.05,131.05,128.64999,129.25,18651728,6079934.45,35.942027329280265,41.55617025143189,NaN,NaN,-120.14053939019784,-80.17074237868924,-0.2582507430454477,-0.9103264289137769,-0.6520756858683292,149945566,162162323.4,22.15112488201072,26.669306245954864,NaN,NaN,-18.84749442871096,-10.385438165356886
2012-11-08T09:30:00-05:00,129.17999,129.67999,127.99001,127.99001,8428309,6199516.7,32.275629221691986,39.687114287758945,NaN,NaN,-148.53025275492897,-95.96754527273808,-0.3720121153061058,-1.1170908300009614,-0.7450787146948556,141517257,157142966.8,18.758769312795096,25.296583363377653,NaN,NaN,-22.07123000231598,-12.054836999208185
2012-11-09T09:30:00-05:00,127.36,128.78999,127.28,127.92,6571563,6021074.95,32.07981395267039,37.84214758806671,NaN,NaN,-151.6277709818654,-109.84825753865184,-0.42148918393485246,-1.2719401946134212,-0.8504510106785688,134945694,151837711.6,15.9741477059073,23.542029153425734,NaN,NaN,-24.540333327263237,-13.838479331787477
2012-11-12T09:30:00-05:00,128.19,128.5401,127.7,128.03999,3758483,6025479.15,32.83196341334917,37.04361244251783,NaN,NaN,-131.72864212406552,-117.666720666727,-0.41499441151249816,-1.3691940250691914,-0.9541996135566932,138704177,146741997.6,13.847834828261597,21.74224696116085,NaN,NaN,-26.211166846430622,-15.60600611959364
2012-11-13T09:30:00-05:00,127.41,128.92,127.33,127.53,5412082,6132522.65,31.248056746960117,36.135544465509895,NaN,NaN,-124.35171643701366,-135.27578433761428,-0.41301603581981916,-1.4704696583314671,-1.057453622511648,133292095,139680957.8,11.552995096602757,20.048951796908312,NaN,NaN,-28.072411258732533,-17.386921139470626
2012-11-14T09:30:00-05:00,127.82001,128.03999,125.46001,125.75999,9480129,6474395.45,26.474340276033743,35.59543686651673,NaN,NaN,-161.5999880805808,-143.56767407569086,-0.4934423454964163,-1.6742565543821684,-1.180814208885752,123811966,134454237.8,10.204889117311538,18.713019037458867,NaN,NaN,-31.360254061357168,-19.38311155688299
2012-11-15T09:30:00-05:00,125.57001,126.05,125.00999,125.50999,7660348,6584425.35,25.873123027037565,35.07104926251195,NaN,NaN,-170.4606970049197,-147.953762925689,-0.5231740933690368,-1.834781825597048,-1.3116077322280113,116151618,129381110,9.095492318135655,17.729050106474002,NaN,NaN,-34.146406902523594,-21.492153749117364
2012-11-16T09:30:00-05:00,125.25,125.77,124.42,125.60001,9350359,6861174.25,26.520202937879205,34.4525161524685,NaN,NaN,-152.36322627499658,-148.10085398431525,-0.4966811830295801,-1.9324592110149865,-1.4357780279854064,125501977,127492366.6,8.715602315975445,16.92981009137646,NaN,NaN,-36.17167792671515,-23.589228631631332
2012-11-19T09:30:00-05:00,126.63,127.67999,126.50999,127.63,9553176,7023527.6,39.37276107632502,34.746794239933614,NaN,NaN,-78.60794329723794,-137.47671421894975,-0.31140015815215105,-1.8250282256755952,-1.5136280675234441,135055153,126762561.8,8.566712739002114,16.196942102468117,NaN,NaN,-33.815647186356664,-25.050145568020664
2012-11-20T09:30:00-05:00,127.31,127.87,126.75,127.71001,7023719,6852831.5,39.81955992298357,35.12990740497851,NaN,NaN,-64.57983492144787,-125.52233791583657,-0.160039980946713,-1.7136780437068353,-1.5536380627601223,142078872,128519917.2,12.44538856587721,15.803734872791834,NaN,NaN,-31.829338552987053,-26.01860170873015
2012-11-21T09:30:00-05:00,127.64999,128.22,127.53999,128.14999,4592309,6802741.5,42.33619862241808,34.989305053677064,NaN,NaN,-40.4509728804653,-101.29253487581349,-0.014538076572210512,-1.5718106584753855,-1.557272581903175,146671181,133091760.2,21.745819813990792,15.931128528134481,NaN,NaN,-29.42640730844121,-26.505431080117443
2012-11-23T09:30:00-05:00,128.67,129.91,128.66,129.89,3345732,6521863.25,51.05364627308129,35.89276866997752,NaN,NaN,17.893325135248933,-63.62173044777976,0.20266253833777714,-1.3039444089809535,-1.5066069473187307,150016913,139864819.2,33.08598509824533,16.6894885245399,NaN,NaN,-24.358025323957754,-26.198658829237488
2012-11-26T09:30:00-05:00,129.12,129.52,128.78999,129.52,4623293,6448103.3,49.34533561915263,36.57995202825295,NaN,NaN,13.176396980729441,-30.513805796634546,0.3182986830848116,-1.1087335934627163,-1.4270322765475278,145393620,143843147.8,38.704729554571735,17.791873976014674,NaN,NaN,-20.798207924707924,-25.42716584287612
2012-11-27T09:30:00-05:00,129.17999,129.64999,128.50999,128.67999,4919211,6378413.05,45.61367162952231,36.48473786059899,NaN,NaN,3.9330358534620995,-14.005609966494543,0.333493940522231,-1.0101648508947392,-1.3436587914169702,140474409,144926999,40.17851106717234,18.930571601132897,NaN,NaN,-18.933147398315153,-24.499448922224556
2012-11-28T09:30:00-05:00,128.17,129.75,127.47,129.64,7399277,6539248.6,50.24464455265531,37.506353376554344,NaN,NaN,8.291341410171185,0.5686252998292673,0.39905120622922796,-0.8448447836304354,-1.2438959898596633,147873686,146085961.8,41.790220002324794,20.333364109726755,NaN,NaN,-15.87429829495553,-23.26728454690041
2012-11-29T09:30:00-05:00,130.23,130.53999,129.50999,130.14,6114508,6647966.9,52.512626441761796,38.95185317798791,NaN,NaN,60.13078058784087,20.684975993490504,0.46247150089724043,-0.6658066137381127,-1.128278114635353,153988194,147549364.4,43.84742733300679,22.125411111170447,NaN,NaN,-12.656515381660554,-21.751460380437575
2012-11-30T09:30:00-05:00,130.25,130.46001,129.78,130.10001,4979578,6706559.9,52.3072607890474,40.39667080915769,NaN,NaN,70.15072353732253,31.13645567390522,0.48571282049065556,-0.5211370890220337,-1.0068499095126893,149008616,147347705,43.61866013230296,24.100019141627282,NaN,NaN,-10.132790993817872,-20.09165046806333
2012-12-03T09:30:00-05:00,130.69,130.8,129.49001,129.55321,5824738,6740693.3,49.45905311448293,41.584320073524395,NaN,NaN,68.55042886360995,42.211262050481324,0.44910192055893483,-0.4454725088140208,-0.8945744293729556,143183878,146905756.6,43.088087749923794,26.18860863603172,NaN,NaN,-8.793118985893916,-18.47757454203913
2012-12-04T09:30:00-05:00,129.61,130.14,129.3,129.39,5760344,6893171.65,48.608262453503194,42.8243347668489,NaN,NaN,56.577041017990396,52.740063083386985,0.4003522363729788,-0.39413413390673213,-0.7944863702797109,137423534,146295581.6,42.32264511395627,28.386440780128403,NaN,NaN,-7.917598065510576,-16.96900647396362
2012-12-05T09:30:00-05:00,129.71001,130.82001,129.16,130.24001,8697742,7107331.4,53.13027037040062,44.728329773589394,NaN,NaN,91.69932276410856,69.42165935417447,0.4102985859875823,-0.2816131377952331,-0.6919117237828154,146121276,145945099.6,41.86262389275059,30.64770754980262,NaN,NaN,-5.850574171696394,-15.38065900221116
2012-12-06T09:30:00-05:00,130.34,130.8,130.09,130.74001,4129398,6381214.9,55.604864916602786,46.852025622844046,NaN,NaN,111.66615056787887,79.72873335018205,0.43324109438969405,-0.15036035579569784,-0.5836014501853919,150250674,145197595.6,40.84296522742829,32.91538418618067,NaN,NaN,-3.3782775756089145,-13.666033084125125
2012-12-07T09:30:00-05:00,131.3,131.61,130.82001,131.56,3993247,6159461.8,59.3914866948638,49.19997446262865,NaN,NaN,133.15628377985655,92.32984539868886,0.4825602292964909,0.019598836435221756,-0.46296139286126914,154243921,146244656.6,42.93952336374448,35.359949975307025,NaN,NaN,-0.09354788394606645,-11.727106626956688
2012-12-10T09:30:00-05:00,131.59,132.005,131.57001,131.74001,3480814,6004924.35,60.19415507059233,50.687216890790616,NaN,NaN,136.5758558769322,105.93493080135332,0.5038844512839392,0.1668941712436549,-0.3369902800402843,157724735,149152828,48.408560326696296,38.20579623157089,NaN,NaN,2.8519998117266185,-9.644377135716216
2012-12-11T09:30:00-05:00,132.21001,133.12,132.17999,132.5,4013966,6017698.5,63.47652193471014,52.376999891628216,NaN,NaN,153.4753031082112,125.31458321939746,0.5424086673230945,0.3410205541135838,-0.2013881132095107,161738701,154015861.4,56.002623133766605,41.31702727213442,NaN,NaN,6.399036120029021,-7.352460956324039
2012-12-12T09:30:00-05:00,132.98,133.34,132.33,132.50999,9551996,6224694.2,63.51910609012872,53.890064710750416,NaN,NaN,141.15153865052153,135.20502639668007,0.5405944964175262,0.474355007312397,-0.06623948910512917,171290697,159049745.6,62.20442817407733,44.20692786928346,NaN,NaN,9.316060056897435,-4.971243668720971
2012-12-13T09:30:00-05:00,132.53,132.72,131.55,131.82001,3844622,5942918.85,58.450163869900315,54.418387396237485,NaN,NaN,104.82767541928764,133.83733136696182,0.46768953354523995,0.5183724278264208,0.050682894281180835,167446075,162488825.8,65.75584424187966,46.540489236685914,NaN,NaN,10.495229861483466,-2.7617474501203376
2012-12-14T09:30:00-05:00,131.7,132,131.261,131.46001,3114361,5715619.5,55.9417472378942,54.88955965471903,NaN,NaN,79.66915499664545,123.1399056103196,0.37404063180497354,0.5182336840373978,0.14419305223242423,164331714,164506384.4,67.67482265108237,48.609781600722386,NaN,NaN,10.807567555936515,-0.8232738778265016
2012-12-17T09:30:00-05:00,131.64999,132.52,131.63,132.44,4534957,5474849.4,60.86531186201265,55.97896252846834,NaN,NaN,101.01827535758841,116.02838950645085,0.35696157831432623,0.590395025125332,0.2334334468110058,168866671,166734771.6,69.69481508990444,50.71808903091754,NaN,NaN,12.5150868847143,1.0822062311078986
2012-12-18T09:30:00-05:00,132.67999,133.73,132.38,133.55,6460660,5320223.6,65.55995039274885,57.07291294561787,NaN,NaN,134.15284861718516,112.16389860824563,0.39625368133793015,0.7287505484834185,0.3324968671454883,175327331,169452497.6,71.99344090265168,52.875461952369456,NaN,NaN,15.495571993444479,3.141258482870267
2012-12-19T09:30:00-05:00,133.67,133.7,132.60001,132.62,5512648,5244670.05,59.15685446824505,57.54750066179525,NaN,NaN,108.87859865457789,105.70931060905691,0.3377271997245589,0.7546558668011869,0.416928667076628,169814683,169157294.8,71.36028970569153,54.84066640756122,NaN,NaN,16.066012728049433,4.987651946467291
2012-12-20T09:30:00-05:00,132.57001,133.28,132.27,133.19,5535309,5291820.05,61.63037509258901,58.213437397762505,NaN,NaN,96.03738028808151,103.95125158281569,0.3159147263213563,0.8118220749783234,0.49590734865696706,175349992,170738078.2,72.74269077159025,56.920954310367456,NaN,NaN,17.305964815405943,6.747410927744241
2012-12-21T09:30:00-05:00,131.06,132.02,130.83,131.78999,11496098,5699338.35,53.12090046423323,58.47499792274466,NaN,NaN,22.626843020859543,92.54278918765853,0.19181585843328164,0.735677171698569,0.5438613132652874,163853894,170642514.2,72.51481465116933,59.02286337474214,NaN,NaN,15.592513192498036,8.01099696556621
2012-12-24T09:30:00-05:00,131.28999,131.42,130.97,130.97,1997462,5568046.8,48.86521202112778,58.49335146328928,NaN,NaN,-5.351333180330327,71.26886748007477,0.04668966204295211,0.6022233908189776,0.5555337287760255,161856432,169240466.4,69.09494978969452,60.93517085158059,NaN,NaN,12.744983688403567,8.687280783114405
2012-12-26T09:30:00-05:00,131.28999,131.479,130.47,130.81,3983433,5521257.9,48.05620923457992,58.13091852501638,NaN,NaN,-24.966582704809497,39.44498121567585,-0.06199569670218252,0.4780391078982973,0.5400348046004798,157872999,165749600,61.33838170950527,62.326296409920204,NaN,NaN,10.234348210694733,8.90829041562588
2012-12-27T09:30:00-05:00,130.94,131.14,129.34,130.60001,8309875,5566787.8,46.957411654211995,57.51324329198845,NaN,NaN,-69.95851718702318,3.6775580473556344,-0.14519212256920955,0.35854465138896785,0.5037367739581774,149563124,161699288.2,53.7928816724011,63.25129044170398,NaN,NaN,7.864069902733557,8.759116056641261
2012-12-28T09:30:00-05:00,129.82001,130.45,128.97,129.07001,8572887,5689706.75,39.81433721974886,56.114875472337395,NaN,NaN,-123.54153649671845,-40.23822530960437,-0.291960317190714,0.13878637746978484,0.43074669466049886,140990237,154827337.2,43.9209207412688,63.32139025438429,NaN,NaN,3.345540274852648,7.985748087814317
2012-12-31T09:30:00-05:00,128.66,130.89999,128.543,130.58,12070090,6044232.35,48.19070988711125,55.25748653066017,NaN,NaN,-88.72027348107912,-62.50764860999209,-0.27620973714321045,0.08548452323148581,0.36169426037469626,153060327,152668623.8,41.35353639302848,62.81745997340801,NaN,NaN,2.1667330385293657,7.154460223630752
2013-01-02T09:30:00-05:00,132.99001,133.86,132.89,133.77,9639121,6234951.5,60.65034159771791,55.055616506589296,NaN,NaN,128.53717482354585,-35.729947009216865,-0.05157735782502637,0.29722256309341333,0.3487999209184397,162699448,152837227,41.6404735044197,61.791592142740384,NaN,NaN,5.953265902123177,6.982861034843956
2013-01-03T09:30:00-05:00,133.64,134.05,133.31,133.63,8665887,6380228.65,59.968718392398195,54.802017385322834,NaN,NaN,125.03714671439958,-5.729201125375047,0.07980722077053182,0.44855894688160447,0.36875172611107265,154033561,152069339.4,40.66463424142132,60.25303543326495,NaN,NaN,8.490750020336314,7.19827374705715
2013-01-04T09:30:00-05:00,133.7,134.2,133.49001,134.06,4759766,6183329.85,61.403494719563575,55.012969588870206,NaN,NaN,126.25697511195109,33.51389733441981,0.1820526592471413,0.5963175501699993,0.414264890922858,158793327,153915380,44.05872363651421,58.70324110431027,NaN,NaN,10.955188124336896,7.734975800954256
2013-01-07T09:30:00-05:00,133.69,133.73199,133.16,133.50999,6120535,6282886.7,58.51457434509494,55.19674295367026,NaN,NaN,88.791308129766,75.98046625971669,0.19771749082478352,0.6614117544538374,0.46369426362905386,152672792,156251891,48.10492128281601,57.30539100657696,NaN,NaN,11.990019232489212,8.342839148316394
2013-01-08T09:30:00-05:00,133.32001,133.5,132.74001,133.0623,4274453,6296947,56.19693116344947,54.863287189487174,NaN,NaN,59.595600043210254,105.64364096457457,0.16437328419316166,0.669160868870506,0.5047875846773443,148398339,155319493.4,46.65471991967903,55.65966992298944,NaN,NaN,12.09684297100792,8.879125408700897
2013-01-09T09:30:00-05:00,133.39999,133.98,133.39999,133.71001,3898205,6317816.55,58.74298851165987,54.37636134083796,NaN,NaN,87.44841174115166,97.42588834809574,0.17159034926700145,0.7192755212610962,0.5476851719940947,152296544,153238912.6,43.5031453882201,53.62464881481575,NaN,NaN,12.972167109465635,9.463845651667288
2013-01-10T09:30:00-05:00,134.2,134.58,133.625,134.53999,6004434,6417339.95,61.806534590675454,54.56562420672585,NaN,NaN,108.53964503320249,94.12638801185632,0.21509305963551972,0.8165514965384943,0.6014584369029746,158300978,154092396,45.14026670378573,51.751790028965324,NaN,NaN,14.66403581735597,10.206729961051385
2013-01-11T09:30:00-05:00,134.46001,134.8,134.21001,134.718,4507988,6165139.55,62.45054333523829,54.624207652629366,NaN,NaN,113.82020566729801,91.63903412292571,0.23696098267165455,0.8976596652425428,0.6606986825708883,162808966,154895523.8,46.70526953443891,49.89197422631167,NaN,NaN,16.221508448526233,11.065984030690649
2013-01-14T09:30:00-05:00,134.66,135,134.39999,134.89,4297945,6187805.7,63.09801557179502,55.336858731740925,NaN,NaN,110.39391863645562,95.95955622426364,0.24319866131144785,0.9646970092101981,0.7214983478987502,167106911,157782347.6,52.0052632073935,48.427006266041964,NaN,NaN,17.684337523998543,12.011463101163205
2013-01-15T09:30:00-05:00,134.28999,135.25999,134.24001,135.08,2966046,6180389.95,63.839767267664584,56.40646982077927,NaN,NaN,105.72190440681598,105.18481709698479,0.23990703515575684,1.0213821418434463,0.7814751066876895,170072957,162117271.2,58.654412739998136,47.68125361963508,NaN,NaN,19.107841958084496,13.025231509294818
2013-01-16T09:30:00-05:00,134.62,135.05,134.53999,134.89,3197708,6113527.5,62.4871216487853,57.437249278936804,NaN,NaN,95.71272801330535,106.83768035141551,0.2060176689377533,1.0389971928598811,0.8329795239221278,166875249,165033012.2,62.42511566135521,47.75887747333865,NaN,NaN,19.949897768267178,14.014469546290869
2013-01-17T09:30:00-05:00,135.37,136.19,135.23,135.83,6231660,6102077.5,66.29234545812326,58.81831597921617,NaN,NaN,126.67783834244618,110.46531901326425,0.22637117277544616,1.1159434898914355,0.8895723171159894,173106909,167994198.4,65.83311851782184,48.618894390868704,NaN,NaN,21.777208908060963,15.123432312258025
2013-01-18T09:30:00-05:00,135.81,136.16,135.42,136.09,4922773,6072583.75,67.28096785036152,60.780218167117084,NaN,NaN,117.98243346082539,111.29776457196974,0.23574413531236071,1.1842524862564403,0.9485083509440796,178029682,171038341.6,68.95083270946094,50.40674524573957,NaN,NaN,23.59068397821312,16.333039693108752
2013-01-22T09:30:00-05:00,136.13,136.77,135.92419,136.74001,4548605,6023248.55,69.67553198190753,62.31484831674539,NaN,NaN,127.11525967109063,114.64203277889673,0.2620955796011244,1.276127825445485,1.0140322458443607,182578287,174132616.8,71.77058748229199,52.57939175211554,NaN,NaN,25.858611670377424,17.69383568986142
2013-01-23T09:30:00-05:00,137.1899,137.63,137.142,137.46001,6403008,5768594.05,72.11034857348564,63.13342024358594,NaN,NaN,150.70061879253217,123.63777565603998,0.3015766505189741,1.3910030589930784,1.0894264084741043,188981295,177914284.4,74.78454602448282,54.946825503548624,NaN,NaN,28.557458328033025,19.245781781028793
2013-01-24T09:30:00-05:00,137.59,138.49001,137.57001,138.02,6288914,5983166.65,73.86779303518927,64.1262112894996,NaN,NaN,156.73716495857,135.8426630450929,0.33631863549119845,1.5098247028381024,1.173506067346904,195270209,183593276.4,78.49733532562337,57.649161295277345,NaN,NaN,31.39484785702093,20.98136264902767
2013-01-25T09:30:00-05:00,138.39,138.63,138.03999,138.62,4464027,6007196.35,75.63907598557513,65.14303852278613,NaN,NaN,154.0190531096046,141.3109059985246,0.3680558274722576,1.633575851687226,1.2655200242149685,199734236,188918741.8,81.28083390536796,60.30788345733833,NaN,NaN,34.3670102933017,22.893598026781103
2013-01-28T09:30:00-05:00,138.85001,138.88,138.3,138.64999,3170223,5750213.75,75.72763521772194,66.37254287083091,NaN,NaN,146.0460658120976,146.92363246877903,0.35903037713851216,1.7143079956381087,1.3552776184995965,202904459,193893697.2,83.43775489580108,62.831657286837256,NaN,NaN,36.82832019134607,24.884272621718956
2013-01-29T09:30:00-05:00,138.44,139.3801,138.44,139.23,3947869,5518962.85,77.43607045042745,67.8896242484722,NaN,NaN,141.58187121238163,149.81695477703724,0.3592115099249007,1.8042920059057224,1.4450804959808217,206852328,198748505.4,85.22668460750009,65.58679762168161,NaN,NaN,39.470264760495006,26.96798578440125
2013-01-30T09:30:00-05:00,139.23,139.37,138.67,138.75999,5498887,5190402.7,72.95484427775163,68.90475680319302,NaN,NaN,123.9148093230074,144.45979288313228,0.29732511631591185,1.8167368913757116,1.5194117750597997,201353441,201222934.6,86.05353304564451,68.62611102578337,NaN,NaN,40.507873295711256,28.90225542887411
2013-01-31T09:30:00-05:00,138.75999,140.22,138.32001,138.41,3935235,4905208.4,69.71935375955306,69.46995817239858,NaN,NaN,110.36374153685767,135.18510819878983,0.20676191855416848,1.7778641732525102,1.5711022546983417,197418206,201652534,86.19796536032793,71.55880378696496,NaN,NaN,40.49736853596934,30.558700158459143
2013-02-01T09:30:00-05:00,139.28999,139.89,139.03999,139.74001,5237383,4733783.2,74.3709540621409,70.32141608146306,NaN,NaN,114.40828468538429,127.26295451394576,0.2097145509643643,1.833245443403797,1.6235308924394327,202655589,202236804.6,86.40418988459068,74.39444095483294,NaN,NaN,41.879724436847965,32.175989341086115
2013-02-04T09:30:00-05:00,138.81,138.98,138.36,138.57001,6536164,4822603.1,64.92273989288196,70.45175353296926,NaN,NaN,74.49671355106175,112.95308406173858,0.1111035325503853,1.7624103081274143,1.651306775577029,196119425,200879797.8,83.29139843438276,76.62916489961788,NaN,NaN,40.07240526551037,33.30404875886101
2013-02-05T09:30:00-05:00,139.24001,139.85001,139.21001,139.39,5820223,4807587.5,67.9918619829379,70.74833172691736,NaN,NaN,93.21853604318632,103.28041702789953,0.08074702334284689,1.7522405547555877,1.6714935314127408,201939648,199897261.8,81.01559382255815,78.22639211980074,NaN,NaN,39.51523369535025,34.191360892645186
2013-02-06T09:30:00-05:00,138.88,139.7,138.88,139.58,3118099,4749769.8,68.67577144791282,71.19037814114076,NaN,NaN,82.67860804695448,95.03317677268896,0.0543739277425932,1.7394609410909823,1.685087013348389,205057747,200638123,81.42766699729563,79.58371721522506,NaN,NaN,39.27691629294789,34.91786880697414
2013-02-07T09:30:00-05:00,139.59,139.64,138.32001,139.28999,6637910,4886755.05,66.34556626400547,71.19417962727519,NaN,NaN,66.55520994360394,86.2714704540382,0.001123033881519131,1.6864908057002879,1.6853677718187687,198419837,200838449.2,81.5443192102544,80.70594583611309,NaN,NaN,38.38369984838393,35.41298752717554
2013-02-08T09:30:00-05:00,139.37,140.03101,139.37,139.73,3573803,4765223.5,68.11336787590801,71.25363677195709,NaN,NaN,84.89743584743492,80.36930068644831,-0.019597232052030122,1.660871231753731,1.6804684638057612,201993640,200706059.4,81.18142116709093,81.57955929737238,NaN,NaN,38.1424434348667,35.802909799702846
2013-02-11T09:30:00-05:00,139.62,139.67999,139.21001,139.52,2543470,4666997.6,66.32278099672106,71.01415455872947,NaN,NaN,70.95017501116612,79.65999297846919,-0.06027919364689316,1.6051194717471446,1.6653986653940378,199450170,201372208.4,81.62455042547128,82.28341379331377,NaN,NaN,37.43048428645111,36.03542044066688
2013-02-12T09:30:00-05:00,139.59,140.21001,139.50999,140.05,3498954,4627048.05,68.56856754151184,70.76117019930278,NaN,NaN,88.10175391017549,78.63663655186701,-0.06397768400879711,1.5854265603830413,1.6494042443918384,202949124,201574103.6,81.76470129032775,82.78199631230268,NaN,NaN,37.4500554348043,36.23751115411508
2013-02-13T09:30:00-05:00,140.23,140.36,139.5,139.87,3387704,4648130.95,66.93599203120444,70.26604155616101,NaN,NaN,86.14811473597715,79.33053788967155,-0.08946649334189338,1.5375711277144717,1.627037621056365,199561420,200474838.2,78.26457057712945,82.76537025883883,NaN,NaN,37.011444847890914,36.34807311036877
2013-02-14T09:30:00-05:00,139.38,139.96001,139.2601,139.86,3048777,4640684.4,66.84077779805553,69.6375916856239,NaN,NaN,73.539683173723,80.72743253569537,-0.11622397186943512,1.4817576562195711,1.5979816280890062,196512643,200093399.4,77.03232181841562,82.4619051097708,NaN,NaN,36.623034429349325,36.387353298794565
2013-02-15T09:30:00-05:00,139.50999,139.71001,138.75,139.45,6114371,4634819.95,62.890772834257206,68.72067294394785,NaN,NaN,41.71434339502223,72.09081404521284,-0.1676361240162838,1.3884364730686514,1.5560725970849352,190398272,197774325.8,69.83335100163711,81.49016197447338,NaN,NaN,35.21832802369556,36.220349688066136
2013-02-19T09:30:00-05:00,139.56,140.16,139.52,139.97,3945901,4585976.35,65.66237309911988,67.8796945617116,NaN,NaN,91.48342999410576,76.19746504180073,-0.17207373399086268,1.3409804295963568,1.5130541635872194,194344173,196753126.4,66.86982779712599,80.17895791658951,NaN,NaN,34.72022892900317,36.00604672248571
2013-02-20T09:30:00-05:00,140,140.284,138.88,138.88,5976242,4657358.2,56.18894058376243,66.68213001214095,NaN,NaN,27.042336014430497,63.98558146265172,-0.24919023203206536,1.2015663735471378,1.4507566055792032,188367931,193836887.8,59.150160813245314,78.25728847141815,NaN,NaN,31.404212276274567,35.348641801598404
2013-02-21T09:30:00-05:00,138.64999,138.88,138.06,138.50999,7522262,4713320.9,53.37385865123961,65.5145946472614,NaN,NaN,-104.32105282000998,25.891747951454306,-0.321301840116202,1.0491293054339508,1.3704311455501528,180845669,190093737.6,51.01016837201669,75.74387440082448,NaN,NaN,27.770899543121175,34.266107193244515
2013-02-22T09:30:00-05:00,139.24001,139.83,138.86,139.81,4158938,4606822.1,60.80404003661612,64.54552935972393,NaN,NaN,39.16962834885863,19.01773698648143,-0.2791871836664055,1.021447165967146,1.3006343496335515,185004607,187792130.4,46.7499859760305,72.91143126449876,NaN,NaN,26.757835880341908,33.193497005687
2013-02-25T09:30:00-05:00,140.33,140.59,137.60001,137.66,10034930,4885367.25,47.36172903537855,63.291171441330825,NaN,NaN,-114.29121925875457,-12.183375544273934,-0.38722069170177953,0.8166084850063271,1.2038291767081066,174969677,184706411.4,41.71939209184966,69.94200224003211,NaN,NaN,20.787660250560396,31.421234612097486
2013-02-26T09:30:00-05:00,138.35001,138.96001,137.98,138.78,9236059,5188659.05,53.169798183594324,62.23245259852056,NaN,NaN,-120.78845497917976,-54.637752538931046,-0.3741345504081508,0.7361609886979181,1.110295539106069,184205736,182678724,38.76728270272134,66.92426573147233,NaN,NaN,18.040627286905895,29.509719279927257
2013-02-27T09:30:00-05:00,138.74001,140.87,138.64,140.60001,7406246,5361577.9,60.74896858203748,61.66625239381518,NaN,NaN,118.70337405729221,-36.30554493035869,-0.2402932253740402,0.8099290073885186,1.0502222327625588,191611982,183327534.2,40.22481030231646,63.98120453897382,NaN,NaN,18.657734378627424,27.95943572259871
2013-02-28T09:30:00-05:00,140.45,141.31,140.17999,140.28,11400070,5656637.05,58.94262817369839,61.137471101650384,NaN,NaN,184.77160493682072,21.51298662100745,-0.17380447406478194,0.8329666401815814,1.0067711142463633,180211912,183200782.8,40.02437344882655,61.015494127443255,NaN,NaN,18.46540923185965,26.6031462239217
2013-03-01T09:30:00-05:00,139.89,140.89999,139.17,140.74001,6506848,5785217.7,60.74936852109151,60.611471147734925,NaN,NaN,122.01958139952178,38.08297723114008,-0.10284127165671264,0.8782195246754725,0.9810607963321851,186718760,183543613.4,40.88242168785747,58.13699416464086,NaN,NaN,18.94048391742465,25.50848018013641
2013-03-04T09:30:00-05:00,140.36,141.10001,140.10001,141.07001,3620655,5704381.3,62.03988474939958,60.30554998721197,NaN,NaN,163.90721417739738,93.72266391837047,-0.04085611672793288,0.929990650422269,0.9708467671502019,190339415,186617561,48.05800340697367,55.7393836633196,NaN,NaN,19.73970006257936,24.684368734771116
2013-03-05T09:30:00-05:00,141.69,142.67999,141.69,142.34,7963430,5775744.6,66.59223149626831,60.16438312683739,NaN,NaN,285.008591404858,174.88207319517804,0.07233349289382784,1.0612636332674867,0.9889301403736589,198302845,189436982.8,53.61872828445762,53.728957020043154,NaN,NaN,21.983284393417936,24.298499543149234
2013-03-06T09:30:00-05:00,142.91,143.07001,142.49001,142.84,4485023,5708984.6,68.20871147166247,60.25529165829868,NaN,NaN,259.739615789167,203.089321541553,0.16237965072387683,1.1919047037785049,1.029525053054628,202787868,191672160,57.502983841679516,52.24598653893958,NaN,NaN,24.321150443434867,24.30173538604718
2013-03-07T09:30:00-05:00,142.98,143.39,142.89999,143.14,3689370,5737548.15,69.17253303025603,60.42184560345586,NaN,NaN,218.274814507414,209.78996345567165,0.22006594411280878,1.304607483195639,1.0845415390828301,206477238,196925225.2,64.935252150821,51.38191013411141,NaN,NaN,26.501332226684426,24.615963506138215
2013-03-08T09:30:00-05:00,143.95,144.02,143.21001,143.75999,5681063,5689705.8,71.12110810958093,61.00972669455041,NaN,NaN,196.65981780135755,224.7180107360388,0.27436513000689433,1.427497951591448,1.1531328215845538,212158301,202013133.4,70.34494738995683,51.41845273327709,NaN,NaN,28.93627558329469,25.233150945731996
2013-03-11T09:30:00-04:00,143.73,144.36,143.61,144.36,4373293,5729680.3,72.90599614509601,61.527128340691554,NaN,NaN,175.0261761171079,226.9418031239809,0.32179447893996294,1.5553759202595074,1.2335814413195445,216531594,207251569.2,74.67674919343803,51.97608997587081,NaN,NaN,31.533243834434888,26.133164215546696
2013-03-12T09:30:00-04:00,144.28999,144.7,144.03,144.39999,5167313,5860872.45,73.0256588726627,62.72975107561301,NaN,NaN,152.90651367673698,200.52138757835667,0.325959019511344,1.6410302157087244,1.3150711961973804,221698907,211930781.6,77.79667150630367,53.30798359680356,NaN,NaN,33.655308996885026,27.207756327166457
2013-03-13T09:30:00-04:00,144.44,144.71001,144.09,144.46001,4322035,5902026.5,73.21685389014254,64.14710787839178,NaN,NaN,128.26514762247982,174.22649394501926,0.3033230455479947,1.6942250031323738,1.390901957584379,226020942,216577396.4,80.38153673677787,55.40593848000078,NaN,NaN,35.44963494288655,28.385167557983614
2013-03-14T09:30:00-04:00,144.81,145.35001,144.75999,145.33,5366152,6000948.9,75.8850350484278,65.2243218078069,NaN,NaN,130.51733441127553,156.67499792579156,0.3160747020314916,1.7859953351237436,1.469920633092252,231387094,221559367.6,82.70619728588471,57.9742392878475,NaN,NaN,37.836126432749055,29.73530454009296
2013-03-15T09:30:00-04:00,144.82001,144.89,144.39,144.82001,10836715,6390345.8,71.39496233228512,66.94098132901452,NaN,NaN,101.09769721164155,137.56257380784837,0.2615506789064217,1.7968589817252791,1.5353083028188574,220550379,223237783.2,83.41902976225353,60.952784835733496,NaN,NaN,38.60206009583054,31.00198390519833
2013-03-18T09:30:00-04:00,143.85001,144.88,143.7,144.17,5511254,6360189.95,66.03211419558062,67.85971818701354,NaN,NaN,78.05076287865748,118.16749116015828,0.15818592634682682,1.733040710752391,1.5748547844055643,215039125,222939289.4,82.76564713420917,64.09552515226834,NaN,NaN,37.70886114707622,31.9601092254666
2013-03-19T09:30:00-04:00,144.50999,144.83,143.4801,144.3,9301672,6627978.5,66.57291145188269,68.27571410628819,NaN,NaN,69.59968688381366,101.50612580157363,0.07904518014170958,1.6736612595827012,1.5946160794409916,224340797,223467667.4,83.01919204321126,67.15226670518939,NaN,NaN,37.12119868755178,32.697407720050194
2013-03-20T09:30:00-04:00,144.86,145.14999,144.59,144.81,5924809,6625406.85,68.67962015947336,68.97121353384355,NaN,NaN,82.72123072923738,92.39734242292513,0.043306812808547424,1.648749595451676,1.6054427826431286,230265606,224316600.2,83.44070887918396,70.25343352164349,NaN,NaN,37.197175004357845,33.34023161780843
2013-03-21T09:30:00-04:00,144.12,144.59,143.49001,143.89,6076520,6553119.75,61.18801872638851,69.00254569136476,NaN,NaN,50.50676891829634,76.39522932432932,-0.05471228426676289,1.5370524273096748,1.5917647115764377,224189086,222876998.6,79.8221655961483,73.03484380080712,NaN,NaN,35.05162479401894,33.58471635726707
2013-03-22T09:30:00-04:00,144.31,144.94,144.28,144.89999,5028566,6596601.15,65.62152490789182,69.25837713125706,NaN,NaN,70.38710993122946,70.25311186824686,-0.06333725977416949,1.512593136858726,1.5759303966328955,229217652,224610453.2,80.89646271633177,75.38044803718984,NaN,NaN,34.488221143132925,33.71378846953362
2013-03-25T09:30:00-04:00,145.09,145.32001,143.60001,144.21001,9603117,6575010.5,60.53423296774224,68.82566295064807,NaN,NaN,54.3294125655237,65.50884180562011,-0.12382335179985127,1.4211512068830814,1.5449745586829327,219614535,225525535.2,81.45769896097217,77.36894594265517,NaN,NaN,32.4240602016744,33.52954157412516
2013-03-26T09:30:00-04:00,144.67,145.28999,144.63,145.28,4879023,6357158.7,65.05814544442059,68.60062252013078,NaN,NaN,80.90783338294865,67.7704711054471,-0.1010448137950406,1.418668541439132,1.5197133552341726,224493558,225556087.4,81.47726505745638,79.08139460092494,NaN,NaN,32.058321210250924,33.31936723642884
2013-03-27T09:30:00-04:00,144.35001,145.08501,144.06,144.96001,4129137,6193303.25,62.74185831076353,68.14128861159561,NaN,NaN,60.65922580929475,63.35807012145857,-0.11574668217643769,1.3750300025136255,1.4907766846900632,220364421,223575850.4,75.88778026583716,79.86371803771182,NaN,NaN,31.04208139873214,32.99404068818645
2013-03-28T09:30:00-04:00,145.00999,145.53,144.84,145.32001,4346066,5840603.05,64.28257108212472,67.65282168106303,NaN,NaN,89.94133214670043,71.24498276713939,-0.10951066360911588,1.3538883551786682,1.4633990187877841,224710487,223680130.6,75.98122515541031,80.26630930667277,NaN,NaN,30.666634244650798,32.66155405339565
2013-04-01T09:30:00-04:00,145.3,145.73351,144.97,145.35001,8623871,5946454.2,64.41463232714415,67.04629569406646,NaN,NaN,103.49489083831276,77.86653894855604,-0.11128831764015201,1.324288621737594,1.435576939377746,233334358,224503471.8,76.74744213567249,80.41421594540381,NaN,NaN,30.401023538074224,32.338621122635445
2013-04-02T09:30:00-04:00,145.87,146.5,145.78,146.27,5673121,6049077.5,68.28701966859879,66.70782146520476,NaN,NaN,182.46848394856622,103.49435322516456,-0.060944867635208455,1.3593958548337355,1.420340722468944,239007479,228382060.6,79.98639623062523,80.57062485428392,NaN,NaN,31.317927611590108,32.19280776391468
2013-04-03T09:30:00-04:00,146.24001,146.47,144.95,145.14,7661523,6033982.15,59.69448030893038,65.74193763797531,NaN,NaN,107.84336315686329,108.88145917994748,-0.11125867318027738,1.2812673809935973,1.3925260541738747,231345956,229752540.2,80.99382049178934,80.61435940821332,NaN,NaN,29.434808847073572,31.798807918651665
2013-04-04T09:30:00-04:00,145.36,145.98,145.09,145.77,7520480,6185755,62.525640115214905,64.78769514274583,NaN,NaN,111.3340622667938,119.01642647144729,-0.10945229428215564,1.25571068632118,1.3651629806033356,238866436,233452943.2,83.42053532289967,80.66538355371438,NaN,NaN,28.735978413698938,31.36126084651556
2013-04-05T09:30:00-04:00,144.17999,145.508,144.05,145.31,7307414,6366657.2,59.25290060446377,63.92040501933002,NaN,NaN,24.79461201576389,105.98708244525999,-0.14438447652018338,1.1846823849531063,1.3290668614732897,231559022,234822650.2,84.22350259127295,80.72284589864434,NaN,NaN,27.1476316317335,30.759313815832407
2013-04-08T09:30:00-04:00,145.32001,145.95,144.75999,145.95,3864981,6275853.1,62.21613812223371,63.64783529980524,NaN,NaN,94.91023702299073,104.27015168219559,-0.12998396279116053,1.166586907984339,1.2965708707754995,235424003,235240579.2,84.47064107746343,80.84463118030536,NaN,NaN,26.707841331345666,30.180532032334302
2013-04-09T09:30:00-04:00,146.08,146.955,145.752,146.50999,5492254,6331801.15,64.63926434587177,63.50971764937588,NaN,NaN,181.04205218416178,103.9848653293147,-0.09022736122631358,1.1837866692426076,1.2740140304689211,240916257,235622334.8,84.70631392816817,80.9651398863737,NaN,NaN,27.079208739487125,29.73748584764185
2013-04-10T09:30:00-04:00,146.98,148.06,146.96001,147.78,7947555,6470813.25,69.42784968167564,63.563162615247464,NaN,NaN,258.85436877804125,134.1870664535503,0.008855302287450462,1.2850831583282343,1.2762278560407838,248863812,239125906,86.70104262661135,81.19802086833282,NaN,NaN,28.977193451135253,29.628872648140906
2013-04-11T09:30:00-04:00,147.8199,148.66,147.63,148.39999,6975523,6603487.65,71.45976546933956,64.29685881117254,NaN,NaN,247.6196517812502,161.44418435644158,0.09842537428634701,1.3992595738987177,1.3008341996123707,255839335,242520485.8,88.29411554831047,81.8031601506301,NaN,NaN,31.20956310753538,29.854685570911546
2013-04-12T09:30:00-04:00,147.99001,148.46001,147.6799,148.42,8711328,6770746.45,71.52554370886259,64.71857443981331,NaN,NaN,191.2382713517144,194.73291622363166,0.13882407375680006,1.4743642918083708,1.3355402180515707,264550663,249118814,90.64094977741566,82.49919494070754,NaN,NaN,32.99338144729407,30.30307069610905
2013-04-15T09:30:00-04:00,147.89999,147.92999,145.72,145.81,14181172,6937969.3,54.03272847707136,64.25418126190824,NaN,NaN,62.82813305659955,188.31649543035343,-0.021872159210154063,1.3082000190388783,1.3300721782490323,250369491,252107911.6,91.47477476995577,83.21470035563493,NaN,NaN,28.54575342985493,30.05202537235846
2013-04-16T09:30:00-04:00,146.98,147.39,146.37,147.36,6975301,7011171.65,60.25014501323812,63.91075265968092,NaN,NaN,87.23651389236656,169.5553877719944,-0.03465550534590944,1.2867527965666454,1.3214083019125549,257344792,255393618.6,92.28812320203758,83.9869045088193,NaN,NaN,27.047147540890894,29.622757110720237
2013-04-17T09:30:00-04:00,146.55,146.60001,145.37,145.95,10757043,7083940.2,53.200760842335384,63.22924569765034,NaN,NaN,11.843943985507849,120.15330281348773,-0.14288109343030975,1.1428069351246677,1.2856880285549774,246587749,254938406,90.99288886104875,85.06584083704868,NaN,NaN,23.17133152174122,28.701124883723235
2013-04-18T09:30:00-04:00,146.10001,146.12,144.77,145.17999,8277020,7201550.75,49.77566971653788,62.19303845725128,NaN,NaN,-32.982405264518206,64.03289140433404,-0.26408634400245745,0.9555800985519056,1.219666442554363,238310729,251432684.8,81.50568521472611,85.46044512699983,NaN,NaN,18.892410551127455,27.299879979066695
2013-04-19T09:30:00-04:00,144.71001,145.21001,144.36,145.14,6029961,7199222.8,49.59708259371557,61.13464204772066,NaN,NaN,-70.74177094774173,11.63688294444282,-0.33988313890958466,0.7948125189173822,1.134695657826967,232280768,244978705.8,67.5436120931094,84.80302869538818,NaN,NaN,15.588438768534296,25.626816948990637
2013-04-22T09:30:00-04:00,145.38,145.57001,144.24001,145.32001,11711969,7533392.95,50.45873095589606,59.86119285395618,NaN,NaN,-62.67148748855197,-13.46304116458749,-0.3684308518118087,0.6741570930622061,1.0425879448740147,243992737,243703355,65.1679595466065,83.74456893224398,NaN,NaN,13.243038220715988,23.857705702094258
2013-04-23T09:30:00-04:00,146.13,146.89999,145.14999,146.8,10436188,7575046.5,56.971653088066105,59.66670519532302,NaN,NaN,23.344148344353346,-26.24151427419012,-0.2820658221501162,0.6900056671863695,0.9720714893364857,254428925,243120181.6,64.05845815096828,82.53490019361391,NaN,NaN,13.289229574160139,22.34792339810367
2013-04-24T09:30:00-04:00,147.02,147.21001,146.39,146.45,4968387,7579514.7,55.12596252838197,59.13815679626354,NaN,NaN,48.41591079329503,-18.927120912632706,-0.2443459107904118,0.6666391008484709,0.9109850116388827,249460538,243694739.4,64.69618697376119,81.19744674010401,NaN,NaN,12.749362255180943,20.97670037768614
2013-04-25T09:30:00-04:00,146.64,147.42,146.36,146.75999,4160813,7581098.5,56.47102613547532,58.93945147705007,NaN,NaN,54.675336319293784,-1.395572595870307,-0.19641722355271207,0.6654634821979926,0.8618807057507046,253621351,246756863.8,67.95918413980141,80.03570970785606,NaN,NaN,12.71672433355702,19.79670379995341
2013-04-26T09:30:00-04:00,146.55,147.14999,146.52,146.88,3242580,7525924.2,57.008289021309515,58.56746225555548,NaN,NaN,49.236597627394055,22.60010111915685,-0.1562787795434114,0.6665322313214403,0.8228110108648518,256863931,251673496.4,72.37426387429475,79.17168276477257,NaN,NaN,12.844889358152528,18.803587451124713
2013-04-29T09:30:00-04:00,147.2,148.14999,146.91,147.86,6133285,7401394.9,61.21782211810045,58.32307352500039,NaN,NaN,102.29369410005575,55.59313743687839,-0.06788848897112831,0.7379503996509413,0.8058388886220696,262997216,255474392.2,75.21732417941786,78.49389778271897,NaN,NaN,14.214301327838042,18.147975147798046
2013-04-30T09:30:00-04:00,147.87,148.11,147.049,148.02,8067613,7521119.5,61.874189326974296,57.783526356807435,NaN,NaN,96.63209654597614,70.25072707720295,-0.00606419358827559,0.7982586466367252,0.8043228402250008,271064829,258801573,77.40902977546276,77.83018257906552,NaN,NaN,15.52511153657031,17.773280346194085
2013-05-01T09:30:00-04:00,147.56,147.81,146.58,146.7401,5374066,7406746.65,54.00089669558235,56.53646430153906,NaN,NaN,40.32117445735178,68.63177981001431,-0.056009113652285114,0.7343114481596444,0.7903205618119296,265690763,262047618,79.32966283317654,77.18986452798454,NaN,NaN,14.351848366716782,17.2845043491259
2013-05-02T09:30:00-04:00,147.12,148.05,146.91,147.96001,4343512,7247898.25,59.314866178899734,55.66427304939886,NaN,NaN,78.51937777850861,73.40058810185727,-0.013730927101498258,0.7731569029350567,0.7868878300365549,270034275,265330202.8,81.08131017645876,76.50703312791619,NaN,NaN,14.991415524554021,16.956920231329917
2013-05-03T09:30:00-04:00,149.25999,149.82001,149.2,149.36,5933480,7179201.55,64.39794232153362,56.40464546686045,NaN,NaN,194.80275599862262,102.51381977610299,0.09565820407720493,0.9064605851330612,0.8108023810558562,275967755,269150967.6,82.89794050407723,75.89440210892487,NaN,NaN,17.245192676540896,16.9981020092172
2013-05-06T09:30:00-04:00,149.36,149.60001,149.14,149.42999,3110780,7141491.5,64.63581810164675,56.717907830318204,NaN,NaN,163.88240053558948,114.83156106320973,0.15628129890603315,1.0061540046883977,0.8498727057823645,279078535,272367231.4,84.26743728840748,75.321495972237,NaN,NaN,19.086651635364067,17.296466241523895
2013-05-07T09:30:00-04:00,149.77,150.278,149.44,150.25999,5364418,7135099.7,67.41619520640671,57.733295999180434,NaN,NaN,169.70942675501462,129.4470271050174,0.2313066900854175,1.1390060683891363,0.9076993783037188,284442953,275042856.2,85.32056304691703,74.91632984265617,NaN,NaN,21.527193146552428,17.900855799385113
2013-05-08T09:30:00-04:00,150.13,150.96001,150.10001,150.94,4087947,6942119.3,69.52986143036482,59.14430969302522,NaN,NaN,174.54713598495636,156.29221941053834,0.30132700048803773,1.284358128913766,0.9830311284257283,288530900,279610883.6,86.9292430844112,75.30372683334797,NaN,NaN,24.237335608753007,18.806067200723383
2013-05-09T09:30:00-04:00,150.89999,151.37,150.39,150.84,3949581,6790822.2,68.8228335406741,60.517577617807966,NaN,NaN,159.74797530873778,172.53793891658415,0.31407444170919874,1.3756241805622267,1.061549738853028,284581319,282520292.4,87.8430327703347,76.75368545314977,NaN,NaN,26.214951002877164,19.86447917245964
2013-05-10T09:30:00-04:00,150.91,151.10001,150.28999,151.03999,4138160,6562163.8,69.49100217882213,61.877025562302684,NaN,NaN,136.76327833841935,160.93004338454352,0.30868493793963414,1.4474059112775706,1.1387209733379364,288719479,285070637.2,88.59568370108734,78.42709432132699,NaN,NaN,28.04038365561367,21.032465527195928
2013-05-13T09:30:00-04:00,150.75,151.00999,150.48399,150.86,3841438,6045177.1,68.07692167399257,62.67025903272601,NaN,NaN,114.94513996050925,151.1425912695275,0.2672570838026582,1.4727923280912592,1.205535244288601,284878041,286230538.4,88.93132153527347,80.20372742020594,NaN,NaN,29.18299606315741,22.19682703233328
2013-05-14T09:30:00-04:00,150.88,152.17,150.86,152.13,5554715,5974147.8,72.35204460565649,63.90069346681704,NaN,NaN,127.45409225453335,142.6915243694312,0.29733864780887154,1.5772085540496903,1.2798699062408188,290432756,287428499,89.28216621402231,81.9598687945103,NaN,NaN,31.507919694001767,23.526983126857353
2013-05-15T09:30:00-04:00,151.88,153.11,151.86,152.78,5770887,5724840,74.25256336615759,65.17080326900863,NaN,NaN,135.28525719577937,134.83914861159582,0.3304193579561685,1.6928941036860294,1.362474745729861,296203643,288963047.6,89.73118275802852,83.5150115529551,NaN,NaN,34.07115154530399,25.033292900921158
2013-05-16T09:30:00-04:00,152.64,153.11,152.24001,152.45,8195234,5720750.7,71.56299304581103,66.21042498504445,NaN,NaN,120.75903089914053,127.04135972967636,0.3003513262173738,1.7379139035015783,1.4375625772842044,288008409,289648465.6,89.9340306369679,84.76928060743175,NaN,NaN,35.438871408349975,26.51980411626813
2013-05-17T09:30:00-04:00,152.42,153.24001,152.21001,153.14,5503195,5694412.4,73.70748041618198,67.10254343490742,NaN,NaN,118.13636533767233,123.31597712952694,0.2966885580343215,1.8084232748271063,1.5117347167927848,293511604,290606890.6,90.2248093396721,85.8412438331642,NaN,NaN,37.25480136446744,28.053375151725174
2013-05-20T09:30:00-04:00,153.03999,153.56,152.82001,153.03999,4464793,5332053.6,72.84995321339689,67.88652656965189,NaN,NaN,117.32089614554184,123.79112836653346,0.2586753000233919,1.8350788418220247,1.5764035417986328,289046811,291440644.6,90.4823819867611,86.7750547053998,NaN,NaN,38.507373041935175,29.546803421755175
2013-05-21T09:30:00-04:00,153.28,154.02,152.89,153.50999,5735289,5097008.65,74.35968175456351,69.34072550243626,NaN,NaN,116.80895650255185,121.66210121613717,0.23691167148611547,1.8725431311562772,1.6356314596701618,294782100,292310513.4,90.75605523884042,87.59122559151865,NaN,NaN,40.00992547812092,31.04153514409314
2013-05-22T09:30:00-04:00,153.71001,155.14,152.35001,152.84,12807223,5488950.45,68.51117687018981,69.99760483752841,NaN,NaN,106.0522617728089,115.81550213154307,0.15318241306876224,1.8271094760061146,1.6739270629373524,281974877,289464760.2,82.40771541418383,87.68596882278472,NaN,NaN,39.66612514442364,32.27361942985464
2013-05-23T09:30:00-04:00,151.67,153.24001,151.55,152.77,10477551,5804787.35,67.91020138654127,70.24848048502895,NaN,NaN,69.69021414044778,105.60173877980453,0.07294435080756312,1.7651075014468063,1.6921631506392432,271497326,286162543.6,73.91142953234123,87.04407518194644,NaN,NaN,39.21746441464558,33.26559728482478
2013-05-24T09:30:00-04:00,152.16,152.82001,151.73,152.77,4535594,5869438.05,67.91020138654129,70.48236500537857,NaN,NaN,61.83529785850031,94.34152528397013,0.0034016960087819292,1.6964152706502205,1.6930135746414385,271497326,281759688,64.3806166315737,85.62358799217259,NaN,NaN,38.844638551750876,34.062603180099934
2013-05-28T09:30:00-04:00,154.21001,154.98,153.48,153.88,9382211,6031884.35,72.36783656677602,70.83605367397637,NaN,NaN,113.93571188634033,93.66448843212984,0.01503810996562338,1.7118112120984676,1.6967731021328443,280879537,280126233.2,61.226241745178655,83.90256504204842,NaN,NaN,39.74698867942793,34.87465825143251
2013-05-29T09:30:00-04:00,153.02,153.25101,152.02,152.84,7906402,6023823.8,63.47149763354132,70.40331340277469,NaN,NaN,53.58718329341902,81.02013379030328,-0.06029626063177007,1.6214027763431318,1.6816990369749019,272973135,275764440.2,53.66501834492421,81.52654898922792,NaN,NaN,37.87338563182591,35.30304787720299
2013-05-30T09:30:00-04:00,152.86,153.8,152.60001,153.10001,8234246,6166832.8,64.64179788953345,70.10466799912179,NaN,NaN,68.25773785479032,73.46122900669955,-0.10309205337856353,1.5528339702516973,1.6559260236302609,281207381,275610941,53.41501628821973,79.06740495479114,NaN,NaN,36.663231905759346,35.49735988128247
2013-05-31T09:30:00-04:00,152.61,153.73,150.89999,151.10001,7430023,6321158.35,51.08435027618701,68.78990714893357,NaN,NaN,-1.2656480973344582,59.27005655914311,-0.2672434604946399,1.321871698011961,1.5891151585066008,273777358,276066947.4,54.09912134926188,76.60336478680361,NaN,NaN,30.863220390059727,34.83533995396493
2013-06-03T09:30:00-04:00,151.53999,152.36,151.10001,152.31,10862992,6567633.95,56.964969887887236,67.9961963070689,NaN,NaN,-8.446081397722494,45.21378070789855,-0.2933899630577681,1.2223777046843907,1.5157676677421588,284640350,278695552.2,57.93396349544429,74.38926778395867,NaN,NaN,27.91021408788244,33.846036258810294
2013-06-04T09:30:00-04:00,152.25999,152.91,150.82001,151.64,7956672,6809928.55,53.15438153352915,66.6249346590598,NaN,NaN,-28.195817402492263,16.78747485013203,-0.35097489690506767,1.0770490466108242,1.428023943515892,276683678,277856380.4,56.316362677778365,72.03456753136983,NaN,NaN,24.215811205898532,32.470289822680044
2013-06-05T09:30:00-04:00,151.22,151.42999,149.2899,149.31,9430758,7013245.55,42.50567452639573,64.35729974193396,NaN,NaN,-158.60214197700105,-25.650390203951986,-0.5303835121831377,0.7650445532869696,1.2954280654701074,267252920,276712337.4,54.09867248956664,69.48938822647969,NaN,NaN,16.754662912428138,30.22520026407263
2013-06-06T09:30:00-04:00,149.38,150.27,148.31,150.25101,15158445,7566770.45,47.113789035653646,62.610928026922714,NaN,NaN,-172.95693293428235,-73.89332436176652,-0.5667868869595185,0.5869444567707092,1.1537313437302277,282411365,276953134.2,54.50476523827485,66.95872641228733,NaN,NaN,12.531918673758819,27.697588608313513
2013-06-07T09:30:00-04:00,151.16,152.44,150.7001,152.32001,8088461,7773714.45,55.549568148504356,61.31393429351717,NaN,NaN,-25.554099308791503,-78.75101460405793,-0.4383715138275752,0.6057669514457587,1.0441384652733339,290499826,280297627.8,59.8216411376515,64.78707154071442,NaN,NaN,12.170412902344875,25.479420650317994
2013-06-10T09:30:00-04:00,152.78999,152.88,151.98,152.21001,4918496,7812731.25,55.04684135983168,60.04228344683395,NaN,NaN,8.555994916620316,-75.35059934118937,-0.35144224073758257,0.6048356643513557,0.9562779050889383,285581330,280485823.8,60.10418291960589,62.61720017877476,NaN,NaN,11.726139867160775,23.514666252724105
2013-06-11T09:30:00-04:00,151.08,152.42,150.7,151.2,7012750,7971296.85,50.52538212455853,58.33983347326216,NaN,NaN,-69.87584298384378,-83.68660445745968,-0.35170815523022103,0.516642711051162,0.868350866281383,278568580,280862804.2,60.70035573833812,60.47036450016747,NaN,NaN,9.793061211780886,21.55443696116079
2013-06-12T09:30:00-04:00,152.17999,152.35001,149.7,149.86,6901816,8038651.9,45.21864507244292,56.67608120199453,NaN,NaN,-122.19911289054332,-76.40599864016812,-0.4268699612252199,0.33476341474985816,0.7616333759750781,271666764,281745573,62.12754368275482,59.021780805065404,NaN,NaN,6.312304622358327,19.37698948418901
2013-06-13T09:30:00-04:00,149.74001,151.99001,149.48,151.75999,6208422,8060528.65,52.79014359336893,55.5960770739108,NaN,NaN,-78.3406152423025,-57.482735101772164,-0.33729343938897327,0.34001657673886143,0.6773100161278347,277875186,280838337.2,59.72693875774174,58.008602892594,NaN,NaN,6.095943445068605,17.479697192886096
2013-06-14T09:30:00-04:00,151.60001,152.00999,150.39,150.66,4640219,7882777.9,48.601966659656156,54.21691745056186,NaN,NaN,-73.95054672179745,-67.16202458437334,-0.33984082959660866,0.2525089791320738,0.5923498087286825,273234967,277385365.4,51.56084972155564,57.09290525616414,NaN,NaN,4.430174350997262,15.615479644044834
2013-06-17T09:30:00-04:00,151.63,152.58,151.05,151.78,6694918,7942364.05,52.71541221655645,52.81317285411761,NaN,NaN,-15.728187806149853,-72.01886112892738,-0.25754702324057754,0.2704160296779605,0.5279630529185381,279929885,276255076.4,49.19001143927635,56.23317452002825,NaN,NaN,4.530678937191202,14.031936685922886
2013-06-18T09:30:00-04:00,151.96001,153.36,151.92,153.10001,4809133,7959581.05,57.07561980812117,52.356324438016166,NaN,NaN,58.65910063775979,-46.31187240460666,-0.11303920313624854,0.38666404899822737,0.4997032521344759,284739018,277489164,51.796191334416335,56.09968687642055,NaN,NaN,6.1467376744338695,12.905479684281598
2013-06-19T09:30:00-04:00,152.94,153.22,151.05,151.09,9145129,8130073.05,49.57861739025952,51.28038297378232,NaN,NaN,-10.698421285722764,-24.011734083642544,-0.14936864087462332,0.3129924510411968,0.4623610919158201,275593889,278274589,53.433287849929364,56.10099198797123,NaN,NaN,4.828661525388167,11.751648518725395
2013-06-20T09:30:00-04:00,149.84,149.88,147.28999,147.58,14314715,8205447.65,39.7577037958533,50.47133679661563,NaN,NaN,-237.5425190801909,-55.85211485122024,-0.3925243354743058,-0.02829432742706217,0.36423000804724365,261279174,274955386.6,46.28008163738002,55.54248915140824,NaN,NaN,-0.24133305787663242,10.038365436353676
2013-06-21T09:30:00-04:00,148.03,148.28,146.53,147.73,10968531,8229996.65,40.30193887483368,49.28112029568324,NaN,NaN,-221.1652493156347,-85.2950553699877,-0.5181008057448365,-0.283395999133802,0.23470480661103452,272247705,274757934.2,45.88654284365703,54.681959104852005,NaN,NaN,-3.7527427027769447,8.068207130763588
2013-06-24T09:30:00-04:00,146.33,147.42999,145.17,146.28,14129324,8709683.15,36.83747312301968,48.1156268377897,NaN,NaN,-222.6230099611505,-126.67401980098785,-0.6643253755880322,-0.5957019128740058,0.06862346271402645,258118381,270395633.4,38.16511105144127,53.385441131542215,NaN,NaN,-7.830022829798035,5.797031422111928
2013-06-25T09:30:00-04:00,147.41,147.8,146.62,147.3,7592801,8620212.65,40.6992516165227,47.98659662994162,NaN,NaN,-148.9067043158571,-168.18718079171123,-0.6566826791076072,-0.7522298861704826,-0.09554720706287537,265711182,266590066.2,32.95525579498174,51.87519708192901,NaN,NaN,-9.761563488633756,3.5743750062911164
2013-06-26T09:30:00-04:00,148.3,149.07001,147.97,148.78999,6328785,8541331.8,45.90248214581529,47.90007470923888,NaN,NaN,-79.25086676667632,-181.89766988790194,-0.5215092273016834,-0.7474337411899796,-0.22592451388829624,272039967,265879281.8,32.07456574830944,50.27303997550291,NaN,NaN,-9.579189472884467,1.6952943664088902
2013-06-27T09:30:00-04:00,149.69,150.42,149.55,149.89999,6585590,8458899,49.460194012739514,47.465119413827104,NaN,NaN,-18.54244005154992,-138.09765408217373,-0.33654943350083366,-0.6466113057643383,-0.3100618722635047,278625557,269348558.4,40.44084998143777,48.88869775005907,NaN,NaN,-8.238145310185677,0.27623155546680933
2013-06-28T09:30:00-04:00,149.32001,150.03,148.47,148.55,6720074,8423401.55,45.53774580323932,46.78589830264194,NaN,NaN,-52.17238492906872,-104.29908120486053,-0.2863041736608228,-0.6679420893395331,-0.38163791567871036,271905483,269280114,40.335297333797676,47.476634493929915,NaN,NaN,-8.416666156145599,-0.9656109747635346
2013-07-01T09:30:00-04:00,149.52,150.5,149.22,149.42,4896789,8125091.4,48.378944875214174,46.63258135626019,NaN,NaN,-18.63060523122499,-63.50060025887542,-0.18080219277667225,-0.6076406566495507,-0.42683846387287844,276802272,273016892.2,48.2732440953014,46.588983662284434,NaN,NaN,-7.645376529672911,-1.9198631968934454
2013-07-02T09:30:00-04:00,149.14999,150.21001,148.39999,148.92999,4874914,7971003.5,46.895049028174334,46.7523244959553,NaN,NaN,-37.52779652672041,-41.22481870104808,-0.13257753401315242,-0.592560381389319,-0.45998284737616657,271927358,274260127.4,50.62679026976668,45.767501275642424,NaN,NaN,-7.477367830421045,-2.7137924302545313
2013-07-03T09:30:00-04:00,148.42,149.98,148.25,149.53999,2599135,7629422.35,48.9924945384035,46.48106384917206,NaN,NaN,-31.61333740194976,-31.69731282810277,-0.05227896801481019,-0.5253315573946793,-0.4730525893798691,274526493,274757432.6,51.57591500168435,45.1852852930669,NaN,NaN,-6.710549706320144,-3.2847577554067615
2013-07-05T09:30:00-04:00,150.72,151.09,149.41,151.02,5528648,7147932.5,53.764000027897616,46.84978051833216,NaN,NaN,21.76605335367452,-23.635614147057893,0.0995546781878095,-0.3486092416451072,-0.4481639198329167,280055141,275043349.4,52.145496794610644,45.22704579828512,NaN,NaN,-4.575457077369119,-3.4691433728299557
2013-07-08T09:30:00-04:00,151.78,152.42999,151.67999,152.02,4920504,6989534.65,56.71061119723182,47.13515187409468,NaN,NaN,88.4407328729081,4.487009413337492,0.2574057341119855,-0.12640675219293485,-0.3838124863049203,284975645,277657381.8,57.11236614815186,45.7929282774905,NaN,NaN,-1.8725245268304258,-3.241054966258594
2013-07-09T09:30:00-04:00,152.71001,152.99001,152.22,152.78999,5200621,7003640.9,58.88345714103006,47.2642831121596,NaN,NaN,113.91086895332317,30.995304250247123,0.39548819209442293,0.11054775381310833,-0.2849404382813146,290176266,280332180.6,61.514123910167086,46.48706631861556,NaN,NaN,1.0407766357072494,-2.629364737406331
2013-07-10T09:30:00-04:00,152.77,153.28999,152.36,152.709,6127238,6959365.3,58.5505604064541,47.90513618474493,NaN,NaN,111.30673419409331,60.76221039440986,0.4587326121061015,0.2884753268513123,-0.17025728525478923,284049028,282756514.6,65.01855711839698,47.31458555207753,NaN,NaN,3.3080516099604016,-1.7811624020682264
2013-07-11T09:30:00-04:00,154.35001,154.62,153.71001,154.3801,5856973,6907123.15,63.17647223735927,49.57790535913822,NaN,NaN,147.53905257285558,96.59268838937093,0.5825233689512268,0.5578969259342443,-0.024626443016982497,289906001,285832416.2,68.88927255938202,48.92952776079197,NaN,NaN,6.738500777916647,-0.5640676620703875
2013-07-12T09:30:00-04:00,154.42,154.75999,153.89,154.17,6349891,6914196.6,62.23603695469754,51.144626650557065,NaN,NaN,131.1860744363568,118.4766926059074,0.6163926029537136,0.7458643106751595,0.1294717077214459,283556110,286532610,69.71089164893274,50.631266961168805,NaN,NaN,9.27968048221215,0.8421820728271179
2013-07-15T09:30:00-04:00,154.56,154.87,154.33,154.64,2753702,6819870.75,63.54342903331201,53.05219492986366,NaN,NaN,124.41689667092463,125.6719253655107,0.6341227970320493,0.9221252040115075,0.2880024069794582,286309812,286799443.4,70.03565850829827,52.90773463665859,NaN,NaN,11.78835675298824,2.4059213128501353
2013-07-16T09:30:00-04:00,154.60001,154.74001,153.92999,154.3,3595111,6664880.4,61.87462025967085,54.56472126151709,NaN,NaN,104.64323326841344,123.81839822852876,0.5876703056631303,1.0225902890583711,0.43491998339524085,282714701,285307130.4,65.78720318166361,55.2528737357073,NaN,NaN,13.454479460135484,3.984286762462328
2013-07-17T09:30:00-04:00,154.64,154.85001,154.17999,154.44,6506402,6749743.85,62.313509990962984,55.7369375361705,NaN,NaN,102.82334622234703,122.1217206341795,0.532717525970161,1.100816890857942,0.5680993648877811,289221103,286341545.4,67.26933306876458,57.76678568716839,NaN,NaN,14.968070398319592,5.553398710441937
2013-07-18T09:30:00-04:00,154.98,155.74001,154.56419,155.341,6825707,6633772.75,65.09816228812795,56.853935270126826,NaN,NaN,109.67694741064562,114.54929960173749,0.5226687169161817,1.2214352610330081,0.6987665441168265,296046810,287569707.2,68.98717977795428,59.80580924406242,NaN,NaN,17.06833335095538,7.198389373372429
2013-07-19T09:30:00-04:00,154.88,155.14,154.57001,155.12,4829563,6159515.15,63.851894871819816,58.16208877502543,NaN,NaN,91.75536475362279,106.6631576651907,0.46849693536547277,1.2843877133236674,0.8158907779581946,291217247,289101934.6,71.03000097499925,61.998288075576816,NaN,NaN,18.524780390453603,8.816445232955454
2013-07-22T09:30:00-04:00,155.12,155.42,154.81,155.11,3167358,5769456.5,63.79238298124149,59.26304863974167,NaN,NaN,87.78011448592218,99.3358012281902,0.4019072315439478,1.3182748173881293,0.9163675858441815,288049889,289449950,71.48936388101018,63.65658234598459,NaN,NaN,19.735902924118086,10.3763677602644
2013-07-23T09:30:00-04:00,155.57001,155.67,155.08,155.36,3394058,5232693.2,64.67870445981885,60.53330974200198,NaN,NaN,88.39286595041357,96.08572776459023,0.34670152164125323,1.349744487895748,1.0030429662544948,291443947,291195799.2,73.73899701698593,65.30745425650025,NaN,NaN,21.005478569536372,11.894812161588968
2013-07-24T09:30:00-04:00,155.61,155.7,154.61,155.10001,3895536,5047829.95,62.95283500514212,61.53047691819761,NaN,NaN,76.66412813752734,90.8538841476263,0.2681884798497798,1.3382785660667196,1.0700900862169398,287548411,290861260.8,72.55755780716751,66.80614302832048,NaN,NaN,21.69114449240536,13.294288208848453
2013-07-25T09:30:00-04:00,154.53999,155.25,154.2,155.12,5484766,5005629,63.03450902710077,62.1926561324264,NaN,NaN,63.08279199806117,81.5350530651094,0.1964390510769789,1.3156389000631634,1.1191998489861845,293033177,290258534.2,70.36999397531869,68.10789282694248,NaN,NaN,22.298682865634863,14.580630302675083
2013-07-26T09:30:00-04:00,154.48,155.25,153.67,155.16,3859958,4869347.4,63.20929194673042,62.65684761453344,NaN,NaN,52.90431055228654,73.76484222484216,0.1335194146479466,1.2860991172961178,1.1525797026481712,296893135,291393711.8,72.07749359156799,69.1768305014722,NaN,NaN,22.86548403378285,15.764180835690478
2013-07-29T09:30:00-04:00,154.86,155.14,154.45,154.92999,2593489,4663018.15,61.41116134885802,62.83739791509258,NaN,NaN,53.63794759660894,66.9364088469795,0.06189674714829385,1.2299506365835384,1.1680538894352446,294299646,292643663.2,73.86352806128914,70.05893079798092,NaN,NaN,22.95160541584181,16.790955775712096
2013-07-30T09:30:00-04:00,155.39999,155.58,154.42,154.91,4214125,4628884.95,61.24808777114737,63.0300784411421,NaN,NaN,55.258016865277476,60.30943902995227,0.0018356775082775112,1.1703484863205915,1.168512808812314,290085521,292371978,72.77392386741992,70.61288556576827,NaN,NaN,22.989498861167494,17.67646193077715
2013-07-31T09:30:00-04:00,155.12,156.03,154.56,154.84,11785926,4974435.55,60.6408323895614,62.848961309156536,NaN,NaN,61.82611507842428,57.34183641813166,-0.05102601130983353,1.1047302946750222,1.1557563059848557,278299595,290522214.8,65.6708520295212,70.38299838506393,NaN,NaN,22.886429391534268,18.420742996599596
2013-08-01T09:30:00-04:00,155.89,156.16,155.6701,155.89,4873391,5088148.35,66.07437026199274,63.123127973963335,NaN,NaN,114.40375388966802,67.60602879645303,-0.025012088549240863,1.1244911952983045,1.1495032838475454,283172986,288550176.6,59.05328501507676,69.62174076835993,NaN,NaN,24.12527193462653,19.235675702032015
2013-08-02T09:30:00-04:00,155.47,156.24001,155.23,156.2,3625316,4992981.75,67.5008508388485,63.40580096007309,NaN,NaN,121.54912175091874,81.33499103617947,0.0019077830414220287,1.151888012649323,1.149980229607901,286798302,286531210,53.148364007488006,68.41550544687348,NaN,NaN,25.577973465040305,20.14171823960463
2013-08-05T09:30:00-04:00,155.91,156.01131,155.5,155.78999,3084225,4901167.8,63.686648085101,63.53523151903238,NaN,NaN,111.49862488770812,92.90712649439931,-0.017969402692934677,1.1275184762417325,1.1454878789346672,283714077,284414096.2,47.75579332015495,67.12754759962287,NaN,NaN,25.90477243492791,20.965011696079383
2013-08-06T09:30:00-04:00,155.37,155.38,154.41,154.851,3587415,4820507.5,55.896741950721605,63.07689094472943,NaN,NaN,1.1096856206765655,82.07746024547913,-0.0998533943299953,1.0206711360221732,1.1205245303521685,280126662,282422324.4,43.30419495045297,65.41575201974346,NaN,NaN,24.05598432968071,21.406579215165287
2013-08-07T09:30:00-04:00,154.32001,154.75,154.00999,154.53799,4342570,4731274.1,53.545544508148204,62.25170396044516,NaN,NaN,-88.80748842672969,51.95073954444835,-0.17613338920635724,0.900357793844222,1.0764911830505792,275784092,281919223.8,42.233304817478,63.50476095113802,NaN,NaN,21.814003129294484,21.464782631469458
2013-08-08T09:30:00-04:00,155.33,155.45,153.9899,154.69,5073672,4692109.05,54.545494256271766,61.58696105933459,NaN,NaN,-48.17802457385818,19.434383851743114,-0.21482425045184161,0.8079608699857772,1.0227851204376188,280857764,281456179.4,41.222876008315794,61.37568059637492,NaN,NaN,20.1741028500619,21.280399805554094
2013-08-09T09:30:00-04:00,154.49001,154.95,153.33,154.11,4551574,4602193.2,50.11306057142911,60.60986660149085,NaN,NaN,-148.67923483457903,-34.61128746535644,-0.27415227224983096,0.6800947801253301,0.954247052375161,276306190,279357757,36.91282066523864,58.90592750953409,NaN,NaN,17.468481424449052,20.7358400368248
2013-08-12T09:30:00-04:00,153.45,154.3,153.35001,154.03,3698424,4649429.3,49.51537861326579,59.52677189816563,NaN,NaN,-169.29602962632666,-90.7702183681634,-0.3107715131437504,0.565782660945473,0.8765541740892234,272607766,277136494.8,32.98175809371752,55.99469615787206,NaN,NaN,15.034110927625315,19.92130730693916
2013-08-13T09:30:00-04:00,154.42,154.97,153.34,154.44,4753246,4707336.05,52.63333866333374,58.789665016607884,NaN,NaN,-109.76708169353094,-112.9455718310049,-0.2992587225793627,0.5024807708650201,0.8017394934443828,277361012,276583364.8,32.06598192350404,53.10244073761038,NaN,NaN,13.712213895818817,19.034293962493397
2013-08-14T09:30:00-04:00,154.27,154.42999,153.11,153.325,6379094,4700970.65,44.571338334234966,57.47086710997462,NaN,NaN,-184.60412388064645,-132.10489892178825,-0.35482109283404606,0.3582131274018252,0.7130342202358713,270981918,275622930,30.483268017526925,50.253388883482394,NaN,NaN,10.03390916062083,17.74852470508303
2013-08-15T09:30:00-04:00,152.10001,152.10001,150.97,151.12,10026941,4861032.35,33.60799707374696,55.35648890476151,NaN,NaN,-340.453085583139,-190.5599111236444,-0.5182647476848633,0.06520328562979216,0.5834680333146555,260954977,271642372.6,24.98010040093604,46.88928936986583,NaN,NaN,2.3410452052097415,15.547456205101133
2013-08-16T09:30:00-04:00,150.58,151.06,150.19009,150.5,7038020,4971455.2,31.278306371860495,53.204142120690264,NaN,NaN,-287.08221298534716,-218.24050675379803,-0.6384260879024819,-0.21456457656344696,0.42386151133903494,253916957,267164526,20.497228211572548,43.07741080917179,NaN,NaN,-4.6892619006301635,12.656496475710949
2013-08-19T09:30:00-04:00,150.3,150.72,149.66,149.742,4176832,5021928.9,28.662354783374752,50.876589764420785,NaN,NaN,-238.70308783193428,-232.12191839491956,-0.732511591226564,-0.49177797769417,0.24073361353239395,249740125,262590997.8,17.118230612932635,39.10200414813698,NaN,NaN,-11.395224509668497,9.220536334942457
2013-08-20T09:30:00-04:00,149.91,150.41,149.56,149.75,3847369,5044594.45,28.73010303142864,48.597251953125586,NaN,NaN,-188.98002092637282,-247.96450624148792,-0.7547672750329373,-0.7027254802587777,0.0520417947741596,253587494,257836294.2,14.451068168164099,35.44344815804005,NaN,NaN,-16.544906125656105,5.539758840571234
2013-08-21T09:30:00-04:00,149.44,149.92,148.5,148.64,9506496,5325142.45,25.159806620666473,45.67478312160228,NaN,NaN,-178.17961768712118,-246.67960500278286,-0.8004626206741629,-0.9485364810685439,-0.1480738603943811,244080998,252456110.2,12.145114526380837,32.09286455170462,NaN,NaN,-22.272163607924668,1.5666270622146765
2013-08-22T09:30:00-04:00,148.86,149.61,148.77,149.39999,4234645,5262636.4,31.44178150961963,43.09913531237165,NaN,NaN,-136.93846444002352,-205.97668077415977,-0.7372912573334436,-1.0696879320611856,-0.33239667472774204,248315643,249928243.4,11.23776946083089,29.09925065551483,NaN,NaN,-24.96099295551641,-2.223032940318336
2013-08-23T09:30:00-04:00,149.59,150.00999,149.06,149.83,9601570,5549717,34.777680525974816,41.03420905814835,NaN,NaN,-105.68063292806539,-169.6963647627034,-0.6285740139459145,-1.1181141921601352,-0.4895401782142207,257917213,250728294.6,13.441848273790697,26.64825458077453,NaN,NaN,-26.057793911216898,-5.627998793303845
2013-08-26T09:30:00-04:00,149.83,150.27,149.19,149.21001,5770145,5708549.8,32.33473653070867,39.35120867100458,NaN,NaN,-93.81784565111778,-140.7193163265401,-0.562584532543786,-1.1927708438939533,-0.6301863113501672,252147068,251209683.2,14.812532217009377,24.613135814099987,NaN,NaN,-27.745498141743962,-8.787641557366719
2013-08-27T09:30:00-04:00,148.19,148.74001,147.41,147.49899,11440168,6069851.95,26.750116181458978,37.43724950481249,NaN,NaN,-122.12881706587383,-127.3490755544403,-0.5951800040435316,-1.3741613164045816,-0.7789813123610501,240706900,248633564.4,13.57377874219101,22.566026808722345,NaN,NaN,-31.229078461028482,-11.993561115032685
2013-08-28T09:30:00-04:00,147.42,148.44,147.37,148.03999,4844949,5722803.1,30.818670284621973,35.74247636398036,NaN,NaN,-106.80694317556346,-113.07454065212876,-0.5427827147443429,-1.4574597057914787,-0.9146769910471357,245551849,248927734.6,14.453560571886712,20.653932848977405,NaN,NaN,-32.63341733380885,-14.94211200342928
2013-08-29T09:30:00-04:00,148.02,148.98,147.82001,148.25,4696254,5713946.25,32.38860094523325,34.4764435335378,NaN,NaN,-88.20945954516128,-103.32873967315632,-0.4597462589937167,-1.4893598147892817,-1.029613555795565,250248103,249314226.6,15.668199931399826,19.136459939417488,NaN,NaN,-33.23586085226959,-17.555504696120753
2013-08-30T09:30:00-04:00,148.42,148.42,147.42999,147.85001,6327762,5849068.55,30.948081452096375,33.150208022025694,NaN,NaN,-92.75002051656284,-100.7426171908558,-0.3997395957197216,-1.529288050445217,-1.1295484547254955,243920341,246514852.2,14.10594223141588,17.788187377824517,NaN,NaN,-34.169540256282424,-19.92893834757242
2013-09-03T09:30:00-04:00,148.88,149.2,147.61,148.11,5431152,5966414.9,33.03295761095812,31.750180803998862,NaN,NaN,-76.20662230669076,-97.22037252197038,-0.31428373948997335,-1.5224031290879623,-1.208119389597989,249351493,245955737.2,13.809769654352806,16.484172215742287,NaN,NaN,-34.306047595181134,-21.982811097230808
2013-09-04T09:30:00-04:00,148.02,149.41,147.82001,149.17999,4578199,6015954.1,40.936655111748244,31.490560573821238,NaN,NaN,-57.79243008050401,-84.35309512489643,-0.16494793543337805,-1.4143043088897116,-1.2493563734563335,253929692,248600295.6,22.137173210627722,15.888022586678058,NaN,NaN,-31.928566822723198,-23.40363334372972
2013-09-05T09:30:00-04:00,149.17999,149.71001,149.021,149.12,6021770,6099914.1,40.646999789289126,31.993346482074255,NaN,NaN,-38.75073170773364,-70.74185283133046,-0.05513858130376792,-1.3182796000860435,-1.2631410187822756,247907922,249071510.2,23.554447963809693,15.78619026974046,NaN,NaN,-30.110701869455575,-24.361785990261986
2013-09-06T09:30:00-04:00,149.7,149.97,147.77,149.09,9001910,6296326,40.49269729653127,32.65151726240788,NaN,NaN,-46.58821892870108,-62.417604708038425,0.02617953568940079,-1.2304165991705247,-1.2565961348599255,238906012,246803092,21.523384402284805,15.859487140505625,NaN,NaN,-28.674686887853195,-24.977914689917874
2013-09-09T09:30:00-04:00,149.5,150.78,149.48,150.47,4407438,6289119.2,49.91203466591651,34.16935153973229,NaN,NaN,13.944946052578864,-41.07861139421008,0.175300304673345,-1.0374707540182442,-1.2127710586915892,243313450,246681713.8,21.41696745066548,16.166539771772253,NaN,NaN,-24.37491681578941,-24.89177213647095
2013-09-10T09:30:00-04:00,151.47,151.82001,151.10001,151.78999,7917012,6500048.6,56.93403030326462,36.18391777343486,NaN,NaN,89.40274517820707,-7.956737897230513,0.35487206238928115,-0.7691809807049879,-1.124053043094269,251230462,247057507.6,22.69141387718345,16.75513589384506,NaN,NaN,-18.144794310682748,-23.927918161358352
2013-09-11T09:30:00-04:00,151.82001,153.17999,151.77,153.14999,7050566,6614914.6,62.73130987681061,38.867596577445156,NaN,NaN,162.91552432447943,36.184852983766184,0.5458609811569357,-0.44172681664809943,-0.9875877978050351,258281028,247927774.8,25.69671838338961,17.72310759791712,NaN,NaN,-10.636700863009489,-22.029172833022802
2013-09-12T09:30:00-04:00,153.33,153.41,152.78,153.03,5556598,6573789.8,61.939090128987054,41.04597576454283,NaN,NaN,190.20947197607956,81.97689372052882,0.6383003687027108,-0.18971233692664669,-0.8280127056293575,252724430,248891076.4,28.987433675269983,18.990940756091337,NaN,NaN,-5.059176816265276,-19.604887687771726
2013-09-13T09:30:00-04:00,153.34,153.8,153.21001,153.69,4829523,6313918.9,64.58815973633347,43.17529570813987,NaN,NaN,190.89161998642572,129.47286150355418,0.7124473178022943,0.06254644162351042,-0.6499008761787839,257553953,252620664.6,40.05642912511155,20.891982245471404,NaN,NaN,0.45372478771819297,-16.739371619844594
2013-09-16T09:30:00-04:00,155.33,155.49001,154.66,154.94,6716535,6297844.65,68.99028804578647,45.79354938778828,NaN,NaN,209.06247146271164,168.49636658558074,0.8072706253752873,0.35918740554032524,-0.448083219834962,264270488,256812072.2,49.57003886697787,23.374661291897723,NaN,NaN,6.782774593491558,-13.37906501793943
2013-09-17T09:30:00-04:00,155.02,155.50999,154.98,155.28999,4519117,6314958.9,70.11065652617296,48.89073084098214,NaN,NaN,170.66756682313675,184.74933091456668,0.8508062107388972,0.6154245435886594,-0.23538166715023773,268789605,260323900.8,55.88724440730986,26.397051696549067,NaN,NaN,12.217348663164204,-9.722434492067482
2013-09-18T09:30:00-04:00,155.16,157.06,154.64999,156.69,9665199,6605850.4,74.13612899728018,51.98483503474343,NaN,NaN,159.91867768020037,184.14996158571086,0.9249841020132081,0.9208484603662725,-0.004135641646935639,278454804,264358656,61.806822182360015,29.779427525868588,NaN,NaN,18.403537968577442,-5.704438426261064
2013-09-19T09:30:00-04:00,156.87,156.92,156.22,156.32001,7628492,6511950.2,71.39935881930735,54.77131774003444,NaN,NaN,141.60443448061034,174.428954086617,0.8994139785276696,1.1201318315126514,0.22071785298498175,270826312,267979032.4,66.19092785826359,33.388193806358736,NaN,NaN,22.469884813287123,-1.6795351063256092
2013-09-20T09:30:00-04:00,156.16,156.19,154.3,154.3,9380965,6769266.2,58.66599662428734,56.75116882376238,NaN,NaN,89.36307619219278,154.12324532777043,0.7053137919143246,1.1023600928778876,0.3970463009635629,261445347,268757311.2,67.06612170221949,37.171063768559,NaN,NaN,21.711022754880325,1.6619731595609526
2013-09-23T09:30:00-04:00,154.11,154.32001,153.32001,153.707,8663344,6722354.9,55.53487159239403,58.35844839386494,NaN,NaN,55.31552267721163,123.37385557067043,0.5052181708623409,1.028569014541489,0.5233508436791481,252782003,266459614.2,61.96615011226403,40.61080522983837,NaN,NaN,20.033995558966502,4.28654778804746
2013-09-24T09:30:00-04:00,153.74001,154.02,152.95,153.06,5774859,6722590.6,52.25770470268782,59.167094793217764,NaN,NaN,40.34410990928267,97.30916418789963,0.3072564225003067,0.9074213718045314,0.6001649493042247,247007144,262103122,53.63771013666366,42.86084358169808,NaN,NaN,17.57992012917401,6.185600979636966
2013-09-25T09:30:00-04:00,153.25999,153.39,152.19,152.42,7189586,6510061.5,49.16693732723663,59.775661760214014,NaN,NaN,19.32257117302796,69.18994288646513,0.1207560502740117,0.7511100121467393,0.6303539618727276,239817558,254375672.8,42.68004719115414,44.22695781222268,NaN,NaN,14.5603997005949,7.382000796916671
2013-09-26T09:30:00-04:00,152.7,153.53999,152.47,152.95,5028414,6519234.75,51.71387837024193,60.57717469405049,NaN,NaN,22.7953307684493,45.42812214403294,0.025607543456874993,0.6623633911938214,0.6367558477369464,244845972,249179604.8,37.17984522793497,45.345276442626265,NaN,NaN,12.879027542682259,8.16729033202604
2013-09-27T09:30:00-04:00,152.3,152.44,151.75999,152.21001,6844930,6626668.55,48.090865527738636,60.44709118418064,NaN,NaN,-6.787241996302767,26.198058506333847,-0.08840170159195115,0.5262537207470075,0.6146554223389586,238001042,244490743.8,33.04180485537414,46.17562197153403,NaN,NaN,10.322378471406024,8.47516006622318
2013-09-30T09:30:00-04:00,150.78999,151.53999,150.45,151,9427895,6781675.2,42.809451449315134,59.43819269461282,NaN,NaN,-50.99142516200083,4.936668938491347,-0.23805003194218222,0.3170928824112309,0.5551429143534131,228573147,239648972.6,29.40268973083144,46.65499881822317,NaN,NaN,6.3683966814324675,8.174193868395935
2013-10-01T09:30:00-04:00,151,151.77,150.77,151.62,8616254,6940930.3,46.077191793933096,58.24861283155015,NaN,NaN,-47.47892816418806,-12.627938676202799,-0.2848619106180895,0.1990655260808012,0.4839274366988907,237189401,237685424,28.053298032227346,46.82332593599729,NaN,NaN,4.1350727140499695,7.597176560632226
2013-10-02T09:30:00-04:00,150.89999,151.10001,150.14999,150.979,8904191,7157229.9,43.321218738298185,56.91876487507237,NaN,NaN,-79.4016240886947,-32.372777728547334,-0.34458875378266984,0.05319149447055338,0.3977802482532232,228285210,235378954.4,26.51401918151764,46.64665347215784,NaN,NaN,1.4127543323960714,6.713687670884204
2013-10-03T09:30:00-04:00,150.66,150.75999,149.16499,149.67101,10950516,7403667.2,38.28864610275314,55.04022818695949,NaN,NaN,-117.04898906947739,-60.34164169613267,-0.4510598227884059,-0.16604453023228416,0.28501529255612174,217334694,229876698.8,23.23824197971186,45.44535439034358,NaN,NaN,-2.6220119501094556,5.380016296456539
2013-10-04T09:30:00-04:00,149.67999,150.56,149.42999,150.42999,6867840,7296963.7,42.465312031398156,53.145587043074606,NaN,NaN,-112.49533955132212,-81.48326120713655,-0.4483106244355189,-0.2753729879882769,0.17293763644724197,224202534,227116997.2,21.78448398929993,43.460671899080864,NaN,NaN,-4.644361352320119,3.9479623466313023
2013-10-07T09:30:00-04:00,149.12,149.85001,148.91,149,6083484,7380766,37.337861726325514,50.80467312879979,NaN,NaN,-142.82184991825494,-99.84934615838736,-0.5159215569408824,-0.47196430972886105,0.04395724721202138,218119050,225026177.8,20.726558407926092,40.94919432769631,NaN,NaN,-8.123847113438018,2.223418138049971
2013-10-08T09:30:00-04:00,149,149.14,147.5,147.53,10388023,7504316.55,32.93536860270892,47.8617616720447,NaN,NaN,-165.25817039751564,-123.40519460505288,-0.6254660347031298,-0.7378752961668908,-0.11240926146376107,207731027,219134503,18.064376394513403,37.824733914278696,NaN,NaN,-12.633740636409208,0.10096688455580294
2013-10-09T09:30:00-04:00,147.69,148.32001,146.96001,147.78,11082480,7705912.25,34.35302607750518,45.21559504763026,NaN,NaN,-148.0223579458768,-137.1293413764893,-0.6443591983283847,-0.9178582593742419,-0.27349906104585725,218813507,217240162.4,17.29517596405867,34.332180207549776,NaN,NaN,-15.709091869501316,-2.157612937452357
2013-10-10T09:30:00-04:00,149.14,151.00999,149.09,150.96001,12792219,8067693.3,49.09383486005138,44.5318692073277,NaN,NaN,-57.745600769344485,-125.26866371646273,-0.4169884454878543,-0.7947346179056751,-0.3777461724178208,231605726,220094368.8,22.640133372866757,31.158895326881723,NaN,NaN,-13.205140807320618,-3.735831204576394
2013-10-11T09:30:00-04:00,150.92,152.22,150.75999,152.17,8186016,8235517.95,53.38314591500489,44.378174516085615,NaN,NaN,-13.497490103811101,-105.46909382696052,-0.17195506436638208,-0.5926900028757984,-0.42073493850941635,239791742,223212210.4,28.10600443410749,28.740313492727683,NaN,NaN,-9.630033861136557,-4.5778601555135605
2013-10-14T09:30:00-04:00,151.19,152.88,151.0802,152.8,6470078,8223195.1,55.486222380193,44.6087829216217,NaN,NaN,8.195943413481887,-75.26553516061315,0.034682168779753664,-0.3773822275347243,-0.41206439631447794,246261820,228840764.4,36.78889848356638,27.536826946077877,NaN,NaN,-6.1067757563607215,-4.796276669920298
2013-10-15T09:30:00-04:00,152.60001,152.8,151.34,151.34,8144668,8404472.65,49.87111379976997,44.659081241088366,NaN,NaN,-0.3862868480575712,-42.29115845072154,0.07296320996155203,-0.3208603838625379,-0.39382359382408993,238117152,234917989.4,44.57265306791467,27.6720130801322,NaN,NaN,-5.104801626588955,-4.840351663730106
2013-10-16T09:30:00-04:00,152.37,153.55901,152.24001,153.52,8714824,8356953.9,56.88681979836588,45.02857705738294,NaN,NaN,56.73655101971368,-1.339376657603519,0.2358450945682039,-0.09901722561383508,-0.334862320182039,246831976,240521683.2,50.61176458954361,28.631435891675675,NaN,NaN,-1.688013033223184,-4.390017573657688
2013-10-17T09:30:00-04:00,152.11,153.59,152.05,153.48,9925254,8471792,56.729933944826826,45.645653372889235,NaN,NaN,67.21611632294714,23.652966760854802,0.32607308402117396,0.0727290348444285,-0.25334404917674547,236906722,241581882.4,51.68435642396986,29.96304671800394,NaN,NaN,0.8373353716288721,-3.6432528671881794
2013-10-18T09:30:00-04:00,153.66,153.8,152.89461,153.60001,7715293,8388508.4,57.11209732161091,46.66727093519608,NaN,NaN,91.84674989343738,44.721814760304504,0.3755013971010377,0.21603269719955165,-0.15946869990148604,244622015,242547937,52.69253971230726,31.626607430966498,NaN,NaN,2.933722096405363,-2.703685015246245
2013-10-21T09:30:00-04:00,153.69,153.75999,153.27,153.53,3590239,8134853.15,56.79694983617273,47.432967938213196,NaN,NaN,97.32212561849767,62.54705120130766,0.3837836734844853,0.32026089195412055,-0.06352278153036472,241031776,241501928.2,51.44090197369426,33.29715056964271,NaN,NaN,4.51744196585692,-1.6720954465172213
2013-10-22T09:30:00-04:00,154.03011,154.86,153.82001,154.25,7503563,8221288.35,59.28520596006031,48.573252739767625,NaN,NaN,127.9061722800136,88.2055430269219,0.4153841125532594,0.4557073591612095,0.04032324660795013,248535339,243585565.6,53.79533753651457,35.245816166428206,NaN,NaN,6.591006864001536,-0.49165225930025613
2013-10-23T09:30:00-04:00,153.81,154.03,153.3201,153.82001,5430973,8133357.7,57.16761869314798,49.921750781938684,NaN,NaN,95.98008417666139,96.05424965831143,0.3856069573823595,0.5223319433358995,0.13672498595354,243104366,242840043.6,52.80872889522457,37.357993803250544,NaN,NaN,7.7284824840025985,0.6826527040287229
2013-10-24T09:30:00-04:00,154.19,154.95,154.095,154.8,5186375,8141255.75,60.61999935070989,51.21851416188953,NaN,NaN,125.36003100174592,107.68303259407121,0.4080232362755469,0.6467540312979736,0.23873079502242672,248290741,245116847.4,55.49330342862314,39.765766620345055,NaN,NaN,9.725576555970637,1.9744989685918535
2013-10-25T09:30:00-04:00,154.91,155.45,154.78999,155.45,4566742,8027346.35,62.76381776831396,53.03465387917442,NaN,NaN,132.6243996752769,115.83856255043911,0.439989091731269,0.788717159686513,0.348728067955244,252857483,246763941,57.38209169803467,42.38401899820996,NaN,NaN,12.045835872670162,3.413261383460183
2013-10-28T09:30:00-04:00,155.2,155.65,154.99,155.37,4971630,7804533.1,62.31418237113804,55.13314057691936,NaN,NaN,119.23689738260548,120.22151690326066,0.42867501507869754,0.884571836803616,0.4558968217249184,247885853,248134756.4,58.94373808150274,45.30397340442347,NaN,NaN,13.828473298495192,4.901148799893756
2013-10-29T09:30:00-04:00,155.71,156.5,155.62,156.5,5783908,7662915.8,66.0174126779396,57.394882476950386,NaN,NaN,130.6119100604252,120.76266445934297,0.46706935419398543,1.0397335144674003,0.5726641602734148,253669761,249161640.8,60.12255183249177,48.36307168074013,NaN,NaN,16.49391745070246,6.557258607152142
2013-10-30T09:30:00-04:00,156.73,156.87,155.37,155.87,6100193,7522715.9,62.33940827453161,58.340994863698974,NaN,NaN,111.5867895225411,123.88400552851893,0.42122363674474506,1.0991937062043462,0.6779700694596011,247569568,250054681.2,61.16679878015984,51.11497635268963,NaN,NaN,17.734078476327657,8.153947159891501
2013-10-31T09:30:00-04:00,155.61,156.18,155.1,155.29,8159868,7383183.5,59.07624534860976,58.747644823242176,NaN,NaN,88.0487420221839,116.42174773260652,0.3272120214250689,1.0869850962409373,0.7597730748158684,239409700,248278473,57.91818383364201,53.24441773837067,NaN,NaN,17.87078860833734,9.542067366812335
2013-11-01T09:30:00-04:00,155.58,156.15,155.08,155.86,5910058,7335294.4,61.22440286109194,59.157514857592105,NaN,NaN,87.55186545638283,107.40724088882772,0.28058372967590217,1.110502736910746,0.8299190072348439,245319758,246770928,55.23672281648555,54.56211947643633,NaN,NaN,18.589135955769503,10.834505736663358
2013-11-04T09:30:00-05:00,156.26,156.36,155.53,156.06,4043078,7233274.1,61.97855521232821,60.022332101346265,NaN,NaN,91.14917340394284,101.78969609309517,0.24184667658758363,1.1322273529693234,0.8903806763817398,249362836,247066324.6,55.66981069584356,55.35477359271696,NaN,NaN,19.393860982994635,12.05727077185354
2013-11-05T09:30:00-05:00,155.28,156.18,154.87,155.89,5442826,6986014.25,60.894424287719715,60.30858956487153,NaN,NaN,74.06162542044869,90.47963916509988,0.18592260623695345,1.1227839341779315,0.9368613279409781,243920010,245116374.4,52.087290611220155,55.460168308551,NaN,NaN,19.785170052206716,13.161256383332566
2013-11-06T09:30:00-05:00,156.4903,157.29,156.37,157.22,7548412,6809310.85,65.91739321590343,60.96483665566272,NaN,NaN,121.02689704356881,92.36766066930541,0.21746041911072478,1.208686851829384,0.9912264327186593,251468422,245896145.2,53.379329356922334,55.58123780376189,NaN,NaN,21.57589321458117,14.363347359225223
2013-11-07T09:30:00-05:00,157.72,157.8,155.68,155.85,10211049,6680252.35,57.69640259497508,61.0065727466173,NaN,NaN,92.11687718623706,93.18128770211605,0.12936105311612422,1.1529277491138146,1.0235666959976903,241257373,246265679.8,54.01223638887764,55.675501852088345,NaN,NaN,20.716588761200832,15.270953273793166
2013-11-08T09:30:00-05:00,155.66,157.49,155.58,157.49,7599007,6650901.9,63.55588786602052,61.48935403446358,NaN,NaN,103.89603968058815,96.45012254695712,0.1626900635909323,1.2269292754863557,1.0642392118954234,248856380,246973004.2,55.264124627362705,55.94858918449324,NaN,NaN,21.819738978411117,16.206494088738587
2013-11-11T09:30:00-05:00,157.33,157.73,157.15,157.61,3798072,6517301.6,63.94936290938407,61.82250810227242,NaN,NaN,127.25181304113171,103.67065047439489,0.17300721360893712,1.2804982289065947,1.1074910152976576,252654452,247631327.4,56.45233501832766,56.13837471890845,NaN,NaN,22.814886759109836,17.15055018450591
2013-11-12T09:30:00-05:00,157.42,157.72,156.87,157.37,4097359,6314936.15,62.49605675490016,62.203110820969,NaN,NaN,114.55993206368903,111.77031180304296,0.14499145584427153,1.288730335102997,1.1437388792587255,248557093,248558744,58.1391439788307,56.519118653451756,NaN,NaN,23.20343569231793,18.01524811419334
2013-11-13T09:30:00-05:00,156.52,158.12,156.5,158.06,5062909,6132340.4,64.9614677492779,62.513215706581,NaN,NaN,119.94809436977552,111.55455126828429,0.1534379689229195,1.335536340412375,1.1820983714894555,253620002,248989060,58.93398612670838,56.764881703314984,NaN,NaN,24.256336790804934,18.90683221085214
2013-11-14T09:30:00-05:00,158.1,158.81,157.9499,158.73,6935653,5982860.35,67.21516605997675,62.83116915598549,NaN,NaN,159.900401442352,125.11125611950729,0.18266947735700434,1.410435218185711,1.2277657408287066,260555655,252848716.4,65.29852014409727,57.33034087803374,NaN,NaN,25.81902144172201,19.89428781526212
2013-11-15T09:30:00-05:00,158.57,159.3,158.48,159.3,6530114,5923601.4,69.03965169333954,63.31155982185703,NaN,NaN,170.14843972877821,138.3617361291453,0.21659814716177417,1.4985134247809242,1.28191527761915,267085769,256494594.2,70.0244697314791,58.121821710174906,NaN,NaN,27.68032324764268,21.006578591316487
2013-11-18T09:30:00-05:00,159.71,159.95,159.07,159.44,5239871,6006083,69.48877436285912,63.559514227922705,NaN,NaN,170.69046823787892,147.04946716849474,0.22375704334666469,1.561611581802481,1.3378545384558163,272325640,260428831.8,74.12031249984895,59.12166175784328,NaN,NaN,29.339897524362655,22.197052724608795
2013-11-19T09:30:00-05:00,159.58,159.93,159.09,159.33,5017290,5881769.35,68.64616793069867,64.00999706050607,NaN,NaN,146.0657180341601,153.35062436258895,0.1972974793581661,1.584476387653524,1.3871789082953578,267308350,264179083.2,77.30386996535015,60.27430969964258,NaN,NaN,30.49633180158461,23.382664021319627
2013-11-20T09:30:00-05:00,159.55,159.88,158.35,158.77,8401131,6030277.25,64.3670546801118,64.38791201275622,NaN,NaN,110.74411757349961,151.50982900333378,0.12198594031482046,1.5396613336888834,1.417675393374063,258907219,265236526.6,78.12112949972519,61.71737724721995,NaN,NaN,30.34730325067222,24.37761248265571
2013-11-21T09:30:00-05:00,159.29,159.88,159.17,159.86,4582399,6000078.45,68.48497796500106,64.9065245201783,NaN,NaN,127.0313801558718,144.93602474603773,0.12502399971619282,1.573955393019304,1.4489313933031112,263489618,265823319.2,78.58202116112325,63.38489855755121,NaN,NaN,31.38807418459483,25.379107011504157
2013-11-22T09:30:00-05:00,159.83,160.43,159.4807,160.4,4467261,5995104.4,70.31523502313757,65.50200164952182,NaN,NaN,132.4831348549278,137.40296377126765,0.14162613935992696,1.6259640675030198,1.4843379281430928,267956879,265997541.2,78.72531913738979,65.03172058909023,NaN,NaN,32.80592035386628,26.440080346127317
2013-11-25T09:30:00-05:00,160.81,160.85,160.3,160.61,5118980,6002471.9,71.02009309810776,66.22526370740667,NaN,NaN,134.94185566780746,130.25324125725336,0.14447704644638737,1.664934236201077,1.5204571897546897,273075859,266147585,78.85652032838473,66.94380842603057,NaN,NaN,34.18429146865547,27.546396220774195
2013-11-26T09:30:00-05:00,160.54,160.97,160.46,160.5,5236551,5975104.05,70.08138873248801,66.52269195859128,NaN,NaN,119.23372565895107,124.88684278221156,0.11780855327597584,1.6677178813496596,1.5499093280736838,267839308,266253776.6,78.95543743840192,68.7706732889934,NaN,NaN,35.08227438299522,28.622950243948626
2013-11-27T09:30:00-05:00,160.79,160.94,160.41,160.85,6272842,5983736.5,71.3777082136981,67.49992807421435,NaN,NaN,109.46858500472307,124.63173626845625,0.10312349422297129,1.6788136958523978,1.5756902016294265,274112150,269294762.8,81.60889288034497,70.74186303838391,NaN,NaN,36.20390530462279,29.705943824044937
2013-11-29T09:30:00-05:00,161.11,161.58,160.58,160.72,2887856,5720135.9,70.16171595504123,67.97177293771583,NaN,NaN,108.68266246420502,120.96199273012289,0.06585171664299971,1.658004847433176,1.5921531307901764,271224294,270841698,82.79716082479575,72.7085084810577,NaN,NaN,36.83830189604244,30.72485212004458
2013-12-02T09:30:00-05:00,160.76,160.84,159.71,159.92,5658529,5707559.45,63.04396117749805,67.90710138543825,NaN,NaN,68.50425282287783,108.16621632371289,-0.02653105450331994,1.5589893126610264,1.5855203671643463,265565765,270363475.2,81.05366070687823,74.46574603023988,NaN,NaN,35.46131566353646,31.40148976911485
2013-12-03T09:30:00-05:00,159.23,159.62,158.46,158.99,8662619,5938536.5,55.93938534096258,67.43876771301414,NaN,NaN,12.095843962008477,83.5970139825531,-0.15684929787725865,1.389458744817773,1.5463080426950317,256903146,267128932.6,70.274787611295,75.33257771827304,NaN,NaN,32.11920922237472,31.504021119580546
2013-12-04T09:30:00-05:00,158.46,159.52,157.83,158.76,7140816,6023436,54.30934337962945,66.67790168661068,NaN,NaN,-13.11657891753396,57.12695306725609,-0.2590834067033374,1.22245378431586,1.4815371910191975,249762330,263513537,60.57770349076431,75.4499861014199,NaN,NaN,28.85724483985178,31.12591022247644
2013-12-05T09:30:00-05:00,158.45,158.89,158.01,158.12,5829475,5937489.15,49.947854647084284,65.44452229997549,NaN,NaN,-40.818998270008755,27.06943641230972,-0.36393038183056015,1.0266242137309973,1.3905545955615575,243932855,257477678,48.53631949284267,74.25268605490172,NaN,NaN,24.707527822560923,30.208998451059937
2013-12-06T09:30:00-05:00,159.53,160.18,159.13,160.16,6346575,5744265.45,60.76414233595334,64.85341448873363,NaN,NaN,44.08330072018632,14.149564063505983,-0.29305798926104965,1.0242321089852453,1.317290098246295,250279430,253288705.2,42.25822321325407,72.26938273217135,NaN,NaN,24.173095341796834,29.346726578308065
2013-12-09T09:30:00-05:00,160.29,160.53,160.11,160.23,3975579,5563094.05,61.07498234085223,64.25242934430456,NaN,NaN,69.38610880085596,14.325935259101607,-0.24081620848239038,1.016269837643307,1.2570860461256974,254255009,251026554,39.30176365276699,69.78234352880835,NaN,NaN,23.85237906501344,28.561819790694546
2013-12-10T09:30:00-05:00,159.77,160.19,159.64,159.72,4047640,5575572.45,57.50073988503757,63.45632734104306,NaN,NaN,31.686782135009164,18.244122893701746,-0.239455710876181,0.957766407530471,1.197222118406652,250207369,249687398.6,37.62367109914256,66.94804360979353,NaN,NaN,22.47664070318732,27.692508492479227
2013-12-11T09:30:00-05:00,159.84,159.9,158.23,158.31,7906687,5766038.85,48.96836576992169,62.35642099031519,NaN,NaN,-64.57607329170926,7.952224018866685,-0.3269480647947449,0.7885370374132208,1.1154851022079657,242300682,248195069,35.78974860215372,63.924373545681284,NaN,NaN,18.377217984865613,26.361752705677283
2013-12-12T09:30:00-05:00,158.21,158.43,157.075,157.47,7078711,5866828.95,44.71176313786701,60.65833421694847,NaN,NaN,-169.60668052430907,-17.80531243199338,-0.4284239217660537,0.5799552000003985,1.0083791217664522,235221971,246452892.2,33.7231322079041,60.720167191879916,NaN,NaN,13.50885067404898,24.525623844016096
2013-12-13T09:30:00-05:00,157.54,157.97,157.1,157.65,8886480,5964370.3,45.799020939609754,58.90717606812506,NaN,NaN,-162.93402538317875,-59.20877765266639,-0.4672743535690298,0.4242861798051649,0.8915605333741947,244108451,245218696.4,32.300203936175805,57.404087534650344,NaN,NaN,9.99507669463595,22.449831394104645
2013-12-16T09:30:00-05:00,158.37,159.37,158.25,158.9,7080032,5991866.2,52.748295389734274,57.602047660384095,NaN,NaN,-53.96555811834382,-83.87911103650634,-0.39548586524361296,0.3972032018196785,0.7926890670632915,251188483,244605391.2,31.586956608549556,54.0276901260907,NaN,NaN,9.171916058283111,20.55298634613014
2013-12-17T09:30:00-05:00,159.27,159.29,158.39,158.78,6004477,6030096.5,52.058249757389625,56.314680590734206,NaN,NaN,-50.73988424570544,-100.36444431264927,-0.3446431235414127,0.3618851626365256,0.7065282861779383,245184006,243600718.6,30.40261123102256,50.55963111127788,NaN,NaN,8.308157568536803,18.803725092188234
2013-12-18T09:30:00-05:00,159.16,161.79,158.11,161.76,15336510,6546057.5,64.48379886295146,55.8222584942523,NaN,NaN,79.5930663445154,-71.53061638540433,-0.11097376134233305,0.5678110845000219,0.678784845842355,260520516,247244685.4,39.29341321495998,47.53709684946466,NaN,NaN,12.103057211513987,17.846486823520486
2013-12-19T09:30:00-05:00,161.48,162.01,161.28,161.88,8020368,6527019.35,64.87855037593573,55.444889524316196,NaN,NaN,148.17663304098204,-7.97395367234611,0.04277286368842659,0.7322509254528882,0.6894780617644616,268540884,253908468,51.4961062855014,45.301307239515076,NaN,NaN,15.094286662503617,17.453315371946648
2013-12-20T09:30:00-05:00,161.62,162.53,161.61,162.01,7978604,6696829.6,65.32814505533266,55.60804551559009,NaN,NaN,147.69473876302516,54.151799156894675,0.13890650191423204,0.8631111891572516,0.7242046872430196,276519488,260390675.4,59.933175013277335,43.792701118543576,NaN,NaN,17.56616777752921,17.469437144172726
2013-12-23T09:30:00-05:00,162.57,162.85,162.33,162.62,4992829,6723108,67.43470996981483,56.42914013193668,NaN,NaN,158.29139620256132,96.6031900210757,0.22420583460733257,1.0044619805021853,0.7802561458948527,281512317,266455442.2,65.90821237094475,43.48080288709,NaN,NaN,20.287773599621623,17.87205663780828
2013-12-24T09:30:00-05:00,162.72,163.26,162.5898,163.16,2461988,6590258.4,69.2176942930735,57.49402234003983,NaN,NaN,158.05613013072036,138.36239289636086,0.2932646556011722,1.146836965396318,0.8535723097951458,283974305,274213502,71.71832468874587,44.27656154408868,NaN,NaN,23.10361797591668,18.619422543252337
2013-12-26T09:30:00-05:00,163.6,164.49,163.58,164.46,4971613,6577011.5,73.04402030911425,59.14374845875626,NaN,NaN,184.45103521204402,159.3339866698666,0.39635707601211867,1.349018654810294,0.9526615787981754,288945918,279898582.4,75.07111082471802,46.17190378207978,NaN,NaN,26.85913193201025,19.79652388450347
2013-12-27T09:30:00-05:00,164.76,164.92,164.22,164.47,6177212,6572230,73.07174905964509,60.02286322473424,NaN,NaN,167.09209994885086,163.11708005144035,0.43214865789140844,1.492847401162436,1.0606987432710275,295123130,285215031.6,77.72994772399694,48.70559838998998,NaN,NaN,29.81841508951149,21.228222628076043
2013-12-30T09:30:00-05:00,164.55,164.68,164.4,164.59,4043646,6630019.5,73.4250249301692,60.90500912397117,NaN,NaN,142.18615419177948,162.0153631371912,0.4299161129620115,1.598093884473542,1.1681777715115305,299166776,289744489.2,79.71500436169987,51.592258440628044,NaN,NaN,32.32505056503972,22.813483761927998
2013-12-31T09:30:00-05:00,164.94,165.51,164.81,165.47,5669786,6630582.35,75.91990740061846,62.22066394651266,NaN,NaN,138.53755715340714,158.06459532736037,0.4514893744098514,1.7325394895238446,1.2810501151139932,304836562,294409338.2,81.53999084891115,54.729138422754374,NaN,NaN,35.287238393508254,24.595448709296605
2014-01-02T09:30:00-05:00,164.79,165.01,163.84,164.11,9294896,6662196.2,65.66049887727908,63.41295916846676,NaN,NaN,95.91176845524602,145.6357229922655,0.3428721455238519,1.709640297018808,1.3667681514949561,295541666,296722810.4,82.38633285711808,58.057465869537545,NaN,NaN,34.73081886751383,26.043358731899065
2014-01-03T09:30:00-05:00,164.4,164.87,164.04,164.39,6127622,6611536.5,66.65944772356627,64.98065092458813,NaN,NaN,88.84974828542894,126.51546560694251,0.26222742781063424,1.694552436258249,1.4323250084476147,301669288,299267484.4,83.29362819419747,61.59821558284421,NaN,NaN,34.58092915941432,27.26301165011553
2014-01-06T09:30:00-05:00,164.99,165.06,163.71,163.89,7447532,6692439.35,63.12788315482607,66.21842679710359,NaN,NaN,75.40435862449672,108.17791734207167,0.15296742041559108,1.6235342839671034,1.4705668635515123,294221756,299087209.6,82.96757022530235,65.21731317492468,NaN,NaN,33.39341933899792,28.138784177098728
2014-01-07T09:30:00-05:00,164.66,165.29,164.52,164.97,5390671,6644644.15,67.1733648677708,67.24878890267762,NaN,NaN,87.1545989645578,97.17160629662735,0.13198275908819035,1.6355453124117503,1.50356255332356,299612427,299176339.8,83.00299686296634,68.88988747881159,NaN,NaN,33.590770517800074,28.91763936862749
2014-01-08T09:30:00-05:00,164.7,164.83,163.91,164.35,9464213,6919075.85,62.90639490811393,68.02365641344363,NaN,NaN,64.78715778384799,82.42152642271552,0.05863658122526805,1.576858279855145,1.5182216986298769,290148214,296238670.2,77.29642258722038,72.23944543282572,NaN,NaN,32.43583992375856,29.42023944793193
2014-01-09T09:30:00-05:00,164.95,164.99,163.52,164.19,8218113,7127599.5,61.81512986330415,67.83303719918311,NaN,NaN,55.96479994282056,74.4321327202304,-0.014461372222039026,1.5001449833523282,1.5146063555743672,281930101,293516357.2,72.3334628769058,74.59944898010757,NaN,NaN,31.17751531089345,29.671278856926435
2014-01-10T09:30:00-05:00,164.56,164.69,163.52,164.18,7497166,7107123.45,61.74303768629312,67.60907200706579,NaN,NaN,48.658035956068545,66.39379025435832,-0.07396621794101343,1.4221485831481004,1.4961148010891139,274432935,288069086.6,63.54188147777787,75.45986149384159,NaN,NaN,30.13525744215666,29.737561511959324
2014-01-13T09:30:00-05:00,163.9,164.28,162.14,162.24,10678092,7287092.5,49.64633601871722,66.48894279016469,NaN,NaN,0.9766669160895871,51.5082519126769,-0.2448313319340345,1.1900756361715707,1.4349069681056053,263754843,281975704,55.42649279761865,75.13795562129455,NaN,NaN,25.232578108547415,29.09399245432905
2014-01-14T09:30:00-05:00,162.74,163.47,162.37,163.45,7340947,7209815.85,55.50213876173625,65.63661627530193,NaN,NaN,-1.819266163611525,33.713478887043024,-0.2749542119021591,1.0912142032279064,1.3661684151300655,271095790,276272376.6,49.104872835886354,73.9377170830761,NaN,NaN,22.87020164961864,28.204879482227565
2014-01-15T09:30:00-05:00,163.66,164.8,163.59,164.57,7783346,7244981.55,60.12464264991819,64.98711258650512,NaN,NaN,48.29688595992913,30.41542452225925,-0.22040040854717802,1.090667904446093,1.311068312993271,278879136,274018561,46.831733888192524,72.16010345446514,NaN,NaN,22.40806962288499,27.376763788035767
2014-01-16T09:30:00-05:00,164.22,164.33,163.52,163.98,5175923,7203553.85,56.77852704074912,63.82529163876476,NaN,NaN,18.89740495853741,23.001945525402625,-0.2242585690777219,1.0307451016461187,1.2550036707238406,273703213,272373183.4,45.18717851622872,70.02553686100161,NaN,NaN,20.937838736228446,26.456917352063293
2014-01-17T09:30:00-05:00,163.79,164.59,163.6141,164.08,8014189,6837437.8,57.21316858135906,62.69253589031576,NaN,NaN,21.704686395476184,17.61127561328415,-0.21998064711762266,0.9800278618268123,1.200008508944435,281717402,273830076.8,46.96313763953234,67.82790756925415,NaN,NaN,19.9101922541708,25.521670909507222
2014-01-21T09:30:00-05:00,165.03,165.05,162.79,163.73,9427040,6907771.4,55.12376067207887,61.38530272902359,NaN,NaN,-10.068411549420262,15.402259920182178,-0.23904401033824985,0.9012034960216226,1.1402475063598725,272290362,275537180.6,49.04639331939892,65.63729249480407,NaN,NaN,18.440515387792423,24.510077263547966
2014-01-22T09:30:00-05:00,163.76,163.8,162.99,163.47,5422212,6779951.8,53.558993844761005,59.78809461789092,NaN,NaN,-74.97419521774698,0.7712741093550874,-0.2654494865167769,0.8084356482139015,1.0738851347306784,266868150,274691652.6,48.039880256664944,63.244427452500766,NaN,NaN,16.773617617968927,23.40486874275096
2014-01-23T09:30:00-05:00,162.43,162.43,161.07,161.71,9960581,7028339.4,44.37602356381379,58.26777495264339,NaN,NaN,-253.53526118326448,-59.59515531928364,-0.39019412081449156,0.5861424837125639,0.9763366045270555,256907569,270297339.2,43.09059437469965,60.43758898947088,NaN,NaN,12.244205285288105,21.810488248827696
2014-01-24T09:30:00-05:00,160.71,160.89,158.48,158.48,14729645,7641722.25,33.14453658121468,55.87385272818971,NaN,NaN,-352.37124371582365,-133.84888505415583,-0.6629591488971014,0.14763766840567882,0.8105968173027802,242177924,263992281.4,37.1729321612442,57.14325355854565,NaN,NaN,3.4318740422064598,19.184971933596092
2014-01-27T09:30:00-05:00,158.705,159.11,157.51,158.02,14277728,8107028,31.90602089179565,53.64371970940182,NaN,NaN,-285.77292454347116,-195.3444072419453,-0.835915751899506,-0.23429787257160228,0.6016178793279037,227900196,253228840.2,29.67963443970612,53.336972431003055,NaN,NaN,-3.7326841271029645,15.911021067781942
2014-01-28T09:30:00-05:00,158.47,159.17,158.28,158.94,8324974,8214416.1,36.978205000744055,51.48692257604277,NaN,NaN,-193.14475283981588,-231.95967550002442,-0.8472740995901857,-0.45747474515982844,0.38979935443035724,236225170,246015801.8,25.91025663740824,49.25891955774891,NaN,NaN,-7.750961062507581,12.53073790631201
2014-01-29T09:30:00-05:00,157.66,158.2484,156.75,157.1,14286066,8726537.1,31.865794420466017,49.26973682692506,NaN,NaN,-193.98483529526476,-255.761803515528,-0.9309560112530378,-0.7738956596359401,0.15706035161709775,221939104,237029992.6,22.138208499583726,45.319047122917716,NaN,NaN,-13.0644748941492,8.874278934817552
2014-01-30T09:30:00-05:00,158.3,158.77,157.37,158.17,7872804,8836688,37.29495884281188,47.51829603974704,NaN,NaN,-136.4177040003024,-232.33829207893555,-0.8677509488141539,-0.9276283344005947,-0.059877385586440734,229811908,231610860.4,20.225849115578598,41.59707471139434,NaN,NaN,-15.405799031782433,5.405696368160411
2014-01-31T09:30:00-05:00,156.23,157.7,155.85,156.75,10694614,8906673.9,33.48195016525584,45.499646931101516,NaN,NaN,-145.38044726008994,-190.94013278778883,-0.872721493461977,-1.150779252413912,-0.27805775895193496,219117294,226998734.4,18.74197045980057,38.397081067253104,NaN,NaN,-18.69413222590711,1.962863711865051
2014-02-03T09:30:00-05:00,156.57,156.76,153.25,153.53,18182252,9509405.4,26.792590114793427,43.867236509392676,NaN,NaN,-167.54472668937564,-167.2944932169697,-1.033045309741655,-1.5693643961290036,-0.5363190863873486,200935042,221605703.6,17.156905702995388,35.663539131922875,NaN,NaN,-24.280341973066022,-1.7861656716965308
2014-02-04T09:30:00-05:00,153.95,154.53,153.26,154.08,11860265,9730042.05,29.38764198034049,42.00191531072154,NaN,NaN,-149.7466389129344,-158.6148704315934,-1.0393899957982078,-1.8355565811351084,-0.7961665853369007,212795307,216919731,15.898718111959951,33.2916709373567,NaN,NaN,-27.52177458061622,-5.462681230113629
2014-02-05T09:30:00-05:00,153.72,154.515,153.12,154.18,11610345,10041025.75,29.874373809058326,39.8411818220887,NaN,NaN,-129.5799460085593,-145.73389257425234,-0.9752399158457064,-2.0152164801440335,-1.0399765642983272,224405652,217413040.6,16.592172258768883,31.13170224954072,NaN,NaN,-29.805396130975737,-8.940211930236787
2014-02-06T09:30:00-05:00,154.7,156.15,154.7,156.14,10429613,10089295.75,38.78140807996071,38.55567332488953,NaN,NaN,-85.89553833191687,-135.6294594405752,-0.7493443117235878,-1.976656953952812,-1.2273126422292242,234835265,218417712,18.073759789512295,29.19502948334669,NaN,NaN,-28.66893571475745,-11.758601042311167
2014-02-07T09:30:00-05:00,156.56,157.8,156.05,157.78,12546840,10305732.1,45.06850622757313,37.688197442476245,NaN,NaN,-50.68793484961403,-116.69095695848004,-0.4526253125848241,-1.7930942829602543,-1.3404689703754302,247382105,224070674.2,26.0350457244337,27.70016577512536,NaN,NaN,-25.500588694425723,-13.72174213547039
2014-02-10T09:30:00-05:00,157.76,157.82,157.13,157.75,4792911,10170519.35,44.977509787845705,36.96346523645959,NaN,NaN,-39.12656540262662,-91.00732470113023,-0.23261395569794208,-1.6312364149978578,-1.3986224592999157,242589194,232401504.6,35.9181254772176,26.762432357826697,NaN,NaN,-23.109500343854474,-15.06285045095383
2014-02-11T09:30:00-05:00,158.06,160.09,157.94,159.76,7623678,10017798.65,51.97409714540365,36.85025832936264,NaN,NaN,0.1766750264811446,-61.02266191324712,0.058503386665905044,-1.3254932259675343,-1.3839966126334393,250212872,239885017.6,43.25327568418043,26.42053203122066,NaN,NaN,-18.63488443491037,-15.573141020090478
2014-02-12T09:30:00-05:00,160,160.45,159.34,159.71,5256778,9913590.2,51.7976499718422,37.38037450136467,NaN,NaN,17.693934626658194,-31.567885786203636,0.24733000252294945,-1.0748341094797524,-1.322164112002702,244956094,243995106,46.8515536293357,26.689171977980383,NaN,NaN,-15.218135649795048,-15.52242596719113
2014-02-13T09:30:00-05:00,158.66,160.47,158.61,160.29,5094547,9779150.25,53.75875105819711,38.8528183925777,NaN,NaN,24.229542389247623,-9.542869641970748,0.4017855825814698,-0.8199321337758647,-1.2217177163573345,250050641,247038181.2,49.409374709916065,27.5632035885998,NaN,NaN,-11.811989880995005,-14.992363669163113
2014-02-14T09:30:00-05:00,160.08,161.83,159.9,161.59,5992559,9819982.05,57.8937757687717,40.70908659807599,NaN,NaN,66.34728082309007,13.864173492570085,0.5716342138798056,-0.5071749490075774,-1.078809162887383,256043200,248770400.2,50.859138184140754,29.076025284630845,NaN,NaN,-7.575234265532191,-13.932773754358696
2014-02-18T09:30:00-05:00,161.7,161.76,161.13,161.41,4967903,9667667.75,57.131974617928634,42.14864157073203,NaN,NaN,83.80672422934855,38.45083141896512,0.6464741531148105,-0.2707164714938699,-0.9171906246086804,251075297,250467620.8,52.301428408814694,30.961108982588453,NaN,NaN,-4.3802212359369666,-12.568123394584163
2014-02-19T09:30:00-05:00,161.02,162.34,160.38,160.52,8247850,9608708.25,53.391038412152284,43.68615899870962,NaN,NaN,82.55107591480774,54.925711596630435,0.6110572648331536,-0.15336904356723835,-0.7644263084003919,242827447,248990535.8,50.901228539942856,33.015610414042676,NaN,NaN,-2.729787180658288,-11.162646792594753
2014-02-20T09:30:00-05:00,160.56,161.72,160.1,161.31,7036272,9689411.25,56.13656393317947,45.03198793373588,NaN,NaN,90.18173710927731,69.42327209315427,0.6142110970040593,0.003337562854682119,-0.6108735341493772,249863719,249972060.8,51.824195218581146,35.27263513568572,NaN,NaN,-0.5203367010939955,-9.642316779523217
2014-02-21T09:30:00-05:00,161.08,161.62,160.62,160.81,5268349,9454799.65,53.96969032382855,46.4953979450625,NaN,NaN,92.14812907219259,83.00698942974324,0.5576502827647462,0.08618931930655549,-0.47146096345819066,244595370,248881006.6,50.68364893459465,37.554183598171,NaN,NaN,0.7177047802932088,-8.162313699549442
2014-02-24T09:30:00-05:00,161.02,162.69,160.97,161.66,6713649,9053999.85,57.007849527873475,48.65363076028251,NaN,NaN,106.81009523839856,91.09955231280495,0.5515093447235633,0.21792571744626343,-0.33358362727729984,251309019,247934170.4,49.66219342332391,39.87598986390875,NaN,NaN,2.660846592885429,-6.616147943487317
2014-02-25T09:30:00-05:00,161.74,162.24,161.13,161.5,6080083,8644117.6,56.255161946436886,50.57273932928939,NaN,NaN,90.83797009228698,92.50580148539264,0.5115796845962397,0.30589097846799973,-0.20568870612823992,245228936,246764898.2,48.36586223364549,42.19507158688629,NaN,NaN,4.059235420020856,-5.091093177271864
2014-02-26T09:30:00-05:00,161.71,162.258,161.27,161.84,5033018,8479519.8,57.538150026003024,52.54872334478545,NaN,NaN,86.11521517500755,93.21862933743259,0.4833079251518805,0.3984462003116107,-0.08486172484026977,250261954,248251799.6,50.14793112516125,44.59191150591432,NaN,NaN,5.5902560500609875,-3.5651861447957423
2014-02-27T09:30:00-05:00,161.64,162.56,161.37,162.55,5293496,8029891.3,60.16550775873071,54.076159036126164,NaN,NaN,87.79981823756727,92.74224556309059,0.4863361434394421,0.5230584544590329,0.03672231101959077,255555450,249390145.8,51.5272420172705,46.981445950754186,NaN,NaN,7.648795273110132,-1.9631887993806174
2014-02-28T09:30:00-05:00,162.56,163.77,162.01,163.02,10013066,8136904.4,61.84840348095488,55.27472312565343,NaN,NaN,99.15367267043942,94.14335428273996,0.49239913941869196,0.6522212352929557,0.15982209587426377,265568516,253584775,56.32278526868109,49.144855918200435,NaN,NaN,9.874878696120081,-0.27203630002337476
2014-03-03T09:30:00-05:00,161.59,162.19,160.49,161.49,9155071,8059927.25,53.869885478317514,55.909892817829984,NaN,NaN,53.620170568714336,83.50536934880313,0.37128883811765084,0.6239331435213273,0.2526443054036765,256413445,254605660.2,57.4267244869839,50.68118441889802,NaN,NaN,9.637564022642996,1.1436208889289639
2014-03-04T09:30:00-05:00,163.13,164,163.05,163.63,7954245,7548526.9,61.375172632392,56.58139820975772,NaN,NaN,110.55616245184801,87.44900782071531,0.4101821638017449,0.7653720101558577,0.35518984635411277,264367690,258433411,61.36925235029817,51.97518275219215,NaN,NaN,11.799003899851144,2.6658184619178464
2014-03-05T09:30:00-05:00,163.78,163.82,163.21,163.35,4968798,7203953.55,59.99967260831137,57.16725696950552,NaN,NaN,105.74468627183293,91.3749020400804,0.39195017613282807,0.8451275665201479,0.4531773903873198,259398892,260260798.6,63.1249202757115,53.137566084076134,NaN,NaN,13.119715448344152,4.159232317121605
2014-03-06T09:30:00-05:00,163.82,164.3075,163.76,164.09,4658263,6856349.45,62.39814912210748,57.78435683121341,NaN,NaN,131.89557368526923,100.19405312962078,0.40306958303528206,0.9570143691814224,0.5539447861461403,264057155,261961139.6,64.73108964906817,54.23197429401557,NaN,NaN,14.956497340889804,5.70169874908849
2014-03-07T09:30:00-05:00,164.76,164.89,163.81,164.34,7383168,6704027.2,63.20093853961507,58.16343988627365,NaN,NaN,144.21265714767728,109.20585002506837,0.3998136453572608,1.0537118428427164,0.6538981974854555,271440323,263135501,65.83785098683757,55.30188235135105,NaN,NaN,16.693774873239096,7.271995338252863
2014-03-10T09:30:00-04:00,164.05,164.16,163.18,163.99,3999765,6276673.45,61.230016211121765,58.4561571429303,NaN,NaN,109.04263557693939,120.29034302671337,0.34851634736383363,1.0895436316902476,0.741027284326414,267440558,265340923.6,67.87657534774874,56.4143928469892,NaN,NaN,17.592505214309583,8.74635389197525
2014-03-11T09:30:00-04:00,164.28,164.49,163.11,163.42,5221300,6298092.9,58.05478400959222,58.78928182846172,NaN,NaN,92.96615649341368,116.77234183502651,0.2549625192729933,1.0597304334176556,0.8047679141446623,262219258,264911237.2,67.03716667702417,57.56695985678073,NaN,NaN,17.471623108908233,9.992820922965675
2014-03-12T09:30:00-04:00,162.66,163.57,162.47,163.23,5258033,6179810.65,56.99381602085506,58.85051412043855,NaN,NaN,53.60346955439714,106.34409849153936,0.1634969641166435,1.0091391192904666,0.8456421551738231,256961225,264423703.8,66.03925264922506,58.58232110182672,NaN,NaN,17.081324359992756,11.005464271112402
2014-03-13T09:30:00-04:00,163.74,164.03,160.78,161.05,9500549,6391999.2,46.49464955229658,58.31658263675769,NaN,NaN,-18.35079446353626,76.29482486177827,-0.04923472013034824,0.7840987550108878,0.833333475141236,247460676,261104408,59.540686003828455,59.214966606771995,NaN,NaN,13.43859552376622,11.353054450062947
2014-03-14T09:30:00-04:00,160.73,161.6,160.38,160.65,8603585,6567451.1,44.86163387770229,57.4489958046026,NaN,NaN,-91.35732680107834,29.180828072027133,-0.21311426088360985,0.5669406490367237,0.7800549099203336,238857091,254587761.6,49.28640035561392,59.18812424479271,NaN,NaN,9.944751292527966,11.151868284700807
2014-03-17T09:30:00-04:00,161.4,162.67,161.33,162.37,6642966,6599971.45,52.57505968698148,57.186131357498645,NaN,NaN,-15.580915414085418,4.2561178738221725,-0.20200421039131344,0.5275496469311918,0.7295538573225052,245500057,250199661.4,43.81440681190796,58.863020286097175,NaN,NaN,9.200360097316281,10.873081400788733
2014-03-18T09:30:00-04:00,162.69,163.64,162.55,163.28,7094550,6706303.8,56.076061363909055,57.081696453063365,NaN,NaN,47.261646529260155,-4.884784119008536,-0.13302838065889488,0.5632683814988866,0.6962967621577815,252594607,248274731.2,41.63088634645593,58.25465994476108,NaN,NaN,9.688226339670297,10.703816392057528
2014-03-19T09:30:00-04:00,163.26,163.5672,161.15,162.19,7936416,6690732.1,51.20044987508638,56.44133517566019,NaN,NaN,-14.215073084214536,-18.448492646730873,-0.158731357563905,0.4978825652029002,0.6566139227668052,244658191,245814124.4,38.95818194367046,57.35686993950393,NaN,NaN,8.534205405733108,10.393871965439754
2014-03-20T09:30:00-04:00,161.85,163.47,161.4831,163.3,6616236,6669730.3,55.44854868584075,55.9842026902949,NaN,NaN,12.035756796829283,-12.37118239465777,-0.1016691424435947,0.5295274947123119,0.6311966371559066,251274427,246576874.6,40.238972513190014,56.20802617125457,NaN,NaN,8.92774953608883,10.184425904103907
2014-03-21T09:30:00-04:00,163.47,164.2,162.53,162.63,7629525,6787789.1,52.47893269783163,55.88484892026019,NaN,NaN,34.21792091750495,12.743867149058888,-0.10908632105176586,0.4948387358411992,0.603925056892965,243644902,247534436.8,41.88747554470276,55.098079818234496,NaN,NaN,8.311497659490769,9.91686472630203
2014-03-24T09:30:00-04:00,163.13,163.46,161.78,162.44,6339916,6769102.45,51.634407161613765,55.18907995806175,NaN,NaN,-14.882650137758793,12.883520204324213,-0.12564800529253528,0.44686505027729595,0.5725130555698312,237304986,245895422.6,39.860649523850064,53.56175104491677,NaN,NaN,7.562623188173285,9.580544506569353
2014-03-25T09:30:00-04:00,163.37,163.72,162.57,163.39,5991113,6764653.95,55.49121677997022,54.86704739889451,NaN,NaN,36.92981074784397,10.817153048040979,-0.07403458367830562,0.47996982597194915,0.5540044096502548,243296099,244035721,37.635422566964166,51.74107263714911,NaN,NaN,8.084588247180912,9.366836469513862
2014-03-26T09:30:00-04:00,164.07,164.33,162.32,162.33,6134692,6819737.65,50.63896375575789,54.02710558701239,NaN,NaN,11.428348280779218,15.945837321039727,-0.11050075181524954,0.4158784698811928,0.5263792216964424,237161407,242536364.2,35.89555181460318,49.681391363258754,NaN,NaN,7.03952705997459,9.034363696722536
2014-03-27T09:30:00-04:00,162.25,162.68,161.54,162.28,7713680,6940746.85,50.4150256468488,53.11382609467195,NaN,NaN,-68.68195831528801,-0.19770570138373386,-0.13555418961058008,0.35693648468321726,0.49249067429379734,229447727,238171024.2,31.35119837349326,47.218059033734164,NaN,NaN,6.135885666592091,8.620295406703901
2014-03-28T09:30:00-04:00,162.61,163.82,162.32,162.85,4535956,6666891.35,52.96844457311078,52.523713834814025,NaN,NaN,11.376962880813643,-4.7658973087219945,-0.11226509953616493,0.3521592998735912,0.4644243994097561,233983683,236238780.4,29.566906542901705,44.48165411910223,NaN,NaN,6.101471845794379,8.260463469431112
2014-03-31T09:30:00-04:00,163.72,164.46,163.64,164.24,6368368,6527556.2,58.57116928518242,52.56059849735618,NaN,NaN,114.21301454581987,21.053235627993736,-0.00731034292726207,0.4552864707506785,0.4625968136779406,240352051,236848193.4,30.902603390635733,41.900613884360205,NaN,NaN,7.776153168767877,8.191276283622079
2014-04-01T09:30:00-04:00,164.67,165.31,164.58,164.95,4078016,6333744.75,61.119027701737345,52.85525647456206,NaN,NaN,176.48020369843042,48.96331421811102,0.09994961992188678,0.5875338385802991,0.4875842186584123,244430067,237074987,31.423808022765016,39.42808212532734,NaN,NaN,9.965748959684054,8.44477238020236
2014-04-02T09:30:00-04:00,165.19,165.57,164.75,165.37,5597674,6365188.55,62.584896792377236,54.00455984885354,NaN,NaN,171.78878442290477,81.03540144653614,0.18429676898326763,0.7179551798874968,0.5336584109042292,250027741,239648253.8,37.2110117673733,37.83310539415197,NaN,NaN,12.21774589044768,8.983768595951693
2014-04-03T09:30:00-04:00,165.72,165.75,164.96,165.34,4452553,6354903.05,62.403918461292825,55.257580176252866,NaN,NaN,160.51801060290722,126.87539523017517,0.22072299499272507,0.8095621546451355,0.5888391596524104,245575188,242873746,43.632292297649116,37.42924053286877,NaN,NaN,14.00058448180036,9.70045657964436
2014-04-04T09:30:00-04:00,166.01,166.06,163.58,163.88,10560661,6513777.7,54.19095110885706,55.37300099210112,NaN,NaN,94.70166135986167,143.54033492598478,0.1334414602443631,0.7556409849578642,0.6221995247135012,235014527,243079914.8,44.026326210684516,37.44437763278138,NaN,NaN,13.196721454217194,10.199922990297623
2014-04-07T09:30:00-04:00,163.58,163.93,162.12,162.16,8627208,6745149.85,46.43715900779328,54.68450796666428,NaN,NaN,-35.05594603130828,113.68654281055915,-0.043698992724927055,0.5675757838073423,0.6112747765322694,226387319,240286968.4,39.951912343444164,37.32445091828054,NaN,NaN,9.955480401168119,10.16500262042198
2014-04-08T09:30:00-04:00,162.1,162.73,161.55,162.33,5930117,6780590.7,47.240669974597765,54.4016665452008,NaN,NaN,-70.3463853235801,64.32122500615705,-0.14716029606397563,0.42732440645229985,0.5744847025162755,232317436,237864442.2,36.77304198555125,37.1683694927006,NaN,NaN,7.610943113946334,9.800136976639745
2014-04-09T09:30:00-04:00,163,164.14,162.43,164.1,6016472,6818512.65,54.83724242847337,54.358001812531704,NaN,NaN,30.814701338657567,36.12640838930761,-0.09657365314393695,0.4537676360863543,0.5503412892302912,238333908,235525675.6,33.9634089380084,36.7201149516162,NaN,NaN,7.942752594360171,9.534796350599805
2014-04-10T09:30:00-04:00,164.12,164.31,161.27,161.47,9981548,6842562.6,44.56857042882459,53.79297593617406,NaN,NaN,-61.71028627643027,-8.319250986559885,-0.23266218723304244,0.2595135551889882,0.49217574242203066,228352360,232081110,30.29239588117295,35.891894975649784,NaN,NaN,4.543491024116872,8.821752732530815
2014-04-11T09:30:00-04:00,160.67,161.32,159.88,160.02,11068130,6965789.85,40.10914398525505,52.96974285214844,NaN,NaN,-203.18048301335568,-67.89567986120336,-0.40278599244747654,-0.011306748137315026,0.3914792443101615,217284230,228535050.6,27.05085248264183,34.97690947270634,NaN,NaN,0.13255857695244425,7.580439281733905
2014-04-14T09:30:00-04:00,161.08,161.62,160.27,161.45,6272681,6947275.6,45.86226011445429,52.28196023318302,NaN,NaN,-140.10312372099372,-88.90511539914044,-0.40061137269800584,-0.10928497156234585,0.29132640113566,223556911,227968969,26.56220014881059,34.1859650142668,NaN,NaN,-1.4195174287339831,6.294731180238492
2014-04-15T09:30:00-04:00,161.67,162.47,160.38,162.36,8494145,7017255.35,49.20609092793528,52.17961217405283,NaN,NaN,-86.27915472339032,-92.09166927910249,-0.3228295461484638,-0.11221053154991978,0.21061901459854404,232051056,227915693,26.51365722695205,33.51582968657743,NaN,NaN,-1.493829933784532,5.1820795925209175
2014-04-16T09:30:00-04:00,163.43,164.03,162.93,164.02,5869424,6913905.75,54.702395481262364,52.48585287651095,NaN,NaN,38.506116709988355,-90.55338620483633,-0.15313699730709943,0.019197767964669765,0.1723347652717692,237920480,227833007.4,26.432917009192394,33.164523874841656,NaN,NaN,0.38288820889264363,4.496480823431164
2014-04-17T09:30:00-04:00,163.61,164.19,163.3299,163.75,5791222,6872655.05,53.68485591976809,52.5370251155579,NaN,NaN,40.85958415645404,-70.03941211825946,-0.05755121312850975,0.100395748861132,0.15794696198964175,232129258,228588387,28.57286664753302,33.09352102517246,NaN,NaN,1.5025346791002656,4.068774231383893
2014-04-21T09:30:00-04:00,163.84,164.25,163.7,164.03,3068525,6644605.05,54.62743381721441,52.255329724988755,NaN,NaN,51.442012929538336,-19.114912929680663,0.02180600784722264,0.18520447179867006,0.16339846395144741,235197783,232171097.6,37.81249142153015,33.58708445595063,NaN,NaN,2.6861756483967913,3.871260148100021
2014-04-22T09:30:00-04:00,164.3,165.3,164.23,164.8,4046873,6529952.9,57.20665084172997,51.97587423498823,NaN,NaN,90.20465017908893,26.94664185033587,0.11805239811966822,0.3109639616010327,0.19291156348136446,239244656,235308646.6,44.57434025015451,34.52640818647845,NaN,NaN,4.467193270025484,3.95639345123223
2014-04-23T09:30:00-04:00,164.94,164.99,164.45,164.64,3550456,6407920.05,56.48808701217989,51.54038782211699,NaN,NaN,76.5400632832146,59.51048545165685,0.16021970504671884,0.393186194789763,0.23296648974304418,235694200,236037275.4,46.041648869829295,35.15716797951102,NaN,NaN,5.699634615363559,4.205427903250992
2014-04-24T09:30:00-04:00,165.01,165.11,164.19,164.69,4030810,6302725.95,56.67124662992929,51.13091126273388,NaN,NaN,68.25217764670737,65.45969763900065,0.17931734659631887,0.4571131729884428,0.2777958263921239,239725010,236398181.4,46.79301514606946,35.38293389725533,NaN,NaN,6.756817940028056,4.569912194219143
2014-04-25T09:30:00-04:00,164.08,164.19,163,163.35,5104287,6172256.3,50.53209534771605,50.86956442265238,NaN,NaN,-0.11036144326536902,57.26570851905677,0.09383898568203075,0.39509455849466235,0.3012555728126316,234620723,236896474.4,47.8723021349737,35.65764646327599,NaN,NaN,5.939112102453508,4.7655121811097665
2014-04-28T09:30:00-04:00,164.13,164.69,162.78,164.17,7236949,6307305.95,53.82830711144467,51.397503572913195,NaN,NaN,19.688630632157942,50.915032059580696,0.08492760513875391,0.407415079236074,0.3224874740973201,241857672,238228452.2,50.74828650028817,36.4288160459077,NaN,NaN,6.192728780614999,4.969400266753371
2014-04-29T09:30:00-04:00,164.62,165.27,164.49,165,4583714,6218073.25,56.954852337992236,52.09137374172708,NaN,NaN,78.7273611917729,48.61957426211749,0.12491868328352934,0.4786358282017318,0.35371714491820244,246441386,239667798.2,53.71972540012506,37.639293432662974,NaN,NaN,7.326825943928815,5.30617536349272
2014-04-30T09:30:00-04:00,164.92,165.6,164.83,165.45,4962191,6262282,58.592016043515436,52.35957185708723,NaN,NaN,98.73001793982891,53.05756519344035,0.16892904953907995,0.5648784568420524,0.39594940730297246,251403577,242809673.6,59.468167197610974,39.461061879777446,NaN,NaN,8.747610286023649,5.797808923854281
2014-05-01T09:30:00-04:00,165.3,165.71,164.9,165.23,3890509,6176923.75,57.44177046161528,53.2790861451437,NaN,NaN,97.6249996570456,58.93212959550799,0.17000867336052405,0.6084602490036275,0.43845157564310344,247513068,244367285.2,61.988860453177324,41.72509506349204,NaN,NaN,9.612455163987335,6.342758386730432
2014-05-02T09:30:00-04:00,165.16,165.85,164.53,164.75,7037255,6306158.85,54.90898286290766,54.33621749354746,NaN,NaN,85.5375954879786,76.06172098175679,0.1271434671178754,0.5973809095404476,0.47023744242257226,240475813,245538303.2,63.81103110465481,44.35082210792154,NaN,NaN,9.662373280531336,6.816989085844846
2014-05-05T09:30:00-04:00,163.97,165.172,163.45,164.93,4060840,5981167.8,55.69786399851451,55.03876062812319,NaN,NaN,54.222232520446646,82.96844135941453,0.10081143012611171,0.5962517300802119,0.4954402999541002,244536653,246074099.4,64.64612615096412,47.07110253664679,NaN,NaN,9.913229636089875,7.259309164451279
2014-05-06T09:30:00-04:00,164.66,164.68,163.68,163.73,5281749,5813894.85,49.48249963438837,55.05850410715556,NaN,NaN,22.230708441055075,71.66911080927096,-0.002075713498847942,0.49284565808054026,0.4949213715793882,239254904,244636803,60.60589721075888,49.50626253549014,NaN,NaN,8.393407705825217,7.421323241790414
2014-05-07T09:30:00-04:00,164.51,165.08,163.39,165.03,5578718,5796324.9,55.3017300862957,55.10131372180079,NaN,NaN,46.87501705365634,61.298110632036455,0.0119962897542501,0.5099167337722008,0.4979204440179507,244833622,243322812,57.09291139742258,51.69626213464944,NaN,NaN,8.732979367005699,7.60870268824974
2014-05-08T09:30:00-04:00,165.02,166.07,164.86,165.35,5997976,5795400.1,56.62620114708098,55.311409809466,NaN,NaN,97.35276049793788,61.243662800214906,0.036069690219619144,0.5430075567924746,0.5069378665728554,250831598,243986518,58.40443636030508,53.82708854270459,NaN,NaN,9.396149984265612,7.864052301966293
2014-05-09T09:30:00-04:00,165.29,165.78,164.87,165.72,4228634,5507754.4,58.16960696899652,55.56442217745043,NaN,NaN,92.98132663313108,62.7324090292454,0.06825847833731546,0.5922609644944998,0.5240024861571844,255060232,246903401.8,63.66149306265328,55.673445802784805,NaN,NaN,10.389781550534464,8.22487076604746
2014-05-12T09:30:00-04:00,166.28,166.93,166.28,166.8,3946694,5151682.6,62.377869047389694,55.93379490642612,NaN,NaN,170.49881518645162,85.9877255624464,0.14900141118283927,0.7102542501357334,0.5612528389528941,259006926,249797456.4,67.98487079955677,57.34562655631354,NaN,NaN,12.518496847721794,8.838245920572364
2014-05-13T09:30:00-04:00,167.1,167.29,166.95,167.05,4133418,5044719.45,63.298313927118926,56.420239686064626,NaN,NaN,198.7841008238199,121.29840403899934,0.20263619800791888,0.8145480864627928,0.6119118884548739,263140344,254574544.4,73.57383629334036,59.31221137227862,NaN,NaN,14.546655938730845,9.653733066023575
2014-05-14T09:30:00-04:00,167.09,167.14,165.92,166.11,3106242,4775324.3,57.59279585090492,56.486064630420024,NaN,NaN,131.34333587642604,138.1920678035533,0.16006363109940724,0.8119914273291329,0.6519277962297256,260034102,257614640.4,76.39767388837599,61.42682985387194,NaN,NaN,14.682862594155477,10.37218014147099
2014-05-15T09:30:00-04:00,165.78,165.87,164.02,164.55,7541336,4858919.9,49.60210261524756,56.41963657810085,NaN,NaN,-11.37578533033372,116.44635863789897,0.019490114062275188,0.6762904388075697,0.6568003247452945,252492766,257946874,76.69081292738167,63.48529491047251,NaN,NaN,12.292693004378101,10.646539121886292
2014-05-16T09:30:00-04:00,164.16,164.64,163.77,164.61,5115443,4825130.95,49.890075357105395,56.13833430993376,NaN,NaN,-60.04522770805433,85.8410477696619,-0.07179921039953874,0.5670513117458711,0.6388505221454098,257608209,258456469.4,77.15940284248806,65.37180322062964,NaN,NaN,10.466770329670647,10.620857865855486
2014-05-19T09:30:00-04:00,164.14,164.91,164.03,164.71,2880377,4815723.55,50.398778902804054,55.67004335027746,NaN,NaN,-43.95091634731873,42.95110146290783,-0.1246962690351826,0.48298018585143154,0.6076764548866141,260488586,258752801.4,77.4433762302065,67.06634970849261,NaN,NaN,9.115592960859583,10.405820022284642
2014-05-20T09:30:00-04:00,164.7,164.72,163.04,163.32,4858583,4856309.05,43.75031011192277,54.60992149802083,NaN,NaN,-116.12855091115831,-20.03142888408781,-0.24556095907860176,0.300725256038362,0.5462862151169637,255630003,257250733.2,72.5214781241205,67.99872906038614,NaN,NaN,5.848217671658793,9.754733972195234
2014-05-21T09:30:00-04:00,163.95,165.15,163.89,164.98,4899932,4923782.85,51.90936898822652,54.21474996420735,NaN,NaN,-24.612002310285348,-51.222496521430095,-0.20748695922354665,0.2869275160875304,0.4944144753110771,260529935,257349899.8,72.64508543491264,68.75988798765296,NaN,NaN,5.500150319917905,9.146936307584188
2014-05-22T09:30:00-04:00,165.09,165.39,164.6,165.18,3564764,4900480.55,52.79772983990412,54.06394617684996,NaN,NaN,9.341522818488336,-47.07903489166567,-0.16449005410437573,0.28880190768060743,0.45329196178498316,264094699,259670286.4,75.43013638763784,69.58982407929459,NaN,NaN,5.496088761671001,8.625386658168019
2014-05-23T09:30:00-04:00,165.29,165.87,165.19,165.83,2856996,4788116,55.66422544715983,54.06154342318177,NaN,NaN,56.087555810567785,-23.85247818794125,-0.09156868132937379,0.33883111012326594,0.43039979145263974,266951695,261538983.6,77.42363133858912,70.50250302126781,NaN,NaN,6.368211105476353,8.302933007783494
2014-05-27T09:30:00-04:00,166.45,166.6,166.13,166.47,2562277,4554382.4,58.34643016883203,54.69468131849917,NaN,NaN,116.29317699105525,8.196340479733541,-0.004143363909687892,0.42522058656552986,0.42936395047521775,269513972,263344060.8,79.18081683341872,71.82928299431494,NaN,NaN,7.919070208450746,8.248095465021674
2014-05-28T09:30:00-04:00,166.54,166.55,165.95,166.09,3682041,4509298.75,56.173443913520394,54.75694659187236,NaN,NaN,86.05817452357385,48.63368556667997,0.022705191893035215,0.45774544034151177,0.43504024844847655,265831931,265384446.4,80.98265036581604,73.53569292062876,NaN,NaN,8.569444313220894,8.294002443335849
2014-05-29T09:30:00-04:00,166.47,166.79,166.03,166.78,2764596,4399419,59.14853650740168,54.937113403323835,NaN,NaN,101.96971091751543,73.95002821224014,0.07841111198058304,0.5330541384242053,0.4546430264436223,268596527,266997764.8,82.28795591367172,75.24165860301208,NaN,NaN,10.009217790127275,8.539033207163195
2014-05-30T09:30:00-04:00,166.6,167.02,166.3,166.93,2769441,4343365.6,59.78760866043902,55.05268495271259,NaN,NaN,104.74505429696256,93.03073450793498,0.11464381931448103,0.5979478005867236,0.48330398127224256,271365968,268452018.6,83.39438112322784,76.65115060733885,NaN,NaN,11.373794793535668,8.943999148073548
2014-06-02T09:30:00-04:00,167.25,167.395,166.63,167.2,4453779,4214191.8,60.971154723392736,54.95220535814138,NaN,NaN,113.2326178233964,104.45974691050068,0.14416853896690385,0.6635146549808724,0.5193461160139685,275819747,270225629,84.65349648871103,77.84176672799272,NaN,NaN,12.85096748049264,9.502137481276275
2014-06-03T09:30:00-04:00,166.94,167.2,166.75,167.02,4125216,4217410.6,59.7094385317389,54.69585711561423,NaN,NaN,95.62599507888449,100.32631052806656,0.13889454932388667,0.6929643026688268,0.5540697533449401,271694531,270661740.8,84.9555685314554,78.65474760214379,NaN,NaN,13.758306303037527,10.11016159867074
2014-06-04T09:30:00-04:00,166.89,167.27,166.58,167.13,2265348,4066590.55,60.25077930406433,54.88571307655418,NaN,NaN,86.63208183124127,100.44109198960004,0.1302764278431654,0.7169152881488969,0.5866388603057315,273959879,272287330.4,86.05722941373827,79.34471585395538,NaN,NaN,14.665482419935058,10.760921715994213
2014-06-05T09:30:00-04:00,167.51,168.31,166.92,168.14,5416514,4058480.35,64.91237651031358,55.979304069058905,NaN,NaN,128.14232306303973,105.6756144187049,0.17715301658660798,0.8080801310389916,0.6309271144523836,279376393,274443303.6,87.3774221409081,80.10804508349297,NaN,NaN,16.809538989133316,11.625009897871228
2014-06-06T09:30:00-04:00,168.58,169.12,168.46,169.08,4121571,3964660.1,68.60289126921487,57.315933777066725,NaN,NaN,175.62955495347995,119.85251455000837,0.2514842623191553,0.9452824423513277,0.6937981800321724,283497964,276869702.8,88.67686857569535,80.9307212072935,NaN,NaN,19.831405631485318,12.797352145530384
2014-06-09T09:30:00-04:00,169.12,169.58,169.02,169.24,2713344,3888895.6,69.19678112417022,58.65864822145003,NaN,NaN,175.29072608228265,132.26413620178562,0.2887760271578508,1.0547682139794858,0.7659921868216351,286211308,278948015,89.65886880228436,81.80325639101336,NaN,NaN,22.501426236916714,14.183648444299859
2014-06-10T09:30:00-04:00,169.15,169.37,168.84,169.35,2822680,3832694.9,69.62221275020715,60.50664126704176,NaN,NaN,148.71726050683458,142.88238928737564,0.2970482048415415,1.1373024428735619,0.8402542380320204,289033988,282415906.4,91.05316169469043,83.12694807462549,NaN,NaN,24.844307433634,15.70659972849045
2014-06-11T09:30:00-04:00,168.75,168.81,168.09,168.3499,3065888,3779318.4,61.328795250381226,61.17945742862424,NaN,NaN,98.59891506711135,145.27575593454966,0.21517680472653367,1.1092252439401875,0.8940484392136538,285968100,284817550.6,91.87062964946416,84.50020123280774,NaN,NaN,24.618315432331702,16.979701971896343
2014-06-12T09:30:00-04:00,168.29,168.34,166.98,167.29,5416016,3894807.1,53.98880370877668,61.264534133543705,NaN,NaN,49.205415095200706,129.48837434098186,0.07679026273861622,0.9900362676369241,0.9132460048983079,280552084,285052688.8,91.94819957159302,85.68006288880453,NaN,NaN,22.160366478040352,17.719796901345486
2014-06-13T09:30:00-04:00,167.54,167.83,167.13,167.62,2709149,3653197.75,55.76397769675016,61.27165929422873,NaN,NaN,43.64937822293861,103.09233899487359,-0.0012392736927349102,0.9116969127823893,0.9129361864751242,283261233,285005342.6,91.75834169261468,86.70397077123494,NaN,NaN,20.641973245876375,18.137250664849898
2014-06-16T09:30:00-04:00,167.39,167.97,167.15,167.69,3068347,3550842.95,56.15044378056361,61.114803123638126,NaN,NaN,42.27562384734198,76.48931854788546,-0.05393753915050381,0.8455142625369945,0.8994518016874983,286329580,285028997,91.76748765218744,87.60301868686126,NaN,NaN,19.510390334300606,18.333413474771426
2014-06-17T09:30:00-04:00,167.43,168.2,167.24,168,2886201,3551134.15,57.90440624389854,61.238443290093706,NaN,NaN,48.75758754298923,56.497383955116376,-0.07255695067681855,0.808755613341475,0.8813125640182936,289215781,285065355.6,91.78258254111836,88.37444241366858,NaN,NaN,19.03230253292887,18.43325476879392
2014-06-18T09:30:00-04:00,168.05,169.06,167.35,168.93,4732194,3544814.7,62.72183751470881,61.49367907632993,NaN,NaN,79.74376798002304,52.72635453769872,-0.02910801292237497,0.8449275478653249,0.8740355607876998,293947975,286661330.6,92.43802751716589,89.09944752820388,NaN,NaN,20.008479296306106,18.6582868441528
2014-06-19T09:30:00-04:00,169.02,169.19,168.54,169.09,3037773,3451706.75,63.49584106350454,61.758552819406034,NaN,NaN,104.95211245510262,63.875694009679094,0.0018932404942149095,0.8764021114054685,0.8745088709112536,296985748,289948063.4,93.57465985985816,89.82661029510605,NaN,NaN,21.035323781556418,18.997863549496174
2014-06-20T09:30:00-04:00,169.25,169.42,168.96,169.08,5370721,3542004.6,63.407229187488916,61.93255813827005,NaN,NaN,110.85107359185189,77.31603308346175,0.012614071661280368,0.8902764604878541,0.8776623888265738,291615027,291618822.2,94.06316998854749,90.49872983080864,NaN,NaN,21.856907667926563,19.406298423557658
2014-06-23T09:30:00-04:00,169.06,169.12,168.58,168.91,2729317,3535620.65,61.82757341976303,62.083853487414636,NaN,NaN,81.20796446154029,85.10250120630141,-0.00017805285741179233,0.877439822754809,0.8776178756122208,288885710,292130048.2,94.20827070725784,91.15963712908025,NaN,NaN,22.139466748581523,19.79675104141821
2014-06-24T09:30:00-04:00,168.83,169.33,167.67,167.87,4862542,3650633.9,53.1104574209397,61.57383049576288,NaN,NaN,30.41012654747717,81.43300900719899,-0.08255801987590206,0.7744203507673433,0.8569783706432453,284023168,291091525.6,89.42670758390594,91.40031414123509,NaN,NaN,19.883434386668156,19.80913437645392
2014-06-25T09:30:00-04:00,167.52,168.48,167.51,168.28,3658137,3649438.7,55.75867664179591,60.91999479086876,NaN,NaN,7.262215621695737,66.93669853553354,-0.11151202547250538,0.7175883388026136,0.829100364275119,287681305,289838191.6,83.89269000502117,91.15140470295744,NaN,NaN,18.704548752935803,19.651336430237045
2014-06-26T09:30:00-04:00,168.38,168.39,167.06,168.08,4052354,3713826.6,54.152018751975696,59.88778961106596,NaN,NaN,-22.5588559017216,41.434504864168694,-0.14413647313131017,0.6489297728609813,0.7930662459922915,283628951,287166832.2,73.45835713285304,90.06436817132587,NaN,NaN,17.263592587765423,19.310230167026813
2014-06-27T09:30:00-04:00,167.76,168.2501,167.34,168.17,3092161,3729962.6,54.783420609932044,58.85826386004895,NaN,NaN,-22.575497274320163,14.74919069093429,-0.15851561662559455,0.5949217252102983,0.7534373418358928,286721112,286188049.2,70.02188259840224,88.66172629962,NaN,NaN,16.229912991933006,18.870184856299126
2014-06-30T09:30:00-04:00,167.91,168.35,167.65,167.89,6488539,3831700.6,52.36715419995167,57.62575967788785,NaN,NaN,-24.237749254624646,-6.33995205229869,-0.1839564249353216,0.5234918106667408,0.7074482356020624,280232573,284457421.8,64.29460429064959,86.75040077075994,NaN,NaN,14.682942537572682,18.272007382195348
2014-07-01T09:30:00-04:00,168.27,169.64,168.229,169.2,4912291,3871054.35,61.02777167414166,57.60425799387074,NaN,NaN,86.95982335829112,4.969987309864093,-0.11310746186767684,0.5660639082674663,0.6791713701351432,285144864,284681761,64.69769596695606,84.80947693629507,NaN,NaN,15.79900006439674,17.91872062250983
2014-07-02T09:30:00-04:00,169.31,169.51,169.18,169.4,1931814,3854377.65,62.15899505486131,58.18784309001963,NaN,NaN,115.12873064671065,26.54329031486708,-0.056199767312653415,0.6089216609943264,0.6651214283069798,287076678,284560835.6,64.27646623171162,82.83292455487496,NaN,NaN,17.053031518784163,17.79505075054902
2014-07-03T09:30:00-04:00,169.85,170.47,169.73,170.47,2074812,3687292.55,67.58069309142311,59.03189418963915,NaN,NaN,181.61218975775103,67.3774994467616,0.04463607300096606,0.7209165195581875,0.6762804465572214,289151490,285665343.4,66.42658133802072,81.02351310097539,NaN,NaN,19.9414007101946,18.10167217335553
2014-07-07T09:30:00-04:00,169.88,170.01,169.5524,169.86,2943811,3628404.55,62.116681048381324,59.45805399448326,NaN,NaN,122.48333807287645,96.38926651620093,0.060403832820890235,0.7517852375833343,0.691381404762444,286207679,285562656.8,66.02868529663289,79.18502721843579,NaN,NaN,20.6515747659866,18.465943972302828
2014-07-08T09:30:00-04:00,169.58,169.6,168.44,168.845,5439657,3764720.2,54.2560396093682,59.1974563777311,NaN,NaN,41.763344197646425,109.58948520665513,-0.003957830594395029,0.6864341165194503,0.6903919471138453,280768022,285669746.6,66.25569645358163,77.36167821218316,NaN,NaN,18.644942050752597,18.49151512636708
2014-07-09T09:30:00-04:00,169.18,169.73,168.86,169.58,3545054,3800838.9,58.36484790839946,58.88624283442329,NaN,NaN,82.67381474045048,108.732283483087,-0.0034791870023299643,0.6860429633609328,0.6895221503632628,284313076,285503389,65.52319392436425,75.43919009841163,NaN,NaN,18.334473018479265,18.469080539525965
2014-07-10T09:30:00-04:00,167.89,169.34,167.7,168.96,4932065,3894147.75,53.96176092979557,58.205237110586936,NaN,NaN,9.483003003601475,87.60313795446517,-0.04884999113357036,0.6284596614462998,0.6773096525798702,279381011,283964255.6,59.02166280633271,72.97111888030267,NaN,NaN,16.60993180318541,18.203487862905884
2014-07-11T09:30:00-04:00,168.77,169.22,168.3201,169.2,2830750,3764884.45,55.36548254049106,57.63082663580137,NaN,NaN,29.03150945446915,57.08700189380879,-0.0655853984277811,0.5953279045451438,0.6609133029729249,282211761,282576309.8,53.83414790039882,70.09761730257776,NaN,NaN,15.674877900078824,17.842257868216304
2014-07-14T09:30:00-04:00,170.15,170.61,170.04,170.29,2832043,3771029.15,61.157958845270564,57.58299702333762,NaN,NaN,160.21386132131633,64.63310654349678,-0.009100899405469765,0.6495371787160877,0.6586380781215575,285043804,282343534.8,52.992918834950174,67.15366359741293,NaN,NaN,16.774890555134537,17.689776823490337
2014-07-15T09:30:00-04:00,170.51,170.91,169.78,170.38,5168525,3876038.05,61.60107056139705,58.189469390513146,NaN,NaN,150.91656137002943,86.46374997797338,0.026518486588768653,0.6917861863575183,0.6652676997687497,290212329,284232396.2,58.64070211742,64.95466320694965,NaN,NaN,17.77868281070031,17.702477678806048
2014-07-16T09:30:00-04:00,170.96,171.16,170.6599,171.07,3198635,3891659.75,64.9065086755674,58.84288596435397,NaN,NaN,180.58577232468355,106.04614149481999,0.08542295418489942,0.772046392499874,0.6866234383149745,293410964,286051973.8,63.22452851481942,63.47836595764953,NaN,NaN,19.685992920092072,17.985836998989765
2014-07-17T09:30:00-04:00,170.81,171.32,169.46,169.61,6149275,3962513.8,54.262644624339636,58.85078781237996,NaN,NaN,88.97589928991864,121.94472075208341,0.018431516895833555,0.7096628344347664,0.6912313175389329,287261689,287628109.4,66.6703547630417,62.99350864552013,NaN,NaN,17.783264101339057,17.95689801361109
2014-07-18T09:30:00-04:00,169.95,170.76,169.74,170.58,6927512,4157000.75,59.06554565248638,59.156653886848126,NaN,NaN,96.12264610749932,135.36294808268946,0.03107768119611143,0.7300784190340721,0.6990007378379607,294189201,290023597.4,71.10220375935857,63.07067444273129,NaN,NaN,17.847402805445366,17.941255841015987
2014-07-21T09:30:00-04:00,170.1,170.38,169.36,170.18,2886557,4032792.55,56.43379473650002,59.44712821088729,NaN,NaN,57.303322650206994,114.78084034846759,0.005475186754440142,0.7058447212810108,0.7003695345265707,291302644,291275365.4,73.11404738456159,63.700634663725005,NaN,NaN,17.021246189906634,17.809825890857507
2014-07-22T09:30:00-04:00,170.56,170.96,170.43,170.74,3798217,4086237.55,59.17623003157726,59.31487523641841,NaN,NaN,104.45180525707151,105.48788912587602,0.01849377728454027,0.723486756132246,0.7049929788477057,295100861,292253071.8,74.60138262660577,64.40804085369999,NaN,NaN,17.237505407484463,17.728065821804215
2014-07-23T09:30:00-04:00,170.81,170.81,170.2,170.56,2612009,3973710.9,57.914281932566226,59.011681441968754,NaN,NaN,81.16074958896542,85.60288457873239,0.007769637348002401,0.7147050255327088,0.7069353881847064,292488852,292068649.4,73.77235881569544,65.0863188954131,NaN,NaN,17.019664848009903,17.62686568269074
2014-07-24T09:30:00-04:00,170.66,170.85,170.22,170.44,3227960,3952202.05,57.040959835394794,58.25884335225245,NaN,NaN,72.79811381207737,82.36732748316412,-0.013462457681739481,0.690107316082532,0.7035697737642714,289260892,292468490,74.43566274577294,65.65839613882397,NaN,NaN,16.58672291187816,17.478273858288944
2014-07-25T09:30:00-04:00,169.77,169.85,168.76,169.16,5716235,4035396.1,48.61908204895332,57.29472913800759,NaN,NaN,-36.216588956493176,55.89948047036562,-0.11416552024937743,0.5608628734525496,0.675028393701927,283544657,290339581.2,65.00855066018768,65.5855293790779,NaN,NaN,13.504184873075891,16.910546860401364
2014-07-28T09:30:00-04:00,169.23,169.65,168.37,169.41,3606116,4061093.85,50.16667484390569,57.002631654760265,NaN,NaN,-56.71445803961622,33.095924332400976,-0.16149919276258928,0.4731544027486905,0.6346535955112798,287150773,289509207,61.7248818216986,65.26189976251483,NaN,NaN,11.474989715921929,16.1340386969043
2014-07-29T09:30:00-04:00,169.89,170.19,168.78,168.78,3685190,3920926.4,46.375864291817805,56.14627568214729,NaN,NaN,-58.64946188120689,0.47567090474530005,-0.22869211102956677,0.34878845672432135,0.5774805677538881,283465583,287182151.4,53.560046830362474,64.4073892558004,NaN,NaN,8.574902111871223,15.054162041899577
2014-07-30T09:30:00-04:00,169.27,169.52,167.78,168.48,5449054,3947764.55,44.64579800412591,55.48084975888518,NaN,NaN,-122.7214398826152,-40.30076698957082,-0.28322899135038726,0.22344432856590402,0.5066733199162913,278016529,284287686.8,45.49831063793435,63.441435529486235,NaN,NaN,5.663113707494973,13.712583708413206
2014-07-31T09:30:00-04:00,167.27,167.43,165.29,165.29,9041692,4303258.45,31.282227509966347,53.76061725670483,NaN,NaN,-291.1379758217585,-113.087984916338,-0.5107619111608211,-0.13177906903473513,0.378982842126086,268974837,280230475.8,37.074525656768714,62.24431965494123,NaN,NaN,-2.5343811225102737,11.391588732566994
2014-08-01T09:30:00-04:00,164.8,165.51,164.01,164.57,7436518,4571343.75,29.160619429924225,51.47509301275153,NaN,NaN,-295.40150998115365,-164.92496912127007,-0.6760039860546677,-0.46602214044224866,0.20998184561241906,261538319,275829208.2,30.481519542028593,60.63636256258968,NaN,NaN,-9.74506855126363,8.372066263448334
2014-08-04T09:30:00-04:00,164.8,165.61,164.11,165.33,4403293,4644317.85,34.231151217959166,49.520098773934535,NaN,NaN,-212.75446344356877,-196.1329702020606,-0.6975502112375813,-0.6619559184345576,0.03559429280302373,265941612,271587376,25.732072635751507,58.28574617104193,NaN,NaN,-13.716448776723777,5.216564114852318
2014-08-05T09:30:00-04:00,164.8,165.14,163.34,163.92,8522812,4798475.6,29.94822972017043,47.02307884854904,NaN,NaN,-196.81684316059903,-223.76644645793903,-0.7647956453983721,-0.9204002639449413,-0.1556046185465693,257418800,266378019.4,21.33541368887029,55.29366654061699,NaN,NaN,-18.629164902290697,1.8100313981176015
2014-08-06T09:30:00-04:00,163.46,164.75,163.37,164.2,4783762,4860411,31.773778864707623,45.41673129428961,NaN,NaN,-157.42434904996384,-230.70702829140873,-0.7475643657992063,-1.0900600757955772,-0.3424957099963709,262202562,263215226,19.19140651513102,51.90231309433766,NaN,NaN,-21.788882233786037,-1.5612419778686322
2014-08-07T09:30:00-04:00,164.85,164.89,163.13,163.55,4964682,4862041.85,29.83033267891804,43.32850179617759,NaN,NaN,-134.4720543466845,-199.37384399639396,-0.7359345876951917,-1.2624139446153606,-0.5264793569201689,257237880,260867834.6,17.7645547358444,48.0924810212295,NaN,NaN,-24.99586558517402,-4.90904535034083
2014-08-08T09:30:00-04:00,163.67,165.38,163.44,165.34,5412693,4991139,40.604454544532096,42.19783463960845,NaN,NaN,-93.25886384051073,-158.94531476826538,-0.5710329308900052,-1.2402705205326754,-0.6692375896426702,262650573,261090285.4,18.38382671680168,44.183179544960936,NaN,NaN,-24.041309238885024,-7.642225905847143
2014-08-11T09:30:00-04:00,165.96,166.15,165.472,165.55,5764166,5137745.15,41.73475267028781,40.952014828087776,NaN,NaN,-58.16837392947528,-128.02809686544668,-0.4182382564957886,-1.192035410262406,-0.7737971537666174,268414739,261584910.8,19.829480202906453,40.27090080041099,NaN,NaN,-22.92818693058081,-9.825934623666239
2014-08-12T09:30:00-04:00,165.28,165.77,165,165.49,3274277,5043032.75,41.49180201855038,39.77898054851522,NaN,NaN,-59.08127213464106,-100.48098266025508,-0.29731927308180695,-1.145446245118876,-0.8481269720370691,265140462,263129243.2,24.33585354137672,36.739721852245374,NaN,NaN,-22.12930012790448,-11.583558267128844
2014-08-13T09:30:00-04:00,166,166.66,165.76,166.49,2843964,5025299.2,47.026712292034084,39.063677152560885,NaN,NaN,-30.755403930631317,-75.14719363638856,-0.13439375374763007,-1.0161191642216068,-0.8817254104739767,267984426,264285616,27.61674849431671,33.39551369142707,NaN,NaN,-19.687476227293626,-12.741260832866669
2014-08-14T09:30:00-04:00,166.69,167.1,166.46,167.1,2752417,4855456.3,50.12613900333419,39.171324077873805,NaN,NaN,-10.801674544801354,-50.41311767601195,0.0217372452153205,-0.8545538539548261,-0.8762910991701466,270736843,266985408.6,34.732435156071986,31.232934012561667,NaN,NaN,-16.685391513784094,-13.304708072997729
2014-08-15T09:30:00-04:00,167.42,167.46,165.44,166.35,7032489,4860705.15,46.522020023494,38.910991590701535,NaN,NaN,-20.044986268003484,-35.77034216151051,0.07858335911055336,-0.7780619002819549,-0.8566452593925082,263704354,267196164.8,35.26741365429169,29.343114857746887,NaN,NaN,-15.242278351842709,-13.58150382711844
2014-08-18T09:30:00-04:00,167.25,168.12,167.23,168.06,2976485,4865201.55,54.54657582834909,39.49461384331091,NaN,NaN,28.1123833841578,-18.5141906987839,0.22703200890932784,-0.5728552482558484,-0.7998872571651763,266680839,266849384.8,34.76251011811365,28.000433664014828,NaN,NaN,-11.247358863989383,-13.248054546671431
2014-08-19T09:30:00-04:00,168.64,169.02,168.33,168.89,3057442,4828162.8,57.85244073781499,40.437945467145845,NaN,NaN,66.33280495274987,6.5686247186943,0.3684364340225287,-0.33934171463701546,-0.7077781486595441,269738281,267768948.6,37.324883747831365,27.416617457578905,NaN,NaN,-6.846807015752467,-12.333590613683008
2014-08-20T09:30:00-04:00,168.72,169.74,168.72,169.6,3108856,4853005.15,60.49905656290147,42.52486182806979,NaN,NaN,92.80127382601039,31.279960270022638,0.48951516112963533,-0.09588419724749997,-0.5853993583771353,272847137,268741490.8,40.008652564206,27.626197950967285,NaN,NaN,-2.3615647063429943,-10.909015484063005
2014-08-21T09:30:00-04:00,169.81,170.53,169.69,170.18,2652896,4824251.95,62.56694938035067,44.91102825310025,NaN,NaN,123.14991882094051,58.07027894317101,0.5820949871854427,0.14221937560466813,-0.4398756115807746,275500033,269694128.8,42.601372411115264,28.49190172733062,NaN,NaN,1.9793437067575057,-9.067821313945789
2014-08-22T09:30:00-04:00,170.01,170.48,169.65,169.87,5152335,4796056.95,60.73678237813814,46.80428762168446,NaN,NaN,114.31850013132222,84.94297622303615,0.5938346336957809,0.30241768053895157,-0.29141695315682936,270347698,271022797.6,46.1002386293,29.946770726869797,NaN,NaN,4.957964152851509,-7.064137675831889
2014-08-25T09:30:00-04:00,170.56,171.057,170.44,170.62,2589968,4745249.55,63.51724832506937,49.202074664891526,NaN,NaN,130.74810706744242,105.47012095969308,0.6205830645287417,0.48431187750409777,-0.1362711870246439,272937666,272274163,49.238658254427804,31.939859624409618,NaN,NaN,8.344191024598148,-4.8629478614847415
2014-08-26T09:30:00-04:00,170.82,171.35,170.78,170.93,3581363,4740058.2,64.63212237389239,51.54909920126187,NaN,NaN,131.3188963361146,118.46733923636603,0.625842307247851,0.6460316970351698,0.02018938978731885,276519029,273630312.6,52.46872692820853,34.31681108248658,NaN,NaN,11.462519986229996,-2.530738168954065
2014-08-27T09:30:00-04:00,171.15,171.21,170.75,171.01,5163143,4725762.65,64.92996536904192,54.056215821985,NaN,NaN,118.15780170400919,123.53864481196578,0.6012523610869381,0.7717548411459916,0.1705024800590534,281682172,275397319.6,56.36483206390055,37.07397374877631,NaN,NaN,14.097218615630549,-0.15531577115626272
2014-08-28T09:30:00-04:00,170.4,170.88,170.1,170.77,2781898,4412772.95,63.21019115434273,55.67091129411433,NaN,NaN,92.82965358281785,117.47459176434124,0.5374505390482365,0.842315653869349,0.30486511482111256,278900274,276077367.8,57.79855314418334,39.889311350732136,NaN,NaN,15.853434320749788,2.131648527687459
2014-08-29T09:30:00-04:00,170.9,171,170.25,170.88,3280263,4204960.2,63.6849564419776,57.238782992092176,NaN,NaN,86.48429726914117,111.90775119190505,0.47352729365098833,0.896774231884848,0.4232469382338596,282180537,278443935.6,62.42541137442806,42.931877862983676,NaN,NaN,17.45301244627028,4.320414801770719
2014-09-02T09:30:00-04:00,170.94,171.07,170.04,170.58,3458655,4157728.3,61.35930249066076,58.657890168671486,NaN,NaN,74.61485307379749,100.68110039317605,0.3856343979446817,0.9052899356647117,0.51965553772003,278721882,279600778.8,64.47574288823513,45.79901281633071,NaN,NaN,18.233669398509463,6.308022601304825
2014-09-03T09:30:00-04:00,171.38,171.48,170.53,170.72,2847495,3873962.45,62.055682739511994,59.73138805777705,NaN,NaN,77.19803898684289,89.85692892332172,0.314526113904012,0.912813180100045,0.598287066196033,281569377,280610848.4,66.20949126837556,48.55563730019205,NaN,NaN,19.0760288664311,8.132023496322864
2014-09-04T09:30:00-04:00,170.91,171.56,170.22,170.66,3761576,3822853.15,61.54377287051212,60.54693333400405,NaN,NaN,69.05151115486653,80.03567081349318,0.24418531163446722,0.903518705739117,0.6593333941046498,277807801,279835974.2,63.64336068811101,50.62070340962341,NaN,NaN,19.668770493235264,9.780130210167492
2014-09-05T09:30:00-04:00,170.52,171.29,170.01,171.25,3403608,3744799.45,64.63329943850394,61.8405961493619,NaN,NaN,65.75093961756788,74.6199280204432,0.21893786692074835,0.9330057277555852,0.7140678608348369,281211409,280298201.2,64.52658356833865,52.710644117769625,NaN,NaN,20.99599976806502,11.38239728986714
2014-09-08T09:30:00-04:00,171.04,171.35,170.75,171.06,3142466,3631288.1,62.881303603780545,62.43593384760701,NaN,NaN,68.94289493152897,71.11164755292074,0.17300079642777277,0.9303188563695528,0.75731805994178,278068943,279475882.4,61.65687571543175,54.63167023186377,NaN,NaN,21.701130852922795,12.856502084589376
2014-09-09T09:30:00-04:00,170.79,170.84,169.89,170.12,4255228,3555841.2,54.94586886969018,62.22832157131238,NaN,NaN,34.8690706519916,63.16249106855956,0.06824641479092941,0.8426260784304418,0.7743796636395124,273813715,278494249,58.3223953966879,56.131492492496385,NaN,NaN,20.186828093711526,13.903691514463969
2014-09-10T09:30:00-04:00,170.17,170.814,169.71,170.67,4595967,3621925.7,58.264608621214705,62.068718146906185,NaN,NaN,34.862169499558604,54.6953171711027,0.027050651497730227,0.8081929780116752,0.781142326513945,278409682,277862310,56.2147036975429,57.28906757344902,NaN,NaN,19.763150123332885,14.74075703001667
2014-09-11T09:30:00-04:00,169.89,170.62,169.82,170.51,3026406,3631047.8,56.95036148262352,61.66753329706853,NaN,NaN,24.922148255294772,45.86944459118835,-0.01752044638518646,0.759241768532462,0.7767622149176484,275383276,277377405,54.58462617212259,58.14501427066382,NaN,NaN,19.04770265159481,15.356034975956405
2014-09-12T09:30:00-04:00,170.38,170.44,169.4,169.9,5000985,3743476.2,52.1231391115764,61.05227306374269,NaN,NaN,-13.344234295127414,30.050409808649288,-0.09054866407320405,0.6635763848261433,0.7541250488993474,270382291,275211581.4,47.90313534824474,58.27379260773131,NaN,NaN,17.04526216307305,15.597353145544497
2014-09-15T09:30:00-04:00,170.06,170.57,169.55,170.32,5131633,3648433.4,54.954261661903395,60.44063115923084,NaN,NaN,-13.668551618035067,13.528120498736481,-0.11164642085066734,0.6145670228360132,0.7262134436866805,275513924,274700577.6,46.45819118777185,58.07518781725589,NaN,NaN,16.095637190457452,15.668536580532063
2014-09-16T09:30:00-04:00,169.96,171.71,169.89,171.38,5950278,3797123.05,61.191608600275636,60.19488017540107,NaN,NaN,83.82827832785429,23.319962033909018,-0.0579914218967863,0.6537241663156976,0.7117155882124839,281464202,276230675,51.20440574213815,57.984879161108,NaN,NaN,17.095394268129116,15.872373393045928
2014-09-17T09:30:00-04:00,171.57,172.25,170.93,171.58,8498822,4069192.05,62.25362269851426,60.003712841791945,NaN,NaN,170.6073056116311,50.46898925632352,-0.015046544260098216,0.6929074078873612,0.7079539521474594,289963024,278541343.4,57.3526313987146,58.05543625645186,NaN,NaN,18.229413717275193,16.209093439364395
2014-09-18T09:30:00-04:00,172.01,172.8,171.9,172.61,6459542,4236726.35,67.22760995040639,60.29067132722508,NaN,NaN,274.3790907141096,100.36037774808649,0.07193715046236382,0.7978753902254141,0.7259382397630503,296422566,282749201.4,65.80283893215082,58.6271709555924,NaN,NaN,20.819643723388868,16.86774347993932
2014-09-19T09:30:00-04:00,173,173.3164,172.19,172.45,9342500,4571206.55,65.77758734609125,60.44014496323319,NaN,NaN,246.92642681549012,152.41450997021,0.10585671428912291,0.858259132624454,0.7524024183353311,287080066,286088756.4,70.755431107812,59.22217236511982,NaN,NaN,22.488653288933236,17.67073059550988
2014-09-22T09:30:00-04:00,172.35,172.38,171.22,171.41,4898383,4558508.95,57.149102249370486,60.13941637456959,NaN,NaN,99.41416008122573,175.03105231006217,0.04833777628427194,0.812824638690671,0.7644868624063991,282181683,287422308.2,72.46999909937924,59.79319066591582,NaN,NaN,21.257581866535986,18.18313791994218
2014-09-23T09:30:00-04:00,170.85,171.38,170.21,170.21,5523151,4705168.1,49.13935748720291,59.21682171369037,NaN,NaN,-43.21500610812555,149.6223954228662,-0.07379880321546939,0.6722383583870624,0.7460371616025318,276658532,286461174.2,69.3157210923666,60.01506422477233,NaN,NaN,17.436618894713593,18.076492344909525
2014-09-24T09:30:00-04:00,170.36,171.9,169.98,171.79,5815707,4816885.3,57.57133040571899,58.93307582334801,NaN,NaN,37.52671565186071,123.0062774309121,-0.05245255942032978,0.6804714623271195,0.7329240217474493,282474239,284963417.2,64.59728499389632,60.08320167518558,NaN,NaN,17.047971567109098,17.92956080522375
2014-09-25T09:30:00-04:00,171.5,171.53,169.09,169.17,8911865,5004321.4,44.42034780416818,57.4892935637526,NaN,NaN,-115.94291181578146,44.94187692493391,-0.2102077051221034,0.47016439034482005,0.6803720954669235,273562374,280391378.8,52.78508587342696,59.24452326840617,NaN,NaN,11.273835839180569,16.978742952931867
2014-09-26T09:30:00-04:00,169.79,171.13,169.5,170.7,6063449,5168398.95,51.401816527709734,56.6693302011761,NaN,NaN,-52.01806052010853,-14.847020542185822,-0.20662793585041894,0.42208717565389975,0.6287151115043187,279625823,278900530.2,49.600100745813755,58.38332505629059,NaN,NaN,9.526949285766953,15.914201000479737
2014-09-29T09:30:00-04:00,169.18,170.58,168.94,170.33,5170197,5262895.65,49.773553374481374,56.29987909437548,NaN,NaN,-101.12479580357709,-54.95481171914638,-0.2228968392617946,0.3500940624270754,0.57299090168887,274455626,277355318.8,46.47034045796169,57.536749703524436,NaN,NaN,7.62806171739953,14.730466817182565
2014-09-30T09:30:00-04:00,170.45,171.1,169.8,170.07,5496439,5364784.85,48.60831965575823,55.61014416827145,NaN,NaN,-56.14040588525735,-57.53989167457273,-0.24322569337431466,0.2689587849709767,0.5121844783452913,268959187,275815449.8,43.52301531503627,56.63020053334539,NaN,NaN,5.783885846945837,13.452383821434461
2014-10-01T09:30:00-04:00,169.91,169.98,167.42,167.68,11030604,5773940.3,39.46274627830964,54.36102879653475,NaN,NaN,-222.45319343077074,-109.53587349109901,-0.40041083718447334,0.011670931864699696,0.41208176904917304,257928583,270906318.6,35.74052382454764,55.284193222804326,NaN,NaN,0.6248388735222791,11.61987740030415
2014-10-02T09:30:00-04:00,167.39,168.27,166.43,167.65,9093707,6040546.85,39.36263281017456,53.44956406072033,NaN,NaN,-247.1785394795706,-135.78299902385683,-0.4836126431531338,-0.1924340348922442,0.2911786082608896,248834876,265960819,29.93356958774656,54.00065281134017,NaN,NaN,-3.225729711085684,9.499076384391316
2014-10-03T09:30:00-04:00,168.89,169.97,168.37,169.72,5589110,6149821.95,48.98043287810958,53.02286200473505,NaN,NaN,-85.51462271772107,-142.48231146337935,-0.3809622050492042,-0.18502414805061562,0.19593805699858854,254423986,260920451.6,25.403385988271637,52.49673815423301,NaN,NaN,-3.0706018921730416,7.703408059167836
2014-10-06T09:30:00-04:00,170.44,170.69,168.96,169.57,5315315,6258464.4,48.381578758775326,52.107859873199324,NaN,NaN,-50.821972629820905,-132.4217468286281,-0.30801121025326916,-0.18907595581799796,0.11893525443527123,249108671,255851060.6,21.825689142939126,50.398258397147366,NaN,NaN,-3.1560406867853255,6.152058238317385
2014-10-07T09:30:00-04:00,168.73,168.94,166.86,166.86,7130002,6402203.1,39.08416816623039,50.45289883517905,NaN,NaN,-182.2554825649925,-157.64476216457518,-0.4201706623627499,-0.40627807351816614,0.013892588844583748,241978669,250454957,18.79186148332579,47.64391768890532,NaN,NaN,-6.705075112835443,4.315324902438409
2014-10-08T09:30:00-04:00,166.87,169.82,166.35,169.62,8895708,6617190.15,49.68830651591697,49.200091447001235,NaN,NaN,-98.20336991005087,-132.7947974604312,-0.2924338975790304,-0.35164978312920425,-0.05921588555017386,250874377,249044115.8,18.084075762340674,44.23543460534744,NaN,NaN,-5.554298449646005,2.9053787092834926
2014-10-09T09:30:00-04:00,169.16,169.48,166.2,166.34,13390612,7135400.45,40.635209842735776,47.4042073396187,NaN,NaN,-149.19720631518368,-113.19853082755381,-0.4058231773464511,-0.5664948572332378,-0.16067167988678666,237483765,246773893.6,16.97606509367708,40.39405131862352,NaN,NaN,-8.375643011093171,1.2938041778011122
2014-10-10T09:30:00-04:00,166.39,167.36,165.21,165.21,12717759,7521239.15,38.06228498698725,46.04086324944847,NaN,NaN,-182.61947536826082,-132.61950135766176,-0.5262686067197272,-0.8185074382864457,-0.2922388315667185,224766006,240842297.6,14.47976389424548,36.251891661113966,NaN,NaN,-11.4906167638851,-0.5325416710112036
2014-10-13T09:30:00-04:00,165.09,165.79,162.84,162.93,14116961,7970505.55,33.458899585620614,44.92083054219258,NaN,NaN,-214.34805102239966,-165.32471703617753,-0.7170135863136482,-1.1885058144587788,-0.4714922281451306,210649045,233150372.4,12.012849110310526,32.15882937668139,NaN,NaN,-15.813969696579836,-2.715602817521008
2014-10-14T09:30:00-04:00,163.67,164.41,162.5,163.03,13634363,8354709.8,33.83686182357083,43.22551135775343,NaN,NaN,-188.4226096912263,-166.55814246142427,-0.7883015361496349,-1.4568691483321743,-0.6685676121825394,224283408,229611320.2,11.077703968433156,28.336002160576868,NaN,NaN,-18.832798265783747,-5.018059310129971
2014-10-15T09:30:00-04:00,161.19,161.85,158.27,161.28,24976691,9178603.25,30.564927788934227,42.235838499522444,NaN,NaN,-222.8445669306916,-191.48638186555243,-0.8972450812772105,-1.7901239637790525,-0.892878882501842,199306717,219297788.2,8.90270072217237,25.2015460783444,NaN,NaN,-22.473555673813742,-7.511701647799081
2014-10-16T09:30:00-04:00,159,161.95,158.73,160.98,18932353,9802243.8,30.028858200700327,40.70919861902177,NaN,NaN,-181.23822369941553,-197.89458534239878,-0.9294988077973059,-2.0547523922484743,-1.1252535844511684,180374364,207875908,7.213532159186769,22.173934036442468,NaN,NaN,-25.446797268191062,-10.073858164997935
2014-10-17T09:30:00-04:00,162.68,163.95,162.21,163.45,11730201,9921628.85,39.445660433392746,39.97149198037258,NaN,NaN,-102.73453093812078,-181.9175964563708,-0.7331006035258303,-2.0416293388584563,-1.308528735332626,192104565,201343619.8,6.458764807175626,19.31596434710061,NaN,NaN,-24.778072902103084,-12.17446027029867
2014-10-20T09:30:00-04:00,162.35,163.68,162.25,163.65,7165208,10034970.1,40.14805394391359,39.36718728666939,NaN,NaN,-89.17832596955996,-156.88365144580285,-0.5468785294584249,-1.9921268971556572,-1.4452483676972323,199269773,199067765.4,6.214784362499472,16.6510907076337,NaN,NaN,-24.03435198732081,-13.868730515587547
2014-10-21T09:30:00-04:00,164.45,165.87,164.12,165.8,8999009,10208763,47.23377988673904,39.92226111584292,NaN,NaN,-35.81071644708988,-126.36127279697557,-0.25110583426325084,-1.7591306605262957,-1.508024826263045,208268782,195864840.2,5.878241797515173,14.518070562845667,NaN,NaN,-21.012703512215168,-14.88929808653435
2014-10-22T09:30:00-04:00,166.17,166.2327,164.28,164.38,6030932,10219524.25,43.56533732090838,40.22245429518106,NaN,NaN,-36.74418220729841,-89.14119585229693,-0.12943056435608002,-1.669813031708145,-1.540382467352065,202237850,196451066.8,6.872264688161465,12.870834498589588,NaN,NaN,-19.7132541554692,-15.578434667810757
2014-10-23T09:30:00-04:00,166.05,167.36,166.01,166.45,7032521,10125557.05,49.69840130009424,40.273737753894245,NaN,NaN,7.234474831154321,-51.44665614618295,0.0997640386617642,-1.4156774190248598,-1.515441457686624,209270371,202230268.2,16.26127256227892,12.217826396732965,NaN,NaN,-16.52316152887948,-15.713395647963432
2014-10-24T09:30:00-04:00,166.6,167.79,166.17,167.74,5733928,10109081,53.11775487676393,40.612036048036295,NaN,NaN,28.88404411763778,-25.122941135031255,0.3343297566593295,-1.0975292618624621,-1.4318590185217916,215004299,206810215,22.895602929094295,12.294248810029762,NaN,NaN,-12.774843690838244,-15.293602511231263
2014-10-27T09:30:00-04:00,167.23,168.06,166.97,167.88,5063687,10103755.5,53.487290972877005,41.64083053422534,NaN,NaN,44.76440884335666,1.6656058275520949,0.48581334439778656,-0.8245923380245586,-1.3104056824223451,220067986,210969857.6,28.440794030487055,12.983458277684138,NaN,NaN,-9.725539281010624,-14.49816490691403
2014-10-28T09:30:00-04:00,168.48,169.69,168.14,169.66,5441960,10101031.55,58.018207798744776,42.23582348299875,NaN,NaN,91.38972474482578,27.105694065935218,0.6808353442533328,-0.45936150210567916,-1.140196846359012,225509946,214418090.4,32.75800439266578,14.031596036993076,NaN,NaN,-5.6453777592505565,-13.23348102867639
2014-10-29T09:30:00-04:00,170.01,170.34,168.61,169.4,7587316,9928867.15,57.14259432049615,43.41492237426734,NaN,NaN,96.03885241499142,53.66230099039318,0.7611832061972175,-0.18871783861249014,-0.9499010448097076,217922630,217555046.4,36.51063007858015,15.426922107343296,NaN,NaN,-2.639547567533919,-11.720061962798894
2014-10-30T09:30:00-04:00,169.63,171.94,169.6,171.6,7449244,9846644,62.323993040663545,45.147901520958506,NaN,NaN,127.26831683453746,77.66906939106981,0.9207001349066566,0.20097412382361313,-0.7197260110830435,225371874,220775347,40.20013045228422,17.264091147203207,NaN,NaN,1.6847585856416774,-9.805087598735955
2014-10-31T09:30:00-04:00,173.34,173.634,172.79,173.451,7563762,9945376.6,66.04370919678081,47.47538792175569,NaN,NaN,169.4211576058972,105.7764920887217,1.097105733394588,0.6516561556601914,-0.4454495777343965,232935636,224361614.4,44.09630155588919,19.555766321887397,NaN,NaN,6.614778012908708,-7.459392511358146
2014-11-03T09:30:00-05:00,173.57,173.78,173.05,173.36,5386924,9948957.05,65.70028425123746,49.75134666658902,NaN,NaN,157.8939183431934,128.40239398868903,1.1484149209205974,0.9900690734163504,-0.15834584750424707,227548712,225857759.6,45.68617989529839,22.027800316663484,NaN,NaN,10.408682217323232,-4.9068104072608065
2014-11-04T09:30:00-05:00,173.08,173.646,172.46,173.46,6465952,9915754.55,65.91006702337766,52.27599946904927,NaN,NaN,133.42493909557513,136.8094368588389,1.1281980930653361,1.2519017688274232,0.12370367576208696,234014664,227558703.2,47.51373253266337,24.785731160269986,NaN,NaN,13.535775612798663,-2.272155261538025
2014-11-05T09:30:00-05:00,174.59,174.62,173.71,174.55,5286216,9735279.95,68.19358876134113,55.00205165195218,NaN,NaN,138.27286653342634,145.2562396825259,1.1248180394955285,1.5297262251314976,0.4049081856359691,239300880,231834353.2,51.89543379358546,27.977295562727033,NaN,NaN,16.89957566262301,0.46666344191355114
2014-11-06T09:30:00-05:00,174.75,175.41,174.1802,175.29,7191719,9425335.3,69.67856224396355,57.161544638421525,NaN,NaN,128.39226390794678,145.48102909720777,1.1072682676832575,1.7889935202400409,0.6817252525567834,246492599,236058498.2,55.819605636828754,31.50306990770226,NaN,NaN,20.178059254614354,3.2825771294422372
2014-11-07T09:30:00-05:00,175.24,175.6,174.77,175.58,4018111,8990352.9,70.26447188768114,59.31271734869063,NaN,NaN,116.01916217344409,134.80063001071713,1.0505155419503391,1.9948696799947072,0.9443541380443682,250510710,239573513,58.82930383996362,35.26124987037827,NaN,NaN,23.070780014847173,6.109463255928656
2014-11-10T09:30:00-05:00,175.62,176.06,175.33,175.95,2941925,8431601.1,71.03353979968335,61.012700199615225,NaN,NaN,109.22360053133536,125.06656644834553,0.9748773115375964,2.1629507774663637,1.1880734659287673,253452635,244754297.6,62.84669295959061,39.33042495338366,NaN,NaN,25.725569065346242,8.911764085845453
2014-11-11T09:30:00-05:00,175.98,176.24,175.69,176.02,3192666,7909516.25,71.18537866564174,62.985560295667604,NaN,NaN,101.53890617745365,118.68935986472124,0.869999851953366,2.275573280870475,1.405573428917109,256645301,249280425,65.9707831566517,43.55174770113296,NaN,NaN,27.990749660984633,11.637333453722478
2014-11-12T09:30:00-05:00,175.26,176.2,175.25,176.04,2836489,6802506.15,71.23177857979042,64.52365867278877,NaN,NaN,90.30221699160816,109.09522995635761,0.7471198708792595,2.3394732675161833,1.5923533966369239,259481790,253316607,68.5133977534506,47.28404235764522,NaN,NaN,29.917396576435852,14.24877104268153
2014-11-13T09:30:00-05:00,176.25,176.98,175.79,176.44,6508365,6181306.75,72.19610610207961,65.8863980460256,NaN,NaN,91.89087867624957,101.79495291001817,0.641945704697741,2.3947855275091,1.752839822811359,265990155,257216118.2,70.78464233023372,50.704688029155186,NaN,NaN,31.84303958372134,16.762237977115788
2014-11-14T09:30:00-05:00,176.36,176.65,176.12,176.35,3521129,5770853.15,71.61443256559089,67.18119387407658,NaN,NaN,84.57445213297405,95.50601090192416,0.5206488244716136,2.403650853400876,1.8830020289292624,262469026,259607781.4,72.11329025715168,53.82415204534551,NaN,NaN,33.359560780664175,19.133284091908415
2014-11-17T09:30:00-05:00,176.06,176.76,176,176.49,3668944,5596039.95,71.99244916747514,68.17935397184304,NaN,NaN,80.10789891868917,89.68287057939492,0.4090965210169142,2.394372680200405,1.9852761591834909,266137970,262144848.4,73.4905505106398,56.733619625200795,NaN,NaN,34.766873185974084,21.366653962489224
2014-11-18T09:30:00-05:00,176.53,177.38,176.45,176.96,4721709,5382174.95,73.278981787289,69.33195307661397,NaN,NaN,85.46767230302395,86.46862380450898,0.32962710091398506,2.3973100353259724,2.0676829344119874,270859679,264987724,74.98158967824018,59.4815453108908,NaN,NaN,36.33456601611558,23.504927113007273
2014-11-19T09:30:00-05:00,176.85,177.19,176.29,176.93,4011447,5281200.7,73.04832617916325,70.09797687222108,NaN,NaN,80.90680903941444,84.58954221407024,0.2417724101174512,2.3698984470588016,2.1281260369413504,266848232,266461012.4,75.74303615340705,62.02032428954243,NaN,NaN,37.63604509335422,25.523658253056837
2014-11-20T09:30:00-05:00,176.11,177.28,176.03,177.25,2881685,5073658.9,73.9888244040031,70.66548510130839,NaN,NaN,77.44473135111228,81.70031274904278,0.1750526162724122,2.3469418072818655,2.1718891910094533,269729917,267208964.8,76.14006296571267,64.3091643902441,NaN,NaN,39.01570420780561,27.451093389449518
2014-11-21T09:30:00-05:00,178.52,178.6,177.28,177.7,4781965,5026060.75,75.29443665985625,71.35078170192402,NaN,NaN,100.35936546337913,84.85729541512379,0.1329746442024562,2.3381074962625235,2.2051328520600673,274511882,269617536,77.4216435892634,66.57598322552732,NaN,NaN,40.56992959894616,29.32521284794904
2014-11-24T09:30:00-05:00,178.13,178.22,177.59,177.8,2408710,4893311.9,75.5876848728443,72.04204011974306,NaN,NaN,99.3556940979816,88.70685445098226,0.08590822700785505,2.312518135819886,2.226609908812031,276920592,271774060.4,78.53342392879033,68.79167546810781,NaN,NaN,41.99312791565828,31.13491500047893
2014-11-25T09:30:00-05:00,178.16,178.19,177.56,177.96,5510449,4896736.35,76.07696939202927,72.6051387362208,NaN,NaN,99.52173186838591,91.51766636405468,0.041815706016523624,2.278879541332685,2.2370638353161616,282431041,274088332.8,79.6892623959879,70.77694893970799,NaN,NaN,43.36048109716243,32.88142444286229
2014-11-26T09:30:00-05:00,177.96,178.09,177.65,178.01,3005627,4667651.9,76.23725107429004,73.07361650981554,NaN,NaN,100.5945171022195,95.45520797661568,-0.005216681111128718,2.2305429839272506,2.2357596650383793,285436668,277806020,81.41997046252564,72.60554642725778,NaN,NaN,44.5925342726961,34.55444013283855
2014-11-28T09:30:00-05:00,178.115,178.69,177.86,178.1,4037459,4497062.65,76.5419125113104,73.52200512578906,NaN,NaN,112.42703878050919,102.45166946249506,-0.049061607503625204,2.1744326556588476,2.223494263162473,289474127,281754862,83.07015564175018,74.3370358416711,NaN,NaN,45.74843453743332,36.153582190637806
2014-12-01T09:30:00-05:00,177.54,178.02,177.026,177.6,6671848,4452466.95,71.0889199968559,73.52596085415853,NaN,NaN,72.2797421746035,96.83574480473995,-0.12615087209166598,2.0658056730478904,2.1919565451395564,282802279,283412941.4,83.72382609321204,75.82825963692976,NaN,NaN,45.531514519349045,37.49328680902513
2014-12-02T09:30:00-05:00,177.68,178.774,177.67,178.56,3920471,4379144.3,74.80090675031131,73.78421286020637,NaN,NaN,110.37089171577131,99.0387843282979,-0.12657458464816118,2.033738314329355,2.160312898977516,286722750,285373373,84.4865131293399,77.15081177783607,NaN,NaN,46.25153572289831,38.74446522529273
2014-12-03T09:30:00-05:00,178.59,179.14,178.41,178.96,11006551,4606174.25,76.1736014176992,74.13720020577128,NaN,NaN,133.60981361340427,105.85640067730155,-0.11437300539356032,2.017346642235566,2.1317196476291262,297729301,288433025,85.61913289978847,78.37265000257449,NaN,NaN,47.24073344051354,39.95821782746713
2014-12-04T09:30:00-05:00,178.73,179.3,178.03,178.83,4790960,4581411.45,74.74845560449572,74.31951088451528,NaN,NaN,113.84719781814138,108.50693682048595,-0.1284604473797577,1.9711440884044293,2.099604535784187,292938341,289933359.6,86.1529976620112,79.47038966913003,NaN,NaN,47.72137478406874,41.06724024983879
2014-12-05T09:30:00-05:00,179.28,179.82,178.99,179.51,4269415,4435296.25,77.15601455914188,74.71533816976894,NaN,NaN,145.1923612271097,115.06000130980604,-0.10630175655265273,1.966727340093371,2.0730290966460236,297207756,291480085.4,86.70111228769693,80.51237695702612,NaN,NaN,48.796987983821985,42.171489926122106
2014-12-08T09:30:00-05:00,178.96,179.54,177.97,178.54,5567952,4512788.3,67.2990058659388,74.38009221965919,NaN,NaN,87.19444395932427,118.0429416667502,-0.16764314916442746,1.8634751601904895,2.031118309354917,291639804,293247590.4,87.31885292166004,81.50011284352756,NaN,NaN,46.91560117794163,42.84922010495347
2014-12-09T09:30:00-05:00,176.78,178.03,176.22,177.96,7945392,4762961.65,62.18346874737735,73.5875555739512,NaN,NaN,-8.7087202805176,94.22701926749242,-0.25283417771115135,1.7150755872159777,1.967909764927129,283694412,292641922.8,85.84730006713959,82.27623501416323,NaN,NaN,43.741619568126225,42.976705742549576
2014-12-10T09:30:00-05:00,177.5,177.5,175.01,175.29,7621986,4984427.65,45.16408705237612,71.59582420775213,NaN,NaN,-121.42047746172165,43.22096105246722,-0.4813104986745662,1.3662716415839213,1.8475821402584875,276072426,288310547.8,75.9851281090321,82.29352729670788,NaN,NaN,34.085921794373334,41.70659374995297
2014-12-11T09:30:00-05:00,175.89,177.66,175.7,176.03,6867314,5185968.9,49.30537907327955,69.8327209698433,NaN,NaN,-86.61317539400443,3.128886410038061,-0.568902921139425,1.1364534888342064,1.7053564099736314,282939740,286310827.6,71.87950446658485,81.98920168962731,NaN,NaN,27.776295248608474,39.71655110690376
2014-12-12T09:30:00-05:00,174.77,175.67,172.93,173,12284430,5474772.15,36.98781040075817,67.09653337990771,NaN,NaN,-243.50449029956843,-74.61048389529758,-0.8028962536329567,0.7017360929324354,1.5046323465653921,270655310,281000338.4,62.258907699293154,80.90614912605801,NaN,NaN,16.5885325069104,36.41254844976185
2014-12-15T09:30:00-05:00,173.75,174.13,171.21,171.79,8874293,5742430.35,33.399439740555295,64.08308729902994,NaN,NaN,-266.6244516638097,-145.37426301992437,-0.9984064120111085,0.25662433155150666,1.2550307435626151,261781017,275028581,53.57506489221765,79.12340919487426,NaN,NaN,6.4589486694075475,32.133462766854095
2014-12-16T09:30:00-05:00,171.27,174.39,170.74,170.85,12257580,6171862.15,30.892099525771542,60.85559659429724,NaN,NaN,-226.0108993466334,-188.8346988331475,-1.1400407574287452,-0.17002020322331646,0.9700205542054288,249523437,268194386,45.71634435599499,76.69677219201762,NaN,NaN,-2.3112915405303993,27.21278358008488
2014-12-17T09:30:00-05:00,171.27,173.98,171.08,173.59,12901618,6580857.6,44.0719664865967,58.55807626660486,NaN,NaN,-151.14167600354625,-194.77893854151245,-1.0030346942625064,-0.28377281362270423,0.7192618806398021,262425055,265464911.8,43.0032392407275,73.95271996188919,NaN,NaN,-4.460234910912863,22.68806665279949
2014-12-18T09:30:00-05:00,175.98,177.83,175.37,177.79,9752401,6867905.3,57.46345727233858,57.19532946382115,NaN,NaN,7.380310614816019,-175.98024133974837,-0.6031043972455306,-0.03461861591711113,0.5684857813284194,272177456,263312455,40.939848443981646,70.94341230490572,NaN,NaN,-0.13943588854297911,19.426994861179136
2014-12-19T09:30:00-05:00,177.79,178.42,177.15,177.65,11452550,7296448.55,56.973748816972815,56.18710295097236,NaN,NaN,33.777036166209044,-120.52393604659287,-0.3349373552147538,0.14981408730997714,0.48475144252473096,260724906,261326374.2,39.076708623896344,67.75433248566888,NaN,NaN,2.6128244390064195,17.02497051515446
2014-12-22T09:30:00-05:00,178.22,179.36,178.19,179.36,7855558,7450128.2,61.31074442716556,55.22351992789053,NaN,NaN,76.8620007319633,-51.82664556743829,-0.04458866015309454,0.4290156173333628,0.47360427748645734,268580464,262686263.6,41.0547677083392,64.65206495559741,NaN,NaN,6.501855875440111,15.521668423766696
2014-12-23T09:30:00-05:00,179.87,180.4,179.68,180.03,6224826,7640934,62.889153995409984,54.27463082629844,NaN,NaN,108.49263947323735,15.074062196535857,0.17817376313016764,0.6963214813991669,0.5181477182689993,274805290,267742634.2,47.836527298569266,61.95330741265318,NaN,NaN,10.008855230012843,14.73412368180186
2014-12-24T09:30:00-05:00,180.19,180.531,179.94,180.03,1647624,7447792.75,62.88915399540999,53.42753785422089,NaN,NaN,104.6454902358945,66.23149544442401,0.3037329174955683,0.8978138651384597,0.5940809476428914,274805290,270218681.2,50.82041993554531,59.42955186076275,NaN,NaN,12.628714451809195,14.43335093466005
2014-12-26T09:30:00-05:00,180.49,180.71,180.19,180.19,1921214,7393572.1,63.30378818701652,52.438093113354796,NaN,NaN,102.65423141984593,85.28627960543,0.37130348514803213,1.0582103040779316,0.6869068189298995,276726504,271128490.8,51.90899127934104,56.9444003601659,NaN,NaN,14.805448305271856,14.486507701890307
2014-12-29T09:30:00-05:00,179.88,180.38,179.81,180.11,2530891,7318243.7,62.92522037065172,52.12567986369144,NaN,NaN,88.00372168142962,96.13161670847413,0.38282325419714813,1.1654358866763346,0.7826126324791864,274195613,273822632.2,55.07978821998743,54.64161002433214,NaN,NaN,16.426590210026585,14.763662345909776
2014-12-30T09:30:00-05:00,179.63,179.87,179.24,179.46,2953280,7132315.3,59.79628736971828,51.955166908144356,NaN,NaN,64.20398470269298,93.60001350262004,0.32135898322749146,1.1843113615135508,0.8629523782860593,271242333,274355006,55.70133829313108,52.488327040474395,NaN,NaN,16.88365380894815,15.066518269200971
2014-12-31T09:30:00-05:00,179.82,180.12,177.88,177.88,4514389,7162011.2,52.90926265413645,52.508393736841526,NaN,NaN,35.90527783913257,79.0825411757991,0.15728891908156084,1.0595635271380104,0.9022746080564495,266727944,272739536.8,53.291653622974394,50.86736457718456,NaN,NaN,15.188772359619012,15.083983139260692
2015-01-02T09:30:00-05:00,178.65,179.23,176.98,177.94,4997212,6861544.25,53.130028030376806,52.78158294806276,NaN,NaN,19.707599790833935,62.09496308678698,0.04181083085081405,0.9545381466199672,0.9127273157691531,271725156,272123510,52.361420893719234,49.47321575055129,NaN,NaN,13.890984726614331,14.913554794596926
2015-01-05T09:30:00-05:00,177.06,177.21,174.46,174.84,6700209,6957006.7,42.13826718784905,53.14947271856926,NaN,NaN,-53.03575895486427,30.956965011844943,-0.23891630906054484,0.6140819294434721,0.8529982385040169,265024947,269783198.6,48.87126575757823,48.51695561185738,NaN,NaN,8.951981551742193,14.061901474189108
2015-01-06T09:30:00-05:00,175.1,175.54,172.32,173.39,10131406,7250106.25,38.16138815158069,53.489611890785355,NaN,NaN,-93.36863440685299,-5.317506205811574,-0.502658488710076,0.22467512761642183,0.7273336163264978,254893541,265922784.2,43.697200680022725,47.81139388241489,NaN,NaN,3.446783766662541,12.545456087399598
2015-01-07T09:30:00-05:00,174.85,175.79,174.24,175.59,5546974,7249057.35,46.42330781330627,54.59898391132355,NaN,NaN,-45.7139764972439,-27.301098445798953,-0.507848890142788,0.09252250364801284,0.6003713937908008,260440515,263762420.6,41.07631894340847,47.479963495801556,NaN,NaN,1.532544483974212,10.972183001195972
2015-01-08T09:30:00-05:00,177.26,178.96,177.21,178.76,7166658,7210120.65,55.62347625938001,55.42409175223664,NaN,NaN,41.42180721511397,-26.197792570602665,-0.2876513322986334,0.24080722841750912,0.5284585607161425,267607173,263938266.4,41.384493064190856,47.36433876890608,NaN,NaN,3.297705787384733,9.875829113508653
2015-01-09T09:30:00-05:00,178.98,179.06,176.63,177.22,6646620,7161352.35,51.03824004109508,54.965147664290676,NaN,NaN,20.20013381537507,-26.099285765694447,-0.23765366892051532,0.23139147456549836,0.46904514348601367,260960553,261785345.8,38.714784592943786,47.20540563668909,NaN,NaN,3.0262682302005626,8.897320415893212
2015-01-12T09:30:00-05:00,177.44,177.63,175.46,176.24,4305292,7033251.25,48.309119327563295,54.34624555790429,NaN,NaN,-13.78835719496261,-18.249805413714117,-0.26067540968357433,0.14320088138154574,0.4038762910651201,256655261,260111408.6,36.7307387876351,47.03783636267043,NaN,NaN,1.859462818422689,7.891912187683137
2015-01-13T09:30:00-05:00,177.72,179.03,174.7,175.98,9913513,6914705.4,47.582171456917145,53.36563320288655,NaN,NaN,-15.03050137032539,-2.5821788064085966,-0.2817146107123699,0.051733027674657706,0.3334476383870276,246741748,258481050,34.857063593309206,46.59514321159686,NaN,NaN,0.7216056985458855,6.8675826892349585
2015-01-14T09:30:00-05:00,173.44,174.72,172.42,174.06,11090635,7025522.5,42.49658811243675,51.909021354102734,NaN,NaN,-107.36792364118527,-14.912968235196871,-0.4057035219148356,-0.17368176400651691,0.2320217579083187,235651113,253523169.6,29.867514329781415,45.31164228525488,NaN,NaN,-1.9488238752188853,5.608096037170124
2015-01-15T09:30:00-05:00,174.74,175.08,172.81,173.06,9293698,6877328.4,40.093060151649354,50.28072893669127,NaN,NaN,-117.70503239240362,-46.73833615670039,-0.5280826822755713,-0.4280815949361454,0.10000108733942586,226357415,245273218,23.77014630381602,43.3794798829885,NaN,NaN,-4.9035887906969595,4.106426776046255
2015-01-16T09:30:00-05:00,172.57,174.97,172.12,174.67,8721910,6668343,45.4430814093053,49.004964166854755,NaN,NaN,-113.71055541343158,-73.52047400246173,-0.4752698543695066,-0.4940862306224574,-0.018816376252950795,235079325,240096972.4,20.888744502962098,41.16374797039,NaN,NaN,-5.654736042067363,2.7119749448871664
2015-01-20T09:30:00-05:00,175.23,175.61,173.14,174.9,7224084,6541927.15,46.18249692536593,47.80905534933434,NaN,NaN,-82.47498659226483,-87.25779988192217,-0.40240375789161853,-0.521821073617474,-0.11941731572585546,242303409,237226602,19.478679202152392,38.62081161197322,NaN,NaN,-6.020887028060933,1.4644232344660093
2015-01-21T09:30:00-05:00,174.25,175.75,173.66,175.35,6259314,6282265.35,47.676678554763534,46.943369005409004,NaN,NaN,-63.74705550578662,-97.0011107090144,-0.3058313767501198,-0.5017065366635052,-0.1958751599133854,248562723,237590797,20.214599928197146,36.0860445859065,NaN,NaN,-5.877290919483226,0.4156069267589757
2015-01-22T09:30:00-05:00,175.92,178.14,174.51,177.92,9565123,6367743.6,55.308227899458274,47.114723665789136,NaN,NaN,-1.2588405976335566,-75.77929410030406,-0.06347234058186993,-0.2752155856407228,-0.21174324505885286,258127846,242086143.6,28.85756497650489,34.34075253973011,NaN,NaN,-3.3027836856208923,-0.11559173215243401
2015-01-23T09:30:00-05:00,177.71,177.82,176.39,176.41,4795306,6296267.6,50.635199262032366,46.936521610907384,NaN,NaN,4.72726322301021,-51.292834977221275,-0.002673316627705924,-0.21508489084348525,-0.21241157421577933,253332540,247481168.6,37.59481859350336,33.28599523257183,NaN,NaN,-2.6077285050447245,-0.47161127113704693
2015-01-26T09:30:00-05:00,176.16,176.71,175.38,176.5,3730398,6400406.3,50.901472434354616,47.56246484280064,NaN,NaN,-13.033964418224254,-31.157516778179815,0.04325457890892115,-0.1583433505796279,-0.20159792948854904,257062938,251877891.2,43.66680622124606,32.91424812283382,NaN,NaN,-1.9775257978208658,-0.6867419178061639
2015-01-27T09:30:00-05:00,173.5,174.75,172.59,173.59,11565051,6882598.15,42.85279784402637,47.89756553511819,NaN,NaN,-100.63226863226511,-34.78897318617986,-0.11409765430902946,-0.3442199973748359,-0.23012234306580642,245497887,252516786.8,44.511690514596744,32.97242596816053,NaN,NaN,-4.018378057736631,-1.1626899377962305
2015-01-28T09:30:00-05:00,174.55,174.61,171.59,171.72,9673196,7239713.4,38.62603874347656,47.34061774441607,NaN,NaN,-126.7070466355508,-47.380971412132695,-0.32398284795819604,-0.6351009030135515,-0.31111805505535545,235824691,249969180.4,41.81837558341318,33.02543001387515,NaN,NaN,-7.160013996615749,-2.0194505176275905
2015-01-29T09:30:00-05:00,172.16,174.07,171.06,173.9,9615220,7572810.4,45.388599761419925,46.609555137418916,NaN,NaN,-103.78938390005776,-67.88708007261754,-0.29659219389610947,-0.6818582974254923,-0.38526610352938284,245439911,247431593.4,39.26953815155087,32.874361805829444,NaN,NaN,-7.555442636334796,-2.8103065345857625
2015-01-30T09:30:00-05:00,173.2,173.951,171.27,171.45,11138459,7904013.9,40.04786853402271,45.82452860119946,NaN,NaN,-124.89831503530975,-93.81219572428154,-0.4167172885039627,-0.9061627141593362,-0.4894454256553735,234301452,243625375.8,35.749832505923536,32.66257951389942,NaN,NaN,-9.749316390137333,-3.801593656807415
2015-02-02T09:30:00-05:00,171.95,173.43,170.1,173.27,9437852,8126045.9,45.2058319990377,45.602865220590495,NaN,NaN,-112.58356623013815,-113.7221160866643,-0.349554033071367,-0.9263879669945823,-0.5768339339232152,243739304,240960649,33.4869114425438,32.43087756067862,NaN,NaN,-9.770223136559908,-4.654255011057771
2015-02-03T09:30:00-05:00,174.13,176.4,174.1,176.33,7543368,8168203.85,52.59112904805413,45.960647905671706,NaN,NaN,30.284533324798822,-87.53875569525152,-0.08859226956071464,-0.6875742708741086,-0.598982001313394,251282672,242117606,35.39889670461402,32.46957992577182,NaN,NaN,-7.12807641020525,-5.00765806807884
2015-02-04T09:30:00-05:00,175.8,177.5662,175.78,176.53,5935850,7958426.05,53.03666810855028,46.713510762536956,NaN,NaN,66.35304057835054,-48.92673825247125,0.09784199863433307,-0.47667950302047757,-0.5745215016548106,257218522,246396372.2,42.035221427070745,33.338701861292485,NaN,NaN,-4.96751446955488,-5.001923268289702
2015-02-05T09:30:00-05:00,177.28,178.64,177.09,178.55,6037756,7982965.15,57.3920193156797,47.94915070282484,NaN,NaN,111.7463908060151,-5.8195833112566815,0.34371583063812905,-0.14487671335714936,-0.4885925439952784,263256278,249959645.6,46.92503892446418,34.992622762767354,NaN,NaN,-1.687421059865947,-4.528422952800594
2015-02-06T09:30:00-05:00,178.82,179.36,177.48,178.09,7211861,7985225.3,56.11575612104054,48.711484610805925,NaN,NaN,120.08171179281565,43.1764220543684,0.45490491296827473,0.08003859721506501,-0.3748663157532097,256044417,254308238.6,52.2221532048562,37.23072338433121,NaN,NaN,0.5058967027470109,-3.8092344305795076
2015-02-09T09:30:00-05:00,177.18,177.94,176.68,177.09,3723092,7839048.9,53.33886190353719,49.222653537818154,NaN,NaN,80.48815927059258,81.79076715451455,0.44034912927719494,0.17557009584328398,-0.26477903343391096,252321325,256024642.8,54.16656202613979,39.708429300330316,NaN,NaN,1.4647049103203806,-3.0558145247366664
2015-02-10T09:30:00-05:00,178.17,178.75,177.14,178.51,3572674,7802418,56.62149346314773,49.86156888841703,NaN,NaN,106.82768758677834,97.09939800691045,0.5011770395798979,0.3616922660409614,-0.13948477353893649,255893999,256946908.2,55.2210839572163,42.208892445260254,NaN,NaN,3.2862441207345237,-2.1498061468122107
2015-02-11T09:30:00-05:00,178.09,179.09,177.67,178.7,5174522,7565468.45,57.05681584482667,49.98646802737192,NaN,NaN,110.48753233705048,105.92629635865043,0.5264272789350208,0.5185493251298396,-0.007877953805181248,261068521,257716908,56.128640421867374,44.156826405643294,NaN,NaN,4.880640798001907,-1.1454565832673367
2015-02-12T09:30:00-05:00,179.27,179.925,179,179.8401,3742736,7198073.5,59.67208390425193,50.631959787530455,NaN,NaN,131.66478037725588,109.90997427289858,0.5874877922623711,0.7264817865227826,0.1389939942604115,264811257,258027903.8,56.51201031620241,45.50805438583608,NaN,NaN,7.006023365235163,0.01904055223302037
2015-02-13T09:30:00-05:00,180,180.54,179.76,180.34,3998242,6933300.7,60.79938447562039,51.33895350476373,NaN,NaN,135.06566520573807,112.90676495548307,0.625597526657673,0.9209909025825027,0.2953933759248297,268809499,260580920.2,59.6306982064796,46.648332384781334,NaN,NaN,9.094471524063694,1.3155306910659736
2015-02-17T09:30:00-05:00,180.06,180.7,179.71,180.57,2850861,6639748.25,61.33491265042544,52.659104562363666,NaN,NaN,124.86244519945063,121.78162214125469,0.6286741314254997,1.0812360402067043,0.4525619087812046,271660360,264448727.2,63.8592845372337,48.03030338639826,NaN,NaN,10.975253106424674,2.6954910361172164
2015-02-18T09:30:00-05:00,180.18,180.68,179.97,180.47,2724833,6414785.7,60.94507400055513,54.25332136644071,NaN,NaN,114.1780203483039,123.2516886935598,0.5871386639684955,1.1864852387418239,0.5993465747733284,268935527,267057032.8,66.41420813643415,49.7871485687569,NaN,NaN,12.445922371012298,4.088409798245085
2015-02-19T09:30:00-05:00,179.87,180.427,179.43,180.09,2663529,6234996.45,59.40006038984962,55.25413998275712,NaN,NaN,93.43486811915592,119.8411558499809,0.5006114181085705,1.2251108474090415,0.7244994293004711,266271998,268097728.2,67.40433504084493,51.79677691799219,NaN,NaN,13.315189289675425,5.406521154163705
2015-02-20T09:30:00-05:00,179.15,181.2,178.5,181.14,8914648,6202472.7,62.24795899470212,56.839860729948505,NaN,NaN,91.0989193437327,111.72798364327625,0.48053836296287034,1.325172383004059,0.8446340200411886,275186646,270172806,69.34492207940323,54.19642617324074,NaN,NaN,14.83904004280496,6.754023852541026
2015-02-23T09:30:00-05:00,180.71,180.92,180.32,180.92,2738564,6099635.6,61.278069456242,57.98787769117739,NaN,NaN,92.55722699957217,103.22629600204307,0.421026092664575,1.3709166358719074,0.9498905432073323,272448082,270900522.6,70.01903320607276,56.80586344206423,NaN,NaN,15.88869685312973,8.058977138339412
2015-02-24T09:30:00-05:00,181.03,182.06,180.89,181.91,4228745,6124552.95,63.996621270165306,58.80255570704247,NaN,NaN,104.4335995386756,99.14052686988806,0.4161735875109678,1.470107527596042,1.0539339400850742,276676827,271903816,70.96695395788035,59.346438960154686,NaN,NaN,17.540806703306288,9.413524219048965
2015-02-25T09:30:00-05:00,181.81,182.17,181.56,181.96,2822884,5687444.6,64.13357950250861,59.59519223518235,NaN,NaN,104.71543460115578,97.24800972045844,0.38489799277517656,1.5350564310540449,1.1501584382788683,279499711,274016652.8,72.90947820385588,61.55174301563934,NaN,NaN,18.96883350211949,10.778568402344753
2015-02-26T09:30:00-05:00,181.92,182.24,181.4,182.01,3045831,5356076.35,64.27991243685105,60.08718460098031,NaN,NaN,100.03733015679846,98.56850212798695,0.3378231753636869,1.572437407483477,1.2346142321197902,282545542,277271361.6,75.61598953949544,63.60109663099872,NaN,NaN,20.221891236126446,12.127614521456422
2015-02-27T09:30:00-05:00,181.93,181.94,181.15,181.19,3161318,5033381.25,59.95935735361512,60.361727546164204,NaN,NaN,81.03894198140334,96.55650665552108,0.22702211610439238,1.5183918772502807,1.2913697611458883,279384224,278110877.2,76.27442106220612,65.31911576366657,NaN,NaN,20.27259855056926,13.291183668472542
2015-03-02T09:30:00-05:00,181.37,182.68,181.37,182.68,3213112,4637113.9,64.61368268716606,61.16707188785198,NaN,NaN,102.50881114092066,98.54682348379077,0.22898843174818828,1.5776053008311237,1.3486168690829354,282597336,280140728,77.83301216112949,67.0095764875944,NaN,NaN,21.56604972216779,14.473307390429005
2015-03-03T09:30:00-05:00,182.23,182.39,181.19,181.87,2825771,4306509.85,60.496772993254666,61.4438775685739,NaN,NaN,87.13796735677448,95.08769704741056,0.1542295380627221,1.5414037916613381,1.387174253598616,279771565,280759675.6,78.30110019283293,68.65814907585273,NaN,NaN,21.576718779544617,15.48808044601695
2015-03-04T09:30:00-05:00,181.41,181.41,180.13,180.78,3820195,4120351.2,55.38291332817703,61.32431310309893,NaN,NaN,37.960080018980634,81.73662613097551,0.017079288140587234,1.40852336377435,1.3914440756337627,275951370,280050007.4,76.31136080430683,70.0997719603127,NaN,NaN,20.136494020641738,16.152139528106204
2015-03-05T09:30:00-05:00,181.25,181.45,180.71,181.17,2410673,3944092.35,56.790322616599695,61.118473011123776,NaN,NaN,50.123556717913104,71.75387144319845,-0.05757579712063032,1.3194743292329747,1.377050126353605,278362043,279213307.6,73.92615714170698,71.34363959070588,NaN,NaN,19.3022178176088,16.60215071232086
2015-03-06T09:30:00-05:00,180.12,180.63,178.125,178.4,7297446,4007076.85,45.751466584040244,60.04362173315376,NaN,NaN,-72.82247518404793,40.98158801010819,-0.29067917174962443,1.0137011616665745,1.304380333416199,271064597,277549382.2,69.28802296144012,72.03344850177449,NaN,NaN,14.959551833042925,16.36749372956687
2015-03-09T09:30:00-04:00,178.53,180.19,178.53,179.8,3844851,3838726.35,50.94178958156553,59.30125579966377,NaN,NaN,-52.35061236700659,10.009703308522742,-0.344093025667332,0.8742640513320339,1.218357076999366,274909448,276011804.6,65.2162030389968,72.13037125190041,NaN,NaN,12.875918022617402,15.86869720000266
2015-03-10T09:30:00-04:00,178.38,178.51,176.68,176.69,6070112,3956077.35,41.453558773881305,57.909004712044215,NaN,NaN,-193.19438734830118,-46.056767632492395,-0.5691143328924553,0.5069641608837969,1.0760784937762522,268839336,273825358.8,59.83167195389026,71.66019009600443,NaN,NaN,7.52592973420808,14.676873276317721
2015-03-11T09:30:00-04:00,176.975,177.289,176.23,176.35,5584619,4056674.6,40.56403932231464,56.56357463579172,NaN,NaN,-213.84586323769105,-96.41795628382673,-0.7118278230474185,0.186293714966979,0.8981215380143975,263254717,271286028.2,54.23140829074993,70.71926675671192,NaN,NaN,3.08935009974288,13.021512822521316
2015-03-12T09:30:00-04:00,177.24,179.02,177.2,178.97,4024348,3999165.9,49.54819721753756,55.65644879456568,NaN,NaN,-108.79845371690557,-128.20235837079048,-0.6049484065564147,0.1419360298188792,0.7468844363752939,267279065,269069432.6,49.845540380250476,69.32645377820101,NaN,NaN,2.3324560787991397,11.49450471627529
2015-03-13T09:30:00-04:00,178.39,178.5,176.27,177.56,6833888,4153723.5,45.55714767291479,54.533525810042306,NaN,NaN,-141.51674082867905,-141.9412114997167,-0.6030381726183557,-0.00691327939765074,0.5961248932207049,260445177,266945548.6,46.00625367506102,67.6112552402716,NaN,NaN,0.32092036801931223,9.89827838081015
2015-03-16T09:30:00-04:00,178.25,179.91,178.25,179.78,5550064,4231314.6,52.099286942320205,53.68371621519623,NaN,NaN,-39.867659639544904,-139.44462095422435,-0.4339881606974479,0.053639692348895096,0.487627853046343,265995241,265162707.2,43.011407686697005,65.61443050661565,NaN,NaN,0.963119245025597,8.621827075698071
2015-03-17T09:30:00-04:00,178.79,178.97,177.86,178.5,5392939,4358418.5,48.481859242940594,52.565736196655656,NaN,NaN,-74.41009509174035,-115.6877625029122,-0.3914127314960484,-0.0016380613237174657,0.3897746701723309,260602302,263515300.4,40.394702105882345,63.291946499617545,NaN,NaN,0.2202945395190305,7.421608141958209
2015-03-18T09:30:00-04:00,177.91,181.007,176.97,180.73,11294422,4786897.95,54.419655122893644,51.86143210280155,NaN,NaN,-18.960807652468414,-76.71075138586767,-0.20544888608499284,0.13296356256608988,0.3384124486510827,271896724,265243701.8,44.2283575479479,61.04997278593557,NaN,NaN,1.7099046683870676,6.6056505028766175
2015-03-19T09:30:00-04:00,180.18,180.39,179.31,179.66,6229177,4965180.35,51.36078967979786,51.24724869752889,NaN,NaN,-8.147024348548605,-56.580465512196284,-0.14949052238497296,0.15154929566986652,0.3010398180548395,265667547,264921398.2,43.664381374826206,58.720684236837016,NaN,NaN,1.8507388234653719,5.926377405817869
2015-03-20T09:30:00-04:00,180.46,181.67,180.17,180.96,5999199,4819407.9,54.69286954885229,50.53861918764933,NaN,NaN,43.26140853058619,-19.624835640343235,-0.026361923501457496,0.2680874136780176,0.2944493371794751,271666746,267165712,48.58120826876573,56.631269673096746,NaN,NaN,3.0871504961892424,5.520773561585208
2015-03-23T09:30:00-04:00,181.05,181.75,180.84,180.85,3593884,4862173.9,54.35356402482404,50.09981854704715,NaN,NaN,51.33474568271196,-1.384354575891861,0.042490251050762595,0.3475621509929283,0.3050718999421657,268072862,267581236.2,49.46069350697913,54.57124062410719,NaN,NaN,3.9453332916696593,5.295710665882987
2015-03-24T09:30:00-04:00,180.65,181.19,179.77,179.83,4692113,4885342.3,51.182714000245284,49.79980430933773,NaN,NaN,15.074605003234733,16.512585443103156,0.015542751627229234,0.32450033947620227,0.30895758784897304,263380749,268136925.6,50.67572591960513,52.7401238466285,NaN,NaN,3.6871356963199236,5.065914241659692
2015-03-25T09:30:00-04:00,179.95,180.16,176.88,176.92,8474718,5167934,43.403284175617635,48.84358727783901,NaN,NaN,-84.73021172344312,3.3587046289082325,-0.19068830473812037,0.07059720692632254,0.2612855116644429,254906031,264738787,43.749105037577166,50.58462012490494,NaN,NaN,0.8671390490778358,4.466089214147998
2015-03-26T09:30:00-04:00,176.15,177.3,175.46,176.48,6604471,5345866,42.35501299360637,48.60098344995088,NaN,NaN,-142.5451325196388,-23.5209170053098,-0.34041560169117957,-0.16423399044953157,0.176181611241648,248301560,261265589.6,38.02779313765502,48.35174656606314,NaN,NaN,-1.7036000025696725,3.584705040331188
2015-03-27T09:30:00-04:00,176.33,176.97,175.97,176.81,3971821,5386391.15,43.45799444775353,48.066426654678594,NaN,NaN,-118.8036667678438,-55.933932064995794,-0.39696300743057894,-0.3200221480465757,0.07694085938400325,252273381,257386916.6,32.859719573727304,46.04056917568675,NaN,NaN,-3.4457823085800405,2.5803497047724413
2015-03-30T09:30:00-04:00,178.31,179.76,178.28,179.39,5399289,5495700,51.303094369533575,48.7699649115109,NaN,NaN,3.138703243403256,-65.57314055285754,-0.24764825152165648,-0.23261945501806736,0.015028796503589126,257672670,255306878.2,30.468336369462776,43.94318806251336,NaN,NaN,-2.521742258619376,1.851479424287896
2015-03-31T09:30:00-04:00,178.52,179.08,177.43,177.58,4633760,5586099.45,46.43543335922423,49.18935019986158,NaN,NaN,-44.81279973891262,-77.55062150128701,-0.25672551084032,-0.30587809204681093,-0.049152581206490895,253038910,253238510.4,28.26549597773065,42.088480040154835,NaN,NaN,-3.3068837122693298,1.114570404779721
2015-04-01T09:30:00-04:00,177.54,177.54,175.57,176.74,7440536,5767116.5,44.33315232241882,48.81684699306739,NaN,NaN,-105.97266925696591,-81.79911300799156,-0.3021157085348771,-0.4267972168750873,-0.12468150834021018,245598374,251376979,26.41450601253453,40.41483472817513,NaN,NaN,-4.607282271938135,0.2971628795343131
2015-04-02T09:30:00-04:00,176.7,177.91,176.43,177.33,3223638,5807764.75,46.17634963072783,48.86107570433975,NaN,NaN,-68.4596731386719,-66.98202113179819,-0.27593888126728494,-0.46960510992431637,-0.19366622865703143,248822012,251481069.4,26.703544331542574,39.036069775066665,NaN,NaN,-5.109359515973172,-0.4751974626810419
2015-04-06T09:30:00-04:00,176.32,179.17,176.085,178.59,6284934,5757139.15,49.98506178962236,48.71005962200419,NaN,NaN,-26.479306300602058,-48.51714903834984,-0.16289070649263948,-0.3972796117728308,-0.2343889052801913,255106946,252047782.4,28.353585780371958,37.98908249604345,NaN,NaN,-4.380462862478755,-1.0330925197950007
2015-04-07T09:30:00-04:00,178.77,179.58,178.42,178.42,6011556,5865474.4,49.47635705660069,48.78109518012277,NaN,NaN,23.035174953707624,-44.53785469628897,-0.09220742459296505,-0.3496481860213976,-0.25744076142843253,249095390,250332326.4,26.415089145017475,36.99053871312452,NaN,NaN,-3.93595419134629,-1.4477870443023277
2015-04-08T09:30:00-04:00,178.6,179.56,177.96,178.75,4738514,5798894.5,50.52886912686299,48.50318189469202,NaN,NaN,16.573459713353813,-32.26060280583568,-0.019663979957631472,-0.28202073637547187,-0.2623567564178404,253833904,250491325.2,26.913848553674043,35.753788070676386,NaN,NaN,-3.273457711255465,-1.7085971395813473
2015-04-09T09:30:00-04:00,178.66,179.63,177.98,179.4,4483753,5743851.2,52.62244715883934,48.59330028605212,NaN,NaN,25.44778572016398,-5.976511810409701,0.07070900201257152,-0.17397050390212598,-0.2446795059146975,258317657,253035181.8,34.55663016686658,35.10323441296499,NaN,NaN,-2.1300052326268046,-1.7687982957306982
2015-04-10T09:30:00-04:00,179.67,180.44,179.18,180.37,3463571,5715812.35,55.639460266512685,48.660913908742145,NaN,NaN,77.93764635712964,23.302952088750608,0.18778018382263978,-0.009954276136397766,-0.19773445995903755,261781228,255627025,41.2927370755281,34.58262932773373,NaN,NaN,-0.2899625409592667,-1.5575360450490652
2015-04-13T09:30:00-04:00,180.17,180.86,179.49,179.64,3358215,5542028.7,52.90879628002375,48.55771621268498,NaN,NaN,71.4708071596104,42.8929747807931,0.2065301977478391,0.060428287225761323,-0.14610191052207777,258423013,256290238.4,42.912000090137546,34.114865512245046,NaN,NaN,0.5456679450027445,-1.257078332184521
2015-04-14T09:30:00-04:00,179.58,180.54,178.8,180.18,4811404,5505095.7,54.680637219281785,48.80756787118759,NaN,NaN,59.21024504946571,50.12798879994472,0.24324921067848262,0.1579596028260255,-0.08528960785245712,263234417,259118043.8,49.32944481361614,34.018702576102974,NaN,NaN,1.742265086851953,-0.8286007008935962
2015-04-15T09:30:00-04:00,180.83,181.38,180.45,180.88,4377762,5454336.85,56.942284564359255,49.77463932752628,NaN,NaN,107.22355157572532,68.25800717241903,0.2989623847906937,0.28841337313591,-0.01054901165478371,267612179,261873698.8,54.676346818655986,34.79921984618003,NaN,NaN,3.3957663331250916,-0.22511969603378368
2015-04-16T09:30:00-04:00,180.67,181.51,180.43,180.91,3873853,5083308.4,57.04123115097048,50.823654910195145,NaN,NaN,100.74025833062706,83.31650169451163,0.32022092399821156,0.38972714334298075,0.0695062193447692,271486032,264507373.8,59.11667243513057,36.305568367428286,NaN,NaN,4.799825304258343,0.49272958972223446
2015-04-17T09:30:00-04:00,179.27,179.41,177.16,177.94,8683455,5206022.3,45.81617461872393,50.99209635097875,NaN,NaN,-39.809338099874466,59.76710480311082,0.1265867180784805,0.22773961694286982,0.10115289886438933,262802577,264711643.6,59.448508367182946,38.20476756696083,NaN,NaN,2.8369469097869118,0.8276177783029026
2015-04-20T09:30:00-04:00,179.31,180.611,179.149,180.03,5355793,5173852,52.8480874646873,51.102453000632586,NaN,NaN,56.52889580374553,56.778722531937845,0.13104138989800354,0.26495463623689375,0.1339132463388902,268158370,266658715,62.56732893394289,40.497552750137984,NaN,NaN,3.3036909861710333,1.1813425222840641
2015-04-21T09:30:00-04:00,180.7,180.88,178.97,179.26,3596594,5173987.5,50.260133330104885,51.37564585569549,NaN,NaN,51.165241551108885,55.169721832266475,0.07660362305437202,0.22966777515685521,0.1530641521024832,264561776,266924186.8,62.98533118817186,42.97754097945521,NaN,NaN,2.8816158372241394,1.4242387101326464
2015-04-22T09:30:00-04:00,179.65,180.25,178.55,180.06,5575238,5218143.75,52.84387650076515,51.98355472557738,NaN,NaN,49.487404479779556,43.622492413077325,0.08812607132639766,0.26322174126048026,0.1750956699340826,270137014,267429153.8,63.813098906741224,45.648869043327124,NaN,NaN,3.3189441335540693,1.6949109134785638
2015-04-23T09:30:00-04:00,179.44,181.07,179.2,180.37,4893032,5039059.45,53.84439599246892,52.53127232284459,NaN,NaN,76.68546188586738,38.81153312412539,0.1089155663795037,0.3112401279084622,0.20232456152895853,275030046,268137956.6,64.99639782486415,48.384072864278664,NaN,NaN,3.9689995013848103,2.019780711750885
2015-04-24T09:30:00-04:00,180.5,180.82,179.7901,180.54,4009959,4909333.85,54.41557969143069,52.84773788725947,NaN,NaN,80.6776905615931,62.9089388564189,0.12524093359719107,0.35887572852544736,0.23363479492825628,279040005,271385442.2,69.859371041353,51.348771811491595,NaN,NaN,4.663197610743305,2.3974116973212305
2015-04-27T09:30:00-04:00,181.46,181.54,179.96,180.17,4969123,4959198.95,52.88168983122989,53.09097594259013,NaN,NaN,85.25705864051022,68.65457142377184,0.10316548136339115,0.3625916466324952,0.25942616526910406,274070882,272567944.6,71.4165661122471,54.56316302343657,NaN,NaN,4.830668468389546,2.745019807473847
2015-04-28T09:30:00-04:00,180.36,180.94,178.88,180.84,4534159,4915942.45,55.33684034618688,53.434402458256116,NaN,NaN,57.33594008228218,69.8887111300065,0.12431360649904988,0.4148181733929164,0.2905045668938665,278605041,275376597.6,74.75299121541529,57.98024464213238,NaN,NaN,5.64607217973652,3.1594558606542287
2015-04-29T09:30:00-04:00,179.8,180.71,179.24,180.07,6559412,5012225.05,51.984392761177446,53.38882714413741,NaN,NaN,39.31522691419998,67.85427561689059,0.07926404113211938,0.3895846183090157,0.3103205771768963,272045629,275758320.6,75.17707806400338,60.881705206213574,NaN,NaN,5.436729139826026,3.484780614821628
2015-04-30T09:30:00-04:00,179.7,180.02,177.45,178.18,8564574,5068426.95,44.80867280173013,52.615199468081514,NaN,NaN,-79.29653063728308,36.65787711226049,-0.07657182378104671,0.21460579745058794,0.29117762123163465,263481055,273448522.4,67.7600644285018,62.772228588568844,NaN,NaN,3.0944687795449166,3.429021781210669
2015-05-01T09:30:00-04:00,179.21,180.01,178.98,179.9,3895734,5102031.75,51.385409622070554,52.506386135370576,NaN,NaN,-2.8724514378660952,19.94784871236866,-0.06312093236017113,0.21227645578142074,0.27539738814159187,267376789,271115879.2,61.19391401958104,64.07807958352909,NaN,NaN,3.046649085305956,3.3743971103671386
2015-05-04T09:30:00-04:00,180.34,181.05,180.25,180.44,3256866,4950628.35,53.268200670389746,52.40549781044972,NaN,NaN,86.43628381976247,20.183693748219092,-0.019430477585348327,0.25110929115990643,0.27053976874525476,270633655,270428433.8,59.36806652069711,64.79512399117773,NaN,NaN,3.5796047036311833,3.403712480833431
2015-05-05T09:30:00-04:00,180.23,180.59,178.78,179.01,5316273,4915864.2,47.96995857943359,51.764617382955024,NaN,NaN,-42.55453237835109,0.2055992560924352,-0.08475328790429115,0.16459815886489082,0.24935144676918197,265317382,267770902,52.80836694805903,64.66169685756367,NaN,NaN,2.390372703465151,3.258949655495105
2015-05-06T09:30:00-04:00,179.87,180.25,177.25,178.39,7534180,5055647.5,45.84104226461056,50.96460389107217,NaN,NaN,-137.14944435585815,-35.08733499791919,-0.16309369360911852,0.045484329757783826,0.20857802336690234,257783202,264918416.6,46.82753029177019,63.783900990180776,NaN,NaN,0.7570568271172244,2.9015363942982653
2015-05-07T09:30:00-04:00,178.12,179.7,177.89,179.28,4142787,5038599.2,49.31819914451279,51.2147485000571,NaN,NaN,-98.66249253660044,-38.96052737778266,-0.14875014650777274,0.022640340232186418,0.17139048673995916,261925989,264607403.4,46.21297186668595,62.83850552585956,NaN,NaN,0.42365818880687495,2.547553793513781
2015-05-08T09:30:00-04:00,181.14,182.02,181.08,181.85,5529586,5141899.95,57.75304579572686,51.56510266655992,NaN,NaN,179.2603810228724,-2.5339608856349627,0.030486701071919253,0.2094988630798582,0.17901216200793896,267455575,264623160.6,46.25145881829122,61.67308623188445,NaN,NaN,2.922173573007775,2.601070904870066
2015-05-11T09:30:00-04:00,181.77,182,180.88,181.08,3753561,5161667.25,54.80980563741906,51.890079259939505,NaN,NaN,126.5231813047816,5.483418611368864,0.09045910064281543,0.29208603781145825,0.20162693716864283,263702014,263236832.4,43.31486029429526,60.268052596607546,NaN,NaN,4.006716816608673,2.801877463689867
2015-05-12T09:30:00-04:00,180.1,181.23,179.2698,180.72,4742796,5158236.85,53.43860077544225,51.932559565273586,NaN,NaN,37.97769727626076,21.589864542291235,0.09849407002979932,0.324744524705892,0.22625045467609267,258959218,261965199.6,40.75852427506391,58.62129726577344,NaN,NaN,4.457339293449982,3.038372010798455
2015-05-13T09:30:00-04:00,180.85,181.44,180.48,180.75,3851383,5131917.9,53.54290444181229,51.9110244545124,NaN,NaN,82.38633911129908,65.49702123572268,0.09821885898029303,0.34902402840145896,0.25080516942116593,262810601,262970679.4,43.59323363072677,57.09249982333506,NaN,NaN,4.848927881086821,3.2970228494110785
2015-05-14T09:30:00-04:00,181.81,182.64,181.729,182.54,4921430,5184296.75,59.38862093024927,52.26624168585658,NaN,NaN,188.57732706709052,122.94498515646087,0.20484464251797246,0.5068609725686315,0.30201633005065903,267732031,264131887.8,46.76155710853907,55.442655970991204,NaN,NaN,7.004440009258621,3.8266538722464416
2015-05-15T09:30:00-04:00,182.24,182.51,181.89,182.48,4522151,4976231.55,59.120084234435815,52.71184128608557,NaN,NaN,169.08660917441512,120.91023078676942,0.25435483824387844,0.6199598778555071,0.36560503961162866,263209880,263282748.8,44.78074654258096,53.54009743030077,NaN,NaN,8.6587223818895,4.516949373624021
2015-05-18T09:30:00-04:00,182.43,183.01,182.19,182.68,2890503,4852967.05,59.7730359781545,53.02871240265468,NaN,NaN,164.4566448277295,128.49692349135898,0.28148355023607324,0.7174594774067202,0.435975927170647,266100383,263762422.6,46.16797064204579,51.49831024648866,NaN,NaN,10.20822529704598,5.3299887912557296
2015-05-19T09:30:00-04:00,182.92,183.2832,182.37,182.93,2766587,4811466.7,60.61976432817034,53.645524657439886,NaN,NaN,152.61378013140353,151.42414006238755,0.29571117515628054,0.8056148961159977,0.5099037209597171,268866970,265743973,51.57960259260749,49.81277628424609,NaN,NaN,11.739448059898972,6.245625829633336
2015-05-20T09:30:00-04:00,183.23,183.35,182.556,182.71,5080776,4786743.6,59.43418528671499,54.69020412065309,NaN,NaN,129.77858444602873,160.90258912933348,0.2704385254483065,0.8479518777701003,0.5775133523217938,263786194,265939091.6,52.09032970556301,48.693509518321896,NaN,NaN,12.724756342252308,7.171215902864617
2015-05-21T09:30:00-04:00,182.62,183.04,182.36,182.79,2724231,4678303.55,59.74251466175543,55.28714019491629,NaN,NaN,105.26966795672165,144.24105730725972,0.24026161795134793,0.8778403747609786,0.6375787568096307,266510425,265694770.4,51.35981132302035,47.99107361142471,NaN,NaN,13.635783281516295,8.094725528386284
2015-05-22T09:30:00-04:00,182.51,182.74,182.04,182.26,2357025,4595656.85,56.66943278312218,55.53008534582575,NaN,NaN,74.7688468470454,125.37750484178578,0.16911636028344268,0.8489742071639341,0.6798578468804914,264153400,265883474.4,51.92064912021264,47.45911522567581,NaN,NaN,13.653933888982206,8.88889815132856
2015-05-26T09:30:00-04:00,181.93,181.93,179.79,180.37,5529694,4623685.4,47.32142500666962,55.48376151919975,NaN,NaN,-13.655389001724492,89.75509807589496,-0.011154986799655986,0.6659141133809214,0.6770691001805774,258623706,264388139,47.26945162997801,47.063478417241456,NaN,NaN,10.963005070842993,9.18519913983062
2015-05-27T09:30:00-04:00,180.77,181.79,180.45,181.52,3588152,4576385.05,52.46007898612366,55.95654985645069,NaN,NaN,13.644469409017374,61.96123593141774,-0.05634320822912531,0.6066400898941708,0.6629832981232961,262211858,263057116.6,43.531293476858046,46.828032930462015,NaN,NaN,10.091920175135927,9.314730716302808
2015-05-28T09:30:00-04:00,181.11,181.33,180.65,181.29,3660851,4431457,51.38056344784179,56.103861592402765,NaN,NaN,1.8607403698201914,36.37766711617603,-0.10243506075637665,0.5349394721778253,0.637374532934202,258551007,262010079.2,40.79805172920451,46.44125292064191,NaN,NaN,9.06389502786208,9.278897046525561
2015-05-29T09:30:00-04:00,181.17,181.19,179.67,180.11,4923650,4249410.8,46.135247343629814,55.2740188458244,NaN,NaN,-50.79676764682158,5.164379995467376,-0.20707039107963898,0.3785365440846533,0.5856069351642923,253627357,259433465.6,34.97781173598021,45.63599241476255,NaN,NaN,6.570868449537999,8.89203581838448
2015-06-01T09:30:00-04:00,181,181.15,179.81,180.4,4349016,4272074.9,47.55234427710272,54.75562874865896,NaN,NaN,-47.107613098710246,-19.21091199368375,-0.24863056107330928,0.27481873382265576,0.523449294895965,257976373,258198060.2,32.5780329457389,44.86907617557995,NaN,NaN,4.91573513070487,8.323992863001678
2015-06-02T09:30:00-04:00,180.08,180.96,179.27,180.15,5106238,4364543.5,46.418603790686184,54.25420039260494,NaN,NaN,-65.20031915360974,-29.5198980240608,-0.2823726488753751,0.17048348380174616,0.45285613267712127,252870135,257047346,30.480343956092412,44.134920438510555,NaN,NaN,3.2168178589498586,7.594396433851418
2015-06-03T09:30:00-04:00,180.85,181.74,180.122,180.88,5481944,4372827.05,50.155623804321124,54.01225177564129,NaN,NaN,-21.796410955082308,-36.608074096880735,-0.24626080329622496,0.14503012855684005,0.391290931853065,258352079,256275390.2,29.125470197535904,43.101508764711205,NaN,NaN,2.7830934024104494,6.90706742935985
2015-06-04T09:30:00-04:00,180.18,180.92,178.78,179.21,7312454,4361740.75,42.80124357728264,52.82743910757225,NaN,NaN,-116.89094859276402,-60.35841188939757,-0.3208600231647789,-0.009784097102908618,0.3110759260618703,251039625,254773113.8,26.643417533235905,41.6644987950467,NaN,NaN,0.11019005776543424,5.936084947703505
2015-06-05T09:30:00-04:00,179.08,179.46,178.25,178.5,5228735,4416038.15,40.10853238725486,51.469471118487895,NaN,NaN,-177.96727943279936,-85.79251424659313,-0.398943917490279,-0.18760397080097846,0.21133994668930053,245810890,253209820.4,24.320733918699347,40.20306932191229,NaN,NaN,-2.9747793734768635,4.663104330392024
2015-06-08T09:30:00-04:00,178.51,178.6,177.68,177.81,4380541,4358585.9,37.630811419966776,49.887883650045914,NaN,NaN,-190.16926336163044,-114.40484429917717,-0.4729330243255906,-0.3798263337176877,0.09310669060790287,241430349,249900615.6,20.288715461351757,38.35455109471986,NaN,NaN,-6.3395253398858955,3.0913000917808926
2015-06-09T09:30:00-04:00,177.82,178.26,177.2,177.71,4722423,4407029,37.27145323250844,48.22014714321292,NaN,NaN,-175.37787642058203,-136.44035575257163,-0.5017466347703752,-0.5340766028550661,-0.03232996808469092,236707926,246668173.8,17.275866109749998,35.90428420308718,NaN,NaN,-9.172238243095729,1.3393660439413755
2015-06-10T09:30:00-04:00,178.38,180.54,178.38,180.06,5480858,4443932.1,49.48081228840007,47.509191929047574,NaN,NaN,-64.88263863388948,-145.05760128833305,-0.34323780377381286,-0.46137722280195703,-0.11813941902814415,242188784,243435514.8,14.893854677501395,33.247393129654206,NaN,NaN,-7.920847358577082,0.016478415010167335
2015-06-11T09:30:00-04:00,180.69,181.26,180.39,180.64,3714802,4437103.05,51.96579331163674,46.953711832610516,NaN,NaN,-5.7634426851141285,-122.8321001068031,-0.18780314693743405,-0.3528933526999367,-0.16509020576250266,245903586,242408307,14.222778893640964,30.594747956127105,NaN,NaN,-6.100579767040294,-0.8573870395684701
2015-06-12T09:30:00-04:00,179.86,180.06,178.72,179.13,4566750,4419369.05,45.667694860326016,46.16787340955365,NaN,NaN,-75.48092696932842,-102.33482961410888,-0.17539434048131328,-0.38433313136414426,-0.208938790882831,241336836,241513496.2,13.645976993830658,27.86084280424268,NaN,NaN,-6.581695721771279,-1.6751454227402998
2015-06-15T09:30:00-04:00,177.89,178.37,177.11,178.1,5502666,4468394.8,41.93428171078918,45.7830774598479,NaN,NaN,-133.85618131705232,-91.07221320519326,-0.2222496184983314,-0.48675081400574527,-0.26450119550741386,235834170,240394260.4,12.93913471656468,25.408677310427443,NaN,NaN,-8.218825074916518,-2.6099568016226167
2015-06-16T09:30:00-04:00,178.07,179.36,177.88,179.21,3276912,4487715.25,46.96605783810244,45.390647377846385,NaN,NaN,-77.19511568858162,-71.43566105879319,-0.1667178930218427,-0.47289856178471723,-0.30618066876287453,239111082,240874891.6,14.9758724830957,23.36900438230156,NaN,NaN,-7.9191708680193695,-3.36841595396501
2015-06-17T09:30:00-04:00,179.66,180.14,178.49,179.48,3650922,4531932,48.143210004392486,45.159407846171426,NaN,NaN,-42.201328958609864,-66.89939912373727,-0.10314989593788598,-0.435118038685232,-0.33196814274734604,242762004,240989535.6,15.483770253809325,21.560841419773332,NaN,NaN,-7.309542625297552,-3.9314340498696585
2015-06-18T09:30:00-04:00,180.21,181.94,180.14,181.33,6542767,4605031.55,55.44122261107263,45.82412036527449,NaN,NaN,64.19589936008904,-52.90753071469665,0.0631897493627348,-0.25298095604392756,-0.31617070540666237,249304771,241669772.6,18.591184565584072,20.39036805045932,NaN,NaN,-4.309610762947393,-3.9854592945950493
2015-06-19T09:30:00-04:00,180.64,180.74,179.73,179.76,3964046,4667022.3,49.122980082366865,45.93630863707907,NaN,NaN,10.607419916625323,-35.689861337505896,0.06682444120079928,-0.23264015390566328,-0.29946459510646256,245340725,242470550.4,22.21679659383912,19.650279739609335,NaN,NaN,-3.894324357904775,-3.97244001792501
2015-06-22T09:30:00-04:00,181.03,181.5,180.67,180.92,4048305,4751586.3,53.35289122902918,46.431614882675,NaN,NaN,82.68601667548796,7.618578261002159,0.14235819957862528,-0.12151684563318099,-0.26387504521180627,249389030,245181522.4,33.08227282820478,19.836131801903072,NaN,NaN,-2.106512386720748,-3.7058789277529725
2015-06-23T09:30:00-04:00,181.12,181.57,180.75,181.12,3116753,4630939.25,54.06204099746558,46.71064468218532,NaN,NaN,87.42389519379542,40.54238043747757,0.19740787512152017,-0.01711520130990607,-0.21452307643142624,252505783,247860462.6,41.74264185494869,20.73735834886113,NaN,NaN,-0.4816080182056118,-3.2452687978176353
2015-06-24T09:30:00-04:00,180.56,180.97,179.39,179.41,4328936,4667978.45,47.423701209801855,47.040820227365266,NaN,NaN,8.576787104846959,50.69800365016893,0.1143910590582265,-0.0715342526086431,-0.1859253116668696,248176847,248943431.2,44.84991161001662,22.037822211488326,NaN,NaN,-1.2577648806723645,-2.9613396667968823
2015-06-25T09:30:00-04:00,180.05,180.12,178.59,178.65,3602699,4665070.85,44.79123821845095,47.37529921530785,NaN,NaN,-44.41588549540573,28.975646679069975,0.00955477978966876,-0.17398183692978364,-0.1835366167194524,244574148,247997306.6,42.706811432883676,23.35111346250149,NaN,NaN,-2.7446251929484777,-2.9303804562471103
2015-06-26T09:30:00-04:00,179.21,179.83,178.68,179.13,4855548,4661665.75,46.79983220954133,48.03022927170603,NaN,NaN,-33.57697753625188,20.13876718849453,-0.024349699451669093,-0.21397374103403877,-0.18962404158236967,249429696,248815100.8,45.14666785439693,25.126681490576143,NaN,NaN,-3.3244206778383036,-2.9866719164744238
2015-06-29T09:30:00-04:00,177.6,178.21,175.59,175.64,8888666,4888648.25,36.42367045863512,47.9696733592865,NaN,NaN,-200.62526005644648,-36.52348815789236,-0.2653187992525717,-0.5212725406480843,-0.2559537413955126,240541030,247045500.8,41.07088442607384,26.826325656027848,NaN,NaN,-7.625854707384559,-3.6494123151758715
2015-06-30T09:30:00-04:00,177,177.01,175.45,175.82,9149750,5090823.85,37.197070341727866,47.092263220238486,NaN,NaN,-188.13295647571852,-91.63485849179514,-0.38862445189498895,-0.7417343062642487,-0.3531098543692598,249690780,246482500.2,39.83860842986318,28.608093781196544,NaN,NaN,-10.653899892440577,-4.6500533976422584
2015-07-01T09:30:00-04:00,177.57,177.82,176.58,177.4,4135129,5023483.1,43.674236036987686,46.50000912919212,NaN,NaN,-104.0680444906211,-114.16382481088877,-0.3414865662325538,-0.7799680621599521,-0.43848149592739827,253825909,247612312.6,43.50204617470341,30.69947001555815,NaN,NaN,-11.037069678654824,-5.562484294929767
2015-07-02T09:30:00-04:00,177.79,178.05,176.65,177.05,4008581,4858289.45,42.625490480320366,46.28270881633458,NaN,NaN,-92.1908893709253,-123.71882558599268,-0.3123787928667695,-0.8289549870108601,-0.5165761941440906,249817328,248660948.6,46.74354808064226,33.06358223604469,NaN,NaN,-11.673659643349001,-6.435509344703943
2015-07-06T09:30:00-04:00,175.59,177.14,175.34,176.68,3748675,4784286.45,41.4912129952475,46.251061050938745,NaN,NaN,-120.01881044387908,-141.0071921675181,-0.29666220098505613,-0.8874039453754108,-0.5907417443903547,246068653,247988740,44.96268794341557,35.35097889510547,NaN,NaN,-12.53256059602955,-7.306516666321887
2015-07-07T09:30:00-04:00,176.88,177.73,174.44,177.63,7783801,4954449.45,45.50120396816402,46.146428631657436,NaN,NaN,-99.85213935864952,-120.85256802795872,-0.2052473625401735,-0.8473009475655715,-0.642053585025398,253852454,250651024.8,52.655921812343905,38.04241099005177,NaN,NaN,-12.039032142652397,-7.9825903057976735
2015-07-08T09:30:00-04:00,176.11,176.44,174.78,175,6849409,5060798.75,37.78123909501251,45.406287852416014,NaN,NaN,-136.49007459855304,-110.52399165252564,-0.29917788276611335,-1.0160259384830397,-0.7168480557169263,247003045,250113477.8,51.10266980812391,40.58661810107424,NaN,NaN,-14.154056796303752,-8.86422837586997
2015-07-09T09:30:00-04:00,177.15,177.47,175.21,175.26,4581356,5015823.65,38.8851685895057,44.22371256516123,NaN,NaN,-98.30003730739159,-109.37039021587972,-0.3192403546422359,-1.1158984990197212,-0.7966581443774853,251584401,249665176.2,49.78374275526635,42.81465797176583,NaN,NaN,-15.472463081275484,-9.808261905213616
2015-07-10T09:30:00-04:00,177.22,177.8,176.62,177.41,4504366,5055301.85,47.22401744000565,44.088072376421145,NaN,NaN,-41.3960318273377,-99.21141870716221,-0.17060905898788659,-1.0099194681123436,-0.839310409124457,256088767,250919464,53.40707960812276,45.04253532992895,NaN,NaN,-13.867010048889972,-10.388083068595952
2015-07-13T09:30:00-04:00,178.83,179.7,178.7999,179.6,3873839,5020656.3,54.09487570452459,44.141071267527956,NaN,NaN,44.03419635398795,-66.40081734758881,0.07890628300223645,-0.7406775553716614,-0.8195838383738978,259962606,253698254.6,60.25004466333716,46.98309046100984,NaN,NaN,-10.071707237630124,-10.342886521315119
2015-07-14T09:30:00-04:00,179.45,180.54,179.31,180.33,2757062,4883376.1,56.14444543300439,44.289814441495025,NaN,NaN,65.63871662862353,-33.30264615013421,0.2852201517013183,-0.4630586487472499,-0.7482788004485682,262719668,255471697.4,63.89458513346103,48.56537212376072,NaN,NaN,-6.369095675493537,-9.77520211476918
2015-07-15T09:30:00-04:00,180.32,180.72,179.9,180.34,3407912,4889926.1,56.17331245620215,44.91478667338076,NaN,NaN,70.13321084584868,8.022010938746144,0.40704206760995687,-0.23947621593612212,-0.646518283546079,266127580,259296604.4,70.23358860762485,50.37849190930416,NaN,NaN,-3.4773943440066257,-8.875515290374528
2015-07-16T09:30:00-04:00,181.2,181.25,180.5,181.07,2495097,4832134.85,58.32962800725075,45.88181451543789,NaN,NaN,87.20557518410592,45.123133437045645,0.5145409449980715,-0.0033421022984896354,-0.5178830472965611,268622677,262704259.6,74.52484897403808,52.65120887652948,NaN,NaN,-0.4173384002489281,-7.667204306070871
2015-07-17T09:30:00-04:00,180.49,180.615,180.01,180.54,2762340,4643113.5,56.16886561110472,46.551031186978136,NaN,NaN,69.69955809619944,67.34225142175308,0.5258441512338637,0.1394221417457686,-0.38642200948809513,265860337,264658573.6,76.60768451702057,54.898424352431164,NaN,NaN,1.487226320307416,-6.359428502302544
2015-07-20T09:30:00-04:00,180.95,181.1,180.36,180.69,2961630,4592992.7,56.65822126447337,47.996356244538006,NaN,NaN,79.45441081871776,74.42629431469902,0.5184587478707114,0.2616514253502942,-0.25680732252041727,268821967,266430445.8,78.33701960741294,57.56029115109824,NaN,NaN,3.183701355537168,-4.996124236896871
2015-07-21T09:30:00-04:00,179.69,179.71,178.43,178.97,5026714,4641913.15,49.79331223135973,48.896087808083145,NaN,NaN,22.66585767417205,65.83172252380874,0.379226137418733,0.21722534925299897,-0.16200078816573402,263795253,266645562.8,78.54440280685247,60.32499074945462,NaN,NaN,2.694798001166702,-3.8974210600306467
2015-07-22T09:30:00-04:00,178.43,178.92,177.84,178.3,3811491,4676650.05,47.38483649096255,49.16113069765277,NaN,NaN,1.8461214703066609,52.17430464870033,0.23079726931101133,0.12649579847303016,-0.10430147083798116,259983762,265416799.2,74.17624331938484,62.51600483121758,NaN,NaN,1.575339455720556,-3.1155981292090464
2015-07-23T09:30:00-04:00,178.33,178.33,176.83,177.16,4968571,4708631.8,43.52699256995059,49.225523704054936,NaN,NaN,-31.689766526350642,28.395236306609007,0.05386491594251741,-0.0369703259098344,-0.09083524185235181,255015191,262695302,65.48910851597842,63.854973433741584,NaN,NaN,-0.5536753305025266,-2.749609157965258
2015-07-24T09:30:00-04:00,177.23,177.25,175.31,175.52,4591323,4758063,38.651731263037945,49.02270358032569,NaN,NaN,-82.83247398144522,-2.1111701089199273,-0.16368938440072744,-0.2954469723532611,-0.13175758795253367,250423868,259608008.2,57.292003677195595,64.73563884329731,NaN,NaN,-3.9744297055081765,-2.9245835218999607
2015-07-27T09:30:00-04:00,174.47,174.78,173.7801,174.23,5370195,4783795.35,35.30228792524707,48.29420957726019,NaN,NaN,-138.65309770192854,-45.732671813049194,-0.37259091466026,-0.5974962312778587,-0.22490531661759866,245053673,254854349.4,47.444765458986126,64.36341338948604,NaN,NaN,-7.9727051642597955,-3.645743756522794
2015-07-28T09:30:00-04:00,174.86,176.28,174.3,176.11,5625920,4620658.05,43.048064949942834,48.67041142404093,NaN,NaN,-83.81392736104618,-67.02862882009283,-0.36196688848981096,-0.6773639272298624,-0.3153970387400514,250679593,252231217.4,43.04784443434861,63.788068719930656,NaN,NaN,-8.966516913007698,-4.405854207449209
2015-07-29T09:30:00-04:00,176.33,177.56,176.17,177.26,4175936,4371967.35,47.21139577123259,49.265141937021426,NaN,NaN,-30.928200492722024,-73.58349321269857,-0.2600673243026965,-0.6404811941184221,-0.38041386981572556,254855529,251205570.8,41.43107229318462,63.191449401210534,NaN,NaN,-8.441204763450367,-4.982332858306517
2015-07-30T09:30:00-04:00,177.04,177.39,176.13,177.22,3658968,4348159.3,47.08247036365947,49.25503143156812,NaN,NaN,-33.237049724394595,-73.89294985230735,-0.1816500386281863,-0.6074764181009584,-0.42582637947277213,251196561,250441844.8,40.219745725224534,62.24949698100351,NaN,NaN,-8.066870209804588,-5.42298105137767
2015-07-31T09:30:00-04:00,177.67,177.73,176.49,176.68,4483781,4371919.3,45.28459089343776,48.62572537363335,NaN,NaN,-30.398625869579583,-63.406180229934236,-0.1535565686183148,-0.6177720902456656,-0.4642155216273508,246712780,249699627.2,39.02558483066539,60.73346413581267,NaN,NaN,-8.285419331428436,-5.831900805670637
2015-08-03T09:30:00-04:00,176.82,176.871,174.735,175.75,4530494,4411010.25,42.28951450734921,47.636087450372266,NaN,NaN,-74.03431902470224,-50.482424494488924,-0.18301669986062852,-0.6929863964531364,-0.5099696965925079,242182286,249125349.8,38.08340361706295,58.88980831321281,NaN,NaN,-9.356412146629332,-6.335402425807593
2015-08-04T09:30:00-04:00,175.79,176.13,174.8277,175.32,4055667,4224603.55,40.941209000997894,46.54808006071482,NaN,NaN,-83.29678513747145,-50.37899604977398,-0.21468000062067039,-0.7783196973683459,-0.5636396967476756,238126619,246614755,34.19647998832083,56.31572912611966,NaN,NaN,-10.634522588978438,-6.949562449117714
2015-08-05T09:30:00-04:00,175.84,176.52,175.032,175.36,4565463,4110406.25,41.12924087043942,45.31948097951401,NaN,NaN,-76.24121776496764,-59.4415995042231,-0.2155807616639629,-0.8331156488276292,-0.6175348871636663,242692082,244182065.6,30.9049828614351,53.200024403790884,NaN,NaN,-11.631309788876615,-7.618383497654699
2015-08-06T09:30:00-04:00,175.48,175.65,173.65,174.22,5374136,4150045.25,37.46793345443206,43.98370011118025,NaN,NaN,-112.11938618145606,-75.2180667956354,-0.27196643054141256,-0.9574929253404321,-0.6855264947990195,237317946,241406342.6,27.636344869963494,49.70207157185822,NaN,NaN,-13.55797406529217,-8.466896435888623
2015-08-07T09:30:00-04:00,173.89,174.12,172.8,173.84,6158423,4232748.1,36.30769408539589,42.53009102696042,NaN,NaN,-128.3091149778933,-94.80016461729812,-0.3110518437827874,-1.0743412995275037,-0.7632894557447163,231159523,238295691.2,24.508054499500076,45.8571454927216,NaN,NaN,-15.503952412896957,-9.472190146889814
2015-08-10T09:30:00-04:00,174.8,176.32,174.8,176.19,4504031,4264257.7,47.19731607885816,42.344662730353164,NaN,NaN,-50.40013524018145,-90.07332786039396,-0.16231369771189375,-0.9661815778845835,-0.8038678801726897,235663554,236991944.8,23.316754827734343,41.91231349421316,NaN,NaN,-14.02678360968881,-10.122846355861098
2015-08-11T09:30:00-04:00,174.59,174.89,173.58,174.11,6761080,4464458.6,40.58345582634134,41.858849825737366,NaN,NaN,-98.05448803602701,-93.02486844010508,-0.1859907877687299,-1.036356364883602,-0.8503655771148722,228902474,235147115.8,21.70872472549796,38.16463359464981,NaN,NaN,-14.854708646211057,-10.79882668305395
2015-08-12T09:30:00-04:00,172.83,174.4,171.4,174.21,8825602,4735343.1,41.01143916329321,41.679167439547555,NaN,NaN,-117.82784586197293,-101.34219405950614,-0.17694679765702348,-1.0715490741861515,-0.894602276529128,237728076,234154314.6,20.87440773053258,34.97786925283226,NaN,NaN,-15.374430048122973,-11.452484306635238
2015-08-13T09:30:00-04:00,173.99,174.97,173.55,174.31,6562745,4938725.5,41.46550209917605,41.88015107070027,NaN,NaN,-78.96150421881819,-94.71061766697856,-0.14746467176996658,-1.0789331162415863,-0.9314684444716197,244290821,235548889.6,25.22186832426098,32.68714529905121,NaN,NaN,-15.660643617929576,-12.05364992253443
2015-08-14T09:30:00-04:00,174.17,175.08,174.06,174.9,3512236,4976220.3,44.19485197592825,42.515334217177504,NaN,NaN,-58.83459512817164,-80.81571369703424,-0.0751110630006675,-1.025357273222454,-0.9502462102217866,247803057,238877596.4,34.47603283067431,31.760807254171798,NaN,NaN,-15.11866033850929,-12.49150855338798
2015-08-17T09:30:00-04:00,174.24,175.73,173.62,175.7,4055384,5030908,47.752289159827036,42.85135023216923,NaN,NaN,-37.06137140253098,-78.14796092950414,0.03389356765794249,-0.9078792506493585,-0.941772818307301,251858441,242116573.8,41.997865061161164,31.685808727515546,NaN,NaN,-13.62281194174566,-12.653123323153363
2015-08-18T09:30:00-04:00,175.28,175.93,175.08,175.33,4050444,4982094.5,46.28275856509188,42.78501900315918,NaN,NaN,-4.028086567713288,-59.3426806358414,0.08541222896442491,-0.8350075321017698,-0.9204197610661947,247807997,245897678.4,49.312899344395994,32.24879637403065,NaN,NaN,-12.778082574141958,-12.670974644723161
2015-08-19T09:30:00-04:00,174.33,175.49,173.12,173.74,10988714,5340955.65,40.51298507240589,42.31577005378392,NaN,NaN,-81.15069690072418,-52.00725084359165,0.02014688340854809,-0.8952361568055096,-0.9153830402140577,236819283,245715919.8,48.99303363952979,32.875459796481024,NaN,NaN,-13.720998148304894,-12.820978002377695
2015-08-20T09:30:00-04:00,172.25,172.55,170.22,170.22,12317188,5708386.5,31.230756561824364,41.311924744382964,NaN,NaN,-245.12324817018762,-85.23959963386554,-0.23810910789721507,-1.2130194250855766,-0.9749103171883615,224502095,241758174.6,42.524783614194085,33.12540256673308,NaN,NaN,-17.923042813032865,-13.549844403899861
2015-08-21T09:30:00-04:00,167.79,168.67,164.41,164.41,18858721,6421756.4,22.192533608164183,39.87642610872689,NaN,NaN,-380.6651146941677,-149.60570354706473,-0.7493894426178818,-1.9116471204607137,-1.162257677842832,205643374,233326238,32.63825926955944,32.73646368476854,NaN,NaN,-26.00423260869566,-15.329042718870689
2015-08-24T09:30:00-04:00,155.9,163.45,150.565,158.38,35102423,7908367.8,16.76851649879825,38.149805215712625,NaN,NaN,-400.32145257257594,-222.25771978107372,-1.4047902498124352,-2.918245490108376,-1.5134552402959407,170540951,217062740,22.00949265518527,31.86596458954457,NaN,NaN,-35.64490935457821,-18.23130938111462
2015-08-25T09:30:00-04:00,163.33,163.68,156.29,156.49,19356991,8594921.35,15.490575257014456,36.318471957610846,NaN,NaN,-244.78997353255713,-270.4100971740425,-1.8487588544201339,-3.824403808321108,-1.9756449539009742,151183960,197737932.6,15.535554579417663,30.768148283686177,NaN,NaN,-43.06388227025529,-21.778819793849003
2015-08-26T09:30:00-04:00,160.39,162.8999,157.67,162.66,19884253,9380337.2,33.34860461842845,36.024234183610595,NaN,NaN,-158.98179620266987,-285.97631703443164,-1.6183482169269103,-3.9985802250596123,-2.380232008132702,171068213,184587718.6,12.780612323695138,29.707024530381297,NaN,NaN,-40.901749186966605,-24.51066685000866
2015-08-27T09:30:00-04:00,164.86,166.49,163.04,166.45,15223696,9958573.6,41.5229432058935,36.39675197793185,NaN,NaN,-82.86980960534683,-253.52562932146347,-1.1255257386762247,-3.7871391814779827,-2.661613442801758,186291909,176945681.4,11.503903183043263,28.778156579205813,NaN,NaN,-35.586833336799614,-26.092976348121656
2015-08-28T09:30:00-04:00,165.72,166.62,165.24,166.33,8115699,10140169.5,41.350022957386,35.97908818354098,NaN,NaN,-63.268734261859024,-190.04635323500173,-0.7410249357595324,-3.5878946125011737,-2.8468696767416413,178176210,171452248.6,10.678140435614452,27.875398408340114,NaN,NaN,-32.010363539723215,-26.93831737549331
2015-08-31T09:30:00-04:00,165.35,166.18,164.3236,165.18,6363653,10231827.45,39.64606419876164,35.91213163871386,NaN,NaN,-64.82880137980615,-122.9478229964478,-0.5086174758586188,-3.482641521564915,-2.974024045706296,171812557,171706569.8,10.996662697669763,27.110251120638093,NaN,NaN,-29.9594141319134,-27.369902626410465
2015-09-01T09:30:00-04:00,161.4,162.62,159.74,160.46,14266930,10742390.6,33.537455868747145,35.378275689103425,NaN,NaN,-102.95844540689609,-94.58151737131561,-0.6103921776242527,-3.737014267736612,-3.126622090112359,157545627,172978903.2,12.67441023495823,26.52453701381135,NaN,NaN,-30.56207619456567,-27.82592742186121
2015-09-02T09:30:00-04:00,162.93,163.48,161.29,163.46,8260621,10927148.5,39.87817207697727,35.26489497323208,NaN,NaN,-72.52498588085125,-77.29015530695189,-0.4222270141820932,-3.6544058578399756,-3.2321788436578824,165806248,171926510.2,12.465106007140363,25.613339705445593,NaN,NaN,-28.633463161302686,-27.941289670352848
2015-09-03T09:30:00-04:00,164.33,165.49,163.13,163.67,8023710,11059627.2,40.30747517867767,34.9872252019999,NaN,NaN,-50.99756021257649,-70.91570542839784,-0.23928603037030172,-3.5312863816207596,-3.292000351250458,173829958,169434120,11.961313302080242,24.005145453403163,NaN,NaN,-27.05249926389051,-27.8143196122868
2015-09-04T09:30:00-04:00,161.42,161.95,160.24,160.97,8651082,11184260.15,36.68086731612417,34.19640935602112,NaN,NaN,-78.60891716121473,-73.98374200826898,-0.2543735502523363,-3.609967289065878,-3.3555937388135417,165178876,166834653.2,11.441906976408887,21.822577018777995,NaN,NaN,-26.992437980280915,-27.69690795057167
2015-09-08T09:30:00-04:00,163.81,165.03,163.28,164.91,6821684,11300142.8,44.52475511248063,34.07083768083461,NaN,NaN,-35.16068041265007,-68.05011781483775,0.03153846944793681,-3.3161706520036205,-3.3477091214515573,172000560,166872253.8,11.501769929471294,19.121782060569092,NaN,NaN,-24.16019225437054,-27.191662851114366
2015-09-09T09:30:00-04:00,166.53,166.71,162.23,162.52,7865688,11355373.2,41.19134498543037,34.119291960336355,NaN,NaN,-38.34756343153013,-55.127941419764554,0.08708549419114808,-3.238852253712622,-3.32593774790377,164134872,168190102.8,13.70357192301229,16.601106223674982,NaN,NaN,-23.024671712364235,-26.59637840272149
2015-09-10T09:30:00-04:00,162.54,164.5,162.15,163.39,8327015,11330443.85,42.86810862516218,34.95053139343191,NaN,NaN,-40.90994698171159,-48.80493363993662,0.20317943477144063,-3.0719634544394694,-3.27514288921091,172461887,169521230.6,15.977506812871155,14.70487216643763,NaN,NaN,-21.58713456494714,-25.880772140182298
2015-09-11T09:30:00-04:00,162.9,164.44,162.51,164.39,6202293,11312421.25,44.81575946127489,36.56647609722553,NaN,NaN,-30.559337858391494,-44.71728916909963,0.3589703822738315,-2.8264299113686207,-3.185400293642452,178664180,170488075,17.674350690625147,13.63602155365661,NaN,NaN,-19.822410772257676,-25.015291944764495
2015-09-14T09:30:00-04:00,164.46,164.58,163.37,163.77,4595558,11366587.35,43.818369290646615,38.498608439500416,NaN,NaN,-23.06331374550702,-33.60816848595809,0.4272730442577255,-2.651308988320295,-3.0785820325780207,174068622,172266024.2,20.840257589948052,13.552504763282522,NaN,NaN,-18.693859811919513,-24.112230211500925
2015-09-15T09:30:00-04:00,164.36,166.53,163.97,166.11,6516059,11489621.1,48.478830399808544,40.85491237827142,NaN,NaN,18.025504968357712,-22.970931409756524,0.6250856486063365,-2.2972249718201,-2.9223106204264364,180584681,173982848.4,23.88414959679831,14.148832978809711,NaN,NaN,-16.30789015912781,-22.997324489733337
2015-09-16T09:30:00-04:00,166.46,167.65,166,167.51,5511661,11562681.95,51.09282100402027,42.1223564058137,NaN,NaN,71.00736794025896,-1.099945135398687,0.8322896115912553,-1.8819486059373673,-2.7142382175286226,186096342,178375142.4,31.175655180774,15.4627646114582,NaN,NaN,-13.531906348877957,-21.64512189818257
2015-09-17T09:30:00-04:00,167.42,169.44,166.48,166.81,14269959,11726744.2,49.73410922572656,42.7088682643732,NaN,NaN,106.97152849893429,28.476349960730488,0.8986038717037714,-1.5909833778989082,-2.4895872496026796,171826383,178248041.6,31.082864425781395,16.861261843082353,NaN,NaN,-11.630439124161928,-20.214452930465335
2015-09-18T09:30:00-04:00,164,165.24,163.2,163.54,10400516,11630910.6,43.865622210283384,42.888553925294445,NaN,NaN,13.153028717809697,37.218823275970735,0.7070753964448966,-1.605743004046559,-2.3128184004914556,161425867,174800379,28.59650856112104,18.141145280618538,NaN,NaN,-11.682395922099724,-18.99558764355596
2015-09-21T09:30:00-04:00,164.67,165.56,163.67,164.9,7762555,11076102.3,46.683420634057924,43.39122224210132,NaN,NaN,39.99163730193547,49.829813485459226,0.6578405446786211,-1.4905177196431794,-2.1483582643218004,169188422,173824339,27.915710237733222,19.349648676337356,NaN,NaN,-10.891225695848433,-17.837821651026314
2015-09-22T09:30:00-04:00,162.62,163.36,161.98,163,8979562,9769959.25,43.40531252432901,44.09606914607145,NaN,NaN,-43.136456495329625,37.59742119272177,0.4908286160038533,-1.534822494316984,-2.0256511103208372,160208860,169749174.8,25.216411632092687,20.245505918989817,NaN,NaN,-11.191478810075669,-16.888344102319078
2015-09-23T09:30:00-04:00,163.26,163.38,161.88,162.59,4554870,9029853.2,42.708383305753465,44.298227090984035,NaN,NaN,-66.12869783990939,10.170208036688095,0.352720959907288,-1.5847499104367273,-1.9374708703440153,155653990,163660704.4,21.821458432517105,20.91381680651673,NaN,NaN,-11.636174617377867,-16.138034175898905
2015-09-24T09:30:00-04:00,161.12,162.24,159.93,161.87,8451838,8458232.45,41.44974492639964,44.379817787249884,NaN,NaN,-128.48173092934695,-36.920443848968155,0.21938237523936577,-1.663242901294808,-1.8826252765341738,147202152,158735858.2,19.530897430155264,21.454501387093522,NaN,NaN,-12.35943206557056,-15.598233874423428
2015-09-25T09:30:00-04:00,163.84,164.43,162.06,162.88,10474628,8220779.05,43.94533451171398,44.898708301220594,NaN,NaN,-38.62284264042303,-47.275618120614695,0.20592732268543412,-1.6252161231773812,-1.8311434458628153,157676780,157986040.8,19.200439046576875,22.008682249248377,NaN,NaN,-12.296665225082586,-15.12658121023188
2015-09-28T09:30:00-04:00,162.04,162.06,159.58,159.79,10013085,8315648.35,38.533935824953964,44.47079263782583,NaN,NaN,-147.7457938980675,-84.8231043606153,0.006196509943226625,-1.823397808433782,-1.8295943183770087,147663695,153681095.4,17.3820288497011,22.428700743550504,NaN,NaN,-13.825495212395317,-14.940711781969513
2015-09-29T09:30:00-04:00,159.98,160.96,159.18,160.23,9906202,8492775.8,39.67310084439045,44.36234662775155,NaN,NaN,-142.79224823240264,-104.75426270802991,-0.07455589110359973,-1.9227891822565084,-1.8482332911529087,157569897,153153302.8,17.167362188882066,22.67611433396977,NaN,NaN,-14.767531942211228,-14.915971804861186
2015-09-30T09:30:00-04:00,162.04,162.75,161.05,162.62,7621395,8160499.05,45.57362451377702,44.55559776265261,NaN,NaN,-59.11431513902605,-103.35138616785324,0.04811261800663269,-1.7880925186446177,-1.8362051366512504,165191292,155060763.2,20.966226398817014,23.03245144725162,NaN,NaN,-13.892914632844237,-14.769820780287336
2015-10-01T09:30:00-04:00,163.01,163.29,160.51,162.49,6862807,8090608.35,45.314002144098254,44.59118652571142,NaN,NaN,-58.32307175640413,-89.31965433326467,0.13092075552861404,-1.672554192240483,-1.803474947769097,158328485,157286029.8,25.271959212088674,23.575137770213303,NaN,NaN,-13.250353212959364,-14.55275398495477
2015-10-02T09:30:00-04:00,160.35,164.58,159.93,164.58,11877500,8283297.85,50.223535380932596,45.04869838930328,NaN,NaN,-14.351168162364878,-84.46531943765305,0.3257810637507592,-1.396248618080648,-1.7220296818314071,170205985,159791870.8,29.90311331314959,24.222484607584843,NaN,NaN,-11.270050999091918,-14.083796415545791
2015-10-05T09:30:00-04:00,165.74,167.78,165.49,167.58,6342052,8167846.35,56.289617954438015,45.60661178606252,NaN,NaN,143.94664346817987,-26.126831964403568,0.6379901555391192,-0.9245419874075083,-1.5625321429466275,176548037,165568739.2,39.25016017772602,25.32005679193682,NaN,NaN,-7.621064318678861,-13.16054897313623
2015-10-06T09:30:00-04:00,167.74,168.43,167.25,167.69,6661036,8159813.95,56.49895211380168,45.99276400818977,NaN,NaN,155.64397605477828,33.56041289303262,0.8214975179008017,-0.5356602455706252,-1.357157763471427,183209073,170696574.4,46.118357798873966,26.38739269322968,NaN,NaN,-4.617542509600222,-11.940119478345371
2015-10-07T09:30:00-04:00,168.6,169.48,167.47,168.95,8832774,8208168.25,58.92550771782432,46.64929247191104,NaN,NaN,153.55576218040108,76.09442835691804,0.9862353248332905,-0.12436360742981378,-1.1105989322631042,192041847,176066685.4,52.211669451289424,27.896593052194532,NaN,NaN,-1.3466357359164995,-10.42676465799839
2015-10-08T09:30:00-04:00,168.67,170.66,168.43,170.37,8160305,8199832.75,61.52995575653282,47.91103058235742,NaN,NaN,157.32582213877004,119.22420713595288,1.1385359064043903,0.3125709507423835,-0.8259649556620067,200202152,184441418.8,59.839249870193534,30.128217431413997,NaN,NaN,2.229493285166124,-8.618727808974889
2015-10-09T09:30:00-04:00,170.62,170.97,170.1,170.76,5006077,8140021.95,62.23815849936476,49.0220832870222,NaN,NaN,149.7277753787043,152.0399958441667,1.2067300805523171,0.6824476450283896,-0.5242824355239274,205208229,191441867.6,64.88470993113555,32.76886026665702,NaN,NaN,5.396646532842523,-6.616531474429545
2015-10-12T09:30:00-04:00,170.73,171.23,170.47,171.17,2835806,8052034.35,63.00912143213035,50.42235535186516,NaN,NaN,133.92161656593674,150.0349904637181,1.2171591079712911,0.9971664494401864,-0.2199926585311046,208044035,197741067.2,68.69577280084343,35.87452892156779,NaN,NaN,8.26886953051261,-4.490045616580666
2015-10-13T09:30:00-04:00,170.25,171.58,170.14,170.64,5909319,8021697.35,61.26775956993556,51.74802508502102,NaN,NaN,112.95832384422873,141.49786002160818,1.128072597865315,1.1900980888005392,0.06202549093522419,202134716,201526195.8,70.75003182582235,39.3694270210896,NaN,NaN,10.264158912760367,-2.3823021123890897
2015-10-14T09:30:00-04:00,170.5,170.95,168.72,169.07,5424022,8017315.4,56.30376279544669,52.80902636138152,NaN,NaN,81.82909765706519,127.152527116941,0.9123402628367465,1.2024508194811574,0.2901105566444108,196710694,202459965.2,71.25123645043693,43.06373695110972,NaN,NaN,10.707553228573461,-0.5123227779658683
2015-10-15T09:30:00-04:00,169.4,171.32,169.19,171.32,9637216,7785678.25,61.160460896002235,54.038678245973536,NaN,NaN,94.56461453133832,114.60028559545465,0.870241891544012,1.3779129210744259,0.5076710295304139,206347910,203689116.8,71.93300365479354,46.83034870883947,NaN,NaN,12.496724317489925,1.3461125213849592
2015-10-16T09:30:00-04:00,171.44,171.96,170.82,171.88,8353736,7683339.25,62.28406203952015,55.73511583272826,NaN,NaN,99.16570173094726,104.48787086590326,0.8293454819049544,1.5443528819116068,0.7150074000066524,214701646,205587800.2,72.99822777234009,50.80293434617083,NaN,NaN,14.309211125100576,3.19798375048719
2015-10-19T09:30:00-04:00,171.28,172.13,171.04,172.12,4859801,7538201.55,62.78100963193853,57.38568074612455,NaN,NaN,91.9618182126453,96.09591119524497,0.7690343973816789,1.676300396733751,0.9072659993520722,219561447,207891282.6,74.27389141846956,54.88197214828422,NaN,NaN,15.954627456699551,5.020361422803242
2015-10-20T09:30:00-04:00,171.59,172.39,171.24,172.01,4140927,7296269.8,62.37534720819775,58.585803795726044,NaN,NaN,86.04897747397234,90.71404192119368,0.6756272101883423,1.7518000120875001,1.0761728018991579,215420520,210548443.4,75.70004718375115,58.79153077577951,NaN,NaN,17.22964252621258,6.764544437576005
2015-10-21T09:30:00-04:00,172.44,172.95,171.33,171.48,5801408,7358596.7,60.35188457218992,59.65993825487544,NaN,NaN,80.09934002474968,90.36809039473059,0.5380292762393797,1.7487093971983825,1.2106801209590028,209619112,213130127,77.03228140290375,62.48869664655202,NaN,NaN,17.813247163436202,8.342930541270318
2015-10-22T09:30:00-04:00,172.56,174.91,172.47,174.8,8553096,7363659.6,67.4706474911151,60.891874834174125,NaN,NaN,109.79808953877172,93.41478539621727,0.6244182775537936,1.9912029679012448,1.3667846903474512,218172208,215494986.6,78.21071512212785,65.93923963290761,NaN,NaN,20.45731597395393,10.07355703165369
2015-10-23T09:30:00-04:00,176,176.64,175.37,176.37,7642904,7222073.4,70.19588560550378,61.885179666393114,NaN,NaN,135.8272418900203,100.74709342803189,0.733565209100999,2.2837412017237,1.550175992622701,225815112,217717679.8,79.28643924305777,68.79897385185988,NaN,NaN,23.57977809199968,12.00301718313169
2015-10-26T09:30:00-04:00,176.24,176.46,175.87,176.02,3795875,6911212.9,68.81185599238829,62.76467280057786,NaN,NaN,131.08845638966204,108.57242106343524,0.7270528498888642,2.4589920549837814,1.7319392050949172,222019237,218209237.8,79.52716132191976,71.18531696064886,NaN,NaN,25.74973831792421,13.966834488102048
2015-10-27T09:30:00-04:00,175.33,176.19,175.24,175.67,4696113,6650708.45,67.38112925448334,63.36864576748208,NaN,NaN,121.04196419555525,115.57101840775181,0.6467317760400537,2.5403539251449843,1.8936221491049305,217323124,218589758.6,79.72360596978784,73.15045528339876,NaN,NaN,27.16031992349275,15.851618121729292
2015-10-28T09:30:00-04:00,176.01,177.68,175.36,177.68,7348489,6637063.15,71.09767056915801,64.05205396838389,NaN,NaN,141.61459245848826,127.87406889449953,0.6734950472565382,2.7354909581756033,2.061995910919065,224671613,221600258.8,81.25599642335442,74.68022289433881,NaN,NaN,29.526812164610263,17.805217270712287
2015-10-29T09:30:00-04:00,177.03,177.71,176.679,177.38,4726892,6530267.4,69.81901480683624,64.59354370463184,NaN,NaN,138.0301616355584,133.52048331385686,0.6170199016245426,2.8332707879497434,2.216250886325201,219944721,221954761.4,81.43393253158118,75.86231022294207,NaN,NaN,31.119716128881137,19.70728853616498
2015-10-30T09:30:00-04:00,177.64,177.83,176.45,176.49,6527468,6262765.8,66.02532141833677,64.80898656078945,NaN,NaN,114.186078991209,129.19225073409459,0.4722743145442658,2.8065937795055333,2.3343194649612675,213417253,219475189.6,75.99949754824927,76.38400484775677,NaN,NaN,31.418818114621395,21.380364190230182
2015-11-02T09:30:00-05:00,176.87,178.29,176.73,178.12,4178329,6154579.65,69.3139291665637,65.38371296054859,NaN,NaN,115.64570210230582,126.10369987662334,0.4395344318287364,2.883737504747188,2.4442030729184516,217595582,218590458.6,74.09937004185642,76.62324329175921,NaN,NaN,32.63291055606592,22.987870813921003
2015-11-03T09:30:00-05:00,177.92,179.6,177.8,179.07,4284912,6035773.45,71.07146368550605,66.43854873840998,NaN,NaN,124.35827563509257,126.76696216453081,0.43431603417517683,2.987098115637423,2.552782081462246,221880494,219501932.6,74.79843456989047,76.8766145860059,NaN,NaN,34.17612442293012,24.586192758065163
2015-11-04T09:30:00-05:00,179.57,179.59,178.19,178.65,6870435,5937656.5,69.18484588949826,67.01171909508825,NaN,NaN,111.13724470276556,120.67149261338628,0.3582010336814685,3.000533373564082,2.6423323398826133,215010059,217569621.8,70.45685681790174,76.77117552622792,NaN,NaN,34.92771890980608,26.063553636885295
2015-11-05T09:30:00-05:00,178.75,179.25,177.7311,178.64,5008123,5780047.4,69.13778723173422,67.50127089453211,NaN,NaN,94.79203326461743,112.02386693919807,0.2669883196758298,2.9760677394774007,2.709079419801571,210001936,215581064.8,66.19843624650458,76.28547613152537,NaN,NaN,35.534448129003934,27.416538564330814
2015-11-06T09:30:00-05:00,178.49,179.17,177.71,179.14,7642830,5911885.05,70.22819372740389,68.03321261563678,NaN,NaN,88.986717832357,106.98399470742768,0.2030326606825481,2.9628702456547558,2.7598375849722077,217644766,216426567.4,67.10870135102286,75.77367684099347,NaN,NaN,36.34159828396577,28.691547095707236
2015-11-09T09:30:00-05:00,178.5,178.6,176.73,177.42,7962284,6168208.95,62.099966089082635,68.0135425357,NaN,NaN,59.13163441950654,95.68118117086783,0.017375890862066257,2.7815574485497905,2.7641815576877242,209682482,214843947.4,63.65330066001181,74.91319494644065,NaN,NaN,34.77198560045846,29.56018116781455
2015-11-10T09:30:00-05:00,176.98,177.86,176.73,177.78,4837736,6114629.8,63.06356883266018,68.20723426859072,NaN,NaN,51.87696200512924,81.18491844487515,-0.10212720525464913,2.6365225511194126,2.7386497563740617,214520218,213371892.2,60.53130874289912,73.73455404215461,NaN,NaN,33.71274325240878,30.153404322756582
2015-11-11T09:30:00-05:00,178.17,178.24,177.11,177.21,2860255,5986441.45,60.44319715937684,67.70527353060942,NaN,NaN,49.74959051822789,68.90738760796762,-0.23301956932698653,2.4473752947153287,2.680394864042315,211659963,212701873,59.110219814326335,72.37023294874021,NaN,NaN,32.08037240675881,30.428685477614042
2015-11-12T09:30:00-05:00,176.09,176.35,174.59,174.67,6164375,5812799.4,50.39447533278108,66.2908870825578,NaN,NaN,-27.294947673412665,44.489991420361605,-0.4893786108803413,2.0686716004418884,2.5580502113222297,205495588,211800603.4,57.16606152083371,70.79020596858136,NaN,NaN,27.408068564817505,29.997168775785966
2015-11-13T09:30:00-05:00,174.07,174.55,172.55,172.61,8011148,5795670,44.00476348062067,64.51895190314583,NaN,NaN,-100.78198628824282,6.536250596241641,-0.7791910991361113,1.5840613374020904,2.3632524365382017,197484440,207768538.2,49.34649208753089,68.63444388041071,NaN,NaN,21.123615342637308,28.72951828533616
2015-11-16T09:30:00-05:00,172.5,175.06,172.15,175.02,5012863,5803323.1,51.71771599657713,63.40013667043825,NaN,NaN,-80.88903363361027,-21.46788301438172,-0.7877382187631365,1.378579663084281,2.1663178818474176,202497303,206331502.4,46.88497431862664,66.2888273338992,NaN,NaN,18.124359360140787,27.21449558173682
2015-11-17T09:30:00-05:00,175.6,176.25,174.76,175.16,6612231,5926888.3,52.13021860108038,62.045318672718416,NaN,NaN,-42.72992909876823,-40.38926123516121,-0.7626162823375338,1.2130475289255003,1.975663811263034,209109534,205249365.6,45.06209736780898,63.70354882993167,NaN,NaN,15.91583247097038,25.600400851627327
2015-11-18T09:30:00-05:00,175.68,177.8405,175.667,177.73,6254431,5949539.45,59.0471407612169,61.275899098031324,NaN,NaN,20.913747166610158,-46.15642990548476,-0.560893087429839,1.2745474519757352,1.8354405394055742,215363965,205990166,46.59292464613936,61.21490540954297,NaN,NaN,16.263594179800187,24.266571327080595
2015-11-19T09:30:00-05:00,177.18,178.05,177.15,177.66,5457330,5794751.15,58.797932120318464,60.75965700531573,NaN,NaN,43.40328738350873,-32.01678289410047,-0.4262545519247223,1.3026223494996714,1.7288769014243937,209906635,206872375.4,48.43564266511049,59.24605863217592,NaN,NaN,16.45588827809204,23.150759462939373
2015-11-20T09:30:00-05:00,178.17,178.97,177.66,178.06,7730037,5799107.8,59.84095593660142,60.08301606031843,NaN,NaN,71.55978809620667,2.451571982789423,-0.30975553345751417,1.3416824846025008,1.651438018060015,217636672,210902821.8,55.918722978320744,57.947440984780506,NaN,NaN,16.926747809206155,22.261614940977484
2015-11-23T09:30:00-05:00,177.88,178.48,177.3,177.74,2596982,5739163.15,58.56369867726298,59.18960427401536,NaN,NaN,45.93967158107528,27.81731302572653,-0.25597580633327266,1.3314682601434242,1.587444066476697,215039690,213411299.2,59.826355826468635,56.878006788821814,NaN,NaN,16.94457640518327,21.502038007292597
2015-11-24T09:30:00-05:00,176.67,178.41,176.61,177.98,4369888,5722851.9,59.26593542377302,58.4811106693207,NaN,NaN,32.45382469293344,42.85406378406687,-0.20800522573173708,1.3274375343120255,1.5354427600437626,219409578,215471308,62.74691115897357,56.32729638461266,NaN,NaN,17.15483976362913,20.881009686769247
2015-11-25T09:30:00-05:00,178.01,178.33,177.79,177.93,2227405,5466797.7,59.04144233611086,57.759943176776176,NaN,NaN,49.67598945513588,48.60651224177201,-0.18422343925408158,1.3051634609761606,1.4893869002302422,217182173,215834949.6,63.25473693260749,56.117032147905725,NaN,NaN,17.269584994240393,20.36509187355084
2015-11-27T09:30:00-05:00,177.8,178.18,177.36,177.9,2878237,5374364.95,58.89728755273157,56.95059273572815,NaN,NaN,35.37276064361374,47.00040689379301,-0.17515316510414203,1.2704454438500647,1.4455986089542068,214303936,216714409.8,64.51461715780225,55.93174041981854,NaN,NaN,17.329107709100438,19.931379850057922
2015-11-30T09:30:00-05:00,178.13,178.329,177.13,177.23,3578504,5226916.75,55.63048293444392,56.488486796111104,NaN,NaN,19.01216388991339,36.49088205253435,-0.21622335598091835,1.175319413978059,1.3915427699589773,210725432,215332161.8,60.97594059131753,55.74050041491181,NaN,NaN,16.537604162237837,19.446554751797912
2015-12-01T09:30:00-05:00,177.92,178.9,177.64,178.81,6058347,5320917.65,61.10878909544604,56.34885967202438,NaN,NaN,68.3691183099709,40.97677139831346,-0.14248509132766252,1.2134364057993992,1.3559214971270617,216783779,215680979.6,61.549114539699545,55.81320082896898,NaN,NaN,17.318219668049416,19.142506882690984
2015-12-02T09:30:00-05:00,178.64,179.04,177.08,177.29,7427120,5478028.05,54.17838104912001,55.90137280700604,NaN,NaN,34.339650074641646,41.3539364746551,-0.19816259812727566,1.108218249467967,1.3063808475952428,209356659,213670395.8,56.406419675689165,55.62007224763776,NaN,NaN,15.991430019732203,18.692353045125444
2015-12-03T09:30:00-05:00,177.66,177.84,174.26,174.83,7005522,5484782.4,45.23664719877823,55.53295651172011,NaN,NaN,-80.60918981820846,15.296900619986229,-0.391573647707554,0.8169137879608002,1.2084874356683541,202351137,210704188.6,49.79602200651276,55.093640853757684,NaN,NaN,11.831269293421034,17.712198223453385
2015-12-04T09:30:00-05:00,175.25,178.68,175.14,178.42,6252675,5547010,56.51569162814694,56.426594236543416,NaN,NaN,23.113528867800888,12.84505426482366,-0.2741851450978128,0.8657560042960881,1.139941149393901,208603812,209564163.8,47.49235220192396,54.961202290500054,NaN,NaN,12.013010025220321,16.898028480848662
2015-12-07T09:30:00-05:00,178.02,178.08,176.42,177.34,5647049,5447220.95,52.98050487678403,56.51679344227248,NaN,NaN,20.034836057935017,13.049588698427982,-0.2655507702662552,0.8080026865610819,1.073553456827337,202956763,208010430,44.47264042618058,54.7888927267539,NaN,NaN,10.908169027578143,16.042334273238588
2015-12-08T09:30:00-05:00,175.68,176.86,174.92,175.7708,6890163,5393614.9,48.25721305656592,56.24015018909288,NaN,NaN,-57.176969604429665,-12.059628884452131,-0.35614836122353766,0.628368005297915,0.9845163665214527,196066600,203866994.2,37.605688045567554,54.25629206087952,NaN,NaN,8.340273619794822,14.942039894175192
2015-12-09T09:30:00-05:00,175.44,177.76,174.08,174.99,9545757,5629015.95,46.05697203787941,55.31228099456877,NaN,NaN,-62.380150100653935,-31.403588919511243,-0.4530677701607304,0.4181816538205396,0.87124942398127,186520843,199299831,31.78058505218813,53.198267804168715,NaN,NaN,5.562229375134698,13.602066962883693
2015-12-10T09:30:00-05:00,175.18,177.13,174.85,175.88,5613801,5766693.25,48.916058593610146,54.60643288551818,NaN,NaN,-39.02645627615861,-23.08704221110127,-0.4412097107646231,0.3197372855254912,0.7609469962901143,192134644,197256532.4,29.573482426306654,51.850970644254154,NaN,NaN,4.2409341662513755,12.264762277650505
2015-12-11T09:30:00-05:00,173.65,174.38,172.4542,172.73,8895641,5903256.55,40.69483429120436,53.23885276798982,NaN,NaN,-164.8630881339761,-60.68236561145667,-0.6186114163000058,-0.012317274084892915,0.6062941422151129,183239003,192183570.6,24.94212293283492,49.638356355290874,NaN,NaN,0.13189567516201495,10.53149562015215
2015-12-14T09:30:00-05:00,172.97,173.95,171.52,173.9,12321572,6118777.75,44.430608934022295,52.22934635775834,NaN,NaN,-166.90282162937692,-98.06989714891907,-0.6282355371346002,-0.17900027920313732,0.44923525793146285,195560575,190704333,23.773023439412185,47.063118327643984,NaN,NaN,-1.8820161117773653,8.758136801305076
2015-12-15T09:30:00-05:00,174.91,176.45,174.91,175.46,8039755,6270122.35,49.03997498371023,51.49892061203957,NaN,NaN,-54.31913932673596,-97.49833109338032,-0.5058746411964877,-0.18310804356414678,0.32276659763234095,203600330,192211079,27.500703596685554,44.54553207319485,NaN,NaN,-1.9696411316691698,7.22559709659447
2015-12-16T09:30:00-05:00,176.43,178,174.97,177.64,11286555,6503838.55,54.69539063760689,51.18848834786071,NaN,NaN,7.630428650554592,-83.49621534313862,-0.2664825118746104,-0.010336542210922062,0.25614596966368836,214886885,197884287.4,39.49776171227018,42.84860527174219,NaN,NaN,-0.06891061790987493,6.183524565950992
2015-12-17T09:30:00-05:00,178.15,178.19,175.09,175.1,8504132,6616323.6,48.00997675086981,50.41082329058487,NaN,NaN,-30.015329347340845,-81.69398995737507,-0.26689880940629984,-0.07747754209418645,0.1894212673121134,206382753,200733909.2,44.46852782064162,41.41674174765928,NaN,NaN,-0.824111953452346,5.1824336346076585
2015-12-18T09:30:00-05:00,173.84,173.91,170.89,171,10946086,6890761.4,39.596600742466066,49.26554599115788,NaN,NaN,-204.5227289034208,-89.62591811126399,-0.5165477992048297,-0.4562634816939237,0.06028431751090596,195436667,203173442,48.37860846574378,40.5169323101183,NaN,NaN,-4.711042535636851,3.7690798960013003
2015-12-21T09:30:00-05:00,172.28,172.56,170.91,172.25,6466723,6827595.7,42.88296212978457,47.96370120789635,NaN,NaN,-174.7622923436244,-91.1978122541135,-0.5667221811602532,-0.6481184089394105,-0.08139622777915737,201903390,204442005,50.336869929418995,39.71605769509826,NaN,NaN,-6.510444784826302,2.300576370168786
2015-12-22T09:30:00-05:00,173.1,174.28,172.1799,174.01,6003720,6997932.6,47.23587540842473,47.46780794784669,NaN,NaN,-96.34518268509436,-99.60302092578517,-0.4554008363395906,-0.6506472732036457,-0.19524643686405505,207907110,205303361,51.6773099906568,39.378264146167375,NaN,NaN,-6.404417533597298,1.0570058124879167
2015-12-23T09:30:00-05:00,175.22,175.82,174.76,175.81,6456643,7102270.35,51.321826235399456,47.90246359331963,NaN,NaN,-12.291192318076735,-103.58734511951143,-0.24510209033627328,-0.5016240497843967,-0.2565219594481234,214363753,205198734.6,51.49549660918044,39.49965518921506,NaN,NaN,-4.889247617997286,0.20754103670431623
2015-12-24T09:30:00-05:00,175.66,175.82,175.18,175.22,1765067,7079153.45,49.95627305143228,47.43393369498286,NaN,NaN,-9.760392250810208,-99.5363577002053,-0.13575601383158648,-0.4262169767376065,-0.29046096290602,212598686,206441921.2,53.58509641569323,39.934851204484296,NaN,NaN,-4.151053058886571,-0.41511526266581045
2015-12-28T09:30:00-05:00,174.49,175.13,174.12,174.98,2932215,7081852.35,49.38069054034465,47.176804099522904,NaN,NaN,-33.4316520405687,-65.31814232763489,-0.07277161905429153,-0.38142548672388443,-0.3086538676695929,209666471,209287882,58.04144223749914,40.904051333864196,NaN,NaN,-3.7453225214829904,-0.8908591567825503
2015-12-29T09:30:00-05:00,176.19,177.2507,176,176.98,6145747,7210214.5,54.12424826564454,47.59587804302852,NaN,NaN,61.56890763288799,-18.051902332332407,0.10096985393188496,-0.18244155025473674,-0.2834114041866217,215812218,212069647.6,61.892726795680545,42.63883981601513,NaN,NaN,-1.900248438508947,-1.035057625600607
2015-12-30T09:30:00-05:00,176.57,176.72,175.62,175.8,2910043,7052799.3,51.082674881428396,47.954856817567745,NaN,NaN,36.43915036880275,8.504964278447009,0.13185360104872546,-0.11859440287571488,-0.25044800392444033,212902175,213068660.6,63.199133474979625,44.88302184621451,NaN,NaN,-1.299439777606931,-1.0728265044586534
2015-12-31T09:30:00-05:00,175.09,175.65,173.9701,173.99,5773408,6970113.7,46.74348403108282,47.79967292024436,NaN,NaN,-31.032343836506183,4.75673397476112,0.03107226691474274,-0.2116076702810119,-0.24267993719575465,207128767,211621663.4,59.99110219555597,47.055708972589464,NaN,NaN,-2.133869144252786,-1.2244040244292438
2016-01-04T09:30:00-05:00,171.05,171.32,169.35,171.29,14350796,7337377.4,41.130782295355715,47.830812063398035,NaN,NaN,-181.32540398705913,-29.556268372488667,-0.20381960608151956,-0.4974544447976541,-0.29363483871613455,192777971,207657520.4,52.17709711896003,49.0010642715984,NaN,NaN,-4.696378842274896,-1.7204004269786226
2016-01-05T09:30:00-05:00,171.69,171.74,170.17,171.39,9412970,7495392.15,41.41138061628879,47.61515289784564,NaN,NaN,-138.80828672627678,-50.63159530963028,-0.331301941760679,-0.7077622659169833,-0.3764603241563043,202190941,206162414.4,49.55538467894468,50.84266150299358,NaN,NaN,-6.62761637187874,-2.421431276250068
2016-01-06T09:30:00-05:00,168.92,169.97,168.01,168.94,8713585,7648718.95,36.78521790168429,46.73981310627236,NaN,NaN,-182.57258031153654,-99.45989289851518,-0.5467591642214138,-1.0599092794330716,-0.5131501152116578,193477356,201695442,42.65872247696564,51.9253771372993,NaN,NaN,-9.796885281881886,-3.475067562768899
2016-01-07T09:30:00-05:00,165.96,167.94,164.48,164.96,15400648,8074243.2,30.771401765916224,45.03095675829445,NaN,NaN,-230.02483165847133,-152.75268930397002,-0.9024575686402392,-1.6412220760119567,-0.7387645073717175,178076708,194730348.6,34.57805821373789,51.573969744547,NaN,NaN,-14.766135706553513,-5.088077297595272
2016-01-08T09:30:00-05:00,165.96,166.39,163,163.24,12512371,8222573.9,28.595661641953654,43.64421996480045,NaN,NaN,-218.66406142934838,-190.27903282253845,-1.1811253272885964,-2.215171166482463,-1.0340458391938667,165564337,186417462.6,27.807672376726188,50.38390864141018,NaN,NaN,-19.557918422936314,-7.155197458358278
2016-01-11T09:30:00-05:00,164.16,164.5,162.15,163.83,12353678,8559567.75,30.4132459604794,42.9882660518014,NaN,NaN,-188.79254348091422,-191.77246072130947,-1.246792718157859,-2.5925367368911907,-1.3457440187333316,177918015,183445471.4,25.858306853517334,48.775315669108295,NaN,NaN,-22.76933303924314,-9.385788255627544
2016-01-12T09:30:00-05:00,165.19,165.78,163.05,164.95,10250310,8627301.2,33.85528515057656,42.34343198185797,NaN,NaN,-139.03597755644657,-191.81799888734344,-1.1388481572381433,-2.769304215281011,-1.6304560580428675,188168325,180640948.2,24.138664686265244,46.90401529459731,NaN,NaN,-24.34318597199702,-11.52255935796604
2016-01-13T09:30:00-05:00,165.54,165.84,161.07,161.35,16369416,8829693.4,28.905961900163078,41.034152445553566,NaN,NaN,-143.96126882537396,-184.0957365901109,-1.2263693285166366,-3.163417718688663,-1.9370483901720266,171798909,176305258.8,21.732469323944372,44.76509810411785,NaN,NaN,-27.40425003956195,-13.79137231247974
2016-01-14T09:30:00-05:00,162.02,164.69,160.61,163.59,14749479,9165179.6,35.24898276312797,39.886092197534175,NaN,NaN,-120.96232868315717,-162.28323599504807,-1.0563263290522715,-3.257456301487366,-2.2011299724350946,186548388,177999594.8,24.88368394794982,42.86425434260138,NaN,NaN,-27.855725149678207,-15.800565574936664
2016-01-15T09:30:00-05:00,159.26,160.58,158.23,159.68,19969146,9599309.15,30.18624460435275,38.47394730845706,NaN,NaN,-146.49932244022418,-147.85028819722322,-1.1238320833300146,-3.605920076597613,-2.4820879932675983,166579242,178202575.8,25.271853169064755,40.841879824985064,NaN,NaN,-30.020370499136423,-17.83196627839377
2016-01-19T09:30:00-05:00,161.45,161.62,158.81,160.02,10233806,9685792.85,31.112784978718253,37.16909691119803,NaN,NaN,-119.58930096853575,-134.00963969474753,-1.0629035193111234,-3.8107173924065023,-2.747813873095379,176813048,177981582.4,25.119655119387986,38.49032360226283,NaN,NaN,-31.384266071812217,-19.768009106024977
2016-01-20T09:30:00-05:00,157.25,158.88,154.3782,157.61,16435999,9960288.5,28.25074280626508,35.320989378385214,NaN,NaN,-137.47386848772612,-133.69721788100344,-1.0977447921504697,-4.119994863283466,-3.0222500711329965,160377049,172423327.2,21.5967268831116,35.61203789422219,NaN,NaN,-33.47570991270871,-21.72625207840837
2016-01-21T09:30:00-05:00,157.81,160.29,156.88,158.6,16782433,10476074,31.056395825887662,33.89054087441802,NaN,NaN,-104.01726509108576,-125.70841713414579,-0.9713042668555016,-4.236380404702373,-3.265076137846872,177159482,173495441.8,23.816151716724292,32.79896776863253,NaN,NaN,-34.27089053607067,-23.51834328664584
2016-01-22T09:30:00-05:00,160.91,161.24,159.62,160.79,7390557,10545415.85,36.931587674315445,33.189691134648925,NaN,NaN,-74.42151502998492,-116.40025440351135,-0.6716086608265899,-4.104586963880109,-3.4329783030535195,184550039,173095772,23.548533958377178,30.19592718026262,NaN,NaN,-33.06660073203106,-24.882380064558017
2016-01-25T09:30:00-05:00,160.41,160.72,158.67,158.7,5782464,10511706.9,33.95751973242476,32.67731523729671,NaN,NaN,-81.27430195562454,-103.35525030659142,-0.5506395347430022,-4.121277721482272,-3.57063818673927,178767575,175533438.6,28.803384251319144,28.526376261145412,NaN,NaN,-32.989705004254404,-26.040569341657502
2016-01-26T09:30:00-05:00,159.5,161.72,159.49,161.54,5945212,10720714.15,40.91980142990411,32.64220243826924,NaN,NaN,-58.70593303913833,-91.17857672071193,-0.23215800375944884,-3.860835691438581,-3.628677687679132,184712787,177113386.4,32.06276798092314,27.276903639858165,NaN,NaN,-30.634205107991676,-26.696803022562385
2016-01-27T09:30:00-05:00,160.57,162.23,158.61,159.3,10121893,11080198.05,37.556770810043815,32.69731336029492,NaN,NaN,-65.22311913004704,-76.7284268491761,-0.13023944909811913,-3.791476999051781,-3.661237549953662,174590894,179956155.4,37.598261513655736,26.915442142478888,NaN,NaN,-29.749666357319704,-27.132926356099144
2016-01-28T09:30:00-05:00,160.68,160.9,158.47,160.51,8613436,11203582.5,40.405965506695445,33.38549648463629,NaN,NaN,-62.86872401027423,-68.49871863301381,0.05106667069888493,-3.5974042115800557,-3.6484708822789407,183204330,181165125,39.84313658056978,27.291519168681166,NaN,NaN,-28.125979669613848,-27.274791115172672
2016-01-29T09:30:00-05:00,161.61,164.43,161.33,164.37,6182773,11367219,48.48174633729406,34.805931105732036,NaN,NaN,-0.8738319838873677,-53.7891820237943,0.4416274297808611,-3.0964365950528645,-3.5380640248337256,189387103,182132537.8,41.651987143826354,28.280398794902606,NaN,NaN,-23.968299785175805,-26.802435210887406
2016-02-01T09:30:00-05:00,163.39,164.97,162.82,164.34,6977286,11427412.9,48.42681928224879,36.092614914429845,NaN,NaN,25.250986013196837,-32.48412443003002,0.6936138319732512,-2.6710467348671614,-3.3646605668404126,182409817,182860986.2,43.04082905138045,29.507721809035694,NaN,NaN,-20.754015786472127,-25.938375293113793
2016-02-02T09:30:00-05:00,162.7,162.7,160.94,161.41,7900994,11104922.8,43.27059313289604,36.76513691316695,NaN,NaN,-19.09168305737633,-24.561274433677617,0.6588828570100183,-2.5410569955778897,-3.199939852587908,174508823,180820193.4,40.15697959400373,30.651887159588444,NaN,NaN,-19.585318272382967,-25.030795718723674
2016-02-03T09:30:00-05:00,162.42,163.75,159.48,163.2,14249346,11346741.6,46.98440377067034,38.056454189631744,NaN,NaN,4.198315356132913,-10.676987536441631,0.7459812856920318,-2.267463245472868,-3.0134445311649,188758169,183653648.4,45.60630347611785,32.35716102760083,NaN,NaN,-17.436913634755932,-23.945955421013995
2016-02-04T09:30:00-05:00,162.82,164.8,162.58,164.14,11715786,11496851.65,48.87712346599383,39.02989281126502,NaN,NaN,70.68382228418795,16.0335217224508,0.8489289243046807,-1.9522833757840488,-2.8012123000887295,200473955,187107573.4,51.414210396691395,34.25219863108238,NaN,NaN,-15.106581395517646,-22.683187703085945
2016-02-05T09:30:00-05:00,163.87,164.01,161.22,161.94,8292457,11141442.1,44.84208261052417,40.07673838313441,NaN,NaN,29.892960338756893,22.186880186979657,0.7540915101960257,-1.858597912343697,-2.612689422539723,192181498,187666452.4,52.30170054579297,36.182902015134395,NaN,NaN,-14.34121870995398,-21.491477846924237
2016-02-08T09:30:00-05:00,160.11,160.81,158.05,160.35,13377575,11184702.3,42.13474864408642,40.86402150208928,NaN,NaN,-60.657382047857375,5.005206574768815,0.5774678385738348,-1.8908546243224293,-2.468322462896264,178803923,186945273.6,51.00692856493444,38.03199297553057,NaN,NaN,-14.523130982914815,-20.495999723494318
2016-02-09T09:30:00-05:00,158.54,161.46,158.51,160.24,11449205,11139478.65,41.946067909934,41.842259009494214,NaN,NaN,-43.17666845219515,0.18820949580505014,0.4519750063648047,-1.9033537049402582,-2.355328711305063,167354718,185514452.6,48.44451551662829,39.94969216363891,NaN,NaN,-14.723855046352433,-19.671407626759763
2016-02-10T09:30:00-05:00,160.98,162.3,159.23,159.39,8205655,11037245.9,40.43911488292232,42.512453227853825,NaN,NaN,-28.46844997518849,-6.34514357045923,0.31685332167272673,-1.9592620592141543,-2.276115380886881,159149063,179592631.4,39.58174391900704,41.07580589237339,NaN,NaN,-15.317334402343805,-19.049397166128912
2016-02-11T09:30:00-05:00,156.8,158.02,155.26,156.8,14806696,10959109.9,36.174528985906846,42.45837760725321,NaN,NaN,-164.9595169958816,-53.47381142647314,0.0710148529200203,-2.1873468147368555,-2.258361667656876,144342367,168366313.8,28.81814186801995,41.45220645734787,NaN,NaN,-17.110168572167158,-18.77236450984866
2016-02-12T09:30:00-05:00,158.16,159.98,157.66,159.98,7072978,10575284.85,43.98522696339699,43.17464240946551,NaN,NaN,-55.90817100787251,-70.63403769579902,0.13673457063279493,-2.087443454365882,-2.224178024998677,151415345,160213083.2,23.763885721976266,41.09224227668052,NaN,NaN,-16.31272771697956,-18.420987825153073
2016-02-16T09:30:00-05:00,161.76,162.29,160.62,162.2,5451192,9849387.15,48.70460465859676,43.73069978294357,NaN,NaN,48.336691280071605,-48.83522303021322,0.33271118452782833,-1.808289044338892,-2.1410002288667203,156866537,155825606,21.571387804079976,40.34285797833458,NaN,NaN,-14.149047517160335,-17.810710638296968
2016-02-17T09:30:00-05:00,163.43,165.26,163.33,164.93,5584173,9616905.5,53.853512949089556,44.8947527928754,NaN,NaN,142.1362804282926,-11.772633254115675,0.6318455719750353,-1.351193263897926,-1.9830388358729614,162450710,154844804.4,21.102671406352172,39.164601542098616,NaN,NaN,-10.618557527773492,-16.78326019393647
2016-02-18T09:30:00-05:00,165.33,165.45,164.29,164.52,5187626,9054486.85,52.993187614771955,45.79384008630944,NaN,NaN,134.10697913919515,20.742452568761053,0.7781285662452437,-1.0103781280664066,-1.7885066943116503,157263084,154467608.6,20.914458650149726,37.812553118497185,NaN,NaN,-8.058907470967295,-15.53692409065516
2016-02-19T09:30:00-05:00,163.18,163.81,162.59,163.7,4660567,8448393.55,51.230434887642566,45.990174982762895,NaN,NaN,73.76116461651014,68.48658889123939,0.7930001176478758,-0.7972565472518056,-1.5902566648996814,152602517,156119638.6,24.107088690785446,36.55934608613712,NaN,NaN,-6.462798715286292,-14.240620465602465
2016-02-22T09:30:00-05:00,165.35,166.46,165.13,165.94,3450737,8251402.55,55.57747311834628,46.500935971055576,NaN,NaN,145.53166593535303,108.77455627988452,0.9182005748317446,-0.44250594636000073,-1.3607065211917453,156053254,157047220.4,25.915502505521914,35.33610847571865,NaN,NaN,-3.758198677313762,-12.743131638704078
2016-02-23T09:30:00-05:00,165.61,165.76,163.84,164.1508,6052788,8264918.75,51.619660107382586,47.097297897804616,NaN,NaN,90.85639855972964,117.2784977358161,0.8467629419866292,-0.30225284370845884,-1.149015785695088,150000466,155674006.2,24.967010031975576,34.25111064985949,NaN,NaN,-2.636528344165411,-11.299331168055698
2016-02-24T09:30:00-05:00,162.6,164.9,161.468,164.67,8003806,8367848.45,52.67289892228016,47.50361898006246,NaN,NaN,54.211382214074675,99.69351809297252,0.8012079937124014,-0.14750579355458626,-0.9487137872669876,158004272,154784718.6,24.345592868676206,32.73248846361366,NaN,NaN,-1.4132673225746195,-9.887036332986973
2016-02-25T09:30:00-05:00,165.03,166.84,164.4,166.84,5266932,8125100.4,56.8964762471039,48.07642989299889,NaN,NaN,120.65313826022636,97.00274991717876,0.8777879607056024,0.14852116361501544,-0.729266797090587,163271204,155986342.6,26.989892925457795,30.987894358525548,NaN,NaN,0.914645329944679,-8.343938952568166
2016-02-26T09:30:00-05:00,167.84,167.95,166.12,166.28,3797964,7884326.8,55.51949189339557,48.83910198463256,NaN,NaN,130.3353820564845,108.31759340517365,0.8506823994868218,0.3340862022679403,-0.5165961972188815,159473240,157360487.2,30.00293274590743,29.395125229962296,NaN,NaN,2.4422150555353928,-6.803059808553372
2016-02-29T09:30:00-05:00,166.16,167.21,164.96,164.96,3485040,7749440.15,52.30608000106454,49.56562565298814,NaN,NaN,87.56427414890325,96.7241150478837,0.7095693744509564,0.370365520844814,-0.33920385360614236,155988200,157347476.4,29.99031275245349,27.89393838621366,NaN,NaN,2.8351659981860857,-5.426170407590592
2016-03-01T09:30:00-05:00,166.01,168.59,165.71,168.52,3914276,7596289.65,59.16984887944078,50.795895722238626,NaN,NaN,130.6132400421055,104.67548334435887,0.8142090050314484,0.6785574026831682,-0.13565160234828022,159902476,159327878.4,34.506069255230756,26.898335081828122,NaN,NaN,5.314322192433762,-3.8918143218728276
2016-03-02T09:30:00-05:00,168.02,168.93,167.55,168.89,3106188,7356549.35,59.817106611135536,52.18003798853956,NaN,NaN,137.1937686455895,121.27196063066182,0.8619621621899833,0.9418011003891991,0.07983893819921567,163008664,160328756.8,36.72733811405114,26.694448952902697,NaN,NaN,7.510473423428082,-2.262916072544126
2016-03-03T09:30:00-05:00,168.73,169.39,168.12,169.35,2968209,6792492.5,60.6522422917807,53.92844608181627,NaN,NaN,133.17048958289482,123.77543089519551,0.8753356840940918,1.1740085433168304,0.2986728592227386,165976873,160869890.6,37.95260764531959,27.346910794138388,NaN,NaN,9.559728268353625,-0.5739668809873044
2016-03-04T09:30:00-05:00,169.53,170.55,168.92,170.02,3524884,6382947.4,61.89448186335287,55.20767857467026,NaN,NaN,134.0625623652926,124.52086695695714,0.8778662968634949,1.3960057303021074,0.5181394334386125,169501757,162875594,42.40455860738949,28.678387428810762,NaN,NaN,11.630323809505185,1.1695032176544797
2016-03-07T09:30:00-05:00,169.37,170.93,169.3,170.62,3235972,6130123.15,63.02040477124305,56.23023572557357,NaN,NaN,128.584832305825,132.7249785883415,0.867000054014426,1.601889500956645,0.7348894469422189,172737729,166225499.8,48.98795680027312,30.636713785681703,NaN,NaN,13.68951142078722,2.9580758181020137
2016-03-08T09:30:00-05:00,169.8,170.7599,169.22,169.62,2832651,5602876.95,59.846506374513126,56.6583066845324,NaN,NaN,109.22190916349862,128.44671241262012,0.7442222174022393,1.665167218695018,0.9209450012927787,169905078,168226020.2,52.48115301009898,32.878033900235046,NaN,NaN,14.617854653561292,4.62375850888191
2016-03-09T09:30:00-05:00,170.41,170.59,169.54,170.02,3583983,5209615.85,60.69913251414914,57.2087313202022,NaN,NaN,103.46362154918258,121.70068299333873,0.6453850753537611,1.72767634548498,1.0822912701312188,173489061,170322099.6,55.88948447381806,35.37625003049707,NaN,NaN,15.6278034055722,6.195764922694808
2016-03-10T09:30:00-05:00,170.67,171.4,168.3,170.0592,4865801,5042623.15,60.78700967687259,57.891343805147194,NaN,NaN,93.04451038347362,113.6754871534545,0.5422383269161539,1.7600891787764112,1.2178508518602573,178354862,172797697.4,59.577215190702425,37.90983049477685,NaN,NaN,16.499113288392596,7.667671832080206
2016-03-11T09:30:00-05:00,171.47,172.3418,171.4194,172.2308,3674161,4485996.4,65.40230508536546,58.59311751707714,NaN,NaN,130.98531821235375,113.06003832286672,0.5766464391740485,1.9386589008278179,1.3620124616537694,182029023,175303150.6,62.95290203515274,40.555359032607626,NaN,NaN,18.56535811187141,9.224484157764664
2016-03-14T09:30:00-04:00,171.7,172.89,171.7,172.4108,2658432,4265269.1,65.7620172016864,59.60328588095598,NaN,NaN,127.90275231266561,112.92362232423484,0.5670539899964013,2.070829949149271,1.5037759591528697,184687455,177693095.8,65.879962866267,43.47771280648558,NaN,NaN,20.393202417237962,10.820015337689421
2016-03-15T09:30:00-04:00,171.61,172.67,171.32,172.64,2431630,4114291,66.24329381346666,60.57259980175502,NaN,NaN,114.20845929408176,113.92093235035148,0.532233091693529,2.169067323769781,1.636834232076252,187119085,181135897.2,69.60544171476445,46.710559152634744,NaN,NaN,22.07000243134467,12.427156351068742
2016-03-16T09:30:00-04:00,172.21,173.94,172.165,173.47,3556197,4012892.2,67.99764558880449,61.365540469019344,NaN,NaN,125.66771442875174,118.36175092626532,0.5205534448091058,2.287526038087634,1.7669725932785283,190675282,184573141.4,72.79877448771794,49.98262212136761,NaN,NaN,24.00362254497173,14.080937235912026
2016-03-17T09:30:00-04:00,173.46,175.41,173.08,174.94,4070450,3957033.4,70.8837738451657,62.462989179860074,NaN,NaN,142.4063321938373,128.23411528833805,0.5636474106280469,2.471531856563587,1.90788444593554,194745732,187851315.4,75.44812435809489,53.22870723652386,NaN,NaN,26.542097640860685,15.861103008047548
2016-03-18T09:30:00-04:00,175.27,175.95,175.04,175.69,5112032,3979606.65,72.25842777777788,63.88815687819674,NaN,NaN,154.77873232098813,132.99279811006494,0.5915799744389205,2.6473594139841907,2.05577943954527,199857764,191417063.6,77.96242912706326,56.655286977567414,NaN,NaN,29.115694746714738,17.754616113571434
2016-03-21T09:30:00-04:00,175.62,176.21,175.25,176.01,2884948,3951317.2,72.84746411835724,64.8651293952622,NaN,NaN,146.1220591280848,136.63665947314877,0.5797554681772841,2.7804737747668753,2.2007183065895912,202742712,195028115,80.17645295800952,59.91745724205161,NaN,NaN,31.45843309110663,19.71230425321932
2016-03-22T09:30:00-04:00,175.3,176.26,175.151,175.7,3980100,3847682.8,71.26873909439438,65.68310314406641,NaN,NaN,126.1265575630155,139.0202791269355,0.5021053525843984,2.828349997320089,2.3262446447356906,198762612,197356820.4,81.46938017758708,63.11331738944704,NaN,NaN,33.05898584520657,21.61897305207464
2016-03-23T09:30:00-04:00,175.22,175.55,174.6,174.81,5039197,3699452.35,66.79327778237635,66.12174853625181,NaN,NaN,97.32691684808678,133.3521196108025,0.3491089230084903,2.7626307984963034,2.413521875487813,193723415,197966447,81.80396294348566,66.24555705360176,NaN,NaN,33.30856895722072,23.288915324238367
2016-03-24T09:30:00-04:00,173.85,174.94,173.7011,174.94,5104879,3691349.7,67.11809106701627,66.49486347937064,NaN,NaN,77.81404404101845,120.43366198023875,0.22120553642267016,2.6900287960161506,2.4688232595934805,198828294,198782959.4,82.26582073509016,69.09279006272324,NaN,NaN,33.601462338318186,24.76213632624977
2016-03-28T09:30:00-04:00,175.13,175.59,174.66,175.12,3098840,3656393.5,67.59079582863362,66.82131998346995,NaN,NaN,85.09321465050076,106.49655844614126,0.11842160095329524,2.6168502607850996,2.4984286598318044,201927134,199196833.4,82.50817828171432,71.4870915971119,NaN,NaN,33.96844626113404,26.077323459804667
2016-03-29T09:30:00-04:00,174.49,176.18,174.06,176.07,5584064,3761344.7,70.03888227475956,67.54934683348755,NaN,NaN,86.68248512851692,94.60864364622768,0.08563984889553744,2.605478470951226,2.5198386220556888,207511198,200150530.6,83.08192912882201,73.67286131987782,NaN,NaN,34.92112388715205,27.340723520854294
2016-03-30T09:30:00-04:00,177.11,177.65,176.51,176.89,3858005,3758531.15,72.00459507888242,68.35687987382565,NaN,NaN,117.61655005172784,92.90664214397015,0.08996109600961821,2.6322899920677116,2.5423288960580934,211369203,202671848.8,84.52692547630659,75.71839282005557,NaN,NaN,36.283214630883585,28.618222250858476
2016-03-31T09:30:00-04:00,176.93,177.3,176.43,176.64,3155448,3760994.15,70.48622667667553,69.04968108809729,NaN,NaN,102.14738285341176,93.87073534503513,0.04882131746584362,2.603355542890398,2.5545342254245544,208213755,205569916.8,86.00641069102832,77.60619249865029,NaN,NaN,37.05744073622346,29.823824891624902
2016-04-01T09:30:00-04:00,175.71,177.85,175.41,177.72,4035231,3814345.25,73.12296334415454,69.6011566780108,NaN,NaN,99.1690654932742,98.14173963548629,0.06611028315710943,2.6371720793709414,2.571061796213832,212248986,208254055.2,87.22479143951688,79.33989888467629,NaN,NaN,38.462956417661175,31.05798653820151
2016-04-04T09:30:00-04:00,177.63,177.88,176.88,177.12,2318852,3754043.65,69.41279405813093,69.86192645347111,NaN,NaN,100.51706506810802,101.22650971900774,0.011750583710131046,2.585750025851496,2.573999442141365,209930134,209854655.2,87.90127330848348,80.91284963054889,NaN,NaN,38.68308006035688,32.14728561279514
2016-04-05T09:30:00-04:00,176.08,176.96,175.57,175.82,5439644,3864227.25,62.06490148189163,69.56346985835862,NaN,NaN,60.53927296132857,95.99786728557005,-0.1293666323396061,2.4122911517168575,2.5416577840564636,204490490,209250513.6,86.04912719735832,82.08739859359132,NaN,NaN,36.77283786491625,32.80807879166958
2016-04-06T09:30:00-04:00,175.86,177.09,175.24,177.04,4086717,3926930.55,65.73116573975265,69.4015784405692,NaN,NaN,68.38696122064783,86.15194951935408,-0.15634881582927473,2.3462217642698704,2.502570580099145,208577207,208692114.4,84.2814506125294,82.90758974536357,NaN,NaN,36.12574615879848,33.282031272687995
2016-04-07T09:30:00-04:00,175.78,176.23,174.68,175.29,5251873,4010325.05,57.192593776833874,68.42363700711692,NaN,NaN,23.010233860764394,70.32451972082461,-0.29956103238990783,2.1281192896117602,2.427680322001668,203325334,207714430.2,81.13860972709502,83.31405298600644,NaN,NaN,32.824329482785956,33.21664530270199
2016-04-08T09:30:00-04:00,176.25,176.81,175.11,175.66,2565444,3895307.2,58.422358738374996,67.43534636144528,NaN,NaN,37.15782765045722,57.922272152261215,-0.37214035340919427,1.962504880240175,2.3346452336493693,205890778,206442788.6,77.11091045311562,83.2532302235816,NaN,NaN,30.495497152587127,32.82790985268558
2016-04-11T09:30:00-04:00,176.12,177.17,175.409,175.44,3237737,3873486,57.36706950699023,66.32960388920478,NaN,NaN,39.91105511977526,45.801070162594655,-0.4334478544610314,1.7928354155730801,2.2262832700341115,202653041,204987370,72.66498148908627,82.71669654722994,NaN,NaN,28.27798610409881,32.177920745744615
2016-04-12T09:30:00-04:00,175.73,177.28,175.36,177.09,3588379,3919983.35,62.79505886793566,65.7243410158863,NaN,NaN,71.74614263917034,48.04244409816302,-0.36414960994088297,1.7710962576080078,2.135245867548891,206241420,205337556,73.06734756459036,82.11655136058732,NaN,NaN,27.90930308471189,31.56811822273994
2016-04-13T09:30:00-04:00,178,179.02,177.92,178.92,5400230,4068413.35,67.70602692566017,65.78953738326372,NaN,NaN,206.4927210588636,75.66359606580616,-0.20430579272952087,1.8798636266369897,2.0841694193665106,211641650,205950444.6,73.79439642643865,81.54443946651254,NaN,NaN,29.177420934056197,31.226590038642264
2016-04-14T09:30:00-04:00,179.03,179.5,178.748,179.11,3689733,4075090.15,68.17571798844236,65.86508216336559,NaN,NaN,209.42058454176953,112.94566620200717,-0.10028435617467135,1.9588139741481712,2.0590983303228425,215331383,208351654.4,76.47397376632489,81.13073611160073,NaN,NaN,30.331279767005515,31.098688571265587
2016-04-15T09:30:00-04:00,178.99,179.14,178.4134,178.68,3799923,4061563.8,65.84176647376326,65.74015149516056,NaN,NaN,156.70702384855036,136.8555054416258,-0.0760426651813666,1.9640449988461341,2.0400876640275007,211531460,209479790.8,77.63123226300105,80.78238282454979,NaN,NaN,30.584636202214714,31.025252518544033
2016-04-18T09:30:00-04:00,178.13,179.83,178.1,179.78,2573666,3934645.5,68.78567908132831,65.65063698134404,NaN,NaN,159.13206434768756,160.69970728720827,-0.005261820358092972,2.0335103885798844,2.0387722089379774,214105126,211770207.8,79.80341958143616,80.54820357116509,NaN,NaN,31.698790495873418,31.121472229591088
2016-04-19T09:30:00-04:00,180.14,180.77,179.59,180.32,2992149,3940005.55,70.14592936226063,65.51787514444248,NaN,NaN,178.4647316638167,182.04342509213754,0.055252516642219085,2.107837854740751,2.052585338098532,217097275,213941378.8,81.62499376805069,80.3409227348611,NaN,NaN,33.033189444862984,31.394574688915643
2016-04-20T09:30:00-04:00,180,181.42,180,180.75,2628876,3872444.35,71.22138906045332,65.57038674328376,NaN,NaN,168.0161637488028,174.3481136301254,0.09901386921183564,2.1763526746133266,2.077338805401491,219726151,215558279,82.8644759275897,80.1164988231869,NaN,NaN,34.45935444798224,31.8324003687823
2016-04-21T09:30:00-04:00,180.64,180.88,179.42,179.7,2760309,3758499.95,65.0582950966026,64.99433901131576,NaN,NaN,115.72651459472844,155.60929964071718,0.0353049181991123,2.121469953150381,2.086165034951269,216965842,215885170.8,83.11249426381154,79.82276331063653,NaN,NaN,33.87896786284671,32.12476715364864
2016-04-22T09:30:00-04:00,179.61,180.08,178.87,179.9,2410490,3623780.5,65.66771473044653,64.7268333450526,NaN,NaN,86.75359414966042,141.6186137009392,-0.01273299584508214,2.070248790144916,2.082981785989998,219376332,217454145.2,84.28797388670385,79.56467049479511,NaN,NaN,33.57399257798258,32.331799357124915
2016-04-25T09:30:00-04:00,179.23,179.59,178.33,179.54,2485534,3593115.2,63.520174916464036,64.83078144752204,NaN,NaN,59.46365302505284,121.68493143641224,-0.08413925134745837,1.977807721805675,2.0619469731531335,216890798,218011279.6,84.69535569945711,79.46797253065931,NaN,NaN,32.71550789080354,32.386614861936145
2016-04-26T09:30:00-04:00,179.84,180.26,179.11,179.64,2241002,3425962.1,63.87359904962785,64.69809811251314,NaN,NaN,73.59255676685565,100.71049645702003,-0.13690120091959512,1.8908204720036395,2.0277216729232346,219131800,218418184.6,85.00122988649,79.5193853359422,NaN,NaN,32.09382377751918,32.344787564162296
2016-04-27T09:30:00-04:00,179.12,180.65,178.99,180.25,3569278,3411525.75,66.03525386863849,65.32971669049917,NaN,NaN,78.10778970894862,82.7288216490492,-0.14235235807716395,1.8497812253267796,1.9921335834039435,222701078,219013170,85.45886144510801,79.8279747443717,NaN,NaN,32.12825267472847,32.31385400852889
2016-04-28T09:30:00-04:00,179.06,180.15,177.74,178.2,3550741,3431290.4,54.280485388815556,65.03386859410206,NaN,NaN,20.901551568053225,63.76382904371417,-0.2872948043818402,1.6330150779266432,1.9203098823084834,219150337,219450069,85.80144298113764,80.44872706780185,NaN,NaN,28.54950491991443,31.77608985301254
2016-04-29T09:30:00-04:00,177.4,177.95,176.29,177.59,5496005,3504329.1,51.3512778669951,64.60416919124528,NaN,NaN,-42.95827377913862,37.82145545795436,-0.4195173269168406,1.3959132236624328,1.8154305505792734,213654332,218305669,80.45459456324647,81.00512800167044,NaN,NaN,24.649505422423264,30.758006362928356
2016-05-02T09:30:00-04:00,178.08,178.91,177.51,178.7,2463102,3511541.6,56.00390623371888,64.11908686022979,NaN,NaN,3.7860169484986557,26.68592824264352,-0.4261133779261921,1.2827888281715332,1.7089022060977253,216117434,218150996.2,79.73140280630881,81.48113194750748,NaN,NaN,22.668695234780103,29.602390487478605
2016-05-03T09:30:00-04:00,177.48,177.83,176.48,177.3,4643212,3471720,49.56526666136949,62.82331826992331,NaN,NaN,-55.842762292498165,0.7988644307727526,-0.5128345520792716,1.0678590159986356,1.5806935680779073,211474222,216619480.6,72.75754901562078,81.40707141816335,NaN,NaN,18.83500733984417,28.0641928949594
2016-05-04T09:30:00-04:00,176.38,177.21,175.9,176.32,3446031,3439685.7,45.61215476767099,61.211635182725345,NaN,NaN,-91.48601849505508,-33.119897210027986,-0.617258261404813,0.809120741321891,1.426379002726704,208028191,213684903.2,61.633365539690864,80.34702797340377,NaN,NaN,14.317101452324444,26.100322688868694
2016-05-05T09:30:00-04:00,176.83,177.22,176,176.4408,1778820,3266033.05,46.181945260163346,59.80736223889678,NaN,NaN,-95.58141448019174,-56.41649041967698,-0.6556461726597824,0.606821286901976,1.2624674595617584,209807011,211816238,55.78446827422516,78.78654483134835,NaN,NaN,10.897690634917238,23.92851810973277
2016-05-06T09:30:00-04:00,175.69,177.4,175.68,177.34,2940804,3284801.05,50.35153405272773,58.49063759399674,NaN,NaN,-88.8685344943912,-65.59854256272749,-0.5994617475023774,0.5131402751837868,1.1126020226861641,212747815,211634934.6,55.236764822203604,77.03178377711745,NaN,NaN,9.239463469964114,21.830081732622965
2016-05-09T09:30:00-04:00,177.25,177.76,176.62,176.98,1921722,3219000.3,48.7239674816916,56.96049745967038,NaN,NaN,-79.24328139024034,-82.2044022304753,-0.5659394021574394,0.40517776998936483,0.9711171721468043,210826093,210576666.4,52.02587046698046,74.91756068418388,NaN,NaN,7.391945552353992,19.7674908497274
2016-05-10T09:30:00-04:00,177.72,179.27,177.64,179.2,2867189,3182940.8,57.78586431026915,56.00081712037151,NaN,NaN,5.6648977499645286,-69.90287022198275,-0.38243904311267396,0.4930683682559618,0.8755074113686357,213693282,211020478.4,53.25313518604389,72.8024649169306,NaN,NaN,8.641749346853544,18.178099206459706
2016-05-11T09:30:00-04:00,178.7,178.94,177.26,177.2992,2697230,3047790.8,49.6887398621262,54.90299174648033,NaN,NaN,-45.13949741012849,-60.63356600499744,-0.3766629358000315,0.4046787416185964,0.7813416774186279,210996052,211614050.6,54.91436062931135,70.7883125144663,NaN,NaN,6.942795452659459,16.57305581305967
2016-05-12T09:30:00-04:00,177.81,178.12,176.4,177.42,2534928,2990050.55,50.16664807619099,53.79577269974779,NaN,NaN,-68.46650725371578,-55.21058455970225,-0.35271145927647807,0.34045235332303037,0.6931638125995084,213530980,212358844.4,56.980177785077515,68.83775565006442,NaN,NaN,5.7848501213766825,15.031883571390672
2016-05-13T09:30:00-04:00,176.9,177.52,175.26,175.48,3336778,2966893.3,43.08793289279149,52.33632684091405,NaN,NaN,-120.8483393357287,-61.60654552796975,-0.4493351302578167,0.1314948997772376,0.5808300300350543,210194202,211848121.8,55.11526197896419,66.72489181288637,NaN,NaN,2.3361533679332522,13.218207828039613
2016-05-16T09:30:00-04:00,175.69,177.7,175.58,177.26,2393474,2957883.7,50.05196433401033,51.34906721836994,NaN,NaN,-72.13328127033195,-60.184545503988076,-0.3780419602158148,0.10827757976528574,0.48631953998110056,212587676,212200438.4,56.18071290415016,64.66628345700495,NaN,NaN,1.8444604455281541,11.59338677339512
2016-05-17T09:30:00-04:00,176.91,177.24,174.92,175.56,3349473,2975749.9,44.45685357557099,49.80775291172226,NaN,NaN,-110.26173768734775,-83.36987259145053,-0.4264629090782967,-0.046759096366770336,0.37970381271152637,209238203,211309422.6,52.7691614081578,62.33130488293708,NaN,NaN,-0.5620029354240631,9.856902529278093
2016-05-18T09:30:00-04:00,175.08,176.73,174.53,175.63,4099817,3049296.95,44.73082442115157,49.125634271174825,NaN,NaN,-116.8947618094384,-97.72092547131251,-0.43345078207938786,-0.1621096648877085,0.27134111719167936,213338020,211777816.2,54.33887885925072,60.08397887423087,NaN,NaN,-2.3030767484374266,8.11976263246159
2016-05-19T09:30:00-04:00,174.95,175.2,173.67,174.68,5090908,3165826.9,41.722953698152665,48.43789683054323,NaN,NaN,-163.52353586618452,-116.73233119380627,-0.47820898505657206,-0.3264201141290357,0.15178887092753635,208247112,210721042.6,50.27878312272385,57.92856377133639,NaN,NaN,-4.715667574610528,6.286129745737002
2016-05-20T09:30:00-04:00,174.72,175.54,174.51,174.76,2749664,3182785.6,42.07618605487427,47.44305967491147,NaN,NaN,-131.96920845058366,-118.95650501677726,-0.4774724714295219,-0.4450517183593661,0.03242075307015585,210996776,210881557.4,50.87913983949392,55.86768784513533,NaN,NaN,-6.511627092001341,4.457878768917238
2016-05-23T09:30:00-04:00,174.84,175.33,174.6,174.78,1735966,3145307.2,42.17055664067883,46.914866102004986,NaN,NaN,-121.33097955962593,-128.79604467463605,-0.4510001635593541,-0.5313294513790368,-0.08032928781968268,212732742,210910570.6,50.99432042293353,54.313171517086246,NaN,NaN,-7.92797812093195,2.688470641795926
2016-05-24T09:30:00-04:00,175.76,177.2349,175.65,176.86,2797044,3173109.3,51.09447257853517,47.30646023135243,NaN,NaN,-19.341395800230814,-110.61197629721269,-0.2772925724996504,-0.4269450034442457,-0.1496524309445953,215529786,212168887.2,55.83162777674439,53.89876167687578,NaN,NaN,-6.449113520488751,1.3831014757552578
2016-05-25T09:30:00-04:00,177.5,178.74,177.45,178.28,2729762,3131133.5,56.07760228445002,48.01329287594434,NaN,NaN,94.75319136564318,-68.28238566219636,-0.06189444957615531,-0.22702049291478943,-0.16512604333863412,218259548,213153192.8,59.22243621724135,54.14433081566265,NaN,NaN,-3.5500450287399032,0.6783662608273776
2016-05-26T09:30:00-04:00,178.49,178.69,177.82,178.08,2263217,3066757.3,55.22411057034448,48.3613340557741,NaN,NaN,101.66953096626904,-15.24377229570565,0.06509942009352249,-0.08375176822173103,-0.1488511883152535,215996331,214703036.6,63.91931443777075,54.7645129310603,NaN,NaN,-1.492949813049918,0.3681782502734783
2016-05-27T09:30:00-04:00,178.22,178.59,178.06,178.5,1628332,2873373.65,56.7140241018074,48.93205238578238,NaN,NaN,105.20873631959245,32.19181665832958,0.169444564823486,0.06295451771410399,-0.10649004710938201,217624663,216028614,67.3800841760695,55.861242481709496,NaN,NaN,0.6475890321870362,0.4080940762611294
2016-05-31T09:30:00-04:00,178.98,178.98,177.13,177.65,2395404,2869988.75,52.87911281527462,48.581570136139916,NaN,NaN,77.18113593292627,71.89423975684002,0.17268935114424824,0.10937164182092829,-0.06331770932331995,215229259,216527917.4,68.60173661815968,56.95757115543205,NaN,NaN,1.3636508104597107,0.544602181146641
2016-06-01T09:30:00-04:00,176.98,177.975,176.55,177.73,2481221,2761889.2,53.19986359582928,48.83236468854727,NaN,NaN,41.30304299871521,84.02312751662923,0.17135312778057588,0.1508737004023999,-0.020479427378175985,217710480,216964056.2,69.67024662707804,58.01156301241538,NaN,NaN,2.0377254224090007,0.7579055013269781
2016-06-02T09:30:00-04:00,177.3,178.31,176.98,178.28,1965896,2687882.45,55.44532172446305,49.20941280628099,NaN,NaN,64.4498345709556,77.96245615769172,0.19681941688722776,0.2255448437308587,0.028725426843630955,219676376,217247421.8,70.37563627761538,58.968381476168084,NaN,NaN,3.2428059123167485,1.1128912743255168
2016-06-03T09:30:00-04:00,177.87,178.29,176.835,178.06,4367218,2817302.35,54.32257229378919,50.0118870492094,NaN,NaN,51.0528965133285,67.83912926710362,0.1881618242001688,0.26392770709384195,0.07576588289367316,215309158,217109987.2,69.53099502547863,59.99807669377627,NaN,NaN,3.9532337604445753,1.5186544866282394
2016-06-06T09:30:00-04:00,178.49,179.46,178.41,179.18,2720256,2806274.95,58.88691293559474,50.642954806465426,NaN,NaN,118.87939959375863,70.57326192193685,0.24365669946599,0.38033675722616067,0.13668005776017067,218029414,217190937.4,69.76120332958475,60.968111724164444,NaN,NaN,5.891863425261347,2.143398620718683
2016-06-07T09:30:00-04:00,179.46,179.99,179.34,179.38,1572342,2788805.95,59.66206468496612,51.729041314279364,NaN,NaN,133.11371583797913,81.75977790294742,0.2771843721254551,0.4831605229169895,0.20597615079153445,219601756,218065436.8,72.20443419325977,62.356345494528874,NaN,NaN,7.723923323443774,2.940616435393696
2016-06-08T09:30:00-04:00,179.67,180.18,179.54,180.06,1713453,2731119.15,62.266969904469285,52.98162313451634,NaN,NaN,143.677197150027,102.23460873320978,0.3251865711437923,0.6124593647212748,0.28727279357748253,221315209,218786382.6,74.064876093478,63.765345296973685,NaN,NaN,10.054818119761284,3.956930961731923
2016-06-09T09:30:00-04:00,179.37,180.04,179.14,179.88,2141814,2703348.35,61.14142686596837,54.36865693221746,NaN,NaN,118.70931001159565,113.08650382133779,0.324120411416007,0.6924233078474913,0.3683028964314843,219173395,218685786.4,73.3273620448667,65.41167236284103,NaN,NaN,11.71438112029232,5.065138127240551
2016-06-10T09:30:00-04:00,178.7,179.24,178.11,178.71,4126582,2782931.05,54.273997175641995,55.239929155129445,NaN,NaN,62.385540609725425,115.35303264061717,0.2284368217329552,0.6538489235976783,0.4254121018647231,215046813,218633317.4,72.91950534060311,66.98598418434884,NaN,NaN,11.298350431194846,5.9555970278054495
2016-06-13T09:30:00-04:00,178,179,177.36,177.36,5111334,2871658.85,47.62674515506407,55.62965690615697,NaN,NaN,21.15503410186936,95.80815954223931,0.0664569186670742,0.5084832501985659,0.4420263315314917,209935479,217014530.4,61.545587870387536,67.73964614488126,NaN,NaN,8.906549569292526,6.377161676589318
2016-06-14T09:30:00-04:00,177,177.42,175.9993,176.81,3643390,2934154.65,45.19799356808351,55.20847983398185,NaN,NaN,-37.30658234684079,61.72409990527533,-0.0776823127826996,0.3449234405531172,0.4226057533358168,206292089,214352597,48.22482301393325,67.19630294753762,NaN,NaN,6.167310145237191,6.347182886396157
2016-06-15T09:30:00-04:00,177.25,177.84,176.38,176.57,2470149,2890188.45,44.14020284226252,54.35580844525417,NaN,NaN,-31.95059959437146,26.59854055639563,-0.18312281071552056,0.1937022399414161,0.37682505065693667,203821940,210853943.2,36.915642479123775,65.60296053767208,NaN,NaN,3.600017319376192,5.954730662536162
2016-06-16T09:30:00-04:00,175.73,177.665,174.8,177.46,5573741,2963884.65,48.914824232059104,53.90514513537664,NaN,NaN,-52.3764750633679,-7.618616458597079,-0.18624899302366493,0.14401380937735553,0.33026280240102046,209395681,208898400.4,32.349226841304855,63.34795428078165,NaN,NaN,2.731825491683627,5.494315638128657
2016-06-17T09:30:00-04:00,177.15,177.15,175.77,176.52,2747996,2846739.05,44.580630482336936,53.038474162557314,NaN,NaN,-74.06190293915645,-34.90810516837346,-0.24144449047050565,0.02845718931288843,0.2699016797833941,206647685,207218574.8,29.027552993099974,60.6084877677124,NaN,NaN,0.6672690112999515,4.8047375485816985
2016-06-20T09:30:00-04:00,178.4,179.23,177.76,177.8,2958411,2857176.4,50.95359893679227,52.90093745695144,NaN,NaN,29.41430316550515,-33.25625135564629,-0.18415707220539668,0.03970533952664823,0.2238624117320449,209606096,207152698.2,28.902216972077213,57.772807792992225,NaN,NaN,0.825952198733677,4.236339641460552
2016-06-21T09:30:00-04:00,178.12,178.53,177.73,178.06,1854652,2863110.7,52.15709802143576,52.82645420163761,NaN,NaN,8.165402611451308,-24.16185436398787,-0.1240449285320114,0.06880625106703064,0.19285117959904205,211460748,208186430,33.7372175306634,55.20616285753403,NaN,NaN,1.317571115566587,3.819372709189986
2016-06-22T09:30:00-04:00,178.23,178.948,177.43,177.57,2966225,2871569.75,49.68279950961373,52.414845472005524,NaN,NaN,-9.024731778248848,-19.57668080076335,-0.11289400397813237,0.05173367462637657,0.16462767860450894,208494523,209120946.6,37.85186291545147,52.88303618880804,NaN,NaN,1.001549478290898,3.416826533347259
2016-06-23T09:30:00-04:00,179.02,179.83,178.67,179.81,2949106,2882536.95,59.209354415733685,52.763901337858705,NaN,NaN,109.4939011034418,12.797394432598594,0.04146395757037022,0.21645762556747172,0.1749936679971015,211443629,209530536.2,39.62152943787715,50.74664578969365,NaN,NaN,3.878440637761683,3.4827714054064627
2016-06-24T09:30:00-04:00,174.55,176.68,173.3,173.76,11377874,3338269.8,38.182453259498836,51.28501136099471,NaN,NaN,-239.24920045894416,-20.24006507135895,-0.2516533216781352,-0.1395729841005675,0.1120803375775677,200065755,208214150.2,36.066923691819866,48.339911529853296,NaN,NaN,-2.212961730447658,2.669095243141588
2016-06-27T09:30:00-04:00,172.48,172.48,170.37,171.2,7689951,3641350.75,32.86411281890125,49.370871941990075,NaN,NaN,-317.7397071516439,-89.67086713478876,-0.586576505142626,-0.6211402938507149,-0.034563788708088836,192375804,204768091.8,28.786279568644957,45.238614770952246,NaN,NaN,-9.300385840072876,0.9591693741109504
2016-06-28T09:30:00-04:00,172.85,173.86,172.2,173.82,5642799,3803720.5,41.79899444127754,47.90887369461924,NaN,NaN,-174.1688144574656,-126.13771054857213,-0.5982331676602788,-0.7823552482834373,-0.18412208062315855,198018603,202079662.8,24.612109310423747,41.70627428644836,NaN,NaN,-10.910986147163952,-0.7365671289283213
2016-06-29T09:30:00-04:00,175.16,176.82,175,176.64,5578181,3958568.5,49.57741898940734,47.08287313200773,NaN,NaN,-47.40515648447821,-133.813795489818,-0.39253454888803085,-0.6747902667331971,-0.28225571784516623,203596784,201100115,23.287120656783912,38.13197133015673,NaN,NaN,-8.79972369456466,-1.8884466383049412
2016-06-30T09:30:00-04:00,177.05,179.08,176.86,179,5068990,4113723.2,54.997941062908794,47.134583409669645,NaN,NaN,39.223724441803135,-147.86783082214575,-0.08984637188935479,-0.3945636827068597,-0.3047173108175049,208665774,200544544,22.545764484121918,34.53384698326522,NaN,NaN,-4.905513401899637,-2.319456175961326
2016-07-01T09:30:00-04:00,178.78,179.8,178.78,179.31,3998242,4095274.4,55.67204691387866,47.70924782101355,NaN,NaN,72.91794037907222,-85.43440265454248,0.12714413402828462,-0.14578714328214915,-0.27293127731043376,212664016,203064196.2,32.96837636815225,32.492617590248415,NaN,NaN,-1.858087242269844,-2.2535463282911143
2016-07-05T09:30:00-04:00,178.58,178.68,177.66,178.21,3233098,4120916.5,52.65783103155474,48.24209335411864,NaN,NaN,31.937971546216335,-15.498866914970424,0.18877330588910562,-0.03696464494905172,-0.22573795083815734,209430918,206475219,43.96203946400591,32.18813305096789,NaN,NaN,-0.5797151319842806,-2.014427585961567
2016-07-06T09:30:00-04:00,177.61,179.1,176.96,178.98,5395428,4312070.8,54.51432906258243,48.98310236985577,NaN,NaN,42.046804154230436,27.744256807368778,0.26870307917602515,0.11014089813187411,-0.15856218104415104,214826346,209836767.6,52.26998614707185,33.28487188439276,NaN,NaN,1.0494947729239466,-1.5767243918350649
2016-07-07T09:30:00-04:00,179.15,179.7233,178.04,178.79,2343277,4343562,53.952114140395466,49.3429087918798,NaN,NaN,66.55676506865751,50.53664111799593,0.29403587816641796,0.20898266666387144,-0.08505321150254654,212483069,211614024.6,55.985372115013604,34.97316797537196,NaN,NaN,2.1377455758969304,-1.0460858250162084
2016-07-08T09:30:00-04:00,180.01,181.56,179.98,181.3,5177303,4495336.45,59.843912708651054,50.433143236616516,NaN,NaN,147.0118412082392,72.09426447128314,0.45545788926735264,0.4842691500816443,0.028811260814291625,217660372,213412944.2,59.42796283961358,37.14462582155151,NaN,NaN,5.057384758569869,-0.1741614559324831
2016-07-11T09:30:00-04:00,181.86,182.72,181.78,182.12,2358721,4406943.4,61.57369571618492,51.19172157800171,NaN,NaN,175.92817238050756,92.6963108715702,0.5848260409627433,0.7598438120177207,0.17501777105497746,220019093,214883959.6,62.042394626815565,39.51178136831852,NaN,NaN,7.964517572394786,0.9885069766856982
2016-07-12T09:30:00-04:00,183.01,183.62,182.78,183.39,3127956,4307774.5,64.14948420073296,52.04832059080867,NaN,NaN,183.38379949875522,122.98547646207798,0.7147067741590185,1.0684012387537507,0.35369446459473214,223147049,217627185.8,66.39175522856536,41.84424834674008,NaN,NaN,11.205114602013996,2.4480223517325976
2016-07-13T09:30:00-04:00,183.68,183.8,183.05,183.6,2390525,4245131.25,64.572370804217,53.11186139756605,NaN,NaN,167.28156855816775,148.03242934286544,0.7688245359024615,1.314725134472809,0.5459005985703476,225537574,219769431.4,69.3457494129164,44.09381166798757,NaN,NaN,13.919804894822333,4.086848429316845
2016-07-14T09:30:00-04:00,185.06,185.27,184.5674,184.96,3354714,4289359.5,67.26539308278981,53.687292730927204,NaN,NaN,175.79730192149523,169.880536713433,0.8442565991717806,1.6012213475350734,0.7569647483632927,228892288,223051275.2,73.22795618057962,46.49427072103775,NaN,NaN,17.06620001527761,5.941041513025525
2016-07-15T09:30:00-04:00,185.35,185.5,184.45,184.88,3837177,4202531.3,66.94303466634875,55.741619974273625,NaN,NaN,147.91959549359768,170.0620875705047,0.8352721128462195,1.8010548894210672,0.9657827765748477,225055111,224530223,74.7781450188148,49.25935795868025,NaN,NaN,19.515457450556596,7.880243789815678
2016-07-18T09:30:00-04:00,184.83,185.38,184.71,185.08,2134899,4171876.45,67.36411735190497,58.20590601234532,NaN,NaN,129.0928183000747,160.6950167544181,0.7898131420398671,1.9530492041246816,1.1632360620848146,227190010,225964406.4,76.21634164374878,52.64721953547337,NaN,NaN,21.65672218327,9.848312131737723
2016-07-19T09:30:00-04:00,185.01,185.42,184.82,185.42,2046274,4126269.6,68.10785829743043,60.085110573499094,NaN,NaN,113.37670892410073,146.69359863948722,0.7310100343771684,2.076998605056275,1.3459885706791066,229236284,227182253.4,77.39507876736812,56.41743163954082,NaN,NaN,23.663124246319207,11.821856719535077
2016-07-20T09:30:00-04:00,185.9,186.08,185.39,185.78,2159531,4141513.55,68.91560830128883,61.46640981006205,NaN,NaN,107.74162395042872,134.7856097179394,0.6665358698629045,2.179158408007737,1.5126225381448326,231395815,228353901.6,78.49911619955112,60.36114560688134,NaN,NaN,25.585261277336453,13.78805737064956
2016-07-21T09:30:00-04:00,185.54,185.73,184.54,184.98,2837735,4135089.05,64.97715119561902,62.179210533827074,NaN,NaN,84.8154484734925,116.58923902833885,0.5263393789208006,2.1705467617958334,1.6442073828750328,228558080,228287060,78.2642726453292,64.34103904696757,NaN,NaN,26.24800350183684,15.568049675104884
2016-07-22T09:30:00-04:00,185,185.57,184.76,185.51,3078267,4141547.1,66.34921495186278,62.94186539368308,NaN,NaN,79.52218570605868,102.90975707083105,0.4297087914432993,2.181343372179157,1.7516345807358575,231636347,229603307.2,79.561000435653,67.66908362321763,NaN,NaN,27.177431270079367,17.22653276010124
2016-07-25T09:30:00-04:00,185.27,185.3,184.37,184.81,2316648,3688485.8,62.84721822080247,63.66967876434364,NaN,NaN,65.67788571928554,90.22677055467322,0.28597488356307066,2.1091031851896958,1.823128301626625,229319699,230029245,79.97728566198778,70.24160120878777,NaN,NaN,27.07312853079063,18.633189298771153
2016-07-26T09:30:00-04:00,184.61,185.02,183.7,184.6,4744411,3541208.8,61.7934900033945,64.1896188315445,NaN,NaN,53.44657665045403,78.24074409994388,0.1508711566217127,2.011717247403766,1.8608460907820532,224575288,229097045.8,76.31390324269552,71.95902385847516,NaN,NaN,26.7137274344716,19.787551889585504
2016-07-27T09:30:00-04:00,185.14,185.28,184.11,184.58,4146723,3466405,61.68740976925535,64.74213994789163,NaN,NaN,53.414502718883824,67.3753198536349,0.040040510754347114,1.9108967292249872,1.87085621847064,220428565,226903595.8,68.37735615288572,72.84416557546604,NaN,NaN,26.383016841007546,20.72976116836008
2016-07-28T09:30:00-04:00,184.28,184.66,183.52,184.38,2906313,3332811.6,60.567669512337396,64.79383686244066,NaN,NaN,36.91431110953827,57.79509238084406,-0.06134475245878934,1.7941752778971534,1.8555200303559427,217522252,224696430.2,61.45180362659822,72.98872563167922,NaN,NaN,25.82346737063221,21.457433482970384
2016-07-29T09:30:00-04:00,183.85,184.5,183.54,184.13,4207250,3289724.6,59.1229889307782,64.61878637776874,NaN,NaN,28.668574097883834,47.62437005920909,-0.15454611587411682,1.6623373855132968,1.8168835013874136,213315002,221032161.2,52.03001811818955,72.27355588106307,NaN,NaN,24.984800033152364,21.961342990139237
2016-08-01T09:30:00-04:00,184.35,184.52,183.38,183.87,3295908,3254607.9,57.58463725154658,64.14986873854114,NaN,NaN,19.520159038953718,38.39282472314274,-0.2380181347451451,1.5193608329559822,1.7573789677011273,210019094,217172040.2,44.32088936757434,70.69706546242087,NaN,NaN,23.87769877868933,22.23510810278925
2016-08-02T09:30:00-04:00,183.7,183.8798,182.31,182.97,5139527,3349929.35,52.49303172300061,63.287058804168545,NaN,NaN,-25.047573752308086,22.693994642590315,-0.35131706115243877,1.318232641260579,1.6695497024130177,204879567,213232896,38.114645325733115,68.46627231333635,NaN,NaN,21.558352334674137,22.138428707344236
2016-08-03T09:30:00-04:00,182.85,183.43,182.71,183.36,3008187,3230567.3,54.375605515779924,62.366359692239264,NaN,NaN,-38.57075819164359,4.29694246048483,-0.3942460894490831,1.176742090601664,1.570988180050747,207887754,210724733.8,34.775521978233044,65.71966987031159,NaN,NaN,19.98355835049602,21.83059008493735
2016-08-04T09:30:00-04:00,183.5,183.89,183.15,183.45,2368861,3231846.5,54.82054227995027,61.50046737892509,NaN,NaN,-43.19266882741389,-11.724453526905602,-0.4090649508609314,1.0596569914745828,1.4687219423355142,210256615,209271606.4,32.97319191622405,62.7336017915551,NaN,NaN,18.739420725741933,21.388994462195146
2016-08-05T09:30:00-04:00,184.4,185.28,183.429,185.26,4187650,3182363.85,62.699017874530185,61.16724598768403,NaN,NaN,32.14284018085026,-11.029600310312317,-0.29478935151689223,1.1002352529393988,1.395024604456291,214444265,209497459,33.549645123396814,59.68598061152996,NaN,NaN,19.68336495542788,21.145333104085537
2016-08-08T09:30:00-04:00,185.5,185.7,185.02,185.28,2076652,3168260.4,62.77626054571822,60.78641757684744,NaN,NaN,86.34533395159438,2.335434672215817,-0.2191520945671943,1.1210844862472982,1.3402365808144925,216520917,210797823.6,36.913789967301746,56.794459982953796,NaN,NaN,20.485491278531278,21.051069986149216
2016-08-09T09:30:00-04:00,185.38,185.86,185.06,185.35,1903842,3107054.7,63.064552887270544,60.36848504727471,NaN,NaN,88.629979989216,25.070945420520637,-0.16800725693083374,1.1302275096509504,1.2982347665817842,218424759,213506862,43.34842709141855,54.28369647523004,NaN,NaN,21.236259942505228,21.077525694200073
2016-08-10T09:30:00-04:00,185.4,185.7819,184.84,185.12,1618402,3068448.55,61.38237743704371,60.111715493090756,NaN,NaN,66.37830793007153,46.06075864486366,-0.15365726674716496,1.106163183147828,1.259820449894993,216806357,215290582.6,47.169379960345175,52.062632712016885,NaN,NaN,21.4579712347511,21.131875057135932
2016-08-11T09:30:00-04:00,185.7,186.58,185.6,186.3,2188740,3010149.85,66.34264205512525,60.11124600046666,NaN,NaN,146.65702654853555,84.03069772005355,-0.07278870233438206,1.1688345719770155,1.2416232743113975,218995097,217038279,50.679417434778465,49.9996624976687,NaN,NaN,23.038572383450084,21.404260389466526
2016-08-12T09:30:00-04:00,186.14,186.25,185.5185,185.9,2514802,2944031.1,63.37115657203073,60.14867016841153,NaN,NaN,107.86600323170696,99.1753303302249,-0.055132856704838806,1.172707203430349,1.2278400601351878,216480295,217445485,51.48815331752074,47.96472447306392,NaN,NaN,23.585345190718858,21.715843932502572
2016-08-15T09:30:00-04:00,186.4,186.879,186.33,186.52,1561712,2915371.75,65.91920101748056,60.44336381227482,NaN,NaN,150.86397159164716,112.07905785823546,-0.012803391150880694,1.211835821196587,1.2246392123474676,218042007,217749703,52.119822498736234,46.236575848495406,NaN,NaN,24.77838570535299,22.153349900052632
2016-08-16T09:30:00-04:00,186.17,186.37,185.72,185.76,1614079,2893762,60.37489997187613,60.34961311246201,NaN,NaN,89.72546377878348,112.29815461614893,-0.04526715371631429,1.1680552702020748,1.213322423918389,216427928,217350336.8,51.177729069635944,45.008031056834696,NaN,NaN,24.246159249880417,22.452322664313744
2016-08-17T09:30:00-04:00,185.77,186.225,185.09,186.1,2952145,2933392.7,61.918036014127324,60.44606786258987,NaN,NaN,77.32556076820502,114.48760518377564,-0.0526054554045039,1.1475656046627591,1.200171060067263,219380073,217865080,52.37268299235677,44.35952244010316,NaN,NaN,24.22826073433252,22.706028102887856
2016-08-18T09:30:00-04:00,185.97,186.41,185.72,186.34,2571762,2920094.05,63.01300030269556,60.72392581772682,NaN,NaN,95.43407405132619,104.24301468433376,-0.05007278698334461,1.1375800763380823,1.187652863321427,221951835,218456427.6,53.772497585127965,44.4839852591702,NaN,NaN,24.51386409902169,22.964290388049832
2016-08-19T09:30:00-04:00,185.3,185.645,184.72,185.32,2368457,2884603.55,55.68489597880796,60.588230012531206,NaN,NaN,24.39853674008285,87.54952138600893,-0.12178208279385272,1.0354252598291112,1.1572073426229639,219583378,219077044.2,55.25873400972432,45.26525987646663,NaN,NaN,22.626762655702837,22.91607214057169
2016-08-22T09:30:00-04:00,184.95,185.5119,184.46,185.12,3152753,2926408.8,54.35021563804613,60.72088600646303,NaN,NaN,8.375305121810785,59.05178809204167,-0.18365763336734875,0.9276353009137779,1.1112929342811266,216430625,218754767.8,54.28275792749081,46.42012506230646,NaN,NaN,20.675955269620854,22.59605544472157
2016-08-23T09:30:00-04:00,185.7,186.13,185.25,185.3,1648121,2771594.3,55.386626854470826,60.79310181636952,NaN,NaN,44.990888449595346,50.10487302620404,-0.21145665918475265,0.8469721103001859,1.0584287694849386,218078746,219084931.4,55.156578679606845,47.875914826690305,NaN,NaN,19.32060647439411,22.12813416324622
2016-08-24T09:30:00-04:00,185.06,185.2,184.285,184.66,1882882,2658402.25,50.95679134819066,60.517119606958126,NaN,NaN,-20.62149391536184,30.515462089490672,-0.2682884404188751,0.7230682189613447,0.9913566593802198,216195864,218448089.6,53.05029348442856,49.30999351013348,NaN,NaN,16.859486516671286,21.375470213735515
2016-08-25T09:30:00-04:00,184.28,184.79,184.1,184.37,2034992,2614836.2,49.042712292400104,59.541669208234545,NaN,NaN,-45.15365740272234,2.397915798680965,-0.3173905084468319,0.5946185238216799,0.9120090322685118,214160872,216889897,48.200272587807284,50.35646690044852,NaN,NaN,14.22974608977929,20.35465248174177
2016-08-26T09:30:00-04:00,184.62,185.54,183.14,183.82,3403504,2574648.9,45.54826113611553,58.311097821834345,NaN,NaN,-66.0871152975593,-15.699214608847466,-0.3749429258656144,0.44333037493649385,0.8182733008021082,210757368,215124695,43.36367598652314,50.81717304467861,NaN,NaN,10.921969861569414,19.007126393145718
2016-08-29T09:30:00-04:00,183.83,185.04,183.83,184.83,2229783,2521342.65,52.27349639230948,57.54030807219427,NaN,NaN,-38.62102665305175,-25.098480963819974,-0.3343647394233614,0.40031737652290644,0.7346821159462679,212987151,214436000.2,41.60939618895674,50.69295655164563,NaN,NaN,9.8998258995901,17.706083465494917
2016-08-30T09:30:00-04:00,184.93,185.15,184.02,184.51,1866690,2357700.8,50.15969629226514,56.73868799042437,NaN,NaN,-50.7121681976478,-44.2390922932686,-0.31852277517361705,0.33652864697924656,0.6550514221528636,211120461,213044343.2,38.24264671614708,50.055332748488624,NaN,NaN,8.424219540725767,16.38010290481361
2016-08-31T09:30:00-04:00,184.25,184.36,183.27,183.94,1876350,2301108.95,46.54891265295823,55.32485017598386,NaN,NaN,-125.98232327383533,-65.3112581649633,-0.3342438958367421,0.23724655235693604,0.5714904481936781,209244111,211653992.6,35.18003163743607,48.94823376296416,NaN,NaN,6.0765374988157665,14.908164989671063
2016-09-01T09:30:00-04:00,183.73,184.28,182.9,184.1,3003907,2332861.25,47.68728320642541,54.204573507012064,NaN,NaN,-139.74564327779234,-84.22965533997731,-0.3215753154854778,0.16952130383683084,0.49109661932230864,212248018,211271421.8,34.36452592825252,47.72511752087358,NaN,NaN,4.461551726199488,13.41579166631798
2016-09-02T09:30:00-04:00,184.94,185.42,184.32,184.86,2652839,2256120.7,52.82657003327048,53.26938557956849,NaN,NaN,-30.3146237776922,-77.07515703600389,-0.25275319497158283,0.1751551256078301,0.4279083205794129,214900857,212100119.6,37.7317093475403,46.69739515293101,NaN,NaN,4.546892142798977,12.14880602010098
2016-09-06T09:30:00-04:00,185.11,185.49,184.45,185.32,2152326,2259904.4,55.66557151131815,52.933004975242916,NaN,NaN,-6.642760748009334,-70.6795038549954,-0.17091211612635726,0.21426817542146637,0.38518029154782363,217053183,212913326,40.93395975885937,45.9656973450184,NaN,NaN,5.465356243351319,11.194027480565316
2016-09-07T09:30:00-04:00,185.37,185.4,184.78,185.32,1803576,2254891.1,55.66557151131815,52.486400367899414,NaN,NaN,2.961078694917716,-59.944854476482305,-0.11416783307871398,0.24247050019943117,0.35663833327814515,217053183,214099870.4,45.350125878579476,45.464086122605735,NaN,NaN,6.211906520687062,10.482295914868422
2016-09-08T09:30:00-04:00,184.68,185.11,184.48,184.82,2229856,2285463.8,51.740224866308864,51.68120212244322,NaN,NaN,-32.36013682870182,-41.220417187455595,-0.1077769848375541,0.22191710223120253,0.32969408706875664,214823327,215215713.6,49.1969406199691,45.137260625094385,NaN,NaN,5.759732564148501,9.807644007622718
2016-09-09T09:30:00-04:00,183.57,183.75,180.91,180.91,8242623,2588157.95,32.462250347201575,50.02244172018562,NaN,NaN,-272.8305223474755,-67.83739300139221,-0.3506543009189024,-0.10862378907987136,0.24203051183903102,206580704,214082250.8,45.67953417047949,44.45303206514833,NaN,NaN,-2.434205109618518,8.058808419445398
2016-09-12T09:30:00-04:00,180.09,183.64,179.93,183.3,7056093,2815222.5,45.76443779432483,49.409171874205526,NaN,NaN,-195.3108676005453,-100.83664176596282,-0.3341855488929224,-0.175701424277122,0.15848412461580041,213636797,213829438.8,44.9083001613552,43.783427938995786,NaN,NaN,-3.8286353360742655,6.360602168656875
2016-09-13T09:30:00-04:00,182.06,182.32,180.38,180.8,7477516,3111012.7,37.454351236400846,48.12829504434338,NaN,NaN,-227.16134525578087,-144.94035866751716,-0.4673337245436901,-0.4256830310638122,0.041650693479877876,206159281,211650658.4,38.82454970105721,42.61685444052795,NaN,NaN,-8.6691349971744,4.213496859252407
2016-09-14T09:30:00-04:00,180.84,181.74,180.01,180.43,2990353,3179826.4,36.40084931618974,47.08858489920046,NaN,NaN,-200.69201478342907,-185.6709773631865,-0.5502822724944033,-0.6462021471381263,-0.09591987464372298,203168928,208873807.4,32.737414438005246,41.165934508640575,NaN,NaN,-12.506968078510045,1.8248590110006284
2016-09-15T09:30:00-04:00,180.37,182.62,180.23,182.26,3986359,3231537.1,44.687688479962304,46.77751176974062,NaN,NaN,-121.35837381325985,-203.4706247600981,-0.45576530137305166,-0.6656265013600375,-0.20986119998698588,207155287,207340199.4,29.94501506031382,39.86198754239104,NaN,NaN,-12.238767718159863,-0.1842305217365845
2016-09-16T09:30:00-04:00,181.5,181.5,180.44,180.97,2844334,3245165.7,40.66529269993994,46.4287283100138,NaN,NaN,-134.68556740550932,-175.84163377170486,-0.4530434465812301,-0.7761655082135235,-0.3231220616322934,204310953,206886249.2,29.15235792490195,38.84689339513239,NaN,NaN,-13.598597334044857,-2.1005686377806234
2016-09-19T09:30:00-04:00,181.88,182.32,180.67,180.98,2260410,3239763.35,40.70984544472572,45.60275324232924,NaN,NaN,-100.25798158818324,-156.83105656923246,-0.4240041358447316,-0.8531272314382079,-0.4291230955934763,206571363,205473162.4,26.776301557650513,37.78738663575337,NaN,NaN,-14.575857063540756,-3.8827526986034995
2016-09-20T09:30:00-04:00,181.81,182.04,181.03,181.05,1997763,3182013.85,41.0435634278774,44.951600894872975,NaN,NaN,-85.6292664583972,-128.5246408097557,-0.3751963912080488,-0.8981185846035373,-0.5229221933954885,208569126,205955131.4,28.904728359146546,37.120392467396194,NaN,NaN,-15.212534796738481,-5.5012929983370675
2016-09-21T09:30:00-04:00,181.66,182.84,180.96,182.66,4496503,3324432.95,48.257276023441776,45.07362684990751,NaN,NaN,-45.39933781077659,-97.46610541522523,-0.2174224070565962,-0.7947002022162337,-0.5772777951596375,213065629,207934471.6,37.003340531334324,37.25062881696035,NaN,NaN,-13.311292396268398,-6.617007198041543
2016-09-22T09:30:00-04:00,183.66,184.26,183.32,183.66,2323481,3346462.9,52.17172914671067,45.39394441707075,NaN,NaN,28.261043396815055,-67.54222197321025,-0.03805449324556265,-0.6248459117165908,-0.5867914184710281,215389110,209581236.2,42.8374824873087,37.855839999750074,NaN,NaN,-10.426794716875621,-7.1612625578749824
2016-09-23T09:30:00-04:00,183.41,183.52,182.29,182.42,1741510,3331788.8,47.38469759214462,45.00523924270461,NaN,NaN,-14.194765385514984,-43.44406156921137,0.00258048183491566,-0.5835658161773836,-0.5861462980122992,213647600,211448565.6,48.645309633797936,38.63538287733991,NaN,NaN,-9.6045563146704,-7.510304523131471
2016-09-26T09:30:00-04:00,181.51,181.55,180.58,180.75,2639750,3293601.1,41.81940074733206,44.016227045277034,NaN,NaN,-88.72083371759912,-41.13663199509455,-0.07331729079873761,-0.6777929115107213,-0.6044756207119837,211007850,212335863,51.183376333096774,39.36748406121401,NaN,NaN,-10.813877350823512,-7.982243498516048
2016-09-27T09:30:00-04:00,180.58,182.14,180.242,182,3717305,3367977.2,46.85118521372603,43.38662802402046,NaN,NaN,-60.24612524180752,-36.06000375177662,-0.03176216214467065,-0.644178323392822,-0.6124161612481513,214725155,213567068.8,54.540689742494486,40.02395290863651,NaN,NaN,-10.082692754305286,-8.282307677914512
2016-09-28T09:30:00-04:00,182.36,183.23,181.52,183.1,6413025,3595293.95,50.87736231164852,43.32499498440187,NaN,NaN,-0.763701245544,-27.132876438730097,0.07173152390476145,-0.5227517563671995,-0.594483280271961,221138180,215181579,58.56495656772534,40.69309690490481,NaN,NaN,-8.117487778711324,-8.258761978028343
2016-09-29T09:30:00-04:00,182.82,183.42,180.65,181.22,3376401,3670296.5,44.65168018128013,44.195668543978904,NaN,NaN,-40.47868975290939,-40.880823068674985,0.01828165891299871,-0.5716312066307125,-0.5899128655437113,217761779,215656112.8,59.694338970574435,41.69415439062588,NaN,NaN,-8.592039011289481,-8.306372982779934
2016-09-30T09:30:00-04:00,182.13,183.435,181.97,182.78,4582993,3749250.8,50.107375826307454,44.505878403406236,NaN,NaN,14.109991580293952,-35.219871675513204,0.0887556428091798,-0.47896831203223655,-0.5677239548414164,222344772,217395547.2,63.60980277746057,43.02997600606198,NaN,NaN,-7.0758105253225985,-8.130578346000314
2016-10-03T09:30:00-04:00,182.31,182.57,181.78,182.32,1987754,3715996.55,48.586549346340995,45.3010354112591,NaN,NaN,-7.612649900184711,-18.99823491203032,0.10409435872074135,-0.43760600644048964,-0.541700365161231,220357018,219265380.8,67.28852412883184,45.06311703661732,NaN,NaN,-6.390176478598236,-7.881949507800018
2016-10-04T09:30:00-04:00,182.62,182.93,180.935,181.48,2811155,3748938,45.84987987971424,45.97596616579657,NaN,NaN,-29.693249694590406,-12.887659802586914,0.05958331162273489,-0.4672212256328123,-0.5268045372555472,217545863,219829522.4,68.32879611983374,47.60535858531936,NaN,NaN,-6.709036802076129,-7.714390549839462
2016-10-05T09:30:00-04:00,182.16,183.018,182.11,182.66,1818159,3749667.15,50.101741157317136,46.362684214179055,NaN,NaN,48.872796626597065,-2.9603602281586987,0.10866881368483822,-0.39096852014949945,-0.49963733383433767,219364022,219474690.8,66.88796332245215,50.24414060404353,NaN,NaN,-5.6107384759736565,-7.413868825001489
2016-10-06T09:30:00-04:00,182.34,182.74,181.47,182.52,2368144,3756581.55,49.60408677519339,47.00116950526859,NaN,NaN,35.48795944234874,12.232969610892928,0.12935868191883187,-0.3379389814357978,-0.4672976633546297,216995878,219321510.6,66.23860261718205,52.89315808206353,NaN,NaN,-4.889467625532135,-7.053240082220153
2016-10-07T09:30:00-04:00,182.8,182.99,181.32,182.22,2527731,3470836.95,48.49253973531863,47.55707624031094,NaN,NaN,25.967919853896152,14.604555265613367,0.12066045908950501,-0.3164720894927484,-0.4371325485822534,214468147,217746185.6,59.80802867115277,55.25256716159941,NaN,NaN,-4.620633650930246,-6.705724877750167
2016-10-10T09:30:00-04:00,183.2,183.85,183.04,183.12,1879077,3211986.15,51.969751643783,48.337518255732775,NaN,NaN,134.67979803030747,43.0630448517118,0.17030451232529764,-0.22425190817563134,-0.394556420500929,216347224,216944226.8,56.78568385897193,57.24406398301551,NaN,NaN,-3.376616300431982,-6.230137938133283
2016-10-11T09:30:00-04:00,182.86,182.89,180.45,181.2,3949794,3035600.05,44.99166315681116,48.10426019383058,NaN,NaN,-50.676658283279714,38.866363133973934,0.07355998021901877,-0.3026064452271555,-0.3761664254461743,212397430,215914540.2,53.076930051888,58.39217752019791,NaN,NaN,-4.404736385281579,-5.969366287725896
2016-10-12T09:30:00-04:00,181,181.8,180.66,181.37,1920198,2982092.3,45.687042300061755,47.6410682762128,NaN,NaN,-81.23414442418192,12.844974923818143,0.02334468637862025,-0.346985567472899,-0.37033025385151924,214317628,214905261.4,49.65373356548077,58.879052597210205,NaN,NaN,-5.027009286822749,-5.834743859025447
2016-10-13T09:30:00-04:00,180.13,181.22,179.43,180.84,3460066,2955777.65,43.82690262211563,47.38694006406787,NaN,NaN,-144.37170216922738,-23.12695739849708,-0.03980018559269721,-0.42008048584239077,-0.38028030024969356,210857562,213677598.2,45.78554866539537,58.67478395661002,NaN,NaN,-6.08541565314915,-5.870554115328833
2016-10-14T09:30:00-04:00,182,182.46,181.21,181.29,2698134,2948467.65,45.8430757947464,47.67434542459747,NaN,NaN,-36.51699840558297,-35.6239410503929,-0.045106884903203304,-0.4366639063786977,-0.39155702147549437,213555696,213495108,45.22159145889551,58.248942179881354,NaN,NaN,-6.407953257025922,-5.94732542128556
2016-10-17T09:30:00-04:00,181.17,181.51,180.45,180.72,1801828,2925538.55,43.70333547906925,47.44949901497914,NaN,NaN,-108.87096774192409,-84.33409420483922,-0.07887476153390305,-0.4901504733928732,-0.41127571185897016,211753868,212576436.8,42.390881253059206,57.381098716350266,NaN,NaN,-7.2804542528442875,-6.1377723972225215
2016-10-18T09:30:00-04:00,181.94,182.1,181.12,181.37,1720729,2911686.85,46.755349244394786,47.155069510175295,NaN,NaN,-46.81072549907243,-83.56090764799777,-0.05067406343868558,-0.4746182911573271,-0.42394422771864154,213474597,212791870.2,43.28741497429029,56.289845745390615,NaN,NaN,-7.184179061819716,-6.28725906359355
2016-10-19T09:30:00-04:00,181.85,182.41,181.57,182,1503744,2762048.9,49.60693522957103,47.50901629933893,NaN,NaN,0.6798212070364217,-67.1781145217541,0.013728152734875265,-0.4067840368000475,-0.42051218953492275,214978341,212924012.8,43.864483799816384,55.15914180462219,NaN,NaN,-6.3075277669466985,-6.290154592644
2016-10-20T09:30:00-04:00,181.72,182.45,181.22,181.54,2359648,2763857.25,47.60227770676033,47.330080719371274,NaN,NaN,-17.540257530860348,-41.81182559408069,0.027852165710286703,-0.3856969823970644,-0.4135491481073511,212618693,213276239,45.45759448743459,53.86255549819175,NaN,NaN,-6.107247173830495,-6.264024961384928
2016-10-21T09:30:00-04:00,180.6,181.45,180.23,181.22,5607576,2957160.55,46.20349751538331,47.15986273144573,NaN,NaN,-100.03813652876305,-54.516053218716706,0.01859336308767834,-0.3903074442477532,-0.40890080733543155,207011117,211967323.2,40.821311655049286,51.972040321493,NaN,NaN,-6.312299869748482,-6.270921376865436
2016-10-24T09:30:00-04:00,182.36,182.5,181.65,181.96,1905717,2920458.9,49.87184041528204,47.447145626843415,NaN,NaN,23.375232334701362,-28.066813203391614,0.06276837199278884,-0.3304403423444455,-0.39320871433723437,208916834,211399916.4,38.96600026680257,49.8746977605622,NaN,NaN,-5.491904017041746,-6.159633182604909
2016-10-25T09:30:00-04:00,181.82,182.17,181.25,181.48,3351051,2902146.2,47.60429386316846,47.26875653440423,NaN,NaN,-28.962894754779335,-24.497247054533,0.06011832014188495,-0.3180608141598782,-0.37817913430176314,205565783,209818153.6,34.28758984409248,47.54609965496508,NaN,NaN,-5.398161795758239,-6.050851555912528
2016-10-26T09:30:00-04:00,180.6,182.12,180.35,181.77,5375380,2850263.95,49.109779421157015,47.233448866258776,NaN,NaN,-52.16111478684981,-35.065434253310244,0.07726072678564389,-0.2816032258197083,-0.3588639526053522,210941163,209010718,32.16462775692641,45.11224430780396,NaN,NaN,-4.917684928242042,-5.888970609102459
2016-10-27T09:30:00-04:00,182.3,182.35,181.23,181.53,2027138,2782800.8,47.883568081859416,47.189950891011684,NaN,NaN,-12.537120896530311,-34.064806926444234,0.07191057503950293,-0.2689757338059735,-0.34088630884547644,208914025,208269784.4,30.310038067245372,43.00524497895344,NaN,NaN,-4.826178297563312,-5.737143136025438
2016-10-28T09:30:00-04:00,181.82,182.32,180.67,181.36,3726582,2739980.25,46.988590563844326,46.83415367101606,NaN,NaN,-41.60764503376485,-22.37870862744459,0.05704632496380657,-0.2695784026407182,-0.32662472760452477,205187443,207905049.6,29.411032907630542,41.04991276814334,NaN,NaN,-4.975664483541689,-5.6283604713849025
2016-10-31T09:30:00-04:00,181.58,181.7,181.05,181.17,1415617,2711373.4,45.9547690351731,46.90294694804192,NaN,NaN,-57.317007294951026,-38.51715655337507,0.03559165753460991,-0.28213515568626235,-0.31772681322087226,203771826,206876048,26.979741485724077,39.185827870560196,NaN,NaN,-5.363439028265422,-5.590514550939262
2016-11-01T09:30:00-04:00,181.52,181.52,179.14,180.12,3622289,2751930.1,40.63412237122838,46.5420240959824,NaN,NaN,-180.05865102638006,-68.73630780769521,-0.04383337816557298,-0.37251853592783846,-0.3286851577622655,200149537,205792798.8,24.66791033092403,37.401126210948995,NaN,NaN,-7.161992193056143,-5.815011356955959
2016-11-02T09:30:00-04:00,179.66,180.21,179.05,179.35,3552726,2838658.45,37.22994388713393,46.07081275776942,NaN,NaN,-232.00394489225553,-104.70487382877636,-0.1374606750058775,-0.5005110015196124,-0.36305032651373487,196596811,202923928.4,19.823276095424518,35.546678170236795,NaN,NaN,-9.726862677989544,-6.3738472599607565
2016-11-03T09:30:00-04:00,179.7,179.89,178.84,179.11,1966889,2818595.7,36.21164585935297,45.38285347666989,NaN,NaN,-209.4383104598605,-144.0851117414424,-0.20094491386602847,-0.6142314688462704,-0.41328655498024197,194629922,200067107.8,16.37457606833297,33.4861770709109,NaN,NaN,-12.176750760020239,-7.202833474254968
2016-11-04T09:30:00-04:00,179.11,179.67,178.64,178.71,4337509,2909084.6,34.517111425072855,44.72669461567015,NaN,NaN,-187.66544881750417,-173.29667249819028,-0.2519609513536726,-0.7282377441723327,-0.4762767928186601,190292413,197088101.8,13.69835750124777,31.436711088638656,NaN,NaN,-14.761507222946726,-8.282644009782361
2016-11-07T09:30:00-05:00,181.17,182.45,181.05,182.36,3402426,2985252.05,55.144211833999705,45.32589908635621,NaN,NaN,81.4254119552756,-145.54818864814493,-0.0334520083489841,-0.5180918032548902,-0.48463979490590614,193694839,195072704.4,12.240771151906728,29.21909367275411,NaN,NaN,-10.353856838165266,-8.578531556694205
2016-11-08T09:30:00-05:00,182.2,184.04,182.02,183.38,3437451,2959634.9,59.02827752862739,45.99885210771737,NaN,NaN,171.5620538997294,-75.22404766292304,0.17477115905370805,-0.2661758460887711,-0.44094700514247914,197132290,194469255,11.83471287156361,26.931252892164625,NaN,NaN,-5.362462585359107,-8.119093132217763
2016-11-09T09:30:00-05:00,181.93,186.55,181.75,185.96,8363851,3281817.55,66.84786430784257,47.37353686493753,NaN,NaN,254.34350955572108,22.045443226672273,0.464789215801468,0.14003951460935582,-0.32474970119211216,205496141,196249121,20.23900755968684,25.129925254468358,NaN,NaN,2.1960526179929922,-6.6455008821876556
2016-11-10T09:30:00-05:00,186.83,188.82,186.35,188.13,8748117,3546220.1,71.73422181961755,49.19716002952568,NaN,NaN,352.184094911852,134.36992430101478,0.7636469079882837,0.6298089337932424,-0.13383797419504123,214244258,200171988.2,34.95580111283229,24.71096021573857,NaN,NaN,10.471375601009155,-4.2002328131595394
2016-11-11T09:30:00-05:00,187.95,188.6299,187.41,188.47,5003789,3661502.85,72.4201358970552,50.80775256393805,NaN,NaN,260.2062691898299,223.9442679024816,0.9338516677932336,1.0334766105465008,0.09962494275326719,219248047,205963115,49.70823500710302,25.4782626971886,NaN,NaN,16.853614931931286,-1.1925402781465642
2016-11-14T09:30:00-05:00,189.11,189.39,188.2,188.77,4796413,3811232.1,73.04175927345023,52.62471437895819,NaN,NaN,206.8378436086833,249.02675423316313,1.0098157038413422,1.3618945725549452,0.35207886871360283,224044460,212033039.2,59.95916205050844,27.31194642621831,NaN,NaN,21.951544019231413,2.113757478621718
2016-11-15T09:30:00-05:00,188.76,189.35,188.14,189.34,3750007,3912696,74.2302183690364,54.41903144666385,NaN,NaN,165.2630705536203,247.76695756394128,1.0376585146676136,1.6491520120481198,0.6114934973805062,227794467,218165474.6,67.22715923813227,29.816412960590156,NaN,NaN,26.421084366063763,5.586232748256295
2016-11-16T09:30:00-05:00,188.79,189.18,188.53,188.98,3459072,4010462.4,72.06921805409652,56.14657787325222,NaN,NaN,134.71193549313753,223.84064275142458,0.9721648466342243,1.8266995556732866,0.8545347090390623,224335395,221933325.4,70.74124845059298,32.7043565594007,NaN,NaN,29.33065537681996,8.97829312376539
2016-11-17T09:30:00-05:00,189.09,189.33,188.7399,189.3,4211228,4103041.4,72.82649021143203,57.9921421337942,NaN,NaN,117.40477211490432,176.88477819203507,0.8927832192429341,1.97051373309273,1.077730513849796,228546623,224793798.4,73.09948880608107,35.824960552147175,NaN,NaN,31.923254710899773,12.2561447790703
2016-11-18T09:30:00-05:00,188.9,188.9599,188.32,188.46,4359186,4040621.9,67.64207464945946,59.54123539195751,NaN,NaN,92.22606488894564,143.2887373318582,0.7327948804837359,1.9937241144544657,1.2609292339707299,224187437,225781676.4,73.88240557258747,39.17515084406598,NaN,NaN,32.58164668370187,15.159787908303382
2016-11-21T09:30:00-05:00,188.88,189.41,188.6,189.34,2999080,4095290.05,70.04770348712967,61.64220547166474,NaN,NaN,90.37288058828305,119.99574472777815,0.6387668637412147,2.0593878136472483,1.4206209499060336,227186517,226410087.8,74.39295748555831,42.72693992653986,NaN,NaN,33.86370104276321,17.8317754989405
2016-11-22T09:30:00-05:00,189.92,190.25,189.416,190.02,2756259,4065550.45,71.79279774316572,64.11098074709558,NaN,NaN,93.20242195534146,105.58361500812236,0.5767911913312707,2.141609939070122,1.5648187477388513,229942776,226839749.6,74.75630898923839,46.650727990383714,NaN,NaN,35.462735685505244,20.35048409702118
2016-11-23T09:30:00-05:00,189.93,190.64,189.87,190.59,2465879,3920075.4,73.20221100042116,66.7531639714576,NaN,NaN,90.86807939334821,96.81484378816451,0.5298196077317043,2.2270932574034816,1.6972736496717773,232408655,228454401.6,76.12721446314106,50.91877359001286,NaN,NaN,37.21866161483066,22.760223742422532
2016-11-25T09:30:00-05:00,191.09,191.34,190.98,191.3,1547109,3896073.95,74.88554492333476,69.63662350704773,NaN,NaN,95.00619229910485,92.3351278250046,0.5024415312270842,2.3253255637056327,1.8228840324785485,233955764,229536229.8,77.02739365951761,55.442276172746425,NaN,NaN,39.2096525144397,25.110142138424983
2016-11-28T09:30:00-05:00,190.93,191.21,190.52,190.78,3159631,3867726.4,71.35047615785305,70.7942138158944,NaN,NaN,81.61073092930154,90.2120610330758,0.4091385970119117,2.334307278743438,1.9251686817315263,230796133,230857969,78.11326652437695,60.147454413637156,NaN,NaN,39.86118118931717,27.21743343140958
2016-11-29T09:30:00-05:00,190.83,191.42,190.68,191.19,2264912,3910191.15,72.4545911115538,71.75323621467486,NaN,NaN,80.39933480828354,88.21735187707588,0.3378242508754461,2.347448995325834,2.009624744450388,233061045,232032874.6,79.06075015519764,64.94931421961101,NaN,NaN,40.718429461190894,29.14614714994977
2016-11-30T09:30:00-05:00,191.97,192.25,191.34,191.4,4774552,3967804.3,73.0279557028328,72.194671314317,NaN,NaN,86.89843476902345,86.9565544398123,0.27049683905671884,2.3477457932712866,2.077248954214568,237835597,233611438.8,80.29502161786557,69.23902950948091,NaN,NaN,41.589179275175546,30.923723167839167
2016-12-01T09:30:00-05:00,191.84,192.16,191.57,191.9,8323928,4206364.4,74.39457941662701,72.38469685696055,NaN,NaN,90.85538302019908,86.95401516518247,0.22708838010445342,2.3611094293451345,2.134021049240681,246159525,236361612.8,82.25726446332787,72.61770546308774,NaN,NaN,42.71128409179009,32.6076604426893
2016-12-02T09:30:00-05:00,191.91,191.98,191.43,191.74,2773577,4246698.8,73.11786647611099,72.43453475546453,NaN,NaN,88.93408550037806,85.73959380543711,0.15831016209593152,2.3319087518605954,2.173598589764664,243385948,238247649.6,83.47275590849402,75.02945695604424,NaN,NaN,43.31496341418693,34.13727515290325
2016-12-05T09:30:00-05:00,192.48,192.78,191.89,192.22,2925574,4176102.05,74.53003415750109,72.54084010432531,NaN,NaN,109.07953387740031,91.23335439505686,0.1177186224044946,2.320746867770282,2.2030282453657875,246311522,241350727.4,85.26173356312843,76.83678349265996,NaN,NaN,44.21375458721891,35.57677221494834
2016-12-06T09:30:00-05:00,192.16,192.57,191.87,192.49,2669410,4139451.25,75.31554693403014,72.61836357325343,NaN,NaN,103.10947820043208,95.77538307348655,0.08325180824632428,2.3070930056736927,2.2238411974273684,248980932,244534704.8,86.83624642933623,78.23743257774596,NaN,NaN,45.18825106213808,36.94984062168973
2016-12-07T09:30:00-05:00,192.47,195.69,192.42,195.48,7241340,4329645.7,81.95322966195761,73.32436440238637,NaN,NaN,174.53611707379076,113.30291953444005,0.22782495862153995,2.5086223957042932,2.2807974370827533,256222272,248212039.8,88.38023806417121,79.49736040728726,NaN,NaN,48.397641158143024,38.58524069832592
2016-12-08T09:30:00-05:00,195.83,196.8,195.41,196.28,7032084,4263057.35,83.25096533882432,74.06896976862868,NaN,NaN,215.21319546347002,138.17448202309424,0.3367581838216669,2.701745166859837,2.36498698303817,263254356,251631006,89.60143298661961,80.67607070589715,NaN,NaN,51.48585384988682,40.42818543426319
2016-12-09T09:30:00-05:00,196.44,197.72,196.37,197.69,4392255,4045264.25,85.26248720079121,75.32757066515238,NaN,NaN,217.56662325639087,163.9009895742968,0.4558037696222028,2.9347416950659238,2.478937925443721,267646611,256483138.6,91.04053726353996,81.90165154096519,NaN,NaN,54.84706300113012,42.48802508667275
2016-12-12T09:30:00-05:00,197.84,198.39,197.68,198.08,3791666,3984658.1,85.77149498579278,76.4506986293426,NaN,NaN,202.23215409391835,182.5315136176004,0.508814134732321,3.114955593859122,2.606141459126801,271438277,261508489.6,92.2385944990778,83.17633989907372,NaN,NaN,57.68962280308062,44.65968190330244
2016-12-13T09:30:00-05:00,198.96,199.72,198.6401,199.23,5357519,4012713.4,87.17780340705183,77.54962760533446,NaN,NaN,189.92646671532665,199.89491132057933,0.5649977460597957,3.3123886417015456,2.74739089564175,276795796,267071462.4,93.30573948320186,84.50129922007112,NaN,NaN,60.579794420217695,46.93398369143319
2016-12-14T09:30:00-05:00,198.97,199.83,197.61,198.14,7456119,4198019,79.18870304020679,77.97723417960485,NaN,NaN,140.6990944723,193.12750680028117,0.47598573779337716,3.3423730678834715,2.8663873300900944,269339677,269694943.4,93.74268448666795,85.75954707889447,NaN,NaN,60.372592105998315,48.853784893513925
2016-12-15T09:30:00-05:00,198.54,199.68,198.34,198.66,6032966,4326713.7,80.1244792511413,78.35144377444819,NaN,NaN,125.14882483015349,175.11463267361788,0.4022956555987869,3.369256899588578,2.966961243989791,275372643,272118600.8,94.12424698983642,86.98075088820295,NaN,NaN,60.496787862978366,50.51707103200884
2016-12-16T09:30:00-05:00,198.7,198.966,197.94,198.19,4467711,4339537.85,76.76467876392839,78.73817253202499,NaN,NaN,98.6959472210389,151.34049746654748,0.2779756153520867,3.3144307631798995,3.036455147827813,270904932,272770265,94.22619461039392,88.13167432291846,NaN,NaN,59.552865959498,51.80789887879301
2016-12-19T09:30:00-05:00,198.3,198.9,198.21,198.6,2729350,4258046.05,77.64529735220356,79.10893726349998,NaN,NaN,91.241239880894,129.14231462394258,0.1839647417059238,3.2664110749602173,3.0824463332542935,273634282,273209466,94.29800128546984,89.22004940365218,NaN,NaN,59.03339073139098,52.84011200059272
2016-12-20T09:30:00-05:00,199.16,199.61,199.06,199.42,3062590,4261221.55,79.33240857270427,79.55925532563366,NaN,NaN,96.3177593038827,110.42057314165382,0.13962522114764164,3.2569778596888455,3.117352638541204,276696872,273189681.2,94.2411426743568,90.21620090768727,NaN,NaN,59.086551475650715,53.73246049702958
2016-12-21T09:30:00-05:00,199.43,199.61,199.14,199.16,2523479,4249582.55,77.33935245644068,79.7695962570489,NaN,NaN,85.59763145926581,99.40028053904697,0.059501782300710016,3.1917298664170914,3.1322280841163814,274173393,274156424.4,94.41824674309427,91.08484249909915,NaN,NaN,58.547940100389674,54.42038615465245
2016-12-22T09:30:00-05:00,199.1,199.17,198.5789,198.97,2250872,4238832.2,75.8399038090536,79.96402749511624,NaN,NaN,70.770114134996,88.52453840001547,-0.03451850034837545,3.0890799586809123,3.123598459029288,271922521,273466400,92.23783101054386,91.71091929210272,NaN,NaN,57.68011385734065,54.88606154075076
2016-12-23T09:30:00-05:00,198.96,199.06,198.73,199.05,1374228,4230188.15,76.0504510108714,80.0726286989284,NaN,NaN,66.03688563003557,81.99272608181482,-0.11501091301299127,2.9798348177630487,3.09484573077604,273296749,273944763.4,92.3693900842644,92.21860904361243,NaN,NaN,57.015272933062136,55.19023459679524
2016-12-27T09:30:00-05:00,199.16,199.54,199.13,199.21,2340748,4189244,76.49170298673815,80.1566398455504,NaN,NaN,68.72398057729748,77.4892742210955,-0.17743722732996892,2.8730491966135787,3.0504864239435476,275637497,274345406.4,92.48428278625634,92.62204021196386,NaN,NaN,56.56521164851238,55.38665988989769
2016-12-28T09:30:00-05:00,199.52,199.56,198,198.08,3818062,4266901.5,67.09030886795297,79.09500264597864,NaN,NaN,47.1526607844842,67.6562545172158,-0.30718794164188923,2.666501496891186,2.9736894385330754,271819435,273369919,88.97164320752867,92.6642834364894,NaN,NaN,53.49085805505155,55.11583105634824
2016-12-29T09:30:00-05:00,197.99,198.52,197.63,197.99,3018668,4179107.3,66.39041520182025,77.89067763619265,NaN,NaN,29.90213367307341,56.517154959977326,-0.40526402490603797,2.467109407400528,2.872373432306566,268800767,272295393.8,85.13582825896059,92.34531167022804,NaN,NaN,50.74550775430959,54.491499156057
2016-12-30T09:30:00-05:00,198.25,198.27,196.92,197.51,4277422,3976782,62.637325951280246,76.27459468979899,NaN,NaN,9.380552679694588,44.23924266891704,-0.5023109629209266,2.244484728655408,2.7467956915763345,264523345,270815558.6,80.01922427864935,91.55807502845013,NaN,NaN,47.317783706827484,53.46668266330993
2017-01-03T09:30:00-05:00,198.91,199.1,197.48,198.42,6669759,4171591.1,66.50339126132329,74.8983015666226,NaN,NaN,30.311440353823155,37.09415361367456,-0.5037740707800906,2.117078103101221,2.6208521738813118,271193104,270394829.6,78.57338937638144,90.58198894825752,NaN,NaN,45.28261639553157,52.29753033934159
2017-01-04T09:30:00-05:00,198.76,199.36,198.6,199.15,4823184,4266471.6,69.25200776077736,73.61788759188872,NaN,NaN,59.931089687820524,35.33557543577918,-0.4555893636094037,2.051365469369557,2.506954832978961,276016288,270470587.8,78.64820128191587,89.53502193387996,NaN,NaN,44.28620416533955,51.15305517162702
2017-01-05T09:30:00-05:00,198.95,199.265,197.895,198.75,4124542,4339228.2,66.05361556000014,72.67966705758825,NaN,NaN,29.82961412815452,31.87096610451324,-0.44988786958536897,1.9445949959972495,2.3944828655826185,271891746,270485050,78.66351672191537,88.45793852211192,NaN,NaN,42.521933996884464,49.920037860949506
2017-01-06T09:30:00-05:00,198.73,199.83,198.17,199.51,4322585,4193290.45,68.98460929080869,71.88396206042162,NaN,NaN,76.32266162659215,41.15507169521699,-0.39605903677685417,1.8994090696115506,2.295468106388405,276214331,271967762.8,80.22927582630707,87.46544058185982,NaN,NaN,41.82647072347164,48.76381398416695
2017-01-09T09:30:00-05:00,199.09,199.27,198.75,198.76,2303543,3956863.4,63.18660245925122,70.9140994672304,NaN,NaN,40.834945079024095,47.445950175082885,-0.4103486904688052,1.7825322433023985,2.1928809337712036,273910788,273845251.4,82.0277699768723,86.59412453660829,NaN,NaN,39.47928000763782,47.437451987519935
2017-01-10T09:30:00-05:00,198.72,199.405,198.21,198.4,3029218,3888711.55,60.5556842293864,69.69341281560061,NaN,NaN,-7.91321362797083,39.80101937872409,-0.44076044800632186,1.6419303737633015,2.0826908217696234,270881570,273782944.6,81.76195433221687,85.69869261137592,NaN,NaN,36.74250726124972,45.909602740909904
2017-01-11T09:30:00-05:00,198.63,199.57,198.15,199.33,5209773,3959616.9,64.65046945773528,68.64470287881711,NaN,NaN,46.081538296692194,37.031109100498426,-0.3963536247715802,1.5872487908051482,1.9836024155767285,276091343,273797955.6,81.7772754977114,84.80841638447268,NaN,NaN,35.55277666189509,44.4300561581935
2017-01-12T09:30:00-05:00,198.88,198.91,197.53,198.75,3865239,3885002.9,60.436641939731636,67.43736641333791,NaN,NaN,-60.990647538640125,18.867056767139495,-0.40284114591803655,1.4800509831791828,1.8828921290972194,272226104,273864827.2,81.85042254442405,83.91071465599623,NaN,NaN,33.26386937670644,42.83488661798106
2017-01-13T09:30:00-05:00,198.91,199.35,198.32,198.7,3468891,3685641.5,60.07313553528034,66.31116867949696,NaN,NaN,9.666771070718745,5.5358786559648125,-0.4061466512754046,1.3752088150029635,1.7813554662783682,268757213,272373403.6,74.65303428315214,82.65465774689683,NaN,NaN,31.308772276053826,41.1882988548486
2017-01-17T09:30:00-05:00,198.27,198.65,197.587,198.09,3329829,3550484.65,55.673611919456356,64.85568017296731,NaN,NaN,-104.88381141748029,-23.607872643336066,-0.44209665209375393,1.2287346511611759,1.6708313032549298,265427384,270676722.8,67.39278961118038,80.87061485596224,NaN,NaN,28.325710453750112,39.35078622612024
2017-01-18T09:30:00-05:00,198.08,198.23,197.3,197.95,4634930,3558845.6,54.68376811384493,63.29797053918922,NaN,NaN,-140.17230645201525,-50.05969120814494,-0.4656211020992611,1.0888049256308534,1.5544260277301145,260792454,268658899.6,59.928249842520266,78.54518393140965,NaN,NaN,25.5797507597853,37.38349544521525
2017-01-19T09:30:00-05:00,198.03,198.16,196.69,197.28,3050941,3574925.15,50.09357701428475,62.08391826392721,NaN,NaN,-175.27584525446983,-94.33116791837736,-0.5128863841827851,0.9133180475016331,1.4262044316844182,257741513,264988933.6,49.24475799026659,75.7075492730338,NaN,NaN,21.826058883726176,35.16100450785967
2017-01-20T09:30:00-05:00,197.53,198.2,197.31,197.96,6998974,3771744.35,54.28754996868322,61.219427890131705,NaN,NaN,-98.79156688394009,-101.89135178743734,-0.4852314177178585,0.8196651595370952,1.3048965772549537,264740487,263491810.2,45.66811986388219,72.88842724481393,NaN,NaN,19.756399499837627,32.96034664957081
2017-01-23T09:30:00-05:00,197.86,198.11,197.04,197.78,3249687,3808054.75,53.01745460325484,60.53229422241561,NaN,NaN,-108.93180544675856,-125.6110670909328,-0.4658448602788803,0.7225905019063532,1.1884353621852335,261490800,262038527.6,42.44539842915981,70.20458254127897,NaN,NaN,17.68155820170433,30.777662585589884
2017-01-24T09:30:00-05:00,197.79,199.22,197.62,198.84,5205819,3955802.1,59.08772166126589,60.00260353669722,NaN,NaN,17.239064720586857,-101.18649186331938,-0.3724613990061716,0.722858613427519,1.0953200124336906,266696619,262292374.6,43.199394778895034,67.67786864145852,NaN,NaN,17.624256000829195,28.898604502052642
2017-01-25T09:30:00-05:00,200.01,200.55,199.75,200.42,4880846,4131133,66.1153684907382,59.77855787455157,NaN,NaN,215.4485138990548,-30.062327793105368,-0.20355932726281623,0.8408708533551703,1.0444301806179865,271577465,264449376.8,49.27981077531608,65.58012646241566,NaN,NaN,19.951140345828527,27.620395336877767
2017-01-26T09:30:00-05:00,200.6,200.97,200.42,200.72,3999710,4214081.1,67.2651503813282,59.865096076075005,NaN,NaN,234.87230890398456,51.96730303858551,-0.07740043601725688,0.9476796355964154,1.0250800716136723,275577175,268016509.2,57.401210908099344,64.06139033285737,NaN,NaN,22.186810604526272,26.84416894654184
2017-01-27T09:30:00-05:00,200.69,200.87,200.45,200.63,3576507,4202003.35,66.53573719841594,59.69017664090409,NaN,NaN,184.7158793142446,108.66879227822244,-0.009358077420142719,1.0133824748384939,1.0227405522586366,272000668,269468545.4,60.195222127489444,62.63038649722755,NaN,NaN,23.75154072478503,26.402364914862293
2017-01-30T09:30:00-05:00,199.83,199.9,198.42,199.38,4718049,4286972.4,57.25009602542953,59.26614046705969,NaN,NaN,46.43526766976365,139.74220690152688,-0.055316089532207124,0.9535954403433777,1.0089115298755849,267282619,270626909.2,62.31852062811146,61.222582972316054,NaN,NaN,22.19584887447496,25.801434051949816
2017-01-31T09:30:00-05:00,198.72,198.89,197.56,198.36,4628094,4304506,50.99595724002169,58.58330282496221,NaN,NaN,-48.8699972182915,126.52039451375121,-0.15551399127826515,0.8145190407777534,0.9700330320560185,262654525,269818490.4,59.916384800856164,59.66218514864743,NaN,NaN,18.77631532050625,24.79784566174359
2017-02-01T09:30:00-05:00,199.13,199.4,198.2,198.63,3676914,4154863.75,52.47592826725136,57.71369273992764,NaN,NaN,-4.800780962679861,82.47053554140427,-0.20177663129875,0.7178122429325811,0.9195888742313311,266331439,268769285.2,56.853395055818055,57.88190797422648,NaN,NaN,16.508736245604954,23.613687173723786
2017-02-02T09:30:00-05:00,198.16,198.97,198.02,198.61,2640562,4045732.65,52.3498072962958,57.13606169396793,NaN,NaN,-23.498879082247417,30.796297944157878,-0.22985576288322784,0.6322691706272963,0.8621249335105241,263690877,266392025.6,50.54809713146592,55.646027587586616,NaN,NaN,14.669142076373735,22.335895016959494
2017-02-03T09:30:00-05:00,199.58,200.57,199.44,200.38,4857335,4082372.3,61.230474834346666,57.21872878675839,NaN,NaN,117.03247826010079,17.25961773332913,-0.13030836316460925,0.6992394795547625,0.8295478427193718,268548212,265701534.4,48.853331627352816,53.80319168360096,NaN,NaN,15.876317885821509,21.41309828393978
2017-02-06T09:30:00-05:00,200.03,200.7,199.78,200.28,2770903,4004788.2,60.54393926601104,57.566609311512295,NaN,NaN,113.2848549540413,30.62953519018465,-0.07502759757026667,0.7357633457565385,0.8107909433268051,265777309,265400472.4,48.09615424327642,52.42486058589353,NaN,NaN,16.612058482478133,20.727235455159548
2017-02-07T09:30:00-05:00,200.89,201.3001,200.43,200.58,2606330,4019927.55,61.92324727101197,58.083714965595654,NaN,NaN,130.61656006598875,66.52684664704071,-0.02469214113890328,0.779925766903176,0.8046179080420793,268383639,266546295.2,51.19643614626596,51.80115960758964,NaN,NaN,17.634596376351688,20.28542987247271
2017-02-08T09:30:00-05:00,200.5,200.69,200.15,200.51,2291450,3983039.15,61.384029255023265,58.890175839934116,NaN,NaN,93.25932124897693,86.13886708937207,-0.0036512337140522932,0.800053865899514,0.8037050996135663,266092189,266498445.2,51.05927677918948,51.93076809251271,NaN,NaN,18.31059501080579,20.003310606520294
2017-02-09T09:30:00-05:00,200.82,202.1052,200.77,201.72,3487574,3896929.2,66.77052333198066,59.78181679445536,NaN,NaN,139.35882462330233,118.71040783048201,0.07962035037438675,0.9032305375815497,0.823610187207163,269579763,267676222.4,54.30436384892731,52.547642662873066,NaN,NaN,20.61123010157376,20.09015624867079
2017-02-10T09:30:00-05:00,202.3,203,202.0675,202.74,2880299,3847682.2,70.50543786222963,61.030958455810705,NaN,NaN,168.50260640507568,129.00443345947699,0.18522485593990945,1.0551412571320498,0.8699164011921403,272460062,268458592.4,56.37373201360733,53.54252363319075,NaN,NaN,23.847945439967393,20.626983275998878
2017-02-13T09:30:00-05:00,203.32,204.47,203.32,204.2,2637381,3806106.7,74.86098561986478,62.15762016713919,NaN,NaN,197.40015687922298,145.82749384451333,0.3269488485077563,1.2786024618268357,0.9516536133190794,275097443,270322619.2,60.915193621388326,54.80793783622598,NaN,NaN,28.262916795223475,21.717830921602392
2017-02-14T09:30:00-05:00,204.06,205.18,203.945,205.17,3586627,3818946.6,77.26330990195738,62.95390169651199,NaN,NaN,197.8805828740114,159.28029840611785,0.45186659206833757,1.5164868534045013,1.0646202613361637,278684070,272382705.4,65.22389545255353,55.946801027457234,NaN,NaN,32.79113164915653,23.299731025538698
2017-02-15T09:30:00-05:00,205.39,206.49,205.29,206.38,3646005,3769500.35,79.85006521074436,63.85282418432744,NaN,NaN,211.42243848795596,182.91292185391367,0.5739884537577575,1.7821058285333606,1.208117374775603,282330075,275630282.6,70.70630426594154,56.897164838731676,NaN,NaN,37.549430065491116,25.335402316960472
2017-02-16T09:30:00-05:00,206.55,206.7199,205.85,206.48,4589617,3846434.15,80.05205323459857,64.81827532976907,NaN,NaN,181.84208756671194,191.40957444259556,0.6158102384393778,1.9778801728248254,1.3620699343854477,286919692,279098268.4,75.20211163578574,57.9690855178957,NaN,NaN,41.27949425398009,27.613129736534702
2017-02-17T09:30:00-05:00,205.03,205.92,205.02,205.88,5747721,3783871.5,75.18233620525994,66.09914962832838,NaN,NaN,131.1401573070524,183.9370846229909,0.5590332026919083,2.060861437750333,1.5018282350584247,281171971,280840650.2,77.10342924249609,59.02515041892318,NaN,NaN,42.80362066519375,29.78319986920028
2017-02-21T09:30:00-05:00,206.56,207.3,206.42,207.07,3076688,3775221.55,78.03611790367486,68.03058967573217,NaN,NaN,143.12786136035382,173.08262551921706,0.5563921509934411,2.197318423800226,1.640926272806785,284248659,282670893.4,78.93084454062836,60.38332611462119,NaN,NaN,45.07151080402648,31.967244288461167
2017-02-22T09:30:00-05:00,206.73,207.53,206.64,207.45,2254362,3627648.7,78.87161967698735,69.91599620499903,NaN,NaN,128.1396164610268,159.13443223662017,0.5348604956517835,2.3095018923715145,1.774641396719731,286503021,284234683.6,80.37226712120673,62.06324554786324,NaN,NaN,47.16167438956498,34.137877160047424
2017-02-23T09:30:00-05:00,208.06,208.15,207.21,207.82,3179933,3542603.05,79.68205948967726,71.8682999330977,NaN,NaN,121.62764004384931,141.17547254779885,0.5007600689718279,2.400591482934516,1.899831413962688,289682954,285705259.4,81.64405464665174,64.28438537037651,NaN,NaN,49.11651506030172,36.277682574369464
2017-02-24T09:30:00-05:00,207.08,207.95,207.07,207.93,3703905,3527812.8,79.9285549060361,73.20387708107553,NaN,NaN,104.659124763697,125.73887998719586,0.4428354545463429,2.4533757321456164,2.0105402775992736,293386859,286998692.8,82.70549109384592,66.70239676084032,NaN,NaN,50.76829663736125,38.34777029765401
2017-02-27T09:30:00-05:00,207.73,208.37,207.61,208.29,3433737,3520674.3,80.75159030792683,74.64728072692665,NaN,NaN,101.17071675190371,119.74499187616611,0.3879599091743007,2.4954901640671494,2.1075302548928487,296820596,290128417.8,84.97022195472145,69.33625874022924,NaN,NaN,52.39277739920131,40.35419988358934
2017-02-28T09:30:00-05:00,208.11,208.31,207.68,207.98,2821874,3425865.55,77.79339741383268,75.78086287998528,NaN,NaN,90.14069583568875,109.1475587712331,0.29423005411358805,2.4753178225348336,2.1810877684212455,293998722,292078430.4,86.18417299682093,71.83538280098317,NaN,NaN,52.93603748255023,42.151605254869466
2017-03-01T09:30:00-05:00,209.92,211.59,209.88,211.02,7846089,3586765.3,83.98804227619482,77.39543523864039,NaN,NaN,136.75010464553785,110.8696564081353,0.3941791083358259,2.673811653841028,2.2796325455052022,301844811,295146788.4,87.84746594806963,74.46311059876032,NaN,NaN,55.66429663023481,44.08198973706452
2017-03-02T09:30:00-05:00,211.19,211.19,209.84,209.89,3336864,3569762.8,75.55145735581947,78.02264481177174,NaN,NaN,116.64844630683358,109.87381766073217,0.3432647840905183,2.70871352561835,2.365448741527832,298507947,296911787,88.69088516810173,76.91929069298706,NaN,NaN,54.95647385786262,45.6354874686071
2017-03-03T09:30:00-05:00,210.06,210.32,209.41,209.91,2589010,3567185.2,75.59817788107485,78.38641195597496,NaN,NaN,101.184153869333,109.17882348185938,0.2730691734519808,2.706785208342808,2.433716034890827,301096957,298453806.6,89.38409375436719,79.27717367446992,NaN,NaN,54.43094476144452,46.891981367583874
2017-03-06T09:30:00-05:00,209.26,209.77,209.02,209.48,2524696,3450553.25,72.39496186464261,78.21026740203051,NaN,NaN,85.25790314587807,105.99626076065424,0.1651278673447516,2.640125869071767,2.4749980017270152,298572261,298804139.6,89.54095056232707,81.32187059882268,NaN,NaN,52.99545918320982,47.76390676981615
2017-03-07T09:30:00-05:00,209.21,209.66,208.975,209.17,2740993,3449057.75,70.08925411500755,77.69783484581981,NaN,NaN,76.58885850094794,103.2858932937061,0.0464685120505699,2.5330836417902276,2.4866151297396577,295831268,299170648.8,89.71221092754712,83.07103598989364,NaN,NaN,51.125601301221344,48.24414884573118
2017-03-08T09:30:00-05:00,209.58,209.61,208.43,208.61,3173098,3477396.15,65.9999399885425,76.7085401870911,NaN,NaN,61.42449035774533,88.22077043614759,-0.08874871644407856,2.3756792341845596,2.464427950628638,292658170,297333320.6,82.4257891437942,83.90814205259741,NaN,NaN,48.31666199801994,48.254507867486716
2017-03-09T09:30:00-05:00,208.74,209.09,207.868,208.67,4430109,3584329.1,66.2272992933085,75.72105776271324,NaN,NaN,46.25077141824415,74.14123545842969,-0.18748656068413982,2.230069749773463,2.417556310457603,297088279,297049387,81.3265059386037,84.34559878851299,NaN,NaN,46.10086569906905,47.946844700569905
2017-03-10T09:30:00-05:00,209.69,209.7,208.36,209.15,3003984,3560149.6,68.06700106202734,75.21281953819664,NaN,NaN,59.418057560525185,65.78801619666814,-0.2309530940450748,2.1288649429012594,2.359818036946334,300092263,296848448.2,80.50819516562838,84.588796354451,NaN,NaN,44.711202265707406,47.48461006701812
2017-03-13T09:30:00-04:00,209.13,209.34,208.585,208.94,2261813,3529225.3,66.36376290311938,74.37907989529981,NaN,NaN,49.25632215489662,58.58769999847185,-0.28100585224224073,2.0085607216435335,2.2895665738857742,297830450,296700086,79.86918239573886,84.65582048695889,NaN,NaN,43.076991272608986,46.85495023924538
2017-03-14T09:30:00-04:00,208.57,208.88,207.98,208.54,4433001,3619006.3,63.12367766716794,73.25422689459843,NaN,NaN,19.371078478607046,47.14414399400366,-0.3440477672238864,1.8595068648559163,2.2035546320798027,293397449,296213322.2,77.69038712756655,84.4642576302703,NaN,NaN,40.77746498157306,45.98673805957791
2017-03-15T09:30:00-04:00,208.83,209.91,208.7101,209.58,5736969,3726523.4,67.55857334291707,72.38826359840127,NaN,NaN,62.599651822766305,47.379176287007866,-0.31924468232841896,1.804498779169279,2.123743461497698,299134418,297508571.8,79.30794796593487,84.29739286736196,NaN,NaN,39.93939205107931,45.122831486935254
2017-03-16T09:30:00-04:00,210.17,210.17,209.05,209.44,3018383,3695142.3,66.40089183051543,71.4220019501498,NaN,NaN,66.20563462526856,51.37014892841273,-0.315259492143106,1.7296690963188155,2.0449285884619215,296116035,297314123,78.38906425299248,83.98907666444386,NaN,NaN,38.92310861259392,44.23715679060078
2017-03-17T09:30:00-04:00,209.53,209.53,208.83,208.86,2873236,3609323.25,61.68490917779639,70.06009615514049,NaN,NaN,29.989636116344467,45.48446463957659,-0.3518926972339216,1.6050627169195195,1.956955414153441,293242799,295944230.2,72.05511398033528,83.0665689519877,NaN,NaN,36.694262927381835,43.159600524426644
2017-03-20T09:30:00-04:00,208.85,209.27,208.56,208.8136,3308571,3487365.75,61.30976122432978,68.88269357017599,NaN,NaN,6.357133189623074,36.904626846521886,-0.3772092123796711,1.4854438986788523,1.8626531110585234,289934228,294364985.8,65.48588615383161,81.58811989177418,NaN,NaN,34.75290398115378,41.958643875387665
2017-03-21T09:30:00-04:00,209.33,209.43,206.25,206.35,6192436,3643153.15,45.4906334336726,66.13287865285297,NaN,NaN,-130.14480269884282,7.001450611031916,-0.5475058328345677,1.1782708200153138,1.7257766528498815,283741792,292433854.4,58.46643305417842,79.48947468506766,NaN,NaN,27.4012806291063,39.879020554490324
2017-03-22T09:30:00-04:00,205.96,206.57,205.5007,206.41,3898464,3725358.25,45.85703781698158,64.01184868579311,NaN,NaN,-211.83323570024552,-47.885126893570444,-0.6374478113674578,0.9289668886405593,1.566414700008017,287640256,290135022,51.40288034154408,76.82604576888498,NaN,NaN,21.75873351164519,37.290408119798165
2017-03-23T09:30:00-04:00,206.03,207.3,205.91,206.31,3839976,3758360.4,45.31037365705061,61.848434098362816,NaN,NaN,-164.2126973474017,-93.9687932881045,-0.6810681036412514,0.715079570456453,1.3961476740977043,283800280,287671871,45.1137076158965,73.66387533042278,NaN,NaN,17.053950409299574,34.399485589726936
2017-03-24T09:30:00-04:00,206.58,206.9,205,205.75,4052695,3775799.9,42.27135423206914,59.69674783889328,NaN,NaN,-182.43621312654452,-136.4539631366823,-0.7211720459499245,0.4946826166602989,1.2158546626102233,279747585,284972828.2,39.4219363613519,70.08394574463883,NaN,NaN,12.113431400191349,31.215763562650423
2017-03-27T09:30:00-04:00,204.18,205.505,203.81,205.23,4559589,3832092.5,39.614372242376426,57.51997056227678,NaN,NaN,-200.03345920187942,-177.73208161498277,-0.7527732897755275,0.274888050390814,1.0276613401663415,275187996,282023581.8,34.32575386984304,66.12777024051711,NaN,NaN,7.104670158495872,27.771321647771202
2017-03-28T09:30:00-04:00,205.08,207.07,204.91,206.75,3538040,3867900.8,49.588923156124174,56.347755074246905,NaN,NaN,-107.13599145840162,-173.13031936689455,-0.6454848607108332,0.2208052642778,0.8662901249886332,278726036,281020430.6,32.773816949440985,62.5812007980633,NaN,NaN,5.647071979096185,24.6107145522462
2017-03-29T09:30:00-04:00,206.53,206.56,205.945,206.31,2203350,3585763.85,47.16045972601379,54.98583796229728,NaN,NaN,-90.78170103120513,-148.92001243308647,-0.5803787426728115,0.14081669664761876,0.7211954393204303,276522686,278796916.6,29.581325346643,58.8851164700661,NaN,NaN,3.6928548319040417,21.62244887791161
2017-03-30T09:30:00-04:00,206.3,207.26,206.15,206.96,2849212,3561381.25,50.97962851051049,53.765311351474644,NaN,NaN,-57.3994564350876,-127.55736425062364,-0.4742405961550885,0.12839469412656968,0.6026352902816582,279371898,277911240.2,28.39484085389583,55.16273401922807,NaN,NaN,3.2570099255680196,18.998814741862525
2017-03-31T09:30:00-04:00,206.72,206.93,206.3,206.34,4179559,3640908.7,47.45619748291464,52.414770964317164,NaN,NaN,-62.478509965754256,-103.56582361846559,-0.4279158489349844,0.06774047911292769,0.4956563280479121,275192339,277000191,27.18687363458396,51.39971196485986,NaN,NaN,1.796520642410847,16.54134415622657
2017-04-03T09:30:00-04:00,206.52,206.63,204.88,206.25,4436098,3736478.8,46.9489377579143,51.25943239937048,NaN,NaN,-82.55940233381806,-80.07101224485332,-0.38671073281227375,0.012267912032569939,0.3989786448448437,270756241,276113840,26.026801228458396,47.70945582920927,NaN,NaN,0.4753967369078824,14.246208810609616
2017-04-04T09:30:00-04:00,206.02,206.77,205.81,206.65,2555352,3727196.75,49.5309864438562,49.97174762086613,NaN,NaN,-53.351846128325924,-69.31418317883818,-0.3187224952987875,0.0005755257213593268,0.3192980210201468,273311593,275030951.4,24.643276264349538,43.80483642195317,NaN,NaN,0.11959679120279496,12.228121379265785
2017-04-05T09:30:00-04:00,207.59,208.65,206.16,206.26,4110448,3774064.25,47.12279671667913,48.59474082702068,NaN,NaN,-19.274730248069048,-55.01278902221094,-0.287200693306762,-0.039702845613305726,0.24749784769345629,269201145,273566643.2,22.872690931878708,39.83938118473076,NaN,NaN,-0.8694440007609754,10.357040610690534
2017-04-06T09:30:00-04:00,206.45,207.29,205.92,206.45,3186890,3711903.3,48.438071670959076,47.64853814796087,NaN,NaN,-39.835984349429545,-51.500094605079326,-0.2425189380860419,-0.05565082491409612,0.1868681131719458,272388035,272169870.6,21.30056464793857,36.2140562324167,NaN,NaN,-1.3245783489441019,8.6882379021713
2017-04-07T09:30:00-04:00,206.19,207.07,205.89,206.38,2609251,3692166.65,47.96470360023139,46.69531974623955,NaN,NaN,-41.38322470566001,-47.28103755306047,-0.2079709134501561,-0.07309552864074931,0.13487538480940678,269778784,271087159.6,20.144711287605233,32.9754008848291,NaN,NaN,-1.828849610111142,7.185796828988094
2017-04-10T09:30:00-04:00,206.49,207.32,205.95,206.39,2395161,3698834.05,48.04282037913028,46.877618813772244,NaN,NaN,-31.174312733323553,-37.00401963296157,-0.1760061584758334,-0.08513231328538495,0.09087384519044843,272173945,271370700.4,21.348380051634592,30.324111384647402,NaN,NaN,-2.230215309909338,5.840652237717032
2017-04-11T09:30:00-04:00,206.22,206.42,204.94,206.33,3511470,3652757.5,47.58127089909454,47.00077831963745,NaN,NaN,-69.28113743618567,-40.18987789453356,-0.1514022749838126,-0.09837899853931731,0.053023276444495275,268662475,270440876.8,20.269398886803884,28.100291280737384,NaN,NaN,-2.6861252295774185,4.622541170960682
2017-04-12T09:30:00-04:00,206.3,206.3,205.35,205.67,2181729,3474995.5,42.71951195235057,46.81571676930173,NaN,NaN,-77.35792690866056,-51.80651722665186,-0.17064734124215017,-0.16028590010819244,0.010361441133957726,266480746,269896797,19.64376482587427,26.281009652878648,NaN,NaN,-4.3853043056280825,3.335706102876573
2017-04-13T09:30:00-04:00,205.34,205.94,204.36,204.37,3605178,3504335.25,35.10977664224248,46.304175512885536,NaN,NaN,-158.9295043181799,-75.62522122040193,-0.2568215865686556,-0.3106655420768618,-0.05384395550820618,262875568,267994303.6,17.59828541555696,24.722177442464723,NaN,NaN,-8.332428660674758,1.668829708083526
2017-04-17T09:30:00-04:00,204.93,206.26,204.86,206.17,2260907,3473718.8,48.72841897972683,46.9551788512677,NaN,NaN,-66.8646580499152,-80.72150788925298,-0.18200824218503744,-0.281354258239503,-0.09934601605446555,265136475,267065841.8,16.685168182087565,23.462135607625044,NaN,NaN,-7.4744944463507474,0.362640543164344
2017-04-18T09:30:00-04:00,205.36,205.81,204.42,205.08,2497919,3433186.2,42.8620882052621,46.47469064049185,NaN,NaN,-136.6418611238945,-101.81501756736716,-0.19423104938738575,-0.34213482778869775,-0.147903778401312,262638556,265158764,14.96730403071723,22.190241827716203,NaN,NaN,-8.805596895805195,-0.947107662402733
2017-04-19T09:30:00-04:00,205.26,205.3,203.64,203.85,3606413,3303885.05,37.39164959706332,45.77691848842395,NaN,NaN,-206.47237840649524,-129.25326576142908,-0.26885747156659556,-0.48397561785955645,-0.2151181462929609,259032143,263232697.6,13.46003135035707,21.038720827981496,NaN,NaN,-11.921318112827429,-2.514852012463404
2017-04-20T09:30:00-04:00,204.35,206.21,204.17,205.7,3873706,3302647.15,48.11728065624545,45.57246507026216,NaN,NaN,-67.83323771273157,-127.34832792224329,-0.18151404516906194,-0.44201070275428833,-0.2604966575852264,262905849,262517718.2,12.93912446865393,19.9347410861785,NaN,NaN,-10.454634283246978,-3.649106622575343
2017-04-21T09:30:00-04:00,205.51,205.7284,204.77,205.25,3034835,3262390.1,46.05070028361814,45.47207241316955,NaN,NaN,-72.67440537672354,-110.09730813395201,-0.14359666185610725,-0.43999248490536047,-0.2963958230492532,259871014,261916807.4,12.501231487093719,18.885766647072053,NaN,NaN,-10.089689680742154,-4.569189916599173
2017-04-24T09:30:00-04:00,207.33,207.63,207.03,207.38,3220158,3220763.25,55.740403007282076,46.10003421669582,NaN,NaN,141.05263872485344,-68.51384877899828,0.026330601792768304,-0.26348257080829285,-0.28981317260106115,263091172,261507746.8,12.198585518048773,17.89803695347137,NaN,NaN,-5.944886382044604,-4.765717983091378
2017-04-25T09:30:00-04:00,208.95,209.98,208.84,209.68,3460590,3165813.3,63.38735934683116,47.08977513833688,NaN,NaN,292.80583684992536,17.375690815765694,0.28088022310927563,0.061287106285533355,-0.21959311682374225,266551762,262290388,16.370188355179963,17.3071021028164,NaN,NaN,0.7530377548499236,-3.9773243062426205
2017-04-26T09:30:00-04:00,209.81,210.43,209.44,209.47,2865327,3132177.65,62.32848633909214,48.1758958256521,NaN,NaN,246.56080829414486,107.98232815589373,0.4143030680045945,0.2982857181820009,-0.11601734982259361,263686435,263221246.4,21.167650027495,17.18531346678899,NaN,NaN,5.2054887725192245,-2.6654938664195
2017-04-27T09:30:00-04:00,209.73,209.77,209.06,209.56,1951683,3119594.3,62.61670802787339,49.188655565431695,NaN,NaN,181.60888508001446,157.87075271444292,0.4830127687029135,0.4877486110560483,0.004735842353134775,265638118,263767700.2,23.926562654201803,17.372884752950647,NaN,NaN,8.637600035701574,-1.0507661661164893
2017-04-28T09:30:00-04:00,209.63,209.63,208.97,209.08,1934014,3073834.4,59.980922088013706,50.046956885987576,NaN,NaN,138.115073361382,200.02864846206404,0.4700826960931467,0.5923392124695681,0.12225651637642146,263704104,264534318.2,27.74688738583879,17.915897331395904,NaN,NaN,10.510246116846176,0.6008070171638913
2017-05-01T09:30:00-04:00,209.49,209.49,208.7,208.92,1886009,2959156.9,59.08806266791527,50.83590276375793,NaN,NaN,108.09069046421904,193.43625880993716,0.4260104498405236,0.654769578677076,0.22875912883655236,261818095,264279702.8,27.257288711682122,18.337962235685012,NaN,NaN,11.7166110372369,2.188779020031464
2017-05-02T09:30:00-04:00,209.1,209.3,208.754,209.13,1359664,2805335.2,59.9311276733297,51.718035390489014,NaN,NaN,94.76930171584482,153.82895178312103,0.3873708040715356,0.7129726339259719,0.32560182985443625,263177759,263604902.2,25.950380269059764,18.743746620131862,NaN,NaN,12.943889367332979,3.725223355360251
2017-05-03T09:30:00-04:00,208.87,209.47,208.47,209.22,1829363,2769035.75,60.30862601514054,52.97440068068829,NaN,NaN,83.11711428196269,121.1402129806846,0.3456207450412409,0.7576277611559874,0.4120070161147465,265007122,263869039.6,27.41739403108997,19.299005849075836,NaN,NaN,14.051355167507607,5.200385042809874
2017-05-04T09:30:00-04:00,209.65,209.65,208.198,209.19,2640119,2695519.3,60.1053507702862,54.75979883269142,NaN,NaN,72.47457328118904,99.31335062091951,0.29566388707260916,0.7815868749555079,0.4859229878828988,262367003,263214816.6,26.04128044395243,19.902076922532654,NaN,NaN,14.910228474348965,6.587505533029744
2017-05-05T09:30:00-04:00,209.07,209.78,208.76,209.77,1673787,2619864.15,62.721457201684785,55.759301562831276,NaN,NaN,79.57903773637383,87.60614349591788,0.28143688468953965,0.8377190937448233,0.5562822090552837,264040790,263282153.8,26.450467563423402,20.599598306913787,NaN,NaN,16.376399348663888,7.985918935263193
2017-05-08T09:30:00-04:00,209.7,210.02,209.53,209.92,2311048,2604954,63.390089533554885,57.22558737199505,NaN,NaN,84.01449675401128,82.79090475387633,0.26226741952844956,0.8841164834658457,0.6218490639373961,266351838,264188902.4,31.913224314045436,21.810021184294378,NaN,NaN,17.788858650527235,9.386338894586627
2017-05-09T09:30:00-04:00,210.14,210.32,209.2231,209.62,1570111,2563701.5,61.03231136512498,58.91420606971373,NaN,NaN,72.71792620508776,78.38062965172492,0.2116893002710134,0.8864606892761628,0.6747713890051494,264781727,264509696,33.78692069007728,23.261941851417248,NaN,NaN,18.39619919942608,10.673461795277976
2017-05-10T09:30:00-04:00,209.19,209.81,208.9,209.48,1394296,2457842.8,59.912384542416966,59.75671349015455,NaN,NaN,56.29106312391429,73.01541942011525,0.15380457717573837,0.8670271104748224,0.713222533299084,263387431,264185757.8,32.80517289997506,24.680945310797323,NaN,NaN,18.62932000485933,11.810012968075313
2017-05-11T09:30:00-04:00,209.14,209.45,208.1,209.28,3093717,2503442.2,58.267472603393884,60.62934008442425,NaN,NaN,36.34547981672115,65.78960072722167,0.09019501761007764,0.825966305311681,0.7357712877016034,260293714,263771100,31.541747989694386,26.04098220384023,NaN,NaN,18.417282195572025,12.753908572003414
2017-05-12T09:30:00-04:00,208.97,209.28,208.82,209.01,1575490,2401957.8,56.03095399229041,60.650093726210564,NaN,NaN,35.769203102902324,57.02763380052737,0.021658950518570363,0.7628449758498164,0.741186025331246,258718224,262706586.8,28.506482833258488,27.205832012069497,NaN,NaN,17.668389081208783,13.45597721617561
2017-05-15T09:30:00-04:00,209.4,210.13,209.4,209.93,1818522,2379838.55,61.459378429982635,60.51238080357853,NaN,NaN,65.73848239644141,53.3724309290134,0.029521472653231795,0.7780878661477857,0.7485663934945539,260536746,261543568.4,25.607184370371115,27.86561744172601,NaN,NaN,18.42121685170504,14.165297164108386
2017-05-16T09:30:00-04:00,210.32,210.46,209.46,209.95,1746608,2342273,61.570454078785744,60.458235642128066,NaN,NaN,72.33882549689105,53.296610787374064,0.02735380118207531,0.782758644972148,0.7554048437900727,262283354,261043893.8,24.456315892418957,28.10052214636343,NaN,NaN,19.07816526208653,14.86713546381955
2017-05-17T09:30:00-04:00,208.12,208.59,206.37,206.47,5717401,2447822.4,39.97951289862077,58.841293132895736,NaN,NaN,-108.61854425180431,20.31468931223035,-0.20441113661147325,0.4998909230257311,0.7043020596372044,256565953,259679598.2,21.60164190642594,27.934456378665153,NaN,NaN,12.069684255724825,14.467499576948875
2017-05-18T09:30:00-04:00,206.03,207.96,205.855,206.96,6653817,2586827.95,43.00991356533226,57.629078238418494,NaN,NaN,-146.87912824252768,-16.330232299619418,-0.3141116722005368,0.3116624693865333,0.6257741415870701,263219770,260264809.4,25.612648820387648,27.782010766847215,NaN,NaN,7.574302786956682,13.482757178378561
2017-05-19T09:30:00-04:00,206.75,208.31,206.58,207.77,4892838,2679728.1,47.70987048290164,56.81635022520323,NaN,NaN,-136.13627787485888,-50.711328495171664,-0.3204163454603284,0.2252537097616596,0.545670055221988,268112608,262143686.2,36.79358042976256,28.46317446099582,NaN,NaN,5.467543447190456,12.337726645351689
2017-05-22T09:30:00-04:00,208.32,208.87,208.32,208.65,2246188,2631029.6,52.311296208032935,56.2720765491106,NaN,NaN,-46.06647751707094,-73.07232047787413,-0.25638646380050273,0.22518697547135957,0.4815734392718623,270358796,264108096.2,45.94220380097339,29.891161856132506,NaN,NaN,5.286651230582915,11.330430157527578
2017-05-23T09:30:00-04:00,209.1,209.35,208.69,209.12,3457531,2630876.65,54.60873955265086,55.86494180178992,NaN,NaN,5.768757529516216,-86.3863340713491,-0.17720968347734345,0.260061334925183,0.43727101840252647,273816327,266414690.8,54.305578600187296,31.811746468210885,NaN,NaN,5.898665632571713,10.554463796819597
2017-05-24T09:30:00-04:00,209.32,209.96,209.075,209.82,3483187,2661769.65,57.86456866226629,55.704885936931355,NaN,NaN,71.7326358483065,-50.31609805132696,-0.07760773878164845,0.3402613449254659,0.41786908370711434,277299514,270561403,64.83773636453891,34.58292189110998,NaN,NaN,7.470619368027492,10.11391459270644
2017-05-25T09:30:00-04:00,210.52,210.92,210.3,210.58,2198248,2674097.9,61.124895675390064,55.59084582791029,NaN,NaN,167.8950004987915,12.638727696936877,0.033580948280373446,0.45984526905758116,0.4262643207772077,279497762,273817001.4,70.57254016418017,37.73449850544976,NaN,NaN,9.850308962203082,10.076256645491675
2017-05-26T09:30:00-04:00,210.54,210.719,210.32,210.54,1152162,2635005.3,60.85798718741934,55.4099813746149,NaN,NaN,137.20504210392923,67.3069916926945,0.09507261745073908,0.5451050925906316,0.4500324751398925,278345600,275863599.8,73.49868397670858,40.70488848135426,NaN,NaN,11.646162638553415,10.300528930214782
2017-05-30T09:30:00-04:00,210.21,210.52,209.97,210.21,1066624,2594036.05,58.585139391528664,55.23518337650088,NaN,NaN,95.6280729215153,95.64590178041175,0.10346785145627535,0.5793672894602366,0.4758994380039613,277278976,277247635.8,75.28824272630877,43.66926862679937,NaN,NaN,12.466677353158792,10.609978704921069
2017-05-31T09:30:00-04:00,210.41,210.41,209.32,210,1577523,2604929,57.12311476596287,55.03594982103988,NaN,NaN,60.349142532968166,106.56197878110213,0.08556547200559156,0.5828562780109507,0.4972908060053592,275701453,277624661,75.76827509735611,46.73806164089802,NaN,NaN,12.730342406725113,10.912887805178789
2017-06-01T09:30:00-04:00,210.27,211.4,209.91,211.4,1827924,2604857.05,63.638020829684024,55.41956040863203,NaN,NaN,129.27814753099872,118.0710811176406,0.1546701479506799,0.690628490943709,0.5359583429930291,277529377,277670633.6,75.8299286629746,49.901503117560885,NaN,NaN,15.003141591898025,11.49720977471011
2017-06-02T09:30:00-04:00,211.45,212.21,211.27,211.91,2314011,2588551.65,65.68358747306742,56.10903422868752,NaN,NaN,174.69695793541345,119.43147260496498,0.21753633395652328,0.8078787604386832,0.59034242648216,279843388,277739758.8,75.92910046544125,53.288832948431086,NaN,NaN,17.531688735040298,12.359278197614422
2017-06-05T09:30:00-04:00,211.86,212.205,211.64,211.86,1922998,2601012.2,65.29576262622346,56.38306167127615,NaN,NaN,156.36043629108372,123.2625514423959,0.23696310493014006,0.886546307644835,0.6495832027146949,277920390,277654716.8,75.51856963489912,56.85393189589737,NaN,NaN,19.455644290253566,13.373044782277157
2017-06-06T09:30:00-04:00,211.33,211.78,211.17,211.37,2095011,2590210.35,61.46556318043818,56.37556946425133,NaN,NaN,112.20102292680696,126.57714144345422,0.19952464975860917,0.8989890149129565,0.6994643651543473,275825379,277363997.4,74.04470778236953,60.3959598880367,NaN,NaN,20.001287290210453,14.31993656912477
2017-06-07T09:30:00-04:00,211.69,211.92,211.14,211.72,1545878,2588998.7,63.12926258714697,58.02912301343177,NaN,NaN,107.42221044879896,135.99175502662038,0.1815588387563546,0.9264129135997905,0.7448540748434359,277371257,277697958.2,74.65659880825226,64.18559966673857,NaN,NaN,20.934528600318096,15.264878287866674
2017-06-08T09:30:00-04:00,211.62,212.699,211.39,211.86,2030336,2620800.7,63.80247086370175,59.51430567760102,NaN,NaN,115.13417373342989,133.1629602671066,0.16292438265065434,0.9485095531567538,0.7855851705060994,279401593,278072401.4,75.35805143598367,67.73884271070972,NaN,NaN,21.89625779118946,16.212218216912785
2017-06-09T09:30:00-04:00,212.15,213.07,211.59,212.67,4271113,2679670.5,67.49985511241135,60.927876008280286,NaN,NaN,123.59780974414714,122.94313062885335,0.18723417886248783,1.0196278940842092,0.8323937152217213,283672706,278838265,76.77403243993106,70.59458928286462,NaN,NaN,23.82695955762365,17.30003840844291
2017-06-12T09:30:00-04:00,212.46,212.78,211.88,212.4,3682286,2785010.3,65.11235981703223,61.84223769463738,NaN,NaN,106.4378987619822,112.95862312303305,0.16783641928079063,1.0421892393227097,0.874352820041919,279990420,279252271,77.52583840857721,72.85056318340774,NaN,NaN,24.784313619573968,18.369220581461633
2017-06-13T09:30:00-04:00,212.8,213.39,212.75,213.37,2426866,2815427.5,69.3119050769144,62.892463803513344,NaN,NaN,128.30370697227292,116.17915993212623,0.20081184307886257,1.1253676238904973,0.9245557808116347,282417286,280570652.4,79.77136241928582,74.66954774191478,NaN,NaN,26.908743842543753,19.589152475901937
2017-06-14T09:30:00-04:00,213.78,214,212.98,213.84,5423128,2999253.5,71.12556153118571,63.83967757986473,NaN,NaN,130.3498947637941,120.76469679512527,0.23251861465812096,1.215204049134286,0.982685434476165,287840414,282664483.8,82.72372467875364,75.94711833578727,NaN,NaN,29.25222488538028,20.9695913915417
2017-06-15T09:30:00-04:00,212.89,213.8,212.75,213.69,2571814,2841974.15,69.70958620343903,64.45286976043965,NaN,NaN,113.2339637031413,120.38465478906755,0.22167118972197564,1.2597744216286344,1.0381032319066588,285268600,283837885.2,84.1222831888988,76.91495712326717,NaN,NaN,30.779663296878084,22.371030235161186
2017-06-16T09:30:00-04:00,213.33,213.58,212.82,213.56,2371973,2627881.95,68.43794751906745,64.99429549841452,NaN,NaN,102.31159387042405,116.12741161432294,0.18549137855689102,1.2699674551027726,1.0844760765458816,282896627,283682669.4,83.16324487209218,77.60528290150884,NaN,NaN,31.702071969940594,23.70403619727253
2017-06-19T09:30:00-04:00,214.36,215.01,214.08,214.92,2103348,2488407.45,73.81869648753158,66.0824067195576,NaN,NaN,158.1668258904735,126.4731970400212,0.2299958706745211,1.371970914889033,1.141975044214512,284999975,284684580.4,84.39958762246671,78.25609325123442,NaN,NaN,34.23865964571236,25.208982404192504
2017-06-20T09:30:00-04:00,214.89,215.07,214.37,214.4,1762126,2464204.35,68.97665254724393,66.92908798964909,NaN,NaN,142.42204995694206,129.29686563695503,0.20223730686821528,1.3947716777997812,1.192534370931566,283237849,284848693,84.59907923554968,78.88686497539109,NaN,NaN,34.901478416305615,26.593624691637235
2017-06-21T09:30:00-04:00,214.65,214.67,213.64,213.89,2129397,2397797.65,64.50751056456582,66.99119439928351,NaN,NaN,102.94416528254948,123.8157197407061,0.1308180462677817,1.356056928766293,1.2252388824985112,281108452,283502300.6,76.01129536218733,78.89981973962058,NaN,NaN,34.0958026009673,27.6653643929701
2017-06-22T09:30:00-04:00,214.08,214.29,213.66,213.73,2697075,2358492.05,63.12565570450244,66.80848498724315,NaN,NaN,84.95816832687773,118.16056066545339,0.0578150439674725,1.297507687457852,1.2396926434903794,278411377,282130856,68.39519966697016,78.36168396830122,NaN,NaN,33.03110913121613,28.431899355576675
2017-06-23T09:30:00-04:00,213.44,213.95,213.0644,213.74,1346820,2315920.65,63.1787460343228,66.6572695163931,NaN,NaN,61.36962135505048,109.97216616237866,-0.0016364482668282943,1.237647083156844,1.2392835314236723,279758197,281503170,65.17640327545246,77.62295779976932,NaN,NaN,32.17770212621494,28.967014037096426
2017-06-26T09:30:00-04:00,214.29,214.76,213.53,213.87,1940386,2355331.85,63.90627593414644,66.83160614165799,NaN,NaN,78.64907049471954,94.06861508322785,-0.041815721611538015,1.1870138794092497,1.2288296010207878,281698583,280842891.6,61.87749717184902,76.75387132758928,NaN,NaN,31.65310248300614,29.350740957940673
2017-06-27T09:30:00-04:00,213.71,214.13,212.87,212.93,1981594,2401080.35,55.384847161327755,66.27843361124232,NaN,NaN,31.14962630574009,71.81413035298746,-0.13599887141625389,1.0588310117504705,1.1948298831667243,279716989,280138719.6,58.47804633770783,75.59826043683611,NaN,NaN,28.67173852210827,29.253740609964616
2017-06-28T09:30:00-04:00,213.58,214.53,213.58,214.24,4693745,2556891.45,62.82451686511313,66.20857975420027,NaN,NaN,76.11592669536908,66.44848263555139,-0.11519365588664399,1.0508378133084193,1.1660314691950633,284410734,280799176,60.661023375054626,74.54847271819833,NaN,NaN,28.217319074550655,29.105680390619764
2017-06-29T09:30:00-04:00,214.52,214.55,211.7,212.61,4372622,2684126.35,51.35046858883767,65.05505214537358,NaN,NaN,-12.68923910857585,46.919001148460666,-0.21076798641826278,0.9025714861722349,1.1133394725904977,280038112,281124523,61.728442217148434,73.47378770228529,NaN,NaN,23.710004774740966,28.334869588351363
2017-06-30T09:30:00-04:00,213.15,213.99,212.97,213.24,2216645,2679258.05,54.78750120887521,64.31756224479093,NaN,NaN,17.770973654003168,38.19927160825121,-0.22956829433605996,0.8263791046704227,1.0559473990064827,282254757,281623835,63.3710944549531,72.46273456274069,NaN,NaN,21.255445721323348,27.323523321633076
2017-07-03T09:30:00-04:00,213.95,215.38,213.88,214.49,2135037,2689860,60.717543345399044,63.70367926396842,NaN,NaN,113.22356016511549,45.1141695423304,-0.1591724048858041,0.8569818928992277,1.0161542977850317,284389794,282162077.2,65.10956104120275,71.41546303573477,NaN,NaN,21.271822773027,26.458994671832208
2017-07-05T09:30:00-04:00,214.74,214.83,213.83,214.58,1799148,2675066.85,61.11301983227848,62.98849771404647,NaN,NaN,91.37660402649355,57.15956508648109,-0.11022603971187783,0.8783717481451845,0.9885977878570623,286188942,283456467.8,68.92876780518357,70.4301089733369,NaN,NaN,21.415917205144375,25.738555033733945
2017-07-06T09:30:00-04:00,214.09,214.2458,212.94,213.14,2298846,2712715.25,52.07885303697672,61.729159630727736,NaN,NaN,-14.396701241906644,39.05703949902595,-0.17467946835056591,0.7702484524188549,0.9449279207694208,283890096,283352340.2,68.28124752305446,69.2986064257766,NaN,NaN,18.361481401804852,24.68468737202979
2017-07-07T09:30:00-04:00,213.54,214.1599,213.42,214.05,1326523,2677524.6,56.45925348363146,60.87353862819659,NaN,NaN,26.679257164816146,46.93073875370435,-0.15646129578455348,0.7493513010387289,0.9058125968232824,285216619,284388041.6,71.18114698480204,68.44274229097016,NaN,NaN,17.379272907897764,23.641056734296644
2017-07-10T09:30:00-04:00,213.68,214.3453,213.54,213.99,1156694,2521803.65,56.09516530017454,59.60757211481395,NaN,NaN,30.06156491833978,49.38885700657166,-0.14892771886967537,0.7196529482361882,0.8685806671058636,284059925,284749075.2,72.13742854351754,67.56687378533093,NaN,NaN,16.50716962592983,22.621930004529958
2017-07-11T09:30:00-04:00,213.91,214.2944,212.68,213.98,1577622,2416570.45,56.030312619669296,58.68283354855862,NaN,NaN,-24.362141225093737,21.87171672852982,-0.14495564247726234,0.6873861140092856,0.832341756486548,282482303,284367577,69.51259280043269,66.489267611394,NaN,NaN,15.802142657346513,21.647674669218038
2017-07-12T09:30:00-04:00,214.98,215.7,214.89,215.23,2103369,2400395.6,61.95180593630428,58.5002832179685,NaN,NaN,199.38541667431886,43.47347925809488,-0.06268342878164956,0.753987470509486,0.8166708992911356,284585672,284046923,67.29613015101303,65.86675581059583,NaN,NaN,17.072621321202618,20.99409561950155
2017-07-13T09:30:00-04:00,215.3,215.56,215,215.46,1587377,2208608.05,62.94076168857175,58.48707650254488,NaN,NaN,173.55669982111877,81.06415947069996,-0.00059820022071011,0.8159231490152479,0.816521349235958,286173049,284503513.6,68.82066971569729,65.89714652836206,NaN,NaN,18.399899707196493,20.62349620345797
2017-07-14T09:30:00-04:00,215.3,216.68,215.11,216.26,2395456,2199790.15,66.22879496895445,58.70493714073285,NaN,NaN,209.208130449451,117.56993412762692,0.08195703866792692,0.9189676475708666,0.8370106089029397,288568505,285173890.8,70.9610797127699,66.31033770245617,NaN,NaN,20.576041179200395,20.616716914278317
2017-07-17T09:30:00-04:00,216.32,216.4898,216.04,216.22,2291048,2195743.9,65.91389589374968,58.8483385664188,NaN,NaN,188.96849388497495,149.35131992095396,0.11922116714518172,0.9860370678344168,0.8668159006892351,286277457,285617397.2,72.31513957881185,67.05588358866778,NaN,NaN,22.22291149486506,20.846173282933567
2017-07-18T09:30:00-04:00,215.66,215.81,214.63,215.7,2247531,2202953.05,61.80010883477455,59.306571543093575,NaN,NaN,96.51097067781063,173.52594230153483,0.09524005007201386,0.9858659632792524,0.8906259132072385,284029926,285926921.8,73.25252908706933,68.11120378505076,NaN,NaN,22.43031451914995,21.07247917382162
2017-07-19T09:30:00-04:00,215.89,216.34,215.66,216.32,1785904,2204141.95,64.63424546633377,59.435837871752206,NaN,NaN,138.4855824998207,161.34597546663522,0.10666379480225552,1.0239556567100578,0.9172918619078023,285815830,286172953.4,74.00594061349511,69.06441215922507,NaN,NaN,23.448171633982767,21.411863810987498
2017-07-20T09:30:00-04:00,216.57,216.58,215.7101,216.19,1372015,2166272.85,63.56926366870525,60.3086089488856,NaN,NaN,121.08861126825508,150.85235775606247,0.09157341320165835,1.0317586284098752,0.9401852152082169,284443815,285827106.6,70.97931372283786,69.72518869534575,NaN,NaN,23.982466558409847,21.779092774904978
2017-07-21T09:30:00-04:00,215.19,215.55,214.76,215.53,2223698,2142604,58.315741485771355,60.560626111521046,NaN,NaN,51.391773852169315,119.28908643660614,0.026623477464602474,0.9734645620389699,0.9468410845743674,282220117,284557429,61.099978142195695,69.56296610157736,NaN,NaN,22.931229699453098,21.94368376412614
2017-07-24T09:30:00-04:00,215.51,215.51,214.681,215.09,1459554,2148240.7,55.04948649769898,60.155764908113895,NaN,NaN,33.372127464238936,88.16981315245894,-0.05219347215972436,0.881599244374712,0.9337927165344364,280760563,283454050.2,54.05832845864413,68.77359234568031,NaN,NaN,21.088487690870434,21.82151289651818
2017-07-25T09:30:00-04:00,216.5,216.52,215.49,215.86,1924172,2147430,59.341296986232564,60.029213276253465,NaN,NaN,85.53135325021326,85.97388966693947,-0.0582319500016828,0.8610027790323329,0.9192347290340157,282684735,283185012,52.47043264928138,67.59799697740159,NaN,NaN,20.726603589880394,21.66509728128421
2017-07-26T09:30:00-04:00,216.81,217.16,216.56,216.81,2040987,2150399.65,63.918573436441335,60.87490759050094,NaN,NaN,132.58098213611487,84.7929695941983,-0.006717842816794217,0.9108374255130229,0.9175552683298172,284725722,282966990.4,51.15898321142951,66.3749780979998,NaN,NaN,21.826794861099216,21.6881969355435
2017-07-27T09:30:00-04:00,217.28,217.75,216.63,217.72,3202399,2075832.35,67.67282869040928,61.67587724812794,NaN,NaN,149.41265377308463,90.45777809516419,0.07563125983234897,1.0120943431202534,0.9364630832879044,287928121,283663851.6,55.02808153185321,65.22118770850345,NaN,NaN,23.990915806139885,22.017156774200124
2017-07-28T09:30:00-04:00,217.53,218.16,217.3,218.02,2305036,1972453.05,68.82447320598236,62.58511352711421,NaN,NaN,165.44449650766867,113.26832262626405,0.13388911036048512,1.1038244712385108,0.9699353608780257,290233157,285266459.6,62.404231548033245,64.52595935168316,NaN,NaN,26.107741537764635,22.60152602613791
2017-07-31T09:30:00-04:00,218.65,219.03,218.49,218.7,1764971,1949869.35,71.31862588292908,63.677135903061334,NaN,NaN,190.51109186826216,144.6961155070687,0.19793860987826983,1.2173586232258629,1.019420013347593,291998128,287513972.6,69.86824403235875,64.55136301110645,NaN,NaN,28.69731759854874,23.472353393625173
2017-08-01T09:30:00-04:00,219.74,219.8,219.15,219.37,2307069,1958470.95,73.56288914156569,64.50649898915144,NaN,NaN,193.04224143871468,166.198293144769,0.26117130340945094,1.3458841426094068,1.0847128391999559,294305197,289838065,75.32388763381945,65.12477425987834,NaN,NaN,31.608179444192242,24.6346142579919
2017-08-02T09:30:00-04:00,219.83,220.13,219.44,219.89,3063290,2021678.05,75.1857743314306,65.38114274935563,NaN,NaN,181.0140348079672,175.88490367913946,0.3104093646877426,1.4727245450596342,1.1623151803718916,297368487,292366618,79.64254203218724,65.89776513962761,NaN,NaN,34.55208605923096,26.051395943883193
2017-08-03T09:30:00-04:00,219.93,220.23,219.72,220.06,2496380,2031554.75,75.7107251475448,66.0584234763978,NaN,NaN,158.18048983842792,177.63847089220812,0.32525105298910795,1.5688789966082766,1.2436279436191686,299864867,294753967.2,82.71790674292563,66.73753849892445,NaN,NaN,37.10208456309826,27.6300657466282
2017-08-04T09:30:00-04:00,220.64,220.67,220.03,220.57,1877667,2059111.95,77.26463478691022,66.86919054019498,NaN,NaN,148.637311307392,174.27703385215278,0.33871242800826584,1.667018478629501,1.3283060506212352,301742534,297055842.6,85.061259218379,67.64797561603639,NaN,NaN,39.74370503522342,29.360585644998945
2017-08-07T09:30:00-04:00,220.75,220.98,220.6,220.85,1902799,2096417.2,78.09326617759615,68.03298749325367,NaN,NaN,140.01053835412614,164.17692314932555,0.33515292506489347,1.747247206952352,1.4120942818874584,303645333,299385283.6,86.98458896441022,68.62883703584644,NaN,NaN,42.19092873937423,31.193491801338272
2017-08-08T09:30:00-04:00,220.8,221.68,220.4411,220.69,3623872,2198729.7,76.38015088034012,68.87198073711127,NaN,NaN,126.40231155008115,150.84893717159886,0.29226800719942814,1.7774292908867437,1.4851612836873156,300021461,300528536.4,87.81383258502039,69.61511503381254,NaN,NaN,43.75218924378578,32.98759143597363
2017-08-09T09:30:00-04:00,220.33,220.61,219.96,220.5,3555795,2271351,74.29587123422115,69.63816699179098,NaN,NaN,93.00474947500518,133.2470801050065,0.22440211155649448,1.7656639231329336,1.5412618115764392,296465666,300347972.2,86.8724195090219,70.75033687568283,NaN,NaN,44.50551777243727,34.63300948403986
2017-08-10T09:30:00-04:00,219.81,219.897,218.55,218.6,7832649,2583614.6,57.42128700261421,69.57427738585119,NaN,NaN,40.46422199450026,109.70382653622093,0.03479660246494598,1.5847575646576217,1.5499609621926758,288633017,298101602.2,75.96185587189467,71.81189957066132,NaN,NaN,39.811283277247,35.37276288306945
2017-08-11T09:30:00-04:00,218.76,219.22,218.52,218.7,4944487,2711066.15,57.96246081024882,69.78234697960474,NaN,NaN,28.892919323193123,85.75494813938117,-0.09361748461345032,1.432939106425863,1.5265565910393133,293577504,296468596.2,69.16165388490637,72.89070852968005,NaN,NaN,36.23683306117916,35.496201479942265
2017-08-14T09:30:00-04:00,219.88,220.285,219.81,219.97,2605013,2726764.4,64.1878076355485,70.12852631169874,NaN,NaN,66.87215251154959,71.12727097086585,-0.1020662553589804,1.3989737718405877,1.501040027199568,296182517,294976033,63.560906780559705,73.68288525334279,NaN,NaN,34.98315979055482,35.42290981002977
2017-08-15T09:30:00-04:00,220.58,220.58,219.86,220.16,1835715,2706173.6,65.02235576129837,70.20736790633138,NaN,NaN,67.99763914372429,59.44633648959448,-0.10357063869928673,1.3715767288254597,1.4751473675247464,298018232,294575387.2,62.10700938592789,74.46488712294982,NaN,NaN,34.24027790523444,35.25396239505901
2017-08-16T09:30:00-04:00,220.7,221.1,220.28,220.47,2476059,2740681.35,66.39821986342747,70.11632441868983,NaN,NaN,79.06758711420473,56.658904017434374,-0.09274937419467477,1.359210649781403,1.4519600239760777,300494291,295381112.2,63.895614859262,75.09828236062188,NaN,NaN,34.04184908115876,35.08080335021612
2017-08-17T09:30:00-04:00,220,220.07,217.77,217.81,3535775,2848869.35,48.697340168064954,68.67867205883859,NaN,NaN,-11.528256365581138,46.2604083454181,-0.26409696792836135,1.121838814065626,1.3859357819939873,296958516,297046212,67.32781042836156,75.44996656635962,NaN,NaN,27.305662577090423,33.97006895405531
2017-08-18T09:30:00-04:00,216.99,217.66,216.15,216.53,4468542,2961111.55,42.786392653695714,66.64065539960764,NaN,NaN,-100.34836165171305,20.41215215043688,-0.4519718423269705,0.8209709790852742,1.2729428214122447,292489974,296828706,66.43931968778537,75.2050433988901,NaN,NaN,19.47774237029865,31.899736584947213
2017-08-21T09:30:00-04:00,216.46,216.92,215.73,216.74,3467166,3061492.15,43.98763269101879,64.52813708171142,NaN,NaN,-125.52155267142547,-18.06658888615813,-0.5442385303537329,0.5926446584700784,1.1368831888238113,295957140,296783630.6,66.24421871777692,74.55649561917276,NaN,NaN,13.959362554113882,29.33682600911388
2017-08-22T09:30:00-04:00,217.41,218.85,217.3,218.69,2423241,3086445.6,53.70714424647198,62.9939492185001,NaN,NaN,-43.72413850694419,-40.41094441629183,-0.45945992240962896,0.5625582858117752,1.0220182082214042,298380381,296856060.4,66.41488333581356,73.61166285514608,NaN,NaN,12.655749094958102,26.95381502137734
2017-08-23T09:30:00-04:00,218.01,218.46,217.84,217.92,3660164,3167404.45,50.01640168032738,61.15864039941314,NaN,NaN,-61.82896585585255,-68.59025501030328,-0.44069383108845306,0.47115091936083786,0.9118447504492909,294720217,295701245.6,61.10987059330437,72.0682317016017,NaN,NaN,10.299747168696168,24.574662470994316
2017-08-24T09:30:00-04:00,218.55,218.55,217.46,217.66,1934354,3104002.2,48.7970127841539,59.12523882778769,NaN,NaN,-75.87137634636643,-81.45887900646034,-0.4307354168968689,0.3734254793282048,0.8041608962250737,292785863,294866715,57.53339219519373,70.1019554856599,NaN,NaN,8.07491661472207,22.21755592009828
2017-08-25T09:30:00-04:00,218.26,218.93,218,218.04,2373252,3107413,50.68921119611388,57.16780632911038,NaN,NaN,-52.50774076240224,-71.89075482859818,-0.38499448263723046,0.3229177929285356,0.7079122755657661,295159115,295400543.2,59.17916563513663,68.11585381928322,NaN,NaN,6.910127226046097,20.030780392376542
2017-08-28T09:30:00-04:00,218.5,218.58,217.53,217.94,1425032,3090416.05,50.163843618944014,55.29521295329638,NaN,NaN,-66.89857106258174,-60.16615850682943,-0.3489785717089191,0.2716890609296172,0.6206676326385363,293734083,294955931.8,57.19117089370311,65.92852084133197,NaN,NaN,5.8275231210122715,18.001743639324502
2017-08-29T09:30:00-04:00,216.68,218.76,216.62,218.59,2013316,3075728.4,53.53494801123305,53.81228986594009,NaN,NaN,-62.20779646851385,-63.86289009914337,-0.2722874899447504,0.2803082702075983,0.5525957601523487,295747399,294429335.4,54.841340947956326,63.640586658398725,NaN,NaN,5.930288147881087,16.27724999768973
2017-08-30T09:30:00-04:00,218.75,219.16,218.39,218.93,1804147,3012771.25,55.2404930755271,53.656518871148144,NaN,NaN,-11.468668597473014,-53.790830647467466,-0.1932851498575292,0.31098932283043723,0.5042744726879664,297551546,294995601.2,56.8924462391454,62.27848597034521,NaN,NaN,6.519451191455097,14.88327873965621
2017-08-31T09:30:00-04:00,219.53,219.89,219.12,219.52,2173023,2996603.4,58.113697795897366,53.66732151298019,NaN,NaN,31.398724917309146,-32.33681039473234,-0.10058063913397658,0.3785486737704957,0.4791293129044723,299724569,296383342.4,61.5067324430842,61.73170586735791,NaN,NaN,7.873835823403219,13.881929751620069
2017-09-01T09:30:00-04:00,220.13,220.41,219.8329,219.92,2150190,3010229.55,59.98892609673821,53.367401403065166,NaN,NaN,66.94345849003882,-8.446570544244121,-0.016043709453182786,0.4590746760879938,0.4751183855411766,301874759,297726471.2,65.37034186903328,61.86095123082031,NaN,NaN,9.56039700923908,13.264567931279927
2017-09-05T09:30:00-04:00,219.53,219.53,217.18,217.67,3828558,3106517.5,47.190793230275325,52.09371836513494,NaN,NaN,-47.83166675577362,-4.633189682882498,-0.11013786913985985,0.3374460491163518,0.44758391825621163,298046201,298588894.8,67.61785242608762,62.25458287654601,NaN,NaN,6.972124101236271,12.365647384130833
2017-09-06T09:30:00-04:00,218.54,218.62,218.04,218.25,1915470,3021097.4,50.143545915668604,50.932670226009314,NaN,NaN,-30.10055053988836,1.7882595028426038,-0.13040694856240215,0.28457523255320893,0.4149821811156111,299961671,299431749.2,69.68837230110456,62.66835126524904,NaN,NaN,5.827884720766982,11.431681289364569
2017-09-07T09:30:00-04:00,218.47,218.72,217.68,218.11,1982763,2942445.8,49.42517234364253,50.98465823855057,NaN,NaN,-34.85547617679517,-2.8891020130218337,-0.14899285340281343,0.22874111436209432,0.37773396776490775,297978908,299517221.6,69.89856565033494,62.851976638247145,NaN,NaN,4.70004749678441,10.470019318995975
2017-09-08T09:30:00-04:00,217.61,218.66,217.52,218.24,2135767,2657601.7,50.139491031652184,51.50987955126175,NaN,NaN,-34.188828651882915,-16.006612726860247,-0.14797911909832662,0.19276006889199948,0.3407391879903261,300114675,299595242.8,70.10237206798813,63.11362323683306,NaN,NaN,3.996000641266663,9.545159507891787
2017-09-11T09:30:00-04:00,219.58,220.885,219.58,220.76,3019327,2561343.7,61.493182722328406,52.76027598206957,NaN,NaN,128.66176789389553,-3.662950846088904,0.018127638556459047,0.3633987361858999,0.34527109762944086,303134002,299847091.4,70.78987673909873,63.43831309549889,NaN,NaN,7.197259376037573,9.209745203341186
2017-09-12T09:30:00-04:00,221.33,221.57,221.07,221.42,2073331,2534759.6,63.81705562565123,53.4824125091538,NaN,NaN,175.88443493103318,41.08026949127246,0.1602617428932106,0.5455982762459541,0.38533653335274354,305207333,301279317.8,74.39573062888455,64.00837361643254,NaN,NaN,10.571289389560366,9.404251515658212
2017-09-13T09:30:00-04:00,221.35,221.79,221.2,221.76,1720803,2529014,64.98924006096112,54.55190096491335,NaN,NaN,171.2300970466405,81.34639900857823,0.25913242659156477,0.7092520665921995,0.45011964000063476,306928136,302672610.8,77.32785752255303,65.16680125423602,NaN,NaN,13.641636229372894,10.009592189046023
2017-09-14T09:30:00-04:00,221.65,222.43,221.62,222.32,1893733,2499897.7,66.8917298287172,55.84438075381074,NaN,NaN,182.81715716500833,124.88092567693893,0.3391527425925587,0.8740605682413332,0.5349078256487745,308821869,304841203,80.97896514518216,66.84148503637805,NaN,NaN,16.778745085138087,10.976614031344889
2017-09-15T09:30:00-04:00,222.13,222.57,221.91,222.45,2377706,2441994.25,67.33547853598702,57.03339984951596,NaN,NaN,154.91080007041901,162.70085142139934,0.37494862297556764,1.003593604368234,0.6286449813926664,311199575,307058183,83.84346534181786,68.60322072971242,NaN,NaN,19.43546338105207,12.185021081303057
2017-09-18T09:30:00-04:00,222.92,223.386,222.67,223.16,1827255,2309929.9,69.72231649046614,58.43043362605325,NaN,NaN,158.9455660125934,168.75761104513887,0.41730866594154015,1.1502808138195917,0.7329721478780515,313026830,309036748.6,85.88628250228354,70.65287155889673,NaN,NaN,22.43917046967505,13.649899565356199
2017-09-19T09:30:00-04:00,223.37,223.67,223.2299,223.58,2042816,2238712.4,71.06905974373228,59.68287017837463,NaN,NaN,150.62310259453886,163.70534457784,0.4421041620269589,1.2856023504117502,0.8434981883847913,315069646,311009211.2,87.57316495625052,72.99085898806061,NaN,NaN,25.35392593355683,15.321903332242004
2017-09-20T09:30:00-04:00,223.57,223.95,222.95,223.9,1819863,2208543.5,72.08775051809033,60.886245709986284,NaN,NaN,132.4264727019679,155.9446197089055,0.4472013083365435,1.4024998238054707,0.9552985154689272,316889509,313001485.8,89.00287412095417,75.28446097961839,NaN,NaN,28.086169005720773,17.145369857024686
2017-09-21T09:30:00-04:00,223.9,223.97,223.39,223.47,1741370,2112603.8,68.59264313549207,61.634741805671624,NaN,NaN,115.94720785036412,142.57062984597664,0.3908021996904252,1.4438012650819587,1.0529990653915335,315148139,314266739.8,89.80507718083466,77.30577131802912,NaN,NaN,29.435081240885157,18.901042911861897
2017-09-22T09:30:00-04:00,223.22,223.46,222.82,223.2,2448419,2138307.05,66.41520143510888,62.0937614726981,NaN,NaN,89.59991510673754,129.50845285324036,0.3081350732354382,1.4381679069358313,1.130032833700393,312699720,314566768.8,89.99151906493374,79.06442683202202,NaN,NaN,29.97332141973883,20.482796984415746
2017-09-25T09:30:00-04:00,223.11,223.43,221.99,222.82,2844322,2161860.55,63.36637717486854,63.24916032588333,NaN,NaN,68.06628529000692,111.33259670872307,0.20561496430246184,1.3870515390784703,1.1814365747760085,309855398,313932482.4,86.39442251188936,80.40561040957928,NaN,NaN,29.600315492785562,21.785299628468575
2017-09-26T09:30:00-04:00,223.06,223.5,222.62,222.69,1314501,2156334,62.31251309216355,64.11837226706155,NaN,NaN,67.89215826303965,94.78640784242323,0.11151144194433815,1.3208258772064312,1.209314435262093,308540897,312626732.6,79.36174098811745,81.09656531579448,NaN,NaN,29.00614293242968,22.81684867189159
2017-09-27T09:30:00-04:00,223.4,223.52,222.3505,223.12,2381499,2174743.15,64.42035081949496,65.18945644390814,NaN,NaN,64.60632031559031,81.22237736514771,0.06310006974092142,1.2881895224382447,1.2250894526973233,310922396,311433310,73.47476300080372,81.35200798368511,NaN,NaN,29.041968035760974,23.706151438158646
2017-09-28T09:30:00-04:00,222.97,223.77,222.7,223.6,1463204,2157696,66.66185179870348,66.36962507012609,NaN,NaN,72.29949268200342,72.49283433147556,0.04891252154543113,1.2862301046291122,1.2373175830836811,312385600,310880802.2,70.85431021713151,81.40571785148107,NaN,NaN,29.67601744665872,24.55898943937294
2017-09-29T09:30:00-04:00,223.39,223.87,223.13,223.82,2415802,2169834.95,67.66726782370316,66.81063114879571,NaN,NaN,75.89369326503328,69.7515899631347,0.04021546380951024,1.287586912845569,1.2473714490360588,314801402,311301138.6,71.68177115702501,81.46942459561866,NaN,NaN,30.483622696205142,25.4053656189204
2017-10-02T09:30:00-04:00,224.19,225.39,224.02,225.24,2611182,2192884.55,73.27057352896625,67.48588242760393,NaN,NaN,115.61605741771547,79.26154438867641,0.11190519066730675,1.3872529373701923,1.2753477467028855,317412584,312812575.8,74.48667522066222,81.4759206378885,NaN,NaN,32.948451636870566,26.482949335770424
2017-10-03T09:30:00-04:00,225.74,226.28,225.61,226.24,2510044,2126958.85,76.3755603914173,68.2991910226365,NaN,NaN,156.35920697698614,96.95495413146571,0.2031632294450494,1.5293017835091973,1.326138554064148,319922628,315088922,78.01810057131969,81.52522371280041,NaN,NaN,36.12621982955051,27.860559406310436
2017-10-04T09:30:00-04:00,226.39,226.68,226.18,226.41,1747092,2118539.95,76.86751609511481,69.01174718452206,NaN,NaN,167.47924792760773,117.52953965386921,0.2484706987792462,1.6367269275382057,1.3882562287589595,321669720,317238386.8,80.73037124651432,81.5074670057527,NaN,NaN,38.845858947118096,29.429887912140103
2017-10-05T09:30:00-04:00,226.61,227.66,226.4472,227.64,2258473,2132325.45,80.09694098920767,69.92328021689495,NaN,NaN,196.68418490550658,142.40647809856983,0.3296825576509286,1.80035942582262,1.4706768681716915,323928193,319546905.4,83.13690919543352,81.45699870958241,NaN,NaN,42.363762466016084,31.27758427697953
2017-10-06T09:30:00-04:00,227.34,227.63,227.23,227.55,2090275,2130050.85,79.22539677466045,70.60207166576599,NaN,NaN,183.76295581865213,163.98033060929362,0.34415060298665767,1.9008651219050137,1.556714518918356,321837918,320954208.6,84.414737404825,81.35188834547822,NaN,NaN,44.9033175505759,33.22411760177901
2017-10-09T09:30:00-04:00,227.89,227.96,227.3399,227.53,1006785,2029423.75,79.01962744556057,71.16996935875372,NaN,NaN,153.19476357897304,171.4960718415451,0.31970932782531825,1.9563511787000039,1.6366418508746856,320831133,321637918.4,85.00907412412911,81.16873900032668,NaN,NaN,46.89409978665554,35.17697219961851
2017-10-10T09:30:00-04:00,228.21,228.43,227.64,228.26,1417660,1996640.2,80.96314703369222,71.80392625272529,NaN,NaN,143.962478667595,169.0167261796669,0.3192962620410609,2.035762178426012,1.716465916384951,322248793,322103151.4,85.41660495510986,80.91257691705209,NaN,NaN,49.22860866640258,37.18434883773052
2017-10-11T09:30:00-04:00,228.32,228.64,228.17,228.61,1423568,1981778.45,81.83212683771617,72.749603660027,NaN,NaN,134.005010168675,162.32187862788035,0.30898681296261854,2.1026994325882242,1.7937126196256057,323672361,322503679.6,85.77513651459148,80.62472401232044,NaN,NaN,51.44786410194296,39.22199387547515
2017-10-12T09:30:00-04:00,228.49,228.81,228.15,228.33,1307260,1952454.8,78.73569953444274,73.62963923855087,NaN,NaN,115.16632543353676,146.01830673348638,0.25210556926299676,2.1088445812043517,1.856739011941355,322365101,322191061.2,84.03848341179274,80.19950717995323,NaN,NaN,52.436702852179764,41.109809443575806
2017-10-13T09:30:00-04:00,228.71,228.97,228.51,228.73,1744317,1920785.35,79.90547227436561,74.81100317422921,NaN,NaN,109.91415243371956,131.24854605649986,0.21183724753489264,2.1215355713599706,1.909698323825078,324109418,322645361.2,84.5287036622907,80.06624154783903,NaN,NaN,53.61310665033887,42.89599475882767
2017-10-16T09:30:00-04:00,229.07,229.53,228.81,229.45,2373390,1948092.1,81.84180610751389,76.20595267532566,NaN,NaN,112.19000634900979,123.04759461050722,0.2040313479022342,2.1647375087028706,1.9607061608006364,326482808,323775696.2,85.7050841667546,80.51933748917027,NaN,NaN,55.22276557543816,44.65696201834346
2017-10-17T09:30:00-04:00,229.71,229.9599,229.52,229.85,1838019,1937852.25,82.83159927181393,77.5210418504913,NaN,NaN,114.55421397160288,117.16594167130879,0.19609478255991108,2.205824639000525,2.009729856440614,328320827,324990103,86.860997338983,81.4754970847545,NaN,NaN,56.8769179314731,46.40267000593341
2017-10-18T09:30:00-04:00,231,231.68,230.91,231.46,2720490,1982883.6,86.11282603396829,78.91039715301022,NaN,NaN,143.14912447372402,118.9947645323186,0.2652647998960336,2.341310856310656,2.0760460564146226,331041317,326463894.2,88.11683156542944,82.70853432391861,NaN,NaN,59.54360419219709,48.27994631825679
2017-10-19T09:30:00-04:00,230.84,231.66,230.52,231.65,2305442,2011087.2,86.44213985745836,80.2514594411356,NaN,NaN,126.73566990015522,121.30863342564226,0.2879120480878692,2.4359361165244593,2.14802406843659,333346759,328660225.8,89.69724250293446,83.99535370576929,NaN,NaN,61.77182527178052,50.20735759733161
2017-10-20T09:30:00-04:00,232.47,233.13,231.8899,233.13,3275654,2052448.95,88.69165073097102,81.35296495556452,NaN,NaN,151.54056471594987,129.63391588208833,0.3618810962314294,2.6003754387258766,2.2384943424944472,336622413,331162824.8,91.14273388516025,85.18507218180487,NaN,NaN,64.57988806761065,52.2605762359429
2017-10-23T09:30:00-04:00,233.58,233.58,232.6099,232.65,2325057,2026485.7,83.8334178920745,81.88566906275432,NaN,NaN,144.69848211936392,136.13561103615916,0.3382326532825579,2.6612851590976447,2.323052505815087,334297356,332725734.4,91.90644422179038,86.17709672826706,NaN,NaN,65.23506852525782,54.11407513441646
2017-10-24T09:30:00-04:00,234.11,234.7,233.96,234.29,3300482,2125784.75,86.5452277339449,82.5769341798136,NaN,NaN,163.2404988108935,145.87286800401728,0.38916169519776345,2.8095046248122912,2.420342929614528,337597838,334581136.6,92.71004894356459,87.03278799234207,NaN,NaN,66.77683978777017,55.92304151346699
2017-10-25T09:30:00-04:00,234.45,234.45,232.35,233.16,3813292,2197374.4,76.9654366779981,82.35325530044149,NaN,NaN,122.25367752677087,141.69377861462664,0.30650276828875445,2.8034713899754706,2.496968621686716,333784546,335129782.4,92.93348191720136,87.73254318675404,NaN,NaN,64.57724562676012,57.15935638679458
2017-10-26T09:30:00-04:00,233.91,234.42,233.75,233.85,2581497,2253289.05,78.52834586934726,82.30346595006199,NaN,NaN,123.98006401035605,141.1426574366668,0.25989617442582125,2.8218388397189926,2.5619426652931714,336366043,335733639.2,93.18119971433187,88.35871906600455,NaN,NaN,63.35947539465426,58.04508767363168
2017-10-27T09:30:00-04:00,233.95,234.33,233.36,234.17,2944240,2279710.95,79.23211717775223,82.31864378807566,NaN,NaN,108.78300164438338,132.59114482235353,0.21412478756478937,2.8295986497491583,2.615473862184369,339310283,336271213.2,93.40291359564775,88.95827902825587,NaN,NaN,62.63477322243346,58.700757037746214
2017-10-30T09:30:00-04:00,233.52,234.14,233.15,233.33,2672543,2282779,72.51323074068536,81.71507833857518,NaN,NaN,87.12079276871265,121.07560695222328,0.09675978027245602,2.736423587524939,2.639663807252483,336637740,336739290,93.59810339321234,89.54267177383463,NaN,NaN,59.78692860216124,58.85592440409122
2017-10-31T09:30:00-04:00,233.64,233.91,233.2,233.63,1772047,2245879.15,73.38140677152477,81.11145547670436,NaN,NaN,79.58750918733715,104.34500902751202,0.013205347951855462,2.6561704921923024,2.642965144240447,338409787,336901679.8,93.66809813742975,90.10645474689451,NaN,NaN,57.78138313143083,58.702418507996875
2017-11-01T09:30:00-04:00,234.6,235.02,233.73,234.19,2675736,2292311.35,74.97063194236944,80.84252207727056,NaN,NaN,91.12926283583754,98.12012608932534,-0.028214714653322925,2.607696750923793,2.635911465577116,341085523,338361875.2,94.2743063239659,90.83758495490687,NaN,NaN,56.60153737898317,58.40229263242349
2017-11-02T09:30:00-04:00,234.21,235.17,233.32,234.96,2459402,2302357.8,77.00367318516722,80.63525071375638,NaN,NaN,88.53679900981648,91.03147308921743,-0.027588446030443414,2.6014259080390616,2.629014354069505,343544925,339797651.6,94.80134130928735,91.5713447868352,NaN,NaN,56.22793790929279,58.09167052911911
2017-11-03T09:30:00-04:00,235.36,235.39,234.64,235.18,2574404,2326564.25,77.56439912645521,80.32972164368077,NaN,NaN,96.48051577044077,88.57097591442891,-0.03567801705330087,2.584416832752879,2.62009484980618,346119329,341159460.8,95.24811857637228,92.25299010180788,NaN,NaN,56.0924613062372,57.80606921156455
2017-11-06T09:30:00-05:00,235.23,235.59,235.09,235.41,2549910,2403720.5,78.1638560275461,79.99631141194735,NaN,NaN,98.25352490090418,90.79752234086722,-0.04808694477587849,2.559986168836332,2.6080731136122104,348669239,343565760.6,95.91600566414074,92.89977641074772,NaN,NaN,56.153368283783976,57.56996907902447
2017-11-07T09:30:00-05:00,235.7,235.88,234.69,235.42,2390702,2452372.6,78.1911401548836,79.43047670629845,NaN,NaN,92.62716015170315,93.40545253374042,-0.07648295126777205,2.512469424527495,2.5889523757952673,351059941,346095791.4,96.47672412975243,93.49691159391365,NaN,NaN,56.21052625329368,57.375762961062925
2017-11-08T09:30:00-05:00,235.37,235.61,234.97,235.46,1531925,2457790.45,78.30789649190166,78.84945932304439,NaN,NaN,90.03605501768591,93.18681097011009,-0.11132193339720509,2.449799959048761,2.561121892445966,352591866,348397060,96.89439325744596,94.01099379066447,NaN,NaN,56.2886468005977,57.22046065242503
2017-11-09T09:30:00-05:00,234.49,235.28,233.16,234.72,4225161,2603685.5,70.7605370743833,77.56866549043097,NaN,NaN,51.33543594709575,85.74653835756594,-0.1978969833966273,2.3137506632001816,2.511647646596809,348366705,349361416,97.0521010237423,94.43309144342035,NaN,NaN,54.28079125157554,56.8005078808751
2017-11-10T09:30:00-05:00,234.45,234.67,234.1001,234.43,2507020,2641820.65,67.99476790331025,76.43733334837638,NaN,NaN,47.87983993264655,76.0264031900071,-0.28319179528974336,2.1576579024846296,2.440849697774373,345859685,349309487.2,96.76713696044834,94.78028378189592,NaN,NaN,51.8078138954821,56.087265882961816
2017-11-13T09:30:00-05:00,233.66,234.7801,233.63,234.66,2452410,2645771.65,69.02871555041415,75.18615390669562,NaN,NaN,40.20736233634443,64.41717067709514,-0.3293822471872696,2.0291218887902858,2.3585041359775554,348312095,349238058.4,96.34807528298822,95.04014280614045,NaN,NaN,49.96832236641363,55.2131310948835
2017-11-14T09:30:00-05:00,233.97,234.35,232.91,234.28,2566475,2682194.45,65.27660544590108,74.35123739011726,NaN,NaN,-3.7663759697238444,45.138463452809745,-0.3868195101625935,1.8749797482743134,2.261799258436907,345745620,348175194.2,90.09572436595508,94.83744583819428,NaN,NaN,47.34830376726906,54.08958433379572
2017-11-15T09:30:00-05:00,233.16,233.67,232.65,232.96,2823614,2687350.65,54.24622861148195,72.61680044312689,NaN,NaN,-78.31495119628251,11.46826221001607,-0.5074020642781858,1.6275466780891747,2.1349487423673605,342922006,346241222.2,79.93147699398656,93.89103707245533,NaN,NaN,41.467109326513956,52.28637361846975
2017-11-16T09:30:00-05:00,234.22,235.2759,234.19,234.91,2933404,2718748.75,63.940195273917226,71.52452030713867,NaN,NaN,65.82617017818959,14.36640905623483,-0.4514014941878517,1.5706968746325458,2.0220983688203975,345855410,345738963.2,77.48658436518339,92.75415641313644,NaN,NaN,39.049751965550655,50.39542766805274
2017-11-17T09:30:00-05:00,233.77,233.97,233.36,233.39,3483299,2729131,54.28524415459339,70.22252126527496,NaN,NaN,-70.33784806079859,-9.277128542454204,-0.5080761433824161,1.3870031895923773,1.8950793329747935,342372111,345041448.4,74.09695139109098,91.3612169844135,NaN,NaN,33.39847308044509,47.96729129839451
2017-11-20T09:30:00-05:00,233.66,234.37,233.42,234.15,2056556,2715705.95,57.72270676528742,69.10404269340087,NaN,NaN,-33.779123757588806,-24.074425761240853,-0.4857401765735332,1.287904112257877,1.7736442888314101,344428667,344264762.8,70.4037866054916,89.69948044641792,NaN,NaN,30.100536051068342,45.41489769163363
2017-11-21T09:30:00-05:00,235.17,235.99,235.1,235.73,2749918,2688177.75,63.814490157201035,68.30717542303168,NaN,NaN,144.1414403916921,5.507137511042333,-0.36161519018424193,1.3216253011011077,1.6832404912853496,347178585,344551355.8,70.97859329544188,88.03550094438049,NaN,NaN,29.540695668130795,43.147154545418935
2017-11-22T09:30:00-05:00,236.06,236.06,234.95,235.17,2860767,2640551.5,60.4877394629029,67.12746587144137,NaN,NaN,107.718915063393,42.713910762977434,-0.31594326160043495,1.2883114142848058,1.6042546758852407,344317818,344830518.2,71.55805008971912,86.37526585726847,NaN,NaN,27.929019501345177,40.9731352534084
2017-11-24T09:30:00-05:00,235.56,235.87,235.41,235.47,1411064,2582029.85,61.641409217842536,65.99010944939762,NaN,NaN,111.34919664544304,51.81851605642813,-0.266235098241302,1.2714608030836132,1.5376959013249152,345728882,344805212.6,71.41884349423319,84.67317477997283,NaN,NaN,27.06075075438325,38.985651753547664
2017-11-27T09:30:00-05:00,235.5,236.33,235.39,235.73,2329453,2551290.5,62.65899814547126,64.88261960067798,NaN,NaN,117.11298570185382,89.30868280895861,-0.21854878809198697,1.2645099162099314,1.4830587043019183,348058335,345942457.4,73.87822551770422,83.09904762665595,NaN,NaN,26.69498320586149,37.229841961021066
2017-11-28T09:30:00-05:00,236.32,238.44,236.23,238.34,4844535,2659890.1,70.9812413363323,64.36762682792433,NaN,NaN,239.62946755231388,143.99040107093916,-0.024159904673269228,1.452858823460332,1.4770187281336011,352902870,347637298,77.04798684851569,81.71128067799616,NaN,NaN,29.400885607451073,36.11141962479678
2017-11-29T09:30:00-05:00,239.15,239.65,238.77,239.42,3376113,2740093.4,73.60291339506574,64.03155660672176,NaN,NaN,290.41475981831206,173.24506495626315,0.15440316275717092,1.6700226815800647,1.5156195188228938,356278983,349457377.6,79.87259312340186,80.49543781127873,NaN,NaN,32.55235576605695,35.602981930691094
2017-11-30T09:30:00-05:00,240.68,243.49,240.41,242.84,6586446,2935628.9,79.82022778082006,64.67867737146724,NaN,NaN,338.6830965686695,219.43790125731843,0.46266776155982337,2.093954220772673,1.6312864592128498,362865429,353166899.8,84.15308859000466,79.57407978029747,NaN,NaN,38.08226415336054,35.95716510535816
2017-12-01T09:30:00-05:00,243.14,243.435,239.41,242.45,9772738,3301295.7,77.57634919930041,65.36307603546653,NaN,NaN,224.47649479881647,242.06336088799313,0.5918672152760525,2.3711204783079154,1.779253263031863,353092691,354639661.6,85.47393806226818,78.76742271614175,NaN,NaN,41.28458263651008,36.71822475266558
2017-12-04T09:30:00-05:00,245.01,245.57,243.07,243.11,6565826,3500866.8,78.66919203162703,66.05168149841032,NaN,NaN,216.97390213756563,262.0355441751355,0.6677188181672014,2.6139017857408646,1.9461829675736633,359658517,356959698,87.27349219837367,78.11923821009785,NaN,NaN,44.14956790528556,37.77984520303986
2017-12-05T09:30:00-05:00,243.78,243.79,241.77,242.01,4923076,3619525.1,72.3411383050172,66.55629098834719,NaN,NaN,142.34353614526367,242.57835789372547,0.5923158007471097,2.68657771850755,2.0942619177604405,354735441,357326212.2,87.53618531768174,77.93641399236405,NaN,NaN,44.25853472935928,38.70537227822835
2017-12-06T09:30:00-05:00,241.72,242.5127,241.55,241.62,3976102,3698795.1,70.18553092046625,67.69481258184607,NaN,NaN,107.62282504913468,206.01997093989,0.47002260216303915,2.6817901704642395,2.2117675683012004,350759339,356222283.4,82.04309871404715,78.08724411522552,NaN,NaN,43.63112604436291,39.40905138767614
2017-12-07T09:30:00-05:00,241.21,242.87,241.101,242.36,2718309,3758114.3,71.89670191647579,68.26313448488597,NaN,NaN,97.19957784053652,157.7232671942634,0.3957930415167179,2.706508870197098,2.31071582868038,353477648,354344727.2,73.58531547621388,77.80858205172771,NaN,NaN,43.668161671650466,40.01749571395819
2017-12-08T09:30:00-05:00,243.19,243.63,242.58,243.62,2704331,3682072.8,74.57272390613446,69.7122401814246,NaN,NaN,105.26235503931576,133.88043924236325,0.38786316699285495,2.7955447874214485,2.4076816204285936,356181979,354962584.8,74.51633029607169,77.83853768779775,NaN,NaN,44.57268681011302,40.66823729912316
2017-12-11T09:30:00-05:00,243.77,244.236,243.5,244.17,1857822,3649612.9,75.66213475985124,70.99362789532204,NaN,NaN,103.68089785116409,111.22183838508292,0.3757097884934497,2.877318856045406,2.5016090675519562,358039801,354638841.6,73.06319264031445,78.02849526171367,NaN,NaN,45.64951815518186,41.37984884998869
2017-12-12T09:30:00-05:00,244.93,245.87,244.8,245.44,3282365,3691110.65,78.00545944898519,72.0072685590209,NaN,NaN,114.0255573719063,105.55824263041146,0.4066386990509705,3.0099074413656695,2.603268742314699,361322166,355956186.6,75.1838623938255,78.32887162588392,NaN,NaN,47.32849805671586,42.22965587952114
2017-12-13T09:30:00-05:00,245.69,246.99,245.65,246.3,3748662,3750220,79.44848258201793,73.36160735324339,NaN,NaN,117.13290311782401,107.4602582441493,0.4358573551327689,3.1480904362306603,2.7122330810978914,365070828,358818484.4,79.04424392457679,78.86359975694518,NaN,NaN,49.18366440315139,43.223085668611176
2017-12-14T09:30:00-05:00,246.89,247.0699,245.47,245.57,4713278,3844703.2,74.95319343038906,74.31244908271101,NaN,NaN,102.74347901120541,108.56903847828308,0.3600088740616352,3.162244173674935,2.8022352996133,360357550,360194464.8,80.60610763994197,79.51983291021008,NaN,NaN,49.32579879646995,44.09490182973386
2017-12-15T09:30:00-05:00,246.21,246.7,245.82,246.25,5862827,3991174.35,76.29849217467134,75.2866986562253,NaN,NaN,98.39489931797299,107.19554733401453,0.3114448225598161,3.19154132781307,2.880096505253254,366220377,362202144.4,82.63928074802926,80.14562256951902,NaN,NaN,49.85320948238271,44.91751720868369
2017-12-18T09:30:00-05:00,248.01,248.541,247.5299,247.79,3285720,3981295.4,79.0437125486234,75.86258945710324,NaN,NaN,121.96355687408023,110.85207913859776,0.3367012758865675,3.300973100111463,2.9642718242248955,369506097,364495403.6,84.62236977389288,80.68664992133168,NaN,NaN,51.19162551864347,45.8138183958208
2017-12-19T09:30:00-05:00,248.31,248.34,246.94,247.4,2773574,4017146.3,76.62329317254498,76.07833086978032,NaN,NaN,111.07748416940916,110.26246449809832,0.28296750499781576,3.317981205472165,3.0350137004743494,366732523,365577475,85.46599078156743,81.08617832548636,NaN,NaN,51.537769062674755,46.63152563394279
2017-12-20T09:30:00-05:00,248.33,248.3989,246.76,247.07,2401391,3999719.95,74.54328130445978,75.70140612146886,NaN,NaN,100.18748769623492,106.87338141378049,0.18572512457329982,3.2671701061909744,3.0814449816176746,364331132,365429535.8,84.78118176625262,81.1310421237898,NaN,NaN,51.21066876949264,47.28568893902134
2017-12-21T09:30:00-05:00,247.73,248.29,247.4201,247.66,2446655,3979014.35,75.80773875090978,75.57507680372669,NaN,NaN,100.3602262662964,106.3967308647987,0.12459894244588332,3.237193659675029,3.1125947172291455,366777787,366713583.2,85.8415900090761,81.15730297713323,NaN,NaN,51.29799810197917,47.85887596230103
2017-12-22T09:30:00-05:00,247.58,247.61,246.97,247.4,1846965,4000809.4,74.06190575374112,75.24598492673483,NaN,NaN,83.88456733408164,103.49466446802043,0.034785028758800074,3.1560760031776454,3.1212909744188453,364930822,366455672.2,84.56701135620368,80.96398291697822,NaN,NaN,50.88197493418585,48.29074724399886
2017-12-26T09:30:00-05:00,246.94,247.585,246.88,247.25,2156672,3992170.35,73.01714559879818,75.2942711620049,NaN,NaN,74.90959648491406,94.08387239018721,-0.06136094462712327,3.044589793634941,3.1059507382620644,362774150,365109282.8,78.05167811086314,80.28651811649118,NaN,NaN,50.25372884579566,48.571173187112684
2017-12-27T09:30:00-05:00,247.15,247.686,247.1,247.48,2930353,3896461.25,73.63137480850543,75.54040286829341,NaN,NaN,73.70931764650182,86.61023908560574,-0.13204503330577877,2.940894446629841,3.0729394799356196,365704503,364903678.8,77.07512593215426,79.93166291778455,NaN,NaN,49.88078806284018,48.758261026502325
2017-12-28T09:30:00-05:00,247.94,248.19,247.77,248.13,2743299,3864820.55,75.33984932546835,75.78634196893574,NaN,NaN,86.58794768756948,83.89033108387264,-0.15596035305581468,2.8779890386158513,3.033949391671666,368447802,365727012.8,78.24874383446914,80.2647649433742,NaN,NaN,50.00390972270712,48.93621084024587
2017-12-29T09:30:00-05:00,248.57,248.61,247.17,247.38,2951804,3683088.45,69.72614824730258,75.4401579933049,NaN,NaN,71.12023663162977,78.04233315693932,-0.23829749807613076,2.7360775190765025,2.9743750171526333,365495998,365470655,76.92817702692403,80.43703970986367,NaN,NaN,48.579055110714904,48.88518859317002
2018-01-02T09:30:00-05:00,248.34,248.47,247.2256,248.02,4454880,3417195.55,71.66628127221514,75.15473988704517,NaN,NaN,73.2178509928544,75.90898988869387,-0.26368638125209864,2.64476704058751,2.9084534218396088,369950878,366474666.2,78.46130726211493,80.82261932570655,NaN,NaN,47.862067176458666,48.739028390782686
2018-01-03T09:30:00-05:00,248.32,249.22,248.07,248.95,5528596,3365334.05,74.24882960901131,74.8864091841899,NaN,NaN,97.43011112050036,80.41309281581111,-0.2329421528576736,2.617275730767517,2.8502178836251906,375479474,369015731,81.76413145251428,81.29263854418431,NaN,NaN,47.95567409103455,48.62712063367581
2018-01-04T09:30:00-05:00,249.96,250.92,249.62,250.6,4932900,3365825.25,78.06829781663804,74.78782455809133,NaN,NaN,150.26390029947314,95.72400934640538,-0.12214680063045691,2.6975343828371194,2.8196811834675763,380412374,371957305.2,84.69076505638125,81.69596148217035,NaN,NaN,49.23132681896623,48.71343580300301
2018-01-05T09:30:00-05:00,251.38,252.85,250.97,252.72,3349162,3334478.25,81.80290258220661,75.27708949750686,NaN,NaN,213.55113541956908,121.11664689280528,0.06328766898349425,2.8987907696969444,2.83550310071345,383761536,375020052,87.02554974972136,82.1544930614403,NaN,NaN,51.694601451260134,49.13931660989688
2018-01-08T09:30:00-05:00,252.75,252.97,252.22,252.59,3847547,3390940.15,80.89324749492037,75.60528630609609,NaN,NaN,221.1117478914074,151.11494914476083,0.14204972107320568,3.0130652520549575,2.8710155309817518,379913989,377903650.2,88.76313751460641,82.59191140191011,NaN,NaN,53.32472549167812,49.73723216443706
2018-01-09T09:30:00-05:00,253.2,254.29,252.724,253.82,5031362,3507291.7,82.83783123345233,75.87629478358386,NaN,NaN,215.75915797265242,179.62321054072044,0.23629099427220046,3.1663792738220025,2.930088279549802,384945351,380902544.8,90.2287496874081,82.99236711001834,NaN,NaN,55.366586570228506,50.541425650978695
2018-01-10T09:30:00-05:00,253.17,253.9311,252.45,253.62,2357613,3532281.25,81.38736925208715,76.2165859321226,NaN,NaN,163.31042636267023,192.7992735891544,0.24349624588078722,3.234458586900786,2.9909623410199986,382587738,382324197.6,90.83877067605721,83.3761371024819,NaN,NaN,56.54604929258671,51.39922902835127
2018-01-11T09:30:00-05:00,254,255.67,253.85,255.61,2760377,3506181.85,84.3278251045044,76.91548191784008,NaN,NaN,174.79868695321997,197.7062309199038,0.33497700069109104,3.409683591883862,3.074706591192771,385348115,383311345.8,91.24737814540404,83.83800827242128,NaN,NaN,58.61165549358329,52.42957566624156
2018-01-12T09:30:00-05:00,256.63,257.97,256.48,257.91,3678352,3502666.35,86.90315580843976,77.70801170766364,NaN,NaN,191.10167691516543,193.21633921902304,0.4935044313285126,3.691587130353412,3.198082699024899,389026467,384364332,91.67397276988444,84.25460704105046,NaN,NaN,61.394366126233,53.71026001766891
2018-01-16T09:30:00-05:00,260.27,260.7499,256.91,257.81,8102905,3672147.7,86.23961537161483,78.57784810894034,NaN,NaN,176.05544577226323,184.20507879519423,0.5314579600091482,3.8624051490363343,3.330947189027186,380923562,384566246.6,91.756937883481,84.76817322157027,NaN,NaN,63.29247405196917,55.07914773685466
2018-01-17T09:30:00-05:00,259.26,261.19,258.5425,261.08,6144372,3686224.95,89.15551841016995,79.73058902403832,NaN,NaN,175.09116274685493,176.0714797500347,0.7057027430310532,4.213075617816003,3.5073728747849495,387067934,384990763.2,91.93881096631156,85.76011128267373,NaN,NaN,66.1722293580499,56.66387368273969
2018-01-18T09:30:00-05:00,261.24,261.32,259.38,260.16,4860173,3764947.6,83.77665775696238,80.45525209178525,NaN,NaN,147.9807854204945,173.0055515615996,0.6872335937254541,4.366414866941767,3.679181273216313,382207761,384914767.8,91.54939598939038,86.79398771533344,NaN,NaN,66.49007113715953,58.06761617622824
2018-01-19T09:30:00-05:00,260.05,260.55,259.27,260.54,4057553,3829146.55,84.20065363693456,81.0881666854614,NaN,NaN,127.11617572170783,163.46904931529713,0.6303398870414769,4.467106132018159,3.8367662449766824,386265314,385098207.6,91.64142755810721,87.7506079813076,NaN,NaN,66.87676883392872,59.326066555899736
2018-01-22T09:30:00-05:00,259.7,262.01,259.63,261.98,3359873,3877070.65,85.72334330736984,82.23082347546621,NaN,NaN,126.21941293321291,150.49259651890662,0.6185549258563845,4.609959902297163,3.9914049764407786,389625187,385217951.6,91.70493342168966,88.80609058093371,NaN,NaN,67.71276135812259,60.52416581336014
2018-01-23T09:30:00-05:00,261.83,262.29,261.275,261.87,3483296,3928902.7,85.04903802216072,83.18673467189089,NaN,NaN,118.91995117324473,139.06549759910294,0.5353338488732318,4.660572287532318,4.125238438659086,386141891,386261617.4,92.25710904794356,89.79150499420719,NaN,NaN,68.14964371404557,61.613519799172344
2018-01-24T09:30:00-05:00,263,263.76,260.8701,262.57,7106353,4191872.1,85.81377876682147,84.01280246887733,NaN,NaN,111.69611576795,126.38648820332196,0.4621727583909969,4.702954386647832,4.240781628256835,393248244,387497679.4,92.86305410484935,90.58428518365967,NaN,NaN,68.74424897243557,62.6321953953528
2018-01-25T09:30:00-05:00,263.58,264.3901,262.42,263.75,5918900,4379983.5,87.01913997382437,84.65214833724778,NaN,NaN,113.22374412778599,119.43507994478026,0.42873139123739,4.776695867303573,4.347964476066183,399167144,390889556,94.20357803113055,91.2637718247132,NaN,NaN,69.62686459112855,63.6314338518922
2018-01-26T09:30:00-05:00,264.32,265.93,264.05,265.91,3861681,4426549.9,88.88146131644913,85.15775967540796,NaN,NaN,122.0871174247047,118.42926828537964,0.48350277386996243,4.952342943403636,4.4688401695336735,403028825,394242258.2,95.16941071554257,91.84547617941472,NaN,NaN,71.03745605954495,64.68943702441402
2018-01-29T09:30:00-05:00,265.56,265.9,264.12,264.16,4605550,4519662.45,78.99340423894272,85.02205658569527,NaN,NaN,104.58233197345561,114.10185209342816,0.34006392656922735,4.893920077745207,4.55385615117598,398423275,396001875.8,95.58518919118033,92.3327655848843,NaN,NaN,68.87121506712043,65.28683388765779
2018-01-30T09:30:00-05:00,261.48,262.44,260.09,260.62,9409546,4842549.55,63.583666638429825,83.64675911462223,NaN,NaN,50.650687570028936,100.44799937278502,-0.03509864419657038,4.509982845930267,4.5450814901268375,389013729,396576243.4,95.7148429036179,92.72462938604214,NaN,NaN,61.05549553142543,64.6823569796246
2018-01-31T09:30:00-05:00,263,263.16,260.29,261.44,5369995,4888305.3,65.27356241471026,82.49577291195246,NaN,NaN,53.91561705088898,88.89189962937282,-0.25750950255454974,4.22319461193365,4.4807041144882,394383724,396803339.4,95.76776618298496,93.07670049367984,NaN,NaN,55.626002624717685,63.38859207178076
2018-02-01T09:30:00-05:00,259.95,262.9,259.77,261.62,5182031,4870977.05,65.65037812501194,81.16166955627443,NaN,NaN,45.83228268450683,75.413607340717,-0.4127757907542975,3.964734376045328,4.377510166799626,399565755,396883061.6,95.78743512837649,93.40099027817789,NaN,NaN,51.594903627553656,61.70377943689117
2018-02-02T09:30:00-05:00,259.61,259.85,254.73,254.93,9486596,5098661.85,45.77117008924813,78.22367057633217,NaN,NaN,-51.89244779054754,40.61769429766653,-0.9553043986968319,3.1833796684285858,4.138684067125418,390079159,394293128.4,82.39110821258373,92.73792852408498,NaN,NaN,39.20031005325741,58.48899809637206
2018-02-05T09:30:00-05:00,252.22,255.02,239.06,243.27,19888246,5925616.05,29.184207446863198,74.14828429599277,NaN,NaN,-229.98823087743273,-26.2964182725111,-2.0271177372328624,1.6047868955843398,3.631904632817202,370190913,388646656,62.02467348381133,90.61419535268,NaN,NaN,18.003725751732993,52.70538776142362
2018-02-06T09:30:00-05:00,238.32,249.33,237.54,248.96,20493141,6757895.75,40.51325625197466,70.67383699897881,NaN,NaN,-208.15226170342723,-78.05700812720234,-2.262633586058637,0.803612650243906,3.066246236302543,390684054,388980721,62.61350075654604,88.51953033769675,NaN,NaN,8.472756422344979,46.386440427269534
2018-02-07T09:30:00-05:00,248.24,252.79,247.57,248.76,12657127,7139184,40.26939609052741,67.5661754513763,NaN,NaN,-127.4752734956706,-114.33518623651426,-2.3323572804015695,0.1507996358005812,2.4831569162021507,378026927,385709361.6,53.81390234730236,85.82413793469048,NaN,NaN,2.2181388876888692,40.0766830644723
2018-02-08T09:30:00-05:00,248.96,249.08,238.5,238.67,15829132,7812759.95,30.34547159889742,63.71937673437363,NaN,NaN,-199.9585348508387,-163.49334974358337,-2.920351414099289,-1.1672823514219601,1.7530690626773286,362197795,378235769.6,39.98760082918417,82.13457888262454,NaN,NaN,-7.933222047838329,33.21812519128507
2018-02-09T09:30:00-05:00,241.41,244.03,233.76,242.03,19858011,8667641.65,36.00149213343435,60.167815936235385,NaN,NaN,-181.71615263394682,-189.4580907122632,-2.937360144568358,-1.9186311180331188,1.0187290265352391,382055806,376631099,37.74519406922881,78.28031178602019,NaN,NaN,-12.55737367365751,26.678768210578987
2018-02-12T09:30:00-05:00,244.03,247.85,243.0646,246.17,10458422,9006645.15,42.22645008496884,57.10905965500739,NaN,NaN,-102.04735969301305,-163.86991647537928,-2.5391220446482627,-2.155173529275089,0.3839485153731734,392514228,381095762,46.70083940243971,75.02629252562704,NaN,NaN,-13.334381952590787,20.962603901554733
2018-02-13T09:30:00-05:00,244.72,247.25,244.33,246.57,6234006,8913200.2,42.80530094975327,54.0370255252168,NaN,NaN,-85.39818010904976,-139.3191001565038,-2.1343824652899994,-2.284029566239326,-0.14964710094932654,398748234,382708598,49.52559833558446,71.93075997067955,NaN,NaN,-13.662087322183773,16.01621944102066
2018-02-14T09:30:00-05:00,245.17,249.49,245.04,249.3,5763970,8894180.1,46.72832797463304,51.15911038241741,NaN,NaN,-60.969302243530066,-126.01790590607568,-1.5932251560501047,-2.1411785460119575,-0.5479533899618527,404512204,388005653.4,57.493521505885454,69.30861307601918,NaN,NaN,-12.474930835953705,11.946055115738607
2018-02-15T09:30:00-05:00,251.62,252.5,248.49,252.5,6111474,8956745.15,50.97325830229525,48.45138159569213,NaN,NaN,-29.806869987401036,-91.98757293338814,-0.9613066325402159,-1.7495866806371225,-0.7882800480969067,410623678,397690830,67.57300672347299,67.33744136229993,NaN,NaN,-9.999032933362601,8.811042537295577
2018-02-16T09:30:00-05:00,251.43,254.12,251.2,251.96,6399008,9073817.9,50.245644176507646,46.39797016266105,NaN,NaN,-16.116513933721308,-58.86764519334305,-0.5421140018711879,-1.4659225504358915,-0.9238085485647036,404224670,402124602.8,70.96710310943247,65.57900664217509,NaN,NaN,-8.346477892205462,6.359968190224
2018-02-20T09:30:00-05:00,250.44,251.5863,248.59,249.35,8685224,9340085.45,46.77057937802312,45.197035358346284,NaN,NaN,-34.442494295272475,-45.346672113794945,-0.4090955866660042,-1.435178031897209,-1.0260824452312047,395539446,402729646.4,71.40692443371279,63.84272675146758,NaN,NaN,-8.109814765521559,4.292856339403206
2018-02-21T09:30:00-05:00,249.6,252.51,247.71,247.72,5894762,9460658.75,44.69172811742478,43.72690433711161,NaN,NaN,-35.03567144190983,-35.27417038036697,-0.3989449485904222,-1.5247636309692325,-1.1258186823788103,389644684,400908936.4,68.0653526246142,61.86398292586967,NaN,NaN,-8.568405831669434,2.455533172107115
2018-02-22T09:30:00-05:00,248.63,251.36,248.5328,249.49,6342316,9422456.9,47.42450624269578,42.425056345517596,NaN,NaN,-26.53362064459724,-28.38703406058041,-0.24844823288013607,-1.4363789734789805,-1.1879307405988444,395987000,399203895.6,64.99782841471784,59.66472530346549,NaN,NaN,-8.10581822900537,0.9467686862339031
2018-02-23T09:30:00-05:00,250.79,252.95,250.05,252.91,5118986,9382461.2,52.32605060676926,42.89326209676911,NaN,NaN,0.9866230635721575,-22.228335450385767,0.08799080789243607,-1.0779422307332993,-1.1659330386257354,401105986,397300357.2,61.65698782055917,58.183716704035156,NaN,NaN,-6.16781486854928,-0.06960039302083731
2018-02-26T09:30:00-05:00,254.32,257.18,253.96,256.92,6120948,9495424.55,57.347168254319286,44.904902154444535,NaN,NaN,56.386327145209755,-7.727767234599557,0.5607900780586625,-0.4649454410524072,-1.0257355191110697,407226934,397900810,62.31499018652321,58.204453611371726,NaN,NaN,-2.862313804780434,-0.4685594518436369
2018-02-27T09:30:00-05:00,257.1,257.86,253.92,253.96,7219248,9626109.45,52.916752604584566,45.79086617963096,NaN,NaN,58.608382133397676,10.882408051134473,0.6481851084331567,-0.21550413356962395,-0.8636892420027806,400007686,398794458,63.32377413459761,58.255187424089705,NaN,NaN,-1.4979977784506164,-0.6156220699303483
2018-02-28T09:30:00-05:00,255.18,255.77,250.2,250.2,5299252,9420594.75,47.85879619208581,46.33296618688514,NaN,NaN,23.679209251881073,22.625384189892653,0.4369033598907913,-0.31756004213929145,-0.7544634020300828,394708434,399807208,64.48408144695,59.017343074064534,NaN,NaN,-1.9699154312661702,-0.80909255012118
2018-03-01T09:30:00-05:00,250.21,251.87,244.37,245.98,8144762,9559333.1,42.90233083701268,47.229884703893376,NaN,NaN,-41.00533084229973,19.731042150352188,0.019140614549439272,-0.7305376338432836,-0.7496782483927229,386563672,397922542.4,60.639402836175684,60.49247178884964,NaN,NaN,-4.013890877239028,-1.2669208825665867
2018-03-02T09:30:00-05:00,243.55,245.92,242.16,245.35,6393363,9619899.7,42.199691655340644,47.67261324117239,NaN,NaN,-83.11576298983579,2.9105649396705955,-0.2770788181797711,-1.0960267711174367,-0.8189479529376656,380170309,393735407,53.069048469716336,61.587032817455906,NaN,NaN,-5.844395780910479,-1.9208458680442857
2018-03-05T09:30:00-05:00,243.84,249.63,243.8,248.84,4891001,9390119.95,47.34445227093203,48.03818482588405,NaN,NaN,-21.540634147128415,-12.674827318797039,-0.2180286515031843,-1.091483767316646,-0.8734551158134617,385061310,389302282.2,46.45627942934184,61.56956424794891,NaN,NaN,-5.792391984560019,-2.4739238846893903
2018-03-06T09:30:00-05:00,250.18,250.18,247.05,248.84,4408519,8616133.6,47.34445227093203,48.36240992025397,NaN,NaN,1.3565039076462935,-24.125202963947316,-0.16162460527210254,-1.0754858724035898,-0.9138612671314873,385061310,386313007,42.60143458349267,61.0749811227995,NaN,NaN,-5.751249652441432,-2.942113280082539
2018-03-07T09:30:00-05:00,245.86,248.58,245.4,248.11,5362562,7859604.65,46.34377683110051,48.33494198143021,NaN,NaN,-30.14761669822619,-34.890568153968765,-0.15605440879726884,-1.1089292781280733,-0.9528748693308045,379698748,383311069.8,39.093233651423134,59.76067484748075,NaN,NaN,-6.0001293463236385,-3.3789727181169815
2018-03-08T09:30:00-05:00,249.13,249.705,247.22,249.14,5846643,7519080.45,48.01338563846336,48.12352250544221,NaN,NaN,0.19479298145169016,-26.650543389218477,-0.06996311555457857,-1.0403287637740277,-0.9703656482194492,385545391,383107413.6,38.85943744418149,57.709705613245646,NaN,NaN,-5.747705302277451,-3.717363087282763
2018-03-09T09:30:00-05:00,250.94,253.56,250.34,253.56,3904035,6922825.6,54.54928129752417,48.43092515694339,NaN,NaN,77.36985043797581,5.446579296343839,0.2785855337727925,-0.6221337310034585,-0.900719264776251,389449426,384963237,42.24881876542266,55.65839958867351,NaN,NaN,-3.581321849625415,-3.6979286247602845
2018-03-12T09:30:00-04:00,254.05,254.72,251.7002,251.96,5512791,6205564.6,52.000662684954385,48.804502536009906,NaN,NaN,77.38019068237449,25.23074426224442,0.38854858413714743,-0.4150335346048166,-0.8035821187419641,383936635,384738302,41.945304278760624,53.553998149034086,NaN,NaN,-2.4937845428445935,-3.5259080416294717
2018-03-13T09:30:00-04:00,253.1,253.97,249.65,250.22,6100856,5987686.3,49.302908902603654,49.133872592094114,NaN,NaN,31.714400134404645,31.30232350759609,0.33338630468415986,-0.3868492378867643,-0.7202355425709241,377835779,383293195.8,39.959169494436054,51.54641363973565,NaN,NaN,-2.34238917625013,-3.3568339180038516
2018-03-14T09:30:00-04:00,251.41,251.62,246.92,247.88,6222815,5987126.75,45.85739427622325,49.02193602306037,NaN,NaN,-41.91771516492737,28.948303814255855,0.13856791223511655,-0.5470256522770285,-0.685593564512145,371612964,381676039,37.802033238339824,49.60385684142293,NaN,NaN,-3.2087696965383516,-3.335681886365923
2018-03-15T09:30:00-04:00,248.84,250.8,247.8,249,5069571,5952406.8,47.739909764755595,48.69435453434511,NaN,NaN,-33.19484219396447,22.27037677917262,0.08692176831068443,-0.5769413541237896,-0.663863122434474,376682535,379903467.8,35.53747284809444,47.73817720053258,NaN,NaN,-3.4036414423485,-3.345390394363434
2018-03-16T09:30:00-04:00,248.57,250.129,248.34,249.1,3430063,5818336.25,47.91404501597294,48.02056001732036,NaN,NaN,-30.651890119115784,0.6660286677542999,0.06242846287335324,-0.5858275438427825,-0.6482560067161357,380112598,378036102.2,33.27590816830457,45.66395705637411,NaN,NaN,-3.517108063253659,-3.3699214899191805
2018-03-19T09:30:00-04:00,248.3,248.38,244.32,245.91,5739545,5785363.1,42.99267137279339,47.31169707219242,NaN,NaN,-110.07156721955604,-36.82432291263181,-0.1538643909488452,-0.8405864954021922,-0.686722104453347,374373053,376123385.8,31.093208784008525,43.36177381704631,NaN,NaN,-5.010769423470097,-3.6043283375693114
2018-03-20T09:30:00-04:00,246.49,247.85,246.32,247.1,3258381,5514020.95,45.25176678074676,47.12548068566821,NaN,NaN,-76.3374947756896,-58.43470189465065,-0.1991630015276924,-0.9356758563629626,-0.7365128548352702,377631434,376082516.8,31.046348744162273,40.973364338275765,NaN,NaN,-5.651972572839663,-3.896848942607933
2018-03-21T09:30:00-04:00,247.14,249.65,246.32,246.62,4341360,5436350.85,44.485983226144505,47.23859871346334,NaN,NaN,-59.48284821611853,-61.94772850488889,-0.24103267094012482,-1.0378036935104262,-0.7967710225703014,373290074,376417938.8,31.952769374767584,38.924319091032324,NaN,NaN,-6.394435527413966,-4.253647026151652
2018-03-22T09:30:00-04:00,244.09,245.03,239.17,239.36,7449708,5491720.45,34.87331775078114,46.71528629170909,NaN,NaN,-198.74535998350416,-95.05783206279682,-0.7106926676729098,-1.6851368571614387,-0.9744441894885288,365840366,374249505,29.273669034701257,37.2246491313884,NaN,NaN,-10.194024403511047,-5.102272365774423
2018-03-23T09:30:00-04:00,239.98,240.9,234.85,235.13,7598675,5615704.9,30.709583596308505,45.52708138637884,NaN,NaN,-249.04769110867196,-138.73699226070806,-1.2288756670736867,-2.5105387733306372,-1.2816631062569506,358241691,369875323.6,24.76319262840333,35.67514293132136,NaN,NaN,-14.913016434960216,-6.503807232800965
2018-03-26T09:30:00-04:00,239.03,242.15,237.2,241.82,6589730,5639144,42.41909213929864,45.175269948405024,NaN,NaN,-156.67639831460517,-148.05795847971788,-1.0506181903044132,-2.594935844137467,-1.5443176538330539,364831421,367966997.2,23.09156630502231,34.281580911430616,NaN,NaN,-15.020085006950632,-7.720418343393775
2018-03-27T09:30:00-04:00,243.05,244.2599,236.85,238.29,6513123,5603837.75,38.702555570362506,44.629468429780886,NaN,NaN,-145.83767762391642,-161.95799504936326,-1.0950118196973058,-2.913082428454686,-1.8180706087573804,358318298,364104370,20.12958563541231,32.9270346245727,NaN,NaN,-16.416997061856474,-8.96278673174559
2018-03-28T09:30:00-04:00,239.04,240.72,237.05,238.28,7983666,5738058.45,38.692213426048035,43.96367041460836,NaN,NaN,-139.6495631181705,-177.99133802977366,-1.0494977314807108,-3.1299427731082687,-2.080445041627558,350334632,359513281.6,17.290637954160317,31.386406089571185,NaN,NaN,-17.48409740799882,-10.180116828353194
2018-03-29T09:30:00-04:00,239.57,242.94,239.06,241.4,6640169,5662828.8,43.74329646636209,43.191814355239636,NaN,NaN,-82.33726923019695,-154.7097198791122,-0.7478758460103205,-3.0152898491404585,-2.267414003130138,356974801,357740168.6,16.33259873420961,29.535247515913113,NaN,NaN,-16.73556804713943,-11.11660985960837
2018-04-02T09:30:00-04:00,240.33,241.03,233.2,236.15,9206667,5803494,38.060834125883346,42.19611231530599,NaN,NaN,-132.7619782636958,-131.45257731011696,-0.833991358317761,-3.309903201027339,-2.475911842709578,347768134,355645457.2,15.257084208810213,27.628946082345227,NaN,NaN,-18.002229649746187,-12.10026982962806
2018-04-03T09:30:00-04:00,237.38,240.25,236.4,240.15,9874504,6052669.15,44.026921669381565,41.819256084361555,NaN,NaN,-87.57607326042627,-117.63251229928122,-0.5664046170582768,-3.183917614032424,-2.6175129969741473,357642638,354207700.6,14.548914359778578,25.813927858441122,NaN,NaN,-17.0180344183105,-12.802807628011266
2018-04-04T09:30:00-04:00,235.05,242.9,234.94,242.46,6437533,6154119.85,47.19046154509043,41.914475174994934,NaN,NaN,-63.52579756275906,-101.17013628704973,-0.1977123959150462,-2.864653491867955,-2.6669410959529087,364080171,355360075.2,17.84058386498951,24.388110046058955,NaN,NaN,-15.169401283677079,-13.140892435963524
2018-04-05T09:30:00-04:00,243.8,246.09,243.381,244.91,4786358,6125309.65,50.39287198578002,42.10397247649667,NaN,NaN,2.6923344519318615,-72.70175677302926,0.22440842529121152,-2.3864305643388946,-2.610838989630106,368866529,359066454.6,27.512305843910923,23.814883831474415,NaN,NaN,-12.61039328714991,-13.065106843275865
2018-04-06T09:30:00-04:00,242.3,244.2525,237.24,239.13,6985503,6182252.65,43.66544558950813,41.80050108889204,NaN,NaN,-55.61806868288531,-67.35791666356693,0.13215814155000416,-2.445641312692601,-2.577799454242605,361881026,360047699.6,29.866195627585938,23.571332935708796,NaN,NaN,-12.636096641939517,-13.003819671656387
2018-04-09T09:30:00-04:00,241.16,243.64,239.43,239.73,5052024,6239652.1,44.49382489590084,41.90772634054258,NaN,NaN,-39.97066667326135,-48.79965434548005,0.1292014065813163,-2.4162976960159597,-2.545499102597276,366933050,363880682.8,38.2953477280228,24.08577143170982,NaN,NaN,-12.391817934808133,-12.916390852106638
2018-04-10T09:30:00-04:00,243.35,245,242.2,244.01,5983591,6263192.1,50.12751073845981,42.25599376609351,NaN,NaN,9.942527445629647,-29.29593420426887,0.41692166172121015,-2.0243470254457634,-2.4412686871669735,372916641,366935483.4,44.06525447794686,25.015693269837293,NaN,NaN,-10.344093220933045,-12.548919761938981
2018-04-11T09:30:00-04:00,242.13,243.58,241.393,241.88,4733059,6194802.25,47.54141868910158,42.47423915630473,NaN,NaN,-7.881948522252877,-18.167164396167635,0.4617283778295862,-1.864108214879991,-2.325836592709577,368183582,367756165.6,45.538639337732,25.986112552906178,NaN,NaN,-9.485432509524783,-12.11127872587981
2018-04-12T09:30:00-04:00,243.66,245.82,243.44,244.81,4742447,6120783.85,51.2659612785657,43.6451422654322,NaN,NaN,45.0916010009785,-9.687311086358307,0.6737977581385612,-1.4835893950363754,-2.1573871531749367,372926029,368568065.6,47.02531133114731,27.25408700265233,NaN,NaN,-7.588756883309494,-11.465204176941194
2018-04-13T09:30:00-04:00,246.42,246.46,242.33,243.58,5222490,6128429.8,49.671600039104476,44.99957201134619,NaN,NaN,42.60698330605668,9.957699311430087,0.7125699057407922,-1.2666747709989465,-1.9792446767397387,367703539,369732568.2,49.168603221511695,28.997330616445783,NaN,NaN,-6.5275540839975115,-10.759825592234954
2018-04-16T09:30:00-04:00,245.12,246.67,244.72,245.62,4018436,6157848.45,52.320115754615124,45.70678798386881,NaN,NaN,87.26615060080178,35.405062766242715,0.847749874892997,-0.9195573331234925,-1.7673072080164896,371721975,370690353.2,50.92719892561385,30.98559008934518,NaN,NaN,-4.846065819767417,-9.915002767596734
2018-04-17T09:30:00-04:00,248.15,248.48,247.27,247.8,3821946,6061968.5,55.04281428645636,46.87394932073265,NaN,NaN,133.61322615349115,60.139202507815014,1.043272320993037,-0.4632168067751934,-1.5064891277682304,375543921,371215809.2,51.91016883667148,33.255631746577976,NaN,NaN,-2.6154174454522194,-8.872204864433233
2018-04-18T09:30:00-04:00,247.88,248.2214,247.08,247.38,3645579,6081328.4,54.398307884388714,47.99581321061413,NaN,NaN,125.1445562809188,86.74450346844935,1.098062898328053,-0.13391050485816436,-1.2319734031862173,371898342,371958761.2,53.33352458979989,35.83012364912366,NaN,NaN,-0.973353124383633,-7.743797472997575
2018-04-19T09:30:00-04:00,246.92,247.58,245.49,246.57,3721807,6050350.75,53.106799743735706,48.66463487328367,NaN,NaN,104.72990752252687,98.67216477275903,1.034381657800043,0.061003669063836696,-0.9733779887362064,368176535,371008862.4,51.24512300116028,38.32387538247728,NaN,NaN,0.049890084816338144,-6.6304135361670165
2018-04-20T09:30:00-04:00,246.37,246.66,243.59,244.48,3396521,5847691.4,49.82008387105921,49.50458128365337,NaN,NaN,59.606101122939045,102.07198833613549,0.8157386781541074,0.04629535895642789,-0.7694433191976795,364780014,370424157.4,49.94859716093366,40.801840593343236,NaN,NaN,0.03753901636216561,-5.677848885805705
2018-04-23T09:30:00-04:00,245.06,245.18,243.14,244.35,2490952,5592305.25,49.61439939307548,49.9036868353458,NaN,NaN,37.80799050264219,92.18035631650358,0.6346536964483696,0.023873801362782388,-0.6107798950855872,362289062,368537574.8,45.912314912749245,43.042083489984,NaN,NaN,-0.027129435946847642,-4.870603250111583
2018-04-24T09:30:00-04:00,245.39,245.5613,238.12,240.09,7088925,5617265,43.30502513354978,49.626155663092895,NaN,NaN,-35.9249998610567,58.27271111359401,0.22158865848359866,-0.3337940719810888,-0.5553827304646874,355200137,364468818,38.6569901129223,44.52896965055063,NaN,NaN,-1.888332416052913,-4.444564559531773
2018-04-25T09:30:00-04:00,240.29,241.33,238.09,240.7,5269188,5555068.25,44.39544520852577,49.19776803614616,NaN,NaN,-66.58131512500545,19.927536832409192,-0.004936455279538343,-0.5615532995641104,-0.556616844284572,360469325,362183014.6,35.28362965619911,45.08406420857121,NaN,NaN,-3.141697426725386,-4.258440683416574
2018-04-26T09:30:00-04:00,241.43,243.88,241.12,243.12,3845767,5348173.3,48.61759748528826,49.551493171559024,NaN,NaN,-5.846278178281121,-2.1877003077524018,0.012854085036584473,-0.5405492379888415,-0.5534033230254259,364315092,361410726,34.197808200890435,45.393465106664394,NaN,NaN,-3.071268670043361,-4.0888446815061155
2018-04-27T09:30:00-04:00,242.97,243.44,241.77,242.95,3209793,5176654.5,48.3399155351183,49.826213931503126,NaN,NaN,-7.8674512324404615,-15.682410778828308,0.017527288280318243,-0.5314942126750282,-0.5490215009553464,361105299,360675783,33.15222974904488,45.0260995367374,NaN,NaN,-3.0875099917494597,-3.945796868683736
2018-04-30T09:30:00-04:00,244.1,244.84,241.51,241.54,3475655,4890103.9,45.99349709051081,49.530927242363916,NaN,NaN,-20.991270189066995,-27.442262917170144,-0.06544002963328377,-0.6308215379969511,-0.5653815083636673,357629644,359743899.4,31.823610627513276,44.151696404563566,NaN,NaN,-3.7312668001956664,-3.9151497160425834
2018-05-01T09:30:00-04:00,240.69,240.89,237.91,240.76,4396633,4616210.35,44.700862848255255,49.32803039658918,NaN,NaN,-112.42701696375612,-42.74266633771003,-0.15863516515743525,-0.7636754648104613,-0.6050402996530261,353233011,359350474.2,31.2541281928209,43.13137417992706,NaN,NaN,-4.622700503927,-4.016228400026072
2018-05-02T09:30:00-04:00,240.61,241.7,238.72,239.11,2729445,4430805.95,42.01108072508694,48.66696749991212,NaN,NaN,-111.64308241569307,-51.75501979584756,-0.30851526150364683,-0.9906843765325846,-0.6821691150289377,350503566,357357322.4,28.474131655109375,41.80628991735292,NaN,NaN,-6.129752104717026,-4.318160357839065
2018-05-03T09:30:00-04:00,237.92,239.83,235.12,239.1,6177495,4500362.8,41.99458789216441,48.11860948941641,NaN,NaN,-148.02498477998648,-80.19076111618863,-0.38070329345925114,-1.1580482318530017,-0.7773449383937505,344326071,353359518.2,23.885022855107096,40.00031989118117,NaN,NaN,-7.39591077313536,-4.757838988595679
2018-05-04T09:30:00-04:00,238.11,243.22,237.68,242.52,3600909,4331133.1,49.32216280454702,47.90446999298297,NaN,NaN,-57.530942627866935,-90.12345939527393,-0.18064894197127823,-1.0031561158578484,-0.8225071738865701,347926980,350723854.4,21.432546569185405,37.89355900857914,NaN,NaN,-6.5731240677483385,-5.01716542847463
2018-05-07T09:30:00-04:00,243.5,244.67,242.49,243.42,2983796,4227721.7,51.073761703062125,47.62096623702623,NaN,NaN,11.3427757193225,-83.65665021359602,0.01914570422833839,-0.7985750436011472,-0.8177207478294856,350910776,349380080.8,20.288733961605843,35.6348850889316,NaN,NaN,-5.393715501468551,-5.07095829604519
2018-05-08T09:30:00-04:00,243.17,243.98,241.84,243.42,2927215,4074902.9,51.073761703062125,47.38349865264576,NaN,NaN,-1.7097238530403587,-61.513191591452866,0.1508244723171306,-0.6291901574330723,-0.7800146297502029,350910776,348915633.8,19.893559972121977,33.24631618766889,NaN,NaN,-4.411692778936727,-4.976777507886839
2018-05-09T09:30:00-04:00,244.23,245.85,243.21,245.4,3670539,4021776.9,55.0387928392572,47.52149815946873,NaN,NaN,48.77624541862559,-29.429326024589137,0.3589219238957563,-0.3313622248805075,-0.6902841487762638,354581315,349731183.6,22.739273626930782,31.210184089509635,NaN,NaN,-2.453954693680386,-4.6163742487144885
2018-05-10T09:30:00-04:00,246,248.11,245.965,247.46,3877780,3978543.55,58.78148281114023,48.16159808376023,NaN,NaN,112.09797306198851,22.595265543805862,0.6082956709718185,0.07008543993850935,-0.5382102310333091,358459095,352557788.4,31.78425510176622,29.91273108528339,NaN,NaN,0.34750083811869575,-3.907249236309748
2018-05-11T09:30:00-04:00,247.7,248.94,247.38,248.54,3293455,3882091.8,60.6317450007857,48.94855134145383,NaN,NaN,126.64051630163847,59.42955732970695,0.8065402770976375,0.46996511533873786,-0.3365751617588997,361752550,355322902.4,39.2738338375699,29.43855386562772,NaN,NaN,3.2692607794286723,-2.882033519775688
2018-05-14T09:30:00-04:00,249.41,250.2,248.85,249.27,4286309,3895485.45,61.87742620514275,50.275151417996184,NaN,NaN,140.8526245172436,85.33152708929117,0.9381713676011019,0.8361390477424777,-0.10203231985862418,366038859,358348519,46.23040265446598,29.979511904309412,NaN,NaN,6.097964660803845,-1.599176636835755
2018-05-15T09:30:00-04:00,248.07,248.18,246.49,247.31,4755865,3942181.4,56.69073132147668,51.153386140349824,NaN,NaN,89.86455269998318,103.64638239989588,0.847342279767612,0.9571455298508909,0.10980325008327882,361282994,360422962.6,50.42378987028578,31.06095191960132,NaN,NaN,7.189466881486255,-0.3436561342183251
2018-05-16T09:30:00-04:00,247.18,248.28,246.971,247.97,2034402,3861622.55,57.96836768385686,51.821298297390435,NaN,NaN,99.67496327253396,113.82612597067755,0.7871118875415242,1.093693109510184,0.3065812219686599,363317396,362170178.8,53.699063984136394,32.45389876126175,NaN,NaN,8.462377258836359,0.9143486362180582
2018-05-17T09:30:00-04:00,247.8,248.8926,246.88,247.74,2058226,3778443.5,57.33361532217416,52.46370542503728,NaN,NaN,97.88046808283961,110.98262497484777,0.6906258336076206,1.1698635139781857,0.479237680370565,361259170,362730193.8,54.73137213167792,33.99526607430697,NaN,NaN,9.364015654469089,2.121443924539634
2018-05-18T09:30:00-04:00,246.97,247.53,246.42,247,2408831,3729059,55.237868887518566,53.12401769625212,NaN,NaN,71.50577904468535,99.95567752345714,0.5423523071659543,1.1571780643280078,0.6148257571620536,358850339,362149751.6,53.40237465386778,35.536606361903715,NaN,NaN,9.59617084594997,3.189262056169682
2018-05-21T09:30:00-04:00,249.22,250.67,249.21,249.94,4060299,3807526.35,61.29174217927624,54.309080505610765,NaN,NaN,120.75661153247668,95.93647492650378,0.6030050117473238,1.3685820218462084,0.7655770100988846,362910638,361524107.4,51.93841325746862,37.01405529509283,NaN,NaN,11.530609063001048,4.380883057145591
2018-05-22T09:30:00-04:00,250.37,250.43,247.92,248.18,2329251,3569542.65,56.37623159836649,55.33516271084501,NaN,NaN,87.30661232396217,95.42488685129958,0.49011172502206024,1.37821666637646,0.8881049413543997,360581387,361383786,51.596770088835534,38.66567232607328,NaN,NaN,11.800914702534811,5.44088757791548
2018-05-23T09:30:00-04:00,246.83,248.7,246.4675,248.63,3489376,3480552.05,57.31874679486602,56.429745489609424,NaN,NaN,62.05766510954267,87.90142721870131,0.4142811990041191,1.4059564401095486,0.9916752411054295,364070763,361534459.4,51.96216696871365,40.67118261990232,NaN,NaN,12.288992393656944,6.419188265878546
2018-05-24T09:30:00-04:00,248.13,248.43,245.85,247.91,3448098,3460668.6,55.26147203656763,56.85398186332518,NaN,NaN,46.05401940340949,77.53613748281529,0.29004515753073035,1.3542316880188423,1.064186530488112,360622665,361407158.4,51.6076925948749,42.82655019316586,NaN,NaN,12.133139286390422,7.235466983094528
2018-05-25T09:30:00-04:00,247.41,248.1,246.71,247.37,4206996,3510528.75,53.70459956164179,57.04189885322372,NaN,NaN,41.87368113352372,71.60971790058295,0.15280824322797137,1.2551968345230762,1.1023885912951048,356415669,360920224.4,50.19710762561665,44.96286259773806,NaN,NaN,11.577193557459237,7.855713636575201
2018-05-29T09:30:00-04:00,245.38,246.21,242.31,243.45,6439614,3658726.7,44.011297361404665,56.53743711453391,NaN,NaN,-34.23596822340697,40.61120194940622,-0.20143516507447012,0.8505946349520173,1.0520298000264874,349976055,358333307.8,43.40882586999552,46.64252444758616,NaN,NaN,8.033471092629465,7.881107558868668
2018-05-30T09:30:00-04:00,245.17,247.16,244.58,246.7,4185861,3648188.1,51.781863623784375,56.3047993134287,NaN,NaN,7.641167559528847,24.678112996519566,-0.21509225381877184,0.7831644827530226,0.9982567365717945,354161916,357049413.6,40.482768330385554,47.909916926404364,NaN,NaN,7.343148909005999,7.804256323174001
2018-05-31T09:30:00-04:00,246,246.02,243.51,244.18,5357794,3779605.55,46.40400265850249,55.42069358824028,NaN,NaN,-42.980497702565735,3.670480434097885,-0.38229819003104615,0.5203839990329868,0.902682189064033,348804122,353996085.4,34.52284893626356,48.105530771725604,NaN,NaN,4.944154916162559,7.395670407886652
2018-06-01T09:30:00-04:00,246.14,246.83,245.65,246.36,3565273,3648994.45,51.132197250960374,54.74215446325276,NaN,NaN,-7.70820386722306,-7.081964220028626,-0.3361660027806995,0.48247468558815854,0.8186406883688581,352369395,352345431.4,31.797452097305595,47.571503504563864,NaN,NaN,4.509525238667292,6.983363955141029
2018-06-04T09:30:00-04:00,247.72,248.67,247.54,248.2,3062549,3622076.45,54.75990664999121,54.23376020931337,NaN,NaN,55.72443672976522,-4.3118131007803395,-0.17966775365404064,0.5940559963013072,0.7737237499553479,355431944,352148686.4,31.478467989415336,46.51779388563167,NaN,NaN,5.353114933184378,6.75047123771865
2018-06-05T09:30:00-04:00,248.16,248.4765,247.16,248.15,2816404,3613706.85,54.64120225764958,54.087365276182865,NaN,NaN,42.56596683176896,11.048573910254847,-0.08240397737129956,0.6707187782412234,0.753122755612523,352615540,352676583.4,33.4087642626741,45.30243491365941,NaN,NaN,5.976413371508641,6.639891542545792
2018-06-06T09:30:00-04:00,249.24,251.53,248.55,251.52,4102505,3672471.35,60.80783304050011,54.29018423022881,NaN,NaN,168.37032025136722,43.19440444862252,0.19107827661124488,0.991970601376579,0.8008923247653341,356718045,353187809.2,35.30934663923448,43.98888367473785,NaN,NaN,8.563899878756493,6.914749876290178
2018-06-07T09:30:00-04:00,252.22,253.37,251.74,252.53,4286770,3703282.9,62.45527998775679,54.65601742062757,NaN,NaN,238.46013445940648,99.48253088101697,0.4096292741818116,1.3129289174925987,0.903299643310787,361004815,355627947.8,43.58580333429739,43.1927716177821,NaN,NaN,11.187454683949404,7.525136277384353
2018-06-08T09:30:00-04:00,251.96,253.41,251.767,253.27,4450986,3731943.2,63.66055319488921,55.257637728296906,NaN,NaN,199.90415417687154,141.0050024898359,0.5641292227914401,1.6084611718000872,1.0443319490086471,365455801,358245229,50.8494085507401,43.01041689613011,NaN,NaN,13.692973426821789,8.406255870161129
2018-06-11T09:30:00-04:00,253.62,254.159,253.02,253.39,4200206,3777280.75,63.86314468512397,55.441309335857454,NaN,NaN,180.16458409889592,165.89303196366203,0.6295313560049096,1.8312461440147842,1.2017147880098746,369656007,361090041.6,57.286851199027375,43.392448177670026,NaN,NaN,15.773749420914815,9.458754948840227
2018-06-12T09:30:00-04:00,253.74,253.77,252.56,253.3,6531009,3889515.75,63.576866698267466,55.95564041442181,NaN,NaN,144.1397991427454,186.2077984258573,0.6208236780414995,1.9777443855617491,1.3569207075202496,363124998,363191933.2,61.31805086438992,44.08682537592391,NaN,NaN,17.403194651188265,10.593674906318517
2018-06-13T09:30:00-04:00,253.42,253.7516,252.03,252.18,3819019,3842673.45,59.97390082578079,56.14529427377287,NaN,NaN,108.7357790171577,174.28089017901542,0.49897470057145155,1.9806390832345642,1.4816643826631126,359305979,363709520,62.26255268869092,44.82256721306514,NaN,NaN,17.829081002794872,11.627304348672283
2018-06-14T09:30:00-04:00,253.16,253.515,251.54,251.99,5006987,3991302.7,59.35933232510224,56.43799858009677,NaN,NaN,87.35911209205553,144.0606857055452,0.3708116363023801,1.9451789280410878,1.5743672917387077,354298992,362368355.4,58.29083559866255,45.29993457047855,NaN,NaN,18.02171063777421,12.540790961401129
2018-06-15T09:30:00-04:00,250.27,251.195,248.77,250.74,6355977,4206190.25,55.341429160474036,56.55491498001336,NaN,NaN,28.08414057475616,109.69668298512212,0.1769176659869478,1.7955143742223925,1.6185967082354447,347943015,358865798.2,49.42385361358806,45.24470214104793,NaN,NaN,17.102726974675452,13.192496106154604
2018-06-18T09:30:00-04:00,248.8,249.9,248.14,249.73,4075518,4289524.6,52.263189612430914,57.14433585508666,NaN,NaN,-0.7521765283530799,73.51333085967232,-0.03309791233188042,1.577224317820594,1.6103222301524744,343867497,353708096.2,39.818450533438146,44.988246759865255,NaN,NaN,15.457508481485258,13.516069302630411
2018-06-19T09:30:00-04:00,246.6,247.23,245.53,246.88,5511050,4362062.15,44.706510424555674,56.63895348371319,NaN,NaN,-68.21725362296867,31.041920306529526,-0.35955790315730196,1.1608748512058469,1.5204327543631488,338356447,348754386,33.15387724429131,44.46475453942996,NaN,NaN,11.637251561615516,13.247666768199712
2018-06-20T09:30:00-04:00,247.96,247.98,246.12,246.46,4711680,4481183.6,43.703646830923226,56.446070924600384,NaN,NaN,-55.44766004697524,-1.794767506297059,-0.5859929954007779,0.7879415101121765,1.3739345055129544,333644767,343622143.6,27.936813854638473,43.99432346217102,NaN,NaN,8.191171133087515,12.52531024889797
2018-06-21T09:30:00-04:00,245.83,245.94,243.93,244.5,4676606,4540545.1,39.27584573607872,55.59918867353741,NaN,NaN,-98.961114299809,-39.05881278466997,-0.8348079230242362,0.3304246017326591,1.1652325247568953,328968161,338555977.4,23.93322107624823,43.43259267495263,NaN,NaN,3.7752814070425544,11.275306128632911
2018-06-22T09:30:00-04:00,245.92,246.51,245.44,245.69,3653100,4550795.2,43.04853388189132,54.762662047244554,NaN,NaN,-68.88275930770178,-58.452192761161555,-0.8816784710947274,0.063134435888486,0.9448129069832134,332621261,335491626.6,21.889797076303367,42.74768760973035,NaN,NaN,1.1177407061685483,9.824225353995145
2018-06-25T09:30:00-04:00,244.18,244.4,240.7,242.31,9535988,4817244.8,36.174038144063765,53.44357889627414,NaN,NaN,-133.4554711790635,-84.99285169130363,-1.0891543628602767,-0.41663004659213243,0.6725243162681442,323085273,331335181.8,19.46249378913714,41.75152543304914,NaN,NaN,-3.606424793585805,7.905561047197866
2018-06-26T09:30:00-04:00,242.92,243.69,242.272,242.67,3833729,4686950.55,37.32210549065614,51.76602692842814,NaN,NaN,-121.26567014976379,-95.60253499666265,-1.1452578777430453,-0.7590480309106624,0.3862098468323829,326919002,329047692.8,18.26227902989089,40.53387774666745,NaN,NaN,-7.026720344667431,5.772377991217109
2018-06-27T09:30:00-04:00,243.27,245.58,241.01,241.12,6149330,4785124,34.44894550224258,49.76557446517713,NaN,NaN,-117.88687808485783,-108.09037860423919,-1.22282454393563,-1.1423208330871546,0.08050371084847541,320769672,326472673.8,16.991967467938167,38.6343180419275,NaN,NaN,-10.842792509205323,3.398782205442476
2018-06-28T09:30:00-04:00,240.47,242.96,239.83,242.08,5523974,4793433,37.65042965952529,47.90770849836542,NaN,NaN,-129.0487943110079,-114.10791460647897,-1.1468083240742886,-1.3530066942443852,-0.20619837017009673,326293646,325937770.8,16.731608671973262,36.1973323363013,NaN,NaN,-13.051321202598718,1.0487674328651626
2018-06-29T09:30:00-04:00,243.48,244.96,242.59,242.73,3966158,4813477.25,39.79447911979284,46.18851810084177,NaN,NaN,-86.96170775893319,-117.72370429672523,-0.995683890122691,-1.4508032328234606,-0.45511934270076954,330259804,325465479.4,16.49133614394043,33.283366975223664,NaN,NaN,-14.248452717478205,-1.136549731469604
2018-07-02T09:30:00-04:00,240.92,243.04,240.62,242.73,5700302,4945364.9,39.79447911979284,44.48977613095072,NaN,NaN,-98.06076904188474,-110.64476386928948,-0.8446173917060487,-1.5108910823333304,-0.6662736906272817,330259804,326900385.6,20.23895497662103,30.349145840383027,NaN,NaN,-15.221458794925837,-3.148679597677637
2018-07-03T09:30:00-04:00,244.06,244.3,241.35,241.66,3143826,4961736,37.34288278233057,42.87327484213285,NaN,NaN,-82.92219097317353,-102.97606803397143,-0.7678662080335104,-1.6261064506691696,-0.8582402426356592,327115978,326939780.8,20.34464727051308,27.355009739084608,NaN,NaN,-16.750168090019255,-5.091749382297868
2018-07-05T09:30:00-04:00,243.13,243.67,241.69,243.55,3294601,4921340.8,43.91541007258088,41.77013753838133,NaN,NaN,-67.925566594689,-92.98380573593766,-0.5510674404773341,-1.547074543232327,-0.9960071027549928,330410579,328867962.2,25.545031531550123,25.016023734290872,NaN,NaN,-16.196661596302157,-6.678165412869909
2018-07-06T09:30:00-04:00,243.31,245.2,242.81,244.6,3546395,4884322.05,47.22735444053084,41.1905607726711,NaN,NaN,-43.028757386339,-75.77979835100389,-0.31020535359427415,-1.3837637947478356,-1.0735584411535615,333956974,330400627.8,29.485802903209063,23.59187725497808,NaN,NaN,-14.74726104915984,-7.830893360911327
2018-07-09T09:30:00-04:00,245.78,248,245.76,247.84,3679325,4845739,55.88443942715118,41.449221473722545,NaN,NaN,16.18795367121392,-55.14986606497446,0.0735804715683881,-0.9815828516930765,-1.0551633232614646,337636299,331875926.8,33.153420649932784,23.115803691870557,NaN,NaN,-10.565140331422487,-8.22150007098435
2018-07-10T09:30:00-04:00,248.52,249.48,248.4483,249.23,3474718,4809464.6,58.99244084350553,42.46964507507611,NaN,NaN,60.512496950625035,-23.435212866472504,0.40859905701956656,-0.5444145019870064,-0.9530135590065729,341111017,334046169.4,38.24218501953672,23.479254247245226,NaN,NaN,-6.056541046864624,-7.912220210395818
2018-07-11T09:30:00-04:00,247.34,248.16,246.64,247.08,4409825,4703405.4,52.796555932106145,43.11913858230346,NaN,NaN,33.49249822781836,-0.1522750262741283,0.46864324374015065,-0.36720950433138455,-0.8358527480715352,336701192,335963212.2,42.41250652458083,24.513232295098252,NaN,NaN,-4.170587516774942,-7.377701254164264
2018-07-12T09:30:00-04:00,249.07,249.44,248.17,249.3,3175377,4671223.3,57.73293259795824,44.43750192958057,NaN,NaN,81.60088201327933,29.753014695319536,0.6310062471234608,-0.047094939167209304,-0.6781011862906701,339876569,337856410.2,46.27114518175343,26.10879830263434,NaN,NaN,-0.8937233845880577,-6.451418701367663
2018-07-13T09:30:00-04:00,249.24,250.46,248.93,250.2,3018231,4571785.5,59.57846479459007,45.61821128048762,NaN,NaN,111.7933746468731,60.71744110196196,0.763311858500636,0.27603863683512486,-0.48727322166551107,342894800,339643975.4,49.69833998077703,28.09512279581103,NaN,NaN,2.347936124748895,-5.194368011922441
2018-07-16T09:30:00-04:00,250.39,250.75,249.83,250.67,1881422,4348057.75,60.54727030126966,47.35915643457376,NaN,NaN,125.40100733324894,82.56005183436898,0.8406610625345197,0.5635531065026385,-0.27710795603188115,344776222,341071960,52.315068598834,30.44173528221795,NaN,NaN,5.252643108425806,-3.7019378518726915
2018-07-17T09:30:00-04:00,250.55,251.57,249.9,251.28,2960092,4292286.45,61.82608368339111,49.10944059119769,NaN,NaN,131.90313856488947,96.83818015722186,0.8865283183639213,0.8310524419230205,-0.055475876440900795,347736314,342397019.4,54.67144543029948,33.042390025104275,NaN,NaN,8.023889041029186,-2.0268197243152803
2018-07-18T09:30:00-04:00,251.39,252.165,251.02,252.03,2119574,4122712.65,63.39703419191276,51.17716121188841,NaN,NaN,132.9861693016401,116.73691437198622,0.9171727571935144,1.0909900700509922,0.1738173128574778,349855888,345027958.6,59.00328882813747,36.043198693689945,NaN,NaN,10.804464555824298,-0.1937791128667694
2018-07-19T09:30:00-04:00,251.22,251.62,250.61,250.79,2537412,4013999.25,59.068908755017034,52.70705257585211,NaN,NaN,103.58531590462225,121.1338011502548,0.807581823885825,1.1832945927147591,0.3757127688289341,347318476,346516340,61.25888377315121,39.22371834377408,NaN,NaN,11.944045970580767,1.5401958990543072
2018-07-20T09:30:00-04:00,249.82,251.04,249.68,250.44,2687910,3914564.45,57.86802600082249,53.99802021021137,NaN,NaN,80.79794886552178,114.93471599398454,0.6707960924116255,1.214207884343466,0.5434117919318405,344630566,346863493.2,61.78698241513199,42.459121648859195,NaN,NaN,12.548744881958115,3.112845753754851
2018-07-23T09:30:00-04:00,250.21,250.6,249.62,250.26,1792009,3821509.9,57.22369841173237,55.242964445349905,NaN,NaN,68.944934004578,103.64350132825034,0.5334558452353387,1.210231598476014,0.6767757532406752,342838557,346475960.2,60.79076815725657,45.35567973319031,NaN,NaN,12.876574938021426,4.507664208650076
2018-07-24T09:30:00-04:00,251.26,252.66,251.06,252.21,5489401,3619180.55,62.14157264935943,57.01429943585197,NaN,NaN,95.6834892260956,96.39957146049156,0.5376834112140053,1.3488800172581819,0.8111966060441765,348327958,346594289,60.997550809171116,48.25945855738017,NaN,NaN,14.58321443606209,5.947028526851792
2018-07-25T09:30:00-04:00,251.57,254.16,250.93,254.02,4696827,3662335.45,66.04387532647077,58.594904096844104,NaN,NaN,106.3770258980746,91.07774277977846,0.6202613616688046,1.5865233081301824,0.9662619464613778,353024785,347228068.4,62.148976039299875,50.87402602221943,NaN,NaN,17.27502608860845,7.565313892817029
2018-07-26T09:30:00-04:00,254.52,255.68,254.45,255.12,4174986,3563618.25,68.18984213562922,60.09222464649399,NaN,NaN,133.99774153988477,97.16022790683095,0.7008947001778283,1.8423803216836632,1.1414856215058349,357199771,349204327.4,65.56295016956958,53.45096511267376,NaN,NaN,20.210271961105374,9.371736474001079
2018-07-27T09:30:00-04:00,255.11,255.6,253.48,254.26,5853325,3580085.8,64.74475717271824,60.72510448546306,NaN,NaN,116.20453544886566,104.24154522349974,0.6494021588669978,1.9532383200895822,1.3038361612225844,351346446,350547503.4,67.69559293203726,55.91826313282407,NaN,NaN,21.674165560912506,11.129226343559854
2018-07-30T09:30:00-04:00,254.53,254.79,252.67,252.87,4484389,3605997.35,59.51138808829109,60.76217214580489,NaN,NaN,89.95339854339352,108.44323813126285,0.48249151918765265,1.9069505602071501,1.4244590410194975,346862057,351352203.4,68.93674473144021,58.110731683674324,NaN,NaN,21.379261358285646,12.593517059949253
2018-07-31T09:30:00-04:00,253.69,254.68,253.6,254.17,3743090,3508136.75,62.55950470768382,61.459525629774724,NaN,NaN,102.0790224324771,109.72234477253915,0.4225586029091164,1.9526572946558929,1.5300986917467765,350605147,351807641.2,69.64752760500033,60.05609033227572,NaN,NaN,22.03578236353189,13.942412103318201
2018-08-01T09:30:00-04:00,253.9,254.64,252.561,253.11,3159023,3508896.6,58.680337579900176,61.527197414199144,NaN,NaN,80.71906805685661,104.59075320429554,0.2812462505205158,1.8816565048974212,1.6004102543769054,347446124,350691909,65.68242228581697,61.442610125423116,NaN,NaN,21.425061582062064,15.01136202885304
2018-08-02T09:30:00-04:00,251.45,253.41,251.03,253.1,4132560,3550794.55,58.64339364911133,61.46040661809352,NaN,NaN,48.73331828048389,87.53786855241538,0.1627022010929451,1.8037880057430868,1.6410858046501418,343313564,347914667.6,56.985740728645766,61.96313875027088,NaN,NaN,20.921114288965207,15.855612351726206
2018-08-03T09:30:00-04:00,253.04,254.5,253.04,254.39,2469438,3496946.7,61.969646461379554,61.56200491524423,NaN,NaN,87.30427702191965,81.75781686702616,0.14723528955717358,1.8251299165966088,1.6778946270394353,345783002,346801978.8,53.906186968885,62.07679006241738,NaN,NaN,21.431025927229662,16.652100005369558
2018-08-06T09:30:00-04:00,254.22,255.24,253.63,254.85,2305424,3428251.65,63.10906384628426,61.653646355450874,NaN,NaN,99.5952555271931,83.68618826378608,0.14388169220034142,1.8577467422898621,1.7138650500895207,348088426,347047252.6,54.49002225782593,62.06383126438356,NaN,NaN,22.17695206973051,17.441364585992552
2018-08-07T09:30:00-04:00,255.98,256.76,255.65,256.12,2394469,3374239.2,66.1265321186593,61.848610493075626,NaN,NaN,139.89468712279364,91.24932120184938,0.19966065882350925,1.9634408736189073,1.763780214795398,350482895,347022802.2,54.416028677602974,61.73616982505966,NaN,NaN,23.700933880737743,18.33558877095615
2018-08-08T09:30:00-04:00,255.97,256.121,255.38,255.62,1877503,3247623.1,63.91015393543979,62.19441372024868,NaN,NaN,114.85029608211266,98.07556680690058,0.17616641337448735,1.9839882315135071,1.8078218181390198,348605392,347254655.8,55.03950603882696,61.29192855832222,NaN,NaN,24.358748730639206,19.196040193768017
2018-08-09T09:30:00-04:00,255.76,256.23,255,255.16,1677288,3172718.65,61.85604817585542,62.47927244703675,NaN,NaN,97.67643251514166,107.86418965383214,0.10636804920661591,1.9407818796472895,1.8344138304406736,346928104,347977563.8,57.013711503349874,60.950980636052066,NaN,NaN,24.348282730115717,19.932074841817688
2018-08-10T09:30:00-04:00,253.68,253.9,252.4,253.3,4797172,3261665.7,54.261767121296124,62.2677059262913,NaN,NaN,4.662977005421874,91.33592965053259,-0.0783810575732613,1.736437508474097,1.8148185660473584,342130932,347247149.8,54.41389994206386,60.49549004925258,NaN,NaN,22.095328880740272,20.241111133092343
2018-08-13T09:30:00-04:00,253.57,253.96,251.7,252.04,3691567,3352172.95,49.801232916098634,61.38625308820124,NaN,NaN,-29.06484436837167,65.60390967141964,-0.28702496481993856,1.4560373600224352,1.7430623248423738,338439365,345317337.6,48.16473007676116,59.57885999693759,NaN,NaN,18.784065284878004,20.03296172620458
2018-08-14T09:30:00-04:00,252.76,253.5532,252.2292,253.21,2828244,3345580.55,53.614321173514405,60.4984277915615,NaN,NaN,-15.108209322375975,34.603330382385714,-0.3439771006634744,1.3130909490130307,1.6570680496765051,341267609,343474280.4,43.0765566421357,58.216544325711574,NaN,NaN,17.06876083498914,19.609504456030944
2018-08-15T09:30:00-04:00,251.84,252.2,249.86,251.76,5803665,3529785.1,48.679238767449796,59.104813265262976,NaN,NaN,-97.8013385418414,-7.926996542405101,-0.46928453369005885,1.0704623825639317,1.5397469162539905,335463944,340845990.8,37.063464320603224,56.18086676507112,NaN,NaN,14.040934198828378,18.81399441928772
2018-08-16T09:30:00-04:00,254.37,256.41,254.28,255.94,7919176,3798873.3,60.08537620932247,58.77200033930613,NaN,NaN,100.10975050184452,-7.440332945064531,-0.2705038783566134,1.2016170683082237,1.472120946664837,343383120,340136994,35.619039836243175,53.88968440108584,NaN,NaN,15.135534545833499,18.2885001516514
2018-08-17T09:30:00-04:00,255.23,257.12,255.03,256.51,3902541,3859604.85,61.34694965896861,58.90311188006881,NaN,NaN,120.8244605249424,15.791963758839568,-0.1087767316164725,1.3361500321442463,1.4449267637607188,347285661,341167939.8,39.32205858941194,51.77434967665524,NaN,NaN,16.41485083532746,18.020835963605123
2018-08-20T09:30:00-04:00,257.11,257.72,256.97,257.43,2930743,3916541.55,63.359907664702924,58.960283519855885,NaN,NaN,162.81663591368863,54.16825981525162,0.04383209602040128,1.4997168837862205,1.4558847877658192,350216404,343523347.6,46.84454270545183,50.14556504097321,NaN,NaN,18.110591765189227,18.03365822097428
2018-08-21T09:30:00-04:00,257.93,258.7,257.76,258.07,3290897,3806616.35,64.73573095995555,59.39281161843129,NaN,NaN,175.28248347257053,92.24639837424093,0.1647568828935666,1.6618308913827775,1.497074008489211,353507301,345971286,53.32143921532619,49.26263767879529,NaN,NaN,19.91602350345914,18.302567547043548
2018-08-22T09:30:00-04:00,258,258.2,257.05,257.18,3850556,3764302.8,61.28918058759013,59.58179639975121,NaN,NaN,123.76380971330363,136.55942802526994,0.16146710978728995,1.6989078957233232,1.5374407859360333,349656745,348809846.2,59.48605409809571,49.441231490898865,NaN,NaN,20.35500117177036,18.59577235057595
2018-08-23T09:30:00-04:00,256.8,257.56,255.98,256.49,2812271,3696167.05,58.68074589901732,59.346874931011044,NaN,NaN,80.02486370143582,132.5424506651882,0.09289002882299657,1.6535533219647789,1.5606632931417823,346844474,349502117,60.84420228170146,49.9368040132429,NaN,NaN,19.934574125959752,18.78702974705935
2018-08-24T09:30:00-04:00,257.24,258.18,256.99,257.85,3631718,3585086.7,62.10417992449093,59.27509750802581,NaN,NaN,106.43215391322806,129.66398934284535,0.11760154768186659,1.7076652277441156,1.590063680062249,350476192,350140223.2,62.10522688155495,50.48074720065211,NaN,NaN,20.610482716181927,19.047523028362576
2018-08-27T09:30:00-04:00,259.25,260.645,259.25,260.58,4111589,3566446.7,67.86063594434896,59.398962067003644,NaN,NaN,174.27846340032255,131.9563548401721,0.2866512966715917,1.9483778009017385,1.6617265042301468,354587781,351014498.6,63.82426241848337,51.152763896429285,NaN,NaN,23.12604620816973,19.630169196906454
2018-08-28T09:30:00-04:00,261.3,261.32,260.35,260.64,2713570,3514970.7,67.97577318602815,59.68936344204567,NaN,NaN,168.76527076947386,130.65291229955278,0.36626108614578823,2.119552861912382,1.7532917757665938,357301351,351773308.6,65.29575349722694,51.885353000600716,NaN,NaN,25.134527120384035,20.416506043117536
2018-08-29T09:30:00-04:00,260.8,261.767,260.44,261.33,2433856,3478712.35,69.33623556142632,60.22366254101502,NaN,NaN,157.16485146842584,137.33312065057723,0.4250087101252613,2.2845526634231703,1.859543953297909,359735207,353789001,68.91312566284537,52.735311154850386,NaN,NaN,27.208528290253604,21.386794935565547
2018-08-30T09:30:00-04:00,260.74,261.15,259.45,260.01,3867210,3465444.85,63.756166163475555,60.90183390117069,NaN,NaN,114.29299071162262,144.18674605261458,0.33835850032077674,2.28249207869888,1.944133578378103,355867997,355593705.6,71.75211083321409,53.97375478993255,NaN,NaN,27.31055725366672,22.233046695294284
2018-08-31T09:30:00-04:00,259.59,260.49,258.98,259.85,3081784,3496062.15,63.0933491350913,61.85127077395589,NaN,NaN,90.78195910273037,141.05670709051503,0.23837539486868042,2.242102821963954,2.0037274270952734,352786213,356055709.8,72.44585210661921,55.70812064920813,NaN,NaN,27.201973882338958,22.942893436300665
2018-09-04T09:30:00-04:00,259.22,259.92,258.21,259.73,2944977,3528039.8,62.567974014425914,62.49081740544956,NaN,NaN,68.96163000059555,119.99334041056963,0.13728616913717584,2.1753351385167434,2.0380489693795676,349841236,355106400.8,68.7117278929432,57.53920430998009,NaN,NaN,26.967771171940324,23.517875969963473
2018-09-05T09:30:00-04:00,259.22,260.31,258.92,259.92,3282756,3572454.15,63.092012668537855,63.52030125552728,NaN,NaN,73.4758145918523,100.93544917504532,0.06027348573240321,2.1133908265450714,2.053117340812668,353123992,354270929,65.51135419133817,59.571196443604016,NaN,NaN,26.909712906533695,24.002424103759218
2018-09-06T09:30:00-04:00,260.14,261.05,259.04,260.29,3878500,3672504,64.14471591717292,63.81025409180232,NaN,NaN,77.42613635949947,84.98770615326006,0.013738448760563848,2.0702904017633728,2.056551953002809,357002492,353724386,63.43001964310285,61.557695001236844,NaN,NaN,27.133167406787717,24.449673147049005
2018-09-07T09:30:00-04:00,259.33,260.34,258.46,259.54,3796404,3778459.8,60.38496852101704,63.74154115337721,NaN,NaN,54.074270377992825,72.94396208653411,-0.08276144252324613,1.9531001498487512,2.0358615923719974,353206088,353192004.2,61.38420857217931,63.133562857148796,NaN,NaN,26.335797083424374,24.71911942367406
2018-09-10T09:30:00-04:00,260.52,260.65,258.86,258.94,2247644,3650983.4,57.482241813374365,63.32170787828232,NaN,NaN,49.79871315370252,64.74731289672854,-0.1957583731089556,1.7911636259858028,1.9869219990947584,350958444,352826450.4,59.954314369672325,64.06997511887884,NaN,NaN,24.868240695765238,24.740422462544227
2018-09-11T09:30:00-04:00,258.1,260.51,257.82,260.03,3072921,3620051.1,61.137114693701115,63.064663859264144,NaN,NaN,43.498049877903874,59.65459687219021,-0.20487381772654545,1.7308297269365767,1.935703544663122,354031365,353664476.2,62.13207206135822,64.69930603645255,NaN,NaN,24.537122496111518,24.711379610196698
2018-09-12T09:30:00-04:00,260.15,261.77,259.58,260.25,4971555,3727216.65,61.849931784365914,63.1047175161767,NaN,NaN,75.11807406963855,59.98304876774745,-0.203454931437689,1.6813848803660107,1.8848398118036997,359002920,354840261.8,65.0073882645711,65.09368704834365,NaN,NaN,24.446939695912658,24.67360247958469
2018-09-13T09:30:00-04:00,261.42,262.2236,260.99,261.78,2472309,3560648.85,66.45768797234521,63.66021337855726,NaN,NaN,123.00999922622856,69.09982134109326,-0.11144285643989527,1.7455362412538307,1.856979097693726,361475229,355734809.2,67.05684681627483,65.53744737224176,NaN,NaN,25.67322793037803,24.81640611541231
2018-09-14T09:30:00-04:00,262.01,262.47,261.02,261.89,3077750,3318577.55,66.76845195786802,63.993375666655616,NaN,NaN,128.4659199964002,83.97815126477475,-0.05783923266384505,1.7846800568639196,1.8425192895277647,364552979,358004187.4,71.60100965542826,66.21571757037556,NaN,NaN,26.772955162913505,25.095913122198194
2018-09-17T09:30:00-04:00,261.72,262.1899,260.64,260.98,2473548,3247127.9,61.6775125424291,63.551723995089915,NaN,NaN,96.47062987223066,93.31253460848038,-0.09608146233552484,1.7224174616083587,1.8184989239438836,362079431,360228384.8,75.21022241365345,67.02900042717343,NaN,NaN,26.32797477057254,25.271921929108814
2018-09-18T09:30:00-04:00,261.25,263.53,261.18,262.91,2998893,3250535.4,67.36154795308039,63.50785076416508,NaN,NaN,154.27311226836764,115.46754708657313,-0.008425018396524209,1.8079676509482283,1.8163926693447525,365078324,362437776.6,78.17713915787719,67.94909940293415,NaN,NaN,27.63697815516985,25.60978710426039
2018-09-19T09:30:00-04:00,263.1,264.99,263.1,264.42,4001009,3286041,70.98728109259392,63.625782587819906,NaN,NaN,211.72567391409305,142.78906705546405,0.1267629629800795,1.9748463730698518,1.8480834100897723,369079333,364453059.2,80.47286091252025,68.77479477791094,NaN,NaN,29.94692566962095,26.229378327883328
2018-09-20T09:30:00-04:00,266,267.31,265.99,267.04,5247064,3355866.4,75.97439837770162,64.49851346026462,NaN,NaN,271.5317162406752,172.49341045835337,0.3552047022157683,2.2920892878594827,1.9368845856437145,374326397,367023292.8,82.93808630326632,69.5737930257718,NaN,NaN,33.81989365327663,27.31373766008237
2018-09-21T09:30:00-04:00,267.55,267.61,266.59,267.12,3955618,3413033.75,76.10943790175028,65.42823408645454,NaN,NaN,229.93303874762526,192.78683420859838,0.4672143473354562,2.520902519813035,2.0536881724775786,378282015,369769100,85.10194854397687,70.4777999141545,NaN,NaN,36.85111474994264,28.67622010149098
2018-09-24T09:30:00-04:00,266.68,266.7,265.25,265.42,3778613,3420378.5,67.43545543969319,65.7759113311165,NaN,NaN,149.05787907140981,203.3042840484342,0.3857145632426975,2.5358313765309504,2.150116813288253,374503402,372253894.2,86.74074850319461,71.76558710060102,NaN,NaN,36.59952496165947,29.808120795800765
2018-09-25T09:30:00-04:00,266.03,266.12,264.53,264.73,1820367,3305817.4,64.23552767959413,65.85759097476338,NaN,NaN,107.05752230841796,193.86116605644426,0.2507758901184931,2.4635866759363694,2.2128107858178763,372683035,373774836.4,87.63718747094306,73.34600376342995,NaN,NaN,35.36098053924776,30.60138647343605
2018-09-26T09:30:00-04:00,264.81,265.84,263.27,263.78,3365925,3338435.15,60.013146160313944,65.56247884927345,NaN,NaN,70.30621083137432,165.57727343990052,0.07225230328051824,2.303126164918524,2.2308738616380057,369317110,373822391.8,87.66526786858671,75.07709292239308,NaN,NaN,32.97844683812196,30.940966525534037
2018-09-27T09:30:00-04:00,264.25,265.37,263.59,264.25,2440217,3338753.2,61.36618031746209,65.63256540616239,NaN,NaN,65.28730341166879,124.32839087409923,-0.0337745566680292,2.188655665802969,2.222430222470998,371757327,373308577.8,85.40803949567164,76.79308084549969,NaN,NaN,31.4491991715107,31.01357118924499
2018-09-28T09:30:00-04:00,263.56,264.94,263.5,264.4,3288848,3309835.1,61.8103160081378,65.9417135629312,NaN,NaN,55.10418032493511,89.36261918956122,-0.10914844287288528,2.0859946688798914,2.1951431117527767,375046175,372661409.8,82.52577820129369,78.40532826204405,NaN,NaN,30.339648455317246,30.917296512969596
2018-10-01T09:30:00-04:00,266.1,267.15,265.74,266.73,5831122,3447302,67.96995096267244,66.42977329642915,NaN,NaN,105.7012279636617,80.69128896801156,-0.02198713681541964,2.1676591907335023,2.189646327548922,380877297,373936188.8,83.69314504491828,79.94540490372692,NaN,NaN,31.254577778926507,30.96547955096344
2018-10-02T09:30:00-04:00,266.11,268.02,266.05,267.57,4553359,3527721.1,69.85749175824564,67.00174186599199,NaN,NaN,110.75430068026246,81.43064464238047,0.06744073327545763,2.273947244143244,2.2065065108677864,385430656,376485713,85.74433513087143,81.42661539417693,NaN,NaN,32.60780036885467,31.20009681066219
2018-10-03T09:30:00-04:00,268.77,269.28,267.67,267.95,5827732,3654969.9,70.69872091384553,67.30467279038486,NaN,NaN,125.90491836750842,92.55038614960729,0.12409144863998733,2.3616208216677705,2.237529373027783,391258388,380873968.6,88.43972366424177,82.9539637404603,NaN,NaN,33.962411157264754,31.594713145891127
2018-10-04T09:30:00-04:00,267.69,267.71,264.58,266.25,8720854,3897087.6,62.31941061444195,66.98688412299728,NaN,NaN,64.61568700955283,92.41606286918409,0.024204784057462625,2.2677853530996117,2.243580569042149,382537534,383030010,89.491062202311,84.23182463666619,NaN,NaN,32.52411499266807,31.727484838287833
2018-10-05T09:30:00-04:00,266.34,266.62,262.9,264.32,7477269,4081130.85,54.431847253178816,66.46933660233655,NaN,NaN,16.40463666136949,84.67615413647097,-0.18329348390762812,2.014463714157614,2.197757198065242,375060265,383032828,89.49240727630539,85.2519806982842,NaN,NaN,28.627543557902293,31.284636083947042
2018-10-08T09:30:00-04:00,263.25,265.21,262.085,264.83,6236412,4280569.25,56.016051904580394,65.6589440274437,NaN,NaN,-9.23049040542353,61.68981046265393,-0.2912303553670048,1.8337192538564864,2.124949609223491,381296677,383116704,89.53534053572349,86.06328079670179,NaN,NaN,25.996861372705393,30.529239696626806
2018-10-09T09:30:00-04:00,264.38,265.32,263.14,264.23,4559121,4354879.25,53.652810458558335,64.42076755358401,NaN,NaN,-12.47786816995918,37.04337669260959,-0.40127967711003887,1.6233500128359424,2.0246296899459812,376737556,381378084,82.05143252361877,86.17603591178026,NaN,NaN,23.109004139360216,29.469206045588724
2018-10-10T09:30:00-04:00,264.04,264.12,255.8,256.06,12291998,4720901.4,33.14646390612734,61.361629377043,NaN,NaN,-219.31443111285694,-32.000493203463485,-0.9890691920173587,0.7882931999242828,1.7773623919416415,364445558,376015518,64.22094218750888,84.83909704636902,NaN,NaN,10.892962160594651,26.815456919161
2018-10-11T09:30:00-04:00,254.7301,256.73,248.86,250.27,15270254,5360798.65,25.661108576205805,57.75817728236125,NaN,NaN,-339.21787572755767,-112.7672057508856,-1.691343778344189,-0.3368173309885947,1.3545264473555942,349175304,369343072,49.73785174016345,82.31309013181091,NaN,NaN,-3.074282006750629,22.54549421545934
2018-10-12T09:30:00-04:00,254.3553,254.609,249.93,253.3,8634402,5638631.25,34.054014030553134,55.37378861027982,NaN,NaN,-238.15789317850113,-163.6797117188597,-1.8618342857570256,-0.9727664098406876,0.8890678759163378,357809706,365892960.2,44.18867753860924,79.2736564914834,NaN,NaN,-9.648413242738458,17.946364578573938
2018-10-15T09:30:00-04:00,252.87,254.74,252.34,252.34,5500898,5789998.75,32.790843103287685,53.12773971197222,NaN,NaN,-181.45939716392127,-198.12549307055926,-1.9404644224402534,-1.536512652133979,0.40395177030627444,352308808,360095386.4,36.765645557150854,75.63997492621252,NaN,NaN,-14.813800587916006,13.26634098336109
2018-10-16T09:30:00-04:00,254.62,258.11,253.98,257.92,7099844,5995046.3,45.45547625179168,52.087906147077774,NaN,NaN,-99.78531698272486,-215.58698283311242,-1.53560610438445,-1.5155558601742882,0.020050244210161883,359408652,356629605.6,33.177623598870895,71.74800033551853,NaN,NaN,-13.722389272670284,9.410808089642323
2018-10-17T09:30:00-04:00,256.92,258.02,254.67,256.97,6822354,6136113.55,43.937470870961775,50.8429983294706,NaN,NaN,-87.06300930552705,-189.1366984716464,-1.2621593194514453,-1.5576489051041449,-0.29548958565269945,352586298,354257753.6,30.95142108862015,67.85824187787199,NaN,NaN,-13.528316876232232,6.13379023737453
2018-10-18T09:30:00-04:00,256.11,256.86,252.32,253.68,8694626,6308491.65,39.07115471079937,49.21877252251786,NaN,NaN,-102.80207805262461,-141.8535389366598,-1.2318698868666305,-1.8353269442359874,-0.6034570573693571,343891672,353201027.2,29.98604134373349,64.1054035309034,NaN,NaN,-15.251996031922971,3.078677913189173
2018-10-19T09:30:00-04:00,254.23,255.98,253.34,254.32,6618342,6441627.85,40.45279630220445,47.253261475341574,NaN,NaN,-86.68560380556934,-111.55908106207343,-1.1019634946427437,-1.9809114256727867,-0.878947931030043,350510014,351741088.8,28.656220439397245,60.174194630509035,NaN,NaN,-16.039420561252044,0.3475209882689989
2018-10-22T09:30:00-04:00,255.07,255.44,252.2,253.04,4662628,6485828.6,38.56903486900119,45.0183716975384,NaN,NaN,-87.95477874983007,-92.8581573792552,-1.036447346580142,-2.1745071142552206,-1.1380597676750785,345847386,350448804.4,27.49391862319945,56.013450594246756,NaN,NaN,-17.296202037507655,-2.1730108725562376
2018-10-23T09:30:00-04:00,249.04,252.93,247.52,251.67,7360465,6762833.5,36.604296617947995,42.583055676402864,NaN,NaN,-109.30009434733579,-94.76111285217739,-1.0181055374422234,-2.410691689477858,-1.3925861520356344,338486921,346264458.2,24.087170776754547,51.41683967371195,NaN,NaN,-18.947601712300838,-4.569380992519752
2018-10-24T09:30:00-04:00,252.4,252.89,245.18,245.64,7624261,6975750.3,29.48484944506778,40.23772987859042,NaN,NaN,-126.41452145364508,-102.631415281801,-1.325363042895821,-3.0492899556554107,-1.7239269127595898,330862660,341919730.6,21.155908649230568,46.535757277063354,NaN,NaN,-23.06911533288036,-7.2122001839998395
2018-10-25T09:30:00-04:00,247.33,250.93,246.25,249.77,5920220,7149750.45,38.33178754712937,39.0877256138726,NaN,NaN,-103.2591251939148,-102.72282471005903,-1.1691847098179817,-3.185407800032067,-2.016223090214085,336782880,340497972.2,20.285923994321962,41.59243704263597,NaN,NaN,-23.2118914768933,-9.497870368698905
2018-10-26T09:30:00-04:00,247.38,249.04,244.31,246.53,5883224,7279469.25,34.65815562168487,37.56216159366578,NaN,NaN,-117.66020594973106,-108.91774513889138,-1.1983922715659432,-3.514213429671514,-2.315821158105571,330899656,336575900.6,18.077453684034566,36.48830226751533,NaN,NaN,-24.67060731990757,-11.665404218871572
2018-10-29T09:30:00-04:00,248.72,250.24,241.05,244.47,6833307,7329578.5,32.523901638215065,36.05295382078412,NaN,NaN,-123.28175578643244,-115.98314054621184,-1.2642287903175147,-3.896107146002464,-2.6318783556849494,324066349,332219693.2,15.994646226706678,31.769960389164474,NaN,NaN,-26.56920888966736,-13.7945191718424
2018-10-30T09:30:00-04:00,244.44,248.94,244.0882,248.7,6151094,7409465.25,40.611192919845934,36.58614875033545,NaN,NaN,-94.56865013821817,-113.03685170438833,-0.9452778320420387,-3.8134756457374976,-2.868197813695459,330217443,330565797.6,15.275066051082717,28.273826379419745,NaN,NaN,-25.24359450594301,-15.4301013624282
2018-10-31T09:30:00-04:00,250.94,253.2198,250.39,251.19,5376447,7386901,44.80489297851157,37.95356192192872,NaN,NaN,-38.43619777882138,-95.4411869694236,-0.5107577296659778,-3.506644975777931,-2.9958872461119532,335593890,331512043.6,17.5602535877796,25.975426511392325,NaN,NaN,-22.70729047888423,-16.469699807636204
2018-11-01T09:30:00-04:00,252.15,253.83,250.91,253.73,3267889,7114252.75,48.778323349021065,39.00529830181928,NaN,NaN,-15.078117002399368,-77.8049853311205,-0.022224385118552625,-3.0236677275101442,-3.0014433423915916,338861779,331927823.4,18.599176723996976,24.147605024634295,NaN,NaN,-19.2856146907349,-16.87197336236459
2018-11-02T09:30:00-04:00,255.38,255.6,250.58,252.46,6413404,7061059.5,46.95807760571287,40.01724362342109,NaN,NaN,-6.038933658592709,-55.48073087289284,0.23145904275116536,-2.712119538952635,-2.9435785817038003,332448375,332237567.2,19.413938453270674,22.90819737435714,NaN,NaN,-17.16554119288684,-16.91391162386777
2018-11-05T09:30:00-05:00,252.84,254.93,252.5,254.48,2833680,6890922.9,50.144811850117016,40.3521961661586,NaN,NaN,26.656821066624275,-25.493015502281473,0.5340771601476688,-2.275982131519214,-2.810059291666883,335282055,334480708.4,25.249150343049635,22.341877856084192,NaN,NaN,-14.399884333531826,-16.55476486810549
2018-11-06T09:30:00-05:00,254.53,256.38,254.33,256.23,2193348,6772634.25,52.79101174120009,40.9845919426042,NaN,NaN,80.19836031459641,9.460386588281443,0.8330548120389563,-1.7687407766181877,-2.601795588657144,337475403,335932300.4,28.840063394590985,22.191066592224974,NaN,NaN,-11.293246399509286,-15.803119372591746
2018-11-07T09:30:00-05:00,258.46,261.86,257.5,261.78,4462341,6381151.4,60.03576232564026,42.48206391509283,NaN,NaN,186.35260026884103,54.418146197813925,1.3546862102106534,-0.9084378258938273,-2.2631240361044807,341937744,337201071.2,31.91857425796732,22.329104657527388,NaN,NaN,-6.021951610753741,-14.405809692329175
2018-11-08T09:30:00-05:00,261.5255,262.97,260.971,262.1,4023379,5818807.65,60.41298103359849,43.90779139590669,NaN,NaN,190.0343024832666,95.44063009494712,1.651673897519602,-0.19853166420497814,-1.85020556172458,345961123,338620940,35.29230775897,22.80311089463973,NaN,NaN,-1.7914394786229568,-12.603756804656857
2018-11-09T09:30:00-05:00,261.16,261.45,259.04,260.09,4386536,5606414.35,56.78718952192603,45.209088156829885,NaN,NaN,131.03597930022735,122.85561268671113,1.6398310180071358,0.19958321078433983,-1.440247807222796,341574587,340446182.4,39.44642667045803,23.656861469443918,NaN,NaN,0.621386730377199,-10.714450585366277
2018-11-12T09:30:00-05:00,259.7,259.92,253.68,254.22,10153025,5839020.7,47.77029110982964,46.00665919196429,NaN,NaN,46.61751849071831,126.84775217152995,1.184966256636886,0.04096001357331147,-1.1440062430635745,331421562,339674083.8,38.32557387601347,24.673890262248126,NaN,NaN,-0.18296917202383559,-9.209953240603072
2018-11-13T09:30:00-05:00,253.83,255.37,252.23,253.06,3937868,5680921.9,46.208812008506285,47.201227946495614,NaN,NaN,6.084992563614186,112.0250786213335,0.7741491436859539,-0.17631981345613212,-0.950468957142086,327483694,337675742,35.51296384483517,25.699394204791307,NaN,NaN,-1.32346547067964,-8.083312130614011
2018-11-14T09:30:00-05:00,255.02,255.2901,249.67,250.91,5610292,5620318.8,43.37859997300241,47.56171454834369,NaN,NaN,-20.487491042426356,70.65706035908002,0.34753202565128205,-0.5160539250779834,-0.8635859507292655,321873402,333662873.6,30.648839024637567,26.439602421242423,NaN,NaN,-3.1625585432286147,-7.380347332416098
2018-11-15T09:30:00-05:00,250.2,254,248.3507,253.22,5667040,5468939.5,47.125713840523254,48.45225442111786,NaN,NaN,-20.175471663387142,28.615105529749258,0.21721042964764403,-0.5920729136697105,-0.8092833433173545,327540442,329978737.4,26.99339050075801,27.076455051008388,NaN,NaN,-3.543627698008442,-6.832244527500718
2018-11-16T09:30:00-05:00,251.79,254.96,251.34,254.05,4529479,5364496.35,48.44588552761222,49.58953898464622,NaN,NaN,12.466162620187006,4.901142193741182,0.1844875911071716,-0.57867385443339,-0.7631614455405616,332069921,328077804.2,25.315625362067323,27.742239274962714,NaN,NaN,-3.4607860162871873,-6.350607597327357
2018-11-19T09:30:00-05:00,253.61,253.78,248.841,249.86,4249638,5343846.85,42.655804415543535,49.73558266291034,NaN,NaN,-36.59339529945225,-11.741040564292929,-0.10613200869208828,-0.8958264564056719,-0.7896944477135837,327820283,327357548.4,24.689458773846894,28.414695898017296,NaN,NaN,-5.198816007460283,-6.1860659416320605
2018-11-20T09:30:00-05:00,246.36,246.9312,243.53,244.5,7341082,5342877.7,36.62541028262652,49.151333898918544,NaN,NaN,-134.34703857996845,-39.82744679300946,-0.6175863128608304,-1.5616773387896217,-0.9440910259287912,320479201,325956649.8,23.473327361926422,28.83705831045636,NaN,NaN,-8.776483616185653,-6.556125609425431
2018-11-21T09:30:00-05:00,245.84,246.6255,244.58,244.65,4257615,5174545.4,36.894283421037365,48.30247390406256,NaN,NaN,-122.22929133261614,-60.175806851047426,-0.8876013199192645,-2.053592675827872,-1.1659913559086075,324736816,326529332.6,25.09759217828754,29.301230842905685,NaN,NaN,-11.484697925119486,-7.2602073688102955
2018-11-23T09:30:00-05:00,243.25,244.03,242.71,242.81,1928034,4974936.1,34.93625132608925,47.44377202694659,NaN,NaN,-143.03651646014208,-84.74801581039841,-1.1171063482025332,-2.562374291161774,-1.4452679429592408,322808782,325583000.6,24.184134105347823,29.641959103768336,NaN,NaN,-14.339235302759803,-8.271497073660225
2018-11-26T09:30:00-05:00,244.87,246.73,244.68,246.39,3435474,4852548.6,41.44738901744489,46.82252753889859,NaN,NaN,-96.93676700764689,-106.62860173596519,-0.9607516245499084,-2.6462074736466263,-1.685455849096718,326244256,324417867.6,23.070774659523636,29.486360840659337,NaN,NaN,-14.804297759802385,-9.204754314537675
2018-11-27T09:30:00-05:00,245.18,247.53,244.14,247.5,2935722,4657669.35,43.34066491837303,46.14750276583951,NaN,NaN,-91.7718868545082,-117.66430004697638,-0.7261837390444907,-2.5931855229023313,-1.8670017838578405,329179978,324689806.6,23.9507699616357,29.137125595448246,NaN,NaN,-14.613741668112997,-9.977466793619865
2018-11-28T09:30:00-05:00,249.12,253.84,248.586,253.84,5132498,4606739.55,52.74027419152389,45.62639647054549,NaN,NaN,-2.7669249483236866,-91.34827732064743,-0.11946829369416356,-2.016337150975545,-1.8968688572813814,334312476,327456461.6,32.42054495793232,29.172980645445744,NaN,NaN,-11.325826349880488,-10.170089587371383
2018-11-29T09:30:00-05:00,253.6,254.9732,252.22,253.59,3471063,4511470.35,52.371324358599885,45.051992422331296,NaN,NaN,21.52139467054246,-62.598140120015685,0.2684108941244787,-1.561355239625783,-1.8297661337502618,330841413,328677381,35.81765268991863,29.21050528337065,NaN,NaN,-8.859766276136014,-9.982900542909187
2018-11-30T09:30:00-05:00,253.1,255.84,252.83,255.51,2991751,4497663.45,54.97634736536853,44.922646554005766,NaN,NaN,38.56839842705518,-26.277157142576232,0.6366670550823472,-1.0339323148973278,-1.670599369979675,333833164,330882257.4,41.53353656445418,29.35958456151323,NaN,NaN,-6.004282142786806,-9.414526485748846
2018-12-03T09:30:00-05:00,260.17,260.3,257.02,258.73,9568519,4655419.2,59.02407388250398,45.72648818062536,NaN,NaN,94.25116825866893,11.960429910686937,1.0548311564531379,-0.3520604244132528,-1.4068915808663907,343401683,334313742.8,49.1269670367901,30.131112644425848,NaN,NaN,-2.2716662748784624,-8.394117884195934
2018-12-04T09:30:00-05:00,257.64,258.04,250.38,250.73,5376856,4782578,47.57929857398376,45.82438007815947,NaN,NaN,5.807235626344396,31.476254406857457,0.7639173732098734,-0.4519948643540488,-1.2159122375639222,338024827,336082712.6,52.54837772207902,31.347927921371838,NaN,NaN,-2.686350207638777,-7.578722501830626
2018-12-06T09:30:00-05:00,246.36,249.87,242.82,249.72,8232779,5084549.55,46.35718596645274,46.03713622054878,NaN,NaN,-74.88747942622898,17.052143511276395,0.4881618381090749,-0.6057099399275785,-1.0938717780366534,329792048,335178627,50.672669934285004,32.778201557775226,NaN,NaN,-3.4114242829097092,-6.983394184841924
2018-12-07T09:30:00-05:00,249.66,251.4081,243.29,244.31,5963661,5159615.55,40.37492334555435,45.55493689947957,NaN,NaN,-82.78759501113443,-3.8096544250589828,-0.04554758027743766,-1.1508062533834504,-1.1052586731060128,323828387,333776021.8,47.82077789399508,34.265872085863585,NaN,NaN,-6.0947097570741215,-6.856439266589381
2018-12-10T09:30:00-05:00,243.94,245.49,239.25,244.71,6020995,5259496.35,40.981359410657404,45.02175646255422,NaN,NaN,-117.85594208249277,-35.094522526968575,-0.34207512675603335,-1.5328525815510545,-1.1907774547950212,329849382,332979265.4,46.22912002986946,35.75969313356374,NaN,NaN,-7.987495363922953,-7.018018709065605
2018-12-11T09:30:00-05:00,248.4441,248.5,242.66,244.23,5646473,5322493.2,40.44969540887526,44.864177247792206,NaN,NaN,-77.13244736082422,-69.3712456508672,-0.5297770926752183,-1.8529988206390442,-1.3232217279638259,324202909,329139510.6,39.41971485999427,36.81185428257426,NaN,NaN,-9.659082364245396,-7.395313516948432
2018-12-12T09:30:00-05:00,247.39,248.76,245.65,245.88,3734799,5001581.9,43.17861117292152,45.33226302567042,NaN,NaN,-44.76120133301974,-79.48493304274002,-0.5022905526966386,-1.9510849188346242,-1.4487943661379856,327937708,327122086.8,36.38708668075777,37.734265662490785,NaN,NaN,-10.25614638935358,-7.804003927292025
2018-12-13T09:30:00-05:00,246.42,247.86,245.17,246.27,4455325,5027454.75,43.8337702482025,45.82794065618221,NaN,NaN,-45.38811144815775,-73.58505944712577,-0.4206343505981889,-1.9745873043857216,-1.5539529537875327,332393033,327642283.8,37.717621558475194,38.635696332504196,NaN,NaN,-10.56072233459086,-8.19782084262043
2018-12-14T09:30:00-05:00,244.06,244.83,240.82,241.42,6591173,5076498.8,37.9704633289026,46.044670084954596,NaN,NaN,-104.85306736841655,-77.99815391858222,-0.6427520544022376,-2.3573930217903296,-1.714640967388092,325801860,328036978.4,38.76418249992671,39.6771283606884,NaN,NaN,-12.611631331575252,-8.828365198185406
2018-12-17T09:30:00-05:00,240.04,241.4,235.05,236.43,7036736,5144983.6,33.069269351466474,45.446232965956135,NaN,NaN,-165.37156384858892,-87.50127827180145,-1.0510950912690422,-3.028509831474395,-1.9774147402053526,318765124,325820126.8,35.187743132089665,40.542626108728825,NaN,NaN,-16.028695695299355,-9.856983840630255
2018-12-18T09:30:00-05:00,238.44,239.81,235.67,237.36,5349647,5185992,34.75947871526918,44.833291094305864,NaN,NaN,-154.44170269880516,-102.96312933939764,-1.174558314239671,-3.4456126330049415,-2.2710543187652705,324114771,325802499.2,35.159964560200535,41.343282865769176,NaN,NaN,-18.26939463204277,-11.058756810832042
2018-12-19T09:30:00-05:00,237.55,241.2,232.07,233.42,9545684,5450794.3,31.168381627156577,43.292441625422484,NaN,NaN,-169.28812540187906,-127.86851415316951,-1.421107209543012,-4.047438330694035,-2.6263311211510234,314569087,323128775,31.14390888394317,41.25209457476995,NaN,NaN,-21.36345103302101,-12.530855985430467
2018-12-20T09:30:00-05:00,232.59,233.37,226.95,228.89,11912832,5679381.8,27.63348862954929,41.52545335906173,NaN,NaN,-209.4284306916517,-160.6765780018683,-1.7662927500656922,-4.834197058733139,-3.0679043086674467,302656255,317181419.4,24.453117199570087,40.440342039745055,NaN,NaN,-25.22575549333298,-14.344413057987968
2018-12-21T09:30:00-05:00,229.01,232.47,223.85,224.09,10244882,5978745.15,24.467048241458897,39.346217707353894,NaN,NaN,-194.78196783127066,-178.6623580944391,-2.168411663245312,-5.7784188877240865,-3.6100072244787746,292411373,310503322,19.410512569573342,38.8601260401107,NaN,NaN,-29.634678259506792,-16.52873665820494
2018-12-24T09:30:00-05:00,222.5,223.31,217.88,218.1,7023992,6233543.05,21.202044977966423,36.64464421417265,NaN,NaN,-210.4415491951736,-187.67635516375603,-2.656136344662608,-6.930177655307034,-4.274041310644426,285387381,303827773.4,15.884305468576642,36.48565021380974,NaN,NaN,-34.62063246958831,-19.11329320268828
2018-12-26T09:30:00-05:00,219.19,228.74,216.97,228.71,9761070,6549822.85,37.19032753988093,35.90257485459387,NaN,NaN,-138.0785442504001,-184.40372347407504,-2.1065226380413904,-6.907194608196164,-4.800671970154774,295148451,298034509.4,13.578858595576406,33.702113133345264,NaN,NaN,-32.97395334332347,-21.093387508493308
2018-12-27T09:30:00-05:00,225.54,231.37,222.5304,231.26,7952030,6800638.25,40.324291048325726,35.47165378901337,NaN,NaN,-95.3298782780029,-169.6120740492998,-1.4451061642490064,-6.607054675466031,-5.161948511217025,303100481,295740788.2,12.787497935047725,30.99602941911403,NaN,NaN,-30.563211012794785,-22.446219437679233
2018-12-28T09:30:00-05:00,232.71,233.81,229.67,230.48,7267146,6907370.65,39.67222280993239,35.4214608936118,NaN,NaN,-65.86427700373837,-140.89924331171713,-0.9575055577179414,-6.3588304583644515,-5.40132490064651,295833335,294376204.2,12.32721947725301,28.460775246489597,NaN,NaN,-28.94933731831925,-23.375236277770664
2018-12-31T09:30:00-05:00,232.33,233.26,231.05,233.2,5079611,6987798.05,43.126035592952434,35.57465204949001,NaN,NaN,-51.17580248861813,-112.1780102431866,-0.378866026718212,-5.874907434044275,-5.496041407326063,300912946,296076518.8,16.366722007149406,26.327746816295306,NaN,NaN,-26.49932986784155,-23.821535362066506
2019-01-02T09:30:00-05:00,229.27,234,229.14,233.36,5325669,7104493.95,43.33155768205645,35.780499354717236,NaN,NaN,-48.071649174163134,-79.7040302389845,0.06399199098834885,-5.4160514185906266,-5.480043409578975,306238615,300246765.6,25.440408713593698,25.329224948695266,NaN,NaN,-24.518268630980202,-23.921068686197035
2019-01-03T09:30:00-05:00,231.25,231.42,226.3604,226.72,7350173,6993576.65,37.30648708187935,35.3610619196428,NaN,NaN,-73.08941451784534,-66.70620429247359,-0.03557652704038805,-5.52451406837946,-5.488937541339072,298888442,300994763.8,26.9708766189775,24.656638515710963,NaN,NaN,-24.685066521868116,-24.03021123415005
2019-01-04T09:30:00-05:00,230,235.18,229.73,234.28,7343729,7091920.3,46.43818476986611,35.547091528333056,NaN,NaN,-25.281376654757125,-52.69650396782443,0.4363839694368288,-4.943457579543036,-5.379841548979865,306232171,301621101.8,28.29810072006481,23.983815598681648,NaN,NaN,-21.665141456848925,-23.69234412310703
2019-01-07T09:30:00-05:00,234.84,236.88,232.951,235.36,5101599,6935361.3,47.6121259519657,36.235781715694706,NaN,NaN,-0.7620792692387407,-39.6760644209245,0.827293761870143,-4.345724346642186,-5.173018108512329,311333770,304721188.8,34.63056444968322,23.6885571665214,NaN,NaN,-18.925905671544783,-23.011424344312424
2019-01-08T09:30:00-05:00,237.94,238.66,235.79,237.92,4845828,6879469.65,50.38787242118051,37.472824792102855,NaN,NaN,30.58749552335934,-23.323404818529003,1.2394749785771335,-3.6236743852909115,-4.863149363868045,316179598,307774519.2,40.229595187441696,24.0486894561894,NaN,NaN,-15.798822572082122,-21.981052662565236
2019-01-09T09:30:00-05:00,238.9319,239.8762,237.78,238.92,4872006,6822020.2,51.46957492435112,38.666403092751565,NaN,NaN,50.275738248405304,-3.65392733401532,1.5410009216942155,-2.9368982117502753,-4.477899133444491,321051604,310737117,45.13958699172046,24.76151962986939,NaN,NaN,-12.953494381978542,-20.69140147962428
2019-01-10T09:30:00-05:00,237.64,240.16,237.04,240,3052249,6692309,52.66981095735041,40.202219473479694,NaN,NaN,59.235188175003884,22.810993204554524,1.7589569551802775,-2.279202939469144,-4.0381598946494215,324103853,315780199.2,52.31984805909777,26.274086713809005,NaN,NaN,-10.269801737127885,-19.202601516410507
2019-01-11T09:30:00-05:00,238.87,239.94,237.96,239.88,2047229,6607930.5,52.514403028570094,41.97942764483832,NaN,NaN,70.95712573729254,42.05869368296446,1.8325171576147312,-1.7475134476310075,-3.5800306052457387,322056624,318945089.8,56.1947003881519,28.541342655850567,NaN,NaN,-8.122784754864343,-17.61977055047534
2019-01-14T09:30:00-05:00,237.93,239.65,237.64,238.94,2330665,6501697.5,51.23901173356374,43.891710751417236,NaN,NaN,74.8503681138747,57.18118315958715,1.7552095415812685,-1.3860186782691528,-3.1412282198504213,319725959,320623527.6,58.137696279915694,31.307570063732165,NaN,NaN,-6.651529394527972,-16.052878956768573
2019-01-15T09:30:00-05:00,238.94,241.03,238.89,240.64,3940345,6369156.1,53.441287640238414,46.194513798722376,NaN,NaN,98.91729075354107,70.8471422056235,1.7518716475956944,-0.9513886603558035,-2.703260307951498,323666304,322120868.8,59.84867767147756,34.44788236393937,NaN,NaN,-4.790312727254781,-14.44394092398089
2019-01-16T09:30:00-05:00,241.355,242.9,241.14,241.86,3718529,6203245.75,55.011632562725794,47.46746415749701,NaN,NaN,115.96512291324692,83.98501913859181,1.7604461717918656,-0.5027025932116658,-2.2631487650035313,327384833,323387514.6,61.29001060636828,37.855821793281656,NaN,NaN,-2.7785241753105403,-12.777452817027983
2019-01-17T09:30:00-05:00,241.23,244.81,241.04,243.8,4108399,6141183.35,57.46823074129974,48.69203127842373,NaN,NaN,122.23129880738635,96.5842412650683,1.8179739832169357,0.009318714017638285,-1.8086552691992974,331493232,324865390.4,62.96069612159331,41.439621663749186,NaN,NaN,-0.3608831932252933,-11.003657156484742
2019-01-18T09:30:00-05:00,245.65,247.4,244.51,247.05,5393351,5933566.7,61.28246934474169,50.235620316624384,NaN,NaN,140.79791598582526,110.55239931477486,1.9826266729142774,0.6696280719435492,-1.3129986009707282,336886583,327831382.2,66.12093400931268,45.2820298446106,NaN,NaN,2.8767574118087524,-9.020740789585671
2019-01-22T09:30:00-05:00,245.35,245.7389,242.35,244,5218505,5598850.35,56.18971853440039,51.16874052672781,NaN,NaN,102.18289866303456,116.01890542460683,1.7992217056062816,0.9360285310371239,-0.8631931745691577,331668078,330219806,68.4550024430953,49.00262130432102,NaN,NaN,4.317302999668557,-7.115305962549353
2019-01-23T09:30:00-05:00,246.15,246.92,242.98,245.72,4330334,5303122.95,58.2945728145262,52.23752732190423,NaN,NaN,105.07032242702908,117.24951175930441,1.7075847995313862,1.271287824845075,-0.4362969746863111,335998412,332686227.6,70.69987762659345,52.23544051239243,NaN,NaN,6.137607111037903,-5.222032666322603
2019-01-24T09:30:00-05:00,245.47,246.2,244.13,245.47,2840417,5093944.2,57.85944534343177,53.70559576915797,NaN,NaN,101.67649358999864,114.39178589465477,1.5486573655460207,1.4995247322462149,-0.04913263329980588,333157995,333840860,71.7146854842739,55.4314268599136,NaN,NaN,7.52948431837239,-3.400387382794747
2019-01-25T09:30:00-05:00,247.39,248.55,246.68,247.39,4110560,4811418.7,60.30973953695476,54.69642110966431,NaN,NaN,124.52698475427754,114.850923084033,1.4908393980922598,1.814416614315519,0.3235772162232591,337268555,334995924.6,72.73213470684061,58.60528643039759,NaN,NaN,9.409601997980078,-1.5703888998269149
2019-01-28T09:30:00-05:00,244.73,245.23,243.14,245.1,3559369,4591785.65,56.11849557923666,55.30401894018366,NaN,NaN,77.52531250918524,102.196402388705,1.227355509611798,1.8577716032380067,0.6304160936262087,333709186,334360445.2,71.21438777586609,61.218416667982076,NaN,NaN,9.913232425783955,0.0701284324032092
2019-01-29T09:30:00-05:00,245.35,246.65,244.95,245.71,2432929,4350074.8,56.97621092299428,55.77461454745607,NaN,NaN,87.05407911487293,99.17063847907266,1.0310503006597747,1.919228969450927,0.8881786687911524,336142115,335255252.6,72.09732857941447,63.49468333883728,NaN,NaN,10.564891812891887,1.5693803439015916
2019-01-30T09:30:00-05:00,248.41,251,247.78,250.18,5686150,4380401.75,62.72574915227397,56.578626992307704,NaN,NaN,129.48349012491582,104.05327201865002,1.1311282401420752,2.3020889689687465,1.1709607288266712,341828265,336421223.2,73.24877188119069,65.50248225951371,NaN,NaN,12.830853883460467,3.178162278124288
2019-01-31T09:30:00-05:00,248.95,250.43,248.34,250.12,5649631,4396599.85,62.6048118058458,57.28826991005737,NaN,NaN,118.34957993347301,107.38788928734489,1.1200550570516155,2.5710295501411906,1.4509744930895752,336178634,337025351,73.85088714494347,67.0404136227884,NaN,NaN,14.6509245478893,4.817128316662147
2019-02-01T09:30:00-05:00,250.67,251.85,249.75,250.48,3971387,4227660.55,63.06495096231311,58.041880476753306,NaN,NaN,127.82897642947141,108.04828762238367,1.0641455650073566,2.781156449348771,1.7170108843414142,340150021,337601644.2,74.4418559849901,68.34378187970542,NaN,NaN,16.297605672683257,6.457196510379449
2019-02-04T09:30:00-05:00,250.43,252.35,249.68,252.32,2576093,3989278.75,65.4078371460196,59.05393943478587,NaN,NaN,131.17201632985817,118.77762838651824,1.0750891505464824,3.060872322524517,1.9857831719780348,342726114,339405029.8,76.25065009421171,69.63756429501228,NaN,NaN,18.381105049982484,8.160612016037025
2019-02-05T09:30:00-05:00,253.3599,254.2,252.81,253.96,3090516,3888724.6,67.39316340489847,60.05050198940444,NaN,NaN,154.59534141741625,132.28588084702693,1.1121473907123516,3.3759674103684745,2.263820019656123,345816630,341339932.8,78.04592228281173,70.93736748153616,NaN,NaN,20.742586591237462,9.958036955351373
2019-02-06T09:30:00-05:00,253.63,254.35,253.05,253.87,1913464,3742106.4,67.1653481588134,60.918624531982125,NaN,NaN,140.30126597802564,134.44943601764888,1.0506917690157254,3.5771847309257794,2.526492961910054,343903166,341754913,78.42265167976623,72.16112755820744,NaN,NaN,22.656452437645008,11.772096309964748
2019-02-07T09:30:00-05:00,252.4,253.34,250.17,251.9,3884789,3692745.55,62.20829431476394,61.257200501515285,NaN,NaN,95.93467760851479,129.96645555265724,0.8083392254224102,3.5369169936880667,2.7285777682656565,340018377,342522861.6,79.136158372651,73.31651771899728,NaN,NaN,23.04393448717881,13.382358906709614
2019-02-08T09:30:00-05:00,250.51,251.37,249.1299,251.32,2942716,3687268.9,60.78587548472283,61.221729511513935,NaN,NaN,67.72094914266688,117.9448500952963,0.5521727006453223,3.4187936440723092,2.866620943426987,337075661,341907989.6,76.94233043882141,74.08947460681932,NaN,NaN,22.999463143363876,14.756230940517366
2019-02-11T09:30:00-05:00,252.12,252.32,250.35,250.94,2677587,3718786.8,59.82077721512239,61.48109084585122,NaN,NaN,70.30323557242575,105.77109394380982,0.3122815320931811,3.256972858543463,2.944691326450282,334398074,340242381.6,71.18539618711046,74.28450273139184,NaN,NaN,22.713228292021974,15.892944847875167
2019-02-12T09:30:00-05:00,252.72,254.88,252.67,254.53,3080642,3756285.65,65.4084882475148,61.989227662493256,NaN,NaN,110.42016729436081,96.93605911919875,0.3478113055500902,3.379455458387895,3.0316441528378046,337478716,338574798.8,65.87139002428988,73.93961075979873,NaN,NaN,23.979169822835082,17.04811984429801
2019-02-13T09:30:00-05:00,255.53,256.556,255.1177,255.8,2918218,3705179.3,67.14899237569068,62.65276673622604,NaN,NaN,132.022517480245,95.28030941964262,0.4052573478558501,3.538215837657617,3.132958489801767,340396934,337873552.4,63.71733558347774,73.36837148117044,NaN,NaN,25.551579953037862,18.262899859832274
2019-02-14T09:30:00-05:00,254.54,256.17,253.62,255.16,3810979,3709801.8,65.36412519167638,63.01379428299187,NaN,NaN,108.9763370174954,97.88864130143875,0.35061326506198487,3.5712250711292484,3.2206118060672635,336585955,337187068,61.59388501102199,72.57278221718339,NaN,NaN,26.394218390175094,19.42451679273839
2019-02-15T09:30:00-05:00,256.17,258.68,256.15,258.65,4751072,3741935.45,70.04070295271049,64.00823766681143,NaN,NaN,150.7951957722202,114.50349062734941,0.49134562953145533,3.8347938429815827,3.3434482134501273,341337027,338039341.2,63.23215533555912,72.00262275716146,NaN,NaN,28.547803203581708,20.727843422858864
2019-02-19T09:30:00-05:00,257.96,259.48,257.96,258.81,2744450,3609490.4,70.23909641236911,64.9555866303382,NaN,NaN,150.42031887696092,130.52690728825647,0.53352604638865,4.01035577143594,3.4768297250472897,344081477,339976021.8,66.70748236843889,71.61763374209178,NaN,NaN,30.36504646141795,22.10458671408159
2019-02-20T09:30:00-05:00,258.82,259.76,258.32,259.5,2453981,3471264.2,71.12707066086244,65.55568102380882,NaN,NaN,142.3349207063061,136.9098579706455,0.5443321926418481,4.1572449658496,3.6129127732077517,346535458,341787370.2,69.60154356925985,71.35711743409672,NaN,NaN,32.14517366980537,23.538956279184987
2019-02-21T09:30:00-05:00,258.94,259.2414,257.5,258.53,3197179,3414606.45,68.05303376462996,65.94483973515055,NaN,NaN,113.50262116645179,133.20587870788685,0.4277291127467735,4.1475741641412185,3.719845051394445,343338279,342375639.2,70.49848492187485,71.11766013244895,NaN,NaN,32.83930510089724,24.867577539429593
2019-02-22T09:30:00-05:00,259.26,260.41,259.01,260.17,3938538,3469512.5,70.38360879046667,66.46760100859008,NaN,NaN,125.33999530539852,136.4786103654675,0.4029701457498378,4.2235577335817425,3.8205875878319047,347276817,344513811.6,73.5529880026175,71.05416956227948,NaN,NaN,34.093178977124666,26.18552060195746
2019-02-25T09:30:00-05:00,261.8549,262.36,260.75,260.89,3585015,3443235.25,71.37105213060643,66.89354493606056,NaN,NaN,136.56625670286394,133.63282255159623,0.3774444941766921,4.29239320555277,3.914948711376078,350861832,346418772.6,75.94282824100937,71.03218228705074,NaN,NaN,35.42733610810321,27.50577995997828
2019-02-26T09:30:00-05:00,259.96,261.5,259.6,260.54,3080247,3419279.15,70.146696725891,67.09022588756004,NaN,NaN,110.76054524774196,125.70086782575245,0.2836312237626024,4.269487741079331,3.9858565173167286,347781585,347158794.2,76.81915196203082,70.94455583556639,NaN,NaN,36.22814347624129,28.751831890872996
2019-02-27T09:30:00-05:00,259.82,260.42,258.77,259.87,2777218,3436493.6,67.75067649133312,67.13203505416858,NaN,NaN,86.15683411856203,114.46525050820362,0.13086633811088078,4.14943943995533,4.018573101844449,345004367,346852576,75.59208681730858,70.74237263110514,NaN,NaN,36.28782191945892,29.8284018949567
2019-02-28T09:30:00-05:00,259.86,260.37,259.06,259.28,2772931,3290832.65,65.62491799812051,67.37607960297977,NaN,NaN,75.68605994519001,106.90193826395125,-0.04603294790196877,3.961031916966988,4.007064864868957,342231436,346631207.4,74.66359789221252,70.42290402535953,NaN,NaN,35.78381463939703,30.67917514416246
2019-03-01T09:30:00-05:00,261.15,261.54,259.2349,260.42,3676922,3192197.2,67.73167402740447,67.87220807031417,NaN,NaN,83.21980982366112,98.47790116760379,-0.11827637881084874,3.8592193913553956,3.9774957701662443,345908358,346357515.6,73.46217847470578,70.17432174220842,NaN,NaN,35.87981528917236,31.422123736306734
2019-03-04T09:30:00-05:00,261.5,261.68,256.201,258.28,4823948,3234825.25,60.26496822462929,67.90393599956467,NaN,NaN,44.67814393052108,80.10027861313523,-0.33018878876629376,3.564759784208377,3.8949485729746707,341084410,344402031.2,65.36873949556235,69.75884626424069,NaN,NaN,33.86034135008714,31.770440538275363
2019-03-05T09:30:00-05:00,258.22,258.86,257.39,258.19,2107218,3211381.5,59.965567670942114,67.5151559583809,NaN,NaN,27.842558517966886,63.51668126718022,-0.48695543238570815,3.2862542824925356,3.7732097148782437,338977192,342641152.6,59.058951475017615,69.27224351072124,NaN,NaN,32.101681268832735,31.817760642640703
2019-03-06T09:30:00-05:00,258.24,258.4526,256.45,256.87,3221994,3217955.4,55.60244278248649,66.69040241600918,NaN,NaN,3.9191237035923234,47.069139184186284,-0.6783256680779877,2.9253026297807594,3.603628297858747,335755198,340791318.8,53.24451641817381,68.52418499891381,NaN,NaN,29.32338345940739,31.461421045035944
2019-03-07T09:30:00-05:00,256.4,256.49,253.61,254.81,4104555,3327509.95,49.543953712786994,65.56039016751707,NaN,NaN,-54.64242598404074,21.003441998340133,-0.9270318507355904,2.444838484439259,3.3718703351748496,331650643,338675160.2,47.48508988578946,67.51641391854007,NaN,NaN,25.005238288060312,30.539109222610854
2019-03-08T09:30:00-05:00,252.88,254.895,252.74,254.71,5528421,3409691.55,49.26333814767254,64.07629268144294,NaN,NaN,-83.55519035156856,-12.351558036705802,-1.0714419909170507,2.0325678465285364,3.104009837445587,326122222,334717933,38.99133191581873,65.78492653141575,NaN,NaN,21.37391922839503,29.22979636629431
2019-03-11T09:30:00-04:00,252.85,256.83,252.46,256.76,5469428,3536027.15,54.902471693975016,62.98081948727192,NaN,NaN,-64.42723780537331,-34.17263438388468,-1.0032611638141469,1.8499333826779036,2.8531945464920505,331591650,332819381,35.692669708497206,63.56958276999135,NaN,NaN,19.682636226642007,27.86591634634398
2019-03-12T09:30:00-04:00,256.24,256.97,255.43,255.86,6570541,3730674.85,52.16144397867458,61.626131867115646,NaN,NaN,-57.2390433655212,-51.1889547605823,-0.9913820617399454,1.6139669693171186,2.605349031057064,325021109,330028164.4,31.476552635800687,60.846369131887116,NaN,NaN,17.446796204614994,26.37747061181127
2019-03-13T09:30:00-04:00,256.84,258.07,256.01,257.35,5272815,3840283.5,56.071610507991544,60.77031592021291,NaN,NaN,-28.974172743911726,-57.76761405008311,-0.8606307355491856,1.5295606116205818,2.3901913471697673,330293924,328935909.6,29.983971687729877,57.95247532944819,NaN,NaN,16.633402826412098,24.985460928182817
2019-03-14T09:30:00-04:00,257.33,257.94,256.62,257.54,3409957,3864870.45,56.55921408320551,59.78285915540854,NaN,NaN,-24.629070598895286,-51.76494297305402,-0.7432282142240121,1.4611560793897524,2.2043842936137645,333703881,329346557.2,31.302893908272196,54.93461146556638,NaN,NaN,16.10290033155278,23.71652370009281
2019-03-15T09:30:00-04:00,257.58,259.15,256.33,258.34,4225190,3885581,58.64089335949502,58.87356210032916,NaN,NaN,-8.552931644201163,-36.76449123158054,-0.5997241569770217,1.4547290973924873,2.054453254369509,337929071,331707927,38.4795275198324,52.25866141405374,NaN,NaN,16.231274090533837,22.64720232729867
2019-03-18T09:30:00-04:00,257.94,259.1167,257.7102,258.99,2786156,3787335.2,60.3052900032335,58.1706044772822,NaN,NaN,18.978684487863095,-20.083306772933263,-0.45558863940224503,1.4849674551167027,1.9405560945189477,340715227,333532642.4,43.40008101671662,49.87158491795987,NaN,NaN,16.803201976912316,21.812345134386334
2019-03-19T09:30:00-04:00,260.11,260.96,258,258.88,4761360,3888180.7,59.86622224456081,57.60742917394132,NaN,NaN,46.689724726122,0.7024468453953758,-0.3660762025675761,1.4829608413094775,1.8490370438770536,335953867,335719194,48.69548567355834,47.95039912197772,NaN,NaN,17.16447756232748,21.14836405266364
2019-03-20T09:30:00-04:00,258.46,259.17,256.55,257.29,4382622,3984612.75,53.77196015108109,56.76078932772422,NaN,NaN,-19.8805739979284,2.521166594592046,-0.4091086251018221,1.3376512624997758,1.746759887601598,331571245,335974658.2,49.29239918160583,46.13817064264867,NaN,NaN,15.794175483334028,20.38347997133084
2019-03-21T09:30:00-04:00,256.38,259.97,256.35,259.58,3800010,4014754.3,60.07571684924704,56.21393524357011,NaN,NaN,21.738013303392638,11.79458337504963,-0.2844167900476573,1.3912389000420262,1.6756556900896835,335371255,336308133,50.10841907834627,44.470044971480135,NaN,NaN,16.42096114564758,19.817405853376087
2019-03-22T09:30:00-04:00,257.92,258.64,254.865,254.96,6226489,4129151.85,46.34512645231236,55.21966083126176,NaN,NaN,-77.48392192098825,-1.991614680307785,-0.5014670053168626,1.0488219334436053,1.550288938760468,329144766,334551272,45.91612287717914,43.08057235588133,NaN,NaN,12.185996620642339,18.727204534414124
2019-03-25T09:30:00-04:00,254.69,255.89,253.57,255.07,4982454,4199023.8,46.65773231416367,54.26910116292044,NaN,NaN,-120.92987388696004,-29.973326355272413,-0.6183358915431834,0.7773690743314887,1.395704965874672,334127220,333233670.6,43.00982413361667,41.93420611720983,NaN,NaN,9.038873276861219,17.343157211906565
2019-03-26T09:30:00-04:00,257.05,257.83,255.3,256.46,3278718,4208947.35,50.57632208962162,53.91009254200152,NaN,NaN,-41.3142782714199,-47.574126954780795,-0.5831906791676609,0.666716616915096,1.2499072960827569,337405938,333524084.8,43.853386305736244,41.26341110917857,NaN,NaN,7.685110147904502,15.963436202763413
2019-03-27T09:30:00-04:00,256.63,257.43,254.1,256.11,3166154,4228394.15,49.58850336323271,53.9132746598905,NaN,NaN,-64.320403637168,-56.46209288262871,-0.5643218704159978,0.5445049580627597,1.1088268284787575,334239784,334057792.6,45.45136638623099,41.118145144924405,NaN,NaN,6.29826028014093,14.582696785245915
2019-03-28T09:30:00-04:00,256.92,257.28,255.59,257.08,2434379,4211466.55,52.36528636858219,54.134842389955466,NaN,NaN,-22.068882643217513,-65.22347207195074,-0.47111841033083923,0.5199288155652084,0.9910472258960477,336674163,334318374.2,46.25564318871752,41.63702452156003,NaN,NaN,5.982064589948869,13.354035043060623
2019-03-29T09:30:00-04:00,258.5821,259.34,257.57,259.13,4255859,4240413.4,57.671796504658175,54.33265130500427,NaN,NaN,90.03740105881205,-31.719207475990686,-0.26621245920276304,0.6582816518925938,0.9244941110953568,340930022,336675425.4,53.00528382304252,42.87363981545614,NaN,NaN,7.390932150092781,12.502163201208074
2019-04-01T09:30:00-04:00,261.23,262.66,260.58,262.39,6051711,4301801.55,64.45339390235088,55.210647728124,NaN,NaN,226.8126611337771,37.829299528156746,0.07579106598811847,1.019232943580505,0.9434418775923865,346981733,339246328,59.046690543633716,44.84293538030135,NaN,NaN,11.025500841951322,12.291211435599966
2019-04-02T09:30:00-04:00,262,262.07,261.08,261.69,2320048,4312443.05,62.15081705852648,55.64487676744792,NaN,NaN,182.07710758395896,82.50757669923253,0.23290561276738075,1.2345738935516124,1.0016682807842316,344661685,340697477.4,62.015020190488855,47.1308674162127,NaN,NaN,13.16544602873437,12.416102091762024
2019-04-03T09:30:00-04:00,262.58,262.72,261.22,262,3265528,4314619.75,62.78488535713415,56.08956757272854,NaN,NaN,161.92509548675548,127.75667652401721,0.3298241270636697,1.4139484396138187,1.084124312550149,347927213,343434963.2,66.8903318771392,49.67282727113174,NaN,NaN,15.065409536917121,12.794574583927037
2019-04-04T09:30:00-04:00,262.22,263.94,262.11,263.78,4397042,4329244.1,66.27816769348921,56.63508716801385,NaN,NaN,175.76703404866865,167.32385986239447,0.4769925356307876,1.6803649820886335,1.203372446457846,352324255,346564981.6,71.40890193529638,52.024925443664884,NaN,NaN,17.819955700526883,13.51248617201273
2019-04-05T09:30:00-04:00,264.56,264.84,263.61,264.16,3112718,4208458.95,66.99053036016485,57.11260433636608,NaN,NaN,175.13482803215751,184.34334525706353,0.5575099014441796,1.9002598232630703,1.3427499218188907,355436973,349466371.8,74.83699517785756,54.27041931231781,NaN,NaN,20.262411835053758,14.476761266732877
2019-04-08T09:30:00-04:00,262.83,263.4,262.37,263.22,3231685,4096571.8,63.42145958898513,57.36654986096782,NaN,NaN,118.91078575022097,162.7629701803523,0.5065208374628598,1.9759009686474656,1.4693801311846058,352205288,350511082.8,75.95494491538591,56.217523543876915,NaN,NaN,21.26678222765517,15.446764261150348
2019-04-09T09:30:00-04:00,262.12,262.14,260.95,261.51,4161583,3976123.9,57.42749020703983,57.62765915067916,NaN,NaN,67.47851790126104,139.84325224381274,0.3254849573916103,1.8762363279241185,1.5507513705325082,348043705,351187486.8,76.6774331950346,58.17359740197897,NaN,NaN,20.320438718371776,16.14300346932484
2019-04-10T09:30:00-04:00,261.9,262.07,261,261.6,3602862,3892626.25,57.65432955132565,57.454702915113344,NaN,NaN,60.596193367597756,119.57747181998118,0.18655840121673561,1.7839493720534279,1.5973909708366922,351646567,351931357.6,77.47887347810554,60.128629859104635,NaN,NaN,19.622204350606136,16.640032166650737
2019-04-11T09:30:00-04:00,261.92,262.25,260.58,261.4,2731683,3858712.55,56.92840693101815,58.2106515207352,NaN,NaN,50.483070282868944,94.52067906682124,0.06237558626647188,1.6753604536697821,1.6129848674033103,348914884,351249483.4,74.93683794952683,62.20153807855804,NaN,NaN,18.844290981706315,16.95492628308725
2019-04-12T09:30:00-04:00,263.8739,264.3877,263.08,264.07,3395215,3817213.8,63.53014628472863,59.41582394720412,NaN,NaN,103.4397216969353,80.1816577997768,0.13695825962246522,1.7841826919313917,1.6472244323089265,352310099,350624108.6,72.58469256205153,64.3140286805891,NaN,NaN,20.105132870594556,17.404955795588293
2019-04-15T09:30:00-04:00,264.02,264.19,263.15,263.81,2190288,3787420.4,62.52513976344906,60.26931092390608,NaN,NaN,89.79906869456909,74.35931438864642,0.14491563277878572,1.8283689732824087,1.683453340503623,350119811,350207013.2,70.98435663294582,66.25195513253264,NaN,NaN,20.841456103113913,17.895884410949098
2019-04-16T09:30:00-04:00,265.28,265.32,263.93,264.53,2536007,3676152.75,64.21345161445362,61.31395008470758,NaN,NaN,100.20744475463734,80.90509975932167,0.17290743836755018,1.8995876384630606,1.7266802000955104,352655818,351129435.8,72.43196518675391,68.17914076114143,NaN,NaN,21.948184304256813,18.474784395707342
2019-04-17T09:30:00-04:00,265.1,265.19,263.92,264.53,2873566,3600699.95,64.21345161445362,62.16024760226982,NaN,NaN,91.9170522635239,87.1692715385069,0.16564625239390507,1.9337380155878918,1.7680917631939868,352655818,351331286,72.75232083492857,70.07176059301364,NaN,NaN,22.855608004441834,19.10061633981227
2019-04-18T09:30:00-04:00,264.98,265.93,264.36,265.56,3469185,3584158.7,66.70231352826852,62.8052845325277,NaN,NaN,102.00021785279932,97.47270105249298,0.20202447005639756,2.0206223507644836,1.818597880708086,356125003,352773309.8,74.98844161018094,71.64198614923781,NaN,NaN,24.34444264894267,19.849734383973754
2019-04-22T09:30:00-04:00,264.6,265.44,264.44,265.07,1604153,3353041.9,64.40743076884775,62.802001451563186,NaN,NaN,92.86600121133334,95.3579569553726,0.16638471056479354,2.026578768914078,1.8601940583492844,354520850,353215460,75.6483389989107,72.82781818175759,NaN,NaN,24.991898530558025,20.58432926205722
2019-04-23T09:30:00-04:00,265.4501,266.86,265.0632,266.48,3399175,3273877.95,67.83660253618223,63.20812898568146,NaN,NaN,118.30123921869563,101.0583910601979,0.20834811013952081,2.1206291960236854,1.9122810858841646,357920025,354775502.8,77.8671688479997,73.96011451443694,NaN,NaN,26.547129823619947,21.43615791370904
2019-04-24T09:30:00-04:00,266.38,266.7,265.73,265.92,1899821,3204933.1,65.15181443858644,63.37719534864233,NaN,NaN,109.6900265138672,102.95490741204387,0.17055621043877744,2.1254763489326365,1.954920138493859,356020204,355448380,78.76586715404892,74.8083670342162,NaN,NaN,27.12130425637277,22.248321676946716
2019-04-25T09:30:00-04:00,264.06,265.25,262.98,264.53,2333830,3163316.9,58.918629434665135,62.85151404444061,NaN,NaN,46.76847518144204,93.9251919956275,0.03139895502738632,1.994168832278092,1.9627698772507056,353686374,355654491.2,79.04652900808259,75.35391182512952,NaN,NaN,25.827937599646482,22.75969538018954
2019-04-26T09:30:00-04:00,264.42,265.34,263.86,265.34,1883384,3135767.15,61.245440947427994,62.4411505149594,NaN,NaN,63.70829170124205,86.26680676531603,-0.02366999246614654,1.9331823866680224,1.956852379134169,355569758,355543442.2,78.44492399032968,75.61162102602039,NaN,NaN,25.38598907962885,23.134880194395155
2019-04-29T09:30:00-04:00,265.32,265.91,265.08,265.44,1522458,2999097.1,61.53509566150782,62.30641023442531,NaN,NaN,87.43220168493747,85.18004686003687,-0.06840380500295273,1.871347622880478,1.9397514278834307,357092216,356057715.4,79.23317174217819,75.84578008507697,NaN,NaN,25.10164302582653,23.415846313171066
2019-04-30T09:30:00-04:00,266.01,266.055,264.1,265.79,2259645,2809493.8,62.58902042448143,62.675090964242564,NaN,NaN,73.22382182548169,76.16456338139407,-0.08820441273878243,1.8294959119599525,1.917700324698735,359351861,356344082.6,79.67880388967086,76.06016370612242,NaN,NaN,25.14299019790456,23.66258115384728
2019-05-01T09:30:00-04:00,266.47,266.81,264.14,264.15,2902466,2838614.7,54.98643970660157,62.48452740390513,NaN,NaN,53.786619586274135,64.98388199587546,-0.21813550546394778,1.6450309428688001,1.863166448332748,356449395,356429920.8,79.81860145657242,76.22728713315577,NaN,NaN,22.985568560538816,23.56586506908893
2019-05-02T09:30:00-04:00,263.76,264.445,261.68,262.88,3660196,2858348.1,49.92868704465804,61.984547412022266,NaN,NaN,-63.9637406668922,42.83743882620862,-0.3861733394629705,1.3804497740040347,1.7666231134670052,352789199,356250485.8,78.60131884249435,76.48903576836774,NaN,NaN,19.563204004997313,22.99405634564727
2019-05-03T09:30:00-04:00,264.32,265.25,263.6,264.97,2161568,2746574.4,56.94699894849075,61.51432260229098,NaN,NaN,25.953235019602676,35.286427489880744,-0.35397940213183543,1.324148860802211,1.6781282629340464,354950767,356126687.6,77.72064408042874,76.85588944825182,NaN,NaN,18.648449927616603,22.373255428785747
2019-05-06T09:30:00-04:00,260.3501,264.7,260.08,264.27,3282557,2755066.35,54.20648888970443,60.920133254166366,NaN,NaN,-61.80636687043565,5.438713778806128,-0.37521622044893754,1.2091079873728745,1.584324207821812,351668210,355041886.4,70.28886550876972,76.80621151081066,NaN,NaN,17.041256294650605,21.61154126676644
2019-05-07T09:30:00-04:00,261.98,262.49,257.81,259.52,6758077,2931385.95,40.10321351552299,59.197973389957035,NaN,NaN,-196.17215658778127,-48.44048190384646,-0.6864354769689416,0.7262798616106352,1.4127153385795768,344910133,352153540.8,55.16388296558787,75.57277706644165,NaN,NaN,10.107241043654799,19.96806980632192
2019-05-08T09:30:00-04:00,259.41,261.1067,258.81,259.66,4115167,2929065.15,40.59380449407318,57.51085573850129,NaN,NaN,-182.6164077941394,-95.72108737992917,-0.8494625787969678,0.350887115083367,1.2003496938803349,349025300,350668721.8,49.29180137880084,73.89702567671826,NaN,NaN,5.070295801088474,17.839816377002858
2019-05-09T09:30:00-04:00,257.74,259.09,255.3701,258.44,7175426,3107693.35,37.696255886381785,55.438994478366524,NaN,NaN,-234.0746667296259,-129.7432725924759,-0.9959154847021475,-0.04454466199734952,0.951370822704798,341849874,348480856.8,42.16883992418556,71.55276841343287,NaN,NaN,-0.031757018662492816,15.28673446333638
2019-05-10T09:30:00-04:00,257.58,260.54,255.04,259.92,5456134,3243915.9,43.0106218798883,53.910650986297995,NaN,NaN,-174.2846621926081,-169.79085203491806,-0.9497251172185732,-0.23578557381841847,0.7139395434001548,347306008,346951905,38.03265020639658,68.86593349968186,NaN,NaN,-2.4916589621692387,12.746963973978435
2019-05-13T09:30:00-04:00,254.67,255.7,252.59,253.47,6326032,3390456.75,30.714595281266057,51.25907903951827,NaN,NaN,-239.3278366623501,-205.29514599330096,-1.2891205119071372,-0.8974610964837666,0.39165941542337046,340979976,344814258.2,33.138586533759224,65.6710347629504,NaN,NaN,-10.025215893290982,9.493795421511376
2019-05-14T09:30:00-04:00,254.4,257.23,254.24,255.81,4308796,3496382.15,37.675831789594525,49.29650885030456,NaN,NaN,-151.7289738173241,-196.40650943920951,-1.2885064935075727,-1.2189737014610955,0.06953279204647722,345288772,344889986,33.46522385157361,62.43527452705931,NaN,NaN,-13.091655680177999,6.267302406984323
2019-05-15T09:30:00-04:00,254.17,257.63,253.74,256.92,4151403,3577151.95,40.718506815899545,47.99650009182131,NaN,NaN,-120.68508184872314,-184.02024425012627,-1.1503723094793403,-1.368432594802698,-0.21806028532335786,349440175,344972961,33.846569872624684,59.206706017383745,NaN,NaN,-14.252122837468278,3.3359559434910944
2019-05-16T09:30:00-04:00,258,260.08,257.85,259.16,3889707,3627959,46.40486450897169,46.93645891764586,NaN,NaN,-55.77958534896094,-148.36122797399327,-0.8585484807224498,-1.2912458862264202,-0.4326974055039704,353329882,347268962.6,43.49709422145492,56.71043246246411,NaN,NaN,-13.064918722944421,0.9929738482860206
2019-05-17T09:30:00-04:00,256.36,259.3926,256.21,257.44,3652916,3637145.55,42.994556345379394,45.61213468077954,NaN,NaN,-72.60182905856698,-128.02466134718503,-0.7364539904961949,-1.353264893624214,-0.6168109031280191,349676966,347743154.2,45.272788584743935,54.28469080836167,NaN,NaN,-13.340968930429048,-1.0547322629589888
2019-05-20T09:30:00-04:00,256.21,257.41,255.49,256.67,2613302,3687603,41.5233635053705,44.10744490084305,NaN,NaN,-84.4360425021958,-97.04630251515417,-0.6648376481460051,-1.4478579633105255,-0.7830203151645204,347063664,348959891.8,49.645617291494965,52.13946319420625,NaN,NaN,-14.051525783084443,-2.911417051548339
2019-05-21T09:30:00-04:00,258.2,258.88,257.68,258.77,2376711,3636479.8,46.86361140626381,43.52724287939035,NaN,NaN,-44.12230605900034,-75.52496896348943,-0.44394228332705576,-1.3379481693233402,-0.8940058859962844,349440375,349790212.4,52.43847302371737,50.183739734716596,NaN,NaN,-12.821316338957917,-4.3271169497497075
2019-05-22T09:30:00-04:00,257.91,258.86,257.47,257.6,2942596,3688618.55,44.42917447599695,43.13442055305742,NaN,NaN,-48.17260547181181,-61.02247368810716,-0.3487333456957642,-1.3299225681159896,-0.9811892224202254,346497779,349201733.2,50.308742403864954,48.16284141767164,NaN,NaN,-12.624073525692442,-5.512396460598669
2019-05-23T09:30:00-04:00,255.32,255.35,253.28,254.76,4616946,3802774.35,39.117289197405704,41.860869856551346,NaN,NaN,-110.99716474219545,-72.06598956675407,-0.44307390025012516,-1.535031597732882,-1.0919576974827567,341880833,346911923.4,42.99203602444297,45.68222655652979,NaN,NaN,-14.246690462799657,-6.760152746627382
2019-05-24T09:30:00-04:00,256.21,256.68,255.02,256.12,2258897,3821550,42.65315078775593,41.03563142069788,NaN,NaN,-74.73221387922258,-72.4920665308852,-0.3822308734849329,-1.569746289338923,-1.18751541585399,344139730,345804476.2,39.96472334480127,43.51621640196062,NaN,NaN,-14.392384918506657,-7.850471628324421
2019-05-28T09:30:00-04:00,256.12,257.21,253.46,253.47,4580059,3974430.05,38.01972800502674,40.886811027091014,NaN,NaN,-96.2105460057983,-74.8469672316057,-0.4823489267863612,-1.7904515743369416,-1.3081026475505804,339559671,344303677.6,36.24040824313263,42.16453963607096,NaN,NaN,-16.07239237769635,-9.025031735377553
2019-05-29T09:30:00-04:00,252.08,252.28,249.48,251.27,5192067,4121051.15,34.654094253270145,40.462546009890794,NaN,NaN,-170.09187024412776,-100.04088006863118,-0.6482885934566665,-2.1184633893714135,-1.470174795914747,334367604,341289123.4,30.160540973831047,40.798021035715976,NaN,NaN,-18.60546802571299,-10.393665491139759
2019-05-30T09:30:00-04:00,251.77,252.34,250.82,251.87,3454668,4148661.25,36.31002503721371,40.36352952066451,NaN,NaN,-141.9366265047677,-118.79368427522236,-0.6666181011516503,-2.30344742235431,-1.6368293212026597,337822272,339554022,27.31960243121395,39.73736121478943,NaN,NaN,-20.078034473289684,-11.777146774304033
2019-05-31T09:30:00-04:00,249.39,250.07,248.22,248.22,4891080,4210205.45,31.14024443706272,39.51564541760553,NaN,NaN,-183.43763985944494,-133.28177929867223,-0.8611732715330007,-2.7132959106189105,-1.8521226390859098,332931192,337764093.8,24.731569363323104,38.78728401171276,NaN,NaN,-23.137890722946835,-13.40011019553872
2019-06-03T09:30:00-04:00,248.34,249.61,247.04,248.5,5479627,4376108.4,31.940783192179197,39.60323026838505,NaN,NaN,-174.24103843677176,-153.18354421018208,-0.9032181628225056,-2.9811453426140417,-2.077927179791536,338410819,336618311.6,23.21548177944736,38.07849081497619,NaN,NaN,-25.27131012180182,-15.09599589929059
2019-06-04T09:30:00-04:00,250.73,253.7,250.51,253.65,3796064,4401783.75,44.679766544576104,40.10351132231231,NaN,NaN,-67.43861959940999,-147.42915892890443,-0.5346178634276901,-2.746199509076149,-2.211581645648459,342206883,337147754,25.488471230072193,37.50872277058323,NaN,NaN,-22.784058278231456,-16.19429052485357
2019-06-05T09:30:00-04:00,255.22,255.8,254.07,255.73,2792381,4203498.95,48.8444444395034,40.683935438284,NaN,NaN,-0.3403596699922091,-113.47885681407732,-0.12265747647612013,-2.3649034912436093,-2.242246014767489,344999264,339274086,33.945593183352344,37.51579586420663,NaN,NaN,-19.319863417063594,-16.64080093802643
2019-06-06T09:30:00-04:00,256.12,258.35,255.53,257.72,2796177,4137549.45,52.52675770342658,41.121213523602215,NaN,NaN,56.478754247099815,-73.79578066370382,0.2894205005716466,-1.880470389052931,-2.1698908896245777,347795441,341268719.8,40.74036495830511,37.3188866311245,NaN,NaN,-15.24089341239716,-16.44081414865082
2019-06-07T09:30:00-04:00,258.46,261.12,258.4,260.25,3124909,3935023.6,56.78575161022419,42.106298899662555,NaN,NaN,121.5431577056959,-12.799621150675648,0.7137722629271326,-1.2776755609656618,-1.9914478238927944,350920350,344866551.4,50.609495257077555,37.70007996486262,NaN,NaN,-10.387673893477613,-15.576079826483218
2019-06-10T09:30:00-04:00,261.88,262.5,260.94,260.99,3495929,3837013.35,57.97337441322159,43.28129967879478,NaN,NaN,149.93140013440166,52.03486656355905,1.0077113259379726,-0.7318086664703287,-1.7395199924083014,354416279,348067643.4,57.406333630334025,38.254416846208265,NaN,NaN,-6.168952304060155,-14.232204466137066
2019-06-11T09:30:00-04:00,262.66,262.87,256.95,260.88,2792090,3660316.25,57.719441303423764,44.05671610002049,NaN,NaN,107.47704910123142,87.01800030368733,1.1479596719232608,-0.3045704025042255,-1.4525300744274863,351624189,349951104.6,60.822531761508415,38.853278184621914,NaN,NaN,-2.910188958910649,-12.614773679390435
2019-06-12T09:30:00-04:00,260.8,261.26,259.99,260.45,1725501,3531151.5,56.674388940354305,44.931374276046014,NaN,NaN,102.70247708850104,107.62656765538597,1.161487519192622,-0.0006706754367087342,-1.1621581946293307,349898688,350930989.4,62.50732822476357,39.724605743257534,NaN,NaN,-0.5456468569570706,-10.890612704757098
2019-06-13T09:30:00-04:00,261.34,261.88,260.3737,261.56,1882693,3417716,58.75060580422481,46.33375403367595,NaN,NaN,104.61193334870289,117.25320347570657,1.1905121980214883,0.3259820528975297,-0.8645301451239586,351781381,351728177.4,63.86866476366987,41.215793510345165,NaN,NaN,2.054364407062304,-9.041330260211469
2019-06-14T09:30:00-04:00,261.24,262.13,260.43,261.51,2260930,3336277.15,58.61434728667185,47.47383949788423,NaN,NaN,100.74246570495094,113.09306507555759,1.1509865608794665,0.5742030559753744,-0.576783504904092,349520451,351448197.6,63.0034300501247,42.861415417868265,NaN,NaN,4.152540985604416,-7.156491510809199
2019-06-17T09:30:00-04:00,261.64,262.18,260.97,261.68,1319478,3219605.25,58.96283881175187,48.96977598407888,NaN,NaN,96.78158978813167,102.4631030063036,1.081983467786227,0.7756958298286918,-0.3062876379575352,350839929,350732927.6,60.739588944548586,44.61135689654083,NaN,NaN,6.000733778402699,-5.2768878980646425
2019-06-18T09:30:00-04:00,263.23,265.8,262.94,265.33,6147714,3396325.85,65.6507216425222,51.183820797596866,NaN,NaN,133.26327593224676,107.62034837250667,1.2177411434377379,1.215888791339637,-0.0018523520981007513,356987643,351805618.4,62.892999448114686,46.94938964470395,NaN,NaN,9.743934041377814,-3.131056192430006
2019-06-19T09:30:00-04:00,265.4,266.21,264.63,265.56,3920808,3473530.7,66.02644825155903,53.30642245576439,NaN,NaN,129.91274018532437,113.06240099187134,1.2536903717306154,1.5652606125651687,0.3115702408345532,360908451,354007571,66.90575377692039,49.776971883682975,NaN,NaN,12.923584946798986,-0.8375360296830077
2019-06-20T09:30:00-04:00,268.05,268.5,265.9,268.08,3471763,3499989.05,69.91003813440892,56.07569343414626,NaN,NaN,138.75367127949133,119.89074857802902,1.3684821170693813,2.02217288717128,0.6536907701018986,364380214,356527337.6,70.79749425615665,53.067395090313944,NaN,NaN,16.96461622298925,1.7056285778416003
2019-06-21T09:30:00-04:00,267.29,268.96,266.901,267.1,4446832,3491483.35,66.71605242804672,58.55964123670823,NaN,NaN,124.54515330133286,124.65128609730542,1.3001923807620566,2.2789312460544693,0.9787388652924127,359933382,358609923.8,73.5644780885977,56.66375196953897,NaN,NaN,19.452896832555428,4.24095261422929
2019-06-24T09:30:00-04:00,267.33,267.91,267.1,267.17,1654193,3461248.15,66.83261558502106,60.14198759674001,NaN,NaN,108.66390146092708,127.02774843186448,1.184775725028215,2.4597085215776815,1.2749327965494666,361587575,360759453,76.08338050934451,60.277674060915565,NaN,NaN,21.521423668212236,6.709591336226854
2019-06-25T09:30:00-04:00,267.39,267.4,265.13,265.26,7240308,3594260.6,60.59676211457255,60.98143885924495,NaN,NaN,83.12809871152697,117.00071298772052,0.9168118431167482,2.420947600445402,1.5041357573286536,354347267,360231377.8,74.21253541114372,63.153884220043516,NaN,NaN,21.598891432246326,8.836634207086778
2019-06-26T09:30:00-04:00,266.12,266.49,265.21,265.22,2141421,3441728.3,60.469512867613766,61.548778513829745,NaN,NaN,75.47368803061845,106.11290255677935,0.6845308563437706,2.359799327758367,1.6752684714145962,352205846,358490856.8,68.25520126946171,65.11922967084043,NaN,NaN,21.627817129706752,10.663946053175346
2019-06-27T09:30:00-04:00,265.45,265.91,264.5,265.15,1991505,3368570.15,60.23114393840226,61.794877965842474,NaN,NaN,64.42623052815037,91.24741440651114,0.4833170559013076,2.279414791291231,1.7960977353899232,350214341,355657682.2,59.83523337595601,65.77821096504603,NaN,NaN,21.589629505440833,12.224757974927558
2019-06-28T09:30:00-04:00,265.94,266.26,265.07,265.85,2176213,3232826.8,61.85065867035607,62.07182684135207,NaN,NaN,67.23363716607919,79.78511117946042,0.3601615496928485,2.246299672505984,1.8861381228131353,352390554,354149116.6,55.88225744848451,65.6693483806282,NaN,NaN,21.970732706817746,13.6170400794833
2019-07-01T09:30:00-04:00,268.45,268.75,266,266.97,3976528,3157671.85,64.35204671695462,62.54558437089001,NaN,NaN,85.41774607190433,75.13588010165586,0.31837002298851846,2.2841006515487834,1.965730628560265,356367082,353105018,53.2596834112372,65.1291449270374,NaN,NaN,22.96454473694666,14.952397887692351
2019-07-02T09:30:00-04:00,266.84,267.73,266.14,267.66,2775740,3106655.65,65.83815710083351,63.20013923949567,NaN,NaN,78.33082125355995,74.17642461006247,0.30159941811862234,2.3427299012085427,2.0411304830899204,359142822,354064129,55.33339703944398,64.61672127094315,NaN,NaN,24.215691496611516,16.275725546109374
2019-07-03T09:30:00-04:00,268.34,269.6,268.28,269.56,1262891,3030181.15,69.59675295767127,63.974864036170416,NaN,NaN,114.33589655013813,81.9488663139664,0.3779225522762961,2.5135336734352904,2.1356111211589943,360405713,355704102.4,58.706944090870714,64.24802693717177,NaN,NaN,26.41418627248161,17.724077078448264
2019-07-05T09:30:00-04:00,268.71,269.48,267.32,269.27,2157032,2998223.9,68.36046838567903,64.67101554324236,NaN,NaN,100.84056902463846,89.23173401326402,0.3679720080173472,2.595576131180678,2.227604123163331,358248681,357310970.4,61.75489382139209,64.1588457779766,NaN,NaN,27.922941786955896,19.18105775109221
2019-07-08T09:30:00-04:00,267.9,268.43,267.47,268.06,1423707,2913163.8,63.30739106556197,64.9813407042288,NaN,NaN,78.72521266201812,91.53004911245179,0.2449174841466859,2.5337509783466885,2.2888334942000026,356824974,358197854.4,63.362316472744716,64.34618345856202,NaN,NaN,27.86366684537648,20.421430478847107
2019-07-09T09:30:00-04:00,266.72,268.12,266.69,267.86,1406997,2808717.2,62.48522871251356,64.75523406637103,NaN,NaN,62.78900842743412,87.00430158355776,0.12131992249059298,2.440483397313244,2.319163474822651,355417977,358008033.4,62.75437698154217,64.33628185380685,NaN,NaN,27.59347484794737,21.44600824586143
2019-07-10T09:30:00-04:00,268.84,269.88,268.17,268.69,1978567,2768041.05,64.54318287625604,64.64928653956368,NaN,NaN,97.74162783584377,90.88646290001452,0.06931686477663046,2.4058095557934394,2.336492691016809,357396544,357658777.8,61.58358938670038,63.95612725450542,NaN,NaN,27.901320609922003,22.368195726441513
2019-07-11T09:30:00-04:00,269.66,270.92,269.23,270.92,2238488,2793690.4,69.40014017820211,64.61286525697747,NaN,NaN,134.14372241895208,94.84802807377731,0.15410068352244277,2.5291185454198626,2.37501786189742,359635032,357504641.6,61.04232295348504,63.2593293043146,NaN,NaN,29.593753750187258,23.400418301262334
2019-07-12T09:30:00-04:00,271.66,273.39,271.6,273.39,2411152,2820113.35,73.6978114938363,65.11156233310531,NaN,NaN,200.48116068249246,114.77614640534811,0.33514037124098106,2.7939433259486464,2.4588029547076653,362046184,358264142.2,62.77832474675466,62.488889779897235,NaN,NaN,32.497716551847795,24.700032337060257
2019-07-15T09:30:00-04:00,273.55,273.6,272.96,273.6,2624471,2838290.4,74.03174769903659,65.62578605553499,NaN,NaN,206.84386902057753,140.39987767706,0.42202920033546354,2.986339455126995,2.5643102547915313,364670655,359833278.4,66.13581631981015,61.778349480644785,NaN,NaN,34.933537023962,26.16196157804622
2019-07-16T09:30:00-04:00,273.62,273.99,272.9012,273.42,1780357,2861334.35,73.17418201986987,66.52417319162765,NaN,NaN,177.49591608896168,163.34125920936552,0.4195004604474244,3.088685830350812,2.6691853699033876,362890298,361327742.6,69.00356035654417,61.406279833887666,NaN,NaN,36.68233119872382,27.664871523857308
2019-07-17T09:30:00-04:00,273.34,273.45,272.18,272.28,1550805,2631488.9,67.81621579825631,67.04893768667355,NaN,NaN,128.9453681887493,169.58200727994662,0.29883799768018715,3.0427328670036218,2.7438948693234346,361339493,362116332.4,70.42670740756967,61.561387415181095,NaN,NaN,36.66332858056131,28.950365389100735
2019-07-18T09:30:00-04:00,271.66,272.75,270.75,272.27,2124399,2541668.45,67.76933929818173,67.58738021237208,NaN,NaN,93.8710629026034,161.52747537667688,0.18188977959487662,2.97125709381703,2.7893673142221536,359215094,362032344.8,70.05777821246454,62.29156918921741,NaN,NaN,36.63485630099419,30.048149805085515
2019-07-19T09:30:00-04:00,273.18,273.34,271.36,271.45,2364266,2486293.6,63.870625698994644,67.73166357156056,NaN,NaN,85.71786991275164,138.5748172227287,0.021293325666596807,2.8159839713054,2.794690645638803,356850828,360993273.6,65.4871435683234,62.977632483491625,NaN,NaN,35.5304926736153,30.831341643446912
2019-07-22T09:30:00-04:00,271.77,272.16,270.8,271.65,1623561,2345130.05,64.40844437401232,67.7356919756361,NaN,NaN,63.29878275309521,109.86579996923226,-0.09319678009559951,2.6781946705193036,2.771391450614903,358474389,359754020.4,60.42390532481207,63.48936262017555,NaN,NaN,34.74304354128483,31.3901562002809
2019-07-23T09:30:00-04:00,272.79,273.61,271.95,273.35,1722929,2348566.85,68.67666657575215,67.93844265241601,NaN,NaN,90.48033971058635,92.4626846935572,-0.07684764948559453,2.67533188875791,2.7521795382435044,360197318,359215424.4,58.31367206598425,63.70223940778557,NaN,NaN,35.208778879894695,31.935673725940013
2019-07-24T09:30:00-04:00,272.25,272.85,271.8286,272.61,2355391,2104321,65.02136180786138,67.61162899885817,NaN,NaN,68.72384257324612,80.41837957045657,-0.1348880171142195,2.58356951685073,2.7184575339649495,357841927,358515911.2,55.597874856013576,63.4801630338672,NaN,NaN,34.567641280021796,32.31166909080884
2019-07-25T09:30:00-04:00,272.48,272.58,270.5199,271.39,2348580,2114678.95,59.40742041023922,66.97212557204104,NaN,NaN,38.60698048786242,69.36556308750836,-0.26683675065295187,2.3849115956487594,2.6517483463017113,355493347,357771561.8,52.78098386467905,62.83916946553055,NaN,NaN,32.35286767267445,32.317554602503925
2019-07-26T09:30:00-04:00,271.655,272.05,271.11,271.86,1731277,2101667.55,60.81119240401066,66.7938256676445,NaN,NaN,38.066579174367796,59.8353049398316,-0.3297328186719448,2.2395823229617804,2.569315141633725,357224624,357846321,53.03833602132463,62.101742290429115,NaN,NaN,30.88735652125879,32.113240590897476
2019-07-29T09:30:00-04:00,271.86,272.68,271.69,272.13,1346401,2060176.95,61.632052380645526,66.73288450108251,NaN,NaN,48.306932211177894,56.83693483144814,-0.3580629028708944,2.121736513045107,2.4797994159160015,358571025,357865648.2,53.10948764829247,61.41282162376842,NaN,NaN,29.88558908460493,31.79500466142711
2019-07-30T09:30:00-04:00,271.09,272.155,270.62,271.91,1674302,1945065.65,60.51968740066041,66.44549196711138,NaN,NaN,22.07104323133536,43.15507553559794,-0.39369714572523806,1.987677983759454,2.381375129484692,356896723,357205529.2,50.30599710420631,60.607279317876,NaN,NaN,28.74284927943523,31.3589824639997
2019-07-31T09:30:00-04:00,272.3,272.68,267.1025,268.52,5058843,2059220.8,46.571380609232016,64.81486628361353,NaN,NaN,-71.19580804638164,15.171145411672365,-0.6334461666966464,1.589567421113884,2.2230135878105304,351837880,356004719.8,45.591381735456515,59.503640659445374,NaN,NaN,23.065658101824102,30.174221840831756
2019-08-01T09:30:00-04:00,268.82,271.71,265.4,265.76,7225326,2357342.55,38.74239721805661,62.31805097820069,NaN,NaN,-136.39051861125526,-19.828354408151178,-0.9469134562336674,1.0393717675184462,1.9862852237521136,344612554,353828561.2,38.54185080547202,57.772463949353764,NaN,NaN,15.089257560868852,28.0192269436942
2019-08-02T09:30:00-04:00,265.21,265.766,262.43,264.81,5691451,2534063.5,36.46981784901841,59.63505598891368,NaN,NaN,-221.61351418507653,-71.76437308004003,-1.1724852762320845,0.520678628462008,1.6931639046940925,338921103,350167857,30.10811777929605,55.19905691074562,NaN,NaN,7.887315475388014,25.14323959107903
2019-08-05T09:30:00-04:00,260.99,261.15,255.13,257.1,6608172,2793286.75,24.109375987673857,56.130426986613955,NaN,NaN,-318.74221906179133,-145.1742033346339,-1.759876147491346,-0.5066812796700901,1.2531948678212559,332312931,344916238.2,22.50123297255591,51.8774620976036,NaN,NaN,-5.3142473662991625,20.79217002573929
2019-08-06T09:30:00-04:00,258.55,260.36,257.05,260.29,4991027,2972488.25,34.06637261034669,53.71972390176327,NaN,NaN,-222.0150439488612,-193.9914207706732,-1.8436325410532777,-1.0513458084953413,0.7922867325579364,337303958,340997685.2,18.70394405090559,48.18297900069903,NaN,NaN,-11.235224594813536,16.216827937088887
2019-08-07T09:30:00-04:00,257.13,260.69,254.36,260.24,5089469,3128033.35,33.99109438225713,51.306992122054375,NaN,NaN,-184.99057003889456,-216.7503731691758,-1.8098971717439636,-1.470084732122018,0.33981243962194546,332214489,337073007,15.823649000680774,44.30911262842875,NaN,NaN,-15.407718756253919,11.699035552325629
2019-08-08T09:30:00-04:00,261.46,264.13,260.5768,264.13,3637099,3197963.9,44.303013025977016,49.9093055025531,NaN,NaN,-92.47368391542054,-207.96700623000885,-1.4487219882643396,-1.471090045708479,-0.022368057444139444,335851588,335320813.8,14.732830262563937,40.68380453516022,NaN,NaN,-14.768054024417346,7.918022755648062
2019-08-09T09:30:00-04:00,263.44,264.44,261.25,263.18,3773003,3266056.45,42.55460730069679,48.34831714017343,NaN,NaN,-80.02317029929436,-179.6489374528524,-1.2068228351777412,-1.5308966014163161,-0.3240737662385748,332078585,333952310.2,13.925404846689503,37.36248307243717,NaN,NaN,-14.935002727048447,4.653304829548561
2019-08-12T09:30:00-04:00,261.42,262.17,258.56,259.4,3072737,3288469.75,36.399237851019144,46.04278651697821,NaN,NaN,-105.32741338424081,-136.9659763173423,-1.2302177357523947,-1.8618459359290682,-0.6316282001766735,329005848,333290893.6,13.53919537939332,34.16430616625211,NaN,NaN,-17.42687598066201,1.498993285232765
2019-08-13T09:30:00-04:00,259.07,264.63,258.63,263.17,4332355,3416069.65,44.951606632663136,44.60923257589263,NaN,NaN,-67.97407254757088,-106.15778203708426,-0.9340401333250761,-1.7991783668330186,-0.8651382335079425,333338203,332497742.6,13.071039292154495,31.126675054547885,NaN,NaN,-16.112765682635814,-1.0169722816056033
2019-08-14T09:30:00-04:00,259.18,259.73,255.06,255.08,6147957,3645927.25,34.29447906007324,42.815451050880775,NaN,NaN,-122.19661516901915,-93.59899106310915,-1.207835422970623,-2.3749325122212213,-1.1670970892505983,327190246,331492894,12.482172015128327,28.24818849386569,NaN,NaN,-19.57644055662904,-3.668324892323237
2019-08-15T09:30:00-04:00,256.24,256.9473,253.93,256.36,4038455,3741630.05,36.845677032635045,41.10362852435395,NaN,NaN,-117.2971513201624,-98.56368454405752,-1.2238014664285897,-2.6968489222863354,-1.4730474558577458,331228701,330568316.6,11.94876626596674,25.313219225625847,NaN,NaN,-21.026840512052562,-6.148112837998855
2019-08-16T09:30:00-04:00,257.39,259.25,256.87,258.88,2748371,3760835.3,41.649245944091035,39.676285207457205,NaN,NaN,-78.87239813485039,-98.33353011116874,-0.9954049727526522,-2.717303671798561,-1.7218986990459089,333977072,330948014,13.582008975185573,22.489827891832498,NaN,NaN,-20.291829711016867,-8.168643819858572
2019-08-19T09:30:00-04:00,262.04,262.25,260.82,261.34,2033201,3781317.3,45.96959111207281,38.63699261541524,NaN,NaN,-37.32451623866331,-84.73295068205323,-0.6273800270423406,-2.5061237328488346,-1.878743705806494,336010273,332348899,19.513805200437275,20.290385612991855,NaN,NaN,-18.1108135305246,-9.588953778525147
2019-08-20T09:30:00-04:00,261.01,261.56,259.4735,259.69,1981083,3794225,43.63586909479585,38.42731322152694,NaN,NaN,-47.85772299027449,-80.70968077059396,-0.45199182073914,-2.443733481730419,-1.991741660991279,334029190,332487096.4,20.09648506725351,18.46932156526307,NaN,NaN,-17.229914961742214,-10.68051966184187
2019-08-21T09:30:00-04:00,261.83,262.66,261.49,262.03,2163005,3784605.7,47.691577321299114,39.06654037175854,NaN,NaN,-18.56620200020874,-59.98359813683187,-0.15087607087167632,-2.1803367495808743,-2.029460678709198,336192195,334287486.2,27.46388526262494,17.678038312202563,NaN,NaN,-15.11782882406017,-11.314420970730199
2019-08-22T09:30:00-04:00,262.71,263.82,260.95,262.56,2329657,3783659.55,48.59382112354494,39.932540605653294,NaN,NaN,-7.028175525718416,-37.92980297794307,0.09809218795098662,-1.9068454437704645,-2.004937631721451,338521852,335746116.4,32.864738806926866,17.874939814176187,NaN,NaN,-13.182880353448546,-11.581343739689963
2019-08-23T09:30:00-04:00,261.27,263.19,255.04,256.29,6296172,4011904.3,39.83916875119291,41.05609723161894,NaN,NaN,-74.41744601183707,-37.03881255334041,-0.1328596037749512,-2.1710121364401402,-2.038152532665189,332225680,335395838,32.243858399068415,18.570841630355652,NaN,NaN,-14.477767970763697,-11.995118629843354
2019-08-26T09:30:00-04:00,259,259.42,257.18,259.1,3146630,4101915.75,44.65182276143857,41.81220081383979,NaN,NaN,-61.40369602572859,-41.854648510753464,-0.07274190966024152,-2.129079919740491,-2.0563380100802493,335372310,335268245.4,32.00665827215688,19.52103550330217,NaN,NaN,-13.854141742839014,-12.260693360271306
2019-08-27T09:30:00-04:00,260.51,260.56,257.24,257.8,3081241,4172262.7,42.940395035218835,42.45143657476562,NaN,NaN,-55.90321746877986,-43.46374740645454,-0.09546377440310927,-2.175667728084136,-2.0802039536810266,332291069,334920621.2,31.330414542073612,20.628661613401654,NaN,NaN,-13.92678856111846,-12.498706960392328
2019-08-28T09:30:00-04:00,257.02,260.46,256.34,260.39,2743182,4056479.65,47.27617631129778,42.66380538085996,NaN,NaN,-36.508125647348066,-47.05213213588241,0.07955154142984355,-1.9807645268937222,-2.0603160683235657,335034251,334689032.4,30.86258520361484,21.78078696633386,NaN,NaN,-12.563548126472341,-12.507969984118043
2019-08-29T09:30:00-04:00,262.94,264.24,262,263.9,3742555,3882341.1,52.53953131487509,43.37701423901556,NaN,NaN,104.08398857453832,-24.82969931583106,0.4278610358445747,-1.5254897735178474,-1.9533508093624221,338776806,334740023.2,31.106511401355107,23.008008863095686,NaN,NaN,-9.64822671034898,-12.099435230722463
2019-08-30T09:30:00-04:00,265.27,265.4,263.1701,264.13,2443354,3719936.25,52.871536182530654,44.55360697698067,NaN,NaN,131.89582431863516,16.432954750263384,0.6562318857068612,-1.1330609522288455,-1.7892928379357067,341220160,336538919.2,39.249669532597714,24.844471302610287,NaN,NaN,-7.267544665102697,-11.40916514991964
2019-09-03T09:30:00-04:00,262.07,262.2,260.03,261.42,3090489,3544052.1,48.56104655426404,44.811424114237866,NaN,NaN,30.489386009931486,34.8115711573954,0.608336322613106,-1.0288724346693243,-1.6372087572824303,338129671,337090391.4,41.53127508937337,26.877345288125923,NaN,NaN,-6.5777225695678805,-10.718959067012245
2019-09-04T09:30:00-04:00,263.58,263.95,262.77,263.93,1971058,3393053.65,52.42945165255298,46.10677929941499,NaN,NaN,95.12160107011576,65.01653486517455,0.7215347722045695,-0.7352902920267184,-1.4568250642312879,340100729,338652323.4,47.54075811586813,29.381530009607335,NaN,NaN,-4.785451929054578,-9.87131519016115
2019-09-05T09:30:00-04:00,266.73,268.7089,266.7,267.68,3624350,3319797.7,57.56415024651916,47.58667024326386,NaN,NaN,191.4837571780648,110.61491143025712,1.0072591576948573,-0.1977511171127162,-1.2050102748075735,343725079,340390489,53.29384953813417,32.33475024333358,NaN,NaN,-1.567158791302716,-8.685007133181374
2019-09-06T09:30:00-04:00,268.07,268.94,267.41,268.32,2470377,3261461.6,58.38963995157422,48.782412672369794,NaN,NaN,180.52527141634985,125.90316799861944,1.1853726311583015,0.2767055141403034,-0.9086671170179981,346195456,341874219,57.57132158828153,35.47684400141186,NaN,NaN,1.256477181966457,-7.264795088160255
2019-09-09T09:30:00-04:00,268.85,269.405,268.03,268.8,2243429,3184982.9,59.03329873496052,49.7155346454332,NaN,NaN,167.40022198693543,133.0040475322795,1.2737881369221098,0.6835680541346392,-0.5902200827874706,348438885,343317964,61.28662619486118,38.460616929585,NaN,NaN,3.73329682945304,-5.693639099929785
2019-09-10T09:30:00-04:00,268.48,269.42,267.55,269.39,2654313,3164061.7,59.8553100432568,50.87406614175184,NaN,NaN,143.77792944996298,155.66175622028578,1.3054645295534464,1.0416105791543373,-0.263853950399109,351093198,345910669.4,66.8932214807837,41.80324095912287,NaN,NaN,6.011571206704646,-4.021466198982009
2019-09-11T09:30:00-04:00,269.72,271.735,269.22,271.69,1899773,3042432.6,62.97427752260656,51.96568758470238,NaN,NaN,155.5660835141357,167.75065270908976,1.406070203845149,1.4937338044073272,0.08766360056217826,352992971,348489117.8,71.33874883917981,44.93715978601965,NaN,NaN,8.905017576138878,-2.1748256596790254
2019-09-12T09:30:00-04:00,272.62,273.44,271.46,272.32,3272206,2898645.05,63.80382792688065,53.0521166420835,NaN,NaN,156.72651455515953,160.7992041845087,1.4348252838212734,1.88119520533877,0.4463699215174966,356265177,350997137.4,74.87304822258567,47.937753315709564,NaN,NaN,11.546667435989203,-0.2146123602978498
2019-09-13T09:30:00-04:00,273.02,273.28,272.46,272.6,2182688,2805856.7,64.18786365687862,54.791309135346744,NaN,NaN,140.61988877984794,152.81812765720832,1.3914319750565405,2.1856598903381723,0.7942279152816318,358447865,353447619.2,77.75887453308398,51.18882589671067,NaN,NaN,13.851780848452588,1.7948723838093554
2019-09-16T09:30:00-04:00,271.6,272.21,270.8,271.17,4077522,2872314.25,60.648757531573345,55.93394733321351,NaN,NaN,102.99448457224723,139.93698017427067,1.192792642867965,2.285218718866588,1.092426075998623,354370343,354633910.8,79.01535752423337,54.54659012900185,NaN,NaN,14.928941857678653,3.671168022933541
2019-09-17T09:30:00-04:00,270.59,271.58,270.37,271.56,1762986,2858803.5,61.27585600513252,57.24362311677878,NaN,NaN,87.8294581738203,128.74728591904216,1.0206906452798143,2.368289382598391,1.3475987373185767,356133329,355641937,80.04687327327741,58.02633718123069,NaN,NaN,16.001939979994322,5.432706873942224
2019-09-18T09:30:00-04:00,271.24,272.13,269.48,271.97,3056480,2912573.35,61.962129805848676,58.29261979496099,NaN,NaN,79.20542315665733,113.47515384754647,0.873193598835474,2.4390907358629192,1.5658971370274453,359189809,356881304.6,81.26618174971529,61.62659407738072,NaN,NaN,17.091616445820883,7.098265384210604
2019-09-19T09:30:00-04:00,272.47,273.2,271.13,271.42,3268663,2967856.25,60.4153572522165,58.85517879048537,NaN,NaN,81.18462634442089,98.36677620539874,0.6855953558872812,2.4228913318865466,1.7372959759992654,355921146,356812498.4,80.97035272508091,65.18829702907541,NaN,NaN,17.64926319997631,8.605550786462848
2019-09-20T09:30:00-04:00,271.39,271.76,269.09,269.25,4080943,3055420.55,54.62176921548195,58.98019543569617,NaN,NaN,49.734346976016376,80.18966784463242,0.37774944386408826,2.2094827808293758,1.8317333369652875,351840203,355490966,75.3005979376061,67.76336334371888,NaN,NaN,16.637525241181255,9.752975708565478
2019-09-23T09:30:00-04:00,268.25,269.97,268.07,269.36,1913266,2836275.25,54.858087785118386,59.42998409504291,NaN,NaN,31.959725029177445,65.98271593601847,0.15531571995955895,2.025877986914736,1.8705622669551771,353753469,355367591.2,74.77418896133157,70.1378571917159,NaN,NaN,15.843297373253531,10.62302166066377
2019-09-24T09:30:00-04:00,270.42,270.609,266.88,267.97,3745984,2866242.95,51.22763030275523,59.3441397129145,NaN,NaN,15.708533476812663,51.55853099661692,-0.09800344744926504,1.7480579576435957,1.8460614050928608,350007485,354142422.4,69.57280933585218,71.71157513600046,NaN,NaN,14.182136020038133,11.131466569145822
2019-09-25T09:30:00-04:00,268.4,270.13,267.42,269.58,3413791,2882870.45,54.94676912788386,59.15718391872626,NaN,NaN,19.573478126909894,39.632141990667456,-0.165725242016725,1.6389048525719545,1.8046300945886795,353421276,352988715.8,64.98836618378982,72.5468977535473,NaN,NaN,13.668611837820164,11.493915893242157
2019-09-26T09:30:00-04:00,270.01,270.01,267.9,268.88,2406636,2866043.15,53.052543997162736,58.77596277912544,NaN,NaN,7.553242621694705,24.90586524612222,-0.260609192599081,1.4788686038398282,1.7394777964389092,351014640,352007414.6,61.28904899746235,72.81244971134592,NaN,NaN,12.724334382995139,11.669689963206869
2019-09-27T09:30:00-04:00,269.58,269.97,267,267.99,3172209,2837525.85,50.661202621436495,58.177955913873724,NaN,NaN,-18.718511703458972,11.215293510227152,-0.3790752579349861,1.2656337240201765,1.6447089819551626,347842431,351207860.2,58.37342511510594,72.60436391993484,NaN,NaN,11.266913318215181,11.612150442493771
2019-09-30T09:30:00-04:00,268.51,269.83,268.51,269.18,2132213,2821968.8,53.66835036351582,57.73603022246366,NaN,NaN,0.6956023725875087,4.96246897890917,-0.3725072191035115,1.1790749580757733,1.5515821771792848,349974644,350452095.2,55.67723970679065,71.80322236464963,NaN,NaN,10.774349672658444,11.492464618231581
2019-10-01T09:30:00-04:00,269.76,270.29,265.45,265.5,3568373,2845863,44.61286278069151,56.42450059804115,NaN,NaN,-97.42517432936857,-17.664272582327087,-0.5978575370309958,0.8042602558905401,1.4021177929215358,346406271,349731852.4,53.15738766713162,70.50455370950333,NaN,NaN,7.5683964650220785,10.931883453487366
2019-10-02T09:30:00-04:00,264.06,264.06,259.5739,260.72,7035988,3099109.5,36.09381359835051,54.445213860289,NaN,NaN,-308.76715602069174,-83.33239941184742,-1.0255933438686318,0.12012611308574606,1.1457194569543778,339370283,346921653.8,44.663724217668474,68.34674485200924,NaN,NaN,1.583284584995062,9.596369329417037
2019-10-03T09:30:00-04:00,260.31,262.03,257.38,262.01,5684506,3202117.3,39.45399718996065,52.67850911265201,NaN,NaN,-278.93962343365274,-140.6309726229169,-1.1680470824423392,-0.31433939609854633,0.8537076863437929,345054789,345729683.6,41.62560347690505,65.76579691942503,NaN,NaN,-2.1716431240829275,7.915224693202757
2019-10-04T09:30:00-04:00,262.88,265.85,262.72,265.66,3229515,3240074.2,47.814921362144446,51.76180652912137,NaN,NaN,-121.10382072993856,-161.10803442821285,-0.9709519849083765,-0.35998229479167776,0.6109696901166988,348284304,345818058.2,41.940934633100255,63.11762385577266,NaN,NaN,-2.606291570487105,6.412150941247063
2019-10-07T09:30:00-04:00,264.92,266.5,264.1851,264.74,2343319,3245068.7,46.087372256343485,50.6769148327793,NaN,NaN,-94.09680481430503,-180.06651586559133,-0.8608000334228635,-0.46503035166188056,0.3957696817609829,345940985,345011326.4,39.825997140352904,60.24470413199234,NaN,NaN,-3.517884733302897,4.993574416311355
2019-10-08T09:30:00-04:00,262.64,264.21,261.35,261.58,3943473,3309526.7,40.654168671407035,49.154917608890614,NaN,NaN,-138.29485619347065,-188.24045223841176,-0.9519063383796731,-0.7941132412136085,0.15779309716606466,341997512,344129574.6,37.59455203178457,57.12530200928301,NaN,NaN,-6.151341972408093,3.4014435036371484
2019-10-09T09:30:00-04:00,263.44,264.24,262.48,263.43,2064206,3317748.35,44.759964154534536,48.03667524477048,NaN,NaN,-98.22979894239639,-146.1329808227527,-0.8424853935797737,-0.8953136448086525,-0.05282825122887877,344061718,345067861.6,41.359762831059825,54.29597415971006,NaN,NaN,-6.9382535512970245,1.924343924360838
2019-10-10T09:30:00-04:00,263.23,266.0289,263.11,265.01,2430485,3275662.3,48.06472167815115,47.56831470638971,NaN,NaN,-60.862781471138625,-102.51761243024984,-0.6284244548282648,-0.8383588197642098,-0.20993436493594497,346492203,345355344.4,42.50438554678966,51.95338756036603,NaN,NaN,-6.500624225312084,0.7207770458361351
2019-10-11T09:30:00-04:00,267.7699,270.14,267.62,268.16,4186362,3375846,53.97632268613385,47.505331485033665,NaN,NaN,29.52443510783992,-72.39196126269414,-0.2583725845662472,-0.532900095643754,-0.2745275110775068,350678565,345834196.6,44.449429718025236,49.7873333287013,NaN,NaN,-4.125416229931105,0.028463720726529473
2019-10-14T09:30:00-04:00,267.6,268.73,267.4352,267.86,1212897,3232614.75,53.353448219250545,47.657175621926186,NaN,NaN,19.942906312519,-49.58401903732935,-0.029529407788187467,-0.31143927081274114,-0.2819098630245537,349465668,346539133.2,47.2770909009567,48.19478201192305,NaN,NaN,-2.459165100961727,-0.32691182522893575
2019-10-15T09:30:00-04:00,269.12,271.19,268.86,270.22,3181257,3303528.3,57.50761365633865,47.84009308824439,NaN,NaN,71.90427279816015,-7.544193239003198,0.268632847357584,0.05388119617242637,-0.21475165118515765,352646925,348669015.8,54.768597877914495,47.46479856150338,NaN,NaN,0.2991516933112201,-0.2374741797231992
2019-10-16T09:30:00-04:00,269.79,270.56,269.4,270.08,2419453,3271676.95,57.182281912420954,48.135074367905695,NaN,NaN,72.66285982201926,26.634338513879932,0.4344563716438562,0.3283188133696626,-0.10613755827419358,350227472,349902166.6,58.44978820037369,47.261994218854184,NaN,NaN,2.393553815172083,0.13838696240469825
2019-10-17T09:30:00-04:00,270.67,271.15,269.71,270.38,1894478,3202967.7,57.73406637076615,48.640278921429235,NaN,NaN,86.01433546488556,56.009761901084765,0.5357293582284754,0.5635241395114008,0.027794781282925313,352121950,351028116,61.528537234740156,47.487359370256634,NaN,NaN,4.260586849211171,0.7272726605199087
2019-10-18T09:30:00-04:00,269.61,275,267.62,267.64,2241257,3110983.4,51.23930541909394,48.466775711113385,NaN,NaN,77.7025930171542,65.64539348294761,0.39600768745103443,0.5228043905967183,0.12679670314568392,349880693,350868541.6,60.84048290998368,47.856162456198994,NaN,NaN,4.006999303643172,1.1958050381089462
2019-10-21T09:30:00-04:00,268.06,268.37,267.4,268.21,1383092,3084474.7,52.43797729546969,49.025712462168975,NaN,NaN,27.088752984229483,67.07456281728972,0.3228935607553258,0.5304136540898412,0.20752009333451538,351263785,351228165,61.875203470819784,48.478863585033864,NaN,NaN,4.143595547259215,1.616917967987556
2019-10-22T09:30:00-04:00,268.48,269.38,267.76,267.82,2546297,3024490.35,51.50503548242682,50.126514025317285,NaN,NaN,35.68875714435773,59.83145968652924,0.2333596186196079,0.49921961660902525,0.26585999798941734,348717488,350442277.6,58.252777997747664,49.44951028361095,NaN,NaN,3.9975819485587887,1.957012822354875
2019-10-23T09:30:00-04:00,268.12,268.9,267.36,268.24,1702903,2938945.95,52.485438676565614,51.05733127436049,NaN,NaN,33.28785358931428,51.95645843998825,0.18938800538303924,0.5025950047182164,0.31320699933517715,350420391,350480861.4,58.38160222057229,50.646367336730044,NaN,NaN,4.138568577609069,2.268663644534046
2019-10-24T09:30:00-04:00,269.02,269.12,267.06,267.98,1846919,2910960.1,51.787461160166444,51.341084117076356,NaN,NaN,31.873476349309307,41.12828661687299,0.1324513768675063,0.47877122041956,0.3463198435520537,348573472,349771165.8,55.01856986751656,51.58048413918834,NaN,NaN,4.075492101344609,2.5267819955069832
2019-10-25T09:30:00-04:00,267.72,270.12,267.625,269.6,1825533,2843626.3,55.73719544376789,52.030357201892386,NaN,NaN,57.920045512449775,37.1717771159321,0.19004856459642855,0.5838805492975894,0.3938319847011608,350399005,349874828.2,55.42249845388457,52.69451994729775,NaN,NaN,5.082399714962755,2.891870241143522
2019-10-28T09:30:00-04:00,270.78,271.58,270.1868,270.81,1813273,2827679.3,58.473640759441615,53.30317663675199,NaN,NaN,98.52752432253862,51.459531383593934,0.2898155884162217,0.7561014702214379,0.46628588180521624,352212278,350064526.8,56.19766696584971,54.023313871159544,NaN,NaN,6.714762010217301,3.4379976367254903
2019-10-29T09:30:00-04:00,270.47,271.6,270.31,270.87,2885958,2793558.55,58.610284847555846,54.29248525768209,NaN,NaN,90.75446161528204,62.47267227777879,0.33673303454643544,0.8872021749882606,0.5504691404418252,355098236,351340676.4,61.098489840401896,55.43322294325541,NaN,NaN,8.111490102063957,4.1056394174881286
2019-10-30T09:30:00-04:00,270.87,271.99,269.88,271.74,2146834,2549100.85,60.63307649652556,55.19022488756598,NaN,NaN,95.1953310390602,74.85416776772799,0.3989907241863262,1.049207545674733,0.6502168214884068,357245070,352705612.2,65.53956242106878,57.07859271998962,NaN,NaN,9.868130319853382,4.928852403540308
2019-10-31T09:30:00-04:00,271.57,271.66,269.07,270.48,3024439,2416097.5,56.33868718650358,55.35896520902096,NaN,NaN,73.32513041774338,83.1444985814148,0.33075872580162113,1.0636652287404331,0.732906502938812,354220631,353835044,68.72155414650553,58.8123158934525,NaN,NaN,10.287792303887699,5.694415246447078
2019-11-01T09:30:00-04:00,271.86,273.34,271.69,273.34,2989672,2404105.35,62.78219975980309,56.03244746191757,NaN,NaN,137.3390950453803,99.0283084880009,0.44649006195896157,1.291019080387514,0.8445290184285523,357210303,355197303.6,72.07131150126253,60.583331650617204,NaN,NaN,12.58275151348816,6.678463284595804
2019-11-04T09:30:00-05:00,274.73,275.05,273.96,274.55,1574198,2365649.3,65.12706764279153,56.57669417523563,NaN,NaN,172.03174774215083,113.72915317192334,0.5651424379008348,1.550957065804596,0.9858146279037611,358784501,356511748.2,74.86810564560695,62.019010776880954,NaN,NaN,15.242451837797184,7.901890220767429
2019-11-05T09:30:00-05:00,275.08,275.51,274.43,274.81,1712906,2254120.95,65.6281888197909,57.17997324004777,NaN,NaN,173.74125569849795,130.32651198856652,0.6174908568197361,1.7576781989284314,1.1401873421086952,360497407,357591582.4,76.91345880772704,63.33784439169191,NaN,NaN,17.571744616402064,9.283297991572377
2019-11-06T09:30:00-05:00,275.02,275.21,273.99,274.8,1607540,2231287.65,65.5891499149186,57.74105063605867,NaN,NaN,157.36884070077687,142.76121392090985,0.6068988935773922,1.8988109590804356,1.2919120655030434,358889867,357920541.8,77.51384162227218,64.4796518479442,NaN,NaN,19.480814766612404,10.74008610229238
2019-11-07T09:30:00-05:00,276.5567,278.05,276.5567,277.05,3029454,2261236.1,69.92417799278856,59.07568439132257,NaN,NaN,207.68832450852622,169.6338527390664,0.7002570412561322,2.1672333670732087,1.4669763258170765,361919321,359460279.8,80.11986294607779,65.85675042195092,NaN,NaN,22.512551236314692,12.421866835724138
2019-11-08T09:30:00-05:00,277.16,277.24,276.05,277.07,1512713,2127553.65,69.96040419099106,60.327286312431234,NaN,NaN,157.4804119908791,173.66211612816616,0.7099656984857652,2.354433448924283,1.6444677504385177,363432034,360704626,81.94135370686337,67.2900468673826,NaN,NaN,25.0051057117003,14.219472389435019
2019-11-11T09:30:00-05:00,275.79,277.41,275.39,277.16,1731935,2153505.55,70.13473287578883,61.65797898338566,NaN,NaN,128.36705570545175,164.92917772082635,0.6695846128361307,2.481448516483681,1.8118639036475503,365163969,361980519.6,83.60053969353578,69.1006012742246,NaN,NaN,27.131854322609634,16.064098379888534
2019-11-12T09:30:00-05:00,277.43,277.99,276.64,277.29,1695664,2079225.9,70.40192506631386,62.93772801122482,NaN,NaN,122.81471120904912,154.74386882293658,0.60095167776269,2.5630535008509128,1.9621018230882228,366859633,363252964.8,85.07345719391876,71.00716234374936,NaN,NaN,29.000939608112976,17.91221855534917
2019-11-13T09:30:00-05:00,276.34,278.4,276.17,278.05,2599747,2088240.6,71.98018160199715,64.3800651856413,NaN,NaN,111.22654350273147,145.5154093833275,0.5570443204382709,2.658407223636061,2.1013629031977903,369459380,365366867.4,87.13990160213943,73.30154318193671,NaN,NaN,31.06382906230389,19.791020056342703
2019-11-14T09:30:00-05:00,277.88,278.32,277.09,278.23,1586544,2072843.9,72.3561541962812,65.56713366796369,NaN,NaN,104.57024442296294,124.89179336621484,0.49265231075830096,2.7171782916456664,2.2245259808873654,371045924,367192188,88.6066475393538,75.67183954518451,NaN,NaN,32.922533381712974,21.6669505313956
2019-11-15T09:30:00-05:00,278.87,279.95,278.495,279.94,2363768,2078969.45,75.69296206072772,66.79708518948412,NaN,NaN,120.0349408604671,117.40269914013246,0.5153146247572056,2.8686692618338725,2.353354637076667,373409692,369187719.6,89.95544144456528,78.08310915080706,NaN,NaN,35.57937728575813,23.654440067733102
2019-11-18T09:30:00-05:00,279.76,280.36,279.61,280.27,1793881,2099508.9,76.28781127772186,68.05976564878169,NaN,NaN,119.63594460726858,115.65647692049583,0.502110024032353,2.9809921671171082,2.478882143084755,375203573,371195640.4,91.0974774517547,80.2258939801894,NaN,NaN,37.99819643905511,25.703548120779104
2019-11-19T09:30:00-05:00,280.83,280.84,278.87,279.33,1931159,2068752,70.96070485297157,68.79745338852783,NaN,NaN,103.997732632197,111.89308120512541,0.38492409964621155,2.9600372676425195,2.575113167996308,373272414,372478196.6,91.74324035640674,82.09758526128496,NaN,NaN,38.704081098931994,27.560767117658088
2019-11-20T09:30:00-05:00,278.64,278.9,276.72,278.2,2468704,2107042.05,65.07764434038354,69.42166461380496,NaN,NaN,64.20844630091185,102.4894617647615,0.19570509982847728,2.819744542781905,2.6240394429534275,370803710,372747062.6,91.87627338439299,83.75149377827691,NaN,NaN,37.6784999298088,29.006157519393906
2019-11-21T09:30:00-05:00,278.33,278.42,277.16,277.72,1383484,2083870.3,62.69971767280983,69.4157730361626,NaN,NaN,54.60075468683392,92.49556381753568,0.01229176645468133,2.639404151021779,2.6271123845670976,369420226,372421923,89.98805013863802,85.03126082380375,NaN,NaN,36.141757154428134,30.025528895827367
2019-11-22T09:30:00-05:00,278.38,279.03,277.7901,278.86,1419523,2063569.8,65.88776731963495,69.4701087273657,NaN,NaN,67.77623042297564,82.0438217300374,-0.05451125769235343,2.5589733124516556,2.613484570144009,370839749,371907934.4,86.94598977689031,85.89396683318112,NaN,NaN,35.655004253644876,30.82973966122987
2019-11-25T09:30:00-05:00,279.68,280.81,279.64,280.8,1815534,2063682.85,70.50740123754201,69.8186239000622,NaN,NaN,109.1515985310033,79.94695251478434,0.0064550990162848265,2.6215534439143653,2.6150983448980805,372655283,371398276.4,83.91669592199327,86.39419805562872,NaN,NaN,36.59575943598369,31.653456771908985
2019-11-26T09:30:00-05:00,281.07,281.58,280.6053,281.36,1305783,1984674.1,71.69884238945527,70.25503050538626,NaN,NaN,126.42882832624184,84.4331716535933,0.05622578263544753,2.68538057319239,2.6291547905569423,373961066,371536006.8,84.07813969689366,86.86307648953024,NaN,NaN,37.730181317920916,32.52156027848212
2019-11-27T09:30:00-05:00,281.61,281.91,281.01,281.91,1790471,1966855.95,72.85855880498062,70.46462913482854,NaN,NaN,134.26351148372046,98.44418469015503,0.09560384721079052,2.7486595995704306,2.65305575235964,375751537,372525572.2,85.22564312687841,87.22777507387313,NaN,NaN,39.017310400144964,33.44952458157681
2019-11-29T09:30:00-05:00,281.3,281.57,280.84,280.95,811888,1856228.4,67.64787198976742,70.29944826331257,NaN,NaN,113.36906541388703,110.19784683556566,0.029821183422616304,2.6903322316379104,2.660511048215294,374939649,373629456.8,86.40289774560044,87.5464567909258,NaN,NaN,38.59078767146464,34.183990737275074
2019-12-02T09:30:00-05:00,281.45,281.49,278.2,278.2,2552515,1834370.55,55.420549507393716,69.24843516557006,NaN,NaN,41.01540674347583,104.8456820996657,-0.2127273384083619,2.3946018752048417,2.6073292136132036,372387134,373938933.8,86.72232591241979,87.76944152084607,NaN,NaN,34.11594670789516,34.174270161649375
2019-12-03T09:30:00-05:00,275.43,275.64,273.62,275.51,3837952,1947558.25,46.55599166419739,67.54515420827603,NaN,NaN,-129.29563911056817,57.1562345713514,-0.5490405727663683,1.921028497655243,2.4700690704216113,368549182,373117713.6,81.26657268382498,87.49752119869652,NaN,NaN,26.89706341132043,33.13466919731667
2019-12-04T09:30:00-05:00,277,277.76,276.61,277.05,1932368,1958531.35,51.353251003739196,66.07180202268617,NaN,NaN,-50.409463267237086,21.78857625265561,-0.6552935244621345,1.6509521648439431,2.3062456893060777,370481550,372421810.4,76.85426616627176,86.76283295327741,NaN,NaN,22.639766857929196,31.63539743454703
2019-12-05T09:30:00-05:00,277.86,277.86,276.1514,277.36,1455896,1950949.15,52.281798025559105,64.63791943906317,NaN,NaN,-60.27405958959066,-17.118937962006623,-0.6887813726921621,1.445268973440875,2.134050346133037,371937446,371658992.2,72.22513998704599,85.59272527096971,NaN,NaN,19.64244831693344,29.92211898917366
2019-12-06T09:30:00-05:00,279.45,280.94,279.3881,280.7,2686913,1933822.1,60.93386678549669,63.583698347975236,NaN,NaN,73.5690411589434,-25.078942812995336,-0.4799685819819275,1.5340896186556279,2.0140582006375554,374624359,371595934.2,71.8399271501253,84.29875996422399,NaN,NaN,20.017337583344883,28.507150216912407
2019-12-09T09:30:00-05:00,280.44,280.72,279.697,279.76,1469588,1931665.85,57.75971976348766,62.26026323981565,NaN,NaN,55.012335071159136,-22.279557147458675,-0.402278412116748,1.5112101854916205,1.9134885976083684,373154771,371749461.6,72.22829677974006,82.95096134479437,NaN,NaN,19.212525593774405,27.179346699321265
2019-12-10T09:30:00-05:00,279.69,280.14,278.63,279.46,1408673,1915502.75,56.743787609609846,61.2447691510041,NaN,NaN,21.825115798089314,7.944593834272823,-0.36908582909409615,1.4521313112407483,1.8212171403348445,371746098,372388844.8,73.84603776436187,81.67258973107687,NaN,NaN,18.255735524585507,25.90454510293044
2019-12-11T09:30:00-05:00,279.13,279.9,278.65,279.72,1923604,1926899.75,57.44242729996392,60.699396505259834,NaN,NaN,18.53420146676582,21.733326781073405,-0.32894436849223285,1.4100366797195534,1.7389810482117862,373669702,373026475.2,75.3859034776138,80.49470616630694,NaN,NaN,17.70827366926295,24.733649183835087
2019-12-12T09:30:00-05:00,279.52,282.95,279.24,281.95,3791831,1986503.95,62.967123606008414,60.71849692905973,NaN,NaN,106.92026164981868,55.172191028955275,-0.1600812392660962,1.538879499129166,1.6989607383952623,377461533,374131292.6,77.82240142212072,79.62573125798427,NaN,NaN,19.011587572057934,23.916211810724064
2019-12-13T09:30:00-05:00,281.93,283.61,281,282.11,3066885,2060521,63.33490032409435,60.53614928652113,NaN,NaN,137.02604821481597,67.86359244012979,-0.051127652743654606,1.635051172465694,1.6861788252093486,380528418,375312104.4,80.09075993549325,79.13607198359877,NaN,NaN,20.15734261044483,23.37923049639846
2019-12-16T09:30:00-05:00,282.93,284.11,282.93,283.07,2120679,2048366.55,65.54582801175025,60.18175119896456,NaN,NaN,162.00559712639284,89.26224485117652,0.06573492732688146,1.7683474843679505,1.702612557041069,382649097,377210969.6,83.08664458006675,79.0767826020326,NaN,NaN,21.79615154759563,23.1530763608552
2019-12-17T09:30:00-05:00,283.19,284,282.91,283.4,1698149,2043579.95,66.29814838138515,59.79598734124527,NaN,NaN,142.23737668286273,113.34469702813121,0.14107363037577048,1.8789545950107822,1.7378809646350117,384347246,379731199.2,86.08046523152706,79.21980585450639,NaN,NaN,23.358621379385273,23.182439934930922
2019-12-18T09:30:00-05:00,283.79,283.91,283.15,283.21,1606536,2027348.8,65.41253065797098,59.26412818788744,NaN,NaN,123.13480898768682,134.26481853231542,0.15292987192855123,1.9290433045457007,1.7761134326171495,382740710,381545400.8,87.76006306464637,79.40083585006126,NaN,NaN,24.401565413497647,23.356600717583312
2019-12-19T09:30:00-05:00,283.65,284.54,283.5701,284.46,1816492,1994738.2,68.40295276611867,59.31806252905539,NaN,NaN,134.46764343369293,139.7742948890903,0.21592389048622795,2.0460182957249344,1.8300944052387065,384557202,382964534.6,88.88944024100455,79.5784460283044,NaN,NaN,26.18738114752825,23.76099792186116
2019-12-20T09:30:00-05:00,284.76,285.0584,284.32,284.46,3638299,2107478.95,68.40295276611867,60.24537704753574,NaN,NaN,132.09215944635991,138.78751713539907,0.22740361242630702,2.11434892077159,1.8869453083452832,384557202,383770291.4,89.48280929700749,79.7756234129178,NaN,NaN,27.6501528771838,24.316591486907253
2019-12-23T09:30:00-05:00,285.34,285.66,285.15,285.33,2566018,2164803.7,70.46424865490873,61.95310968972941,NaN,NaN,139.58152765872248,134.302703241865,0.2609964539404639,2.213190875770863,1.952194421830399,387123220,384665116,90.11422898637976,80.40759886310028,NaN,NaN,29.505198344857693,25.05782103804303
2019-12-24T09:30:00-05:00,285.63,285.63,284.87,285.01,611593,2104606.65,68.68925002820106,63.19139533433383,NaN,NaN,116.93480591004607,129.24218908730168,0.23015049448397296,2.2398825399353655,2.0097320454513925,386511627,385097992.2,90.41405129844293,81.37615494396964,NaN,NaN,30.600482274609064,25.84962978612389
2019-12-26T09:30:00-05:00,285.23,286.1,285.2,286.06,933330,2085984,71.24850541181272,64.54616014763766,NaN,NaN,117.40656589705677,128.09654046917566,0.24743817902987697,2.319029769238739,2.071591590208862,387444957,386038841.6,91.04944711681142,82.72074831038147,NaN,NaN,32.28895121693211,26.76953284766792
2019-12-27T09:30:00-05:00,286.83,286.85,285.9,286.33,1930421,2092981.5,71.88488919379738,65.32837603394486,NaN,NaN,115.36187664855274,124.27538711214763,0.2436471107030278,2.376150478587647,2.132503367884619,389375378,387002476.8,91.65925275990058,84.1364144253654,NaN,NaN,33.884452757215186,27.785949977603245
2019-12-30T09:30:00-05:00,286.34,286.41,284.1184,284.53,2556317,2180202.95,62.02799988615271,65.63325318556379,NaN,NaN,74.06090097127989,112.66913541713161,0.09418513735240985,2.2502347895751313,2.1560496522227215,386819061,387454848.6,91.93697282062259,85.54417699971415,NaN,NaN,32.508336894571,28.46057668002721
2019-12-31T09:30:00-05:00,283.91,285.31,283.56,285.1,1342339,2119694.15,63.724309015711434,66.13186185742818,NaN,NaN,60.05683167481908,96.76419622035094,0.012287702732668215,2.1714092806385565,2.1591215779058883,388161400,387662484.6,92.06753052756629,86.84571219708592,NaN,NaN,31.827976368677657,28.941633778405844
2020-01-02T09:30:00-05:00,286.44,288.63,286.15,288.62,3871798,2121386.45,72.03310756164441,67.17405330469107,NaN,NaN,130.75140212938453,99.52751546421864,0.16526571300067072,2.365703719156727,2.2004380061560562,392033198,388766798.8,92.74077008779905,88.08534552638484,NaN,NaN,33.94801279566838,29.65683078087192
2020-01-03T09:30:00-05:00,285.34,287.11,285.18,286.32,3296709,2189603.5,62.03477450795641,67.1074569405445,NaN,NaN,85.3874818001147,93.12369864483023,0.08564426433985606,2.307493336580876,2.22184907224102,388736489,389025105.2,92.89271704842113,89.16179664254916,NaN,NaN,32.23525824561275,30.02517756154918
2020-01-06T09:30:00-05:00,284.29,287.03,284.16,286.98,1648682,2199242.8,63.59627476174278,67.12612654323367,NaN,NaN,76.64432357855415,85.38018803083051,0.053112953227623105,2.288240263775549,2.235127310547926,390385171,389227063.8,93.01580893994714,90.0850144285816,NaN,NaN,31.414167860972736,30.223604747181117
2020-01-07T09:30:00-05:00,286.3,286.7873,285.58,285.74,1526173,2141205.8,58.71049121690042,66.6378882007444,NaN,NaN,70.4308119747701,84.65417023152854,-0.06957244329043011,2.148161756434888,2.217734199725318,388858998,389635051.2,93.26940830834776,90.81235469488739,NaN,NaN,29.093009021633847,30.062091072102934
2020-01-08T09:30:00-05:00,285.32,288.67,285.0825,287.4,3138656,2224659.2,62.8276161423346,66.38999304081221,NaN,NaN,100.41742754418875,92.72628940540248,-0.05710350800995112,2.146354814712879,2.20345832272283,391997654,390402302,93.73045346971314,91.35878242618638,NaN,NaN,28.52007195644734,29.841802627009276
2020-01-09T09:30:00-05:00,288.95,289.84,288.43,289.56,1790626,2243756.85,67.38487522910707,66.53087479589337,NaN,NaN,175.29226300669686,101.63446158086495,0.07146288423046565,2.292786928010912,2.2213240437804465,393788280,390753318.4,93.93513839545466,91.79985923552984,NaN,NaN,29.621445407992393,29.81032302429258
2020-01-10T09:30:00-05:00,289.96,290.043,287.84,288.24,2989819,2297067.6,62.353904149430164,66.09879989470133,NaN,NaN,145.4851286089005,113.65399094262212,0.04380890213060029,2.2760851714436967,2.2322762693130964,390798461,391165712.8,94.17571978344193,92.17745063141821,NaN,NaN,28.788168880214187,29.66430100370995
2020-01-13T09:30:00-05:00,288.79,289.08,288.14,289.02,1471574,2181054.75,64.06138590691089,65.78868797618648,NaN,NaN,134.11847440209962,125.1488211073312,0.05360592799107211,2.2992836793019364,2.2456777513108643,392270035,391542685.6,94.39461123889157,92.52829362726709,NaN,NaN,28.684839567028103,29.52437794132683
2020-01-14T09:30:00-05:00,288.87,290.49,288.72,289.22,2202118,2137816.4,64.50592713165396,65.36309358166828,NaN,NaN,149.47615501259187,140.95788971489554,0.04922652004254413,2.3072109013640443,2.2579843813215,394472153,392665316.6,94.99755966202495,92.87710296124176,NaN,NaN,28.74098265507087,29.41246432900455
2020-01-15T09:30:00-05:00,289.01,291.242,288.9527,290.35,2195108,2141537.85,66.99034600431632,65.24174329424794,NaN,NaN,152.8222265443006,151.43884951491793,0.0954294039807615,2.377271136297452,2.2818417323166904,396667261,393599238,95.43726122600852,93.23590367035357,NaN,NaN,29.556030880436225,29.43297383635193
2020-01-16T09:30:00-05:00,291.63,292.97,291.47,292.93,2522044,2182732.6,71.83730304880586,65.28380026831888,NaN,NaN,196.81881892944614,155.74416069946778,0.2632323666296221,2.610882190603718,2.3476498239740957,399189305,394679443,95.88751836158858,93.58148018783766,NaN,NaN,31.90561226175428,29.786207897123695
2020-01-17T09:30:00-05:00,293.52,293.61,292.79,293.27,2147389,2209775.25,72.4121989063142,65.32146524778436,NaN,NaN,184.67157371662813,163.5814497210133,0.35490386748443736,2.7912796583296426,2.4363757908452053,401336694,396787089.6,96.59380474154408,93.93394818652646,NaN,NaN,33.949052273678916,30.3808999509173
2020-01-21T09:30:00-05:00,292.44,293.28,291.37,291.83,4476910,2342796.15,66.24437192294882,65.6226346789841,NaN,NaN,131.22433536757666,163.00262191410872,0.27964773214439376,2.7859354560256975,2.5062877238813037,396859784,397705039.4,96.84773010163791,94.28471656374185,NaN,NaN,33.747878382126544,30.86189686966148
2020-01-22T09:30:00-05:00,292.5,293.0693,291.58,291.81,2077014,2264731.9,66.16008335455854,65.79661856033032,NaN,NaN,114.9910139361115,156.10559369881267,0.19369334820508755,2.748404409137663,2.5547110609325756,394782770,397767162.8,96.86476453409438,94.62737613563672,NaN,NaN,33.56333144089499,31.247816094123408
2020-01-23T09:30:00-05:00,290.75,291.86,289.6,291.54,1872554,2230058.7,64.9584450523102,65.2912855239493,NaN,NaN,74.05448527986007,140.35204544592455,0.08914349786722386,2.666140433266605,2.5769969353993813,392910216,397015753.8,90.49484462603657,94.46695288836796,NaN,NaN,33.070166370895244,31.508151847947957
2020-01-24T09:30:00-05:00,292.54,292.77,288.34,289.8,3612534,2380105.75,57.686923955553524,64.98072477020624,NaN,NaN,49.00776136635794,110.78983393330688,-0.11559609651557334,2.4325018147549144,2.548097911270488,389297682,395037429.2,76.27330675485659,93.27985215311334,NaN,NaN,30.450882885501535,31.357113424741325
2020-01-27T09:30:00-05:00,284.85,286.645,283.86,285.36,4129077,2539893.1,44.11612511529448,63.58928550974565,NaN,NaN,-96.2197330498173,54.61157258001781,-0.5444441190352443,1.8675427624764325,2.4119868815116767,385168605,391803811.4,59.74584234042482,90.90342596743317,NaN,NaN,23.013505326753386,30.165169410743047
2020-01-28T09:30:00-05:00,286.22,288.19,285.75,287.29,2999200,2593332.05,49.65984872656243,62.94281104615008,NaN,NaN,-46.21345626618291,19.124014253265898,-0.6835186238355702,1.5575886017172138,2.241107225552784,388167805,390065415.6,53.08607670159275,88.0331879955221,NaN,NaN,18.791869603489967,28.540412295421177
2020-01-29T09:30:00-05:00,288.99,289.28,287.2139,287.29,2137029,2572367.65,49.65984872656242,62.00225623073777,NaN,NaN,-27.169887798416664,-9.308166093639741,-0.7552884001867617,1.2969967253193317,2.0522851255060934,388167805,388742422.6,48.642237203837524,84.81260111938812,NaN,NaN,15.577133199503598,26.688515281718665
2020-01-30T09:30:00-05:00,285.67,288.77,284.85,288.54,3433177,2676909.55,53.15076649540578,60.985534178330546,NaN,NaN,-51.55285358528984,-34.42963386666975,-0.6996170515697866,1.1777638110438602,1.8773808626136468,391600982,388480575.8,47.78955899312194,81.5164883049358,NaN,NaN,14.022222472673368,24.87904488042648
2020-01-31T09:30:00-05:00,286.96,287.23,281.61,282.42,4885760,2727607.65,38.92010235895708,59.311691193296745,NaN,NaN,-152.36730963840134,-74.7046480676216,-1.0357280724123243,0.5827207720982415,1.6184488445105658,386715222,387964083.8,46.0739127974399,78.08064494879281,NaN,NaN,6.939567893552874,22.31626245373025
2020-02-03T09:30:00-05:00,283.69,286.26,283.5006,283.98,3169335,2721238.95,43.10197397732327,57.81459034118335,NaN,NaN,-119.70097337409528,-79.40089613247719,-1.107300905333749,0.23432271284337958,1.3416236181771286,389884557,388907274.2,49.630112533622885,74.88318075555932,NaN,NaN,2.9941238127607765,19.555956933591755
2020-02-04T09:30:00-05:00,287.68,289,287.4238,288.04,3004116,2789010.65,52.26246058282816,56.940057016267225,NaN,NaN,-18.361939707418234,-73.83059282072426,-0.8472464385609138,0.28256556997598636,1.1298120085369001,392888673,389851447.8,52.97335875068284,71.88145211903489,NaN,NaN,3.195284577313929,17.218718025552064
2020-02-05T09:30:00-05:00,290.76,293.04,289.95,292.86,3305903,2877997.15,60.411339114068916,56.47012795267812,NaN,NaN,89.09503043600421,-50.57760917384009,-0.34253441938078444,0.7016439843109197,1.0441784036917041,396194576,391456802,58.069391865593545,69.21231859329097,NaN,NaN,6.729565881135792,15.720267719206882
2020-02-06T09:30:00-05:00,294.02,294.14,292.45,293.74,2857207,2863924.7,61.69689829748934,55.74581332758408,NaN,NaN,119.72317831543171,-16.32240279369578,0.03840548558906565,1.0921852606780362,1.0537797750889706,399051783,392946962.2,62.167642028974065,66.80375599810421,NaN,NaN,9.812919620012448,14.876360847893391
2020-02-07T09:30:00-05:00,292.76,292.81,290.66,291.19,3839279,2966357.35,56.0200540536677,54.57494583810933,NaN,NaN,58.51956232257391,25.854971598499265,0.10281580717951244,1.182299534063361,1.0794837268838486,395212504,394646418.6,66.22234087063137,64.63436572161044,NaN,NaN,10.18443076979265,14.206085122450428
2020-02-10T09:30:00-05:00,290.2,292.96,290.16,292.95,2877674,2960750.1,58.8353572225459,54.04573050236626,NaN,NaN,65.10101412914851,62.81536909914803,0.24027481564607056,1.3798272464414367,1.1395524307953662,398090178,396287542.8,69.60959503805161,62.68878464563999,NaN,NaN,11.483837274049872,13.81719257267892
2020-02-11T09:30:00-05:00,294.35,294.42,292.28,292.94,1994456,2986894.2,58.81232102402088,53.520890335899274,NaN,NaN,88.29975411960696,84.14770786455307,0.3028085976295838,1.518063177832346,1.2152545802027621,396095722,396928952.6,70.84037113759882,60.82989940303316,NaN,NaN,12.460403080727463,13.62336550240014
2020-02-12T09:30:00-05:00,294.63,295.87,294.53,295.72,2804383,3017007.45,63.13378100747653,53.39055718983973,NaN,NaN,128.94533017071635,92.1177678114955,0.49246369501803855,1.8308341989753103,1.3383705039572718,398900105,397470058.4,71.87518795236412,59.49992392634226,NaN,NaN,14.742028426378436,13.783174491539897
2020-02-13T09:30:00-05:00,294.39,295.84,293.92,294.82,2637966,3039150.35,60.90583592371624,53.62047947327993,NaN,NaN,103.80666081382469,88.9344643111741,0.5158825093327266,1.98322364062318,1.4673411312904534,396262139,396912129.6,69.15025062725854,58.9911342029424,NaN,NaN,15.85786385598068,14.07955868646001
2020-02-14T09:30:00-05:00,294.97,295.13,293.4,294.54,1861714,3006133.85,60.19413575146529,54.768908804434986,NaN,NaN,87.57834152704818,94.74622015206896,0.4722711399805348,2.057680056266122,1.585408916285587,394400425,396749713.8,68.33802973431473,59.604861873934524,NaN,NaN,16.53312079053869,14.430067558471249
2020-02-18T09:30:00-05:00,293.15,293.88,291.76,292.95,2414999,3019514.35,56.1795546900035,55.234602087537915,NaN,NaN,54.43719739761125,92.6134568057615,0.30425518908245985,1.9657279026386618,1.661472713556202,391985426,395528763.4,62.404030724936256,60.27043001845907,NaN,NaN,15.906353769046714,14.640965588553458
2020-02-19T09:30:00-05:00,293.77,294.72,293.385,294.1,1474385,2869388.1,58.343537630450115,55.85486558067276,NaN,NaN,77.66258076930436,90.48602213570098,0.2412394701078302,1.9630220511909897,1.7217825810831595,393459811,395001581.2,59.98214092073306,61.08042314109447,NaN,NaN,16.017241170446,14.837576385966678
2020-02-20T09:30:00-05:00,293.56,294.2925,290.17,292.78,3493860,2940230.4,54.98695392199532,55.98602182542915,NaN,NaN,40.54705625421581,72.80636735240087,0.08915978724782159,1.8332323151429364,1.7440725278951148,389965951,393214750.4,52.539380196770004,61.41969608421219,NaN,NaN,15.129993674106695,14.879350284272395
2020-02-21T09:30:00-05:00,290.8,291.05,288.75,289.74,3272935,3010249.45,48.12068428923747,56.6432062490206,NaN,NaN,-14.816885781079403,49.08165803342005,-0.22074078940126007,1.4681465411435397,1.6888873305447998,386693016,391300925.8,45.96118577412563,61.411644153975466,NaN,NaN,12.197814144989252,14.49627369294623
2020-02-24T09:30:00-05:00,280.33,282.7799,278.97,279.56,6595237,3159384.6,33.17938414062064,55.93444983211327,NaN,NaN,-178.5920796951876,-4.152426211027118,-1.068469951211965,0.35329989152984353,1.4217698427418086,380097779,388440396.6,38.25205419070817,60.59892570091012,NaN,NaN,3.121541162343672,12.871311902860151
2020-02-25T09:30:00-05:00,280.8,281.36,269.8835,270.7,9903677,3448114.6,25.700073272991588,54.03713645283923,NaN,NaN,-243.3815805269891,-63.71618179594718,-2.122185711875271,-1.2309622971022804,0.8912234147729908,370194102,384082131.8,29.99664165680504,58.957731622775995,NaN,NaN,-8.234157985628826,9.856244775933156
2020-02-26T09:30:00-05:00,271.99,275.31,268.83,269.74,7514831,3673896.15,25.041394055635934,51.5107118058083,NaN,NaN,-223.35293787813765,-123.91928552543558,-2.7407759260482263,-2.534746492787292,0.20602943326093426,362679271,377926023.8,22.582853975318713,56.422978916327786,NaN,NaN,-16.549509675636266,6.083994139994667
2020-02-27T09:30:00-05:00,264.86,267.73,257.39,257.5,11188868,4126488.1,18.52294245873351,48.42685781732574,NaN,NaN,-255.50018639133026,-183.1287340545448,-3.7678268213906425,-4.503754093477369,-0.7359272720867263,351490403,370230914.2,16.945111800511214,53.19279818572329,NaN,NaN,-27.151646695192206,1.3360454492536862
2020-02-28T09:30:00-05:00,250.52,255.12,247,254.56,17555116,4832585.05,17.354395853572512,45.665025088747505,NaN,NaN,-242.10073829097738,-228.5855045565244,-4.394961340453517,-6.229628947653623,-1.8346676072001056,333935287,359679368.4,12.380909423068744,49.34698165375453,NaN,NaN,-35.25795117764828,-3.891668354589452
2020-03-02T09:30:00-05:00,256.71,267.25,254.06,267.03,8544492,5015521.65,35.8423321395794,44.022666154249904,NaN,NaN,-137.3480612929231,-220.33670087607146,-3.7451133894177566,-6.516059343972302,-2.770945954554545,342479779,352155768.4,10.259028600808918,45.107655479665766,NaN,NaN,-33.816563104303675,-8.166653318834342
2020-03-03T09:30:00-05:00,267.8,271.02,257.18,259.3,11482599,5431184.85,31.185233831730102,42.04930278337198,NaN,NaN,-116.38041665253998,-194.93646810118167,-3.6095246069455955,-7.282851713236539,-3.6733271062909436,330997180,344316384,8.60430588629076,40.66222224742948,NaN,NaN,-34.78010591452177,-11.96857511821826
2020-03-04T09:30:00-05:00,265.45,271.11,262.96,270.89,5408159,5551387,43.11894253681299,40.619671464038866,NaN,NaN,-74.04488649059694,-165.07485782367354,-2.5621871948321973,-6.87606109983119,-4.313873904998993,336405339,339061597.6,7.70695998714065,36.07877739277066,NaN,NaN,-30.09246791087763,-14.557702660026742
2020-03-05T09:30:00-05:00,264.27,266.5299,259.56,261.46,5872852,5679734.45,37.43119368486157,38.94291130412068,NaN,NaN,-91.97096192418768,-132.369012930245,-2.3338941135049645,-7.231241546880199,-4.897347433375234,330532487,334870014.4,7.073276508829224,31.64470781288285,NaN,NaN,-29.058199520444283,-16.62920221151496
2020-03-06T09:30:00-05:00,253.67,260.1,252.43,258.85,7372397,5905493.95,36.01516761755709,37.215842151698666,NaN,NaN,-104.36351605205971,-104.8215684824615,-2.1903737677292465,-7.635314643036793,-5.444940875307546,323160090,332714975,6.765286057934063,27.246654693141377,NaN,NaN,-28.896991609673776,-18.38174355410908
2020-03-09T09:30:00-04:00,241.5,247.0714,237.1701,238.72,10406911,6233875.55,27.404340389753216,35.16046970168079,NaN,NaN,-154.75867662807693,-108.30369154949226,-3.2206040691598146,-9.470695961757315,-6.2500918925975,312753179,326769655,5.99033791627626,23.217105206808522,NaN,NaN,-32.61945010769857,-20.41570163319329
2020-03-10T09:30:00-04:00,247.29,250.54,237.09,250.47,9407066,6560345.15,36.88940863128059,33.62803191602582,NaN,NaN,-118.75695971071342,-108.77900016112694,-2.89066463151274,-9.863422681988425,-6.972758050475685,322160245,325002268,5.778434585902474,19.34541189717777,NaN,NaN,-31.25778924070119,-21.964571291408703
2020-03-11T09:30:00-04:00,243.54,244.91,233.6,235.84,7732616,6847253.15,31.390040171353306,31.942538076694245,NaN,NaN,-135.6858656379422,-121.10719599059598,-3.4024146848924985,-11.225776406591308,-7.823361721698809,314427629,320606726,5.278343018182355,15.969623527278653,NaN,NaN,-32.617883812113504,-23.486473080080817
2020-03-12T09:30:00-04:00,220.5,229,211.83,212.11,17322591,7573163.55,24.904726364942505,30.28425536781603,NaN,NaN,-189.65107102619822,-140.64321781099807,-4.987878571023765,-14.058209935478516,-9.07033136445475,297105038,313921236.2,4.622999964646112,13.016895969458684,NaN,NaN,-36.76320014593127,-25.38314837520231
2020-03-13T09:30:00-04:00,225.65,232.48,213.2946,232.11,13676016,8125066.05,36.76313463543539,30.540237546017085,NaN,NaN,-141.98574629702605,-148.16766385999136,-4.361098026510373,-14.521703897592715,-10.160605871082343,310781054,311445429,4.404890514326283,10.59924142114569,NaN,NaN,-34.408549674785895,-26.672491417999964
2020-03-16T09:30:00-04:00,206.5,218.31,201.51,202.49,12407034,8652332.05,29.366886932859103,30.802152807436194,NaN,NaN,-180.71342125643002,-153.35861278566196,-5.537275057085273,-17.082199692438934,-11.544924635353661,298374020,308569597.2,4.1594117914038975,8.753725002188466,NaN,NaN,-36.09570445511594,-28.018664709016534
2020-03-17T09:30:00-04:00,207.01,214.47,199.35,213.47,16128070,9337985.6,34.618086333167966,31.48620225583134,NaN,NaN,-149.3445803494344,-159.47613691340615,-5.178236102221984,-18.01771976313114,-12.839483660909156,314502090,307037966.2,4.03058040636617,7.428562604406143,NaN,NaN,-34.939794674445764,-29.00739756122071
2020-03-18T09:30:00-04:00,199.07,205.44,189.67,199.39,13369843,9932758.5,31.3948404242324,32.40562353908126,NaN,NaN,-157.14813388591017,-163.76859056299978,-5.46324333280398,-19.668537826914132,-14.205294494110152,301132247,304378889.8,3.809947589505356,6.490336589334295,NaN,NaN,-35.4415839957583,-29.926567051868936
2020-03-19T09:30:00-04:00,198.37,204.98,192.32,201.31,13532072,10434669.1,32.320246631258414,33.47461288034454,NaN,NaN,-133.51746832359478,-152.5418700224791,-5.103451227457228,-20.584608528431687,-15.48115730097446,314664319,307890746,10.757989931600733,6.37441376851515,NaN,NaN,-35.44675109370787,-30.71516477213164
2020-03-20T09:30:00-04:00,203.29,205.29,191,191.9,12205979,10881321.3,30.172144683025536,33.06959949059068,NaN,NaN,-125.85031571791485,-149.31478390665686,-5.069794620264577,-21.81840057630518,-16.748605956040603,302458340,306226203.2,10.375445424174998,6.38272925589844,NaN,NaN,-36.230873182038316,-31.503123116404023
2020-03-23T09:30:00-04:00,190.13,191.2,182.1,186.13,15712333,11337176.1,28.903607653012543,32.906626192110856,NaN,NaN,-131.9870418798113,-139.5695080313331,-4.9984663762344255,-22.996688926333633,-17.998222550099207,286746007,303900600.6,9.848522446417334,6.471601867336056,NaN,NaN,-37.2750114422944,-32.32767859153122
2020-03-24T09:30:00-04:00,196.27,207.21,196.205,206.64,14123621,11548173.3,38.759779050224665,32.595257371640265,NaN,NaN,-77.99806226904286,-125.3002044152548,-3.2187447033864096,-22.02165342933222,-18.80290872594581,300869628,301174108.2,9.255085870385898,6.582182287567856,NaN,NaN,-34.64287254913703,-32.65842058547491
2020-03-25T09:30:00-04:00,210.57,220.17,205.32,212.06,17556067,12050235.1,41.084179358044395,32.85618491972475,NaN,NaN,-48.11263533461044,-103.49310470499486,-1.4172034541217187,-20.574413043597957,-19.15720958947624,318425695,304632797.8,16.15688941752566,7.231011781046173,NaN,NaN,-31.80661458832531,-32.536734014453536
2020-03-26T09:30:00-04:00,214.43,225.87,214.01,225.07,16071887,12294386.05,46.34823953899959,33.59426148554207,NaN,NaN,-19.239541403116935,-80.63751932089927,0.7911802754520423,-18.168234245161187,-18.95941452061323,334497582,308599450.4,23.35655885368527,8.416102695028403,NaN,NaN,-27.66491007822005,-31.84075916642018
2020-03-27T09:30:00-04:00,217.61,223.26,214.57,216.35,10545574,11943908.95,43.54020007885522,34.7468228919065,NaN,NaN,-25.691677708879116,-60.60579171909211,1.750236770904671,-16.77161855698239,-18.52185532788706,323952008,312898184,30.33795734971416,10.155218368845398,NaN,NaN,-25.226679115401513,-30.895890587703228
2020-03-30T09:30:00-04:00,217.36,223.72,215.1,223.1,7691810,11901274.85,46.25465592923289,35.41576912747452,NaN,NaN,-12.931317139860312,-36.79464677110191,2.8592339488652847,-14.947812891805455,-17.80704684067074,331643818,321877746.2,42.18493944150649,12.755683001388544,NaN,NaN,-22.386058500424337,-29.680200289520528
2020-03-31T09:30:00-04:00,221.95,224.75,218.44,219.23,8426574,11748473.6,44.92117612800871,36.38227883866419,NaN,NaN,-6.3175577549700455,-22.458545868287352,3.319815214911902,-13.657277822030863,-16.977093036942765,323217244,326347269.4,47.01502656297425,15.736874683159394,NaN,NaN,-20.499420106765182,-28.36866026341262
2020-04-01T09:30:00-04:00,210.65,214.78,207.767,209.38,8570347,11906583,41.631430842130946,37.577043444177654,NaN,NaN,-38.19802505094111,-20.475623811553497,2.960641358199908,-13.27629133919288,-16.23693269739279,314646897,325591509.8,46.31049482712996,18.714552887622524,NaN,NaN,-19.894588618804796,-27.15807859989722
2020-04-02T09:30:00-04:00,208.31,214.79,207.18,213.96,8231894,12024535.1,43.6961600465704,38.07225954497301,NaN,NaN,-25.2079259905528,-21.669300729040668,3.0206303472715383,-12.461144763303366,-15.481775110574905,322878791,323267751.6,44.121205349945654,21.5514325187382,NaN,NaN,-18.788503114566076,-25.962424959135628
2020-04-03T09:30:00-04:00,212.73,214.55,208.69,210.6,6664520,11989141.25,42.50816429722365,39.0109222138562,NaN,NaN,-20.270452542758488,-20.58505569581654,2.8266008873279507,-11.948524001414967,-14.775124888742917,316214271,321720204.2,42.6743394421432,24.30249877950529,NaN,NaN,-18.212606537553803,-24.855308041766797
2020-04-06T09:30:00-04:00,218.95,227.91,218.12,226.53,10322481,11984919.75,49.516037431805664,40.075061578044604,NaN,NaN,63.42402101688561,-5.313988064467355,3.7081292694634236,-10.139963301913639,-13.848092571377062,326536752,320698791,41.702301694446646,26.99333601436818,NaN,NaN,-15.578043403989044,-23.529984522084263
2020-04-07T09:30:00-04:00,235.46,236.16,226.45,226.6,10857730,12057452.95,49.54514125192717,41.37151163716566,NaN,NaN,112.37423699747592,18.424370886021837,4.196985570717217,-8.60186060798054,-12.798846178697758,337394482,323534238.6,45.41904282496773,29.965414245472637,NaN,NaN,-13.454113378314759,-22.09057435868862
2020-04-08T09:30:00-04:00,229.14,235.25,226.84,234.33,7010161,12021330.2,52.78232462299289,42.83308863657526,NaN,NaN,135.22257999475136,53.10849189516033,4.8933734896530385,-6.68212931663146,-11.575502806284499,344404643,329485787.8,52.2940968217865,32.93227902334305,NaN,NaN,-10.695308541317338,-20.462679241921293
2020-04-09T09:30:00-04:00,237.84,240.19,235.105,237.14,9418378,11626119.55,53.93925382877181,44.530739289842856,NaN,NaN,148.6565818541961,87.88139346411012,5.358196506565783,-4.877757173077271,-10.235953679643053,353823021,335674633.8,58.19153646348845,36.347714097579725,NaN,NaN,-8.073546321581643,-18.6928031104442
2020-04-13T09:30:00-04:00,236.41,236.69,230.96,233.96,6761902,11280413.85,52.37526411629848,46.20728618007757,NaN,NaN,118.58636457782546,115.65275688822689,5.259032118459965,-3.6621635315680976,-8.921195650028062,347061119,341844003.4,63.08991381102394,40.15067062362305,NaN,NaN,-6.276899561007462,-16.91910260338181
2020-04-14T09:30:00-04:00,238.7,240.47,236.88,239.68,5391925,10929658.4,54.9079566261104,47.36072743549797,NaN,NaN,129.57951094915194,128.88385487468017,5.367560522212507,-2.2117449972624286,-7.579305519474936,352453044,347027261.8,66.62762150047547,44.24870888291516,NaN,NaN,-4.030985036269719,-15.077942950937224
2020-04-15T09:30:00-04:00,234.48,236.58,232.3908,235.08,6828004,10464655.1,52.49040213363497,48.17545763375444,NaN,NaN,94.45306114319308,125.2996197038236,4.929745459190196,-1.4171236954871915,-6.346869154677387,345625040,348673373.4,67.68686800481872,47.929421639150384,NaN,NaN,-2.741520623509182,-13.31559690416179
2020-04-16T09:30:00-04:00,235.7,236.06,232.18,235.34,6126358,10102480.85,52.61738940012322,48.62325405240613,NaN,NaN,86.29343703940991,115.5137911127553,4.471361843751329,-0.757666849988226,-5.229028693739555,351751398,350142724.4,68.64359302614227,51.164209794325885,NaN,NaN,-1.6322495686556753,-11.646547284803773
2020-04-17T09:30:00-04:00,241.6,242.6598,238.25,242.43,5924520,9722103.25,56.065948297529545,49.51795035374001,NaN,NaN,113.2961631026549,108.44170736244708,4.449798990470405,0.333220044348451,-4.116578946121954,357675918,350913303.8,69.15930680359202,53.93716332674573,NaN,NaN,0.2704838574532129,-9.944114264481346
2020-04-20T09:30:00-04:00,238.24,241.11,236.26,236.64,7357417,9479675.15,52.69315389712844,49.97784306573255,NaN,NaN,87.36024109504477,102.19648266589094,3.871043786712942,0.7222257872692239,-3.148817999443718,350318501,351564780.2,69.61431317201767,55.89640430749653,NaN,NaN,1.0459020987029202,-8.374111926883593
2020-04-21T09:30:00-04:00,231.33,233.34,229.41,230.22,6571408,9022628.9,49.16166058770498,50.280734812853716,NaN,NaN,38.39570201046125,83.9597208781528,2.9243624963883206,0.5066351210416826,-2.417727375346638,343747093,349823590,66.77859647167247,57.30808787240354,NaN,NaN,0.7683888674518363,-7.068040384835674
2020-04-22T09:30:00-04:00,234.4,236.27,233.39,234.77,4327266,8532811.15,51.635610790348714,50.99531909486927,NaN,NaN,58.29173859910644,76.72745636933546,2.4901134188844547,0.6949143982589305,-1.7951990206255242,348074359,350313453.8,67.18360943721467,58.799024630266736,NaN,NaN,1.1929676649971754,-5.887896377716696
2020-04-23T09:30:00-04:00,235.51,238.92,234.83,235.07,6364822,7973248.9,51.802152027403515,51.574318522071636,NaN,NaN,63.77096583774823,72.22296212900314,2.1229104357154536,0.8584390240187929,-1.2644714116966607,354439181,350851010.4,67.64969205197326,60.479630823268714,NaN,NaN,1.5903036114985947,-4.819582093543083
2020-04-24T09:30:00-04:00,236.61,238.33,234.2,237.83,3572511,7348280.1,53.392260067247214,52.35175393421618,NaN,NaN,62.71304438577475,62.1063383856271,1.9691329434165479,1.1969447675740241,-0.7721881758425237,358011692,350918165.2,67.71138833620678,62.26799145855897,NaN,NaN,2.3405382296334096,-3.796707761660727
2020-04-27T09:30:00-04:00,239.12,242.19,238.45,241.32,3632509,7002626.85,55.39614336502541,52.77176150087473,NaN,NaN,88.28618162340867,62.29152649129988,1.999286526601936,1.7269199824098962,-0.27236654419203976,361644201,353183305.2,69.80329732029757,64.27520543183404,NaN,NaN,3.5102991662032275,-2.7528496291087334
2020-04-28T09:30:00-04:00,245.01,245.16,240.36,241.09,4709897,6853531.2,55.22762089769983,53.1776529041442,NaN,NaN,95.5107761024524,73.7145413096981,1.901185356096881,2.1041151509290614,0.2029297948321805,356934304,355820747.4,72.07213649070228,66.17899783652936,NaN,NaN,4.459712073633631,-1.7224836715741099
2020-04-29T09:30:00-04:00,245.48,247.665,244.2,246.45,5015346,6682969.8,58.40345070157992,53.57916190975756,NaN,NaN,121.99526183693082,86.45524595726299,2.0802467708924546,2.803238258447749,0.7229914875552941,361949650,358595805.6,74.26328182261244,67.74822533658836,NaN,NaN,6.129089577429045,-0.6008303502879451
2020-04-30T09:30:00-04:00,244.2,245.17,241.91,243.22,4928857,6500895.3,55.8332763967355,53.714449236040686,NaN,NaN,99.3304374657123,93.5671402828558,1.8707065939990657,3.0613747300541263,1.1906681360550606,357020793,359112128,74.66161452601796,68.9246594839119,NaN,NaN,6.936834601419322,0.4759789285273788
2020-05-01T09:30:00-04:00,239.58,240.33,236.5,237.28,4723466,6325473.9,51.357232959476704,53.64173272483913,NaN,NaN,36.097063843716704,88.2439441744442,1.251373322541797,2.7548847892323067,1.5035114666905098,352297327,357969255,72.00506726486171,69.56145615918602,NaN,NaN,6.475791627368845,1.3330950283618739
2020-05-04T09:30:00-04:00,235.21,237.7497,233.64,237.42,3845484,6184522.1,51.45601156897723,53.395165220758194,NaN,NaN,-4.346812277199647,69.71734539432254,0.7928154149954381,2.4945307354348074,1.7017153204393693,356142811,356868977,69.44330006647478,69.7625760567574,NaN,NaN,6.113404548245777,2.0159963883452887
2020-05-05T09:30:00-04:00,240.02,241.735,238.7,238.8,3143466,5825571.35,52.48037340526967,53.39444888301782,NaN,NaN,49.756948338006296,60.566579841433295,0.5363936704896843,2.372207408551475,1.8358137380617905,359286277,357339371.6,69.93576056809202,69.92321123984834,NaN,NaN,6.0549640217874785,2.5929917645513156
2020-05-06T09:30:00-04:00,240.34,240.54,236.6017,236.86,3082265,5436798.1,50.85570425464295,53.26861422976923,NaN,NaN,6.702541242455917,37.50803572253831,0.2070118149624114,2.0945785067648046,1.8875666918023932,356204012,356190244,67.0911626786249,69.81232335788282,NaN,NaN,5.596867592164361,3.0221168827817504
2020-05-07T09:30:00-04:00,239.24,241.18,238.55,238.91,3411516,5256865.85,52.528108898822424,53.015911415575864,NaN,NaN,36.02997356474575,24.847942942345004,0.10332737329551778,2.0167259084217903,1.9133985351262726,359615528,356709191,67.72952374181577,69.71019599632737,NaN,NaN,5.6056644647652165,3.3911951087793883
2020-05-08T09:30:00-04:00,242.27,243.8,241.34,243.62,3904446,4981169.25,56.21488272610839,53.26746347478872,NaN,NaN,102.98924849894625,38.22637987339091,0.3160604896836763,2.308474147230868,1.9924136575471916,363519974,358953720.4,70.40363346904977,69.76657601754395,NaN,NaN,6.5576676443519295,3.8435483281468943
2020-05-11T09:30:00-04:00,241.68,243.94,241,242.56,2742952,4780221.75,55.17632092836004,53.6970820705498,NaN,NaN,84.27113518770838,55.949969366372514,0.3470178939317048,2.4261860249618223,2.0791681310301176,360777022,359880562.6,71.45550195449522,70.10064069488843,NaN,NaN,7.1136409755496715,4.310704420633005
2020-05-12T09:30:00-04:00,243.81,244.14,237.94,238.08,6433919,4832321.45,50.896498302068856,53.64428832138695,NaN,NaN,27.173856581633174,51.43335101509788,0.04337163087452467,2.1333826696232734,2.0900110387487487,354343103,358891927.8,68.65268118519589,70.2055743911728,NaN,NaN,6.495923913713317,4.622878633930193
2020-05-13T09:30:00-04:00,236.96,237.5,231.0233,232.82,7531319,4867487.2,46.35058961392333,53.25489100613836,NaN,NaN,-109.80008783612871,28.132825199380953,-0.5039567201359261,1.460065138578841,1.964021858714767,346811784,357013482.2,63.55191184569552,69.9128758050101,NaN,NaN,4.683379194662927,4.631521571177727
2020-05-14T09:30:00-04:00,230.08,236.76,228.3,236.75,6964490,4909393.8,49.94765802056569,53.008848002803965,NaN,NaN,-104.72494833612829,-0.01815918079385028,-0.5876954766022617,1.22940251296194,1.8170979895642017,353776274,355845631.4,60.54031864520242,69.40065654136694,NaN,NaN,4.0715753149297615,4.551529248856589
2020-05-15T09:30:00-04:00,234.16,237.25,233.41,236.91,4811095,4853722.55,50.09436320470992,52.63014941992429,NaN,NaN,-57.29290190754323,-32.07458926209175,-0.6157286481684068,1.0474371793536932,1.6631658275221,358587369,354859110.4,58.03832493950102,68.56030137131005,NaN,NaN,3.6011862500144023,4.415765963307705
2020-05-18T09:30:00-04:00,243.51,247.2,243.361,245.93,5234302,4747566.8,57.63340066912311,52.801990832168805,NaN,NaN,130.10438308163282,-22.907939683306846,-0.040549221576742456,1.612479300551172,1.6530285221279144,363821671,355468040.2,59.16026587346731,67.6380248986504,NaN,NaN,5.350405143204962,4.549285846150171
2020-05-19T09:30:00-04:00,245.45,246.02,242.07,242.22,4404718,4639232.3,54.01877688525101,52.48879984528816,NaN,NaN,83.00833054799057,-11.741044890035369,0.07025387886875256,1.740845870713855,1.6705919918451024,359416953,356482810.2,61.03021693193208,66.69280597788752,NaN,NaN,5.7943326091849165,4.727149669440848
2020-05-20T09:30:00-04:00,245.4,246.58,244.73,245.73,3280550,4586896.5,56.780537952636614,52.55646138499539,NaN,NaN,117.13300506070391,33.64557368933116,0.34478982289415216,2.1015792704627927,1.7567894475686405,362697503,359659954,66.2419131742112,66.09139873847283,NaN,NaN,6.983125828855982,5.049431977928725
2020-05-21T09:30:00-04:00,245.55,247.38,243.88,245.02,3378211,4437565.95,56.04721456982959,52.89146007144916,NaN,NaN,99.90038457325383,74.57064027120758,0.4374623263474935,2.3036173555030075,1.866155029155514,359319292,360768557.6,67.85723278760621,65.7951248472403,NaN,NaN,7.757104305983852,5.436242310508029
2020-05-22T09:30:00-04:00,244.91,245.1,243.17,244.88,2521101,4384995.45,55.89392415413447,53.20845382753182,NaN,NaN,71.228440604178,100.27490877355183,0.44666730601027815,2.4244891616683617,1.9778218556580835,356798191,360410722,66.74702442570211,65.60253373004225,NaN,NaN,8.357037017285107,5.853498697190469
2020-05-26T09:30:00-04:00,250.84,252.02,249.88,250.25,4872320,4446986,60.37109784061312,53.77207700148493,NaN,NaN,167.56215499584798,107.76646315639486,0.7536912010448034,2.919935856964088,2.1662446559192845,361670511,359980490,65.3623744036875,65.27586328972764,NaN,NaN,10.164760636115261,6.4693932598940105
2020-05-27T09:30:00-04:00,253.73,255.79,250.33,255.77,5326092,4477795.75,64.37439017727823,54.7376974245303,NaN,NaN,188.42521543187567,128.84984013317188,1.239142357481934,3.715172602771702,2.476030245289768,366996603,361496420,67.88998267978619,65.33292186123916,NaN,NaN,12.970855880560642,7.398173634274958
2020-05-28T09:30:00-04:00,257.87,257.94,253.8877,254.35,4971255,4475591.2,62.62186128756747,55.45867973801209,NaN,NaN,185.33149275529408,142.4895376720899,1.3652612698852828,4.182606832646371,2.8173455627610884,362025348,361361989,67.42013591174776,65.31082273052002,NaN,NaN,14.809603839568735,8.456949377888355
2020-05-29T09:30:00-04:00,253.27,255.32,250.68,254.29,5132697,4485783.2,62.54438158408376,55.91078679929604,NaN,NaN,135.75943234567475,149.6613472265741,1.3432266475548222,4.496378872204616,3.153152224649794,356892651,360876660.8,65.6535706841405,64.97153253159793,NaN,NaN,16.30256106246505,9.577751047113598
2020-06-01T09:30:00-04:00,253.78,255.55,252.7,255.27,2079746,4353597.2,63.34217092359076,56.494061798955386,NaN,NaN,129.8221505127607,161.38008920829063,1.292796236310966,4.769147520038501,3.4763512837275354,358972397,361311502,66.50052102783916,64.61760532255107,NaN,NaN,17.781213690624057,10.749674281900806
2020-06-02T09:30:00-04:00,256.55,257.92,255.71,257.85,3045777,4313611.85,65.42979150236557,57.53215417040515,NaN,NaN,140.64507457612,155.99667312434502,1.3263732581636898,5.134317856432148,3.807944598268458,362018174,361381034.6,66.64217103439456,64.47399745463669,NaN,NaN,19.64133324392356,12.019911276475485
2020-06-03T09:30:00-04:00,260.35,264,259.66,263.17,5184539,4415665.5,69.31081912594495,59.172170564120975,NaN,NaN,165.2280493222047,151.35723990241087,1.5826816745253085,5.786296691425093,4.203615016899785,367202713,361422256.6,66.7319822850043,64.70114534315874,NaN,NaN,22.458905055423717,13.511196102039518
2020-06-04T09:30:00-04:00,262.37,264.43,261.385,263.33,3937053,4458404.9,69.42200427544863,60.56319529661261,NaN,NaN,144.7792099679549,143.24678334494303,1.632251306246693,6.243929149708151,4.611677843461458,371139766,363245140.2,70.51276392435184,65.41346286309799,NaN,NaN,24.816575291822467,15.12625027200851
2020-06-05T09:30:00-04:00,270.4,273.95,269.79,271.54,7866818,4681170,74.52263472396905,62.308071833702556,NaN,NaN,184.1336581800793,152.92162851182394,2.0596545137814184,7.186245985688231,5.126591471906813,379006584,367667926.8,77.26408591621282,66.78673150429168,NaN,NaN,28.64095895160133,17.05692294052177
2020-06-08T09:30:00-04:00,272.9,276.38,272.9,276.28,4667603,4719327.85,76.91668311709844,63.68544915141508,NaN,NaN,176.83928682265451,162.32505577380272,2.475329641684443,8.220753524012366,5.745423882327923,383674187,372608284.8,82.17383941493681,68.43055818582522,NaN,NaN,32.72544660485019,19.295283463997258
2020-06-09T09:30:00-04:00,273.24,275.02,272.13,273.38,4632645,4813812.5,72.43218022346642,65.0006922470019,NaN,NaN,142.68656788855182,162.73335443628906,2.3686547308816817,8.706242295930025,6.337587565048343,379041542,376012958.4,84.63618049624301,70.11669844041886,NaN,NaN,34.77335634040609,21.50643673205566
2020-06-10T09:30:00-04:00,273.2,274.1799,270.01,270.46,6531248,4818678.95,68.12521669324185,65.8110264427594,NaN,NaN,116.54829456287744,152.99740348442361,1.9334980139785625,8.754460082521547,6.820962068542984,372510294,377074474.6,85.31716336950372,71.47921631151118,NaN,NaN,35.18108025458052,23.4599572352735
2020-06-11T09:30:00-04:00,262.14,263.51,251.3801,252.03,14257754,5155000.7,48.51627186089474,65.27310196354978,NaN,NaN,7.252048809354043,125.49197125270344,0.321048100032054,7.222272193583052,6.901224093550998,358252540,374497029.4,76.455902727145,72.09340702147823,NaN,NaN,28.07750600865811,24.11960706004273
2020-06-12T09:30:00-04:00,259,260.32,251.43,256.74,9817238,5297638.1,52.29536149221106,65.01606177341239,NaN,NaN,3.4119245901830992,89.34762453472422,-0.4687700857462609,6.315261486368172,6.784031572114433,368069778,372309668.2,69.82760514641684,72.3134485015293,NaN,NaN,23.850563344779964,24.08117224357662
2020-06-15T09:30:00-04:00,250.29,259.6,249.1,258.35,7421335,5428150.1,53.55048943591446,64.52887545879105,NaN,NaN,-8.928419316194256,52.194083306954425,-0.8983414029093666,5.661104818477725,6.559446221387091,375491113,370673053.4,65.26824826443863,72.30672520586866,NaN,NaN,21.033635253324707,23.645809816397776
2020-06-16T09:30:00-04:00,267.09,267.14,258.69,263.82,9238017,5628335.85,57.62934820401432,64.04708674641506,NaN,NaN,48.3824176041832,33.3332532500807,-0.831214439578309,5.5204281719142045,6.3516426114925135,384729130,371810571,66.88661290294868,72.23505593609455,NaN,NaN,20.08570890803625,23.137223972346128
2020-06-17T09:30:00-04:00,264.61,264.7,261.26,261.82,3669349,5591567.4,55.70330578323954,63.55290421039164,NaN,NaN,35.992122916660705,17.222018920837346,-0.9311089658908527,5.1877564041289475,6.1188653700198,381059781,373520468.4,69.20917646188204,72.36284454681844,NaN,NaN,18.703585419984964,22.503847036294534
2020-06-18T09:30:00-04:00,260.04,262.26,259.11,261.45,3268725,5590976.15,55.33485681665025,63.03793815557496,NaN,NaN,15.328689114713375,18.837346981909224,-1.024307712330832,4.83848072960626,5.862788441937092,377791056,377428171.6,73.74193800823039,72.9405850699677,NaN,NaN,17.49966935304654,21.788964510116248
2020-06-19T09:30:00-04:00,264.21,264.46,257.61,258.8,5852615,5714696.35,52.64880889488304,62.27412658209584,NaN,NaN,2.2979755605472647,18.614557175982057,-1.2515937104052295,4.298296303930556,5.549890014335785,371938441,378201904.2,74.54110069768885,73.51491218924268,NaN,NaN,15.685597666346748,20.91705496100632
2020-06-22T09:30:00-04:00,257.88,260.58,256.68,260.32,2823468,5729814.7,54.02727968021969,61.459661451942566,NaN,NaN,-18.9931687448653,16.60160729024785,-1.2820359991538552,3.9473450153934664,5.229381014547322,374761909,378056063.4,74.08341603836566,74.04642968952633,NaN,NaN,14.582886733337524,20.012173785625063
2020-06-23T09:30:00-04:00,262.83,263.15,261.02,261.5,2948032,5633600.3,55.119591325874204,60.44600232336608,NaN,NaN,6.581234558547707,8.24137068112075,-1.2062806156405426,3.721530244996643,4.9278108606371855,377709941,376652225.6,69.65023258908897,74.2548761398181,NaN,NaN,13.970601009262227,19.149091960430372
2020-06-24T09:30:00-04:00,259.22,259.52,252.94,254.63,5903533,5662472.35,47.97294694629221,58.91392679985491,NaN,NaN,-73.95021362913047,-13.747096628037486,-1.5789166471314768,2.954165051722839,4.533081698854316,371806408,374801551,64.19638390178658,73.80370613820628,NaN,NaN,11.255159262394294,18.021387289282362
2020-06-25T09:30:00-04:00,253.34,257.7125,252.06,257.44,4313910,5629605.1,50.783802362082035,57.21829591686298,NaN,NaN,-73.86819752680206,-31.58647395634057,-1.5917078780634473,2.5434468512750072,4.1351547293384545,376120318,374467403.4,63.233616232413134,72.8015297322206,NaN,NaN,9.793576234271393,16.84598570999508
2020-06-26T09:30:00-04:00,255.65,256.0543,249.7,250.38,5331447,5639542.6,44.30694737070129,54.889029077834614,NaN,NaN,-119.0961948292424,-55.86530803429851,-2.0045373395522246,1.6294830548981736,3.634020394450398,370788871,374237489.4,62.53863815295699,71.3990153563649,NaN,NaN,6.428315314757464,15.357747082103993
2020-06-29T09:30:00-04:00,252.18,256.12,250.95,255.91,3759039,5723507.25,49.716592460057235,53.26648709473397,NaN,NaN,-89.80679234355264,-70.02803275403598,-1.8384286778485341,1.3359845471397307,3.174413224988265,374547910,374194689.6,62.401146396072846,69.81079863492417,NaN,NaN,5.256694365913194,13.914739551219593
2020-06-30T09:30:00-04:00,255.07,259.05,254.7226,257.87,3667863,5754611.55,51.514212206811735,52.07998677427467,NaN,NaN,-53.180238079439846,-81.98032728163348,-1.5417994159475321,1.2471639550538498,2.788963371001382,378215773,374295856,62.61039298256091,68.18888646442825,NaN,NaN,4.861258372929137,12.6213850971781
2020-07-01T09:30:00-04:00,258.87,260.2563,257.14,257.31,3575294,5674149.3,50.95372499608203,52.25409056964519,NaN,NaN,-37.10913549136727,-74.61211165408085,-1.336218606590133,1.1186901127637157,2.4549087193538486,374640479,374862670.2,63.825123506909094,67.28668794869712,NaN,NaN,4.3785544575013615,11.443837862938565
2020-07-02T09:30:00-04:00,261.15,262.17,257.88,258.42,3829965,5668794.9,52.066976032414004,52.23777732251683,NaN,NaN,-19.37486902886059,-63.713445954492556,-1.0888610780489185,1.0938323717927005,2.182693449841619,378470444,375332695.4,64.84507684049296,66.93079306970256,NaN,NaN,4.294109323708766,10.422448071620023
2020-07-06T09:30:00-04:00,262.16,263.14,260.87,263,2989142,5424911.1,56.458521960493975,52.44549393141536,NaN,NaN,25.46879514464387,-34.8004479597153,-0.6043565735598326,1.4272477328918285,2.031604306451661,381459586,377466838.4,69.10454086992135,67.20481397009418,NaN,NaN,5.505068344898405,9.719965253516934
2020-07-07T09:30:00-04:00,261.1,261.85,258.78,259.04,2828663,5332964.1,52.02066884523648,52.044873977216945,NaN,NaN,1.8842549201954824,-16.46223850696567,-0.5402368637009822,1.3563082268254334,1.8965450905264156,378630923,378283441,70.57372431766505,67.46817907114534,NaN,NaN,5.251289885809001,9.081583058130086
2020-07-08T09:30:00-04:00,259.64,261.19,258.25,260.72,2837849,5243224.3,53.68397974569525,51.90063640310664,NaN,NaN,20.145725691564085,-1.797045752764891,-0.38180452703043044,1.4192894317383775,1.801093958768808,381468772,378934040.8,71.72727554172081,67.64804329113385,NaN,NaN,5.520230546009546,8.572818413541437
2020-07-09T09:30:00-04:00,260.87,261.189,255.35,257.24,3995584,5116441.1,49.83036777584013,51.50745861447734,NaN,NaN,-13.05992552257319,3.012796240993919,-0.5009930834497749,1.1748526044565892,1.6758456879063641,377473188,379500582.6,72.72979476155675,67.57574734494287,NaN,NaN,4.634014982947936,8.010132209170937
2020-07-10T09:30:00-04:00,257.2,261.16,256.46,260.82,3110122,4559059.5,53.52626055351542,51.570133732951085,NaN,NaN,23.34922198034682,11.557614442835396,-0.336246405039768,1.2555376816066541,1.5917840866464221,380583310,379923155.8,73.48501075345857,67.50031234892641,NaN,NaN,4.9545372634717655,7.573618645499627
2020-07-13T09:30:00-04:00,263.06,266.52,260.58,261.04,4875970,4311996.1,53.75173546441992,51.5504520032511,NaN,NaN,101.57513744959715,26.778882903826066,-0.2158318921461002,1.3219942214637967,1.537826113609897,385459280,380723094.6,74.90198402418086,67.55878149077036,NaN,NaN,5.27913771205929,7.24583565500815
2020-07-14T09:30:00-04:00,260.54,267.05,260.1,266.59,7614334,4321646.05,59.13775379407946,51.8374636081229,NaN,NaN,139.6518047372138,54.332392867229736,0.21112382320586565,1.801730892617229,1.5906070694113634,393073614,383611632.8,79.22030901832184,68.2423583785727,NaN,NaN,7.175471585123095,7.235783645024571
2020-07-15T09:30:00-04:00,270.47,270.54,267.05,268.91,5220604,4120775.4,61.173307066453624,52.780346473848724,NaN,NaN,222.97451051866963,94.89814983265084,0.6012196534290515,2.342131636197678,1.7409119827686264,398294218,386976722,82.90951894504667,69.57901088166271,NaN,NaN,9.37775410162924,7.5417794245395235
2020-07-16T09:30:00-04:00,267.16,268.93,266.02,267.47,2478069,4061211.4,59.20199329208893,53.381645825992074,NaN,NaN,168.72975420605866,131.2560857783772,0.7064382365661996,2.623959778476376,1.9175215419101763,395816149,390645314.2,85.85740632976184,71.19499588861619,NaN,NaN,10.6616341654033,7.987472958948635
2020-07-17T09:30:00-04:00,267.95,268.07,266.17,266.74,3415083,4068529.3,58.17846209286779,54.372468306146814,NaN,NaN,135.39786396663376,153.6658141756346,0.6712859738974086,2.756629009281937,2.0853430353845286,392401066,393008865.4,87.36902962931119,72.96859527978435,NaN,NaN,11.45095344328438,8.482255885282312
2020-07-20T09:30:00-04:00,266.39,267.64,265.03,266.82,4017268,3976761.95,58.263621245449926,54.98297036224629,NaN,NaN,107.28647107599876,154.80808090091494,0.6001570353786607,2.8355393296078546,2.235382294229194,396418334,395200676.2,88.58725428708058,74.83903155771347,NaN,NaN,12.129619328162725,9.0033078056938
2020-07-21T09:30:00-04:00,268.82,270.27,267.65,268.34,3179711,3994574.1,59.93300575748413,55.58431275872289,NaN,NaN,125.94931314839091,152.06758258315034,0.6007368665278388,2.9863033773889924,2.3855665108611537,399598045,396505562.4,89.25188042622713,76.74199494654677,NaN,NaN,13.155908547451393,9.59653648308774
2020-07-22T09:30:00-04:00,267.82,270.35,267.77,269.98,2039285,3949136.75,61.712449025818955,56.352793046561246,NaN,NaN,118.0070810608693,131.07409669159028,0.6525208883909839,3.2012176213498833,2.5486967329588994,401637330,397174184.8,89.58651912873687,78.58209463382018,NaN,NaN,14.518421660386572,10.299662936987573
2020-07-23T09:30:00-04:00,269.64,269.78,265.62,266.69,2838003,3795860.25,56.309671213023464,56.655842702319056,NaN,NaN,79.5170523562376,113.23155632162607,0.4175757912913376,3.0706664720730714,2.653090680781734,398799327,397770820.4,89.88903570702016,80.37094883857212,NaN,NaN,14.291488000025959,10.869923660278772
2020-07-24T09:30:00-04:00,265.15,266.3399,264.05,264.69,2637694,3712049.45,53.2572674055387,56.427181662679395,NaN,NaN,39.979800444714535,94.14794361724222,0.0966036941398416,2.7738452984565356,2.677241604316694,396161633,398522933.8,90.27266008276591,81.88295735377531,NaN,NaN,13.259612022164124,11.21130771197668
2020-07-27T09:30:00-04:00,264.77,266.31,264.35,265.95,2637853,3577369.75,54.91537493050965,56.63394638305605,NaN,NaN,41.17632784813205,80.92591497166889,-0.05363716762463122,2.610195144785905,2.6638323124105363,398799486,398999164.2,90.5179800812776,83.30754705117621,NaN,NaN,12.818140681626037,11.440855279069446
2020-07-28T09:30:00-04:00,264.92,265.61,263.63,263.93,1989345,3488885.05,51.746225090418946,56.4955353362506,NaN,NaN,14.847405461586254,58.70553343430795,-0.2981908117944405,2.291093797667486,2.5892846094619264,396810141,398441583.4,87.72830278768022,84.45047756874474,NaN,NaN,11.569704331819782,11.459262286605208
2020-07-29T09:30:00-04:00,264.19,266.07,263.8,265.5,1917868,3401385.3,53.969667567030555,56.79119960704991,NaN,NaN,23.41193203647374,39.786503629428836,-0.35925292441726153,2.1402184539403493,2.499471378357611,398728009,397859719.2,84.79153164581791,85.31203020333483,NaN,NaN,11.08517312309145,11.405820977531814
2020-07-30T09:30:00-04:00,262.48,263.82,259.941,263.28,3055612,3375401.2,50.43107291072721,56.57011477542219,NaN,NaN,-42.167791871974195,15.44953478378647,-0.5431552588288917,1.8205273048214963,2.363682563650388,395672397,397234333.2,81.628641234482,85.89371809483649,NaN,NaN,9.685671555462871,11.16008534580768
2020-07-31T09:30:00-04:00,263.76,264.49,260.18,264.35,3317252,3349765.55,52.06251552300311,56.44945620817812,NaN,NaN,-33.618786332281516,0.7298174283872612,-0.5832129255291325,1.6346664067389725,2.217879332268105,398989649,397799936.4,82.27269592143264,86.42019751606877,NaN,NaN,8.927889065942608,10.841200162969812
2020-08-03T09:30:00-04:00,265.67,267.15,265.35,266.72,2570812,3328849.05,55.55201853476385,56.19333226108415,NaN,NaN,45.06341610734694,1.5072350802302452,-0.44671942896955574,1.65948004605616,2.106199475025716,401560461,398352131.4,82.90288321218874,86.6832385299164,NaN,NaN,9.214780075509198,10.608854436189725
2020-08-04T09:30:00-04:00,266.29,268.42,266.03,268.41,1909762,3282904,57.9051200018423,55.95989032789763,NaN,NaN,69.71206252886866,12.480166493686728,-0.24910014573291406,1.7948242928595732,2.0439244385924873,403470223,399684147.8,84.34829132288608,86.78600798547636,NaN,NaN,10.114249783229901,10.538196628624036
2020-08-05T09:30:00-04:00,269.99,272.27,269.9,272,2133451,3247684.1,62.45250763754703,56.19206992400178,NaN,NaN,154.2165979675259,38.64109967989716,0.09829337788548553,2.1667911609493444,2.068497783063859,405603674,401059280.8,85.69302206108125,86.77426625199918,NaN,NaN,12.260435954459536,10.784230818029107
2020-08-06T09:30:00-04:00,271.63,274.03,271.57,273.9,1948108,3145310.3,64.63025957669724,56.652912601418166,NaN,NaN,186.55516460278898,84.3856909748498,0.4132756688745096,2.585092369156996,2.1718167002824864,407551782,403435157.8,87.66490060763206,86.79539989330782,NaN,NaN,14.738001948045474,11.349055265174302
2020-08-07T09:30:00-04:00,273.2299,274.82,272.475,274.62,2311296,3105369,65.44808972014431,57.1660889210392,NaN,NaN,187.51433365363533,128.61231497203318,0.6151845528328903,2.940797391323599,2.325612838490709,409863078,405609843.6,89.14029321377296,86.83490267378583,NaN,NaN,17.034464815339444,12.161256629483608
2020-08-10T09:30:00-04:00,275.5099,278.28,275.48,278.14,2313886,2977264.8,69.19787785267292,57.82786549926696,NaN,NaN,223.37226227225932,164.27408420501564,0.912924147179186,3.4667680224646915,2.5538438752855055,412176964,407733144.2,90.35349884443079,86.91358970365754,NaN,NaN,20.22934957213256,13.313841335576315
2020-08-11T09:30:00-04:00,280.9,281.78,276.47,277.19,4546407,2823868.45,67.08192583940414,58.21139955738018,NaN,NaN,198.70546743784067,190.07276518681005,0.9677748766583161,3.7635624711084006,2.7957875944500845,407630557,408565211,90.7878191820658,86.99939685032389,NaN,NaN,22.29032754270869,14.596196508023798
2020-08-12T09:30:00-04:00,279.84,280.74,278.72,280.04,2650851,2695380.8,70.0415608694739,59.19224881855522,NaN,NaN,178.3223087206855,194.89390733744196,1.1078135731046062,4.180554560830842,3.072740987726236,410281408,409500757.8,91.26407599382742,87.09761401366725,NaN,NaN,24.99050417582598,16.08109760342411
2020-08-13T09:30:00-04:00,279.13,280.22,278.2262,279.42,1668346,2654894.65,68.59665944495397,60.28791967851345,NaN,NaN,139.66976901131835,185.51682821914784,1.0699331523420588,4.410157428153809,3.3402242758117504,408613062,409713013.8,91.37304808009466,87.1762131563336,NaN,NaN,26.813897605631638,17.614354746596614
2020-08-14T09:30:00-04:00,278.23,280.1599,277.9,279.8,2247041,2596492.55,69.01851255836523,61.2952866519317,NaN,NaN,118.5500117628161,171.723963840984,0.9839012997681031,4.570100900521879,3.586199600753776,410860103,409912418.8,91.48056528092235,87.24496924202252,NaN,NaN,28.44581079647001,19.161705610864242
2020-08-17T09:30:00-04:00,280.14,280.25,278.5,278.95,2436887,2517473.5,66.85509701532284,62.37449178942484,NaN,NaN,102.89931781118331,147.62937494876877,0.791460757875174,4.575525548097744,3.78406479022257,408423216,409161669.2,87.08024813785539,87.19867962417788,NaN,NaN,29.257608820729597,20.603977497987863
2020-08-18T09:30:00-04:00,279.1,279.37,277.11,278.2,1678320,2442403.95,64.92139645059916,63.15675813825116,NaN,NaN,80.80782087640239,124.04984563648114,0.5469912294134494,4.467803826989382,3.9208125975759325,406744896,408984537,86.0288042137543,87.28705623617336,NaN,NaN,29.4407339139571,21.866371271697755
2020-08-19T09:30:00-04:00,278.68,279.74,276.97,277.43,3374281,2509153.75,62.909592225094535,64.04808094642026,NaN,NaN,70.75014054750119,102.53541200184426,0.2802033798549579,4.27106682239463,3.990863442539672,403370615,407602378.4,78.10406229636556,87.03530059773645,NaN,NaN,29.071607896229995,22.895690789488075
2020-08-20T09:30:00-04:00,276.04,278.34,275.87,277.87,2063727,2470439.95,63.60366051800551,64.87244844606329,NaN,NaN,57.30788792652251,86.0630357848851,0.08999303196799602,4.1033547324996675,4.0133617005316715,405434342,406966634.4,74.69569877291742,86.49408651569966,NaN,NaN,28.929841277576212,23.75771228778638
2020-08-21T09:30:00-04:00,277.04,279.61,276.86,279.29,2601159,2468613.2,65.8262227617476,65.60632017656218,NaN,NaN,65.44760965492922,75.44255536330772,0.020087317537675453,4.038470847453766,4.018383529916091,408035501,406401714,71.70143666134157,85.69398319063914,NaN,NaN,29.3738423748872,24.56001658594364
2020-08-24T09:30:00-04:00,281.72,283.25,280.47,283.18,2622765,2467858.8,71.04293322351103,66.54473540668137,NaN,NaN,100.32344060309173,74.92737992168941,0.18683463630382224,4.251926825295868,4.065092188992046,410658266,406848724,72.63616591180048,84.85740280413303,NaN,NaN,31.295816129774895,25.52227366363382
2020-08-25T09:30:00-04:00,284.23,284.23,281.02,282.62,3346049,2535694,69.4004935866711,67.04102011733309,NaN,NaN,97.3339556394897,78.23260687430687,0.20875588364222697,4.326037043544829,4.1172811599026025,407312217,406962188.2,72.88102767550154,83.9422603480202,NaN,NaN,32.442584830127416,26.510889544561476
2020-08-26T09:30:00-04:00,282.61,283.61,281.57,283.43,2647495,2572175.35,70.4641460259493,67.45772629227966,NaN,NaN,95.34598205020889,83.15177517484841,0.22570820969274408,4.399416422018533,4.1737082123257885,409959712,408280007.6,75.61078235212494,83.08125190119826,NaN,NaN,33.709840020174845,27.53931104107767
2020-08-27T09:30:00-04:00,284.44,286.45,283.68,285.04,3432795,2591034.5,72.50960967593309,67.962120574836,NaN,NaN,124.72042411407239,96.63428241235839,0.2891971395882962,4.535204636811159,4.2460074972228625,413392507,409871640.6,78.43427220745781,82.31653611503289,NaN,NaN,35.39499423976029,28.66155149803233
2020-08-28T09:30:00-04:00,286.23,287.45,285,286.7,2715534,2560948.6,74.47258973333857,68.33888570916926,NaN,NaN,149.78089536766913,113.50093955490635,0.3810578610056039,4.722329823479868,4.341271962474264,416108041,411486148.6,80.85539453518741,81.63810009294409,NaN,NaN,37.43080851059892,29.91430249982756
2020-08-31T09:30:00-04:00,286.26,286.34,283.8919,284.28,4070137,2635914.85,66.96539972497723,68.33056241528162,NaN,NaN,119.27890948380235,117.29203333104847,0.22464140456512727,4.622073718180673,4.397432313615545,412037904,411762076.2,81.24297003121292,80.95632515359743,NaN,NaN,37.03405666633329,30.931410237899808
2020-09-01T09:30:00-04:00,283.73,286.93,283.17,286.79,3036302,2692241.85,70.30854653419523,68.34963281990457,NaN,NaN,123.7318498864646,122.57161218044345,0.23491831150398124,4.691080202995522,4.456161891491541,415074206,413314474,83.2923303754964,80.38691475228809,NaN,NaN,37.69289339157076,31.897336402709943
2020-09-02T09:30:00-04:00,288.08,292.06,287.6,291.21,3464294,2758784,75.08938502844852,68.81339893301133,NaN,NaN,184.45779943371852,140.3939756571454,0.470492968319018,5.044278101890313,4.573785133571295,418538500,415030231.6,85.21503336192998,79.94705655813345,NaN,NaN,39.886596434233695,33.03865926435619
2020-09-03T09:30:00-04:00,290.97,292.36,281.1,283.34,6118525,2967304.85,57.374801165684275,67.98170526210555,NaN,NaN,84.47591578135685,132.3450739906023,0.04953924027007339,4.635709183908887,4.586169943638813,412419975,414835725.2,84.03439725968013,79.41518741375901,NaN,NaN,35.11826746237817,33.3357461497879
2020-09-04T09:30:00-04:00,284.91,285.79,277.01,281.77,7145822,3209031.15,54.60714896511688,67.10685182994798,NaN,NaN,-2.473583119125172,101.89417829324341,-0.35890829822391623,4.137534570858918,4.496442869082834,405274153,412668947.6,72.05750397419627,78.34213425921193,NaN,NaN,30.44490740982687,32.92276918693633
2020-09-08T09:30:00-04:00,278.82,278.83,275.0105,275.42,4780144,3332344.05,45.12573038001447,65.69287568204908,NaN,NaN,-110.38388562435657,55.96161927161165,-1.0423361129316557,3.193522727918264,4.23585884084992,400494009,410360168.6,61.92922920236582,76.62073604411275,NaN,NaN,22.61238650010615,31.449857374532016
2020-09-09T09:30:00-04:00,278.09,282.49,277.39,279.85,3488892,3279468.3,51.4579583328566,64.87490183260351,NaN,NaN,-38.23843978262776,23.567561337793183,-1.1719597113603912,2.770909201649431,3.9428689130098222,403982901,408141907.6,54.066086474521235,74.90373777112386,NaN,NaN,18.74708251061969,29.63517525111597
2020-09-10T09:30:00-04:00,281.13,282.17,274.85,275.79,3455758,3319713.65,46.19652483830462,63.63153499833917,NaN,NaN,-83.32658803094075,-29.98931615513868,-1.4868153053402273,2.084349781334538,3.5711650866747653,400527143,404539636.2,44.24215680776921,72.72848477361327,NaN,NaN,13.630033136556236,27.348726377607438
2020-09-11T09:30:00-04:00,276.95,278.82,274.96,277.09,2787455,3375669.1,48.02890427601014,62.36029796364363,NaN,NaN,-91.22940437376518,-65.13038018616308,-1.5558140441854205,1.62639753144299,3.1822115756284104,403314598,402718560.8,40.2595668949869,70.48263693315938,NaN,NaN,10.414252036819468,24.92951575749487
2020-09-14T09:30:00-04:00,278.92,281.43,278.6721,280.53,2371734,3381903.75,52.626592132281,61.04484502855577,NaN,NaN,-26.284860247494237,-69.8926356118369,-1.3269816258804061,1.5234845432779025,2.8504661691583086,405686332,402800996.6,40.52058378367229,68.18866678115023,NaN,NaN,9.427538883562102,22.71494763264733
2020-09-15T09:30:00-04:00,282.42,282.9,279.88,280.58,2331755,3376647.15,52.69210211812233,59.85138849508801,NaN,NaN,-9.721305984692671,-49.76011968390411,-1.1367876025129013,1.4294816660171819,2.566269268530083,408018087,404305812.2,45.225289308183605,66.21325689777038,NaN,NaN,8.698570621998808,20.71260805969754
2020-09-16T09:30:00-04:00,281.54,284.2334,280.7803,281.03,2668303,3426146.3,53.31778109368862,58.62664814278367,NaN,NaN,5.510598375309508,-41.010312052316664,-0.9526636271060664,1.3754397346475002,2.3281033617535667,410686390,405646510,49.08904193436695,64.31884686793053,NaN,NaN,8.314350213734633,18.941428367417124
2020-09-17T09:30:00-04:00,277.69,281.15,277.09,279.57,3305288,3422696.65,50.962754426971735,57.08758705357214,NaN,NaN,-58.165400086014046,-35.978074463331325,-0.9017167479874422,1.2009574267692642,2.1026741747567064,407381102,407017301.8,52.75831383873858,62.48484984159344,NaN,NaN,7.29197908133981,17.277221326548936
2020-09-18T09:30:00-04:00,279.02,279.4,274.7731,276.52,3156714,3477346,46.35632494290049,55.07928242568371,NaN,NaN,-110.7036115705715,-39.87291590269258,-1.0363283029451331,0.80726379607529,1.843592099020423,404224388,407199259.8,53.24006949549255,60.51232662447238,NaN,NaN,4.994572361689122,15.52255718871182
2020-09-21T09:30:00-04:00,271.58,272.17,267.05,271.44,5936941,3644135.1,39.88914661958186,53.1452643467269,NaN,NaN,-219.77804726922446,-78.57155330703863,-1.4073755850914806,0.08437261765607218,1.4917482027475528,398287447,405719482.8,48.87493686690321,58.2003242555931,NaN,NaN,0.8050695135270595,13.420058949399712
2020-09-22T09:30:00-04:00,271.67,273.24,269.79,272.81,3169838,3671488.75,42.22987325115335,51.13964482650962,NaN,NaN,-154.95548597168204,-107.6183893044365,-1.4923336635966347,-0.37366887674824056,1.118664786848394,401457285,404407322.4,45.32612664532807,55.48845256058108,NaN,NaN,-1.8503670325800656,11.238569523402601
2020-09-23T09:30:00-04:00,274.18,274.59,267.08,267.58,3575918,3682982.2,36.40224573894923,48.37627773440253,NaN,NaN,-162.14729077236623,-141.14996713397164,-1.811318179775704,-1.1454829378712361,0.665835241904468,397881367,401846317.8,39.32451300412658,52.21055824930941,NaN,NaN,-6.1665072512763,8.752129984162758
2020-09-24T09:30:00-04:00,266.86,270.8777,265.27,268.1,4432082,3772211.55,37.32828610240994,46.94438380131151,NaN,NaN,-157.6335216162469,-161.04359144001825,-1.8891843103330364,-1.6956451460118274,0.19353916432120888,402313449,400832787.2,37.22387051821995,48.86694919634796,NaN,NaN,-9.274638387676184,6.1768773596143385
2020-09-25T09:30:00-04:00,266.76,272.31,266.23,271.7,3606821,3780912.85,43.46568194538505,46.14856472847352,NaN,NaN,-113.88490135301856,-161.67984939650765,-1.6109759990461727,-1.8201808344865071,-0.20920483544033436,405920270,401171963.6,38.40957225664823,46.463525502237395,NaN,NaN,-9.996329302405462,3.8664192650400815
2020-09-28T09:30:00-04:00,275.26,277.12,274.72,275.9,2790187,3784645.5,49.65953958833623,46.47240824335364,NaN,NaN,-31.77392948958515,-124.07902584057979,-1.0822089268554103,-1.5619659940095971,-0.4797570671541869,408710457,403256565.6,45.25369712066574,45.27241606783025,NaN,NaN,-8.57342455963026,2.089298718658604
2020-09-29T09:30:00-04:00,275.6,275.98,273.29,274.42,1980155,3680146.4,47.67729264855287,46.202360694474805,NaN,NaN,-45.19778285140711,-102.12748521652479,-0.7841330785619522,-1.4599234153566272,-0.6757903367946749,406730302,404311169,48.37893014926016,44.86619061602589,NaN,NaN,-8.04589722136609,0.6414135843693622
2020-09-30T09:30:00-04:00,275,280.17,275,277.5,4028462,3729754.4,51.97372206723258,46.61501763939823,NaN,NaN,4.117252659666855,-68.87457653011818,-0.35347990378179617,-1.1176402165219201,-0.764160312740124,410758764,406886648.4,55.11737199382058,45.642991700743835,NaN,NaN,-6.22322798452472,-0.33924949690122097
2020-10-01T09:30:00-04:00,279.33,280.35,276.57,278.14,2967993,3704939.35,52.8402898561514,46.95868803797975,NaN,NaN,30.10513856211975,-31.326844494444845,-0.01721482776472949,-0.7856788474460359,-0.7684640196813064,413726757,409169310,60.089963097740096,47.05944857236906,NaN,NaN,-4.4972152879321206,-0.9332446099056352
2020-10-02T09:30:00-04:00,274.17,278.51,273.6,276.8,4771602,3637593.2,50.77453366443428,46.82639814741926,NaN,NaN,1.3811487020744597,-8.273634483426239,0.11594230732818234,-0.6235361355210784,-0.7394784428492608,408955155,409776287,61.31722561537957,48.54492298891959,NaN,NaN,-3.66500017058762,-1.3234954042887759
2020-10-05T09:30:00-04:00,278.79,281.59,278.75,281.51,1862496,3373426.9,57.12007504557504,47.14268192795161,NaN,NaN,90.06570337120277,16.094292088731343,0.5006476129769563,-0.11366892662806549,-0.6143165396050217,410817651,410197725.8,62.186680615248484,49.75645093942421,NaN,NaN,-0.9179034852094503,-1.265553701563158
2020-10-06T09:30:00-04:00,282.54,283.52,277.24,277.72,4364415,3352640.45,51.38049506380032,47.00430435438816,NaN,NaN,61.9775360803397,37.529355875080704,0.47926033118407724,-0.01524112562492519,-0.4945014568090024,406453236,410142312.6,61.989388266847676,50.677904248887124,NaN,NaN,-0.3591605604833242,-1.1360689671231816
2020-10-07T09:30:00-04:00,280.28,283.67,280.23,282.92,2422621,3299326.9,57.66586508031127,47.48309797248384,NaN,NaN,111.24304984943078,58.95451531303348,0.7770917060375138,0.47686317573788983,-0.30022853029962393,408875857,409765731.2,60.58271916791174,51.23679034382807,NaN,NaN,2.247504641829854,-0.6527013087013194
2020-10-08T09:30:00-04:00,284.52,284.68,282.69,284.29,2147964,3233937.2,59.16371549790618,48.397911583555675,NaN,NaN,126.9487944051721,78.32324648164396,1.013197536161832,0.9662683899026661,-0.046929146259165944,411023821,409225144,58.52947407175399,51.61460495641817,NaN,NaN,4.813204241070557,0.12814234126609148
2020-10-09T09:30:00-04:00,285.61,286.81,284.41,285.93,2548741,3222001.5,60.945114043844804,49.90190925671732,NaN,NaN,137.71275269247445,105.58956727972398,1.2131594200079623,1.469520128750787,0.2563607087428247,413572562,410148625.4,60.96341971569259,52.478068017045985,NaN,NaN,7.467308919884871,1.1765947096402027
2020-10-12T09:30:00-04:00,286.95,289.61,286.68,288.46,2534786,3230154.1,63.58427110316281,51.42722338900371,NaN,NaN,158.10997676083383,119.19842195765018,1.434017331261561,2.048882372819776,0.6148650415582149,416107348,411206564.8,63.59914554424683,53.78328365268304,NaN,NaN,10.525865164890599,2.5122047746759737
2020-10-13T09:30:00-04:00,287.66,288.1099,286.02,286.74,2430643,3235098.5,60.58676395004677,53.15468897551067,NaN,NaN,126.32078044023235,132.0670708296287,1.3819012442177294,2.3422415968303767,0.9603403526126473,413676705,412651258.6,66.88709719339148,55.75203966620194,NaN,NaN,12.164558226135929,3.8911124105988244
2020-10-14T09:30:00-04:00,287.22,287.95,284.58,285.13,2269823,3215174.5,57.83819053757975,54.61968214945137,NaN,NaN,104.448404166184,130.70814169297938,1.165292665381196,2.416956184339142,1.2516635189579461,411406882,413157463.6,67.97851398561991,57.948799913873366,NaN,NaN,12.722107997576906,5.152683208738551
2020-10-15T09:30:00-04:00,282.03,285.4,281.66,285.04,3134929,3206656.55,57.68066131408662,55.635037818644335,NaN,NaN,72.89685807412027,119.89775442676901,0.9512852703734733,2.440770106924788,1.4894848365513145,408271953,412607090,65.45250161164192,59.88043772494434,NaN,NaN,13.130545736077673,6.292377855501282
2020-10-16T09:30:00-04:00,286.24,288.37,285.89,285.97,2412674,3169454.55,58.92558559520657,56.29689824770651,NaN,NaN,94.9647454766874,111.34815298361158,0.81305271381069,2.505800728814677,1.6927480150039869,410684627,412029503,62.81453988978869,61.134783637024555,NaN,NaN,13.814393410605092,7.366951506230398
2020-10-19T09:30:00-04:00,286.64,287.06,281.28,282.03,2837641,3014489.55,51.95273390456008,56.60228690884988,NaN,NaN,49.960571441826986,89.71827191981022,0.41691560262565774,2.213892518286059,1.7969769156604012,407846986,410377430.6,55.87748061661067,61.67039438469244,NaN,NaN,12.416551229118769,8.088322895214452
2020-10-20T09:30:00-04:00,283.16,285.66,282.25,282.95,3337794,3022887.35,53.34114130926146,56.69995971185194,NaN,NaN,46.68695667374944,73.79150716651364,0.18909868616089542,2.0333502733615205,1.844251587200625,411184780,409879045.6,53.94211180748314,61.58644722852548,NaN,NaN,11.639031540171265,8.59556698735114
2020-10-21T09:30:00-04:00,282.54,284.47,281.83,281.97,2907083,2989445.6,51.629666575553195,56.61348662038064,NaN,NaN,29.683632391805876,58.83855281163803,-0.042960409356642026,1.7905510755048226,1.8335114848614646,408277697,409253208.6,51.52856394181752,60.97491871738816,NaN,NaN,10.508950351905714,8.868907468001792
2020-10-22T09:30:00-04:00,282.1,284.16,280.3001,283.65,2324172,2884050.1,54.334639769330444,56.86777991358751,NaN,NaN,21.40327959022694,48.53983711485935,-0.09566059805535199,1.7139357372922746,1.8095963353476265,410601869,409719191.8,53.20736480011669,60.39564294486938,NaN,NaN,10.271696109994004,9.06930584542925
2020-10-23T09:30:00-04:00,284.45,284.54,281.51,283.34,2161005,2811759.3,53.73746948120056,56.626165230417904,NaN,NaN,21.25293635239349,33.79747529000057,-0.1599585888889965,1.6096480992363809,1.7696066881253774,408440864,409270439.2,51.36243312817084,59.62248241007813,NaN,NaN,9.914563131696045,9.190056886324507
2020-10-26T09:30:00-04:00,280.14,280.39,273.7,277,5140625,2929281.2,43.264587409014815,56.046457540790364,NaN,NaN,-109.58275775628233,1.8888094503787074,-0.6126111853273177,1.00384270646623,1.6164538917935478,403300239,408361089.8,47.74929944346265,58.605333208407764,NaN,NaN,6.337796551634828,8.782591124225982
2020-10-27T09:30:00-04:00,276.95,277.07,274.6,274.66,3029773,2981762.1,40.1540884788062,54.79561635496857,NaN,NaN,-147.06356407204737,-36.861294698780654,-1.028281207720892,0.3311023821424328,1.3593835898633249,400270466,406178227,40.402087254334404,57.16385950029509,NaN,NaN,2.3285759752853306,7.8605889600916035
2020-10-28T09:30:00-04:00,269,270.75,265.02,265.48,5815157,3071096.85,30.799037778187568,52.76956794641724,NaN,NaN,-259.72513083184555,-94.74304734351094,-1.8331503193792609,-0.9320543093607512,0.9010960100185097,394455309,403413749.4,33.39405548838556,55.368472458625924,NaN,NaN,-5.04541077439942,6.016874712307172
2020-10-29T09:30:00-04:00,265.13,268.94,262.81,266.59,5479384,3196666.4,32.83661433581443,50.76181796727222,NaN,NaN,-219.50315980970868,-142.92433522349808,-2.178907430263351,-1.8225382778106791,0.356369152452672,399934693,401280314.2,29.186538188320526,53.09869520667077,NaN,NaN,-10.073900250586286,3.718192574750964
2020-10-30T09:30:00-04:00,265.03,266.32,261.41,265.06,5278983,3222035.45,31.461513491956836,48.4673352807575,NaN,NaN,-202.32664091217632,-187.640250676412,-2.382289336148017,-2.6214925177323494,-0.2392031815843323,394655710,398523283.4,24.832228731987854,50.329629720080845,NaN,NaN,-14.552632308712028,1.1080747342562507
2020-11-02T09:30:00-05:00,268.9,270.5,266.93,269.2,5062870,3382054.15,38.91568648637299,46.91940117620938,NaN,NaN,-120.52127664426558,-189.82795445400865,-2.1184957330950605,-2.8873228479531576,-0.7688271148580974,399718580,397806951.6,23.837170044985015,47.2546349237661,NaN,NaN,-15.93047864255473,-1.3260043195738893
2020-11-03T09:30:00-05:00,272.66,276.43,272.2,274.65,4343013,3380984.05,47.07586355289332,46.15066353444605,NaN,NaN,-54.06621748518716,-171.2284851366366,-1.487284448399476,-2.6279326753574423,-1.1406482269579663,404061593,398565177,27.16412644891473,44.33932152828715,NaN,NaN,-14.278585015013345,-3.176372990350954
2020-11-04T09:30:00-05:00,275.9,283.06,275.5601,278.51,6766381,3598172.05,51.96981473265336,45.74274592148654,NaN,NaN,-4.4904563036948515,-120.18155023100648,-0.7569522808501101,-2.086838578020604,-1.329886297170494,410827974,401839710,39.46288989300454,42.48292069124163,NaN,NaN,-11.194921992644522,-4.321879990678607
2020-11-05T09:30:00-05:00,282.29,284.9599,282.07,283.91,4316166,3706582.15,57.84291676726197,45.66541243377621,NaN,NaN,44.03957949807034,-67.47300236945071,0.09722616638477266,-1.208353589189528,-1.3055797555743007,415144140,404881599.4,48.21131244653245,41.439833016723334,NaN,NaN,-6.455525613664808,-4.626686508248064
2020-11-06T09:30:00-05:00,283.95,284.38,281.89,283.22,3078245,3733057.35,56.88573011260463,46.01776930577939,NaN,NaN,40.95944726123992,-18.815784734767465,0.5953804460088243,-0.5613541980632704,-1.1567346440720947,412065895,408363636.4,56.042317433642985,41.451607075082784,NaN,NaN,-3.1290848978775867,-4.412743421052282
2020-11-09T09:30:00-05:00,298.61,299.49,291.39,291.72,10839326,4148284.35,64.6469187651537,46.82532483834314,NaN,NaN,150.02341461439292,35.29315351696423,1.429398942224662,0.6300140337087328,-0.7993849085159292,422905221,413000964.6,63.87646835199304,42.16120397111921,NaN,NaN,2.751335215179056,-3.3893036158763765
2020-11-10T09:30:00-05:00,293.3,294.96,291.4,294.51,4354521,4244478.25,66.76193130225919,47.906200890250716,NaN,NaN,135.09057070107784,73.12451115421723,2.0625532451813657,1.7788066479607778,-0.2837465972205878,427259742,417640594.4,69.69565430881859,43.45885328304785,NaN,NaN,8.149886590650263,-1.7408478720868565
2020-11-11T09:30:00-05:00,296.07,296.14,292.93,294.11,2910419,4276508.05,66.15090216850433,48.75021963304886,NaN,NaN,131.84444716182077,100.39149184732034,2.3283394447547177,2.6266777087228093,0.2983382639680916,424349323,420344864.2,72.4785371288151,44.83536559224059,NaN,NaN,12.106369017856643,0.23732596933364336
2020-11-12T09:30:00-05:00,292.22,293.32,289.19,291.05,4401456,4339834.4,61.51275700099816,49.3055973130344,NaN,NaN,94.47441385032784,110.47845871777186,2.174871740133505,3.0169279391349733,0.842056199001468,419947867,421305609.6,73.41266804356577,46.41038237191166,NaN,NaN,13.9140340735248,2.1911414127895226
2020-11-13T09:30:00-05:00,292.97,295.9235,292.42,295.15,3102834,4374342.4,65.04880172421952,50.861612621263305,NaN,NaN,116.04061900068945,125.49469306566175,2.218646341637959,3.6153641260489167,1.3967177844109577,423050701,423502570.8,75.4635763708738,48.389973581012455,NaN,NaN,16.600538215431357,4.249626670309784
2020-11-16T09:30:00-05:00,299.28,300.08,297.568,299.98,4615039,4463212.3,68.69742458784597,52.90042234333758,NaN,NaN,138.72521954373482,123.23505405153014,2.425284013246888,4.428322800969568,2.0030387877226796,427665740,424454674.6,76.31622294144809,50.95526898723487,NaN,NaN,20.115159730617144,6.516131393210835
2020-11-17T09:30:00-05:00,297.31,299.15,295.6,298.31,4049164,4498780.8,66.12702915369147,55.42385029873071,NaN,NaN,113.1977823280599,118.85649637692654,2.302826286151464,4.881571645412009,2.5787453592605454,423616576,423726041.4,74.19140975664301,53.86936572068182,NaN,NaN,22.121552864101567,8.745477317623797
2020-11-18T09:30:00-05:00,299.2,299.75,294.76,294.76,3566443,4531748.8,60.909763358068325,57.429075228891705,NaN,NaN,91.94398823051257,110.8764045906649,1.8552915602944315,4.897859809628585,3.0425682493341535,420050133,422866203.4,71.6559963317423,56.90289844521195,NaN,NaN,22.15473146538198,10.661085053017823
2020-11-19T09:30:00-05:00,294.06,295.81,292.9,295.33,3266622,4578871.3,61.43587584436234,59.570101111206384,NaN,NaN,71.29444736294437,106.2404112931882,1.486165569423087,4.900275211113012,3.414109641689925,423316755,423539981,72.45049572179096,60.30420323019789,NaN,NaN,22.338278431048117,12.329255535593578
2020-11-20T09:30:00-05:00,294.22,294.5895,292.2,292.53,3092546,4625448.35,57.35240198334242,60.887009360989914,NaN,NaN,55.27041640267512,94.08637077358534,0.9670820499858288,4.622962204172211,3.655880154186382,420224209,422974682.6,70.66089005134705,63.64875465922375,NaN,NaN,21.2649012078001,13.605776345908795
2020-11-23T09:30:00-05:00,294.26,296.65,293.48,295.89,2855621,4511198.15,60.72589597793633,61.862011677064416,NaN,NaN,63.1219791384669,78.96572269253177,0.7721319061416088,4.621045036863393,3.848913130721784,423079830,422057500.6,67.73736554996273,66.54684316644146,NaN,NaN,21.354530117489357,14.712741170420305
2020-11-24T09:30:00-05:00,298.94,301.11,298.3,300.43,4022685,4560843.75,64.77984168449962,62.777013602196284,NaN,NaN,84.48523904749365,73.22321403641851,0.8641068897967097,4.929046742967671,4.064939853170961,427102515,422754688.4,68.79428222540268,68.64194261875562,NaN,NaN,22.694666326201986,15.853016192674831
2020-11-25T09:30:00-05:00,299.95,300.04,298.05,298.74,2629180,4401544.9,62.205785878872,63.08864711016843,NaN,NaN,73.92740019104366,69.61989642852473,0.731545984103577,4.979372333300432,4.247826349196855,424473335,423639328.8,70.13136405093655,70.20766059049876,NaN,NaN,23.014731322249723,16.876118354042674
2020-11-27T09:30:00-05:00,299.44,300.2,298.1701,299.24,1518004,4203475.9,62.6782921404002,63.50240154072525,NaN,NaN,73.5142312802064,70.06385321197713,0.603292737159359,5.001942270646055,4.3986495334866955,425991339,424174245.6,70.94212316628992,71.27193242854499,NaN,NaN,23.40996445838595,17.80952494037743
2020-11-30T09:30:00-05:00,297.52,297.8,294.75,296.62,4159303,4147491.9,58.54773781411084,63.066745758507906,NaN,NaN,48.88997998106228,68.78776592765456,0.2839765571063442,4.753620229869625,4.469643672763281,421832036,424495811,71.4439368990167,71.81246589618954,NaN,NaN,22.552664556255916,18.487116314074356
2020-12-01T09:30:00-05:00,299.73,301.0099,298.18,298.44,2865731,4037634.95,60.49531452524103,62.61913027443518,NaN,NaN,79.00012708653595,71.96339551726837,0.14434810122236463,4.6500787992912365,4.505730698068872,424697767,424819398.4,71.96854059425573,71.9748149165779,NaN,NaN,22.3781096466074,19.042972504436218
2020-12-02T09:30:00-05:00,297.1,299.34,296.35,299.18,2481696,3944569.1,61.291649906144414,62.27204082712375,NaN,NaN,68.17152823864618,68.70065335549887,0.055411908656061826,4.574995583888949,4.519583675232887,427179463,424834788,71.9948912052339,71.94026877917925,NaN,NaN,22.45129518654732,19.529875744737804
2020-12-03T09:30:00-05:00,299.38,301.4,299.0531,300.06,3140866,3763293.35,62.265783183676646,62.32582841160079,NaN,NaN,98.16815621239417,73.54880455976897,0.01171900482525512,4.534232431264456,4.522513426439201,430320329,426004186.8,73.99529173789682,71.98188475734574,NaN,NaN,22.77375710013324,19.993287366937153
2020-12-04T09:30:00-05:00,300.74,302.59,300.6,302.59,2747275,3684848.8,64.99341645744165,62.32187232111665,NaN,NaN,127.70027420226707,84.3860131441811,0.10394660740027106,4.65244668568954,4.548500078289269,433067604,427419439.8,76.21006408857198,72.0352053086099,NaN,NaN,23.805286916783576,20.537858731200927
2020-12-07T09:30:00-05:00,301.77,302.16,300,301.1,2589937,3660433.4,62.144349122555745,61.85379550216736,NaN,NaN,105.74873047753086,95.75776324347483,0.019747902955279173,4.5731849569833685,4.553437054028089,430477667,429148566,78.60734578324188,72.1988569401666,NaN,NaN,23.91737178111084,21.020646309759485
2020-12-08T09:30:00-05:00,300.01,302.87,299.98,302.2,2205376,3228735.9,63.419251793326,61.66038283356982,NaN,NaN,108.98377513620258,101.75449285340815,-0.005374817743161842,4.546718531849137,4.552093349592299,432683043,430745621.2,80.55622246691993,72.6534864194721,NaN,NaN,24.35296892319561,21.49669239739322
2020-12-09T09:30:00-05:00,303.22,303.6,299.97,300.88,3074513,3164735.5,60.77421568307271,61.65070085678442,NaN,NaN,95.97575497720604,107.31533820112011,-0.14657937793083597,4.368869127178755,4.515448505109591,429608530,431231434.6,81.11968263982526,73.32946401290658,NaN,NaN,24.02539250589964,21.857935270036993
2020-12-10T09:30:00-05:00,299.99,301.15,299.2,300.54,2413039,3139866.5,60.079153016645435,61.553792083376074,NaN,NaN,60.24484009028221,99.73067497669773,-0.2902642152633703,4.152618236030378,4.442882451293748,427195491,430606467,77.98865634100503,73.72504691427903,NaN,NaN,23.569123914701645,22.10239079070337
2020-12-11T09:30:00-05:00,299.43,301.18,298.68,300.93,2454313,3042509.35,60.63529031841627,61.78828410730991,NaN,NaN,54.87482131049332,85.16558439834299,-0.3807229802105043,3.966978726030618,4.347701706241122,429649804,429922907,74.5971955931384,74.00621159583555,NaN,NaN,23.31776155187194,22.276015185156023
2020-12-14T09:30:00-05:00,303.02,303.799,299,299.1,3646063,3069670.8,56.64748388956797,61.496968958140755,NaN,NaN,62.157460325210806,76.44733036787896,-0.5738861452033097,3.630344024736985,4.204230169940295,426003741,429028121.8,70.2883069186288,74.18842169359742,NaN,NaN,22.064021519038203,22.24573037571062
2020-12-15T09:30:00-05:00,300.95,302.94,299.48,302.62,4228573,3050347.5,61.84542637418227,61.28736786454665,NaN,NaN,89.51511303671745,72.55359794798196,-0.4785640020992723,3.6060251673162043,4.084589169415477,430232314,428537976,67.97216558864972,74.12969907668649,NaN,NaN,22.312294024386418,22.255239468378594
2020-12-16T09:30:00-05:00,302.54,302.8721,301.32,302.15,1977342,2946756.4,60.79723432095358,61.18675703898105,NaN,NaN,95.06224961948922,72.3708968764386,-0.46096353549135927,3.5083847500512775,3.9693482855426367,428254972,428267264.4,66.66554448584031,73.88214053632247,NaN,NaN,22.240283887569063,22.253102956834375
2020-12-17T09:30:00-05:00,303.2165,303.71,302.85,303.49,3002872,2918577.85,62.73637789592539,61.190906021518565,NaN,NaN,123.9836268978103,85.11865423794418,-0.37643955488437086,3.498798841937173,3.875238396821544,431257844,429079735,68.61547693648859,73.71595151990809,NaN,NaN,22.695564822811512,22.31631179483111
2020-12-18T09:30:00-05:00,303.07,303.14,300.23,301.9,4442136,2977353.55,59.00669783097735,61.223688879866174,NaN,NaN,69.22308812173408,87.98830760019234,-0.4405278720536443,3.3245785567544885,3.765106428808133,426815708,428512915.8,65.72685544822606,73.30758855913733,NaN,NaN,22.086397205113457,22.28346685344287
2020-12-21T09:30:00-05:00,298.79,302.97,297.42,302.14,6340751,3139763.8,59.399059911347415,61.14538497887377,NaN,NaN,28.467134860140032,81.25024250717817,-0.47661350596715213,3.1693395463491925,3.6459530523163446,433156459,429943459.4,69.24581302320622,73.11310801834807,NaN,NaN,21.676190730535154,22.19671312159891
2020-12-22T09:30:00-05:00,301.84,301.88,299.8597,300.07,2723542,3133159.85,54.54943480847833,60.663798186183335,NaN,NaN,6.223868380371992,64.59199357590909,-0.6395884367893592,2.8464675063296454,3.4860559431190046,430432917,429983580,69.34088896594729,72.9235364298276,NaN,NaN,19.9918575942863,21.88173376055425
2020-12-23T09:30:00-05:00,301.2,302.7899,301.14,301.28,2714356,3067743.4,56.77121618003765,60.27132911449484,NaN,NaN,64.62653453024747,58.504850558060774,-0.6627720167379088,2.6575909221966185,3.3203629389345273,433147273,430962040.2,71.64329828261086,72.75553689730718,NaN,NaN,19.123249365647222,21.487664561281818
2020-12-24T09:30:00-05:00,301.66,302.1,300.93,302.02,1955723,3034070.55,58.11957098640052,59.78034015227762,NaN,NaN,56.21595896929672,44.951316972358065,-0.6256054751005689,2.538356095058816,3.163961570159385,435102996,431731070.6,73.3380273583694,72.55039141657842,NaN,NaN,18.73617363213291,21.09459442854626
2020-12-28T09:30:00-05:00,303.69,305.15,303.3517,304,2382440,3077292.35,61.57325735020536,59.73954788282401,NaN,NaN,177.486209878409,66.60394132369305,-0.47200119339815805,2.5739600784116874,3.0459612718098454,437485436,433865016.2,77.37817095304159,72.46259321442126,NaN,NaN,19.335682125128546,20.843321242343727
2020-12-29T09:30:00-05:00,305.43,305.7,302.64,303.46,2319636,2985309,60.11718268103703,59.50368580337481,NaN,NaN,161.03331245543495,93.11717684275204,-0.4132129088873979,2.5294451357005983,2.942658044587996,435165800,434266884.4,78.0526547170322,72.28376694657213,NaN,NaN,19.45438270634873,20.6449014514873
2020-12-30T09:30:00-05:00,304.11,305.13,303.86,304.13,2081348,2946089.85,61.33879288996095,59.544012746723965,NaN,NaN,171.54554822866393,126.18151281241043,-0.33877406451926717,2.519190463938912,2.8579645284581794,437247148,435629730.6,80.2078411344621,72.21863541047477,NaN,NaN,19.87882918556439,20.535462556355455
2020-12-31T09:30:00-05:00,304,306.29,303.35,305.79,2796979,2961854,64.2597325838309,59.8426255729515,NaN,NaN,186.90916248519116,150.63803840339915,-0.19447633786093954,2.614869106132005,2.8093454439929446,440044127,437009101.4,82.12145329630091,72.5138351929959,NaN,NaN,21.053227712402936,20.60942900721938
2021-01-04T09:30:00-05:00,306.59,306.66,298.74,302.32,5106635,3060142.45,54.919093142146835,59.434325774646545,NaN,NaN,30.19641233145672,145.43412907583118,-0.34089810691877354,2.3832228103444777,2.7241209172632512,434937492,436976000.6,81.9167731419029,73.03666216076479,NaN,NaN,19.397622902426637,20.436313849391844
2021-01-05T09:30:00-05:00,301.93,305.05,301.38,303.84,3355243,3090540.85,57.81194375460264,59.51750147929188,NaN,NaN,71.37293634195075,124.21147436853951,-0.3426344344420742,2.2958278742106586,2.638462308652733,438292735,437137460.4,82.15047192506637,73.88395966122462,NaN,NaN,18.834832172760674,20.20753075273025
2021-01-06T09:30:00-05:00,303.75,310.24,303.06,308.21,7290298,3325558.9,64.80459492219238,59.7288706612926,NaN,NaN,216.17918979135433,135.2406498357234,-0.07093243401205784,2.5497967661376606,2.6207292001497184,445583033,439220907,84.86802896603182,75.09080704532334,NaN,NaN,20.594240060635872,20.26277493957391
2021-01-07T09:30:00-05:00,309.72,311.98,309.059,310.5,4107942,3420687.2,67.81512457120044,60.23014853631024,NaN,NaN,267.89706716336826,154.51095362266426,0.22533327379404078,2.9023957923922694,2.6770625185982286,449690975,441709672.4,87.34633308481405,76.56800623096431,NaN,NaN,23.075038409804694,20.664526863892593
2021-01-08T09:30:00-05:00,311.25,311.43,307.99,311.04,3234948,3428708.95,68.49938115884922,60.64179162651908,NaN,NaN,203.88362406133598,157.90584593789322,0.4092698077542125,3.188649778290994,2.7793799705367817,452925923,444286031.6,89.29999805643314,78.04547202524607,NaN,NaN,25.269578173783074,21.32239133673409
2021-01-11T09:30:00-05:00,308.49,311,308.42,310.17,2822095,3449161.75,66.06251090207073,61.14577827445432,NaN,NaN,162.1991845923724,184.30640039007636,0.4222426200130247,3.3071832455530625,2.884940625540038,450103828,447319298.8,91.05170996737503,79.85439020518528,NaN,NaN,26.34031708945687,22.039237872837344
2021-01-12T09:30:00-05:00,310.18,311.25,308.91,310.74,2290854,3440988.8,66.89350744639029,61.68109595552881,NaN,NaN,145.90735689920217,199.21328450152663,0.41831368692750326,3.407832734199417,2.9895190472719135,452394682,450139688.2,92.31201193705716,81.50197584188892,NaN,NaN,27.463442672371613,22.814124272770812
2021-01-13T09:30:00-05:00,310.63,311.6,309.92,310.63,1854424,3351406.85,66.55481810924954,62.538623334155325,NaN,NaN,130.3928339075076,182.05601332475726,0.35964759556119263,3.439078541723404,3.0794309461622116,450540258,451131133.2,92.70117511697696,83.17056770981961,NaN,NaN,28.29081150335953,23.596508162854914
2021-01-14T09:30:00-05:00,311.59,312.2683,309.89,310.05,3232381,3301597.25,64.6948426723615,63.10459665503561,NaN,NaN,111.8661015324632,150.84982019857628,0.23893467565628201,3.378099290732564,3.139164615076282,447307877,450654513.6,90.33385206309816,84.50560726556871,NaN,NaN,28.48939064805779,24.295491375026753
2021-01-15T09:30:00-05:00,308.01,309.32,306.03,308.12,4009106,3403185.45,58.80558838777733,63.153597897991084,NaN,NaN,46.16149549163925,119.30539448463693,-0.0010384502109670457,3.1378665523125733,3.1389050025235403,443298771,448729083.2,81.3013016013121,85.07441256863603,NaN,NaN,27.00981706448577,24.683252187806612
2021-01-19T09:30:00-05:00,310.36,310.74,308.6,309.32,2781746,3392129.15,61.17227734667567,63.12495646916754,NaN,NaN,72.232271229564,101.31201181207524,-0.1034301203390986,3.009617352099667,3.113047472438766,446080517,447924421,77.80015120602818,85.10455401527794,NaN,NaN,26.38891244385107,24.926917938670105
2021-01-20T09:30:00-05:00,310.43,312.3385,309.94,311.77,2398402,3289942.45,65.52691970938955,63.51136625690699,NaN,NaN,95.96710259396811,91.32396095102841,-0.03421304092534028,3.0702811712820903,3.1044942122074306,448478919,447141268.4,74.44016072145541,84.84651872987959,NaN,NaN,27.110322767567936,25.238832914226936
2021-01-21T09:30:00-05:00,312.01,312.7098,311.2,311.87,1938431,3069826.45,65.69603136446871,63.82259757651469,NaN,NaN,97.81532665627462,84.80845950078182,-0.010956927121915427,3.0907980533050363,3.1017549804269517,450417350,447116686.8,74.33164821227506,84.4267906640091,NaN,NaN,27.74575230616622,25.596964255932548
2021-01-22T09:30:00-05:00,309.86,311.02,309.09,309.97,2049721,3036135.4,59.70323403845787,63.497133394702324,NaN,NaN,55.55528952405753,73.54629709910068,-0.14533773464776667,2.9200828121172435,3.06542054676501,448367629,447328637.2,74.67444773217196,83.89486169514274,NaN,NaN,26.567196616606502,25.73556887888597
2021-01-25T09:30:00-05:00,308.99,309.78,305.62,309.65,4546419,3127738.55,58.731510580276854,63.76944892599733,NaN,NaN,15.173202597131572,67.34863852019916,-0.27031468361590116,2.727527192245134,2.997841875861035,443821210,447433125,74.85274669085679,83.3902883772109,NaN,NaN,25.31899724681187,25.676058645732528
2021-01-26T09:30:00-05:00,310.54,311.19,309.21,309.39,2256091,3142756.95,57.906835792049726,63.77622692867212,NaN,NaN,46.5266457717533,62.207513428637014,-0.37840081637147627,2.5248408553966897,2.903241671768166,441565119,446530045.4,70.2493607312851,82.5402090062265,NaN,NaN,24.05212150312602,25.44406762536017
2021-01-27T09:30:00-05:00,306.54,306.7199,302.0971,303.26,5743141,3310792,42.68780022744495,62.19645587904731,NaN,NaN,-103.17866884153885,22.378359141535633,-0.8439812936781848,1.848265054670435,2.6922463483486196,435821978,443998657.2,59.24982996858876,80.7103376492663,NaN,NaN,17.5822449341698,24.32095009804726
2021-01-28T09:30:00-05:00,304.98,309.42,304.83,306.07,6392069,3514413.65,49.26975355484584,60.87178652073627,NaN,NaN,-39.670134322151355,-5.118733054149561,-0.9367722837594341,1.5212809936493272,2.4580532774087613,442214047,442357996.6,53.41243789811811,78.28648799307372,NaN,NaN,14.267863624159085,22.884794887491807
2021-01-29T09:30:00-05:00,303.92,304.78,298.59,299.81,5929934,3706842.95,38.62705012513708,58.73804858975682,NaN,NaN,-175.8878974252342,-51.40737044400792,-1.3677329056523568,0.7483871453433153,2.116120050995672,436284113,439941293.4,46.19308926820153,75.2074230796286,NaN,NaN,7.022900933602427,20.618810036936182
2021-02-01T09:30:00-05:00,302.28,303.35,300.14,302.02,3138644,3723926.2,43.28477521481464,57.111067469238534,NaN,NaN,-141.67578325202442,-82.77716761383911,-1.4444070809105114,0.31061119985753294,1.7550182807680443,439422757,439061602.8,43.868736419612745,71.83721068335987,NaN,NaN,3.0962523244622218,18.11558750658276
2021-02-02T09:30:00-05:00,304.5399,308.43,304.52,306.82,3090522,3623120.55,51.8347414018033,56.03544132319661,NaN,NaN,-38.65581886883042,-99.81366054195585,-1.1264221429233,0.3469906021139195,1.4734127450372194,442513279,439251234.8,44.516852057497104,68.42327069196271,NaN,NaN,3.106837012283957,15.971480293111503
2021-02-03T09:30:00-05:00,306.1,307.9353,305.18,307.26,2087820,3559749.4,52.54102515281012,55.03445611202236,NaN,NaN,-40.97274477167837,-87.37247572798375,-0.853419484795515,0.40663838904282557,1.2600578738383406,444601099,441007059,50.2452871202009,65.39070726362156,NaN,NaN,3.368251326862558,14.171019012218796
2021-02-04T09:30:00-05:00,307.85,310.67,307.77,310.67,2638783,3327173.65,57.715994960072265,54.53596698971599,NaN,NaN,36.23524739156334,-72.19139938524083,-0.43143852151330764,0.7207597219467061,1.1521982434600138,447239882,442012226,53.22278291288892,62.739916610035195,NaN,NaN,5.461930729126087,12.926863543205553
2021-02-05T09:30:00-05:00,312.36,312.55,310.87,311.54,1955606,3219556.85,58.94596593435857,54.545993957328925,NaN,NaN,87.24857413501879,-19.564105073190227,-0.09931531257065584,1.0280541027466938,1.1273694153173497,449195488,444594501,59.867311027530455,61.20891728333651,NaN,NaN,7.5020794600791,12.151894388473202
2021-02-08T09:30:00-05:00,312.6953,313.89,312.41,313.89,1690007,3142309.8,62.14878132437662,54.61574424145043,NaN,NaN,123.84353580105486,33.53975873742563,0.25375285150247207,1.4445604796954399,1.1908076281929678,450885495,446887048.6,64.66600505493503,60.270763986829834,NaN,NaN,10.26916601185029,11.882933191812786
2021-02-09T09:30:00-05:00,313.26,314.5,312.57,313.92,1798748,3091142.45,62.18933483552795,54.37734532188888,NaN,NaN,118.80783128258746,65.03248876770921,0.4528051569674769,1.756814074402314,1.304008917434837,452684243,448921241.4,68.28919050205491,59.83140897115836,NaN,NaN,12.431902305061945,11.96135735084838
2021-02-10T09:30:00-05:00,315.17,315.24,312.3,314.5,3048029,3129001.2,63.014371074941174,54.185798158351204,NaN,NaN,116.4777315309572,96.52258402823631,0.5789563358230609,2.027704337213663,1.4487480013906022,455732272,451147476,71.70835165695436,59.64403064577831,NaN,NaN,14.432729645163453,12.314410535750532
2021-02-11T09:30:00-05:00,315.09,315.76,312.8,314.68,1937081,3133134.05,63.28214311499874,54.441434520961266,NaN,NaN,115.52437579707265,112.38040970933818,0.6259548234715875,2.2311915307300865,1.605236707258499,457669353,453233370.2,74.48438290302099,59.630454586553235,NaN,NaN,16.136209261815342,12.860381782331219
2021-02-12T09:30:00-05:00,314.28,315.14,313.83,315.04,2479493,3095489.65,63.845916097929305,54.8067492007936,NaN,NaN,111.06084131081225,117.14286314449687,0.6309387011569807,2.393910083704725,1.7629713825477442,460148846,455424041.8,77.03318732473764,59.78620034611614,NaN,NaN,17.707758435467984,13.552864161350756
2021-02-16T09:30:00-05:00,316.33,316.54,314.8701,315.58,1836346,2986851.65,64.7209399334005,55.29347092517578,NaN,NaN,118.20273079292991,116.01470214287187,0.6193765147334849,2.5371920259646004,1.9178155112311155,461985192,457643981.2,79.29076647521943,60.432015042111466,NaN,NaN,19.273173341635626,14.370051187105737
2021-02-17T09:30:00-05:00,314.69,316.91,313.87,316.6,2019115,2948720.1,66.3763241397005,56.98550834747976,NaN,NaN,106.58068914193021,113.56927371474043,0.6272704790633465,2.701903610060299,2.0746331309969523,464004307,459907994,81.30868889509718,62.00764782257636,NaN,NaN,21.076370891398906,15.32809685914762
2021-02-18T09:30:00-05:00,314.75,316,313.38,315.56,2618615,2959730.75,63.123997571242974,57.97509720579383,NaN,NaN,83.7612286259576,107.02597313374051,0.5140513033328871,2.7171972601630614,2.2031459568301743,461385692,461038678,82.23946155976859,64.06672094126567,NaN,NaN,21.791293668134713,16.251410689002917
2021-02-19T09:30:00-05:00,315.61,316.34,314.58,314.92,2314889,2978553.65,61.138687355639135,59.58307129368684,NaN,NaN,82.42969011836067,100.40703599799812,0.355211332666598,2.647160122663422,2.291948789996824,459070803,461318968,82.47247209723078,66.65810542905346,NaN,NaN,21.887721524125904,17.056597951163344
2021-02-22T09:30:00-05:00,312.9,316.49,312.77,315.21,3003801,3026257.65,61.726094694532044,60.90030839938095,NaN,NaN,67.56778890423456,91.70842551668258,0.23464461416050364,2.5852545576974535,2.35060994353695,462074604,461704119.6,82.80628109744383,69.43935862032713,NaN,NaN,22.118629585501566,17.779745327497377
2021-02-23T09:30:00-05:00,314.77,316.49,311.6,315.39,5722901,3085081.75,62.108935218884135,61.63417938631528,NaN,NaN,57.01047340853494,79.46997403980359,0.13683238968414058,2.5216504306421257,2.384818040957985,467797505,462866582.2,83.80857353352056,72.2459101543288,NaN,NaN,22.41031505797651,18.441255288994395
2021-02-24T09:30:00-05:00,314.68,320.043,314.18,319.53,4290289,3186791.65,69.63268075771987,62.85501192952312,NaN,NaN,101.7382194794065,78.50148010729885,0.3108157996953844,2.773337790577216,2.4625219908818314,472087794,464483279.6,85.10871673579386,74.73615512687115,NaN,NaN,24.882286409850675,19.361402591973864
2021-02-25T09:30:00-05:00,319.7144,319.92,312.96,313.98,7648597,3282064.45,54.11873548473067,62.59806482414158,NaN,NaN,62.15774462496339,74.1807833071,0.026933375527966597,2.49618871029179,2.4692553347638233,464439197,465093980.6,85.57976246097026,77.04736795173412,NaN,NaN,22.100342111886558,19.752679666247104
2021-02-26T09:30:00-05:00,314.42,314.44,308.78,309.45,7925551,3358738.55,45.25587337122203,61.620201069631825,NaN,NaN,-23.17258517695974,53.06032824803592,-0.46401626691585474,1.8892350011190047,2.3532512680348594,456513646,464582549.2,83.20604373713866,78.71442028813469,NaN,NaN,16.363750409274218,19.268546915250976
2021-03-01T09:30:00-05:00,313.48,316.92,313.45,315.59,4753274,3299905.55,55.817513355064214,61.16796764325237,NaN,NaN,54.70433906682418,50.48763828055386,-0.3770231788363665,1.881972294489401,2.2589954733257676,461266920,464421012.4,82.42835895154849,79.9831598521785,NaN,NaN,15.412881133558793,18.71773751786638
2021-03-02T09:30:00-05:00,315.72,316.43,314.01,314.19,4075678,3346757.25,53.29282976570257,60.5325029954077,NaN,NaN,40.61974040214146,47.20949167927516,-0.4126729783992453,1.743154250326711,2.1558272287259563,457191242,462299759.8,72.80521829180681,80.30573326573221,NaN,NaN,13.756371526485363,18.00897094766909
2021-03-03T09:30:00-05:00,313.94,315.87,312.83,312.99,5148051,3449633.7,51.15693957533703,59.685543602578825,NaN,NaN,0.1426597257926167,26.890379728552386,-0.5096200445907373,1.5188021729875345,2.028422217578272,452043191,458290839.2,58.827394941734156,79.38566492893077,NaN,NaN,11.728432861711534,17.111751221103727
2021-03-04T09:30:00-05:00,313.19,314.92,305.68,309.58,8577594,3774122.4,45.568017084696955,58.420248886128704,NaN,NaN,-175.5755961130897,-20.656288419058235,-0.7797804344423107,1.0536966745253835,1.8334771089676942,443465597,454096119.2,48.3642606853257,77.5199419133811,NaN,NaN,8.041903714658783,15.81605872018302
2021-03-05T09:30:00-05:00,312.5,316.05,307.9,315.24,7016121,3992989.3,54.461107905296146,57.749905443797765,NaN,NaN,-58.82429931604292,-27.786631246874872,-0.5637418376397665,1.128799811917986,1.6925416495577525,450481718,452889733.6,45.839116006992974,75.29179396211363,NaN,NaN,8.16341814152671,14.722824351803547
2021-03-08T09:30:00-05:00,316.75,321.73,315.83,318.25,8230727,4306745.35,58.35756120811596,57.295378391991726,NaN,NaN,202.73359869489985,1.8192206787402596,-0.22212016290885606,1.4148914459216826,1.6370116088305386,458712445,452378838.6,44.772991284332356,72.82623859133598,NaN,NaN,9.702992163150807,14.005705467710298
2021-03-09T09:30:00-05:00,319.47,321.77,318.44,318.61,5829913,4513740.65,58.81148592184454,56.75503280500202,NaN,NaN,212.19039119449315,36.1333508372106,0.011695627091349525,1.6516311426947254,1.639935515603376,464542358,453849061.8,48.48605891928414,70.48176502163506,NaN,NaN,11.019901319201422,13.579162017923316
2021-03-10T09:30:00-05:00,320.53,324.31,320.47,323.33,6472177,4747412.1,64.30531788937444,56.83941282772569,NaN,NaN,264.58937358085325,89.02269360822272,0.4439021245603787,2.1948131713038492,1.7509110467434705,471014535,457643330.6,56.59636033590263,68.65011493421606,NaN,NaN,14.112144351494194,13.655302351290585
2021-03-11T09:30:00-05:00,324.71,326.97,323.83,325.33,5745916,4882306.45,66.35324774923325,57.21188142726812,NaN,NaN,255.7643292865193,175.2906786881445,0.80320330690141,2.754915180370233,1.951711873468823,476760451,464302301.4,66.54982557231081,67.51278303957892,NaN,NaN,17.28111734307475,14.173275921545466
2021-03-12T09:30:00-05:00,325.67,328.49,325.5,328.31,4257160,4998310.4,69.18971771195372,57.74499735708395,NaN,NaN,224.42009121307206,231.93955679396748,1.1586843361690065,3.400067293680081,2.2413829575110746,481017611,470409480,72.72710896403882,66.79284217290713,NaN,NaN,20.870678129989706,15.130047665608929
2021-03-15T09:30:00-04:00,329.18,330.24,326.8101,330.09,4465420,5097606.75,70.77455469559925,58.36397017684932,NaN,NaN,197.3189094714037,230.8566189492683,1.4139139919790438,4.008775447484879,2.5948614555058356,485483031,475763597.2,76.77625411862479,66.29053364327171,NaN,NaN,24.285827943839237,16.438016276784687
2021-03-16T09:30:00-04:00,329.85,330,328.32,328.86,3270599,5169319.4,68.16526765811787,58.259154955449176,NaN,NaN,160.31002050188928,220.48054481074752,1.3976147047089058,4.341879836391968,2.944265131683062,482212432,479297612,78.99320993344232,65.85371172881803,NaN,NaN,26.218923207684792,17.835288695484703
2021-03-17T09:30:00-04:00,329.21,331.03,328.38,330.77,4338229,5285275.1,70.01400861360978,59.39453160751197,NaN,NaN,144.27471403028431,196.41761290063374,1.4091827896449378,4.705743618739234,3.2965608290942963,486550661,482404837.2,80.73458449783976,65.50762758859443,NaN,NaN,28.400312953337814,19.344577875178004
2021-03-18T09:30:00-04:00,330.3,332.86,328.77,329.36,5386239,5423656.3,66.92422110077888,60.94227073105174,NaN,NaN,124.86713651674782,170.23817434667941,1.222524728970706,4.824716740307679,3.6021920113369728,481164422,483285631.4,81.2100772431155,65.36505855330707,NaN,NaN,29.273716210286103,20.763026208764874
2021-03-19T09:30:00-04:00,328.09,328.18,324.98,326.01,5628836,5589353.65,60.13413732251603,61.25060101444116,NaN,NaN,70.56603222580276,139.46736254922558,0.7948146355301065,4.595710305749606,3.800895670219499,475535586,482189226.4,78.60919836766044,65.09226136874362,NaN,NaN,27.927870601040418,21.78657540766138
2021-03-22T09:30:00-04:00,325.55,327.98,325.03,327.24,3807558,5629541.5,61.67178007311967,61.84909746497096,NaN,NaN,66.4247256084696,113.28852577663875,0.5289124247170243,4.4620362011157795,3.933123776398755,479343144,480961249,75.68553647358857,65.29799838172804,NaN,NaN,27.280753761295422,22.5714580296091
2021-03-23T09:30:00-04:00,326.32,327.48,323.44,324.06,5068441,5596818.5,55.69114731163859,62.172969446135355,NaN,NaN,42.45077667998562,89.71667701225803,0.09572589742884086,4.052781148184806,3.9570552507559653,474274703,479373703.2,71.9593744776431,66.23599692000724,NaN,NaN,24.861043264463596,22.898541634588316
2021-03-24T09:30:00-04:00,325.28,327.73,324.08,324.08,6098982,5687253.15,55.720231272702044,62.898127602421425,NaN,NaN,41.64114180688001,69.18996256757717,-0.21560449948997995,3.6875496263934906,3.9031541258834705,480373685,478138308,69.10808048924193,67.71769833457267,NaN,NaN,22.93791746806542,22.904166753656472
2021-03-25T09:30:00-04:00,322.71,326.62,320.62,326.19,5557909,5582718.75,58.79327205072976,63.207567898523834,NaN,NaN,28.994492210972172,50.015433706422044,-0.30036705713773326,3.5276953044613037,3.828062361599037,485931594,479091742.4,70.09299192037261,69.45011804267122,NaN,NaN,22.168292818819832,22.799041905822666
2021-03-26T09:30:00-04:00,327.6,330.89,326.68,330.61,4956562,5434269.3,64.37137515040817,63.63712603725899,NaN,NaN,80.10674467235889,51.923576195733254,-0.09057448844335969,3.7148442510448376,3.8054187394881973,490888156,482162256.4,73.07070109016303,71.47138302880197,NaN,NaN,23.201564181689722,22.856545088089387
2021-03-29T09:30:00-04:00,329.29,332.46,328.9,331.66,5200879,5456649.55,65.5639441696168,64.11944448352844,NaN,NaN,93.71595498262137,57.381822070563615,0.07798276435935847,3.9028971949373954,3.824914430578037,496089035,485511434.6,75.89044903782545,73.42883946584062,NaN,NaN,24.406203201215153,23.077924818535926
2021-03-30T09:30:00-04:00,331.05,331.6,329.78,330.82,4568829,5481307.1,63.72623248520145,64.07808124037322,NaN,NaN,86.7729981747148,66.24626636950944,0.09106534719274739,3.9387461145689713,3.847680767376224,491520206,488960535.2,78.39894028039566,74.98616660473299,NaN,NaN,24.865424203119783,23.333281873476476
2021-03-31T09:30:00-04:00,330.61,331.62,329.94,330.18,3763686,5412088.85,62.29357964831129,63.78810494745022,NaN,NaN,82.22327951730628,74.36269391159469,0.018569584740914635,3.870892748302367,3.8523231635614525,487756520,490437102.2,79.38768074390595,75.90315625984692,NaN,NaN,24.844697773683794,23.54919843064895
2021-04-01T09:30:00-04:00,330.78,331.6,329.72,331.45,5936080,5280013.15,64.0220713808653,63.41898735237248,NaN,NaN,85.27867714411819,85.6195308982239,0.01808473510549069,3.874929082443316,3.8568443473378253,493692600,491989303.4,80.40316395894827,76.45144590234045,NaN,NaN,25.305881400186486,23.800153140582882
2021-04-05T09:30:00-04:00,333.94,336.1521,333.91,335.2,5632673,5210840.75,68.59930880329173,63.2636126457791,NaN,NaN,158.64240336078032,101.32666263590819,0.22098693465758412,4.133078015659805,3.912091081002221,499325273,493676726.8,81.4718233519204,76.78684370471872,NaN,NaN,27.09123288633436,24.27030738997595
2021-04-06T09:30:00-04:00,334.69,335.42,333.78,334.37,2987511,4948679.95,66.580271450276,63.150398630933246,NaN,NaN,137.69727053223693,110.1229257458313,0.24794315358792218,4.222020022987124,3.9740768693992017,496337762,493726472.2,81.50384534356141,76.9661748054415,NaN,NaN,27.991325323134713,24.801881380427204
2021-04-07T09:30:00-04:00,334.14,335.17,333.44,334.37,2658526,4790110.6,66.580271450276,62.90513169069512,NaN,NaN,128.7311352182959,118.5145531545475,0.2156102993331812,4.243589743565678,4.027979444232497,496337762,494689983.4,82.14742891796257,77.06709226402172,NaN,NaN,28.726842035592963,25.362590045450883
2021-04-08T09:30:00-04:00,334.3,335.15,333.43,335.13,2664978,4599750.65,67.59317018556493,62.95291376817984,NaN,NaN,124.91976361793611,127.05384997467347,0.1958211492895563,4.272755880844443,4.0769347315548865,499002740,496939227.4,83.583477572296,77.23662085896318,NaN,NaN,29.623866500915792,25.971343824803014
2021-04-09T09:30:00-04:00,335.72,338.08,335.36,337.86,3034682,4464188.95,70.99399854389864,63.72861814113573,NaN,NaN,165.73988304648148,143.14609115514617,0.3102060116898082,4.4646922461671465,4.154486234477338,502037422,498608191.8,84.57497039639816,77.66274743244445,NaN,NaN,31.402218684000776,26.747183090402693
2021-04-12T09:30:00-04:00,337.26,337.86,336.65,337.55,2951503,4398906.1,70.0944685634221,64.33023874758591,NaN,NaN,148.96247915497756,141.2101063139856,0.3079795819537319,4.539460711919503,4.231481129965771,499085919,498560321,84.41748180464538,78.28645781323421,NaN,NaN,32.63761318111042,27.58867310336094
2021-04-13T09:30:00-04:00,336.63,337.42,335.49,336.79,3391673,4345218.75,67.82552470916572,65.19697999026643,NaN,NaN,113.88852503455351,136.44835721444892,0.20336027008541002,4.485681467572533,4.282321197487123,495694246,498431617.8,83.96478464800671,79.14398711111733,NaN,NaN,33.08990182673028,28.37456292098513
2021-04-14T09:30:00-04:00,336.81,339.11,336.74,337.53,3966835,4380030.55,68.88175333066916,66.13708870869264,NaN,NaN,118.09723227605211,134.32157662600017,0.13531039711516435,4.451459193881078,4.316148796765914,499661081,499096281.6,84.42917621857266,80.2383510917838,NaN,NaN,33.755194969428544,29.14322464219133
2021-04-15T09:30:00-04:00,338.83,340.72,338.83,340.44,3881795,4357208.85,72.67992276209418,67.12899233093296,NaN,NaN,134.34369933892603,136.20636377019815,0.23192475748545682,4.606054743622735,4.374129986137278,503542876,500004308.8,85.06550502978642,81.3078163138848,NaN,NaN,35.44556702999393,30.043559269020275
2021-04-16T09:30:00-04:00,341.73,342.43,340.982,341.86,3748913,4275342.55,74.32665045001019,67.84008342376168,NaN,NaN,139.70839964693252,131.00006709028835,0.33106586229483703,4.787962314005824,4.456896451710987,507291789,501055182.2,85.78930972528407,82.21628835925058,NaN,NaN,37.37599116268914,31.091049539544397
2021-04-19T09:30:00-04:00,341.07,341.31,339.65,340.75,3222821,4155041.8,70.73736450946333,68.20961344803644,NaN,NaN,110.42485108585794,123.29254147646441,0.26438028550386594,4.7873718085908195,4.5229915230869535,504068968,502051792,86.45953951486217,82.97122339332465,NaN,NaN,38.020959911012206,32.081036735468366
2021-04-20T09:30:00-04:00,339.4,339.86,336.7507,338.12,3762864,4152807.1,62.97730548793455,68.15611866251737,NaN,NaN,69.90774875880697,114.4963862213151,-0.00035189974160765303,4.522551648409944,4.522903548151552,500306104,502974163.6,87.06747478358785,83.59040442926695,NaN,NaN,36.30764566478365,32.684838011084835
2021-04-21T09:30:00-04:00,337.63,341.54,337.56,341.3,4191221,4108946.1,67.60486486645847,68.53549617809931,NaN,NaN,94.86690888206839,109.85032154251837,-0.004556734934901385,4.517207629482925,4.521764364417827,504497325,503941412.4,87.69155997756272,84.18353866024243,NaN,NaN,36.18901725883792,33.18543504647813
2021-04-22T09:30:00-04:00,341.12,341.21,337.0901,338.12,4962486,4052121.3,59.58437249724392,68.21851768641207,NaN,NaN,66.20094907230502,96.22177148919417,-0.2511176061197089,4.20786735676819,4.458984962887899,499534839,503139805,84.07068657215639,84.44550456118587,NaN,NaN,33.46055022910251,33.224737215424476
2021-04-23T09:30:00-04:00,337.75,341.59,337.13,340.43,3615382,3954994.95,63.01676917041119,67.81976485549202,NaN,NaN,77.10784506609372,83.7016605730264,-0.28572609497811285,4.101827344165258,4.387553439143371,503150221,502311491.4,80.37744675369589,84.36733480416983,NaN,NaN,32.272203730371714,33.08866100327408
2021-04-26T09:30:00-04:00,341.15,341.48,339.39,339.87,2090866,3811710.15,61.64985595320037,67.46759231998662,NaN,NaN,82.49640066266203,78.11597048838722,-0.36817817021035104,3.9273307263804327,4.295508896590784,501059355,501709568.8,77.70599115373595,84.09605950489659,NaN,NaN,30.897828428130218,32.775684921110674
2021-04-27T09:30:00-04:00,339.6,340.425,338.695,339.83,2732683,3688300.35,61.547160910109945,67.10808442426047,NaN,NaN,64.29983904237449,76.99438854510072,-0.44227106675821926,3.7426700631430094,4.184941129901229,498326672,501313682.4,75.91877306632034,83.65115551549356,NaN,NaN,29.768856619907602,32.34613802093881
2021-04-28T09:30:00-04:00,339.23,339.49,338.06,338.37,3025135,3611115.65,57.76483865806233,66.40606074372457,NaN,NaN,35.01413430362639,65.02383362941232,-0.5968535773788934,3.4388741581776117,4.035727735556505,495301537,499474524.8,68.08440873960416,82.54407917030129,NaN,NaN,27.695122047181925,31.681707167544968
2021-04-29T09:30:00-04:00,339.89,340.86,337.37,340.57,3688409,3607351.8,61.594805233110044,65.73468979295396,NaN,NaN,55.67214989804182,62.91807379455969,-0.5588489485087274,3.337166549920596,3.8960154984293234,498989946,499365546.2,67.63900001148178,81.33436699995012,NaN,NaN,27.009829233121003,31.01429603405583
2021-04-30T09:30:00-04:00,338.92,339.65,337.85,338.94,2909575,3456026.55,57.438802627261666,64.83071365465679,NaN,NaN,23.55017880633973,52.20654054260889,-0.6452746197080517,3.0894222237942586,3.7346968435023102,496080371,497951576.2,61.97394837237607,79.73125746907374,NaN,NaN,25.17766280534418,30.18049128709702
2021-05-03T09:30:00-04:00,340.79,342.18,340.5535,341.11,2698416,3309313.7,61.192854242477594,64.35695147846478,NaN,NaN,107.16292351891462,57.139845113859415,-0.5611823819885027,3.033218866016682,3.594401248005185,498778787,497495462.6,60.22177233195082,78.03532801792689,NaN,NaN,24.72649198121541,29.401348529113932
2021-05-04T09:30:00-04:00,339.99,341.53,337.62,341.49,4478302,3383853.25,61.82780792839557,63.853098235445245,NaN,NaN,61.893155520596586,56.65850840950384,-0.48757564656608654,2.984931689797577,3.4725073363636634,503257089,498481546,62.67847852658356,76.48170675421338,NaN,NaN,24.544788805190088,28.707554282839098
2021-05-05T09:30:00-04:00,342.25,343.3,342,342.28,2075112,3354682.55,63.176712071649206,63.174297471842024,NaN,NaN,151.58196899057089,79.97207534689274,-0.3971230818555802,2.976103484044188,3.373226565899768,505332201,500487678.8,67.12665856208847,75.20036057794924,NaN,NaN,24.77694877645747,28.146039210498866
2021-05-06T09:30:00-04:00,342.93,345.64,341.91,345.51,4276661,3435266.7,68.13476568818169,62.732019988854276,NaN,NaN,221.302234445348,113.09809225635397,-0.14423332706479464,3.192934907068775,3.3371682341335696,509608862,502611462,71.05916354186421,74.14820727913353,NaN,NaN,26.51285815525143,27.912727631177805
2021-05-07T09:30:00-04:00,345.17,348.29,344.81,347.88,3526538,3459859.5,71.19903034321956,62.76499611983686,NaN,NaN,273.6659149152115,163.12123947812833,0.14265755875499186,3.5154901825773095,3.3728326238223176,513135400,506022467.8,76.02072560542051,73.4025777141734,NaN,NaN,28.99233535115063,28.06695730545964
2021-05-10T09:30:00-04:00,349.26,351.0885,347.59,347.74,6092529,3616910.8,70.76611905790755,63.32133994626351,NaN,NaN,252.54029107116554,192.19671298857853,0.27531291887758114,3.716973772419294,3.441660853541713,507042871,507675284.6,77.98978400834086,72.75417123022721,NaN,NaN,30.848538815182984,28.464326092562974
2021-05-11T09:30:00-04:00,344.99,345.22,340.89,342.91,8396433,3867148.8,57.72554649987454,62.615674348650366,NaN,NaN,60.944334112061256,192.00694870687144,0.004410089214598845,3.4471734650599615,3.4427633758453626,498646438,506753154.4,74.32289802740891,71.79926680521622,NaN,NaN,28.31274317374363,28.442671389874498
2021-05-12T09:30:00-04:00,341.55,342.23,335.71,336,7034070,4020510.55,44.96060044727975,61.57111920222435,NaN,NaN,-96.8052178959943,142.32951132955841,-0.6379848138341595,2.645282358552663,3.2832671723868225,491612368,504009187.8,64.59089472408317,70.40785310178242,NaN,NaN,21.04239811038128,27.385489492804037
2021-05-13T09:30:00-04:00,336.3,342.04,336.27,340.45,5741302,4113485.9,52.27916067329725,60.80414716671621,NaN,NaN,-45.467784748390756,88.97550749081066,-0.7531255917481596,2.341860182701623,3.094985774449783,497353670,501558149.4,57.3651336101432,68.76411644867152,NaN,NaN,17.816136657685366,26.018439087787083
2021-05-14T09:30:00-04:00,342.31,344.93,341.8817,344.26,4677297,4159905.1,57.49090894034508,60.50707952294084,NaN,NaN,74.9613048880658,49.23458548538154,-0.5708846080762449,2.3813800143544768,2.9522646224307216,502030967,499337262.8,51.71932561774435,66.90792605324354,NaN,NaN,17.220151155338428,24.76154081172299
2021-05-17T09:30:00-04:00,343.33,345.125,342.04,343.65,3262206,4161874.35,56.42832785526764,60.1414485904521,NaN,NaN,64.39314890398231,11.60515705194489,-0.4925767835616086,2.336543642978711,2.8291204265403196,498768761,497682440.8,47.933772934317815,64.90899747238623,NaN,NaN,16.39930236437891,23.566935319245264
2021-05-18T09:30:00-04:00,343.85,344.5,340.87,341.11,3462332,4146847.75,52.109477196955254,59.73749420037303,NaN,NaN,19.22425347807082,3.261140925146795,-0.6055626842857169,2.0721670711831734,2.6777297554688904,495306429,497014439,46.45559901369531,63.36408249196416,NaN,NaN,14.236029279386866,22.233948742122635
2021-05-19T09:30:00-04:00,337.56,339.56,335.2,339.44,7223927,4298483.05,49.430708126844394,58.86863012135405,NaN,NaN,-92.06462224025896,4.2092600562938625,-0.7756233110263238,1.7082006166859856,2.4838239277123093,488082502,496308465.8,44.88039833674153,61.73846808662557,NaN,NaN,11.611188805811757,20.716411608363938
2021-05-20T09:30:00-04:00,339.74,342.94,339.34,341.52,4532808,4276999.15,52.692667637771436,58.529620479247605,NaN,NaN,-7.038805433954179,11.895055919181178,-0.7314583695127124,1.569500965821419,2.3009593353341313,492615310,495360793.8,42.78326397009256,60.36770491503389,NaN,NaN,10.528483059343213,19.26099324421812
2021-05-21T09:30:00-04:00,342.29,344.07,341.275,342.04,4480975,4320278.8,53.500213771524294,57.9801461598938,NaN,NaN,23.833317466835656,1.6694584349351493,-0.6532246052421589,1.4844285787814329,2.1376531840235917,497096285,494373857.4,40.652792425341126,58.969920635990334,NaN,NaN,9.920002413515286,17.926565982689144
2021-05-24T09:30:00-04:00,343.37,344.69,343.05,343.96,2531776,4342324.3,56.45585183348709,57.59643501025748,NaN,NaN,59.473851436892126,0.6855989415171123,-0.46690474573475793,1.5540222518551445,2.0209269975899025,499628061,494545717.4,41.20187244914201,57.43587734474452,NaN,NaN,10.316804235460626,16.839457161656497
2021-05-25T09:30:00-04:00,344.68,345,342.66,343.18,2623215,4336850.9,54.928373389921234,57.00726796156262,NaN,NaN,46.33545539072756,6.10783932404846,-0.39384933256990773,1.5286153318775177,1.9224646644474255,497004846,494885400.8,42.33744128200251,55.665218967595514,NaN,NaN,10.193335658184022,15.890011232589002
2021-05-26T09:30:00-04:00,343.56,344.1194,342.67,343.27,2064527,4288820.5,55.07939680781845,56.07474161296524,NaN,NaN,33.92166530588584,31.305096833277425,-0.339196535734249,1.4984689947796141,1.8376655305138632,499069373,497082775,49.175564365171674,54.1021047406889,NaN,NaN,10.13531632610691,15.067911960234417
2021-05-27T09:30:00-04:00,345.3499,346.16,343.87,344.6,3026179,4255709,57.35354028960277,55.0857780377069,NaN,NaN,74.85131246278227,47.68312041262472,-0.21903613156415802,1.5638703660586657,1.7829064976228237,502095552,498978823.4,54.22037968049089,52.54493717462251,NaN,NaN,10.719276572985509,14.446678333484574
2021-05-28T09:30:00-04:00,346.38,346.48,345.35,345.64,2642469,4242353.7,59.09731541248313,54.25229206303373,NaN,NaN,96.4293160195228,62.202320123162146,-0.08212373000914552,1.6802518351113918,1.7623755651205373,504738021,500507170.6,57.85205027907375,51.106527622532,NaN,NaN,11.698683563086114,14.054107651999079
2021-06-01T09:30:00-04:00,348.5401,348.65,345.6,345.87,2584285,4236647.15,59.49179962138986,54.37845300028482,NaN,NaN,112.51301833754165,72.81015350329206,0.0066061935404251315,1.7706333070460687,1.7640271135056436,507322306,502046019.6,61.19040186689069,50.16849218249498,NaN,NaN,12.621481115477625,13.8494467182103
2021-06-02T09:30:00-04:00,346.75,347.35,345.75,346.36,2576707,4141567.4,60.36873713532454,55.47903419228802,NaN,NaN,97.09254990667597,82.96157240648174,0.07706243985533456,1.8603551633248117,1.783292723469477,509899013,504624853,66.04419843652991,50.27229959052695,NaN,NaN,13.636329008409653,13.819001331095922
2021-06-03T09:30:00-04:00,344.6079,346.96,343.56,346.02,4436384,4259631,59.407709170211284,55.98821622778188,NaN,NaN,60.26958403194704,88.23115615169397,0.07922736458707114,1.882326929203316,1.8030995646162449,505462629,505903504.2,68.16986156636597,51.04406587311429,NaN,NaN,14.26363094926804,13.882519847977653
2021-06-04T09:30:00-04:00,347.07,347.99,346.54,347.9,2594230,4175509.45,62.922488978939604,56.37618623053863,NaN,NaN,109.06755253990312,95.07440416711812,0.17996976152669641,2.0280617665246155,1.848092004997919,508056859,507095765.6,70.0524110179789,52.353571973131054,NaN,NaN,15.764330163146594,14.151349893001788
2021-06-07T09:30:00-04:00,348.5,348.54,346.02,346.59,2224299,4110397.5,59.083483066997836,56.56584017423364,NaN,NaN,96.30178590959336,95.04889814513224,0.13322899029771285,2.01462824287006,1.8813992525723473,505832560,507314673.4,70.39858527552752,53.9582014260746,NaN,NaN,16.07555359642551,14.426236136348034
2021-06-08T09:30:00-04:00,346.69,346.91,344.75,346.34,2748703,3943206.2,58.351804098330476,57.01172066718902,NaN,NaN,74.44872136357317,87.43603875033854,0.06384192277610312,1.9612016560424763,1.8973597332663732,503083857,506466983.6,67.16107646962791,55.43716410149836,NaN,NaN,16.150484993618928,14.672557401672448
2021-06-09T09:30:00-04:00,346.5375,346.88,344.69,344.79,2591194,3652944.25,53.895419054194825,57.33062859057119,NaN,NaN,52.09805614790202,78.43713999858375,-0.09921049141269367,1.773346619000506,1.8725571104131997,500492663,504585713.6,60.51026085506357,56.55358285280708,NaN,NaN,15.034747372623466,14.72429882609402
2021-06-10T09:30:00-04:00,346.54,347.73,344.8,344.98,3089394,3455710.45,54.35559357632186,57.449409014753364,NaN,NaN,57.02870050245854,77.78896329268605,-0.20115419748926988,1.6211143635516123,1.8222685610408822,503582057,504209599.2,59.24704528407627,57.72956723237735,NaN,NaN,14.210108239097508,14.650843027951662
2021-06-11T09:30:00-04:00,346.03,346.5485,343.57,345.12,3003271,3318808.9,54.71426684633552,57.53612709152559,NaN,NaN,24.84193996297442,60.94384077730031,-0.2621845037524251,1.4945379313503508,1.756722435102776,506585328,503915293,58.22279607645528,58.98456749317121,NaN,NaN,13.597253192073458,14.500330194254776
2021-06-14T09:30:00-04:00,344.83,344.87,342.47,344.3,2526962,3211292.15,52.13038369485687,57.227165081623426,NaN,NaN,-20.889261752911278,37.50563124479938,-0.35503915988113244,1.3129234852513605,1.667962645132493,504058366,503560454.2,56.94457011836262,60.109045898115546,NaN,NaN,12.40371862771577,14.200814256177775
2021-06-15T09:30:00-04:00,344.51,344.53,342.3701,343.41,2138494,3155106.55,49.403355840482185,56.83252097094921,NaN,NaN,-37.19645872045036,15.176595227994682,-0.466631137860988,1.084673722806258,1.551304860667246,501919872,503327657.2,56.07478267280049,61.09028456888683,NaN,NaN,10.646563071374676,13.69306408692019
2021-06-16T09:30:00-04:00,343.41,343.64,339.49,340.76,4031995,3183589.7,42.30677542642148,55.920190872278006,NaN,NaN,-113.30564610525639,-17.90414522263701,-0.6953730118583294,0.6820885958443341,1.3774616077026636,497887877,502806700,54.083933164750626,61.44088234028533,NaN,NaN,6.954781218795726,12.730452248616695
2021-06-17T09:30:00-04:00,340.5599,341.28,336.62,338.65,5169081,3080847.4,37.66720912042648,54.51402436019398,NaN,NaN,-209.66865833784502,-71.24361699069773,-0.9495047098807674,0.19058072035170426,1.1400854302324717,492718796,500634047.8,46.64591406409029,60.899849081971,NaN,NaN,2.223388583850194,11.229443153650053
2021-06-18T09:30:00-04:00,334.35,335.25,332.68,332.96,7126597,3210536.85,28.568665060696304,52.3334064779235,NaN,NaN,-316.7154517816026,-139.55509533961313,-1.4325313773448078,-0.6505787914485381,0.7819525858962697,485592199,496435422,36.26606383077021,59.357992907092175,NaN,NaN,-5.812440676243741,8.794888320808083
2021-06-21T09:30:00-04:00,335.26,339.0899,334.41,338.78,5435720,3258274.1,43.58048125582525,51.19688373752603,NaN,NaN,-170.32712465416364,-169.4426679198636,-1.2958975818285743,-0.8379193913894483,0.4579781904391261,491027919,493829332.6,31.570142199033086,57.24226007367377,NaN,NaN,-7.32485331573297,6.492068087016504
2021-06-22T09:30:00-04:00,338.73,340.41,337.45,339.45,4042104,3333790.5,45.01313080040904,50.10005471360349,NaN,NaN,-106.82892058221816,-183.36916029221715,-1.1037425382108763,-0.9216999823244691,0.18204255588640705,495070023,492459362.8,29.413983927349122,54.62581618016086,NaN,NaN,-7.930657498389447,4.431678717672797
2021-06-23T09:30:00-04:00,339.59,340.16,338.68,338.78,3082666,3356763.05,43.81496279260988,48.98628711520339,NaN,NaN,-90.20253609801743,-178.74853829076937,-0.9698609538230207,-1.0302836363923689,-0.06042268256934816,491987357,491279258.8,27.66142503426606,51.73235642786801,NaN,NaN,-8.802740434239924,2.5410474102566942
2021-06-24T09:30:00-04:00,340.67,342.3161,340.37,341.98,3704742,3438773.8,50.58097162451314,48.10475016131579,NaN,NaN,-35.45404197496179,-143.90561501819272,-0.6303374703475281,-0.8483445205037583,-0.2180070501562302,495692099,491873919.4,29.927124363981875,48.86626452401108,NaN,NaN,-7.169168101051648,1.153873765784074
2021-06-25T09:30:00-04:00,343.69,344.98,343.0901,344.45,3638030,3469366.35,55.0777835304304,47.8186287658467,NaN,NaN,20.73081282178732,-76.41636209751474,-0.2248702384970906,-0.49909484827759343,-0.27422460978050284,499330129,494621505.4,39.37531477677252,46.650316631242866,NaN,NaN,-4.237356673294779,0.38369798877280936
2021-06-28T09:30:00-04:00,344.33,344.42,341.82,342.8,3606313,3517558.55,51.69385549566997,47.3430610085138,NaN,NaN,-0.9962644561955538,-42.550190057921135,-0.06174225517306764,-0.35140242874683736,-0.2896601735737697,495723816,495560684.8,42.2420803838958,44.87038833940486,NaN,NaN,-3.0127743616936344,-0.10151234700811113
2021-06-29T09:30:00-04:00,343.98,344.73,342.611,342.86,2375814,3507135,51.80980138854882,47.19408831811051,NaN,NaN,11.57899010799277,-18.868607919878944,0.05020967184089331,-0.22689808377265308,-0.2771077556135464,498099630,496166606.2,44.079327158190594,43.696750218199654,NaN,NaN,-2.026681177188687,-0.3765364656053362
2021-06-30T09:30:00-04:00,342.38,345.51,342.35,344.95,3778882,3567243.75,55.790407656783195,47.296575038143466,NaN,NaN,34.9039367643454,6.152686652593628,0.2536521527502405,0.03995743532425422,-0.21369471742598628,501878512,498144837.2,49.704437157342554,43.015135352004386,NaN,NaN,0.07954430281808307,-0.31138207011627633
2021-07-01T09:30:00-04:00,345.78,346.4,344.92,346.36,3606946,3525771.85,58.29336347395255,47.55222479725897,NaN,NaN,72.21368167627487,27.68623138284096,0.45980021339186605,0.3610555493138463,-0.09874466407801977,505485458,500103509,54.57645638648035,42.754682517006174,NaN,NaN,2.6130649936015256,0.10639608184340965
2021-07-02T09:30:00-04:00,347.04,348.29,346.18,347.94,3013489,3546734.8,60.96060537629777,48.18295491736189,NaN,NaN,109.05656019235838,45.351380856955174,0.6666384821662125,0.7345534386297459,0.06791495646353338,508498947,501937272.6,58.61808383385195,42.87421921096969,NaN,NaN,5.572454244185466,0.8872615336065606
2021-07-06T09:30:00-04:00,347.75,348.11,343.6,345.82,3910571,3631048.4,55.80375947716455,48.640126605696345,NaN,NaN,73.55723672149375,60.262081092493034,0.6254217961201042,0.8496922016136637,0.22427040549355945,504588376,503710184.6,62.12670790862409,43.3064995849571,NaN,NaN,6.514533778973218,1.6911575686589402
2021-07-07T09:30:00-04:00,345.65,347.14,344.4299,346.92,3347034,3660964.95,57.79857836366361,49.74668395835649,NaN,NaN,80.78576237520458,74.1034355459354,0.6349571315151337,1.0179668198874765,0.38300968837234284,507935410,505677340.6,65.61076354356624,44.129844612015354,NaN,NaN,7.900649735229852,2.5782278781690704
2021-07-08T09:30:00-04:00,342.56,345,341.53,344.38,6379929,3850401.7,51.96596903655595,50.768023952365745,NaN,NaN,23.685227472906334,71.85969368764759,0.4420595006440612,0.9355840641774194,0.49352456353335816,501555481,505612734.4,65.3979807812905,45.46927794895823,NaN,NaN,7.293018024589809,3.2517693276577475
2021-07-09T09:30:00-04:00,346.57,349.07,345.844,348.73,5063138,3949088.9,59.50312448396557,52.97762819688497,NaN,NaN,120.82530912756559,81.58201917790572,0.5710889815363752,1.2073857904538272,0.636296808917452,506618619,505839366.6,65.81678053194938,47.58004342761389,NaN,NaN,9.28299654739992,4.113373216192343
2021-07-12T09:30:00-04:00,348.01,350.29,347.37,350.03,3999772,3998913.95,61.449929232970376,54.25401733810963,NaN,NaN,140.5254508542785,87.87579731028976,0.6991866987657416,1.510280182374629,0.8110934836088874,510618391,506263255.4,66.63030792500979,50.08434097946936,NaN,NaN,11.522925067657159,5.171880623544459
2021-07-13T09:30:00-04:00,349.53,350.25,348.85,349,3310228,4038077.25,59.0286638738005,55.25512684335187,NaN,NaN,128.16337352847086,98.79702467168518,0.6696965659612475,1.6482141910604469,0.9785176250991994,507308163,506807212.8,67.69287217173266,52.818547282639614,NaN,NaN,12.577976065301055,6.229894258081115
2021-07-14T09:30:00-04:00,350.19,350.69,348.36,349.41,3933330,4127819.05,59.70921082228445,56.390430274042906,NaN,NaN,115.08017399425405,105.65590699549507,0.633350405189175,1.770205631585668,1.136855226396493,511241493,507468429.4,68.98566523169154,55.77027872531287,NaN,NaN,13.630246952963148,7.28708750020712
2021-07-15T09:30:00-04:00,347.9,350,347.64,349.94,5082591,4180348.85,60.61982068441564,57.1074909211788,NaN,NaN,98.28683464533579,120.57622842998096,0.6008269306883096,1.88788888975688,1.2870619590685703,516324084,510422150,73.99227143435427,58.917789230339466,NaN,NaN,14.757253178128577,8.35425402562447
2021-07-16T09:30:00-04:00,350.72,350.74,346.34,346.74,5710392,4207414.4,52.85281706051464,56.94856474475625,NaN,NaN,68.46633403618915,110.10443341170567,0.3329950840106075,1.7033058140818298,1.3703107300712223,510613692,511221164.6,75.16041259500369,61.473867645927406,NaN,NaN,13.41339346767427,9.076988231631585
2021-07-19T09:30:00-04:00,341.79,350.03,337.38,339.88,9715318,4336850.45,40.78779953015216,56.16956074721926,NaN,NaN,-53.20260888294182,71.3588214642616,-0.3026149164199732,0.9920420845462559,1.294657000966229,500898374,509277161.2,67.24652726661674,63.25989956612176,NaN,NaN,7.7583869512113175,8.888616620142976
2021-07-20T09:30:00-04:00,340.29,346.12,339.75,345.08,5802181,4355173.5,50.088656912357315,56.046621856062735,NaN,NaN,-36.902513695850296,38.345644019397376,-0.3650906658093649,0.838293668704523,1.203384334513888,506700555,509155639.6,66.77321903982187,64.88089184338114,NaN,NaN,6.326244622627238,8.522563477640727
2021-07-21T09:30:00-04:00,346.97,348.15,346.37,347.99,3056841,4305910.35,54.40488537936007,55.947655979103935,NaN,NaN,52.196398122688436,25.768888845084252,-0.21037222274731238,0.9404190560797474,1.1507912788270598,509757396,508858820.2,65.55945843807709,66.01339336343361,NaN,NaN,6.775192473980632,8.272939048546428
2021-07-22T09:30:00-04:00,347.77,348.81,346.68,348.26,2429252,4273239.65,54.795494472937456,55.697808193317144,NaN,NaN,57.68064388172647,17.647650692362383,-0.09563041568190078,1.031253259224684,1.1268836749065847,512186648,508031333,62.16677938877253,66.55555929216877,NaN,NaN,7.246131237458508,8.126252218391011
2021-07-23T09:30:00-04:00,349.9999,350.99,349.205,350.57,4142346,4295119.85,58.10257146479655,55.49366291392419,NaN,NaN,116.34223860440899,27.222831606006356,0.11844585053814471,1.2749409880792655,1.1564951375411208,516328994,509174393.4,64.87113683243177,67.00220593492448,NaN,NaN,8.739296343329004,8.21382995052501
2021-07-26T09:30:00-04:00,350,351.45,349.49,351.41,2466576,4236547.15,59.269474019827925,55.74121395268587,NaN,NaN,118.51300804128213,61.565954990851154,0.2894788718440455,1.5183437273461777,1.2288648555021322,518795570,512753832.6,71.69441920965366,67.685613884998,NaN,NaN,10.296914087909052,8.51141339872273
2021-07-27T09:30:00-04:00,350.02,350.68,348.725,350.62,3902627,4251362.85,57.643440097349995,55.73013264794918,NaN,NaN,89.09507874669501,86.76547347936021,0.31988481460121454,1.6287208737536503,1.3088360591524357,514892943,514392310.2,74.16785125835565,68.2968344360544,NaN,NaN,11.064682543734282,8.87616613372438
2021-07-28T09:30:00-04:00,351.02,351.23,348.71,349.36,3697738,4317459.05,55.04938533667692,55.950376669386394,NaN,NaN,77.147643032205,91.75572246126352,0.22983111496769593,1.5961249528620556,1.3662938378943597,511195205,514679872,74.58756155270243,68.95323306258382,NaN,NaN,10.935434800947807,9.170347371899156
2021-07-29T09:30:00-04:00,350.95,351.7086,350.38,350.82,2425671,4249798.5,57.43941781561191,55.80296905021827,NaN,NaN,109.04345791500637,102.0282852679195,0.2420566228992025,1.6688646165183627,1.4268079936191602,513620876,514966717.6,75.023497215943,69.61085568286907,NaN,NaN,11.526044102842215,9.506875476319593
2021-07-30T09:30:00-04:00,349.88,351.01,348.67,349.48,3576715,4248286.95,54.571475007838465,55.31165089128029,NaN,NaN,61.174294944639136,90.99469653596553,0.13850672063139502,1.599941394408404,1.461434673777009,510044161,513709751,69.40491769466043,69.80904209498698,NaN,NaN,11.195787381838127,9.748148605679383
2021-08-02T09:30:00-04:00,350.45,351.91,348.06,348.35,2827133,4238969.15,52.20432765971685,54.82419830456002,NaN,NaN,47.04192606871153,76.70048014145141,-0.019094684253584404,1.4375663184600285,1.4566610027136129,507217028,511394042.6,60.426469802116195,69.29001335430009,NaN,NaN,10.241755781804063,9.818663916554337
2021-08-03T09:30:00-04:00,349.09,351.19,347.11,351.09,3819338,4234407.5,57.06732821276282,54.6354924038799,NaN,NaN,54.21696645546915,69.72485768320624,0.04470508186289246,1.5125423550422283,1.4678372731793359,511036366,510622727.2,57.746856141326866,68.4872412764169,NaN,NaN,10.824632416074248,9.962373702200038
2021-08-04T09:30:00-04:00,349.59,350.08,347.88,347.99,3118464,4222979,50.773064496881176,53.932152676198875,NaN,NaN,10.117932123403047,56.31891550144584,-0.1288667250739377,1.3067538668369139,1.4356205919108516,507917902,509967266.6,55.49471373679476,67.16598715516265,NaN,NaN,9.400742499449791,9.882140673235718
2021-08-05T09:30:00-04:00,348.85,350.65,348.67,350.61,2261380,4017051.55,55.26401886452295,54.10438137648517,NaN,NaN,57.139758336301675,45.93817558570491,-0.0767887640449918,1.339634636854612,1.4164234008996037,510179282,509278947.8,53.15047221720645,65.59384855674857,NaN,NaN,9.578665608839788,9.838787092607728
2021-08-06T09:30:00-04:00,351.62,352.49,351.46,352.09,2123737,3870081.5,57.616251713897036,55.306413675324094,NaN,NaN,135.10449204757901,60.72421500629289,0.04141496758437557,1.4681921103800732,1.4267771427956977,512303019,509730719.4,54.508762115537245,64.68400818881432,NaN,NaN,10.450726001755386,9.92620693677168
2021-08-09T09:30:00-04:00,351.6,352.06,350.55,351.15,2322494,3786217.6,55.61604772614725,55.70122730488051,NaN,NaN,93.95779078568896,70.10738794968837,0.04033547669536319,1.4771964886649016,1.4368610119695384,509980525,510283418.8,56.18250799000793,63.927528828113324,NaN,NaN,10.573270332725903,10.01864456476514
2021-08-10T09:30:00-04:00,351.41,352.94,351.01,352.73,2841009,3762756.65,58.24027152821997,55.97518345837051,NaN,NaN,122.10250105234203,83.68449486906295,0.1252767416381646,1.5934569390172442,1.4681801973790796,512821534,510640452.4,57.27605606510383,63.3358572300438,NaN,NaN,11.453760472401791,10.223661122998948
2021-08-11T09:30:00-04:00,353.94,355.12,353.7,354.94,3422522,3737216.25,61.65534175876888,56.465172550215605,NaN,NaN,186.31540594868227,118.92398963411881,0.29960098554032943,1.8426814293044913,1.5430804437641619,516244056,512305683.2,62.03512862637153,63.32645360415802,NaN,NaN,13.245954325411413,10.655417294772157
2021-08-12T09:30:00-04:00,355.19,355.25,353.735,355.23,3126880,3639430.7,62.093415314480495,56.75023282519304,NaN,NaN,166.58299811010633,140.81263758887974,0.3975976183166432,2.040077466659966,1.6424798483433227,519370936,514144014,66.47484924159164,63.441004490526566,NaN,NaN,14.829656847583319,11.251737230888038
2021-08-13T09:30:00-04:00,355.85,356.37,355,355.39,2414944,3474658.3,62.348994460060496,56.97019857092393,NaN,NaN,168.586618414538,147.50906286227155,0.4334139360347804,2.184247268386798,1.7508333323520178,521785880,516040586.2,70.32984515266791,63.34353491502759,NaN,NaN,16.203212036104187,11.959090774490345
2021-08-16T09:30:00-04:00,354.41,356.6,352.66,356.57,3637866,3170785.7,64.26271710103336,57.44300407118703,NaN,NaN,144.54299674323508,157.62610405378078,0.49248546541204963,2.36644016411708,1.8739546987050302,525423746,519129230.4,75.30918523177301,63.42505877027168,NaN,NaN,17.915804587302965,12.810049890606434
2021-08-17T09:30:00-04:00,353.91,354.67,351.51,353.83,5019577,3131655.5,57.0158357753467,57.583464816806305,NaN,NaN,73.39566240540736,147.88473632439383,0.31174856758746405,2.26364040818936,1.9518918406018961,520404169,520645757.4,77.32165890180437,63.62035143806468,NaN,NaN,17.39758479289914,13.465412019505392
2021-08-18T09:30:00-04:00,352.62,354.04,349.89,350.12,4038003,3180713.6,48.964285373261255,56.97809821378126,NaN,NaN,-1.200120011986219,110.38163113226014,-0.07243475165742597,1.8613484010301136,1.9337831526875395,516366166,520670179.4,77.35367057463408,63.786792392256906,NaN,NaN,14.4030773370456,13.599364207725422
2021-08-19T09:30:00-04:00,347.33,350.48,347.31,349.48,5442184,3331360.2,47.71256440336183,56.48817602774721,NaN,NaN,-88.67661187173266,59.329709135892315,-0.36790950063739314,1.4738962768907982,1.8418057775281913,510923982,518980788.6,69.99349234524134,63.82883343872697,NaN,NaN,11.588149999104957,13.312047892208213
2021-08-20T09:30:00-04:00,348.98,351.75,348.53,351.16,3394759,3293980.85,51.23656814833274,56.419050348362624,NaN,NaN,-36.84112859174528,18.24415973463565,-0.4433986415261282,1.287557475620531,1.7309561171466592,514318741,517487360.8,64.17989195801253,64.09693502129099,NaN,NaN,10.2256055968096,12.871127564294126
2021-08-23T09:30:00-04:00,352.96,354.31,352.92,353.45,3569246,3349114.35,55.6266454222905,56.316144434757454,NaN,NaN,70.58316106036982,3.4521925980625925,-0.33710842946438624,1.3095705803161763,1.6466790097805626,517887987,515980209,58.866036278826265,64.17687645968381,NaN,NaN,10.373685188749478,12.514350082073461
2021-08-24T09:30:00-04:00,354.08,354.49,353.62,353.74,1981376,3253051.8,56.164850257981215,56.70127198912174,NaN,NaN,75.13616708245868,3.8002935334728534,-0.2493213385115891,1.335027336641076,1.5843486751526652,519869363,515873247.8,58.495875862500505,64.3912451829485,NaN,NaN,10.649980544903764,12.248011576763504
2021-08-25T09:30:00-04:00,353.78,355.04,352.92,354.18,2434699,3189899.85,57.0167027966769,56.82646369856131,NaN,NaN,70.62222621425657,18.16476277872141,-0.16759268643826064,1.3748578171048393,1.5424505035431,522304062,517060827,61.39824862434886,64.98037206917296,NaN,NaN,11.117270614667802,12.086477153606976
2021-08-26T09:30:00-04:00,354.47,355,352.07,352.16,3008937,3219063.15,52.0188228048588,56.42664734791572,NaN,NaN,33.4556231746534,42.59120978799862,-0.25055517283350826,1.2292565375012146,1.4798117103347228,519295125,518735055.6,65.10321454113338,65.73711867100126,NaN,NaN,10.096090536787761,11.802136208347088
2021-08-27T09:30:00-04:00,352.65,354.8496,352.65,354.57,3163666,3198410.7,56.875690121841046,56.51662180475099,NaN,NaN,59.8090306785704,61.92124164206176,-0.1491105269642905,1.2934235516293597,1.4425340785936502,522458791,520363065.6,68.29031752030455,66.60196220887958,NaN,NaN,10.634438339668083,11.63532222710723
2021-08-30T09:30:00-04:00,354.96,355.22,353.88,354.08,2481998,3181153.95,55.64242872012001,56.33106160417242,NaN,NaN,66.40815157459696,61.08623974490719,-0.12213233113555844,1.2898686646742021,1.4120009958097606,519976793,520780826.8,69.07092607525583,67.44445292389044,NaN,NaN,10.723410299613157,11.505049094608076
2021-08-31T09:30:00-04:00,353.8,354.802,353.18,353.92,2913829,3135878.5,55.221368502016894,55.87149208583299,NaN,NaN,46.074240551267806,55.27385443866901,-0.12190431179474048,1.2596206060663349,1.3815249178610753,517062964,520219547,66.69532876473798,67.77732436234518,NaN,NaN,10.681196722935297,11.387355898654821
2021-09-01T09:30:00-04:00,354.29,354.35,353.29,353.55,2739235,3116917.05,54.19995063892158,55.307673180435934,NaN,NaN,31.303094801599006,47.4100281561375,-0.15157860280658353,1.1920516643528458,1.3436302671594293,514323729,518623480.4,60.33998530003265,67.33911979509097,NaN,NaN,10.373871344050725,11.242572390854235
2021-09-02T09:30:00-04:00,354.78,355.18,353.92,354.87,2392219,3123459,57.238760058815835,54.94265643748988,NaN,NaN,69.23669921914086,54.56624336503501,-0.0902421771253128,1.2308275457527884,1.3210697228781012,516715948,518107645,58.40301184188726,66.48720313003521,NaN,NaN,10.923674667758636,11.19701557326915
2021-09-03T09:30:00-04:00,353.68,354.6517,353.09,354.14,2469109,3140727.6,55.062903611134644,54.28552690249712,NaN,NaN,31.19780613890064,48.84399845710105,-0.10569788482965325,1.1889473668410346,1.294645251670688,514246839,516465254.6,52.61201481808723,64.8659766719148,NaN,NaN,10.815139581691408,11.142461860186616
2021-09-07T09:30:00-04:00,353.64,353.69,350.99,351.44,3168544,3183030.1,47.82199162557055,53.62882374894168,NaN,NaN,-74.36251538817068,20.689865064547526,-0.2939550911528166,0.9272013877296672,1.2211564788824838,511078295,514685555,47.1556114717511,62.71125899833957,NaN,NaN,8.616401897895484,10.781596151287882
2021-09-08T09:30:00-04:00,350.82,352.17,349.64,350.73,3075726,3194765.95,46.105025625810775,53.424590909838074,NaN,NaN,-126.3768473692192,-13.800352519549875,-0.45298504114232907,0.6549251774545723,1.1079102185969014,508002569,512873476,42.340636607620006,60.210328000695704,NaN,NaN,6.276815165269034,10.138056010428047
2021-09-09T09:30:00-04:00,350.56,352.5084,348.9223,349.31,3484688,3197874.25,42.79563388584832,53.07338158715854,NaN,NaN,-130.24918270535457,-46.11080802094059,-0.6296373970972713,0.3208634722253123,0.9505008693225836,504517881,510912306.4,37.83758650600576,57.913477583607445,NaN,NaN,3.2771137930514316,9.157921407945674
2021-09-10T09:30:00-04:00,351.25,351.66,346.57,346.7,4539038,3268482.15,37.47161949663735,52.09017096918029,NaN,NaN,-173.77797833583546,-94.71374353193585,-0.8825826762577449,-0.15272747599959757,0.7298552002581473,499978843,507564885.4,31.650218168646745,55.5899294557956,NaN,NaN,-1.0946513655538541,7.693268154588599
2021-09-13T09:30:00-04:00,348.91,349.94,347.47,349.3,5439709,3419720.4,44.83415730162521,51.31927896056134,NaN,NaN,-128.729004989777,-126.69910575767139,-0.835585459200721,-0.31462662374275396,0.5209588354579671,505418552,505799228,28.96014517632281,53.453794377045355,NaN,NaN,-2.6413765574575425,6.216890338582007
2021-09-14T09:30:00-04:00,350.4,350.57,345.705,346.47,3902220,3432938.1,39.39656672346563,50.12154442238166,NaN,NaN,-151.00225846475485,-142.02705437298823,-0.9476792143905577,-0.66364018253023,0.28403903186032764,501516332,503886835.4,26.348038306163303,51.15752026587842,NaN,NaN,-5.805727821363525,4.499373458589789
2021-09-15T09:30:00-04:00,346.41,349.46,345.78,348.82,3267250,3345321.75,45.326385113771885,49.2865217307456,NaN,NaN,-117.70037801387835,-140.29176050192004,-0.8208765178063316,-0.7420566153975869,0.0788199024087447,504783582,503243038,25.51374033908371,48.594341102645195,NaN,NaN,-6.490045725602787,2.929456432276564
2021-09-16T09:30:00-04:00,348.91,350.08,346,348.18,3646002,3325721.7,44.06192700427837,48.71817203070414,NaN,NaN,-102.03826822996889,-134.6495776068429,-0.7399292315144226,-0.8460916369842835,-0.10616240546986094,501137580,502566977.8,24.63170064195438,45.70351868127526,NaN,NaN,-7.436044762257452,1.4486705473431332
2021-09-17T09:30:00-04:00,346.85,347.7,345.06,345.64,5380943,3322659.65,39.36801150962066,47.46762355840268,NaN,NaN,-143.7189376529374,-128.6377694702633,-0.8115337313959334,-1.1205795697147778,-0.30904583831884436,495756637,501722536.6,23.537148209964258,42.50686373053667,NaN,NaN,-9.789825124611182,-0.15682883436462602
2021-09-20T09:30:00-04:00,340.22,342.16,335.99,339.4,10010551,3653449.25,30.71203715693359,45.686881303889365,NaN,NaN,-251.84428026237674,-153.26082452478323,-1.2092768158222218,-1.8206418580966215,-0.6113650422743998,485746086,497788043.4,19.245893291530948,38.94793281741346,NaN,NaN,-15.27982866331159,-2.3172573813570496
2021-09-21T09:30:00-04:00,341.41,343.07,339.01,339.11,6071105,3778542.2,30.377745062184005,43.91233677247273,NaN,NaN,-184.84528620496386,-160.02943007282502,-1.4081156107720063,-2.371509555739408,-0.9633939449674015,479674981,493419773.2,15.801360446481908,35.312649366109454,NaN,NaN,-19.519497260964187,-4.774720221300926
2021-09-22T09:30:00-04:00,341.16,344.329,340.44,342.5,6862699,4022608.35,38.76812154798037,42.81006326597692,NaN,NaN,-126.77635033978461,-161.84462453800626,-1.2338032091390962,-2.5056479563912717,-1.2718447472521754,486537680,489770592.8,13.609969201414671,31.97479107335103,NaN,NaN,-20.161827660304382,-6.972878426872848
2021-09-23T09:30:00-04:00,344.81,348.67,344.53,347.56,5592151,4180480.95,48.7048835006511,42.20050065467944,NaN,NaN,-43.12010076312814,-150.06099104463811,-0.7253570250975137,-2.1785410286240676,-1.453184003526554,492129831,487969043,12.675377408079171,28.70853147093617,NaN,NaN,-16.96670908117807,-8.400568520345022
2021-09-24T09:30:00-04:00,346.5,348.43,346.31,347.87,3121582,4186113.2,49.24827640058101,41.785170139639895,NaN,NaN,-28.159534530042386,-126.94911042005913,-0.33561651637321965,-1.8727046489930785,-1.5370881326198589,495251413,487867998.2,12.623019719979183,25.85217467821417,NaN,NaN,-14.382860391339985,-9.255181644772874
2021-09-27T09:30:00-04:00,348.29,350.5,348.17,348.61,3425978,4199228.8,50.59374806790188,41.983152742663556,NaN,NaN,5.3902936645380715,-75.50219563467616,-0.012502733339009309,-1.5527165492936206,-1.5402138159546113,498677391,490454259.2,21.554633301723968,24.023533380355087,NaN,NaN,-11.91340228536285,-9.63492745057144
2021-09-28T09:30:00-04:00,347.31,347.82,342.41,342.92,7493792,4449818.5,41.486351743626706,41.6532474653647,NaN,NaN,-80.63306634753854,-54.65975166319108,-0.1584065317093324,-1.7382219805912769,-1.5798154488819445,491183599,492755982.8,28.554257899051237,23.038792044028746,NaN,NaN,-12.874759026080385,-10.097760532787005
2021-09-29T09:30:00-04:00,343.87,345.67,342.88,343.77,4116581,4509956.1,43.133177634081754,41.67735773309566,NaN,NaN,-78.04652903717596,-44.91378740266936,-0.17290438362271088,-1.7959459284103332,-1.6230415447876223,495300180,494508482.8,33.42513618218112,22.723617020898413,NaN,NaN,-13.066390018544968,-10.521850459323856
2021-09-30T09:30:00-04:00,345.08,345.44,338.11,338.29,7926020,4769295.35,36.08246486305592,41.578132402125554,NaN,NaN,-131.63413263842435,-62.616593777728596,-0.5078512605998551,-2.257855620537441,-1.750004359937586,487374160,493557348.6,32.144272302390746,22.75890660188013,NaN,NaN,-15.773755413298593,-11.27212259560596
2021-10-01T09:30:00-04:00,340.03,344.78,337.68,343.18,6219801,4960674.45,44.75985912801507,41.57282538972483,NaN,NaN,-93.58998236381825,-75.70268334448379,-0.3631442400531726,-2.2039346600040517,-1.840790419950879,493593961,493225858.2,31.688502703001134,22.953789282357157,NaN,NaN,-14.839149619800631,-11.781697884776628
2021-10-04T09:30:00-04:00,342.61,344.03,338.07,340.01,7037745,5189106.25,40.88489827333386,41.67913478614399,NaN,NaN,-103.52700423664908,-97.48614292472121,-0.43892792130366054,-2.389450321580455,-1.9505224002767942,486556216,490801623.2,28.50535590391786,23.107883396482485,NaN,NaN,-15.500205674919698,-12.312913283368495
2021-10-05T09:30:00-04:00,341.13,344.87,340.47,343.13,3826144,5221986.25,45.85344579313215,41.71678197752686,NaN,NaN,-53.59003970332261,-92.07753759587803,-0.24652468609632638,-2.258678257897202,-2.0121535718008756,490382360,490641375.4,28.302965955448258,23.307113797651386,NaN,NaN,-14.247781577200819,-12.589323039630255
2021-10-06T09:30:00-04:00,340.48,344.2999,338.47,344.12,6276337,5382016.8,47.36515967203943,41.95272716808121,NaN,NaN,-57.73073612988464,-88.01437901441976,-0.03148292712325329,-2.0515072307049422,-2.020024303581689,496658697,490913078.8,29.220573951149504,23.634890462593894,NaN,NaN,-12.768832482903797,-12.61496724581219
2021-10-07T09:30:00-04:00,346.87,349.7699,346.77,347.63,5310444,5473304.6,52.435512729022875,42.886120112324235,NaN,NaN,70.95578731560016,-47.49639502361485,0.3473676443998528,-1.585814748081873,-1.9331823924817257,501969141,493832075,38.349427736884564,24.69291042880249,NaN,NaN,-9.801885699157452,-12.213098453432941
2021-10-08T09:30:00-04:00,347.92,348.46,346.58,347.53,3658277,5429266.55,52.28099216704404,44.42675975590355,NaN,NaN,60.746620299284636,-16.629074490994277,0.5778569456364835,-1.2108612104361214,-1.7887181560726049,498310864,494775455.6,40.998012933410884,26.246633260365343,NaN,NaN,-7.553974321513415,-11.547509291730153
2021-10-11T09:30:00-04:00,347.66,349.56,344.86,344.98,4098427,5362202.45,48.36687641534482,45.71169770970074,NaN,NaN,41.34278614582504,12.344883585500547,0.5456033176358688,-1.106714009027769,-1.6523173266636377,494212437,496306699.8,45.1193512849886,28.340775463115822,NaN,NaN,-6.878382102420019,-10.880491121828705
2021-10-12T09:30:00-04:00,345.49,346.0999,343.19,343.78,5100277,5422105.3,46.598841988296165,46.27103488400901,NaN,NaN,-4.798445314788228,22.103202463207428,0.4352686060708857,-1.1082315690750306,-1.5435001751459163,489112160,496052659.8,44.56320330449077,30.551720756192683,NaN,NaN,-6.860961125441525,-10.306272550916251
2021-10-13T09:30:00-04:00,343.9499,344.56,341.12,343.89,4194168,5468451.2,46.79085254165227,46.13431838693767,NaN,NaN,-29.279895616363223,27.793370565911705,0.36438718631155287,-1.0880161922564753,-1.4524033785680281,493306328,495382186,43.054813390118085,32.72168046919547,NaN,NaN,-6.792118320997343,-9.804250518070694
2021-10-14T09:30:00-04:00,347.21,349.22,346.6,349.13,4482065,5510254.35,55.077222346822865,46.550671668812086,NaN,NaN,104.13649237068773,34.429511576929194,0.6485041499474897,-0.6417731911336659,-1.2902773410811557,497788393,494546036.4,41.182672195551895,34.761655646022085,NaN,NaN,-4.135486944454582,-8.99442715041125
2021-10-15T09:30:00-04:00,351.65,353.08,350.9188,352.85,4206750,5451544.7,59.85676866874105,47.21231599744346,NaN,NaN,174.92709760296088,57.26560703766445,1.0417524209797688,0.011913185143555438,-1.0298392358362134,501995143,495282892.2,43.513678175980054,36.3301588513261,NaN,NaN,-0.2773618582870556,-7.749132108679222
2021-10-18T09:30:00-04:00,351.34,353.13,350.245,352.5,3310629,5116548.6,59.21837823456207,48.47888931822455,NaN,NaN,145.04918407068567,78.00688662263657,1.220675100853708,0.4960046402309217,-0.7246704606227863,498684514,496177307.6,46.29587096717227,37.59741692762045,NaN,NaN,2.59146343052377,-6.271904174507366
2021-10-19T09:30:00-04:00,353.67,354.51,352.8,354.46,2380866,4932036.65,61.68293085865513,49.80387169140837,NaN,NaN,162.9489614603861,111.55636797767143,1.4005198677783344,1.0259793741001317,-0.37454049367820264,501065380,498567951.6,52.9644119771754,38.99307948440576,NaN,NaN,5.757888556110821,-4.553362355847625
2021-10-20T09:30:00-04:00,354.51,356.58,354.37,356.03,2873781,4732590.75,63.58148963027058,51.76808774620941,NaN,NaN,171.37969380582845,151.68828586210978,1.543433864177421,1.5547518365435735,0.011317972366152618,503939161,500694518.2,57.964607830975915,40.83738916501899,NaN,NaN,8.97809787406584,-2.62029660871713
2021-10-21T09:30:00-04:00,355.39,356.09,354.3,355.96,2243827,4565174.55,63.43058119199481,53.10171075077939,NaN,NaN,142.12548483699064,159.28608435537035,1.5475298145915568,1.9457302406055987,0.3982004260140419,501695334,501475906.4,59.66149430281873,42.83545999357739,NaN,NaN,11.547743317826436,-0.5962909049251923
2021-10-22T09:30:00-04:00,355.97,357.62,355.32,356.74,3872278,4602709.35,64.44329239081694,54.78445318774247,NaN,NaN,137.53480403872987,151.80762564252416,1.515120467410282,2.2921010102768946,0.7769805428666124,505567612,502190400.2,61.203706793127154,45.17105648566377,NaN,NaN,13.989240252121585,1.487356403224347
2021-10-25T09:30:00-04:00,357.36,357.8916,356.29,357.55,2518214,4557321.15,65.51140765818965,56.18859332096087,NaN,NaN,128.7275297688248,148.54329478215197,1.45999052234648,2.6019686957997123,1.1419781734532324,508085826,504070662.6,64.99635342439583,47.79201273344574,NaN,NaN,16.35207618849925,3.6108878011207617
2021-10-26T09:30:00-04:00,358.56,358.93,357.37,357.5,3182174,4341740.25,65.38084566100181,57.47542803445818,NaN,NaN,118.99378415568229,139.75225932121123,1.3352989449098174,2.811101854590504,1.4758029096806866,504903652,504838317,66.43886960462919,50.45046242298,NaN,NaN,18.29471256940152,5.708577053732299
2021-10-27T09:30:00-04:00,358.09,358.3,354.96,354.98,3542133,4313017.85,58.99882195084507,57.94423583601691,NaN,NaN,84.42328677459857,122.36097791496525,1.0128709764386667,2.74189163022902,1.7290206537903532,501361519,504322788.6,64.51601488984622,52.31950436247727,NaN,NaN,18.360062865437815,7.515932169690229
2021-10-28T09:30:00-04:00,355.75,357.38,355.75,357.3,2490467,4041240.2,62.61672825127325,58.68250269917614,NaN,NaN,84.14859843108718,110.76560063378456,0.8899768307912073,2.8414916922793623,1.951514861488155,503851986,504754119,65.41783228014509,54.063777172958275,NaN,NaN,19.418538098322582,9.216304445209136
2021-10-29T09:30:00-04:00,356.65,358.52,356.391,358.23,2979629,3879231.6,63.98849995142382,59.79833295175322,NaN,NaN,87.08859281440736,100.67635838892004,0.8078539439371824,2.961332291409633,2.1534783474724506,506831615,505006919.6,65.96381612717747,55.55266751882891,NaN,NaN,20.692967546643185,10.855827745414
2021-11-01T09:30:00-04:00,359.45,360.05,357.98,359.13,2548432,3654765.95,65.31495058976012,61.13519785185779,NaN,NaN,97.36980081014813,94.40481259718472,0.7518349171900409,3.093271993960002,2.341437076769961,509380047,505265763.8,66.54621149165035,57.122882389340305,NaN,NaN,22.139516013438545,12.46778321227465
2021-11-02T09:30:00-04:00,359.41,360.88,358.79,360.57,2628974,3594907.45,67.38496063942755,62.60620557312745,NaN,NaN,103.5740959371874,91.32087495348574,0.7478618487959601,3.276264387764911,2.528402538968951,512009021,506686837.6,69.61970251124075,59.020374469420496,NaN,NaN,23.968084963234592,14.110683462411785
2021-11-03T09:30:00-04:00,359.91,361.84,358.9,361.56,3557431,3458962.15,68.76511430513162,63.583912141578075,NaN,NaN,106.61351722568575,95.75892104370318,0.746295976461917,3.4612725095463475,2.7149765330844304,515566452,509527824.2,74.636562594468,61.40993806934307,NaN,NaN,25.914092577639764,15.79688476458721
2021-11-04T09:30:00-04:00,361.34,361.65,359.87,361.35,3870860,3386982.95,68.10674669701653,64.1731962864549,NaN,NaN,101.53712993968774,99.2366273454233,0.6680388175267193,3.5500250549928296,2.8819862374661103,511695592,511096545.4,76.90448828064936,63.794995933962305,NaN,NaN,27.376543859222874,17.45112177810659
2021-11-05T09:30:00-04:00,362.96,364.94,361.89,363.3,4489006,3428519.4,70.89345167057353,65.00713010331286,NaN,NaN,128.68496415946265,107.55590161443433,0.6821389737428816,3.7346599546447123,3.0525209809018308,516184598,512967142,79.2833013477397,66.1512409611457,NaN,NaN,29.453959458391648,19.165812875290168
2021-11-08T09:30:00-05:00,365.06,365.64,363.33,364.32,3055958,3376395.95,72.25887249707402,65.76255450605707,NaN,NaN,139.12739936374888,115.90742132515447,0.6924825922950175,3.9181242212706024,3.225641628975585,519240556,514939243.8,81.45228828092516,68.1860892685564,NaN,NaN,31.620726329457057,20.945086225885436
2021-11-09T09:30:00-05:00,364.19,364.3,361.82,363.28,3680600,3305412.1,68.71913271482867,66.12952901209692,NaN,NaN,114.1864245999227,118.02988705770153,0.5668867608719856,3.934250080065567,3.3673633191935815,515559956,515649430.8,82.1760064492816,69.91547488414965,NaN,NaN,32.544726909869524,22.602177752168878
2021-11-10T09:30:00-05:00,362.52,363.73,360.2801,361.07,3529017,3272154.55,61.79196388951495,66.01248491906266,NaN,NaN,82.69628354930813,113.24644032242603,0.2867119405456533,3.725753244875648,3.4390413043299946,512030939,514942328.2,78.87597354572266,71.28793768721422,NaN,NaN,31.411852808100893,23.860702760159164
2021-11-11T09:30:00-05:00,361.19,361.26,359.38,359.46,2461200,3171111.3,57.26327418815564,65.49962647601542,NaN,NaN,40.541765195845144,101.0473673736575,-0.038025644501855194,3.3915092487026754,3.4295348932045306,509569739,514517157.6,76.8768739613806,72.40744962780376,NaN,NaN,29.104577426541077,24.60982771249944
2021-11-12T09:30:00-05:00,360.69,361.74,359.58,361.28,3099789,3115763.25,60.763980689843955,65.16052454970502,NaN,NaN,52.80632873713304,85.87164028919157,-0.15468977131060724,3.2361726790662715,3.3908624503768787,512669528,513814143.6,73.55716427539036,73.01893611716051,NaN,NaN,28.09014911849717,25.10701648478483
2021-11-15T09:30:00-05:00,362.6,362.73,360.67,361.24,2554951,3077979.35,60.6464008745389,64.82234992210051,NaN,NaN,62.92293039567698,70.63074649557718,-0.25317004466393733,3.074399894546957,3.3275699392108944,510114577,511988947.8,65.63294552412452,72.96137011141018,NaN,NaN,27.23028859135535,25.41034107143776
2021-11-16T09:30:00-05:00,361.82,363.54,361.7,361.93,2728633,3095367.7,62.01195003611003,65.0375733567623,NaN,NaN,78.47695390595065,63.488852356782786,-0.28792661196135194,2.9676616742592046,3.2555882862205565,512843210,511445598.6,63.44184873544685,72.8846439575245,NaN,NaN,26.867655748293924,25.618528882417213
2021-11-17T09:30:00-05:00,361.44,361.58,359.54,359.85,2975958,3100476.55,55.733685995148115,64.5459274813248,NaN,NaN,15.377772951347652,50.02515023719069,-0.45703908393072545,2.6842894313071497,3.141328515237875,509867252,511012861.2,61.675871722016396,72.61736106051532,NaN,NaN,24.730621289551355,25.491684940579233
2021-11-18T09:30:00-05:00,360.03,360.05,357.13,359.35,3443247,3160447.55,54.31025191959643,63.85462405047998,NaN,NaN,-38.8697875908471,34.142839679852244,-0.599624485462654,2.3917979084095577,2.9914223938722118,506424005,510383714.4,59.10008690037557,72.12709468717232,NaN,NaN,22.540910284815045,25.070145704041494
2021-11-19T09:30:00-05:00,357.89,357.89,355.38,355.91,3544043,3144035.8,45.668371733237386,62.45129698929979,NaN,NaN,-120.90038337400432,-0.5985027423752272,-0.9043659369295813,1.860964972710235,2.7653309096398164,502879962,508425801.2,51.84375910938667,71.07691951701064,NaN,NaN,17.774206172251745,24.02786862807153
2021-11-22T09:30:00-05:00,357.48,359.24,356.09,356.2,4935826,3264916.4,46.44207495510444,60.95537658327671,NaN,NaN,-94.2153603416986,-32.026160889850345,-1.0546674896192498,1.446996547615754,2.501664037235004,507815788,507966043.4,50.28253136092725,69.69569300627396,NaN,NaN,14.130049950609425,22.61389453129123
2021-11-23T09:30:00-05:00,356.28,358.37,355.34,358.02,5792629,3395439.15,51.14421691914961,59.69674105570657,NaN,NaN,-88.95871439425014,-65.5132945498905,-1.0002452238126365,1.2513575074692085,2.251602731281845,513608417,508119084.8,50.8135137094974,67.99404665734748,NaN,NaN,12.32976884291171,21.144733718665584
2021-11-24T09:30:00-05:00,356.06,358.2,355.8,358.03,4246714,3430668.2,51.16958430475903,58.48694374197389,NaN,NaN,-91.15828827891119,-86.82050679594228,-0.9335891501502109,1.084616293594081,2.018205443744292,517855131,509716660.6,56.085954917742896,66.50700855999703,NaN,NaN,10.880430048357573,19.678404622907298
2021-11-26T09:30:00-05:00,350.33,351.46,347.36,349.02,9074951,3759892.4,34.02656497025575,55.85359469195119,NaN,NaN,-287.4351810820284,-136.53358549417854,-1.436266873373858,0.22287185202696946,1.6591387254008274,508780180,510187895.6,57.532021483338255,64.95334571253979,NaN,NaN,2.72487536862676,17.25647187229579
2021-11-29T09:30:00-05:00,352.59,352.77,348.923,351.19,5242959,3873058.9,39.301007168377694,53.49946145418716,NaN,NaN,-197.97894921227825,-151.94929866183332,-1.5526857695573466,-0.28171848654585574,1.2709672830114909,514023139,512416531,63.6315444227317,63.68043543695453,NaN,NaN,-1.8110561309594615,14.532539300402183
2021-11-30T09:30:00-05:00,348.7,350.01,344.36,344.9,9543521,4222813.35,31.45176024154493,50.837506277524035,NaN,NaN,-227.79815285380485,-178.66585716425456,-1.9572607960705715,-1.1756087120767234,0.781652083993848,504479618,511749297,60.815296183049206,62.154670417937936,NaN,NaN,-9.038896920993267,11.165191268774262
2021-12-01T09:30:00-05:00,348.04,350.3775,340.32,340.46,8476602,4515194.75,27.306039589441653,48.374225970375946,NaN,NaN,-212.96353111099037,-203.46682050760262,-2.3987143398141257,-2.2167408407738094,0.18197349904031646,496003016,508228216.8,48.59295931163308,59.99159797264582,NaN,NaN,-16.558746483712543,7.204628732704718
2021-12-02T09:30:00-05:00,341.81,347.95,341.17,346.61,8326411,4753643.75,39.25068571625984,47.08761250809768,NaN,NaN,-156.44414939989676,-216.52399273179972,-2.1588446844521334,-2.51658235652485,-0.3577376720727169,504329427,505523076,41.66491626336962,57.47645813707361,NaN,NaN,-17.746320140275476,3.640207465136119
2021-12-03T09:30:00-05:00,347.86,348.5,343.08,346.24,11365325,5128367,38.83722482307196,45.521415660471106,NaN,NaN,-122.79947993085389,-183.59685250156483,-1.9156799353803526,-2.752337591298158,-0.8366576559178052,492964102,502359860.4,35.3230258800392,54.74544825169138,NaN,NaN,-18.74925247100189,0.44171318854497565
2021-12-06T09:30:00-05:00,349.26,354.02,348.8262,352.82,7026475,5255240.45,49.104897914377716,44.697022591888164,NaN,NaN,-45.28515203420956,-153.05809306595108,-1.235297997757197,-2.3807801531143014,-1.1454821553571044,499990577,499553348,30.838069209810854,52.26009994352612,NaN,NaN,-15.486541481902288,-1.833751764376062
2021-12-07T09:30:00-05:00,355.93,358.61,355.79,357.74,5271465,5366015.8,55.165565186269134,44.207995102613815,NaN,NaN,24.426493271670665,-102.61316384085599,-0.4196653700279598,-1.670063867892054,-1.2503984978640943,505262042,499709832.8,31.361378903356155,49.9686378126625,NaN,NaN,-10.442825489788463,-3.0636194394349765
2021-12-08T09:30:00-05:00,358.17,358.87,356.42,357.99,3355590,5349765.3,55.455830344834794,44.18814827044857,NaN,NaN,33.55565919963124,-53.30932577873166,0.14091097214334014,-1.0742597826849192,-1.2151707548282593,508617632,502232756,39.33160644991487,48.372618864655244,NaN,NaN,-6.662358341769141,-3.577724996911286
2021-12-09T09:30:00-05:00,356.75,359.18,356.35,358.11,3774467,5362037.8,55.60440645951553,44.280587880442795,NaN,NaN,38.488371464321595,-14.322821605887981,0.5036191767179461,-0.5856467839308266,-1.0892659606487727,512392099,503845290.4,43.82174801018962,47.28130894392768,NaN,NaN,-3.751787200388067,-3.6025910259793976
2021-12-10T09:30:00-05:00,359.59,360.33,357.61,360.23,3855226,5431739.1,58.253615890937276,45.17953389170707,NaN,NaN,58.88063025061978,22.013200430406755,0.8497811802190303,-0.027039485374984906,-0.8768206655940152,516247325,508501935,54.33288905986892,47.4591039403907,NaN,NaN,-0.5069700190706659,-3.1603594535638644
2021-12-13T09:30:00-05:00,359.43,359.99,356.61,357.04,4563040,5504901.65,53.117297874264885,45.65633552878995,NaN,NaN,41.90025542574612,39.45028192239789,0.8266173431367216,0.15645101332688682,-0.6701663298098348,511684285,510840676.6,58.529640718191374,48.048183180195274,NaN,NaN,0.5784856383255711,-2.626238726151088
2021-12-14T09:30:00-05:00,355.71,358.41,354.97,356.17,4079652,5581136.7,51.77646494866401,45.7014961023267,NaN,NaN,28.005291923736657,40.16604165281109,0.7193544627480181,0.2290267486251878,-0.49032771412283027,507604633,511309194.8,59.33585463604404,48.656921817805745,NaN,NaN,1.0333155957930986,-2.1034452515876327
2021-12-15T09:30:00-05:00,355.83,359.97,354.44,359.81,9274927,5908451.4,56.70118468829916,46.09661041543671,NaN,NaN,54.313227950914865,44.31755540306781,0.8511809382041998,0.5736484586324195,-0.2775324795717803,516879560,512961580.4,62.13196843390476,49.08877992610302,NaN,NaN,2.9936806119953725,-1.375284413932918
2021-12-16T09:30:00-05:00,361.27,362.51,358.31,359.44,9493714,6234339.2,56.074323268881244,47.67145029390996,NaN,NaN,83.48087331034392,53.316055772272286,0.8681045828538955,0.8075982489955891,-0.060506333858306394,507385846,511960329.8,59.46380775112076,49.22676465951606,NaN,NaN,4.369651652875451,-0.5545792615317224
2021-12-17T09:30:00-05:00,356.3,356.93,352.71,353.63,10641783,6594266,47.242140160309496,48.23867407904795,NaN,NaN,5.542114999217435,42.648352721991806,0.4629755166623396,0.5182130619696181,0.05523754530727852,496744063,508059677.4,50.385912979176695,48.28064812783356,NaN,NaN,2.7715636991402817,-0.07941598143572187
2021-12-20T09:30:00-05:00,349.38,349.64,346.541,349.27,7303444,6782236.05,41.90765595737241,48.98552377303562,NaN,NaN,-72.88517148109885,19.69126734062281,-0.09397007938812302,-0.06222505392787525,0.03174502546024777,489440619,503610944.2,42.430011881696046,46.96741353487976,NaN,NaN,-0.4011682563520449,-0.12538059213805372
2021-12-21T09:30:00-05:00,352.16,354.98,351.51,354.91,4693326,6770111.05,49.803736319197505,50.59250211087532,NaN,NaN,4.5589357854693455,15.001996112969355,-0.07848451172955725,-0.06636061420169881,0.01212389752785845,494133945,500916806.6,38.4685609648953,46.24424222439849,NaN,NaN,-0.41014669789239727,-0.16606146438867422
2021-12-22T09:30:00-05:00,354.95,357.56,354.17,357.39,2999520,6630455.6,52.839239675025105,51.563113107929986,NaN,NaN,42.85225833029074,12.709802188844531,0.09349310487621,0.12899027862312096,0.03549717374691096,497133465,496967587.6,33.52712107455966,45.662971139483496,NaN,NaN,0.6142403616558736,-0.05458977495373883
2021-12-23T09:30:00-05:00,358.39,360.5,358.16,359.36,2655037,6550871.75,55.15895290511512,52.728950828075924,NaN,NaN,83.30671568815666,12.674970664407077,0.3217814569205249,0.4377239948975671,0.11594253797704218,499788502,495448118.8,31.832829793356026,45.41367141900612,NaN,NaN,2.1986973135972048,0.26730838055353884
2021-12-27T09:30:00-05:00,360.06,362.96,359.7,362.92,2599809,6227114.65,59.07633947293602,53.441196653687236,NaN,NaN,109.2717336872624,33.42089440201607,0.6741337148148026,0.9586096814955454,0.2844759666807428,502388311,496576968.4,34.48183327976801,45.67394028114592,NaN,NaN,4.823524169120571,0.9181963503488291
2021-12-28T09:30:00-05:00,363.11,365.12,362.89,363.99,3058115,6117872.45,60.20173021782976,53.80092272737013,NaN,NaN,125.72057280774885,73.14204325978561,0.9253334677799232,1.4411428014056469,0.5158093336257237,505446426,499778129.8,41.43240925275736,46.39329959181743,NaN,NaN,7.273014468905145,1.8260275101425885
2021-12-29T09:30:00-05:00,363.9,365.64,363.79,364.84,3012202,5791306.5,61.116504603878504,54.20525660301611,NaN,NaN,128.77642399340775,97.9855409013733,1.0838155759781798,1.8705788035984483,0.7867632276202686,508458628,502643066.4,46.86528237066015,46.931419300442094,NaN,NaN,9.529785356282632,2.9265643453054517
2021-12-30T09:30:00-05:00,365.69,366.7205,363.6,364.07,2863233,5510638.05,59.776106179831885,54.50323515446729,NaN,NaN,128.0104395493682,115.01717714518877,1.0700213163691397,2.1242898730816933,1.0542685567125536,505595395,504335452.4,49.826148263273645,47.36030503280524,NaN,NaN,10.999754757617389,4.079877261350014
2021-12-31T09:30:00-05:00,363.51,364.74,362.91,363.32,3133781,5251006.55,58.43185539435075,54.515966547568254,NaN,NaN,107.3348284369808,119.82279969495362,0.9478082431023185,2.2390288605904516,1.291220617488133,502461614,504870074.8,50.7596052205046,47.10507047285064,NaN,NaN,11.850993617575083,5.190036740810738
2022-01-03T09:30:00-05:00,364.34,365.85,362.3,365.68,5624133,4963946.95,61.37528332703269,55.105822651337384,NaN,NaN,114.65774987480275,120.90000293246169,0.9603596568694255,2.491670188574915,1.5313105317054894,508085747,506009562,52.77622730007311,46.69411237155648,NaN,NaN,13.423197231481296,6.3662025251922465
2022-01-04T09:30:00-05:00,367.34,369.21,367.21,367.87,5462192,4885732.8,63.927874676623304,55.97378048904876,NaN,NaN,159.09687376547367,127.57526312400664,1.0436830176697387,2.835914303792663,1.7922312861229241,513547939,507629864.6,55.563105892051155,46.42463031841414,NaN,NaN,15.513662341388082,7.672982498934509
2022-01-05T09:30:00-05:00,367.71,369.4985,363.98,364.09,7638014,5004060.25,56.93396836280427,55.990407894370556,NaN,NaN,102.69743721976708,122.3594657692785,0.7836266978273922,2.7717646584071645,1.9881379605797722,505909925,507120124,54.47396481977384,45.877630060261936,NaN,NaN,15.323924920674164,8.765974273468746
2022-01-06T09:30:00-05:00,364.11,364.65,361.96,362.39,7019832,5187272.35,54.06900090207776,55.84717058245602,NaN,NaN,48.40226758522917,106.4378313764507,0.4529339255220224,2.5543053674823,2.1013714419602776,498890093,505779063.6,51.60782749391451,45.31648861331863,NaN,NaN,14.321958641276181,9.559686326012665
2022-01-07T09:30:00-05:00,361.89,363.87,361.13,362.31,5806281,5288863.05,53.93146496068297,56.324979496768414,NaN,NaN,34.981166810671844,91.96709905118891,0.19765534218563863,2.348440619692326,2.1507852775066874,493083812,503903503.2,47.818425489020676,45.13309664973606,NaN,NaN,13.4681183206338,10.118033753815684
2022-01-10T09:30:00-05:00,361.07,361.22,356.44,360.79,8091815,5500692.5,51.26329984034833,56.993239774123836,NaN,NaN,-15.149459210381233,66.00565723415211,-0.08932089575808,2.0391341578090874,2.1284550535671674,484991997,499284753.2,40.02445713610806,44.96127131076549,NaN,NaN,11.993143443581202,10.38590656663933
2022-01-11T09:30:00-05:00,360.69,362.75,357.7,362.54,7310850,5638083,54.0800665497788,57.298691933451074,NaN,NaN,8.101286435437077,35.8065397681448,-0.17223349985233805,1.913163178751745,2.085396678604083,492302847,495035734.8,34.45994840448708,44.674941842164905,NaN,NaN,11.487318539381713,10.543251134173955
2022-01-12T09:30:00-05:00,363.73,364.56,361.67,362.95,4493155,5658758.15,54.74005939802703,57.434464770808354,NaN,NaN,39.85077464980358,23.2372072541521,-0.20801967043631642,1.8253720905586874,2.033391760995004,496796002,493212950.2,32.38019312652649,44.5930184173054,NaN,NaN,11.240025504677991,10.642790329960246
2022-01-13T09:30:00-05:00,364.21,365.13,360.45,361.2,6418102,5515916.9,51.347729356902434,57.16223451736459,NaN,NaN,22.329281132744704,18.022609963655206,-0.3497639702301414,1.5961867982073272,1.9459507684374686,490377900,491510511.6,30.52707302073263,44.49975007640372,NaN,NaN,10.103162393267814,10.56570062471847
2022-01-14T09:30:00-05:00,358.21,359.8,356.4,359.14,8575412,5470001.8,47.60762910953762,56.34304091997899,NaN,NaN,-46.32276398671319,1.7618238041781964,-0.5694765951913827,1.2341050244482403,1.803581619639623,481802488,489254246.8,28.2218502041718,44.052608428146854,NaN,NaN,8.059357077528013,10.207651546548405
2022-01-18T09:30:00-05:00,355.33,355.36,352.62,353.85,8173145,5346569.9,39.62563551423099,54.873319869721925,NaN,NaN,-126.92514589746219,-20.593313533238,-1.0313736587891245,0.5143645461532174,1.5457382049423418,473629343,486981716,26.085232378946486,42.95638150858893,NaN,NaN,3.6208514141858745,9.266680099068044
2022-01-19T09:30:00-05:00,354.91,355.55,350.21,350.35,7386469,5350721.15,35.39701670186949,53.036213591007005,NaN,NaN,-174.8857315931429,-57.19071713895399,-1.5042695018819952,-0.3345986724101522,1.169670829471843,466242874,481769721.4,21.975934855971744,41.17857097182548,NaN,NaN,-1.6313705828404228,7.709815715938262
2022-01-20T09:30:00-05:00,351.48,355.05,346.81,347.33,8968728,5564491.25,32.20363538624402,51.06675139146501,NaN,NaN,-200.81203536090703,-105.32327914109612,-1.9252081722527254,-1.236839385844064,0.6883687864086615,457274146,473865350.2,17.478827740226436,38.8680480773221,NaN,NaN,-7.1585831231234,5.585758738929453
2022-01-21T09:30:00-05:00,347.09,348.85,342.14,342.35,16301610,6229595.75,27.756715757067823,48.87566998880194,NaN,NaN,-235.68700533177423,-156.9265364339999,-2.4122094748983285,-2.3268930572142494,0.08531641768407927,440972536,463984277.4,13.703607863796861,36.22119112327155,NaN,NaN,-13.595668062213873,2.8455549101946924
2022-01-24T09:30:00-05:00,338.43,344.12,331.35,343.81,29719461,7582816.95,30.77476961541312,46.689919009400555,NaN,NaN,-226.0602457506226,-192.8740327867818,-2.4986044742729714,-3.0379391751571347,-0.5393347008841636,470691997,461762179.2,13.022422121298973,33.38163361050197,NaN,NaN,-17.762681334206498,-0.0984788390054776
2022-01-25T09:30:00-05:00,340.26,345.79,335.34,342.96,18657852,8385719.1,29.98926969096911,44.26573293899668,NaN,NaN,-164.61314232946256,-200.41163207318186,-2.471102213569172,-3.6282124678456285,-1.1571102542764566,452034145,457443139.6,11.79514526999823,30.25535070892676,NaN,NaN,-21.344414148269244,-3.133612454614587
2022-01-26T09:30:00-05:00,346.04,348,338.53,341.46,19047285,9185177.6,28.601866377811405,42.24201136864004,NaN,NaN,-126.55234921730082,-190.74495559801343,-2.409502410440385,-4.168988267326938,-1.759485856886553,432986860,450791936.8,10.200798995883858,27.09298172150605,NaN,NaN,-24.733072517766008,-6.219249606493361
2022-01-27T09:30:00-05:00,344.4,347.6294,339.89,341.55,12854107,9677272.85,28.814662309559637,40.438130040603035,NaN,NaN,-106.34485220388035,-171.8515189666081,-2.222798262911968,-4.5379836855265125,-2.3151854226145447,445840967,448505301,9.714630155637707,24.10061048305771,NaN,NaN,-27.403092408894096,-9.24551286397918
2022-01-28T09:30:00-05:00,341.86,347.18,337.9,347.11,12008868,10134554.6,40.594064862840526,39.485458605042865,NaN,NaN,-86.63237798427602,-142.04059349710846,-1.6133196479655476,-4.331834982571479,-2.7185153346059314,457849835,451880760.8,16.07340107299123,21.833108739055604,NaN,NaN,-26.19507184704966,-11.666878432989249
2022-01-31T09:30:00-05:00,345.78,351.36,344.72,351.08,8379123,10396821.7,47.29978603421891,39.20235047603361,NaN,NaN,-42.523270902515065,-105.33319852748693,-0.8685970671065499,-3.8042616684891186,-2.9356646013825687,466228958,450988153,15.75735418693992,20.09974424268645,NaN,NaN,-22.922553212607603,-13.274831972934727
2022-02-01T09:30:00-05:00,351.66,354.27,349.68,353.94,7635973,10497413.7,51.54333650214768,39.02115547263139,NaN,NaN,-9.969710078580405,-74.4045120773105,-0.14700367523139501,-3.1194191954218127,-2.9724155201904177,473864931,455354310.2,23.664069660715285,19.328610046702753,NaN,NaN,-18.774283621689587,-14.06046792275685
2022-02-02T09:30:00-05:00,353.59,356.66,352.76,356.03,8856380,10667123.1,54.431030292269256,38.999081965077266,NaN,NaN,18.097967552971625,-45.47444872325601,0.4734611210688575,-2.3805891188543455,-2.854050239923203,482721311,465301200.4,37.95187204338984,19.726587112192995,NaN,NaN,-14.420119512938639,-14.111846721354247
2022-02-03T09:30:00-05:00,354.82,355.22,350.58,350.98,9339872,10752216,47.12358271311713,38.697357204806885,NaN,NaN,-2.3088866422757834,-24.667255610935108,0.5412774496333945,-2.17745342788146,-2.7187308775148544,473381439,470809294.8,44.182160939629206,20.701950534971324,NaN,NaN,-13.001081125846046,-13.953165921995932
2022-02-04T09:30:00-05:00,350.4,353.25,347.82,350.87,8532315,10827840.15,46.97564534123876,38.652215507071254,NaN,NaN,-13.160588995906503,-9.972897813261197,0.5731749596589766,-2.002262177941134,-2.5754371376001104,464849124,472209152.6,45.67511200122022,21.948612091903353,NaN,NaN,-11.944956349621073,-13.666278840228095
2022-02-07T09:30:00-05:00,351.26,353.16,349.83,350.9,4746182,10774835.2,47.024491226709465,39.18070520081972,NaN,NaN,-0.2216770763830682,-1.5125790480347976,0.5885152211638958,-1.8397931111452408,-2.4283083323091366,469595306,472882422.2,46.41742303567068,23.400911424526516,NaN,NaN,-11.090403606541788,-13.298296663987195
2022-02-08T09:30:00-05:00,351.6,355.35,350.79,354.54,4568416,10598665.25,52.716049205496574,40.417778951078795,NaN,NaN,31.11905100068572,6.705173167818399,0.8217139793549397,-1.401165858115462,-2.2228798374704017,474163722,472942180.4,46.48731656833903,25.15172440398132,NaN,NaN,-8.58360852426885,-12.624769786884574
2022-02-09T09:30:00-05:00,357.35,358.1,356.66,357.67,4781723,10472208.9,56.994689284840405,42.18856851526426,NaN,NaN,83.68628014509532,19.822835686243135,1.1448176974797437,-0.791857715620722,-1.9366754131004658,478945445,472187007.2,45.67646818304651,27.165841578468466,NaN,NaN,-5.072960501220886,-11.545939888932619
2022-02-10T09:30:00-05:00,354.78,358.06,351.03,352.55,10298493,10762475.8,49.158562099131885,43.717271825411686,NaN,NaN,47.58438632176413,29.80149027905112,0.9782294743337663,-0.7138885701832578,-1.692118044517024,468646952,471240109.8,44.62540603166353,29.374541447601803,NaN,NaN,-4.497592251484704,-10.539033083582916
2022-02-11T09:30:00-05:00,352.46,354.42,346.23,347.29,8211455,10852143.45,42.66816176430663,44.56679983604694,NaN,NaN,-6.389914762856747,31.155625125661068,0.502280603457979,-1.0642672901945502,-1.5665478936525292,460435497,470357384.4,43.61776312050617,31.55992294754517,NaN,NaN,-6.238436686276877,-9.924662169682053
2022-02-14T09:30:00-05:00,346.72,347.55,343.199,345.89,7315140,10789129.85,41.11229981071667,45.36130198745748,NaN,NaN,-55.20786234379404,20.158388072178877,0.10257188141628393,-1.4383330418821743,-1.5409049232984582,453120357,467062394.6,39.988084227216056,33.57370430163216,NaN,NaN,-8.129470257735381,-9.6682061822611
2022-02-15T09:30:00-05:00,348.93,350.755,348.35,350.22,4939762,10627460.7,47.489863694571085,46.710444652940325,NaN,NaN,14.380093200654462,16.810596512172626,0.13704383095282724,-1.369600134607424,-1.5066439655602513,458060119,463841674,36.76737784050382,35.47131707624787,NaN,NaN,-7.610259989216617,-9.374213868969031
2022-02-16T09:30:00-05:00,348.76,350.72,346.71,349.67,4496491,10482961.8,46.796591279533644,47.994868150795604,NaN,NaN,4.9629314279387335,1.0659267687413077,0.13010218735824464,-1.3440162313624455,-1.4741184187206902,453563628,458765310.6,32.34539250130905,37.08780010093868,NaN,NaN,-7.421433864210397,-9.095245296860655
2022-02-17T09:30:00-05:00,347.43,347.71,342.86,343.68,4433540,10256202.4,39.95545967909942,47.9492534948141,NaN,NaN,-58.91352560615505,-20.233655616842526,-0.24989742203862497,-1.7864901962689714,-1.5365927742303465,449130088,454861937.8,29.415799389031875,38.04082855208444,NaN,NaN,-9.55604022076084,-9.16107314313211
2022-02-18T09:30:00-05:00,342.9,344.2,339.67,340.98,6193742,9750809,37.307954668456695,47.235551254402516,NaN,NaN,-102.01163283764977,-39.35799923180113,-0.6332726488883251,-2.328183585340753,-1.6949109364524277,442936346,451362107.6,27.050120918882513,38.847454747223196,NaN,NaN,-12.181910240634753,-9.592621299918202
2022-02-22T09:30:00-05:00,338.79,340.26,333.58,336.01,7942677,8661969.8,32.97642283646489,45.90934313542517,NaN,NaN,-168.23928363547395,-61.964283490137106,-1.14208922487335,-3.1225224675441154,-1.9804332426707654,434993669,447736770,24.823133188964945,38.93024499924103,NaN,NaN,-15.924524867403164,-10.497178952416053
2022-02-23T09:30:00-05:00,338.16,338.26,330.82,331.52,5732648,8015709.6,29.62954619526394,44.13780855706765,NaN,NaN,-188.10713697176976,-102.46172952462196,-1.6696214716041067,-4.067460082175899,-2.397838610571792,429261021,441976950.4,21.75822675239388,37.77355604988418,NaN,NaN,-20.23026148462791,-11.887619314160604
2022-02-24T09:30:00-05:00,322.82,332.74,322.685,332.34,14167066,7771698.65,31.006739884856472,42.98660549790617,NaN,NaN,-203.331521033711,-144.1206200169519,-1.838553026160847,-4.696029893272851,-2.8574768671120037,443428087,439949842.2,20.785536433423744,36.10236858515522,NaN,NaN,-23.150484364550238,-13.496600035644837
2022-02-25T09:30:00-05:00,333.68,341.02,333.06,340.54,9496305,7603808.55,43.01659463822196,42.7038161619764,NaN,NaN,-94.08890161266494,-151.1556952182539,-1.298700149654799,-4.480852054180502,-3.1821519045257034,452924392,440708703,22.18792373632226,34.42471228051965,NaN,NaN,-21.59506397095667,-14.6535234549751
2022-02-28T09:30:00-05:00,335.95,339.8189,334.79,339.34,8217281,7414229.2,41.8680036140175,42.33549561821268,NaN,NaN,-87.99600319915851,-148.35256929055564,-0.9398209425908193,-4.356928082764227,-3.417107140173408,444707111,441062856,22.87416503894623,32.743050995039326,NaN,NaN,-20.762992506862656,-15.526304748101893
2022-03-01T09:30:00-05:00,337.27,339.02,331.33,333.16,8532868,7421916.45,36.46757544759336,41.17489034979103,NaN,NaN,-107.07903845242943,-136.12052025394672,-1.0288554903221256,-4.703176503076065,-3.6743210127539396,436174243,441298970.8,23.359459547047408,31.09106120780421,NaN,NaN,-21.893957888301628,-16.43596948241614
2022-03-02T09:30:00-05:00,335.27,340.45,334.69,339,6836203,7381927.95,43.839576224977,40.235239416943635,NaN,NaN,-65.89105427162647,-111.67730371391806,-0.624533075046187,-4.4549873565616736,-3.8304542815154865,443010446,444048855.8,28.96543543899631,29.897416011800626,NaN,NaN,-20.24960176312727,-16.9807740939463
2022-03-03T09:30:00-05:00,340.71,342.09,336.6799,338.13,7790653,7328641.6,43.03838352576447,39.79808380456025,NaN,NaN,-50.85395785202866,-81.18179107758161,-0.3589724093983362,-4.2791697932634065,-3.9201973838650703,435219793,442407197,27.664463383973526,28.685920108394193,NaN,NaN,-19.241478124596455,-17.30373181261061
2022-03-04T09:30:00-05:00,334.61,336.865,332.8,336.47,6034028,7163349.4,41.480661958484326,39.713262389858656,NaN,NaN,-76.41643086245631,-77.64729692753988,-0.24390383274921046,-4.225077174801584,-3.981173342052373,429185765,437659471.6,24.269493023117064,27.303900815723544,NaN,NaN,-18.919868190429266,-17.534608438013276
2022-03-07T09:30:00-05:00,335.2,335.33,328.34,328.47,6590822,7066274.75,34.92092782177224,39.27102153350548,NaN,NaN,-108.31234334263944,-81.71056495623606,-0.633240949330558,-4.772724528715571,-4.139483579385013,422594943,433237038,21.609290742023035,25.991129852495472,NaN,NaN,-20.85591450639172,-18.00908073349591
2022-03-08T09:30:00-05:00,328.49,334.4,326.06,326.53,8209822,7239456.75,33.53593535951188,38.27431236671554,NaN,NaN,-113.2985004966071,-82.95445736507159,-0.9301417605162801,-5.302160780030363,-4.372019019514083,414385121,428879213.6,19.357647302577504,24.747577671215023,NaN,NaN,-22.849983833181692,-18.700638319165307
2022-03-09T09:30:00-05:00,333.12,335.04,331.57,333.4,4669162,7244494.05,42.268017241236656,37.95084279255148,NaN,NaN,-68.10146088303189,-83.39653868735266,-0.5891876556869207,-5.1085035891227335,-4.519315933435813,419054283,424087981,17.231713299251084,23.668029156782314,NaN,NaN,-21.62648276451808,-19.118616097072845
2022-03-10T09:30:00-05:00,329.32,332.85,328.68,332.11,3317366,7171276.2,41.17412893668557,38.03789059666476,NaN,NaN,-85.91078807768439,-90.40790473248383,-0.38572108328215204,-5.001467287538503,-4.615746204256351,415736917,420191405.8,15.719679868634941,22.689734905325388,NaN,NaN,-21.01374579087252,-19.389348910472798
2022-03-11T09:30:00-05:00,334.1,335.73,329.69,330.02,6923442,7002523.65,39.395250664695425,38.18698316782467,NaN,NaN,-75.59860022428585,-90.24433860484973,-0.3292700812449443,-5.027333805812532,-4.698063724567588,408813475,416116947.8,14.306084286366314,21.779446574431372,NaN,NaN,-21.066325546173108,-19.628917001287128
2022-03-14T09:30:00-04:00,331.75,334.6,328.79,330.07,5640611,6873981.45,39.462634190472656,38.65028397882522,NaN,NaN,-77.12535154170007,-84.00694024466186,-0.23060457166739212,-4.986319439151828,-4.755714867484436,414454086,414488776.4,13.773083769066872,20.990157330152943,NaN,NaN,-21.088496370529214,-19.837428339750282
2022-03-15T09:30:00-04:00,332,336.85,331.11,336.19,6648491,6840649,47.20083860339023,39.90537629369139,NaN,NaN,-25.19378723803464,-66.38599759294735,0.2772467781949839,-4.409156394740705,-4.686403172935689,421102577,415832267.6,16.53635543400189,20.617166521696372,NaN,NaN,-18.706730955736514,-19.67590014203403
2022-03-16T09:30:00-04:00,339.19,341.42,334.54,341.36,9577061,7072513.95,52.701192965750764,41.454980085183834,NaN,NaN,51.62450601259352,-42.44080421382229,0.9536867964409383,-3.4942946773845165,-4.447981473825455,430679638,418157338.6,21.240388552738878,20.649655958790312,NaN,NaN,-14.868334919442876,-18.989105110235293
2022-03-17T09:30:00-04:00,339.94,345.59,339.61,345.45,6032880,7149333.4,56.55688266148522,42.42214351541692,NaN,NaN,138.9729944427432,2.535952290263225,1.6292381003606842,-2.4114338483745996,-4.040671948735284,436712518,422352458.8,29.014254484812213,21.137251012253877,NaN,NaN,-10.380505971771733,-17.759305233311927
2022-03-18T09:30:00-04:00,343.62,347.44,342.65,347.19,5903890,7222850.9,58.12096349024969,43.58306922086208,NaN,NaN,174.5065505316605,52.55698244145249,2.115133986547792,-1.3967544655505435,-3.5118884520983356,442616408,429113045.4,39.39577646388841,22.317366114035462,NaN,NaN,-6.249542055578117,-16.115053350778528
2022-03-21T09:30:00-04:00,346.61,347.93,343.295,345.44,4329871,7129657.35,55.939585439628665,44.97392707743604,NaN,NaN,158.56103128516145,99.6942590068248,2.2291416009506086,-0.7254614509100747,-2.9546030518606834,438286537,433879535.6,45.45282621929278,23.895463733481563,NaN,NaN,-3.493566867166748,-14.311983853119703
2022-03-22T09:30:00-04:00,347.12,348.7228,346.858,348.14,4430831,6954065.05,58.52592330992523,46.022951869218055,NaN,NaN,162.9919062636627,137.33139770716429,2.38298832310754,0.024132352023741532,-2.3588559710837984,442717368,438202493.8,50.3039986424251,25.41964681944076,NaN,NaN,-0.3895727260760429,-12.323067977827751
2022-03-23T09:30:00-04:00,345.75,346.44,343.3535,343.41,4098657,6872365.5,52.690757732958765,46.71240716973193,NaN,NaN,99.90283690273802,146.98706388519318,2.0741439722152677,0.2338239941852862,-1.8403199780299815,438618711,439790308.4,51.992821421498526,27.157386679263976,NaN,NaN,0.5649799492886782,-10.481918273953976
2022-03-24T09:30:00-04:00,344.49,347.06,343.4356,347.06,3550042,6341514.3,56.310659660721896,47.77169271989176,NaN,NaN,108.9899204843533,140.9904490935152,2.0215485808894753,0.6866157480818629,-1.3349328328076124,442168753,440881555.4,53.1706675384061,29.22175628749891,NaN,NaN,2.489408265403983,-8.628871625474268
2022-03-25T09:30:00-04:00,347.8,349.32,346.19,348.54,3207531,6027075.6,57.72321760905739,49.40042770469785,NaN,NaN,119.40760793487429,129.97066057415796,1.9892303617582363,1.151605119390183,-0.8376252423680532,445376284,441433530.6,53.78827949591829,31.52025548420571,NaN,NaN,4.488385294836976,-6.754977779715519
2022-03-28T09:30:00-04:00,347.75,349.49,345.38,349.49,2962414,5764332.25,58.64744681442807,51.19410709433472,NaN,NaN,105.25348930869487,119.30915217886464,1.9329584355768854,1.5785728021030536,-0.35438563347383184,448338698,443443962.8,56.06128073200603,34.141943586307754,NaN,NaN,6.39774994156181,-4.876016676675901
2022-03-29T09:30:00-04:00,352.6599,353.71,350.125,352.97,4711808,5573279.25,61.9306206630916,52.598578767324355,NaN,NaN,131.00299261006631,112.91136944814536,2.0216757434191033,2.1727090458000475,0.1510333023809441,453050506,445510590.4,58.33023658353889,37.07755239232831,NaN,NaN,9.02240626590668,-2.8905276848783896
2022-03-30T09:30:00-04:00,352.15,353.47,350.44,352.12,3909838,5426961,60.66371316751184,53.99069192666909,NaN,NaN,111.73412856516313,115.27762778063038,1.915680494070825,2.5456339199694753,0.6299534258986503,449140668,447614981.8,60.563432065927046,40.28067754927775,NaN,NaN,10.841364083662734,-0.9288288608010864
2022-03-31T09:30:00-04:00,351.07,351.57,346.76,346.83,3978913,5236374,53.34914981690242,54.98739900896959,NaN,NaN,69.40885887216469,107.36141545819267,1.405482981505598,2.386807152780648,0.9813241712750498,445161755,448213582.2,61.200415226760896,43.630272616448785,NaN,NaN,10.326082372183313,0.6790156010538277
2022-04-01T09:30:00-04:00,348.15,348.35,345.24,348.01,3560210,5112683.1,54.662345608484685,56.073092681684734,NaN,NaN,53.49972671739636,94.17983921469708,1.0783816226105942,2.3293011995382926,1.2509195769276984,448721965,448882718.4,61.94045429154491,47.070799082340066,NaN,NaN,10.273823206658065,2.049702401854433
2022-04-04T09:30:00-04:00,347.64,349.28,346.03,349.24,3829885,4974636.25,56.05110084051434,56.70525427005074,NaN,NaN,58.377014069039674,84.80454416676605,0.8839216127556382,2.355821592872246,1.471899980116608,452551850,449725348.8,62.90009281086063,50.38249460925856,NaN,NaN,10.615891686644343,3.2734437282529916
2022-04-05T09:30:00-04:00,347.82,351.05,345.5,346.34,4331699,4780730.1,52.00627368845825,56.65561717881557,NaN,NaN,49.23041101414851,68.45002784758249,0.5172109581141022,2.1184136777592357,1.6012027196451335,448220151,448759277.8,61.001036291775385,53.22254087633259,NaN,NaN,9.761224638919327,4.200269572633896
2022-04-06T09:30:00-04:00,343.59,346.06,342.7,344.75,5431293,4818836.65,49.88090651565249,56.178761739827515,NaN,NaN,8.209016854277357,47.74500550540533,0.14418282605342658,1.7814312522119167,1.63724842615849,442788858,447488915.8,58.499858566262304,55.328655453579024,NaN,NaN,8.436833787381563,4.805493031883563
2022-04-07T09:30:00-04:00,343.77,347.1,341.89,345.97,4599942,4882965.45,51.51811912613008,55.70712999953326,NaN,NaN,6.732218788084369,35.209677488589264,-0.03425121387942687,1.5944344088092066,1.6286856226886335,447388800,447934324.8,59.13256305834132,56.73842592461137,NaN,NaN,7.759275066299044,5.227461893942917
2022-04-08T09:30:00-04:00,345.71,349.12,344.65,347.37,4535880,4763587.35,53.39936931551424,55.525685990667945,NaN,NaN,33.11709715739023,31.133151576588034,-0.06979839462714876,1.5414376294046974,1.6112360240318462,451924680,448574867.8,60.07525008465581,57.78288477213731,NaN,NaN,7.684108501290214,5.578411409278245
2022-04-11T09:30:00-04:00,345.36,347.08,342.74,343.2,5344447,4748779.15,47.48853759931915,54.73730129705323,NaN,NaN,-40.42178292673719,11.373392177432669,-0.36922872106667315,1.1497001226985049,1.518928843765178,446580233,447380544.4,57.41586998810435,58.29087558254297,NaN,NaN,5.916940234338672,5.626772670001163
2022-04-12T09:30:00-04:00,344.41,346.75,341,342.22,4501423,4641425.75,46.19441145904707,54.273276563202394,NaN,NaN,-90.59146161304545,-16.590982348006122,-0.6139393639416402,0.7515046388381279,1.365444002779768,442078810,446152276.2,54.73246757976371,58.486564593847625,NaN,NaN,4.073198406510413,5.404833489502485
2022-04-13T09:30:00-04:00,341.69,346.05,341.54,345.76,3604954,4342820.4,51.35165621654897,53.919062031475754,NaN,NaN,-74.06248898869445,-33.045283516600485,-0.5216695005366891,0.7133571271089068,1.235026627645596,445683764,446731257.4,55.781558726735454,58.67305682158543,NaN,NaN,3.8991352139442506,5.189733735851308
2022-04-14T09:30:00-04:00,346.71,348.73,344.245,344.29,4179594,4250156.1,49.24100710283443,53.313189852459836,NaN,NaN,-36.28215506425197,-41.648158287067744,-0.5415612283130489,0.5580750922542848,1.0996363205673336,441504170,445554331.4,53.08820248422661,58.623051320750314,NaN,NaN,3.1514007364762406,4.898543307369156
2022-04-18T09:30:00-04:00,343.87,346.07,342.63,344.1,3938996,4151911.4,48.96089499466705,52.621293293905474,NaN,NaN,-82.8229244610656,-64.83616261075892,-0.5477899739986972,0.4148988530689621,0.9626888270676593,437565174,442682430.2,47.11060268232621,57.98371717434461,NaN,NaN,2.4580729885597394,4.5499046903963825
2022-04-19T09:30:00-04:00,344.29,349.74,344.25,349.12,4261175,4148476.6,56.07121217499003,52.20276411618393,NaN,NaN,30.316904026478912,-50.68842522011569,-0.21138995341715983,0.6984513852962095,0.9098413387133694,441826349,441731653.4,45.29237738254181,57.05244151713053,NaN,NaN,3.8966755848435843,4.4565862467459825
2022-04-20T09:30:00-04:00,351.06,353.07,350.2801,351.53,5676962,4210783.15,59.022612999705515,52.085542675626336,NaN,NaN,145.70470908412142,-3.429191080682338,0.15604619298437195,1.1048990799438343,0.9488528869594623,447503311,442816553.6,47.769508776473856,56.13858985359816,NaN,NaN,6.008850835087448,4.678338330794763
2022-04-21T09:30:00-04:00,353.96,354.8783,347.18,347.71,5369607,4274330.65,52.94999575959775,52.057031671533146,NaN,NaN,83.62386975531956,28.108080668120465,0.12573386540361364,1.1060202187139794,0.9802863533103657,442133704,442106541.6,46.2922055156572,55.07371773137647,NaN,NaN,6.0226879158562285,4.87038827151783
2022-04-22T09:30:00-04:00,346.34,346.41,337.74,338.27,6855127,4439584.9,41.56817486981372,51.12173376162808,NaN,NaN,-174.3444119396217,0.49562929304651676,-0.5112323212681107,0.3412459517252273,0.852478272993338,435278577,440861423,43.73771282053703,53.77352191201877,NaN,NaN,2.007128565976531,4.461351170726216
2022-04-25T09:30:00-04:00,336.45,341.08,333.2,340.56,6806588,4619537.75,44.674990530961225,50.30915445380286,NaN,NaN,-195.61189823680544,-22.06216546210145,-0.7453001754847379,-0.07914694636258446,0.6661532291221535,442085165,441765421.2,46.064789525551475,52.5710002487824,NaN,NaN,-0.14342119263114605,3.80352654738945
2022-04-26T09:30:00-04:00,338.03,339.05,332.27,332.45,7619818,4852407.95,37.142952386276306,49.24748864650415,NaN,NaN,-225.44745312832194,-73.21503689306162,-1.3765739505044805,-1.054564209008447,0.32200974149603334,434465347,440293220.8,42.94925211605648,51.2815870933739,NaN,NaN,-4.842721016602905,2.568348323961971
2022-04-27T09:30:00-04:00,333.88,337,331.075,333.03,6894376,4961536.35,37.94868483687262,48.39518709801988,NaN,NaN,-207.12122083690238,-143.78022287726637,-1.6660032980482138,-1.760494381064234,-0.09449108301602016,441359723,439064503.2,40.487978993062164,49.995024266716754,NaN,NaN,-8.139739854654698,1.038621441302447
2022-04-28T09:30:00-04:00,335.24,340.535,332.491,339.29,5976595,5064874.2,45.99507789606911,48.00068415301553,NaN,NaN,-121.6176523788861,-184.8285273041075,-1.359717327421086,-1.7941377422923779,-0.43442041487129174,447336318,440105026,43.443738547967286,48.87439394454718,NaN,NaN,-8.166676966202333,-0.27642118834109297
2022-04-29T09:30:00-04:00,337.62,339.225,329.1,329.69,6495649,5190711,37.882321712499056,46.892323609943006,NaN,NaN,-166.13102510469108,-183.1858499371214,-1.7051536302983028,-2.5658624527441702,-0.8607088224458674,440840669,441217444.4,46.50285663338233,47.904937269456205,NaN,NaN,-11.26240187079101,-1.8458470001196523
2022-05-02T09:30:00-04:00,330.35,332.34,324.4601,330.74,9221719,5473786.45,39.1466056565358,46.29647132831563,NaN,NaN,-174.47329871953605,-178.95813003366752,-1.7574239767474902,-3.05748879338023,-1.30006481663274,450062388,442812889,50.627609661162296,47.420061531817495,NaN,NaN,-13.14941739499114,-3.460642770815579
2022-05-03T09:30:00-04:00,331.18,333.42,329.11,331.25,6051042,5584844.3,39.78763900668232,45.83884472457529,NaN,NaN,-125.17491147000436,-158.903621702004,-1.6536594970706695,-3.367139187971077,-1.7134796909004073,456113430,447142505.6,59.70687492267407,47.775376342025375,NaN,NaN,-14.393846996123932,-5.022529088716772
2022-05-04T09:30:00-04:00,331.8,341.17,330.2,340.59,10569673,5896743,50.145331892688546,45.752678701442406,NaN,NaN,-46.378062677674784,-126.75499007015847,-0.8902559207576639,-2.826299591847487,-1.9360436710898232,466683103,452207181.6,67.28554712809668,48.59708979926546,NaN,NaN,-11.850371877762802,-5.997935201437634
2022-05-05T09:30:00-04:00,337.83,338.24,326.89,330.24,9101151,6080235.9,41.60457076186994,45.20721896280208,NaN,NaN,-99.56400565275739,-122.34426072493272,-1.0079629421870182,-3.195997348823596,-2.1880344066365778,457581952,454256308.4,69.76351316509661,49.7881834193276,NaN,NaN,-12.830441901653627,-6.974007587182776
2022-05-06T09:30:00-04:00,327.74,330.65,324.75,329.07,10644204,6382449,40.75943893323969,44.621400672700126,NaN,NaN,-123.0767628878135,-113.73340828155722,-1.0836191144860985,-3.5425582997442007,-2.458939185258102,446937748,455475724.2,71.1633215507739,51.50623476707386,NaN,NaN,-13.86323726114502,-7.958183254891668
2022-05-09T09:30:00-04:00,324.98,326.37,321.37,322.6,7817217,6546515.85,36.36078526745333,43.213513036447516,NaN,NaN,-152.8074120830147,-109.40023095425292,-1.4647164387209508,-4.289834733659291,-2.8251182949383398,439120531,453287352.8,65.31904221643482,52.93671082663764,NaN,NaN,-16.283598826896384,-9.147528336606626
2022-05-10T09:30:00-04:00,326.5,327.61,319.06,321.83,7716509,6665118.95,35.864729775466955,41.55937852043047,NaN,NaN,-140.35972359585088,-112.43719337942223,-1.6501815393346266,-4.887845219106623,-3.2376636797719964,431404022,448345471.2,54.445047345768195,53.41353501015867,NaN,NaN,-18.306293070372043,-10.455923298573115
2022-05-11T09:30:00-04:00,321.74,326.07,318.16,318.46,9374744,6908785,33.69790511107624,40.18422918839322,NaN,NaN,-137.84073943115143,-130.72972873011756,-1.8654705935681948,-5.56950192173224,-3.704031328164045,422029278,439414706.2,41.12197724087889,53.04423299053165,NaN,NaN,-20.664513715938458,-11.914293358196735
2022-05-12T09:30:00-04:00,316.6,319.43,312.53,317.64,6790822,7068078.4,33.17272771408929,39.584554391555756,NaN,NaN,-155.18892166741514,-141.85471193304912,-1.9211800886097912,-6.105506438926284,-4.184326350316493,415238456,430946007,32.90032882558823,52.27013413374959,NaN,NaN,-22.702405165212987,-13.455452187770485
2022-05-13T09:30:00-04:00,320.33,323.03,318.8478,322.23,4236731,7070935.25,38.91182746318473,39.17289988671458,NaN,NaN,-104.28753669314348,-138.09686669411514,-1.5243155044437602,-6.089720730871193,-4.5654052264274325,419475187,425453494.8,28.868939437823357,51.0418591274833,NaN,NaN,-22.688593020694025,-14.774472306759561
2022-05-16T09:30:00-04:00,321.71,325.57,319.695,322.78,3692621,7058616.5,39.581396570804344,39.34707447132373,NaN,NaN,-84.9083379031652,-124.51705185814521,-1.1189396909883476,-5.964079840162867,-4.84514014917452,423167808,422262950.2,26.81357998419533,49.88931111806465,NaN,NaN,-22.481213146696525,-15.875435283893413
2022-05-17T09:30:00-04:00,326.83,327.37,323.46,327.1,3316843,7011399.9,44.70774712379337,39.82986463467522,NaN,NaN,-50.72637141194947,-106.59038142136494,-0.4863367914107295,-5.453061138437931,-4.966724347027202,426484651,421279076,26.194249647685666,48.86833045053776,NaN,NaN,-20.767361312902693,-16.57428185946617
2022-05-18T09:30:00-04:00,324.21,324.39,314.43,315.55,3659049,6910504.25,35.93008622775548,39.1109366583671,NaN,NaN,-112.81376322485016,-101.58498618010469,-0.7561523105573951,-5.911914735223945,-5.15576242466655,422825602,421438340.8,26.49023994036949,47.657366264280775,NaN,NaN,-22.05687738557361,-17.35750979176723
2022-05-19T09:30:00-04:00,312.12,316.345,310.83,313.18,3836689,6833858.35,34.4360524415296,38.86477456758356,NaN,NaN,-145.19432256898128,-99.58606636041793,-0.9898724585319867,-6.393102997831534,-5.403230539299547,418988913,422188432.2,27.955673466880484,46.332567466673495,NaN,NaN,-23.572803994203614,-18.24540896354386
2022-05-20T09:30:00-04:00,314.79,315.07,306.28,312.42,4653963,6723800.15,33.94855384725341,38.493485152634825,NaN,NaN,-147.9349348330087,-108.31554598839095,-1.083714172468361,-6.7578732548849985,-5.6741590824166375,414334950,421160384.8,27.156611725813093,44.65606761414855,NaN,NaN,-24.92576229420772,-19.199745153638695
2022-05-23T09:30:00-04:00,315.32,319.6484,314.7817,318.84,4484636,6607702.55,41.484488625872906,38.61468869686272,NaN,NaN,-77.41649680473476,-106.8171777687049,-0.6242826261117775,-6.45451236505636,-5.830229738944582,418819586,420290740.4,26.467427452690487,42.28182136629258,NaN,NaN,-23.724851117677066,-19.846188862787034
2022-05-24T09:30:00-04:00,316.57,320.15,313.62,319.39,5260533,6489738.3,42.094012356346816,38.03959444426688,NaN,NaN,-70.93947645744066,-110.85979877780312,-0.21534109994790818,-6.099406113879468,-5.88406501393156,424080119,419809834,26.073369166028883,39.33809436900202,NaN,NaN,-22.584146992500163,-20.23732573846034
2022-05-25T09:30:00-04:00,317.98,322.54,317.45,321.28,4612843,6375661.65,44.24332826660506,38.22807712317654,NaN,NaN,-38.81357382512489,-96.05976089785807,0.22652334460959622,-5.600910833169564,-5.8274341777791605,428692962,420983306,28.85679107655679,36.416185648392045,NaN,NaN,-21.006793884738514,-20.347249759357222
2022-05-26T09:30:00-04:00,322.9499,327.77,322.9,326.45,3270215,6240342.65,49.73900620569224,38.869474785494575,NaN,NaN,27.796013764147272,-61.46169363123236,0.8746656170617992,-4.734102156451911,-5.60876777351371,431963177,423578158.8,34.710685861352644,33.81242595629052,NaN,NaN,-17.947376870348787,-20.00441077521316
2022-05-27T09:30:00-04:00,327.05,332.13,326.82,332.07,2773115,6054215.95,54.93849429356533,40.19645400164544,NaN,NaN,87.78977848137568,-14.316750968355473,1.6448465556965441,-3.5527095788930296,-5.197556134589574,434736292,427658427.2,42.69543653319291,32.196454121773236,NaN,NaN,-13.62659630423598,-19.09329442221642
2022-05-31T09:30:00-04:00,330.17,332.5457,327.66,330.2,4354032,5810831.6,52.974734869579784,41.41859722265349,NaN,NaN,83.81083695442206,17.928715783475898,1.9694015685327697,-2.7358041739236114,-4.705205742456381,430382260,429970962,46.67584348497384,31.64151098885936,NaN,NaN,-10.66824506058272,-17.889715941983034
2022-06-01T09:30:00-04:00,332.41,332.95,326.1,328.36,3721407,5694349.85,51.04145179724003,42.65742198595091,NaN,NaN,74.38511554336145,46.99363418363631,1.9950590395835288,-2.2113819429769705,-4.206440982560499,426660853,430487108.8,47.55151428290767,32.100763634718554,NaN,NaN,-8.775127886849939,-16.587631934106877
2022-06-02T09:30:00-04:00,328.55,332.78,325.36,332.77,3718751,5351803.75,55.25614090628657,44.234808642536436,NaN,NaN,100.95769754293632,74.94788845724857,2.226341570771653,-1.4235140190959328,-3.649855589867586,430379604,430824437.2,48.150785480061096,33.19008196718091,NaN,NaN,-5.858847814105678,-15.05494848839242
2022-06-03T09:30:00-04:00,329.87,331.73,328.73,329.35,4150850,5104288.7,51.54987296220402,45.137526178180664,NaN,NaN,99.24108302138255,89.23690230869562,2.0696151030986254,-1.0628367109943042,-3.1324518140929296,426228754,429677552.6,46.217276050280745,34.42924886807072,NaN,NaN,-4.470824515473258,-13.542930777975396
2022-06-06T09:30:00-04:00,331.59,332.74,328.53,329.45,1957646,4669960.8,51.65198888199191,45.999711343265496,NaN,NaN,99.6789567563942,91.61473796369933,1.8978290775146078,-0.7601654671996698,-2.6579945447142777,428186400,428367574.2,44.041882249103274,35.659841886992716,NaN,NaN,-3.3194922292846942,-12.082439556733867
2022-06-07T09:30:00-04:00,326.82,332.47,326.82,332.17,2424032,4400301.55,54.46332905299007,46.6965386239224,NaN,NaN,91.05118763442121,93.06280809969914,1.8884860629514777,-0.29738696602493064,-2.1858730289764083,430610432,428413208.6,44.14052003674847,36.94171834335435,NaN,NaN,-1.533338293671349,-10.57542509058208
2022-06-08T09:30:00-04:00,330.56,331.925,328.5623,329.38,2032944,4116123.3,51.176156988386836,47.785543678253205,NaN,NaN,75.40436922824856,93.26665883667657,1.6255093875398916,-0.15398629455154378,-1.7794956820914354,428577488,428796535.6,45.01725513092897,38.26507657125146,NaN,NaN,-0.9189233585916272,-9.195924843154872
2022-06-09T09:30:00-04:00,328.16,329.99,323,323,2591478,3776960,44.55391184349022,48.5082479212504,NaN,NaN,17.933134985351668,76.66174632515964,0.984535441276079,-0.5488263804963367,-1.5333618217724156,425986010,427917816.8,43.338041410148676,39.36381713862776,NaN,NaN,-2.3648967753875274,-8.22006369061668
2022-06-10T09:30:00-04:00,318.31,318.77,314.32,314.37,4484707,3661654.25,37.487501130045494,48.76102987002126,NaN,NaN,-95.66172353478355,37.68118501392642,-0.005592656922909445,-1.5403526429260523,-1.534759986003143,421501303,426972326.6,41.542436735371126,40.3913760678819,NaN,NaN,-6.050892719955471,-7.910182123379364
2022-06-13T09:30:00-04:00,307.5,309.62,304.16,305.58,6317234,3765679.4,31.932232329622167,48.078725848860486,NaN,NaN,-173.35949218161036,-16.92650477367449,-1.172857741712615,-3.0008321631439117,-1.8279744214312967,415184069,424371860.4,37.00155409827648,41.143813685423765,NaN,NaN,-11.296226973538499,-8.39390281625924
2022-06-14T09:30:00-04:00,306.61,307.425,301.93,304.3,3723955,3767246.1,31.207001258446653,47.30108219901048,NaN,NaN,-158.93362667524343,-66.92346763560742,-1.9080150581161401,-4.212993244076472,-2.3049781859603318,411460114,420541796.8,31.534281739036956,41.53387886921006,NaN,NaN,-15.62185307022299,-9.426467138254061
2022-06-15T09:30:00-04:00,306.4,310.68,302.26,307.23,7060907,3954449.3,34.854330811706475,46.630439523660584,NaN,NaN,-121.11352900181805,-106.22704728162076,-2.0607763183565266,-4.88094858390599,-2.8201722655494637,418521021,418530503.4,29.10244535046766,41.55142560306083,NaN,NaN,-17.99528063224779,-10.650583351681737
2022-06-16T09:30:00-04:00,301.37,301.66,298.022,299.9,4943471,4018670.4,30.497979721289454,45.25608048906038,NaN,NaN,-153.08579738344528,-140.43083375538012,-2.4905673204800527,-5.93338141614953,-3.442814095669477,413577550,416048811.4,26.397427413857557,40.95762142823975,NaN,NaN,-21.541982263552377,-12.206497481948972
2022-06-17T09:30:00-04:00,298.27,301.5792,296.39,298.72,4737958,4063733.85,29.851150087123713,43.464127331457405,NaN,NaN,-142.0687098183029,-149.712231012084,-2.6733097041387612,-6.784451225842929,-4.111141521704168,408839592,413516469.2,23.951045089815082,39.618736325141334,NaN,NaN,-24.552478115461856,-13.97020900102224
2022-06-21T09:30:00-04:00,303.08,306.47,302.62,305.29,3246541,3993362.75,37.76554591756075,42.37775669202748,NaN,NaN,-95.77373173030736,-134.19507892182338,-2.190947233994338,-6.84982556419709,-4.658878330202752,412086133,412896882,23.38012633805762,37.95475652893303,NaN,NaN,-24.602314538086777,-15.489081220602888
2022-06-22T09:30:00-04:00,301.53,307.68,301.33,304.61,6361190,4087190.45,37.29652329762719,41.39597608491228,NaN,NaN,-86.79124045946084,-119.76660167866687,-1.7746806152082186,-6.877229099213025,-5.1025484840048065,405724943,411749847.8,22.319428875526313,36.15246471412008,NaN,NaN,-24.78499863606659,-16.817069422811986
2022-06-23T09:30:00-04:00,305.67,307.06,302.78,306.74,3582611,4003294.35,39.81780526131538,40.29323782455719,NaN,NaN,-72.40784153650931,-110.02546418560512,-1.2382904881381647,-6.650411594177513,-5.412121106039348,409307554,409907154.4,20.695101257270707,34.19134441249219,NaN,NaN,-24.18153189559841,-17.869135490352903
2022-06-24T09:30:00-04:00,309.2,315.12,309.12,315.02,3314805,3938392.45,48.488765080878274,40.07458726160535,NaN,NaN,-25.964075381445365,-84.60111978520514,-0.2594267830769832,-5.736404584885577,-5.4769778018085935,412622359,409716116.2,20.528301509519935,32.35641765958071,NaN,NaN,-20.832851169458248,-18.29252344451081
2022-06-27T09:30:00-04:00,315.4,315.89,313.38,314.36,1896472,3869705.3,47.89638537237003,39.80632986806093,NaN,NaN,-14.74466055453867,-59.1363099324523,0.3755185072018481,-5.007579667806283,-5.383098175008131,410725887,410093375.2,21.86755662795295,30.77253725806997,NaN,NaN,-18.34459470839862,-18.299962196494782
2022-06-28T09:30:00-04:00,316,318.75,309.23,309.34,3030245,3882561.8,43.539401339693846,39.026049317111195,NaN,NaN,-23.16589223315011,-44.61474203302085,0.48251661970572446,-4.779952400375976,-5.2624690200817,407695642,409215277,20.981276742161214,29.11830559417088,NaN,NaN,-17.519744254022104,-18.188502490427258
2022-06-29T09:30:00-04:00,310.4,311.48,308.83,310.05,2462832,3788001.8,44.31100087320853,38.53568102316989,NaN,NaN,-33.41098024565327,-33.938689990259334,0.6175741120490708,-4.490501380020362,-5.108075492069433,410158474,410101983.2,24.31700221102902,27.639716099892308,NaN,NaN,-16.626914078815457,-17.965418431625572
2022-06-30T09:30:00-04:00,306.75,309.82,304.25,307.82,4117791,3807821,42.353219878328645,38.37848873994407,NaN,NaN,-47.733151696415526,-29.00375202224057,0.5741072352070784,-4.390441448060585,-4.9645486832676635,406040683,409448609,23.528818716888935,26.224771621802326,NaN,NaN,-16.43711975015082,-17.74709004855775
2022-07-01T09:30:00-04:00,307.4,311.31,304.77,310.85,3315014,3787634.15,45.853822396073404,38.97608311608891,NaN,NaN,-31.181645467793512,-30.047266039510202,0.7553957530230138,-4.0203039919888965,-4.77569974501191,409355697,408795276.6,22.735268724957166,24.881402478201327,NaN,NaN,-15.265104137927285,-17.3925206327534
2022-07-05T09:30:00-04:00,306.6,309.76,303.58,309.71,3767731,3768478.2,44.75270421046963,39.891831107578014,NaN,NaN,-36.22838824245845,-34.34401157709416,0.8002117964643993,-3.775434999431411,-4.5756467958958105,405587966,407767692.4,21.506656126799058,23.774624051667224,NaN,NaN,-14.59473673829742,-16.992837219259687
2022-07-06T09:30:00-04:00,310,312.29,307.94,310.41,2493272,3795259.5,45.616289230589025,40.92106596273105,NaN,NaN,-6.620701031192302,-31.0349733367026,0.872740862700951,-3.4847207175196218,-4.357461580220573,408081238,407844811.6,21.84799423892686,23.082746373087936,NaN,NaN,-13.801993764663939,-16.537002440031724
2022-07-07T09:30:00-04:00,312.54,314.27,311.6112,313.95,2267512,3787433.5,49.88278129276243,41.9945267113779,NaN,NaN,39.85225590074029,-16.3823261074239,1.1380908335130808,-2.9348480383292213,-4.072938871842302,410348750,407882866.8,22.028182206641006,22.577441862814602,NaN,NaN,-11.915562036390227,-15.876796668082939
2022-07-08T09:30:00-04:00,313.5,315.14,312.17,313.46,2094271,3790499.85,49.30617297783859,43.337969086845696,NaN,NaN,64.17967353093174,6.000238938045554,1.250608003404595,-2.5096788675865582,-3.760286870991153,408254479,408325626,24.217421846620468,22.421727179440527,NaN,NaN,-10.492152027074436,-15.107561719367439
2022-07-11T09:30:00-04:00,311.66,313.74,311.17,311.7,2633170,3792584.45,47.19591327352149,44.576880743016964,NaN,NaN,62.83992273754471,24.8045525791132,1.1775353769107495,-2.2883676498527166,-3.465903026763466,405621309,407578748.4,23.04213240255413,22.356804844636176,NaN,NaN,-9.814730538062037,-14.351442979180954
2022-07-12T09:30:00-04:00,310.56,313.55,308.6,309.97,2805957,3708646.95,45.15034579416301,45.10436644848856,NaN,NaN,44.532704791111094,40.95677118582711,0.9911999379416292,-2.2269031043364294,-3.2181030422780585,402815352,407024225.6,22.181414526088133,22.271182572352643,NaN,NaN,-9.76562050285652,-13.696325482563177
2022-07-13T09:30:00-04:00,306.19,309.94,305.11,307.75,3481167,3566843.6,42.59882788793048,45.48310249065308,NaN,NaN,-13.605015771158904,39.55990823783379,0.7101117735654379,-2.3304633253212614,-3.0405750988866993,399334185,405274815,19.68339824697287,22.082894670313106,NaN,NaN,-10.403246355782636,-13.225885607308815
2022-07-14T09:30:00-04:00,302.66,306.86,301.47,306.4,2893106,3525301.15,41.07856639323133,45.57315685721851,NaN,NaN,-64.29336075022456,18.730784907640817,0.43827242177077963,-2.4927345716732248,-2.9310069934440044,396441079,402493280.8,16.50137410410339,21.78334273080116,NaN,NaN,-11.35544001939596,-12.958679094749835
2022-07-15T09:30:00-04:00,310.81,312.78,309.15,312.66,3027542,3323632.9,49.99096093253243,45.68045656090809,NaN,NaN,54.14860972274586,16.72457214600364,0.6711338246870726,-2.092089712585164,-2.7632235372722365,399468621,400736109.2,14.866356650227857,21.378918097994585,NaN,NaN,-9.68602494218935,-12.49115707295548
2022-07-18T09:30:00-04:00,315.76,316.35,309.73,310.65,2344920,3193705.35,47.50623703062345,45.652588822211904,NaN,NaN,61.94772766648099,16.546133131790896,0.6788231739366646,-1.914694569851406,-2.5935177437880705,397123701,399036587.6,13.475610318526947,20.779493361607013,NaN,NaN,-8.980486267435609,-11.989632672166927
2022-07-19T09:30:00-04:00,313.07,318.4,312.66,318.11,3004908,3107052.85,56.20635597500133,46.557371296162444,NaN,NaN,143.28923045043823,36.29743826365633,1.1477820548899111,-1.1587901751756817,-2.306572230065593,400128609,398499239,13.059615535746929,20.21366041829171,NaN,NaN,-5.538841178220037,-11.068091030174514
2022-07-20T09:30:00-04:00,318.24,319.43,316.45,318.74,3243033,3106877.45,56.8566617865801,47.453489932831836,NaN,NaN,165.78455624566274,72.17535266702066,1.442781471231702,-0.5030953910259655,-1.9458768622576674,403371642,399306730.4,17.196329533124015,19.705040941298495,NaN,NaN,-2.582425366552831,-9.85585307822856
2022-07-21T09:30:00-04:00,317.63,320.46,315.38,320.41,2159793,2896807.6,58.611150236162814,48.61477067267714,NaN,NaN,161.09656230815216,117.25333727869602,1.6763640879945039,0.14957824773546236,-1.5267858402590415,405531435,401124801.6,25.761230916234098,19.864498955537435,NaN,NaN,0.4018711962910263,-8.390463896154333
2022-07-22T09:30:00-04:00,321.76,322.2,317.34,319.06,3264096,2880881.85,56.607095315690934,49.38286159550696,NaN,NaN,161.3283655301257,138.68928844017196,1.662656940295213,0.5515353351099748,-1.1111216051852382,402267339,401684545.2,28.222855870868912,20.2564694659597,NaN,NaN,2.321917072631854,-6.860123757756307
2022-07-25T09:30:00-04:00,320.07,320.39,318.25,319.96,4002541,2915268.65,57.646797727250686,50.30386827527703,NaN,NaN,138.46228218559725,153.9921993439952,1.6344721224641876,0.9319685478949964,-0.7025035745691912,406269880,403513781,35.72365500713251,21.271969385983517,NaN,NaN,4.2148201118893045,-5.277988919235506
2022-07-26T09:30:00-04:00,318.89,319.48,317.1,317.54,2101675,2925528.8,53.90663827197603,50.896036063947534,NaN,NaN,99.52580789951946,145.23951483381148,1.383090539736144,1.0263596001009887,-0.35673093963515523,404168205,404321700.2,38.767257908298525,22.480488219510068,NaN,NaN,4.816442382470024,-3.8359273047061446
2022-07-27T09:30:00-04:00,318.88,323.44,318.04,322.01,3338124,2940922.75,59.17545534512975,51.55979849625948,NaN,NaN,132.43460399163845,138.5695243830066,1.4415427473587434,1.4451974945632742,0.003654747204530684,407506329,405148637.6,41.80474060826783,23.893099533911982,NaN,NaN,6.918036993569027,-2.2996466906668345
2022-07-28T09:30:00-04:00,322.45,326.12,319.81,325.23,2688420,2952202.15,62.50075152209555,52.502268392277834,NaN,NaN,146.92502665592562,135.7352172525613,1.6080709636963815,2.0137434518250075,0.40567248812862605,410194749,406081300.4,45.11182731479043,25.385557067352693,NaN,NaN,9.7438427245255,-0.5791482027822152
2022-07-29T09:30:00-04:00,325.5201,329.27,324.9231,328.66,3225635,2907594.35,65.70524653814334,53.82436362546508,NaN,NaN,171.64764799910526,137.7990737463572,1.8433460346372643,2.7098550314252066,0.8665089967879422,413420384,408311909.4,52.11987048358539,27.462538358854925,NaN,NaN,13.176167919303689,1.3858969575157711
2022-08-01T09:30:00-04:00,326.91,329.72,326.45,328.04,2745526,2879119.95,64.6301329801503,55.21577699589274,NaN,NaN,153.43531072927505,140.79367945509279,1.8467138972581894,3.174901368360679,1.3281874711024897,410674858,409192905,54.58614457909312,29.77716193406957,NaN,NaN,15.653336802930221,3.4241026497178355
2022-08-02T09:30:00-04:00,326.97,327.78,323.9,324.04,5394567,2960461.75,58.0326309198221,56.31819149817072,NaN,NaN,107.11742212137602,142.3120022994641,1.484637527342311,3.1839843802803784,1.6993468529380675,405280291,409415322.2,55.21335585866135,32.31501604919018,NaN,NaN,15.84973453344071,5.199192918821103
2022-08-03T09:30:00-04:00,325.7,329.14,325.14,328.16,2564614,2964028.85,62.30130246372349,57.834101217491586,NaN,NaN,121.17230104522953,140.05954171018232,1.4273040748807797,3.4834769465390423,2.0561728716582626,407844905,409483037.4,55.415245643366745,35.0945783019947,NaN,NaN,17.344222915494157,6.93419720406011
2022-08-04T09:30:00-04:00,327.69,328.36,326.55,327.36,2426392,2971972.85,61.003779093762475,58.620731086150876,NaN,NaN,108.73439691706886,132.42141576241096,1.246747072861842,3.614606712735565,2.367859639873723,405418513,408527790.2,51.863499392227475,37.73723135499468,NaN,NaN,18.166720834040362,8.538843436914432
2022-08-05T09:30:00-04:00,325.07,328.19,324.9298,327.97,2672438,3000881.2,61.65947229435958,59.63167646213203,NaN,NaN,93.61114034728004,116.81411423204591,1.0855623508321783,3.724812578413946,2.6392502275817677,408090951,407461903.6,48.154716501048206,40.21431036803191,NaN,NaN,19.027197104842884,10.037179675189925
2022-08-08T09:30:00-04:00,329.81,331.12,327.71,328.42,2530002,2995722.8,62.16487859555438,60.05728522074296,NaN,NaN,105.15023825295813,107.15709973678254,0.9322843256751763,3.804605634675738,2.872321309000562,410620953,407451122.6,48.117236206496756,42.718426130228316,NaN,NaN,19.878006019278853,11.443012010059771
2022-08-09T09:30:00-04:00,328.28,328.94,327.19,327.91,1655102,2938180.05,61.1805540444644,60.36613466773469,NaN,NaN,83.93091718271256,102.51979874904983,0.728607330473579,3.7830804720925357,3.0544731416189568,408965851,408188234.6,50.92942473915627,45.1279329306592,NaN,NaN,20.330584370325283,12.712665204383416
2022-08-10T09:30:00-04:00,332.5973,333.83,331.9627,333.2,2934424,2910842.9,67.01477482796875,60.9663935671494,NaN,NaN,127.73404948438838,103.83214843688158,0.8725001285412186,4.14509830229548,3.2725981737542615,411900275,408999308.6,53.890973995178506,47.137200293440934,NaN,NaN,22.456311156717206,14.104614626145386
2022-08-11T09:30:00-04:00,335.82,336.8,333.18,333.71,2401597,2886267.45,67.52156456890452,61.745998513807514,NaN,NaN,137.15970405235907,109.51720986393964,0.9196628039079311,4.422176678639175,3.5025138747312443,414301872,410775980.4,59.63752206798131,49.38110502180611,NaN,NaN,24.350480675420528,15.568309776041835
2022-08-12T09:30:00-04:00,334.8,337.92,334.19,337.83,2606866,2865233.65,71.35095956413626,62.7248672164422,NaN,NaN,149.6984181544049,120.7346654253646,1.1320102357872015,4.917526669465246,3.785516433678045,416908738,412539537.8,64.38266781538115,51.428177365252445,NaN,NaN,27.213527370217577,17.23191228949551
2022-08-15T09:30:00-04:00,336.11,339.85,336.06,339.37,1936450,2844810.15,72.64908058738393,64.0636130961142,NaN,NaN,159.14091461218467,131.5328006972099,1.2695310166623894,5.372430204506031,4.102899187843642,418845188,414184384.8,68.1443244156626,53.52653925863559,NaN,NaN,29.999771703774087,19.05589220582102
2022-08-16T09:30:00-04:00,338.82,343.09,338.75,341.74,3897090,2889419.25,74.55955864072692,65.16247761722828,NaN,NaN,176.77184767284274,150.10098679523594,1.4030179787275001,5.856671661253017,4.453653682525517,422742278,416939670.2,73.24224632310397,55.772075381123884,NaN,NaN,32.96629415606388,21.043092484427145
2022-08-17T09:30:00-04:00,339.67,342.06,338.7034,340.2,2960328,2875284,71.08495802188119,65.77563522435581,NaN,NaN,144.99731754692556,153.5536404077434,1.2742541868803832,6.046471416125996,4.772217229245613,419781950,418516005.2,75.6437506880488,57.952927050642344,NaN,NaN,34.46141704210088,22.95999599266625
2022-08-18T09:30:00-04:00,340.2,341,338.97,340.58,1850925,2859840.6,71.43865212743285,66.18516419501934,NaN,NaN,122.53889391042979,150.62947837935752,1.1074923453460421,6.156582660928166,5.049090315582124,421632875,419982205.8,77.6527821984547,59.77670645884729,NaN,NaN,35.79154274286494,24.793074099837494
2022-08-19T09:30:00-04:00,338.35,338.66,336.26,337.04,2010332,2797152.4,63.63009302175708,66.11373276941984,NaN,NaN,79.04066697579562,136.49792814363568,0.6729665524634667,5.890298506161457,5.2173319536979905,419622543,420524966.8,78.36423884418767,61.4751417634969,NaN,NaN,34.701926355966116,26.208624422141582
2022-08-22T09:30:00-04:00,333.11,333.52,330.16,330.76,2684482,2731249.45,52.63804815877187,65.72840542934482,NaN,NaN,8.098174647475666,106.28938015069386,-0.08300416335230043,5.113576749507615,5.196580912859916,416938061,420143541.4,76.52054546686995,62.99708387836894,NaN,NaN,30.05238451451453,26.75773300676629
2022-08-23T09:30:00-04:00,330.31,331.45,328.64,329.11,2897211,2771026.25,50.18503892343736,64.8629580336101,NaN,NaN,-21.73768823976315,66.5874729681727,-0.7051561285800183,4.315135752134893,5.020291880714911,414040850,418403255.8,68.59124194737377,63.9382264715123,NaN,NaN,25.4650808962491,26.57306841954955
2022-08-24T09:30:00-04:00,328.93,331.03,328.33,329.86,2581683,2733204.2,51.29606802053497,64.16955009980813,NaN,NaN,-29.333917895011943,31.721225879785187,-1.056049272746705,3.70023028978153,4.756279562528235,416622533,417771372.4,65.92022425824513,64.94227824765642,NaN,NaN,22.08305068866633,25.93163731513766
2022-08-25T09:30:00-04:00,330.09,333.15,329,333.15,2498866,2723726.5,55.9384872760003,63.76090831278247,NaN,NaN,-6.8277923454541725,5.847888628608397,-1.054024428582136,3.438749026800565,4.492773455382701,419121399,417269077.2,63.79359426517693,66.05934094509418,NaN,NaN,20.543361995368347,25.161883698027758
2022-08-26T09:30:00-04:00,333.49,333.67,322.82,322.93,4190969,2771993.2,42.41380075281541,62.350117038301114,NaN,NaN,-85.41683973824443,-27.043612714199604,-1.6906778754627885,2.379426111054215,4.070103986517004,414930430,416330654.6,59.90527061717811,66.90134340299998,NaN,NaN,14.032929299915187,23.57203306972596
2022-08-29T09:30:00-04:00,320.54,323.33,319.75,321.1,2896894,2779561.6,40.5244254524647,60.87467928172971,NaN,NaN,-147.82023649220002,-58.22729494213475,-2.15498447991319,1.3763733866255166,3.5313578665387064,412033536,415349749.6,56.058966706040685,67.26773925777745,NaN,NaN,8.287390337736776,21.388512679441792
2022-08-30T09:30:00-04:00,322.09,322.17,316.57,318.04,2926264,2656146.45,37.515080679560604,58.76755827112913,NaN,NaN,-168.3442709540704,-87.5486114849962,-2.5605117839633245,0.33071813658455085,2.8912299205478753,409107272,414363034,52.41335624366714,67.1621951326695,NaN,NaN,2.5603199962783556,18.6987708675613
2022-08-31T09:30:00-04:00,318.46,320.17,315.6,315.65,2981566,2676994.05,35.309572380822445,56.46670168626612,NaN,NaN,-168.0007325067758,-115.28197440734895,-2.8593451908347247,-0.6829515679955307,2.176393622839194,406125706,412263668.6,45.61623066544318,66.16067431820248,NaN,NaN,-2.8191695706760433,15.624779376384538
2022-09-01T09:30:00-04:00,314.29,317.25,312.7,317.06,3227960,2717072.45,37.63885810778328,54.058694439383764,NaN,NaN,-161.44235851450185,-146.20488764115848,-2.8266154403886796,-1.3568756776466557,1.469739762742024,409353666,410310122,40.36983841304204,64.4454722180354,NaN,NaN,-6.399968817392504,12.478386777273531
2022-09-02T09:30:00-04:00,319.7699,320.745,312.31,313.76,3826209,2774761,34.50721565236887,51.33427551545412,NaN,NaN,-142.51615058819255,-157.6247498111481,-2.881922842210566,-2.1326637900211836,0.7492590521893824,405527457,408429527.4,36.06919084331268,62.15439124858185,NaN,NaN,-10.44105531109947,9.204180764648816
2022-09-06T09:30:00-04:00,314.55,315.2,310.93,312.2,3320402,2814281,33.104969469722576,48.373233431810945,NaN,NaN,-142.19209000176645,-156.4991205130614,-2.871899699963133,-2.840615572764534,0.031284127198598966,402207055,406464231.2,32.20770746851136,59.22335275896809,NaN,NaN,-14.17507032128712,5.864287752372254
2022-09-07T09:30:00-04:00,311.64,316.94,311.45,316.33,2520234,2857537.6,40.050566296724895,46.156491165728355,NaN,NaN,-106.78020513875195,-144.18630734999772,-2.4517859205707704,-3.033448273514864,-0.5816623529440937,404727289,405588234.6,30.63346031717063,56.008332018191076,NaN,NaN,-15.220382300932469,2.8521920304715795
2022-09-08T09:30:00-04:00,314.69,318.4,313.68,318.24,3301094,2875871.1,42.99819205700242,44.12502973212618,NaN,NaN,-81.37639185909926,-126.8614392204624,-1.9327454307296075,-2.997594141356103,-1.0648487106264957,408028383,405968770,32.18413862732753,52.76057176311057,NaN,NaN,-15.161445827479275,0.2788151936214578
2022-09-09T09:30:00-04:00,320.08,322.94,319.5001,322.28,2479262,2879754.35,48.73940413422748,43.06140909730264,NaN,NaN,-40.470272882740524,-102.66702209411017,-1.238571813736789,-2.613063477797482,-1.374491664060693,410507645,406199565.8,33.160083088978766,49.531703494881356,NaN,NaN,-13.26824845441921,-1.6564796132414947
2022-09-12T09:30:00-04:00,323.29,325.68,323.21,324.57,2486866,2873754.35,51.70850151324626,42.99501290833653,NaN,NaN,-14.400306304472506,-77.04385323736616,-0.579875829588143,-2.099336451045872,-1.5194606214577289,412994511,407692976.6,39.25210076982477,46.8696717308067,NaN,NaN,-10.758379832887028,-2.9567510731908566
2022-09-13T09:30:00-04:00,318.8,319.59,310.83,311.73,4301167,2991990.2,38.30974997565485,42.146777983494914,NaN,NaN,-89.06332077330838,-66.41809939167453,-0.9421860695716386,-2.697193208422277,-1.7550071388506385,408693344,408990234.4,44.02468382965556,45.114917579541114,NaN,NaN,-13.20934723224111,-4.421407667340892
2022-09-14T09:30:00-04:00,312.36,313.48,309.53,312.06,2868847,2940578.05,38.74903752911739,41.25056151982223,NaN,NaN,-100.38302688478502,-65.13866374088114,-1.0828242640785604,-3.108537468948839,-2.0257132048702786,411562191,410357214.8,48.60663024837178,43.87823229312159,NaN,NaN,-14.890277566248681,-5.916960510042005
2022-09-15T09:30:00-04:00,311.63,313.52,309.53,310.36,3294627,2957293,37.27643218838354,39.91755758499246,NaN,NaN,-99.06902215862789,-68.67718980078688,-1.2042321104514428,-3.531003342934582,-2.3267712324831393,408267564,410405051,48.76468295868287,42.804738628372014,NaN,NaN,-16.70532513151777,-7.458155455967114
2022-09-16T09:30:00-04:00,305.96,308.58,305.35,308.05,4070950,3068294.25,35.312606364225104,39.410329414378864,NaN,NaN,-126.3824065951003,-85.85961654325884,-1.3434064336018539,-4.006029274485456,-2.6626228408836026,404196614,409142844.8,44.84569497872219,41.729054654196595,NaN,NaN,-18.813382035098623,-9.08033068155733
2022-09-19T09:30:00-04:00,305.37,310.19,305.29,310.15,2730018,3104278.55,38.48537919386248,39.26468325305014,NaN,NaN,-109.25404798758669,-104.83036487988167,-1.2019228997670872,-4.165026465592462,-2.9631035658253744,406926632,407929269,41.40063483011149,40.68203094877308,NaN,NaN,-19.559105707064912,-10.577298542344128
2022-09-20T09:30:00-04:00,307.69,307.99,304.58,307.02,2822819,3111195.4,35.676630512719996,39.1333653839901,NaN,NaN,-122.10705489245444,-111.43911170371089,-1.2229722154080975,-4.491818835085496,-3.2688466196773986,404103813,407011362.8,38.962599189379,39.7212625877525,NaN,NaN,-21.05840181024446,-12.074599009187033
2022-09-21T09:30:00-04:00,308.52,310.27,301.72,301.81,5110654,3221867.55,31.549168387942828,38.86476509878442,NaN,NaN,-134.46364319257822,-118.25523496526948,-1.4747438720876676,-5.112276459786983,-3.6375325876993156,398993159,404497556.4,33.19693611755075,38.83417012004589,NaN,NaN,-23.70610327517071,-13.736242475756129
2022-09-22T09:30:00-04:00,301.56,302.97,299.89,300.52,3492495,3267408.15,30.60504457253306,38.36234984626655,NaN,NaN,-159.35657810067005,-130.31274615367792,-1.604403054259941,-5.643036405524242,-4.038633351264301,395500664,401944176.4,28.571958294019296,37.991464397258554,NaN,NaN,-26.130924080161495,-15.506911276385466
2022-09-23T09:30:00-04:00,297.82,298,292.395,295.86,4949293,3389929.5,27.41359544604343,37.85566268867187,NaN,NaN,-196.7412936821221,-144.38452357108227,-1.8621363225091105,-6.36630375440069,-4.504167431891579,390551371,399215127.8,24.62338731523593,37.17390700239593,NaN,NaN,-29.259583527718096,-17.471578740861556
2022-09-26T09:30:00-04:00,294.6,296.24,291.495,292.72,4143384,3387550.25,25.485136951816983,37.3113889373929,NaN,NaN,-186.112085729853,-159.75613111953552,-2.0853861085450216,-7.110900067572857,-5.025513959027835,386407987,395111398.8,20.120502384563167,36.31053521068534,NaN,NaN,-32.4915694663845,-19.617291701650547
2022-09-27T09:30:00-04:00,294.78,296.53,289.5,291.3,3680981,3426754.6,24.64093780503393,36.2107011879864,NaN,NaN,-164.03159044793526,-168.1410382306317,-2.160799794760929,-7.7265137024789965,-5.5657139077180675,382727006,390836037.4,16.695104427766225,35.314938361442174,NaN,NaN,-35.37908778780232,-21.868976856815085
2022-09-28T09:30:00-04:00,292.35,298.0272,291.05,296.73,3995690,3480225.9,33.68687558740076,35.54560715444343,NaN,NaN,-119.8910018031316,-165.2265099527424,-1.6975234706561046,-7.687618246038198,-5.990094775382094,386722696,388381944.8,15.10543027818747,34.095030622217884,NaN,NaN,-35.0630231832949,-23.753840617740774
2022-09-29T09:30:00-04:00,294.77,294.85,289.85,292.21,3351123,3498703.75,30.414099031949533,34.236656789995,NaN,NaN,-126.53812196677374,-158.66281872596312,-1.5520091503018163,-7.930106213259364,-6.378097062957548,383371573,385956126.6,13.715239638962174,32.70611323293098,NaN,NaN,-35.84024879259592,-25.480470357005796
2022-09-30T09:30:00-04:00,291.21,293.46,287.04,287.3,3827178,3528664.65,27.310195773115794,32.493920665699974,NaN,NaN,-130.57357344453192,-145.4292746784451,-1.6346415450455218,-8.42139899426445,-6.786757449218928,379544395,383754731.4,12.583450665506675,30.801209654051117,NaN,NaN,-37.52288864357425,-27.200815826515576
2022-10-03T09:30:00-04:00,290.555,296.37,289.47,294.79,3457556,3510232,37.747225945431644,32.45374037782689,NaN,NaN,-86.77161269128116,-125.56118007073073,-1.0608754441260517,-8.112851754376493,-7.051976310250441,383001951,383073524.2,12.246670890043276,28.531351586935955,NaN,NaN,-35.35196356425016,-28.365265503334804
2022-10-04T09:30:00-04:00,298.61,303.18,298.4408,303.14,4163757,3552399.75,46.900621293325926,33.03599636098465,NaN,NaN,-24.09366460013531,-97.57359490117075,-0.04846810917733624,-7.112561446722111,-7.064093337544775,387165708,383961264.6,15.42345449856083,26.16112474766374,NaN,NaN,-30.086209845923044,-28.611114695133125
2022-10-05T09:30:00-04:00,299.73,304.55,298.8,302.79,2746927,3563734.4,46.59138151579717,33.70134988437134,NaN,NaN,-16.553424792375136,-76.90607949901946,0.6306957813574732,-6.275723610847933,-6.9064193922054065,384418781,383500481.6,15.117539831155696,23.7577573814118,NaN,NaN,-26.218214477100272,-28.269271806842717
2022-10-06T09:30:00-04:00,301.47,303.31,298.61,299.23,3081700,3552764.7,43.453017377390466,34.282807813883146,NaN,NaN,-24.682133444743286,-56.534881794613376,0.8590940594080161,-5.832551817945387,-6.691645877353403,381337081,383093583.2,14.837668429378695,21.61432691360155,NaN,NaN,-24.077278331053524,-27.67041559601569
2022-10-07T09:30:00-04:00,296.73,296.89,291.435,292.97,3029301,3580266.65,38.537288546052125,34.28651562475384,NaN,NaN,-74.89340793348201,-45.3988486924034,0.6187224277429042,-5.918242842674772,-6.536965270417676,378307780,382846260.2,14.66001442294187,19.70428259880372,NaN,NaN,-23.89734698422301,-27.131405794331023
2022-10-10T09:30:00-04:00,294.28,294.92,290.09,291.96,3154486,3613647.65,37.79439413656393,34.4377844550284,NaN,NaN,-81.91444777047903,-44.427415708242975,0.4307681178526721,-5.998505123101836,-6.429273240954508,375153294,381276528.8,13.551025920584976,17.88917022246129,NaN,NaN,-23.99269206335318,-26.683018118477044
2022-10-11T09:30:00-04:00,291.18,296.135,290.7232,292.29,3849920,3591085.3,38.213493331231575,34.91380766526332,NaN,NaN,-67.06719267936903,-53.022121324089724,0.37005470710260546,-5.966704857076252,-6.336759564178857,379003214,379644030,12.492606241969781,16.410289517062647,NaN,NaN,-23.9428588098586,-26.29156678867441
2022-10-12T09:30:00-04:00,292.46,294.57,291.37,292.16,4378740,3666579.95,38.10458061635831,35.44948881125084,NaN,NaN,-64.63278213338798,-62.63799279229229,0.3620765692954091,-5.884163852559595,-6.2462404218550045,374624474,377685168.6,11.347318779360052,15.179958123158416,NaN,NaN,-23.93334629829963,-25.954678147192297
2022-10-13T09:30:00-04:00,287.14,301.73,286.62,300.56,7389583,3871327.75,48.34848516213115,36.94483807668566,NaN,NaN,-16.8471780199824,-61.07100170734011,0.9311095327065555,-5.08235350597181,-6.013463038678365,382014057,377820563.8,11.94819354863047,14.274587139829455,NaN,NaN,-20.71341624305359,-25.205926446601055
2022-10-14T09:30:00-04:00,302.54,304.3557,296.19,296.82,5526988,3944129.65,44.79379410190446,38.324027873120485,NaN,NaN,27.7416266618536,-40.54399478827298,1.0551036018587165,-4.694583536354969,-5.749687138213686,376487069,377456421.6,11.718153368930473,13.67441935299855,NaN,NaN,-19.0967620918128,-24.333188681631302
2022-10-17T09:30:00-04:00,300.89,303.21,299.98,302.06,3555723,3985414.9,50.30647853120471,40.157280782132695,NaN,NaN,77.14226899854202,-8.732651434468774,1.464333766478556,-3.9192699301154903,-5.383603696594046,380042792,378434321.2,16.374528576875733,13.651521077934941,NaN,NaN,-15.929080309877763,-23.1326017713808
2022-10-18T09:30:00-04:00,308.26,308.38,303.04,305.47,4685468,4078547.35,53.55665189842639,41.57655051863452,NaN,NaN,140.73967095951687,32.8287212933084,1.9107680307015098,-2.9951436582171596,-4.905911688918669,384728260,379579330.4,21.589480191903277,14.114667500343216,NaN,NaN,-12.257936680224027,-21.57907818692983
2022-10-19T09:30:00-04:00,304.34,306.65,302.29,304.35,2939760,3970002.65,52.345674926691764,43.14309165397325,NaN,NaN,122.03393019128882,70.16206375824376,2.0636692380197177,-2.3263251413940225,-4.38999437941374,381788500,381012135.6,27.668092934128254,15.111299878569364,NaN,NaN,-9.659716516029363,-19.87631223394405
2022-10-20T09:30:00-04:00,304.83,308.37,302.74,303.31,3574620,3974108.9,51.1882502177198,44.84866697144496,NaN,NaN,118.82232146287231,97.2959636548147,2.0249761714800605,-1.8587741650636644,-3.883750336543725,378213880,380252100.2,26.494759412206008,16.104964789047887,NaN,NaN,-7.864925168528989,-18.160399796027612
2022-10-21T09:30:00-04:00,303.08,311.2,302.01,310.88,5357237,3994506.1,58.39875256650762,46.32377601580753,NaN,NaN,140.94164860697725,119.93596804383942,2.4130786355341325,-0.8674020421260593,-3.280480677660192,383571117,381668909.8,32.26161950707623,17.534603975978815,NaN,NaN,-3.9361924167287268,-16.128370170413486
2022-10-24T09:30:00-04:00,312.53,316.0001,311.6,315.05,4331651,4003919.45,61.75064534116731,47.38449201922477,NaN,NaN,186.9463852669219,141.89679129751542,2.8258633459802227,0.25184850481508647,-2.5740148411651362,387902768,383240905,38.067451590194395,19.152032339666928,NaN,NaN,0.4646660786897101,-13.7579364205416
2022-10-25T09:30:00-04:00,314.35,318.78,314.11,318.49,6024809,4121110.85,64.30564240365068,48.649796368357165,NaN,NaN,187.9026317624704,151.32938345810612,3.1794519449085317,1.4003000899705285,-1.7791518549380032,393927577,385080768.4,44.105765947751365,21.22261991942376,NaN,NaN,4.95718090195619,-11.084348231613346
2022-10-26T09:30:00-04:00,317.98,321.72,317.77,318.38,5004116,4171532.15,64.15805936837766,50.12872793914197,NaN,NaN,178.29160770565503,162.58091896097935,3.243602548651287,2.2753513308761057,-0.9682512177751813,388923461,386507760.6,48.31481104406593,23.61384439190142,NaN,NaN,8.49277798226216,-8.287615915345416
2022-10-27T09:30:00-04:00,321.5599,323.87,319.92,320.46,4260994,4217025.7,65.75834475867686,52.07308909718659,NaN,NaN,168.62580385843808,172.5416154400925,3.2553440011444463,3.1009287836553767,-0.1544152174890696,393184455,389501875.6,55.830526853803065,26.55459527982008,NaN,NaN,11.93290763414672,-5.398969693989397
2022-10-28T09:30:00-04:00,321.77,328.89,321.46,328.58,5251394,4288236.5,71.16997715968287,54.45705931312365,NaN,NaN,178.78084049236242,180.10945381716954,3.6116600086185224,4.360159793284083,0.748499784665561,398435849,392474822,61.77430886795654,29.999115490346618,NaN,NaN,16.87127852587695,-2.217505662579919
2022-10-31T09:30:00-04:00,326.92,328.82,325.86,327.42,5128206,4371769,69.48061092445093,56.69042485549647,NaN,NaN,155.62226345127976,173.84462945404113,3.5648103737888563,5.204512751901632,1.6397023781127753,393307643,393555797,63.68771636216417,33.6559090703605,NaN,NaN,20.35167073517166,1.0066623942417348
2022-11-01T09:30:00-04:00,329.37,329.8284,324.8,326.41,4376357,4382399,67.96782176684502,58.82351350910266,NaN,NaN,128.56751426593738,161.97760595473449,3.2691679858965337,5.726162360483443,2.456994374586909,388931286,392556538.8,60.66473689842761,37.17858179315105,NaN,NaN,22.764052980759466,4.114861049458553
2022-11-02T09:30:00-04:00,325.46,330.75,321.32,321.36,7110318,4600568.55,60.83556443276397,59.71544774271929,NaN,NaN,97.49774507815272,145.81883342923402,2.5678107258524308,5.666757781902447,3.0989470560500165,381820968,391136040.2,56.555138680657144,40.36479215972438,NaN,NaN,22.758436454691065,6.778228964491769
2022-11-03T09:30:00-04:00,319.35,321.85,317.18,319.87,4112743,4652120.7,58.87258245349017,60.72107548211827,NaN,NaN,60.736716399333346,124.24101593741307,1.8702638735881854,5.436776898035248,3.5665130244470626,377708225,388040794.2,48.797960588427244,43.01334981825986,NaN,NaN,22.175893581433748,8.977895338340623
2022-11-04T09:30:00-04:00,323.61,326.1432,319.34,324.14,6263736,4813842.45,62.597258426855745,61.59898833180763,NaN,NaN,73.88878925006185,103.26260568895296,1.5749989036440404,5.535261654002113,3.9602627503580727,383971961,385148016.6,42.87857545690113,44.906496023975954,NaN,NaN,22.76372657861943,10.947299801237595
2022-11-07T09:30:00-05:00,325.14,328.95,324.15,328.42,4518306,4882033.45,65.92810007215442,62.482663201359635,NaN,NaN,89.59102792814777,90.05635858432655,1.5444031372169862,5.890766671879305,4.346363534662319,388490267,384184541.4,41.09073400517548,46.29944272492397,NaN,NaN,24.282643678233267,12.85234892652269
2022-11-08T09:30:00-05:00,329.4714,333.5599,328.29,331.71,6349031,5006989,68.26743567638516,63.61993182633774,NaN,NaN,106.53684735420968,85.65022520198102,1.614601286363266,6.364615142616401,4.750013856253135,394839298,385366143.8,44.165464591594606,47.477826414743,NaN,NaN,26.280878208552355,14.770710252526928
2022-11-09T09:30:00-05:00,329.71,330.87,324.961,325.34,4799249,5028014.45,59.71813427900275,64.22920925928652,NaN,NaN,74.9137425157109,81.13342468949266,1.1241365707025563,6.155184569631331,5.031047998928774,390040049,387009960,48.21490324222101,49.02926525974407,NaN,NaN,25.310800799040695,16.276437473457467
2022-11-10T09:30:00-05:00,334.22,337.49,331.88,337.26,6002336,4958652.1,67.83550352364124,64.90326289908178,NaN,NaN,127.04515890995492,94.39511319161697,1.472633140665911,6.871839424761163,5.399206284095252,396042385,390676792,55.89854751316735,50.71761726017915,NaN,NaN,27.295871831176026,17.850642381702976
2022-11-11T09:30:00-05:00,337.9,338.37,334.14,337.79,5190697,4941837.55,68.14289816025835,65.35985238615972,NaN,NaN,128.7616790857525,105.3696911587551,1.598466005322841,7.397288790748803,5.798822785425962,401233082,394129016.2,61.665483276628585,52.403190952067305,NaN,NaN,28.908396646546574,19.43032156239492
2022-11-14T09:30:00-05:00,336.71,339.8704,335.564,335.77,3303299,4929216.35,65.57078486683514,65.4502197049586,NaN,NaN,122.81060478736208,112.01360653059797,1.4117629364146014,7.5635264559442135,6.151763519529612,397929783,396016919.4,64.40659753884674,53.85325035143119,NaN,NaN,29.377047548737394,20.851282417586702
2022-11-15T09:30:00-05:00,338.49,340.12,333.42,336.21,4824088,4936147.35,65.87295681595577,65.57271237978561,NaN,NaN,111.29594763612509,112.96542658698104,1.1927294422484334,7.642675322340153,6.44994588009172,402753871,397599834,66.56531978057555,55.156858118324735,NaN,NaN,29.839667130454533,22.135337376567822
2022-11-16T09:30:00-05:00,335.67,337.25,335.55,336.07,3085454,4943432.05,65.67544635652833,65.56679106534644,NaN,NaN,102.7798001498389,118.53863811380666,0.9251812448973382,7.606422436213393,6.6812411913160545,399668417,399525507.6,69.02641601985819,56.099421630185816,NaN,NaN,30.15688909405112,23.281273336208294
2022-11-17T09:30:00-05:00,332.73,336.78,332.73,336.1,3465797,4937990.9,65.69918005090364,65.17601984329077,NaN,NaN,88.46858094793436,110.82332252140255,0.6499906177304808,7.493729463479156,6.843738845748675,403134214,400943873.4,70.73512593794683,56.73947999232798,NaN,NaN,30.42351170969564,24.301593103849342
2022-11-18T09:30:00-05:00,337.46,338.15,335.26,337.37,3659103,4853084.2,66.74740183509599,64.98079062262256,NaN,NaN,96.64651818997238,104.4002903422465,0.4620882540571758,7.421349163320144,6.9592609092629685,406793317,402055920.4,72.03760520198828,57.33590062374399,NaN,NaN,30.92615180671953,25.247958632830798
2022-11-21T09:30:00-05:00,337.66,338.6457,335.5349,337.05,2304118,4751707.55,66.19845852516973,64.85440753393148,NaN,NaN,87.61670014140516,97.36150941305513,0.2362233572126664,7.254540105778801,7.018316748566135,404489199,403367803.6,73.53407496939508,58.25513905738452,NaN,NaN,31.208891844161112,26.0995205201637
2022-11-22T09:30:00-05:00,338.89,341.12,338.39,340.96,4389436,4669938.9,69.49922958604883,65.4732407591661,NaN,NaN,109.79015903060449,97.06035169195101,0.2678148082841183,7.353085258921283,7.085270450637164,408878635,404592756.4,74.88560344175887,59.56445796889178,NaN,NaN,32.34874060447139,26.99226624649337
2022-11-23T09:30:00-05:00,340.61,342.58,339.99,341.95,3108531,4575159.65,70.2903091227602,66.28879266411396,NaN,NaN,113.94961614425183,99.29431489083359,0.2721608519343963,7.425471515555159,7.153310663620763,411987166,407056506.2,77.38687391432228,61.60652320645572,NaN,NaN,33.52710877742302,27.92581517948332
2022-11-25T09:30:00-05:00,342.09,343.795,342.03,343.52,1498294,4437024.65,71.55049107836919,66.9283092820792,NaN,NaN,120.29168849946174,105.65893640113907,0.2955961106348992,7.522805801914387,7.227209691279488,413485460,409126755.4,79.25640480042303,64.20493958813584,NaN,NaN,34.88042334445114,28.91933063162158
2022-11-28T09:30:00-05:00,341.69,342.98,337.95,338.49,3095274,4329218.65,62.41600519876035,66.67744536255105,NaN,NaN,76.22728649375806,101.5750900618962,-0.09210270000230913,7.112081316276601,7.20418401627891,410390186,409846129.2,79.87890615552517,66.97552331316082,NaN,NaN,33.556048804996294,29.58171894210368
2022-11-29T09:30:00-05:00,337.93,339.37,336.61,338.48,2943615,4219989.1,62.39894965901964,66.2582677898821,NaN,NaN,52.92345331879489,94.63644069737416,-0.39659397496596505,6.708441547571454,7.105035522537419,407446571,410437603.6,80.3997223910416,69.5636845845499,NaN,NaN,32.46261748181708,29.993275876348452
2022-11-30T09:30:00-05:00,338.65,346.19,336.18,346.15,6940401,4348191.3,69.32302881723233,66.94433168546992,NaN,NaN,102.72987255335417,93.22438340192409,-0.14194686677436597,6.927601939069461,7.069548805843827,414386972,411539271,81.36713510704976,71.93170114632338,NaN,NaN,33.485907973845244,30.492223318847994
2022-12-01T09:30:00-05:00,346.75,346.76,341.69,344.41,5325874,4258969.1,66.33856256560891,66.83740733132477,NaN,NaN,118.829600974228,94.20038036791932,-0.15039236542932422,6.881558349057173,7.031950714486497,409061098,410954057.4,79.13276803761494,73.59128832664105,NaN,NaN,33.44000422787401,30.91333487728028
2022-12-02T09:30:00-05:00,340.86,345.41,340.86,344.74,3736481,4240156,66.63196864136239,66.72948379426076,NaN,NaN,113.08530747126545,92.75910416228007,-0.1908511473853407,6.793386780254821,6.984237927640161,412797579,410816481.2,78.5864235016561,74.79992691414303,NaN,NaN,33.4855605460419,31.28079568710337
2022-12-05T09:30:00-05:00,342.45,343.305,339.03,340.03,3827240,4118331.2,58.759575960525275,66.2429688723815,NaN,NaN,59.31735317241041,89.37711749801053,-0.5704603561798729,6.2711624824153205,6.841622838595193,408970339,410532511.8,77.39858826730931,75.72792625189035,NaN,NaN,31.146718125408547,31.261641749718397
2022-12-06T09:30:00-05:00,339.77,340.649,334.72,336.46,5516318,4168231.8,53.59124905355662,65.36570403221013,NaN,NaN,-16.568116361531636,75.47880356194523,-1.0686904087855575,5.505759827613247,6.574450236398804,403454021,409734001.8,74.01094159565156,76.25975638153864,NaN,NaN,27.514065037940895,30.726273648035896
2022-12-07T09:30:00-05:00,336.14,338.33,335.54,336.44,3577139,4029637.2,53.56282531088714,64.50051681466432,NaN,NaN,-35.67786238781509,47.79725657371137,-1.3861631974125208,4.841746239633153,6.227909437045674,399876882,406831983.8,63.18674912315489,75.84263731748841,NaN,NaN,24.592041456938148,29.84995476359336
2022-12-08T09:30:00-05:00,337.74,339.65,337.06,338.46,3278409,3953595.2,56.095627180612084,63.81454875250064,NaN,NaN,-13.956092829849585,21.240117812895846,-1.4403510061420821,4.427470679368071,5.867821685510153,403155291,405650822.4,59.38017017087012,75.0315690484115,NaN,NaN,22.812791854597204,28.844645776593907
2022-12-09T09:30:00-05:00,337.67,339.11,335.2501,335.37,3815538,3844255.3,51.470871988618306,62.72336804918081,NaN,NaN,-65.0026327609892,-14.377470233555021,-1.6495016864871683,3.805944577401192,5.45544626388836,399339753,402959257.2,51.73213963829843,73.58117865100508,NaN,NaN,19.888155728786476,27.5651471983357
2022-12-12T09:30:00-05:00,336.14,340.65,336.06,340.62,5017318,3835586.35,57.831925110578496,62.12575851956716,NaN,NaN,0.8563083349471199,-26.069679201047677,-1.4088172041196785,3.694424758738762,5.103241962858441,404357071,402036603.6,49.384056883939685,71.85617735918684,NaN,NaN,19.200332517411905,26.370173672489443
2022-12-13T09:30:00-05:00,348.181,348.22,339.5,341.81,5274321,3934137.45,59.13931324071977,61.38576449490079,NaN,NaN,101.59358906847686,-2.43733811504598,-1.1546905705142478,3.659878749715631,4.814569320229879,409631392,403272077.8,52.493520563700066,70.25674286789693,NaN,NaN,19.032061691612046,25.32187196093553
2022-12-14T09:30:00-05:00,341.78,344.66,337.64,340.22,5498435,3967854.8,56.61364264191943,60.40885974626931,NaN,NaN,34.20552009325401,11.539338381167846,-1.0802417270215985,3.464267161452881,4.544508888474479,404132957,404123292.8,54.56453626227396,68.62657589275061,NaN,NaN,18.14825736227257,24.297069875412248
2022-12-15T09:30:00-05:00,336.58,337.37,330.78,332.8,5871994,4107181.8,46.60975669106626,58.62737871860481,NaN,NaN,-151.89301666293076,-16.04804638544839,-1.4919090634818168,2.6796225591222083,4.171531622604025,398260963,403144427.2,51.76958823775509,66.66323185256005,NaN,NaN,14.022150405465434,22.829224236848418
2022-12-16T09:30:00-05:00,329.29,330.5,326.445,328.97,6672188,4267501.35,42.440945418616174,57.200588734308795,NaN,NaN,-242.9641825658005,-51.640356346410655,-1.9541785462325407,1.7288084398133492,3.68298698604589,391588775,401594231.6,47.61035914834366,64.35833563776137,NaN,NaN,9.150838803956637,20.875169175006736
2022-12-19T09:30:00-05:00,328.87,330.33,325.71,327.38,3709565,4270024.45,40.809112888200445,55.65845753639314,NaN,NaN,-214.5146327431537,-94.71454456203082,-2.276526008653684,0.8373294752287848,3.113855483882469,387879210,398298659.4,40.21361983021083,61.487899740559165,NaN,NaN,4.700393019874053,18.56448686713064
2022-12-20T09:30:00-05:00,327.59,329.8693,326.41,328.38,4721741,4390905.6,42.31145109003171,53.72905912730739,NaN,NaN,-172.0612532124051,-149.4455130182072,-2.323798660282882,0.20910715852886597,2.532905818811748,392600951,394892571.2,34.28500989810492,58.12489079706311,NaN,NaN,1.5548351309421988,16.13453661910372
2022-12-21T09:30:00-05:00,331.541,334.3291,331.12,333.6,5086839,4425775.75,49.514766295298344,52.52735939371377,NaN,NaN,-78.91986510140876,-172.07059005713978,-1.9215746905661542,0.13093745560405523,2.0525121461702094,397687790,393603537.8,32.34172762626238,54.78267362482364,NaN,NaN,1.0414352038157522,13.978379274062583
2022-12-22T09:30:00-05:00,331.5,331.85,325.65,330.26,4876882,4514193.3,45.592002825336564,51.02450469256907,NaN,NaN,-120.84157762827984,-165.8603022502096,-1.8005997367873483,-0.19823752481397605,1.6023622119733723,392810908,392513526.8,30.754317672527677,51.36609463702876,NaN,NaN,-0.640993102977543,11.889897505913993
2022-12-23T09:30:00-05:00,329.62,332.19,328.06,331.93,3997912,4639174.2,47.81804025220493,50.24296642768905,NaN,NaN,-87.1486741483747,-134.6972005667244,-1.5384174977278013,-0.32065966018637937,1.217757837541422,396808820,393557535.8,34.09110084757323,48.27270267847617,NaN,NaN,-1.3236849456664355,10.002242869973932
2022-12-27T09:30:00-05:00,332.34,333.82,330.57,332.37,3098871,4639354.05,48.41686309759453,49.87336743083461,NaN,NaN,-57.4779839852308,-103.28987081513984,-1.2764626559295906,-0.3778204823705664,0.8986421735590242,399907691,395963232,41.13066311591856,45.924111358495246,NaN,NaN,-1.6973447385071443,8.330873211619492
2022-12-28T09:30:00-05:00,332.69,333.74,328.57,328.57,3102446,4647295.6,43.74760519285074,49.17228027954629,NaN,NaN,-75.91300280069173,-84.06022073279716,-1.2960600259885144,-0.7214328589266188,0.5746271670618956,396805245,396804090.8,43.40596602945577,44.51119828037388,NaN,NaN,-3.430934336578325,6.650614990448376
2022-12-29T09:30:00-05:00,330.53,332.85,330.125,332.06,2458825,4423216.8,48.64598165960279,48.64016274233135,NaN,NaN,-50.93883017060822,-78.46401374663705,-1.0229167891491024,-0.7040188193744825,0.31889796977462,399264070,397119346.8,44.275568364510264,43.43229815134818,NaN,NaN,-3.420950913854353,5.211819861262272
2022-12-30T09:30:00-05:00,330.62,331.4,328.345,331.33,3881803,4351013.25,47.71013666705342,48.371538790791,NaN,NaN,-63.23747381883398,-66.94319298474787,-0.8475871380900419,-0.7405859528379324,0.1070011852521095,395382267,397633618.6,45.740245505072565,43.00430571326062,NaN,NaN,-3.6860377806704077,3.9406973409861754
2023-01-03T09:30:00-05:00,332.42,333.8276,328.3536,331.22,3910724,4359725.4,47.561656506098736,47.637948176185304,NaN,NaN,-46.632320774264066,-58.83992230992575,-0.7012574435571484,-0.7695706191943259,-0.06831317563717759,391471543,396566163.2,43.20195476621976,42.56272699056633,NaN,NaN,-3.942994716226628,2.8144556185272034
2023-01-04T09:30:00-05:00,332.56,334.04,330.2,332.56,4137262,4375226.5,49.61861108390498,46.9578980221271,NaN,NaN,-23.378226363743018,-52.019970785628196,-0.4866412842388356,-0.6766147809357221,-0.1899734966968865,395608805,395706386,41.21791766034422,41.75732678318377,NaN,NaN,-3.594149745133878,1.8989405665756203
2023-01-05T09:30:00-05:00,330.97,331.15,328.1,329.22,4350093,4316915.25,44.89179149671834,46.12062294032702,NaN,NaN,-67.93174828567716,-50.42371988262529,-0.5380325381720069,-0.8625141694118952,-0.32448163123988827,391258712,394597079.4,38.74552043650197,40.62739708134292,NaN,NaN,-4.620577299486349,0.9675808714239105
2023-01-06T09:30:00-05:00,332.18,337.12,329.91,336.28,4800792,4378097.9,54.71255328154286,46.69939412536106,NaN,NaN,26.323518429830507,-34.97125016253754,-0.08852808216908209,-0.4351417339512409,-0.3466136517821588,396059504,393956166.2,37.35148945011692,39.597532882225906,NaN,NaN,-2.4500021759089554,0.4793547218049296
2023-01-09T09:30:00-05:00,337.69,339.41,334.92,335.29,3864019,4407378.4,53.27872261533251,47.47352106798366,NaN,NaN,70.85236864197248,-8.153281670376249,0.137833914179244,-0.1743212590581038,-0.3121551732373478,392195485,393318809.8,35.965669233328455,38.76576931686767,NaN,NaN,-1.1334498015130943,0.24895407561664049
2023-01-10T09:30:00-05:00,334.95,337.33,334.29,337.23,2277477,4330475.35,55.72721599124311,48.53909986105814,NaN,NaN,66.39337884092508,14.451858252661584,0.39913987352421504,0.186769668667921,-0.21237020485629404,394472962,393919093.6,38.28801787750366,38.62822632024574,NaN,NaN,0.712404919204025,0.31516133898626686
2023-01-11T09:30:00-05:00,338.4,339.806,337.13,339.76,3265765,4242897.7,58.76237432752379,49.71416580659329,NaN,NaN,119.28407518170351,42.98431856175089,0.7053926428649293,0.6693705987248677,-0.03602204414006166,397738727,394345078,39.952321361116816,39.03303428188944,NaN,NaN,3.2113089545516402,0.728896712638463
2023-01-12T09:30:00-05:00,340.88,343,337.95,342,4332552,4195809.25,61.292553202895085,50.555436299993055,NaN,NaN,169.99743072935698,90.57015436475771,1.003648070692549,1.2185380442256246,0.2148899735330756,402071279,396507591.4,47.6680932708791,40.127774685076346,NaN,NaN,6.096928894375841,1.4957584528866599
2023-01-13T09:30:00-05:00,339.16,343.49,339.11,343.04,3473423,4094558.65,62.44467682548902,51.75919872857537,NaN,NaN,184.0316396385105,122.11177860649373,1.2023871638720949,1.7178739283731943,0.5154867645010994,405544702,398404631,53.33302966222386,41.7405398271975,NaN,NaN,8.822041597573369,2.542370330699047
2023-01-17T09:30:00-05:00,342.36,342.75,338.6304,339.16,3929658,3997441.85,55.77469254547778,52.32753103523772,NaN,NaN,126.54469766186364,133.25024441047194,1.0116097252335112,1.7799989210429885,0.7683891958094773,401615044,400288542.8,58.175111486138874,43.460826301380756,NaN,NaN,9.250595111883817,3.5006881565825854
2023-01-18T09:30:00-05:00,339.57,340.2,332.7,332.97,5164250,3922044.95,47.1262841051459,52.2353468214914,NaN,NaN,32.146397020349944,126.40084804635691,0.43696727260846635,1.3145982865700603,0.8776310139615939,396450794,400684109.2,59.13391380488834,44.74677277916432,NaN,NaN,6.803503466968365,3.9725189152091254
2023-01-19T09:30:00-05:00,331.06,332.455,329.965,330.63,3454233,3909278.35,44.328028907364015,52.27680565824234,NaN,NaN,-51.57637386136388,92.22875823774345,-0.10344855826951138,0.7483203161247047,0.8517688743942161,392996561,399735676,55.82924403623566,45.63414977964859,NaN,NaN,3.88519753963305,3.9600444329839717
2023-01-20T09:30:00-05:00,330.82,333.73,329.35,333.67,4120190,3879200.8,48.598196213172756,52.273392412068766,NaN,NaN,-33.361773270579185,51.556917437756205,-0.2505075033380696,0.5386344952216291,0.7891419985596987,397116751,398744770.4,52.52646273657812,46.22349937765345,NaN,NaN,2.7960290038664506,3.7937565145386114
2023-01-23T09:30:00-05:00,334.69,337.75,333.05,336.17,3985295,3824123.6,51.867799904537456,52.57036835760334,NaN,NaN,31.858579981883196,21.12230550643074,-0.1771994812555696,0.5676426469902367,0.7448421282458063,401102046,397856239.2,49.687929074509235,46.50547677547034,NaN,NaN,2.9247853905452663,3.669617782539562
2023-01-24T09:30:00-05:00,334.96,337.72,333.7,337.1,3360938,3748326.4,53.06385663841766,52.963382652768985,NaN,NaN,36.674047225988396,3.1481754192556806,-0.06940249976591928,0.6580890035384073,0.7274915033043265,404462984,398425827.2,51.497408580288294,47.09800919076095,NaN,NaN,3.391474899816422,3.629883085007685
2023-01-25T09:30:00-05:00,334.24,337.64,332.55,337.32,4318605,3764361.05,53.35911841822234,53.23056174807736,NaN,NaN,25.40475703208628,1.7998474216029507,0.009208238447281913,0.739001801363429,0.729793562916147,408781589,400891986.2,58.46304849098737,48.32980425009261,NaN,NaN,3.8536400471925365,3.6618483653198064
2023-01-26T09:30:00-05:00,338.45,339.46,336.2,339.36,2930873,3755961.15,56.11588112101407,54.03228243552706,NaN,NaN,71.48886095524476,26.412894384924677,0.18153186072122152,0.956708388817674,0.7751765280964524,411712462,404635166.4,66.35995490451114,50.302263854950404,NaN,NaN,5.04224749787955,3.8590482413997695
2023-01-27T09:30:00-05:00,339.4,341.535,338.16,339.61,2907380,3746207.85,56.45555326717911,54.15678243450107,NaN,NaN,93.78900307216995,51.843049653474495,0.28891204810892046,1.136316588232603,0.8474045401236825,414619842,408135784.6,71.76603983395654,52.76044602522467,NaN,NaN,6.114879113547397,4.181309794563717
2023-01-30T09:30:00-05:00,338.461,340.43,336.845,337.06,3032739,3774903.55,52.03165578665141,54.06770623245243,NaN,NaN,52.945553921778995,56.06044444145366,0.17060995412513846,1.0606669827801056,0.8900570286549672,411587103,410232796,74.41819100656872,55.50705472331326,NaN,NaN,5.830943529484314,4.41697175669523
2023-01-31T09:30:00-05:00,337.6,340.86,336.51,340.83,2593457,3710486.25,57.35247030244984,54.18379582611005,NaN,NaN,75.14625164902402,63.75488532606077,0.3199949503529622,1.2900507165961699,0.9700557662432077,414180560,412176311.2,76.61104229159797,58.24441361003427,NaN,NaN,7.140926682154869,4.806108174618036
2023-02-01T09:30:00-05:00,339.12,343.27,335.58,340.87,6175391,3823719.6,57.406454979047815,54.086944444076046,NaN,NaN,78.5884811508041,74.39163014980434,0.3905608011553783,1.4582567676874305,1.0676959665320522,420355951,414491183.6,78.92794894301585,61.02838700874135,NaN,NaN,8.220452292233967,5.29387161999174
2023-02-02T09:30:00-05:00,341.51,341.51,338.01,340.43,5169417,3875327.35,56.558347863392264,53.748786919825854,NaN,NaN,72.49449938936786,74.59275783662898,0.3765025143815173,1.5383241095089488,1.1618215951274316,415186534,415185998,79.58174562886333,63.307933605740224,NaN,NaN,8.894771374667963,5.8082858706597715
2023-02-03T09:30:00-05:00,338.77,341.67,337.96,338.98,6504277,3983036.55,53.74065937228048,53.12707138745382,NaN,NaN,55.38953254334251,66.91286373086348,0.24482645039497863,1.467854658121155,1.2230282077261763,408682257,413998481,75.28256192197169,64.87575733857935,NaN,NaN,8.723503051042925,6.224745467857365
2023-02-06T09:30:00-05:00,337.65,339.56,336.69,338.48,2708370,3878415.45,52.76449106751817,52.91205699617098,NaN,NaN,15.57163788789769,59.43808052408722,0.10640129076811933,1.3560298211863255,1.2496285304182062,405973887,412875837.8,71.35790900326171,65.81738573265956,NaN,NaN,8.32248868032868,6.524423069638981
2023-02-07T09:30:00-05:00,336.95,342.305,336.19,341.52,4969583,3933693.65,57.78529986664768,53.67341526484968,NaN,NaN,62.1870273798731,56.84623567025706,0.1966744242000349,1.4954715606682498,1.298797136468215,410943470,412228419.8,69.12002059206762,66.53067907460094,NaN,NaN,9.340263801769517,6.926686031371915
2023-02-08T09:30:00-05:00,340.37,341.46,338.84,339.42,2769515,3958295.55,53.55080616052247,54.33218506864671,NaN,NaN,55.237331735590104,52.176005787214265,0.09708789745661339,1.4201570082889816,1.3230691108323682,408173955,409792020.6,61.32555791872068,66.92327292334986,NaN,NaN,9.04379849580503,7.229130669148074
2023-02-09T09:30:00-05:00,341.75,342.56,336.0604,337.08,3094735,3949744.05,49.222398669088165,54.37677095835495,NaN,NaN,15.545521945749531,40.78621029849059,-0.1318160180745087,1.1582990882392323,1.290115106313741,405079220,407770557.8,55.712060437656156,67.150815616284,NaN,NaN,7.53071931586257,7.272214761535859
2023-02-10T09:30:00-05:00,336.74,339.01,335.95,338.73,2523928,3859312.85,52.158809869783504,54.39755738444395,NaN,NaN,-0.024047285148188734,29.703494332792452,-0.17484113210434127,1.0715636911833144,1.2464048232876557,407603148,407554736,55.13181920442238,67.5396649112778,NaN,NaN,7.073376886859224,7.243809350867768
2023-02-13T09:30:00-05:00,338.88,342.56,338.88,342.55,2653949,3818339.15,58.187402525042394,54.76352494777429,NaN,NaN,109.86312791778434,48.56179233876977,0.039777261940167286,1.2961264007128648,1.2563491387726975,410257097,408411378,57.044181203345346,67.93586295578187,NaN,NaN,8.50129671663888,7.423450403120785
2023-02-14T09:30:00-05:00,341.52,343.53,338.41,341.14,3501122,3796912.35,55.41180375869927,54.91014532923693,NaN,NaN,97.63440165812695,55.65126719442054,0.07077392241316782,1.3448165417891573,1.2740426193759895,406755975,407573879,54.59428090273881,67.65952241376412,NaN,NaN,8.861398169996463,7.628871512674453
2023-02-15T09:30:00-05:00,339.46,341.67,338.63,341.66,1972454,3637322.55,56.240825181080275,54.919069904955954,NaN,NaN,81.12704094178002,60.82920903565853,0.10806192454895203,1.4091200250621796,1.3010581005132276,408728429,407684773.8,54.87066152856823,66.83885860119678,NaN,NaN,9.395451586741766,7.8812400946840695
2023-02-16T09:30:00-05:00,338.5,340.89,337.31,337.39,3229591,3626090.45,48.29942589335661,54.33648937825434,NaN,NaN,-1.0893657815926718,57.502231490190084,-0.15859438560338246,1.1028151185089996,1.261409504112382,405498838,407768697.4,55.09343551458701,65.64795829267037,NaN,NaN,7.420395104420844,7.815405096075037
2023-02-17T09:30:00-05:00,335.72,338.43,335.08,338.29,3034169,3571789.4,49.90503113485255,54.18458761741157,NaN,NaN,-76.35938787161592,42.235163372896544,-0.27147974728875646,0.9220598200014365,1.193539567290193,408533007,407954669.2,55.61628517455551,64.30496501895513,NaN,NaN,6.281337153582806,7.596252532861861
2023-02-21T09:30:00-05:00,334.72,335.94,331.1,331.25,3142876,3529668.45,39.5565492624412,52.9134504002681,NaN,NaN,-264.0384820536641,-32.54515862139314,-0.7881603137731347,0.20833917507377464,0.9964994888469093,405390131,406981276,52.191060846624026,62.560680630028436,NaN,NaN,1.6029234762782913,6.7400626676356366
2023-02-22T09:30:00-05:00,331.75,332.43,329.45,330.52,2896384,3506440.75,38.66130064858784,51.57451080523524,NaN,NaN,-282.9672397615319,-108.66548690532491,-1.1263608072701243,-0.41145152024074605,0.7149092870293783,402493747,406128830.4,49.32604900359535,60.4462592057841,NaN,NaN,-2.36297660878586,5.439628485289709
2023-02-23T09:30:00-05:00,331.85,332.7499,327.98,331.67,5999610,3590491,40.92937098044192,50.458155313595924,NaN,NaN,-230.7407356772636,-171.03904222913363,-1.2124200079369358,-0.8006157228917914,0.4118042850451443,408493357,406081816,49.16574593439293,58.273687799036225,NaN,NaN,-4.877365720748327,3.965772170141418
2023-02-24T09:30:00-05:00,327.83,329.135,326.43,328.12,3764680,3632181.35,36.44891921645657,49.22303101675136,NaN,NaN,-226.89614481493192,-216.20039803580147,-1.4331102350389708,-1.3795835087535693,0.05352672628540156,404728677,405927783.8,48.6083780497962,56.36838895102369,NaN,NaN,-8.525749178158476,2.1812691203842904
2023-02-27T09:30:00-05:00,330.73,331.98,328.2,329.06,2887324,3631178.55,38.37265050873869,48.19504240540997,NaN,NaN,-146.3209755122016,-230.1927155639186,-1.4368079762408033,-1.7424832440156024,-0.30567526777479925,407616001,405744382.6,47.91191484852183,54.69367508282799,NaN,NaN,-10.881335631337382,0.31518272728119445
2023-02-28T09:30:00-05:00,328.87,328.87,326.51,326.57,3155346,3637308.9,35.32244951243703,46.59055309439492,NaN,NaN,-153.78851798807042,-208.1427227507999,-1.5199250002997382,-2.2055815181494722,-0.6856565178497339,404460655,405558487.4,47.17411009741785,53.12611004749585,NaN,NaN,-13.843410977284204,-1.707473516228148
2023-03-01T09:30:00-05:00,326.04,327.82,325.3,327,3317538,3673512.95,36.2646446610095,45.35582727300114,NaN,NaN,-135.10884948224262,-178.57104469494203,-1.4586515656283172,-2.5089709748851305,-1.0503194092568133,407778193,406615376.6,51.72566883933403,52.440403684682515,NaN,NaN,-15.956765317825127,-3.743086630742002
2023-03-02T09:30:00-05:00,327.57,331.2,326.8,330.44,3049578,3517222.3,43.37178429476412,44.93792624626371,NaN,NaN,-82.75593846932945,-148.9740852533552,-1.114673313363666,-2.4436610509613956,-1.3289877375977297,410827771,407082259.4,53.62651160701085,52.291435911064994,NaN,NaN,-15.646729861125126,-5.443607092225305
2023-03-03T09:30:00-05:00,331.52,334.43,330.415,334.21,3033470,3410424.95,49.95774183836213,44.780707101162186,NaN,NaN,-29.075808815017645,-109.41001805337234,-0.5879326716986373,-2.0639035772210264,-1.475970905522389,413861241,408908772.2,60.224937308065314,52.6552300613252,NaN,NaN,-13.240154795905267,-6.557399621322443
2023-03-06T09:30:00-05:00,334.63,336.12,334.18,334.68,2641708,3217296.5,50.72711185878136,44.247829196429244,NaN,NaN,2.159389036317342,-79.71394514366855,-0.18351099299993523,-1.7053596467723082,-1.521848653772373,416502949,410686161.8,65.386287686847,53.251094810146746,NaN,NaN,-11.081762523686242,-7.203737178802985
2023-03-07T09:30:00-05:00,334.67,334.92,328.72,328.87,5009229,3332339.45,42.108602682406904,43.29760054812265,NaN,NaN,-53.44758667647726,-59.645758881349934,-0.2773135933504083,-1.8684906454603833,-1.591177052109975,411493720,412092774.8,68.8331365658711,54.268155928941916,NaN,NaN,-11.925877190396356,-7.87832860903061
2023-03-08T09:30:00-05:00,328.92,329.5,326.6,328.49,3169584,3242339.5,41.610649339220764,42.252587987989834,NaN,NaN,-83.93653986172565,-49.41129695724654,-0.3313142639849005,-2.0053198820911007,-1.6740056181062002,408324136,412201963.4,69.09044508696678,55.28385475454182,NaN,NaN,-12.744359675328631,-8.57347590421604
2023-03-09T09:30:00-05:00,329.72,330.44,322.4,323.08,4760947,3341911.1,35.22422687508764,41.318645200970614,NaN,NaN,-116.2643786945557,-56.11298500229181,-0.6777847685556082,-2.5212365788007105,-1.8434518102451023,403563189,410749047,61.78130689070422,55.7615598528359,NaN,NaN,-15.640842329013708,-9.583099679187136
2023-03-10T09:30:00-05:00,322.54,324.87,318.43,319.73,7741847,3574266.7,31.953776461209557,40.03641272428184,NaN,NaN,-159.94012392711937,-82.28584802471212,-1.0563979465366948,-3.1639492434159706,-2.107551296879276,395821342,407141067.2,48.156967130471216,55.2287514211156,NaN,NaN,-19.17894865426669,-10.953935247055643
2023-03-13T09:30:00-04:00,316.76,323.17,316.66,318.82,6831617,3789651.15,31.108826488277728,39.43300395469873,NaN,NaN,-161.7181605403246,-115.06135794004051,-1.27718715676331,-3.704035242833413,-2.426848086070103,388989725,401638422.4,35.352303872221796,54.02598306580115,NaN,NaN,-22.246961948759107,-12.567224775870423
2023-03-14T09:30:00-04:00,322.21,323.71,318.71,322.19,4760458,3894976.6,37.680910345710366,39.362976075921765,NaN,NaN,-125.39476234896634,-129.45079307453835,-1.1114306573045658,-3.81613640770081,-2.7047057503962444,393750183,398089715,29.841520090606664,52.63423100058767,NaN,NaN,-22.727586469296366,-14.018705017788415
2023-03-15T09:30:00-04:00,316.9,319.8071,314.97,319.54,6518035,4045822.25,34.86433390535814,38.92975914198721,NaN,NaN,-156.37676629783294,-143.9388383617598,-1.093733186146232,-4.071872233079034,-2.978139046932802,387232148,393871317.4,24.877205966062135,50.89933528856404,NaN,NaN,-24.035555906683808,-15.449683716202042
2023-03-16T09:30:00-04:00,317.66,323.57,316.43,323.25,6579949,4276197,41.46145967606234,39.287797746244756,NaN,NaN,-104.35880664532847,-141.55772395191434,-0.7613907951772214,-3.9298775409043287,-3.1684867457271073,393812097,391921099,22.974365978748267,49.06833442634633,NaN,NaN,-22.972436428272015,-16.52436267506918
2023-03-17T09:30:00-04:00,320.72,321.09,317.16,318.5,5315086,4380471.75,36.380877724733075,39.14552826167293,NaN,NaN,-121.23299820371835,-133.81629880723415,-0.7874190737220266,-4.152760587879641,-3.365341514157614,388497011,390456232.8,21.635703529150547,47.191462189248384,NaN,NaN,-23.77471502414836,-17.560127296366208
2023-03-20T09:30:00-04:00,319.33,322.75,319.33,322.3,4695134,4463520,42.45585535072506,39.65505725012207,NaN,NaN,-74.57817206946777,-116.3883011130628,-0.4892669867649877,-3.976925247613849,-3.4876582608488613,393192145,391296716.8,24.359036680539617,45.561814088042794,NaN,NaN,-22.351955339437033,-18.24467415966204
2023-03-21T09:30:00-04:00,325.42,325.84,323.34,325.62,3527311,4482741.75,47.19972116703866,40.43613414340986,NaN,NaN,-17.90799923210931,-94.89094848969137,-0.03307189240101627,-3.5289981263501318,-3.4959262339491155,396719456,391890571.4,26.307713957059846,43.746245882166065,NaN,NaN,-19.55403468171389,-18.431725662812305
2023-03-22T09:30:00-04:00,325.65,327.56,320.06,320.18,4378682,4556856.65,41.20550985634179,40.28140025495112,NaN,NaN,-48.52178176310829,-73.31995158274643,-0.060700360979698775,-3.571801685173739,-3.51110132419404,392340774,392912296.6,29.665034531007294,42.03471180530867,NaN,NaN,-19.245072898981135,-18.547918125122138
2023-03-23T09:30:00-04:00,321.33,325.02,318.5,320.84,4772565,4495504.4,42.16515769770308,39.72478710204691,NaN,NaN,-60.41535150135568,-64.53126055395188,-0.0007056379251966227,-3.511983371600536,-3.5112777336753394,397113339,393572545,31.82648074161621,40.00625062199087,NaN,NaN,-18.690632673173674,-18.56830591770093
2023-03-24T09:30:00-04:00,319.45,322.46,317.9086,322.32,4485455,4531543.15,44.358354919492626,39.26987589209772,NaN,NaN,-62.932931060299744,-52.87124712526817,0.1633966742046571,-3.307031890919518,-3.470428565124175,401598794,396192901.6,39.74113301269872,38.17445385955171,NaN,NaN,-17.550139491635413,-18.42285357112014
2023-03-27T09:30:00-04:00,324.59,325.57,323.3,324.31,3550881,4564721,47.25468507139499,39.63745320559686,NaN,NaN,-3.3154152540913326,-38.61869576219288,0.41632368637447836,-2.950023957156077,-3.3663476435305553,405149675,398584407.6,45.91284975546341,36.53729051595116,NaN,NaN,-15.709612575706766,-18.035247714632515
2023-03-28T09:30:00-04:00,323.99,325.65,322.84,323.81,2536520,4533779.7,46.59835798395484,39.99371810879216,NaN,NaN,-5.763006700154803,-36.18969725580198,0.5518105789880301,-2.6765844197955175,-3.2283949987835476,402613155,399763147.4,48.701663207478575,35.08094895313058,NaN,NaN,-14.414972007864947,-17.518065470808576
2023-03-29T09:30:00-04:00,326.58,327.1663,325.29,327.08,2531695,4494487.55,51.35675252128185,41.146041369234595,NaN,NaN,36.79242933632291,-19.126855035915735,0.8459207377279805,-2.170994076623572,-3.0169148143515523,405144850,402323962.6,54.22383309439103,34.541129396251065,NaN,NaN,-11.849923817752396,-16.708330948943406
2023-03-30T09:30:00-04:00,328.88,328.95,326.72,328.48,2486955,4466356.4,53.27633893916232,42.669081546231226,NaN,NaN,66.50849630524353,6.257914525404111,1.102768090304938,-1.6384547014703799,-2.741222791775318,407631805,404427655.8,58.20424068678515,35.25879179313063,NaN,NaN,-9.149634897898137,-15.62851722736551
2023-03-31T09:30:00-04:00,329.59,332.81,329.51,332.62,2837333,4456549.55,58.49268864298206,44.625071700138676,NaN,NaN,135.09619909955964,45.86374055737599,1.4951424425527788,-0.872294738584344,-2.367437181137123,410469138,406201724.6,61.26327116385971,37.109575171104765,NaN,NaN,-5.130383179493709,-14.128783791955254
2023-04-03T09:30:00-04:00,333.59,336.25,333.51,335.91,3450686,4496998.45,62.112652812187676,46.37019616202991,NaN,NaN,199.77359917918596,86.48154344403144,1.8942408343795272,0.00036386183728609467,-1.893876972542241,413919824,407955754.4,64.0637693700553,39.55402154820824,NaN,NaN,-0.5314027705079225,-12.18630078889135
2023-04-04T09:30:00-04:00,335.91,336.26,332.6301,333.94,2449871,4369030.55,58.80551178776239,48.08028029648735,NaN,NaN,170.18454672609437,121.67105412928126,1.936634057061721,0.5269155987849103,-1.4097184582768107,411469953,409727114,66.6833296592254,42.54017324057704,NaN,NaN,2.297448146721238,-10.117193798089552
2023-04-05T09:30:00-04:00,334,335.45,333.76,334.82,2566604,4338881.55,59.83430722126086,49.39262654971582,NaN,NaN,155.75064459541,145.4626971810987,1.9306954285906135,1.0036508274614562,-0.9270446011291573,414036557,411505455.4,69.11724256625538,45.83609299682756,NaN,NaN,4.914706255735067,-7.969779504686036
2023-04-06T09:30:00-04:00,334.35,335.31,333.28,334.9,2333279,4217498.15,59.93227350077042,51.07486910514706,NaN,NaN,128.05444512439422,157.77188694492884,1.8393200684022557,1.3721054843736624,-0.4672145840285933,416369836,413253061.6,71.33355224624071,49.385939333762565,NaN,NaN,7.072045133817005,-5.820947413471316
2023-04-10T09:30:00-04:00,334,335.96,333.4327,335.96,2834213,3972116.45,61.279866543388586,52.419441333194456,NaN,NaN,116.64356358492834,154.08135984200257,1.7575337953790697,1.7297026601952439,-0.02783113518382585,419204049,415000043.8,73.38943373365143,52.88811055184198,NaN,NaN,9.270563580608766,-3.665017271459876
2023-04-11T09:30:00-04:00,336.31,337.87,336.0148,336.9,2343093,3747690.25,62.4848401450012,53.51123554590606,NaN,NaN,120.6487762933072,138.25639526482684,1.6743812533064173,2.0651454314491957,0.3907641781427785,421547142,416525507.4,75.07068488818567,56.37117990406525,NaN,NaN,11.46605857141486,-1.5034350081920569
2023-04-12T09:30:00-04:00,338.61,339.01,335.96,336.61,3363762,3677855.45,61.84539560035819,54.98551309905009,NaN,NaN,108.03255802880739,125.82599752536944,1.5124193738566156,2.281288395463548,0.7688690216069325,418183380,417868192.8,76.47928004592119,59.715054583701956,NaN,NaN,13.150408023901939,0.5899711392499425
2023-04-13T09:30:00-04:00,337.07,340.58,336.07,340.37,3040854,3503996.4,66.61568976870026,56.73197967554989,NaN,NaN,113.70677462368137,117.41722353102371,1.5645660666570502,2.724576604928245,1.160010538271195,421224234,419305728.2,77.91789720544054,63.00729861683227,NaN,NaN,16.058800324351395,2.7998038799787213
2023-04-14T09:30:00-04:00,339.94,340.85,337.31,338.84,3107859,3330391.9,63.1555171028389,58.07463411721748,NaN,NaN,101.47165488897546,112.10066548393995,1.4070168446261047,2.9187815940538258,1.511764749427721,418116375,419655036,78.26576435230766,65.75905799823292,NaN,NaN,17.605678762160284,4.914928863147516
2023-04-17T09:30:00-04:00,339.12,339.93,337.99,339.92,2226394,3175957.3,64.5550794721479,59.310376574414114,NaN,NaN,95.80794944923854,107.933542656802,1.2896505027853706,3.1238278779094344,1.8341773751240638,420342769,419882780,78.50353778285319,68.0869642859036,NaN,NaN,19.305746009524803,6.970759884058557
2023-04-18T09:30:00-04:00,339.94,340.2224,337.9,339.8,2191052,3050753.2,64.26298532029898,60.57213566986726,NaN,NaN,89.1891572654002,101.6416188512206,1.1241019784075377,3.239304848133486,2.115202869725948,418151717,419203695,75.8392871871832,70.02536599873966,NaN,NaN,20.645616015543155,8.924310759984929
2023-04-19T09:30:00-04:00,339.11,339.63,338.19,338.99,2854701,3017122.7,62.21660109310531,61.347839139283224,NaN,NaN,78.51302656235087,95.73771255792929,0.8904358788379567,3.228247718273394,2.3378118394354375,415297016,418626422.2,73.554035754506,71.40609476017644,NaN,NaN,21.26963002781762,10.687927798246742
2023-04-20T09:30:00-04:00,337.43,338.85,336.85,337.95,2179345,2907155.85,59.59267170705144,61.79900576556103,NaN,NaN,62.00008203120381,85.39637403943378,0.6096166196866033,3.0998326140436916,2.4902159943570883,413117671,417005109.6,67.41025040214058,72.06366688270182,NaN,NaN,21.131903375607617,12.179924309298295
2023-04-21T09:30:00-04:00,338.26,338.58,336.81,338.11,2470056,2792030.4,59.87305573918277,61.897603415289645,NaN,NaN,58.30292791502276,76.76262864464324,0.3891554402065922,2.9766602946153284,2.5875048544087362,415587727,416499380,65.57043647899033,72.37132154806831,NaN,NaN,21.08421684451928,13.45196610004415